week,Date,PTE,period_from,period_until,upward_dispatch_EURMwh,downward_dispatch_kWhPTE,incentive_component_EURMwh,take_from_system_kWhPTE,feed_into_system_EURMwh,Regulation state,purchase_kWhPTE,sell_kWhPTE,absolute_kWhPTE,imbalance_kWhPTE,downward_reserve_kWh_PTE,downward_power_kWh_PTE,upward_power_kWh_PTE,upward_reserve_kWh_PTE,upward_incident_reserve_kWh_PTE,downward_incident_reserve_kWh_PTE,volume_kWhPTE,totals_kWhPTE
1,01-01-17,1,0:00,0:15,250,-200,0,250,-200,2,-111380,106822,218202,-4558,0,-6199,3167,0,0,,9366,-3032
1,01-01-17,2,0:15,0:30,250,,0,250,250,1,-110431,79722,190153,-30709,0,0,39599,0,0,,39599,39599
1,01-01-17,3,0:30,0:45,,,0,33.56,33.56,0,-95092,96056,191148,964,0,0,2883,0,0,,2883,2883
1,01-01-17,4,0:45,1:00,42.89,,0,42.89,42.89,1,-119886,93190,213076,-26696,0,0,1062,0,0,,1062,1062
1,01-01-17,5,1:00,1:15,72.28,,0,72.28,72.28,1,-116536,108904,225440,-7632,0,0,3760,0,0,,3760,3760
1,01-01-17,6,1:15,1:30,250,,0,250,250,1,-129230,101447,230677,-27783,0,0,37005,0,0,,37005,37005
1,01-01-17,7,1:30,1:45,39.13,33.12,0,39.13,33.12,2,-92298,106249,198547,13951,0,-169,6199,0,0,,6368,6030
1,01-01-17,8,1:45,2:00,46.69,,0,46.69,46.69,1,-122009,106071,228080,-15938,0,0,2790,0,0,,2790,2790
1,01-01-17,9,2:00,2:15,250,,0,250,250,1,-128845,56635,185480,-72210,0,0,27771,0,0,,27771,27771
1,01-01-17,10,2:15,2:30,250,,0,250,250,1,-115620,81356,196976,-34264,0,0,45063,0,0,,45063,45063
1,01-01-17,11,2:30,2:45,250,31.63,0,31.63,31.63,-1,-94781,98027,192808,3246,0,-673,5028,0,0,,5701,4355
1,01-01-17,12,2:45,3:00,,35.63,0,35.63,35.63,-1,-90597,91469,182066,872,0,-830,0,0,0,,830,-830
1,01-01-17,13,3:00,3:15,250,36.63,0,250,34.33,2,-110290,63869,174159,-46421,0,-297,17338,0,0,,17635,17041
1,01-01-17,14,3:15,3:30,49.13,,0,49.13,49.13,1,-93776,84925,178701,-8851,0,0,16146,0,0,,16146,16146
1,01-01-17,15,3:30,3:45,49.13,36.63,0,36.63,36.63,-1,-79142,85259,164401,6117,0,-10,432,0,0,,442,422
1,01-01-17,16,3:45,4:00,,31.63,0,31.63,31.63,-1,-79233,86992,166225,7759,0,-4990,0,0,0,,4990,-4990
1,01-01-17,17,4:00,4:15,50.02,36.63,0,50.02,50.02,1,-85800,65477,151277,-20323,0,-2491,5166,0,0,,7657,2675
1,01-01-17,18,4:15,4:30,42.39,,0,42.39,42.39,1,-81786,69877,151663,-11909,0,0,7660,0,0,,7660,7660
1,01-01-17,19,4:30,4:45,43.13,,0,43.13,43.13,1,-81416,66530,147946,-14886,0,0,9457,0,0,,9457,9457
1,01-01-17,20,4:45,5:00,42.39,,0,42.39,42.39,1,-90044,67192,157236,-22852,0,0,9324,0,0,,9324,9324
1,01-01-17,21,5:00,5:15,42.39,36.63,0,36.63,36.63,-1,-86120,96950,183070,10830,0,-533,451,0,0,,984,-82
1,01-01-17,22,5:15,5:30,,,0,34.33,34.33,0,-88996,88218,177214,-778,0,0,0,0,0,,0,0
1,01-01-17,23,5:30,5:45,49.13,,0,49.13,49.13,1,-98115,76030,174145,-22085,0,0,7217,0,0,,7217,7217
1,01-01-17,24,5:45,6:00,56.02,,0,56.02,56.02,1,-111881,75405,187286,-36476,0,0,29447,0,0,,29447,29447
1,01-01-17,25,6:00,6:15,49.13,,0,49.13,49.13,1,-81727,49273,131000,-32454,0,0,18221,0,0,,18221,18221
1,01-01-17,26,6:15,6:30,250,,0,250,250,1,-110674,35841,146515,-74833,0,0,39215,0,0,,39215,39215
1,01-01-17,27,6:30,6:45,44.29,,0,44.29,44.29,1,-97837,47562,145399,-50275,0,0,17676,0,0,,17676,17676
1,01-01-17,28,6:45,7:00,,,0,34.33,34.33,0,-106282,40176,146458,-66106,0,0,42,0,0,,42,42
1,01-01-17,29,7:00,7:15,,35.63,0,35.63,35.63,-1,-96851,95897,192748,-954,0,-3,0,0,0,,3,-3
1,01-01-17,30,7:15,7:30,,,0,34.33,34.33,0,-99039,82791,181830,-16248,0,0,0,0,0,,0,0
1,01-01-17,31,7:30,7:45,49.13,,0,49.13,49.13,1,-112439,77794,190233,-34645,0,0,2720,0,0,,2720,2720
1,01-01-17,32,7:45,8:00,49.13,,0,49.13,49.13,1,-111411,77707,189118,-33704,0,0,17881,0,0,,17881,17881
1,01-01-17,33,8:00,8:15,49.13,36.63,0,36.63,36.63,-1,-101646,88909,190555,-12737,0,-128,1452,0,0,,1580,1324
1,01-01-17,34,8:15,8:30,40.99,36.63,0,40.99,40.99,1,-96136,71116,167252,-25020,0,-97,515,0,0,,612,418
1,01-01-17,35,8:30,8:45,49.13,,0,49.13,49.13,1,-96692,71249,167941,-25443,0,0,12817,0,0,,12817,12817
1,01-01-17,36,8:45,9:00,40.02,,0,40.02,40.02,1,-89793,96298,186091,6505,0,0,5717,0,0,,5717,5717
1,01-01-17,37,9:00,9:15,62.02,,0,62.02,62.02,1,-110195,54754,164949,-55441,0,0,2857,0,0,,2857,2857
1,01-01-17,38,9:15,9:30,250,,0,250,250,1,-96585,46154,142739,-50431,0,0,40289,0,0,,40289,40289
1,01-01-17,39,9:30,9:45,44.02,,0,44.02,44.02,1,-79350,62475,141825,-16875,0,0,15138,0,0,,15138,15138
1,01-01-17,40,9:45,10:00,101.22,,0,101.22,101.22,1,-104081,59246,163327,-44835,0,0,27197,0,0,,27197,27197
1,01-01-17,41,10:00,10:15,250,33.41,0,250,33.41,2,-113827,84731,198558,-29096,0,-6,49920,0,0,,49926,49914
1,01-01-17,42,10:15,10:30,250,18.97,0,250,18.97,2,-77492,62091,139583,-15401,0,-1372,7370,0,0,,8742,5998
1,01-01-17,43,10:30,10:45,250,,0,250,250,1,-103822,48564,152386,-55258,0,0,42657,0,0,,42657,42657
1,01-01-17,44,10:45,11:00,250,,0,250,250,1,-130755,66060,196815,-64695,0,0,43587,0,0,,43587,43587
1,01-01-17,45,11:00,11:15,250,28.18,0,250,28.18,2,-103874,109986,213860,6112,0,-120,40652,0,0,,40772,40532
1,01-01-17,46,11:15,11:30,82.02,11.03,0,82.02,11.03,2,-103977,88981,192958,-14996,0,-2226,3986,0,0,,6212,1760
1,01-01-17,47,11:30,11:45,250,,0,250,250,1,-133701,80799,214500,-52902,0,0,43858,0,0,,43858,43858
1,01-01-17,48,11:45,12:00,49.13,,0,49.13,49.13,1,-120560,94973,215533,-25587,0,0,25058,0,0,,25058,25058
1,01-01-17,49,12:00,12:15,47.69,,0,47.69,47.69,1,-127764,122258,250022,-5506,0,0,16745,0,0,,16745,16745
1,01-01-17,50,12:15,12:30,47.69,,0,47.69,47.69,1,-121057,108776,229833,-12281,0,0,5882,0,0,,5882,5882
1,01-01-17,51,12:30,12:45,250,,0,250,250,1,-130413,88862,219275,-41551,0,0,30551,0,0,,30551,30551
1,01-01-17,52,12:45,13:00,250,,0,250,250,1,-119151,52719,171870,-66432,0,0,59376,0,0,,59376,59376
1,01-01-17,53,13:00,13:15,54.69,,0,54.69,54.69,1,-90330,82586,172916,-7744,0,0,29134,0,0,,29134,29134
1,01-01-17,54,13:15,13:30,46.99,,0,46.99,46.99,1,-104017,82953,186970,-21064,0,0,6388,0,0,,6388,6388
1,01-01-17,55,13:30,13:45,61.19,,0,61.19,61.19,1,-128622,89728,218350,-38894,0,0,20239,0,0,,20239,20239
1,01-01-17,56,13:45,14:00,94.93,,0,94.93,94.93,1,-137603,67673,205276,-69930,0,0,48807,0,0,,48807,48807
1,01-01-17,57,14:00,14:15,43.79,,0,43.79,43.79,1,-126966,99803,226769,-27163,0,0,24322,0,0,,24322,24322
1,01-01-17,58,14:15,14:30,46.79,,0,46.79,46.79,1,-114869,68117,182986,-46752,0,0,9796,0,0,,9796,9796
1,01-01-17,59,14:30,14:45,36.65,,0,36.65,36.65,1,-107470,56316,163786,-51154,0,0,2496,0,0,,2496,2496
1,01-01-17,60,14:45,15:00,,,0,31.6,31.6,0,-113335,65715,179050,-47620,0,0,0,0,0,,0,0
1,01-01-17,61,15:00,15:15,43.79,,0,43.79,43.79,1,-94805,58651,153456,-36154,0,0,955,0,0,,955,955
1,01-01-17,62,15:15,15:30,136.02,,0,136.02,136.02,1,-115092,48201,163293,-66891,0,0,37996,0,0,,37996,37996
1,01-01-17,63,15:30,15:45,136.02,,0,136.02,136.02,1,-105249,48694,153943,-56555,0,0,50852,0,0,,50852,50852
1,01-01-17,64,15:45,16:00,49.13,,0,49.13,49.13,1,-104897,55493,160390,-49404,0,0,21961,0,0,,21961,21961
1,01-01-17,65,16:00,16:15,39.13,33.17,0,33.17,33.17,-1,-100974,99595,200569,-1379,0,-21,12205,0,0,,12226,12184
1,01-01-17,66,16:15,16:30,27.87,33.17,0,31.59,31.59,2,-66868,61178,128046,-5690,0,-1140,369,0,0,,1509,-771
1,01-01-17,67,16:30,16:45,50.12,,0,50.12,50.12,1,-112343,69393,181736,-42950,0,0,5852,0,0,,5852,5852
1,01-01-17,68,16:45,17:00,136.02,,0,136.02,136.02,1,-185485,93510,278995,-91975,0,0,56081,0,0,,56081,56081
1,01-01-17,69,17:00,17:15,67.29,2.03,0,2.03,2.03,-1,-42603,155915,198518,113312,0,-5351,31180,0,0,,36531,25829
1,01-01-17,70,17:15,17:30,,11.1,0,11.1,11.1,-1,-34439,98097,132536,63658,0,-10983,0,0,0,,10983,-10983
1,01-01-17,71,17:30,17:45,36.65,11.1,0,36.65,36.65,1,-59483,57069,116552,-2414,0,-24,294,0,0,,318,270
1,01-01-17,72,17:45,18:00,39.13,,0,39.13,39.13,1,-75735,63832,139567,-11903,0,0,7092,0,0,,7092,7092
1,01-01-17,73,18:00,18:15,54.07,,0,54.07,54.07,1,-107705,61569,169274,-46136,0,0,20477,0,0,,20477,20477
1,01-01-17,74,18:15,18:30,39.13,,0,39.13,39.13,1,-110585,59674,170259,-50911,0,0,10250,0,0,,10250,10250
1,01-01-17,75,18:30,18:45,40.89,,0,40.89,40.89,1,-129705,56139,185844,-73566,0,0,4290,0,0,,4290,4290
1,01-01-17,76,18:45,19:00,41.2,,0,41.2,41.2,1,-127705,61320,189025,-66385,0,0,1806,0,0,,1806,1806
1,01-01-17,77,19:00,19:15,99.73,,0,99.73,99.73,1,-156209,46602,202811,-109607,0,0,17330,0,0,,17330,17330
1,01-01-17,78,19:15,19:30,154.71,,0,154.71,154.71,1,-130377,44264,174641,-86113,0,0,61221,0,0,,61221,61221
1,01-01-17,79,19:30,19:45,61,,0,61,61,1,-103564,61117,164681,-42447,0,0,42421,0,0,,42421,42421
1,01-01-17,80,19:45,20:00,36.74,,0,36.74,36.74,1,-105520,64112,169632,-41408,0,0,8277,0,0,,8277,8277
1,01-01-17,81,20:00,20:15,58,,0,58,58,1,-105239,82494,187733,-22745,0,0,13409,0,0,,13409,13409
1,01-01-17,82,20:15,20:30,39.13,,0,39.13,39.13,1,-101746,81057,182803,-20689,0,0,12121,0,0,,12121,12121
1,01-01-17,83,20:30,20:45,39.13,,0,39.13,39.13,1,-93411,73928,167339,-19483,0,0,16944,0,0,,16944,16944
1,01-01-17,84,20:45,21:00,36.71,,0,36.71,36.71,1,-84709,87403,172112,2694,0,0,6482,0,0,,6482,6482
1,01-01-17,85,21:00,21:15,147.84,,0,147.84,147.84,1,-133643,60628,194271,-73015,0,0,29172,0,0,,29172,29172
1,01-01-17,86,21:15,21:30,60.54,,0,60.54,60.54,1,-110106,61696,171802,-48410,0,0,39828,0,0,,39828,39828
1,01-01-17,87,21:30,21:45,60.54,34.09,0,34.09,34.09,-1,-81446,62445,143891,-19001,0,-78,3130,0,0,,3208,3052
1,01-01-17,88,21:45,22:00,,,0,32,32,0,-91751,64596,156347,-27155,0,0,0,0,0,,0,0
1,01-01-17,89,22:00,22:15,,,0,31.89,31.89,0,-125684,40292,165976,-85392,0,0,0,0,0,,0,0
1,01-01-17,90,22:15,22:30,41.36,,0,41.36,41.36,1,-120188,41642,161830,-78546,0,0,4160,0,0,,4160,4160
1,01-01-17,91,22:30,22:45,58.44,,0,58.44,58.44,1,-85763,48112,133875,-37651,0,0,5785,0,0,,5785,5785
1,01-01-17,92,22:45,23:00,102.02,,0,102.02,102.02,1,-88845,53517,142362,-35328,0,0,41041,0,0,,41041,41041
1,01-01-17,93,23:00,23:15,46.19,,0,46.19,46.19,1,-161400,47278,208678,-114122,0,0,13370,0,0,,13370,13370
1,01-01-17,94,23:15,23:30,39.13,,0,39.13,39.13,1,-112980,51741,164721,-61239,0,0,7323,0,0,,7323,7323
1,01-01-17,95,23:30,23:45,40.6,,0,40.6,40.6,1,-96323,45748,142071,-50575,0,0,819,0,0,,819,819
1,01-01-17,96,23:45,0:00,40.45,32.17,0,32.17,32.17,-1,-95397,46981,142378,-48416,0,-216,992,0,0,,1208,776
1,01-02-17,1,0:00,0:15,43.09,-200,0,43.09,-200,2,-70961,109263,180224,38302,0,-20118,16,0,0,,20134,-20102
1,01-02-17,2,0:15,0:30,90.47,-200,0,90.47,90.47,1,-109040,29272,138312,-79768,0,-297,7336,0,0,,7633,7039
1,01-02-17,3,0:30,0:45,90.47,28.17,0,28.17,28.17,-1,-46702,45188,91890,-1514,0,-491,106,0,0,,597,-385
1,01-02-17,4,0:45,1:00,,11.74,0,11.74,11.74,-1,-91263,88025,179288,-3238,0,-21833,0,0,0,,21833,-21833
1,01-02-17,5,1:00,1:15,74.43,11.74,0,74.43,74.43,1,-77308,34794,112102,-42514,0,-3234,4277,0,0,,7511,1043
1,01-02-17,6,1:15,1:30,250,,0,250,250,1,-85205,52010,137215,-33195,0,0,29664,0,0,,29664,29664
1,01-02-17,7,1:30,1:45,250,-3.78,0,-3.78,-3.78,-1,-53256,89403,142659,36147,0,-10729,1444,0,0,,12173,-9285
1,01-02-17,8,1:45,2:00,,29.99,0,29.99,29.99,-1,-48709,70846,119555,22137,0,-10031,0,0,0,,10031,-10031
1,01-02-17,9,2:00,2:15,71.12,28.78,0,71.12,71.12,1,-79275,65673,144948,-13602,0,-7424,1185,0,0,,8609,-6239
1,01-02-17,10,2:15,2:30,250,28.78,0,250,250,1,-78385,50817,129202,-27568,0,-28,23489,0,0,,23517,23461
1,01-02-17,11,2:30,2:45,250,28.17,0,28.17,28.17,-1,-44293,70384,114677,26091,0,-2789,872,0,0,,3661,-1917
1,01-02-17,12,2:45,3:00,,23.17,0,23.17,23.17,-1,-40278,79698,119976,39420,0,-26943,0,0,0,,26943,-26943
1,01-02-17,13,3:00,3:15,55.55,19.78,0,55.55,19.78,2,-64472,53353,117825,-11119,0,-27956,269,0,0,,28225,-27687
1,01-02-17,14,3:15,3:30,109.99,19.78,0,109.99,109.99,1,-63191,43107,106298,-20084,0,-1657,10663,0,0,,12320,9006
1,01-02-17,15,3:30,3:45,109.99,33.17,0,33.17,33.17,-1,-49095,60415,109510,11320,0,-775,172,0,0,,947,-603
1,01-02-17,16,3:45,4:00,,28.17,0,28.17,28.17,-1,-47045,67266,114311,20221,0,-4758,0,0,0,,4758,-4758
1,01-02-17,17,4:00,4:15,,28.17,0,28.17,28.17,-1,-74488,60735,135223,-13753,0,-7772,0,0,0,,7772,-7772
1,01-02-17,18,4:15,4:30,,,0,32.95,32.95,0,-70416,49959,120375,-20457,0,-45,0,0,0,,45,-45
1,01-02-17,19,4:30,4:45,,,0,32.95,32.95,0,-60161,45775,105936,-14386,0,0,0,0,0,,0,0
1,01-02-17,20,4:45,5:00,32.12,,0,32.12,32.12,1,-71238,31651,102889,-39587,0,0,62,0,0,,62,62
1,01-02-17,21,5:00,5:15,32.12,,0,32.12,32.12,1,-74730,56768,131498,-17962,0,0,61,0,0,,61,61
1,01-02-17,22,5:15,5:30,45.17,,0,45.17,45.17,1,-63964,42749,106713,-21215,0,0,1101,0,0,,1101,1101
1,01-02-17,23,5:30,5:45,45.17,,0,45.17,45.17,1,-61444,44511,105955,-16933,0,0,3108,0,0,,3108,3108
1,01-02-17,24,5:45,6:00,45.17,,0,45.17,45.17,1,-71570,91032,162602,19462,0,0,6276,0,0,,6276,6276
1,01-02-17,25,6:00,6:15,45.17,32.17,0,32.17,32.17,-1,-105288,60030,165318,-45258,0,-541,65,0,0,,606,-476
1,01-02-17,26,6:15,6:30,,30.69,0,30.69,30.69,-1,-86266,64458,150724,-21808,0,-1450,0,0,0,,1450,-1450
1,01-02-17,27,6:30,6:45,,33.17,0,33.17,33.17,-1,-102655,74717,177372,-27938,0,-696,0,0,0,,696,-696
1,01-02-17,28,6:45,7:00,,32.17,0,32.17,32.17,-1,-117238,74002,191240,-43236,0,-33,0,0,0,,33,-33
1,01-02-17,29,7:00,7:15,,-200,0,-200,-200,-1,-84257,143698,227955,59441,0,-30801,0,0,0,,30801,-30801
1,01-02-17,30,7:15,7:30,,25.13,0,25.13,25.13,-1,-88831,115892,204723,27061,0,-31019,0,0,0,,31019,-31019
1,01-02-17,31,7:30,7:45,,-200,0,-200,-200,-1,-89076,100646,189722,11570,0,-37819,0,0,0,,37819,-37819
1,01-02-17,32,7:45,8:00,50.12,28.17,0,50.12,28.17,2,-91937,94342,186279,2405,0,-7122,1591,0,0,,8713,-5531
1,01-02-17,33,8:00,8:15,,-200,0,-200,-200,-1,-43871,126310,170181,82439,0,-44325,0,0,0,,44325,-44325
1,01-02-17,34,8:15,8:30,,-200,0,-200,-200,-1,-45835,99721,145556,53886,0,-22642,0,0,0,,22642,-22642
1,01-02-17,35,8:30,8:45,45.19,-200,0,45.19,45.19,1,-107997,79782,187779,-28215,0,-23860,33,0,0,,23893,-23827
1,01-02-17,36,8:45,9:00,45.19,-200,0,45.19,45.19,1,-89274,90573,179847,1299,0,-923,477,0,0,,1400,-446
1,01-02-17,37,9:00,9:15,,-200,0,-200,-200,-1,-63985,95858,159843,31873,0,-13033,0,0,0,,13033,-13033
1,01-02-17,38,9:15,9:30,,29.78,0,29.78,29.78,-1,-82903,75559,158462,-7344,0,-11226,0,0,0,,11226,-11226
1,01-02-17,39,9:30,9:45,54.84,33.17,0,54.84,33.17,2,-95936,68500,164436,-27436,0,-2962,507,0,0,,3469,-2455
1,01-02-17,40,9:45,10:00,250,33.17,0,250,250,1,-121202,70935,192137,-50267,0,-17,15799,0,0,,15816,15782
1,01-02-17,41,10:00,10:15,250,0.78,0,0.78,0.78,-1,-76214,99185,175399,22971,0,-12417,1096,0,0,,13513,-11321
1,01-02-17,42,10:15,10:30,48.32,0.78,0,48.32,48.32,1,-111992,79414,191406,-32578,0,-2478,574,0,0,,3052,-1904
1,01-02-17,43,10:30,10:45,,,0,36.3,36.3,0,-112045,74106,186151,-37939,0,0,0,0,0,,0,0
1,01-02-17,44,10:45,11:00,36.01,,0,36.01,36.01,1,-125524,67391,192915,-58133,0,0,46,0,0,,46,46
1,01-02-17,45,11:00,11:15,61.5,,0,61.5,61.5,1,-114779,99736,214515,-15043,0,0,13377,0,0,,13377,13377
1,01-02-17,46,11:15,11:30,35.97,33.6,0,33.6,33.6,-1,-92565,118876,211441,26311,0,-2244,1883,0,0,,4127,-361
1,01-02-17,47,11:30,11:45,,28.17,0,28.17,28.17,-1,-62739,115070,177809,52331,0,-14300,0,0,0,,14300,-14300
1,01-02-17,48,11:45,12:00,,0.78,0,0.78,0.78,-1,-48771,121714,170485,72943,0,-57888,0,0,0,,57888,-57888
1,01-02-17,49,12:00,12:15,,28.17,0,28.17,28.17,-1,-68320,116467,184787,48147,0,-32918,0,0,0,,32918,-32918
1,01-02-17,50,12:15,12:30,,16.01,0,16.01,16.01,-1,-63363,129993,193356,66630,0,-65415,0,0,0,,65415,-65415
1,01-02-17,51,12:30,12:45,,27.99,0,27.99,27.99,-1,-77716,121010,198726,43294,0,-62464,0,0,0,,62464,-62464
1,01-02-17,52,12:45,13:00,,30.19,0,30.19,30.19,-1,-75158,118849,194007,43691,0,-40789,0,0,0,,40789,-40789
1,01-02-17,53,13:00,13:15,,30.19,0,30.19,30.19,-1,-54296,109438,163734,55142,0,-44086,0,0,0,,44086,-44086
1,01-02-17,54,13:15,13:30,,26.94,0,26.94,26.94,-1,-72654,110182,182836,37528,0,-49510,0,0,0,,49510,-49510
1,01-02-17,55,13:30,13:45,,33.49,0,33.49,33.49,-1,-72355,98457,170812,26102,0,-23139,0,0,0,,23139,-23139
1,01-02-17,56,13:45,14:00,,28.17,0,28.17,28.17,-1,-42451,79752,122203,37301,0,-19702,0,0,0,,19702,-19702
1,01-02-17,57,14:00,14:15,,26.94,0,26.94,26.94,-1,-50498,81582,132080,31084,0,-37515,0,0,0,,37515,-37515
1,01-02-17,58,14:15,14:30,,32.17,0,32.17,32.17,-1,-54788,87564,142352,32776,0,-31357,0,0,0,,31357,-31357
1,01-02-17,59,14:30,14:45,36.49,34.09,0,36.49,36.49,1,-65606,65668,131274,62,0,-15948,236,0,0,,16184,-15712
1,01-02-17,60,14:45,15:00,36.49,34.09,0,36.49,36.49,1,-70032,47929,117961,-22103,0,-149,595,0,0,,744,446
1,01-02-17,61,15:00,15:15,,36.62,0,36.62,36.62,-1,-93232,90532,183764,-2700,0,-384,0,0,0,,384,-384
1,01-02-17,62,15:15,15:30,,36.59,0,36.59,36.59,-1,-77808,63337,141145,-14471,0,-1702,0,0,0,,1702,-1702
1,01-02-17,63,15:30,15:45,,37.79,0,37.79,37.79,-1,-81360,52693,134053,-28667,0,-551,0,0,0,,551,-551
1,01-02-17,64,15:45,16:00,,,0,37.6,37.6,0,-74376,45491,119867,-28885,0,0,0,0,0,,0,0
1,01-02-17,65,16:00,16:15,,28.17,0,28.17,28.17,-1,-50937,86554,137491,35617,0,-17136,0,0,0,,17136,-17136
1,01-02-17,66,16:15,16:30,,32.59,0,32.59,32.59,-1,-46494,69944,116438,23450,0,-12608,0,0,0,,12608,-12608
1,01-02-17,67,16:30,16:45,,32.17,0,32.17,32.17,-1,-70800,84560,155360,13760,0,-21314,0,0,0,,21314,-21314
1,01-02-17,68,16:45,17:00,120.19,32.17,0,120.19,120.19,1,-131468,91981,223449,-39487,0,-3774,16093,0,0,,19867,12319
1,01-02-17,69,17:00,17:15,46.89,28.12,0,46.89,28.12,2,-32742,91439,124181,58697,0,-9631,11168,0,0,,20799,1537
1,01-02-17,70,17:15,17:30,,35.16,0,35.16,35.16,-1,-51046,69086,120132,18040,0,-5824,0,0,0,,5824,-5824
1,01-02-17,71,17:30,17:45,,54.1,0,54.1,54.1,-1,-71537,79391,150928,7854,0,-1804,0,0,0,,1804,-1804
1,01-02-17,72,17:45,18:00,,54.1,0,54.1,54.1,-1,-78203,89000,167203,10797,0,-1537,0,0,0,,1537,-1537
1,01-02-17,73,18:00,18:15,,,0,44.89,44.89,0,-96880,38693,135573,-58187,0,-132,0,0,0,,132,-132
1,01-02-17,74,18:15,18:30,,33.7,0,33.7,33.7,-1,-55841,60806,116647,4965,0,-1193,0,0,0,,1193,-1193
1,01-02-17,75,18:30,18:45,,33.17,0,33.17,33.17,-1,-54587,68591,123178,14004,0,-14346,0,0,0,,14346,-14346
1,01-02-17,76,18:45,19:00,,32.17,0,32.17,32.17,-1,-61386,97318,158704,35932,0,-22614,0,0,0,,22614,-22614
1,01-02-17,77,19:00,19:15,,30.78,0,30.78,30.78,-1,-51902,88400,140302,36498,0,-28931,0,0,0,,28931,-28931
1,01-02-17,78,19:15,19:30,,-25.54,0,-25.54,-25.54,-1,-46727,121253,167980,74526,0,-54686,0,0,0,,54686,-54686
1,01-02-17,79,19:30,19:45,,17.88,0,17.88,17.88,-1,-58236,135086,193322,76850,0,-57899,0,0,0,,57899,-57899
1,01-02-17,80,19:45,20:00,,13.47,0,13.47,13.47,-1,-60854,133066,193920,72212,0,-72362,0,0,0,,72362,-72362
1,01-02-17,81,20:00,20:15,36.43,29.72,0,36.43,36.43,1,-71981,76467,148448,4486,0,-38188,231,0,0,,38419,-37957
1,01-02-17,82,20:15,20:30,37.36,33.7,0,45.07,33.7,2,-64700,79098,143798,14398,0,-4314,349,0,0,,4663,-3965
1,01-02-17,83,20:30,20:45,,33.7,0,33.7,33.7,-1,-71115,74459,145574,3344,0,-11805,0,0,0,,11805,-11805
1,01-02-17,84,20:45,21:00,,,0,44.57,44.57,0,-166170,78590,244760,-87580,0,-388,0,0,0,,388,-388
1,01-02-17,85,21:00,21:15,46.09,,0,46.09,46.09,1,-75918,49681,125599,-26237,0,0,5819,0,0,,5819,5819
1,01-02-17,86,21:15,21:30,36.8,33.39,0,33.39,33.39,-1,-67539,48602,116141,-18937,0,-145,4319,0,0,,4464,4174
1,01-02-17,87,21:30,21:45,36.8,27.36,0,27.36,27.36,-1,-42147,89013,131160,46866,0,-28885,74,0,0,,28959,-28811
1,01-02-17,88,21:45,22:00,,28.17,0,28.17,28.17,-1,-41856,103270,145126,61414,0,-57684,0,0,0,,57684,-57684
1,01-02-17,89,22:00,22:15,61.92,32.17,0,61.92,61.92,1,-91200,51618,142818,-39582,0,-28075,3919,0,0,,31994,-24156
1,01-02-17,90,22:15,22:30,36.43,32.17,0,36.43,36.43,1,-85304,65248,150552,-20056,0,-84,3575,0,0,,3659,3491
1,01-02-17,91,22:30,22:45,37.07,,0,37.07,37.07,1,-86407,63772,150179,-22635,0,0,2023,0,0,,2023,2023
1,01-02-17,92,22:45,23:00,36.43,32.03,0,32.03,32.03,-1,-64362,70729,135091,6367,0,-2308,2349,0,0,,4657,41
1,01-02-17,93,23:00,23:15,,32.09,0,32.09,32.09,-1,-102199,59422,161621,-42777,0,-4632,0,0,0,,4632,-4632
1,01-02-17,94,23:15,23:30,,,0,32.22,32.22,0,-100138,47620,147758,-52518,0,-56,0,0,0,,56,-56
1,01-02-17,95,23:30,23:45,,,0,32.22,32.22,0,-79595,47801,127396,-31794,0,0,0,0,0,,0,0
1,01-02-17,96,23:45,0:00,,32.17,0,32.17,32.17,-1,-68162,71402,139564,3240,0,-7016,0,0,0,,7016,-7016
1,01-03-17,1,0:00,0:15,134.02,28.23,0,134.02,28.23,2,-98986,36820,135806,-62166,0,-10244,6727,0,0,,16971,-3517
1,01-03-17,2,0:15,0:30,134.02,28.23,0,134.02,134.02,1,-117704,551,118255,-117153,0,-26,37067,0,0,,37093,37041
1,01-03-17,3,0:30,0:45,,,0,32.43,32.43,0,-93108,37760,130868,-55348,0,0,1682,0,0,,1682,1682
1,01-03-17,4,0:45,1:00,,,0,32.43,32.43,0,-93786,31188,124974,-62598,0,0,0,0,0,,0,0
1,01-03-17,5,1:00,1:15,51.3,,0,51.3,51.3,1,-94051,26205,120256,-67846,0,0,7122,0,0,,7122,7122
1,01-03-17,6,1:15,1:30,36.81,,0,36.81,36.81,1,-53854,19994,73848,-33860,0,0,8738,0,0,,8738,8738
1,01-03-17,7,1:30,1:45,36.81,33.91,0,33.91,33.91,-1,-48530,37160,85690,-11370,0,-1266,254,0,0,,1520,-1012
1,01-03-17,8,1:45,2:00,,33.23,0,33.23,33.23,-1,-57912,48472,106384,-9440,0,-4992,0,0,0,,4992,-4992
1,01-03-17,9,2:00,2:15,37.29,33.23,0,37.29,37.29,1,-80118,24925,105043,-55193,0,-799,1580,0,0,,2379,781
1,01-03-17,10,2:15,2:30,37.08,,0,37.08,37.08,1,-70984,23635,94619,-47349,0,0,1098,0,0,,1098,1098
1,01-03-17,11,2:30,2:45,,,0,32.46,32.46,0,-63799,35026,98825,-28773,0,0,0,0,0,,0,0
1,01-03-17,12,2:45,3:00,,33.23,0,33.23,33.23,-1,-42623,33406,76029,-9217,0,-398,0,0,0,,398,-398
1,01-03-17,13,3:00,3:15,36.28,33.23,0,36.28,32.44,2,-50815,9101,59916,-41714,0,-673,769,0,0,,1442,96
1,01-03-17,14,3:15,3:30,,,0,32.44,32.44,0,-72777,2183,74960,-70594,0,0,46,0,0,,46,46
1,01-03-17,15,3:30,3:45,,,0,32.44,32.44,0,-77142,6506,83648,-70636,0,0,0,0,0,,0,0
1,01-03-17,16,3:45,4:00,,,0,32.44,32.44,0,-51367,6730,58097,-44637,0,0,0,0,0,,0,0
1,01-03-17,17,4:00,4:15,,,0,32.35,32.35,0,-63388,7793,71181,-55595,0,0,0,0,0,,0,0
1,01-03-17,18,4:15,4:30,,,0,32.35,32.35,0,-64431,5361,69792,-59070,0,0,0,0,0,,0,0
1,01-03-17,19,4:30,4:45,,,0,32.35,32.35,0,-71792,1462,73254,-70330,0,0,0,0,0,,0,0
1,01-03-17,20,4:45,5:00,,,0,32.35,32.35,0,-68772,12602,81374,-56170,0,0,0,0,0,,0,0
1,01-03-17,21,5:00,5:15,,,0,32.35,32.35,0,-60546,21933,82479,-38613,0,0,0,0,0,,0,0
1,01-03-17,22,5:15,5:30,27.86,,0,27.86,27.86,1,-58820,10480,69300,-48340,0,0,104,0,0,,104,104
1,01-03-17,23,5:30,5:45,56.41,,0,56.41,56.41,1,-88214,2867,91081,-85347,0,0,12109,0,0,,12109,12109
1,01-03-17,24,5:45,6:00,68.57,,0,68.57,68.57,1,-80204,14164,94368,-66040,0,0,57996,0,0,,57996,57996
1,01-03-17,25,6:00,6:15,37.02,28.27,0,37.02,28.27,2,-77406,63869,141275,-13537,0,-5348,18439,0,0,,23787,13091
1,01-03-17,26,6:15,6:30,,35.74,0,35.74,35.74,-1,-83338,38143,121481,-45195,0,-1459,0,0,0,,1459,-1459
1,01-03-17,27,6:30,6:45,,,0,31.83,31.83,0,-95921,26863,122784,-69058,0,0,0,0,0,,0,0
1,01-03-17,28,6:45,7:00,,,0,31.87,31.87,0,-91381,12425,103806,-78956,0,0,0,0,0,,0,0
1,01-03-17,29,7:00,7:15,,28.56,0,28.56,28.56,-1,-104153,112133,216286,7980,0,-5785,0,0,0,,5785,-5785
1,01-03-17,30,7:15,7:30,,1.65,0,1.65,1.65,-1,-50056,110491,160547,60435,0,-32030,0,0,0,,32030,-32030
1,01-03-17,31,7:30,7:45,36.51,1.65,0,36.51,36.51,1,-63265,56283,119548,-6982,0,-44121,14,0,0,,44135,-44107
1,01-03-17,32,7:45,8:00,62.31,1.65,0,62.31,62.31,1,-90461,42069,132530,-48392,0,-2129,13809,0,0,,15938,11680
1,01-03-17,33,8:00,8:15,41.29,-17.07,0,-17.07,-17.07,-1,-38264,133740,172004,95476,0,-24823,8330,0,0,,33153,-16493
1,01-03-17,34,8:15,8:30,,28.03,0,28.03,28.03,-1,-38584,92636,131220,54052,0,-42409,0,0,0,,42409,-42409
1,01-03-17,35,8:30,8:45,,24.09,0,24.09,24.09,-1,-30722,81753,112475,51031,0,-55269,0,0,0,,55269,-55269
1,01-03-17,36,8:45,9:00,,30.25,0,30.25,30.25,-1,-47734,59106,106840,11372,0,-36461,0,0,0,,36461,-36461
1,01-03-17,37,9:00,9:15,,16.21,0,16.21,16.21,-1,-36959,121062,158021,84103,0,-38333,0,0,0,,38333,-38333
1,01-03-17,38,9:15,9:30,,26.61,0,26.61,26.61,-1,-43005,96301,139306,53296,0,-59483,0,0,0,,59483,-59483
1,01-03-17,39,9:30,9:45,,32.85,0,32.85,32.85,-1,-55451,84175,139626,28724,0,-31488,0,0,0,,31488,-31488
1,01-03-17,40,9:45,10:00,40.21,32.85,0,40.21,40.21,1,-107874,85619,193493,-22255,0,-6276,1464,0,0,,7740,-4812
1,01-03-17,41,10:00,10:15,,32.64,0,32.64,32.64,-1,-89260,113158,202418,23898,0,-2031,0,0,0,,2031,-2031
1,01-03-17,42,10:15,10:30,,32.3,0,32.3,32.3,-1,-93193,120065,213258,26872,0,-11198,0,0,0,,11198,-11198
1,01-03-17,43,10:30,10:45,,32.27,0,32.27,32.27,-1,-96671,135575,232246,38904,0,-16145,0,0,0,,16145,-16145
1,01-03-17,44,10:45,11:00,,32.85,0,32.85,32.85,-1,-113214,133313,246527,20099,0,-13590,0,0,0,,13590,-13590
1,01-03-17,45,11:00,11:15,45.29,32.85,0,45.29,45.29,1,-112738,79208,191946,-33530,0,-9645,1627,0,0,,11272,-8018
1,01-03-17,46,11:15,11:30,45.69,35.8,0,45.69,35.51,2,-77112,87931,165043,10819,0,-34,5436,0,0,,5470,5402
1,01-03-17,47,11:30,11:45,,35.47,0,35.47,35.47,-1,-68375,90209,158584,21834,0,-1380,0,0,0,,1380,-1380
1,01-03-17,48,11:45,12:00,,33.2,0,33.2,33.2,-1,-79336,92906,172242,13570,0,-6165,0,0,0,,6165,-6165
1,01-03-17,49,12:00,12:15,35.22,35.47,0,35.22,35.22,1,-123912,66500,190412,-57412,0,-3536,195,0,0,,3731,-3341
1,01-03-17,50,12:15,12:30,35.22,35.47,0,35.22,35.22,1,-107860,55181,163041,-52679,0,-6,516,0,0,,522,510
1,01-03-17,51,12:30,12:45,,,0,35.54,35.54,0,-85886,70179,156065,-15707,0,0,0,0,0,,0,0
1,01-03-17,52,12:45,13:00,,35.61,0,35.61,35.61,-1,-70354,60462,130816,-9892,0,-42,0,0,0,,42,-42
1,01-03-17,53,13:00,13:15,35.26,32.85,0,35.51,32.85,2,-55772,57557,113329,1785,0,-1708,60,0,0,,1768,-1648
1,01-03-17,54,13:15,13:30,35.22,,0,35.22,35.22,1,-68385,63084,131469,-5301,0,0,1301,0,0,,1301,1301
1,01-03-17,55,13:30,13:45,,35.8,0,35.8,35.8,-1,-65204,64558,129762,-646,0,-170,0,0,0,,170,-170
1,01-03-17,56,13:45,14:00,,35.66,0,35.66,35.66,-1,-71086,65813,136899,-5273,0,-21,0,0,0,,21,-21
1,01-03-17,57,14:00,14:15,,33.27,0,33.27,33.27,-1,-70971,60282,131253,-10689,0,-1030,0,0,0,,1030,-1030
1,01-03-17,58,14:15,14:30,,,0,34.94,34.94,0,-62774,61959,124733,-815,0,0,0,0,0,,0,0
1,01-03-17,59,14:30,14:45,,,0,34.44,34.44,0,-63751,66531,130282,2780,0,0,0,0,0,,0,0
1,01-03-17,60,14:45,15:00,,35.66,0,35.66,35.66,-1,-73077,67724,140801,-5353,0,-19,0,0,0,,19,-19
1,01-03-17,61,15:00,15:15,,33.68,0,33.68,33.68,-1,-65698,66758,132456,1060,0,-204,0,0,0,,204,-204
1,01-03-17,62,15:15,15:30,,33.68,0,33.68,33.68,-1,-60723,74844,135567,14121,0,-2374,0,0,0,,2374,-2374
1,01-03-17,63,15:30,15:45,,32.27,0,32.27,32.27,-1,-60394,78063,138457,17669,0,-4458,0,0,0,,4458,-4458
1,01-03-17,64,15:45,16:00,,31.03,0,31.03,31.03,-1,-48959,83209,132168,34250,0,-23536,0,0,0,,23536,-23536
1,01-03-17,65,16:00,16:15,,33.24,0,33.24,33.24,-1,-46039,147505,193544,101466,0,-15197,0,0,0,,15197,-15197
1,01-03-17,66,16:15,16:30,,33.27,0,33.27,33.27,-1,-36995,129275,166270,92280,0,-3324,0,0,0,,3324,-3324
1,01-03-17,67,16:30,16:45,,16.21,0,16.21,16.21,-1,-39645,133212,172857,93567,0,-29820,0,0,0,,29820,-29820
1,01-03-17,68,16:45,17:00,,32.85,0,32.85,32.85,-1,-60388,115041,175429,54653,0,-8323,0,0,0,,8323,-8323
1,01-03-17,69,17:00,17:15,,16.21,0,16.21,16.21,-1,-55564,109359,164923,53795,0,-32687,0,0,0,,32687,-32687
1,01-03-17,70,17:15,17:30,,35.93,0,35.93,35.93,-1,-42089,83073,125162,40984,0,-6526,0,0,0,,6526,-6526
1,01-03-17,71,17:30,17:45,,,0,35.52,35.52,0,-38823,86435,125258,47612,0,0,0,0,0,,0,0
1,01-03-17,72,17:45,18:00,,32.27,0,32.27,32.27,-1,-39500,110364,149864,70864,0,-662,0,0,0,,662,-662
1,01-03-17,73,18:00,18:15,,16.21,0,16.21,16.21,-1,-42752,128470,171222,85718,0,-9665,0,0,0,,9665,-9665
1,01-03-17,74,18:15,18:30,,16.21,0,16.21,16.21,-1,-40229,136677,176906,96448,0,-20419,0,0,0,,20419,-20419
1,01-03-17,75,18:30,18:45,,15.04,0,15.04,15.04,-1,-38123,120048,158171,81925,0,-72534,0,0,0,,72534,-72534
1,01-03-17,76,18:45,19:00,,23.27,0,23.27,23.27,-1,-57498,126226,183724,68728,0,-56450,0,0,0,,56450,-56450
1,01-03-17,77,19:00,19:15,35.06,28.56,0,35.42,28.56,2,-47065,50313,97378,3248,0,-24614,12,0,0,,24626,-24602
1,01-03-17,78,19:15,19:30,37.01,32.85,0,37.01,32.85,2,-58307,65058,123365,6751,0,-4627,803,0,0,,5430,-3824
1,01-03-17,79,19:30,19:45,,32.18,0,32.18,32.18,-1,-41684,72230,113914,30546,0,-17997,0,0,0,,17997,-17997
1,01-03-17,80,19:45,20:00,,18.49,0,18.49,18.49,-1,-47758,90072,137830,42314,0,-47370,0,0,0,,47370,-47370
1,01-03-17,81,20:00,20:15,,32.27,0,32.27,32.27,-1,-61443,85446,146889,24003,0,-21351,0,0,0,,21351,-21351
1,01-03-17,82,20:15,20:30,,28.27,0,28.27,28.27,-1,-59956,93616,153572,33660,0,-2512,0,0,0,,2512,-2512
1,01-03-17,83,20:30,20:45,,21.19,0,21.19,21.19,-1,-50074,98538,148612,48464,0,-42342,0,0,0,,42342,-42342
1,01-03-17,84,20:45,21:00,,26.61,0,26.61,26.61,-1,-61037,111192,172229,50155,0,-58804,0,0,0,,58804,-58804
1,01-03-17,85,21:00,21:15,41.29,28.27,0,41.29,41.29,1,-41416,47231,88647,5815,0,-29921,1379,0,0,,31300,-28542
1,01-03-17,86,21:15,21:30,40.67,28.27,0,40.67,40.67,1,-49340,55757,105097,6417,0,-60,439,0,0,,499,379
1,01-03-17,87,21:30,21:45,,35.86,0,35.86,35.86,-1,-47769,73238,121007,25469,0,-53,0,0,0,,53,-53
1,01-03-17,88,21:45,22:00,,28.27,0,28.27,28.27,-1,-43660,91065,134725,47405,0,-7036,0,0,0,,7036,-7036
1,01-03-17,89,22:00,22:15,41.54,28.03,0,41.54,41.54,1,-75343,43270,118613,-32073,0,-11450,977,0,0,,12427,-10473
1,01-03-17,90,22:15,22:30,45.54,28.03,0,45.54,45.54,1,-86852,49705,136557,-37147,0,-75,11608,0,0,,11683,11533
1,01-03-17,91,22:30,22:45,45.54,33.27,0,33.27,33.27,-1,-43681,70113,113794,26432,0,-1302,227,0,0,,1529,-1075
1,01-03-17,92,22:45,23:00,,16.21,0,16.21,16.21,-1,-24932,91061,115993,66129,0,-35444,0,0,0,,35444,-35444
1,01-03-17,93,23:00,23:15,36.26,23.91,0,36.26,36.26,1,-68952,55791,124743,-13161,0,-29310,590,0,0,,29900,-28720
1,01-03-17,94,23:15,23:30,,,0,32.86,32.86,0,-60271,49448,109719,-10823,0,-35,180,0,0,,215,145
1,01-03-17,95,23:30,23:45,,28.27,0,28.27,28.27,-1,-40080,77352,117432,37272,0,-5211,0,0,0,,5211,-5211
1,01-03-17,96,23:45,0:00,,20.17,0,20.17,20.17,-1,-33015,115681,148696,82666,0,-60182,0,0,0,,60182,-60182
1,01-04-17,1,0:00,0:15,41.07,21.79,0,41.07,41.07,1,-88441,101117,189558,12676,0,-35552,1893,0,0,,37445,-33659
1,01-04-17,2,0:15,0:30,28.38,,0,28.38,28.38,1,-88541,52240,140781,-36301,0,0,940,0,0,,940,940
1,01-04-17,3,0:30,0:45,,,0,31.84,31.84,0,-45870,60578,106448,14708,0,0,0,0,0,,0,0
1,01-04-17,4,0:45,1:00,,35.39,0,35.39,35.39,-1,-75502,85512,161014,10010,0,-742,0,0,0,,742,-742
1,01-04-17,5,1:00,1:15,51.04,35.39,0,51.04,51.04,1,-58108,40045,98153,-18063,0,-506,9929,0,0,,10435,9423
1,01-04-17,6,1:15,1:30,52.76,,0,52.76,52.76,1,-52886,43125,96011,-9761,0,0,24706,0,0,,24706,24706
1,01-04-17,7,1:30,1:45,52.76,35.39,0,35.39,35.39,-1,-30444,51578,82022,21134,0,-486,4310,0,0,,4796,3824
1,01-04-17,8,1:45,2:00,,32.27,0,32.27,32.27,-1,-28757,70429,99186,41672,0,-4570,0,0,0,,4570,-4570
1,01-04-17,9,2:00,2:15,,35.39,0,35.39,35.39,-1,-51531,68417,119948,16886,0,-1032,0,0,0,,1032,-1032
1,01-04-17,10,2:15,2:30,,,0,31.8,31.8,0,-40676,47668,88344,6992,0,0,0,0,0,,0,0
1,01-04-17,11,2:30,2:45,,,0,31.8,31.8,0,-33205,56647,89852,23442,0,0,0,0,0,,0,0
1,01-04-17,12,2:45,3:00,,24.52,0,24.52,24.52,-1,-32149,58166,90315,26017,0,-1942,0,0,0,,1942,-1942
1,01-04-17,13,3:00,3:15,,19.39,0,19.39,19.39,-1,-33122,72718,105840,39596,0,-12308,0,0,0,,12308,-12308
1,01-04-17,14,3:15,3:30,,,0,31.77,31.77,0,-29874,54421,84295,24547,0,-22,0,0,0,,22,-22
1,01-04-17,15,3:30,3:45,,,0,31.77,31.77,0,-31460,51799,83259,20339,0,0,0,0,0,,0,0
1,01-04-17,16,3:45,4:00,,28.27,0,28.27,28.27,-1,-22401,58813,81214,36412,0,-1012,0,0,0,,1012,-1012
1,01-04-17,17,4:00,4:15,,17.38,0,17.38,17.38,-1,-28565,81261,109826,52696,0,-18685,0,0,0,,18685,-18685
1,01-04-17,18,4:15,4:30,,32.78,0,32.78,32.78,-1,-36140,56532,92672,20392,0,-5538,0,0,0,,5538,-5538
1,01-04-17,19,4:30,4:45,28.35,32.78,0,28.35,28.35,1,-52814,49398,102212,-3416,0,-82,133,0,0,,215,51
1,01-04-17,20,4:45,5:00,29.94,,0,29.94,29.94,1,-57959,41295,99254,-16664,0,0,2107,0,0,,2107,2107
1,01-04-17,21,5:00,5:15,29.94,31.78,0,31.78,31.78,-1,-40950,64753,105703,23803,0,-2508,12,0,0,,2520,-2496
1,01-04-17,22,5:15,5:30,,35.39,0,35.39,35.39,-1,-73168,52815,125983,-20353,0,-1037,0,0,0,,1037,-1037
1,01-04-17,23,5:30,5:45,,,0,31.8,31.8,0,-102269,25194,127463,-77075,0,0,0,0,0,,0,0
1,01-04-17,24,5:45,6:00,51.04,,0,51.04,51.04,1,-110819,13108,123927,-97711,0,0,13539,0,0,,13539,13539
1,01-04-17,25,6:00,6:15,28.2,33.27,0,31.74,31.74,2,-77348,92234,169582,14886,0,-841,1736,0,0,,2577,895
1,01-04-17,26,6:15,6:30,,33.27,0,33.27,33.27,-1,-68096,85362,153458,17266,0,-823,0,0,0,,823,-823
1,01-04-17,27,6:30,6:45,,32.27,0,32.27,32.27,-1,-51869,70024,121893,18155,0,-2318,0,0,0,,2318,-2318
1,01-04-17,28,6:45,7:00,,27.88,0,27.88,27.88,-1,-78135,93792,171927,15657,0,-6553,0,0,0,,6553,-6553
1,01-04-17,29,7:00,7:15,,11.69,0,11.69,11.69,-1,-58541,138494,197035,79953,0,-19375,0,0,0,,19375,-19375
1,01-04-17,30,7:15,7:30,,28.27,0,28.27,28.27,-1,-38326,114639,152965,76313,0,-15791,0,0,0,,15791,-15791
1,01-04-17,31,7:30,7:45,,27.93,0,27.93,27.93,-1,-43683,90448,134131,46765,0,-14722,0,0,0,,14722,-14722
1,01-04-17,32,7:45,8:00,,37.5,0,37.5,37.5,-1,-77398,115528,192926,38130,0,-3130,0,0,0,,3130,-3130
1,01-04-17,33,8:00,8:15,84.55,-150.78,0,84.55,-150.78,2,-108140,64975,173115,-43165,0,-15537,1229,0,0,,16766,-14308
1,01-04-17,34,8:15,8:30,134.12,,0,134.12,134.12,1,-89859,60448,150307,-29411,0,0,31217,0,0,,31217,31217
1,01-04-17,35,8:30,8:45,39.04,,0,39.04,39.04,1,-65770,69199,134969,3429,0,0,14271,0,0,,14271,14271
1,01-04-17,36,8:45,9:00,88.12,,0,88.12,88.12,1,-80541,57347,137888,-23194,0,0,6717,0,0,,6717,6717
1,01-04-17,37,9:00,9:15,138.12,,0,138.12,138.12,1,-109294,63080,172374,-46214,0,0,47791,0,0,,47791,47791
1,01-04-17,38,9:15,9:30,138.12,33.27,0,33.27,33.27,-1,-62855,88665,151520,25810,0,-1088,6593,0,0,,7681,5505
1,01-04-17,39,9:30,9:45,41.04,,0,41.04,41.04,1,-68495,68957,137452,462,0,0,2897,0,0,,2897,2897
1,01-04-17,40,9:45,10:00,43.79,,0,43.79,43.79,1,-66549,63494,130043,-3055,0,0,2423,0,0,,2423,2423
1,01-04-17,41,10:00,10:15,41.95,,0,41.95,41.95,1,-61255,78358,139613,17103,0,0,3604,0,0,,3604,3604
1,01-04-17,42,10:15,10:30,38.21,,0,38.21,38.21,1,-61641,67457,129098,5816,0,0,477,0,0,,477,477
1,01-04-17,43,10:30,10:45,41.04,,0,41.04,41.04,1,-76142,63159,139301,-12983,0,0,13515,0,0,,13515,13515
1,01-04-17,44,10:45,11:00,38.12,,0,38.12,38.12,1,-69090,63592,132682,-5498,0,0,8616,0,0,,8616,8616
1,01-04-17,45,11:00,11:15,34.12,,0,34.12,34.12,1,-54633,54035,108668,-598,0,0,695,0,0,,695,695
1,01-04-17,46,11:15,11:30,41.04,,0,41.04,41.04,1,-55177,49576,104753,-5601,0,0,4719,0,0,,4719,4719
1,01-04-17,47,11:30,11:45,36.75,,0,36.75,36.75,1,-43641,69503,113144,25862,0,0,4519,0,0,,4519,4519
1,01-04-17,48,11:45,12:00,36.75,32.95,0,32.95,32.95,-1,-56062,66997,123059,10935,0,-3077,148,0,0,,3225,-2929
1,01-04-17,49,12:00,12:15,134.12,32.95,0,134.12,134.12,1,-138204,55893,194097,-82311,0,-49,32275,0,0,,32324,32226
1,01-04-17,50,12:15,12:30,52.44,,0,52.44,52.44,1,-110617,73343,183960,-37274,0,0,42208,0,0,,42208,42208
1,01-04-17,51,12:30,12:45,37.08,35.39,0,37.08,33.45,2,-80779,72041,152820,-8738,0,-631,3648,0,0,,4279,3017
1,01-04-17,52,12:45,13:00,37.08,35.36,0,37.08,33.45,2,-69819,80414,150233,10595,0,-1472,803,0,0,,2275,-669
1,01-04-17,53,13:00,13:15,,35.33,0,35.33,35.33,-1,-63823,78833,142656,15010,0,-1447,0,0,0,,1447,-1447
1,01-04-17,54,13:15,13:30,,,0,33.45,33.45,0,-68803,85431,154234,16628,0,-16,0,0,0,,16,-16
1,01-04-17,55,13:30,13:45,,,0,33.45,33.45,0,-72626,95896,168522,23270,0,0,0,0,0,,0,0
1,01-04-17,56,13:45,14:00,,37,0,37,37,-1,-32069,102973,135042,70904,0,-362,0,0,0,,362,-362
1,01-04-17,57,14:00,14:15,,37.5,0,37.5,37.5,-1,-29960,97821,127781,67861,0,-870,0,0,0,,870,-870
1,01-04-17,58,14:15,14:30,,,0,33.48,33.48,0,-48487,86930,135417,38443,0,-2,0,0,0,,2,-2
1,01-04-17,59,14:30,14:45,,37.5,0,37.5,37.5,-1,-63101,87764,150865,24663,0,-66,0,0,0,,66,-66
1,01-04-17,60,14:45,15:00,,32.76,0,32.76,32.76,-1,-64174,79716,143890,15542,0,-4758,0,0,0,,4758,-4758
1,01-04-17,61,15:00,15:15,,31.16,0,31.16,31.16,-1,-49291,86849,136140,37558,0,-8180,0,0,0,,8180,-8180
1,01-04-17,62,15:15,15:30,,28.27,0,28.27,28.27,-1,-51010,74044,125054,23034,0,-35737,0,0,0,,35737,-35737
1,01-04-17,63,15:30,15:45,41.04,28.27,0,41.04,41.04,1,-69067,62150,131217,-6917,0,-6225,1806,0,0,,8031,-4419
1,01-04-17,64,15:45,16:00,41.04,,0,41.04,41.04,1,-76515,57619,134134,-18896,0,0,7920,0,0,,7920,7920
1,01-04-17,65,16:00,16:15,38.21,32.27,0,38.21,32.27,2,-61629,97648,159277,36019,0,-5108,4529,0,0,,9637,-579
1,01-04-17,66,16:15,16:30,38.21,38,0,38,38,-1,-54022,91723,145745,37701,0,-694,6,0,0,,700,-688
1,01-04-17,67,16:30,16:45,,35.39,0,35.39,35.39,-1,-62500,84866,147366,22366,0,-1070,0,0,0,,1070,-1070
1,01-04-17,68,16:45,17:00,68.12,,0,68.12,68.12,1,-110318,64180,174498,-46138,0,0,4268,0,0,,4268,4268
1,01-04-17,69,17:00,17:15,90.89,,0,90.89,90.89,1,-144750,41140,185890,-103610,0,0,6836,0,0,,6836,6836
1,01-04-17,70,17:15,17:30,163.22,,0,163.22,163.22,1,-165508,29253,194761,-136255,0,0,53991,0,0,,53991,53991
1,01-04-17,71,17:30,17:45,163.22,,0,163.22,163.22,1,-139802,34104,173906,-105698,0,0,94584,0,0,,94584,94584
1,01-04-17,72,17:45,18:00,163.22,,0,163.22,163.22,1,-109663,73486,183149,-36177,0,0,81266,0,0,,81266,81266
1,01-04-17,73,18:00,18:15,163.22,-8.78,0,-8.78,-8.78,-1,-58580,97898,156478,39318,0,-20461,10970,0,0,,31431,-9491
1,01-04-17,74,18:15,18:30,,28.27,0,28.27,28.27,-1,-63806,88627,152433,24821,0,-24652,0,0,0,,24652,-24652
1,01-04-17,75,18:30,18:45,,18.52,0,18.52,18.52,-1,-62261,85804,148065,23543,0,-46164,0,0,0,,46164,-46164
1,01-04-17,76,18:45,19:00,41.04,33.27,0,41.04,33.27,2,-58645,85830,144475,27185,0,-9506,1343,0,0,,10849,-8163
1,01-04-17,77,19:00,19:15,36.05,38,0,36.05,33.58,2,-119810,59977,179787,-59833,0,-1030,1024,0,0,,2054,-6
1,01-04-17,78,19:15,19:30,45.04,,0,45.04,45.04,1,-97411,59527,156938,-37884,0,0,6069,0,0,,6069,6069
1,01-04-17,79,19:30,19:45,40.9,,0,40.9,40.9,1,-88110,65730,153840,-22380,0,0,1732,0,0,,1732,1732
1,01-04-17,80,19:45,20:00,,35.06,0,35.06,35.06,-1,-81334,71182,152516,-10152,0,-217,0,0,0,,217,-217
1,01-04-17,81,20:00,20:15,41.04,28.27,0,41.04,28.27,2,-99724,93350,193074,-6374,0,-6020,1279,0,0,,7299,-4741
1,01-04-17,82,20:15,20:30,51.04,,0,51.04,51.04,1,-126459,50418,176877,-76041,0,0,12059,0,0,,12059,12059
1,01-04-17,83,20:30,20:45,38.21,,0,38.21,38.21,1,-127202,48213,175415,-78989,0,0,3560,0,0,,3560,3560
1,01-04-17,84,20:45,21:00,,,0,32.72,32.72,0,-134042,38285,172327,-95757,0,0,63,0,0,,63,63
1,01-04-17,85,21:00,21:15,134.12,,0,134.12,134.12,1,-158393,21990,180383,-136403,0,0,31740,0,0,,31740,31740
1,01-04-17,86,21:15,21:30,132.12,,0,132.12,132.12,1,-145299,15794,161093,-129505,0,0,61260,0,0,,61260,61260
1,01-04-17,87,21:30,21:45,27.19,,0,27.19,27.19,1,-102038,23429,125467,-78609,0,0,13970,0,0,,13970,13970
1,01-04-17,88,21:45,22:00,,,0,32.85,32.85,0,-90691,23313,114004,-67378,0,0,0,0,0,,0,0
1,01-04-17,89,22:00,22:15,51.04,,0,51.04,51.04,1,-152568,27717,180285,-124851,0,0,3749,0,0,,3749,3749
1,01-04-17,90,22:15,22:30,131.12,,0,131.12,131.12,1,-145700,26629,172329,-119071,0,0,47193,0,0,,47193,47193
1,01-04-17,91,22:30,22:45,35.29,,0,35.29,35.29,1,-115457,62613,178070,-52844,0,0,11112,0,0,,11112,11112
1,01-04-17,92,22:45,23:00,,33.45,0,33.45,33.45,-1,-94980,94913,189893,-67,0,-4026,0,0,0,,4026,-4026
1,01-04-17,93,23:00,23:15,36.21,37.5,0,36.21,32.87,2,-108596,65478,174074,-43118,0,-1720,1039,0,0,,2759,-681
1,01-04-17,94,23:15,23:30,34.73,,0,34.73,34.73,1,-88087,66036,154123,-22051,0,0,2031,0,0,,2031,2031
1,01-04-17,95,23:30,23:45,,,0,32.87,32.87,0,-67797,69025,136822,1228,0,0,68,0,0,,68,68
1,01-04-17,96,23:45,0:00,,28.27,0,28.27,28.27,-1,-63689,88794,152483,25105,0,-2503,0,0,0,,2503,-2503
1,01-05-17,1,0:00,0:15,128.02,20.19,0,128.02,128.02,1,-147248,52630,199878,-94618,0,-4300,18247,0,0,,22547,13947
1,01-05-17,2,0:15,0:30,128.02,31.43,0,128.02,31.12,2,-91197,83190,174387,-8007,0,-164,40833,0,0,,40997,40669
1,01-05-17,3,0:30,0:45,128.02,30.64,0,30.64,30.64,-1,-80988,102794,183782,21806,0,-4091,281,0,0,,4372,-3810
1,01-05-17,4,0:45,1:00,,33.13,0,33.13,33.13,-1,-73689,104205,177894,30516,0,-4347,0,0,0,,4347,-4347
1,01-05-17,5,1:00,1:15,27.74,33.13,0,27.74,27.74,1,-91232,95663,186895,4431,0,-1629,82,0,0,,1711,-1547
1,01-05-17,6,1:15,1:30,27.74,,0,27.74,27.74,1,-91857,106970,198827,15113,0,0,127,0,0,,127,127
1,01-05-17,7,1:30,1:45,34.35,,0,34.35,34.35,1,-79364,86590,165954,7226,0,0,796,0,0,,796,796
1,01-05-17,8,1:45,2:00,46.07,,0,46.07,46.07,1,-85080,42186,127266,-42894,0,0,5558,0,0,,5558,5558
1,01-05-17,9,2:00,2:15,36.07,,0,36.07,36.07,1,-69248,39375,108623,-29873,0,0,5461,0,0,,5461,5461
1,01-05-17,10,2:15,2:30,36.07,33.55,0,33.55,33.55,-1,-83222,59154,142376,-24068,0,-301,73,0,0,,374,-228
1,01-05-17,11,2:30,2:45,,31.43,0,31.43,31.43,-1,-71124,74535,145659,3411,0,-7472,0,0,0,,7472,-7472
1,01-05-17,12,2:45,3:00,,34.57,0,34.57,34.57,-1,-80121,56022,136143,-24099,0,-224,0,0,0,,224,-224
1,01-05-17,13,3:00,3:15,,32.12,0,32.12,32.12,-1,-73287,72597,145884,-690,0,-3597,0,0,0,,3597,-3597
1,01-05-17,14,3:15,3:30,,23.69,0,23.69,23.69,-1,-68833,113251,182084,44418,0,-34989,0,0,0,,34989,-34989
1,01-05-17,15,3:30,3:45,,24.37,0,24.37,24.37,-1,-79294,140376,219670,61082,0,-56537,0,0,0,,56537,-56537
1,01-05-17,16,3:45,4:00,,13.32,0,13.32,13.32,-1,-73131,150869,224000,77738,0,-53905,0,0,0,,53905,-53905
1,01-05-17,17,4:00,4:15,,29.57,0,29.57,29.57,-1,-119516,117845,237361,-1671,0,-26860,0,0,0,,26860,-26860
1,01-05-17,18,4:15,4:30,33.45,29.57,0,33.45,33.45,1,-81236,113504,194740,32268,0,-65,48,0,0,,113,-17
1,01-05-17,19,4:30,4:45,33.45,,0,33.45,33.45,1,-85343,97168,182511,11825,0,0,655,0,0,,655,655
1,01-05-17,20,4:45,5:00,36.07,,0,36.07,36.07,1,-101084,81513,182597,-19571,0,0,5496,0,0,,5496,5496
1,01-05-17,21,5:00,5:15,36.07,25.19,0,25.19,25.19,-1,-113122,148854,261976,35732,0,-13667,205,0,0,,13872,-13462
1,01-05-17,22,5:15,5:30,,25.19,0,25.19,25.19,-1,-97205,100304,197509,3099,0,-35137,0,0,0,,35137,-35137
1,01-05-17,23,5:30,5:45,46.07,25.19,0,46.07,46.07,1,-108530,70544,179074,-37986,0,-4687,3297,0,0,,7984,-1390
1,01-05-17,24,5:45,6:00,73.54,,0,73.54,73.54,1,-93958,72904,166862,-21054,0,0,9082,0,0,,9082,9082
1,01-05-17,25,6:00,6:15,73.54,26.56,0,26.56,26.56,-1,-80693,113650,194343,32957,0,-14749,265,0,0,,15014,-14484
1,01-05-17,26,6:15,6:30,,33.57,0,33.57,33.57,-1,-96600,83543,180143,-13057,0,-5136,0,0,0,,5136,-5136
1,01-05-17,27,6:30,6:45,33.45,,0,33.45,33.45,1,-118767,79344,198111,-39423,0,0,11,0,0,,11,11
1,01-05-17,28,6:45,7:00,189.07,,0,189.07,189.07,1,-159009,67253,226262,-91756,0,0,15792,0,0,,15792,15792
1,01-05-17,29,7:00,7:15,47.27,24.61,0,47.27,24.61,2,-55670,94312,149982,38642,0,-7394,11941,0,0,,19335,4547
1,01-05-17,30,7:15,7:30,47.27,33.32,0,33.32,33.32,-1,-70354,73800,144154,3446,0,-5682,2,0,0,,5684,-5680
1,01-05-17,31,7:30,7:45,,,0,33.93,33.93,0,-119594,73502,193096,-46092,0,-1068,0,0,0,,1068,-1068
1,01-05-17,32,7:45,8:00,250,,0,250,250,1,-162304,54201,216505,-108103,0,0,7110,0,0,,7110,7110
1,01-05-17,33,8:00,8:15,161.54,24.61,0,24.61,24.61,-1,-65317,101899,167216,36582,0,-6324,14076,0,0,,20400,7752
1,01-05-17,34,8:15,8:30,,25.03,0,25.03,25.03,-1,-115608,76948,192556,-38660,0,-8118,0,0,0,,8118,-8118
1,01-05-17,35,8:30,8:45,,,0,42.99,42.99,0,-128931,71567,200498,-57364,0,0,0,0,0,,0,0
1,01-05-17,36,8:45,9:00,,,0,42.99,42.99,0,-153493,70138,223631,-83355,0,0,0,0,0,,0,0
1,01-05-17,37,9:00,9:15,,33.39,0,33.39,33.39,-1,-96848,112674,209522,15826,0,-1884,0,0,0,,1884,-1884
1,01-05-17,38,9:15,9:30,,37.23,0,37.23,37.23,-1,-107236,97983,205219,-9253,0,-617,0,0,0,,617,-617
1,01-05-17,39,9:30,9:45,,37.23,0,37.23,37.23,-1,-119627,93611,213238,-26016,0,-607,0,0,0,,607,-607
1,01-05-17,40,9:45,10:00,,33.57,0,33.57,33.57,-1,-113607,112914,226521,-693,0,-3316,0,0,0,,3316,-3316
1,01-05-17,41,10:00,10:15,,33.57,0,33.57,33.57,-1,-99478,125133,224611,25655,0,-3948,0,0,0,,3948,-3948
1,01-05-17,42,10:15,10:30,,33.57,0,33.57,33.57,-1,-110079,115792,225871,5713,0,-2632,0,0,0,,2632,-2632
1,01-05-17,43,10:30,10:45,,29.57,0,29.57,29.57,-1,-102312,125806,228118,23494,0,-8497,0,0,0,,8497,-8497
1,01-05-17,44,10:45,11:00,59.13,29.57,0,59.13,59.13,1,-164831,102148,266979,-62683,0,-15309,1561,0,0,,16870,-13748
1,01-05-17,45,11:00,11:15,56.06,29.57,0,56.06,56.06,1,-180798,69402,250200,-111396,0,-20,8744,0,0,,8764,8724
1,01-05-17,46,11:15,11:30,36.57,,0,36.57,36.57,1,-181250,70914,252164,-110336,0,0,5063,0,0,,5063,5063
1,01-05-17,47,11:30,11:45,39.54,,0,39.54,39.54,1,-186655,100991,287646,-85664,0,0,8601,0,0,,8601,8601
1,01-05-17,48,11:45,12:00,,,0,36.14,36.14,0,-185467,129686,315153,-55781,0,0,644,0,0,,644,644
1,01-05-17,49,12:00,12:15,,33.29,0,33.29,33.29,-1,-157004,156762,313766,-242,0,-1848,0,0,0,,1848,-1848
1,01-05-17,50,12:15,12:30,,33.57,0,33.57,33.57,-1,-150745,159436,310181,8691,0,-4022,0,0,0,,4022,-4022
1,01-05-17,51,12:30,12:45,,33.57,0,33.57,33.57,-1,-148551,162783,311334,14232,0,-2021,0,0,0,,2021,-2021
1,01-05-17,52,12:45,13:00,,32.18,0,32.18,32.18,-1,-149991,166527,316518,16536,0,-11101,0,0,0,,11101,-11101
1,01-05-17,53,13:00,13:15,,31.25,0,31.25,31.25,-1,-57968,156079,214047,98111,0,-21537,0,0,0,,21537,-21537
1,01-05-17,54,13:15,13:30,,30.74,0,30.74,30.74,-1,-62618,142145,204763,79527,0,-29870,0,0,0,,29870,-29870
1,01-05-17,55,13:30,13:45,,30.85,0,30.85,30.85,-1,-62440,137633,200073,75193,0,-29235,0,0,0,,29235,-29235
1,01-05-17,56,13:45,14:00,,29.93,0,29.93,29.93,-1,-70475,131625,202100,61150,0,-24133,0,0,0,,24133,-24133
1,01-05-17,57,14:00,14:15,,29.93,0,29.93,29.93,-1,-74859,126407,201266,51548,0,-29603,0,0,0,,29603,-29603
1,01-05-17,58,14:15,14:30,,29.57,0,29.57,29.57,-1,-76846,132770,209616,55924,0,-25634,0,0,0,,25634,-25634
1,01-05-17,59,14:30,14:45,,29.57,0,29.57,29.57,-1,-82151,113605,195756,31454,0,-35564,0,0,0,,35564,-35564
1,01-05-17,60,14:45,15:00,,24.61,0,24.61,24.61,-1,-98631,99878,198509,1247,0,-22580,0,0,0,,22580,-22580
1,01-05-17,61,15:00,15:15,,14.21,0,14.21,14.21,-1,-54137,118253,172390,64116,0,-44208,0,0,0,,44208,-44208
1,01-05-17,62,15:15,15:30,,31.69,0,31.69,31.69,-1,-46833,116105,162938,69272,0,-26971,0,0,0,,26971,-26971
1,01-05-17,63,15:30,15:45,,32.74,0,32.74,32.74,-1,-54174,107902,162076,53728,0,-24067,0,0,0,,24067,-24067
1,01-05-17,64,15:45,16:00,,33.57,0,33.57,33.57,-1,-53011,105938,158949,52927,0,-13164,0,0,0,,13164,-13164
1,01-05-17,65,16:00,16:15,,26.19,0,26.19,26.19,-1,-53874,88072,141946,34198,0,-22732,0,0,0,,22732,-22732
1,01-05-17,66,16:15,16:30,,32.18,0,32.18,32.18,-1,-39029,85717,124746,46688,0,-6707,0,0,0,,6707,-6707
1,01-05-17,67,16:30,16:45,,29.57,0,29.57,29.57,-1,-29250,93975,123225,64725,0,-17320,0,0,0,,17320,-17320
1,01-05-17,68,16:45,17:00,35.56,29.57,0,35.56,35.56,1,-67684,79902,147586,12218,0,-971,1084,0,0,,2055,113
1,01-05-17,69,17:00,17:15,156.78,,0,156.78,156.78,1,-176782,89515,266297,-87267,0,0,35622,0,0,,35622,35622
1,01-05-17,70,17:15,17:30,54.8,,0,54.8,54.8,1,-119568,82493,202061,-37075,0,0,31745,0,0,,31745,31745
1,01-05-17,71,17:30,17:45,106.11,,0,106.11,106.11,1,-136224,74472,210696,-61752,0,0,34838,0,0,,34838,34838
1,01-05-17,72,17:45,18:00,106.11,,0,106.11,106.11,1,-121537,89721,211258,-31816,0,0,50220,0,0,,50220,50220
1,01-05-17,73,18:00,18:15,37.61,,0,37.61,37.61,1,-103047,50159,153206,-52888,0,0,24718,0,0,,24718,24718
1,01-05-17,74,18:15,18:30,33.06,,0,33.06,33.06,1,-65604,54051,119655,-11553,0,0,4106,0,0,,4106,4106
1,01-05-17,75,18:30,18:45,,28.25,0,28.25,28.25,-1,-43975,66319,110294,22344,0,-16942,0,0,0,,16942,-16942
1,01-05-17,76,18:45,19:00,33.45,32.8,0,43.18,32.8,2,-46326,45794,92120,-532,0,-13015,371,0,0,,13386,-12644
1,01-05-17,77,19:00,19:15,,37.47,0,37.47,37.47,-1,-72956,100424,173380,27468,0,-1378,0,0,0,,1378,-1378
1,01-05-17,78,19:15,19:30,,34.57,0,34.57,34.57,-1,-53369,95874,149243,42505,0,-810,0,0,0,,810,-810
1,01-05-17,79,19:30,19:45,,33.57,0,33.57,33.57,-1,-56969,95699,152668,38730,0,-1192,0,0,0,,1192,-1192
1,01-05-17,80,19:45,20:00,,24.57,0,24.57,24.57,-1,-45292,106560,151852,61268,0,-18550,0,0,0,,18550,-18550
1,01-05-17,81,20:00,20:15,151.94,32.41,0,151.94,151.94,1,-98485,53281,151766,-45204,0,-16164,8372,0,0,,24536,-7792
1,01-05-17,82,20:15,20:30,159.54,32.41,0,159.54,159.54,1,-75847,64065,139912,-11782,0,-23,21230,0,0,,21253,21207
1,01-05-17,83,20:30,20:45,159.54,32.41,0,32.41,32.41,-1,-47168,75090,122258,27922,0,-3429,364,0,0,,3793,-3065
1,01-05-17,84,20:45,21:00,,31.34,0,31.34,31.34,-1,-38182,81824,120006,43642,0,-20962,0,0,0,,20962,-20962
1,01-05-17,85,21:00,21:15,53.57,33.57,0,53.57,33.57,2,-88314,59135,147449,-29179,0,-12647,6806,0,0,,19453,-5841
1,01-05-17,86,21:15,21:30,35.02,33.57,0,35.02,33.57,2,-65273,59288,124561,-5985,0,-82,12378,0,0,,12460,12296
1,01-05-17,87,21:30,21:45,35.02,30.29,0,30.29,30.29,-1,-48462,88531,136993,40069,0,-5413,1651,0,0,,7064,-3762
1,01-05-17,88,21:45,22:00,,27.27,0,27.27,27.27,-1,-36343,97342,133685,60999,0,-33383,0,0,0,,33383,-33383
1,01-05-17,89,22:00,22:15,35.02,31.73,0,35.02,35.02,1,-105855,38423,144278,-67432,0,-21075,1709,0,0,,22784,-19366
1,01-05-17,90,22:15,22:30,,,0,31.39,31.39,0,-82294,39904,122198,-42390,0,-141,541,0,0,,682,400
1,01-05-17,91,22:30,22:45,,30.29,0,30.29,30.29,-1,-48164,59574,107738,11410,0,-5103,0,0,0,,5103,-5103
1,01-05-17,92,22:45,23:00,,29.57,0,29.57,29.57,-1,-40673,67465,108138,26792,0,-24604,0,0,0,,24604,-24604
1,01-05-17,93,23:00,23:15,109.6,29.03,0,109.6,109.6,1,-92502,59496,151998,-33006,0,-17459,5723,0,0,,23182,-11736
1,01-05-17,94,23:15,23:30,94.68,32.74,0,94.68,31.38,2,-70029,54899,124928,-15130,0,-421,12107,0,0,,12528,11686
1,01-05-17,95,23:30,23:45,94.68,32.41,0,32.41,32.41,-1,-44160,64030,108190,19870,0,-776,65,0,0,,841,-711
1,01-05-17,96,23:45,0:00,,24.61,0,24.61,24.61,-1,-40937,103885,144822,62948,0,-5269,0,0,0,,5269,-5269
1,01-06-17,1,0:00,0:15,35.2,19.78,0,35.2,19.78,2,-73772,90840,164612,17068,0,-15193,203,0,0,,15396,-14990
1,01-06-17,2,0:15,0:30,35.2,36.78,0,35.2,34.99,2,-51250,69109,120359,17859,0,-43,115,0,0,,158,72
1,01-06-17,3,0:30,0:45,,32.7,0,32.7,32.7,-1,-45842,64914,110756,19072,0,-9326,0,0,0,,9326,-9326
1,01-06-17,4,0:45,1:00,,32.27,0,32.27,32.27,-1,-40624,70658,111282,30034,0,-8906,0,0,0,,8906,-8906
1,01-06-17,5,1:00,1:15,39.2,30.7,0,39.2,30.7,2,-71211,69081,140292,-2130,0,-12075,1360,0,0,,13435,-10715
1,01-06-17,6,1:15,1:30,39.2,30.7,0,39.2,39.2,1,-71705,56759,128464,-14946,0,-304,4374,0,0,,4678,4070
1,01-06-17,7,1:30,1:45,34.87,35.25,0,34.87,31.74,2,-59908,75844,135752,15936,0,-7,2208,0,0,,2215,2201
1,01-06-17,8,1:45,2:00,34.87,28.7,0,28.7,28.7,-1,-51179,95636,146815,44457,0,-17273,228,0,0,,17501,-17045
1,01-06-17,9,2:00,2:15,,32.27,0,32.27,32.27,-1,-64642,73059,137701,8417,0,-17857,0,0,0,,17857,-17857
1,01-06-17,10,2:15,2:30,,33.7,0,33.7,33.7,-1,-55329,73088,128417,17759,0,-6157,0,0,0,,6157,-6157
1,01-06-17,11,2:30,2:45,,32.27,0,32.27,32.27,-1,-51904,82368,134272,30464,0,-20435,0,0,0,,20435,-20435
1,01-06-17,12,2:45,3:00,,32.16,0,32.16,32.16,-1,-50011,84074,134085,34063,0,-31735,0,0,0,,31735,-31735
1,01-06-17,13,3:00,3:15,,32.16,0,32.16,32.16,-1,-70275,78738,149013,8463,0,-24135,0,0,0,,24135,-24135
1,01-06-17,14,3:15,3:30,,33.7,0,33.7,33.7,-1,-68544,86448,154992,17904,0,-2667,0,0,0,,2667,-2667
1,01-06-17,15,3:30,3:45,,33.7,0,33.7,33.7,-1,-70523,87171,157694,16648,0,-5131,0,0,0,,5131,-5131
1,01-06-17,16,3:45,4:00,,32.7,0,32.7,32.7,-1,-72823,96479,169302,23656,0,-13177,0,0,0,,13177,-13177
1,01-06-17,17,4:00,4:15,,27.06,0,27.06,27.06,-1,-54886,102564,157450,47678,0,-34236,0,0,0,,34236,-34236
1,01-06-17,18,4:15,4:30,,32.27,0,32.27,32.27,-1,-65844,94680,160524,28836,0,-27689,0,0,0,,27689,-27689
1,01-06-17,19,4:30,4:45,,33.7,0,33.7,33.7,-1,-72807,81005,153812,8198,0,-14312,0,0,0,,14312,-14312
1,01-06-17,20,4:45,5:00,,33.7,0,33.7,33.7,-1,-77611,81371,158982,3760,0,-4267,0,0,0,,4267,-4267
1,01-06-17,21,5:00,5:15,,14.78,0,14.78,14.78,-1,-38090,104145,142235,66055,0,-29892,0,0,0,,29892,-29892
1,01-06-17,22,5:15,5:30,,32.7,0,32.7,32.7,-1,-50398,83553,133951,33155,0,-21661,0,0,0,,21661,-21661
1,01-06-17,23,5:30,5:45,36.03,33.99,0,36.03,36.03,1,-77381,78073,155454,692,0,-7920,1817,0,0,,9737,-6103
1,01-06-17,24,5:45,6:00,36.4,33.99,0,36.4,36.4,1,-92789,70341,163130,-22448,0,-5,9895,0,0,,9900,9890
1,01-06-17,25,6:00,6:15,36.4,-40.91,0,-40.91,-40.91,-1,-28897,83233,112130,54336,0,-28976,2636,0,0,,31612,-26340
1,01-06-17,26,6:15,6:30,,33.6,0,33.6,33.6,-1,-60298,65690,125988,5392,0,-8194,0,0,0,,8194,-8194
1,01-06-17,27,6:30,6:45,45.46,33.02,0,45.46,31.36,2,-92194,70430,162624,-21764,0,-3899,2656,0,0,,6555,-1243
1,01-06-17,28,6:45,7:00,60.12,,0,60.12,60.12,1,-109545,86789,196334,-22756,0,0,21419,0,0,,21419,21419
1,01-06-17,29,7:00,7:15,60.12,-33.99,0,-33.99,-33.99,-1,-38714,136324,175038,97610,0,-29962,3557,0,0,,33519,-26405
1,01-06-17,30,7:15,7:30,,32.7,0,32.7,32.7,-1,-46608,73698,120306,27090,0,-16268,0,0,0,,16268,-16268
1,01-06-17,31,7:30,7:45,,34.22,0,34.22,34.22,-1,-81059,74514,155573,-6545,0,-7016,0,0,0,,7016,-7016
1,01-06-17,32,7:45,8:00,55.49,34.22,0,55.49,55.49,1,-126102,84371,210473,-41731,0,-262,5606,0,0,,5868,5344
1,01-06-17,33,8:00,8:15,62.12,,0,62.12,62.12,1,-22876,102207,125083,79331,0,0,8288,0,0,,8288,8288
1,01-06-17,34,8:15,8:30,,,0,43.27,43.27,0,-27905,66332,94237,38427,0,0,0,0,0,,0,0
1,01-06-17,35,8:30,8:45,,,0,43.27,43.27,0,-45318,62931,108249,17613,0,0,0,0,0,,0,0
1,01-06-17,36,8:45,9:00,34.48,,0,34.48,34.48,1,-69643,54353,123996,-15290,0,0,422,0,0,,422,422
1,01-06-17,37,9:00,9:15,72.47,,0,72.47,72.47,1,-63927,44517,108444,-19410,0,0,11192,0,0,,11192,11192
1,01-06-17,38,9:15,9:30,72.47,,0,72.47,72.47,1,-78083,49932,128015,-28151,0,0,24830,0,0,,24830,24830
1,01-06-17,39,9:30,9:45,52.12,,0,52.12,52.12,1,-84568,56697,141265,-27871,0,0,29724,0,0,,29724,29724
1,01-06-17,40,9:45,10:00,46.5,,0,46.5,46.5,1,-95064,60624,155688,-34440,0,0,23989,0,0,,23989,23989
1,01-06-17,41,10:00,10:15,46.5,,0,46.5,46.5,1,-57513,55077,112590,-2436,0,0,17191,0,0,,17191,17191
1,01-06-17,42,10:15,10:30,46.5,33.18,0,33.18,33.18,-1,-50520,64647,115167,14127,0,-6055,542,0,0,,6597,-5513
1,01-06-17,43,10:30,10:45,,28.7,0,28.7,28.7,-1,-44519,75295,119814,30776,0,-5145,0,0,0,,5145,-5145
1,01-06-17,44,10:45,11:00,,27.61,0,27.61,27.61,-1,-44046,77485,121531,33439,0,-33537,0,0,0,,33537,-33537
1,01-06-17,45,11:00,11:15,35.52,33.7,0,35.52,35.52,1,-56754,56625,113379,-129,0,-12762,365,0,0,,13127,-12397
1,01-06-17,46,11:15,11:30,35.52,53.29,0,53.29,53.29,-1,-60483,64684,125167,4201,0,-57,135,0,0,,192,78
1,01-06-17,47,11:30,11:45,,33.6,0,33.6,33.6,-1,-60392,78067,138459,17675,0,-8210,0,0,0,,8210,-8210
1,01-06-17,48,11:45,12:00,,33.7,0,33.7,33.7,-1,-59256,78124,137380,18868,0,-14598,0,0,0,,14598,-14598
1,01-06-17,49,12:00,12:15,34.87,33.7,0,34.87,34.87,1,-77962,52949,130911,-25013,0,-4231,744,0,0,,4975,-3487
1,01-06-17,50,12:15,12:30,34.48,32.7,0,37.23,32.7,2,-50785,65872,116657,15087,0,-2146,512,0,0,,2658,-1634
1,01-06-17,51,12:30,12:45,,31.88,0,31.88,31.88,-1,-48287,75450,123737,27163,0,-23579,0,0,0,,23579,-23579
1,01-06-17,52,12:45,13:00,,28.69,0,28.69,28.69,-1,-40608,82537,123145,41929,0,-25489,0,0,0,,25489,-25489
1,01-06-17,53,13:00,13:15,,21.45,0,21.45,21.45,-1,-30810,102286,133096,71476,0,-63067,0,0,0,,63067,-63067
1,01-06-17,54,13:15,13:30,,30.12,0,30.12,30.12,-1,-34955,83553,118508,48598,0,-49250,0,0,0,,49250,-49250
1,01-06-17,55,13:30,13:45,,28.7,0,28.7,28.7,-1,-31611,92845,124456,61234,0,-46599,0,0,0,,46599,-46599
1,01-06-17,56,13:45,14:00,,27.98,0,27.98,27.98,-1,-30641,90815,121456,60174,0,-56349,0,0,0,,56349,-56349
1,01-06-17,57,14:00,14:15,,28.7,0,28.7,28.7,-1,-34958,96675,131633,61717,0,-50841,0,0,0,,50841,-50841
1,01-06-17,58,14:15,14:30,,28.7,0,28.7,28.7,-1,-31167,93458,124625,62291,0,-52654,0,0,0,,52654,-52654
1,01-06-17,59,14:30,14:45,,28.7,0,28.7,28.7,-1,-30212,88860,119072,58648,0,-58226,0,0,0,,58226,-58226
1,01-06-17,60,14:45,15:00,,30.13,0,30.13,30.13,-1,-29739,77781,107520,48042,0,-50221,0,0,0,,50221,-50221
1,01-06-17,61,15:00,15:15,,32.67,0,32.67,32.67,-1,-42641,63597,106238,20956,0,-29216,0,0,0,,29216,-29216
1,01-06-17,62,15:15,15:30,,53.34,0,53.34,53.34,-1,-34408,61150,95558,26742,0,-652,0,0,0,,652,-652
1,01-06-17,63,15:30,15:45,,33.83,0,33.83,33.83,-1,-39161,78629,117790,39468,0,-960,0,0,0,,960,-960
1,01-06-17,64,15:45,16:00,,33.83,0,33.83,33.83,-1,-53708,89730,143438,36022,0,-1579,0,0,0,,1579,-1579
1,01-06-17,65,16:00,16:15,,-23.53,0,-23.53,-23.53,-1,-65269,110324,175593,45055,0,-26846,0,0,0,,26846,-26846
1,01-06-17,66,16:15,16:30,,,0,43.96,43.96,0,-75031,90826,165857,15795,0,-1422,0,0,0,,1422,-1422
1,01-06-17,67,16:30,16:45,,,0,43.96,43.96,0,-55403,128492,183895,73089,0,0,0,0,0,,0,0
1,01-06-17,68,16:45,17:00,,33.6,0,33.6,33.6,-1,-86052,117855,203907,31803,0,-1084,0,0,0,,1084,-1084
1,01-06-17,69,17:00,17:15,,19.19,0,19.19,19.19,-1,-61755,100386,162141,38631,0,-18364,0,0,0,,18364,-18364
1,01-06-17,70,17:15,17:30,46.5,32.67,0,46.5,32.67,2,-60669,55847,116516,-4822,0,-10872,2707,0,0,,13579,-8165
1,01-06-17,71,17:30,17:45,46.5,27.23,0,27.23,27.23,-1,-57548,92898,150446,35350,0,-21902,22,0,0,,21924,-21880
1,01-06-17,72,17:45,18:00,,28.7,0,28.7,28.7,-1,-52373,121832,174205,69459,0,-50770,0,0,0,,50770,-50770
1,01-06-17,73,18:00,18:15,36.43,32.7,0,36.43,36.43,1,-74581,54284,128865,-20297,0,-24389,1017,0,0,,25406,-23372
1,01-06-17,74,18:15,18:30,36.43,27.23,0,27.23,27.23,-1,-55790,104556,160346,48766,0,-20605,139,0,0,,20744,-20466
1,01-06-17,75,18:30,18:45,,25.47,0,25.47,25.47,-1,-45777,105602,151379,59825,0,-61151,0,0,0,,61151,-61151
1,01-06-17,76,18:45,19:00,,28.7,0,28.7,28.7,-1,-40890,111575,152465,70685,0,-59641,0,0,0,,59641,-59641
1,01-06-17,77,19:00,19:15,,28.7,0,28.7,28.7,-1,-82598,94703,177301,12105,0,-44548,0,0,0,,44548,-44548
1,01-06-17,78,19:15,19:30,,18.33,0,18.33,18.33,-1,-70387,115921,186308,45534,0,-15977,0,0,0,,15977,-15977
1,01-06-17,79,19:30,19:45,,16.36,0,16.36,16.36,-1,-59987,125148,185135,65161,0,-66190,0,0,0,,66190,-66190
1,01-06-17,80,19:45,20:00,,27.23,0,27.23,27.23,-1,-53304,121645,174949,68341,0,-60486,0,0,0,,60486,-60486
1,01-06-17,81,20:00,20:15,121.17,32.67,0,121.17,121.17,1,-100634,60188,160822,-40446,0,-24975,9861,0,0,,34836,-15114
1,01-06-17,82,20:15,20:30,39.7,19.19,0,19.19,19.19,-1,-63085,96671,159756,33586,0,-6714,8680,0,0,,15394,1966
1,01-06-17,83,20:30,20:45,,18.33,0,18.33,18.33,-1,-46042,67614,113656,21572,0,-32984,0,0,0,,32984,-32984
1,01-06-17,84,20:45,21:00,,-10.14,0,-10.14,-10.14,-1,-61410,101903,163313,40493,0,-19598,0,0,0,,19598,-19598
1,01-06-17,85,21:00,21:15,39.03,-40.18,0,39.03,-40.18,2,-72174,86037,158211,13863,0,-44579,112,0,0,,44691,-44467
1,01-06-17,86,21:15,21:30,95.29,32.27,0,95.29,31.72,2,-76954,71489,148443,-5465,0,-2387,11036,0,0,,13423,8649
1,01-06-17,87,21:30,21:45,95.29,18.28,0,18.28,18.28,-1,-42574,93714,136288,51140,0,-43307,12,0,0,,43319,-43295
1,01-06-17,88,21:45,22:00,,4.31,0,4.31,4.31,-1,-54743,134159,188902,79416,0,-60881,0,0,0,,60881,-60881
1,01-06-17,89,22:00,22:15,48,28.7,0,48,48,1,-100951,47847,148798,-53104,0,-32375,2563,0,0,,34938,-29812
1,01-06-17,90,22:15,22:30,48,28.7,0,48,48,1,-113673,73213,186886,-40460,0,-45,5631,0,0,,5676,5586
1,01-06-17,91,22:30,22:45,48,33.7,0,33.7,33.7,-1,-46992,99872,146864,52880,0,-1783,70,0,0,,1853,-1713
1,01-06-17,92,22:45,23:00,,33.7,0,33.7,33.7,-1,-34731,102588,137319,67857,0,-3027,0,0,0,,3027,-3027
1,01-06-17,93,23:00,23:15,37.06,33.7,0,37.06,33.29,2,-88655,55191,143846,-33464,0,-1750,3576,0,0,,5326,1826
1,01-06-17,94,23:15,23:30,27.43,,0,27.43,27.43,1,-98915,41954,140869,-56961,0,0,551,0,0,,551,551
1,01-06-17,95,23:30,23:45,49.44,,0,49.44,49.44,1,-113729,39516,153245,-74213,0,0,11493,0,0,,11493,11493
1,01-06-17,96,23:45,0:00,37.6,,0,37.6,37.6,1,-150984,53988,204972,-96996,0,0,14550,0,0,,14550,14550
2,01-07-17,1,0:00,0:15,52.09,35.51,0,52.09,31.42,2,-92116,104547,196663,12431,0,-199,1293,0,0,,1492,1094
2,01-07-17,2,0:15,0:30,53.91,,0,53.91,53.91,1,-116995,55485,172480,-61510,0,0,9462,0,0,,9462,9462
2,01-07-17,3,0:30,0:45,44.14,,0,44.14,44.14,1,-119898,36684,156582,-83214,0,0,9678,0,0,,9678,9678
2,01-07-17,4,0:45,1:00,37.34,,0,37.34,37.34,1,-124251,58463,182714,-65788,0,0,8535,0,0,,8535,8535
2,01-07-17,5,1:00,1:15,60.02,,0,60.02,60.02,1,-121069,98560,219629,-22509,0,0,7730,0,0,,7730,7730
2,01-07-17,6,1:15,1:30,76.02,,0,76.02,76.02,1,-91746,66517,158263,-25229,0,0,30919,0,0,,30919,30919
2,01-07-17,7,1:30,1:45,41.08,,0,41.08,41.08,1,-71831,55938,127769,-15893,0,0,5997,0,0,,5997,5997
2,01-07-17,8,1:45,2:00,44.14,,0,44.14,44.14,1,-57764,60040,117804,2276,0,0,5163,0,0,,5163,5163
2,01-07-17,9,2:00,2:15,44.14,,0,44.14,44.14,1,-83157,57645,140802,-25512,0,0,4795,0,0,,4795,4795
2,01-07-17,10,2:15,2:30,44.14,,0,44.14,44.14,1,-76551,48021,124572,-28530,0,0,13247,0,0,,13247,13247
2,01-07-17,11,2:30,2:45,37.34,,0,37.34,37.34,1,-53604,62329,115933,8725,0,0,7884,0,0,,7884,7884
2,01-07-17,12,2:45,3:00,37.34,33.53,0,33.53,33.53,-1,-43105,71616,114721,28511,0,-771,57,0,0,,828,-714
2,01-07-17,13,3:00,3:15,,33.09,0,33.09,33.09,-1,-46642,53491,100133,6849,0,-1172,0,0,0,,1172,-1172
2,01-07-17,14,3:15,3:30,,,0,31.34,31.34,0,-71141,53545,124686,-17596,0,0,0,0,0,,0,0
2,01-07-17,15,3:30,3:45,36.02,,0,36.02,36.02,1,-73275,53602,126877,-19673,0,0,1293,0,0,,1293,1293
2,01-07-17,16,3:45,4:00,,,0,31.34,31.34,0,-90665,54131,144796,-36534,0,0,0,0,0,,0,0
2,01-07-17,17,4:00,4:15,44.14,,0,44.14,44.14,1,-104825,41938,146763,-62887,0,0,5016,0,0,,5016,5016
2,01-07-17,18,4:15,4:30,44.14,,0,44.14,44.14,1,-117388,61527,178915,-55861,0,0,22200,0,0,,22200,22200
2,01-07-17,19,4:30,4:45,,,0,31.33,31.33,0,-119236,39831,159067,-79405,0,0,5463,0,0,,5463,5463
2,01-07-17,20,4:45,5:00,39.39,,0,39.39,39.39,1,-125811,29226,155037,-96585,0,0,3040,0,0,,3040,3040
2,01-07-17,21,5:00,5:15,50.14,,0,50.14,50.14,1,-127781,47543,175324,-80238,0,0,26470,0,0,,26470,26470
2,01-07-17,22,5:15,5:30,68.89,,0,68.89,68.89,1,-134480,40488,174968,-93992,0,0,40030,0,0,,40030,40030
2,01-07-17,23,5:30,5:45,123.02,,0,123.02,123.02,1,-149242,41838,191080,-107404,0,0,78197,0,0,,78197,78197
2,01-07-17,24,5:45,6:00,123.02,,0,123.02,123.02,1,-153988,60695,214683,-93293,0,0,85257,0,0,,85257,85257
2,01-07-17,25,6:00,6:15,55.2,32.04,0,32.04,32.04,-1,-100353,98518,198871,-1835,0,-1207,38143,0,0,,39350,36936
2,01-07-17,26,6:15,6:30,52.9,32.04,0,52.9,52.9,1,-121617,84527,206144,-37090,0,-726,7626,0,0,,8352,6900
2,01-07-17,27,6:30,6:45,52.95,,0,52.95,52.95,1,-110919,78987,189906,-31932,0,0,21334,0,0,,21334,21334
2,01-07-17,28,6:45,7:00,62.28,,0,62.28,62.28,1,-121353,75180,196533,-46173,0,0,32552,0,0,,32552,32552
2,01-07-17,29,7:00,7:15,57.99,,0,57.99,57.99,1,-163877,100273,264150,-63604,0,0,33029,0,0,,33029,33029
2,01-07-17,30,7:15,7:30,48.79,,0,48.79,48.79,1,-151240,124382,275622,-26858,0,0,35575,0,0,,35575,35575
2,01-07-17,31,7:30,7:45,44.14,32.59,0,44.14,31.25,2,-150244,131684,281928,-18560,0,-1705,10054,0,0,,11759,8349
2,01-07-17,32,7:45,8:00,122.02,,0,122.02,122.02,1,-198509,141251,339760,-57258,0,0,38209,0,0,,38209,38209
2,01-07-17,33,8:00,8:15,122.02,-9.03,0,-9.03,-9.03,-1,-126741,172666,299407,45925,0,-16019,12504,0,0,,28523,-3515
2,01-07-17,34,8:15,8:30,68.65,27.46,0,68.65,68.65,1,-144066,103625,247691,-40441,0,-16147,6162,0,0,,22309,-9985
2,01-07-17,35,8:30,8:45,72.08,,0,72.08,72.08,1,-180394,144636,325030,-35758,0,0,27111,0,0,,27111,27111
2,01-07-17,36,8:45,9:00,83.44,,0,83.44,83.44,1,-207356,143869,351225,-63487,0,0,32091,0,0,,32091,32091
2,01-07-17,37,9:00,9:15,112.02,33.53,0,112.02,33.53,2,-117250,111117,228367,-6133,0,-46,37314,0,0,,37360,37268
2,01-07-17,38,9:15,9:30,61.02,33.2,0,61.02,33.2,2,-130001,97346,227347,-32655,0,-888,8255,0,0,,9143,7367
2,01-07-17,39,9:30,9:45,124.02,,0,124.02,124.02,1,-174722,76620,251342,-98102,0,0,70329,0,0,,70329,70329
2,01-07-17,40,9:45,10:00,124.02,,0,124.02,124.02,1,-237392,73925,311317,-163467,0,0,94712,0,0,,94712,94712
2,01-07-17,41,10:00,10:15,136.43,,0,136.43,136.43,1,-141759,72261,214020,-69498,0,0,85098,15000,0,,100098,100098
2,01-07-17,42,10:15,10:30,124.02,,0,124.02,124.02,1,-140350,71620,211970,-68730,0,0,32467,0,0,,32467,32467
2,01-07-17,43,10:30,10:45,124.02,,0,124.02,124.02,1,-162324,39323,201647,-123001,0,0,79550,6250,0,,85800,85800
2,01-07-17,44,10:45,11:00,187.22,,0,187.22,187.22,1,-185233,41495,226728,-143738,0,0,94969,16250,0,,111219,111219
2,01-07-17,45,11:00,11:15,193.14,,0,193.14,193.14,1,-154902,42964,197866,-111938,0,0,95664,15000,0,,110664,110664
2,01-07-17,46,11:15,11:30,149.94,,0,149.94,149.94,1,-147157,56666,203823,-90491,0,0,76961,15000,0,,91961,91961
2,01-07-17,47,11:30,11:45,143.11,,0,143.11,143.11,1,-168835,52699,221534,-116136,0,0,81174,13750,0,,94924,94924
2,01-07-17,48,11:45,12:00,149.94,,0,149.94,149.94,1,-167317,57933,225250,-109384,0,0,94925,15000,0,,109925,109925
2,01-07-17,49,12:00,12:15,193.14,,0,193.14,193.14,1,-191292,61586,252878,-129706,0,0,94369,15000,0,,109369,109369
2,01-07-17,50,12:15,12:30,193.14,,0,260.63,260.63,1,-199195,76564,275759,-122631,0,0,96359,15000,0,,111359,111359
2,01-07-17,51,12:30,12:45,160.63,,0,260.63,260.63,1,-187650,114960,302610,-72690,0,0,72423,15000,5833,,93256,93256
2,01-07-17,52,12:45,13:00,160.63,,0,260.63,260.63,1,-184360,101772,286132,-82588,0,0,42896,15000,17499,,75395,75395
2,01-07-17,53,13:00,13:15,357.44,33.2,0,33.2,33.2,-1,-134299,90134,224433,-44165,0,-57,27837,18750,17499,,64143,64029
2,01-07-17,54,13:15,13:30,357.44,32.46,0,393.18,32.46,2,-142008,44788,186796,-97220,0,-871,15546,18750,17499,,52666,50924
2,01-07-17,55,13:30,13:45,357.44,,0,393.18,393.18,1,-133643,30116,163759,-103527,0,0,68517,18750,17499,,104766,104766
2,01-07-17,56,13:45,14:00,357.44,31.46,0,31.46,31.46,-1,-96537,60846,157383,-35691,0,-1045,27836,18750,17499,,65130,63040
2,01-07-17,57,14:00,14:15,252.2,31.46,0,277.42,277.42,1,-104426,30731,135157,-73695,0,-1149,11595,17500,17499,,47743,45445
2,01-07-17,58,14:15,14:30,252.2,,0,277.42,277.42,1,-118198,29706,147904,-88492,0,0,55224,17500,17499,,90223,90223
2,01-07-17,59,14:30,14:45,252.2,,0,277.42,277.42,1,-203719,46328,250047,-157391,0,0,83100,17500,17499,,118099,118099
2,01-07-17,60,14:45,15:00,352.2,,0,387.42,387.42,1,-177662,111172,288834,-66490,0,0,75180,18750,17499,,111429,111429
2,01-07-17,61,15:00,15:15,150.47,30.47,0,250.47,30.47,2,-161851,106459,268310,-55392,0,-1785,7813,15000,17499,,42097,38527
2,01-07-17,62,15:15,15:30,250,,0,275,275,1,-158006,70020,228026,-87986,0,0,43374,15000,17499,,75873,75873
2,01-07-17,63,15:30,15:45,65.59,33.2,0,33.2,33.2,-1,-142208,121625,263833,-20583,0,-320,15172,6250,17499,,39241,38601
2,01-07-17,64,15:45,16:00,35.8,33.09,0,250.47,32,2,-161883,118760,280643,-43123,0,-258,610,0,17499,,18367,17851
2,01-07-17,65,16:00,16:15,,28.72,0,28.72,28.72,-1,-110935,139739,250674,28804,0,-6979,0,0,0,,6979,-6979
2,01-07-17,66,16:15,16:30,65.08,28.72,0,65.08,65.08,1,-119256,83322,202578,-35934,0,-13,10365,0,0,,10378,10352
2,01-07-17,67,16:30,16:45,60.09,,0,60.09,60.09,1,-132524,94794,227318,-37730,0,0,29762,0,0,,29762,29762
2,01-07-17,68,16:45,17:00,48.09,,0,48.09,48.09,1,-161736,109854,271590,-51882,0,0,30802,0,0,,30802,30802
2,01-07-17,69,17:00,17:15,49.76,,0,49.76,49.76,1,-101150,62469,163619,-38681,0,0,21861,0,0,,21861,21861
2,01-07-17,70,17:15,17:30,162.87,,0,162.87,162.87,1,-110188,50190,160378,-59998,0,0,52285,0,0,,52285,52285
2,01-07-17,71,17:30,17:45,95.23,,0,95.23,95.23,1,-120179,58594,178773,-61585,0,0,65657,0,0,,65657,65657
2,01-07-17,72,17:45,18:00,90.69,,0,90.69,90.69,1,-114416,92858,207274,-21558,0,0,52707,0,0,,52707,52707
2,01-07-17,73,18:00,18:15,90.69,31.46,0,31.46,31.46,-1,-87943,85203,173146,-2740,0,-4113,8094,0,0,,12207,3981
2,01-07-17,74,18:15,18:30,40.14,31.46,0,40.14,40.14,1,-66614,59444,126058,-7170,0,-195,9146,0,0,,9341,8951
2,01-07-17,75,18:30,18:45,40.14,31.46,0,31.46,31.46,-1,-52918,73138,126056,20220,0,-7423,1013,0,0,,8436,-6410
2,01-07-17,76,18:45,19:00,,30.47,0,30.47,30.47,-1,-45700,83657,129357,37957,0,-20065,0,0,0,,20065,-20065
2,01-07-17,77,19:00,19:15,98.84,32.46,0,98.84,31.69,2,-80106,38691,118797,-41415,0,-13273,8555,0,0,,21828,-4718
2,01-07-17,78,19:15,19:30,35.02,,0,35.02,35.02,1,-63088,55150,118238,-7938,0,0,5251,0,0,,5251,5251
2,01-07-17,79,19:30,19:45,,30.47,0,30.47,30.47,-1,-54275,77448,131723,23173,0,-5683,0,0,0,,5683,-5683
2,01-07-17,80,19:45,20:00,,27.46,0,27.46,27.46,-1,-50968,85347,136315,34379,0,-37083,0,0,0,,37083,-37083
2,01-07-17,81,20:00,20:15,,31.46,0,31.46,31.46,-1,-81688,115158,196846,33470,0,-24054,0,0,0,,24054,-24054
2,01-07-17,82,20:15,20:30,,24.13,0,24.13,24.13,-1,-66824,106147,172971,39323,0,-27772,0,0,0,,27772,-27772
2,01-07-17,83,20:30,20:45,,32.02,0,32.02,32.02,-1,-65151,90971,156122,25820,0,-26263,0,0,0,,26263,-26263
2,01-07-17,84,20:45,21:00,,-6.58,0,-6.58,-6.58,-1,-55378,124007,179385,68629,0,-47968,0,0,0,,47968,-47968
2,01-07-17,85,21:00,21:15,44.14,-7.52,0,44.14,44.14,1,-99904,63093,162997,-36811,0,-42534,858,0,0,,43392,-41676
2,01-07-17,86,21:15,21:30,44.14,32.46,0,32.46,32.46,-1,-74194,87302,161496,13108,0,-1743,411,0,0,,2154,-1332
2,01-07-17,87,21:30,21:45,,22.75,0,22.75,22.75,-1,-48499,100123,148622,51624,0,-37148,0,0,0,,37148,-37148
2,01-07-17,88,21:45,22:00,,27.46,0,27.46,27.46,-1,-56775,122697,179472,65922,0,-50319,0,0,0,,50319,-50319
2,01-07-17,89,22:00,22:15,36.39,27.46,0,36.39,36.39,1,-63560,58038,121598,-5522,0,-36764,179,0,0,,36943,-36585
2,01-07-17,90,22:15,22:30,37.71,29.64,0,37.71,29.64,2,-47492,67860,115352,20368,0,-5257,617,0,0,,5874,-4640
2,01-07-17,91,22:30,22:45,,24.55,0,24.55,24.55,-1,-37148,83473,120621,46325,0,-37897,0,0,0,,37897,-37897
2,01-07-17,92,22:45,23:00,,31.09,0,31.09,31.09,-1,-63472,86066,149538,22594,0,-36020,0,0,0,,36020,-36020
2,01-07-17,93,23:00,23:15,,32.03,0,32.03,32.03,-1,-83920,110311,194231,26391,0,-17676,0,0,0,,17676,-17676
2,01-07-17,94,23:15,23:30,34.24,34.58,0,34.24,31.65,2,-69024,67294,136318,-1730,0,-1350,63,0,0,,1413,-1287
2,01-07-17,95,23:30,23:45,39.39,,0,39.39,39.39,1,-75285,73483,148768,-1802,0,0,5065,0,0,,5065,5065
2,01-07-17,96,23:45,0:00,39.39,25.81,0,25.81,25.81,-1,-75858,92572,168430,16714,0,-11416,461,0,0,,11877,-10955
2,01-08-17,1,0:00,0:15,41.08,14.41,0,41.08,14.41,2,-67662,94752,162414,27090,0,-31721,330,0,0,,32051,-31391
2,01-08-17,2,0:15,0:30,88.13,32.93,0,88.13,31.67,2,-70938,64940,135878,-5998,0,-1372,14559,0,0,,15931,13187
2,01-08-17,3,0:30,0:45,88.13,29.04,0,29.04,29.04,-1,-44291,52585,96876,8294,0,-10058,629,0,0,,10687,-9429
2,01-08-17,4,0:45,1:00,44.3,29.04,0,44.3,44.3,1,-79238,55119,134357,-24119,0,-150,11098,0,0,,11248,10948
2,01-08-17,5,1:00,1:15,35.46,34.19,0,35.46,31.21,2,-72057,79073,151130,7016,0,-418,6080,0,0,,6498,5662
2,01-08-17,6,1:15,1:30,36.22,33.09,0,36.22,31.3,2,-54382,49510,103892,-4872,0,-844,648,0,0,,1492,-196
2,01-08-17,7,1:30,1:45,36.39,,0,36.39,36.39,1,-58011,56507,114518,-1504,0,0,1026,0,0,,1026,1026
2,01-08-17,8,1:45,2:00,,30.97,0,30.97,30.97,-1,-39034,62626,101660,23592,0,-5737,0,0,0,,5737,-5737
2,01-08-17,9,2:00,2:15,107.29,30.97,0,107.29,107.29,1,-94171,39774,133945,-54397,0,-631,24477,0,0,,25108,23846
2,01-08-17,10,2:15,2:30,44.3,,0,44.3,44.3,1,-79395,39939,119334,-39456,0,0,39556,0,0,,39556,39556
2,01-08-17,11,2:30,2:45,40.3,,0,40.3,40.3,1,-60074,39043,99117,-21031,0,0,29626,0,0,,29626,29626
2,01-08-17,12,2:45,3:00,40.3,29.93,0,29.93,29.93,-1,-37297,51622,88919,14325,0,-6327,8115,0,0,,14442,1788
2,01-08-17,13,3:00,3:15,68.12,29.93,0,68.12,68.12,1,-89665,45848,135513,-43817,0,-571,13311,0,0,,13882,12740
2,01-08-17,14,3:15,3:30,44.3,,0,44.3,44.3,1,-46446,44504,90950,-1942,0,0,14131,0,0,,14131,14131
2,01-08-17,15,3:30,3:45,,,0,31.32,31.32,0,-57721,46510,104231,-11211,0,0,99,0,0,,99,99
2,01-08-17,16,3:45,4:00,,,0,31.32,31.32,0,-47389,49507,96896,2118,0,0,0,0,0,,0,0
2,01-08-17,17,4:00,4:15,81.58,,0,81.58,81.58,1,-91729,44513,136242,-47216,0,0,14815,0,0,,14815,14815
2,01-08-17,18,4:15,4:30,44.3,,0,44.3,44.3,1,-71709,47455,119164,-24254,0,0,15901,0,0,,15901,15901
2,01-08-17,19,4:30,4:45,50.3,,0,50.3,50.3,1,-71758,40218,111976,-31540,0,0,20233,0,0,,20233,20233
2,01-08-17,20,4:45,5:00,37.71,,0,37.71,37.71,1,-80159,30601,110760,-49558,0,0,14651,0,0,,14651,14651
2,01-08-17,21,5:00,5:15,37.71,32.78,0,32.78,32.78,-1,-47486,51428,98914,3942,0,-568,2971,0,0,,3539,2403
2,01-08-17,22,5:15,5:30,44.3,32.78,0,44.3,44.3,1,-51585,38767,90352,-12818,0,-6,1692,0,0,,1698,1686
2,01-08-17,23,5:30,5:45,50.3,,0,50.3,50.3,1,-54779,34303,89082,-20476,0,0,21222,0,0,,21222,21222
2,01-08-17,24,5:45,6:00,40.3,,0,40.3,40.3,1,-55406,31582,86988,-23824,0,0,15220,0,0,,15220,15220
2,01-08-17,25,6:00,6:15,44.3,29.89,0,44.3,29.89,2,-68310,80535,148845,12225,0,-1108,14396,0,0,,15504,13288
2,01-08-17,26,6:15,6:30,44.3,29,0,44.3,29,2,-67259,55718,122977,-11541,0,-5560,2338,0,0,,7898,-3222
2,01-08-17,27,6:30,6:45,50.3,,0,50.3,50.3,1,-66336,49420,115756,-16916,0,0,17719,0,0,,17719,17719
2,01-08-17,28,6:45,7:00,40.3,,0,40.3,40.3,1,-70319,59745,130064,-10574,0,0,17096,0,0,,17096,17096
2,01-08-17,29,7:00,7:15,40.3,30.43,0,30.43,30.43,-1,-34899,63744,98643,28845,0,-5083,5541,0,0,,10624,458
2,01-08-17,30,7:15,7:30,,32.51,0,32.51,32.51,-1,-45555,59298,104853,13743,0,-2651,0,0,0,,2651,-2651
2,01-08-17,31,7:30,7:45,,34.55,0,34.55,34.55,-1,-61566,54702,116268,-6864,0,-972,0,0,0,,972,-972
2,01-08-17,32,7:45,8:00,44.3,,0,44.3,44.3,1,-85501,51590,137091,-33911,0,0,313,0,0,,313,313
2,01-08-17,33,8:00,8:15,50.3,30.68,0,50.3,30.68,2,-75917,64228,140145,-11689,0,-1390,2127,0,0,,3517,737
2,01-08-17,34,8:15,8:30,,30.43,0,30.43,30.43,-1,-51546,50423,101969,-1123,0,-7597,0,0,0,,7597,-7597
2,01-08-17,35,8:30,8:45,,33.16,0,33.16,33.16,-1,-61396,59730,121126,-1666,0,-1850,0,0,0,,1850,-1850
2,01-08-17,36,8:45,9:00,,,0,31.38,31.38,0,-84031,70898,154929,-13133,0,-46,0,0,0,,46,-46
2,01-08-17,37,9:00,9:15,,27.31,0,27.31,27.31,-1,-49758,86087,135845,36329,0,-11760,0,0,0,,11760,-11760
2,01-08-17,38,9:15,9:30,,33.3,0,33.3,33.3,-1,-49420,67476,116896,18056,0,-11926,0,0,0,,11926,-11926
2,01-08-17,39,9:30,9:45,,33.3,0,33.3,33.3,-1,-60549,63727,124276,3178,0,-14040,0,0,0,,14040,-14040
2,01-08-17,40,9:45,10:00,52.89,33.3,0,52.89,52.89,1,-82229,61860,144089,-20369,0,-1522,6157,0,0,,7679,4635
2,01-08-17,41,10:00,10:15,193.55,32.51,0,193.55,32.51,2,-75886,74751,150637,-1135,0,-127,26431,0,0,,26558,26304
2,01-08-17,42,10:15,10:30,193.55,8.09,0,8.09,8.09,-1,-33775,61737,95512,27962,0,-25385,1214,0,0,,26599,-24171
2,01-08-17,43,10:30,10:45,40.55,32.51,0,43.55,32.51,2,-54868,57123,111991,2255,0,-2606,1119,0,0,,3725,-1487
2,01-08-17,44,10:45,11:00,,32.51,0,32.51,32.51,-1,-72927,62071,134998,-10856,0,-2890,0,0,0,,2890,-2890
2,01-08-17,45,11:00,11:15,,,0,32.23,32.23,0,-49321,75195,124516,25874,0,0,0,0,0,,0,0
2,01-08-17,46,11:15,11:30,,,0,32.24,32.24,0,-64015,69189,133204,5174,0,0,0,0,0,,0,0
2,01-08-17,47,11:30,11:45,34.9,,0,34.9,34.9,1,-72090,60937,133027,-11153,0,0,166,0,0,,166,166
2,01-08-17,48,11:45,12:00,49.89,,0,49.89,49.89,1,-83376,52969,136345,-30407,0,0,13038,0,0,,13038,13038
2,01-08-17,49,12:00,12:15,35.2,33.16,0,33.16,33.16,-1,-48629,75491,124120,26862,0,-183,6150,0,0,,6333,5967
2,01-08-17,50,12:15,12:30,,32.93,0,32.93,32.93,-1,-47966,62997,110963,15031,0,-465,0,0,0,,465,-465
2,01-08-17,51,12:30,12:45,,,0,35.3,35.3,0,-44438,57764,102202,13326,0,0,0,0,0,,0,0
2,01-08-17,52,12:45,13:00,,,0,35.3,35.3,0,-46938,50741,97679,3803,0,0,0,0,0,,0,0
2,01-08-17,53,13:00,13:15,34.9,,0,34.9,34.9,1,-40613,39218,79831,-1395,0,0,154,0,0,,154,154
2,01-08-17,54,13:15,13:30,34.81,,0,34.81,34.81,1,-58658,36026,94684,-22632,0,0,1111,0,0,,1111,1111
2,01-08-17,55,13:30,13:45,49.89,,0,49.89,49.89,1,-69629,34974,104603,-34655,0,0,2906,0,0,,2906,2906
2,01-08-17,56,13:45,14:00,49.89,,0,49.89,49.89,1,-67785,38285,106070,-29500,0,0,4832,0,0,,4832,4832
2,01-08-17,57,14:00,14:15,52.89,,0,52.89,52.89,1,-82924,45212,128136,-37712,0,0,7950,0,0,,7950,7950
2,01-08-17,58,14:15,14:30,49.89,,0,49.89,49.89,1,-71936,38002,109938,-33934,0,0,17274,0,0,,17274,17274
2,01-08-17,59,14:30,14:45,,,0,32.22,32.22,0,-66983,41614,108597,-25369,0,0,1850,0,0,,1850,1850
2,01-08-17,60,14:45,15:00,,,0,32.22,32.22,0,-75841,54220,130061,-21621,0,0,0,0,0,,0,0
2,01-08-17,61,15:00,15:15,44.55,,0,44.55,44.55,1,-64709,43946,108655,-20763,0,0,1513,0,0,,1513,1513
2,01-08-17,62,15:15,15:30,44.55,,0,44.55,44.55,1,-63513,46327,109840,-17186,0,0,12984,0,0,,12984,12984
2,01-08-17,63,15:30,15:45,,,0,32.23,32.23,0,-48529,36397,84926,-12132,0,0,1079,0,0,,1079,1079
2,01-08-17,64,15:45,16:00,50.55,,0,50.55,50.55,1,-67731,42049,109780,-25682,0,0,1457,0,0,,1457,1457
2,01-08-17,65,16:00,16:15,59.7,29.6,0,59.7,29.6,2,-21166,60541,81707,39375,0,-6210,2786,0,0,,8996,-3424
2,01-08-17,66,16:15,16:30,,29.6,0,29.6,29.6,-1,-29973,65004,94977,35031,0,-15599,0,0,0,,15599,-15599
2,01-08-17,67,16:30,16:45,34.84,29.6,0,34.84,34.84,1,-55188,58189,113377,3001,0,-20649,9,0,0,,20658,-20640
2,01-08-17,68,16:45,17:00,35.93,29.6,0,35.93,35.93,1,-87027,60200,147227,-26827,0,-1296,732,0,0,,2028,-564
2,01-08-17,69,17:00,17:15,,32.04,0,32.04,32.04,-1,-19328,85867,105195,66539,0,-1561,0,0,0,,1561,-1561
2,01-08-17,70,17:15,17:30,,34.46,0,34.46,34.46,-1,-28628,53277,81905,24649,0,-939,0,0,0,,939,-939
2,01-08-17,71,17:30,17:45,40.95,34.46,0,40.95,40.95,1,-61837,42389,104226,-19448,0,-60,2056,0,0,,2116,1996
2,01-08-17,72,17:45,18:00,102.12,,0,102.12,102.12,1,-70836,50631,121467,-20205,0,0,9364,0,0,,9364,9364
2,01-08-17,73,18:00,18:15,108.95,,0,108.95,108.95,1,-79849,39104,118953,-40745,0,0,16447,0,0,,16447,16447
2,01-08-17,74,18:15,18:30,,,0,43.98,43.98,0,-49528,42220,91748,-7308,0,0,124,0,0,,124,124
2,01-08-17,75,18:30,18:45,,32.87,0,32.87,32.87,-1,-44929,50618,95547,5689,0,-405,0,0,0,,405,-405
2,01-08-17,76,18:45,19:00,,32.66,0,32.66,32.66,-1,-29385,51072,80457,21687,0,-511,0,0,0,,511,-511
2,01-08-17,77,19:00,19:15,,,0,43.95,43.95,0,-58650,37358,96008,-21292,0,0,0,0,0,,0,0
2,01-08-17,78,19:15,19:30,,36.78,0,36.78,36.78,-1,-46849,40832,87681,-6017,0,-223,0,0,0,,223,-223
2,01-08-17,79,19:30,19:45,,36.78,0,36.78,36.78,-1,-43102,44212,87314,1110,0,-98,0,0,0,,98,-98
2,01-08-17,80,19:45,20:00,,32.8,0,32.8,32.8,-1,-42065,53783,95848,11718,0,-1641,0,0,0,,1641,-1641
2,01-08-17,81,20:00,20:15,36.76,35.78,0,36.76,36.76,1,-51135,50843,101978,-292,0,-1045,599,0,0,,1644,-446
2,01-08-17,82,20:15,20:30,36.76,,0,36.76,36.76,1,-48643,51447,100090,2804,0,0,1647,0,0,,1647,1647
2,01-08-17,83,20:30,20:45,36.76,32.26,0,32.26,32.26,-1,-20064,60278,80342,40214,0,-1994,70,0,0,,2064,-1924
2,01-08-17,84,20:45,21:00,,28.99,0,28.99,28.99,-1,-37208,77297,114505,40089,0,-9971,0,0,0,,9971,-9971
2,01-08-17,85,21:00,21:15,,32.66,0,32.66,32.66,-1,-51302,69449,120751,18147,0,-8736,0,0,0,,8736,-8736
2,01-08-17,86,21:15,21:30,34.81,32.66,0,34.81,34.81,1,-32143,67001,99144,34858,0,-86,110,0,0,,196,24
2,01-08-17,87,21:30,21:45,,32.73,0,32.73,32.73,-1,-34134,70456,104590,36322,0,-1363,0,0,0,,1363,-1363
2,01-08-17,88,21:45,22:00,,18.52,0,18.52,18.52,-1,-26049,105882,131931,79833,0,-24822,0,0,0,,24822,-24822
2,01-08-17,89,22:00,22:15,36.76,18.78,0,36.76,36.76,1,-87304,30562,117866,-56742,0,-27772,335,0,0,,28107,-27437
2,01-08-17,90,22:15,22:30,37.93,32.8,0,37.93,31.39,2,-56205,38207,94412,-17998,0,-606,996,0,0,,1602,390
2,01-08-17,91,22:30,22:45,,32.8,0,32.8,32.8,-1,-27284,39561,66845,12277,0,-1276,0,0,0,,1276,-1276
2,01-08-17,92,22:45,23:00,,32.04,0,32.04,32.04,-1,-24932,65633,90565,40701,0,-3822,0,0,0,,3822,-3822
2,01-08-17,93,23:00,23:15,,31.6,0,31.6,31.6,-1,-83298,43807,127105,-39491,0,-3025,0,0,0,,3025,-3025
2,01-08-17,94,23:15,23:30,,,0,31.37,31.37,0,-61020,35931,96951,-25089,0,0,0,0,0,,0,0
2,01-08-17,95,23:30,23:45,,,0,31.37,31.37,0,-28665,34400,63065,5735,0,0,0,0,0,,0,0
2,01-08-17,96,23:45,0:00,,24.07,0,24.07,24.07,-1,-28340,65006,93346,36666,0,-9881,0,0,0,,9881,-9881
2,01-09-17,1,0:00,0:15,37.31,18.52,0,37.31,18.52,2,-74104,73762,147866,-342,0,-21929,543,0,0,,22472,-21386
2,01-09-17,2,0:15,0:30,38.02,18.52,0,38.02,38.02,1,-77146,57546,134692,-19600,0,-250,1712,0,0,,1962,1462
2,01-09-17,3,0:30,0:45,35.85,,0,35.85,35.85,1,-74276,48481,122757,-25795,0,0,2325,0,0,,2325,2325
2,01-09-17,4,0:45,1:00,34.01,29.89,0,34.01,29.89,2,-51434,63778,115212,12344,0,-1867,1281,0,0,,3148,-586
2,01-09-17,5,1:00,1:15,34.01,28.31,0,28.31,28.31,-1,-63394,67608,131002,4214,0,-4922,9,0,0,,4931,-4913
2,01-09-17,6,1:15,1:30,,35.48,0,35.48,35.48,-1,-59693,67323,127016,7630,0,-1006,0,0,0,,1006,-1006
2,01-09-17,7,1:30,1:45,,32.43,0,32.43,32.43,-1,-54209,62109,116318,7900,0,-3650,0,0,0,,3650,-3650
2,01-09-17,8,1:45,2:00,,32.05,0,32.05,32.05,-1,-38135,63855,101990,25720,0,-6123,0,0,0,,6123,-6123
2,01-09-17,9,2:00,2:15,59.29,32.43,0,59.29,59.29,1,-81350,49886,131236,-31464,0,-6635,5032,0,0,,11667,-1603
2,01-09-17,10,2:15,2:30,39.21,,0,39.21,39.21,1,-63427,46988,110415,-16439,0,0,5554,0,0,,5554,5554
2,01-09-17,11,2:30,2:45,,,0,30.97,30.97,0,-68747,48201,116948,-20546,0,0,0,0,0,,0,0
2,01-09-17,12,2:45,3:00,,32.43,0,32.43,32.43,-1,-54691,53692,108383,-999,0,-1139,0,0,0,,1139,-1139
2,01-09-17,13,3:00,3:15,,32.28,0,32.28,32.28,-1,-60085,54185,114270,-5900,0,-3396,0,0,0,,3396,-3396
2,01-09-17,14,3:15,3:30,,32.43,0,32.43,32.43,-1,-62421,59120,121541,-3301,0,-6311,0,0,0,,6311,-6311
2,01-09-17,15,3:30,3:45,,35.48,0,35.48,35.48,-1,-68081,54533,122614,-13548,0,-2102,0,0,0,,2102,-2102
2,01-09-17,16,3:45,4:00,,35.48,0,35.48,35.48,-1,-67760,61053,128813,-6707,0,-1270,0,0,0,,1270,-1270
2,01-09-17,17,4:00,4:15,,32.43,0,32.43,32.43,-1,-60880,59915,120795,-965,0,-4105,0,0,0,,4105,-4105
2,01-09-17,18,4:15,4:30,,32.03,0,32.03,32.03,-1,-63716,55365,119081,-8351,0,-7938,0,0,0,,7938,-7938
2,01-09-17,19,4:30,4:45,,32.43,0,32.43,32.43,-1,-60923,58389,119312,-2534,0,-3502,0,0,0,,3502,-3502
2,01-09-17,20,4:45,5:00,,29.84,0,29.84,29.84,-1,-60243,84802,145045,24559,0,-18238,0,0,0,,18238,-18238
2,01-09-17,21,5:00,5:15,,31.92,0,31.92,31.92,-1,-52874,61070,113944,8196,0,-10347,0,0,0,,10347,-10347
2,01-09-17,22,5:15,5:30,,29.89,0,29.89,29.89,-1,-46764,59893,106657,13129,0,-16265,0,0,0,,16265,-16265
2,01-09-17,23,5:30,5:45,,32.66,0,32.66,32.66,-1,-62913,70806,133719,7893,0,-7990,0,0,0,,7990,-7990
2,01-09-17,24,5:45,6:00,,31.03,0,31.03,31.03,-1,-72041,91686,163727,19645,0,-8045,0,0,0,,8045,-8045
2,01-09-17,25,6:00,6:15,35.07,33.28,0,35.07,33.22,2,-78286,56430,134716,-21856,0,-1852,838,0,0,,2690,-1014
2,01-09-17,26,6:15,6:30,,29.7,0,29.7,29.7,-1,-50038,66672,116710,16634,0,-11989,0,0,0,,11989,-11989
2,01-09-17,27,6:30,6:45,49.77,33.03,0,49.77,33.03,2,-97544,68175,165719,-29369,0,-7637,525,0,0,,8162,-7112
2,01-09-17,28,6:45,7:00,250,33.03,0,250,250,1,-170438,75131,245569,-95307,0,-58,47650,0,0,,47708,47592
2,01-09-17,29,7:00,7:15,55.29,-150.03,0,-150.03,-150.03,-1,-72965,167406,240371,94441,0,-11574,28981,0,0,,40555,17407
2,01-09-17,30,7:15,7:30,34.95,-8.03,0,34.95,-8.03,2,-72466,75187,147653,2721,0,-31098,73,0,0,,31171,-31025
2,01-09-17,31,7:30,7:45,39.77,-8.03,0,39.77,39.77,1,-101162,95105,196267,-6057,0,-873,2484,0,0,,3357,1611
2,01-09-17,32,7:45,8:00,137.02,,0,137.02,137.02,1,-164805,79233,244038,-85572,0,0,37590,0,0,,37590,37590
2,01-09-17,33,8:00,8:15,147.82,30.78,0,147.82,30.78,2,-32340,93131,125471,60791,0,-467,45884,0,0,,46351,45417
2,01-09-17,34,8:15,8:30,147.82,26.98,0,26.98,26.98,-1,-58294,62556,120850,4262,0,-2878,349,0,0,,3227,-2529
2,01-09-17,35,8:30,8:45,,,0,41.08,41.08,0,-67216,64195,131411,-3021,0,0,0,0,0,,0,0
2,01-09-17,36,8:45,9:00,,,0,41.08,41.08,0,-68343,73685,142028,5342,0,0,0,0,0,,0,0
2,01-09-17,37,9:00,9:15,33.91,,0,33.91,33.91,1,-104264,39959,144223,-64305,0,0,250,0,0,,250,250
2,01-09-17,38,9:15,9:30,34.07,,0,34.07,34.07,1,-109471,26017,135488,-83454,0,0,2145,0,0,,2145,2145
2,01-09-17,39,9:30,9:45,33.91,,0,33.91,33.91,1,-106886,42811,149697,-64075,0,0,2221,0,0,,2221,2221
2,01-09-17,40,9:45,10:00,,,0,41.01,41.01,0,-105524,38549,144073,-66975,0,0,204,0,0,,204,204
2,01-09-17,41,10:00,10:15,148.58,,0,148.58,148.58,1,-119231,36090,155321,-83141,0,0,31796,0,0,,31796,31796
2,01-09-17,42,10:15,10:30,72.58,,0,72.58,72.58,1,-96106,34028,130134,-62078,0,0,57582,0,0,,57582,57582
2,01-09-17,43,10:30,10:45,55.29,,0,55.29,55.29,1,-78679,30648,109327,-48031,0,0,38586,0,0,,38586,38586
2,01-09-17,44,10:45,11:00,61.58,,0,61.58,61.58,1,-83384,32419,115803,-50965,0,0,27022,0,0,,27022,27022
2,01-09-17,45,11:00,11:15,67.98,,0,67.98,67.98,1,-91248,27686,118934,-63562,0,0,45350,0,0,,45350,45350
2,01-09-17,46,11:15,11:30,56.98,,0,56.98,56.98,1,-88086,31597,119683,-56489,0,0,49997,0,0,,49997,49997
2,01-09-17,47,11:30,11:45,55.39,,0,55.39,55.39,1,-74133,42710,116843,-31423,0,0,41316,0,0,,41316,41316
2,01-09-17,48,11:45,12:00,34.95,,0,34.95,34.95,1,-67250,48779,116029,-18471,0,0,8921,0,0,,8921,8921
2,01-09-17,49,12:00,12:15,33.02,,0,33.02,33.02,1,-98462,49419,147881,-49043,0,0,1703,0,0,,1703,1703
2,01-09-17,50,12:15,12:30,,,0,33.73,33.73,0,-101239,31725,132964,-69514,0,0,0,0,0,,0,0
2,01-09-17,51,12:30,12:45,41.02,,0,41.02,41.02,1,-86350,32493,118843,-53857,0,0,3024,0,0,,3024,3024
2,01-09-17,52,12:45,13:00,33.02,,0,33.02,33.02,1,-76331,28760,105091,-47571,0,0,776,0,0,,776,776
2,01-09-17,53,13:00,13:15,115.02,,0,115.02,115.02,1,-88214,26407,114621,-61807,0,0,13903,0,0,,13903,13903
2,01-09-17,54,13:15,13:30,41.02,,0,41.02,41.02,1,-73849,49449,123298,-24400,0,0,11764,0,0,,11764,11764
2,01-09-17,55,13:30,13:45,,,0,33.72,33.72,0,-74691,39265,113956,-35426,0,0,0,0,0,,0,0
2,01-09-17,56,13:45,14:00,,,0,33.72,33.72,0,-82664,42266,124930,-40398,0,0,0,0,0,,0,0
2,01-09-17,57,14:00,14:15,149,,0,149,149,1,-111230,27431,138661,-83799,0,0,31159,0,0,,31159,31159
2,01-09-17,58,14:15,14:30,65.02,,0,65.02,65.02,1,-84828,31116,115944,-53712,0,0,58029,0,0,,58029,58029
2,01-09-17,59,14:30,14:45,50.29,,0,50.29,50.29,1,-75768,31652,107420,-44116,0,0,29195,0,0,,29195,29195
2,01-09-17,60,14:45,15:00,,,0,32.53,32.53,0,-62990,27225,90215,-35765,0,0,312,0,0,,312,312
2,01-09-17,61,15:00,15:15,45,,0,45,45,1,-63802,43006,106808,-20796,0,0,5934,0,0,,5934,5934
2,01-09-17,62,15:15,15:30,38.16,,0,38.16,38.16,1,-58372,49537,107909,-8835,0,0,7578,0,0,,7578,7578
2,01-09-17,63,15:30,15:45,34.95,,0,34.95,34.95,1,-51072,50266,101338,-806,0,0,8378,0,0,,8378,8378
2,01-09-17,64,15:45,16:00,34.95,32,0,32,32,-1,-44118,59300,103418,15182,0,-4447,1541,0,0,,5988,-2906
2,01-09-17,65,16:00,16:15,33.02,32,0,33.02,33.02,1,-62783,49271,112054,-13512,0,-416,24,0,0,,440,-392
2,01-09-17,66,16:15,16:30,36.41,,0,36.41,36.41,1,-53896,54425,108321,529,0,0,2008,0,0,,2008,2008
2,01-09-17,67,16:30,16:45,36.41,,0,36.41,36.41,1,-69046,53121,122167,-15925,0,0,2313,0,0,,2313,2313
2,01-09-17,68,16:45,17:00,58.5,,0,58.5,58.5,1,-114332,64432,178764,-49900,0,0,9572,0,0,,9572,9572
2,01-09-17,69,17:00,17:15,36.41,29.41,0,40.66,29.41,2,-89585,25750,115335,-63835,0,-3387,3460,0,0,,6847,73
2,01-09-17,70,17:15,17:30,109.7,,0,109.7,109.7,1,-90673,35440,126113,-55233,0,0,25386,0,0,,25386,25386
2,01-09-17,71,17:30,17:45,52.02,33.03,0,33.03,33.03,-1,-65570,73398,138968,7828,0,-241,18227,0,0,,18468,17986
2,01-09-17,72,17:45,18:00,52.02,32.83,0,32.83,32.83,-1,-60369,100062,160431,39693,0,-4359,146,0,0,,4505,-4213
2,01-09-17,73,18:00,18:15,,31.8,0,31.8,31.8,-1,-72379,83239,155618,10860,0,-10172,0,0,0,,10172,-10172
2,01-09-17,74,18:15,18:30,,19.03,0,19.03,19.03,-1,-43414,102233,145647,58819,0,-43632,0,0,0,,43632,-43632
2,01-09-17,75,18:30,18:45,,26.8,0,26.8,26.8,-1,-31715,90194,121909,58479,0,-64814,0,0,0,,64814,-64814
2,01-09-17,76,18:45,19:00,,29.09,0,29.09,29.09,-1,-37691,84386,122077,46695,0,-47439,0,0,0,,47439,-47439
2,01-09-17,77,19:00,19:15,49.52,25.09,0,49.52,25.09,2,-69648,51096,120744,-18552,0,-34672,976,0,0,,35648,-33696
2,01-09-17,78,19:15,19:30,53.02,28.12,0,53.02,28.12,2,-55505,66873,122378,11368,0,-4462,2661,0,0,,7123,-1801
2,01-09-17,79,19:30,19:45,,19.25,0,19.25,19.25,-1,-40071,79251,119322,39180,0,-39282,0,0,0,,39282,-39282
2,01-09-17,80,19:45,20:00,,31.8,0,31.8,31.8,-1,-77819,90577,168396,12758,0,-18846,0,0,0,,18846,-18846
2,01-09-17,81,20:00,20:15,34.95,28.12,0,34.95,28.12,2,-104928,90519,195447,-14409,0,-11871,958,0,0,,12829,-10913
2,01-09-17,82,20:15,20:30,34.95,31.8,0,31.8,31.8,-1,-84197,76914,161111,-7283,0,-1304,298,0,0,,1602,-1006
2,01-09-17,83,20:30,20:45,,23.01,0,23.01,23.01,-1,-49591,98110,147701,48519,0,-29585,0,0,0,,29585,-29585
2,01-09-17,84,20:45,21:00,,25.09,0,25.09,25.09,-1,-51680,126979,178659,75299,0,-57815,0,0,0,,57815,-57815
2,01-09-17,85,21:00,21:15,112.27,23.03,0,112.27,112.27,1,-98895,54903,153798,-43992,0,-33970,5516,0,0,,39486,-28454
2,01-09-17,86,21:15,21:30,192.52,34.21,0,192.52,31.85,2,-67034,87427,154461,20393,0,-89,28924,0,0,,29013,28835
2,01-09-17,87,21:30,21:45,192.52,22.75,0,22.75,22.75,-1,-28581,160839,189420,132258,0,-20205,778,0,0,,20983,-19427
2,01-09-17,88,21:45,22:00,,-52.41,0,-52.41,-52.41,-1,-42449,140312,182761,97863,0,-72252,0,0,0,,72252,-72252
2,01-09-17,89,22:00,22:15,,18.62,0,18.62,18.62,-1,-65689,128218,193907,62529,0,-39579,0,0,0,,39579,-39579
2,01-09-17,90,22:15,22:30,,19.45,0,19.45,19.45,-1,-37826,105982,143808,68156,0,-63309,0,0,0,,63309,-63309
2,01-09-17,91,22:30,22:45,,26.8,0,26.8,26.8,-1,-31010,112503,143513,81493,0,-55348,0,0,0,,55348,-55348
2,01-09-17,92,22:45,23:00,,-53.79,0,-53.79,-53.79,-1,-39338,154466,193804,115128,0,-63154,0,0,0,,63154,-63154
2,01-09-17,93,23:00,23:15,41.15,-53.77,0,41.15,-53.77,2,-78389,148414,226803,70025,0,-75434,101,0,0,,75535,-75333
2,01-09-17,94,23:15,23:30,,-53.77,0,-53.77,-53.77,-1,-59251,184091,243342,124840,0,-62760,0,0,0,,62760,-62760
2,01-09-17,95,23:30,23:45,,-53.77,0,-53.77,-53.77,-1,-74210,150886,225096,76676,0,-62181,0,0,0,,62181,-62181
2,01-09-17,96,23:45,0:00,,-53.77,0,-53.77,-53.77,-1,-53919,175620,229539,121701,0,-49046,0,0,0,,49046,-49046
2,01-10-17,1,0:00,0:15,,-14.29,0,-14.29,-14.29,-1,-51781,172643,224424,120862,0,-70365,0,0,0,,70365,-70365
2,01-10-17,2,0:15,0:30,,-8.86,0,-8.86,-8.86,-1,-50183,148990,199173,98807,0,-46313,0,0,0,,46313,-46313
2,01-10-17,3,0:30,0:45,,-14.29,0,-14.29,-14.29,-1,-52508,118245,170753,65737,0,-66561,0,0,0,,66561,-66561
2,01-10-17,4,0:45,1:00,,8.48,0,8.48,8.48,-1,-56258,123620,179878,67362,0,-52192,0,0,0,,52192,-52192
2,01-10-17,5,1:00,1:15,,-13.78,0,-13.78,-13.78,-1,-51965,218292,270257,166327,0,-74022,0,0,0,,74022,-74022
2,01-10-17,6,1:15,1:30,,-13.78,0,-13.78,-13.78,-1,-65059,173294,238353,108235,0,-67744,0,0,0,,67744,-67744
2,01-10-17,7,1:30,1:45,,-13.78,0,-13.78,-13.78,-1,-54064,146516,200580,92452,0,-94731,0,0,0,,94731,-94731
2,01-10-17,8,1:45,2:00,,-13.78,0,-13.78,-13.78,-1,-48475,186056,234531,137581,0,-90107,0,0,0,,90107,-90107
2,01-10-17,9,2:00,2:15,,-13.78,0,-13.78,-13.78,-1,-50303,139524,189827,89221,0,-101574,0,0,0,,101574,-101574
2,01-10-17,10,2:15,2:30,,-150.78,0,-150.78,-150.78,-1,-39435,154095,193530,114660,0,-70002,0,0,0,,70002,-70002
2,01-10-17,11,2:30,2:45,,-150.78,0,-150.78,-150.78,-1,-43807,148910,192717,105103,0,-69794,0,0,0,,69794,-69794
2,01-10-17,12,2:45,3:00,,-150.78,0,-150.78,-150.78,-1,-64066,88525,152591,24459,0,-50622,0,0,0,,50622,-50622
2,01-10-17,13,3:00,3:15,,22.78,0,22.78,22.78,-1,-47918,131466,179384,83548,0,-23185,0,0,0,,23185,-23185
2,01-10-17,14,3:15,3:30,,26.74,0,26.74,26.74,-1,-49747,96372,146119,46625,0,-19336,0,0,0,,19336,-19336
2,01-10-17,15,3:30,3:45,,31.78,0,31.78,31.78,-1,-54124,83919,138043,29795,0,-16752,0,0,0,,16752,-16752
2,01-10-17,16,3:45,4:00,,32.59,0,32.59,32.59,-1,-72373,79910,152283,7537,0,-6725,0,0,0,,6725,-6725
2,01-10-17,17,4:00,4:15,,32.05,0,32.05,32.05,-1,-70180,72289,142469,2109,0,-1835,0,0,0,,1835,-1835
2,01-10-17,18,4:15,4:30,35.36,,0,35.36,35.36,1,-79982,46580,126562,-33402,0,0,1482,0,0,,1482,1482
2,01-10-17,19,4:30,4:45,34.48,,0,34.48,34.48,1,-94939,29983,124922,-64956,0,0,532,0,0,,532,532
2,01-10-17,20,4:45,5:00,35.46,,0,35.46,35.46,1,-101892,26957,128849,-74935,0,0,4269,0,0,,4269,4269
2,01-10-17,21,5:00,5:15,35.46,26.8,0,26.8,26.8,-1,-48786,61222,110008,12436,0,-2751,761,0,0,,3512,-1990
2,01-10-17,22,5:15,5:30,,26.48,0,26.48,26.48,-1,-52336,46618,98954,-5718,0,-24097,0,0,0,,24097,-24097
2,01-10-17,23,5:30,5:45,45.12,26.48,0,45.12,45.12,1,-67779,20459,88238,-47320,0,-857,8593,0,0,,9450,7736
2,01-10-17,24,5:45,6:00,34.48,,0,34.48,34.48,1,-56596,46201,102797,-10395,0,0,3443,0,0,,3443,3443
2,01-10-17,25,6:00,6:15,,30.1,0,30.1,30.1,-1,-88794,85550,174344,-3244,0,-1710,0,0,0,,1710,-1710
2,01-10-17,26,6:15,6:30,,30.8,0,30.8,30.8,-1,-48523,61359,109882,12836,0,-2599,0,0,0,,2599,-2599
2,01-10-17,27,6:30,6:45,,,0,33.14,33.14,0,-59439,35238,94677,-24201,0,-26,0,0,0,,26,-26
2,01-10-17,28,6:45,7:00,250,,0,250,250,1,-121107,76667,197774,-44440,0,0,14433,0,0,,14433,14433
2,01-10-17,29,7:00,7:15,33.74,3.82,0,42.42,3.82,2,-25586,92184,117770,66598,0,-19499,3682,0,0,,23181,-15817
2,01-10-17,30,7:15,7:30,39.77,31.03,0,39.77,39.77,1,-49038,25191,74229,-23847,0,-10476,270,0,0,,10746,-10206
2,01-10-17,31,7:30,7:45,57.68,,0,57.68,57.68,1,-119383,26804,146187,-92579,0,0,6558,0,0,,6558,6558
2,01-10-17,32,7:45,8:00,250,,0,250,250,1,-177611,35104,212715,-142507,0,0,47879,0,0,,47879,47879
2,01-10-17,33,8:00,8:15,62.75,22.61,0,62.75,22.61,2,-25664,71681,97345,46017,0,-6315,25980,0,0,,32295,19665
2,01-10-17,34,8:15,8:30,39.77,32.75,0,42.46,32.75,2,-72327,35142,107469,-37185,0,-3175,1437,0,0,,4612,-1738
2,01-10-17,35,8:30,8:45,37.71,,0,37.71,37.71,1,-86297,31482,117779,-54815,0,0,2780,0,0,,2780,2780
2,01-10-17,36,8:45,9:00,45.25,,0,45.25,45.25,1,-98351,26856,125207,-71495,0,0,718,0,0,,718,718
2,01-10-17,37,9:00,9:15,67.12,,0,67.12,67.12,1,-59732,19069,78801,-40663,0,0,9706,0,0,,9706,9706
2,01-10-17,38,9:15,9:30,95.8,,0,95.8,95.8,1,-84689,17207,101896,-67482,0,0,24261,0,0,,24261,24261
2,01-10-17,39,9:30,9:45,36.38,,0,36.38,36.38,1,-72009,23090,95099,-48919,0,0,10615,0,0,,10615,10615
2,01-10-17,40,9:45,10:00,33.85,,0,33.85,33.85,1,-88886,20058,108944,-68828,0,0,1641,0,0,,1641,1641
2,01-10-17,41,10:00,10:15,33.41,,0,33.41,33.41,1,-79802,18597,98399,-61205,0,0,1820,0,0,,1820,1820
2,01-10-17,42,10:15,10:30,39.77,,0,39.77,39.77,1,-76043,15200,91243,-60843,0,0,2952,0,0,,2952,2952
2,01-10-17,43,10:30,10:45,39.85,,0,39.85,39.85,1,-55258,17106,72364,-38152,0,0,10283,0,0,,10283,10283
2,01-10-17,44,10:45,11:00,53.55,,0,53.55,53.55,1,-56832,26345,83177,-30487,0,0,30466,0,0,,30466,30466
2,01-10-17,45,11:00,11:15,39.77,30.8,0,30.8,30.8,-1,-28008,62253,90261,34245,0,-2207,17685,0,0,,19892,15478
2,01-10-17,46,11:15,11:30,39.77,30.8,0,30.8,30.8,-1,-30589,63024,93613,32435,0,-2578,144,0,0,,2722,-2434
2,01-10-17,47,11:30,11:45,,32.27,0,32.27,32.27,-1,-20273,68040,88313,47767,0,-2767,0,0,0,,2767,-2767
2,01-10-17,48,11:45,12:00,,31.03,0,31.03,31.03,-1,-20007,72099,92106,52092,0,-18524,0,0,0,,18524,-18524
2,01-10-17,49,12:00,12:15,35.87,33.31,0,35.87,35.87,1,-50974,54275,105249,3301,0,-8215,390,0,0,,8605,-7825
2,01-10-17,50,12:15,12:30,35.87,30.59,0,30.59,30.59,-1,-33597,53872,87469,20275,0,-4515,15,0,0,,4530,-4500
2,01-10-17,51,12:30,12:45,,29,0,29,29,-1,-39602,73009,112611,33407,0,-20067,0,0,0,,20067,-20067
2,01-10-17,52,12:45,13:00,,28.22,0,28.22,28.22,-1,-22258,67417,89675,45159,0,-15806,0,0,0,,15806,-15806
2,01-10-17,53,13:00,13:15,34.48,31.8,0,42.37,31.8,2,-25036,44480,69516,19444,0,-20204,49,0,0,,20253,-20155
2,01-10-17,54,13:15,13:30,34.48,31.8,0,34.48,34.48,1,-27780,42383,70163,14603,0,-1520,476,0,0,,1996,-1044
2,01-10-17,55,13:30,13:45,,30.22,0,30.22,30.22,-1,-31300,61768,93068,30468,0,-3089,0,0,0,,3089,-3089
2,01-10-17,56,13:45,14:00,,26.8,0,26.8,26.8,-1,-28168,57636,85804,29468,0,-29685,0,0,0,,29685,-29685
2,01-10-17,57,14:00,14:15,,29.14,0,29.14,29.14,-1,-33437,83586,117023,50149,0,-39691,0,0,0,,39691,-39691
2,01-10-17,58,14:15,14:30,,29.14,0,29.14,29.14,-1,-27374,66012,93386,38638,0,-43393,0,0,0,,43393,-43393
2,01-10-17,59,14:30,14:45,,26.8,0,26.8,26.8,-1,-22918,76940,99858,54022,0,-34008,0,0,0,,34008,-34008
2,01-10-17,60,14:45,15:00,,24.05,0,24.05,24.05,-1,-22875,71942,94817,49067,0,-57607,0,0,0,,57607,-57607
2,01-10-17,61,15:00,15:15,,30.8,0,30.8,30.8,-1,-26034,56641,82675,30607,0,-26836,0,0,0,,26836,-26836
2,01-10-17,62,15:15,15:30,,24.05,0,24.05,24.05,-1,-27252,55804,83056,28552,0,-34648,0,0,0,,34648,-34648
2,01-10-17,63,15:30,15:45,54.74,34.78,0,54.74,34.78,2,-35909,32184,68093,-3725,0,-10191,3814,0,0,,14005,-6377
2,01-10-17,64,15:45,16:00,54.74,32.27,0,32.27,32.27,-1,-34943,41196,76139,6253,0,-730,348,0,0,,1078,-382
2,01-10-17,65,16:00,16:15,,26.8,0,26.8,26.8,-1,-33567,50495,84062,16928,0,-14963,0,0,0,,14963,-14963
2,01-10-17,66,16:15,16:30,,26.8,0,26.8,26.8,-1,-33576,66614,100190,33038,0,-6178,0,0,0,,6178,-6178
2,01-10-17,67,16:30,16:45,,24.69,0,24.69,24.69,-1,-45195,62056,107251,16861,0,-26678,0,0,0,,26678,-26678
2,01-10-17,68,16:45,17:00,160.95,24.69,0,160.95,160.95,1,-81757,81330,163087,-427,0,-2357,12492,0,0,,14849,10135
2,01-10-17,69,17:00,17:15,54.74,30.8,0,54.74,30.8,2,-27508,112141,139649,84633,0,-1990,9472,0,0,,11462,7482
2,01-10-17,70,17:15,17:30,,,0,42.91,42.91,0,-33332,70151,103483,36819,0,0,0,0,0,,0,0
2,01-10-17,71,17:30,17:45,,,0,42.91,42.91,0,-42953,86418,129371,43465,0,0,0,0,0,,0,0
2,01-10-17,72,17:45,18:00,,,0,42.91,42.91,0,-37015,97243,134258,60228,0,0,0,0,0,,0,0
2,01-10-17,73,18:00,18:15,55.26,,0,55.26,55.26,1,-79032,31964,110996,-47068,0,0,1086,0,0,,1086,1086
2,01-10-17,74,18:15,18:30,,31.8,0,31.8,31.8,-1,-52841,65669,118510,12828,0,-7577,0,0,0,,7577,-7577
2,01-10-17,75,18:30,18:45,,34.29,0,34.29,34.29,-1,-44688,69570,114258,24882,0,-8613,0,0,0,,8613,-8613
2,01-10-17,76,18:45,19:00,,34.42,0,34.42,34.42,-1,-43987,83374,127361,39387,0,-1613,0,0,0,,1613,-1613
2,01-10-17,77,19:00,19:15,94.55,34.42,0,94.55,34.42,2,-79419,38640,118059,-40779,0,-555,10501,0,0,,11056,9946
2,01-10-17,78,19:15,19:30,36.59,,0,36.59,36.59,1,-56766,57606,114372,840,0,0,4958,0,0,,4958,4958
2,01-10-17,79,19:30,19:45,,26.8,0,26.8,26.8,-1,-51901,82022,133923,30121,0,-5712,0,0,0,,5712,-5712
2,01-10-17,80,19:45,20:00,,26.8,0,26.8,26.8,-1,-49910,92625,142535,42715,0,-21403,0,0,0,,21403,-21403
2,01-10-17,81,20:00,20:15,154.44,35.04,0,154.44,154.44,1,-103482,32082,135564,-71400,0,-5702,22249,0,0,,27951,16547
2,01-10-17,82,20:15,20:30,154.44,15.73,0,15.73,15.73,-1,-72909,93190,166099,20281,0,-3653,31153,0,0,,34806,27500
2,01-10-17,83,20:30,20:45,154.44,5.89,0,5.89,5.89,-1,-61373,94953,156326,33580,0,-34869,32,0,0,,34901,-34837
2,01-10-17,84,20:45,21:00,,17.96,0,17.96,17.96,-1,-71188,131958,203146,60770,0,-42943,0,0,0,,42943,-42943
2,01-10-17,85,21:00,21:15,,14.5,0,14.5,14.5,-1,-44296,114115,158411,69819,0,-54746,0,0,0,,54746,-54746
2,01-10-17,86,21:15,21:30,,14.5,0,14.5,14.5,-1,-37177,114390,151567,77213,0,-43855,0,0,0,,43855,-43855
2,01-10-17,87,21:30,21:45,,3.97,0,3.97,3.97,-1,-50501,129726,180227,79225,0,-62738,0,0,0,,62738,-62738
2,01-10-17,88,21:45,22:00,,14.5,0,14.5,14.5,-1,-52323,156656,208979,104333,0,-72536,0,0,0,,72536,-72536
2,01-10-17,89,22:00,22:15,43.77,14.5,0,43.77,43.77,1,-66620,36569,103189,-30051,0,-45278,1410,0,0,,46688,-43868
2,01-10-17,90,22:15,22:30,43.77,31.8,0,31.8,31.8,-1,-37331,45175,82506,7844,0,-892,1092,0,0,,1984,200
2,01-10-17,91,22:30,22:45,,14.5,0,14.5,14.5,-1,-34461,82386,116847,47925,0,-35761,0,0,0,,35761,-35761
2,01-10-17,92,22:45,23:00,,22.46,0,22.46,22.46,-1,-53573,105074,158647,51501,0,-22165,0,0,0,,22165,-22165
2,01-10-17,93,23:00,23:15,43.77,13.23,0,43.77,13.23,2,-63238,28438,91676,-34800,0,-22552,2822,0,0,,25374,-19730
2,01-10-17,94,23:15,23:30,26.68,21.98,0,21.98,21.98,-1,-30367,51850,82217,21483,0,-4515,628,0,0,,5143,-3887
2,01-10-17,95,23:30,23:45,,1.99,0,1.99,1.99,-1,-35523,83514,119037,47991,0,-44730,0,0,0,,44730,-44730
2,01-10-17,96,23:45,0:00,,-26.41,0,-26.41,-26.41,-1,-33666,107796,141462,74130,0,-58170,0,0,0,,58170,-58170
2,01-11-17,1,0:00,0:15,42.55,-20.04,0,42.55,42.55,1,-91676,87445,179121,-4231,0,-46268,1085,0,0,,47353,-45183
2,01-11-17,2,0:15,0:30,38.11,-20.04,0,38.11,38.11,1,-51570,28172,79742,-23398,0,-364,1561,0,0,,1925,1197
2,01-11-17,3,0:30,0:45,,37.52,0,37.52,37.52,-1,-53383,58657,112040,5274,0,-31,0,0,0,,31,-31
2,01-11-17,4,0:45,1:00,,30.03,0,30.03,30.03,-1,-77995,83069,161064,5074,0,-14847,0,0,0,,14847,-14847
2,01-11-17,5,1:00,1:15,49.52,32.03,0,49.52,49.52,1,-92006,43352,135358,-48654,0,-17042,868,0,0,,17910,-16174
2,01-11-17,6,1:15,1:30,53.21,36.52,0,53.21,32.51,2,-66860,37725,104585,-29135,0,-1223,9962,0,0,,11185,8739
2,01-11-17,7,1:30,1:45,,36.04,0,36.04,36.04,-1,-55655,63706,119361,8051,0,-1508,0,0,0,,1508,-1508
2,01-11-17,8,1:45,2:00,,32.52,0,32.52,32.52,-1,-44635,83136,127771,38501,0,-21040,0,0,0,,21040,-21040
2,01-11-17,9,2:00,2:15,43.52,37.52,0,43.52,43.52,1,-49574,38529,88103,-11045,0,-6480,4635,0,0,,11115,-1845
2,01-11-17,10,2:15,2:30,43.52,,0,43.52,43.52,1,-39077,52451,91528,13374,0,0,8855,0,0,,8855,8855
2,01-11-17,11,2:30,2:45,43.52,36.52,0,36.52,36.52,-1,-35700,65947,101647,30247,0,-1354,14,0,0,,1368,-1340
2,01-11-17,12,2:45,3:00,,16.9,0,16.9,16.9,-1,-20974,72317,93291,51343,0,-29270,0,0,0,,29270,-29270
2,01-11-17,13,3:00,3:15,39.79,16.91,0,39.79,39.79,1,-36726,35721,72447,-1005,0,-29425,1597,0,0,,31022,-27828
2,01-11-17,14,3:15,3:30,39.79,26.04,0,26.04,26.04,-1,-29655,49946,79601,20291,0,-6696,1007,0,0,,7703,-5689
2,01-11-17,15,3:30,3:45,,20.84,0,20.84,20.84,-1,-9465,57151,66616,47686,0,-47857,0,0,0,,47857,-47857
2,01-11-17,16,3:45,4:00,,-10.03,0,-10.03,-10.03,-1,-11542,72790,84332,61248,0,-51138,0,0,0,,51138,-51138
2,01-11-17,17,4:00,4:15,,-11.03,0,-11.03,-11.03,-1,-31738,45168,76906,13430,0,-39880,0,0,0,,39880,-39880
2,01-11-17,18,4:15,4:30,,32.52,0,32.52,32.52,-1,-35221,51690,86911,16469,0,-1104,0,0,0,,1104,-1104
2,01-11-17,19,4:30,4:45,,30.03,0,30.03,30.03,-1,-27329,65039,92368,37710,0,-10767,0,0,0,,10767,-10767
2,01-11-17,20,4:45,5:00,,26.93,0,26.93,26.93,-1,-24818,84495,109313,59677,0,-13464,0,0,0,,13464,-13464
2,01-11-17,21,5:00,5:15,,34.03,0,34.03,34.03,-1,-29423,106129,135552,76706,0,-12014,0,0,0,,12014,-12014
2,01-11-17,22,5:15,5:30,,34.03,0,34.03,34.03,-1,-21287,105226,126513,83939,0,-9593,0,0,0,,9593,-9593
2,01-11-17,23,5:30,5:45,,37.52,0,37.52,37.52,-1,-21669,101360,123029,79691,0,-476,0,0,0,,476,-476
2,01-11-17,24,5:45,6:00,,35.16,0,35.16,35.16,-1,-28103,113639,141742,85536,0,-334,0,0,0,,334,-334
2,01-11-17,25,6:00,6:15,,-118.25,0,-118.25,-118.25,-1,-31864,111518,143382,79654,0,-36419,0,0,0,,36419,-36419
2,01-11-17,26,6:15,6:30,39.33,29.74,0,39.33,29.74,2,-43926,122349,166275,78423,0,-8479,463,0,0,,8942,-8016
2,01-11-17,27,6:30,6:45,,17.31,0,17.31,17.31,-1,-40323,127796,168119,87473,0,-43042,0,0,0,,43042,-43042
2,01-11-17,28,6:45,7:00,,,0,32.28,32.28,0,-58528,153254,211782,94726,0,-7107,0,0,0,,7107,-7107
2,01-11-17,29,7:00,7:15,,-150.03,0,-150.03,-150.03,-1,-113083,141022,254105,27939,0,-27834,0,0,0,,27834,-27834
2,01-11-17,30,7:15,7:30,39.33,32.38,0,39.33,32.38,2,-114369,104247,218616,-10122,0,-6104,2244,0,0,,8348,-3860
2,01-11-17,31,7:30,7:45,39.33,32.38,0,39.33,32.38,2,-122990,83314,206304,-39676,0,-4389,428,0,0,,4817,-3961
2,01-11-17,32,7:45,8:00,145.84,,0,145.84,145.84,1,-185702,62276,247978,-123426,0,0,56202,0,0,,56202,56202
2,01-11-17,33,8:00,8:15,145.84,-113.04,0,-113.04,-113.04,-1,-68847,114475,183322,45628,0,-9359,32645,0,0,,42004,23286
2,01-11-17,34,8:15,8:30,35.58,-113.04,0,35.58,35.58,1,-107381,64314,171695,-43067,0,-1000,803,0,0,,1803,-197
2,01-11-17,35,8:30,8:45,,,0,33.01,33.01,0,-112888,92454,205342,-20434,0,0,68,0,0,,68,68
2,01-11-17,36,8:45,9:00,,,0,33.01,33.01,0,-120034,86453,206487,-33581,0,0,0,0,0,,0,0
2,01-11-17,37,9:00,9:15,,37.38,0,37.38,37.38,-1,-47545,76247,123792,28702,0,-371,0,0,0,,371,-371
2,01-11-17,38,9:15,9:30,,37.38,0,37.38,37.38,-1,-56754,91432,148186,34678,0,-75,0,0,0,,75,-75
2,01-11-17,39,9:30,9:45,,,0,32.95,32.95,0,-62891,99118,162009,36227,0,0,0,0,0,,0,0
2,01-11-17,40,9:45,10:00,,37.38,0,37.38,37.38,-1,-63605,90810,154415,27205,0,-51,0,0,0,,51,-51
2,01-11-17,41,10:00,10:15,,32.38,0,32.38,32.38,-1,-39875,109341,149216,69466,0,-3831,0,0,0,,3831,-3831
2,01-11-17,42,10:15,10:30,,21.68,0,21.68,21.68,-1,-42018,115502,157520,73484,0,-17883,0,0,0,,17883,-17883
2,01-11-17,43,10:30,10:45,,21.68,0,21.68,21.68,-1,-51616,95877,147493,44261,0,-27902,0,0,0,,27902,-27902
2,01-11-17,44,10:45,11:00,,32.38,0,32.38,32.38,-1,-50871,101427,152298,50556,0,-7963,0,0,0,,7963,-7963
2,01-11-17,45,11:00,11:15,,32.38,0,32.38,32.38,-1,-35622,99705,135327,64083,0,-5335,0,0,0,,5335,-5335
2,01-11-17,46,11:15,11:30,,37.38,0,37.38,37.38,-1,-27087,79372,106459,52285,0,-7,0,0,0,,7,-7
2,01-11-17,47,11:30,11:45,,36.92,0,36.92,36.92,-1,-18045,94410,112455,76365,0,-1231,0,0,0,,1231,-1231
2,01-11-17,48,11:45,12:00,,32.39,0,32.39,32.39,-1,-16636,102141,118777,85505,0,-3296,0,0,0,,3296,-3296
2,01-11-17,49,12:00,12:15,,37.02,0,37.02,37.02,-1,-32786,112208,144994,79422,0,-1641,0,0,0,,1641,-1641
2,01-11-17,50,12:15,12:30,,37.38,0,37.38,37.38,-1,-25559,111060,136619,85501,0,-35,0,0,0,,35,-35
2,01-11-17,51,12:30,12:45,,36.92,0,36.92,36.92,-1,-19405,132791,152196,113386,0,-1143,0,0,0,,1143,-1143
2,01-11-17,52,12:45,13:00,,16.34,0,16.34,16.34,-1,-19650,155670,175320,136020,0,-19863,0,0,0,,19863,-19863
2,01-11-17,53,13:00,13:15,,8.03,0,8.03,8.03,-1,-7242,169052,176294,161810,0,-57416,0,0,0,,57416,-57416
2,01-11-17,54,13:15,13:30,,18.29,0,18.29,18.29,-1,-10018,155958,165976,145940,0,-37994,0,0,0,,37994,-37994
2,01-11-17,55,13:30,13:45,,15.44,0,15.44,15.44,-1,-15450,147157,162607,131707,0,-47289,0,0,0,,47289,-47289
2,01-11-17,56,13:45,14:00,,22.83,0,22.83,22.83,-1,-18496,143849,162345,125353,0,-10577,0,0,0,,10577,-10577
2,01-11-17,57,14:00,14:15,,21.77,0,21.77,21.77,-1,-21493,125407,146900,103914,0,-12845,0,0,0,,12845,-12845
2,01-11-17,58,14:15,14:30,,37.38,0,37.38,37.38,-1,-25560,123178,148738,97618,0,-936,0,0,0,,936,-936
2,01-11-17,59,14:30,14:45,,33.99,0,33.99,33.99,-1,-29429,121651,151080,92222,0,-685,0,0,0,,685,-685
2,01-11-17,60,14:45,15:00,,24.06,0,24.06,24.06,-1,-22469,127860,150329,105391,0,-11034,0,0,0,,11034,-11034
2,01-11-17,61,15:00,15:15,,35.03,0,35.03,35.03,-1,-34111,119064,153175,84953,0,-9644,0,0,0,,9644,-9644
2,01-11-17,62,15:15,15:30,,,0,32.85,32.85,0,-46133,126408,172541,80275,0,-172,0,0,0,,172,-172
2,01-11-17,63,15:30,15:45,,,0,32.85,32.85,0,-38692,122344,161036,83652,0,0,0,0,0,,0,0
2,01-11-17,64,15:45,16:00,,19.1,0,19.1,19.1,-1,-63926,134015,197941,70089,0,-12777,0,0,0,,12777,-12777
2,01-11-17,65,16:00,16:15,,13.8,0,13.8,13.8,-1,-72325,124303,196628,51978,0,-50444,0,0,0,,50444,-50444
2,01-11-17,66,16:15,16:30,,36.38,0,36.38,36.38,-1,-122453,163496,285949,41043,0,-17129,0,0,0,,17129,-17129
2,01-11-17,67,16:30,16:45,,-8.03,0,-8.03,-8.03,-1,-57267,154047,211314,96780,0,-41504,0,0,0,,41504,-41504
2,01-11-17,68,16:45,17:00,,32.38,0,32.38,32.38,-1,-59935,109144,169079,49209,0,-29961,0,0,0,,29961,-29961
2,01-11-17,69,17:00,17:15,,-9.03,0,-9.03,-9.03,-1,-89999,99801,189800,9802,0,-40821,0,0,0,,40821,-40821
2,01-11-17,70,17:15,17:30,115.45,-9.03,0,115.45,115.45,1,-105206,55329,160535,-49877,0,-6947,11171,0,0,,18118,4224
2,01-11-17,71,17:30,17:45,36.7,,0,36.7,36.7,1,-63577,60669,124246,-2908,0,0,3093,0,0,,3093,3093
2,01-11-17,72,17:45,18:00,37.86,,0,37.86,37.86,1,-73586,77482,151068,3896,0,0,3016,0,0,,3016,3016
2,01-11-17,73,18:00,18:15,37.86,-10.03,0,-10.03,-10.03,-1,-73946,117042,190988,43096,0,-25670,234,0,0,,25904,-25436
2,01-11-17,74,18:15,18:30,,27.89,0,27.89,27.89,-1,-67383,85751,153134,18368,0,-24882,0,0,0,,24882,-24882
2,01-11-17,75,18:30,18:45,,-10.03,0,-10.03,-10.03,-1,-34991,101720,136711,66729,0,-46618,0,0,0,,46618,-46618
2,01-11-17,76,18:45,19:00,,25.47,0,25.47,25.47,-1,-46680,88307,134987,41627,0,-31643,0,0,0,,31643,-31643
2,01-11-17,77,19:00,19:15,81.6,23.03,0,81.6,23.03,2,-101241,44964,146205,-56277,0,-17356,5824,0,0,,23180,-11532
2,01-11-17,78,19:15,19:30,85.68,35.79,0,85.68,35.79,2,-72024,59454,131478,-12570,0,-598,15224,0,0,,15822,14626
2,01-11-17,79,19:30,19:45,85.68,32.38,0,32.38,32.38,-1,-47406,70013,117419,22607,0,-16766,112,0,0,,16878,-16654
2,01-11-17,80,19:45,20:00,,33.31,0,33.31,33.31,-1,-46898,65753,112651,18855,0,-22849,0,0,0,,22849,-22849
2,01-11-17,81,20:00,20:15,37.35,27.87,0,37.35,27.87,2,-62428,63710,126138,1282,0,-24406,154,0,0,,24560,-24252
2,01-11-17,82,20:15,20:30,39.88,29.92,0,39.88,29.92,2,-67986,86859,154845,18873,0,-6915,1551,0,0,,8466,-5364
2,01-11-17,83,20:30,20:45,,29.92,0,29.92,29.92,-1,-64597,85467,150064,20870,0,-16948,0,0,0,,16948,-16948
2,01-11-17,84,20:45,21:00,,22.13,0,22.13,22.13,-1,-59699,102320,162019,42621,0,-36812,0,0,0,,36812,-36812
2,01-11-17,85,21:00,21:15,37.4,27.62,0,37.4,37.4,1,-83482,115523,199005,32041,0,-23639,357,0,0,,23996,-23282
2,01-11-17,86,21:15,21:30,38.81,32.38,0,38.81,32.38,2,-69652,84131,153783,14479,0,-1273,3675,0,0,,4948,2402
2,01-11-17,87,21:30,21:45,,12.03,0,12.03,12.03,-1,-52846,93101,145947,40255,0,-31446,0,0,0,,31446,-31446
2,01-11-17,88,21:45,22:00,,29.74,0,29.74,29.74,-1,-74198,94646,168844,20448,0,-26060,0,0,0,,26060,-26060
2,01-11-17,89,22:00,22:15,,32.03,0,32.03,32.03,-1,-76777,99177,175954,22400,0,-15629,0,0,0,,15629,-15629
2,01-11-17,90,22:15,22:30,,18.03,0,18.03,18.03,-1,-52079,98343,150422,46264,0,-29568,0,0,0,,29568,-29568
2,01-11-17,91,22:30,22:45,,18.03,0,18.03,18.03,-1,-34304,100634,134938,66330,0,-30510,0,0,0,,30510,-30510
2,01-11-17,92,22:45,23:00,,28.26,0,28.26,28.26,-1,-38932,124768,163700,85836,0,-3326,0,0,0,,3326,-3326
2,01-11-17,93,23:00,23:15,,27.36,0,27.36,27.36,-1,-58211,80207,138418,21996,0,-2162,0,0,0,,2162,-2162
2,01-11-17,94,23:15,23:30,,-89.52,0,-89.52,-89.52,-1,-36104,82218,118322,46114,0,-9698,0,0,0,,9698,-9698
2,01-11-17,95,23:30,23:45,49.74,-89.52,0,49.74,-89.52,2,-76148,56353,132501,-19795,0,-18978,5797,0,0,,24775,-13181
2,01-11-17,96,23:45,0:00,49.74,-89.52,0,-89.52,-89.52,-1,-93760,119325,213085,25565,0,-21568,1779,0,0,,23347,-19789
2,01-12-17,1,0:00,0:15,,33.37,0,33.37,33.37,-1,-52798,46866,99664,-5932,0,-4880,0,0,0,,4880,-4880
2,01-12-17,2,0:15,0:30,,33.37,0,33.37,33.37,-1,-33763,59718,93481,25955,0,-1045,0,0,0,,1045,-1045
2,01-12-17,3,0:30,0:45,,26.43,0,26.43,26.43,-1,-49160,65300,114460,16140,0,-2611,0,0,0,,2611,-2611
2,01-12-17,4,0:45,1:00,,22.06,0,22.06,22.06,-1,-55125,95783,150908,40658,0,-25255,0,0,0,,25255,-25255
2,01-12-17,5,1:00,1:15,39.37,32.37,0,39.37,39.37,1,-43306,36954,80260,-6352,0,-9980,1456,0,0,,11436,-8524
2,01-12-17,6,1:15,1:30,40,26.09,0,40,26.09,2,-32217,47434,79651,15217,0,-2650,4147,0,0,,6797,1497
2,01-12-17,7,1:30,1:45,,26.09,0,26.09,26.09,-1,-33207,64411,97618,31204,0,-5389,0,0,0,,5389,-5389
2,01-12-17,8,1:45,2:00,,-10.78,0,-10.78,-10.78,-1,-28561,71219,99780,42658,0,-25432,0,0,0,,25432,-25432
2,01-12-17,9,2:00,2:15,38.74,32.74,0,38.74,32.74,2,-54486,55026,109512,540,0,-10583,1428,0,0,,12011,-9155
2,01-12-17,10,2:15,2:30,37.33,,0,37.33,37.33,1,-51530,40433,91963,-11097,0,0,664,0,0,,664,664
2,01-12-17,11,2:30,2:45,40,,0,40,40,1,-67848,39629,107477,-28219,0,0,7278,0,0,,7278,7278
2,01-12-17,12,2:45,3:00,37.38,37.88,0,37.88,37.88,-1,-58473,45900,104373,-12573,0,-56,5934,0,0,,5990,5878
2,01-12-17,13,3:00,3:15,37.38,37.63,0,37.63,37.63,-1,-39631,47925,87556,8294,0,-1181,28,0,0,,1209,-1153
2,01-12-17,14,3:15,3:30,,37.88,0,37.88,37.88,-1,-42136,48209,90345,6073,0,-95,0,0,0,,95,-95
2,01-12-17,15,3:30,3:45,,,0,32.96,32.96,0,-47874,38570,86444,-9304,0,0,0,0,0,,0,0
2,01-12-17,16,3:45,4:00,,,0,32.96,32.96,0,-58786,38635,97421,-20151,0,0,0,0,0,,0,0
2,01-12-17,17,4:00,4:15,,,0,32.89,32.89,0,-80654,44771,125425,-35883,0,0,0,0,0,,0,0
2,01-12-17,18,4:15,4:30,,,0,32.89,32.89,0,-53421,39982,93403,-13439,0,0,0,0,0,,0,0
2,01-12-17,19,4:30,4:45,,,0,32.89,32.89,0,-55725,32855,88580,-22870,0,0,0,0,0,,0,0
2,01-12-17,20,4:45,5:00,,,0,32.89,32.89,0,-57735,47299,105034,-10436,0,0,0,0,0,,0,0
2,01-12-17,21,5:00,5:15,,33.75,0,33.75,33.75,-1,-41160,82701,123861,41541,0,-1277,0,0,0,,1277,-1277
2,01-12-17,22,5:15,5:30,,27.31,0,27.31,27.31,-1,-39904,71176,111080,31272,0,-11068,0,0,0,,11068,-11068
2,01-12-17,23,5:30,5:45,,37.88,0,37.88,37.88,-1,-53896,65782,119678,11886,0,-3490,0,0,0,,3490,-3490
2,01-12-17,24,5:45,6:00,39.37,36.57,0,39.37,32.9,2,-71793,57261,129054,-14532,0,-20,4351,0,0,,4371,4331
2,01-12-17,25,6:00,6:15,39.37,31.28,0,31.28,31.28,-1,-26071,93797,119868,67726,0,-8522,14,0,0,,8536,-8508
2,01-12-17,26,6:15,6:30,41.08,36.88,0,41.08,32.95,2,-51200,59374,110574,8174,0,-4976,262,0,0,,5238,-4714
2,01-12-17,27,6:30,6:45,111.33,36.88,0,111.33,111.33,1,-93078,42149,135227,-50929,0,-60,34141,0,0,,34201,34081
2,01-12-17,28,6:45,7:00,44.12,,0,44.12,44.12,1,-87088,81537,168625,-5551,0,0,25888,0,0,,25888,25888
2,01-12-17,29,7:00,7:15,38.36,26.06,0,26.06,26.06,-1,-106355,134391,240746,28036,0,-3751,8194,0,0,,11945,4443
2,01-12-17,30,7:15,7:30,38.36,27.16,0,27.16,27.16,-1,-56931,90073,147004,33142,0,-4828,43,0,0,,4871,-4785
2,01-12-17,31,7:30,7:45,36.99,34.88,0,36.99,32.89,2,-69978,60394,130372,-9584,0,-906,183,0,0,,1089,-723
2,01-12-17,32,7:45,8:00,122.81,,0,122.81,122.81,1,-108346,60559,168905,-47787,0,0,18927,0,0,,18927,18927
2,01-12-17,33,8:00,8:15,122.81,34.08,0,34.08,34.08,-1,-78917,80831,159748,1914,0,-2724,2021,0,0,,4745,-703
2,01-12-17,34,8:15,8:30,,36.88,0,36.88,36.88,-1,-54120,74555,128675,20435,0,-871,0,0,0,,871,-871
2,01-12-17,35,8:30,8:45,,33.88,0,33.88,33.88,-1,-47422,76355,123777,28933,0,-13545,0,0,0,,13545,-13545
2,01-12-17,36,8:45,9:00,,37.88,0,37.88,37.88,-1,-69307,74436,143743,5129,0,-4213,0,0,0,,4213,-4213
2,01-12-17,37,9:00,9:15,,22.78,0,22.78,22.78,-1,-52797,97499,150296,44702,0,-14803,0,0,0,,14803,-14803
2,01-12-17,38,9:15,9:30,,22.78,0,22.78,22.78,-1,-58898,68446,127344,9548,0,-25292,0,0,0,,25292,-25292
2,01-12-17,39,9:30,9:45,36.99,37.4,0,37.44,37.4,2,-65231,75713,140944,10482,0,-1224,57,0,0,,1281,-1167
2,01-12-17,40,9:45,10:00,,33.78,0,33.78,33.78,-1,-61192,82139,143331,20947,0,-6807,0,0,0,,6807,-6807
2,01-12-17,41,10:00,10:15,,32.88,0,32.88,32.88,-1,-50786,94665,145451,43879,0,-4922,0,0,0,,4922,-4922
2,01-12-17,42,10:15,10:30,,32.88,0,32.88,32.88,-1,-64896,98057,162953,33161,0,-8761,0,0,0,,8761,-8761
2,01-12-17,43,10:30,10:45,,,0,32.83,32.83,0,-84938,97679,182617,12741,0,-198,0,0,0,,198,-198
2,01-12-17,44,10:45,11:00,,37.7,0,37.7,37.7,-1,-81296,94407,175703,13111,0,-94,0,0,0,,94,-94
2,01-12-17,45,11:00,11:15,,27.85,0,27.85,27.85,-1,-56796,111324,168120,54528,0,-17619,0,0,0,,17619,-17619
2,01-12-17,46,11:15,11:30,,32.74,0,32.74,32.74,-1,-53504,100569,154073,47065,0,-30923,0,0,0,,30923,-30923
2,01-12-17,47,11:30,11:45,,27.44,0,27.44,27.44,-1,-45364,113156,158520,67792,0,-44474,0,0,0,,44474,-44474
2,01-12-17,48,11:45,12:00,,30,0,30,30,-1,-49047,107679,156726,58632,0,-45248,0,0,0,,45248,-45248
2,01-12-17,49,12:00,12:15,,30,0,30,30,-1,-67522,117709,185231,50187,0,-40778,0,0,0,,40778,-40778
2,01-12-17,50,12:15,12:30,,27.44,0,27.44,27.44,-1,-58093,114324,172417,56231,0,-49137,0,0,0,,49137,-49137
2,01-12-17,51,12:30,12:45,,25.88,0,25.88,25.88,-1,-57064,115061,172125,57997,0,-62693,0,0,0,,62693,-62693
2,01-12-17,52,12:45,13:00,,33,0,33,33,-1,-66570,97198,163768,30628,0,-28432,0,0,0,,28432,-28432
2,01-12-17,53,13:00,13:15,,28.74,0,28.74,28.74,-1,-71541,93950,165491,22409,0,-20486,0,0,0,,20486,-20486
2,01-12-17,54,13:15,13:30,37.15,28.74,0,37.15,37.15,1,-79769,76815,156584,-2954,0,-3149,425,0,0,,3574,-2724
2,01-12-17,55,13:30,13:45,39.49,,0,39.49,39.49,1,-97927,63926,161853,-34001,0,0,1744,0,0,,1744,1744
2,01-12-17,56,13:45,14:00,41.54,,0,41.54,41.54,1,-110969,42022,152991,-68947,0,0,3881,0,0,,3881,3881
2,01-12-17,57,14:00,14:15,37.12,36.97,0,37.12,32.75,2,-47716,89981,137697,42265,0,-668,1381,0,0,,2049,713
2,01-12-17,58,14:15,14:30,,36.97,0,36.97,36.97,-1,-51356,85889,137245,34533,0,-667,0,0,0,,667,-667
2,01-12-17,59,14:30,14:45,43,,0,43,43,1,-64211,47529,111740,-16682,0,0,1593,0,0,,1593,1593
2,01-12-17,60,14:45,15:00,67.64,,0,67.64,67.64,1,-73481,40235,113716,-33246,0,0,31294,0,0,,31294,31294
2,01-12-17,61,15:00,15:15,37.38,18.27,0,18.27,18.27,-1,-53718,106426,160144,52708,0,-13921,10751,0,0,,24672,-3170
2,01-12-17,62,15:15,15:30,36.99,30.77,0,36.99,36.99,1,-81728,82030,163758,302,0,-17990,7,0,0,,17997,-17983
2,01-12-17,63,15:30,15:45,37.15,30.77,0,37.15,37.15,1,-90153,71542,161695,-18611,0,-79,97,0,0,,176,18
2,01-12-17,64,15:45,16:00,138.12,,0,138.12,138.12,1,-111110,38105,149215,-73005,0,0,26926,0,0,,26926,26926
2,01-12-17,65,16:00,16:15,118.44,,0,118.44,118.44,1,-93084,75522,168606,-17562,0,0,31162,0,0,,31162,31162
2,01-12-17,66,16:15,16:30,56.31,,0,56.31,56.31,1,-95032,66919,161951,-28113,0,0,25171,0,0,,25171,25171
2,01-12-17,67,16:30,16:45,143.96,,0,143.96,143.96,1,-120952,60490,181442,-60462,0,0,43997,0,0,,43997,43997
2,01-12-17,68,16:45,17:00,143.97,,0,143.97,143.97,1,-184640,65350,249990,-119290,0,0,82950,0,0,,82950,82950
2,01-12-17,69,17:00,17:15,250.35,,0,250.35,250.35,1,-116500,36903,153403,-79597,0,0,69373,5000,0,,74373,74373
2,01-12-17,70,17:15,17:30,174.79,,0,174.79,174.79,1,-144335,61671,206006,-82664,0,0,25720,0,0,,25720,25720
2,01-12-17,71,17:30,17:45,192.7,,0,192.7,192.7,1,-145555,55965,201520,-89590,0,0,70282,0,0,,70282,70282
2,01-12-17,72,17:45,18:00,112.67,,0,112.67,112.67,1,-124277,63259,187536,-61018,0,0,60634,0,0,,60634,60634
2,01-12-17,73,18:00,18:15,42.12,-2.78,0,-2.78,-2.78,-1,-39756,108346,148102,68590,0,-13346,19765,0,0,,33111,6419
2,01-12-17,74,18:15,18:30,36.28,-2.78,0,36.28,36.28,1,-51492,58717,110209,7225,0,-23204,167,0,0,,23371,-23037
2,01-12-17,75,18:30,18:45,36.28,31.54,0,44.09,31.54,2,-39834,68893,108727,29059,0,-4736,230,0,0,,4966,-4506
2,01-12-17,76,18:45,19:00,,31.54,0,31.54,31.54,-1,-48221,59154,107375,10933,0,-6424,0,0,0,,6424,-6424
2,01-12-17,77,19:00,19:15,,55.09,0,55.09,55.09,-1,-48939,64640,113579,15701,0,-21,0,0,0,,21,-21
2,01-12-17,78,19:15,19:30,,33,0,33,33,-1,-48714,67815,116529,19101,0,-3460,0,0,0,,3460,-3460
2,01-12-17,79,19:30,19:45,,33,0,33,33,-1,-43086,64128,107214,21042,0,-6810,0,0,0,,6810,-6810
2,01-12-17,80,19:45,20:00,,33,0,33,33,-1,-52724,70734,123458,18010,0,-13183,0,0,0,,13183,-13183
2,01-12-17,81,20:00,20:15,79.69,33,0,79.69,33,2,-95949,57315,153264,-38634,0,-8226,6248,0,0,,14474,-1978
2,01-12-17,82,20:15,20:30,44.94,33,0,44.94,44.94,1,-68908,64304,133212,-4604,0,-78,12738,0,0,,12816,12660
2,01-12-17,83,20:30,20:45,44.94,37.73,0,37.73,37.73,-1,-48632,82634,131266,34002,0,-486,731,0,0,,1217,245
2,01-12-17,84,20:45,21:00,,25.88,0,25.88,25.88,-1,-35678,97437,133115,61759,0,-19239,0,0,0,,19239,-19239
2,01-12-17,85,21:00,21:15,250,33,0,250,250,1,-149853,46908,196761,-102945,0,-11813,14772,0,0,,26585,2959
2,01-12-17,86,21:15,21:30,347.44,33,0,347.44,347.44,1,-119291,57916,177207,-61375,0,-6,56922,6250,0,,63178,63166
2,01-12-17,87,21:30,21:45,347.44,33,0,33,33,-1,-72990,88072,161062,15082,0,-2843,5830,0,0,,8673,2987
2,01-12-17,88,21:45,22:00,,30.6,0,30.6,30.6,-1,-75031,87684,162715,12653,0,-12513,0,0,0,,12513,-12513
2,01-12-17,89,22:00,22:15,45.37,29.39,0,45.37,29.39,2,-128832,72404,201236,-56428,0,-18840,1060,0,0,,19900,-17780
2,01-12-17,90,22:15,22:30,52.92,29.39,0,52.92,52.92,1,-138622,64354,202976,-74268,0,-827,7289,0,0,,8116,6462
2,01-12-17,91,22:30,22:45,37.15,,0,37.15,37.15,1,-76564,64134,140698,-12430,0,0,344,0,0,,344,344
2,01-12-17,92,22:45,23:00,,29.75,0,29.75,29.75,-1,-74115,89241,163356,15126,0,-14498,0,0,0,,14498,-14498
2,01-12-17,93,23:00,23:15,39.94,29.39,0,39.94,29.39,2,-70220,58480,128700,-11740,0,-25252,242,0,0,,25494,-25010
2,01-12-17,94,23:15,23:30,41.37,34.17,0,41.37,32.88,2,-75721,55659,131380,-20062,0,-1286,2989,0,0,,4275,1703
2,01-12-17,95,23:30,23:45,,32.18,0,32.18,32.18,-1,-56673,70761,127434,14088,0,-7452,0,0,0,,7452,-7452
2,01-12-17,96,23:45,0:00,,18.87,0,18.87,18.87,-1,-58519,119350,177869,60831,0,-43893,0,0,0,,43893,-43893
2,01/13/2017,1,0:00,0:15,35.37,18.79,0,35.37,35.37,1,-99694,67392,167086,-32302,0,-36382,148,0,0,,36530,-36234
2,01/13/2017,2,0:15,0:30,35.37,32.37,0,35.37,32.37,2,-59774,51513,111287,-8261,0,-1026,603,0,0,,1629,-423
2,01/13/2017,3,0:30,0:45,,32.34,0,32.34,32.34,-1,-65023,58794,123817,-6229,0,-3638,0,0,0,,3638,-3638
2,01/13/2017,4,0:45,1:00,,34.03,0,34.03,34.03,-1,-82441,75560,158001,-6881,0,-3029,0,0,0,,3029,-3029
2,01/13/2017,5,1:00,1:15,131.02,34.03,0,131.02,131.02,1,-83661,28609,112270,-55052,0,-339,21705,0,0,,22044,21366
2,01/13/2017,6,1:15,1:30,43.39,20.99,0,20.99,20.99,-1,-46692,80895,127587,34203,0,-4560,15857,0,0,,20417,11297
2,01/13/2017,7,1:30,1:45,,-8.03,0,-8.03,-8.03,-1,-41900,90754,132654,48854,0,-49633,0,0,0,,49633,-49633
2,01/13/2017,8,1:45,2:00,,-5.03,0,-5.03,-5.03,-1,-31507,128591,160098,97084,0,-63412,0,0,0,,63412,-63412
2,01/13/2017,9,2:00,2:15,,39.52,0,39.52,39.52,-1,-64166,92956,157122,28790,0,-29205,0,0,0,,29205,-29205
2,01/13/2017,10,2:15,2:30,,,0,33.92,33.92,0,-51596,104085,155681,52489,0,0,0,0,0,,0,0
2,01/13/2017,11,2:30,2:45,,,0,33.92,33.92,0,-46842,96152,142994,49310,0,0,0,0,0,,0,0
2,01/13/2017,12,2:45,3:00,,,0,33.92,33.92,0,-132789,94820,227609,-37969,0,0,0,0,0,,0,0
2,01/13/2017,13,3:00,3:15,83.18,,0,83.18,83.18,1,-136340,66141,202481,-70199,0,0,27329,0,0,,27329,27329
2,01/13/2017,14,3:15,3:30,35.37,39.62,0,39.62,39.62,-1,-92238,87258,179496,-4980,0,-193,7883,0,0,,8076,7690
2,01/13/2017,15,3:30,3:45,28.74,39.62,0,28.74,28.74,1,-106213,89433,195646,-16780,0,-223,455,0,0,,678,232
2,01/13/2017,16,3:45,4:00,28.52,,0,28.52,28.52,1,-104148,76894,181042,-27254,0,0,1120,0,0,,1120,1120
2,01/13/2017,17,4:00,4:15,39.37,,0,39.37,39.37,1,-105779,77949,183728,-27830,0,0,1478,0,0,,1478,1478
2,01/13/2017,18,4:15,4:30,40.9,,0,40.9,40.9,1,-126243,53213,179456,-73030,0,0,6738,0,0,,6738,6738
2,01/13/2017,19,4:30,4:45,43.39,,0,43.39,43.39,1,-131522,56646,188168,-74876,0,0,8029,0,0,,8029,8029
2,01/13/2017,20,4:45,5:00,71.87,,0,71.87,71.87,1,-187250,54545,241795,-132705,0,0,16722,0,0,,16722,16722
2,01/13/2017,21,5:00,5:15,39,,0,39,39,1,-113166,71496,184662,-41670,0,0,8412,0,0,,8412,8412
2,01/13/2017,22,5:15,5:30,106.76,,0,106.76,106.76,1,-147409,41264,188673,-106145,0,0,5834,0,0,,5834,5834
2,01/13/2017,23,5:30,5:45,125.02,,0,125.02,125.02,1,-165238,40300,205538,-124938,0,0,61148,0,0,,61148,61148
2,01/13/2017,24,5:45,6:00,59.45,,0,59.45,59.45,1,-161513,53991,215504,-107522,0,0,58172,0,0,,58172,58172
2,01/13/2017,25,6:00,6:15,45.87,,0,45.87,45.87,1,-145945,67641,213586,-78304,0,0,30348,0,0,,30348,30348
2,01/13/2017,26,6:15,6:30,139.02,,0,139.02,139.02,1,-172774,38789,211563,-133985,0,0,16724,0,0,,16724,16724
2,01/13/2017,27,6:30,6:45,250,,0,250,250,1,-138856,37343,176199,-101513,0,0,80324,0,0,,80324,80324
2,01/13/2017,28,6:45,7:00,250,,0,250,250,1,-181034,72747,253781,-108287,0,0,85919,0,0,,85919,85919
2,01/13/2017,29,7:00,7:15,250,33.86,0,33.86,33.86,-1,-167067,138490,305557,-28577,0,-7,63133,0,0,,63140,63126
2,01/13/2017,30,7:15,7:30,250,28.19,0,250,28.19,2,-94248,47309,141557,-46939,0,-360,11460,0,0,,11820,11100
2,01/13/2017,31,7:30,7:45,250,,0,250,250,1,-220649,66030,286679,-154619,0,0,74315,0,0,,74315,74315
2,01/13/2017,32,7:45,8:00,346.98,,0,346.98,346.98,1,-229568,67614,297182,-161954,0,0,89955,5000,0,,94955,94955
2,01/13/2017,33,8:00,8:15,250,,0,250,250,1,-196308,153045,349353,-43263,0,0,72151,13750,0,,85901,85901
2,01/13/2017,34,8:15,8:30,69,13.16,0,69,13.16,2,-87636,94823,182459,7187,0,-4475,9977,0,0,,14452,5502
2,01/13/2017,35,8:30,8:45,69,34.35,0,69,33.81,2,-60263,56263,116526,-4000,0,-48,5723,0,0,,5771,5675
2,01/13/2017,36,8:45,9:00,250,,0,250,250,1,-108127,79069,187196,-29058,0,0,26310,0,0,,26310,26310
2,01/13/2017,37,9:00,9:15,250,-1.03,0,-1.03,-1.03,-1,-74267,108301,182568,34034,0,-13551,6648,0,0,,20199,-6903
2,01/13/2017,38,9:15,9:30,169.04,-1.03,0,169.04,169.04,1,-123257,90581,213838,-32676,0,-1045,14030,0,0,,15075,12985
2,01/13/2017,39,9:30,9:45,146.02,,0,146.02,146.02,1,-147514,93731,241245,-53783,0,0,20978,0,0,,20978,20978
2,01/13/2017,40,9:45,10:00,160.99,,0,160.99,160.99,1,-130522,87034,217556,-43488,0,0,48685,0,0,,48685,48685
2,01/13/2017,41,10:00,10:15,48.02,,0,48.02,48.02,1,-110247,104344,214591,-5903,0,0,28811,0,0,,28811,28811
2,01/13/2017,42,10:15,10:30,64.02,,0,64.02,64.02,1,-140782,119983,260765,-20799,0,0,8322,0,0,,8322,8322
2,01/13/2017,43,10:30,10:45,64.02,,0,64.02,64.02,1,-127934,115683,243617,-12251,0,0,13649,0,0,,13649,13649
2,01/13/2017,44,10:45,11:00,46.4,33.35,0,46.4,33.35,2,-99910,101495,201405,1585,0,-822,2361,0,0,,3183,1539
2,01/13/2017,45,11:00,11:15,80.45,,0,80.45,80.45,1,-102859,90874,193733,-11985,0,0,17120,0,0,,17120,17120
2,01/13/2017,46,11:15,11:30,80.45,28.03,0,28.03,28.03,-1,-76265,88217,164482,11952,0,-9311,999,0,0,,10310,-8312
2,01/13/2017,47,11:30,11:45,41.87,33.35,0,41.87,33.35,2,-77806,78104,155910,298,0,-1136,2530,0,0,,3666,1394
2,01/13/2017,48,11:45,12:00,,24.37,0,24.37,24.37,-1,-60662,109335,169997,48673,0,-23539,0,0,0,,23539,-23539
2,01/13/2017,49,12:00,12:15,,29.35,0,29.35,29.35,-1,-54874,138419,193293,83545,0,-20116,0,0,0,,20116,-20116
2,01/13/2017,50,12:15,12:30,,27.33,0,27.33,27.33,-1,-47426,162978,210404,115552,0,-9880,0,0,0,,9880,-9880
2,01/13/2017,51,12:30,12:45,,25.45,0,25.45,25.45,-1,-40125,166234,206359,126109,0,-31402,0,0,0,,31402,-31402
2,01/13/2017,52,12:45,13:00,,-6.03,0,-6.03,-6.03,-1,-36623,145635,182258,109012,0,-69106,0,0,0,,69106,-69106
2,01/13/2017,53,13:00,13:15,,20.66,0,20.66,20.66,-1,-44298,118819,163117,74521,0,-52008,0,0,0,,52008,-52008
2,01/13/2017,54,13:15,13:30,,-5.03,0,-5.03,-5.03,-1,-44238,151571,195809,107333,0,-28255,0,0,0,,28255,-28255
2,01/13/2017,55,13:30,13:45,,-1.03,0,-1.03,-1.03,-1,-53779,81877,135656,28098,0,-39297,0,0,0,,39297,-39297
2,01/13/2017,56,13:45,14:00,,29.01,0,29.01,29.01,-1,-54534,90706,145240,36172,0,-24295,0,0,0,,24295,-24295
2,01/13/2017,57,14:00,14:15,41.87,33.35,0,41.87,41.87,1,-95230,73847,169077,-21383,0,-13246,1106,0,0,,14352,-12140
2,01/13/2017,58,14:15,14:30,41.23,,0,41.23,41.23,1,-102485,86194,188679,-16291,0,0,1220,0,0,,1220,1220
2,01/13/2017,59,14:30,14:45,,,0,39.23,39.23,0,-121004,107282,228286,-13722,0,0,298,0,0,,298,298
2,01/13/2017,60,14:45,15:00,41.69,,0,41.69,41.69,1,-131824,94160,225984,-37664,0,0,1025,0,0,,1025,1025
2,01/13/2017,61,15:00,15:15,194.87,,0,194.87,194.87,1,-145517,83342,228859,-62175,0,0,31303,0,0,,31303,31303
2,01/13/2017,62,15:15,15:30,51.87,29.35,0,29.35,29.35,-1,-129440,137473,266913,8033,0,-455,21148,0,0,,21603,20693
2,01/13/2017,63,15:30,15:45,39.28,29.35,0,39.28,29.35,2,-141256,101173,242429,-40083,0,-912,471,0,0,,1383,-441
2,01/13/2017,64,15:45,16:00,39.23,,0,39.23,39.23,1,-158194,95510,253704,-62684,0,0,1764,0,0,,1764,1764
2,01/13/2017,65,16:00,16:15,38.84,,0,38.84,38.84,1,-138715,123490,262205,-15225,0,0,164,0,0,,164,164
2,01/13/2017,66,16:15,16:30,,,0,46.79,46.79,0,-114150,116212,230362,2062,0,0,0,0,0,,0,0
2,01/13/2017,67,16:30,16:45,,26.74,0,26.74,26.74,-1,-115803,144669,260472,28866,0,-12144,0,0,0,,12144,-12144
2,01/13/2017,68,16:45,17:00,,33.35,0,33.35,33.35,-1,-135791,134884,270675,-907,0,-13587,0,0,0,,13587,-13587
2,01/13/2017,69,17:00,17:15,54.72,33.35,0,54.72,54.72,1,-125397,105475,230872,-19922,0,-1873,5204,0,0,,7077,3331
2,01/13/2017,70,17:15,17:30,54.72,39.43,0,39.43,39.43,-1,-91901,102718,194619,10817,0,-62,6091,0,0,,6153,6029
2,01/13/2017,71,17:30,17:45,,27.12,0,27.12,27.12,-1,-85805,122812,208617,37007,0,-17653,0,0,0,,17653,-17653
2,01/13/2017,72,17:45,18:00,,35.03,0,35.03,35.03,-1,-94675,107160,201835,12485,0,-9462,0,0,0,,9462,-9462
2,01/13/2017,73,18:00,18:15,,29.35,0,29.35,29.35,-1,-124660,97869,222529,-26791,0,-7699,0,0,0,,7699,-7699
2,01/13/2017,74,18:15,18:30,38.84,33.35,0,45.89,33.35,2,-113421,93872,207293,-19549,0,-236,1121,0,0,,1357,885
2,01/13/2017,75,18:30,18:45,38.84,19.53,0,19.53,19.53,-1,-53292,93844,147136,40552,0,-23900,32,0,0,,23932,-23868
2,01/13/2017,76,18:45,19:00,,29.02,0,29.02,29.02,-1,-80358,85224,165582,4866,0,-28372,0,0,0,,28372,-28372
2,01/13/2017,77,19:00,19:15,39.4,27.78,0,39.4,27.78,2,-80108,99460,179568,19352,0,-18990,83,0,0,,19073,-18907
2,01/13/2017,78,19:15,19:30,51.87,27.78,0,51.87,51.87,1,-103228,95595,198823,-7633,0,-2505,11556,0,0,,14061,9051
2,01/13/2017,79,19:30,19:45,51.87,24.49,0,24.49,24.49,-1,-85068,100839,185907,15771,0,-11769,2810,0,0,,14579,-8959
2,01/13/2017,80,19:45,20:00,,29.35,0,29.35,29.35,-1,-106470,107775,214245,1305,0,-4372,0,0,0,,4372,-4372
2,01/13/2017,81,20:00,20:15,45.87,27.86,0,45.87,27.86,2,-118547,115621,234168,-2926,0,-2669,3166,0,0,,5835,497
2,01/13/2017,82,20:15,20:30,36.39,33.35,0,33.35,33.35,-1,-93118,94395,187513,1277,0,-500,1003,0,0,,1503,503
2,01/13/2017,83,20:30,20:45,,21.5,0,21.5,21.5,-1,-81354,136823,218177,55469,0,-29052,0,0,0,,29052,-29052
2,01/13/2017,84,20:45,21:00,,-8.03,0,-8.03,-8.03,-1,-71742,156038,227780,84296,0,-58539,0,0,0,,58539,-58539
2,01/13/2017,85,21:00,21:15,44.18,-8.03,0,44.18,-8.03,2,-100487,120925,221412,20438,0,-40471,313,0,0,,40784,-40158
2,01/13/2017,86,21:15,21:30,45.47,-8.03,0,45.47,-8.03,2,-61327,133795,195122,72468,0,-9781,859,0,0,,10640,-8922
2,01/13/2017,87,21:30,21:45,,-8.03,0,-8.03,-8.03,-1,-69607,111359,180966,41752,0,-27535,0,0,0,,27535,-27535
2,01/13/2017,88,21:45,22:00,,21.09,0,21.09,21.09,-1,-68631,135763,204394,67132,0,-33348,0,0,0,,33348,-33348
2,01/13/2017,89,22:00,22:15,,20.59,0,20.59,20.59,-1,-82765,122335,205100,39570,0,-28290,0,0,0,,28290,-28290
2,01/13/2017,90,22:15,22:30,,-8.03,0,-8.03,-8.03,-1,-65848,142091,207939,76243,0,-6537,0,0,0,,6537,-6537
2,01/13/2017,91,22:30,22:45,,-8.03,0,-8.03,-8.03,-1,-66205,136463,202668,70258,0,-30527,0,0,0,,30527,-30527
2,01/13/2017,92,22:45,23:00,,-7.03,0,-7.03,-7.03,-1,-44460,162284,206744,117824,0,-25343,0,0,0,,25343,-25343
2,01/13/2017,93,23:00,23:15,40.35,-90.25,0,40.35,-90.25,2,-73489,55993,129482,-17496,0,-29701,826,0,0,,30527,-28875
2,01/13/2017,94,23:15,23:30,40.35,16.36,0,16.36,16.36,-1,-50425,86003,136428,35578,0,-13244,106,0,0,,13350,-13138
2,01/13/2017,95,23:30,23:45,,6.03,0,6.03,6.03,-1,-43761,92742,136503,48981,0,-46642,0,0,0,,46642,-46642
2,01/13/2017,96,23:45,0:00,,-90.09,0,-90.09,-90.09,-1,-45833,87124,132957,41291,0,-63339,0,0,0,,63339,-63339
3,01/14/2017,1,0:00,0:15,38.82,30.49,0,38.82,30.49,2,-82437,73894,156331,-8543,0,-16719,1245,0,0,,17964,-15474
3,01/14/2017,2,0:15,0:30,38.82,19.82,0,19.82,19.82,-1,-51505,72294,123799,20789,0,-8961,8,0,0,,8969,-8953
3,01/14/2017,3,0:30,0:45,,13.28,0,13.28,13.28,-1,-64086,82133,146219,18047,0,-29479,0,0,0,,29479,-29479
3,01/14/2017,4,0:45,1:00,,14.05,0,14.05,14.05,-1,-69165,119959,189124,50794,0,-45860,0,0,0,,45860,-45860
3,01/14/2017,5,1:00,1:15,68.42,27.8,0,68.42,68.42,1,-63760,45879,109639,-17881,0,-22714,3396,0,0,,26110,-19318
3,01/14/2017,6,1:15,1:30,123.12,28.98,0,123.12,28.98,2,-60955,59987,120942,-968,0,-581,20765,0,0,,21346,20184
3,01/14/2017,7,1:30,1:45,123.12,15,0,15,15,-1,-35939,87364,123303,51425,0,-30636,383,0,0,,31019,-30253
3,01/14/2017,8,1:45,2:00,,15.87,0,15.87,15.87,-1,-47614,90514,138128,42900,0,-52363,0,0,0,,52363,-52363
3,01/14/2017,9,2:00,2:15,39.09,26.96,0,39.09,39.09,1,-41660,53158,94818,11498,0,-26975,555,0,0,,27530,-26420
3,01/14/2017,10,2:15,2:30,41.17,26.96,0,41.17,41.17,1,-55193,49469,104662,-5724,0,-403,5207,0,0,,5610,4804
3,01/14/2017,11,2:30,2:45,41.17,29.59,0,29.59,29.59,-1,-45855,65990,111845,20135,0,-7461,1,0,0,,7462,-7460
3,01/14/2017,12,2:45,3:00,,27.04,0,27.04,27.04,-1,-49293,74880,124173,25587,0,-25891,0,0,0,,25891,-25891
3,01/14/2017,13,3:00,3:15,40.01,35.09,0,40.01,40.01,1,-43172,47624,90796,4452,0,-9237,1868,0,0,,11105,-7369
3,01/14/2017,14,3:15,3:30,40.01,,0,40.01,40.01,1,-59615,31403,91018,-28212,0,0,6654,0,0,,6654,6654
3,01/14/2017,15,3:30,3:45,37.2,,0,37.2,37.2,1,-60514,35664,96178,-24850,0,0,2582,0,0,,2582,2582
3,01/14/2017,16,3:45,4:00,,,0,33.2,33.2,0,-49351,41461,90812,-7890,0,0,405,0,0,,405,405
3,01/14/2017,17,4:00,4:15,,28.11,0,28.11,28.11,-1,-37700,65419,103119,27719,0,-3820,0,0,0,,3820,-3820
3,01/14/2017,18,4:15,4:30,,37.55,0,37.55,37.55,-1,-53458,51054,104512,-2404,0,-4079,0,0,0,,4079,-4079
3,01/14/2017,19,4:30,4:45,38.69,37.55,0,38.69,38.69,1,-59428,38608,98036,-20820,0,-640,2250,0,0,,2890,1610
3,01/14/2017,20,4:45,5:00,40.01,,0,40.01,40.01,1,-70852,22572,93424,-48280,0,0,12718,0,0,,12718,12718
3,01/14/2017,21,5:00,5:15,36.12,22.82,0,22.82,22.82,-1,-62595,58482,121077,-4113,0,-2077,5069,0,0,,7146,2992
3,01/14/2017,22,5:15,5:30,,10.68,0,10.68,10.68,-1,-39664,59359,99023,19695,0,-28126,0,0,0,,28126,-28126
3,01/14/2017,23,5:30,5:45,26.8,10.68,0,26.8,26.8,1,-54452,54535,108987,83,0,-2258,34,0,0,,2292,-2224
3,01/14/2017,24,5:45,6:00,44.44,,0,44.44,44.44,1,-72047,40281,112328,-31766,0,0,8778,0,0,,8778,8778
3,01/14/2017,25,6:00,6:15,35.92,33.78,0,35.92,32.49,2,-58124,65583,123707,7459,0,-1467,2638,0,0,,4105,1171
3,01/14/2017,26,6:15,6:30,35.92,37.78,0,35.92,32.49,2,-49448,48810,98258,-638,0,-15,636,0,0,,651,621
3,01/14/2017,27,6:30,6:45,38.69,32.92,0,38.69,32.49,2,-51202,47325,98527,-3877,0,-6324,157,0,0,,6481,-6167
3,01/14/2017,28,6:45,7:00,72.32,32.92,0,72.32,72.32,1,-89138,53491,142629,-35647,0,-65,25409,0,0,,25474,25344
3,01/14/2017,29,7:00,7:15,72.32,-8.78,0,-8.78,-8.78,-1,-55577,150397,205974,94820,0,-27151,6663,0,0,,33814,-20488
3,01/14/2017,30,7:15,7:30,41.17,-3.78,0,41.17,41.17,1,-70446,42498,112944,-27948,0,-30091,1736,0,0,,31827,-28355
3,01/14/2017,31,7:30,7:45,41.17,-3.78,0,41.17,41.17,1,-74076,23732,97808,-50344,0,-49,2524,0,0,,2573,2475
3,01/14/2017,32,7:45,8:00,123.75,,0,123.75,123.75,1,-81220,25496,106716,-55724,0,0,18300,0,0,,18300,18300
3,01/14/2017,33,8:00,8:15,139.45,,0,139.45,139.45,1,-163542,76190,239732,-87352,0,0,55303,0,0,,55303,55303
3,01/14/2017,34,8:15,8:30,41.04,,0,41.04,41.04,1,-91536,55134,146670,-36402,0,0,9452,0,0,,9452,9452
3,01/14/2017,35,8:30,8:45,45.04,,0,45.04,45.04,1,-71893,48237,120130,-23656,0,0,5683,0,0,,5683,5683
3,01/14/2017,36,8:45,9:00,124.12,,0,124.12,124.12,1,-89103,29580,118683,-59523,0,0,37277,0,0,,37277,37277
3,01/14/2017,37,9:00,9:15,79.14,,0,79.14,79.14,1,-105220,63020,168240,-42200,0,0,32173,0,0,,32173,32173
3,01/14/2017,38,9:15,9:30,194.04,,0,194.04,194.04,1,-144621,21814,166435,-122807,0,0,48613,0,0,,48613,48613
3,01/14/2017,39,9:30,9:45,95.12,,0,95.12,95.12,1,-104459,43618,148077,-60841,0,0,40034,0,0,,40034,40034
3,01/14/2017,40,9:45,10:00,78.12,,0,78.12,78.12,1,-89018,44217,133235,-44801,0,0,25916,0,0,,25916,25916
3,01/14/2017,41,10:00,10:15,37.53,30,0,37.53,30,2,-43045,69855,112900,26810,0,-2803,10763,0,0,,13566,7960
3,01/14/2017,42,10:15,10:30,101.93,30,0,101.93,101.93,1,-134635,66476,201111,-68159,0,-385,6327,0,0,,6712,5942
3,01/14/2017,43,10:30,10:45,166.03,,0,166.03,166.03,1,-129759,75501,205260,-54258,0,0,24633,0,0,,24633,24633
3,01/14/2017,44,10:45,11:00,54.94,,0,54.94,54.94,1,-114214,57703,171917,-56511,0,0,15391,0,0,,15391,15391
3,01/14/2017,45,11:00,11:15,39.49,,0,39.49,39.49,1,-114074,67925,181999,-46149,0,0,2707,0,0,,2707,2707
3,01/14/2017,46,11:15,11:30,,,0,38.09,38.09,0,-117483,69624,187107,-47859,0,0,492,0,0,,492,492
3,01/14/2017,47,11:30,11:45,37.14,,0,37.14,37.14,1,-95718,53344,149062,-42374,0,0,684,0,0,,684,684
3,01/14/2017,48,11:45,12:00,37.14,,0,37.14,37.14,1,-93841,66444,160285,-27397,0,0,614,0,0,,614,614
3,01/14/2017,49,12:00,12:15,38.18,,0,38.18,38.18,1,-108436,69548,177984,-38888,0,0,539,0,0,,539,539
3,01/14/2017,50,12:15,12:30,,37.96,0,37.96,37.96,-1,-83604,83680,167284,76,0,-246,0,0,0,,246,-246
3,01/14/2017,51,12:30,12:45,,34.04,0,34.04,34.04,-1,-78685,88658,167343,9973,0,-7740,0,0,0,,7740,-7740
3,01/14/2017,52,12:45,13:00,,31.66,0,31.66,31.66,-1,-79852,77155,157007,-2697,0,-14432,0,0,0,,14432,-14432
3,01/14/2017,53,13:00,13:15,127.12,31.66,0,127.12,127.12,1,-101684,57271,158955,-44413,0,-1111,16893,0,0,,18004,15782
3,01/14/2017,54,13:15,13:30,45.04,,0,45.04,45.04,1,-94772,55053,149825,-39719,0,0,21003,0,0,,21003,21003
3,01/14/2017,55,13:30,13:45,40.01,,0,40.01,40.01,1,-87515,40873,128388,-46642,0,0,868,0,0,,868,868
3,01/14/2017,56,13:45,14:00,41.04,,0,41.04,41.04,1,-80537,55750,136287,-24787,0,0,1007,0,0,,1007,1007
3,01/14/2017,57,14:00,14:15,45.04,,0,45.04,45.04,1,-87913,70510,158423,-17403,0,0,6143,0,0,,6143,6143
3,01/14/2017,58,14:15,14:30,45.04,25.67,0,25.67,25.67,-1,-83403,106509,189912,23106,0,-6672,442,0,0,,7114,-6230
3,01/14/2017,59,14:30,14:45,,24.05,0,24.05,24.05,-1,-62141,87531,149672,25390,0,-28135,0,0,0,,28135,-28135
3,01/14/2017,60,14:45,15:00,,36.98,0,36.98,36.98,-1,-53907,66527,120434,12620,0,-9408,0,0,0,,9408,-9408
3,01/14/2017,61,15:00,15:15,40.01,37.94,0,40.01,37.54,2,-66759,50582,117341,-16177,0,-252,962,0,0,,1214,710
3,01/14/2017,62,15:15,15:30,,28.92,0,28.92,28.92,-1,-74626,97926,172552,23300,0,-8805,0,0,0,,8805,-8805
3,01/14/2017,63,15:30,15:45,,25.62,0,25.62,25.62,-1,-52578,96186,148764,43608,0,-32896,0,0,0,,32896,-32896
3,01/14/2017,64,15:45,16:00,39.3,25.62,0,39.3,39.3,1,-66411,66996,133407,585,0,-28141,263,0,0,,28404,-27878
3,01/14/2017,65,16:00,16:15,45.04,36.9,0,45.79,36.9,2,-69546,73465,143011,3919,0,-1942,4130,0,0,,6072,2188
3,01/14/2017,66,16:15,16:30,,32.78,0,32.78,32.78,-1,-41877,76625,118502,34748,0,-16556,0,0,0,,16556,-16556
3,01/14/2017,67,16:30,16:45,,-12.78,0,-12.78,-12.78,-1,-41198,111475,152673,70277,0,-44675,0,0,0,,44675,-44675
3,01/14/2017,68,16:45,17:00,,20.67,0,20.67,20.67,-1,-67566,99508,167074,31942,0,-37855,0,0,0,,37855,-37855
3,01/14/2017,69,17:00,17:15,,-12.78,0,-12.78,-12.78,-1,-32310,118167,150477,85857,0,-60101,0,0,0,,60101,-60101
3,01/14/2017,70,17:15,17:30,115.12,37.88,0,115.12,115.12,1,-79058,35966,115024,-43092,0,-15885,5965,0,0,,21850,-9920
3,01/14/2017,71,17:30,17:45,194.04,,0,194.04,194.04,1,-66905,41048,107953,-25857,0,0,25392,0,0,,25392,25392
3,01/14/2017,72,17:45,18:00,37.14,32.78,0,44.93,32.78,2,-55947,89021,144968,33074,0,-4945,4663,0,0,,9608,-282
3,01/14/2017,73,18:00,18:15,,37.55,0,37.55,37.55,-1,-60121,57534,117655,-2587,0,-3422,0,0,0,,3422,-3422
3,01/14/2017,74,18:15,18:30,,,0,45.49,45.49,0,-53439,24859,78298,-28580,0,-530,0,0,0,,530,-530
3,01/14/2017,75,18:30,18:45,37.14,,0,37.14,37.14,1,-81276,17055,98331,-64221,0,0,14,0,0,,14,14
3,01/14/2017,76,18:45,19:00,41.04,,0,41.04,41.04,1,-65441,19119,84560,-46322,0,0,4825,0,0,,4825,4825
3,01/14/2017,77,19:00,19:15,194.04,,0,194.04,194.04,1,-106836,16632,123468,-90204,0,0,34057,0,0,,34057,34057
3,01/14/2017,78,19:15,19:30,73.39,19.05,0,19.05,19.05,-1,-51317,57267,108584,5950,0,-794,35324,0,0,,36118,34530
3,01/14/2017,79,19:30,19:45,73.39,12.78,0,12.78,12.78,-1,-47346,75986,123332,28640,0,-9447,1623,0,0,,11070,-7824
3,01/14/2017,80,19:45,20:00,,33.78,0,33.78,33.78,-1,-50318,80895,131213,30577,0,-12263,0,0,0,,12263,-12263
3,01/14/2017,81,20:00,20:15,69,34.04,0,69,33.44,2,-61773,48422,110195,-13351,0,-7503,3109,0,0,,10612,-4394
3,01/14/2017,82,20:15,20:30,138.12,34.04,0,138.12,138.12,1,-79548,38461,118009,-41087,0,-76,34659,0,0,,34735,34583
3,01/14/2017,83,20:30,20:45,38.79,34.04,0,38.79,33.46,2,-53219,63882,117101,10663,0,-1255,11163,0,0,,12418,9908
3,01/14/2017,84,20:45,21:00,,34.04,0,34.04,34.04,-1,-56466,38840,95306,-17626,0,-418,0,0,0,,418,-418
3,01/14/2017,85,21:00,21:15,,21.35,0,21.35,21.35,-1,-41430,87953,129383,46523,0,-8588,0,0,0,,8588,-8588
3,01/14/2017,86,21:15,21:30,,-49.78,0,-49.78,-49.78,-1,-35333,73824,109157,38491,0,-12713,0,0,0,,12713,-12713
3,01/14/2017,87,21:30,21:45,123.98,-49.78,0,123.98,123.98,1,-77155,23016,100171,-54139,0,-18924,6561,0,0,,25485,-12363
3,01/14/2017,88,21:45,22:00,137.12,28.92,0,137.12,28.92,2,-71073,70600,141673,-473,0,-699,23532,0,0,,24231,22833
3,01/14/2017,89,22:00,22:15,137.12,31.6,0,31.6,31.6,-1,-91003,27839,118842,-63164,0,-1394,388,0,0,,1782,-1006
3,01/14/2017,90,22:15,22:30,51.04,,0,51.04,51.04,1,-101545,9743,111288,-91802,0,0,6093,0,0,,6093,6093
3,01/14/2017,91,22:30,22:45,55.51,,0,55.51,55.51,1,-73730,16574,90304,-57156,0,0,39775,0,0,,39775,39775
3,01/14/2017,92,22:45,23:00,51.04,,0,51.04,51.04,1,-51678,14638,66316,-37040,0,0,30965,0,0,,30965,30965
3,01/14/2017,93,23:00,23:15,45.04,32.92,0,45.04,32.92,2,-88046,29021,117067,-59025,0,-401,4833,0,0,,5234,4432
3,01/14/2017,94,23:15,23:30,51.04,,0,51.04,51.04,1,-104788,12998,117786,-91790,0,0,14468,0,0,,14468,14468
3,01/14/2017,95,23:30,23:45,70.09,,0,70.09,70.09,1,-83027,27386,110413,-55641,0,0,16448,0,0,,16448,16448
3,01/14/2017,96,23:45,0:00,38.54,32.92,0,32.92,32.92,-1,-60598,63263,123861,2665,0,-343,6487,0,0,,6830,6144
3,01/15/2017,1,0:00,0:15,27.96,28.92,0,32.99,28.92,2,-78861,83278,162139,4417,0,-2618,113,0,0,,2731,-2505
3,01/15/2017,2,0:15,0:30,51.06,,0,51.06,51.06,1,-93880,55773,149653,-38107,0,0,12901,0,0,,12901,12901
3,01/15/2017,3,0:30,0:45,38.18,,0,38.18,38.18,1,-85803,46744,132547,-39059,0,0,14832,0,0,,14832,14832
3,01/15/2017,4,0:45,1:00,39.64,,0,39.64,39.64,1,-81072,46543,127615,-34529,0,0,6975,0,0,,6975,6975
3,01/15/2017,5,1:00,1:15,128.02,,0,128.02,128.02,1,-114569,41533,156102,-73036,0,0,40168,0,0,,40168,40168
3,01/15/2017,6,1:15,1:30,45.92,37.78,0,37.78,37.78,-1,-82814,69824,152638,-12990,0,-35,31103,0,0,,31138,31068
3,01/15/2017,7,1:30,1:45,39.92,37.88,0,39.92,33.01,2,-83663,60807,144470,-22856,0,-111,3044,0,0,,3155,2933
3,01/15/2017,8,1:45,2:00,39.92,,0,39.92,39.92,1,-59981,61791,121772,1810,0,0,4705,0,0,,4705,4705
3,01/15/2017,9,2:00,2:15,191.02,,0,191.02,191.02,1,-105081,57494,162575,-47587,0,0,15163,0,0,,15163,15163
3,01/15/2017,10,2:15,2:30,190.02,,0,190.02,190.02,1,-104361,61010,165371,-43351,0,0,39630,0,0,,39630,39630
3,01/15/2017,11,2:30,2:45,39.92,,0,39.92,39.92,1,-87351,78213,165564,-9138,0,0,25346,0,0,,25346,25346
3,01/15/2017,12,2:45,3:00,39.64,,0,39.64,39.64,1,-79520,48293,127813,-31227,0,0,4527,0,0,,4527,4527
3,01/15/2017,13,3:00,3:15,39.64,32.92,0,39.64,32.92,2,-65451,67303,132754,1852,0,-410,2311,0,0,,2721,1901
3,01/15/2017,14,3:15,3:30,38.54,,0,38.54,38.54,1,-77342,59290,136632,-18052,0,0,3456,0,0,,3456,3456
3,01/15/2017,15,3:30,3:45,39.92,,0,39.92,39.92,1,-92770,43140,135910,-49630,0,0,10341,0,0,,10341,10341
3,01/15/2017,16,3:45,4:00,37.39,,0,37.39,37.39,1,-105554,40283,145837,-65271,0,0,5874,0,0,,5874,5874
3,01/15/2017,17,4:00,4:15,48.63,,0,48.63,48.63,1,-100633,39326,139959,-61307,0,0,7641,0,0,,7641,7641
3,01/15/2017,18,4:15,4:30,45.92,,0,45.92,45.92,1,-98438,47564,146002,-50874,0,0,14265,0,0,,14265,14265
3,01/15/2017,19,4:30,4:45,38.18,,0,38.18,38.18,1,-83998,55136,139134,-28862,0,0,10744,0,0,,10744,10744
3,01/15/2017,20,4:45,5:00,128.02,,0,128.02,128.02,1,-102180,33811,135991,-68369,0,0,32998,0,0,,32998,32998
3,01/15/2017,21,5:00,5:15,39.92,28.92,0,39.92,28.92,2,-72075,73280,145355,1205,0,-1257,17313,0,0,,18570,16056
3,01/15/2017,22,5:15,5:30,40.02,28.92,0,40.02,40.02,1,-79951,52294,132245,-27657,0,-55,11381,0,0,,11436,11326
3,01/15/2017,23,5:30,5:45,38.02,27.75,0,27.75,27.75,-1,-70026,78594,148620,8568,0,-2937,6605,0,0,,9542,3668
3,01/15/2017,24,5:45,6:00,,32.92,0,32.92,32.92,-1,-67075,58770,125845,-8305,0,-3686,0,0,0,,3686,-3686
3,01/15/2017,25,6:00,6:15,,37.83,0,37.83,37.83,-1,-51358,40297,91655,-11061,0,-613,0,0,0,,613,-613
3,01/15/2017,26,6:15,6:30,,33.78,0,33.78,33.78,-1,-42346,31498,73844,-10848,0,-1941,0,0,0,,1941,-1941
3,01/15/2017,27,6:30,6:45,,37.83,0,37.83,37.83,-1,-71680,33926,105606,-37754,0,-276,0,0,0,,276,-276
3,01/15/2017,28,6:45,7:00,,36.95,0,36.95,36.95,-1,-71702,33230,104932,-38472,0,-163,0,0,0,,163,-163
3,01/15/2017,29,7:00,7:15,,24.99,0,24.99,24.99,-1,-29922,58692,88614,28770,0,-16521,0,0,0,,16521,-16521
3,01/15/2017,30,7:15,7:30,45.78,37.6,0,45.78,45.78,1,-56185,23553,79738,-32632,0,-4780,1717,0,0,,6497,-3063
3,01/15/2017,31,7:30,7:45,45.78,,0,45.78,45.78,1,-108421,60274,168695,-48147,0,0,22493,0,0,,22493,22493
3,01/15/2017,32,7:45,8:00,68.82,,0,68.82,68.82,1,-106781,57764,164545,-49017,0,0,38756,0,0,,38756,38756
3,01/15/2017,33,8:00,8:15,40.31,,0,40.31,40.31,1,-69220,39295,108515,-29925,0,0,18060,0,0,,18060,18060
3,01/15/2017,34,8:15,8:30,40.56,33.56,0,40.56,33.32,2,-37975,36237,74212,-1738,0,-324,1961,0,0,,2285,1637
3,01/15/2017,35,8:30,8:45,37.31,25.25,0,37.31,25.25,2,-35837,37894,73731,2057,0,-16230,8,0,0,,16238,-16222
3,01/15/2017,36,8:45,9:00,137.02,25.25,0,137.02,137.02,1,-82908,24288,107196,-58620,0,-1166,25508,0,0,,26674,24342
3,01/15/2017,37,9:00,9:15,44.56,21.53,0,44.56,21.53,2,-44277,89828,134105,45551,0,-5587,13986,0,0,,19573,8399
3,01/15/2017,38,9:15,9:30,44.56,38.56,0,38.56,38.56,-1,-26387,76100,102487,49713,0,-1289,22,0,0,,1311,-1267
3,01/15/2017,39,9:30,9:45,,,0,33.25,33.25,0,-21182,96669,117851,75487,0,0,0,0,0,,0,0
3,01/15/2017,40,9:45,10:00,37.39,,0,37.39,37.39,1,-56610,78113,134723,21503,0,0,33,0,0,,33,33
3,01/15/2017,41,10:00,10:15,38.74,33.56,0,38.74,33.56,2,-53734,63246,116980,9512,0,-545,1339,0,0,,1884,794
3,01/15/2017,42,10:15,10:30,38.58,31.27,0,38.58,31.27,2,-53556,63488,117044,9932,0,-7789,553,0,0,,8342,-7236
3,01/15/2017,43,10:30,10:45,38.58,35.38,0,35.38,35.38,-1,-39012,55721,94733,16709,0,-4446,339,0,0,,4785,-4107
3,01/15/2017,44,10:45,11:00,42.32,35.38,0,42.32,42.32,1,-53544,38216,91760,-15328,0,-5519,4443,0,0,,9962,-1076
3,01/15/2017,45,11:00,11:15,41.25,29.58,0,29.58,29.58,-1,-29743,69938,99681,40195,0,-8872,5241,0,0,,14113,-3631
3,01/15/2017,46,11:15,11:30,41.25,28.64,0,28.64,28.64,-1,-34341,67608,101949,33267,0,-32406,7,0,0,,32413,-32399
3,01/15/2017,47,11:30,11:45,,33.56,0,33.56,33.56,-1,-41279,73051,114330,31772,0,-25141,0,0,0,,25141,-25141
3,01/15/2017,48,11:45,12:00,,37.56,0,37.56,37.56,-1,-50144,66507,116651,16363,0,-12827,0,0,0,,12827,-12827
3,01/15/2017,49,12:00,12:15,38.08,35,0,38.08,35,2,-63363,75624,138987,12261,0,-3522,36,0,0,,3558,-3486
3,01/15/2017,50,12:15,12:30,39.69,35,0,39.69,39.69,1,-69447,57425,126872,-12022,0,-13,2244,0,0,,2257,2231
3,01/15/2017,51,12:30,12:45,44.56,,0,44.56,44.56,1,-64808,53833,118641,-10975,0,0,9973,0,0,,9973,9973
3,01/15/2017,52,12:45,13:00,38.79,,0,38.79,38.79,1,-63510,60268,123778,-3242,0,0,11099,0,0,,11099,11099
3,01/15/2017,53,13:00,13:15,40.56,,0,40.56,40.56,1,-45473,36781,82254,-8692,0,0,6360,0,0,,6360,6360
3,01/15/2017,54,13:15,13:30,39.69,,0,39.69,39.69,1,-49061,32517,81578,-16544,0,0,3868,0,0,,3868,3868
3,01/15/2017,55,13:30,13:45,49.94,,0,49.94,49.94,1,-46434,28067,74501,-18367,0,0,17010,0,0,,17010,17010
3,01/15/2017,56,13:45,14:00,37.35,37.56,0,37.56,37.56,-1,-41562,37231,78793,-4331,0,-309,5003,0,0,,5312,4694
3,01/15/2017,57,14:00,14:15,37.35,0.56,0,0.56,0.56,-1,-35759,98781,134540,63022,0,-25865,154,0,0,,26019,-25711
3,01/15/2017,58,14:15,14:30,,0.56,0,0.56,0.56,-1,-41101,77522,118623,36421,0,-54569,0,0,0,,54569,-54569
3,01/15/2017,59,14:30,14:45,37.35,37.99,0,37.35,37.35,1,-42550,43715,86265,1165,0,-9633,300,0,0,,9933,-9333
3,01/15/2017,60,14:45,15:00,38.23,38.56,0,38.23,33.01,2,-51002,49308,100310,-1694,0,-181,1741,0,0,,1922,1560
3,01/15/2017,61,15:00,15:15,43.43,38.56,0,43.43,43.43,1,-61487,46755,108242,-14732,0,-41,7120,0,0,,7161,7079
3,01/15/2017,62,15:15,15:30,43.43,37.56,0,37.56,37.56,-1,-38928,46105,85033,7177,0,-907,1188,0,0,,2095,281
3,01/15/2017,63,15:30,15:45,,34.86,0,34.86,34.86,-1,-36138,49912,86050,13774,0,-13080,0,0,0,,13080,-13080
3,01/15/2017,64,15:45,16:00,27.49,37.6,0,27.49,27.49,1,-50236,49271,99507,-965,0,-7217,5,0,0,,7222,-7212
3,01/15/2017,65,16:00,16:15,27.49,26.11,0,26.11,26.11,-1,-37914,72022,109936,34108,0,-14950,1,0,0,,14951,-14949
3,01/15/2017,66,16:15,16:30,,31.27,0,31.27,31.27,-1,-33153,72243,105396,39090,0,-28582,0,0,0,,28582,-28582
3,01/15/2017,67,16:30,16:45,,26.11,0,26.11,26.11,-1,-42805,70230,113035,27425,0,-43472,0,0,0,,43472,-43472
3,01/15/2017,68,16:45,17:00,41.24,26.11,0,41.24,41.24,1,-80229,73322,153551,-6907,0,-8498,1564,0,0,,10062,-6934
3,01/15/2017,69,17:00,17:15,42.38,-23.08,0,46.3,-23.08,2,-32552,89984,122536,57432,0,-25506,764,0,0,,26270,-24742
3,01/15/2017,70,17:15,17:30,161.88,-23.08,0,161.88,161.88,1,-85775,17649,103424,-68126,0,-7833,18632,0,0,,26465,10799
3,01/15/2017,71,17:30,17:45,169.97,,0,169.97,169.97,1,-101938,26286,128224,-75652,0,0,79268,0,0,,79268,79268
3,01/15/2017,72,17:45,18:00,114.02,,0,114.02,114.02,1,-93674,47782,141456,-45892,0,0,62894,0,0,,62894,62894
3,01/15/2017,73,18:00,18:15,66.68,40.76,0,66.68,40.76,2,-54823,36733,91556,-18090,0,-35,29032,0,0,,29067,28997
3,01/15/2017,74,18:15,18:30,41.24,37.56,0,46.3,37.56,2,-53557,46670,100227,-6887,0,-616,3795,0,0,,4411,3179
3,01/15/2017,75,18:30,18:45,36.52,,0,36.52,36.52,1,-61493,53063,114556,-8430,0,0,309,0,0,,309,309
3,01/15/2017,76,18:45,19:00,40.68,35.76,0,46.3,35.76,2,-57973,66333,124306,8360,0,-1582,2421,0,0,,4003,839
3,01/15/2017,77,19:00,19:15,,33.56,0,33.56,33.56,-1,-80558,115654,196212,35096,0,-22683,0,0,0,,22683,-22683
3,01/15/2017,78,19:15,19:30,,35.48,0,35.48,35.48,-1,-54937,70701,125638,15764,0,-20368,0,0,0,,20368,-20368
3,01/15/2017,79,19:30,19:45,,37.56,0,37.56,37.56,-1,-57320,55250,112570,-2070,0,-4814,0,0,0,,4814,-4814
3,01/15/2017,80,19:45,20:00,44.94,56.52,0,44.94,44.94,1,-80006,63932,143938,-16074,0,-693,2955,0,0,,3648,2262
3,01/15/2017,81,20:00,20:15,72.35,,0,72.35,72.35,1,-103914,71842,175756,-32072,0,0,21421,0,0,,21421,21421
3,01/15/2017,82,20:15,20:30,43.12,32.02,0,32.02,32.02,-1,-61392,78245,139637,16853,0,-1049,19881,0,0,,20930,18832
3,01/15/2017,83,20:30,20:45,43.12,16.05,0,16.05,16.05,-1,-35718,65104,100822,29386,0,-27675,1098,0,0,,28773,-26577
3,01/15/2017,84,20:45,21:00,,35.48,0,35.48,35.48,-1,-44956,58118,103074,13162,0,-13893,0,0,0,,13893,-13893
3,01/15/2017,85,21:00,21:15,138.02,36.03,0,138.02,138.02,1,-99588,41954,141542,-57634,0,-6896,12233,0,0,,19129,5337
3,01/15/2017,86,21:15,21:30,138.02,37.56,0,37.56,37.56,-1,-54063,58077,112140,4014,0,-113,21381,0,0,,21494,21268
3,01/15/2017,87,21:30,21:45,138.02,35.76,0,35.76,35.76,-1,-62668,67751,130419,5083,0,-759,391,0,0,,1150,-368
3,01/15/2017,88,21:45,22:00,36.08,33.56,0,37.32,33.56,2,-57261,68786,126047,11525,0,-1398,133,0,0,,1531,-1265
3,01/15/2017,89,22:00,22:15,40.56,31.27,0,40.56,31.27,2,-78489,61348,139837,-17141,0,-7796,836,0,0,,8632,-6960
3,01/15/2017,90,22:15,22:30,40.56,32.95,0,32.95,32.95,-1,-52598,58963,111561,6365,0,-2364,933,0,0,,3297,-1431
3,01/15/2017,91,22:30,22:45,,8.94,0,8.94,8.94,-1,-46367,111160,157527,64793,0,-48772,0,0,0,,48772,-48772
3,01/15/2017,92,22:45,23:00,,33.2,0,33.2,33.2,-1,-38610,56254,94864,17644,0,-39303,0,0,0,,39303,-39303
3,01/15/2017,93,23:00,23:15,50.56,37.31,0,50.56,32.98,2,-73453,59202,132655,-14251,0,-9620,5604,0,0,,15224,-4016
3,01/15/2017,94,23:15,23:30,38.02,37.31,0,38.02,38.02,1,-70652,50077,120729,-20575,0,-13,8562,0,0,,8575,8549
3,01/15/2017,95,23:30,23:45,36.24,,0,36.24,36.24,1,-57118,47668,104786,-9450,0,0,3467,0,0,,3467,3467
3,01/15/2017,96,23:45,0:00,36.24,32.78,0,32.78,32.78,-1,-52406,74585,126991,22179,0,-3763,177,0,0,,3940,-3586
3,01/16/2017,1,0:00,0:15,35.98,32.78,0,35.98,32.78,2,-63859,45968,109827,-17891,0,-4065,119,0,0,,4184,-3946
3,01/16/2017,2,0:15,0:30,28.04,,0,28.04,28.04,1,-50722,39917,90639,-10805,0,0,22,0,0,,22,22
3,01/16/2017,3,0:30,0:45,51.07,,0,51.07,51.07,1,-61969,25026,86995,-36943,0,0,7801,0,0,,7801,7801
3,01/16/2017,4,0:45,1:00,,,0,33.02,33.02,0,-62036,47495,109531,-14541,0,0,429,0,0,,429,429
3,01/16/2017,5,1:00,1:15,64.12,,0,64.12,64.12,1,-80847,32483,113330,-48364,0,0,5885,0,0,,5885,5885
3,01/16/2017,6,1:15,1:30,67.76,37.99,0,67.76,33.03,2,-52351,31696,84047,-20655,0,-8,14932,0,0,,14940,14924
3,01/16/2017,7,1:30,1:45,67.76,37.99,0,37.99,37.99,-1,-43043,42161,85204,-882,0,-404,133,0,0,,537,-271
3,01/16/2017,8,1:45,2:00,,31.46,0,31.46,31.46,-1,-35733,70044,105777,34311,0,-10643,0,0,0,,10643,-10643
3,01/16/2017,9,2:00,2:15,,31.48,0,31.48,31.48,-1,-42068,52249,94317,10181,0,-11811,0,0,0,,11811,-11811
3,01/16/2017,10,2:15,2:30,,35.82,0,35.82,35.82,-1,-44779,49578,94357,4799,0,-195,0,0,0,,195,-195
3,01/16/2017,11,2:30,2:45,,33.87,0,33.87,33.87,-1,-38180,50253,88433,12073,0,-4354,0,0,0,,4354,-4354
3,01/16/2017,12,2:45,3:00,,33.78,0,33.78,33.78,-1,-43485,55962,99447,12477,0,-14397,0,0,0,,14397,-14397
3,01/16/2017,13,3:00,3:15,,32.78,0,32.78,32.78,-1,-47014,62579,109593,15565,0,-15747,0,0,0,,15747,-15747
3,01/16/2017,14,3:15,3:30,,32.78,0,32.78,32.78,-1,-41581,59009,100590,17428,0,-3289,0,0,0,,3289,-3289
3,01/16/2017,15,3:30,3:45,,32.78,0,32.78,32.78,-1,-44248,58689,102937,14441,0,-10079,0,0,0,,10079,-10079
3,01/16/2017,16,3:45,4:00,,33.78,0,33.78,33.78,-1,-42618,53818,96436,11200,0,-10770,0,0,0,,10770,-10770
3,01/16/2017,17,4:00,4:15,,35.82,0,35.82,35.82,-1,-31799,43774,75573,11975,0,-2570,0,0,0,,2570,-2570
3,01/16/2017,18,4:15,4:30,,,0,32.44,32.44,0,-36865,32087,68952,-4778,0,-5,0,0,0,,5,-5
3,01/16/2017,19,4:30,4:45,,,0,32.44,32.44,0,-40734,28578,69312,-12156,0,0,0,0,0,,0,0
3,01/16/2017,20,4:45,5:00,,,0,32.01,32.01,0,-53041,20135,73176,-32906,0,0,0,0,0,,0,0
3,01/16/2017,21,5:00,5:15,,,0,32.45,32.45,0,-83559,66866,150425,-16693,0,0,0,0,0,,0,0
3,01/16/2017,22,5:15,5:30,,,0,32.45,32.45,0,-47272,46995,94267,-277,0,0,0,0,0,,0,0
3,01/16/2017,23,5:30,5:45,,,0,32.45,32.45,0,-50580,16566,67146,-34014,0,0,0,0,0,,0,0
3,01/16/2017,24,5:45,6:00,34.12,,0,34.12,34.12,1,-80675,59377,140052,-21298,0,0,541,0,0,,541,541
3,01/16/2017,25,6:00,6:15,36.93,,0,36.93,36.93,1,-87588,49175,136763,-38413,0,0,797,0,0,,797,797
3,01/16/2017,26,6:15,6:30,36.54,,0,36.54,36.54,1,-63526,46076,109602,-17450,0,0,252,0,0,,252,252
3,01/16/2017,27,6:30,6:45,40.55,,0,40.55,40.55,1,-91692,68593,160285,-23099,0,0,3906,0,0,,3906,3906
3,01/16/2017,28,6:45,7:00,44.55,,0,44.55,44.55,1,-134138,101756,235894,-32382,0,0,11024,0,0,,11024,11024
3,01/16/2017,29,7:00,7:15,36.93,15.21,0,15.21,15.21,-1,-29750,89877,119627,60127,0,-18150,5662,0,0,,23812,-12488
3,01/16/2017,30,7:15,7:30,76.1,33.55,0,76.1,76.1,1,-68467,45986,114453,-22481,0,-16942,3188,0,0,,20130,-13754
3,01/16/2017,31,7:30,7:45,194.05,,0,194.05,194.05,1,-149027,68062,217089,-80965,0,0,50009,0,0,,50009,50009
3,01/16/2017,32,7:45,8:00,194.05,,0,194.05,194.05,1,-207527,74136,281663,-133391,0,0,88335,0,0,,88335,88335
3,01/16/2017,33,8:00,8:15,127.55,-44.26,0,-44.26,-44.26,-1,-35845,155862,191707,120017,0,-11677,44544,0,0,,56221,32867
3,01/16/2017,34,8:15,8:30,36.93,-44.26,0,46.54,-44.26,2,-57712,41024,98736,-16688,0,-30270,128,0,0,,30398,-30142
3,01/16/2017,35,8:30,8:45,37.58,-44.26,0,37.58,37.58,1,-86669,42544,129213,-44125,0,-229,853,0,0,,1082,624
3,01/16/2017,36,8:45,9:00,39.66,,0,39.66,39.66,1,-105030,51448,156478,-53582,0,0,5200,0,0,,5200,5200
3,01/16/2017,37,9:00,9:15,36.93,,0,36.93,36.93,1,-75166,39503,114669,-35663,0,0,1694,0,0,,1694,1694
3,01/16/2017,38,9:15,9:30,76.94,,0,76.94,76.94,1,-96727,37284,134011,-59443,0,0,17481,0,0,,17481,17481
3,01/16/2017,39,9:30,9:45,131.6,,0,131.6,131.6,1,-89651,34762,124413,-54889,0,0,56691,0,0,,56691,56691
3,01/16/2017,40,9:45,10:00,66.78,,0,66.78,66.78,1,-79400,44063,123463,-35337,0,0,41156,0,0,,41156,41156
3,01/16/2017,41,10:00,10:15,70.99,,0,70.99,70.99,1,-89887,46944,136831,-42943,0,0,12537,0,0,,12537,12537
3,01/16/2017,42,10:15,10:30,89.7,,0,89.7,89.7,1,-97204,60403,157607,-36801,0,0,43567,0,0,,43567,43567
3,01/16/2017,43,10:30,10:45,38.49,,0,38.49,38.49,1,-79720,60896,140616,-18824,0,0,15670,0,0,,15670,15670
3,01/16/2017,44,10:45,11:00,,,0,46.54,46.54,0,-78109,55744,133853,-22365,0,0,0,0,0,,0,0
3,01/16/2017,45,11:00,11:15,39.66,,0,39.66,39.66,1,-76644,64366,141010,-12278,0,0,1411,0,0,,1411,1411
3,01/16/2017,46,11:15,11:30,66.94,,0,66.94,66.94,1,-91609,58338,149947,-33271,0,0,20711,0,0,,20711,20711
3,01/16/2017,47,11:30,11:45,55.94,,0,55.94,55.94,1,-92717,63577,156294,-29140,0,0,19762,0,0,,19762,19762
3,01/16/2017,48,11:45,12:00,66.94,,0,66.94,66.94,1,-95720,64587,160307,-31133,0,0,29092,0,0,,29092,29092
3,01/16/2017,49,12:00,12:15,167.89,,0,167.89,167.89,1,-133241,45060,178301,-88181,0,0,33831,0,0,,33831,33831
3,01/16/2017,50,12:15,12:30,39.66,,0,39.66,39.66,1,-88348,31494,119842,-56854,0,0,13316,0,0,,13316,13316
3,01/16/2017,51,12:30,12:45,,,0,46.54,46.54,0,-53270,32308,85578,-20962,0,0,0,0,0,,0,0
3,01/16/2017,52,12:45,13:00,,36.12,0,36.12,36.12,-1,-52801,38719,91520,-14082,0,-166,0,0,0,,166,-166
3,01/16/2017,53,13:00,13:15,36.54,36.12,0,46.54,36.12,2,-82473,32208,114681,-50265,0,-175,358,0,0,,533,183
3,01/16/2017,54,13:15,13:30,37.58,,0,37.58,37.58,1,-89080,25443,114523,-63637,0,0,2714,0,0,,2714,2714
3,01/16/2017,55,13:30,13:45,36.54,,0,36.54,36.54,1,-77045,24584,101629,-52461,0,0,970,0,0,,970,970
3,01/16/2017,56,13:45,14:00,36.54,,0,36.54,36.54,1,-72684,20849,93533,-51835,0,0,680,0,0,,680,680
3,01/16/2017,57,14:00,14:15,51.47,,0,51.47,51.47,1,-73349,16379,89728,-56970,0,0,3659,0,0,,3659,3659
3,01/16/2017,58,14:15,14:30,94.12,,0,94.12,94.12,1,-74406,13712,88118,-60694,0,0,34545,0,0,,34545,34545
3,01/16/2017,59,14:30,14:45,51.47,,0,51.47,51.47,1,-71049,14848,85897,-56201,0,0,20379,0,0,,20379,20379
3,01/16/2017,60,14:45,15:00,38.49,,0,38.49,38.49,1,-80797,26237,107034,-54560,0,0,7492,0,0,,7492,7492
3,01/16/2017,61,15:00,15:15,80.08,,0,80.08,80.08,1,-70239,37559,107798,-32680,0,0,4071,0,0,,4071,4071
3,01/16/2017,62,15:15,15:30,91.08,,0,91.08,91.08,1,-79368,40742,120110,-38626,0,0,17091,0,0,,17091,17091
3,01/16/2017,63,15:30,15:45,,,0,46.54,46.54,0,-77703,42028,119731,-35675,0,0,320,0,0,,320,320
3,01/16/2017,64,15:45,16:00,39.66,,0,39.66,39.66,1,-92227,37673,129900,-54554,0,0,2170,0,0,,2170,2170
3,01/16/2017,65,16:00,16:15,,,0,46.54,46.54,0,-136194,102089,238283,-34105,0,0,30,0,0,,30,30
3,01/16/2017,66,16:15,16:30,,,0,46.53,46.53,0,-110775,61020,171795,-49755,0,0,0,0,0,,0,0
3,01/16/2017,67,16:30,16:45,,,0,46.53,46.53,0,-121911,84284,206195,-37627,0,0,0,0,0,,0,0
3,01/16/2017,68,16:45,17:00,176.83,,0,176.83,176.83,1,-167829,104962,272791,-62867,0,0,7960,0,0,,7960,7960
3,01/16/2017,69,17:00,17:15,237.95,,0,237.95,237.95,1,-129826,68418,198244,-61408,0,0,19179,0,0,,19179,19179
3,01/16/2017,70,17:15,17:30,237.95,,0,237.95,237.95,1,-131838,47502,179340,-84336,0,0,14253,0,0,,14253,14253
3,01/16/2017,71,17:30,17:45,237.95,,0,237.95,237.95,1,-133303,52948,186251,-80355,0,0,45162,0,0,,45162,45162
3,01/16/2017,72,17:45,18:00,132.5,,0,132.5,132.5,1,-112638,67793,180431,-44845,0,0,51293,0,0,,51293,51293
3,01/16/2017,73,18:00,18:15,258.96,,0,258.96,258.96,1,-228785,52329,281114,-176456,0,0,62074,0,0,,62074,62074
3,01/16/2017,74,18:15,18:30,314.76,,0,346.24,346.24,1,-242618,80343,322961,-162275,0,0,86042,1250,8334,,95626,95626
3,01/16/2017,75,18:30,18:45,224.83,,0,324.83,324.83,1,-209155,98698,307853,-110457,0,0,48530,1250,12501,,62281,62281
3,01/16/2017,76,18:45,19:00,314.76,,0,346.24,346.24,1,-191188,97270,288458,-93918,0,0,53391,1250,21359,,76000,76000
3,01/16/2017,77,19:00,19:15,287.74,,0,316.51,316.51,1,-197771,88558,286329,-109213,0,0,50399,2500,26250,,79149,79149
3,01/16/2017,78,19:15,19:30,263.04,,0,313.04,313.04,1,-175197,113103,288300,-62094,0,0,49844,2500,26250,,78594,78594
3,01/16/2017,79,19:30,19:45,40.99,,0,313.04,313.04,1,-169862,114747,284609,-55115,0,0,16742,0,14137,,30879,30879
3,01/16/2017,80,19:45,20:00,36.93,,0,36.93,36.93,1,-162839,89208,252047,-73631,0,0,3699,0,2175,,5874,5874
3,01/16/2017,81,20:00,20:15,,,0,45.39,45.39,0,-80758,120447,201205,39689,0,0,0,0,0,,0,0
3,01/16/2017,82,20:15,20:30,,34.73,0,34.73,34.73,-1,-79160,94597,173757,15437,0,-3572,0,0,0,,3572,-3572
3,01/16/2017,83,20:30,20:45,,34.73,0,34.73,34.73,-1,-72366,77681,150047,5315,0,-4104,0,0,0,,4104,-4104
3,01/16/2017,84,20:45,21:00,,34.82,0,34.82,34.82,-1,-84944,80537,165481,-4407,0,-17673,0,0,0,,17673,-17673
3,01/16/2017,85,21:00,21:15,194.05,34.82,0,194.05,194.05,1,-135948,65494,201442,-70454,0,-3244,15558,0,0,,18802,12314
3,01/16/2017,86,21:15,21:30,42.78,32.95,0,32.95,32.95,-1,-68167,92362,160529,24195,0,-1091,10804,0,0,,11895,9713
3,01/16/2017,87,21:30,21:45,,30.4,0,30.4,30.4,-1,-54298,86537,140835,32239,0,-9421,0,0,0,,9421,-9421
3,01/16/2017,88,21:45,22:00,,33.95,0,33.95,33.95,-1,-70937,89493,160430,18556,0,-16606,0,0,0,,16606,-16606
3,01/16/2017,89,22:00,22:15,53.12,36.28,0,53.12,34.34,2,-129403,82059,211462,-47344,0,-7367,7384,0,0,,14751,17
3,01/16/2017,90,22:15,22:30,45.05,,0,45.05,45.05,1,-131576,94151,225727,-37425,0,0,16610,0,0,,16610,16610
3,01/16/2017,91,22:30,22:45,45.05,35.89,0,35.89,35.89,-1,-103144,108683,211827,5539,0,-1889,2337,0,0,,4226,448
3,01/16/2017,92,22:45,23:00,,33.55,0,33.55,33.55,-1,-78657,122114,200771,43457,0,-7451,0,0,0,,7451,-7451
3,01/16/2017,93,23:00,23:15,126.12,33.55,0,126.12,126.12,1,-105825,57179,163004,-48646,0,-6710,9840,0,0,,16550,3130
3,01/16/2017,94,23:15,23:30,126.12,37.55,0,37.55,37.55,-1,-70017,64037,134054,-5980,0,-93,13899,0,0,,13992,13806
3,01/16/2017,95,23:30,23:45,126.12,34.99,0,34.99,34.99,-1,-56580,77075,133655,20495,0,-5312,10,0,0,,5322,-5302
3,01/16/2017,96,23:45,0:00,,27.24,0,27.24,27.24,-1,-64252,98023,162275,33771,0,-22021,0,0,0,,22021,-22021
3,01/17/2017,1,0:00,0:15,,14.29,0,14.29,14.29,-1,-56192,132768,188960,76576,0,-32469,0,0,0,,32469,-32469
3,01/17/2017,2,0:15,0:30,37.92,36.38,0,37.92,32.15,2,-74707,40067,114774,-34640,0,-2136,345,0,0,,2481,-1791
3,01/17/2017,3,0:30,0:45,40.15,,0,40.15,40.15,1,-65226,40075,105301,-25151,0,0,1919,0,0,,1919,1919
3,01/17/2017,4,0:45,1:00,37.03,36.77,0,37.03,32.15,2,-59658,65042,124700,5384,0,-64,147,0,0,,211,83
3,01/17/2017,5,1:00,1:15,44.55,36.77,0,44.55,32.22,2,-65547,34768,100315,-30779,0,-266,7574,0,0,,7840,7308
3,01/17/2017,6,1:15,1:30,44.55,,0,44.55,44.55,1,-63145,35461,98606,-27684,0,0,20654,0,0,,20654,20654
3,01/17/2017,7,1:30,1:45,,,0,32.22,32.22,0,-65424,41341,106765,-24083,0,0,1754,0,0,,1754,1754
3,01/17/2017,8,1:45,2:00,,,0,32.22,32.22,0,-65787,52941,118728,-12846,0,0,0,0,0,,0,0
3,01/17/2017,9,2:00,2:15,47.43,,0,47.43,47.43,1,-75164,13728,88892,-61436,0,0,10365,0,0,,10365,10365
3,01/17/2017,10,2:15,2:30,40.15,,0,40.15,40.15,1,-67048,16361,83409,-50687,0,0,22512,0,0,,22512,22512
3,01/17/2017,11,2:30,2:45,37.42,,0,37.42,37.42,1,-55119,20188,75307,-34931,0,0,10324,0,0,,10324,10324
3,01/17/2017,12,2:45,3:00,38.07,,0,38.07,38.07,1,-60600,57264,117864,-3336,0,0,1506,0,0,,1506,1506
3,01/17/2017,13,3:00,3:15,124.02,,0,124.02,124.02,1,-155899,10283,166182,-145616,0,0,54082,0,0,,54082,54082
3,01/17/2017,14,3:15,3:30,124.02,,0,124.02,124.02,1,-106010,36209,142219,-69801,0,0,101709,0,0,,101709,101709
3,01/17/2017,15,3:30,3:45,37.92,,0,37.92,37.92,1,-73880,44679,118559,-29201,0,0,21401,0,0,,21401,21401
3,01/17/2017,16,3:45,4:00,53.21,,0,53.21,53.21,1,-90895,38854,129749,-52041,0,0,18049,0,0,,18049,18049
3,01/17/2017,17,4:00,4:15,71.02,,0,71.02,71.02,1,-91869,53601,145470,-38268,0,0,47241,0,0,,47241,47241
3,01/17/2017,18,4:15,4:30,47.43,,0,47.43,47.43,1,-115577,74128,189705,-41449,0,0,14305,0,0,,14305,14305
3,01/17/2017,19,4:30,4:45,50.55,,0,50.55,50.55,1,-135666,74167,209833,-61499,0,0,33178,0,0,,33178,33178
3,01/17/2017,20,4:45,5:00,50.55,,0,50.55,50.55,1,-136094,88101,224195,-47993,0,0,54445,0,0,,54445,54445
3,01/17/2017,21,5:00,5:15,37.23,32.22,0,32.22,32.22,-1,-141277,122517,263794,-18760,0,-1334,17367,0,0,,18701,16033
3,01/17/2017,22,5:15,5:30,,30.03,0,30.03,30.03,-1,-96447,95765,192212,-682,0,-9280,0,0,0,,9280,-9280
3,01/17/2017,23,5:30,5:45,39.9,30.03,0,39.9,39.9,1,-115832,84108,199940,-31724,0,-349,2517,0,0,,2866,2168
3,01/17/2017,24,5:45,6:00,53.71,,0,53.71,53.71,1,-124327,81265,205592,-43062,0,0,19786,0,0,,19786,19786
3,01/17/2017,25,6:00,6:15,53.71,-54.26,0,-54.26,-54.26,-1,-75732,242818,318550,167086,0,-54490,3874,0,0,,58364,-50616
3,01/17/2017,26,6:15,6:30,,26.19,0,26.19,26.19,-1,-75804,109803,185607,33999,0,-42875,0,0,0,,42875,-42875
3,01/17/2017,27,6:30,6:45,,36.57,0,36.57,36.57,-1,-89782,97517,187299,7735,0,-6493,0,0,0,,6493,-6493
3,01/17/2017,28,6:45,7:00,75.74,36.57,0,75.74,75.74,1,-142944,83143,226087,-59801,0,-213,11826,0,0,,12039,11613
3,01/17/2017,29,7:00,7:15,37.42,-44.71,0,45.17,-44.71,2,-44073,180812,224885,136739,0,-24279,4045,0,0,,28324,-20234
3,01/17/2017,30,7:15,7:30,,35.73,0,35.73,35.73,-1,-75290,89313,164603,14023,0,-3936,0,0,0,,3936,-3936
3,01/17/2017,31,7:30,7:45,193.8,,0,193.8,193.8,1,-125407,81772,207179,-43635,0,0,7493,0,0,,7493,7493
3,01/17/2017,32,7:45,8:00,193.8,,0,193.8,193.8,1,-186099,55588,241687,-130511,0,0,69224,0,0,,69224,69224
3,01/17/2017,33,8:00,8:15,70,35.31,0,70,35.31,2,-121940,114588,236528,-7352,0,-1127,30442,0,0,,31569,29315
3,01/17/2017,34,8:15,8:30,123.12,,0,123.12,123.12,1,-120782,97929,218711,-22853,0,0,23161,0,0,,23161,23161
3,01/17/2017,35,8:30,8:45,40.15,,0,40.15,40.15,1,-102767,103738,206505,971,0,0,7920,0,0,,7920,7920
3,01/17/2017,36,8:45,9:00,37.03,,0,37.03,37.03,1,-91389,98830,190219,7441,0,0,600,0,0,,600,600
3,01/17/2017,37,9:00,9:15,,36.69,0,36.69,36.69,-1,-74316,101190,175506,26874,0,-208,0,0,0,,208,-208
3,01/17/2017,38,9:15,9:30,,36.38,0,36.38,36.38,-1,-79016,77905,156921,-1111,0,-823,0,0,0,,823,-823
3,01/17/2017,39,9:30,9:45,,52.89,0,52.89,52.89,-1,-77574,80698,158272,3124,0,-113,0,0,0,,113,-113
3,01/17/2017,40,9:45,10:00,,36.77,0,36.77,36.77,-1,-75270,78634,153904,3364,0,-894,0,0,0,,894,-894
3,01/17/2017,41,10:00,10:15,88.75,,0,88.75,88.75,1,-76718,54092,130810,-22626,0,0,5549,0,0,,5549,5549
3,01/17/2017,42,10:15,10:30,38.98,,0,38.98,38.98,1,-80086,67406,147492,-12680,0,0,5191,0,0,,5191,5191
3,01/17/2017,43,10:30,10:45,,,0,45.16,45.16,0,-85129,68525,153654,-16604,0,0,624,0,0,,624,624
3,01/17/2017,44,10:45,11:00,38.98,,0,38.98,38.98,1,-94480,60486,154966,-33994,0,0,1144,0,0,,1144,1144
3,01/17/2017,45,11:00,11:15,231.8,,0,231.8,231.8,1,-83239,19023,102262,-64216,0,0,18303,0,0,,18303,18303
3,01/17/2017,46,11:15,11:30,43.27,,0,43.27,43.27,1,-50956,21061,72017,-29895,0,0,12066,0,0,,12066,12066
3,01/17/2017,47,11:30,11:45,38.07,,0,38.07,38.07,1,-54134,21203,75337,-32931,0,0,2949,0,0,,2949,2949
3,01/17/2017,48,11:45,12:00,40.15,,0,40.15,40.15,1,-59607,31497,91104,-28110,0,0,4265,0,0,,4265,4265
3,01/17/2017,49,12:00,12:15,77.94,,0,77.94,77.94,1,-91427,34546,125973,-56881,0,0,8114,0,0,,8114,8114
3,01/17/2017,50,12:15,12:30,38.07,,0,38.07,38.07,1,-77552,27670,105222,-49882,0,0,3825,0,0,,3825,3825
3,01/17/2017,51,12:30,12:45,37.03,,0,37.03,37.03,1,-68777,48877,117654,-19900,0,0,668,0,0,,668,668
3,01/17/2017,52,12:45,13:00,,40.51,0,40.51,40.51,-1,-64223,52603,116826,-11620,0,-72,0,0,0,,72,-72
3,01/17/2017,53,13:00,13:15,,38.26,0,38.26,38.26,-1,-42233,73731,115964,31498,0,-1972,0,0,0,,1972,-1972
3,01/17/2017,54,13:15,13:30,,36.38,0,36.38,36.38,-1,-41955,64689,106644,22734,0,-824,0,0,0,,824,-824
3,01/17/2017,55,13:30,13:45,,35.22,0,35.22,35.22,-1,-50465,67239,117704,16774,0,-1990,0,0,0,,1990,-1990
3,01/17/2017,56,13:45,14:00,,34.03,0,34.03,34.03,-1,-53544,69747,123291,16203,0,-14226,0,0,0,,14226,-14226
3,01/17/2017,57,14:00,14:15,,35.22,0,35.22,35.22,-1,-51702,59691,111393,7989,0,-13406,0,0,0,,13406,-13406
3,01/17/2017,58,14:15,14:30,,53.34,0,53.34,53.34,-1,-47870,63854,111724,15984,0,-173,0,0,0,,173,-173
3,01/17/2017,59,14:30,14:45,,35.22,0,35.22,35.22,-1,-49125,68655,117780,19530,0,-2566,0,0,0,,2566,-2566
3,01/17/2017,60,14:45,15:00,,35.22,0,35.22,35.22,-1,-45461,66337,111798,20876,0,-6625,0,0,0,,6625,-6625
3,01/17/2017,61,15:00,15:15,,33.03,0,33.03,33.03,-1,-48502,78952,127454,30450,0,-5359,0,0,0,,5359,-5359
3,01/17/2017,62,15:15,15:30,,33.03,0,33.03,33.03,-1,-47848,66132,113980,18284,0,-8289,0,0,0,,8289,-8289
3,01/17/2017,63,15:30,15:45,38.98,53.37,0,45.2,45.2,2,-45413,48076,93489,2663,0,-2470,989,0,0,,3459,-1481
3,01/17/2017,64,15:45,16:00,38.98,,0,38.98,38.98,1,-58830,52159,110989,-6671,0,0,1279,0,0,,1279,1279
3,01/17/2017,65,16:00,16:15,,34.03,0,34.03,34.03,-1,-67670,89904,157574,22234,0,-6190,0,0,0,,6190,-6190
3,01/17/2017,66,16:15,16:30,,36.38,0,36.38,36.38,-1,-70642,84651,155293,14009,0,-1505,0,0,0,,1505,-1505
3,01/17/2017,67,16:30,16:45,,35.22,0,35.22,35.22,-1,-78445,98864,177309,20419,0,-6628,0,0,0,,6628,-6628
3,01/17/2017,68,16:45,17:00,40.15,35.22,0,40.15,40.15,1,-84974,104619,189593,19645,0,-566,499,0,0,,1065,-67
3,01/17/2017,69,17:00,17:15,41.58,33.03,0,45.18,33.03,2,-90058,94629,184687,4571,0,-7163,849,0,0,,8012,-6314
3,01/17/2017,70,17:15,17:30,355.9,33.03,0,355.9,355.9,1,-93293,44726,138019,-48567,0,-425,23884,0,0,,24309,23459
3,01/17/2017,71,17:30,17:45,355.91,53.32,0,53.32,53.32,-1,-79846,73274,153120,-6572,0,-3,38079,0,0,,38082,38076
3,01/17/2017,72,17:45,18:00,198.18,36.38,0,198.18,36.38,2,-74680,65942,140622,-8738,0,-764,7365,0,0,,8129,6601
3,01/17/2017,73,18:00,18:15,366.84,,0,366.84,366.84,1,-140595,18781,159376,-121814,0,0,37709,0,0,,37709,37709
3,01/17/2017,74,18:15,18:30,366.84,,0,366.84,366.84,1,-113911,43410,157321,-70501,0,0,32970,0,0,,32970,32970
3,01/17/2017,75,18:30,18:45,366.84,35.22,0,35.22,35.22,-1,-79234,51926,131160,-27308,0,-14,26622,0,0,,26636,26608
3,01/17/2017,76,18:45,19:00,153.55,35.22,0,153.55,35.22,2,-77712,60098,137810,-17614,0,-56,2735,0,0,,2791,2679
3,01/17/2017,77,19:00,19:15,291.2,,0,291.2,291.2,1,-83456,65165,148621,-18291,0,0,21054,0,0,,21054,21054
3,01/17/2017,78,19:15,19:30,291.2,34.03,0,34.03,34.03,-1,-64897,76822,141719,11925,0,-1868,2590,0,0,,4458,722
3,01/17/2017,79,19:30,19:45,,33.03,0,33.03,33.03,-1,-68629,83464,152093,14835,0,-13448,0,0,0,,13448,-13448
3,01/17/2017,80,19:45,20:00,,36.38,0,36.38,36.38,-1,-74913,75370,150283,457,0,-8542,0,0,0,,8542,-8542
3,01/17/2017,81,20:00,20:15,193.8,36.38,0,193.8,193.8,1,-122107,62437,184544,-59670,0,-164,19920,0,0,,20084,19756
3,01/17/2017,82,20:15,20:30,66.1,52.92,0,52.92,52.92,-1,-102827,76601,179428,-26226,0,-13,29714,0,0,,29727,29701
3,01/17/2017,83,20:30,20:45,66.1,33.03,0,33.03,33.03,-1,-87313,92727,180040,5414,0,-7554,1600,0,0,,9154,-5954
3,01/17/2017,84,20:45,21:00,,33.03,0,33.03,33.03,-1,-75245,89586,164831,14341,0,-5289,0,0,0,,5289,-5289
3,01/17/2017,85,21:00,21:15,193.8,36.4,0,193.8,36.4,2,-158498,87188,245686,-71310,0,-2611,19336,0,0,,21947,16725
3,01/17/2017,86,21:15,21:30,40.8,,0,40.8,40.8,1,-132440,98487,230927,-33953,0,0,16701,0,0,,16701,16701
3,01/17/2017,87,21:30,21:45,37.42,,0,37.42,37.42,1,-110682,99276,209958,-11406,0,0,6864,0,0,,6864,6864
3,01/17/2017,88,21:45,22:00,37.42,33.65,0,33.65,33.65,-1,-114302,114641,228943,339,0,-3441,76,0,0,,3517,-3365
3,01/17/2017,89,22:00,22:15,193.8,33.03,0,193.8,33.03,2,-145923,67145,213068,-78778,0,-7021,13283,0,0,,20304,6262
3,01/17/2017,90,22:15,22:30,193.8,34.69,0,193.8,33.74,2,-123195,96244,219439,-26951,0,-289,43803,0,0,,44092,43514
3,01/17/2017,91,22:30,22:45,193.8,27.99,0,27.99,27.99,-1,-79675,107906,187581,28231,0,-25770,1116,0,0,,26886,-24654
3,01/17/2017,92,22:45,23:00,,31.03,0,31.03,31.03,-1,-81692,111111,192803,29419,0,-18898,0,0,0,,18898,-18898
3,01/17/2017,93,23:00,23:15,50.8,29.69,0,50.8,50.8,1,-128808,80900,209708,-47908,0,-16363,2965,0,0,,19328,-13398
3,01/17/2017,94,23:15,23:30,37.23,29.69,0,37.23,37.23,1,-130003,80694,210697,-49309,0,-277,2785,0,0,,3062,2508
3,01/17/2017,95,23:30,23:45,,,0,32.49,32.49,0,-101550,84207,185757,-17343,0,0,320,0,0,,320,320
3,01/17/2017,96,23:45,0:00,,36.38,0,36.38,36.38,-1,-91327,81399,172726,-9928,0,-152,0,0,0,,152,-152
3,01/18/2017,1,0:00,0:15,37.33,35.02,0,37.33,33.45,2,-83783,77373,161156,-6410,0,-1019,889,0,0,,1908,-130
3,01/18/2017,2,0:15,0:30,40.8,,0,40.8,40.8,1,-71454,39246,110700,-32208,0,0,13999,0,0,,13999,13999
3,01/18/2017,3,0:30,0:45,,,0,33.37,33.37,0,-74199,44266,118465,-29933,0,0,2314,0,0,,2314,2314
3,01/18/2017,4,0:45,1:00,,,0,33.37,33.37,0,-94451,57652,152103,-36799,0,0,0,0,0,,0,0
3,01/18/2017,5,1:00,1:15,38.76,,0,38.76,38.76,1,-84502,60665,145167,-23837,0,0,1453,0,0,,1453,1453
3,01/18/2017,6,1:15,1:30,38.79,,0,38.79,38.79,1,-99440,40416,139856,-59024,0,0,4770,0,0,,4770,4770
3,01/18/2017,7,1:30,1:45,40.8,,0,40.8,40.8,1,-83522,39752,123274,-43770,0,0,1150,0,0,,1150,1150
3,01/18/2017,8,1:45,2:00,40.99,,0,40.99,40.99,1,-76241,50248,126489,-25993,0,0,3389,0,0,,3389,3389
3,01/18/2017,9,2:00,2:15,123.12,,0,123.12,123.12,1,-94802,32956,127758,-61846,0,0,19934,0,0,,19934,19934
3,01/18/2017,10,2:15,2:30,51.05,,0,51.05,51.05,1,-81145,41195,122340,-39950,0,0,29493,0,0,,29493,29493
3,01/18/2017,11,2:30,2:45,45.05,,0,45.05,45.05,1,-97692,45753,143445,-51939,0,0,5168,0,0,,5168,5168
3,01/18/2017,12,2:45,3:00,34.41,,0,34.41,34.41,1,-89639,46570,136209,-43069,0,0,2119,0,0,,2119,2119
3,01/18/2017,13,3:00,3:15,51.05,,0,51.05,51.05,1,-75335,53114,128449,-22221,0,0,9519,0,0,,9519,9519
3,01/18/2017,14,3:15,3:30,35.39,39.05,0,39.05,39.05,-1,-57167,56867,114034,-300,0,-47,7173,0,0,,7220,7126
3,01/18/2017,15,3:30,3:45,35.39,39.05,0,39.05,39.05,-1,-69019,63463,132482,-5556,0,-288,64,0,0,,352,-224
3,01/18/2017,16,3:45,4:00,34.6,,0,34.6,34.6,1,-79813,61728,141541,-18085,0,0,618,0,0,,618,618
3,01/18/2017,17,4:00,4:15,36.16,,0,36.16,36.16,1,-70911,46008,116919,-24903,0,0,2149,0,0,,2149,2149
3,01/18/2017,18,4:15,4:30,34.41,,0,34.41,34.41,1,-86602,44626,131228,-41976,0,0,2240,0,0,,2240,2240
3,01/18/2017,19,4:30,4:45,53.72,,0,53.72,53.72,1,-97713,36256,133969,-61457,0,0,10059,0,0,,10059,10059
3,01/18/2017,20,4:45,5:00,67.12,,0,67.12,67.12,1,-83230,60088,143318,-23142,0,0,19623,0,0,,19623,19623
3,01/18/2017,21,5:00,5:15,67.12,32,0,32,32,-1,-58494,73564,132058,15070,0,-8038,1280,0,0,,9318,-6758
3,01/18/2017,22,5:15,5:30,,33.78,0,33.78,33.78,-1,-73355,54281,127636,-19074,0,-10213,0,0,0,,10213,-10213
3,01/18/2017,23,5:30,5:45,27.76,,0,27.76,27.76,1,-72366,33842,106208,-38524,0,0,17,0,0,,17,17
3,01/18/2017,24,5:45,6:00,34.13,34.05,0,34.13,33.41,2,-69704,52383,122087,-17321,0,-79,312,0,0,,391,233
3,01/18/2017,25,6:00,6:15,36.16,34.05,0,36.16,36.16,1,-123639,81773,205412,-41866,0,-82,688,0,0,,770,606
3,01/18/2017,26,6:15,6:30,,34.78,0,34.78,34.78,-1,-91499,84017,175516,-7482,0,-671,0,0,0,,671,-671
3,01/18/2017,27,6:30,6:45,84.55,34.78,0,84.55,84.55,1,-119680,59558,179238,-60122,0,-2,6530,0,0,,6532,6528
3,01/18/2017,28,6:45,7:00,186.22,,0,186.22,186.22,1,-166697,66845,233542,-99852,0,0,49701,0,0,,49701,49701
3,01/18/2017,29,7:00,7:15,186.22,-25.45,0,-25.45,-25.45,-1,-51822,134107,185929,82285,0,-35196,5454,0,0,,40650,-29742
3,01/18/2017,30,7:15,7:30,,33.69,0,33.69,33.69,-1,-81151,73170,154321,-7981,0,-6719,0,0,0,,6719,-6719
3,01/18/2017,31,7:30,7:45,61.21,50.48,0,61.21,61.21,1,-138915,53164,192079,-85751,0,-792,2366,0,0,,3158,1574
3,01/18/2017,32,7:45,8:00,185.62,,0,185.62,185.62,1,-186425,49009,235434,-137416,0,0,56433,0,0,,56433,56433
3,01/18/2017,33,8:00,8:15,143.56,,0,143.56,143.56,1,-106891,70045,176936,-36846,0,0,58772,0,0,,58772,58772
3,01/18/2017,34,8:15,8:30,185.62,,0,185.62,185.62,1,-133723,57347,191070,-76376,0,0,49799,0,0,,49799,49799
3,01/18/2017,35,8:30,8:45,61.12,,0,61.12,61.12,1,-120993,55348,176341,-65645,0,0,41597,0,0,,41597,41597
3,01/18/2017,36,8:45,9:00,185.62,,0,185.62,185.62,1,-137664,50226,187890,-87438,0,0,50052,0,0,,50052,50052
3,01/18/2017,37,9:00,9:15,175.84,,0,175.84,175.84,1,-77324,48540,125864,-28784,0,0,52562,0,0,,52562,52562
3,01/18/2017,38,9:15,9:30,112.12,,0,112.12,112.12,1,-86058,43250,129308,-42808,0,0,11939,0,0,,11939,11939
3,01/18/2017,39,9:30,9:45,175.84,,0,175.84,175.84,1,-86278,38471,124749,-47807,0,0,46878,0,0,,46878,46878
3,01/18/2017,40,9:45,10:00,56.12,,0,56.12,56.12,1,-78505,34719,113224,-43786,0,0,25320,0,0,,25320,25320
3,01/18/2017,41,10:00,10:15,,,0,42.35,42.35,0,-72254,51271,123525,-20983,0,0,4464,0,0,,4464,4464
3,01/18/2017,42,10:15,10:30,,,0,42.35,42.35,0,-76266,52147,128413,-24119,0,0,0,0,0,,0,0
3,01/18/2017,43,10:30,10:45,,,0,42.35,42.35,0,-77915,42020,119935,-35895,0,0,0,0,0,,0,0
3,01/18/2017,44,10:45,11:00,,,0,42.35,42.35,0,-83889,38074,121963,-45815,0,0,0,0,0,,0,0
3,01/18/2017,45,11:00,11:15,164.29,,0,164.29,164.29,1,-93438,22877,116315,-70561,0,0,17349,0,0,,17349,17349
3,01/18/2017,46,11:15,11:30,164.29,,0,164.29,164.29,1,-75570,27655,103225,-47915,0,0,35952,0,0,,35952,35952
3,01/18/2017,47,11:30,11:45,101.12,,0,101.12,101.12,1,-88883,25165,114048,-63718,0,0,22604,0,0,,22604,22604
3,01/18/2017,48,11:45,12:00,101.12,,0,101.12,101.12,1,-81984,24062,106046,-57922,0,0,31257,0,0,,31257,31257
3,01/18/2017,49,12:00,12:15,48.09,,0,48.09,48.09,1,-110374,34108,144482,-76266,0,0,16551,0,0,,16551,16551
3,01/18/2017,50,12:15,12:30,,,0,42.36,42.36,0,-114981,35840,150821,-79141,0,0,397,0,0,,397,397
3,01/18/2017,51,12:30,12:45,173.13,,0,173.13,173.13,1,-107017,42308,149325,-64709,0,0,19881,0,0,,19881,19881
3,01/18/2017,52,12:45,13:00,50.12,,0,50.12,50.12,1,-73906,53884,127790,-20022,0,0,12512,0,0,,12512,12512
3,01/18/2017,53,13:00,13:15,108.7,,0,108.7,108.7,1,-107372,36345,143717,-71027,0,0,10933,0,0,,10933,10933
3,01/18/2017,54,13:15,13:30,101.12,,0,101.12,101.12,1,-115911,35784,151695,-80127,0,0,24642,0,0,,24642,24642
3,01/18/2017,55,13:30,13:45,97.02,,0,97.02,97.02,1,-89972,43922,133894,-46050,0,0,35561,0,0,,35561,35561
3,01/18/2017,56,13:45,14:00,50.69,50.51,0,50.51,50.51,-1,-77161,60465,137626,-16696,0,-18,22144,0,0,,22162,22126
3,01/18/2017,57,14:00,14:15,50.69,35.81,0,35.81,35.81,-1,-64186,88635,152821,24449,0,-2634,727,0,0,,3361,-1907
3,01/18/2017,58,14:15,14:30,,35.81,0,35.81,35.81,-1,-58071,67427,125498,9356,0,-3762,0,0,0,,3762,-3762
3,01/18/2017,59,14:30,14:45,,,0,42.37,42.37,0,-60090,53110,113200,-6980,0,-396,0,0,0,,396,-396
3,01/18/2017,60,14:45,15:00,,,0,42.37,42.37,0,-64464,59028,123492,-5436,0,0,0,0,0,,0,0
3,01/18/2017,61,15:00,15:15,,,0,42.37,42.37,0,-65288,58493,123781,-6795,0,0,0,0,0,,0,0
3,01/18/2017,62,15:15,15:30,,50.53,0,50.53,50.53,-1,-70654,62048,132702,-8606,0,-358,0,0,0,,358,-358
3,01/18/2017,63,15:30,15:45,,50.53,0,50.53,50.53,-1,-79549,62734,142283,-16815,0,-318,0,0,0,,318,-318
3,01/18/2017,64,15:45,16:00,,,0,42.37,42.37,0,-100490,53899,154389,-46591,0,0,0,0,0,,0,0
3,01/18/2017,65,16:00,16:15,40.45,,0,40.45,40.45,1,-101282,74513,175795,-26769,0,0,295,0,0,,295,295
3,01/18/2017,66,16:15,16:30,82.45,,0,82.45,82.45,1,-93562,77246,170808,-16316,0,0,13002,0,0,,13002,13002
3,01/18/2017,67,16:30,16:45,,,0,42.37,42.37,0,-86530,93981,180511,7451,0,0,1074,0,0,,1074,1074
3,01/18/2017,68,16:45,17:00,98.45,,0,98.45,98.45,1,-97496,89675,187171,-7821,0,0,2668,0,0,,2668,2668
3,01/18/2017,69,17:00,17:15,122.05,26.22,0,122.05,26.22,2,-44548,120515,165063,75967,0,-9890,4662,0,0,,14552,-5228
3,01/18/2017,70,17:15,17:30,96.05,37.99,0,96.05,96.05,1,-80631,54488,135119,-26143,0,-3681,1165,0,0,,4846,-2516
3,01/18/2017,71,17:30,17:45,122.05,,0,122.05,122.05,1,-107326,68285,175611,-39041,0,0,18861,0,0,,18861,18861
3,01/18/2017,72,17:45,18:00,111.05,,0,111.05,111.05,1,-100684,76669,177353,-24015,0,0,31427,0,0,,31427,31427
3,01/18/2017,73,18:00,18:15,53.19,,0,53.19,53.19,1,-119386,41445,160831,-77941,0,0,20836,0,0,,20836,20836
3,01/18/2017,74,18:15,18:30,95.1,,0,95.1,95.1,1,-85298,59512,144810,-25786,0,0,4922,0,0,,4922,4922
3,01/18/2017,75,18:30,18:45,95.1,33.95,0,33.95,33.95,-1,-72395,80205,152600,7810,0,-757,6334,0,0,,7091,5577
3,01/18/2017,76,18:45,19:00,34.6,33.95,0,34.6,34.6,1,-75601,69225,144826,-6376,0,-484,420,0,0,,904,-64
3,01/18/2017,77,19:00,19:15,38.76,,0,38.76,38.76,1,-101125,56842,157967,-44283,0,0,3679,0,0,,3679,3679
3,01/18/2017,78,19:15,19:30,,,0,42.38,42.38,0,-78465,64093,142558,-14372,0,0,8,0,0,,8,8
3,01/18/2017,79,19:30,19:45,34.6,,0,34.6,34.6,1,-65220,61354,126574,-3866,0,0,392,0,0,,392,392
3,01/18/2017,80,19:45,20:00,34.6,,0,34.6,34.6,1,-62015,61969,123984,-46,0,0,1544,0,0,,1544,1544
3,01/18/2017,81,20:00,20:15,205.34,,0,205.34,205.34,1,-147441,60648,208089,-86793,0,0,21494,0,0,,21494,21494
3,01/18/2017,82,20:15,20:30,37.33,,0,37.33,37.33,1,-112576,66466,179042,-46110,0,0,9511,0,0,,9511,9511
3,01/18/2017,83,20:30,20:45,34.21,,0,34.21,34.21,1,-76795,64914,141709,-11881,0,0,616,0,0,,616,616
3,01/18/2017,84,20:45,21:00,34.21,50.16,0,42.38,42.38,2,-67430,69996,137426,2566,0,-27,1204,0,0,,1231,1177
3,01/18/2017,85,21:00,21:15,78.12,50.16,0,78.12,78.12,1,-90934,55489,146423,-35445,0,-26,8661,0,0,,8687,8635
3,01/18/2017,86,21:15,21:30,78.12,,0,78.12,78.12,1,-80086,59812,139898,-20274,0,0,22382,0,0,,22382,22382
3,01/18/2017,87,21:30,21:45,78.12,32,0,32,32,-1,-51026,78994,130020,27968,0,-3251,7298,0,0,,10549,4047
3,01/18/2017,88,21:45,22:00,,27.71,0,27.71,27.71,-1,-41569,87582,129151,46013,0,-33353,0,0,0,,33353,-33353
3,01/18/2017,89,22:00,22:15,46.1,29.62,0,46.1,46.1,1,-111654,72261,183915,-39393,0,-27227,2048,0,0,,29275,-25179
3,01/18/2017,90,22:15,22:30,46.1,32.66,0,32.66,32.66,-1,-72375,81139,153514,8764,0,-1173,1152,0,0,,2325,-21
3,01/18/2017,91,22:30,22:45,,32,0,32,32,-1,-51499,83771,135270,32272,0,-2311,0,0,0,,2311,-2311
3,01/18/2017,92,22:45,23:00,,33.56,0,33.56,33.56,-1,-75853,94411,170264,18558,0,-26,0,0,0,,26,-26
3,01/18/2017,93,23:00,23:15,38.76,32.91,0,38.76,32.29,2,-118927,100967,219894,-17960,0,-282,3320,0,0,,3602,3038
3,01/18/2017,94,23:15,23:30,43,,0,43,43,1,-96931,73408,170339,-23523,0,0,17005,0,0,,17005,17005
3,01/18/2017,95,23:30,23:45,43,33.95,0,33.95,33.95,-1,-61362,69696,131058,8334,0,-846,792,0,0,,1638,-54
3,01/18/2017,96,23:45,0:00,,33.56,0,33.56,33.56,-1,-53181,68530,121711,15349,0,-946,0,0,0,,946,-946
3,01/19/2017,1,0:00,0:15,49.13,34.5,0,49.13,31.44,2,-114499,86410,200909,-28089,0,-641,8976,0,0,,9617,8335
3,01/19/2017,2,0:15,0:30,50.23,,0,50.23,50.23,1,-88390,54410,142800,-33980,0,0,31569,0,0,,31569,31569
3,01/19/2017,3,0:30,0:45,36.24,,0,36.24,36.24,1,-87165,46898,134063,-40267,0,0,20222,0,0,,20222,20222
3,01/19/2017,4,0:45,1:00,36.24,34.55,0,34.55,34.55,-1,-73479,62590,136069,-10889,0,-218,3837,0,0,,4055,3619
3,01/19/2017,5,1:00,1:15,58.76,,0,58.76,58.76,1,-105320,64004,169324,-41316,0,0,15280,0,0,,15280,15280
3,01/19/2017,6,1:15,1:30,58.76,,0,58.76,58.76,1,-67779,44891,112670,-22888,0,0,34100,0,0,,34100,34100
3,01/19/2017,7,1:30,1:45,36.02,,0,36.02,36.02,1,-61511,46033,107544,-15478,0,0,8022,0,0,,8022,8022
3,01/19/2017,8,1:45,2:00,38.32,,0,38.32,38.32,1,-73222,47263,120485,-25959,0,0,18402,0,0,,18402,18402
3,01/19/2017,9,2:00,2:15,39.75,,0,39.75,39.75,1,-79537,37781,117318,-41756,0,0,22927,0,0,,22927,22927
3,01/19/2017,10,2:15,2:30,37.12,,0,37.12,37.12,1,-73980,36206,110186,-37774,0,0,27126,0,0,,27126,27126
3,01/19/2017,11,2:30,2:45,39.75,,0,39.75,39.75,1,-83477,37639,121116,-45838,0,0,37438,0,0,,37438,37438
3,01/19/2017,12,2:45,3:00,36.32,,0,36.32,36.32,1,-72605,38039,110644,-34566,0,0,18560,0,0,,18560,18560
3,01/19/2017,13,3:00,3:15,61.65,,0,61.65,61.65,1,-97563,26329,123892,-71234,0,0,15327,0,0,,15327,15327
3,01/19/2017,14,3:15,3:30,39.6,,0,39.6,39.6,1,-89286,34336,123622,-54950,0,0,17200,0,0,,17200,17200
3,01/19/2017,15,3:30,3:45,,,0,31.41,31.41,0,-86417,27322,113739,-59095,0,0,13,0,0,,13,13
3,01/19/2017,16,3:45,4:00,,,0,31.41,31.41,0,-90933,28232,119165,-62701,0,0,0,0,0,,0,0
3,01/19/2017,17,4:00,4:15,,,0,31.45,31.45,0,-71012,39242,110254,-31770,0,0,0,0,0,,0,0
3,01/19/2017,18,4:15,4:30,,,0,31.45,31.45,0,-81027,35319,116346,-45708,0,0,0,0,0,,0,0
3,01/19/2017,19,4:30,4:45,,,0,31.45,31.45,0,-85147,32972,118119,-52175,0,0,0,0,0,,0,0
3,01/19/2017,20,4:45,5:00,,,0,31.45,31.45,0,-81677,28569,110246,-53108,0,0,0,0,0,,0,0
3,01/19/2017,21,5:00,5:15,,,0,31.42,31.42,0,-74916,49080,123996,-25836,0,0,0,0,0,,0,0
3,01/19/2017,22,5:15,5:30,27.89,,0,27.89,27.89,1,-63703,31503,95206,-32200,0,0,71,0,0,,71,71
3,01/19/2017,23,5:30,5:45,36.02,,0,36.02,36.02,1,-87795,22091,109886,-65704,0,0,1050,0,0,,1050,1050
3,01/19/2017,24,5:45,6:00,38.32,,0,38.32,38.32,1,-98861,37042,135903,-61819,0,0,12697,0,0,,12697,12697
3,01/19/2017,25,6:00,6:15,33.92,18.03,0,18.03,18.03,-1,-94056,152248,246304,58192,0,-18024,4130,0,0,,22154,-13894
3,01/19/2017,26,6:15,6:30,,30.39,0,30.39,30.39,-1,-62382,116170,178552,53788,0,-34329,0,0,0,,34329,-34329
3,01/19/2017,27,6:30,6:45,60,33.57,0,60,60,1,-88340,61117,149457,-27223,0,-15955,2139,0,0,,18094,-13816
3,01/19/2017,28,6:45,7:00,93.08,33.57,0,93.08,93.08,1,-146346,61250,207596,-85096,0,-636,15159,0,0,,15795,14523
3,01/19/2017,29,7:00,7:15,93.08,-22.81,0,-22.81,-22.81,-1,-64573,152091,216664,87518,0,-30267,2232,0,0,,32499,-28035
3,01/19/2017,30,7:15,7:30,38.32,-22.81,0,38.32,38.32,1,-69379,58237,127616,-11142,0,-6000,931,0,0,,6931,-5069
3,01/19/2017,31,7:30,7:45,188.3,,0,188.3,188.3,1,-114052,66439,180491,-47613,0,0,12811,0,0,,12811,12811
3,01/19/2017,32,7:45,8:00,188.3,,0,188.3,188.3,1,-163540,52773,216313,-110767,0,0,72162,0,0,,72162,72162
3,01/19/2017,33,8:00,8:15,127.89,19.05,0,127.89,19.05,2,-38298,70585,108883,32287,0,-5798,41055,0,0,,46853,35257
3,01/19/2017,34,8:15,8:30,,34.94,0,34.94,34.94,-1,-56656,50261,106917,-6395,0,-2392,0,0,0,,2392,-2392
3,01/19/2017,35,8:30,8:45,35.2,,0,35.2,35.2,1,-60039,51303,111342,-8736,0,0,42,0,0,,42,42
3,01/19/2017,36,8:45,9:00,35.59,41.25,0,44.28,41.25,2,-50182,52355,102537,2173,0,-72,1752,0,0,,1824,1680
3,01/19/2017,37,9:00,9:15,37.15,34.99,0,44.29,34.99,2,-44202,38112,82314,-6090,0,-475,612,0,0,,1087,137
3,01/19/2017,38,9:15,9:30,,,0,44.29,44.29,0,-48569,32457,81026,-16112,0,0,180,0,0,,180,180
3,01/19/2017,39,9:30,9:45,,,0,44.29,44.29,0,-47924,36349,84273,-11575,0,0,0,0,0,,0,0
3,01/19/2017,40,9:45,10:00,39.75,,0,39.75,39.75,1,-58868,42975,101843,-15893,0,0,1184,0,0,,1184,1184
3,01/19/2017,41,10:00,10:15,37.15,,0,37.15,37.15,1,-57803,39635,97438,-18168,0,0,592,0,0,,592,592
3,01/19/2017,42,10:15,10:30,37.15,,0,37.15,37.15,1,-59074,45713,104787,-13361,0,0,474,0,0,,474,474
3,01/19/2017,43,10:30,10:45,,53.38,0,53.38,53.38,-1,-58830,59802,118632,972,0,-6,0,0,0,,6,-6
3,01/19/2017,44,10:45,11:00,,33.9,0,33.9,33.9,-1,-54724,64579,119303,9855,0,-6721,0,0,0,,6721,-6721
3,01/19/2017,45,11:00,11:15,,31.82,0,31.82,31.82,-1,-32896,63798,96694,30902,0,-11835,0,0,0,,11835,-11835
3,01/19/2017,46,11:15,11:30,,30.92,0,30.92,30.92,-1,-36314,68873,105187,32559,0,-32243,0,0,0,,32243,-32243
3,01/19/2017,47,11:30,11:45,,30.92,0,30.92,30.92,-1,-34870,75512,110382,40642,0,-31962,0,0,0,,31962,-31962
3,01/19/2017,48,11:45,12:00,,30.89,0,30.89,30.89,-1,-29263,80736,109999,51473,0,-44855,0,0,0,,44855,-44855
3,01/19/2017,49,12:00,12:15,,13.16,0,13.16,13.16,-1,-27166,119299,146465,92133,0,-69611,0,0,0,,69611,-69611
3,01/19/2017,50,12:15,12:30,,18.18,0,18.18,18.18,-1,-24068,81550,105618,57482,0,-75666,0,0,0,,75666,-75666
3,01/19/2017,51,12:30,12:45,,18.18,0,18.18,18.18,-1,-21691,92469,114160,70778,0,-52711,0,0,0,,52711,-52711
3,01/19/2017,52,12:45,13:00,,18.18,0,18.18,18.18,-1,-23310,98855,122165,75545,0,-79765,0,0,0,,79765,-79765
3,01/19/2017,53,13:00,13:15,35.59,30.92,0,35.59,35.59,1,-37746,53762,91508,16016,0,-40956,128,0,0,,41084,-40828
3,01/19/2017,54,13:15,13:30,35.59,30.39,0,44.31,30.39,2,-38394,66376,104770,27982,0,-6457,292,0,0,,6749,-6165
3,01/19/2017,55,13:30,13:45,,27.56,0,27.56,27.56,-1,-43287,75273,118560,31986,0,-33729,0,0,0,,33729,-33729
3,01/19/2017,56,13:45,14:00,,34.94,0,34.94,34.94,-1,-44361,59799,104160,15438,0,-16150,0,0,0,,16150,-16150
3,01/19/2017,57,14:00,14:15,,31.92,0,31.92,31.92,-1,-34522,63108,97630,28586,0,-23279,0,0,0,,23279,-23279
3,01/19/2017,58,14:15,14:30,,33.19,0,33.19,33.19,-1,-38111,60688,98799,22577,0,-26634,0,0,0,,26634,-26634
3,01/19/2017,59,14:30,14:45,,34.55,0,34.55,34.55,-1,-38826,55629,94455,16803,0,-14204,0,0,0,,14204,-14204
3,01/19/2017,60,14:45,15:00,,34.09,0,34.09,34.09,-1,-36371,51106,87477,14735,0,-13569,0,0,0,,13569,-13569
3,01/19/2017,61,15:00,15:15,,32.99,0,32.99,32.99,-1,-34029,64706,98735,30677,0,-19627,0,0,0,,19627,-19627
3,01/19/2017,62,15:15,15:30,35.59,32.99,0,35.59,35.59,1,-35573,41245,76818,5672,0,-21221,100,0,0,,21321,-21121
3,01/19/2017,63,15:30,15:45,38.32,53.03,0,44.31,44.31,2,-31064,35258,66322,4194,0,-1840,1323,0,0,,3163,-517
3,01/19/2017,64,15:45,16:00,,36.03,0,36.03,36.03,-1,-56324,45912,102236,-10412,0,-822,0,0,0,,822,-822
3,01/19/2017,65,16:00,16:15,,,0,44.31,44.31,0,-55975,47332,103307,-8643,0,0,0,0,0,,0,0
3,01/19/2017,66,16:15,16:30,,53.03,0,53.03,53.03,-1,-43056,52809,95865,9753,0,-7,0,0,0,,7,-7
3,01/19/2017,67,16:30,16:45,,30.39,0,30.39,30.39,-1,-23234,60199,83433,36965,0,-15124,0,0,0,,15124,-15124
3,01/19/2017,68,16:45,17:00,36.24,33.19,0,44.31,33.19,2,-36538,62216,98754,25678,0,-16040,77,0,0,,16117,-15963
3,01/19/2017,69,17:00,17:15,36.24,18.18,0,44.31,18.18,2,-52826,146835,199661,94009,0,-18891,347,0,0,,19238,-18544
3,01/19/2017,70,17:15,17:30,35.59,33.19,0,35.59,35.59,1,-52274,75023,127297,22749,0,-14078,34,0,0,,14112,-14044
3,01/19/2017,71,17:30,17:45,41.44,33.19,0,41.44,41.44,1,-67227,62405,129632,-4822,0,-234,2227,0,0,,2461,1993
3,01/19/2017,72,17:45,18:00,124.14,,0,124.14,124.14,1,-73358,58899,132257,-14459,0,0,17179,0,0,,17179,17179
3,01/19/2017,73,18:00,18:15,162.74,34.94,0,34.94,34.94,-1,-60274,55594,115868,-4680,0,-330,24376,0,0,,24706,24046
3,01/19/2017,74,18:15,18:30,35.2,33.29,0,44.31,33.29,2,-65261,78559,143820,13298,0,-1274,956,0,0,,2230,-318
3,01/19/2017,75,18:30,18:45,35.59,,0,35.59,35.59,1,-58171,71861,130032,13690,0,0,698,0,0,,698,698
3,01/19/2017,76,18:45,19:00,,34.55,0,34.55,34.55,-1,-52747,78119,130866,25372,0,-758,0,0,0,,758,-758
3,01/19/2017,77,19:00,19:15,35.2,34.55,0,35.2,35.2,1,-80635,67009,147644,-13626,0,-196,76,0,0,,272,-120
3,01/19/2017,78,19:15,19:30,,53.42,0,53.42,53.42,-1,-61103,74465,135568,13362,0,-3,0,0,0,,3,-3
3,01/19/2017,79,19:30,19:45,,33.29,0,33.29,33.29,-1,-57889,74033,131922,16144,0,-5729,0,0,0,,5729,-5729
3,01/19/2017,80,19:45,20:00,,31.92,0,31.92,31.92,-1,-50406,77755,128161,27349,0,-4996,0,0,0,,4996,-4996
3,01/19/2017,81,20:00,20:15,45.27,31.92,0,45.27,31.92,2,-69047,56977,126024,-12070,0,-13654,1559,0,0,,15213,-12095
3,01/19/2017,82,20:15,20:30,104.22,31.92,0,104.22,104.22,1,-98006,47403,145409,-50603,0,-264,12366,0,0,,12630,12102
3,01/19/2017,83,20:30,20:45,37.15,53.03,0,44.31,44.31,2,-77260,71829,149089,-5431,0,-37,4837,0,0,,4874,4800
3,01/19/2017,84,20:45,21:00,37.15,28.14,0,28.14,28.14,-1,-48393,92380,140773,43987,0,-21895,176,0,0,,22071,-21719
3,01/19/2017,85,21:00,21:15,67.69,33.39,0,67.69,67.69,1,-102154,73416,175570,-28738,0,-12831,6552,0,0,,19383,-6279
3,01/19/2017,86,21:15,21:30,37.15,38.78,0,38.78,38.78,-1,-80606,78348,158954,-2258,0,-49,10317,0,0,,10366,10268
3,01/19/2017,87,21:30,21:45,37.15,33.39,0,33.39,33.39,-1,-84230,99621,183851,15391,0,-11202,80,0,0,,11282,-11122
3,01/19/2017,88,21:45,22:00,,28.33,0,28.33,28.33,-1,-69974,114125,184099,44151,0,-28015,0,0,0,,28015,-28015
3,01/19/2017,89,22:00,22:15,40.68,31.19,0,40.68,40.68,1,-132675,63232,195907,-69443,0,-23048,1761,0,0,,24809,-21287
3,01/19/2017,90,22:15,22:30,,,0,31.82,31.82,0,-124207,58142,182349,-66065,0,-405,698,0,0,,1103,293
3,01/19/2017,91,22:30,22:45,37.15,,0,37.15,37.15,1,-94424,69847,164271,-24577,0,0,957,0,0,,957,957
3,01/19/2017,92,22:45,23:00,,31.92,0,31.92,31.92,-1,-79055,79714,158769,659,0,-1256,0,0,0,,1256,-1256
3,01/19/2017,93,23:00,23:15,,29.06,0,29.06,29.06,-1,-100311,122921,223232,22610,0,-9486,0,0,0,,9486,-9486
3,01/19/2017,94,23:15,23:30,,33.57,0,33.57,33.57,-1,-81932,80969,162901,-963,0,-4552,0,0,0,,4552,-4552
3,01/19/2017,95,23:30,23:45,,30.92,0,30.92,30.92,-1,-66092,89185,155277,23093,0,-13553,0,0,0,,13553,-13553
3,01/19/2017,96,23:45,0:00,,26.92,0,26.92,26.92,-1,-64677,114592,179269,49915,0,-28924,0,0,0,,28924,-28924
3,01/20/2017,1,0:00,0:15,,21.74,0,21.74,21.74,-1,-54427,99312,153739,44885,0,-32706,0,0,0,,32706,-32706
3,01/20/2017,2,0:15,0:30,,29.26,0,29.26,29.26,-1,-43305,72378,115683,29073,0,-25506,0,0,0,,25506,-25506
3,01/20/2017,3,0:30,0:45,,30.59,0,30.59,30.59,-1,-42965,84665,127630,41700,0,-22074,0,0,0,,22074,-22074
3,01/20/2017,4,0:45,1:00,,22.53,0,22.53,22.53,-1,-34782,110068,144850,75286,0,-51153,0,0,0,,51153,-51153
3,01/20/2017,5,1:00,1:15,,19.19,0,19.19,19.19,-1,-44595,70504,115099,25909,0,-58294,0,0,0,,58294,-58294
3,01/20/2017,6,1:15,1:30,38.52,28.9,0,38.52,28.9,2,-41212,62050,103262,20838,0,-9157,1031,0,0,,10188,-8126
3,01/20/2017,7,1:30,1:45,,26.9,0,26.9,26.9,-1,-30209,83758,113967,53549,0,-49321,0,0,0,,49321,-49321
3,01/20/2017,8,1:45,2:00,,26.92,0,26.92,26.92,-1,-32200,80033,112233,47833,0,-60115,0,0,0,,60115,-60115
3,01/20/2017,9,2:00,2:15,,33.75,0,33.75,33.75,-1,-44733,75691,120424,30958,0,-30555,0,0,0,,30555,-30555
3,01/20/2017,10,2:15,2:30,,33.85,0,33.85,33.85,-1,-48920,59351,108271,10431,0,-15031,0,0,0,,15031,-15031
3,01/20/2017,11,2:30,2:45,,33.85,0,33.85,33.85,-1,-48047,64949,112996,16902,0,-13221,0,0,0,,13221,-13221
3,01/20/2017,12,2:45,3:00,,33.85,0,33.85,33.85,-1,-46034,62516,108550,16482,0,-16977,0,0,0,,16977,-16977
3,01/20/2017,13,3:00,3:15,,33.85,0,33.85,33.85,-1,-48940,57587,106527,8647,0,-13877,0,0,0,,13877,-13877
3,01/20/2017,14,3:15,3:30,33.92,33.85,0,33.92,33.92,1,-57354,54247,111601,-3107,0,-911,251,0,0,,1162,-660
3,01/20/2017,15,3:30,3:45,,34.75,0,34.75,34.75,-1,-60025,55547,115572,-4478,0,-754,0,0,0,,754,-754
3,01/20/2017,16,3:45,4:00,,35.14,0,35.14,35.14,-1,-63576,59213,122789,-4363,0,-1294,0,0,0,,1294,-1294
3,01/20/2017,17,4:00,4:15,,35.14,0,35.14,35.14,-1,-64236,45286,109522,-18950,0,-274,0,0,0,,274,-274
3,01/20/2017,18,4:15,4:30,,35.14,0,35.14,35.14,-1,-52638,40262,92900,-12376,0,-1000,0,0,0,,1000,-1000
3,01/20/2017,19,4:30,4:45,,35.14,0,35.14,35.14,-1,-54081,34859,88940,-19222,0,-886,0,0,0,,886,-886
3,01/20/2017,20,4:45,5:00,,,0,31.58,31.58,0,-61582,35541,97123,-26041,0,0,0,0,0,,0,0
3,01/20/2017,21,5:00,5:15,,32.02,0,32.02,32.02,-1,-63609,80901,144510,17292,0,-6132,0,0,0,,6132,-6132
3,01/20/2017,22,5:15,5:30,,34.1,0,34.1,34.1,-1,-46153,47593,93746,1440,0,-2597,0,0,0,,2597,-2597
3,01/20/2017,23,5:30,5:45,,,0,31.55,31.55,0,-59754,38156,97910,-21598,0,-200,0,0,0,,200,-200
3,01/20/2017,24,5:45,6:00,38.1,,0,38.1,38.1,1,-84511,44040,128551,-40471,0,0,1271,0,0,,1271,1271
3,01/20/2017,25,6:00,6:15,38.1,-38.59,0,-38.59,-38.59,-1,-30000,110780,140780,80780,0,-23713,125,0,0,,23838,-23588
3,01/20/2017,26,6:15,6:30,,30.26,0,30.26,30.26,-1,-67588,59012,126600,-8576,0,-17959,0,0,0,,17959,-17959
3,01/20/2017,27,6:30,6:45,41.64,30.26,0,41.64,41.64,1,-73074,63660,136734,-9414,0,-62,846,0,0,,908,784
3,01/20/2017,28,6:45,7:00,55.35,,0,55.35,55.35,1,-110507,59622,170129,-50885,0,0,21277,0,0,,21277,21277
3,01/20/2017,29,7:00,7:15,55.35,-22.61,0,-22.61,-22.61,-1,-43905,208955,252860,165050,0,-52730,5635,0,0,,58365,-47095
3,01/20/2017,30,7:15,7:30,,30.92,0,30.92,30.92,-1,-50459,92653,143112,42194,0,-43748,0,0,0,,43748,-43748
3,01/20/2017,31,7:30,7:45,35.79,31.99,0,35.79,35.79,1,-89324,91537,180861,2213,0,-29470,126,0,0,,29596,-29344
3,01/20/2017,32,7:45,8:00,188.3,31.99,0,188.3,188.3,1,-140198,59411,199609,-80787,0,-2932,35432,0,0,,38364,32500
3,01/20/2017,33,8:00,8:15,190.47,28.15,0,28.15,28.15,-1,-52495,89598,142093,37103,0,-973,49758,0,0,,50731,48785
3,01/20/2017,34,8:15,8:30,190.47,16.34,0,16.34,16.34,-1,-55475,77909,133384,22434,0,-25771,1980,0,0,,27751,-23791
3,01/20/2017,35,8:30,8:45,41.64,16.34,0,41.64,41.64,1,-75241,58045,133286,-17196,0,-2451,2502,0,0,,4953,51
3,01/20/2017,36,8:45,9:00,50.6,,0,50.6,50.6,1,-78496,55409,133905,-23087,0,0,13636,0,0,,13636,13636
3,01/20/2017,37,9:00,9:15,52.12,,0,52.12,52.12,1,-60768,42269,103037,-18499,0,0,13649,0,0,,13649,13649
3,01/20/2017,38,9:15,9:30,57.12,,0,57.12,57.12,1,-64930,42082,107012,-22848,0,0,23850,0,0,,23850,23850
3,01/20/2017,39,9:30,9:45,57.12,53.33,0,53.33,53.33,-1,-50024,46195,96219,-3829,0,-17,5379,0,0,,5396,5362
3,01/20/2017,40,9:45,10:00,,,0,44.37,44.37,0,-57047,49235,106282,-7812,0,0,0,0,0,,0,0
3,01/20/2017,41,10:00,10:15,59.99,,0,59.99,59.99,1,-50979,31617,82596,-19362,0,0,5112,0,0,,5112,5112
3,01/20/2017,42,10:15,10:30,35.4,37.78,0,37.78,37.78,-1,-41449,47201,88650,5752,0,-282,914,0,0,,1196,632
3,01/20/2017,43,10:30,10:45,,33.49,0,33.49,33.49,-1,-38427,59740,98167,21313,0,-13922,0,0,0,,13922,-13922
3,01/20/2017,44,10:45,11:00,,33.49,0,33.49,33.49,-1,-37829,61712,99541,23883,0,-21547,0,0,0,,21547,-21547
3,01/20/2017,45,11:00,11:15,,33.39,0,33.39,33.39,-1,-24751,43613,68364,18862,0,-18621,0,0,0,,18621,-18621
3,01/20/2017,46,11:15,11:30,,34.63,0,34.63,34.63,-1,-34861,46305,81166,11444,0,-9042,0,0,0,,9042,-9042
3,01/20/2017,47,11:30,11:45,,31.92,0,31.92,31.92,-1,-34568,61465,96033,26897,0,-6550,0,0,0,,6550,-6550
3,01/20/2017,48,11:45,12:00,,30.92,0,30.92,30.92,-1,-34367,62565,96932,28198,0,-29463,0,0,0,,29463,-29463
3,01/20/2017,49,12:00,12:15,,30.92,0,30.92,30.92,-1,-26592,67570,94162,40978,0,-34267,0,0,0,,34267,-34267
3,01/20/2017,50,12:15,12:30,,28.9,0,28.9,28.9,-1,-27336,72469,99805,45133,0,-39320,0,0,0,,39320,-39320
3,01/20/2017,51,12:30,12:45,,21.92,0,21.92,21.92,-1,-24671,77691,102362,53020,0,-57302,0,0,0,,57302,-57302
3,01/20/2017,52,12:45,13:00,,27.76,0,27.76,27.76,-1,-27550,82702,110252,55152,0,-39201,0,0,0,,39201,-39201
3,01/20/2017,53,13:00,13:15,35.4,27.76,0,35.4,35.4,1,-45510,64493,110003,18983,0,-30166,54,0,0,,30220,-30112
3,01/20/2017,54,13:15,13:30,35.4,34.75,0,43.73,34.75,2,-42542,54486,97028,11944,0,-1971,629,0,0,,2600,-1342
3,01/20/2017,55,13:30,13:45,,33.19,0,33.19,33.19,-1,-46921,60384,107305,13463,0,-7991,0,0,0,,7991,-7991
3,01/20/2017,56,13:45,14:00,,34.75,0,34.75,34.75,-1,-45144,52263,97407,7119,0,-6619,0,0,0,,6619,-6619
3,01/20/2017,57,14:00,14:15,149.24,34.75,0,149.24,149.24,1,-89303,25837,115140,-63466,0,-1179,15768,0,0,,16947,14589
3,01/20/2017,58,14:15,14:30,76.6,,0,76.6,76.6,1,-74681,23998,98679,-50683,0,0,35468,0,0,,35468,35468
3,01/20/2017,59,14:30,14:45,57.12,,0,57.12,57.12,1,-54645,31881,86526,-22764,0,0,31486,0,0,,31486,31486
3,01/20/2017,60,14:45,15:00,41.64,,0,41.64,41.64,1,-48541,29610,78151,-18931,0,0,12557,0,0,,12557,12557
3,01/20/2017,61,15:00,15:15,169.15,,0,169.15,169.15,1,-96479,56649,153128,-39830,0,0,36090,0,0,,36090,36090
3,01/20/2017,62,15:15,15:30,35.4,,0,35.4,35.4,1,-78571,59578,138149,-18993,0,0,9456,0,0,,9456,9456
3,01/20/2017,63,15:30,15:45,67.93,,0,67.93,67.93,1,-96415,54407,150822,-42008,0,0,7429,0,0,,7429,7429
3,01/20/2017,64,15:45,16:00,78.93,,0,78.93,78.93,1,-89670,50874,140544,-38796,0,0,31341,0,0,,31341,31341
3,01/20/2017,65,16:00,16:15,35.4,-11.66,0,-11.66,-11.66,-1,-41871,142690,184561,100819,0,-18022,10394,0,0,,28416,-7628
3,01/20/2017,66,16:15,16:30,,-11.66,0,-11.66,-11.66,-1,-49326,90540,139866,41214,0,-45448,0,0,0,,45448,-45448
3,01/20/2017,67,16:30,16:45,,24.99,0,24.99,24.99,-1,-49795,114441,164236,64646,0,-51713,0,0,0,,51713,-51713
3,01/20/2017,68,16:45,17:00,,24.99,0,24.99,24.99,-1,-49966,112950,162916,62984,0,-57430,0,0,0,,57430,-57430
3,01/20/2017,69,17:00,17:15,,20.41,0,20.41,20.41,-1,-40688,113320,154008,72632,0,-71169,0,0,0,,71169,-71169
3,01/20/2017,70,17:15,17:30,,29.36,0,29.36,29.36,-1,-45989,72705,118694,26716,0,-43370,0,0,0,,43370,-43370
3,01/20/2017,71,17:30,17:45,41.64,29.36,0,41.64,41.64,1,-49822,56890,106712,7068,0,-1592,18,0,0,,1610,-1574
3,01/20/2017,72,17:45,18:00,,34.1,0,34.1,34.1,-1,-55312,66532,121844,11220,0,-344,0,0,0,,344,-344
3,01/20/2017,73,18:00,18:15,,19.19,0,19.19,19.19,-1,-68737,48087,116824,-20650,0,-24232,0,0,0,,24232,-24232
3,01/20/2017,74,18:15,18:30,,30.92,0,30.92,30.92,-1,-50569,80914,131483,30345,0,-10390,0,0,0,,10390,-10390
3,01/20/2017,75,18:30,18:45,,26.92,0,26.92,26.92,-1,-32343,80002,112345,47659,0,-43139,0,0,0,,43139,-43139
3,01/20/2017,76,18:45,19:00,,30.59,0,30.59,30.59,-1,-26355,88878,115233,62523,0,-42156,0,0,0,,42156,-42156
3,01/20/2017,77,19:00,19:15,,31.99,0,31.99,31.99,-1,-48948,75488,124436,26540,0,-32539,0,0,0,,32539,-32539
3,01/20/2017,78,19:15,19:30,,32.02,0,32.02,32.02,-1,-35255,60988,96243,25733,0,-27118,0,0,0,,27118,-27118
3,01/20/2017,79,19:30,19:45,,26.92,0,26.92,26.92,-1,-30393,86363,116756,55970,0,-39148,0,0,0,,39148,-39148
3,01/20/2017,80,19:45,20:00,,26.92,0,26.92,26.92,-1,-28147,76960,105107,48813,0,-53917,0,0,0,,53917,-53917
3,01/20/2017,81,20:00,20:15,,33.19,0,33.19,33.19,-1,-65086,72106,137192,7020,0,-23667,0,0,0,,23667,-23667
3,01/20/2017,82,20:15,20:30,,28.15,0,28.15,28.15,-1,-42605,76477,119082,33872,0,-15977,0,0,0,,15977,-15977
3,01/20/2017,83,20:30,20:45,,28.15,0,28.15,28.15,-1,-39358,87749,127107,48391,0,-44260,0,0,0,,44260,-44260
3,01/20/2017,84,20:45,21:00,,16.26,0,16.26,16.26,-1,-21535,98716,120251,77181,0,-59665,0,0,0,,59665,-59665
3,01/20/2017,85,21:00,21:15,,9.79,0,9.79,9.79,-1,-63981,107643,171624,43662,0,-59546,0,0,0,,59546,-59546
3,01/20/2017,86,21:15,21:30,,11.23,0,11.23,11.23,-1,-43038,99106,142144,56068,0,-20130,0,0,0,,20130,-20130
3,01/20/2017,87,21:30,21:45,,-41.17,0,-41.17,-41.17,-1,-37353,92226,129579,54873,0,-69129,0,0,0,,69129,-69129
3,01/20/2017,88,21:45,22:00,,28.9,0,28.9,28.9,-1,-47683,101603,149286,53920,0,-36624,0,0,0,,36624,-36624
3,01/20/2017,89,22:00,22:15,41.64,26.92,0,41.64,26.92,2,-96339,23357,119696,-72982,0,-28441,1645,0,0,,30086,-26796
3,01/20/2017,90,22:15,22:30,47.17,26.92,0,47.17,47.17,1,-61730,35479,97209,-26251,0,-830,1506,0,0,,2336,676
3,01/20/2017,91,22:30,22:45,,30.92,0,30.92,30.92,-1,-33684,48588,82272,14904,0,-3576,0,0,0,,3576,-3576
3,01/20/2017,92,22:45,23:00,,26.92,0,26.92,26.92,-1,-52031,72152,124183,20121,0,-38484,0,0,0,,38484,-38484
3,01/20/2017,93,23:00,23:15,,0.78,0,0.78,0.78,-1,-30147,86219,116366,56072,0,-59823,0,0,0,,59823,-59823
3,01/20/2017,94,23:15,23:30,35.79,24.74,0,35.79,24.74,2,-49017,53833,102850,4816,0,-9143,510,0,0,,9653,-8633
3,01/20/2017,95,23:30,23:45,,16.55,0,16.55,16.55,-1,-46807,58095,104902,11288,0,-26666,0,0,0,,26666,-26666
3,01/20/2017,96,23:45,0:00,,30.59,0,30.59,30.59,-1,-45397,86200,131597,40803,0,-4533,0,0,0,,4533,-4533
4,01/21/2017,1,0:00,0:15,40.39,30.59,0,40.39,40.39,1,-90345,54315,144660,-36030,0,-1809,2524,0,0,,4333,715
4,01/21/2017,2,0:15,0:30,51.11,,0,51.11,51.11,1,-59499,38004,97503,-21495,0,0,3234,0,0,,3234,3234
4,01/21/2017,3,0:30,0:45,64.02,,0,64.02,64.02,1,-59011,43959,102970,-15052,0,0,26345,0,0,,26345,26345
4,01/21/2017,4,0:45,1:00,64.02,32.98,0,32.98,32.98,-1,-48507,66209,114716,17702,0,-7911,2612,0,0,,10523,-5299
4,01/21/2017,5,1:00,1:15,38.96,35.19,0,38.96,32.13,2,-74871,63366,138237,-11505,0,-3360,2658,0,0,,6018,-702
4,01/21/2017,6,1:15,1:30,36.23,,0,36.23,36.23,1,-65769,65082,130851,-687,0,0,3047,0,0,,3047,3047
4,01/21/2017,7,1:30,1:45,35.76,,0,35.76,35.76,1,-51455,68224,119679,16769,0,0,1921,0,0,,1921,1921
4,01/21/2017,8,1:45,2:00,35.76,32.03,0,32.03,32.03,-1,-33252,79471,112723,46219,0,-2349,24,0,0,,2373,-2325
4,01/21/2017,9,2:00,2:15,,29.34,0,29.34,29.34,-1,-53015,52082,105097,-933,0,-17039,0,0,0,,17039,-17039
4,01/21/2017,10,2:15,2:30,,33.98,0,33.98,33.98,-1,-63448,67652,131100,4204,0,-3239,0,0,0,,3239,-3239
4,01/21/2017,11,2:30,2:45,,31.69,0,31.69,31.69,-1,-49243,75034,124277,25791,0,-21930,0,0,0,,21930,-21930
4,01/21/2017,12,2:45,3:00,,32.46,0,32.46,32.46,-1,-58399,80288,138687,21889,0,-25192,0,0,0,,25192,-25192
4,01/21/2017,13,3:00,3:15,,29.34,0,29.34,29.34,-1,-50345,59819,110164,9474,0,-30779,0,0,0,,30779,-30779
4,01/21/2017,14,3:15,3:30,37.2,33.98,0,37.2,32.02,2,-61189,54191,115380,-6998,0,-4541,1470,0,0,,6011,-3071
4,01/21/2017,15,3:30,3:45,,33.63,0,33.63,33.63,-1,-43018,52498,95516,9480,0,-10903,0,0,0,,10903,-10903
4,01/21/2017,16,3:45,4:00,,34.21,0,34.21,34.21,-1,-46505,51474,97979,4969,0,-4029,0,0,0,,4029,-4029
4,01/21/2017,17,4:00,4:15,,33.63,0,33.63,33.63,-1,-51403,58085,109488,6682,0,-5565,0,0,0,,5565,-5565
4,01/21/2017,18,4:15,4:30,,34.21,0,34.21,34.21,-1,-41448,46264,87712,4816,0,-2436,0,0,0,,2436,-2436
4,01/21/2017,19,4:30,4:45,,34.21,0,34.21,34.21,-1,-41618,42821,84439,1203,0,-4439,0,0,0,,4439,-4439
4,01/21/2017,20,4:45,5:00,,33.98,0,33.98,33.98,-1,-41804,43518,85322,1714,0,-2882,0,0,0,,2882,-2882
4,01/21/2017,21,5:00,5:15,,28.98,0,28.98,28.98,-1,-29421,79193,108614,49772,0,-32607,0,0,0,,32607,-32607
4,01/21/2017,22,5:15,5:30,,30,0,30,30,-1,-37494,68770,106264,31276,0,-36512,0,0,0,,36512,-36512
4,01/21/2017,23,5:30,5:45,,32.98,0,32.98,32.98,-1,-37709,63851,101560,26142,0,-28827,0,0,0,,28827,-28827
4,01/21/2017,24,5:45,6:00,35.84,34.21,0,35.84,35.84,1,-65145,55815,120960,-9330,0,-13682,180,0,0,,13862,-13502
4,01/21/2017,25,6:00,6:15,28.36,18.07,0,31.97,18.07,2,-28433,90605,119038,62172,0,-14353,33,0,0,,14386,-14320
4,01/21/2017,26,6:15,6:30,,16.13,0,16.13,16.13,-1,-27525,62156,89681,34631,0,-45825,0,0,0,,45825,-45825
4,01/21/2017,27,6:30,6:45,,34.21,0,34.21,34.21,-1,-39329,60996,100325,21667,0,-12529,0,0,0,,12529,-12529
4,01/21/2017,28,6:45,7:00,,33.98,0,33.98,33.98,-1,-34685,69509,104194,34824,0,-8902,0,0,0,,8902,-8902
4,01/21/2017,29,7:00,7:15,,22.18,0,22.18,22.18,-1,-28302,85851,114153,57549,0,-36337,0,0,0,,36337,-36337
4,01/21/2017,30,7:15,7:30,,31.9,0,31.9,31.9,-1,-28618,71220,99838,42602,0,-25675,0,0,0,,25675,-25675
4,01/21/2017,31,7:30,7:45,36.04,31.9,0,36.04,36.04,1,-45091,67406,112497,22315,0,-1001,38,0,0,,1039,-963
4,01/21/2017,32,7:45,8:00,51.11,,0,51.11,51.11,1,-96008,91782,187790,-4226,0,0,6147,0,0,,6147,6147
4,01/21/2017,33,8:00,8:15,60.71,-1.86,0,60.71,-1.86,2,-72804,97926,170730,25122,0,-4895,19689,0,0,,24584,14794
4,01/21/2017,34,8:15,8:30,37.2,-36.88,0,37.2,-36.88,2,-44439,57969,102408,13530,0,-27415,718,0,0,,28133,-26697
4,01/21/2017,35,8:30,8:45,38.96,-36.88,0,38.96,38.96,1,-51942,60214,112156,8272,0,-148,1044,0,0,,1192,896
4,01/21/2017,36,8:45,9:00,38.96,,0,38.96,38.96,1,-81085,67862,148947,-13223,0,0,1417,0,0,,1417,1417
4,01/21/2017,37,9:00,9:15,35.84,32.98,0,32.98,32.98,-1,-23217,84430,107647,61213,0,-6623,797,0,0,,7420,-5826
4,01/21/2017,38,9:15,9:30,,32.98,0,32.98,32.98,-1,-39774,61450,101224,21676,0,-14314,0,0,0,,14314,-14314
4,01/21/2017,39,9:30,9:45,37.2,32.98,0,37.2,37.2,1,-52958,52552,105510,-406,0,-541,1255,0,0,,1796,714
4,01/21/2017,40,9:45,10:00,42.08,,0,42.08,42.08,1,-68076,46337,114413,-21739,0,0,8652,0,0,,8652,8652
4,01/21/2017,41,10:00,10:15,36.23,28.97,0,28.97,28.97,-1,-36239,73968,110207,37729,0,-6818,3135,0,0,,9953,-3683
4,01/21/2017,42,10:15,10:30,,26.03,0,26.03,26.03,-1,-40115,71119,111234,31004,0,-39965,0,0,0,,39965,-39965
4,01/21/2017,43,10:30,10:45,,33.63,0,33.63,33.63,-1,-50394,67490,117884,17096,0,-27308,0,0,0,,27308,-27308
4,01/21/2017,44,10:45,11:00,,28.98,0,28.98,28.98,-1,-25866,68266,94132,42400,0,-29308,0,0,0,,29308,-29308
4,01/21/2017,45,11:00,11:15,37.2,32.98,0,37.2,37.2,1,-48646,55241,103887,6595,0,-23719,114,0,0,,23833,-23605
4,01/21/2017,46,11:15,11:30,37.2,32.98,0,45.45,32.98,2,-29255,50646,79901,21391,0,-5402,488,0,0,,5890,-4914
4,01/21/2017,47,11:30,11:45,,32.46,0,32.46,32.46,-1,-28237,54808,83045,26571,0,-18761,0,0,0,,18761,-18761
4,01/21/2017,48,11:45,12:00,,28.98,0,28.98,28.98,-1,-25040,58853,83893,33813,0,-24893,0,0,0,,24893,-24893
4,01/21/2017,49,12:00,12:15,36.23,29.34,0,36.23,36.23,1,-41097,40098,81195,-999,0,-21873,132,0,0,,22005,-21741
4,01/21/2017,50,12:15,12:30,37.2,32.98,0,37.2,32.98,2,-27349,48147,75496,20798,0,-4144,964,0,0,,5108,-3180
4,01/21/2017,51,12:30,12:45,,26.78,0,26.78,26.78,-1,-14677,69201,83878,54524,0,-40301,0,0,0,,40301,-40301
4,01/21/2017,52,12:45,13:00,,28.34,0,28.34,28.34,-1,-16056,70746,86802,54690,0,-45517,0,0,0,,45517,-45517
4,01/21/2017,53,13:00,13:15,,24.99,0,24.99,24.99,-1,-20097,70673,90770,50576,0,-48491,0,0,0,,48491,-48491
4,01/21/2017,54,13:15,13:30,,33.63,0,33.63,33.63,-1,-28173,56783,84956,28610,0,-12566,0,0,0,,12566,-12566
4,01/21/2017,55,13:30,13:45,,29.34,0,29.34,29.34,-1,-23450,62887,86337,39437,0,-24913,0,0,0,,24913,-24913
4,01/21/2017,56,13:45,14:00,,29.34,0,29.34,29.34,-1,-18850,61818,80668,42968,0,-27332,0,0,0,,27332,-27332
4,01/21/2017,57,14:00,14:15,,29.34,0,29.34,29.34,-1,-38127,50437,88564,12310,0,-23787,0,0,0,,23787,-23787
4,01/21/2017,58,14:15,14:30,37.2,29.34,0,37.2,37.2,1,-34177,40656,74833,6479,0,-1149,1002,0,0,,2151,-147
4,01/21/2017,59,14:30,14:45,,35.19,0,35.19,35.19,-1,-22723,34701,57424,11978,0,-723,0,0,0,,723,-723
4,01/21/2017,60,14:45,15:00,,33.63,0,33.63,33.63,-1,-19881,37841,57722,17960,0,-10559,0,0,0,,10559,-10559
4,01/21/2017,61,15:00,15:15,35.77,35.03,0,35.77,35.77,1,-55590,26809,82399,-28781,0,-6940,52,0,0,,6992,-6888
4,01/21/2017,62,15:15,15:30,35.77,35.19,0,35.19,35.19,-1,-35179,33623,68802,-1556,0,-320,37,0,0,,357,-283
4,01/21/2017,63,15:30,15:45,,35.19,0,35.19,35.19,-1,-48389,25595,73984,-22794,0,-846,0,0,0,,846,-846
4,01/21/2017,64,15:45,16:00,42.59,37.03,0,42.59,42.59,1,-59831,22539,82370,-37292,0,-6,1657,0,0,,1663,1651
4,01/21/2017,65,16:00,16:15,45.49,34.03,0,45.49,34.03,2,-39127,42328,81455,3201,0,-2712,3041,0,0,,5753,329
4,01/21/2017,66,16:15,16:30,,32.98,0,32.98,32.98,-1,-34508,40808,75316,6300,0,-1932,0,0,0,,1932,-1932
4,01/21/2017,67,16:30,16:45,36.23,31.03,0,45.46,31.03,2,-38263,38511,76774,248,0,-13201,38,0,0,,13239,-13163
4,01/21/2017,68,16:45,17:00,38.96,31.03,0,38.96,38.96,1,-61182,53777,114959,-7405,0,-380,835,0,0,,1215,455
4,01/21/2017,69,17:00,17:15,,-18.92,0,-18.92,-18.92,-1,-5041,97635,102676,92594,0,-32877,0,0,0,,32877,-32877
4,01/21/2017,70,17:15,17:30,,33.63,0,33.63,33.63,-1,-33892,29813,63705,-4079,0,-13230,0,0,0,,13230,-13230
4,01/21/2017,71,17:30,17:45,52.02,,0,52.02,52.02,1,-67211,46477,113688,-20734,0,0,5324,0,0,,5324,5324
4,01/21/2017,72,17:45,18:00,71.91,,0,71.91,71.91,1,-78310,64397,142707,-13913,0,0,30610,0,0,,30610,30610
4,01/21/2017,73,18:00,18:15,71.91,-46.91,0,-46.91,-46.91,-1,-28801,96485,125286,67684,0,-27419,7736,0,0,,35155,-19683
4,01/21/2017,74,18:15,18:30,,28.97,0,28.97,28.97,-1,-26323,69739,96062,43416,0,-42165,0,0,0,,42165,-42165
4,01/21/2017,75,18:30,18:45,,28.98,0,28.98,28.98,-1,-28251,86129,114380,57878,0,-48546,0,0,0,,48546,-48546
4,01/21/2017,76,18:45,19:00,,20.55,0,20.55,20.55,-1,-25941,108577,134518,82636,0,-60713,0,0,0,,60713,-60713
4,01/21/2017,77,19:00,19:15,,28.97,0,28.97,28.97,-1,-65435,80492,145927,15057,0,-42418,0,0,0,,42418,-42418
4,01/21/2017,78,19:15,19:30,,-6.41,0,-6.41,-6.41,-1,-45162,104082,149244,58920,0,-17755,0,0,0,,17755,-17755
4,01/21/2017,79,19:30,19:45,,-45.57,0,-45.57,-45.57,-1,-43927,50009,93936,6082,0,-50442,0,0,0,,50442,-50442
4,01/21/2017,80,19:45,20:00,37.2,33.98,0,45.38,33.98,2,-48965,65865,114830,16900,0,-5373,983,0,0,,6356,-4390
4,01/21/2017,81,20:00,20:15,99.42,33.98,0,99.42,32.63,2,-68730,22014,90744,-46716,0,-1692,10665,0,0,,12357,8973
4,01/21/2017,82,20:15,20:30,36.88,,0,36.88,36.88,1,-47560,33982,81542,-13578,0,0,2584,0,0,,2584,2584
4,01/21/2017,83,20:30,20:45,36.88,34.21,0,34.21,34.21,-1,-34687,36054,70741,1367,0,-483,21,0,0,,504,-462
4,01/21/2017,84,20:45,21:00,,32.98,0,32.98,32.98,-1,-37383,58618,96001,21235,0,-10067,0,0,0,,10067,-10067
4,01/21/2017,85,21:00,21:15,,26.03,0,26.03,26.03,-1,-62698,78245,140943,15547,0,-20750,0,0,0,,20750,-20750
4,01/21/2017,86,21:15,21:30,,32.98,0,32.98,32.98,-1,-56208,76052,132260,19844,0,-7149,0,0,0,,7149,-7149
4,01/21/2017,87,21:30,21:45,,29.7,0,29.7,29.7,-1,-46522,72686,119208,26164,0,-29814,0,0,0,,29814,-29814
4,01/21/2017,88,21:45,22:00,,32.98,0,32.98,32.98,-1,-41666,74757,116423,33091,0,-25811,0,0,0,,25811,-25811
4,01/21/2017,89,22:00,22:15,,25.03,0,25.03,25.03,-1,-71516,76151,147667,4635,0,-32332,0,0,0,,32332,-32332
4,01/21/2017,90,22:15,22:30,37.79,28.98,0,37.79,28.98,2,-81103,90648,171751,9545,0,-6092,1387,0,0,,7479,-4705
4,01/21/2017,91,22:30,22:45,,18.07,0,18.07,18.07,-1,-49064,85426,134490,36362,0,-39175,0,0,0,,39175,-39175
4,01/21/2017,92,22:45,23:00,37.2,34.21,0,37.2,32.18,2,-42856,45880,88736,3024,0,-7093,825,0,0,,7918,-6268
4,01/21/2017,93,23:00,23:15,,30.05,0,30.05,30.05,-1,-88593,104753,193346,16160,0,-11701,0,0,0,,11701,-11701
4,01/21/2017,94,23:15,23:30,,35.19,0,35.19,35.19,-1,-97734,92348,190082,-5386,0,-292,0,0,0,,292,-292
4,01/21/2017,95,23:30,23:45,,33.98,0,33.98,33.98,-1,-76206,92045,168251,15839,0,-1633,0,0,0,,1633,-1633
4,01/21/2017,96,23:45,0:00,,28.98,0,28.98,28.98,-1,-80250,104882,185132,24632,0,-13848,0,0,0,,13848,-13848
4,01/22/2017,1,0:00,0:15,,-10.42,0,-10.42,-10.42,-1,-52483,125912,178395,73429,0,-40830,0,0,0,,40830,-40830
4,01/22/2017,2,0:15,0:30,38.96,-10.42,0,38.96,38.96,1,-62349,57815,120164,-4534,0,-2969,2563,0,0,,5532,-406
4,01/22/2017,3,0:30,0:45,36.23,,0,36.23,36.23,1,-61440,27701,89141,-33739,0,0,657,0,0,,657,657
4,01/22/2017,4,0:45,1:00,35.84,,0,35.84,35.84,1,-71453,28663,100116,-42790,0,0,1365,0,0,,1365,1365
4,01/22/2017,5,1:00,1:15,130.12,,0,130.12,130.12,1,-91891,36355,128246,-55536,0,0,14617,0,0,,14617,14617
4,01/22/2017,6,1:15,1:30,132.12,,0,132.12,132.12,1,-66789,29860,96649,-36929,0,0,57304,0,0,,57304,57304
4,01/22/2017,7,1:30,1:45,132.12,34.54,0,34.54,34.54,-1,-50231,58498,108729,8267,0,-379,2372,0,0,,2751,1993
4,01/22/2017,8,1:45,2:00,,34.46,0,34.46,34.46,-1,-53781,58985,112766,5204,0,-190,0,0,0,,190,-190
4,01/22/2017,9,2:00,2:15,36.52,34.46,0,36.52,32.94,2,-40505,38547,79052,-1958,0,-906,1781,0,0,,2687,875
4,01/22/2017,10,2:15,2:30,36.46,,0,36.46,36.46,1,-38058,38262,76320,204,0,0,2334,0,0,,2334,2334
4,01/22/2017,11,2:30,2:45,,,0,32.94,32.94,0,-29502,41009,70511,11507,0,0,56,0,0,,56,56
4,01/22/2017,12,2:45,3:00,,33.46,0,33.46,33.46,-1,-26444,41545,67989,15101,0,-7950,0,0,0,,7950,-7950
4,01/22/2017,13,3:00,3:15,28.03,34.78,0,28.03,28.03,1,-36679,35140,71819,-1539,0,-6283,17,0,0,,6300,-6266
4,01/22/2017,14,3:15,3:30,28.03,,0,28.03,28.03,1,-42003,26971,68974,-15032,0,0,286,0,0,,286,286
4,01/22/2017,15,3:30,3:45,28.03,,0,28.03,28.03,1,-38285,22198,60483,-16087,0,0,47,0,0,,47,47
4,01/22/2017,16,3:45,4:00,28.03,,0,28.03,28.03,1,-37086,23993,61079,-13093,0,0,175,0,0,,175,175
4,01/22/2017,17,4:00,4:15,49.77,,0,49.77,49.77,1,-96795,20599,117394,-76196,0,0,12465,0,0,,12465,12465
4,01/22/2017,18,4:15,4:30,39.23,,0,39.23,39.23,1,-87404,21844,109248,-65560,0,0,16867,0,0,,16867,16867
4,01/22/2017,19,4:30,4:45,43.62,,0,43.62,43.62,1,-89320,19738,109058,-69582,0,0,13750,0,0,,13750,13750
4,01/22/2017,20,4:45,5:00,46.46,,0,46.46,46.46,1,-89389,19120,108509,-70269,0,0,21942,0,0,,21942,21942
4,01/22/2017,21,5:00,5:15,48.71,,0,48.71,48.71,1,-89081,30120,119201,-58961,0,0,41324,0,0,,41324,41324
4,01/22/2017,22,5:15,5:30,43.09,,0,43.09,43.09,1,-87507,24917,112424,-62590,0,0,49166,0,0,,49166,49166
4,01/22/2017,23,5:30,5:45,48.71,,0,48.71,48.71,1,-94840,15039,109879,-79801,0,0,48953,0,0,,48953,48953
4,01/22/2017,24,5:45,6:00,46.46,,0,46.46,46.46,1,-78864,39532,118396,-39332,0,0,46046,0,0,,46046,46046
4,01/22/2017,25,6:00,6:15,67,,0,67,67,1,-96640,29155,125795,-67485,0,0,26796,0,0,,26796,26796
4,01/22/2017,26,6:15,6:30,70.44,,0,70.44,70.44,1,-72704,34180,106884,-38524,0,0,36353,0,0,,36353,36353
4,01/22/2017,27,6:30,6:45,36.7,,0,36.7,36.7,1,-75043,47612,122655,-27431,0,0,20298,0,0,,20298,20298
4,01/22/2017,28,6:45,7:00,40.46,,0,40.46,40.46,1,-83418,44485,127903,-38933,0,0,26065,0,0,,26065,26065
4,01/22/2017,29,7:00,7:15,35.86,35.4,0,35.4,35.4,-1,-73566,77014,150580,3448,0,-563,10718,0,0,,11281,10155
4,01/22/2017,30,7:15,7:30,51.11,,0,51.11,51.11,1,-83185,45897,129082,-37288,0,0,12112,0,0,,12112,12112
4,01/22/2017,31,7:30,7:45,114.55,,0,114.55,114.55,1,-113480,49401,162881,-64079,0,0,34229,0,0,,34229,34229
4,01/22/2017,32,7:45,8:00,132.12,,0,132.12,132.12,1,-139997,55166,195163,-84831,0,0,63303,0,0,,63303,63303
4,01/22/2017,33,8:00,8:15,46.46,,0,46.46,46.46,1,-113471,85316,198787,-28155,0,0,31877,0,0,,31877,31877
4,01/22/2017,34,8:15,8:30,,,0,32.88,32.88,0,-101648,51985,153633,-49663,0,0,12,0,0,,12,12
4,01/22/2017,35,8:30,8:45,120.06,,0,120.06,120.06,1,-112961,40362,153323,-72599,0,0,5770,0,0,,5770,5770
4,01/22/2017,36,8:45,9:00,132.12,,0,132.12,132.12,1,-137026,35965,172991,-101061,0,0,74349,0,0,,74349,74349
4,01/22/2017,37,9:00,9:15,93.12,34.36,0,34.36,34.36,-1,-105997,109613,215610,3616,0,-516,48443,0,0,,48959,47927
4,01/22/2017,38,9:15,9:30,108.64,34.36,0,108.64,108.64,1,-105968,69825,175793,-36143,0,-433,10287,0,0,,10720,9854
4,01/22/2017,39,9:30,9:45,139.12,,0,139.12,139.12,1,-113980,66216,180196,-47764,0,0,53791,0,0,,53791,53791
4,01/22/2017,40,9:45,10:00,46.46,,0,46.46,46.46,1,-115596,71203,186799,-44393,0,0,41009,0,0,,41009,41009
4,01/22/2017,41,10:00,10:15,54.59,,0,54.59,54.59,1,-110202,71822,182024,-38380,0,0,27981,0,0,,27981,27981
4,01/22/2017,42,10:15,10:30,113.8,,0,113.8,113.8,1,-120416,55353,175769,-65063,0,0,63473,0,0,,63473,63473
4,01/22/2017,43,10:30,10:45,51.27,,0,51.27,51.27,1,-115840,77288,193128,-38552,0,0,42970,0,0,,42970,42970
4,01/22/2017,44,10:45,11:00,39.27,,0,39.27,39.27,1,-106098,79621,185719,-26477,0,0,11680,0,0,,11680,11680
4,01/22/2017,45,11:00,11:15,39.27,35.01,0,35.01,35.01,-1,-87038,82446,169484,-4592,0,-106,9088,0,0,,9194,8982
4,01/22/2017,46,11:15,11:30,39.27,33.45,0,33.45,33.45,-1,-71072,84786,155858,13714,0,-15379,496,0,0,,15875,-14883
4,01/22/2017,47,11:30,11:45,,34.28,0,34.28,34.28,-1,-72444,80468,152912,8024,0,-16710,0,0,0,,16710,-16710
4,01/22/2017,48,11:45,12:00,57.88,34.46,0,57.88,57.88,1,-122281,84144,206425,-38137,0,-11411,9199,0,0,,20610,-2212
4,01/22/2017,49,12:00,12:15,38.78,34.46,0,38.78,38.78,1,-89413,73861,163274,-15552,0,-4,11032,0,0,,11036,11028
4,01/22/2017,50,12:15,12:30,38.78,35.4,0,35.4,35.4,-1,-86681,78115,164796,-8566,0,-12,505,0,0,,517,493
4,01/22/2017,51,12:30,12:45,,35.4,0,35.4,35.4,-1,-88060,70540,158600,-17520,0,-692,0,0,0,,692,-692
4,01/22/2017,52,12:45,13:00,,35.78,0,35.78,35.78,-1,-85274,75582,160856,-9692,0,-474,0,0,0,,474,-474
4,01/22/2017,53,13:00,13:15,,35.78,0,35.78,35.78,-1,-58538,73824,132362,15286,0,-606,0,0,0,,606,-606
4,01/22/2017,54,13:15,13:30,,34.46,0,34.46,34.46,-1,-61314,74817,136131,13503,0,-2162,0,0,0,,2162,-2162
4,01/22/2017,55,13:30,13:45,,33.46,0,33.46,33.46,-1,-48603,70921,119524,22318,0,-5640,0,0,0,,5640,-5640
4,01/22/2017,56,13:45,14:00,,29.46,0,29.46,29.46,-1,-45421,79356,124777,33935,0,-14061,0,0,0,,14061,-14061
4,01/22/2017,57,14:00,14:15,,29.46,0,29.46,29.46,-1,-25019,67170,92189,42151,0,-25400,0,0,0,,25400,-25400
4,01/22/2017,58,14:15,14:30,,29.16,0,29.16,29.16,-1,-21493,67123,88616,45630,0,-13024,0,0,0,,13024,-13024
4,01/22/2017,59,14:30,14:45,,29.16,0,29.16,29.16,-1,-22979,58791,81770,35812,0,-37436,0,0,0,,37436,-37436
4,01/22/2017,60,14:45,15:00,,34.36,0,34.36,34.36,-1,-34532,51946,86478,17414,0,-15917,0,0,0,,15917,-15917
4,01/22/2017,61,15:00,15:15,37.61,29.16,0,37.61,29.16,2,-47391,78329,125720,30938,0,-3117,54,0,0,,3171,-3063
4,01/22/2017,62,15:15,15:30,,21.2,0,21.2,21.2,-1,-42100,79509,121609,37409,0,-29409,0,0,0,,29409,-29409
4,01/22/2017,63,15:30,15:45,,35.4,0,35.4,35.4,-1,-45142,72556,117698,27414,0,-5071,0,0,0,,5071,-5071
4,01/22/2017,64,15:45,16:00,,33.94,0,33.94,33.94,-1,-55299,72596,127895,17297,0,-6118,0,0,0,,6118,-6118
4,01/22/2017,65,16:00,16:15,,33.75,0,33.75,33.75,-1,-40255,51141,91396,10886,0,-3048,0,0,0,,3048,-3048
4,01/22/2017,66,16:15,16:30,41.27,33.75,0,41.27,41.27,1,-46257,40285,86542,-5972,0,-314,3242,0,0,,3556,2928
4,01/22/2017,67,16:30,16:45,36.05,,0,36.05,36.05,1,-62543,50390,112933,-12153,0,0,590,0,0,,590,590
4,01/22/2017,68,16:45,17:00,52.59,,0,52.59,52.59,1,-107187,66407,173594,-40780,0,0,18765,0,0,,18765,18765
4,01/22/2017,69,17:00,17:15,37.61,-6.59,0,45.39,-6.59,2,-37329,87257,124586,49928,0,-20973,8841,0,0,,29814,-12132
4,01/22/2017,70,17:15,17:30,58.8,34.46,0,58.8,58.8,1,-94093,37981,132074,-56112,0,-5903,1476,0,0,,7379,-4427
4,01/22/2017,71,17:30,17:45,158.62,,0,158.62,158.62,1,-168031,37148,205179,-130883,0,0,56051,0,0,,56051,56051
4,01/22/2017,72,17:45,18:00,158.62,,0,158.62,158.62,1,-181200,43993,225193,-137207,0,0,94652,0,0,,94652,94652
4,01/22/2017,73,18:00,18:15,194.45,,0,194.45,194.45,1,-100840,48554,149394,-52286,0,0,78642,0,0,,78642,78642
4,01/22/2017,74,18:15,18:30,194.45,33.46,0,33.46,33.46,-1,-57957,64542,122499,6585,0,-4513,9160,0,0,,13673,4647
4,01/22/2017,75,18:30,18:45,,35.01,0,35.01,35.01,-1,-53415,66019,119434,12604,0,-477,0,0,0,,477,-477
4,01/22/2017,76,18:45,19:00,,33.75,0,33.75,33.75,-1,-48369,66908,115277,18539,0,-4249,0,0,0,,4249,-4249
4,01/22/2017,77,19:00,19:15,55.89,35.4,0,55.89,35.4,2,-61680,42232,103912,-19448,0,-2705,5359,0,0,,8064,2654
4,01/22/2017,78,19:15,19:30,40.21,,0,40.21,40.21,1,-57925,38285,96210,-19640,0,0,9299,0,0,,9299,9299
4,01/22/2017,79,19:30,19:45,38.78,,0,38.78,38.78,1,-47530,40110,87640,-7420,0,0,9204,0,0,,9204,9204
4,01/22/2017,80,19:45,20:00,45,,0,45,45,1,-49437,38531,87968,-10906,0,0,5917,0,0,,5917,5917
4,01/22/2017,81,20:00,20:15,140.12,,0,140.12,140.12,1,-122592,45110,167702,-77482,0,0,43196,0,0,,43196,43196
4,01/22/2017,82,20:15,20:30,56.12,,0,56.12,56.12,1,-88619,53267,141886,-35352,0,0,54218,0,0,,54218,54218
4,01/22/2017,83,20:30,20:45,56.12,35.01,0,35.01,35.01,-1,-57373,56604,113977,-769,0,-533,13104,0,0,,13637,12571
4,01/22/2017,84,20:45,21:00,,28.79,0,28.79,28.79,-1,-48023,61209,109232,13186,0,-3166,0,0,0,,3166,-3166
4,01/22/2017,85,21:00,21:15,,25.78,0,25.78,25.78,-1,-49861,92010,141871,42149,0,-10157,0,0,0,,10157,-10157
4,01/22/2017,86,21:15,21:30,,29.46,0,29.46,29.46,-1,-44439,75845,120284,31406,0,-5316,0,0,0,,5316,-5316
4,01/22/2017,87,21:30,21:45,,29.16,0,29.16,29.16,-1,-38767,78402,117169,39635,0,-35236,0,0,0,,35236,-35236
4,01/22/2017,88,21:45,22:00,,29.46,0,29.46,29.46,-1,-43467,108857,152324,65390,0,-32032,0,0,0,,32032,-32032
4,01/22/2017,89,22:00,22:15,37.61,33.46,0,37.61,37.61,1,-72634,26824,99458,-45810,0,-19292,714,0,0,,20006,-18578
4,01/22/2017,90,22:15,22:30,38.12,33.46,0,38.12,38.12,1,-56859,28572,85431,-28287,0,-284,644,0,0,,928,360
4,01/22/2017,91,22:30,22:45,,35.78,0,35.78,35.78,-1,-42569,41018,83587,-1551,0,-195,0,0,0,,195,-195
4,01/22/2017,92,22:45,23:00,,33.94,0,33.94,33.94,-1,-41783,64690,106473,22907,0,-1025,0,0,0,,1025,-1025
4,01/22/2017,93,23:00,23:15,,34.03,0,34.03,34.03,-1,-60780,49341,110121,-11439,0,-1617,0,0,0,,1617,-1617
4,01/22/2017,94,23:15,23:30,,,0,31.69,31.69,0,-66922,38498,105420,-28424,0,0,0,0,0,,0,0
4,01/22/2017,95,23:30,23:45,,,0,31.69,31.69,0,-48958,40777,89735,-8181,0,0,0,0,0,,0,0
4,01/22/2017,96,23:45,0:00,,34.36,0,34.36,34.36,-1,-43552,69051,112603,25499,0,-1786,0,0,0,,1786,-1786
4,01/23/2017,1,0:00,0:15,37.21,39.59,0,37.21,37.21,1,-63358,59737,123095,-3621,0,-368,631,0,0,,999,263
4,01/23/2017,2,0:15,0:30,41.19,,0,41.19,41.19,1,-75427,42905,118332,-32522,0,0,15595,0,0,,15595,15595
4,01/23/2017,3,0:30,0:45,36.28,,0,36.28,36.28,1,-64698,36113,100811,-28585,0,0,9819,0,0,,9819,9819
4,01/23/2017,4,0:45,1:00,,,0,34.16,34.16,0,-69079,55559,124638,-13520,0,0,1336,0,0,,1336,1336
4,01/23/2017,5,1:00,1:15,51.59,,0,51.59,51.59,1,-71527,32189,103716,-39338,0,0,8049,0,0,,8049,8049
4,01/23/2017,6,1:15,1:30,51.59,,0,51.59,51.59,1,-64096,32039,96135,-32057,0,0,24837,0,0,,24837,24837
4,01/23/2017,7,1:30,1:45,37.61,,0,37.61,37.61,1,-62795,34813,97608,-27982,0,0,6794,0,0,,6794,6794
4,01/23/2017,8,1:45,2:00,38.78,,0,38.78,38.78,1,-52933,36150,89083,-16783,0,0,3800,0,0,,3800,3800
4,01/23/2017,9,2:00,2:15,42.09,,0,42.09,42.09,1,-78712,34452,113164,-44260,0,0,13263,0,0,,13263,13263
4,01/23/2017,10,2:15,2:30,38.78,,0,38.78,38.78,1,-70494,35379,105873,-35115,0,0,18521,0,0,,18521,18521
4,01/23/2017,11,2:30,2:45,,,0,34.16,34.16,0,-59854,32497,92351,-27357,0,0,4032,0,0,,4032,4032
4,01/23/2017,12,2:45,3:00,35.66,,0,35.66,35.66,1,-61982,33252,95234,-28730,0,0,541,0,0,,541,541
4,01/23/2017,13,3:00,3:15,39.39,,0,39.39,39.39,1,-66370,36336,102706,-30034,0,0,4841,0,0,,4841,4841
4,01/23/2017,14,3:15,3:30,41.59,,0,41.59,41.59,1,-66455,34671,101126,-31784,0,0,27355,0,0,,27355,27355
4,01/23/2017,15,3:30,3:45,38.78,,0,38.78,38.78,1,-58279,32858,91137,-25421,0,0,17964,0,0,,17964,17964
4,01/23/2017,16,3:45,4:00,36.7,,0,36.7,36.7,1,-62276,33279,95555,-28997,0,0,16242,0,0,,16242,16242
4,01/23/2017,17,4:00,4:15,39.39,,0,39.39,39.39,1,-49644,32828,82472,-16816,0,0,15754,0,0,,15754,15754
4,01/23/2017,18,4:15,4:30,39.05,39.59,0,39.05,34.21,2,-56071,28698,84769,-27373,0,-44,2889,0,0,,2933,2845
4,01/23/2017,19,4:30,4:45,45.59,,0,45.59,45.59,1,-63172,25412,88584,-37760,0,0,23654,0,0,,23654,23654
4,01/23/2017,20,4:45,5:00,46.45,,0,46.45,46.45,1,-60932,30465,91397,-30467,0,0,46464,0,0,,46464,46464
4,01/23/2017,21,5:00,5:15,45.59,,0,45.59,45.59,1,-107560,33438,140998,-74122,0,0,37665,0,0,,37665,37665
4,01/23/2017,22,5:15,5:30,64.78,,0,64.78,64.78,1,-89862,19186,109048,-70676,0,0,11435,0,0,,11435,11435
4,01/23/2017,23,5:30,5:45,75.34,,0,75.34,75.34,1,-95999,27031,123030,-68968,0,0,55900,0,0,,55900,55900
4,01/23/2017,24,5:45,6:00,48.02,,0,48.02,48.02,1,-101298,65994,167292,-35304,0,0,52088,0,0,,52088,52088
4,01/23/2017,25,6:00,6:15,48.02,34.39,0,34.39,34.39,-1,-112176,103273,215449,-8903,0,-1286,9831,0,0,,11117,8545
4,01/23/2017,26,6:15,6:30,28.69,34.39,0,28.69,28.69,1,-55215,50027,105242,-5188,0,-119,31,0,0,,150,-88
4,01/23/2017,27,6:30,6:45,45.59,,0,45.59,45.59,1,-75021,57750,132771,-17271,0,0,4694,0,0,,4694,4694
4,01/23/2017,28,6:45,7:00,45.59,9.02,0,9.02,9.02,-1,-110613,87864,198477,-22749,0,-3814,11674,0,0,,15488,7860
4,01/23/2017,29,7:00,7:15,40.66,-14.99,0,46.44,-14.99,2,-63243,52800,116043,-10443,0,-37397,477,0,0,,37874,-36920
4,01/23/2017,30,7:15,7:30,156.17,-14.99,0,156.17,156.17,1,-77805,30511,108316,-47294,0,-1049,24293,0,0,,25342,23244
4,01/23/2017,31,7:30,7:45,156.17,,0,156.17,156.17,1,-129219,46341,175560,-82878,0,0,37081,0,0,,37081,37081
4,01/23/2017,32,7:45,8:00,156.17,,0,156.17,156.17,1,-202056,45743,247799,-156313,0,0,87952,0,0,,87952,87952
4,01/23/2017,33,8:00,8:15,117.28,34.81,0,34.81,34.81,-1,-38020,61488,99508,23468,0,-439,45248,0,0,,45687,44809
4,01/23/2017,34,8:15,8:30,65.45,34.81,0,65.45,65.45,1,-78292,41228,119520,-37064,0,-26,14641,0,0,,14667,14615
4,01/23/2017,35,8:30,8:45,65.45,,0,65.45,65.45,1,-85549,45241,130790,-40308,0,0,34394,0,0,,34394,34394
4,01/23/2017,36,8:45,9:00,54.45,,0,54.45,54.45,1,-76690,34998,111688,-41692,0,0,38752,0,0,,38752,38752
4,01/23/2017,37,9:00,9:15,74.83,,0,74.83,74.83,1,-73924,26223,100147,-47701,0,0,35196,0,0,,35196,35196
4,01/23/2017,38,9:15,9:30,42.35,,0,42.35,42.35,1,-60675,27813,88488,-32862,0,0,28486,0,0,,28486,28486
4,01/23/2017,39,9:30,9:45,40.69,,0,40.69,40.69,1,-52689,26650,79339,-26039,0,0,15951,0,0,,15951,15951
4,01/23/2017,40,9:45,10:00,97.02,,0,97.02,97.02,1,-67178,20402,87580,-46776,0,0,13809,0,0,,13809,13809
4,01/23/2017,41,10:00,10:15,169.36,,0,169.36,169.36,1,-112667,17363,130030,-95304,0,0,56628,0,0,,56628,56628
4,01/23/2017,42,10:15,10:30,169.36,,0,169.36,169.36,1,-108119,21303,129422,-86816,0,0,72841,0,0,,72841,72841
4,01/23/2017,43,10:30,10:45,135.02,,0,135.02,135.02,1,-117190,24707,141897,-92483,0,0,79336,0,0,,79336,79336
4,01/23/2017,44,10:45,11:00,97.02,,0,97.02,97.02,1,-107299,26584,133883,-80715,0,0,54821,0,0,,54821,54821
4,01/23/2017,45,11:00,11:15,156.31,,0,156.31,156.31,1,-126859,26940,153799,-99919,0,0,62644,0,0,,62644,62644
4,01/23/2017,46,11:15,11:30,156.31,,0,156.31,156.31,1,-145846,24698,170544,-121148,0,0,92844,0,0,,92844,92844
4,01/23/2017,47,11:30,11:45,156.31,,0,156.31,156.31,1,-123783,25942,149725,-97841,0,0,93040,0,0,,93040,93040
4,01/23/2017,48,11:45,12:00,97.02,,0,97.02,97.02,1,-132305,32316,164621,-99989,0,0,75074,0,0,,75074,75074
4,01/23/2017,49,12:00,12:15,159.66,,0,159.66,159.66,1,-197065,24649,221714,-172416,0,0,72852,0,0,,72852,72852
4,01/23/2017,50,12:15,12:30,194.59,,0,194.59,194.59,1,-163678,30878,194556,-132800,0,0,88280,5000,0,,93280,93280
4,01/23/2017,51,12:30,12:45,125.1,,0,125.1,125.1,1,-120798,41661,162459,-79137,0,0,50106,5000,0,,55106,55106
4,01/23/2017,52,12:45,13:00,70.3,,0,70.3,70.3,1,-106367,47169,153536,-59198,0,0,54689,0,0,,54689,54689
4,01/23/2017,53,13:00,13:15,194.59,,0,194.59,194.59,1,-89919,6559,96478,-83360,0,0,55580,0,0,,55580,55580
4,01/23/2017,54,13:15,13:30,361.76,,0,361.76,361.76,1,-115234,5287,120521,-109947,0,0,89077,5000,0,,94077,94077
4,01/23/2017,55,13:30,13:45,361.76,,0,361.76,361.76,1,-104739,11602,116341,-93137,0,0,76461,5000,0,,81461,81461
4,01/23/2017,56,13:45,14:00,361.76,,0,361.76,361.76,1,-81861,18988,100849,-62873,0,0,56280,5000,0,,61280,61280
4,01/23/2017,57,14:00,14:15,72.08,,0,72.08,72.08,1,-60933,16905,77838,-44028,0,0,5523,0,0,,5523,5523
4,01/23/2017,58,14:15,14:30,128,,0,128,128,1,-97310,17872,115182,-79438,0,0,38190,0,0,,38190,38190
4,01/23/2017,59,14:30,14:45,86.63,,0,86.63,86.63,1,-117686,22524,140210,-95162,0,0,50976,0,0,,50976,50976
4,01/23/2017,60,14:45,15:00,72.08,,0,72.08,72.08,1,-105186,27083,132269,-78103,0,0,54512,0,0,,54512,54512
4,01/23/2017,61,15:00,15:15,66.02,,0,66.02,66.02,1,-70458,41895,112353,-28563,0,0,42987,0,0,,42987,42987
4,01/23/2017,62,15:15,15:30,60.61,,0,60.61,60.61,1,-67127,29520,96647,-37607,0,0,10419,0,0,,10419,10419
4,01/23/2017,63,15:30,15:45,143.02,,0,143.02,143.02,1,-80117,9714,89831,-70403,0,0,49678,0,0,,49678,49678
4,01/23/2017,64,15:45,16:00,143.02,,0,143.02,143.02,1,-85036,13633,98669,-71403,0,0,70186,0,0,,70186,70186
4,01/23/2017,65,16:00,16:15,42.09,,0,42.09,42.09,1,-70973,64696,135669,-6277,0,0,25463,0,0,,25463,25463
4,01/23/2017,66,16:15,16:30,163.23,,0,163.23,163.23,1,-75642,31580,107222,-44062,0,0,7961,0,0,,7961,7961
4,01/23/2017,67,16:30,16:45,163.23,,0,163.23,163.23,1,-66194,24710,90904,-41484,0,0,53460,0,0,,53460,53460
4,01/23/2017,68,16:45,17:00,120.02,,0,120.02,120.02,1,-66449,29903,96352,-36546,0,0,41442,0,0,,41442,41442
4,01/23/2017,69,17:00,17:15,199.51,35.46,0,199.51,20.84,2,-44004,53649,97653,9645,0,-847,31715,0,0,,32562,30868
4,01/23/2017,70,17:15,17:30,209.98,35.17,0,209.98,20.84,2,-91325,38457,129782,-52868,0,-1083,11876,0,0,,12959,10793
4,01/23/2017,71,17:30,17:45,209.98,,0,209.98,209.98,1,-85834,39039,124873,-46795,0,0,49019,0,0,,49019,49019
4,01/23/2017,72,17:45,18:00,38.06,,0,38.06,38.06,1,-74437,57329,131766,-17108,0,0,14403,0,0,,14403,14403
4,01/23/2017,73,18:00,18:15,41.19,,0,41.19,41.19,1,-92570,34723,127293,-57847,0,0,7992,0,0,,7992,7992
4,01/23/2017,74,18:15,18:30,36.11,,0,36.11,36.11,1,-73323,59188,132511,-14135,0,0,2954,0,0,,2954,2954
4,01/23/2017,75,18:30,18:45,36.5,,0,36.5,36.5,1,-79463,65091,144554,-14372,0,0,554,0,0,,554,554
4,01/23/2017,76,18:45,19:00,104.44,,0,104.44,104.44,1,-79872,57258,137130,-22614,0,0,5910,0,0,,5910,5910
4,01/23/2017,77,19:00,19:15,183.48,,0,183.48,183.48,1,-95419,17348,112767,-78071,0,0,49989,0,0,,49989,49989
4,01/23/2017,78,19:15,19:30,69.67,35.46,0,35.46,35.46,-1,-57197,40921,98118,-16276,0,-446,27415,0,0,,27861,26969
4,01/23/2017,79,19:30,19:45,69.67,34.59,0,34.59,34.59,-1,-61748,40468,102216,-21280,0,-3369,771,0,0,,4140,-2598
4,01/23/2017,80,19:45,20:00,,,0,38.94,38.94,0,-56537,39744,96281,-16793,0,0,0,0,0,,0,0
4,01/23/2017,81,20:00,20:15,42.09,,0,42.09,42.09,1,-86513,46391,132904,-40122,0,0,2465,0,0,,2465,2465
4,01/23/2017,82,20:15,20:30,39.23,,0,39.23,39.23,1,-80741,39760,120501,-40981,0,0,1303,0,0,,1303,1303
4,01/23/2017,83,20:30,20:45,,,0,37.85,37.85,0,-74983,60334,135317,-14649,0,0,0,0,0,,0,0
4,01/23/2017,84,20:45,21:00,,35.03,0,35.03,35.03,-1,-66557,76442,142999,9885,0,-2246,0,0,0,,2246,-2246
4,01/23/2017,85,21:00,21:15,37.15,39.59,0,37.15,34.16,2,-86020,88429,174449,2409,0,-1108,1329,0,0,,2437,221
4,01/23/2017,86,21:15,21:30,37.76,35.46,0,37.76,34.16,2,-67186,67904,135090,718,0,-388,2204,0,0,,2592,1816
4,01/23/2017,87,21:30,21:45,37.76,32.73,0,32.73,32.73,-1,-56046,78681,134727,22635,0,-20396,2,0,0,,20398,-20394
4,01/23/2017,88,21:45,22:00,,28.09,0,28.09,28.09,-1,-68720,95835,164555,27115,0,-11747,0,0,0,,11747,-11747
4,01/23/2017,89,22:00,22:15,37.76,20.82,0,37.76,20.82,2,-65898,88141,154039,22243,0,-25016,503,0,0,,25519,-24513
4,01/23/2017,90,22:15,22:30,52.62,20.82,0,52.62,52.62,1,-78956,51123,130079,-27833,0,-349,10671,0,0,,11020,10322
4,01/23/2017,91,22:30,22:45,52.62,33.61,0,33.61,33.61,-1,-52333,71075,123408,18742,0,-9317,1651,0,0,,10968,-7666
4,01/23/2017,92,22:45,23:00,,20.82,0,20.82,20.82,-1,-67185,108458,175643,41273,0,-24645,0,0,0,,24645,-24645
4,01/23/2017,93,23:00,23:15,74.48,5.03,0,74.48,5.03,2,-62304,29471,91775,-32833,0,-26249,3900,0,0,,30149,-22349
4,01/23/2017,94,23:15,23:30,36.2,5.03,0,36.2,36.2,1,-57439,37909,95348,-19530,0,-197,2475,0,0,,2672,2278
4,01/23/2017,95,23:30,23:45,,35.85,0,35.85,35.85,-1,-46302,39962,86264,-6340,0,-249,0,0,0,,249,-249
4,01/23/2017,96,23:45,0:00,,31.3,0,31.3,31.3,-1,-43620,67588,111208,23968,0,-9461,0,0,0,,9461,-9461
4,01/24/2017,1,0:00,0:15,,15.48,0,15.48,15.48,-1,-32716,87213,119929,54497,0,-35418,0,0,0,,35418,-35418
4,01/24/2017,2,0:15,0:30,,35.02,0,35.02,35.02,-1,-40445,45939,86384,5494,0,-8879,0,0,0,,8879,-8879
4,01/24/2017,3,0:30,0:45,,35.02,0,35.02,35.02,-1,-53118,55313,108431,2195,0,-4323,0,0,0,,4323,-4323
4,01/24/2017,4,0:45,1:00,,30.73,0,30.73,30.73,-1,-48895,78643,127538,29748,0,-16334,0,0,0,,16334,-16334
4,01/24/2017,5,1:00,1:15,125.12,35.02,0,125.12,33.52,2,-99256,38359,137615,-60897,0,-11918,12702,0,0,,24620,784
4,01/24/2017,6,1:15,1:30,42.06,35.6,0,35.6,35.6,-1,-57702,48369,106071,-9333,0,-286,13965,0,0,,14251,13679
4,01/24/2017,7,1:30,1:45,39.44,35.78,0,39.44,34.04,2,-68415,49038,117453,-19377,0,-401,2031,0,0,,2432,1630
4,01/24/2017,8,1:45,2:00,37.62,35.02,0,37.62,34.04,2,-61898,55281,117179,-6617,0,-177,493,0,0,,670,316
4,01/24/2017,9,2:00,2:15,41.34,34.66,0,41.34,34.66,2,-46822,49943,96765,3121,0,-5528,529,0,0,,6057,-4999
4,01/24/2017,10,2:15,2:30,44.29,,0,44.29,44.29,1,-57240,36374,93614,-20866,0,0,15500,0,0,,15500,15500
4,01/24/2017,11,2:30,2:45,39.02,,0,39.02,39.02,1,-57114,38390,95504,-18724,0,0,6913,0,0,,6913,6913
4,01/24/2017,12,2:45,3:00,,,0,34.68,34.68,0,-47829,45908,93737,-1921,0,0,629,0,0,,629,629
4,01/24/2017,13,3:00,3:15,75.12,,0,75.12,75.12,1,-75749,25427,101176,-50322,0,0,14893,0,0,,14893,14893
4,01/24/2017,14,3:15,3:30,41.34,,0,41.34,41.34,1,-47855,34818,82673,-13037,0,0,10843,0,0,,10843,10843
4,01/24/2017,15,3:30,3:45,44.29,,0,44.29,44.29,1,-58176,32600,90776,-25576,0,0,4791,0,0,,4791,4791
4,01/24/2017,16,3:45,4:00,37.29,,0,37.29,37.29,1,-61265,30403,91668,-30862,0,0,2111,0,0,,2111,2111
4,01/24/2017,17,4:00,4:15,,29.99,0,29.99,29.99,-1,-47995,85099,133094,37104,0,-13428,0,0,0,,13428,-13428
4,01/24/2017,18,4:15,4:30,,29.99,0,29.99,29.99,-1,-39371,52939,92310,13568,0,-22770,0,0,0,,22770,-22770
4,01/24/2017,19,4:30,4:45,,37.77,0,37.77,37.77,-1,-44973,49586,94559,4613,0,-6879,0,0,0,,6879,-6879
4,01/24/2017,20,4:45,5:00,,39.17,0,39.17,39.17,-1,-47510,44886,92396,-2624,0,-3509,0,0,0,,3509,-3509
4,01/24/2017,21,5:00,5:15,,29.66,0,29.66,29.66,-1,-37721,70387,108108,32666,0,-16466,0,0,0,,16466,-16466
4,01/24/2017,22,5:15,5:30,,35.02,0,35.02,35.02,-1,-45734,48204,93938,2470,0,-14139,0,0,0,,14139,-14139
4,01/24/2017,23,5:30,5:45,41.34,35.02,0,41.34,41.34,1,-47114,29559,76673,-17555,0,-429,2925,0,0,,3354,2496
4,01/24/2017,24,5:45,6:00,82.62,,0,82.62,82.62,1,-73719,30346,104065,-43373,0,0,13884,0,0,,13884,13884
4,01/24/2017,25,6:00,6:15,101.48,22.99,0,22.99,22.99,-1,-80720,129419,210139,48699,0,-7003,15255,0,0,,22258,8252
4,01/24/2017,26,6:15,6:30,45.57,22.99,0,45.57,45.57,1,-73448,59534,132982,-13914,0,-9321,786,0,0,,10107,-8535
4,01/24/2017,27,6:30,6:45,62.3,,0,62.3,62.3,1,-85998,43983,129981,-42015,0,0,17563,0,0,,17563,17563
4,01/24/2017,28,6:45,7:00,101.48,,0,101.48,101.48,1,-122672,52326,174998,-70346,0,0,50716,0,0,,50716,50716
4,01/24/2017,29,7:00,7:15,101.48,-12.33,0,-12.33,-12.33,-1,-89477,191133,280610,101656,0,-17239,22001,0,0,,39240,4762
4,01/24/2017,30,7:15,7:30,,34.92,0,34.92,34.92,-1,-74775,90524,165299,15749,0,-11735,0,0,0,,11735,-11735
4,01/24/2017,31,7:30,7:45,91.49,36.78,0,91.49,91.49,1,-94412,69055,163467,-25357,0,-4494,2959,0,0,,7453,-1535
4,01/24/2017,32,7:45,8:00,250,36.78,0,250,250,1,-164779,57399,222178,-107380,0,-30,67375,0,0,,67405,67345
4,01/24/2017,33,8:00,8:15,,,0,40.17,40.17,0,-44553,37349,81902,-7204,0,0,42239,0,0,,42239,42239
4,01/24/2017,34,8:15,8:30,236.74,,0,236.74,236.74,1,-66310,25149,91459,-41161,0,0,16321,0,0,,16321,16321
4,01/24/2017,35,8:30,8:45,236.74,,0,236.74,236.74,1,-56133,23345,79478,-32788,0,0,24409,0,0,,24409,24409
4,01/24/2017,36,8:45,9:00,55.29,,0,55.29,55.29,1,-100574,20910,121484,-79664,0,0,7074,0,0,,7074,7074
4,01/24/2017,37,9:00,9:15,44.29,,0,44.29,44.29,1,-52988,12709,65697,-40279,0,0,10235,0,0,,10235,10235
4,01/24/2017,38,9:15,9:30,172.98,,0,172.98,172.98,1,-78332,10207,88539,-68125,0,0,28687,0,0,,28687,28687
4,01/24/2017,39,9:30,9:45,116.12,,0,116.12,116.12,1,-63402,11670,75072,-51732,0,0,40312,0,0,,40312,40312
4,01/24/2017,40,9:45,10:00,139.4,,0,139.4,139.4,1,-70894,10865,81759,-60029,0,0,39284,0,0,,39284,39284
4,01/24/2017,41,10:00,10:15,251.07,,0,251.07,251.07,1,-90977,9439,100416,-81538,0,0,58824,0,0,,58824,58824
4,01/24/2017,42,10:15,10:30,65.12,,0,65.12,65.12,1,-57508,25426,82934,-32082,0,0,29817,0,0,,29817,29817
4,01/24/2017,43,10:30,10:45,43.15,,0,43.15,43.15,1,-71996,19821,91817,-52175,0,0,458,0,0,,458,458
4,01/24/2017,44,10:45,11:00,87.12,,0,87.12,87.12,1,-79275,13030,92305,-66245,0,0,21247,0,0,,21247,21247
4,01/24/2017,45,11:00,11:15,71.12,,0,71.12,71.12,1,-83364,17145,100509,-66219,0,0,30150,0,0,,30150,30150
4,01/24/2017,46,11:15,11:30,141,,0,141,141,1,-90382,8670,99052,-81712,0,0,23348,0,0,,23348,23348
4,01/24/2017,47,11:30,11:45,43.73,,0,43.73,43.73,1,-89214,16587,105801,-72627,0,0,11495,0,0,,11495,11495
4,01/24/2017,48,11:45,12:00,48.29,,0,48.29,48.29,1,-97976,17248,115224,-80728,0,0,3837,0,0,,3837,3837
4,01/24/2017,49,12:00,12:15,198.1,,0,198.1,198.1,1,-134391,11881,146272,-122510,0,0,36234,0,0,,36234,36234
4,01/24/2017,50,12:15,12:30,60.29,,0,60.29,60.29,1,-110500,7239,117739,-103261,0,0,35369,0,0,,35369,35369
4,01/24/2017,51,12:30,12:45,43.15,,0,43.15,43.15,1,-96590,18985,115575,-77605,0,0,10078,0,0,,10078,10078
4,01/24/2017,52,12:45,13:00,127.58,,0,127.58,127.58,1,-89704,15785,105489,-73919,0,0,17978,0,0,,17978,17978
4,01/24/2017,53,13:00,13:15,123.68,,0,123.68,123.68,1,-115559,20816,136375,-94743,0,0,20343,0,0,,20343,20343
4,01/24/2017,54,13:15,13:30,97.68,,0,97.68,97.68,1,-122565,8290,130855,-114275,0,0,31507,0,0,,31507,31507
4,01/24/2017,55,13:30,13:45,59.12,,0,59.12,59.12,1,-125668,12022,137690,-113646,0,0,30356,0,0,,30356,30356
4,01/24/2017,56,13:45,14:00,55.29,,0,55.29,55.29,1,-132787,14016,146803,-118771,0,0,27562,0,0,,27562,27562
4,01/24/2017,57,14:00,14:15,212.21,,0,212.21,212.21,1,-122635,18656,141291,-103979,0,0,52370,0,0,,52370,52370
4,01/24/2017,58,14:15,14:30,212.21,,0,212.21,212.21,1,-107884,13876,121760,-94008,0,0,81312,0,0,,81312,81312
4,01/24/2017,59,14:30,14:45,212.21,,0,212.21,212.21,1,-94598,12708,107306,-81890,0,0,47497,1250,0,,48747,48747
4,01/24/2017,60,14:45,15:00,102.21,,0,102.21,102.21,1,-96710,13060,109770,-83650,0,0,43363,0,0,,43363,43363
4,01/24/2017,61,15:00,15:15,217.18,,0,217.18,217.18,1,-104594,8479,113073,-96115,0,0,51438,0,0,,51438,51438
4,01/24/2017,62,15:15,15:30,107.18,,0,107.18,107.18,1,-104352,7918,112270,-96434,0,0,38967,0,0,,38967,38967
4,01/24/2017,63,15:30,15:45,217.18,,0,217.18,217.18,1,-116197,10939,127136,-105258,0,0,19116,0,0,,19116,19116
4,01/24/2017,64,15:45,16:00,217.18,,0,217.18,217.18,1,-125800,10209,136009,-115591,0,0,77315,0,0,,77315,77315
4,01/24/2017,65,16:00,16:15,195.76,,0,195.76,195.76,1,-83998,14844,98842,-69154,0,0,68398,0,0,,68398,68398
4,01/24/2017,66,16:15,16:30,186.44,,0,186.44,186.44,1,-86123,23354,109477,-62769,0,0,49137,0,0,,49137,49137
4,01/24/2017,67,16:30,16:45,126,,0,126,126,1,-82857,23139,105996,-59718,0,0,52594,0,0,,52594,52594
4,01/24/2017,68,16:45,17:00,220,,0,220,220,1,-106352,22721,129073,-83631,0,0,74059,0,0,,74059,74059
4,01/24/2017,69,17:00,17:15,233.76,35.02,0,35.02,35.02,-1,-42031,101864,143895,59833,0,-2285,49790,0,0,,52075,47505
4,01/24/2017,70,17:15,17:30,41.44,40.64,0,41.44,41.44,1,-50647,62399,113046,11752,0,-1590,297,0,0,,1887,-1293
4,01/24/2017,71,17:30,17:45,111.01,,0,111.01,111.01,1,-83970,51271,135241,-32699,0,0,21876,0,0,,21876,21876
4,01/24/2017,72,17:45,18:00,60.29,,0,60.29,60.29,1,-82147,55720,137867,-26427,0,0,31597,0,0,,31597,31597
4,01/24/2017,73,18:00,18:15,60.29,,0,60.29,60.29,1,-94464,31589,126053,-62875,0,0,20174,0,0,,20174,20174
4,01/24/2017,74,18:15,18:30,60.29,36.91,0,36.91,36.91,-1,-49093,38943,88036,-10150,0,-527,891,0,0,,1418,364
4,01/24/2017,75,18:30,18:45,,,0,40.15,40.15,0,-42224,23113,65337,-19111,0,0,0,0,0,,0,0
4,01/24/2017,76,18:45,19:00,,,0,40.15,40.15,0,-35947,29940,65887,-6007,0,0,0,0,0,,0,0
4,01/24/2017,77,19:00,19:15,250,,0,250,250,1,-88243,15211,103454,-73032,0,0,24261,0,0,,24261,24261
4,01/24/2017,78,19:15,19:30,55.29,,0,55.29,55.29,1,-62443,19000,81443,-43443,0,0,16781,0,0,,16781,16781
4,01/24/2017,79,19:30,19:45,,,0,40.18,40.18,0,-42003,28478,70481,-13525,0,0,168,0,0,,168,168
4,01/24/2017,80,19:45,20:00,,,0,40.18,40.18,0,-38339,34200,72539,-4139,0,0,0,0,0,,0,0
4,01/24/2017,81,20:00,20:15,96.12,,0,96.12,96.12,1,-80864,32291,113155,-48573,0,0,10301,0,0,,10301,10301
4,01/24/2017,82,20:15,20:30,116.12,,0,116.12,116.12,1,-60165,31210,91375,-28955,0,0,42232,0,0,,42232,42232
4,01/24/2017,83,20:30,20:45,,,0,40.2,40.2,0,-43789,27254,71043,-16535,0,0,9300,0,0,,9300,9300
4,01/24/2017,84,20:45,21:00,,35.02,0,35.02,35.02,-1,-47773,36630,84403,-11143,0,-1844,0,0,0,,1844,-1844
4,01/24/2017,85,21:00,21:15,41.27,39.78,0,41.27,36.01,2,-88765,26969,115734,-61796,0,-883,1916,0,0,,2799,1033
4,01/24/2017,86,21:15,21:30,,,0,36.01,36.01,0,-56022,20422,76444,-35600,0,0,17,0,0,,17,17
4,01/24/2017,87,21:30,21:45,,,0,36.01,36.01,0,-56637,27394,84031,-29243,0,0,0,0,0,,0,0
4,01/24/2017,88,21:45,22:00,,37.78,0,37.78,37.78,-1,-71158,52383,123541,-18775,0,-363,0,0,0,,363,-363
4,01/24/2017,89,22:00,22:15,54.75,35.78,0,54.75,35.78,2,-88165,25466,113631,-62699,0,-1619,3800,0,0,,5419,2181
4,01/24/2017,90,22:15,22:30,54.75,,0,54.75,54.75,1,-70632,27162,97794,-43470,0,0,6291,0,0,,6291,6291
4,01/24/2017,91,22:30,22:45,54.75,38.03,0,38.03,38.03,-1,-37653,50261,87914,12608,0,-1295,25,0,0,,1320,-1270
4,01/24/2017,92,22:45,23:00,,33.92,0,33.92,33.92,-1,-43162,68553,111715,25391,0,-22892,0,0,0,,22892,-22892
4,01/24/2017,93,23:00,23:15,51.77,29.92,0,51.77,29.92,2,-70482,45481,115963,-25001,0,-31478,2001,0,0,,33479,-29477
4,01/24/2017,94,23:15,23:30,51.77,29.92,0,51.77,51.77,1,-49164,22808,71972,-26356,0,-1014,2650,0,0,,3664,1636
4,01/24/2017,95,23:30,23:45,38.69,37.68,0,38.69,34.04,2,-40629,39406,80035,-1223,0,-64,655,0,0,,719,591
4,01/24/2017,96,23:45,0:00,,26.78,0,26.78,26.78,-1,-39195,93210,132405,54015,0,-28967,0,0,0,,28967,-28967
4,01/25/2017,1,0:00,0:15,41.18,26.49,0,41.18,41.18,1,-87030,62204,149234,-24826,0,-30740,635,0,0,,31375,-30105
4,01/25/2017,2,0:15,0:30,,,0,39.74,39.74,0,-63883,39026,102909,-24857,0,-94,337,0,0,,431,243
4,01/25/2017,3,0:30,0:45,,,0,39.74,39.74,0,-48266,33931,82197,-14335,0,0,0,0,0,,0,0
4,01/25/2017,4,0:45,1:00,,41.39,0,41.39,41.39,-1,-54008,36816,90824,-17192,0,-640,0,0,0,,640,-640
4,01/25/2017,5,1:00,1:15,41.45,39.48,0,41.45,35.2,2,-65841,54418,120259,-11423,0,-1005,582,0,0,,1587,-423
4,01/25/2017,6,1:15,1:30,42.14,41.36,0,42.14,35.2,2,-53384,39712,93096,-13672,0,-13,1850,0,0,,1863,1837
4,01/25/2017,7,1:30,1:45,38.02,37.06,0,38.02,35.2,2,-44109,42117,86226,-1992,0,-1235,6,0,0,,1241,-1229
4,01/25/2017,8,1:45,2:00,39.33,,0,39.33,39.33,1,-44818,53028,97846,8210,0,0,1151,0,0,,1151,1151
4,01/25/2017,9,2:00,2:15,46.8,,0,46.8,46.8,1,-58559,19126,77685,-39433,0,0,8719,0,0,,8719,8719
4,01/25/2017,10,2:15,2:30,42.11,,0,42.11,42.11,1,-53369,38519,91888,-14850,0,0,18038,0,0,,18038,18038
4,01/25/2017,11,2:30,2:45,,,0,35.2,35.2,0,-45888,36110,81998,-9778,0,0,2697,0,0,,2697,2697
4,01/25/2017,12,2:45,3:00,,41.33,0,41.33,41.33,-1,-59679,31466,91145,-28213,0,-3,0,0,0,,3,-3
4,01/25/2017,13,3:00,3:15,,37.06,0,37.06,37.06,-1,-43637,54621,98258,10984,0,-3725,0,0,0,,3725,-3725
4,01/25/2017,14,3:15,3:30,,39.9,0,39.9,39.9,-1,-48568,47445,96013,-1123,0,-1602,0,0,0,,1602,-1602
4,01/25/2017,15,3:30,3:45,,41.45,0,41.45,41.45,-1,-43488,41977,85465,-1511,0,-154,0,0,0,,154,-154
4,01/25/2017,16,3:45,4:00,,41.45,0,41.45,41.45,-1,-51108,48096,99204,-3012,0,-500,0,0,0,,500,-500
4,01/25/2017,17,4:00,4:15,41.18,41.45,0,41.18,35.2,2,-50125,31064,81189,-19061,0,-73,1255,0,0,,1328,1182
4,01/25/2017,18,4:15,4:30,,39.18,0,39.18,39.18,-1,-44444,46202,90646,1758,0,-3568,0,0,0,,3568,-3568
4,01/25/2017,19,4:30,4:45,43.37,39.18,0,43.37,43.37,1,-56142,41320,97462,-14822,0,-128,1963,0,0,,2091,1835
4,01/25/2017,20,4:45,5:00,45.11,,0,45.11,45.11,1,-55012,31521,86533,-23491,0,0,10676,0,0,,10676,10676
4,01/25/2017,21,5:00,5:15,45.11,37.06,0,37.06,37.06,-1,-47506,56024,103530,8518,0,-3849,3125,0,0,,6974,-724
4,01/25/2017,22,5:15,5:30,,41.45,0,41.45,41.45,-1,-40271,44162,84433,3891,0,-1163,0,0,0,,1163,-1163
4,01/25/2017,23,5:30,5:45,43.43,41.45,0,43.43,43.43,1,-61929,42311,104240,-19618,0,-3,767,0,0,,770,764
4,01/25/2017,24,5:45,6:00,93.02,,0,93.02,93.02,1,-78260,31901,110161,-46359,0,0,31505,0,0,,31505,31505
4,01/25/2017,25,6:00,6:15,42.72,-35.74,0,42.72,-35.74,2,-19202,111339,130541,92137,0,-54559,16109,0,0,,70668,-38450
4,01/25/2017,26,6:15,6:30,41.49,37.03,0,41.49,37.03,2,-67314,40649,107963,-26665,0,-17767,511,0,0,,18278,-17256
4,01/25/2017,27,6:30,6:45,250,,0,250,250,1,-90900,46660,137560,-44240,0,0,10139,0,0,,10139,10139
4,01/25/2017,28,6:45,7:00,250,5.86,0,250,5.86,2,-123687,60285,183972,-63402,0,-642,52390,0,0,,53032,51748
4,01/25/2017,29,7:00,7:15,250,-22.64,0,-22.64,-22.64,-1,-29347,151302,180649,121955,0,-62722,3142,0,0,,65864,-59580
4,01/25/2017,30,7:15,7:30,72.92,32.83,0,72.92,72.92,1,-56444,35153,91597,-21291,0,-18525,4379,0,0,,22904,-14146
4,01/25/2017,31,7:30,7:45,250,,0,250,250,1,-123763,39590,163353,-84173,0,0,55989,0,0,,55989,55989
4,01/25/2017,32,7:45,8:00,250,,0,250,250,1,-185762,46799,232561,-138963,0,0,95103,0,0,,95103,95103
4,01/25/2017,33,8:00,8:15,170.28,10.66,0,10.66,10.66,-1,-27145,106406,133551,79261,0,-6145,65237,0,0,,71382,59092
4,01/25/2017,34,8:15,8:30,133.41,-5.35,0,133.41,-5.35,2,-69193,38682,107875,-30511,0,-17555,8091,0,0,,25646,-9464
4,01/25/2017,35,8:30,8:45,133.41,,0,133.41,133.41,1,-59123,32961,92084,-26162,0,0,28756,0,0,,28756,28756
4,01/25/2017,36,8:45,9:00,55.19,,0,55.19,55.19,1,-63421,35600,99021,-27821,0,0,19320,0,0,,19320,19320
4,01/25/2017,37,9:00,9:15,173.66,,0,173.66,173.66,1,-78607,11817,90424,-66790,0,0,50817,0,0,,50817,50817
4,01/25/2017,38,9:15,9:30,90.2,,0,90.2,90.2,1,-66502,14016,80518,-52486,0,0,57145,0,0,,57145,57145
4,01/25/2017,39,9:30,9:45,79.2,,0,79.2,79.2,1,-62053,17216,79269,-44837,0,0,48989,0,0,,48989,48989
4,01/25/2017,40,9:45,10:00,142.87,,0,142.87,142.87,1,-71501,9359,80860,-62142,0,0,43787,0,0,,43787,43787
4,01/25/2017,41,10:00,10:15,236.76,,0,236.76,236.76,1,-113937,16915,130852,-97022,0,0,78278,1250,0,,79528,79528
4,01/25/2017,42,10:15,10:30,125.56,,0,125.56,125.56,1,-65780,18317,84097,-47463,0,0,64580,0,0,,64580,64580
4,01/25/2017,43,10:30,10:45,185.51,,0,185.51,185.51,1,-90999,16193,107192,-74806,0,0,53372,0,0,,53372,53372
4,01/25/2017,44,10:45,11:00,185.51,,0,185.51,185.51,1,-73088,18489,91577,-54599,0,0,63402,0,0,,63402,63402
4,01/25/2017,45,11:00,11:15,192.16,,0,192.16,192.16,1,-97469,17039,114508,-80430,0,0,49014,0,0,,49014,49014
4,01/25/2017,46,11:15,11:30,192.16,,0,192.16,192.16,1,-97858,20409,118267,-77449,0,0,76500,0,0,,76500,76500
4,01/25/2017,47,11:30,11:45,141.02,,0,141.02,141.02,1,-93766,17161,110927,-76605,0,0,74032,0,0,,74032,74032
4,01/25/2017,48,11:45,12:00,192.16,,0,192.16,192.16,1,-105771,17799,123570,-87972,0,0,75254,0,0,,75254,75254
4,01/25/2017,49,12:00,12:15,173.05,,0,173.05,173.05,1,-153312,14865,168177,-138447,0,0,84835,0,0,,84835,84835
4,01/25/2017,50,12:15,12:30,250,,0,250,250,1,-127800,11277,139077,-116523,0,0,91279,1250,0,,92529,92529
4,01/25/2017,51,12:30,12:45,250,,0,250,250,1,-91448,13638,105086,-77810,0,0,88483,1250,0,,89733,89733
4,01/25/2017,52,12:45,13:00,80.9,,0,80.9,80.9,1,-79109,17768,96877,-61341,0,0,52454,0,0,,52454,52454
4,01/25/2017,53,13:00,13:15,70.3,,0,70.3,70.3,1,-102275,58160,160435,-44115,0,0,44261,0,0,,44261,44261
4,01/25/2017,54,13:15,13:30,98.02,,0,98.02,98.02,1,-109617,50125,159742,-59492,0,0,47568,0,0,,47568,47568
4,01/25/2017,55,13:30,13:45,108.07,,0,108.07,108.07,1,-107592,46428,154020,-61164,0,0,62064,0,0,,62064,62064
4,01/25/2017,56,13:45,14:00,70.3,,0,70.3,70.3,1,-102635,45753,148388,-56882,0,0,50065,0,0,,50065,50065
4,01/25/2017,57,14:00,14:15,129.02,,0,129.02,129.02,1,-110326,52951,163277,-57375,0,0,34713,0,0,,34713,34713
4,01/25/2017,58,14:15,14:30,141.02,,0,141.02,141.02,1,-107185,43154,150339,-64031,0,0,67992,0,0,,67992,67992
4,01/25/2017,59,14:30,14:45,84.56,,0,84.56,84.56,1,-105159,48960,154119,-56199,0,0,57750,0,0,,57750,57750
4,01/25/2017,60,14:45,15:00,61.02,,0,61.02,61.02,1,-101011,46951,147962,-54060,0,0,39031,0,0,,39031,39031
4,01/25/2017,61,15:00,15:15,129.02,,0,129.02,129.02,1,-99875,29248,129123,-70627,0,0,52180,0,0,,52180,52180
4,01/25/2017,62,15:15,15:30,80.3,,0,80.3,80.3,1,-83364,32066,115430,-51298,0,0,49818,0,0,,49818,49818
4,01/25/2017,63,15:30,15:45,105.51,,0,105.51,105.51,1,-86867,24825,111692,-62042,0,0,59191,0,0,,59191,59191
4,01/25/2017,64,15:45,16:00,141.39,,0,141.39,141.39,1,-94349,23755,118104,-70594,0,0,69441,0,0,,69441,69441
4,01/25/2017,65,16:00,16:15,124,,0,124,124,1,-74408,21493,95901,-52915,0,0,57542,0,0,,57542,57542
4,01/25/2017,66,16:15,16:30,234.36,,0,234.36,234.36,1,-85995,16621,102616,-69374,0,0,46161,0,0,,46161,46161
4,01/25/2017,67,16:30,16:45,234.36,,0,234.36,234.36,1,-68265,21727,89992,-46538,0,0,52067,0,0,,52067,52067
4,01/25/2017,68,16:45,17:00,113,,0,113,113,1,-99006,31855,130861,-67151,0,0,43486,0,0,,43486,43486
4,01/25/2017,69,17:00,17:15,80.02,30.61,0,80.02,30.61,2,-24180,50360,74540,26180,0,-8150,24143,0,0,,32293,15993
4,01/25/2017,70,17:15,17:30,128.9,40.7,0,128.9,128.9,1,-58373,17606,75979,-40767,0,-1961,4095,0,0,,6056,2134
4,01/25/2017,71,17:30,17:45,231.58,,0,231.58,231.58,1,-124270,33436,157706,-90834,0,0,58769,0,0,,58769,58769
4,01/25/2017,72,17:45,18:00,231.58,,0,231.58,231.58,1,-120466,46564,167030,-73902,0,0,83134,0,0,,83134,83134
4,01/25/2017,73,18:00,18:15,111,35.46,0,35.46,35.46,-1,-89276,51837,141113,-37439,0,-402,37182,0,0,,37584,36780
4,01/25/2017,74,18:15,18:30,50.19,32.77,0,50.19,32.77,2,-61595,54251,115846,-7344,0,-7784,937,0,0,,8721,-6847
4,01/25/2017,75,18:30,18:45,60.02,37.16,0,60.02,37.16,2,-41613,45521,87134,3908,0,-482,6934,0,0,,7416,6452
4,01/25/2017,76,18:45,19:00,,34.46,0,34.46,34.46,-1,-32468,57494,89962,25026,0,-16662,0,0,0,,16662,-16662
4,01/25/2017,77,19:00,19:15,172.07,34.46,0,172.07,172.07,1,-102430,41527,143957,-60903,0,-1578,21314,0,0,,22892,19736
4,01/25/2017,78,19:15,19:30,52.69,,0,52.69,52.69,1,-64815,44521,109336,-20294,0,0,11154,0,0,,11154,11154
4,01/25/2017,79,19:30,19:45,47.69,,0,47.69,47.69,1,-60066,41434,101500,-18632,0,0,6593,0,0,,6593,6593
4,01/25/2017,80,19:45,20:00,41.02,,0,41.02,41.02,1,-69102,47032,116134,-22070,0,0,3927,0,0,,3927,3927
4,01/25/2017,81,20:00,20:15,167.01,,0,167.01,167.01,1,-108630,31810,140440,-76820,0,0,16646,0,0,,16646,16646
4,01/25/2017,82,20:15,20:30,74.02,,0,74.02,74.02,1,-76183,40748,116931,-35435,0,0,21484,0,0,,21484,21484
4,01/25/2017,83,20:30,20:45,74.02,37.06,0,37.06,37.06,-1,-51402,46963,98365,-4439,0,-1470,5031,0,0,,6501,3561
4,01/25/2017,84,20:45,21:00,,37.06,0,37.06,37.06,-1,-45595,37168,82763,-8427,0,-3015,0,0,0,,3015,-3015
4,01/25/2017,85,21:00,21:15,250,40.71,0,250,250,1,-103555,30633,134188,-72922,0,-297,19551,0,0,,19848,19254
4,01/25/2017,86,21:15,21:30,250,36.14,0,250,36.14,2,-62203,43629,105832,-18574,0,-222,54170,0,0,,54392,53948
4,01/25/2017,87,21:30,21:45,250,30.82,0,30.82,30.82,-1,-46308,63991,110299,17683,0,-19309,1199,0,0,,20508,-18110
4,01/25/2017,88,21:45,22:00,,30.82,0,30.82,30.82,-1,-51031,79783,130814,28752,0,-19635,0,0,0,,19635,-19635
4,01/25/2017,89,22:00,22:15,111,5.86,0,111,5.86,2,-75216,72977,148193,-2239,0,-43648,1258,0,0,,44906,-42390
4,01/25/2017,90,22:15,22:30,250,30.82,0,250,30.82,2,-56078,57027,113105,949,0,-4351,22298,0,0,,26649,17947
4,01/25/2017,91,22:30,22:45,,11.03,0,11.03,11.03,-1,-31840,81134,112974,49294,0,-40780,0,0,0,,40780,-40780
4,01/25/2017,92,22:45,23:00,,20.42,0,20.42,20.42,-1,-44004,114390,158394,70386,0,-50616,0,0,0,,50616,-50616
4,01/25/2017,93,23:00,23:15,83.82,20.42,0,83.82,83.82,1,-82447,75706,158153,-6741,0,-43395,1993,0,0,,45388,-41402
4,01/25/2017,94,23:15,23:30,83.82,35.06,0,83.82,35.06,2,-62646,65888,128534,3242,0,-1102,2342,0,0,,3444,1240
4,01/25/2017,95,23:30,23:45,,31.06,0,31.06,31.06,-1,-40698,69249,109947,28551,0,-16620,0,0,0,,16620,-16620
4,01/25/2017,96,23:45,0:00,,13.23,0,13.23,13.23,-1,-45796,119154,164950,73358,0,-38109,0,0,0,,38109,-38109
4,01/26/2017,1,0:00,0:15,88.72,13.39,0,88.72,88.72,1,-86587,65570,152157,-21017,0,-31287,2889,0,0,,34176,-28398
4,01/26/2017,2,0:15,0:30,194.49,13.39,0,194.49,194.49,1,-73479,36678,110157,-36801,0,-23,23295,0,0,,23318,23272
4,01/26/2017,3,0:30,0:45,,,0,34.05,34.05,0,-62176,51373,113549,-10803,0,0,1507,0,0,,1507,1507
4,01/26/2017,4,0:45,1:00,,40.58,0,40.58,40.58,-1,-57910,48925,106835,-8985,0,-270,0,0,0,,270,-270
4,01/26/2017,5,1:00,1:15,61.29,40.52,0,61.29,34.07,2,-66002,37617,103619,-28385,0,-398,4401,0,0,,4799,4003
4,01/26/2017,6,1:15,1:30,107.92,,0,107.92,107.92,1,-62823,28915,91738,-33908,0,0,33096,0,0,,33096,33096
4,01/26/2017,7,1:30,1:45,39.91,,0,39.91,39.91,1,-56938,42120,99058,-14818,0,0,3862,0,0,,3862,3862
4,01/26/2017,8,1:45,2:00,40.1,,0,40.1,40.1,1,-62366,65315,127681,2949,0,0,1396,0,0,,1396,1396
4,01/26/2017,9,2:00,2:15,50.19,,0,50.19,50.19,1,-75871,40141,116012,-35730,0,0,8086,0,0,,8086,8086
4,01/26/2017,10,2:15,2:30,40.75,,0,40.75,40.75,1,-70151,44353,114504,-25798,0,0,5338,0,0,,5338,5338
4,01/26/2017,11,2:30,2:45,40.75,,0,40.75,40.75,1,-65676,49602,115278,-16074,0,0,933,0,0,,933,933
4,01/26/2017,12,2:45,3:00,,,0,34.03,34.03,0,-68476,47511,115987,-20965,0,0,270,0,0,,270,270
4,01/26/2017,13,3:00,3:15,,,0,34.13,34.13,0,-51220,52266,103486,1046,0,0,0,0,0,,0,0
4,01/26/2017,14,3:15,3:30,38.76,,0,38.76,38.76,1,-57396,43403,100799,-13993,0,0,1580,0,0,,1580,1580
4,01/26/2017,15,3:30,3:45,38.76,,0,38.76,38.76,1,-63890,36145,100035,-27745,0,0,1900,0,0,,1900,1900
4,01/26/2017,16,3:45,4:00,27.74,,0,27.74,27.74,1,-73914,30441,104355,-43473,0,0,245,0,0,,245,245
4,01/26/2017,17,4:00,4:15,39.67,,0,39.67,39.67,1,-65623,35440,101063,-30183,0,0,1193,0,0,,1193,1193
4,01/26/2017,18,4:15,4:30,38.72,,0,38.72,38.72,1,-82141,41050,123191,-41091,0,0,1275,0,0,,1275,1275
4,01/26/2017,19,4:30,4:45,27.79,,0,27.79,27.79,1,-87506,43529,131035,-43977,0,0,855,0,0,,855,855
4,01/26/2017,20,4:45,5:00,27.79,,0,27.79,27.79,1,-96695,41531,138226,-55164,0,0,48,0,0,,48,48
4,01/26/2017,21,5:00,5:15,,,0,34.04,34.04,0,-73588,44342,117930,-29246,0,0,0,0,0,,0,0
4,01/26/2017,22,5:15,5:30,,,0,34.04,34.04,0,-84935,41841,126776,-43094,0,0,0,0,0,,0,0
4,01/26/2017,23,5:30,5:45,27.55,,0,27.55,27.55,1,-113014,34193,147207,-78821,0,0,306,0,0,,306,306
4,01/26/2017,24,5:45,6:00,47.95,,0,47.95,47.95,1,-100314,22522,122836,-77792,0,0,4167,0,0,,4167,4167
4,01/26/2017,25,6:00,6:15,45.17,,0,45.17,45.17,1,-133435,103002,236437,-30433,0,0,8970,0,0,,8970,8970
4,01/26/2017,26,6:15,6:30,41.17,,0,41.17,41.17,1,-92453,54617,147070,-37836,0,0,945,0,0,,945,945
4,01/26/2017,27,6:30,6:45,250,,0,250,250,1,-123981,45147,169128,-78834,0,0,32426,0,0,,32426,32426
4,01/26/2017,28,6:45,7:00,250,,0,250,250,1,-153422,65907,219329,-87515,0,0,85706,0,0,,85706,85706
4,01/26/2017,29,7:00,7:15,250,-17.36,0,-17.36,-17.36,-1,-58341,165299,223640,106958,0,-24896,30295,0,0,,55191,5399
4,01/26/2017,30,7:15,7:30,250,-18.99,0,250,250,1,-86205,33006,119211,-53199,0,-23667,8618,0,0,,32285,-15049
4,01/26/2017,31,7:30,7:45,250,,0,250,250,1,-126196,39545,165741,-86651,0,0,73931,0,0,,73931,73931
4,01/26/2017,32,7:45,8:00,250,,0,250,250,1,-161495,43020,204515,-118475,0,0,83620,0,0,,83620,83620
4,01/26/2017,33,8:00,8:15,131.03,,0,131.03,131.03,1,-54135,33554,87689,-20581,0,0,41017,0,0,,41017,41017
4,01/26/2017,34,8:15,8:30,66.46,,0,66.46,66.46,1,-79354,18635,97989,-60719,0,0,2887,0,0,,2887,2887
4,01/26/2017,35,8:30,8:45,80.12,,0,80.12,80.12,1,-92694,13558,106252,-79136,0,0,17574,0,0,,17574,17574
4,01/26/2017,36,8:45,9:00,117.12,,0,117.12,117.12,1,-117993,17806,135799,-100187,0,0,32657,0,0,,32657,32657
4,01/26/2017,37,9:00,9:15,250,,0,250,250,1,-90245,11256,101501,-78989,0,0,61382,0,0,,61382,61382
4,01/26/2017,38,9:15,9:30,152.62,,0,152.62,152.62,1,-78787,13457,92244,-65330,0,0,69783,0,0,,69783,69783
4,01/26/2017,39,9:30,9:45,103.3,,0,103.3,103.3,1,-74254,16396,90650,-57858,0,0,59232,0,0,,59232,59232
4,01/26/2017,40,9:45,10:00,74.44,,0,74.44,74.44,1,-66411,21579,87990,-44832,0,0,41809,0,0,,41809,41809
4,01/26/2017,41,10:00,10:15,171.41,,0,171.41,171.41,1,-79937,23629,103566,-56308,0,0,47861,0,0,,47861,47861
4,01/26/2017,42,10:15,10:30,82.45,,0,82.45,82.45,1,-56805,28810,85615,-27995,0,0,36493,0,0,,36493,36493
4,01/26/2017,43,10:30,10:45,105.23,,0,105.23,105.23,1,-60741,29176,89917,-31565,0,0,13792,0,0,,13792,13792
4,01/26/2017,44,10:45,11:00,106.12,40.64,0,106.12,40.64,2,-52490,41123,93613,-11367,0,-15,27995,0,0,,28010,27980
4,01/26/2017,45,11:00,11:15,38.47,35.34,0,46.61,35.34,2,-73177,83572,156749,10395,0,-6182,2835,0,0,,9017,-3347
4,01/26/2017,46,11:15,11:30,38.86,35.34,0,38.86,38.86,1,-65425,69765,135190,4340,0,-9,1354,0,0,,1363,1345
4,01/26/2017,47,11:30,11:45,38.86,37.59,0,37.59,37.59,-1,-59271,79063,138334,19792,0,-4540,118,0,0,,4658,-4422
4,01/26/2017,48,11:45,12:00,,37.59,0,37.59,37.59,-1,-59657,71560,131217,11903,0,-6573,0,0,0,,6573,-6573
4,01/26/2017,49,12:00,12:15,50.19,38.15,0,50.19,38.15,2,-63471,52588,116059,-10883,0,-2499,5367,0,0,,7866,2868
4,01/26/2017,50,12:15,12:30,50.19,37.59,0,37.59,37.59,-1,-49157,49347,98504,190,0,-1087,1184,0,0,,2271,97
4,01/26/2017,51,12:30,12:45,,,0,46.37,46.37,0,-44072,45443,89515,1371,0,0,0,0,0,,0,0
4,01/26/2017,52,12:45,13:00,,54.27,0,54.27,54.27,-1,-43722,25210,68932,-18512,0,-397,0,0,0,,397,-397
4,01/26/2017,53,13:00,13:15,59.11,,0,59.11,59.11,1,-68998,37851,106849,-31147,0,0,5830,0,0,,5830,5830
4,01/26/2017,54,13:15,13:30,76.12,,0,76.12,76.12,1,-81559,41826,123385,-39733,0,0,28948,0,0,,28948,28948
4,01/26/2017,55,13:30,13:45,,,0,44.31,44.31,0,-65561,52566,118127,-12995,0,0,5720,0,0,,5720,5720
4,01/26/2017,56,13:45,14:00,,38.15,0,38.15,38.15,-1,-66840,55476,122316,-11364,0,-1322,0,0,0,,1322,-1322
4,01/26/2017,57,14:00,14:15,,,0,40.22,40.22,0,-55969,60619,116588,4650,0,-87,0,0,0,,87,-87
4,01/26/2017,58,14:15,14:30,,38.15,0,38.15,38.15,-1,-54096,64993,119089,10897,0,-891,0,0,0,,891,-891
4,01/26/2017,59,14:30,14:45,,38.15,0,38.15,38.15,-1,-72660,60369,133029,-12291,0,-534,0,0,0,,534,-534
4,01/26/2017,60,14:45,15:00,47.1,,0,47.1,47.1,1,-74183,55735,129918,-18448,0,0,432,0,0,,432,432
4,01/26/2017,61,15:00,15:15,50.43,,0,50.43,50.43,1,-94637,56917,151554,-37720,0,0,3318,0,0,,3318,3318
4,01/26/2017,62,15:15,15:30,43.34,,0,43.34,43.34,1,-94583,50855,145438,-43728,0,0,972,0,0,,972,972
4,01/26/2017,63,15:30,15:45,105.38,,0,105.38,105.38,1,-107931,50663,158594,-57268,0,0,29220,0,0,,29220,29220
4,01/26/2017,64,15:45,16:00,61.43,,0,61.43,61.43,1,-118018,54740,172758,-63278,0,0,32159,0,0,,32159,32159
4,01/26/2017,65,16:00,16:15,41.17,,0,41.17,41.17,1,-95915,40925,136840,-54990,0,0,6745,0,0,,6745,6745
4,01/26/2017,66,16:15,16:30,,,0,47.5,47.5,0,-112413,40799,153212,-71614,0,0,17,0,0,,17,17
4,01/26/2017,67,16:30,16:45,43.11,,0,43.11,43.11,1,-99505,51618,151123,-47887,0,0,1175,0,0,,1175,1175
4,01/26/2017,68,16:45,17:00,38.47,,0,38.47,38.47,1,-103189,72043,175232,-31146,0,0,270,0,0,,270,270
4,01/26/2017,69,17:00,17:15,38.47,33.66,0,33.66,33.66,-1,-53726,83848,137574,30122,0,-8678,17,0,0,,8695,-8661
4,01/26/2017,70,17:15,17:30,,,0,47.49,47.49,0,-64470,67206,131676,2736,0,-582,0,0,0,,582,-582
4,01/26/2017,71,17:30,17:45,250,,0,250,250,1,-109566,49789,159355,-59777,0,0,5212,0,0,,5212,5212
4,01/26/2017,72,17:45,18:00,250,,0,250,250,1,-161596,66983,228579,-94613,0,0,64955,0,0,,64955,64955
4,01/26/2017,73,18:00,18:15,106.97,,0,106.97,106.97,1,-123332,46275,169607,-77057,0,0,49163,0,0,,49163,49163
4,01/26/2017,74,18:15,18:30,65.9,,0,65.9,65.9,1,-97944,57630,155574,-40314,0,0,7287,0,0,,7287,7287
4,01/26/2017,75,18:30,18:45,54.9,,0,54.9,54.9,1,-100991,58754,159745,-42237,0,0,2875,0,0,,2875,2875
4,01/26/2017,76,18:45,19:00,72.4,,0,72.4,72.4,1,-97075,61752,158827,-35323,0,0,16749,0,0,,16749,16749
4,01/26/2017,77,19:00,19:15,72.4,42.3,0,42.3,42.3,-1,-103203,118551,221754,15348,0,-79,2338,0,0,,2417,2259
4,01/26/2017,78,19:15,19:30,,37.59,0,37.59,37.59,-1,-91609,101782,193391,10173,0,-5624,0,0,0,,5624,-5624
4,01/26/2017,79,19:30,19:45,,36.26,0,36.26,36.26,-1,-81235,95879,177114,14644,0,-6633,0,0,0,,6633,-6633
4,01/26/2017,80,19:45,20:00,,36.26,0,36.26,36.26,-1,-81455,102430,183885,20975,0,-18724,0,0,0,,18724,-18724
4,01/26/2017,81,20:00,20:15,127.12,36.26,0,127.12,127.12,1,-127113,27950,155063,-99163,0,-13851,10842,0,0,,24693,-3009
4,01/26/2017,82,20:15,20:30,141.12,36.26,0,141.12,141.12,1,-106137,40001,146138,-66136,0,-113,40322,0,0,,40435,40209
4,01/26/2017,83,20:30,20:45,,,0,47.48,47.48,0,-89009,55792,144801,-33217,0,0,1756,0,0,,1756,1756
4,01/26/2017,84,20:45,21:00,,36.36,0,36.36,36.36,-1,-105022,83020,188042,-22002,0,-1367,0,0,0,,1367,-1367
4,01/26/2017,85,21:00,21:15,250,35.34,0,250,33.88,2,-140254,63641,203895,-76613,0,-3287,9727,0,0,,13014,6440
4,01/26/2017,86,21:15,21:30,250,30.43,0,30.43,30.43,-1,-86385,80844,167229,-5541,0,-2342,17134,0,0,,19476,14792
4,01/26/2017,87,21:30,21:45,,30.2,0,30.2,30.2,-1,-61348,98258,159606,36910,0,-15436,0,0,0,,15436,-15436
4,01/26/2017,88,21:45,22:00,,38.15,0,38.15,38.15,-1,-77208,67909,145117,-9299,0,-3621,0,0,0,,3621,-3621
4,01/26/2017,89,22:00,22:15,42.59,,0,42.59,42.59,1,-117128,22202,139330,-94926,0,0,1431,0,0,,1431,1431
4,01/26/2017,90,22:15,22:30,28.57,,0,28.57,28.57,1,-106323,18447,124770,-87876,0,0,409,0,0,,409,409
4,01/26/2017,91,22:30,22:45,93.82,,0,93.82,93.82,1,-93724,29959,123683,-63765,0,0,13820,0,0,,13820,13820
4,01/26/2017,92,22:45,23:00,54.12,,0,54.12,54.12,1,-103179,56281,159460,-46898,0,0,28556,0,0,,28556,28556
4,01/26/2017,93,23:00,23:15,45.95,,0,45.95,45.95,1,-107135,52782,159917,-54353,0,0,5571,0,0,,5571,5571
4,01/26/2017,94,23:15,23:30,45.17,,0,45.17,45.17,1,-128589,37172,165761,-91417,0,0,6164,0,0,,6164,6164
4,01/26/2017,95,23:30,23:45,56.12,,0,56.12,56.12,1,-121391,42025,163416,-79366,0,0,11971,0,0,,11971,11971
4,01/26/2017,96,23:45,0:00,43.51,,0,43.51,43.51,1,-108031,83517,191548,-24514,0,0,23436,0,0,,23436,23436
4,01/27/2017,1,0:00,0:15,130.71,,0,130.71,130.71,1,-146955,42959,189914,-103996,0,0,21694,0,0,,21694,21694
4,01/27/2017,2,0:15,0:30,130.71,,0,130.71,130.71,1,-110897,61785,172682,-49112,0,0,55087,0,0,,55087,55087
4,01/27/2017,3,0:30,0:45,,,0,33.05,33.05,0,-97666,83093,180759,-14573,0,0,6318,0,0,,6318,6318
4,01/27/2017,4,0:45,1:00,,,0,33.05,33.05,0,-107632,51348,158980,-56284,0,0,0,0,0,,0,0
4,01/27/2017,5,1:00,1:15,64.04,,0,64.04,64.04,1,-80113,33745,113858,-46368,0,0,17614,0,0,,17614,17614
4,01/27/2017,6,1:15,1:30,42.32,,0,42.32,42.32,1,-70951,52415,123366,-18536,0,0,22224,0,0,,22224,22224
4,01/27/2017,7,1:30,1:45,38.59,,0,38.59,38.59,1,-76503,63943,140446,-12560,0,0,4235,0,0,,4235,4235
4,01/27/2017,8,1:45,2:00,39.12,,0,39.12,39.12,1,-74311,69451,143762,-4860,0,0,9059,0,0,,9059,9059
4,01/27/2017,9,2:00,2:15,130.76,,0,130.76,130.76,1,-116851,34070,150921,-82781,0,0,14238,0,0,,14238,14238
4,01/27/2017,10,2:15,2:30,130.76,,0,130.76,130.76,1,-128304,44273,172577,-84031,0,0,43981,0,0,,43981,43981
4,01/27/2017,11,2:30,2:45,,,0,33.04,33.04,0,-116863,41223,158086,-75640,0,0,844,0,0,,844,844
4,01/27/2017,12,2:45,3:00,,,0,33.04,33.04,0,-131164,37697,168861,-93467,0,0,0,0,0,,0,0
4,01/27/2017,13,3:00,3:15,,,0,33.04,33.04,0,-121653,41988,163641,-79665,0,0,0,0,0,,0,0
4,01/27/2017,14,3:15,3:30,39.12,,0,39.12,39.12,1,-123444,40100,163544,-83344,0,0,2237,0,0,,2237,2237
4,01/27/2017,15,3:30,3:45,39.2,,0,39.2,39.2,1,-115022,43609,158631,-71413,0,0,7213,0,0,,7213,7213
4,01/27/2017,16,3:45,4:00,36.78,,0,36.78,36.78,1,-97480,57345,154825,-40135,0,0,2868,0,0,,2868,2868
4,01/27/2017,17,4:00,4:15,27.59,,0,27.59,27.59,1,-81375,66730,148105,-14645,0,0,38,0,0,,38,38
4,01/27/2017,18,4:15,4:30,27.59,,0,27.59,27.59,1,-83004,56221,139225,-26783,0,0,141,0,0,,141,141
4,01/27/2017,19,4:30,4:45,27.59,,0,27.59,27.59,1,-82381,51184,133565,-31197,0,0,42,0,0,,42,42
4,01/27/2017,20,4:45,5:00,27.59,,0,27.59,27.59,1,-97090,47273,144363,-49817,0,0,607,0,0,,607,607
4,01/27/2017,21,5:00,5:15,27.48,,0,27.48,27.48,1,-97324,55031,152355,-42293,0,0,235,0,0,,235,235
4,01/27/2017,22,5:15,5:30,36.78,,0,36.78,36.78,1,-101454,45330,146784,-56124,0,0,1041,0,0,,1041,1041
4,01/27/2017,23,5:30,5:45,41.17,,0,41.17,41.17,1,-111011,28361,139372,-82650,0,0,9951,0,0,,9951,9951
4,01/27/2017,24,5:45,6:00,45.17,,0,45.17,45.17,1,-117030,27102,144132,-89928,0,0,27803,0,0,,27803,27803
4,01/27/2017,25,6:00,6:15,40.72,31.81,0,40.72,31.81,2,-58462,80892,139354,22430,0,-8878,12507,0,0,,21385,3629
4,01/27/2017,26,6:15,6:30,,35.32,0,35.32,35.32,-1,-81714,28146,109860,-53568,0,-4190,0,0,0,,4190,-4190
4,01/27/2017,27,6:30,6:45,56.45,,0,56.45,56.45,1,-125999,31908,157907,-94091,0,0,5406,0,0,,5406,5406
4,01/27/2017,28,6:45,7:00,250,,0,250,250,1,-143541,64814,208355,-78727,0,0,49109,0,0,,49109,49109
4,01/27/2017,29,7:00,7:15,37.01,-48.85,0,-48.85,-48.85,-1,-75818,161702,237520,85884,0,-21132,15984,0,0,,37116,-5148
4,01/27/2017,30,7:15,7:30,,-49.48,0,-49.48,-49.48,-1,-77476,63315,140791,-14161,0,-36033,0,0,0,,36033,-36033
4,01/27/2017,31,7:30,7:45,37.66,-49.48,0,37.66,37.66,1,-110861,53463,164324,-57398,0,-360,147,0,0,,507,-213
4,01/27/2017,32,7:45,8:00,68.02,,0,68.02,68.02,1,-183133,52271,235404,-130862,0,0,16909,0,0,,16909,16909
4,01/27/2017,33,8:00,8:15,72.81,35.32,0,72.81,35.32,2,-65783,31868,97651,-33915,0,-560,24539,0,0,,25099,23979
4,01/27/2017,34,8:15,8:30,72.81,35.32,0,35.32,35.32,-1,-68903,32481,101384,-36422,0,-410,595,0,0,,1005,185
4,01/27/2017,35,8:30,8:45,,,0,37.86,37.86,0,-91285,29151,120436,-62134,0,0,0,0,0,,0,0
4,01/27/2017,36,8:45,9:00,,,0,37.86,37.86,0,-92101,24626,116727,-67475,0,0,0,0,0,,0,0
4,01/27/2017,37,9:00,9:15,104.73,,0,104.73,104.73,1,-80269,32012,112281,-48257,0,0,10467,0,0,,10467,10467
4,01/27/2017,38,9:15,9:30,104.73,,0,104.73,104.73,1,-82041,39823,121864,-42218,0,0,16499,0,0,,16499,16499
4,01/27/2017,39,9:30,9:45,104.02,,0,104.02,104.02,1,-89287,41992,131279,-47295,0,0,29176,0,0,,29176,29176
4,01/27/2017,40,9:45,10:00,58.32,,0,58.32,58.32,1,-84369,55722,140091,-28647,0,0,31718,0,0,,31718,31718
4,01/27/2017,41,10:00,10:15,193.72,,0,193.72,193.72,1,-87857,35651,123508,-52206,0,0,57281,0,0,,57281,57281
4,01/27/2017,42,10:15,10:30,53.02,,0,53.02,53.02,1,-65537,54894,120431,-10643,0,0,29983,0,0,,29983,29983
4,01/27/2017,43,10:30,10:45,51.85,,0,51.85,51.85,1,-77848,54336,132184,-23512,0,0,6937,0,0,,6937,6937
4,01/27/2017,44,10:45,11:00,40.72,,0,40.72,40.72,1,-70016,58855,128871,-11161,0,0,10456,0,0,,10456,10456
4,01/27/2017,45,11:00,11:15,44.72,,0,44.72,44.72,1,-61233,36749,97982,-24484,0,0,15011,0,0,,15011,15011
4,01/27/2017,46,11:15,11:30,42.41,,0,42.41,42.41,1,-56550,45729,102279,-10821,0,0,15092,0,0,,15092,15092
4,01/27/2017,47,11:30,11:45,40.72,,0,40.72,40.72,1,-54733,49514,104247,-5219,0,0,15094,0,0,,15094,15094
4,01/27/2017,48,11:45,12:00,37.83,35.32,0,44.9,35.32,2,-53367,52576,105943,-791,0,-1432,5406,0,0,,6838,3974
4,01/27/2017,49,12:00,12:15,125.34,35.32,0,125.34,125.34,1,-80878,30837,111715,-50041,0,-258,17485,0,0,,17743,17227
4,01/27/2017,50,12:15,12:30,40.72,,0,40.72,40.72,1,-69545,40331,109876,-29214,0,0,7928,0,0,,7928,7928
4,01/27/2017,51,12:30,12:45,139.02,,0,139.02,139.02,1,-91615,19755,111370,-71860,0,0,22618,0,0,,22618,22618
4,01/27/2017,52,12:45,13:00,139.02,,0,139.02,139.02,1,-77428,29690,107118,-47738,0,0,53102,0,0,,53102,53102
4,01/27/2017,53,13:00,13:15,139.02,35.11,0,35.11,35.11,-1,-75084,104830,179914,29746,0,-1761,5526,0,0,,7287,3765
4,01/27/2017,54,13:15,13:30,40.39,,0,40.39,40.39,1,-89760,81926,171686,-7834,0,0,1799,0,0,,1799,1799
4,01/27/2017,55,13:30,13:45,40.72,,0,40.72,40.72,1,-88213,75489,163702,-12724,0,0,6328,0,0,,6328,6328
4,01/27/2017,56,13:45,14:00,43.08,,0,43.08,43.08,1,-99286,81365,180651,-17921,0,0,19413,0,0,,19413,19413
4,01/27/2017,57,14:00,14:15,100.67,,0,100.67,100.67,1,-107626,46291,153917,-61335,0,0,36727,0,0,,36727,36727
4,01/27/2017,58,14:15,14:30,55.3,,0,55.3,55.3,1,-115626,53811,169437,-61815,0,0,52222,0,0,,52222,52222
4,01/27/2017,59,14:30,14:45,55.3,,0,55.3,55.3,1,-112020,34661,146681,-77359,0,0,38427,0,0,,38427,38427
4,01/27/2017,60,14:45,15:00,55.3,,0,55.3,55.3,1,-132139,36299,168438,-95840,0,0,37125,0,0,,37125,37125
4,01/27/2017,61,15:00,15:15,59.67,,0,59.67,59.67,1,-135227,29504,164731,-105723,0,0,34905,0,0,,34905,34905
4,01/27/2017,62,15:15,15:30,43.41,,0,43.41,43.41,1,-137663,26008,163671,-111655,0,0,22022,0,0,,22022,22022
4,01/27/2017,63,15:30,15:45,93.11,,0,93.11,93.11,1,-151495,10872,162367,-140623,0,0,32455,0,0,,32455,32455
4,01/27/2017,64,15:45,16:00,93.11,,0,93.11,93.11,1,-126349,6342,132691,-120007,0,0,38196,0,0,,38196,38196
4,01/27/2017,65,16:00,16:15,149.16,,0,149.16,149.16,1,-114975,6561,121536,-108414,0,0,52798,0,0,,52798,52798
4,01/27/2017,66,16:15,16:30,149.16,,0,149.16,149.16,1,-114098,22865,136963,-91233,0,0,71123,0,0,,71123,71123
4,01/27/2017,67,16:30,16:45,,,0,44.77,44.77,0,-96721,22388,119109,-74333,0,0,9127,0,0,,9127,9127
4,01/27/2017,68,16:45,17:00,90.72,,0,90.72,90.72,1,-94614,25259,119873,-69355,0,0,2719,0,0,,2719,2719
4,01/27/2017,69,17:00,17:15,97.55,,0,97.55,97.55,1,-68556,54440,122996,-14116,0,0,2314,0,0,,2314,2314
4,01/27/2017,70,17:15,17:30,,,0,44.61,44.61,0,-88820,26191,115011,-62629,0,0,0,0,0,,0,0
4,01/27/2017,71,17:30,17:45,193.97,,0,193.97,193.97,1,-140083,31432,171515,-108651,0,0,19226,0,0,,19226,19226
4,01/27/2017,72,17:45,18:00,193.97,,0,193.97,193.97,1,-167573,44786,212359,-122787,0,0,79159,0,0,,79159,79159
4,01/27/2017,73,18:00,18:15,193.72,52.42,0,52.42,52.42,-1,-113334,75847,189181,-37487,0,-2,67832,0,0,,67834,67830
4,01/27/2017,74,18:15,18:30,193.72,3.21,0,3.21,3.21,-1,-86715,110853,197568,24138,0,-20228,6124,0,0,,26352,-14104
4,01/27/2017,75,18:30,18:45,37.89,33.33,0,45.13,33.33,2,-82533,97247,179780,14714,0,-4951,41,0,0,,4992,-4910
4,01/27/2017,76,18:45,19:00,,24.94,0,24.94,24.94,-1,-73344,126928,200272,53584,0,-48011,0,0,0,,48011,-48011
4,01/27/2017,77,19:00,19:15,106.9,34.33,0,106.9,33.35,2,-115826,63056,178882,-52770,0,-20054,4967,0,0,,25021,-15087
4,01/27/2017,78,19:15,19:30,40,,0,40,40,1,-101472,69878,171350,-31594,0,0,2237,0,0,,2237,2237
4,01/27/2017,79,19:30,19:45,40.72,34.2,0,40.72,33.36,2,-71565,82676,154241,11111,0,-1493,2093,0,0,,3586,600
4,01/27/2017,80,19:45,20:00,40.72,34.33,0,34.33,34.33,-1,-96162,90766,186928,-5396,0,-12117,31,0,0,,12148,-12086
4,01/27/2017,81,20:00,20:15,137.86,34.33,0,137.86,137.86,1,-112919,57844,170763,-55075,0,-518,10077,0,0,,10595,9559
4,01/27/2017,82,20:15,20:30,42.41,,0,42.41,42.41,1,-86889,74462,161351,-12427,0,0,7687,0,0,,7687,7687
4,01/27/2017,83,20:30,20:45,,34.41,0,34.41,34.41,-1,-57052,81811,138863,24759,0,-1948,0,0,0,,1948,-1948
4,01/27/2017,84,20:45,21:00,,34.03,0,34.03,34.03,-1,-143046,97152,240198,-45894,0,-4475,0,0,0,,4475,-4475
4,01/27/2017,85,21:00,21:15,40.72,,0,40.72,40.72,1,-113136,91637,204773,-21499,0,0,1080,0,0,,1080,1080
4,01/27/2017,86,21:15,21:30,40.72,34.33,0,34.33,34.33,-1,-86457,104472,190929,18015,0,-978,539,0,0,,1517,-439
4,01/27/2017,87,21:30,21:45,,28.17,0,28.17,28.17,-1,-73670,139287,212957,65617,0,-10349,0,0,0,,10349,-10349
4,01/27/2017,88,21:45,22:00,,28.03,0,28.03,28.03,-1,-78356,160899,239255,82543,0,-30422,0,0,0,,30422,-30422
4,01/27/2017,89,22:00,22:15,40.16,28.17,0,40.16,40.16,1,-90239,89637,179876,-602,0,-28369,75,0,0,,28444,-28294
4,01/27/2017,90,22:15,22:30,40.27,29.33,0,40.27,29.33,2,-96340,122515,218855,26175,0,-7323,393,0,0,,7716,-6930
4,01/27/2017,91,22:30,22:45,,19.56,0,19.56,19.56,-1,-64398,137695,202093,73297,0,-61825,0,0,0,,61825,-61825
4,01/27/2017,92,22:45,23:00,,19.56,0,19.56,19.56,-1,-81443,149736,231179,68293,0,-77522,0,0,0,,77522,-77522
4,01/27/2017,93,23:00,23:15,,33.33,0,33.33,33.33,-1,-49805,104231,154036,54426,0,-29797,0,0,0,,29797,-29797
4,01/27/2017,94,23:15,23:30,,28.17,0,28.17,28.17,-1,-44582,112180,156762,67598,0,-3235,0,0,0,,3235,-3235
4,01/27/2017,95,23:30,23:45,,17.77,0,17.77,17.77,-1,-45318,118922,164240,73604,0,-27674,0,0,0,,27674,-27674
4,01/27/2017,96,23:45,0:00,,20.47,0,20.47,20.47,-1,-58449,130374,188823,71925,0,-58426,0,0,0,,58426,-58426
5,01/28/2017,1,0:00,0:15,,9.53,0,9.53,9.53,-1,-47448,172270,219718,124822,0,-68048,0,0,0,,68048,-68048
5,01/28/2017,2,0:15,0:30,,27.78,0,27.78,27.78,-1,-69525,143939,213464,74414,0,-48305,0,0,0,,48305,-48305
5,01/28/2017,3,0:30,0:45,,31.27,0,31.27,31.27,-1,-72681,120750,193431,48069,0,-36384,0,0,0,,36384,-36384
5,01/28/2017,4,0:45,1:00,,27.99,0,27.99,27.99,-1,-73391,126545,199936,53154,0,-29928,0,0,0,,29928,-29928
5,01/28/2017,5,1:00,1:15,,-19.78,0,-19.78,-19.78,-1,-44347,124229,168576,79882,0,-62348,0,0,0,,62348,-62348
5,01/28/2017,6,1:15,1:30,,-13.78,0,-13.78,-13.78,-1,-47148,115249,162397,68101,0,-45382,0,0,0,,45382,-45382
5,01/28/2017,7,1:30,1:45,,-13.78,0,-13.78,-13.78,-1,-54578,88328,142906,33750,0,-51817,0,0,0,,51817,-51817
5,01/28/2017,8,1:45,2:00,,-8.78,0,-8.78,-8.78,-1,-46873,124008,170881,77135,0,-46182,0,0,0,,46182,-46182
5,01/28/2017,9,2:00,2:15,,25.78,0,25.78,25.78,-1,-58528,89027,147555,30499,0,-44100,0,0,0,,44100,-44100
5,01/28/2017,10,2:15,2:30,,27.42,0,27.42,27.42,-1,-53142,108545,161687,55403,0,-38019,0,0,0,,38019,-38019
5,01/28/2017,11,2:30,2:45,,27.32,0,27.32,27.32,-1,-53688,120875,174563,67187,0,-61116,0,0,0,,61116,-61116
5,01/28/2017,12,2:45,3:00,,27.73,0,27.73,27.73,-1,-52635,113149,165784,60514,0,-53536,0,0,0,,53536,-53536
5,01/28/2017,13,3:00,3:15,51.42,33.96,0,51.42,33.92,2,-99812,56101,155913,-43711,0,-20645,9414,0,0,,30059,-11231
5,01/28/2017,14,3:15,3:30,36.12,37.54,0,37.54,37.54,-1,-68371,73341,141712,4970,0,-346,4872,0,0,,5218,4526
5,01/28/2017,15,3:30,3:45,,28.96,0,28.96,28.96,-1,-58853,87402,146255,28549,0,-7506,0,0,0,,7506,-7506
5,01/28/2017,16,3:45,4:00,,28.17,0,28.17,28.17,-1,-56974,94971,151945,37997,0,-36403,0,0,0,,36403,-36403
5,01/28/2017,17,4:00,4:15,,32.96,0,32.96,32.96,-1,-53154,115236,168390,62082,0,-23319,0,0,0,,23319,-23319
5,01/28/2017,18,4:15,4:30,,,0,33.89,33.89,0,-44917,102135,147052,57218,0,-910,0,0,0,,910,-910
5,01/28/2017,19,4:30,4:45,,,0,33.89,33.89,0,-92034,84259,176293,-7775,0,0,0,0,0,,0,0
5,01/28/2017,20,4:45,5:00,,,0,33.89,33.89,0,-124981,59951,184932,-65030,0,0,0,0,0,,0,0
5,01/28/2017,21,5:00,5:15,36.12,,0,36.12,36.12,1,-117657,66399,184056,-51258,0,0,685,0,0,,685,685
5,01/28/2017,22,5:15,5:30,38.39,,0,38.39,38.39,1,-114422,59663,174085,-54759,0,0,2585,0,0,,2585,2585
5,01/28/2017,23,5:30,5:45,41.93,,0,41.93,41.93,1,-127854,57946,185800,-69908,0,0,3963,0,0,,3963,3963
5,01/28/2017,24,5:45,6:00,41.93,,0,41.93,41.93,1,-142281,57078,199359,-85203,0,0,6083,0,0,,6083,6083
5,01/28/2017,25,6:00,6:15,29.8,0.78,0,0.78,0.78,-1,-22937,121091,144028,98154,0,-26429,710,0,0,,27139,-25719
5,01/28/2017,26,6:15,6:30,,7.33,0,7.33,7.33,-1,-37255,106728,143983,69473,0,-52229,0,0,0,,52229,-52229
5,01/28/2017,27,6:30,6:45,,37.68,0,37.68,37.68,-1,-25381,78269,103650,52888,0,-11351,0,0,0,,11351,-11351
5,01/28/2017,28,6:45,7:00,,27.81,0,27.81,27.81,-1,-36662,97353,134015,60691,0,-13546,0,0,0,,13546,-13546
5,01/28/2017,29,7:00,7:15,,29.44,0,29.44,29.44,-1,-72831,140659,213490,67828,0,-28377,0,0,0,,28377,-28377
5,01/28/2017,30,7:15,7:30,,29.44,0,29.44,29.44,-1,-53120,134282,187402,81162,0,-38359,0,0,0,,38359,-38359
5,01/28/2017,31,7:30,7:45,,,0,33.3,33.3,0,-58145,92831,150976,34686,0,-12080,0,0,0,,12080,-12080
5,01/28/2017,32,7:45,8:00,,,0,33.25,33.25,0,-57911,95124,153035,37213,0,0,0,0,0,,0,0
5,01/28/2017,33,8:00,8:15,,19.79,0,19.79,19.79,-1,-39794,156451,196245,116657,0,-9997,0,0,0,,9997,-9997
5,01/28/2017,34,8:15,8:30,,19.58,0,19.58,19.58,-1,-27186,150307,177493,123121,0,-38670,0,0,0,,38670,-38670
5,01/28/2017,35,8:30,8:45,,31.81,0,31.81,31.81,-1,-34152,121162,155314,87010,0,-26600,0,0,0,,26600,-26600
5,01/28/2017,36,8:45,9:00,,,0,33.59,33.59,0,-31528,84763,116291,53235,0,-3896,0,0,0,,3896,-3896
5,01/28/2017,37,9:00,9:15,,,0,32.51,32.51,0,-70396,138320,208716,67924,0,0,0,0,0,,0,0
5,01/28/2017,38,9:15,9:30,,,0,32.51,32.51,0,-61400,111514,172914,50114,0,0,0,0,0,,0,0
5,01/28/2017,39,9:30,9:45,,,0,32.51,32.51,0,-62290,90080,152370,27790,0,0,0,0,0,,0,0
5,01/28/2017,40,9:45,10:00,,,0,32.51,32.51,0,-64817,83675,148492,18858,0,0,0,0,0,,0,0
5,01/28/2017,41,10:00,10:15,,33.18,0,33.18,33.18,-1,-57363,116860,174223,59497,0,-3638,0,0,0,,3638,-3638
5,01/28/2017,42,10:15,10:30,,32.81,0,32.81,32.81,-1,-65632,103280,168912,37648,0,-8114,0,0,0,,8114,-8114
5,01/28/2017,43,10:30,10:45,,31.81,0,31.81,31.81,-1,-60947,102370,163317,41423,0,-19703,0,0,0,,19703,-19703
5,01/28/2017,44,10:45,11:00,,32.56,0,32.56,32.56,-1,-65299,90704,156003,25405,0,-26454,0,0,0,,26454,-26454
5,01/28/2017,45,11:00,11:15,37.44,32.78,0,37.44,37.44,1,-96114,92296,188410,-3818,0,-14698,901,0,0,,15599,-13797
5,01/28/2017,46,11:15,11:30,37.44,32.78,0,37.44,37.44,1,-99792,80127,179919,-19665,0,-238,658,0,0,,896,420
5,01/28/2017,47,11:30,11:45,37.44,,0,37.44,37.44,1,-102293,71649,173942,-30644,0,0,2318,0,0,,2318,2318
5,01/28/2017,48,11:45,12:00,38.09,,0,38.09,38.09,1,-123777,67464,191241,-56313,0,0,1667,0,0,,1667,1667
5,01/28/2017,49,12:00,12:15,34.81,,0,34.81,34.81,1,-73830,52065,125895,-21765,0,0,781,0,0,,781,781
5,01/28/2017,50,12:15,12:30,,,0,33.24,33.24,0,-85527,37686,123213,-47841,0,0,1,0,0,,1,1
5,01/28/2017,51,12:30,12:45,40.93,,0,40.93,40.93,1,-59610,27722,87332,-31888,0,0,6677,0,0,,6677,6677
5,01/28/2017,52,12:45,13:00,34.81,,0,34.81,34.81,1,-53122,43740,96862,-9382,0,0,1825,0,0,,1825,1825
5,01/28/2017,53,13:00,13:15,38.6,,0,38.6,38.6,1,-106677,50961,157638,-55716,0,0,636,0,0,,636,636
5,01/28/2017,54,13:15,13:30,38.6,,0,38.6,38.6,1,-110954,48929,159883,-62025,0,0,339,0,0,,339,339
5,01/28/2017,55,13:30,13:45,34.81,,0,34.81,34.81,1,-108749,51943,160692,-56806,0,0,34,0,0,,34,34
5,01/28/2017,56,13:45,14:00,34.81,,0,34.81,34.81,1,-113189,53778,166967,-59411,0,0,459,0,0,,459,459
5,01/28/2017,57,14:00,14:15,104.12,,0,104.12,104.12,1,-85305,34445,119750,-50860,0,0,16360,0,0,,16360,16360
5,01/28/2017,58,14:15,14:30,37.44,,0,37.44,37.44,1,-61120,51963,113083,-9157,0,0,6903,0,0,,6903,6903
5,01/28/2017,59,14:30,14:45,,,0,33.17,33.17,0,-63606,48837,112443,-14769,0,0,1684,0,0,,1684,1684
5,01/28/2017,60,14:45,15:00,,,0,33.17,33.17,0,-68633,56413,125046,-12220,0,0,0,0,0,,0,0
5,01/28/2017,61,15:00,15:15,55.77,,0,55.77,55.77,1,-56277,52423,108700,-3854,0,0,2558,0,0,,2558,2558
5,01/28/2017,62,15:15,15:30,39.29,,0,39.29,39.29,1,-52432,48147,100579,-4285,0,0,1335,0,0,,1335,1335
5,01/28/2017,63,15:30,15:45,39.92,,0,39.92,39.92,1,-56781,47774,104555,-9007,0,0,8009,0,0,,8009,8009
5,01/28/2017,64,15:45,16:00,28.66,,0,28.66,28.66,1,-70718,42033,112751,-28685,0,0,762,0,0,,762,762
5,01/28/2017,65,16:00,16:15,,,0,33.18,33.18,0,-61336,57089,118425,-4247,0,0,0,0,0,,0,0
5,01/28/2017,66,16:15,16:30,,,0,33.18,33.18,0,-48844,57168,106012,8324,0,0,0,0,0,,0,0
5,01/28/2017,67,16:30,16:45,,,0,33.18,33.18,0,-60158,56632,116790,-3526,0,0,0,0,0,,0,0
5,01/28/2017,68,16:45,17:00,38.6,,0,38.6,38.6,1,-78741,45303,124044,-33438,0,0,801,0,0,,801,801
5,01/28/2017,69,17:00,17:15,38.6,8.85,0,8.85,8.85,-1,-57013,136022,193035,79009,0,-21815,143,0,0,,21958,-21672
5,01/28/2017,70,17:15,17:30,,34.48,0,34.48,34.48,-1,-59504,80456,139960,20952,0,-16100,0,0,0,,16100,-16100
5,01/28/2017,71,17:30,17:45,151.55,37.78,0,151.55,151.55,1,-82479,38888,121367,-43591,0,-5234,5349,0,0,,10583,115
5,01/28/2017,72,17:45,18:00,193.71,,0,193.71,193.71,1,-83070,48355,131425,-34715,0,0,40549,0,0,,40549,40549
5,01/28/2017,73,18:00,18:15,50,34.39,0,50,34.39,2,-73547,72808,146355,-739,0,-161,26372,0,0,,26533,26211
5,01/28/2017,74,18:15,18:30,50,31.81,0,31.81,31.81,-1,-56731,81797,138528,25066,0,-3414,1978,0,0,,5392,-1436
5,01/28/2017,75,18:30,18:45,,32.64,0,32.64,32.64,-1,-56097,78868,134965,22771,0,-3903,0,0,0,,3903,-3903
5,01/28/2017,76,18:45,19:00,,27.81,0,27.81,27.81,-1,-47124,90639,137763,43515,0,-17327,0,0,0,,17327,-17327
5,01/28/2017,77,19:00,19:15,62.65,27.81,0,62.65,27.81,2,-103781,90821,194602,-12960,0,-16611,5995,0,0,,22606,-10616
5,01/28/2017,78,19:15,19:30,37.44,34.13,0,34.13,34.13,-1,-74623,82105,156728,7482,0,-1029,2583,0,0,,3612,1554
5,01/28/2017,79,19:30,19:45,,34.13,0,34.13,34.13,-1,-73420,100892,174312,27472,0,-1700,0,0,0,,1700,-1700
5,01/28/2017,80,19:45,20:00,,31.81,0,31.81,31.81,-1,-86014,122159,208173,36145,0,-16635,0,0,0,,16635,-16635
5,01/28/2017,81,20:00,20:15,50.71,33.93,0,50.71,33.38,2,-86746,50199,136945,-36547,0,-12076,4732,0,0,,16808,-7344
5,01/28/2017,82,20:15,20:30,34.81,33.93,0,34.81,34.81,1,-57642,58422,116064,780,0,-130,1615,0,0,,1745,1485
5,01/28/2017,83,20:30,20:45,,33.93,0,33.93,33.93,-1,-67089,76583,143672,9494,0,-1623,0,0,0,,1623,-1623
5,01/28/2017,84,20:45,21:00,,33.73,0,33.73,33.73,-1,-70210,109862,180072,39652,0,-10011,0,0,0,,10011,-10011
5,01/28/2017,85,21:00,21:15,50.71,31.78,0,50.71,31.78,2,-74410,51212,125622,-23198,0,-10162,3565,0,0,,13727,-6597
5,01/28/2017,86,21:15,21:30,50.71,31.78,0,50.71,50.71,1,-44140,60940,105080,16800,0,-163,8312,0,0,,8475,8149
5,01/28/2017,87,21:30,21:45,,33.73,0,33.73,33.73,-1,-42832,64718,107550,21886,0,-2327,0,0,0,,2327,-2327
5,01/28/2017,88,21:45,22:00,,23.11,0,23.11,23.11,-1,-41706,82579,124285,40873,0,-17833,0,0,0,,17833,-17833
5,01/28/2017,89,22:00,22:15,37.05,17.09,0,37.05,37.05,1,-72508,45614,118122,-26894,0,-25407,127,0,0,,25534,-25280
5,01/28/2017,90,22:15,22:30,37.44,17.09,0,37.44,37.44,1,-72061,54532,126593,-17529,0,-901,984,0,0,,1885,83
5,01/28/2017,91,22:30,22:45,,37.78,0,37.78,37.78,-1,-68396,78145,146541,9749,0,-756,0,0,0,,756,-756
5,01/28/2017,92,22:45,23:00,,31.81,0,31.81,31.81,-1,-68575,89173,157748,20598,0,-2237,0,0,0,,2237,-2237
5,01/28/2017,93,23:00,23:15,,29.49,0,29.49,29.49,-1,-45414,80924,126338,35510,0,-14933,0,0,0,,14933,-14933
5,01/28/2017,94,23:15,23:30,,37.78,0,37.78,37.78,-1,-53544,59197,112741,5653,0,-4944,0,0,0,,4944,-4944
5,01/28/2017,95,23:30,23:45,,25.56,0,25.56,25.56,-1,-51504,96541,148045,45037,0,-10362,0,0,0,,10362,-10362
5,01/28/2017,96,23:45,0:00,,20.63,0,20.63,20.63,-1,-76251,132187,208438,55936,0,-34972,0,0,0,,34972,-34972
5,01/29/2017,1,0:00,0:15,,27.81,0,27.81,27.81,-1,-19733,63246,82979,43513,0,-17546,0,0,0,,17546,-17546
5,01/29/2017,2,0:15,0:30,,32.81,0,32.81,32.81,-1,-25823,72283,98106,46460,0,-2827,0,0,0,,2827,-2827
5,01/29/2017,3,0:30,0:45,,32.81,0,32.81,32.81,-1,-34240,60311,94551,26071,0,-6712,0,0,0,,6712,-6712
5,01/29/2017,4,0:45,1:00,,32.81,0,32.81,32.81,-1,-85850,86878,172728,1028,0,-6561,0,0,0,,6561,-6561
5,01/29/2017,5,1:00,1:15,,34.94,0,34.94,34.94,-1,-30856,36508,67364,5652,0,-2629,0,0,0,,2629,-2629
5,01/29/2017,6,1:15,1:30,,32.81,0,32.81,32.81,-1,-27415,44338,71753,16923,0,-1675,0,0,0,,1675,-1675
5,01/29/2017,7,1:30,1:45,,32.29,0,32.29,32.29,-1,-27002,60958,87960,33956,0,-4904,0,0,0,,4904,-4904
5,01/29/2017,8,1:45,2:00,,25.03,0,25.03,25.03,-1,-24235,75089,99324,50854,0,-30640,0,0,0,,30640,-30640
5,01/29/2017,9,2:00,2:15,,28.19,0,28.19,28.19,-1,-32476,44978,77454,12502,0,-23188,0,0,0,,23188,-23188
5,01/29/2017,10,2:15,2:30,,32.81,0,32.81,32.81,-1,-31553,52402,83955,20849,0,-1643,0,0,0,,1643,-1643
5,01/29/2017,11,2:30,2:45,,31.81,0,31.81,31.81,-1,-32578,64327,96905,31749,0,-12762,0,0,0,,12762,-12762
5,01/29/2017,12,2:45,3:00,,27.81,0,27.81,27.81,-1,-26246,70979,97225,44733,0,-21651,0,0,0,,21651,-21651
5,01/29/2017,13,3:00,3:15,,27.81,0,27.81,27.81,-1,-28637,63968,92605,35331,0,-16831,0,0,0,,16831,-16831
5,01/29/2017,14,3:15,3:30,,31.81,0,31.81,31.81,-1,-25107,57808,82915,32701,0,-6048,0,0,0,,6048,-6048
5,01/29/2017,15,3:30,3:45,,27.81,0,27.81,27.81,-1,-23200,59010,82210,35810,0,-19525,0,0,0,,19525,-19525
5,01/29/2017,16,3:45,4:00,,30.99,0,30.99,30.99,-1,-24083,55469,79552,31386,0,-26137,0,0,0,,26137,-26137
5,01/29/2017,17,4:00,4:15,,33.99,0,33.99,33.99,-1,-26709,32334,59043,5625,0,-11144,0,0,0,,11144,-11144
5,01/29/2017,18,4:15,4:30,,,0,32.39,32.39,0,-28696,43731,72427,15035,0,-74,0,0,0,,74,-74
5,01/29/2017,19,4:30,4:45,,,0,32.39,32.39,0,-31240,49068,80308,17828,0,0,0,0,0,,0,0
5,01/29/2017,20,4:45,5:00,34.81,,0,34.81,34.81,1,-38658,42260,80918,3602,0,0,137,0,0,,137,137
5,01/29/2017,21,5:00,5:15,34.81,,0,34.81,34.81,1,-36542,49008,85550,12466,0,0,432,0,0,,432,432
5,01/29/2017,22,5:15,5:30,,,0,32.4,32.4,0,-34400,44372,78772,9972,0,0,0,0,0,,0,0
5,01/29/2017,23,5:30,5:45,37.11,,0,37.11,37.11,1,-55436,32672,88108,-22764,0,0,571,0,0,,571,571
5,01/29/2017,24,5:45,6:00,37.14,,0,37.14,37.14,1,-43340,25153,68493,-18187,0,0,1753,0,0,,1753,1753
5,01/29/2017,25,6:00,6:15,37.14,36.1,0,36.1,36.1,-1,-28791,55299,84090,26508,0,-416,1,0,0,,417,-415
5,01/29/2017,26,6:15,6:30,,32.51,0,32.51,32.51,-1,-27838,57628,85466,29790,0,-4170,0,0,0,,4170,-4170
5,01/29/2017,27,6:30,6:45,,,0,32.31,32.31,0,-33544,43964,77508,10420,0,0,0,0,0,,0,0
5,01/29/2017,28,6:45,7:00,,,0,32.31,32.31,0,-44912,55547,100459,10635,0,0,0,0,0,,0,0
5,01/29/2017,29,7:00,7:15,,32.29,0,32.29,32.29,-1,-44733,59453,104186,14720,0,-4788,0,0,0,,4788,-4788
5,01/29/2017,30,7:15,7:30,,,0,32.35,32.35,0,-60733,30914,91647,-29819,0,-282,0,0,0,,282,-282
5,01/29/2017,31,7:30,7:45,,,0,32.35,32.35,0,-65643,19843,85486,-45800,0,0,0,0,0,,0,0
5,01/29/2017,32,7:45,8:00,,,0,32.35,32.35,0,-71871,24885,96756,-46986,0,0,0,0,0,,0,0
5,01/29/2017,33,8:00,8:15,,32.87,0,32.87,32.87,-1,-27163,48980,76143,21817,0,-3436,0,0,0,,3436,-3436
5,01/29/2017,34,8:15,8:30,,32.2,0,32.2,32.2,-1,-23604,58246,81850,34642,0,-9115,0,0,0,,9115,-9115
5,01/29/2017,35,8:30,8:45,,26.82,0,26.82,26.82,-1,-25798,72736,98534,46938,0,-33171,0,0,0,,33171,-33171
5,01/29/2017,36,8:45,9:00,,27.87,0,27.87,27.87,-1,-23622,82569,106191,58947,0,-41048,0,0,0,,41048,-41048
5,01/29/2017,37,9:00,9:15,38.41,29.19,0,38.41,38.41,1,-49775,62147,111922,12372,0,-27309,80,0,0,,27389,-27229
5,01/29/2017,38,9:15,9:30,38.87,29.19,0,38.87,38.87,1,-42178,47557,89735,5379,0,-737,834,0,0,,1571,97
5,01/29/2017,39,9:30,9:45,,37.65,0,37.65,37.65,-1,-41445,43763,85208,2318,0,-91,0,0,0,,91,-91
5,01/29/2017,40,9:45,10:00,44.39,37.65,0,44.39,44.39,1,-53025,33643,86668,-19382,0,-10,6291,0,0,,6301,6281
5,01/29/2017,41,10:00,10:15,34.87,27.87,0,27.87,27.87,-1,-40832,70330,111162,29498,0,-5343,2799,0,0,,8142,-2544
5,01/29/2017,42,10:15,10:30,,27.87,0,27.87,27.87,-1,-45716,56275,101991,10559,0,-14949,0,0,0,,14949,-14949
5,01/29/2017,43,10:30,10:45,,37.65,0,37.65,37.65,-1,-46403,44760,91163,-1643,0,-517,0,0,0,,517,-517
5,01/29/2017,44,10:45,11:00,42.4,37.65,0,42.4,42.4,1,-58887,25072,83959,-33815,0,-19,327,0,0,,346,308
5,01/29/2017,45,11:00,11:15,64.57,,0,64.57,64.57,1,-69672,33641,103313,-36031,0,0,30252,0,0,,30252,30252
5,01/29/2017,46,11:15,11:30,53.19,,0,53.19,53.19,1,-69573,26580,96153,-42993,0,0,33671,0,0,,33671,33671
5,01/29/2017,47,11:30,11:45,,,0,32.5,32.5,0,-70768,25350,96118,-45418,0,0,3151,0,0,,3151,3151
5,01/29/2017,48,11:45,12:00,53.19,,0,53.19,53.19,1,-91673,20330,112003,-71343,0,0,1452,0,0,,1452,1452
5,01/29/2017,49,12:00,12:15,53.19,,0,53.19,53.19,1,-90489,41714,132203,-48775,0,0,6303,0,0,,6303,6303
5,01/29/2017,50,12:15,12:30,37.06,,0,37.06,37.06,1,-88836,34148,122984,-54688,0,0,1778,0,0,,1778,1778
5,01/29/2017,51,12:30,12:45,80.71,,0,80.71,80.71,1,-88060,38762,126822,-49298,0,0,21217,0,0,,21217,21217
5,01/29/2017,52,12:45,13:00,48.9,,0,48.9,48.9,1,-74078,47822,121900,-26256,0,0,23457,0,0,,23457,23457
5,01/29/2017,53,13:00,13:15,48.9,36.1,0,36.1,36.1,-1,-42776,50572,93348,7796,0,-620,2189,0,0,,2809,1569
5,01/29/2017,54,13:15,13:30,,32.87,0,32.87,32.87,-1,-51261,52891,104152,1630,0,-2461,0,0,0,,2461,-2461
5,01/29/2017,55,13:30,13:45,,,0,32.23,32.23,0,-65431,60311,125742,-5120,0,-19,0,0,0,,19,-19
5,01/29/2017,56,13:45,14:00,,32.87,0,32.87,32.87,-1,-61520,62744,124264,1224,0,-646,0,0,0,,646,-646
5,01/29/2017,57,14:00,14:15,,29.19,0,29.19,29.19,-1,-61495,95120,156615,33625,0,-21495,0,0,0,,21495,-21495
5,01/29/2017,58,14:15,14:30,,32.87,0,32.87,32.87,-1,-70005,80968,150973,10963,0,-12697,0,0,0,,12697,-12697
5,01/29/2017,59,14:30,14:45,,32.87,0,32.87,32.87,-1,-76484,81300,157784,4816,0,-1644,0,0,0,,1644,-1644
5,01/29/2017,60,14:45,15:00,,31.87,0,31.87,31.87,-1,-65990,85174,151164,19184,0,-10961,0,0,0,,10961,-10961
5,01/29/2017,61,15:00,15:15,,29.19,0,29.19,29.19,-1,-54874,83775,138649,28901,0,-13439,0,0,0,,13439,-13439
5,01/29/2017,62,15:15,15:30,,28.15,0,28.15,28.15,-1,-52532,76379,128911,23847,0,-25588,0,0,0,,25588,-25588
5,01/29/2017,63,15:30,15:45,44.87,28.15,0,44.87,44.87,1,-65014,63089,128103,-1925,0,-4668,5432,0,0,,10100,764
5,01/29/2017,64,15:45,16:00,44.87,28.15,0,28.15,28.15,-1,-56844,76804,133648,19960,0,-9960,748,0,0,,10708,-9212
5,01/29/2017,65,16:00,16:15,37.48,37.03,0,37.48,33.07,2,-58968,47904,106872,-11064,0,-2886,728,0,0,,3614,-2158
5,01/29/2017,66,16:15,16:30,45.02,,0,45.02,45.02,1,-63766,39616,103382,-24150,0,0,7023,0,0,,7023,7023
5,01/29/2017,67,16:30,16:45,53.98,,0,53.98,53.98,1,-58919,26754,85673,-32165,0,0,24392,0,0,,24392,24392
5,01/29/2017,68,16:45,17:00,53.98,,0,53.98,53.98,1,-113562,58140,171702,-55422,0,0,40673,0,0,,40673,40673
5,01/29/2017,69,17:00,17:15,52.02,30.36,0,30.36,30.36,-1,-57268,108765,166033,51497,0,-2300,23007,0,0,,25307,20707
5,01/29/2017,70,17:15,17:30,52.02,37.65,0,37.65,37.65,-1,-83346,68979,152325,-14367,0,-1603,183,0,0,,1786,-1420
5,01/29/2017,71,17:30,17:45,160.57,,0,160.57,160.57,1,-139473,50829,190302,-88644,0,0,19449,0,0,,19449,19449
5,01/29/2017,72,17:45,18:00,160.57,,0,160.57,160.57,1,-207475,57793,265268,-149682,0,0,83464,0,0,,83464,83464
5,01/29/2017,73,18:00,18:15,212.14,,0,212.14,212.14,1,-190172,29544,219716,-160628,0,0,87103,1250,0,,88353,88353
5,01/29/2017,74,18:15,18:30,257.85,,0,257.85,257.85,1,-148474,38504,186978,-109970,0,0,85888,1250,0,,87138,87138
5,01/29/2017,75,18:30,18:45,257.85,,0,257.85,257.85,1,-115228,62234,177462,-52994,0,0,69137,1250,0,,70387,70387
5,01/29/2017,76,18:45,19:00,200,15.57,0,200,15.57,2,-45343,61868,107211,16525,0,-11638,6011,1250,0,,18899,-4377
5,01/29/2017,77,19:00,19:15,,33.08,0,33.08,33.08,-1,-72528,76661,149189,4133,0,-8305,0,0,0,,8305,-8305
5,01/29/2017,78,19:15,19:30,,32.87,0,32.87,32.87,-1,-58090,50998,109088,-7092,0,-4174,0,0,0,,4174,-4174
5,01/29/2017,79,19:30,19:45,,32.87,0,32.87,32.87,-1,-41649,55920,97569,14271,0,-2103,0,0,0,,2103,-2103
5,01/29/2017,80,19:45,20:00,,37.59,0,37.59,37.59,-1,-38835,55248,94083,16413,0,-1708,0,0,0,,1708,-1708
5,01/29/2017,81,20:00,20:15,,37.59,0,37.59,37.59,-1,-43125,63962,107087,20837,0,-1854,0,0,0,,1854,-1854
5,01/29/2017,82,20:15,20:30,,31.24,0,31.24,31.24,-1,-43568,66152,109720,22584,0,-4078,0,0,0,,4078,-4078
5,01/29/2017,83,20:30,20:45,,27.87,0,27.87,27.87,-1,-29919,76435,106354,46516,0,-31783,0,0,0,,31783,-31783
5,01/29/2017,84,20:45,21:00,,25.62,0,25.62,25.62,-1,-34201,113913,148114,79712,0,-44368,0,0,0,,44368,-44368
5,01/29/2017,85,21:00,21:15,,26.36,0,26.36,26.36,-1,-24468,68493,92961,44025,0,-31998,0,0,0,,31998,-31998
5,01/29/2017,86,21:15,21:30,,32.87,0,32.87,32.87,-1,-26155,55117,81272,28962,0,-1535,0,0,0,,1535,-1535
5,01/29/2017,87,21:30,21:45,,-8.03,0,-8.03,-8.03,-1,-21441,87048,108489,65607,0,-33074,0,0,0,,33074,-33074
5,01/29/2017,88,21:45,22:00,,-5.03,0,-5.03,-5.03,-1,-23880,112024,135904,88144,0,-43721,0,0,0,,43721,-43721
5,01/29/2017,89,22:00,22:15,34.02,-22.03,0,34.02,34.02,1,-45106,22371,67477,-22735,0,-40231,21,0,0,,40252,-40210
5,01/29/2017,90,22:15,22:30,38.41,26.41,0,38.41,26.41,2,-41965,66451,108416,24486,0,-3720,512,0,0,,4232,-3208
5,01/29/2017,91,22:30,22:45,,20.77,0,20.77,20.77,-1,-29040,99444,128484,70404,0,-22960,0,0,0,,22960,-22960
5,01/29/2017,92,22:45,23:00,,-16.03,0,-16.03,-16.03,-1,-29360,124014,153374,94654,0,-22520,0,0,0,,22520,-22520
5,01/29/2017,93,23:00,23:15,37.25,-22.03,0,37.25,37.25,1,-103411,40698,144109,-62713,0,-23677,278,0,0,,23955,-23399
5,01/29/2017,94,23:15,23:30,37.48,-22.03,0,37.48,37.48,1,-61982,33443,95425,-28539,0,-235,619,0,0,,854,384
5,01/29/2017,95,23:30,23:45,,32.87,0,32.87,32.87,-1,-32316,42479,74795,10163,0,-5129,0,0,0,,5129,-5129
5,01/29/2017,96,23:45,0:00,,30.99,0,30.99,30.99,-1,-36007,61908,97915,25901,0,-8172,0,0,0,,8172,-8172
5,01/30/2017,1,0:00,0:15,132.12,30.99,0,132.12,132.12,1,-115973,22254,138227,-93719,0,-4564,20232,0,0,,24796,15668
5,01/30/2017,2,0:15,0:30,118.12,,0,118.12,118.12,1,-72830,28249,101079,-44581,0,0,50660,0,0,,50660,50660
5,01/30/2017,3,0:30,0:45,35.12,,0,35.12,35.12,1,-54724,29497,84221,-25227,0,0,11341,0,0,,11341,11341
5,01/30/2017,4,0:45,1:00,,34.78,0,34.78,34.78,-1,-44904,41079,85983,-3825,0,-74,0,0,0,,74,-74
5,01/30/2017,5,1:00,1:15,38.09,,0,38.09,38.09,1,-58736,35162,93898,-23574,0,0,571,0,0,,571,571
5,01/30/2017,6,1:15,1:30,38.99,,0,38.99,38.99,1,-54948,22877,77825,-32071,0,0,1275,0,0,,1275,1275
5,01/30/2017,7,1:30,1:45,37.9,,0,37.9,37.9,1,-40233,16926,57159,-23307,0,0,3953,0,0,,3953,3953
5,01/30/2017,8,1:45,2:00,35.02,,0,35.02,35.02,1,-29796,26686,56482,-3110,0,0,2438,0,0,,2438,2438
5,01/30/2017,9,2:00,2:15,,36.1,0,36.1,36.1,-1,-27660,30132,57792,2472,0,-408,0,0,0,,408,-408
5,01/30/2017,10,2:15,2:30,35.02,,0,35.02,35.02,1,-34220,27077,61297,-7143,0,0,881,0,0,,881,881
5,01/30/2017,11,2:30,2:45,32.12,33.02,0,33.02,33.02,-1,-32988,46949,79937,13961,0,-3089,430,0,0,,3519,-2659
5,01/30/2017,12,2:45,3:00,,33.02,0,33.02,33.02,-1,-41076,54331,95407,13255,0,-13459,0,0,0,,13459,-13459
5,01/30/2017,13,3:00,3:15,,36.44,0,36.44,36.44,-1,-28226,52121,80347,23895,0,-7192,0,0,0,,7192,-7192
5,01/30/2017,14,3:15,3:30,,36.44,0,36.44,36.44,-1,-25680,45226,70906,19546,0,-1205,0,0,0,,1205,-1205
5,01/30/2017,15,3:30,3:45,,36.1,0,36.1,36.1,-1,-37295,40831,78126,3536,0,-3347,0,0,0,,3347,-3347
5,01/30/2017,16,3:45,4:00,,37.65,0,37.65,37.65,-1,-48762,40640,89402,-8122,0,-538,0,0,0,,538,-538
5,01/30/2017,17,4:00,4:15,,37.65,0,37.65,37.65,-1,-54907,39550,94457,-15357,0,-27,0,0,0,,27,-27
5,01/30/2017,18,4:15,4:30,,37.65,0,37.65,37.65,-1,-49742,26881,76623,-22861,0,-45,0,0,0,,45,-45
5,01/30/2017,19,4:30,4:45,35.02,,0,35.02,35.02,1,-59518,27831,87349,-31687,0,0,828,0,0,,828,828
5,01/30/2017,20,4:45,5:00,27.57,,0,27.57,27.57,1,-75598,42777,118375,-32821,0,0,715,0,0,,715,715
5,01/30/2017,21,5:00,5:15,,,0,32.59,32.59,0,-88809,45689,134498,-43120,0,0,0,0,0,,0,0
5,01/30/2017,22,5:15,5:30,,,0,32.59,32.59,0,-59654,37398,97052,-22256,0,0,0,0,0,,0,0
5,01/30/2017,23,5:30,5:45,,,0,32.59,32.59,0,-84661,39947,124608,-44714,0,0,0,0,0,,0,0
5,01/30/2017,24,5:45,6:00,,,0,32.59,32.59,0,-103835,89153,192988,-14682,0,0,0,0,0,,0,0
5,01/30/2017,25,6:00,6:15,,,0,32.38,32.38,0,-98688,27668,126356,-71020,0,0,0,0,0,,0,0
5,01/30/2017,26,6:15,6:30,34.96,,0,34.96,34.96,1,-94484,35546,130030,-58938,0,0,18,0,0,,18,18
5,01/30/2017,27,6:30,6:45,132.82,,0,132.82,132.82,1,-142207,17757,159964,-124450,0,0,6695,0,0,,6695,6695
5,01/30/2017,28,6:45,7:00,132.82,,0,132.82,132.82,1,-207503,22586,230089,-184917,0,0,84107,0,0,,84107,84107
5,01/30/2017,29,7:00,7:15,132.82,-39.37,0,-39.37,-39.37,-1,-24143,105470,129613,81327,0,-19721,28108,0,0,,47829,8387
5,01/30/2017,30,7:15,7:30,,33.43,0,33.43,33.43,-1,-117109,81208,198317,-35901,0,-7015,0,0,0,,7015,-7015
5,01/30/2017,31,7:30,7:45,40.28,,0,40.28,40.28,1,-182769,111239,294008,-71530,0,0,1822,0,0,,1822,1822
5,01/30/2017,32,7:45,8:00,250,37.46,0,250,37.46,2,-235423,99392,334815,-136031,0,-1,22524,0,0,,22525,22523
5,01/30/2017,33,8:00,8:15,250,-16.49,0,-16.49,-16.49,-1,-67210,94421,161631,27211,0,-29347,4421,0,0,,33768,-24926
5,01/30/2017,34,8:15,8:30,,33.43,0,33.43,33.43,-1,-92074,112702,204776,20628,0,-10103,0,0,0,,10103,-10103
5,01/30/2017,35,8:30,8:45,35.67,33.43,0,35.67,35.67,1,-115498,113200,228698,-2298,0,-7382,14,0,0,,7396,-7368
5,01/30/2017,36,8:45,9:00,40.65,33.43,0,40.65,40.65,1,-126870,95675,222545,-31195,0,-65,1873,0,0,,1938,1808
5,01/30/2017,37,9:00,9:15,,53.47,0,53.47,53.47,-1,-68485,76607,145092,8122,0,-61,0,0,0,,61,-61
5,01/30/2017,38,9:15,9:30,80,,0,80,80,1,-86499,56470,142969,-30029,0,0,11556,0,0,,11556,11556
5,01/30/2017,39,9:30,9:45,42.49,,0,42.49,42.49,1,-81542,59652,141194,-21890,0,0,18034,0,0,,18034,18034
5,01/30/2017,40,9:45,10:00,42.49,,0,42.49,42.49,1,-79091,63707,142798,-15384,0,0,13540,0,0,,13540,13540
5,01/30/2017,41,10:00,10:15,54.79,,0,54.79,54.79,1,-69623,12679,82302,-56944,0,0,11780,0,0,,11780,11780
5,01/30/2017,42,10:15,10:30,113.12,,0,113.12,113.12,1,-98664,9131,107795,-89533,0,0,33315,0,0,,33315,33315
5,01/30/2017,43,10:30,10:45,63.77,,0,63.77,63.77,1,-103610,18083,121693,-85527,0,0,28851,0,0,,28851,28851
5,01/30/2017,44,10:45,11:00,89.6,,0,89.6,89.6,1,-120169,7289,127458,-112880,0,0,44004,0,0,,44004,44004
5,01/30/2017,45,11:00,11:15,64.91,,0,64.91,64.91,1,-75528,25193,100721,-50335,0,0,38728,0,0,,38728,38728
5,01/30/2017,46,11:15,11:30,90.86,,0,90.86,90.86,1,-88179,17470,105649,-70709,0,0,39046,0,0,,39046,39046
5,01/30/2017,47,11:30,11:45,110.44,,0,110.44,110.44,1,-85521,14884,100405,-70637,0,0,56015,0,0,,56015,56015
5,01/30/2017,48,11:45,12:00,64.91,,0,64.91,64.91,1,-76548,15973,92521,-60575,0,0,40998,0,0,,40998,40998
5,01/30/2017,49,12:00,12:15,52.89,,0,52.89,52.89,1,-86498,25159,111657,-61339,0,0,22253,0,0,,22253,22253
5,01/30/2017,50,12:15,12:30,,,0,44.9,44.9,0,-67406,36156,103562,-31250,0,0,342,0,0,,342,342
5,01/30/2017,51,12:30,12:45,70,,0,70,70,1,-81206,44459,125665,-36747,0,0,4281,0,0,,4281,4281
5,01/30/2017,52,12:45,13:00,72.66,,0,72.66,72.66,1,-84921,43397,128318,-41524,0,0,9151,0,0,,9151,9151
5,01/30/2017,53,13:00,13:15,44.02,,0,44.02,44.02,1,-61051,42391,103442,-18660,0,0,3378,0,0,,3378,3378
5,01/30/2017,54,13:15,13:30,39.9,,0,39.9,39.9,1,-80970,52489,133459,-28481,0,0,10488,0,0,,10488,10488
5,01/30/2017,55,13:30,13:45,,,0,37.61,37.61,0,-64188,69770,133958,5582,0,0,3064,0,0,,3064,3064
5,01/30/2017,56,13:45,14:00,36.89,35.78,0,37.61,35.78,2,-81764,80748,162512,-1016,0,-967,30,0,0,,997,-937
5,01/30/2017,57,14:00,14:15,,32.96,0,32.96,32.96,-1,-58136,63879,122015,5743,0,-4031,0,0,0,,4031,-4031
5,01/30/2017,58,14:15,14:30,,28.25,0,28.25,28.25,-1,-41570,63598,105168,22028,0,-33360,0,0,0,,33360,-33360
5,01/30/2017,59,14:30,14:45,,33.43,0,33.43,33.43,-1,-52390,65891,118281,13501,0,-8697,0,0,0,,8697,-8697
5,01/30/2017,60,14:45,15:00,,27.19,0,27.19,27.19,-1,-34511,62030,96541,27519,0,-26180,0,0,0,,26180,-26180
5,01/30/2017,61,15:00,15:15,,35.42,0,35.42,35.42,-1,-36915,61730,98645,24815,0,-8743,0,0,0,,8743,-8743
5,01/30/2017,62,15:15,15:30,,35.42,0,35.42,35.42,-1,-36614,65864,102478,29250,0,-5339,0,0,0,,5339,-5339
5,01/30/2017,63,15:30,15:45,,33.11,0,33.11,33.11,-1,-34235,82231,116466,47996,0,-3459,0,0,0,,3459,-3459
5,01/30/2017,64,15:45,16:00,,31.96,0,31.96,31.96,-1,-36033,79780,115813,43747,0,-8525,0,0,0,,8525,-8525
5,01/30/2017,65,16:00,16:15,,27.19,0,27.19,27.19,-1,-51161,117199,168360,66038,0,-34952,0,0,0,,34952,-34952
5,01/30/2017,66,16:15,16:30,,27.96,0,27.96,27.96,-1,-45318,118088,163406,72770,0,-16293,0,0,0,,16293,-16293
5,01/30/2017,67,16:30,16:45,,27.96,0,27.96,27.96,-1,-34797,134891,169688,100094,0,-32784,0,0,0,,32784,-32784
5,01/30/2017,68,16:45,17:00,,31.96,0,31.96,31.96,-1,-44159,127445,171604,83286,0,-20836,0,0,0,,20836,-20836
5,01/30/2017,69,17:00,17:15,,-16.49,0,-16.49,-16.49,-1,-62908,158603,221511,95695,0,-65948,0,0,0,,65948,-65948
5,01/30/2017,70,17:15,17:30,,30.69,0,30.69,30.69,-1,-79290,131737,211027,52447,0,-50452,0,0,0,,50452,-50452
5,01/30/2017,71,17:30,17:45,,31.96,0,31.96,31.96,-1,-70413,111089,181502,40676,0,-44333,0,0,0,,44333,-44333
5,01/30/2017,72,17:45,18:00,,30.99,0,30.99,30.99,-1,-70258,105629,175887,35371,0,-17611,0,0,0,,17611,-17611
5,01/30/2017,73,18:00,18:15,,-16.49,0,-16.49,-16.49,-1,-91820,39680,131500,-52140,0,-48498,0,0,0,,48498,-48498
5,01/30/2017,74,18:15,18:30,38.48,34.76,0,44.43,34.76,2,-74402,63058,137460,-11344,0,-7510,702,0,0,,8212,-6808
5,01/30/2017,75,18:30,18:45,,32.51,0,32.51,32.51,-1,-52931,80745,133676,27814,0,-17378,0,0,0,,17378,-17378
5,01/30/2017,76,18:45,19:00,,33.43,0,33.43,33.43,-1,-52903,71077,123980,18174,0,-9308,0,0,0,,9308,-9308
5,01/30/2017,77,19:00,19:15,,32.96,0,32.96,32.96,-1,-57935,78633,136568,20698,0,-10226,0,0,0,,10226,-10226
5,01/30/2017,78,19:15,19:30,,32.76,0,32.76,32.76,-1,-66439,83565,150004,17126,0,-10818,0,0,0,,10818,-10818
5,01/30/2017,79,19:30,19:45,,33.43,0,33.43,33.43,-1,-65636,62255,127891,-3381,0,-6717,0,0,0,,6717,-6717
5,01/30/2017,80,19:45,20:00,,33.43,0,33.43,33.43,-1,-66552,76249,142801,9697,0,-11552,0,0,0,,11552,-11552
5,01/30/2017,81,20:00,20:15,34.96,33.43,0,37.33,33.43,2,-84368,53690,138058,-30678,0,-10069,15,0,0,,10084,-10054
5,01/30/2017,82,20:15,20:30,34.96,33.43,0,34.96,34.96,1,-45140,27687,72827,-17453,0,-75,561,0,0,,636,486
5,01/30/2017,83,20:30,20:45,,31.96,0,31.96,31.96,-1,-36475,60443,96918,23968,0,-5847,0,0,0,,5847,-5847
5,01/30/2017,84,20:45,21:00,,27.96,0,27.96,27.96,-1,-35438,84723,120161,49285,0,-33016,0,0,0,,33016,-33016
5,01/30/2017,85,21:00,21:15,48.2,30.99,0,48.2,30.99,2,-97593,62705,160298,-34888,0,-26092,469,0,0,,26561,-25623
5,01/30/2017,86,21:15,21:30,48.2,35.77,0,48.2,33.51,2,-77974,69040,147014,-8934,0,-2092,2321,0,0,,4413,229
5,01/30/2017,87,21:30,21:45,,32.96,0,32.96,32.96,-1,-45477,73152,118629,27675,0,-14439,0,0,0,,14439,-14439
5,01/30/2017,88,21:45,22:00,,27.89,0,27.89,27.89,-1,-47171,107267,154438,60096,0,-33315,0,0,0,,33315,-33315
5,01/30/2017,89,22:00,22:15,99.35,27.96,0,99.35,99.35,1,-74959,14479,89438,-60480,0,-34985,3259,0,0,,38244,-31726
5,01/30/2017,90,22:15,22:30,137.12,32.64,0,137.12,32.64,2,-102595,61402,163997,-41193,0,-883,31313,0,0,,32196,30430
5,01/30/2017,91,22:30,22:45,137.12,15.5,0,15.5,15.5,-1,-42636,115409,158045,72773,0,-45461,891,0,0,,46352,-44570
5,01/30/2017,92,22:45,23:00,,27.96,0,27.96,27.96,-1,-50403,94648,145051,44245,0,-48916,0,0,0,,48916,-48916
5,01/30/2017,93,23:00,23:15,35.7,31.99,0,35.7,35.7,1,-97950,85485,183435,-12465,0,-16056,302,0,0,,16358,-15754
5,01/30/2017,94,23:15,23:30,35.7,31.99,0,35.7,31.99,2,-63307,85337,148644,22030,0,-4283,645,0,0,,4928,-3638
5,01/30/2017,95,23:30,23:45,,31.99,0,31.99,31.99,-1,-53803,88577,142380,34774,0,-8143,0,0,0,,8143,-8143
5,01/30/2017,96,23:45,0:00,,25.99,0,25.99,25.99,-1,-56085,95011,151096,38926,0,-7222,0,0,0,,7222,-7222
5,01/31/2017,1,0:00,0:15,,23.86,0,23.86,23.86,-1,-82911,107385,190296,24474,0,-9079,0,0,0,,9079,-9079
5,01/31/2017,2,0:15,0:30,27.79,,0,27.79,27.79,1,-57579,48997,106576,-8582,0,0,248,0,0,,248,248
5,01/31/2017,3,0:30,0:45,,33.69,0,33.69,33.69,-1,-36244,56941,93185,20697,0,-600,0,0,0,,600,-600
5,01/31/2017,4,0:45,1:00,,30.01,0,30.01,30.01,-1,-38767,80340,119107,41573,0,-11710,0,0,0,,11710,-11710
5,01/31/2017,5,1:00,1:15,27.82,36.17,0,27.82,27.82,1,-63143,34483,97626,-28660,0,-5776,43,0,0,,5819,-5733
5,01/31/2017,6,1:15,1:30,27.82,,0,27.82,27.82,1,-82178,41820,123998,-40358,0,0,605,0,0,,605,605
5,01/31/2017,7,1:30,1:45,,,0,32.19,32.19,0,-50429,53118,103547,2689,0,0,0,0,0,,0,0
5,01/31/2017,8,1:45,2:00,,,0,32.19,32.19,0,-40829,61055,101884,20226,0,0,0,0,0,,0,0
5,01/31/2017,9,2:00,2:15,28.21,,0,28.21,28.21,1,-24184,23427,47611,-757,0,0,27,0,0,,27,27
5,01/31/2017,10,2:15,2:30,34.76,35.94,0,34.76,32.39,2,-19556,34803,54359,15247,0,-172,508,0,0,,680,336
5,01/31/2017,11,2:30,2:45,,35.43,0,35.43,35.43,-1,-18323,49510,67833,31187,0,-3873,0,0,0,,3873,-3873
5,01/31/2017,12,2:45,3:00,,30.18,0,30.18,30.18,-1,-19329,64813,84142,45484,0,-14470,0,0,0,,14470,-14470
5,01/31/2017,13,3:00,3:15,,26,0,26,26,-1,-9893,95834,105727,85941,0,-34152,0,0,0,,34152,-34152
5,01/31/2017,14,3:15,3:30,,27.7,0,27.7,27.7,-1,-13041,104040,117081,90999,0,-38198,0,0,0,,38198,-38198
5,01/31/2017,15,3:30,3:45,,31.43,0,31.43,31.43,-1,-11653,106996,118649,95343,0,-38330,0,0,0,,38330,-38330
5,01/31/2017,16,3:45,4:00,,19.75,0,19.75,19.75,-1,-11486,116048,127534,104562,0,-47483,0,0,0,,47483,-47483
5,01/31/2017,17,4:00,4:15,,30.35,0,30.35,30.35,-1,-42983,76930,119913,33947,0,-27781,0,0,0,,27781,-27781
5,01/31/2017,18,4:15,4:30,,,0,32.94,32.94,0,-25954,91362,117316,65408,0,-317,0,0,0,,317,-317
5,01/31/2017,19,4:30,4:45,,,0,32.94,32.94,0,-32257,97384,129641,65127,0,0,0,0,0,,0,0
5,01/31/2017,20,4:45,5:00,,,0,32.94,32.94,0,-32433,92710,125143,60277,0,0,0,0,0,,0,0
5,01/31/2017,21,5:00,5:15,,12.66,0,12.66,12.66,-1,-21687,126519,148206,104832,0,-18531,0,0,0,,18531,-18531
5,01/31/2017,22,5:15,5:30,,12.66,0,12.66,12.66,-1,-17760,87528,105288,69768,0,-48824,0,0,0,,48824,-48824
5,01/31/2017,23,5:30,5:45,36.92,35.43,0,36.92,36.92,1,-33226,59407,92633,26181,0,-17811,477,0,0,,18288,-17334
5,01/31/2017,24,5:45,6:00,36.92,35.43,0,36.92,36.92,1,-26823,46650,73473,19827,0,-54,322,0,0,,376,268
5,01/31/2017,25,6:00,6:15,28.06,,0,28.06,28.06,1,-87213,90155,177368,2942,0,0,328,0,0,,328,328
5,01/31/2017,26,6:15,6:30,39.6,36.5,0,39.6,34.27,2,-116657,98685,215342,-17972,0,-234,1311,0,0,,1545,1077
5,01/31/2017,27,6:30,6:45,68.96,,0,68.96,68.96,1,-156770,53122,209892,-103648,0,0,21527,0,0,,21527,21527
5,01/31/2017,28,6:45,7:00,136.54,,0,136.54,136.54,1,-212448,95509,307957,-116939,0,0,58033,0,0,,58033,58033
5,01/31/2017,29,7:00,7:15,75.42,32.75,0,32.75,32.75,-1,-143872,175534,319406,31662,0,-1736,34536,0,0,,36272,32800
5,01/31/2017,30,7:15,7:30,156.79,32.75,0,156.79,156.79,1,-162871,62980,225851,-99891,0,-106,5991,0,0,,6097,5885
5,01/31/2017,31,7:30,7:45,156.79,,0,156.79,156.79,1,-216308,44756,261064,-171552,0,0,73732,0,0,,73732,73732
5,01/31/2017,32,7:45,8:00,156.79,,0,156.79,156.79,1,-244454,50850,295304,-193604,0,0,93790,0,0,,93790,93790
5,01/31/2017,33,8:00,8:15,281.82,32.95,0,32.95,32.95,-1,-93046,76576,169622,-16470,0,-96,42797,16250,0,,59143,58951
5,01/31/2017,34,8:15,8:30,,32.95,0,32.95,32.95,-1,-98245,73290,171535,-24955,0,-128,0,0,0,,128,-128
5,01/31/2017,35,8:30,8:45,40.17,,0,40.17,40.17,1,-137049,45277,182326,-91772,0,0,1462,0,0,,1462,1462
5,01/31/2017,36,8:45,9:00,55.02,,0,55.02,55.02,1,-131852,32827,164679,-99025,0,0,20272,0,0,,20272,20272
5,01/31/2017,37,9:00,9:15,,,0,44.02,44.02,0,-51051,33796,84847,-17255,0,0,5055,0,0,,5055,5055
5,01/31/2017,38,9:15,9:30,,,0,44.02,44.02,0,-63779,21858,85637,-41921,0,0,0,0,0,,0,0
5,01/31/2017,39,9:30,9:45,37.88,,0,37.88,37.88,1,-68616,18054,86670,-50562,0,0,368,0,0,,368,368
5,01/31/2017,40,9:45,10:00,55.02,,0,55.02,55.02,1,-75991,12136,88127,-63855,0,0,16568,0,0,,16568,16568
5,01/31/2017,41,10:00,10:15,35.15,34.86,0,34.86,34.86,-1,-35254,46392,81646,11138,0,-1455,8053,0,0,,9508,6598
5,01/31/2017,42,10:15,10:30,,34.86,0,34.86,34.86,-1,-43877,38448,82325,-5429,0,-1806,0,0,0,,1806,-1806
5,01/31/2017,43,10:30,10:45,,,0,44.02,44.02,0,-45080,53225,98305,8145,0,0,0,0,0,,0,0
5,01/31/2017,44,10:45,11:00,,53.38,0,53.38,53.38,-1,-39797,68915,108712,29118,0,-393,0,0,0,,393,-393
5,01/31/2017,45,11:00,11:15,,53.38,0,53.38,53.38,-1,-45890,61138,107028,15248,0,-222,0,0,0,,222,-222
5,01/31/2017,46,11:15,11:30,,53.38,0,53.38,53.38,-1,-48336,57715,106051,9379,0,-9,0,0,0,,9,-9
5,01/31/2017,47,11:30,11:45,,,0,44.02,44.02,0,-46098,61254,107352,15156,0,0,0,0,0,,0,0
5,01/31/2017,48,11:45,12:00,55.02,,0,55.02,55.02,1,-42646,51576,94222,8930,0,0,7216,0,0,,7216,7216
5,01/31/2017,49,12:00,12:15,88.36,,0,88.36,88.36,1,-108066,15811,123877,-92255,0,0,20583,0,0,,20583,20583
5,01/31/2017,50,12:15,12:30,40.17,,0,40.17,40.17,1,-93496,10036,103532,-83460,0,0,21718,0,0,,21718,21718
5,01/31/2017,51,12:30,12:45,35.8,,0,35.8,35.8,1,-87208,32866,120074,-54342,0,0,9991,0,0,,9991,9991
5,01/31/2017,52,12:45,13:00,,,0,43.99,43.99,0,-82118,33673,115791,-48445,0,0,0,0,0,,0,0
5,01/31/2017,53,13:00,13:15,,,0,43.99,43.99,0,-65751,35835,101586,-29916,0,0,0,0,0,,0,0
5,01/31/2017,54,13:15,13:30,,,0,43.99,43.99,0,-81714,23685,105399,-58029,0,0,0,0,0,,0,0
5,01/31/2017,55,13:30,13:45,35.8,,0,35.8,35.8,1,-93610,33543,127153,-60067,0,0,646,0,0,,646,646
5,01/31/2017,56,13:45,14:00,36.71,,0,36.71,36.71,1,-93831,22584,116415,-71247,0,0,3694,0,0,,3694,3694
5,01/31/2017,57,14:00,14:15,190.36,,0,190.36,190.36,1,-146234,23858,170092,-122376,0,0,32705,0,0,,32705,32705
5,01/31/2017,58,14:15,14:30,190.36,,0,190.36,190.36,1,-125218,13899,139117,-111319,0,0,55542,0,0,,55542,55542
5,01/31/2017,59,14:30,14:45,190.36,,0,190.36,190.36,1,-127478,30122,157600,-97356,0,0,50063,0,0,,50063,50063
5,01/31/2017,60,14:45,15:00,190.36,,0,190.36,190.36,1,-119631,43069,162700,-76562,0,0,72285,0,0,,72285,72285
5,01/31/2017,61,15:00,15:15,130.5,,0,130.5,130.5,1,-127563,58002,185565,-69561,0,0,68147,0,0,,68147,68147
5,01/31/2017,62,15:15,15:30,95.75,,0,95.75,95.75,1,-124855,59835,184690,-65020,0,0,64488,0,0,,64488,64488
5,01/31/2017,63,15:30,15:45,183.63,,0,183.63,183.63,1,-122281,62736,185017,-59545,0,0,68769,0,0,,68769,68769
5,01/31/2017,64,15:45,16:00,95.75,,0,95.75,95.75,1,-125438,62835,188273,-62603,0,0,66464,0,0,,66464,66464
5,01/31/2017,65,16:00,16:15,85.2,,0,85.2,85.2,1,-85694,73170,158864,-12524,0,0,39485,0,0,,39485,39485
5,01/31/2017,66,16:15,16:30,85.2,,0,85.2,85.2,1,-82377,54789,137166,-27588,0,0,4606,0,0,,4606,4606
5,01/31/2017,67,16:30,16:45,102.7,,0,102.7,102.7,1,-83611,36110,119721,-47501,0,0,29785,0,0,,29785,29785
5,01/31/2017,68,16:45,17:00,107.84,,0,107.84,107.84,1,-110037,69321,179358,-40716,0,0,34206,0,0,,34206,34206
5,01/31/2017,69,17:00,17:15,35.15,29.9,0,43.24,29.9,2,-70213,87333,157546,17120,0,-4582,8411,0,0,,12993,3829
5,01/31/2017,70,17:15,17:30,37.02,,0,37.02,37.02,1,-75208,79771,154979,4563,0,0,4585,0,0,,4585,4585
5,01/31/2017,71,17:30,17:45,37.02,,0,37.02,37.02,1,-93058,39721,132779,-53337,0,0,10503,0,0,,10503,10503
5,01/31/2017,72,17:45,18:00,195,,0,195,195,1,-86104,62384,148488,-23720,0,0,27960,0,0,,27960,27960
5,01/31/2017,73,18:00,18:15,84.33,38.29,0,84.33,38.29,2,-80715,60424,141139,-20291,0,-21,23669,0,0,,23690,23648
5,01/31/2017,74,18:15,18:30,35.8,36.03,0,41.48,36.03,2,-49143,63959,113102,14816,0,-1156,1779,0,0,,2935,623
5,01/31/2017,75,18:30,18:45,35.8,,0,35.8,35.8,1,-44002,66545,110547,22543,0,0,863,0,0,,863,863
5,01/31/2017,76,18:45,19:00,35.8,,0,35.8,35.8,1,-39730,71465,111195,31735,0,0,152,0,0,,152,152
5,01/31/2017,77,19:00,19:15,190,,0,190,190,1,-64805,30743,95548,-34062,0,0,28990,0,0,,28990,28990
5,01/31/2017,78,19:15,19:30,70,,0,70,70,1,-42119,53042,95161,10923,0,0,24856,0,0,,24856,24856
5,01/31/2017,79,19:30,19:45,70,34.86,0,34.86,34.86,-1,-35869,62696,98565,26827,0,-4085,2035,0,0,,6120,-2050
5,01/31/2017,80,19:45,20:00,,36.06,0,36.06,36.06,-1,-38145,61895,100040,23750,0,-2654,0,0,0,,2654,-2654
5,01/31/2017,81,20:00,20:15,92.22,35.88,0,92.22,34.22,2,-98252,39569,137821,-58683,0,-1547,9665,0,0,,11212,8118
5,01/31/2017,82,20:15,20:30,37.88,,0,37.88,37.88,1,-77557,34654,112211,-42903,0,0,10290,0,0,,10290,10290
5,01/31/2017,83,20:30,20:45,37.88,33.9,0,33.9,33.9,-1,-49976,49405,99381,-571,0,-1456,1392,0,0,,2848,-64
5,01/31/2017,84,20:45,21:00,,32.75,0,32.75,32.75,-1,-44080,65232,109312,21152,0,-18999,0,0,0,,18999,-18999
5,01/31/2017,85,21:00,21:15,84.36,35.81,0,84.36,34.08,2,-128271,33263,161534,-95008,0,-11215,9721,0,0,,20936,-1494
5,01/31/2017,86,21:15,21:30,34.76,35.81,0,34.76,34.76,1,-80912,48806,129718,-32106,0,-15,1363,0,0,,1378,1348
5,01/31/2017,87,21:30,21:45,,,0,34.08,34.08,0,-55184,57503,112687,2319,0,0,0,0,0,,0,0
5,01/31/2017,88,21:45,22:00,,31.11,0,31.11,31.11,-1,-39107,84785,123892,45678,0,-14612,0,0,0,,14612,-14612
5,01/31/2017,89,22:00,22:15,119.84,29.9,0,119.84,29.9,2,-104892,53675,158567,-51217,0,-21394,8487,0,0,,29881,-12907
5,01/31/2017,90,22:15,22:30,37.09,38.29,0,38.29,38.29,-1,-66441,73402,139843,6961,0,-59,7712,0,0,,7771,7653
5,01/31/2017,91,22:30,22:45,37.09,26.31,0,26.31,26.31,-1,-34035,91620,125655,57585,0,-26148,28,0,0,,26176,-26120
5,01/31/2017,92,22:45,23:00,,31.99,0,31.99,31.99,-1,-49912,94643,144555,44731,0,-35214,0,0,0,,35214,-35214
5,01/31/2017,93,23:00,23:15,35.15,33.13,0,35.15,35.15,1,-56478,82126,138604,25648,0,-17166,427,0,0,,17593,-16739
5,01/31/2017,94,23:15,23:30,35.15,34.5,0,35.15,33.45,2,-22012,45797,67809,23785,0,-1701,279,0,0,,1980,-1422
5,01/31/2017,95,23:30,23:45,,34.11,0,34.11,34.11,-1,-44571,67419,111990,22848,0,-4754,0,0,0,,4754,-4754
5,01/31/2017,96,23:45,0:00,,32.95,0,32.95,32.95,-1,-55757,88395,144152,32638,0,-4494,0,0,0,,4494,-4494
5,02-01-17,1,0:00,0:15,40.11,33.11,0,40.11,33.11,2,-94441,78260,172701,-16181,0,-6091,2386,0,0,,8477,-3705
5,02-01-17,2,0:15,0:30,31.67,36.51,0,36.51,36.51,-1,-51985,40992,92977,-10993,0,-324,1323,0,0,,1647,999
5,02-01-17,3,0:30,0:45,,27.49,0,27.49,27.49,-1,-25680,70889,96569,45209,0,-9897,0,0,0,,9897,-9897
5,02-01-17,4,0:45,1:00,,-17.4,0,-17.4,-17.4,-1,-30313,98452,128765,68139,0,-66818,0,0,0,,66818,-66818
5,02-01-17,5,1:00,1:15,,32.04,0,32.04,32.04,-1,-41062,59607,100669,18545,0,-29987,0,0,0,,29987,-29987
5,02-01-17,6,1:15,1:30,,33.11,0,33.11,33.11,-1,-30383,60512,90895,30129,0,-1761,0,0,0,,1761,-1761
5,02-01-17,7,1:30,1:45,,28.63,0,28.63,28.63,-1,-25328,82079,107407,56751,0,-32373,0,0,0,,32373,-32373
5,02-01-17,8,1:45,2:00,,16.08,0,16.08,16.08,-1,-21018,103359,124377,82341,0,-48648,0,0,0,,48648,-48648
5,02-01-17,9,2:00,2:15,,29.11,0,29.11,29.11,-1,-26091,64606,90697,38515,0,-43088,0,0,0,,43088,-43088
5,02-01-17,10,2:15,2:30,,29.11,0,29.11,29.11,-1,-20050,85031,105081,64981,0,-37615,0,0,0,,37615,-37615
5,02-01-17,11,2:30,2:45,,24.11,0,24.11,24.11,-1,-18880,79381,98261,60501,0,-61729,0,0,0,,61729,-61729
5,02-01-17,12,2:45,3:00,,29.11,0,29.11,29.11,-1,-22572,81177,103749,58605,0,-52955,0,0,0,,52955,-52955
5,02-01-17,13,3:00,3:15,,30.86,0,30.86,30.86,-1,-36037,47456,83493,11419,0,-31050,0,0,0,,31050,-31050
5,02-01-17,14,3:15,3:30,,,0,35.41,35.41,0,-40138,46622,86760,6484,0,-227,0,0,0,,227,-227
5,02-01-17,15,3:30,3:45,,,0,35.41,35.41,0,-50219,55733,105952,5514,0,0,0,0,0,,0,0
5,02-01-17,16,3:45,4:00,36.11,,0,36.11,36.11,1,-52185,51590,103775,-595,0,0,904,0,0,,904,904
5,02-01-17,17,4:00,4:15,36.11,36.51,0,36.51,36.51,-1,-52962,61699,114661,8737,0,-5586,13,0,0,,5599,-5573
5,02-01-17,18,4:15,4:30,,,0,35.47,35.47,0,-62674,63043,125717,369,0,-111,0,0,0,,111,-111
5,02-01-17,19,4:30,4:45,31.55,,0,31.55,31.55,1,-59072,56498,115570,-2574,0,0,21,0,0,,21,21
5,02-01-17,20,4:45,5:00,31.55,,0,31.55,31.55,1,-51122,58185,109307,7063,0,0,17,0,0,,17,17
5,02-01-17,21,5:00,5:15,,-6.31,0,-6.31,-6.31,-1,-42016,97692,139708,55676,0,-14215,0,0,0,,14215,-14215
5,02-01-17,22,5:15,5:30,,-14.77,0,-14.77,-14.77,-1,-33955,87055,121010,53100,0,-51710,0,0,0,,51710,-51710
5,02-01-17,23,5:30,5:45,,29.11,0,29.11,29.11,-1,-26294,83585,109879,57291,0,-45813,0,0,0,,45813,-45813
5,02-01-17,24,5:45,6:00,,29.11,0,29.11,29.11,-1,-31785,70724,102509,38939,0,-41127,0,0,0,,41127,-41127
5,02-01-17,25,6:00,6:15,,-46.64,0,-46.64,-46.64,-1,-49092,143188,192280,94096,0,-53196,0,0,0,,53196,-53196
5,02-01-17,26,6:15,6:30,,30.71,0,30.71,30.71,-1,-55757,110201,165958,54444,0,-51291,0,0,0,,51291,-51291
5,02-01-17,27,6:30,6:45,41.71,34.48,0,41.71,41.71,1,-65490,70326,135816,4836,0,-30298,267,0,0,,30565,-30031
5,02-01-17,28,6:45,7:00,56.27,34.48,0,56.27,56.27,1,-85911,76974,162885,-8937,0,-1249,14434,0,0,,15683,13185
5,02-01-17,29,7:00,7:15,56.27,-32.22,0,-32.22,-32.22,-1,-59414,175114,234528,115700,0,-27657,1349,0,0,,29006,-26308
5,02-01-17,30,7:15,7:30,,35.64,0,35.64,35.64,-1,-54571,98155,152726,43584,0,-11514,0,0,0,,11514,-11514
5,02-01-17,31,7:30,7:45,41.91,38.59,0,41.91,41.91,1,-72644,58411,131055,-14233,0,-2711,690,0,0,,3401,-2021
5,02-01-17,32,7:45,8:00,55.41,,0,55.41,55.41,1,-102847,54140,156987,-48707,0,0,15439,0,0,,15439,15439
5,02-01-17,33,8:00,8:15,37.36,18.13,0,18.13,18.13,-1,-22820,94605,117425,71785,0,-19718,5312,0,0,,25030,-14406
5,02-01-17,34,8:15,8:30,,17.14,0,17.14,17.14,-1,-34230,88163,122393,53933,0,-49242,0,0,0,,49242,-49242
5,02-01-17,35,8:30,8:45,,35.25,0,35.25,35.25,-1,-39203,61201,100404,21998,0,-27676,0,0,0,,27676,-27676
5,02-01-17,36,8:45,9:00,,35.71,0,35.71,35.71,-1,-46629,50023,96652,3394,0,-13342,0,0,0,,13342,-13342
5,02-01-17,37,9:00,9:15,,,0,48.42,48.42,0,-21719,69480,91199,47761,0,-2354,0,0,0,,2354,-2354
5,02-01-17,38,9:15,9:30,,39.22,0,39.22,39.22,-1,-22809,75168,97977,52359,0,-269,0,0,0,,269,-269
5,02-01-17,39,9:30,9:45,,35.15,0,35.15,35.15,-1,-25623,94991,120614,69368,0,-7113,0,0,0,,7113,-7113
5,02-01-17,40,9:45,10:00,,35.04,0,35.04,35.04,-1,-31553,93573,125126,62020,0,-17653,0,0,0,,17653,-17653
5,02-01-17,41,10:00,10:15,,32.17,0,32.17,32.17,-1,-34292,99788,134080,65496,0,-11813,0,0,0,,11813,-11813
5,02-01-17,42,10:15,10:30,,30.71,0,30.71,30.71,-1,-41249,106482,147731,65233,0,-35869,0,0,0,,35869,-35869
5,02-01-17,43,10:30,10:45,,30.86,0,30.86,30.86,-1,-52296,102297,154593,50001,0,-37768,0,0,0,,37768,-37768
5,02-01-17,44,10:45,11:00,,34.03,0,34.03,34.03,-1,-51423,107407,158830,55984,0,-33545,0,0,0,,33545,-33545
5,02-01-17,45,11:00,11:15,,34.71,0,34.71,34.71,-1,-32558,118464,151022,85906,0,-23809,0,0,0,,23809,-23809
5,02-01-17,46,11:15,11:30,,,0,48.15,48.15,0,-26690,118216,144906,91526,0,-1111,0,0,0,,1111,-1111
5,02-01-17,47,11:30,11:45,,32.17,0,32.17,32.17,-1,-29757,114945,144702,85188,0,-2878,0,0,0,,2878,-2878
5,02-01-17,48,11:45,12:00,,19.96,0,19.96,19.96,-1,-30431,100275,130706,69844,0,-45144,0,0,0,,45144,-45144
5,02-01-17,49,12:00,12:15,,37.73,0,37.73,37.73,-1,-63763,53224,116987,-10539,0,-12402,0,0,0,,12402,-12402
5,02-01-17,50,12:15,12:30,,35.15,0,35.15,35.15,-1,-48668,61253,109921,12585,0,-6492,0,0,0,,6492,-6492
5,02-01-17,51,12:30,12:45,,39.26,0,39.26,39.26,-1,-46033,70721,116754,24688,0,-2380,0,0,0,,2380,-2380
5,02-01-17,52,12:45,13:00,,37.63,0,37.63,37.63,-1,-42056,61143,103199,19087,0,-2286,0,0,0,,2286,-2286
5,02-01-17,53,13:00,13:15,,39.22,0,39.22,39.22,-1,-47190,49445,96635,2255,0,-1329,0,0,0,,1329,-1329
5,02-01-17,54,13:15,13:30,,43.05,0,43.05,43.05,-1,-52120,44268,96388,-7852,0,-291,0,0,0,,291,-291
5,02-01-17,55,13:30,13:45,39.31,,0,39.31,39.31,1,-55884,43334,99218,-12550,0,0,2283,0,0,,2283,2283
5,02-01-17,56,13:45,14:00,40.48,,0,40.48,40.48,1,-51669,35387,87056,-16282,0,0,4994,0,0,,4994,4994
5,02-01-17,57,14:00,14:15,,,0,37.33,37.33,0,-35964,25006,60970,-10958,0,0,10,0,0,,10,10
5,02-01-17,58,14:15,14:30,37.36,,0,37.36,37.36,1,-39716,39453,79169,-263,0,0,618,0,0,,618,618
5,02-01-17,59,14:30,14:45,,37.53,0,37.53,37.53,-1,-34877,44133,79010,9256,0,-541,0,0,0,,541,-541
5,02-01-17,60,14:45,15:00,,34.32,0,34.32,34.32,-1,-32630,60926,93556,28296,0,-22267,0,0,0,,22267,-22267
5,02-01-17,61,15:00,15:15,37.71,35.21,0,37.71,37.71,1,-45189,63221,108410,18032,0,-17037,349,0,0,,17386,-16688
5,02-01-17,62,15:15,15:30,37.71,36.13,0,37.71,36.13,2,-30888,63870,94758,32982,0,-2435,261,0,0,,2696,-2174
5,02-01-17,63,15:30,15:45,,35.15,0,35.15,35.15,-1,-37414,81298,118712,43884,0,-18176,0,0,0,,18176,-18176
5,02-01-17,64,15:45,16:00,,35.71,0,35.71,35.71,-1,-32828,89131,121959,56303,0,-19807,0,0,0,,19807,-19807
5,02-01-17,65,16:00,16:15,,35.15,0,35.15,35.15,-1,-41885,118091,159976,76206,0,-13424,0,0,0,,13424,-13424
5,02-01-17,66,16:15,16:30,,34.71,0,34.71,34.71,-1,-38337,117235,155572,78898,0,-22347,0,0,0,,22347,-22347
5,02-01-17,67,16:30,16:45,,30.71,0,30.71,30.71,-1,-33271,103709,136980,70438,0,-39959,0,0,0,,39959,-39959
5,02-01-17,68,16:45,17:00,,35.15,0,35.15,35.15,-1,-31866,84996,116862,53130,0,-33367,0,0,0,,33367,-33367
5,02-01-17,69,17:00,17:15,,-14.77,0,-14.77,-14.77,-1,-53453,134250,187703,80797,0,-52836,0,0,0,,52836,-52836
5,02-01-17,70,17:15,17:30,,34.03,0,34.03,34.03,-1,-57512,106149,163661,48637,0,-38186,0,0,0,,38186,-38186
5,02-01-17,71,17:30,17:45,,34.36,0,34.36,34.36,-1,-55305,92182,147487,36877,0,-33408,0,0,0,,33408,-33408
5,02-01-17,72,17:45,18:00,42.58,34.36,0,42.58,42.58,1,-58367,88208,146575,29841,0,-6597,12,0,0,,6609,-6585
5,02-01-17,73,18:00,18:15,37.71,35.15,0,35.15,35.15,-1,-59220,72748,131968,13528,0,-3862,6,0,0,,3868,-3856
5,02-01-17,74,18:15,18:30,,34.71,0,34.71,34.71,-1,-45885,83413,129298,37528,0,-18422,0,0,0,,18422,-18422
5,02-01-17,75,18:30,18:45,,34.71,0,34.71,34.71,-1,-42683,87071,129754,44388,0,-30394,0,0,0,,30394,-30394
5,02-01-17,76,18:45,19:00,,34.03,0,34.03,34.03,-1,-58182,100283,158465,42101,0,-30466,0,0,0,,30466,-30466
5,02-01-17,77,19:00,19:15,37.36,18.51,0,37.36,18.51,2,-64059,106913,170972,42854,0,-39834,20,0,0,,39854,-39814
5,02-01-17,78,19:15,19:30,42.02,18.51,0,42.02,42.02,1,-43972,59689,103661,15717,0,-2882,1612,0,0,,4494,-1270
5,02-01-17,79,19:30,19:45,,28.91,0,28.91,28.91,-1,-33730,100010,133740,66280,0,-24599,0,0,0,,24599,-24599
5,02-01-17,80,19:45,20:00,,30.71,0,30.71,30.71,-1,-38316,74080,112396,35764,0,-48172,0,0,0,,48172,-48172
5,02-01-17,81,20:00,20:15,39.31,30.71,0,39.31,30.71,2,-82813,117598,200411,34785,0,-29218,725,0,0,,29943,-28493
5,02-01-17,82,20:15,20:30,39.31,0.03,0,39.31,0.03,2,-44272,118251,162523,73979,0,-23650,1114,0,0,,24764,-22536
5,02-01-17,83,20:30,20:45,,3.95,0,3.95,3.95,-1,-33790,86905,120695,53115,0,-48457,0,0,0,,48457,-48457
5,02-01-17,84,20:45,21:00,,18.51,0,18.51,18.51,-1,-33719,119868,153587,86149,0,-55170,0,0,0,,55170,-55170
5,02-01-17,85,21:00,21:15,37.75,28.91,0,37.75,37.75,1,-51654,58119,109773,6465,0,-37666,533,0,0,,38199,-37133
5,02-01-17,86,21:15,21:30,37.75,30.71,0,30.71,30.71,-1,-41636,85583,127219,43947,0,-2940,487,0,0,,3427,-2453
5,02-01-17,87,21:30,21:45,,28.91,0,28.91,28.91,-1,-34602,125395,159997,90793,0,-9939,0,0,0,,9939,-9939
5,02-01-17,88,21:45,22:00,,30.71,0,30.71,30.71,-1,-61811,125591,187402,63780,0,-26621,0,0,0,,26621,-26621
5,02-01-17,89,22:00,22:15,37.65,26.46,0,37.65,37.65,1,-54640,85662,140302,31022,0,-26599,206,0,0,,26805,-26393
5,02-01-17,90,22:15,22:30,37.71,34.71,0,37.71,34.71,2,-47144,84338,131482,37194,0,-2861,960,0,0,,3821,-1901
5,02-01-17,91,22:30,22:45,,30.71,0,30.71,30.71,-1,-31736,102295,134031,70559,0,-14713,0,0,0,,14713,-14713
5,02-01-17,92,22:45,23:00,,20.34,0,20.34,20.34,-1,-45093,139900,184993,94807,0,-48605,0,0,0,,48605,-48605
5,02-01-17,93,23:00,23:15,,22.6,0,22.6,22.6,-1,-54644,104648,159292,50004,0,-41496,0,0,0,,41496,-41496
5,02-01-17,94,23:15,23:30,,25.99,0,25.99,25.99,-1,-51221,107245,158466,56024,0,-25534,0,0,0,,25534,-25534
5,02-01-17,95,23:30,23:45,,25.74,0,25.74,25.74,-1,-40138,121086,161224,80948,0,-43708,0,0,0,,43708,-43708
5,02-01-17,96,23:45,0:00,,11.03,0,11.03,11.03,-1,-38590,140009,178599,101419,0,-60884,0,0,0,,60884,-60884
5,02-02-17,1,0:00,0:15,41.25,24.46,0,41.25,41.25,1,-28934,59813,88747,30879,0,-32240,1546,0,0,,33786,-30694
5,02-02-17,2,0:15,0:30,41.25,,0,41.25,41.25,1,-55137,33655,88792,-21482,0,0,7769,0,0,,7769,7769
5,02-02-17,3,0:30,0:45,41.25,40.83,0,40.83,40.83,-1,-46384,55504,101888,9120,0,-187,359,0,0,,546,172
5,02-02-17,4,0:45,1:00,,28.48,0,28.48,28.48,-1,-47284,89273,136557,41989,0,-17447,0,0,0,,17447,-17447
5,02-02-17,5,1:00,1:15,39.79,30.14,0,39.79,39.79,1,-47983,31026,79009,-16957,0,-16646,981,0,0,,17627,-15665
5,02-02-17,6,1:15,1:30,40.7,30.14,0,40.7,40.7,1,-43036,37376,80412,-5660,0,-320,1861,0,0,,2181,1541
5,02-02-17,7,1:30,1:45,,37.6,0,37.6,37.6,-1,-35373,47078,82451,11705,0,-89,0,0,0,,89,-89
5,02-02-17,8,1:45,2:00,,26.57,0,26.57,26.57,-1,-28239,58119,86358,29880,0,-17568,0,0,0,,17568,-17568
5,02-02-17,9,2:00,2:15,,34.76,0,34.76,34.76,-1,-53491,54420,107911,929,0,-9690,0,0,0,,9690,-9690
5,02-02-17,10,2:15,2:30,,,0,34.74,34.74,0,-24007,37228,61235,13221,0,-11,0,0,0,,11,-11
5,02-02-17,11,2:30,2:45,,34.76,0,34.76,34.76,-1,-22414,51119,73533,28705,0,-2356,0,0,0,,2356,-2356
5,02-02-17,12,2:45,3:00,,28.52,0,28.52,28.52,-1,-17531,65693,83224,48162,0,-15691,0,0,0,,15691,-15691
5,02-02-17,13,3:00,3:15,,-13.78,0,-13.78,-13.78,-1,-17064,116232,133296,99168,0,-46237,0,0,0,,46237,-46237
5,02-02-17,14,3:15,3:30,,17.07,0,17.07,17.07,-1,-21755,108318,130073,86563,0,-49377,0,0,0,,49377,-49377
5,02-02-17,15,3:30,3:45,,-27.78,0,-27.78,-27.78,-1,-24461,103366,127827,78905,0,-70526,0,0,0,,70526,-70526
5,02-02-17,16,3:45,4:00,,18.06,0,18.06,18.06,-1,-18147,110154,128301,92007,0,-74294,0,0,0,,74294,-74294
5,02-02-17,17,4:00,4:15,,-23.78,0,-23.78,-23.78,-1,-15632,109489,125121,93857,0,-79831,0,0,0,,79831,-79831
5,02-02-17,18,4:15,4:30,,-52.78,0,-52.78,-52.78,-1,-29960,73689,103649,43729,0,-72167,0,0,0,,72167,-72167
5,02-02-17,19,4:30,4:45,,13.84,0,13.84,13.84,-1,-43349,100896,144245,57547,0,-32018,0,0,0,,32018,-32018
5,02-02-17,20,4:45,5:00,,13.08,0,13.08,13.08,-1,-40491,96213,136704,55722,0,-55972,0,0,0,,55972,-55972
5,02-02-17,21,5:00,5:15,,4.68,0,4.68,4.68,-1,-99394,136737,236131,37343,0,-24787,0,0,0,,24787,-24787
5,02-02-17,22,5:15,5:30,,-52.78,0,-52.78,-52.78,-1,-43744,119767,163511,76023,0,-68581,0,0,0,,68581,-68581
5,02-02-17,23,5:30,5:45,,30.76,0,30.76,30.76,-1,-49388,97718,147106,48330,0,-51074,0,0,0,,51074,-51074
5,02-02-17,24,5:45,6:00,,30.76,0,30.76,30.76,-1,-35643,93419,129062,57776,0,-47404,0,0,0,,47404,-47404
5,02-02-17,25,6:00,6:15,,19.9,0,19.9,19.9,-1,-67664,171826,239490,104162,0,-52023,0,0,0,,52023,-52023
5,02-02-17,26,6:15,6:30,,30.3,0,30.3,30.3,-1,-35214,114726,149940,79512,0,-48860,0,0,0,,48860,-48860
5,02-02-17,27,6:30,6:45,43.3,30.3,0,43.3,43.3,1,-46577,69251,115828,22674,0,-7539,1593,0,0,,9132,-5946
5,02-02-17,28,6:45,7:00,48.85,,0,48.85,48.85,1,-59274,66157,125431,6883,0,0,9511,0,0,,9511,9511
5,02-02-17,29,7:00,7:15,38.85,36.85,0,41.36,36.85,2,-87945,117194,205139,29249,0,-1101,1669,0,0,,2770,568
5,02-02-17,30,7:15,7:30,,40.39,0,40.39,40.39,-1,-41339,111642,152981,70303,0,-176,0,0,0,,176,-176
5,02-02-17,31,7:30,7:45,,35.85,0,35.85,35.85,-1,-58088,91201,149289,33113,0,-9069,0,0,0,,9069,-9069
5,02-02-17,32,7:45,8:00,50.58,35.85,0,50.58,50.58,1,-123293,69402,192695,-53891,0,-455,4372,0,0,,4827,3917
5,02-02-17,33,8:00,8:15,38.75,19.9,0,49.68,19.9,2,-15776,80823,96599,65047,0,-20322,1551,0,0,,21873,-18771
5,02-02-17,34,8:15,8:30,,33.78,0,33.78,33.78,-1,-39830,72968,112798,33138,0,-38875,0,0,0,,38875,-38875
5,02-02-17,35,8:30,8:45,,35.85,0,35.85,35.85,-1,-26882,56322,83204,29440,0,-29330,0,0,0,,29330,-29330
5,02-02-17,36,8:45,9:00,,35.85,0,35.85,35.85,-1,-29586,63309,92895,33723,0,-23705,0,0,0,,23705,-23705
5,02-02-17,37,9:00,9:15,,32.25,0,32.25,32.25,-1,-19697,95088,114785,75391,0,-29332,0,0,0,,29332,-29332
5,02-02-17,38,9:15,9:30,,31.85,0,31.85,31.85,-1,-18157,106806,124963,88649,0,-33727,0,0,0,,33727,-33727
5,02-02-17,39,9:30,9:45,,5.34,0,5.34,5.34,-1,-15114,106151,121265,91037,0,-57540,0,0,0,,57540,-57540
5,02-02-17,40,9:45,10:00,,26.4,0,26.4,26.4,-1,-24155,82798,106953,58643,0,-65094,0,0,0,,65094,-65094
5,02-02-17,41,10:00,10:15,38.75,38.39,0,38.75,38.75,1,-45397,60877,106274,15480,0,-17789,130,0,0,,17919,-17659
5,02-02-17,42,10:15,10:30,38.75,,0,38.75,38.75,1,-39915,74320,114235,34405,0,0,11,0,0,,11,11
5,02-02-17,43,10:30,10:45,,,0,49.72,49.72,0,-46238,72777,119015,26539,0,0,0,0,0,,0,0
5,02-02-17,44,10:45,11:00,,43.89,0,43.89,43.89,-1,-38610,77122,115732,38512,0,-45,0,0,0,,45,-45
5,02-02-17,45,11:00,11:15,,40.83,0,40.83,40.83,-1,-77762,76760,154522,-1002,0,-636,0,0,0,,636,-636
5,02-02-17,46,11:15,11:30,,41.78,0,41.78,41.78,-1,-51722,86425,138147,34703,0,-833,0,0,0,,833,-833
5,02-02-17,47,11:30,11:45,,40.5,0,40.5,40.5,-1,-35223,110491,145714,75268,0,-3051,0,0,0,,3051,-3051
5,02-02-17,48,11:45,12:00,,38.39,0,38.39,38.39,-1,-32050,112476,144526,80426,0,-8047,0,0,0,,8047,-8047
5,02-02-17,49,12:00,12:15,,39.83,0,39.83,39.83,-1,-57711,85986,143697,28275,0,-5294,0,0,0,,5294,-5294
5,02-02-17,50,12:15,12:30,,25.88,0,25.88,25.88,-1,-48664,96863,145527,48199,0,-19407,0,0,0,,19407,-19407
5,02-02-17,51,12:30,12:45,,24.01,0,24.01,24.01,-1,-51220,104840,156060,53620,0,-47375,0,0,0,,47375,-47375
5,02-02-17,52,12:45,13:00,,31.85,0,31.85,31.85,-1,-39188,98777,137965,59589,0,-41234,0,0,0,,41234,-41234
5,02-02-17,53,13:00,13:15,,23.59,0,23.59,23.59,-1,-31412,109408,140820,77996,0,-46092,0,0,0,,46092,-46092
5,02-02-17,54,13:15,13:30,,,0,41.28,41.28,0,-46237,100701,146938,54464,0,-4732,0,0,0,,4732,-4732
5,02-02-17,55,13:30,13:45,,,0,41.28,41.28,0,-42009,106178,148187,64169,0,0,0,0,0,,0,0
5,02-02-17,56,13:45,14:00,,36.85,0,36.85,36.85,-1,-39656,98808,138464,59152,0,-2009,0,0,0,,2009,-2009
5,02-02-17,57,14:00,14:15,,36.85,0,36.85,36.85,-1,-74900,79518,154418,4618,0,-4484,0,0,0,,4484,-4484
5,02-02-17,58,14:15,14:30,,,0,41.28,41.28,0,-54290,69811,124101,15521,0,0,0,0,0,,0,0
5,02-02-17,59,14:30,14:45,,,0,41.28,41.28,0,-45419,70106,115525,24687,0,0,0,0,0,,0,0
5,02-02-17,60,14:45,15:00,,39.34,0,39.34,39.34,-1,-40176,66577,106753,26401,0,-679,0,0,0,,679,-679
5,02-02-17,61,15:00,15:15,,39.34,0,39.34,39.34,-1,-41423,69892,111315,28469,0,-1335,0,0,0,,1335,-1335
5,02-02-17,62,15:15,15:30,,43.83,0,43.83,43.83,-1,-38567,76616,115183,38049,0,-62,0,0,0,,62,-62
5,02-02-17,63,15:30,15:45,,43.83,0,43.83,43.83,-1,-28097,68732,96829,40635,0,-201,0,0,0,,201,-201
5,02-02-17,64,15:45,16:00,,41.78,0,41.78,41.78,-1,-22506,82543,105049,60037,0,-409,0,0,0,,409,-409
5,02-02-17,65,16:00,16:15,,35.85,0,35.85,35.85,-1,-39382,98948,138330,59566,0,-5148,0,0,0,,5148,-5148
5,02-02-17,66,16:15,16:30,,35.85,0,35.85,35.85,-1,-36807,92368,129175,55561,0,-18092,0,0,0,,18092,-18092
5,02-02-17,67,16:30,16:45,,31.85,0,31.85,31.85,-1,-29481,81288,110769,51807,0,-23001,0,0,0,,23001,-23001
5,02-02-17,68,16:45,17:00,,18.63,0,18.63,18.63,-1,-19907,92928,112835,73021,0,-46790,0,0,0,,46790,-46790
5,02-02-17,69,17:00,17:15,,-42.78,0,-42.78,-42.78,-1,-53210,154206,207416,100996,0,-86735,0,0,0,,86735,-86735
5,02-02-17,70,17:15,17:30,,19.9,0,19.9,19.9,-1,-45760,110756,156516,64996,0,-47211,0,0,0,,47211,-47211
5,02-02-17,71,17:30,17:45,,5.34,0,5.34,5.34,-1,-33249,81187,114436,47938,0,-61011,0,0,0,,61011,-61011
5,02-02-17,72,17:45,18:00,115.59,5.34,0,115.59,115.59,1,-57533,42392,99925,-15141,0,-9428,7856,0,0,,17284,-1572
5,02-02-17,73,18:00,18:15,38.85,,0,38.85,38.85,1,-56454,62598,119052,6144,0,0,799,0,0,,799,799
5,02-02-17,74,18:15,18:30,,35.85,0,35.85,35.85,-1,-42267,89714,131981,47447,0,-9310,0,0,0,,9310,-9310
5,02-02-17,75,18:30,18:45,,31.85,0,31.85,31.85,-1,-38763,94536,133299,55773,0,-27937,0,0,0,,27937,-27937
5,02-02-17,76,18:45,19:00,,35.85,0,35.85,35.85,-1,-36352,92056,128408,55704,0,-23125,0,0,0,,23125,-23125
5,02-02-17,77,19:00,19:15,106.9,36.43,0,106.9,36.43,2,-40648,39056,79704,-1592,0,-6922,5347,0,0,,12269,-1575
5,02-02-17,78,19:15,19:30,40,36.43,0,40,40,1,-50760,44144,94904,-6616,0,-9,4320,0,0,,4329,4311
5,02-02-17,79,19:30,19:45,,,0,38.01,38.01,0,-56532,52503,109035,-4029,0,0,0,0,0,,0,0
5,02-02-17,80,19:45,20:00,43.3,,0,43.3,43.3,1,-139264,44848,184112,-94416,0,0,1471,0,0,,1471,1471
5,02-02-17,81,20:00,20:15,,,0,36.07,36.07,0,-52770,85241,138011,32471,0,0,216,0,0,,216,216
5,02-02-17,82,20:15,20:30,,40.89,0,40.89,40.89,-1,-56661,68365,125026,11704,0,-149,0,0,0,,149,-149
5,02-02-17,83,20:30,20:45,,36.33,0,36.33,36.33,-1,-54274,81835,136109,27561,0,-2200,0,0,0,,2200,-2200
5,02-02-17,84,20:45,21:00,,28.84,0,28.84,28.84,-1,-53783,63365,117148,9582,0,-9622,0,0,0,,9622,-9622
5,02-02-17,85,21:00,21:15,,13.5,0,13.5,13.5,-1,-74308,138195,212503,63887,0,-29213,0,0,0,,29213,-29213
5,02-02-17,86,21:15,21:30,38.91,40.77,0,38.91,35.01,2,-69826,64059,133885,-5767,0,-2724,720,0,0,,3444,-2004
5,02-02-17,87,21:30,21:45,,35.51,0,35.51,35.51,-1,-62199,77330,139529,15131,0,-4080,0,0,0,,4080,-4080
5,02-02-17,88,21:45,22:00,,38.86,0,38.86,38.86,-1,-64313,83898,148211,19585,0,-2776,0,0,0,,2776,-2776
5,02-02-17,89,22:00,22:15,38.67,38.86,0,38.67,38.67,1,-114904,32293,147197,-82611,0,-746,478,0,0,,1224,-268
5,02-02-17,90,22:15,22:30,36.7,,0,36.7,36.7,1,-86232,34023,120255,-52209,0,0,1065,0,0,,1065,1065
5,02-02-17,91,22:30,22:45,38.95,,0,38.95,38.95,1,-60762,44527,105289,-16235,0,0,542,0,0,,542,542
5,02-02-17,92,22:45,23:00,,36.54,0,36.54,36.54,-1,-59741,69076,128817,9335,0,-2510,0,0,0,,2510,-2510
5,02-02-17,93,23:00,23:15,47.19,36.54,0,47.19,35.51,2,-120989,65820,186809,-55169,0,-1837,8787,0,0,,10624,6950
5,02-02-17,94,23:15,23:30,39.14,,0,39.14,39.14,1,-112225,47965,160190,-64260,0,0,8017,0,0,,8017,8017
5,02-02-17,95,23:30,23:45,39.31,,0,39.31,39.31,1,-89105,40114,129219,-48991,0,0,1329,0,0,,1329,1329
5,02-02-17,96,23:45,0:00,30.4,,0,30.4,30.4,1,-79902,46738,126640,-33164,0,0,714,0,0,,714,714
5,02-03-17,1,0:00,0:15,,,0,36.17,36.17,0,-101299,73191,174490,-28108,0,0,0,0,0,,0,0
5,02-03-17,2,0:15,0:30,,,0,36.17,36.17,0,-78075,21728,99803,-56347,0,0,0,0,0,,0,0
5,02-03-17,3,0:30,0:45,,,0,36.2,36.2,0,-74006,24105,98111,-49901,0,0,0,0,0,,0,0
5,02-03-17,4,0:45,1:00,,,0,36.2,36.2,0,-88701,38856,127557,-49845,0,0,0,0,0,,0,0
5,02-03-17,5,1:00,1:15,133.73,,0,133.73,133.73,1,-114649,20898,135547,-93751,0,0,22911,0,0,,22911,22911
5,02-03-17,6,1:15,1:30,131.02,,0,131.02,131.02,1,-88811,39674,128485,-49137,0,0,54001,0,0,,54001,54001
5,02-03-17,7,1:30,1:45,41.16,,0,41.16,41.16,1,-75034,47498,122532,-27536,0,0,12422,0,0,,12422,12422
5,02-03-17,8,1:45,2:00,39.55,,0,39.55,39.55,1,-73828,55984,129812,-17844,0,0,10096,0,0,,10096,10096
5,02-03-17,9,2:00,2:15,39.55,38.06,0,38.06,38.06,-1,-58016,67958,125974,9942,0,-1378,216,0,0,,1594,-1162
5,02-03-17,10,2:15,2:30,,37.58,0,37.58,37.58,-1,-48302,71051,119353,22749,0,-1763,0,0,0,,1763,-1763
5,02-03-17,11,2:30,2:45,,39.84,0,39.84,39.84,-1,-32595,64246,96841,31651,0,-1808,0,0,0,,1808,-1808
5,02-03-17,12,2:45,3:00,,37.58,0,37.58,37.58,-1,-45285,46627,91912,1342,0,-1867,0,0,0,,1867,-1867
5,02-03-17,13,3:00,3:15,,34.86,0,34.86,34.86,-1,-28994,44296,73290,15302,0,-3095,0,0,0,,3095,-3095
5,02-03-17,14,3:15,3:30,,34.86,0,34.86,34.86,-1,-23690,46068,69758,22378,0,-2961,0,0,0,,2961,-2961
5,02-03-17,15,3:30,3:45,,34.86,0,34.86,34.86,-1,-31657,43785,75442,12128,0,-7484,0,0,0,,7484,-7484
5,02-03-17,16,3:45,4:00,,34.79,0,34.79,34.79,-1,-31752,45815,77567,14063,0,-11791,0,0,0,,11791,-11791
5,02-03-17,17,4:00,4:15,,26.66,0,26.66,26.66,-1,-23189,99415,122604,76226,0,-17589,0,0,0,,17589,-17589
5,02-03-17,18,4:15,4:30,,40.23,0,40.23,40.23,-1,-26646,88251,114897,61605,0,-6100,0,0,0,,6100,-6100
5,02-03-17,19,4:30,4:45,,,0,35.64,35.64,0,-24311,84419,108730,60108,0,-39,0,0,0,,39,-39
5,02-03-17,20,4:45,5:00,,,0,35.63,35.63,0,-16919,79905,96824,62986,0,0,0,0,0,,0,0
5,02-03-17,21,5:00,5:15,,,0,36.21,36.21,0,-62486,76586,139072,14100,0,0,0,0,0,,0,0
5,02-03-17,22,5:15,5:30,,34.79,0,34.79,34.79,-1,-24755,103891,128646,79136,0,-4176,0,0,0,,4176,-4176
5,02-03-17,23,5:30,5:45,,41.38,0,41.38,41.38,-1,-29719,79933,109652,50214,0,-1099,0,0,0,,1099,-1099
5,02-03-17,24,5:45,6:00,,,0,36.2,36.2,0,-39903,73493,113396,33590,0,0,0,0,0,,0,0
5,02-03-17,25,6:00,6:15,,13.96,0,13.96,13.96,-1,-86732,116363,203095,29631,0,-5025,0,0,0,,5025,-5025
5,02-03-17,26,6:15,6:30,,-46.78,0,-46.78,-46.78,-1,-39843,78014,117857,38171,0,-40125,0,0,0,,40125,-40125
5,02-03-17,27,6:30,6:45,,41.09,0,41.09,41.09,-1,-41207,50622,91829,9415,0,-3291,0,0,0,,3291,-3291
5,02-03-17,28,6:45,7:00,192.53,41.09,0,192.53,192.53,1,-98992,42272,141264,-56720,0,-128,19712,0,0,,19840,19584
5,02-03-17,29,7:00,7:15,192.53,15.74,0,192.53,15.74,2,-80188,104806,184994,24618,0,-1701,37525,0,0,,39226,35824
5,02-03-17,30,7:15,7:30,192.53,-20.45,0,-20.45,-20.45,-1,-18318,102914,121232,84596,0,-49292,369,0,0,,49661,-48923
5,02-03-17,31,7:30,7:45,45.04,39.01,0,45.04,45.04,1,-60232,52946,113178,-7286,0,-7729,357,0,0,,8086,-7372
5,02-03-17,32,7:45,8:00,150.23,,0,150.23,150.23,1,-121768,39538,161306,-82230,0,0,18422,0,0,,18422,18422
5,02-03-17,33,8:00,8:15,41.53,26.3,0,26.3,26.3,-1,-10440,84914,95354,74474,0,-15351,4484,0,0,,19835,-10867
5,02-03-17,34,8:15,8:30,,36.53,0,36.53,36.53,-1,-36530,36395,72925,-135,0,-14089,0,0,0,,14089,-14089
5,02-03-17,35,8:30,8:45,,,0,42.33,42.33,0,-53463,30114,83577,-23349,0,-40,0,0,0,,40,-40
5,02-03-17,36,8:45,9:00,,,0,42.33,42.33,0,-79897,20318,100215,-59579,0,0,0,0,0,,0,0
5,02-03-17,37,9:00,9:15,,,0,42.37,42.37,0,-47424,47277,94701,-147,0,0,0,0,0,,0,0
5,02-03-17,38,9:15,9:30,,41.22,0,41.22,41.22,-1,-48451,39628,88079,-8823,0,-830,0,0,0,,830,-830
5,02-03-17,39,9:30,9:45,,41.38,0,41.38,41.38,-1,-60484,39382,99866,-21102,0,-494,0,0,0,,494,-494
5,02-03-17,40,9:45,10:00,,45.36,0,45.36,45.36,-1,-85130,37153,122283,-47977,0,-82,0,0,0,,82,-82
5,02-03-17,41,10:00,10:15,,,0,42.36,42.36,0,-69820,48761,118581,-21059,0,0,0,0,0,,0,0
5,02-03-17,42,10:15,10:30,41.53,,0,41.53,41.53,1,-73478,52303,125781,-21175,0,0,1698,0,0,,1698,1698
5,02-03-17,43,10:30,10:45,43.09,,0,43.09,43.09,1,-89332,53494,142826,-35838,0,0,8609,0,0,,8609,8609
5,02-03-17,44,10:45,11:00,,,0,42.36,42.36,0,-98741,49817,148558,-48924,0,0,540,0,0,,540,540
5,02-03-17,45,11:00,11:15,,,0,42.35,42.35,0,-118582,62284,180866,-56298,0,0,0,0,0,,0,0
5,02-03-17,46,11:15,11:30,,,0,42.35,42.35,0,-103486,60541,164027,-42945,0,0,0,0,0,,0,0
5,02-03-17,47,11:30,11:45,,,0,42.35,42.35,0,-103110,85260,188370,-17850,0,0,0,0,0,,0,0
5,02-03-17,48,11:45,12:00,,,0,42.35,42.35,0,-93399,88656,182055,-4743,0,0,0,0,0,,0,0
5,02-03-17,49,12:00,12:15,,,0,38.96,38.96,0,-126502,62686,189188,-63816,0,0,0,0,0,,0,0
5,02-03-17,50,12:15,12:30,,,0,38.96,38.96,0,-95498,76777,172275,-18721,0,0,0,0,0,,0,0
5,02-03-17,51,12:30,12:45,,37.53,0,37.53,37.53,-1,-82505,106951,189456,24446,0,-4089,0,0,0,,4089,-4089
5,02-03-17,52,12:45,13:00,,34.7,0,34.7,34.7,-1,-75715,119242,194957,43527,0,-37308,0,0,0,,37308,-37308
5,02-03-17,53,13:00,13:15,,36.11,0,36.11,36.11,-1,-78222,112812,191034,34590,0,-30070,0,0,0,,30070,-30070
5,02-03-17,54,13:15,13:30,42.99,36.11,0,42.99,42.99,1,-86380,85619,171999,-761,0,-1456,193,0,0,,1649,-1263
5,02-03-17,55,13:30,13:45,40.74,,0,40.74,40.74,1,-92049,88751,180800,-3298,0,0,454,0,0,,454,454
5,02-03-17,56,13:45,14:00,41.69,,0,41.69,41.69,1,-91215,75135,166350,-16080,0,0,5330,0,0,,5330,5330
5,02-03-17,57,14:00,14:15,43.09,,0,43.09,43.09,1,-104727,89408,194135,-15319,0,0,5440,0,0,,5440,5440
5,02-03-17,58,14:15,14:30,43.09,,0,43.09,43.09,1,-113486,83674,197160,-29812,0,0,11632,0,0,,11632,11632
5,02-03-17,59,14:30,14:45,41.69,,0,41.69,41.69,1,-129799,79116,208915,-50683,0,0,11407,0,0,,11407,11407
5,02-03-17,60,14:45,15:00,39.53,,0,39.53,39.53,1,-156376,69137,225513,-87239,0,0,1345,0,0,,1345,1345
5,02-03-17,61,15:00,15:15,54.47,,0,54.47,54.47,1,-121802,59523,181325,-62279,0,0,12198,0,0,,12198,12198
5,02-03-17,62,15:15,15:30,40.74,,0,40.74,40.74,1,-127742,64504,192246,-63238,0,0,6435,0,0,,6435,6435
5,02-03-17,63,15:30,15:45,41.53,,0,41.53,41.53,1,-143435,61151,204586,-82284,0,0,1047,0,0,,1047,1047
5,02-03-17,64,15:45,16:00,41.53,,0,41.53,41.53,1,-136922,61619,198541,-75303,0,0,1547,0,0,,1547,1547
5,02-03-17,65,16:00,16:15,73.21,,0,73.21,73.21,1,-119821,53144,172965,-66677,0,0,13455,0,0,,13455,13455
5,02-03-17,66,16:15,16:30,73.21,,0,73.21,73.21,1,-98541,53671,152212,-44870,0,0,17498,0,0,,17498,17498
5,02-03-17,67,16:30,16:45,45.74,,0,45.74,45.74,1,-85856,58964,144820,-26892,0,0,5684,0,0,,5684,5684
5,02-03-17,68,16:45,17:00,39.53,,0,39.53,39.53,1,-77095,83428,160523,6333,0,0,1356,0,0,,1356,1356
5,02-03-17,69,17:00,17:15,,34.79,0,34.79,34.79,-1,-39978,81774,121752,41796,0,-11667,0,0,0,,11667,-11667
5,02-03-17,70,17:15,17:30,,41.29,0,41.29,41.29,-1,-38117,64580,102697,26463,0,-4175,0,0,0,,4175,-4175
5,02-03-17,71,17:30,17:45,,37.53,0,37.53,37.53,-1,-17378,58211,75589,40833,0,-4237,0,0,0,,4237,-4237
5,02-03-17,72,17:45,18:00,45.2,37.53,0,45.2,45.2,1,-53539,49397,102936,-4142,0,-430,7066,0,0,,7496,6636
5,02-03-17,73,18:00,18:15,149.07,,0,149.07,149.07,1,-85880,27286,113166,-58594,0,0,28940,0,0,,28940,28940
5,02-03-17,74,18:15,18:30,61.79,39.83,0,39.83,39.83,-1,-38593,48925,87518,10332,0,-271,26252,0,0,,26523,25981
5,02-03-17,75,18:30,18:45,61.79,34.4,0,34.4,34.4,-1,-24378,50392,74770,26014,0,-16093,851,0,0,,16944,-15242
5,02-03-17,76,18:45,19:00,,40.52,0,40.52,40.52,-1,-17211,93578,110789,76367,0,-8106,0,0,0,,8106,-8106
5,02-03-17,77,19:00,19:15,45.04,40.99,0,45.04,38.97,2,-83764,21429,105193,-62335,0,-2787,1389,0,0,,4176,-1398
5,02-03-17,78,19:15,19:30,,,0,38.97,38.97,0,-57832,27254,85086,-30578,0,0,0,0,0,,0,0
5,02-03-17,79,19:30,19:45,,38.64,0,38.64,38.64,-1,-50598,46145,96743,-4453,0,-704,0,0,0,,704,-704
5,02-03-17,80,19:45,20:00,,39.52,0,39.52,39.52,-1,-66034,46395,112429,-19639,0,-966,0,0,0,,966,-966
5,02-03-17,81,20:00,20:15,44.9,,0,44.9,44.9,1,-90500,13323,103823,-77177,0,0,1643,0,0,,1643,1643
5,02-03-17,82,20:15,20:30,39.53,,0,39.53,39.53,1,-64388,12711,77099,-51677,0,0,527,0,0,,527,527
5,02-03-17,83,20:30,20:45,41.11,,0,41.11,41.11,1,-59661,35846,95507,-23815,0,0,736,0,0,,736,736
5,02-03-17,84,20:45,21:00,55.9,,0,55.9,55.9,1,-171894,49509,221403,-122385,0,0,5604,0,0,,5604,5604
5,02-03-17,85,21:00,21:15,192.53,,0,192.53,192.53,1,-93923,36152,130075,-57771,0,0,22965,0,0,,22965,22965
5,02-03-17,86,21:15,21:30,192.53,38.51,0,192.53,37.63,2,-75000,48698,123698,-26302,0,-246,43186,0,0,,43432,42940
5,02-03-17,87,21:30,21:45,192.53,34.08,0,34.08,34.08,-1,-82107,46495,128602,-35612,0,-2265,854,0,0,,3119,-1411
5,02-03-17,88,21:45,22:00,,,0,37.63,37.63,0,-124841,53841,178682,-71000,0,0,0,0,0,,0,0
5,02-03-17,89,22:00,22:15,192.38,,0,192.38,192.38,1,-158969,24937,183906,-134032,0,0,8857,0,0,,8857,8857
5,02-03-17,90,22:15,22:30,192.38,,0,192.38,192.38,1,-159291,37473,196764,-121818,0,0,37284,0,0,,37284,37284
5,02-03-17,91,22:30,22:45,41.86,,0,41.86,41.86,1,-144146,43202,187348,-100944,0,0,6018,0,0,,6018,6018
5,02-03-17,92,22:45,23:00,44.09,,0,44.09,44.09,1,-153807,34635,188442,-119172,0,0,12167,0,0,,12167,12167
5,02-03-17,93,23:00,23:15,49.38,,0,49.38,49.38,1,-185163,42176,227339,-142987,0,0,24792,0,0,,24792,24792
5,02-03-17,94,23:15,23:30,49.38,,0,49.38,49.38,1,-181402,18798,200200,-162604,0,0,52598,0,0,,52598,52598
5,02-03-17,95,23:30,23:45,43.76,,0,43.76,43.76,1,-160105,28959,189064,-131146,0,0,42085,0,0,,42085,42085
5,02-03-17,96,23:45,0:00,31.12,,0,31.12,31.12,1,-155964,40862,196826,-115102,0,0,7706,0,0,,7706,7706
6,02-04-17,1,0:00,0:15,133.12,,0,133.12,133.12,1,-205968,60110,266078,-145858,0,0,21695,0,0,,21695,21695
6,02-04-17,2,0:15,0:30,125.76,,0,125.76,125.76,1,-170127,46034,216161,-124093,0,0,59498,0,0,,59498,59498
6,02-04-17,3,0:30,0:45,133.12,,0,133.12,133.12,1,-191094,35967,227061,-155127,0,0,15292,0,0,,15292,15292
6,02-04-17,4,0:45,1:00,133.12,,0,133.12,133.12,1,-208539,48451,256990,-160088,0,0,63445,0,0,,63445,63445
6,02-04-17,5,1:00,1:15,133.12,,0,133.12,133.12,1,-185336,58987,244323,-126349,0,0,57808,0,0,,57808,57808
6,02-04-17,6,1:15,1:30,133.12,,0,133.12,133.12,1,-203649,36583,240232,-167066,0,0,84561,0,0,,84561,84561
6,02-04-17,7,1:30,1:45,46.26,,0,46.26,46.26,1,-172168,85955,258123,-86213,0,0,49282,0,0,,49282,49282
6,02-04-17,8,1:45,2:00,39.82,,0,39.82,39.82,1,-143316,54722,198038,-88594,0,0,3496,0,0,,3496,3496
6,02-04-17,9,2:00,2:15,41.87,,0,41.87,41.87,1,-112073,50708,162781,-61365,0,0,1997,0,0,,1997,1997
6,02-04-17,10,2:15,2:30,45.82,,0,45.82,45.82,1,-90858,45622,136480,-45236,0,0,9108,0,0,,9108,9108
6,02-04-17,11,2:30,2:45,,,0,36.88,36.88,0,-69238,52156,121394,-17082,0,0,217,0,0,,217,217
6,02-04-17,12,2:45,3:00,,,0,36.88,36.88,0,-73089,60436,133525,-12653,0,0,0,0,0,,0,0
6,02-04-17,13,3:00,3:15,,,0,36.88,36.88,0,-93465,85671,179136,-7794,0,0,0,0,0,,0,0
6,02-04-17,14,3:15,3:30,,,0,36.88,36.88,0,-98143,73662,171805,-24481,0,0,0,0,0,,0,0
6,02-04-17,15,3:30,3:45,,,0,36.88,36.88,0,-100458,76539,176997,-23919,0,0,0,0,0,,0,0
6,02-04-17,16,3:45,4:00,,,0,36.88,36.88,0,-101491,93719,195210,-7772,0,0,0,0,0,,0,0
6,02-04-17,17,4:00,4:15,44.02,,0,44.02,44.02,1,-87352,50547,137899,-36805,0,0,2987,0,0,,2987,2987
6,02-04-17,18,4:15,4:30,47.61,,0,47.61,47.61,1,-105833,37707,143540,-68126,0,0,27008,0,0,,27008,27008
6,02-04-17,19,4:30,4:45,,,0,36.29,36.29,0,-106502,52384,158886,-54118,0,0,6230,0,0,,6230,6230
6,02-04-17,20,4:45,5:00,,,0,36.29,36.29,0,-111026,48395,159421,-62631,0,0,0,0,0,,0,0
6,02-04-17,21,5:00,5:15,,,0,35.65,35.65,0,-65011,42517,107528,-22494,0,0,0,0,0,,0,0
6,02-04-17,22,5:15,5:30,,,0,36.25,36.25,0,-67535,56946,124481,-10589,0,0,0,0,0,,0,0
6,02-04-17,23,5:30,5:45,41.77,,0,41.77,41.77,1,-81757,51619,133376,-30138,0,0,465,0,0,,465,465
6,02-04-17,24,5:45,6:00,105.41,,0,105.41,105.41,1,-104266,25546,129812,-78720,0,0,32444,0,0,,32444,32444
6,02-04-17,25,6:00,6:15,42.83,-14.78,0,42.83,-14.78,2,-56223,103559,159782,47336,0,-8137,16777,0,0,,24914,8640
6,02-04-17,26,6:15,6:30,,33.04,0,33.04,33.04,-1,-61991,66601,128592,4610,0,-6457,0,0,0,,6457,-6457
6,02-04-17,27,6:30,6:45,30.08,,0,30.08,30.08,1,-76633,52496,129129,-24137,0,0,61,0,0,,61,61
6,02-04-17,28,6:45,7:00,59.53,,0,59.53,59.53,1,-99860,46339,146199,-53521,0,0,15462,0,0,,15462,15462
6,02-04-17,29,7:00,7:15,43.66,,0,43.66,43.66,1,-106557,77316,183873,-29241,0,0,11641,0,0,,11641,11641
6,02-04-17,30,7:15,7:30,,,0,36.41,36.41,0,-105808,74958,180766,-30850,0,0,67,0,0,,67,67
6,02-04-17,31,7:30,7:45,,,0,36.41,36.41,0,-134745,61630,196375,-73115,0,0,0,0,0,,0,0
6,02-04-17,32,7:45,8:00,43.84,,0,43.84,43.84,1,-157890,63670,221560,-94220,0,0,8823,0,0,,8823,8823
6,02-04-17,33,8:00,8:15,,,0,36.37,36.37,0,-124731,86125,210856,-38606,0,0,1326,0,0,,1326,1326
6,02-04-17,34,8:15,8:30,,,0,36.37,36.37,0,-63597,58655,122252,-4942,0,0,0,0,0,,0,0
6,02-04-17,35,8:30,8:45,,,0,36.37,36.37,0,-60036,35534,95570,-24502,0,0,0,0,0,,0,0
6,02-04-17,36,8:45,9:00,48.99,,0,48.99,48.99,1,-113189,32102,145291,-81087,0,0,8401,0,0,,8401,8401
6,02-04-17,37,9:00,9:15,42.15,,0,42.15,42.15,1,-51034,49337,100371,-1697,0,0,8185,0,0,,8185,8185
6,02-04-17,38,9:15,9:30,55.58,,0,55.58,55.58,1,-69737,34992,104729,-34745,0,0,21249,0,0,,21249,21249
6,02-04-17,39,9:30,9:45,142.29,,0,142.29,142.29,1,-102804,37167,139971,-65637,0,0,48051,0,0,,48051,48051
6,02-04-17,40,9:45,10:00,142.29,,0,142.29,142.29,1,-121097,35353,156450,-85744,0,0,72927,0,0,,72927,72927
6,02-04-17,41,10:00,10:15,86.4,,0,86.4,86.4,1,-112797,70746,183543,-42051,0,0,60685,0,0,,60685,60685
6,02-04-17,42,10:15,10:30,147.77,,0,147.77,147.77,1,-135725,60225,195950,-75500,0,0,61049,0,0,,61049,61049
6,02-04-17,43,10:30,10:45,147.77,,0,147.77,147.77,1,-147695,59809,207504,-87886,0,0,79287,0,0,,79287,79287
6,02-04-17,44,10:45,11:00,57.97,,0,57.97,57.97,1,-148963,65713,214676,-83250,0,0,50762,0,0,,50762,50762
6,02-04-17,45,11:00,11:15,56,,0,56,56,1,-107185,77703,184888,-29482,0,0,26152,0,0,,26152,26152
6,02-04-17,46,11:15,11:30,106.9,,0,106.9,106.9,1,-104495,60060,164555,-44435,0,0,49877,0,0,,49877,49877
6,02-04-17,47,11:30,11:45,44.7,,0,44.7,44.7,1,-104697,80978,185675,-23719,0,0,24052,0,0,,24052,24052
6,02-04-17,48,11:45,12:00,143.25,,0,143.25,143.25,1,-118391,61858,180249,-56533,0,0,27711,0,0,,27711,27711
6,02-04-17,49,12:00,12:15,143.25,40.83,0,143.25,36.35,2,-134078,62244,196322,-71834,0,-21,58155,0,0,,58176,58134
6,02-04-17,50,12:15,12:30,143.25,14.15,0,14.15,14.15,-1,-65681,101350,167031,35669,0,-18334,4012,0,0,,22346,-14322
6,02-04-17,51,12:30,12:45,44.83,42.25,0,44.83,36.35,2,-80544,60799,141343,-19745,0,-3158,3291,0,0,,6449,133
6,02-04-17,52,12:45,13:00,42.1,,0,42.1,42.1,1,-85136,56391,141527,-28745,0,0,4823,0,0,,4823,4823
6,02-04-17,53,13:00,13:15,44.12,,0,44.12,44.12,1,-96323,66735,163058,-29588,0,0,7891,0,0,,7891,7891
6,02-04-17,54,13:15,13:30,45.79,,0,45.79,45.79,1,-102188,61019,163207,-41169,0,0,15389,0,0,,15389,15389
6,02-04-17,55,13:30,13:45,46.26,,0,46.26,46.26,1,-101871,58640,160511,-43231,0,0,14722,0,0,,14722,14722
6,02-04-17,56,13:45,14:00,55.12,,0,55.12,55.12,1,-104409,63705,168114,-40704,0,0,27068,0,0,,27068,27068
6,02-04-17,57,14:00,14:15,42.15,,0,42.15,42.15,1,-90221,72282,162503,-17939,0,0,5379,0,0,,5379,5379
6,02-04-17,58,14:15,14:30,45.99,,0,45.99,45.99,1,-85274,57629,142903,-27645,0,0,17898,0,0,,17898,17898
6,02-04-17,59,14:30,14:45,43.84,,0,43.84,43.84,1,-85910,51961,137871,-33949,0,0,23093,0,0,,23093,23093
6,02-04-17,60,14:45,15:00,42.83,,0,42.83,42.83,1,-78569,45940,124509,-32629,0,0,13603,0,0,,13603,13603
6,02-04-17,61,15:00,15:15,,,0,40.24,40.24,0,-59633,55407,115040,-4226,0,0,149,0,0,,149,149
6,02-04-17,62,15:15,15:30,,,0,40.24,40.24,0,-56407,58205,114612,1798,0,0,0,0,0,,0,0
6,02-04-17,63,15:30,15:45,,,0,40.24,40.24,0,-52680,52187,104867,-493,0,0,0,0,0,,0,0
6,02-04-17,64,15:45,16:00,,,0,40.24,40.24,0,-53242,56344,109586,3102,0,0,0,0,0,,0,0
6,02-04-17,65,16:00,16:15,134.68,,0,134.68,134.68,1,-138367,66521,204888,-71846,0,0,20337,0,0,,20337,20337
6,02-04-17,66,16:15,16:30,42.93,,0,42.93,42.93,1,-56093,72041,128134,15948,0,0,7454,0,0,,7454,7454
6,02-04-17,67,16:30,16:45,,37.84,0,37.84,37.84,-1,-60142,72491,132633,12349,0,-2546,0,0,0,,2546,-2546
6,02-04-17,68,16:45,17:00,,42.58,0,42.58,42.58,-1,-77247,76710,153957,-537,0,-258,0,0,0,,258,-258
6,02-04-17,69,17:00,17:15,,-37.78,0,-37.78,-37.78,-1,-67576,113712,181288,46136,0,-25657,0,0,0,,25657,-25657
6,02-04-17,70,17:15,17:30,,39.78,0,39.78,39.78,-1,-72280,38105,110385,-34175,0,-6564,0,0,0,,6564,-6564
6,02-04-17,71,17:30,17:45,62.37,,0,62.37,62.37,1,-77200,53539,130739,-23661,0,0,1790,0,0,,1790,1790
6,02-04-17,72,17:45,18:00,96.91,,0,96.91,96.91,1,-87254,64621,151875,-22633,0,0,23761,0,0,,23761,23761
6,02-04-17,73,18:00,18:15,46.18,,0,46.18,46.18,1,-83271,61083,144354,-22188,0,0,12612,0,0,,12612,12612
6,02-04-17,74,18:15,18:30,46.18,42.02,0,42.02,42.02,-1,-53137,72059,125196,18922,0,-1097,644,0,0,,1741,-453
6,02-04-17,75,18:30,18:45,,37.84,0,37.84,37.84,-1,-41427,83740,125167,42313,0,-4363,0,0,0,,4363,-4363
6,02-04-17,76,18:45,19:00,,28.99,0,28.99,28.99,-1,-33336,90309,123645,56973,0,-10316,0,0,0,,10316,-10316
6,02-04-17,77,19:00,19:15,,36.84,0,36.84,36.84,-1,-69008,44270,113278,-24738,0,-9052,0,0,0,,9052,-9052
6,02-04-17,78,19:15,19:30,,36.84,0,36.84,36.84,-1,-44169,52813,96982,8644,0,-4200,0,0,0,,4200,-4200
6,02-04-17,79,19:30,19:45,,36.84,0,36.84,36.84,-1,-43319,60189,103508,16870,0,-5195,0,0,0,,5195,-5195
6,02-04-17,80,19:45,20:00,,36.84,0,36.84,36.84,-1,-42562,59394,101956,16832,0,-11803,0,0,0,,11803,-11803
6,02-04-17,81,20:00,20:15,61.49,39.99,0,61.49,39.99,2,-101465,47575,149040,-53890,0,-6686,5899,0,0,,12585,-787
6,02-04-17,82,20:15,20:30,41.71,39.99,0,41.71,41.71,1,-76881,48821,125702,-28060,0,-22,3497,0,0,,3519,3475
6,02-04-17,83,20:30,20:45,,30.27,0,30.27,30.27,-1,-30503,74741,105244,44238,0,-5350,0,0,0,,5350,-5350
6,02-04-17,84,20:45,21:00,,22.41,0,22.41,22.41,-1,-27258,83352,110610,56094,0,-20426,0,0,0,,20426,-20426
6,02-04-17,85,21:00,21:15,43.66,-7.85,0,43.66,-7.85,2,-38633,66178,104811,27545,0,-37518,439,0,0,,37957,-37079
6,02-04-17,86,21:15,21:30,47.95,-7.85,0,47.95,47.95,1,-37120,47774,84894,10654,0,-609,2296,0,0,,2905,1687
6,02-04-17,87,21:30,21:45,,,0,36.47,36.47,0,-33279,87036,120315,53757,0,0,0,0,0,,0,0
6,02-04-17,88,21:45,22:00,,30.19,0,30.19,30.19,-1,-44429,103629,148058,59200,0,-744,0,0,0,,744,-744
6,02-04-17,89,22:00,22:15,,14.78,0,14.78,14.78,-1,-55660,54903,110563,-757,0,-12927,0,0,0,,12927,-12927
6,02-04-17,90,22:15,22:30,,32.84,0,32.84,32.84,-1,-43497,57561,101058,14064,0,-9008,0,0,0,,9008,-9008
6,02-04-17,91,22:30,22:45,,33.84,0,33.84,33.84,-1,-28121,62135,90256,34014,0,-9113,0,0,0,,9113,-9113
6,02-04-17,92,22:45,23:00,,7.78,0,7.78,7.78,-1,-24044,83877,107921,59833,0,-19208,0,0,0,,19208,-19208
6,02-04-17,93,23:00,23:15,35.84,7.78,0,35.84,35.84,1,-47700,33790,81490,-13910,0,-23945,109,0,0,,24054,-23836
6,02-04-17,94,23:15,23:30,38.19,7.78,0,38.19,38.19,1,-44957,29421,74378,-15536,0,-697,828,0,0,,1525,131
6,02-04-17,95,23:30,23:45,,32.84,0,32.84,32.84,-1,-32903,45859,78762,12956,0,-1311,0,0,0,,1311,-1311
6,02-04-17,96,23:45,0:00,,26.59,0,26.59,26.59,-1,-32990,66603,99593,33613,0,-25456,0,0,0,,25456,-25456
6,02-05-17,1,0:00,0:15,141.38,27.22,0,141.38,141.38,1,-89289,56726,146015,-32563,0,-24562,5924,0,0,,30486,-18638
6,02-05-17,2,0:15,0:30,163.66,27.22,0,163.66,163.66,1,-91413,46283,137696,-45130,0,-129,46649,0,0,,46778,46520
6,02-05-17,3,0:30,0:45,163.66,25.42,0,25.42,25.42,-1,-63655,58066,121721,-5589,0,-8089,4808,0,0,,12897,-3281
6,02-05-17,4,0:45,1:00,,39.5,0,39.5,39.5,-1,-82734,64218,146952,-18516,0,-311,0,0,0,,311,-311
6,02-05-17,5,1:00,1:15,,32.84,0,32.84,32.84,-1,-31597,62470,94067,30873,0,-5981,0,0,0,,5981,-5981
6,02-05-17,6,1:15,1:30,,32.84,0,32.84,32.84,-1,-26079,34276,60355,8197,0,-8448,0,0,0,,8448,-8448
6,02-05-17,7,1:30,1:45,,37.03,0,37.03,37.03,-1,-43262,44902,88164,1640,0,-7247,0,0,0,,7247,-7247
6,02-05-17,8,1:45,2:00,,33.84,0,33.84,33.84,-1,-59740,62628,122368,2888,0,-10367,0,0,0,,10367,-10367
6,02-05-17,9,2:00,2:15,,27.36,0,27.36,27.36,-1,-39065,79858,118923,40793,0,-14127,0,0,0,,14127,-14127
6,02-05-17,10,2:15,2:30,,,0,36.33,36.33,0,-52008,41840,93848,-10168,0,-1259,0,0,0,,1259,-1259
6,02-05-17,11,2:30,2:45,,34.89,0,34.89,34.89,-1,-38067,43141,81208,5074,0,-4633,0,0,0,,4633,-4633
6,02-05-17,12,2:45,3:00,,35.29,0,35.29,35.29,-1,-50574,51997,102571,1423,0,-7542,0,0,0,,7542,-7542
6,02-05-17,13,3:00,3:15,,42.52,0,42.52,42.52,-1,-41490,55187,96677,13697,0,-1014,0,0,0,,1014,-1014
6,02-05-17,14,3:15,3:30,,,0,36.33,36.33,0,-41509,38884,80393,-2625,0,0,0,0,0,,0,0
6,02-05-17,15,3:30,3:45,,35.29,0,35.29,35.29,-1,-38884,47244,86128,8360,0,-3336,0,0,0,,3336,-3336
6,02-05-17,16,3:45,4:00,,39.5,0,39.5,39.5,-1,-38527,50283,88810,11756,0,-1995,0,0,0,,1995,-1995
6,02-05-17,17,4:00,4:15,,42.25,0,42.25,42.25,-1,-44139,80215,124354,36076,0,-1843,0,0,0,,1843,-1843
6,02-05-17,18,4:15,4:30,,,0,36.33,36.33,0,-50925,71061,121986,20136,0,-118,0,0,0,,118,-118
6,02-05-17,19,4:30,4:45,,,0,36.33,36.33,0,-53215,58673,111888,5458,0,0,0,0,0,,0,0
6,02-05-17,20,4:45,5:00,,39.5,0,39.5,39.5,-1,-47305,54006,101311,6701,0,-1180,0,0,0,,1180,-1180
6,02-05-17,21,5:00,5:15,,,0,36.33,36.33,0,-45112,71398,116510,26286,0,-585,0,0,0,,585,-585
6,02-05-17,22,5:15,5:30,,,0,36.33,36.33,0,-36978,52478,89456,15500,0,0,0,0,0,,0,0
6,02-05-17,23,5:30,5:45,,33.84,0,33.84,33.84,-1,-32992,51144,84136,18152,0,-2785,0,0,0,,2785,-2785
6,02-05-17,24,5:45,6:00,,33.84,0,33.84,33.84,-1,-38801,47351,86152,8550,0,-4982,0,0,0,,4982,-4982
6,02-05-17,25,6:00,6:15,,33.71,0,33.71,33.71,-1,-30623,77482,108105,46859,0,-2674,0,0,0,,2674,-2674
6,02-05-17,26,6:15,6:30,,,0,43.5,43.5,0,-41257,72219,113476,30962,0,0,0,0,0,,0,0
6,02-05-17,27,6:30,6:45,,,0,43.5,43.5,0,-41379,65232,106611,23853,0,0,0,0,0,,0,0
6,02-05-17,28,6:45,7:00,,,0,43.5,43.5,0,-37576,73412,110988,35836,0,0,0,0,0,,0,0
6,02-05-17,29,7:00,7:15,,-8.03,0,-8.03,-8.03,-1,-4600,94686,99286,90086,0,-30165,0,0,0,,30165,-30165
6,02-05-17,30,7:15,7:30,,27.03,0,27.03,27.03,-1,-6932,78498,85430,71566,0,-55402,0,0,0,,55402,-55402
6,02-05-17,31,7:30,7:45,,27.03,0,27.03,27.03,-1,-19244,81209,100453,61965,0,-51875,0,0,0,,51875,-51875
6,02-05-17,32,7:45,8:00,39.71,27.03,0,39.71,39.71,1,-26962,75631,102593,48669,0,-15587,1,0,0,,15588,-15586
6,02-05-17,33,8:00,8:15,42.75,,0,42.75,42.75,1,-74286,40334,114620,-33952,0,0,570,0,0,,570,570
6,02-05-17,34,8:15,8:30,,33.71,0,33.71,33.71,-1,-36022,48659,84681,12637,0,-3202,0,0,0,,3202,-3202
6,02-05-17,35,8:30,8:45,,41.6,0,41.6,41.6,-1,-65422,34614,100036,-30808,0,-1472,0,0,0,,1472,-1472
6,02-05-17,36,8:45,9:00,,,0,35.72,35.72,0,-82000,43694,125694,-38306,0,0,0,0,0,,0,0
6,02-05-17,37,9:00,9:15,,29.38,0,29.38,29.38,-1,-34789,59789,94578,25000,0,-7946,0,0,0,,7946,-7946
6,02-05-17,38,9:15,9:30,42.34,39.03,0,42.34,42.34,1,-49702,39376,89078,-10326,0,-4458,1616,0,0,,6074,-2842
6,02-05-17,39,9:30,9:45,42.63,,0,42.63,42.63,1,-57309,46201,103510,-11108,0,0,12102,0,0,,12102,12102
6,02-05-17,40,9:45,10:00,47.32,,0,47.32,47.32,1,-67364,43266,110630,-24098,0,0,11926,0,0,,11926,11926
6,02-05-17,41,10:00,10:15,66.1,,0,66.1,66.1,1,-60056,49984,110040,-10072,0,0,26824,0,0,,26824,26824
6,02-05-17,42,10:15,10:30,66.1,38.87,0,38.87,38.87,-1,-26918,66103,93021,39185,0,-1199,3761,0,0,,4960,2562
6,02-05-17,43,10:30,10:45,,,0,40.14,40.14,0,-20411,78542,98953,58131,0,0,0,0,0,,0,0
6,02-05-17,44,10:45,11:00,,,0,40.14,40.14,0,-17157,83259,100416,66102,0,0,0,0,0,,0,0
6,02-05-17,45,11:00,11:15,,29.35,0,29.35,29.35,-1,-4679,133531,138210,128852,0,-7733,0,0,0,,7733,-7733
6,02-05-17,46,11:15,11:30,,29.21,0,29.21,29.21,-1,-5261,110418,115679,105157,0,-21262,0,0,0,,21262,-21262
6,02-05-17,47,11:30,11:45,,,0,40.14,40.14,0,-6908,91787,98695,84879,0,-2243,0,0,0,,2243,-2243
6,02-05-17,48,11:45,12:00,,,0,40.14,40.14,0,-17270,77839,95109,60569,0,0,0,0,0,,0,0
6,02-05-17,49,12:00,12:15,,,0,40.14,40.14,0,-26138,94089,120227,67951,0,0,0,0,0,,0,0
6,02-05-17,50,12:15,12:30,,41.9,0,41.9,41.9,-1,-26527,86323,112850,59796,0,-121,0,0,0,,121,-121
6,02-05-17,51,12:30,12:45,,41.9,0,41.9,41.9,-1,-24884,98109,122993,73225,0,-1013,0,0,0,,1013,-1013
6,02-05-17,52,12:45,13:00,,41.99,0,41.99,41.99,-1,-23123,100708,123831,77585,0,-581,0,0,0,,581,-581
6,02-05-17,53,13:00,13:15,,33.09,0,33.09,33.09,-1,-8210,125155,133365,116945,0,-6981,0,0,0,,6981,-6981
6,02-05-17,54,13:15,13:30,,33.09,0,33.09,33.09,-1,-9002,133405,142407,124403,0,-30511,0,0,0,,30511,-30511
6,02-05-17,55,13:30,13:45,,27.92,0,27.92,27.92,-1,-8551,154222,162773,145671,0,-28034,0,0,0,,28034,-28034
6,02-05-17,56,13:45,14:00,,17.59,0,17.59,17.59,-1,-8801,168599,177400,159798,0,-63643,0,0,0,,63643,-63643
6,02-05-17,57,14:00,14:15,,25.53,0,25.53,25.53,-1,-3638,175011,178649,171373,0,-66472,0,0,0,,66472,-66472
6,02-05-17,58,14:15,14:30,,28.98,0,28.98,28.98,-1,-4398,156729,161127,152331,0,-58115,0,0,0,,58115,-58115
6,02-05-17,59,14:30,14:45,,33.09,0,33.09,33.09,-1,-4706,139200,143906,134494,0,-41718,0,0,0,,41718,-41718
6,02-05-17,60,14:45,15:00,,33.09,0,33.09,33.09,-1,-3903,137604,141507,133701,0,-34030,0,0,0,,34030,-34030
6,02-05-17,61,15:00,15:15,,33.09,0,33.09,33.09,-1,-10103,134697,144800,124594,0,-28293,0,0,0,,28293,-28293
6,02-05-17,62,15:15,15:30,,33.09,0,33.09,33.09,-1,-8650,144985,153635,136335,0,-23389,0,0,0,,23389,-23389
6,02-05-17,63,15:30,15:45,,34.89,0,34.89,34.89,-1,-8469,139979,148448,131510,0,-27979,0,0,0,,27979,-27979
6,02-05-17,64,15:45,16:00,,33.09,0,33.09,33.09,-1,-8801,141771,150572,132970,0,-27636,0,0,0,,27636,-27636
6,02-05-17,65,16:00,16:15,,33.09,0,33.09,33.09,-1,-4530,119859,124389,115329,0,-30992,0,0,0,,30992,-30992
6,02-05-17,66,16:15,16:30,,41.99,0,41.99,41.99,-1,-2469,108647,111116,106178,0,-7120,0,0,0,,7120,-7120
6,02-05-17,67,16:30,16:45,,39.93,0,39.93,39.93,-1,-5983,98238,104221,92255,0,-2091,0,0,0,,2091,-2091
6,02-05-17,68,16:45,17:00,,27.41,0,27.41,27.41,-1,-23322,146574,169896,123252,0,-8436,0,0,0,,8436,-8436
6,02-05-17,69,17:00,17:15,,27.48,0,27.48,27.48,-1,-88871,153474,242345,64603,0,-6731,0,0,0,,6731,-6731
6,02-05-17,70,17:15,17:30,,19.74,0,19.74,19.74,-1,-23563,100561,124124,76998,0,-18328,0,0,0,,18328,-18328
6,02-05-17,71,17:30,17:45,144.02,19.74,0,144.02,144.02,1,-218077,82310,300387,-135767,0,-1538,21900,0,0,,23438,20362
6,02-05-17,72,17:45,18:00,192.81,,0,248.24,248.24,1,-279182,108244,387426,-170938,0,0,91396,0,14922,,106318,106318
6,02-05-17,73,18:00,18:15,193.8,41.37,0,41.37,41.37,-1,-275763,174628,450391,-101135,0,-233,63133,0,64644,,128010,127544
6,02-05-17,74,18:15,18:30,45.07,41.37,0,265.07,41.37,2,-266806,200400,467206,-66406,0,-196,3372,0,41771,,45339,44947
6,02-05-17,75,18:30,18:45,71.07,,0,71.07,71.07,1,-255456,195574,451030,-59882,0,0,11422,0,0,,11422,11422
6,02-05-17,76,18:45,19:00,89.8,,0,89.8,89.8,1,-252501,177054,429555,-75447,0,0,7051,0,0,,7051,7051
6,02-05-17,77,19:00,19:15,42.83,,0,42.83,42.83,1,-180654,120640,301294,-60014,0,0,12710,0,0,,12710,12710
6,02-05-17,78,19:15,19:30,,,0,47.78,47.78,0,-176253,129290,305543,-46963,0,0,1137,0,0,,1137,1137
6,02-05-17,79,19:30,19:45,,,0,47.78,47.78,0,-173142,127888,301030,-45254,0,0,0,0,0,,0,0
6,02-05-17,80,19:45,20:00,,,0,47.78,47.78,0,-173585,129761,303346,-43824,0,0,0,0,0,,0,0
6,02-05-17,81,20:00,20:15,,,0,47.76,47.76,0,-66478,83968,150446,17490,0,0,0,0,0,,0,0
6,02-05-17,82,20:15,20:30,,29.32,0,29.32,29.32,-1,-64288,97104,161392,32816,0,-5362,0,0,0,,5362,-5362
6,02-05-17,83,20:30,20:45,,19.76,0,19.76,19.76,-1,-60921,100251,161172,39330,0,-42542,0,0,0,,42542,-42542
6,02-05-17,84,20:45,21:00,,33.09,0,33.09,33.09,-1,-60435,118887,179322,58452,0,-17526,0,0,0,,17526,-17526
6,02-05-17,85,21:00,21:15,155.92,33.09,0,155.92,155.92,1,-144284,46721,191005,-97563,0,-8265,17325,0,0,,25590,9060
6,02-05-17,86,21:15,21:30,145.02,,0,145.02,145.02,1,-133771,66748,200519,-67023,0,0,40032,0,0,,40032,40032
6,02-05-17,87,21:30,21:45,45.02,41.9,0,41.9,41.9,-1,-127962,112753,240715,-15209,0,-8,25465,0,0,,25473,25457
6,02-05-17,88,21:45,22:00,45.02,33.09,0,33.09,33.09,-1,-123541,151243,274784,27702,0,-3221,1714,0,0,,4935,-1507
6,02-05-17,89,22:00,22:15,,31.03,0,31.03,31.03,-1,-75036,100320,175356,25284,0,-9079,0,0,0,,9079,-9079
6,02-05-17,90,22:15,22:30,,34.89,0,34.89,34.89,-1,-68776,97737,166513,28961,0,-15552,0,0,0,,15552,-15552
6,02-05-17,91,22:30,22:45,,35.29,0,35.29,35.29,-1,-65970,115146,181116,49176,0,-16978,0,0,0,,16978,-16978
6,02-05-17,92,22:45,23:00,,14.85,0,14.85,14.85,-1,-62467,135611,198078,73144,0,-30879,0,0,0,,30879,-30879
6,02-05-17,93,23:00,23:15,84.01,-9.03,0,84.01,-9.03,2,-113003,65861,178864,-47142,0,-37807,1919,0,0,,39726,-35888
6,02-05-17,94,23:15,23:30,88.21,33.09,0,33.09,33.09,-1,-41089,51363,92452,10274,0,-2920,2805,0,0,,5725,-115
6,02-05-17,95,23:30,23:45,,24.56,0,24.56,24.56,-1,-16415,84863,101278,68448,0,-24441,0,0,0,,24441,-24441
6,02-05-17,96,23:45,0:00,,16.61,0,16.61,16.61,-1,-15674,94359,110033,78685,0,-62497,0,0,0,,62497,-62497
6,02-06-17,1,0:00,0:15,50.99,19.65,0,50.99,50.99,1,-103515,72972,176487,-30543,0,-34769,1354,0,0,,36123,-33415
6,02-06-17,2,0:15,0:30,30.65,,0,30.65,30.65,1,-71217,66170,137387,-5047,0,0,814,0,0,,814,814
6,02-06-17,3,0:30,0:45,,,0,36.32,36.32,0,-50967,70942,121909,19975,0,0,0,0,0,,0,0
6,02-06-17,4,0:45,1:00,,18.79,0,18.79,18.79,-1,-43451,99232,142683,55781,0,-17001,0,0,0,,17001,-17001
6,02-06-17,5,1:00,1:15,,-6.78,0,-6.78,-6.78,-1,-43545,71484,115029,27939,0,-53534,0,0,0,,53534,-53534
6,02-06-17,6,1:15,1:30,44.69,41.6,0,44.69,36.37,2,-50149,27652,77801,-22497,0,-5989,1582,0,0,,7571,-4407
6,02-06-17,7,1:30,1:45,,40.7,0,40.7,40.7,-1,-25484,54763,80247,29279,0,-571,0,0,0,,571,-571
6,02-06-17,8,1:45,2:00,,22,0,22,22,-1,-25070,77777,102847,52707,0,-21338,0,0,0,,21338,-21338
6,02-06-17,9,2:00,2:15,,22,0,22,22,-1,-22984,54573,77557,31589,0,-24903,0,0,0,,24903,-24903
6,02-06-17,10,2:15,2:30,,,0,36.35,36.35,0,-22639,61473,84112,38834,0,-348,0,0,0,,348,-348
6,02-06-17,11,2:30,2:45,,41.9,0,41.9,41.9,-1,-15633,80155,95788,64522,0,-325,0,0,0,,325,-325
6,02-06-17,12,2:45,3:00,,18.79,0,18.79,18.79,-1,-16856,82342,99198,65486,0,-18087,0,0,0,,18087,-18087
6,02-06-17,13,3:00,3:15,,28.71,0,28.71,28.71,-1,-25163,71008,96171,45845,0,-19817,0,0,0,,19817,-19817
6,02-06-17,14,3:15,3:30,,26.2,0,26.2,26.2,-1,-18860,74714,93574,55854,0,-6042,0,0,0,,6042,-6042
6,02-06-17,15,3:30,3:45,,18.58,0,18.58,18.58,-1,-13021,88503,101524,75482,0,-53146,0,0,0,,53146,-53146
6,02-06-17,16,3:45,4:00,39.97,26.99,0,39.97,39.97,1,-19641,67594,87235,47953,0,-36278,11,0,0,,36289,-36267
6,02-06-17,17,4:00,4:15,44.32,26.99,0,44.32,44.32,1,-75773,46427,122200,-29346,0,-671,6773,0,0,,7444,6102
6,02-06-17,18,4:15,4:30,,,0,36.44,36.44,0,-30777,59506,90283,28729,0,0,85,0,0,,85,85
6,02-06-17,19,4:30,4:45,,41.6,0,41.6,41.6,-1,-36682,76418,113100,39736,0,-552,0,0,0,,552,-552
6,02-06-17,20,4:45,5:00,,41.65,0,41.65,41.65,-1,-32423,79189,111612,46766,0,-1545,0,0,0,,1545,-1545
6,02-06-17,21,5:00,5:15,,40.24,0,40.24,40.24,-1,-62853,93683,156536,30830,0,-2539,0,0,0,,2539,-2539
6,02-06-17,22,5:15,5:30,,41.99,0,41.99,41.99,-1,-26778,81070,107848,54292,0,-802,0,0,0,,802,-802
6,02-06-17,23,5:30,5:45,,41.65,0,41.65,41.65,-1,-34528,83838,118366,49310,0,-457,0,0,0,,457,-457
6,02-06-17,24,5:45,6:00,,36.77,0,36.77,36.77,-1,-40709,106755,147464,66046,0,-4545,0,0,0,,4545,-4545
6,02-06-17,25,6:00,6:15,,39.73,0,39.73,39.73,-1,-74705,88792,163497,14087,0,-1839,0,0,0,,1839,-1839
6,02-06-17,26,6:15,6:30,,39.73,0,39.73,39.73,-1,-50801,80844,131645,30043,0,-1468,0,0,0,,1468,-1468
6,02-06-17,27,6:30,6:45,,,0,41.9,41.9,0,-31628,66112,97740,34484,0,0,0,0,0,,0,0
6,02-06-17,28,6:45,7:00,,,0,41.9,41.9,0,-67825,78462,146287,10637,0,0,0,0,0,,0,0
6,02-06-17,29,7:00,7:15,,-7.61,0,-7.61,-7.61,-1,-31637,146808,178445,115171,0,-25277,0,0,0,,25277,-25277
6,02-06-17,30,7:15,7:30,,38.34,0,38.34,38.34,-1,-34784,43467,78251,8683,0,-5462,0,0,0,,5462,-5462
6,02-06-17,31,7:30,7:45,,,0,47.85,47.85,0,-75682,37198,112880,-38484,0,0,0,0,0,,0,0
6,02-06-17,32,7:45,8:00,80.95,,0,80.95,80.95,1,-154091,38856,192947,-115235,0,0,4224,0,0,,4224,4224
6,02-06-17,33,8:00,8:15,77.06,29.82,0,77.06,29.82,2,-11101,64919,76020,53818,0,-9568,5334,0,0,,14902,-4234
6,02-06-17,34,8:15,8:30,,38.88,0,38.88,38.88,-1,-47196,18820,66016,-28376,0,-2860,0,0,0,,2860,-2860
6,02-06-17,35,8:30,8:45,,,0,47.57,47.57,0,-62659,17264,79923,-45395,0,0,0,0,0,,0,0
6,02-06-17,36,8:45,9:00,99.29,,0,99.29,99.29,1,-92644,31688,124332,-60956,0,0,11747,0,0,,11747,11747
6,02-06-17,37,9:00,9:15,44.33,,0,44.33,44.33,1,-52782,44541,97323,-8241,0,0,3535,0,0,,3535,3535
6,02-06-17,38,9:15,9:30,79.01,,0,79.01,79.01,1,-55219,31477,86696,-23742,0,0,10626,0,0,,10626,10626
6,02-06-17,39,9:30,9:45,41.3,,0,41.3,41.3,1,-41095,37034,78129,-4061,0,0,5390,0,0,,5390,5390
6,02-06-17,40,9:45,10:00,42.5,,0,42.5,42.5,1,-41885,28429,70314,-13456,0,0,3116,0,0,,3116,3116
6,02-06-17,41,10:00,10:15,45.16,,0,45.16,45.16,1,-63332,29974,93306,-33358,0,0,1720,0,0,,1720,1720
6,02-06-17,42,10:15,10:30,,,0,47.62,47.62,0,-56373,31867,88240,-24506,0,0,0,0,0,,0,0
6,02-06-17,43,10:30,10:45,,,0,47.62,47.62,0,-63240,35858,99098,-27382,0,0,0,0,0,,0,0
6,02-06-17,44,10:45,11:00,,,0,47.62,47.62,0,-49010,39719,88729,-9291,0,0,0,0,0,,0,0
6,02-06-17,45,11:00,11:15,,40.06,0,40.06,40.06,-1,-47270,49595,96865,2325,0,-304,0,0,0,,304,-304
6,02-06-17,46,11:15,11:30,,38.78,0,38.78,38.78,-1,-48550,42079,90629,-6471,0,-4101,0,0,0,,4101,-4101
6,02-06-17,47,11:30,11:45,,40.06,0,40.06,40.06,-1,-36453,37464,73917,1011,0,-1460,0,0,0,,1460,-1460
6,02-06-17,48,11:45,12:00,,40.06,0,40.06,40.06,-1,-33300,51232,84532,17932,0,-5228,0,0,0,,5228,-5228
6,02-06-17,49,12:00,12:15,,,0,47.64,47.64,0,-56098,58046,114144,1948,0,-569,0,0,0,,569,-569
6,02-06-17,50,12:15,12:30,,37.24,0,37.24,37.24,-1,-49516,57548,107064,8032,0,-2686,0,0,0,,2686,-2686
6,02-06-17,51,12:30,12:45,,37.68,0,37.68,37.68,-1,-45019,51396,96415,6377,0,-15170,0,0,0,,15170,-15170
6,02-06-17,52,12:45,13:00,,37.68,0,37.68,37.68,-1,-39461,57910,97371,18449,0,-15010,0,0,0,,15010,-15010
6,02-06-17,53,13:00,13:15,40.28,38.17,0,40.28,40.28,1,-66625,39070,105695,-27555,0,-11016,47,0,0,,11063,-10969
6,02-06-17,54,13:15,13:30,41.37,38.17,0,41.37,41.37,1,-69406,29729,99135,-39677,0,-169,1450,0,0,,1619,1281
6,02-06-17,55,13:30,13:45,39.89,,0,39.89,39.89,1,-64368,22581,86949,-41787,0,0,526,0,0,,526,526
6,02-06-17,56,13:45,14:00,,,0,47.64,47.64,0,-55879,11271,67150,-44608,0,0,0,0,0,,0,0
6,02-06-17,57,14:00,14:15,52.93,,0,52.93,52.93,1,-54863,22948,77811,-31915,0,0,4915,0,0,,4915,4915
6,02-06-17,58,14:15,14:30,42.25,,0,42.25,42.25,1,-55892,12198,68090,-43694,0,0,4045,0,0,,4045,4045
6,02-06-17,59,14:30,14:45,,,0,47.8,47.8,0,-57591,13109,70700,-44482,0,0,30,0,0,,30,30
6,02-06-17,60,14:45,15:00,,,0,47.8,47.8,0,-58842,14138,72980,-44704,0,0,0,0,0,,0,0
6,02-06-17,61,15:00,15:15,,,0,47.83,47.83,0,-37706,19776,57482,-17930,0,0,0,0,0,,0,0
6,02-06-17,62,15:15,15:30,39.89,,0,39.89,39.89,1,-46184,15017,61201,-31167,0,0,121,0,0,,121,121
6,02-06-17,63,15:30,15:45,,,0,47.83,47.83,0,-47494,11750,59244,-35744,0,0,0,0,0,,0,0
6,02-06-17,64,15:45,16:00,39.89,,0,39.89,39.89,1,-58509,13743,72252,-44766,0,0,138,0,0,,138,138
6,02-06-17,65,16:00,16:15,44.08,,0,44.08,44.08,1,-68039,16402,84441,-51637,0,0,3164,0,0,,3164,3164
6,02-06-17,66,16:15,16:30,39.89,,0,39.89,39.89,1,-57010,20101,77111,-36909,0,0,558,0,0,,558,558
6,02-06-17,67,16:30,16:45,39.89,,0,39.89,39.89,1,-60124,37038,97162,-23086,0,0,326,0,0,,326,326
6,02-06-17,68,16:45,17:00,42.76,,0,42.76,42.76,1,-106218,51946,158164,-54272,0,0,415,0,0,,415,415
6,02-06-17,69,17:00,17:15,49.94,,0,49.94,49.94,1,-122799,46902,169701,-75897,0,0,2939,0,0,,2939,2939
6,02-06-17,70,17:15,17:30,179.96,,0,179.96,179.96,1,-127900,28819,156719,-99081,0,0,21395,0,0,,21395,21395
6,02-06-17,71,17:30,17:45,75.94,,0,75.94,75.94,1,-109516,51877,161393,-57639,0,0,32278,0,0,,32278,32278
6,02-06-17,72,17:45,18:00,179.96,,0,179.96,179.96,1,-132377,70332,202709,-62045,0,0,53982,0,0,,53982,53982
6,02-06-17,73,18:00,18:15,103.81,38.03,0,38.03,38.03,-1,-88418,53707,142125,-34711,0,-954,33124,0,0,,34078,32170
6,02-06-17,74,18:15,18:30,103.81,37.17,0,37.17,37.17,-1,-57711,78746,136457,21035,0,-1525,215,0,0,,1740,-1310
6,02-06-17,75,18:30,18:45,,38.17,0,38.17,38.17,-1,-42697,86097,128794,43400,0,-2422,0,0,0,,2422,-2422
6,02-06-17,76,18:45,19:00,,,0,47.63,47.63,0,-24515,97249,121764,72734,0,-108,0,0,0,,108,-108
6,02-06-17,77,19:00,19:15,193.17,,0,193.17,193.17,1,-111602,44105,155707,-67497,0,0,18594,0,0,,18594,18594
6,02-06-17,78,19:15,19:30,57.29,,0,57.29,57.29,1,-88513,71009,159522,-17504,0,0,17796,0,0,,17796,17796
6,02-06-17,79,19:30,19:45,57.29,55.27,0,55.27,55.27,-1,-84188,83633,167821,-555,0,-306,251,0,0,,557,-55
6,02-06-17,80,19:45,20:00,,37.57,0,37.57,37.57,-1,-72604,100986,173590,28382,0,-6002,0,0,0,,6002,-6002
6,02-06-17,81,20:00,20:15,,38.26,0,38.26,38.26,-1,-52448,66882,119330,14434,0,-5198,0,0,0,,5198,-5198
6,02-06-17,82,20:15,20:30,,6.48,0,6.48,6.48,-1,-25530,94740,120270,69210,0,-25220,0,0,0,,25220,-25220
6,02-06-17,83,20:30,20:45,,2.45,0,2.45,2.45,-1,-24754,62349,87103,37595,0,-55121,0,0,0,,55121,-55121
6,02-06-17,84,20:45,21:00,,8.12,0,8.12,8.12,-1,-37191,72788,109979,35597,0,-20226,0,0,0,,20226,-20226
6,02-06-17,85,21:00,21:15,41.41,-35.75,0,42.95,-35.75,2,-74143,104878,179021,30735,0,-54297,15,0,0,,54312,-54282
6,02-06-17,86,21:15,21:30,83.75,21.04,0,83.75,21.04,2,-35352,49018,84370,13666,0,-6335,7626,0,0,,13961,1291
6,02-06-17,87,21:30,21:45,,15.72,0,15.72,15.72,-1,-24337,69141,93478,44804,0,-49283,0,0,0,,49283,-49283
6,02-06-17,88,21:45,22:00,,-20.89,0,-20.89,-20.89,-1,-15893,91436,107329,75543,0,-54655,0,0,0,,54655,-54655
6,02-06-17,89,22:00,22:15,,-27.82,0,-27.82,-27.82,-1,-66441,66800,133241,359,0,-60377,0,0,0,,60377,-60377
6,02-06-17,90,22:15,22:30,40.22,28.27,0,40.22,28.27,2,-25696,23631,49327,-2065,0,-3278,204,0,0,,3482,-3074
6,02-06-17,91,22:30,22:45,,15.78,0,15.78,15.78,-1,-28237,58856,87093,30619,0,-36546,0,0,0,,36546,-36546
6,02-06-17,92,22:45,23:00,,33.22,0,33.22,33.22,-1,-37299,61950,99249,24651,0,-24174,0,0,0,,24174,-24174
6,02-06-17,93,23:00,23:15,,31.85,0,31.85,31.85,-1,-31245,61227,92472,29982,0,-20598,0,0,0,,20598,-20598
6,02-06-17,94,23:15,23:30,,26.99,0,26.99,26.99,-1,-14356,52697,67053,38341,0,-14162,0,0,0,,14162,-14162
6,02-06-17,95,23:30,23:45,,24.39,0,24.39,24.39,-1,-9856,43965,53821,34109,0,-35469,0,0,0,,35469,-35469
6,02-06-17,96,23:45,0:00,,31.85,0,31.85,31.85,-1,-37795,81796,119591,44001,0,-28099,0,0,0,,28099,-28099
6,02-07-17,1,0:00,0:15,,33.18,0,33.18,33.18,-1,-48137,48039,96176,-98,0,-22309,0,0,0,,22309,-22309
6,02-07-17,2,0:15,0:30,,38.18,0,38.18,38.18,-1,-24894,28385,53279,3491,0,-4906,0,0,0,,4906,-4906
6,02-07-17,3,0:30,0:45,,36.9,0,36.9,36.9,-1,-30476,53989,84465,23513,0,-21082,0,0,0,,21082,-21082
6,02-07-17,4,0:45,1:00,,30.71,0,30.71,30.71,-1,-34759,86933,121692,52174,0,-43797,0,0,0,,43797,-43797
6,02-07-17,5,1:00,1:15,44.18,37.18,0,44.18,44.18,1,-35331,21098,56429,-14233,0,-24421,1090,0,0,,25511,-23331
6,02-07-17,6,1:15,1:30,44.18,37.18,0,37.18,37.18,-1,-27884,37132,65016,9248,0,-2491,565,0,0,,3056,-1926
6,02-07-17,7,1:30,1:45,,37.18,0,37.18,37.18,-1,-29219,52279,81498,23060,0,-12863,0,0,0,,12863,-12863
6,02-07-17,8,1:45,2:00,,30.71,0,30.71,30.71,-1,-26453,70492,96945,44039,0,-36407,0,0,0,,36407,-36407
6,02-07-17,9,2:00,2:15,,33.18,0,33.18,33.18,-1,-19554,44745,64299,25191,0,-36903,0,0,0,,36903,-36903
6,02-07-17,10,2:15,2:30,,33.18,0,33.18,33.18,-1,-19457,49338,68795,29881,0,-14359,0,0,0,,14359,-14359
6,02-07-17,11,2:30,2:45,,31.38,0,31.38,31.38,-1,-21476,63044,84520,41568,0,-35495,0,0,0,,35495,-35495
6,02-07-17,12,2:45,3:00,,33.18,0,33.18,33.18,-1,-23532,65448,88980,41916,0,-41127,0,0,0,,41127,-41127
6,02-07-17,13,3:00,3:15,,33.71,0,33.71,33.71,-1,-13421,63510,76931,50089,0,-34057,0,0,0,,34057,-34057
6,02-07-17,14,3:15,3:30,,29.21,0,29.21,29.21,-1,-6860,70606,77466,63746,0,-23587,0,0,0,,23587,-23587
6,02-07-17,15,3:30,3:45,,27.71,0,27.71,27.71,-1,-10756,68887,79643,58131,0,-52190,0,0,0,,52190,-52190
6,02-07-17,16,3:45,4:00,,33.18,0,33.18,33.18,-1,-15686,78593,94279,62907,0,-60428,0,0,0,,60428,-60428
6,02-07-17,17,4:00,4:15,,30.71,0,30.71,30.71,-1,-16582,87000,103582,70418,0,-55166,0,0,0,,55166,-55166
6,02-07-17,18,4:15,4:30,,33.18,0,33.18,33.18,-1,-15585,90250,105835,74665,0,-38814,0,0,0,,38814,-38814
6,02-07-17,19,4:30,4:45,,27.71,0,27.71,27.71,-1,-17133,89174,106307,72041,0,-46525,0,0,0,,46525,-46525
6,02-07-17,20,4:45,5:00,,23.79,0,23.79,23.79,-1,-18598,104450,123048,85852,0,-65328,0,0,0,,65328,-65328
6,02-07-17,21,5:00,5:15,,2.98,0,2.98,2.98,-1,-31743,122668,154411,90925,0,-77046,0,0,0,,77046,-77046
6,02-07-17,22,5:15,5:30,,2.98,0,2.98,2.98,-1,-33873,110875,144748,77002,0,-90272,0,0,0,,90272,-90272
6,02-07-17,23,5:30,5:45,,33.18,0,33.18,33.18,-1,-41784,84690,126474,42906,0,-62075,0,0,0,,62075,-62075
6,02-07-17,24,5:45,6:00,,35.54,0,35.54,35.54,-1,-43317,83732,127049,40415,0,-34878,0,0,0,,34878,-34878
6,02-07-17,25,6:00,6:15,,-8.03,0,-8.03,-8.03,-1,-53942,161029,214971,107087,0,-58507,0,0,0,,58507,-58507
6,02-07-17,26,6:15,6:30,,-8.03,0,-8.03,-8.03,-1,-54278,104775,159053,50497,0,-84216,0,0,0,,84216,-84216
6,02-07-17,27,6:30,6:45,,30.71,0,30.71,30.71,-1,-52494,101389,153883,48895,0,-19625,0,0,0,,19625,-19625
6,02-07-17,28,6:45,7:00,,30.71,0,30.71,30.71,-1,-63708,88186,151894,24478,0,-24734,0,0,0,,24734,-24734
6,02-07-17,29,7:00,7:15,,25.03,0,25.03,25.03,-1,-83271,183451,266722,100180,0,-36976,0,0,0,,36976,-36976
6,02-07-17,30,7:15,7:30,42.21,39.67,0,47.73,39.67,2,-101793,133346,235139,31553,0,-13461,1031,0,0,,14492,-12430
6,02-07-17,31,7:30,7:45,41.43,,0,41.43,41.43,1,-92646,88430,181076,-4216,0,0,121,0,0,,121,121
6,02-07-17,32,7:45,8:00,59.9,,0,59.9,59.9,1,-137302,67700,205002,-69602,0,0,12355,0,0,,12355,12355
6,02-07-17,33,8:00,8:15,40.68,-14.99,0,-14.99,-14.99,-1,-59223,144178,203401,84955,0,-15175,4216,0,0,,19391,-10959
6,02-07-17,34,8:15,8:30,,-23.06,0,-23.06,-23.06,-1,-59627,119233,178860,59606,0,-68279,0,0,0,,68279,-68279
6,02-07-17,35,8:30,8:45,,17.55,0,17.55,17.55,-1,-47254,121663,168917,74409,0,-23782,0,0,0,,23782,-23782
6,02-07-17,36,8:45,9:00,,-2.88,0,-2.88,-2.88,-1,-31400,72496,103896,41096,0,-46889,0,0,0,,46889,-46889
6,02-07-17,37,9:00,9:15,,23.06,0,23.06,23.06,-1,-23642,124705,148347,101063,0,-30107,0,0,0,,30107,-30107
6,02-07-17,38,9:15,9:30,,21.83,0,21.83,21.83,-1,-25116,97640,122756,72524,0,-41684,0,0,0,,41684,-41684
6,02-07-17,39,9:30,9:45,,30.71,0,30.71,30.71,-1,-24822,111847,136669,87025,0,-31639,0,0,0,,31639,-31639
6,02-07-17,40,9:45,10:00,40.88,30.02,0,47.73,30.02,2,-23597,76717,100314,53120,0,-30916,7,0,0,,30923,-30909
6,02-07-17,41,10:00,10:15,45.54,37.43,0,47.73,37.43,2,-34043,87685,121728,53642,0,-2915,1781,0,0,,4696,-1134
6,02-07-17,42,10:15,10:30,,34.18,0,34.18,34.18,-1,-21545,83344,104889,61799,0,-8240,0,0,0,,8240,-8240
6,02-07-17,43,10:30,10:45,,36.98,0,36.98,36.98,-1,-30356,75718,106074,45362,0,-8770,0,0,0,,8770,-8770
6,02-07-17,44,10:45,11:00,,37.8,0,37.8,37.8,-1,-35427,61086,96513,25659,0,-5872,0,0,0,,5872,-5872
6,02-07-17,45,11:00,11:15,40.68,56.25,0,47.73,47.73,2,-68261,34819,103080,-33442,0,-1338,289,0,0,,1627,-1049
6,02-07-17,46,11:15,11:30,40.68,,0,40.68,40.68,1,-75203,33685,108888,-41518,0,0,490,0,0,,490,490
6,02-07-17,47,11:30,11:45,40.68,,0,40.68,40.68,1,-78777,33603,112380,-45174,0,0,227,0,0,,227,227
6,02-07-17,48,11:45,12:00,40.68,,0,40.68,40.68,1,-80763,31222,111985,-49541,0,0,944,0,0,,944,944
6,02-07-17,49,12:00,12:15,69.49,,0,69.49,69.49,1,-90578,23633,114211,-66945,0,0,7036,0,0,,7036,7036
6,02-07-17,50,12:15,12:30,,,0,47.73,47.73,0,-89858,27753,117611,-62105,0,0,556,0,0,,556,556
6,02-07-17,51,12:30,12:45,69.49,,0,69.49,69.49,1,-86713,38451,125164,-48262,0,0,5536,0,0,,5536,5536
6,02-07-17,52,12:45,13:00,40.68,,0,40.68,40.68,1,-83995,38249,122244,-45746,0,0,1326,0,0,,1326,1326
6,02-07-17,53,13:00,13:15,,,0,47.73,47.73,0,-71361,42143,113504,-29218,0,0,0,0,0,,0,0
6,02-07-17,54,13:15,13:30,,,0,47.73,47.73,0,-76159,30060,106219,-46099,0,0,0,0,0,,0,0
6,02-07-17,55,13:30,13:45,40.68,,0,40.68,40.68,1,-70663,19600,90263,-51063,0,0,153,0,0,,153,153
6,02-07-17,56,13:45,14:00,40.68,,0,40.68,40.68,1,-82381,17449,99830,-64932,0,0,535,0,0,,535,535
6,02-07-17,57,14:00,14:15,43.3,,0,43.3,43.3,1,-45831,40352,86183,-5479,0,0,3246,0,0,,3246,3246
6,02-07-17,58,14:15,14:30,43.71,,0,43.71,43.71,1,-48354,37806,86160,-10548,0,0,6340,0,0,,6340,6340
6,02-07-17,59,14:30,14:45,40.88,,0,40.88,40.88,1,-49313,47667,96980,-1646,0,0,1969,0,0,,1969,1969
6,02-07-17,60,14:45,15:00,40.68,,0,40.68,40.68,1,-58104,47201,105305,-10903,0,0,1273,0,0,,1273,1273
6,02-07-17,61,15:00,15:15,,,0,47.78,47.78,0,-46574,46026,92600,-548,0,0,276,0,0,,276,276
6,02-07-17,62,15:15,15:30,,,0,47.78,47.78,0,-53300,44406,97706,-8894,0,0,0,0,0,,0,0
6,02-07-17,63,15:30,15:45,,,0,47.78,47.78,0,-59154,43250,102404,-15904,0,0,0,0,0,,0,0
6,02-07-17,64,15:45,16:00,,,0,47.78,47.78,0,-63606,42117,105723,-21489,0,0,0,0,0,,0,0
6,02-07-17,65,16:00,16:15,100.4,,0,100.4,100.4,1,-73934,31269,105203,-42665,0,0,10249,0,0,,10249,10249
6,02-07-17,66,16:15,16:30,134.55,,0,134.55,134.55,1,-60194,37570,97764,-22624,0,0,40655,0,0,,40655,40655
6,02-07-17,67,16:30,16:45,,,0,47.73,47.73,0,-45818,41711,87529,-4107,0,0,7839,0,0,,7839,7839
6,02-07-17,68,16:45,17:00,40.68,,0,40.68,40.68,1,-53473,59971,113444,6498,0,0,61,0,0,,61,61
6,02-07-17,69,17:00,17:15,,30.02,0,30.02,30.02,-1,-17761,76395,94156,58634,0,-18257,0,0,0,,18257,-18257
6,02-07-17,70,17:15,17:30,,41.07,0,41.07,41.07,-1,-28541,51216,79757,22675,0,-9289,0,0,0,,9289,-9289
6,02-07-17,71,17:30,17:45,,38.03,0,38.03,38.03,-1,-40277,81565,121842,41288,0,-2396,0,0,0,,2396,-2396
6,02-07-17,72,17:45,18:00,43.71,,0,43.71,43.71,1,-66153,90839,156992,24686,0,0,179,0,0,,179,179
6,02-07-17,73,18:00,18:15,73.67,,0,73.67,73.67,1,-87267,61203,148470,-26064,0,0,4840,0,0,,4840,4840
6,02-07-17,74,18:15,18:30,,36.98,0,36.98,36.98,-1,-37415,84978,122393,47563,0,-5405,0,0,0,,5405,-5405
6,02-07-17,75,18:30,18:45,,32.98,0,32.98,32.98,-1,-37693,85073,122766,47380,0,-36480,0,0,0,,36480,-36480
6,02-07-17,76,18:45,19:00,,37.98,0,37.98,37.98,-1,-38888,87948,126836,49060,0,-22679,0,0,0,,22679,-22679
6,02-07-17,77,19:00,19:15,45.23,56.25,0,45.23,43.69,2,-92810,21788,114598,-71022,0,-4776,2313,0,0,,7089,-2463
6,02-07-17,78,19:15,19:30,36.02,,0,36.02,36.02,1,-60601,30079,90680,-30522,0,0,256,0,0,,256,256
6,02-07-17,79,19:30,19:45,36.02,,0,36.02,36.02,1,-55505,43092,98597,-12413,0,0,727,0,0,,727,727
6,02-07-17,80,19:45,20:00,36.02,35.23,0,35.23,35.23,-1,-46281,47875,94156,1594,0,-1386,131,0,0,,1517,-1255
6,02-07-17,81,20:00,20:15,43.71,32.98,0,44.17,32.98,2,-64688,67461,132149,2773,0,-4859,2343,0,0,,7202,-2516
6,02-07-17,82,20:15,20:30,52.44,39.3,0,52.44,39.3,2,-54237,44129,98366,-10108,0,-178,8638,0,0,,8816,8460
6,02-07-17,83,20:30,20:45,52.44,38.47,0,38.47,38.47,-1,-40120,44097,84217,3977,0,-971,156,0,0,,1127,-815
6,02-07-17,84,20:45,21:00,,38.47,0,38.47,38.47,-1,-72920,56467,129387,-16453,0,-330,0,0,0,,330,-330
6,02-07-17,85,21:00,21:15,56.45,38.87,0,56.45,38,2,-73872,73605,147477,-267,0,-822,7580,0,0,,8402,6758
6,02-07-17,86,21:15,21:30,43.98,,0,43.98,43.98,1,-72512,58013,130525,-14499,0,0,18926,0,0,,18926,18926
6,02-07-17,87,21:30,21:45,43.98,38.87,0,38.87,38.87,-1,-75978,57832,133810,-18146,0,-3630,6296,0,0,,9926,2666
6,02-07-17,88,21:45,22:00,,,0,38,38,0,-109851,65322,175173,-44529,0,-19,0,0,0,,19,-19
6,02-07-17,89,22:00,22:15,,,0,37.5,37.5,0,-114368,51985,166353,-62383,0,0,0,0,0,,0,0
6,02-07-17,90,22:15,22:30,,,0,38,38,0,-100116,51050,151166,-49066,0,0,0,0,0,,0,0
6,02-07-17,91,22:30,22:45,,38.47,0,38.47,38.47,-1,-48827,57144,105971,8317,0,-172,0,0,0,,172,-172
6,02-07-17,92,22:45,23:00,,32.23,0,32.23,32.23,-1,-38810,72376,111186,33566,0,-4264,0,0,0,,4264,-4264
6,02-07-17,93,23:00,23:15,,32.23,0,32.23,32.23,-1,-86982,126085,213067,39103,0,-10861,0,0,0,,10861,-10861
6,02-07-17,94,23:15,23:30,,36.59,0,36.59,36.59,-1,-50257,81826,132083,31569,0,-21020,0,0,0,,21020,-21020
6,02-07-17,95,23:30,23:45,,30.71,0,30.71,30.71,-1,-29261,71404,100665,42143,0,-20238,0,0,0,,20238,-20238
6,02-07-17,96,23:45,0:00,,15.07,0,15.07,15.07,-1,-32333,98431,130764,66098,0,-56499,0,0,0,,56499,-56499
6,02-08-17,1,0:00,0:15,40.16,28.69,0,40.16,28.69,2,-57504,86792,144296,29288,0,-35409,104,0,0,,35513,-35305
6,02-08-17,2,0:15,0:30,45.71,28.69,0,45.71,45.71,1,-56229,22833,79062,-33396,0,-600,14344,0,0,,14944,13744
6,02-08-17,3,0:30,0:45,,,0,35.6,35.6,0,-45403,19658,65061,-25745,0,0,1444,0,0,,1444,1444
6,02-08-17,4,0:45,1:00,,37,0,37,37,-1,-41742,38236,79978,-3506,0,-976,0,0,0,,976,-976
6,02-08-17,5,1:00,1:15,45.71,37,0,45.71,45.71,1,-68107,25138,93245,-42969,0,-364,9343,0,0,,9707,8979
6,02-08-17,6,1:15,1:30,40,,0,40,40,1,-51869,20314,72183,-31555,0,0,6042,0,0,,6042,6042
6,02-08-17,7,1:30,1:45,,,0,36.21,36.21,0,-37947,25139,63086,-12808,0,0,0,0,0,,0,0
6,02-08-17,8,1:45,2:00,,33.71,0,33.71,33.71,-1,-32789,35793,68582,3004,0,-3563,0,0,0,,3563,-3563
6,02-08-17,9,2:00,2:15,35.71,33.71,0,35.71,35.71,1,-66175,23283,89458,-42892,0,-318,745,0,0,,1063,427
6,02-08-17,10,2:15,2:30,30.12,,0,30.12,30.12,1,-62341,23064,85405,-39277,0,0,974,0,0,,974,974
6,02-08-17,11,2:30,2:45,39.71,,0,39.71,39.71,1,-54194,22646,76840,-31548,0,0,924,0,0,,924,924
6,02-08-17,12,2:45,3:00,,,0,36.16,36.16,0,-47874,23890,71764,-23984,0,0,0,0,0,,0,0
6,02-08-17,13,3:00,3:15,35.71,,0,35.71,35.71,1,-59314,31470,90784,-27844,0,0,699,0,0,,699,699
6,02-08-17,14,3:15,3:30,34.12,,0,34.12,34.12,1,-56744,25689,82433,-31055,0,0,1983,0,0,,1983,1983
6,02-08-17,15,3:30,3:45,40.16,,0,40.16,40.16,1,-62762,21106,83868,-41656,0,0,5947,0,0,,5947,5947
6,02-08-17,16,3:45,4:00,33.12,,0,33.12,33.12,1,-62394,20887,83281,-41507,0,0,2851,0,0,,2851,2851
6,02-08-17,17,4:00,4:15,40.2,,0,40.2,40.2,1,-64942,12650,77592,-52292,0,0,6276,0,0,,6276,6276
6,02-08-17,18,4:15,4:30,42.5,,0,42.5,42.5,1,-58328,15043,73371,-43285,0,0,10618,0,0,,10618,10618
6,02-08-17,19,4:30,4:45,40.2,,0,40.2,40.2,1,-57258,16350,73608,-40908,0,0,15665,0,0,,15665,15665
6,02-08-17,20,4:45,5:00,39.71,,0,39.71,39.71,1,-59252,37582,96834,-21670,0,0,9404,0,0,,9404,9404
6,02-08-17,21,5:00,5:15,39.71,39.3,0,39.3,39.3,-1,-67833,44497,112330,-23336,0,-77,165,0,0,,242,88
6,02-08-17,22,5:15,5:30,,33.5,0,33.5,33.5,-1,-29850,51377,81227,21527,0,-15338,0,0,0,,15338,-15338
6,02-08-17,23,5:30,5:45,40.16,38.78,0,40.16,40.16,1,-47449,21355,68804,-26094,0,-8792,262,0,0,,9054,-8530
6,02-08-17,24,5:45,6:00,41.04,,0,41.04,41.04,1,-60917,49127,110044,-11790,0,0,1652,0,0,,1652,1652
6,02-08-17,25,6:00,6:15,36.12,,0,36.12,36.12,1,-85916,27445,113361,-58471,0,0,723,0,0,,723,723
6,02-08-17,26,6:15,6:30,,,0,34.45,34.45,0,-78008,49877,127885,-28131,0,0,0,0,0,,0,0
6,02-08-17,27,6:30,6:45,56.07,,0,56.07,56.07,1,-105301,22684,127985,-82617,0,0,2229,0,0,,2229,2229
6,02-08-17,28,6:45,7:00,57.15,,0,57.15,57.15,1,-147781,52598,200379,-95183,0,0,22849,0,0,,22849,22849
6,02-08-17,29,7:00,7:15,57.15,-7.26,0,-7.26,-7.26,-1,-26785,98368,125153,71583,0,-20580,4860,0,0,,25440,-15720
6,02-08-17,30,7:15,7:30,40.2,55.8,0,47.87,47.87,2,-67381,24691,92072,-42690,0,-2970,1434,0,0,,4404,-1536
6,02-08-17,31,7:30,7:45,39.69,,0,39.69,39.69,1,-82887,26500,109387,-56387,0,0,1967,0,0,,1967,1967
6,02-08-17,32,7:45,8:00,42.27,,0,42.27,42.27,1,-125318,30467,155785,-94851,0,0,4318,0,0,,4318,4318
6,02-08-17,33,8:00,8:15,42.27,38.92,0,38.92,38.92,-1,-52943,55353,108296,2410,0,-1399,809,0,0,,2208,-590
6,02-08-17,34,8:15,8:30,,,0,47.94,47.94,0,-58648,34675,93323,-23973,0,0,0,0,0,,0,0
6,02-08-17,35,8:30,8:45,40.39,,0,40.39,40.39,1,-85850,20842,106692,-65008,0,0,100,0,0,,100,100
6,02-08-17,36,8:45,9:00,44.94,,0,44.94,44.94,1,-113897,16537,130434,-97360,0,0,5449,0,0,,5449,5449
6,02-08-17,37,9:00,9:15,182.12,,0,182.12,182.12,1,-132090,25365,157455,-106725,0,0,27154,0,0,,27154,27154
6,02-08-17,38,9:15,9:30,76.93,,0,76.93,76.93,1,-134706,32367,167073,-102339,0,0,15444,0,0,,15444,15444
6,02-08-17,39,9:30,9:45,182.12,,0,182.12,182.12,1,-147229,28598,175827,-118631,0,0,40534,0,0,,40534,40534
6,02-08-17,40,9:45,10:00,76.93,,0,76.93,76.93,1,-156437,26648,183085,-129789,0,0,33794,0,0,,33794,33794
6,02-08-17,41,10:00,10:15,62.51,,0,62.51,62.51,1,-93011,33343,126354,-59668,0,0,30952,0,0,,30952,30952
6,02-08-17,42,10:15,10:30,42.69,,0,42.69,42.69,1,-89367,22083,111450,-67284,0,0,15281,0,0,,15281,15281
6,02-08-17,43,10:30,10:45,41.85,,0,41.85,41.85,1,-92968,16685,109653,-76283,0,0,837,0,0,,837,837
6,02-08-17,44,10:45,11:00,42.69,,0,42.69,42.69,1,-109777,11473,121250,-98304,0,0,4831,0,0,,4831,4831
6,02-08-17,45,11:00,11:15,,,0,47.92,47.92,0,-95215,43487,138702,-51728,0,0,720,0,0,,720,720
6,02-08-17,46,11:15,11:30,,,0,47.92,47.92,0,-101347,41161,142508,-60186,0,0,0,0,0,,0,0
6,02-08-17,47,11:30,11:45,41.19,,0,41.19,41.19,1,-106414,28709,135123,-77705,0,0,1892,0,0,,1892,1892
6,02-08-17,48,11:45,12:00,83.99,,0,83.99,83.99,1,-103799,26971,130770,-76828,0,0,5565,0,0,,5565,5565
6,02-08-17,49,12:00,12:15,164.02,,0,164.02,164.02,1,-106356,19791,126147,-86565,0,0,34996,0,0,,34996,34996
6,02-08-17,50,12:15,12:30,164.02,,0,164.02,164.02,1,-91955,11247,103202,-80708,0,0,73110,0,0,,73110,73110
6,02-08-17,51,12:30,12:45,164.02,,0,164.02,164.02,1,-93691,15062,108753,-78629,0,0,41898,0,0,,41898,41898
6,02-08-17,52,12:45,13:00,164.02,,0,164.02,164.02,1,-91694,15539,107233,-76155,0,0,43126,0,0,,43126,43126
6,02-08-17,53,13:00,13:15,129.4,,0,129.4,129.4,1,-105483,7780,113263,-97703,0,0,18628,0,0,,18628,18628
6,02-08-17,54,13:15,13:30,129.4,,0,129.4,129.4,1,-118217,4399,122616,-113818,0,0,34648,0,0,,34648,34648
6,02-08-17,55,13:30,13:45,61.94,,0,61.94,61.94,1,-116936,4142,121078,-112794,0,0,30951,0,0,,30951,30951
6,02-08-17,56,13:45,14:00,119.12,,0,119.12,119.12,1,-130900,3556,134456,-127344,0,0,39226,0,0,,39226,39226
6,02-08-17,57,14:00,14:15,52.12,,0,52.12,52.12,1,-91711,6198,97909,-85513,0,0,22864,0,0,,22864,22864
6,02-08-17,58,14:15,14:30,45.69,,0,45.69,45.69,1,-88448,7503,95951,-80945,0,0,2361,0,0,,2361,2361
6,02-08-17,59,14:30,14:45,60.69,,0,60.69,60.69,1,-103700,7466,111166,-96234,0,0,10239,0,0,,10239,10239
6,02-08-17,60,14:45,15:00,60.69,,0,60.69,60.69,1,-108706,6495,115201,-102211,0,0,20481,0,0,,20481,20481
6,02-08-17,61,15:00,15:15,41.04,,0,41.04,41.04,1,-63164,18704,81868,-44460,0,0,9914,0,0,,9914,9914
6,02-08-17,62,15:15,15:30,41.04,,0,41.04,41.04,1,-56686,25403,82089,-31283,0,0,1388,0,0,,1388,1388
6,02-08-17,63,15:30,15:45,66,,0,66,66,1,-67540,24896,92436,-42644,0,0,18358,0,0,,18358,18358
6,02-08-17,64,15:45,16:00,55,,0,55,55,1,-61815,28697,90512,-33118,0,0,21936,0,0,,21936,21936
6,02-08-17,65,16:00,16:15,55,38.99,0,38.99,38.99,-1,-50549,60424,110973,9875,0,-527,2902,0,0,,3429,2375
6,02-08-17,66,16:15,16:30,,,0,47.94,47.94,0,-53595,64156,117751,10561,0,0,0,0,0,,0,0
6,02-08-17,67,16:30,16:45,,38.99,0,38.99,38.99,-1,-44689,66829,111518,22140,0,-922,0,0,0,,922,-922
6,02-08-17,68,16:45,17:00,,56.18,0,56.18,56.18,-1,-62730,76072,138802,13342,0,-26,0,0,0,,26,-26
6,02-08-17,69,17:00,17:15,,17.9,0,17.9,17.9,-1,-45040,122488,167528,77448,0,-20458,0,0,0,,20458,-20458
6,02-08-17,70,17:15,17:30,,36.35,0,36.35,36.35,-1,-53739,77961,131700,24222,0,-14200,0,0,0,,14200,-14200
6,02-08-17,71,17:30,17:45,,33.63,0,33.63,33.63,-1,-38278,91225,129503,52947,0,-19460,0,0,0,,19460,-19460
6,02-08-17,72,17:45,18:00,42.06,33.63,0,42.06,42.06,1,-55911,92234,148145,36323,0,-3272,21,0,0,,3293,-3251
6,02-08-17,73,18:00,18:15,42.06,39.06,0,39.06,39.06,-1,-66261,50562,116823,-15699,0,-571,28,0,0,,599,-543
6,02-08-17,74,18:15,18:30,40.16,39.06,0,47.94,39.06,2,-63011,66118,129129,3107,0,-1211,89,0,0,,1300,-1122
6,02-08-17,75,18:30,18:45,40.16,,0,40.16,40.16,1,-79378,73059,152437,-6319,0,0,1689,0,0,,1689,1689
6,02-08-17,76,18:45,19:00,119.12,,0,119.12,119.12,1,-144499,77063,221562,-67436,0,0,19081,0,0,,19081,19081
6,02-08-17,77,19:00,19:15,210.73,,0,210.73,210.73,1,-222652,35295,257947,-187357,0,0,64304,0,0,,64304,64304
6,02-08-17,78,19:15,19:30,210.73,,0,210.73,210.73,1,-179873,81671,261544,-98202,0,0,75539,0,0,,75539,75539
6,02-08-17,79,19:30,19:45,,,0,47.94,47.94,0,-186780,94242,281022,-92538,0,0,11752,0,0,,11752,11752
6,02-08-17,80,19:45,20:00,210.73,,0,210.73,210.73,1,-244755,94192,338947,-150563,0,0,17824,0,0,,17824,17824
6,02-08-17,81,20:00,20:15,151.77,33.03,0,151.77,33.03,2,-83381,102640,186021,19259,0,-998,36898,0,0,,37896,35900
6,02-08-17,82,20:15,20:30,151.77,9.7,0,9.7,9.7,-1,-39623,129421,169044,89798,0,-22450,1670,0,0,,24120,-20780
6,02-08-17,83,20:30,20:45,,8.34,0,8.34,8.34,-1,-35682,82123,117805,46441,0,-35085,0,0,0,,35085,-35085
6,02-08-17,84,20:45,21:00,,5.88,0,5.88,5.88,-1,-36661,106520,143181,69859,0,-25553,0,0,0,,25553,-25553
6,02-08-17,85,21:00,21:15,,12.76,0,12.76,12.76,-1,-54096,82689,136785,28593,0,-27777,0,0,0,,27777,-27777
6,02-08-17,86,21:15,21:30,,35.03,0,35.03,35.03,-1,-41485,81144,122629,39659,0,-1448,0,0,0,,1448,-1448
6,02-08-17,87,21:30,21:45,,30.19,0,30.19,30.19,-1,-36272,87309,123581,51037,0,-26091,0,0,0,,26091,-26091
6,02-08-17,88,21:45,22:00,,31.96,0,31.96,31.96,-1,-45486,87256,132742,41770,0,-46509,0,0,0,,46509,-46509
6,02-08-17,89,22:00,22:15,129.12,36.35,0,129.12,129.12,1,-138561,32688,171249,-105873,0,-20285,11138,0,0,,31423,-9147
6,02-08-17,90,22:15,22:30,135.12,30.03,0,30.03,30.03,-1,-47721,47052,94773,-669,0,-1698,15673,0,0,,17371,13975
6,02-08-17,91,22:30,22:45,,27.19,0,27.19,27.19,-1,-25025,72392,97417,47367,0,-18640,0,0,0,,18640,-18640
6,02-08-17,92,22:45,23:00,,32.63,0,32.63,32.63,-1,-41688,96811,138499,55123,0,-2560,0,0,0,,2560,-2560
6,02-08-17,93,23:00,23:15,,30.19,0,30.19,30.19,-1,-65385,82938,148323,17553,0,-5581,0,0,0,,5581,-5581
6,02-08-17,94,23:15,23:30,,40.78,0,40.78,40.78,-1,-40267,41362,81629,1095,0,-1948,0,0,0,,1948,-1948
6,02-08-17,95,23:30,23:45,,37.79,0,37.79,37.79,-1,-42227,48158,90385,5931,0,-865,0,0,0,,865,-865
6,02-08-17,96,23:45,0:00,,27.19,0,27.19,27.19,-1,-48256,86680,134936,38424,0,-14415,0,0,0,,14415,-14415
6,02-09-17,1,0:00,0:15,,20.76,0,20.76,20.76,-1,-41744,79107,120851,37363,0,-23473,0,0,0,,23473,-23473
6,02-09-17,2,0:15,0:30,,36.54,0,36.54,36.54,-1,-13331,52442,65773,39111,0,-7245,0,0,0,,7245,-7245
6,02-09-17,3,0:30,0:45,,35.02,0,35.02,35.02,-1,-24829,54834,79663,30005,0,-9044,0,0,0,,9044,-9044
6,02-09-17,4,0:45,1:00,,32.54,0,32.54,32.54,-1,-24264,68228,92492,43964,0,-16411,0,0,0,,16411,-16411
6,02-09-17,5,1:00,1:15,76.3,32.54,0,76.3,76.3,1,-45423,40008,85431,-5415,0,-14309,3260,0,0,,17569,-11049
6,02-09-17,6,1:15,1:30,96.02,32.54,0,96.02,96.02,1,-16905,45708,62613,28803,0,-251,9726,0,0,,9977,9475
6,02-09-17,7,1:30,1:45,,39.58,0,39.58,39.58,-1,-12535,59670,72205,47135,0,-890,0,0,0,,890,-890
6,02-09-17,8,1:45,2:00,,32.54,0,32.54,32.54,-1,-16692,66247,82939,49555,0,-5967,0,0,0,,5967,-5967
6,02-09-17,9,2:00,2:15,,31.99,0,31.99,31.99,-1,-33797,58878,92675,25081,0,-13262,0,0,0,,13262,-13262
6,02-09-17,10,2:15,2:30,,32.54,0,32.54,32.54,-1,-26159,60596,86755,34437,0,-14407,0,0,0,,14407,-14407
6,02-09-17,11,2:30,2:45,,32.54,0,32.54,32.54,-1,-25099,57012,82111,31913,0,-30256,0,0,0,,30256,-30256
6,02-09-17,12,2:45,3:00,,35.98,0,35.98,35.98,-1,-27936,53999,81935,26063,0,-26454,0,0,0,,26454,-26454
6,02-09-17,13,3:00,3:15,39.54,36.03,0,39.54,39.54,1,-42889,37106,79995,-5783,0,-17389,421,0,0,,17810,-16968
6,02-09-17,14,3:15,3:30,40.02,36.03,0,40.02,40.02,1,-25925,36706,62631,10781,0,-339,656,0,0,,995,317
6,02-09-17,15,3:30,3:45,,,0,38.69,38.69,0,-33701,37168,70869,3467,0,0,0,0,0,,0,0
6,02-09-17,16,3:45,4:00,,38.79,0,38.79,38.79,-1,-37403,37104,74507,-299,0,-287,0,0,0,,287,-287
6,02-09-17,17,4:00,4:15,,36.54,0,36.54,36.54,-1,-39844,48397,88241,8553,0,-8819,0,0,0,,8819,-8819
6,02-09-17,18,4:15,4:30,39.54,36.54,0,39.54,39.54,1,-48596,31125,79721,-17471,0,-777,1582,0,0,,2359,805
6,02-09-17,19,4:30,4:45,39.04,,0,39.04,39.04,1,-56030,35115,91145,-20915,0,0,374,0,0,,374,374
6,02-09-17,20,4:45,5:00,39.54,,0,39.54,39.54,1,-47284,30064,77348,-17220,0,0,1715,0,0,,1715,1715
6,02-09-17,21,5:00,5:15,,,0,35.03,35.03,0,-64399,52006,116405,-12393,0,0,63,0,0,,63,63
6,02-09-17,22,5:15,5:30,43.54,,0,43.54,43.54,1,-61627,38554,100181,-23073,0,0,2677,0,0,,2677,2677
6,02-09-17,23,5:30,5:45,49.54,,0,49.54,49.54,1,-60436,18981,79417,-41455,0,0,23437,0,0,,23437,23437
6,02-09-17,24,5:45,6:00,59.49,,0,59.49,59.49,1,-76432,23732,100164,-52700,0,0,44987,0,0,,44987,44987
6,02-09-17,25,6:00,6:15,40.28,1.37,0,1.37,1.37,-1,-38123,112603,150726,74480,0,-19669,18721,0,0,,38390,-948
6,02-09-17,26,6:15,6:30,,32.97,0,32.97,32.97,-1,-36551,47296,83847,10745,0,-25092,0,0,0,,25092,-25092
6,02-09-17,27,6:30,6:45,,,0,34.98,34.98,0,-62172,41124,103296,-21048,0,-1164,0,0,0,,1164,-1164
6,02-09-17,28,6:45,7:00,40.28,,0,40.28,40.28,1,-116973,51096,168069,-65877,0,0,981,0,0,,981,981
6,02-09-17,29,7:00,7:15,,-5.9,0,-5.9,-5.9,-1,-126161,136339,262500,10178,0,-19166,0,0,0,,19166,-19166
6,02-09-17,30,7:15,7:30,68.09,54.82,0,68.09,68.09,1,-130502,49892,180394,-80610,0,-384,2512,0,0,,2896,2128
6,02-09-17,31,7:30,7:45,82.02,,0,82.02,82.02,1,-114264,13956,128220,-100308,0,0,8612,0,0,,8612,8612
6,02-09-17,32,7:45,8:00,250,,0,250,250,1,-176614,18460,195074,-158154,0,0,34129,0,0,,34129,34129
6,02-09-17,33,8:00,8:15,66.44,,0,66.44,66.44,1,-66585,56444,123029,-10141,0,0,23166,0,0,,23166,23166
6,02-09-17,34,8:15,8:30,,,0,46.33,46.33,0,-80685,22324,103009,-58361,0,0,201,0,0,,201,201
6,02-09-17,35,8:30,8:45,250,,0,250,250,1,-101591,11434,113025,-90157,0,0,14742,0,0,,14742,14742
6,02-09-17,36,8:45,9:00,250,,0,250,250,1,-108324,12815,121139,-95509,0,0,66729,0,0,,66729,66729
6,02-09-17,37,9:00,9:15,43.02,36.48,0,46.32,36.48,2,-36466,90794,127260,54328,0,-1566,27407,0,0,,28973,25841
6,02-09-17,38,9:15,9:30,,,0,46.32,46.32,0,-48001,66172,114173,18171,0,-136,0,0,0,,136,-136
6,02-09-17,39,9:30,9:45,,,0,46.32,46.32,0,-47058,61925,108983,14867,0,0,0,0,0,,0,0
6,02-09-17,40,9:45,10:00,40.77,,0,40.77,40.77,1,-57058,54685,111743,-2373,0,0,2381,0,0,,2381,2381
6,02-09-17,41,10:00,10:15,65.97,,0,65.97,65.97,1,-57717,34364,92081,-23353,0,0,4990,0,0,,4990,4990
6,02-09-17,42,10:15,10:30,65.97,,0,65.97,65.97,1,-60940,21711,82651,-39229,0,0,21564,0,0,,21564,21564
6,02-09-17,43,10:30,10:45,65.97,,0,65.97,65.97,1,-64511,20674,85185,-43837,0,0,30278,0,0,,30278,30278
6,02-09-17,44,10:45,11:00,60.02,,0,60.02,60.02,1,-65067,18783,83850,-46284,0,0,28327,0,0,,28327,28327
6,02-09-17,45,11:00,11:15,48.97,,0,48.97,48.97,1,-132913,26021,158934,-106892,0,0,14596,0,0,,14596,14596
6,02-09-17,46,11:15,11:30,169.37,,0,169.37,169.37,1,-129961,22435,152396,-107526,0,0,27979,0,0,,27979,27979
6,02-09-17,47,11:30,11:45,74.97,,0,74.97,74.97,1,-113616,18429,132045,-95187,0,0,34507,0,0,,34507,34507
6,02-09-17,48,11:45,12:00,59.92,,0,59.92,59.92,1,-128687,19181,147868,-109506,0,0,24768,0,0,,24768,24768
6,02-09-17,49,12:00,12:15,159.87,,0,159.87,159.87,1,-170660,10954,181614,-159706,0,0,51242,0,0,,51242,51242
6,02-09-17,50,12:15,12:30,159.87,,0,159.87,159.87,1,-145988,11620,157608,-134368,0,0,73097,0,0,,73097,73097
6,02-09-17,51,12:30,12:45,159.87,,0,159.87,159.87,1,-127344,8949,136293,-118395,0,0,58804,0,0,,58804,58804
6,02-09-17,52,12:45,13:00,159.87,,0,159.87,159.87,1,-128099,8403,136502,-119696,0,0,74203,0,0,,74203,74203
6,02-09-17,53,13:00,13:15,155.86,,0,155.86,155.86,1,-139367,14898,154265,-124469,0,0,44679,0,0,,44679,44679
6,02-09-17,54,13:15,13:30,155.86,,0,155.86,155.86,1,-158647,14858,173505,-143789,0,0,62379,0,0,,62379,62379
6,02-09-17,55,13:30,13:45,155.86,,0,155.86,155.86,1,-143352,16091,159443,-127261,0,0,67233,0,0,,67233,67233
6,02-09-17,56,13:45,14:00,123.02,,0,123.02,123.02,1,-141770,15124,156894,-126646,0,0,65763,0,0,,65763,65763
6,02-09-17,57,14:00,14:15,154.26,,0,154.26,154.26,1,-104558,20184,124742,-84374,0,0,72343,0,0,,72343,72343
6,02-09-17,58,14:15,14:30,109.63,,0,109.63,109.63,1,-94030,21895,115925,-72135,0,0,67579,0,0,,67579,67579
6,02-09-17,59,14:30,14:45,81.81,,0,81.81,81.81,1,-98314,29401,127715,-68913,0,0,58243,0,0,,58243,58243
6,02-09-17,60,14:45,15:00,67.7,,0,67.7,67.7,1,-98231,27472,125703,-70759,0,0,37060,0,0,,37060,37060
6,02-09-17,61,15:00,15:15,60.62,,0,60.62,60.62,1,-60131,36134,96265,-23997,0,0,13744,0,0,,13744,13744
6,02-09-17,62,15:15,15:30,60.62,,0,60.62,60.62,1,-72220,38818,111038,-33402,0,0,26773,0,0,,26773,26773
6,02-09-17,63,15:30,15:45,41.17,,0,41.17,41.17,1,-75917,49708,125625,-26209,0,0,10050,0,0,,10050,10050
6,02-09-17,64,15:45,16:00,41.79,,0,41.79,41.79,1,-90197,60652,150849,-29545,0,0,4071,0,0,,4071,4071
6,02-09-17,65,16:00,16:15,41.3,,0,41.3,41.3,1,-68148,50185,118333,-17963,0,0,2185,0,0,,2185,2185
6,02-09-17,66,16:15,16:30,,,0,46.37,46.37,0,-46459,56759,103218,10300,0,0,163,0,0,,163,163
6,02-09-17,67,16:30,16:45,,,0,46.37,46.37,0,-41536,90259,131795,48723,0,0,0,0,0,,0,0
6,02-09-17,68,16:45,17:00,41.3,54.43,0,46.37,46.37,2,-54749,112972,167721,58223,0,-749,526,0,0,,1275,-223
6,02-09-17,69,17:00,17:15,41.3,25.42,0,25.42,25.42,-1,-31144,119718,150862,88574,0,-15435,72,0,0,,15507,-15363
6,02-09-17,70,17:15,17:30,,36.84,0,36.84,36.84,-1,-35316,70251,105567,34935,0,-11829,0,0,0,,11829,-11829
6,02-09-17,71,17:30,17:45,,34.53,0,34.53,34.53,-1,-37174,90055,127229,52881,0,-6989,0,0,0,,6989,-6989
6,02-09-17,72,17:45,18:00,,,0,46.37,46.37,0,-69305,106094,175399,36789,0,-434,0,0,0,,434,-434
6,02-09-17,73,18:00,18:15,,,0,46.36,46.36,0,-71878,47479,119357,-24399,0,0,0,0,0,,0,0
6,02-09-17,74,18:15,18:30,,,0,46.36,46.36,0,-47074,80516,127590,33442,0,0,0,0,0,,0,0
6,02-09-17,75,18:30,18:45,,36.06,0,36.06,36.06,-1,-42346,92884,135230,50538,0,-210,0,0,0,,210,-210
6,02-09-17,76,18:45,19:00,,35.8,0,35.8,35.8,-1,-38654,106205,144859,67551,0,-1799,0,0,0,,1799,-1799
6,02-09-17,77,19:00,19:15,,36.06,0,36.06,36.06,-1,-45130,61868,106998,16738,0,-2700,0,0,0,,2700,-2700
6,02-09-17,78,19:15,19:30,,32.99,0,32.99,32.99,-1,-37644,69655,107299,32011,0,-19561,0,0,0,,19561,-19561
6,02-09-17,79,19:30,19:45,,32.16,0,32.16,32.16,-1,-38197,64835,103032,26638,0,-20476,0,0,0,,20476,-20476
6,02-09-17,80,19:45,20:00,,31.99,0,31.99,31.99,-1,-46260,92585,138845,46325,0,-22950,0,0,0,,22950,-22950
6,02-09-17,81,20:00,20:15,75.32,35.03,0,75.32,35.03,2,-102252,39571,141823,-62681,0,-16123,4699,0,0,,20822,-11424
6,02-09-17,82,20:15,20:30,37.8,35.03,0,37.8,37.8,1,-87343,38260,125603,-49083,0,-44,314,0,0,,358,270
6,02-09-17,83,20:30,20:45,,,0,46.28,46.28,0,-78609,55328,133937,-23281,0,0,0,0,0,,0,0
6,02-09-17,84,20:45,21:00,,36.48,0,36.48,36.48,-1,-104256,69742,173998,-34514,0,-59,0,0,0,,59,-59
6,02-09-17,85,21:00,21:15,136.02,34.03,0,136.02,33.72,2,-154879,70835,225714,-84044,0,-2320,11620,0,0,,13940,9300
6,02-09-17,86,21:15,21:30,341.4,,0,341.4,341.4,1,-152795,62850,215645,-89945,0,0,69591,20000,0,,89591,89591
6,02-09-17,87,21:30,21:45,42.33,31.28,0,42.33,31.28,2,-89140,76057,165197,-13083,0,-3732,11126,0,0,,14858,7394
6,02-09-17,88,21:45,22:00,92.19,,0,92.19,92.19,1,-143648,105602,249250,-38046,0,0,21391,0,0,,21391,21391
6,02-09-17,89,22:00,22:15,50.11,,0,50.11,50.11,1,-136861,60293,197154,-76568,0,0,3195,0,0,,3195,3195
6,02-09-17,90,22:15,22:30,50.11,,0,50.11,50.11,1,-104208,59874,164082,-44334,0,0,4074,0,0,,4074,4074
6,02-09-17,91,22:30,22:45,68.02,,0,68.02,68.02,1,-106936,76148,183084,-30788,0,0,7595,0,0,,7595,7595
6,02-09-17,92,22:45,23:00,72.25,34.65,0,72.25,34.65,2,-112294,79874,192168,-32420,0,-391,17856,0,0,,18247,17465
6,02-09-17,93,23:00,23:15,72.25,21.34,0,21.34,21.34,-1,-57830,116564,174394,58734,0,-5302,168,0,0,,5470,-5134
6,02-09-17,94,23:15,23:30,,30.8,0,30.8,30.8,-1,-52844,80256,133100,27412,0,-6438,0,0,0,,6438,-6438
6,02-09-17,95,23:30,23:45,,25.8,0,25.8,25.8,-1,-40681,84697,125378,44016,0,-22142,0,0,0,,22142,-22142
6,02-09-17,96,23:45,0:00,,14.36,0,14.36,14.36,-1,-46109,122556,168665,76447,0,-45824,0,0,0,,45824,-45824
6,02-10-17,1,0:00,0:15,,29.53,0,29.53,29.53,-1,-81424,109903,191327,28479,0,-35448,0,0,0,,35448,-35448
6,02-10-17,2,0:15,0:30,38.22,35.1,0,38.22,34.13,2,-70860,88172,159032,17312,0,-469,56,0,0,,525,-413
6,02-10-17,3,0:30,0:45,,34.8,0,34.8,34.8,-1,-65831,83428,149259,17597,0,-2925,0,0,0,,2925,-2925
6,02-10-17,4,0:45,1:00,,31.99,0,31.99,31.99,-1,-41872,87596,129468,45724,0,-18148,0,0,0,,18148,-18148
6,02-10-17,5,1:00,1:15,38.22,35.78,0,38.22,38.22,1,-64445,48642,113087,-15803,0,-14066,643,0,0,,14709,-13423
6,02-10-17,6,1:15,1:30,38.22,35.78,0,38.22,38.22,1,-56496,62013,118509,5517,0,-155,430,0,0,,585,275
6,02-10-17,7,1:30,1:45,,28.28,0,28.28,28.28,-1,-40723,77776,118499,37053,0,-10239,0,0,0,,10239,-10239
6,02-10-17,8,1:45,2:00,,24.92,0,24.92,24.92,-1,-38609,87169,125778,48560,0,-47254,0,0,0,,47254,-47254
6,02-10-17,9,2:00,2:15,30.62,34.52,0,30.62,30.62,1,-63955,71323,135278,7368,0,-26019,82,0,0,,26101,-25937
6,02-10-17,10,2:15,2:30,30.62,31.99,0,34.63,31.99,2,-41890,83497,125387,41607,0,-8582,63,0,0,,8645,-8519
6,02-10-17,11,2:30,2:45,,31.38,0,31.38,31.38,-1,-41470,73052,114522,31582,0,-20357,0,0,0,,20357,-20357
6,02-10-17,12,2:45,3:00,,29.09,0,29.09,29.09,-1,-35973,72349,108322,36376,0,-22004,0,0,0,,22004,-22004
6,02-10-17,13,3:00,3:15,,29.09,0,29.09,29.09,-1,-34845,81362,116207,46517,0,-26968,0,0,0,,26968,-26968
6,02-10-17,14,3:15,3:30,,,0,34.65,34.65,0,-37969,54674,92643,16705,0,-840,0,0,0,,840,-840
6,02-10-17,15,3:30,3:45,,,0,34.65,34.65,0,-25153,59160,84313,34007,0,0,0,0,0,,0,0
6,02-10-17,16,3:45,4:00,,35.8,0,35.8,35.8,-1,-25231,54254,79485,29023,0,-924,0,0,0,,924,-924
6,02-10-17,17,4:00,4:15,,,0,34.68,34.68,0,-40701,66201,106902,25500,0,-98,0,0,0,,98,-98
6,02-10-17,18,4:15,4:30,,31.6,0,31.6,31.6,-1,-21258,73815,95073,52557,0,-4055,0,0,0,,4055,-4055
6,02-10-17,19,4:30,4:45,,30.23,0,30.23,30.23,-1,-23923,63335,87258,39412,0,-13018,0,0,0,,13018,-13018
6,02-10-17,20,4:45,5:00,,38.64,0,38.64,38.64,-1,-42352,58569,100921,16217,0,-289,0,0,0,,289,-289
6,02-10-17,21,5:00,5:15,,35.72,0,35.72,35.72,-1,-98279,95751,194030,-2528,0,-1542,0,0,0,,1542,-1542
6,02-10-17,22,5:15,5:30,,35.8,0,35.8,35.8,-1,-34949,66220,101169,31271,0,-2082,0,0,0,,2082,-2082
6,02-10-17,23,5:30,5:45,39.23,35.8,0,39.23,39.23,1,-53482,40111,93593,-13371,0,-76,1552,0,0,,1628,1476
6,02-10-17,24,5:45,6:00,39.23,,0,39.23,39.23,1,-55423,41783,97206,-13640,0,0,4758,0,0,,4758,4758
6,02-10-17,25,6:00,6:15,30.9,33.9,0,35.15,33.9,2,-80206,104778,184984,24572,0,-5504,1396,0,0,,6900,-4108
6,02-10-17,26,6:15,6:30,36.9,35.43,0,36.9,35.15,2,-33894,61639,95533,27745,0,-8151,13,0,0,,8164,-8138
6,02-10-17,27,6:30,6:45,38.48,35.43,0,38.48,38.48,1,-75072,69966,145038,-5106,0,-112,1642,0,0,,1754,1530
6,02-10-17,28,6:45,7:00,40.9,,0,40.9,40.9,1,-113587,95775,209362,-17812,0,0,1982,0,0,,1982,1982
6,02-10-17,29,7:00,7:15,40.9,-12.29,0,-12.29,-12.29,-1,-28270,140857,169127,112587,0,-17834,111,0,0,,17945,-17723
6,02-10-17,30,7:15,7:30,,37.66,0,37.66,37.66,-1,-41750,54960,96710,13210,0,-3209,0,0,0,,3209,-3209
6,02-10-17,31,7:30,7:45,52,37.66,0,52,52,1,-85395,38600,123995,-46795,0,-195,7982,0,0,,8177,7787
6,02-10-17,32,7:45,8:00,151.71,,0,151.71,151.71,1,-137089,42578,179667,-94511,0,0,42288,0,0,,42288,42288
6,02-10-17,33,8:00,8:15,151.71,-3.65,0,-3.65,-3.65,-1,-26024,104341,130365,78317,0,-18804,18124,0,0,,36928,-680
6,02-10-17,34,8:15,8:30,,35.43,0,35.43,35.43,-1,-57270,34335,91605,-22935,0,-7135,0,0,0,,7135,-7135
6,02-10-17,35,8:30,8:45,,,0,47.17,47.17,0,-62760,24545,87305,-38215,0,0,0,0,0,,0,0
6,02-10-17,36,8:45,9:00,,,0,47.17,47.17,0,-94729,18607,113336,-76122,0,0,0,0,0,,0,0
6,02-10-17,37,9:00,9:15,64.01,,0,64.01,64.01,1,-51663,25332,76995,-26331,0,0,10782,0,0,,10782,10782
6,02-10-17,38,9:15,9:30,144.94,,0,144.94,144.94,1,-78347,27149,105496,-51198,0,0,28638,0,0,,28638,28638
6,02-10-17,39,9:30,9:45,144.94,,0,144.94,144.94,1,-83047,28347,111394,-54700,0,0,50734,0,0,,50734,50734
6,02-10-17,40,9:45,10:00,144.94,,0,144.94,144.94,1,-107723,33213,140936,-74510,0,0,53798,0,0,,53798,53798
6,02-10-17,41,10:00,10:15,163.15,,0,163.15,163.15,1,-89916,19782,109698,-70134,0,0,71958,0,0,,71958,71958
6,02-10-17,42,10:15,10:30,75.9,,0,75.9,75.9,1,-82149,22189,104338,-59960,0,0,51795,0,0,,51795,51795
6,02-10-17,43,10:30,10:45,82.4,,0,82.4,82.4,1,-80109,17673,97782,-62436,0,0,51181,0,0,,51181,51181
6,02-10-17,44,10:45,11:00,163.15,,0,163.15,163.15,1,-88058,15141,103199,-72917,0,0,56505,0,0,,56505,56505
6,02-10-17,45,11:00,11:15,164.53,,0,164.53,164.53,1,-111903,19230,131133,-92673,0,0,78757,0,0,,78757,78757
6,02-10-17,46,11:15,11:30,164.53,,0,164.53,164.53,1,-101070,21882,122952,-79188,0,0,76503,0,0,,76503,76503
6,02-10-17,47,11:30,11:45,164.53,,0,164.53,164.53,1,-117060,23464,140524,-93596,0,0,81292,0,0,,81292,81292
6,02-10-17,48,11:45,12:00,164.53,,0,164.53,164.53,1,-126596,30775,157371,-95821,0,0,84089,0,0,,84089,84089
6,02-10-17,49,12:00,12:15,158.04,,0,158.04,158.04,1,-117545,26660,144205,-90885,0,0,77014,0,0,,77014,77014
6,02-10-17,50,12:15,12:30,189.9,,0,189.9,189.9,1,-108164,26621,134785,-81543,0,0,85258,0,0,,85258,85258
6,02-10-17,51,12:30,12:45,86.12,,0,86.12,86.12,1,-90562,41845,132407,-48717,0,0,51290,0,0,,51290,51290
6,02-10-17,52,12:45,13:00,158.04,,0,158.04,158.04,1,-119379,27760,147139,-91619,0,0,19992,0,0,,19992,19992
6,02-10-17,53,13:00,13:15,155.5,,0,155.5,155.5,1,-152984,22738,175722,-130246,0,0,76926,0,0,,76926,76926
6,02-10-17,54,13:15,13:30,134.33,,0,134.33,134.33,1,-133710,21341,155051,-112369,0,0,75960,0,0,,75960,75960
6,02-10-17,55,13:30,13:45,148.1,,0,148.1,148.1,1,-140471,21373,161844,-119098,0,0,74389,0,0,,74389,74389
6,02-10-17,56,13:45,14:00,121.84,,0,121.84,121.84,1,-135091,23745,158836,-111346,0,0,72035,0,0,,72035,72035
6,02-10-17,57,14:00,14:15,127.71,,0,127.71,127.71,1,-131536,26223,157759,-105313,0,0,50765,0,0,,50765,50765
6,02-10-17,58,14:15,14:30,147.84,,0,147.84,147.84,1,-132955,27492,160447,-105463,0,0,63666,0,0,,63666,63666
6,02-10-17,59,14:30,14:45,71.11,,0,71.11,71.11,1,-115717,23467,139184,-92250,0,0,49159,0,0,,49159,49159
6,02-10-17,60,14:45,15:00,58,,0,58,58,1,-99961,29221,129182,-70740,0,0,40039,0,0,,40039,40039
6,02-10-17,61,15:00,15:15,40.53,,0,40.53,40.53,1,-116895,48946,165841,-67949,0,0,20411,0,0,,20411,20411
6,02-10-17,62,15:15,15:30,67.73,,0,67.73,67.73,1,-125013,47142,172155,-77871,0,0,25477,0,0,,25477,25477
6,02-10-17,63,15:30,15:45,49.12,,0,49.12,49.12,1,-114532,42951,157483,-71581,0,0,33008,0,0,,33008,33008
6,02-10-17,64,15:45,16:00,74.67,,0,74.67,74.67,1,-135283,43289,178572,-91994,0,0,38005,0,0,,38005,38005
6,02-10-17,65,16:00,16:15,95.3,,0,95.3,95.3,1,-104869,24479,129348,-80390,0,0,47695,0,0,,47695,47695
6,02-10-17,66,16:15,16:30,64.03,,0,64.03,64.03,1,-110849,29382,140231,-81467,0,0,43528,0,0,,43528,43528
6,02-10-17,67,16:30,16:45,58,,0,58,58,1,-88237,40420,128657,-47817,0,0,29675,0,0,,29675,29675
6,02-10-17,68,16:45,17:00,73.12,,0,73.12,73.12,1,-111373,44587,155960,-66786,0,0,12530,0,0,,12530,12530
6,02-10-17,69,17:00,17:15,41.28,35.01,0,47.13,35.01,2,-66698,34132,100830,-32566,0,-4071,9362,0,0,,13433,5291
6,02-10-17,70,17:15,17:30,41.28,57.53,0,57.53,57.53,-1,-88554,37516,126070,-51038,0,-1152,19,0,0,,1171,-1133
6,02-10-17,71,17:30,17:45,,57.53,0,57.53,57.53,-1,-81767,38812,120579,-42955,0,-374,0,0,0,,374,-374
6,02-10-17,72,17:45,18:00,250.12,57.53,0,250.12,250.12,1,-112062,53798,165860,-58264,0,-1,15762,0,0,,15763,15761
6,02-10-17,73,18:00,18:15,57.8,21.44,0,21.44,21.44,-1,-67841,78087,145928,10246,0,-5966,20755,0,0,,26721,14789
6,02-10-17,74,18:15,18:30,37.35,17.98,0,47.13,17.98,2,-45777,46263,92040,486,0,-15078,633,0,0,,15711,-14445
6,02-10-17,75,18:30,18:45,37.35,29.86,0,29.86,29.86,-1,-25614,71996,97610,46382,0,-8553,24,0,0,,8577,-8529
6,02-10-17,76,18:45,19:00,,21.44,0,21.44,21.44,-1,-18927,60361,79288,41434,0,-43911,0,0,0,,43911,-43911
6,02-10-17,77,19:00,19:15,39.6,34.9,0,39.6,39.6,1,-59288,23100,82388,-36188,0,-16837,1865,0,0,,18702,-14972
6,02-10-17,78,19:15,19:30,,,0,47,47,0,-39854,32703,72557,-7151,0,-374,547,0,0,,921,173
6,02-10-17,79,19:30,19:45,,29.86,0,29.86,29.86,-1,-27419,57305,84724,29886,0,-9106,0,0,0,,9106,-9106
6,02-10-17,80,19:45,20:00,,16.03,0,16.03,16.03,-1,-27763,52524,80287,24761,0,-45736,0,0,0,,45736,-45736
6,02-10-17,81,20:00,20:15,36.73,36.31,0,36.73,36.73,1,-50423,68722,119145,18299,0,-8312,78,0,0,,8390,-8234
6,02-10-17,82,20:15,20:30,,29.9,0,29.9,29.9,-1,-34208,70135,104343,35927,0,-13177,0,0,0,,13177,-13177
6,02-10-17,83,20:30,20:45,,28.23,0,28.23,28.23,-1,-27675,88194,115869,60519,0,-29213,0,0,0,,29213,-29213
6,02-10-17,84,20:45,21:00,,-8.86,0,-8.86,-8.86,-1,-21142,84459,105601,63317,0,-63872,0,0,0,,63872,-63872
6,02-10-17,85,21:00,21:15,81.38,26.68,0,81.38,81.38,1,-62785,71240,134025,8455,0,-39999,2245,0,0,,42244,-37754
6,02-10-17,86,21:15,21:30,111.12,15.3,0,111.12,15.3,2,-43809,100169,143978,56360,0,-3614,5997,0,0,,9611,2383
6,02-10-17,87,21:30,21:45,,15.3,0,15.3,15.3,-1,-51940,108572,160512,56632,0,-24091,0,0,0,,24091,-24091
6,02-10-17,88,21:45,22:00,,-53.14,0,-53.14,-53.14,-1,-42959,147225,190184,104266,0,-33628,0,0,0,,33628,-33628
6,02-10-17,89,22:00,22:15,50.9,-53.24,0,50.9,50.9,1,-108421,8025,116446,-100396,0,-33381,1516,0,0,,34897,-31865
6,02-10-17,90,22:15,22:30,57.87,-53.24,0,57.87,57.87,1,-66129,20035,86164,-46094,0,-233,5899,0,0,,6132,5666
6,02-10-17,91,22:30,22:45,63.28,,0,63.28,63.28,1,-67597,28751,96348,-38846,0,0,11855,0,0,,11855,11855
6,02-10-17,92,22:45,23:00,39.6,35.18,0,39.6,35.18,2,-52541,30732,83273,-21809,0,-53,18933,0,0,,18986,18880
6,02-10-17,93,23:00,23:15,39.6,29.9,0,29.9,29.9,-1,-64344,97574,161918,33230,0,-3114,3582,0,0,,6696,468
6,02-10-17,94,23:15,23:30,,34.9,0,34.9,34.9,-1,-33584,32987,66571,-597,0,-357,0,0,0,,357,-357
6,02-10-17,95,23:30,23:45,,34.9,0,34.9,34.9,-1,-25237,34706,59943,9469,0,-1007,0,0,0,,1007,-1007
6,02-10-17,96,23:45,0:00,,32.23,0,32.23,32.23,-1,-37451,43025,80476,5574,0,-15898,0,0,0,,15898,-15898
7,02-11-17,1,0:00,0:15,,27.99,0,27.99,27.99,-1,-47189,130538,177727,83349,0,-20463,0,0,0,,20463,-20463
7,02-11-17,2,0:15,0:30,,34.75,0,34.75,34.75,-1,-37980,77170,115150,39190,0,-420,0,0,0,,420,-420
7,02-11-17,3,0:30,0:45,,33.59,0,33.59,33.59,-1,-34302,33508,67810,-794,0,-3095,0,0,0,,3095,-3095
7,02-11-17,4,0:45,1:00,,,0,34.89,34.89,0,-92560,37400,129960,-55160,0,-20,0,0,0,,20,-20
7,02-11-17,5,1:00,1:15,67.91,,0,67.91,67.91,1,-70602,30177,100779,-40425,0,0,10551,0,0,,10551,10551
7,02-11-17,6,1:15,1:30,38.98,,0,38.98,38.98,1,-60151,32884,93035,-27267,0,0,20019,0,0,,20019,20019
7,02-11-17,7,1:30,1:45,32.95,,0,32.95,32.95,1,-39056,28146,67202,-10910,0,0,4036,0,0,,4036,4036
7,02-11-17,8,1:45,2:00,34.75,34.75,0,34.91,34.75,2,-18430,40160,58590,21730,0,-619,2273,0,0,,2892,1654
7,02-11-17,9,2:00,2:15,38.98,34.75,0,38.98,34.75,2,-47815,33419,81234,-14396,0,-1632,3156,0,0,,4788,1524
7,02-11-17,10,2:15,2:30,40.75,,0,40.75,40.75,1,-47068,34436,81504,-12632,0,0,12961,0,0,,12961,12961
7,02-11-17,11,2:30,2:45,,,0,34.91,34.91,0,-43017,42170,85187,-847,0,0,1554,0,0,,1554,1554
7,02-11-17,12,2:45,3:00,,34.75,0,34.75,34.75,-1,-39850,41202,81052,1352,0,-1374,0,0,0,,1374,-1374
7,02-11-17,13,3:00,3:15,43.49,34.75,0,43.49,43.49,1,-61836,29242,91078,-32594,0,-271,5164,0,0,,5435,4893
7,02-11-17,14,3:15,3:30,46.75,,0,46.75,46.75,1,-50345,29435,79780,-20910,0,0,22898,0,0,,22898,22898
7,02-11-17,15,3:30,3:45,36.36,,0,36.36,36.36,1,-34291,30501,64792,-3790,0,0,3598,0,0,,3598,3598
7,02-11-17,16,3:45,4:00,32.5,37.2,0,34.88,34.88,2,-40197,33530,73727,-6667,0,-66,341,0,0,,407,275
7,02-11-17,17,4:00,4:15,,36.87,0,36.87,36.87,-1,-41376,65572,106948,24196,0,-1726,0,0,0,,1726,-1726
7,02-11-17,18,4:15,4:30,,34.64,0,34.64,34.64,-1,-36830,56596,93426,19766,0,-3220,0,0,0,,3220,-3220
7,02-11-17,19,4:30,4:45,,33.75,0,33.75,33.75,-1,-30773,55867,86640,25094,0,-2356,0,0,0,,2356,-2356
7,02-11-17,20,4:45,5:00,,33.03,0,33.03,33.03,-1,-32118,63686,95804,31568,0,-9961,0,0,0,,9961,-9961
7,02-11-17,21,5:00,5:15,35.56,37.26,0,35.56,35.56,1,-47160,23889,71049,-23271,0,-1742,132,0,0,,1874,-1610
7,02-11-17,22,5:15,5:30,36.6,,0,36.6,36.6,1,-32921,26430,59351,-6491,0,0,1649,0,0,,1649,1649
7,02-11-17,23,5:30,5:45,32.56,,0,32.56,32.56,1,-29215,22315,51530,-6900,0,0,46,0,0,,46,46
7,02-11-17,24,5:45,6:00,40.75,,0,40.75,40.75,1,-42658,9943,52601,-32715,0,0,9929,0,0,,9929,9929
7,02-11-17,25,6:00,6:15,40.75,1.17,0,1.17,1.17,-1,-31920,116975,148895,85055,0,-14282,2408,0,0,,16690,-11874
7,02-11-17,26,6:15,6:30,,1.03,0,1.03,1.03,-1,-25644,76546,102190,50902,0,-31123,0,0,0,,31123,-31123
7,02-11-17,27,6:30,6:45,35.42,1.03,0,35.42,35.42,1,-51949,61751,113700,9802,0,-641,12,0,0,,653,-629
7,02-11-17,28,6:45,7:00,32.51,,0,32.51,32.51,1,-37853,74071,111924,36218,0,0,2,0,0,,2,2
7,02-11-17,29,7:00,7:15,35.42,33.42,0,35.42,33.42,2,-50354,51348,101702,994,0,-1717,406,0,0,,2123,-1311
7,02-11-17,30,7:15,7:30,35.42,33.42,0,35.42,35.42,1,-33661,28233,61894,-5428,0,-57,65,0,0,,122,8
7,02-11-17,31,7:30,7:45,35.56,,0,35.56,35.56,1,-35736,30314,66050,-5422,0,0,382,0,0,,382,382
7,02-11-17,32,7:45,8:00,56.69,,0,56.69,56.69,1,-43316,37650,80966,-5666,0,0,4855,0,0,,4855,4855
7,02-11-17,33,8:00,8:15,119.63,,0,119.63,119.63,1,-168588,58544,227132,-110044,0,0,24964,0,0,,24964,24964
7,02-11-17,34,8:15,8:30,42.92,,0,42.92,42.92,1,-91061,51405,142466,-39656,0,0,11059,0,0,,11059,11059
7,02-11-17,35,8:30,8:45,53.92,,0,53.92,53.92,1,-49449,22213,71662,-27236,0,0,7777,0,0,,7777,7777
7,02-11-17,36,8:45,9:00,138.48,,0,138.48,138.48,1,-100683,22580,123263,-78103,0,0,41413,0,0,,41413,41413
7,02-11-17,37,9:00,9:15,138.48,35.03,0,35.03,35.03,-1,-56102,78092,134194,21990,0,-703,7383,0,0,,8086,6680
7,02-11-17,38,9:15,9:30,,38.8,0,38.8,38.8,-1,-28914,49770,78684,20856,0,-203,0,0,0,,203,-203
7,02-11-17,39,9:30,9:45,,41.06,0,41.06,41.06,-1,-47135,56109,103244,8974,0,-226,0,0,0,,226,-226
7,02-11-17,40,9:45,10:00,48.53,,0,48.53,48.53,1,-72112,52020,124132,-20092,0,0,7088,0,0,,7088,7088
7,02-11-17,41,10:00,10:15,102.2,,0,102.2,102.2,1,-82973,25684,108657,-57289,0,0,27074,0,0,,27074,27074
7,02-11-17,42,10:15,10:30,102.2,,0,102.2,102.2,1,-85301,34772,120073,-50529,0,0,51194,0,0,,51194,51194
7,02-11-17,43,10:30,10:45,43.76,,0,43.76,43.76,1,-90208,42393,132601,-47815,0,0,32629,0,0,,32629,32629
7,02-11-17,44,10:45,11:00,69.76,,0,69.76,69.76,1,-106320,45556,151876,-60764,0,0,37200,0,0,,37200,37200
7,02-11-17,45,11:00,11:15,55.1,,0,55.1,55.1,1,-84222,39661,123883,-44561,0,0,36327,0,0,,36327,36327
7,02-11-17,46,11:15,11:30,39.95,,0,39.95,39.95,1,-64761,41695,106456,-23066,0,0,17126,0,0,,17126,17126
7,02-11-17,47,11:30,11:45,32.51,,0,32.51,32.51,1,-67491,36373,103864,-31118,0,0,341,0,0,,341,341
7,02-11-17,48,11:45,12:00,55.1,,0,55.1,55.1,1,-65975,32666,98641,-33309,0,0,9993,0,0,,9993,9993
7,02-11-17,49,12:00,12:15,137.02,,0,137.02,137.02,1,-150433,23569,174002,-126864,0,0,34333,0,0,,34333,34333
7,02-11-17,50,12:15,12:30,137.02,,0,137.02,137.02,1,-143975,51406,195381,-92569,0,0,79998,0,0,,79998,79998
7,02-11-17,51,12:30,12:45,50.02,,0,50.02,50.02,1,-114362,53660,168022,-60702,0,0,38240,0,0,,38240,38240
7,02-11-17,52,12:45,13:00,57.02,,0,57.02,57.02,1,-116217,53528,169745,-62689,0,0,27896,0,0,,27896,27896
7,02-11-17,53,13:00,13:15,136.02,,0,136.02,136.02,1,-123887,25012,148899,-98875,0,0,25130,0,0,,25130,25130
7,02-11-17,54,13:15,13:30,250,,0,250,250,1,-127470,28828,156298,-98642,0,0,69221,0,0,,69221,69221
7,02-11-17,55,13:30,13:45,51.79,,0,51.79,51.79,1,-109527,34149,143676,-75378,0,0,47100,0,0,,47100,47100
7,02-11-17,56,13:45,14:00,70.85,,0,70.85,70.85,1,-109213,28807,138020,-80406,0,0,25143,0,0,,25143,25143
7,02-11-17,57,14:00,14:15,67.02,,0,67.02,67.02,1,-70342,80728,151070,10386,0,0,27523,0,0,,27523,27523
7,02-11-17,58,14:15,14:30,67.02,35.14,0,35.14,35.14,-1,-58372,79168,137540,20796,0,-805,5915,0,0,,6720,5110
7,02-11-17,59,14:30,14:45,,35.14,0,35.14,35.14,-1,-53872,69869,123741,15997,0,-811,0,0,0,,811,-811
7,02-11-17,60,14:45,15:00,45.57,,0,45.57,45.57,1,-61269,74563,135832,13294,0,0,1654,0,0,,1654,1654
7,02-11-17,61,15:00,15:15,132.02,,0,132.02,132.02,1,-98048,34427,132475,-63621,0,0,48311,0,0,,48311,48311
7,02-11-17,62,15:15,15:30,68.68,,0,68.68,68.68,1,-76679,46682,123361,-29997,0,0,55269,0,0,,55269,55269
7,02-11-17,63,15:30,15:45,79.02,,0,79.02,79.02,1,-79390,36048,115438,-43342,0,0,54097,0,0,,54097,54097
7,02-11-17,64,15:45,16:00,59.33,,0,59.33,59.33,1,-76979,42693,119672,-34286,0,0,51026,0,0,,51026,51026
7,02-11-17,65,16:00,16:15,51.69,,0,51.69,51.69,1,-72494,64734,137228,-7760,0,0,31713,0,0,,31713,31713
7,02-11-17,66,16:15,16:30,42.88,,0,42.88,42.88,1,-82603,72714,155317,-9889,0,0,22517,0,0,,22517,22517
7,02-11-17,67,16:30,16:45,45.57,,0,45.57,45.57,1,-86429,74516,160945,-11913,0,0,24144,0,0,,24144,24144
7,02-11-17,68,16:45,17:00,53.82,,0,53.82,53.82,1,-114850,83942,198792,-30908,0,0,40887,0,0,,40887,40887
7,02-11-17,69,17:00,17:15,39.57,31.63,0,39.57,31.63,2,-57422,64242,121664,6820,0,-2853,21532,0,0,,24385,18679
7,02-11-17,70,17:15,17:30,33.95,31.63,0,33.95,33.95,1,-50413,45798,96211,-4615,0,-182,289,0,0,,471,107
7,02-11-17,71,17:30,17:45,39.57,33.57,0,39.57,33.57,2,-66678,73491,140169,6813,0,-1271,386,0,0,,1657,-885
7,02-11-17,72,17:45,18:00,51.69,,0,51.69,51.69,1,-102122,80859,182981,-21263,0,0,17443,0,0,,17443,17443
7,02-11-17,73,18:00,18:15,35.57,33.57,0,35.57,33.57,2,-64609,76320,140929,11711,0,-2087,4446,0,0,,6533,2359
7,02-11-17,74,18:15,18:30,,30.02,0,30.02,30.02,-1,-49161,96473,145634,47312,0,-6512,0,0,0,,6512,-6512
7,02-11-17,75,18:30,18:45,,28.9,0,28.9,28.9,-1,-38738,78035,116773,39297,0,-14355,0,0,0,,14355,-14355
7,02-11-17,76,18:45,19:00,,26.12,0,26.12,26.12,-1,-33587,106294,139881,72707,0,-18937,0,0,0,,18937,-18937
7,02-11-17,77,19:00,19:15,,31,0,31,31,-1,-66066,74374,140440,8308,0,-14629,0,0,0,,14629,-14629
7,02-11-17,78,19:15,19:30,,18.66,0,18.66,18.66,-1,-42055,82148,124203,40093,0,-20358,0,0,0,,20358,-20358
7,02-11-17,79,19:30,19:45,,11.22,0,11.22,11.22,-1,-36747,76750,113497,40003,0,-72280,0,0,0,,72280,-72280
7,02-11-17,80,19:45,20:00,,34.25,0,34.25,34.25,-1,-69184,98894,168078,29710,0,-18350,0,0,0,,18350,-18350
7,02-11-17,81,20:00,20:15,51.69,34.03,0,51.69,34.03,2,-68440,47469,115909,-20971,0,-3368,8072,0,0,,11440,4704
7,02-11-17,82,20:15,20:30,39.57,33.57,0,33.57,33.57,-1,-65066,73974,139040,8908,0,-416,10299,0,0,,10715,9883
7,02-11-17,83,20:30,20:45,,30.9,0,30.9,30.9,-1,-53653,74877,128530,21224,0,-13726,0,0,0,,13726,-13726
7,02-11-17,84,20:45,21:00,,30.9,0,30.9,30.9,-1,-52862,65805,118667,12943,0,-13348,0,0,0,,13348,-13348
7,02-11-17,85,21:00,21:15,,7.07,0,7.07,7.07,-1,-48274,95207,143481,46933,0,-51836,0,0,0,,51836,-51836
7,02-11-17,86,21:15,21:30,35.46,28.42,0,35.46,28.42,2,-62099,92310,154409,30211,0,-10986,446,0,0,,11432,-10540
7,02-11-17,87,21:30,21:45,,19.96,0,19.96,19.96,-1,-47501,97114,144615,49613,0,-53517,0,0,0,,53517,-53517
7,02-11-17,88,21:45,22:00,,28.42,0,28.42,28.42,-1,-39863,97377,137240,57514,0,-48941,0,0,0,,48941,-48941
7,02-11-17,89,22:00,22:15,32.3,25.03,0,34.78,25.03,2,-64078,81166,145244,17088,0,-43580,6,0,0,,43586,-43574
7,02-11-17,90,22:15,22:30,123.02,37.17,0,123.02,34.78,2,-90480,76548,167028,-13932,0,-5606,16013,0,0,,21619,10407
7,02-11-17,91,22:30,22:45,123.02,-8.03,0,-8.03,-8.03,-1,-38265,101999,140264,63734,0,-40296,1088,0,0,,41384,-39208
7,02-11-17,92,22:45,23:00,,24.47,0,24.47,24.47,-1,-39148,105674,144822,66526,0,-62106,0,0,0,,62106,-62106
7,02-11-17,93,23:00,23:15,42.72,24.6,0,42.72,42.72,1,-86318,77119,163437,-9199,0,-43174,699,0,0,,43873,-42475
7,02-11-17,94,23:15,23:30,43.49,32.42,0,43.49,32.42,2,-52271,70223,122494,17952,0,-4386,709,0,0,,5095,-3677
7,02-11-17,95,23:30,23:45,,29.15,0,29.15,29.15,-1,-34063,79647,113710,45584,0,-27241,0,0,0,,27241,-27241
7,02-11-17,96,23:45,0:00,,8.82,0,8.82,8.82,-1,-39762,93424,133186,53662,0,-53711,0,0,0,,53711,-53711
7,02-12-17,1,0:00,0:15,,-11.78,0,-11.78,-11.78,-1,-28208,114010,142218,85802,0,-82472,0,0,0,,82472,-82472
7,02-12-17,2,0:15,0:30,,17.16,0,17.16,17.16,-1,-35975,101222,137197,65247,0,-44307,0,0,0,,44307,-44307
7,02-12-17,3,0:30,0:45,,17.16,0,17.16,17.16,-1,-42026,72125,114151,30099,0,-50443,0,0,0,,50443,-50443
7,02-12-17,4,0:45,1:00,,31.89,0,31.89,31.89,-1,-39611,55110,94721,15499,0,-17330,0,0,0,,17330,-17330
7,02-12-17,5,1:00,1:15,,28.21,0,28.21,28.21,-1,-44023,63929,107952,19906,0,-23149,0,0,0,,23149,-23149
7,02-12-17,6,1:15,1:30,,30.7,0,30.7,30.7,-1,-43921,62995,106916,19074,0,-5663,0,0,0,,5663,-5663
7,02-12-17,7,1:30,1:45,,22.74,0,22.74,22.74,-1,-42754,93848,136602,51094,0,-45572,0,0,0,,45572,-45572
7,02-12-17,8,1:45,2:00,,28.74,0,28.74,28.74,-1,-42008,90115,132123,48107,0,-50760,0,0,0,,50760,-50760
7,02-12-17,9,2:00,2:15,,30.89,0,30.89,30.89,-1,-40043,66408,106451,26365,0,-26628,0,0,0,,26628,-26628
7,02-12-17,10,2:15,2:30,,30.89,0,30.89,30.89,-1,-47053,66548,113601,19495,0,-6394,0,0,0,,6394,-6394
7,02-12-17,11,2:30,2:45,,26.89,0,26.89,26.89,-1,-32252,75333,107585,43081,0,-30419,0,0,0,,30419,-30419
7,02-12-17,12,2:45,3:00,,26.89,0,26.89,26.89,-1,-28019,84211,112230,56192,0,-63366,0,0,0,,63366,-63366
7,02-12-17,13,3:00,3:15,,26.89,0,26.89,26.89,-1,-38641,83787,122428,45146,0,-52802,0,0,0,,52802,-52802
7,02-12-17,14,3:15,3:30,,30.9,0,30.9,30.9,-1,-37306,74639,111945,37333,0,-19014,0,0,0,,19014,-19014
7,02-12-17,15,3:30,3:45,,30.89,0,30.89,30.89,-1,-38281,72481,110762,34200,0,-16010,0,0,0,,16010,-16010
7,02-12-17,16,3:45,4:00,,30.89,0,30.89,30.89,-1,-40275,69002,109277,28727,0,-25778,0,0,0,,25778,-25778
7,02-12-17,17,4:00,4:15,,31.74,0,31.74,31.74,-1,-35523,57959,93482,22436,0,-16880,0,0,0,,16880,-16880
7,02-12-17,18,4:15,4:30,,,0,34.58,34.58,0,-34237,60081,94318,25844,0,-213,0,0,0,,213,-213
7,02-12-17,19,4:30,4:45,33.89,,0,33.89,33.89,1,-35169,40758,75927,5589,0,0,293,0,0,,293,293
7,02-12-17,20,4:45,5:00,,,0,34.59,34.59,0,-35972,43042,79014,7070,0,0,0,0,0,,0,0
7,02-12-17,21,5:00,5:15,,28.9,0,28.9,28.9,-1,-35349,50331,85680,14982,0,-9161,0,0,0,,9161,-9161
7,02-12-17,22,5:15,5:30,,31.12,0,31.12,31.12,-1,-29759,58483,88242,28724,0,-23784,0,0,0,,23784,-23784
7,02-12-17,23,5:30,5:45,,30.89,0,30.89,30.89,-1,-31831,62158,93989,30327,0,-34622,0,0,0,,34622,-34622
7,02-12-17,24,5:45,6:00,,28.9,0,28.9,28.9,-1,-37076,76268,113344,39192,0,-28764,0,0,0,,28764,-28764
7,02-12-17,25,6:00,6:15,,30.7,0,30.7,30.7,-1,-46695,66915,113610,20220,0,-29198,0,0,0,,29198,-29198
7,02-12-17,26,6:15,6:30,,33.59,0,33.59,33.59,-1,-42484,54574,97058,12090,0,-16556,0,0,0,,16556,-16556
7,02-12-17,27,6:30,6:45,,35.61,0,35.61,35.61,-1,-44261,42869,87130,-1392,0,-7797,0,0,0,,7797,-7797
7,02-12-17,28,6:45,7:00,33.34,35.11,0,34.3,34.3,2,-54648,43702,98350,-10946,0,-1013,1882,0,0,,2895,869
7,02-12-17,29,7:00,7:15,,30.34,0,30.34,30.34,-1,-40449,74844,115293,34395,0,-17311,0,0,0,,17311,-17311
7,02-12-17,30,7:15,7:30,,31.19,0,31.19,31.19,-1,-41845,64101,105946,22256,0,-30555,0,0,0,,30555,-30555
7,02-12-17,31,7:30,7:45,33.34,36.92,0,33.34,33.34,1,-44282,40587,84869,-3695,0,-10486,909,0,0,,11395,-9577
7,02-12-17,32,7:45,8:00,32.15,,0,32.15,32.15,1,-54864,39339,94203,-15525,0,0,339,0,0,,339,339
7,02-12-17,33,8:00,8:15,32.06,26.44,0,26.44,26.44,-1,-52197,82643,134840,30446,0,-9528,238,0,0,,9766,-9290
7,02-12-17,34,8:15,8:30,35.6,26.43,0,35.6,26.43,2,-37633,37059,74692,-574,0,-21096,148,0,0,,21244,-20948
7,02-12-17,35,8:30,8:45,43.34,26.43,0,43.34,43.34,1,-49588,26660,76248,-22928,0,-735,15219,0,0,,15954,14484
7,02-12-17,36,8:45,9:00,36.02,33.39,0,33.39,33.39,-1,-49631,48671,98302,-960,0,-604,11860,0,0,,12464,11256
7,02-12-17,37,9:00,9:15,43.74,33.39,0,43.74,43.74,1,-76065,40869,116934,-35196,0,-74,8895,0,0,,8969,8821
7,02-12-17,38,9:15,9:30,35.79,,0,35.79,35.79,1,-50480,26455,76935,-24025,0,0,12214,0,0,,12214,12214
7,02-12-17,39,9:30,9:45,39.35,,0,39.35,39.35,1,-63599,30362,93961,-33237,0,0,19210,0,0,,19210,19210
7,02-12-17,40,9:45,10:00,39.12,,0,39.12,39.12,1,-75047,30727,105774,-44320,0,0,31448,0,0,,31448,31448
7,02-12-17,41,10:00,10:15,36.02,28.9,0,28.9,28.9,-1,-43972,66034,110006,22062,0,-5989,15236,0,0,,21225,9247
7,02-12-17,42,10:15,10:30,36.02,28.9,0,28.9,28.9,-1,-49230,59756,108986,10526,0,-16064,13,0,0,,16077,-16051
7,02-12-17,43,10:30,10:45,,31.64,0,31.64,31.64,-1,-48754,60976,109730,12222,0,-6523,0,0,0,,6523,-6523
7,02-12-17,44,10:45,11:00,,34.8,0,34.8,34.8,-1,-65360,70175,135535,4815,0,-2692,0,0,0,,2692,-2692
7,02-12-17,45,11:00,11:15,77.12,34.8,0,77.12,77.12,1,-85610,46940,132550,-38670,0,-194,10701,0,0,,10895,10507
7,02-12-17,46,11:15,11:30,85.12,,0,85.12,85.12,1,-80234,52593,132827,-27641,0,0,32643,0,0,,32643,32643
7,02-12-17,47,11:30,11:45,36.44,,0,36.44,36.44,1,-77253,54046,131299,-23207,0,0,20143,0,0,,20143,20143
7,02-12-17,48,11:45,12:00,36.44,,0,36.44,36.44,1,-79677,60236,139913,-19441,0,0,16602,0,0,,16602,16602
7,02-12-17,49,12:00,12:15,36.44,33.39,0,33.39,33.39,-1,-48850,65510,114360,16660,0,-1203,4911,0,0,,6114,3708
7,02-12-17,50,12:15,12:30,,33.39,0,33.39,33.39,-1,-49336,52804,102140,3468,0,-1254,0,0,0,,1254,-1254
7,02-12-17,51,12:30,12:45,,33.39,0,33.39,33.39,-1,-48558,58699,107257,10141,0,-1337,0,0,0,,1337,-1337
7,02-12-17,52,12:45,13:00,,34.8,0,34.8,34.8,-1,-48817,40809,89626,-8008,0,-542,0,0,0,,542,-542
7,02-12-17,53,13:00,13:15,,26.41,0,26.41,26.41,-1,-45212,86076,131288,40864,0,-12724,0,0,0,,12724,-12724
7,02-12-17,54,13:15,13:30,,26.41,0,26.41,26.41,-1,-45275,61407,106682,16132,0,-22798,0,0,0,,22798,-22798
7,02-12-17,55,13:30,13:45,,26.41,0,26.41,26.41,-1,-40854,75389,116243,34535,0,-17033,0,0,0,,17033,-17033
7,02-12-17,56,13:45,14:00,,26.41,0,26.41,26.41,-1,-34628,76573,111201,41945,0,-38905,0,0,0,,38905,-38905
7,02-12-17,57,14:00,14:15,,31.48,0,31.48,31.48,-1,-39167,61973,101140,22806,0,-17490,0,0,0,,17490,-17490
7,02-12-17,58,14:15,14:30,,30.03,0,30.03,30.03,-1,-37259,60219,97478,22960,0,-6677,0,0,0,,6677,-6677
7,02-12-17,59,14:30,14:45,,26.34,0,26.34,26.34,-1,-30807,84366,115173,53559,0,-33574,0,0,0,,33574,-33574
7,02-12-17,60,14:45,15:00,,25.74,0,25.74,25.74,-1,-28728,95229,123957,66501,0,-49123,0,0,0,,49123,-49123
7,02-12-17,61,15:00,15:15,,28.84,0,28.84,28.84,-1,-38147,106521,144668,68374,0,-43136,0,0,0,,43136,-43136
7,02-12-17,62,15:15,15:30,,30.41,0,30.41,30.41,-1,-30761,112888,143649,82127,0,-32202,0,0,0,,32202,-32202
7,02-12-17,63,15:30,15:45,,28.12,0,28.12,28.12,-1,-25862,102959,128821,77097,0,-36374,0,0,0,,36374,-36374
7,02-12-17,64,15:45,16:00,,32.83,0,32.83,32.83,-1,-31687,73220,104907,41533,0,-14374,0,0,0,,14374,-14374
7,02-12-17,65,16:00,16:15,,19.78,0,19.78,19.78,-1,-41577,120704,162281,79127,0,-23052,0,0,0,,23052,-23052
7,02-12-17,66,16:15,16:30,,32.52,0,32.52,32.52,-1,-34075,79990,114065,45915,0,-12489,0,0,0,,12489,-12489
7,02-12-17,67,16:30,16:45,,37.1,0,37.1,37.1,-1,-40128,83067,123195,42939,0,-204,0,0,0,,204,-204
7,02-12-17,68,16:45,17:00,,25.74,0,25.74,25.74,-1,-47254,85743,132997,38489,0,-19589,0,0,0,,19589,-19589
7,02-12-17,69,17:00,17:15,,-12.78,0,-12.78,-12.78,-1,-37012,137626,174638,100614,0,-50523,0,0,0,,50523,-50523
7,02-12-17,70,17:15,17:30,,26.34,0,26.34,26.34,-1,-52531,67595,120126,15064,0,-38065,0,0,0,,38065,-38065
7,02-12-17,71,17:30,17:45,,,0,33.24,33.24,0,-33698,62166,95864,28468,0,-1316,0,0,0,,1316,-1316
7,02-12-17,72,17:45,18:00,,,0,33.24,33.24,0,-58273,75805,134078,17532,0,0,0,0,0,,0,0
7,02-12-17,73,18:00,18:15,,,0,33.58,33.58,0,-67369,7619,74988,-59750,0,0,0,0,0,,0,0
7,02-12-17,74,18:15,18:30,131.12,,0,131.12,131.12,1,-71679,13127,84806,-58552,0,0,24998,0,0,,24998,24998
7,02-12-17,75,18:30,18:45,41.64,34.98,0,34.98,34.98,-1,-47311,40764,88075,-6547,0,-53,16913,0,0,,16966,16860
7,02-12-17,76,18:45,19:00,41.64,34.75,0,34.75,34.75,-1,-40141,53932,94073,13791,0,-1715,50,0,0,,1765,-1665
7,02-12-17,77,19:00,19:15,47.74,34.75,0,47.74,47.74,1,-78855,40069,118924,-38786,0,-197,8884,0,0,,9081,8687
7,02-12-17,78,19:15,19:30,47.74,,0,47.74,47.74,1,-67663,48102,115765,-19561,0,0,19503,0,0,,19503,19503
7,02-12-17,79,19:30,19:45,36.44,,0,36.44,36.44,1,-69280,49017,118297,-20263,0,0,12363,0,0,,12363,12363
7,02-12-17,80,19:45,20:00,,,0,33.56,33.56,0,-74075,44211,118286,-29864,0,0,790,0,0,,790,790
7,02-12-17,81,20:00,20:15,99.12,,0,99.12,99.12,1,-102767,28417,131184,-74350,0,0,14524,0,0,,14524,14524
7,02-12-17,82,20:15,20:30,36.44,,0,36.44,36.44,1,-85741,20003,105744,-65738,0,0,7542,0,0,,7542,7542
7,02-12-17,83,20:30,20:45,,,0,33.56,33.56,0,-59563,19915,79478,-39648,0,0,0,0,0,,0,0
7,02-12-17,84,20:45,21:00,,31.33,0,31.33,31.33,-1,-57976,32475,90451,-25501,0,-474,0,0,0,,474,-474
7,02-12-17,85,21:00,21:15,,22.36,0,22.36,22.36,-1,-68302,108496,176798,40194,0,-13578,0,0,0,,13578,-13578
7,02-12-17,86,21:15,21:30,,37.26,0,37.26,37.26,-1,-77413,65737,143150,-11676,0,-1283,0,0,0,,1283,-1283
7,02-12-17,87,21:30,21:45,,34.32,0,34.32,34.32,-1,-64257,61630,125887,-2627,0,-1780,0,0,0,,1780,-1780
7,02-12-17,88,21:45,22:00,,31.34,0,31.34,31.34,-1,-43610,70493,114103,26883,0,-20520,0,0,0,,20520,-20520
7,02-12-17,89,22:00,22:15,35.46,37.17,0,35.46,34.3,2,-131107,43131,174238,-87976,0,-7997,1163,0,0,,9160,-6834
7,02-12-17,90,22:15,22:30,,,0,34.3,34.3,0,-107120,37170,144290,-69950,0,0,58,0,0,,58,58
7,02-12-17,91,22:30,22:45,38.52,,0,38.52,38.52,1,-67623,37165,104788,-30458,0,0,4332,0,0,,4332,4332
7,02-12-17,92,22:45,23:00,31.34,34.1,0,34.1,34.1,-1,-42002,44984,86986,2982,0,-194,241,0,0,,435,47
7,02-12-17,93,23:00,23:15,,34.25,0,34.25,34.25,-1,-76731,50757,127488,-25974,0,-885,0,0,0,,885,-885
7,02-12-17,94,23:15,23:30,,34.25,0,34.25,34.25,-1,-57984,52829,110813,-5155,0,-381,0,0,0,,381,-381
7,02-12-17,95,23:30,23:45,,31.34,0,31.34,31.34,-1,-34534,59683,94217,25149,0,-20402,0,0,0,,20402,-20402
7,02-12-17,96,23:45,0:00,,31.62,0,31.62,31.62,-1,-40347,48890,89237,8543,0,-26018,0,0,0,,26018,-26018
7,02/13/2017,1,0:00,0:15,33.34,32.03,0,33.34,33.34,1,-59674,71643,131317,11969,0,-5563,155,0,0,,5718,-5408
7,02/13/2017,2,0:15,0:30,36.08,,0,36.08,36.08,1,-64471,40664,105135,-23807,0,0,5178,0,0,,5178,5178
7,02/13/2017,3,0:30,0:45,36.08,32.98,0,32.98,32.98,-1,-51092,46179,97271,-4913,0,-1638,38,0,0,,1676,-1600
7,02/13/2017,4,0:45,1:00,,30.34,0,30.34,30.34,-1,-55923,61416,117339,5493,0,-17987,0,0,0,,17987,-17987
7,02/13/2017,5,1:00,1:15,,35.02,0,35.02,35.02,-1,-42603,79585,122188,36982,0,-10865,0,0,0,,10865,-10865
7,02/13/2017,6,1:15,1:30,,29.31,0,29.31,29.31,-1,-45783,61522,107305,15739,0,-6700,0,0,0,,6700,-6700
7,02/13/2017,7,1:30,1:45,,29.31,0,29.31,29.31,-1,-53549,54156,107705,607,0,-11409,0,0,0,,11409,-11409
7,02/13/2017,8,1:45,2:00,,,0,34.3,34.3,0,-54876,42447,97323,-12429,0,-11,0,0,0,,11,-11
7,02/13/2017,9,2:00,2:15,,28.81,0,28.81,28.81,-1,-43233,76606,119839,33373,0,-17249,0,0,0,,17249,-17249
7,02/13/2017,10,2:15,2:30,,28.81,0,28.81,28.81,-1,-38279,64882,103161,26603,0,-41543,0,0,0,,41543,-41543
7,02/13/2017,11,2:30,2:45,,31.34,0,31.34,31.34,-1,-42268,53578,95846,11310,0,-25162,0,0,0,,25162,-25162
7,02/13/2017,12,2:45,3:00,,17.54,0,17.54,17.54,-1,-43177,96946,140123,53769,0,-21830,0,0,0,,21830,-21830
7,02/13/2017,13,3:00,3:15,,16.67,0,16.67,16.67,-1,-47554,59799,107353,12245,0,-28579,0,0,0,,28579,-28579
7,02/13/2017,14,3:15,3:30,,24.74,0,24.74,24.74,-1,-37531,69478,107009,31947,0,-5981,0,0,0,,5981,-5981
7,02/13/2017,15,3:30,3:45,,13.29,0,13.29,13.29,-1,-40370,59431,99801,19061,0,-27522,0,0,0,,27522,-27522
7,02/13/2017,16,3:45,4:00,,30.34,0,30.34,30.34,-1,-35385,61201,96586,25816,0,-11303,0,0,0,,11303,-11303
7,02/13/2017,17,4:00,4:15,,34.37,0,34.37,34.37,-1,-68084,36670,104754,-31414,0,-6283,0,0,0,,6283,-6283
7,02/13/2017,18,4:15,4:30,,31.34,0,31.34,31.34,-1,-43373,53184,96557,9811,0,-4394,0,0,0,,4394,-4394
7,02/13/2017,19,4:30,4:45,,31.34,0,31.34,31.34,-1,-36818,58129,94947,21311,0,-14550,0,0,0,,14550,-14550
7,02/13/2017,20,4:45,5:00,,17.19,0,17.19,17.19,-1,-25681,118960,144641,93279,0,-32277,0,0,0,,32277,-32277
7,02/13/2017,21,5:00,5:15,35.84,28.81,0,35.84,35.84,1,-108460,59199,167659,-49261,0,-30106,467,0,0,,30573,-29639
7,02/13/2017,22,5:15,5:30,37.34,28.81,0,37.34,37.34,1,-55037,52930,107967,-2107,0,-1021,1248,0,0,,2269,227
7,02/13/2017,23,5:30,5:45,,,0,33.14,33.14,0,-69087,31732,100819,-37355,0,0,0,0,0,,0,0
7,02/13/2017,24,5:45,6:00,40.76,,0,40.76,40.76,1,-69898,17507,87405,-52391,0,0,10264,0,0,,10264,10264
7,02/13/2017,25,6:00,6:15,39.51,35.64,0,35.64,35.64,-1,-89391,63839,153230,-25552,0,-98,8361,0,0,,8459,8263
7,02/13/2017,26,6:15,6:30,46,32.51,0,46,32.51,2,-56535,45894,102429,-10641,0,-6044,922,0,0,,6966,-5122
7,02/13/2017,27,6:30,6:45,188.51,32.51,0,188.51,188.51,1,-70367,15718,86085,-54649,0,-62,31248,0,0,,31310,31186
7,02/13/2017,28,6:45,7:00,188.51,,0,188.51,188.51,1,-127186,49692,176878,-77494,0,0,17619,0,0,,17619,17619
7,02/13/2017,29,7:00,7:15,43.89,12.79,0,12.79,12.79,-1,-39550,108170,147720,68620,0,-15194,9914,0,0,,25108,-5280
7,02/13/2017,30,7:15,7:30,38.04,31.15,0,38.04,38.04,1,-69374,36079,105453,-33295,0,-16938,135,0,0,,17073,-16803
7,02/13/2017,31,7:30,7:45,62.98,31.15,0,62.98,62.98,1,-157054,45032,202086,-112022,0,-132,9609,0,0,,9741,9477
7,02/13/2017,32,7:45,8:00,188.51,,0,188.51,188.51,1,-204137,30485,234622,-173652,0,0,61624,0,0,,61624,61624
7,02/13/2017,33,8:00,8:15,188.51,-1.5,0,-1.5,-1.5,-1,-35153,126287,161440,91134,0,-16534,24366,0,0,,40900,7832
7,02/13/2017,34,8:15,8:30,,32.51,0,32.51,32.51,-1,-67640,76632,144272,8992,0,-14895,0,0,0,,14895,-14895
7,02/13/2017,35,8:30,8:45,,36.35,0,36.35,36.35,-1,-73591,71870,145461,-1721,0,-5582,0,0,0,,5582,-5582
7,02/13/2017,36,8:45,9:00,53.95,36.35,0,53.95,53.95,1,-99775,93088,192863,-6687,0,-814,591,0,0,,1405,-223
7,02/13/2017,37,9:00,9:15,63.9,,0,63.9,63.9,1,-116167,33326,149493,-82841,0,0,5516,0,0,,5516,5516
7,02/13/2017,38,9:15,9:30,39.2,,0,39.2,39.2,1,-89864,22484,112348,-67380,0,0,4657,0,0,,4657,4657
7,02/13/2017,39,9:30,9:45,39.2,37.07,0,37.07,37.07,-1,-67656,50938,118594,-16718,0,-233,130,0,0,,363,-103
7,02/13/2017,40,9:45,10:00,,34.03,0,34.03,34.03,-1,-49540,50892,100432,1352,0,-5427,0,0,0,,5427,-5427
7,02/13/2017,41,10:00,10:15,37.71,34.03,0,37.71,37.71,1,-46090,27579,73669,-18511,0,-45,1109,0,0,,1154,1064
7,02/13/2017,42,10:15,10:30,35.51,35.84,0,35.84,35.84,-1,-29485,30817,60302,1332,0,-1068,645,0,0,,1713,-423
7,02/13/2017,43,10:30,10:45,,34,0,34,34,-1,-21122,45070,66192,23948,0,-5518,0,0,0,,5518,-5518
7,02/13/2017,44,10:45,11:00,,28.51,0,28.51,28.51,-1,-18466,62723,81189,44257,0,-40762,0,0,0,,40762,-40762
7,02/13/2017,45,11:00,11:15,137.02,28.51,0,137.02,28.51,2,-60014,51551,111565,-8463,0,-48643,2109,0,0,,50752,-46534
7,02/13/2017,46,11:15,11:30,45.51,28.51,0,45.51,45.51,1,-130508,99661,230169,-30847,0,-5080,4800,0,0,,9880,-280
7,02/13/2017,47,11:30,11:45,,,0,36.6,36.6,0,-135380,135687,271067,307,0,0,7,0,0,,7,7
7,02/13/2017,48,11:45,12:00,,31.33,0,31.33,31.33,-1,-124192,138610,262802,14418,0,-5164,0,0,0,,5164,-5164
7,02/13/2017,49,12:00,12:15,,21.89,0,21.89,21.89,-1,-36468,101279,137747,64811,0,-48917,0,0,0,,48917,-48917
7,02/13/2017,50,12:15,12:30,,-0.4,0,-0.4,-0.4,-1,-30968,96092,127060,65124,0,-36754,0,0,0,,36754,-36754
7,02/13/2017,51,12:30,12:45,,-32.02,0,-32.02,-32.02,-1,-50618,81160,131778,30542,0,-61442,0,0,0,,61442,-61442
7,02/13/2017,52,12:45,13:00,,-13.41,0,-13.41,-13.41,-1,-31324,88850,120174,57526,0,-27178,0,0,0,,27178,-27178
7,02/13/2017,53,13:00,13:15,,-31.76,0,-31.76,-31.76,-1,-46665,71338,118003,24673,0,-47495,0,0,0,,47495,-47495
7,02/13/2017,54,13:15,13:30,,18.8,0,18.8,18.8,-1,-29052,96527,125579,67475,0,-9940,0,0,0,,9940,-9940
7,02/13/2017,55,13:30,13:45,,17.53,0,17.53,17.53,-1,-22853,87837,110690,64984,0,-39598,0,0,0,,39598,-39598
7,02/13/2017,56,13:45,14:00,,13.15,0,13.15,13.15,-1,-23381,131727,155108,108346,0,-57486,0,0,0,,57486,-57486
7,02/13/2017,57,14:00,14:15,,24.74,0,24.74,24.74,-1,-59200,74945,134145,15745,0,-54066,0,0,0,,54066,-54066
7,02/13/2017,58,14:15,14:30,,28.51,0,28.51,28.51,-1,-40038,76652,116690,36614,0,-23497,0,0,0,,23497,-23497
7,02/13/2017,59,14:30,14:45,,23.99,0,23.99,23.99,-1,-37416,89335,126751,51919,0,-47838,0,0,0,,47838,-47838
7,02/13/2017,60,14:45,15:00,,30.74,0,30.74,30.74,-1,-35997,99693,135690,63696,0,-30434,0,0,0,,30434,-30434
7,02/13/2017,61,15:00,15:15,,33.51,0,33.51,33.51,-1,-59403,72195,131598,12792,0,-21161,0,0,0,,21161,-21161
7,02/13/2017,62,15:15,15:30,,33.51,0,33.51,33.51,-1,-51043,63524,114567,12481,0,-12155,0,0,0,,12155,-12155
7,02/13/2017,63,15:30,15:45,,35.44,0,35.44,35.44,-1,-57805,67336,125141,9531,0,-14035,0,0,0,,14035,-14035
7,02/13/2017,64,15:45,16:00,,39.63,0,39.63,39.63,-1,-59195,57832,117027,-1363,0,-3050,0,0,0,,3050,-3050
7,02/13/2017,65,16:00,16:15,,39.69,0,39.69,39.69,-1,-85849,30537,116386,-55312,0,-339,0,0,0,,339,-339
7,02/13/2017,66,16:15,16:30,44.17,,0,44.17,44.17,1,-96236,30231,126467,-66005,0,0,1049,0,0,,1049,1049
7,02/13/2017,67,16:30,16:45,55.17,,0,55.17,55.17,1,-111773,33558,145331,-78215,0,0,5778,0,0,,5778,5778
7,02/13/2017,68,16:45,17:00,38.91,,0,38.91,38.91,1,-105817,34640,140457,-71177,0,0,2968,0,0,,2968,2968
7,02/13/2017,69,17:00,17:15,38.91,34.4,0,34.4,34.4,-1,-61231,60753,121984,-478,0,-7086,154,0,0,,7240,-6932
7,02/13/2017,70,17:15,17:30,,39.63,0,39.63,39.63,-1,-70287,60504,130791,-9783,0,-1070,0,0,0,,1070,-1070
7,02/13/2017,71,17:30,17:45,,35.54,0,35.54,35.54,-1,-56136,47724,103860,-8412,0,-1181,0,0,0,,1181,-1181
7,02/13/2017,72,17:45,18:00,43.2,,0,43.2,43.2,1,-69735,63937,133672,-5798,0,0,560,0,0,,560,560
7,02/13/2017,73,18:00,18:15,44.21,33.51,0,44.21,33.51,2,-103614,113452,217066,9838,0,-2133,1431,0,0,,3564,-702
7,02/13/2017,74,18:15,18:30,,33.51,0,33.51,33.51,-1,-82409,105449,187858,23040,0,-14393,0,0,0,,14393,-14393
7,02/13/2017,75,18:30,18:45,,32.51,0,32.51,32.51,-1,-71028,106367,177395,35339,0,-32836,0,0,0,,32836,-32836
7,02/13/2017,76,18:45,19:00,,24.74,0,24.74,24.74,-1,-55495,115713,171208,60218,0,-37161,0,0,0,,37161,-37161
7,02/13/2017,77,19:00,19:15,39.51,19.98,0,39.51,19.98,2,-51875,70944,122819,19069,0,-42434,196,0,0,,42630,-42238
7,02/13/2017,78,19:15,19:30,44.38,28.51,0,44.38,28.51,2,-40859,61232,102091,20373,0,-10704,2236,0,0,,12940,-8468
7,02/13/2017,79,19:30,19:45,,26.74,0,26.74,26.74,-1,-32668,78233,110901,45565,0,-40025,0,0,0,,40025,-40025
7,02/13/2017,80,19:45,20:00,,31.15,0,31.15,31.15,-1,-29701,66156,95857,36455,0,-33934,0,0,0,,33934,-33934
7,02/13/2017,81,20:00,20:15,,20.68,0,20.68,20.68,-1,-25351,100922,126273,75571,0,-49205,0,0,0,,49205,-49205
7,02/13/2017,82,20:15,20:30,37.65,36.27,0,37.65,36.27,2,-71000,70043,141043,-957,0,-8947,279,0,0,,9226,-8668
7,02/13/2017,83,20:30,20:45,,24.55,0,24.55,24.55,-1,-29942,74829,104771,44887,0,-34044,0,0,0,,34044,-34044
7,02/13/2017,84,20:45,21:00,,31.03,0,31.03,31.03,-1,-61904,76335,138239,14431,0,-28482,0,0,0,,28482,-28482
7,02/13/2017,85,21:00,21:15,35.51,39.69,0,35.51,35.43,2,-59993,47561,107554,-12432,0,-1243,425,0,0,,1668,-818
7,02/13/2017,86,21:15,21:30,,33.72,0,33.72,33.72,-1,-33740,47826,81566,14086,0,-8260,0,0,0,,8260,-8260
7,02/13/2017,87,21:30,21:45,,32.2,0,32.2,32.2,-1,-40298,69013,109311,28715,0,-21528,0,0,0,,21528,-21528
7,02/13/2017,88,21:45,22:00,,28.51,0,28.51,28.51,-1,-45332,103640,148972,58308,0,-27085,0,0,0,,27085,-27085
7,02/13/2017,89,22:00,22:15,,28.51,0,28.51,28.51,-1,-69674,63566,133240,-6108,0,-23677,0,0,0,,23677,-23677
7,02/13/2017,90,22:15,22:30,37.65,28.51,0,37.65,37.65,1,-57170,53348,110518,-3822,0,-1315,1741,0,0,,3056,426
7,02/13/2017,91,22:30,22:45,31.14,39.57,0,39.57,39.57,-1,-41376,53540,94916,12164,0,-79,230,0,0,,309,151
7,02/13/2017,92,22:45,23:00,,30.78,0,30.78,30.78,-1,-39207,71964,111171,32757,0,-9198,0,0,0,,9198,-9198
7,02/13/2017,93,23:00,23:15,32.08,28.51,0,32.08,32.08,1,-67917,66349,134266,-1568,0,-14250,32,0,0,,14282,-14218
7,02/13/2017,94,23:15,23:30,32.08,29.87,0,35.69,29.87,2,-48041,67662,115703,19621,0,-3432,176,0,0,,3608,-3256
7,02/13/2017,95,23:30,23:45,,26.74,0,26.74,26.74,-1,-43657,84805,128462,41148,0,-38010,0,0,0,,38010,-38010
7,02/13/2017,96,23:45,0:00,,28.51,0,28.51,28.51,-1,-47271,91893,139164,44622,0,-34824,0,0,0,,34824,-34824
7,02/14/2017,1,0:00,0:15,38.04,26.34,0,38.04,26.34,2,-75830,39172,115002,-36658,0,-3409,2829,0,0,,6238,-580
7,02/14/2017,2,0:15,0:30,,,0,34.28,34.28,0,-62243,43517,105760,-18726,0,-179,302,0,0,,481,123
7,02/14/2017,3,0:30,0:45,,37.15,0,37.15,37.15,-1,-70681,44580,115261,-26101,0,-305,0,0,0,,305,-305
7,02/14/2017,4,0:45,1:00,,,0,34.28,34.28,0,-60292,36543,96835,-23749,0,0,0,0,0,,0,0
7,02/14/2017,5,1:00,1:15,37.1,37.21,0,37.1,34.28,2,-64301,28121,92422,-36180,0,-43,1693,0,0,,1736,1650
7,02/14/2017,6,1:15,1:30,43.34,,0,43.34,43.34,1,-65657,24034,89691,-41623,0,0,24403,0,0,,24403,24403
7,02/14/2017,7,1:30,1:45,34.12,,0,34.12,34.12,1,-41430,26182,67612,-15248,0,0,7676,0,0,,7676,7676
7,02/14/2017,8,1:45,2:00,32.55,,0,32.55,32.55,1,-41026,34480,75506,-6546,0,0,1750,0,0,,1750,1750
7,02/14/2017,9,2:00,2:15,33.34,,0,33.34,33.34,1,-51741,31239,82980,-20502,0,0,388,0,0,,388,388
7,02/14/2017,10,2:15,2:30,32.16,,0,32.16,32.16,1,-44547,35189,79736,-9358,0,0,852,0,0,,852,852
7,02/14/2017,11,2:30,2:45,31.34,,0,31.34,31.34,1,-46532,25736,72268,-20796,0,0,56,0,0,,56,56
7,02/14/2017,12,2:45,3:00,,,0,34.28,34.28,0,-51713,31946,83659,-19767,0,0,0,0,0,,0,0
7,02/14/2017,13,3:00,3:15,35.91,,0,35.91,35.91,1,-52538,38256,90794,-14282,0,0,2851,0,0,,2851,2851
7,02/14/2017,14,3:15,3:30,35.51,,0,35.51,35.51,1,-50439,34889,85328,-15550,0,0,676,0,0,,676,676
7,02/14/2017,15,3:30,3:45,35.51,,0,35.51,35.51,1,-45604,32194,77798,-13410,0,0,1549,0,0,,1549,1549
7,02/14/2017,16,3:45,4:00,35.51,34.53,0,34.53,34.53,-1,-42135,45294,87429,3159,0,-704,45,0,0,,749,-659
7,02/14/2017,17,4:00,4:15,,34.71,0,34.71,34.71,-1,-57706,48170,105876,-9536,0,-182,0,0,0,,182,-182
7,02/14/2017,18,4:15,4:30,,34.41,0,34.41,34.41,-1,-48408,57936,106344,9528,0,-3126,0,0,0,,3126,-3126
7,02/14/2017,19,4:30,4:45,,31.34,0,31.34,31.34,-1,-38341,62455,100796,24114,0,-5173,0,0,0,,5173,-5173
7,02/14/2017,20,4:45,5:00,,37.21,0,37.21,37.21,-1,-50330,55451,105781,5121,0,-1412,0,0,0,,1412,-1412
7,02/14/2017,21,5:00,5:15,,30.22,0,30.22,30.22,-1,-51607,77160,128767,25553,0,-3308,0,0,0,,3308,-3308
7,02/14/2017,22,5:15,5:30,,25.4,0,25.4,25.4,-1,-30807,71200,102007,40393,0,-35097,0,0,0,,35097,-35097
7,02/14/2017,23,5:30,5:45,30.4,31.43,0,30.4,30.4,1,-39553,66709,106262,27156,0,-22741,2,0,0,,22743,-22739
7,02/14/2017,24,5:45,6:00,45.4,31.43,0,45.4,45.4,1,-90075,55202,145277,-34873,0,-2314,17611,0,0,,19925,15297
7,02/14/2017,25,6:00,6:15,30.43,-55.62,0,33.82,-55.62,2,-41346,133831,175177,92485,0,-31201,5157,0,0,,36358,-26044
7,02/14/2017,26,6:15,6:30,,32.4,0,32.4,32.4,-1,-63123,70150,133273,7027,0,-11416,0,0,0,,11416,-11416
7,02/14/2017,27,6:30,6:45,39.9,32.4,0,39.9,39.9,1,-97431,53470,150901,-43961,0,-363,3017,0,0,,3380,2654
7,02/14/2017,28,6:45,7:00,188.4,,0,188.4,188.4,1,-156405,97134,253539,-59271,0,0,41113,0,0,,41113,41113
7,02/14/2017,29,7:00,7:15,38.3,26.9,0,26.9,26.9,-1,-56275,91838,148113,35563,0,-4896,14879,0,0,,19775,9983
7,02/14/2017,30,7:15,7:30,44.38,28.4,0,44.38,44.38,1,-53541,38682,92223,-14859,0,-5140,2128,0,0,,7268,-3012
7,02/14/2017,31,7:30,7:45,44.38,,0,44.38,44.38,1,-108504,64980,173484,-43524,0,0,9958,0,0,,9958,9958
7,02/14/2017,32,7:45,8:00,37.85,,0,37.85,37.85,1,-162468,74397,236865,-88071,0,0,5144,0,0,,5144,5144
7,02/14/2017,33,8:00,8:15,35.35,29.11,0,47.76,29.11,2,-40818,75177,115995,34359,0,-7747,1677,0,0,,9424,-6070
7,02/14/2017,34,8:15,8:30,,34.47,0,34.47,34.47,-1,-52384,36081,88465,-16303,0,-3628,0,0,0,,3628,-3628
7,02/14/2017,35,8:30,8:45,45.7,,0,45.7,45.7,1,-71237,30602,101839,-40635,0,0,3211,0,0,,3211,3211
7,02/14/2017,36,8:45,9:00,56.7,,0,56.7,56.7,1,-101586,33896,135482,-67690,0,0,19349,0,0,,19349,19349
7,02/14/2017,37,9:00,9:15,35.51,,0,35.51,35.51,1,-54542,38325,92867,-16217,0,0,7084,0,0,,7084,7084
7,02/14/2017,38,9:15,9:30,54.07,,0,54.07,54.07,1,-71026,30664,101690,-40362,0,0,8734,0,0,,8734,8734
7,02/14/2017,39,9:30,9:45,35.51,,0,35.51,35.51,1,-84145,35905,120050,-48240,0,0,5083,0,0,,5083,5083
7,02/14/2017,40,9:45,10:00,35.35,,0,35.35,35.35,1,-82473,26205,108678,-56268,0,0,889,0,0,,889,889
7,02/14/2017,41,10:00,10:15,35.35,,0,35.35,35.35,1,-52778,51096,103874,-1682,0,0,58,0,0,,58,58
7,02/14/2017,42,10:15,10:30,,33.54,0,33.54,33.54,-1,-47345,52885,100230,5540,0,-558,0,0,0,,558,-558
7,02/14/2017,43,10:30,10:45,,26.48,0,26.48,26.48,-1,-33555,81481,115036,47926,0,-28410,0,0,0,,28410,-28410
7,02/14/2017,44,10:45,11:00,,30.01,0,30.01,30.01,-1,-38190,62750,100940,24560,0,-38298,0,0,0,,38298,-38298
7,02/14/2017,45,11:00,11:15,,33.76,0,33.76,33.76,-1,-32257,63854,96111,31597,0,-11117,0,0,0,,11117,-11117
7,02/14/2017,46,11:15,11:30,,33.4,0,33.4,33.4,-1,-36725,58740,95465,22015,0,-12120,0,0,0,,12120,-12120
7,02/14/2017,47,11:30,11:45,,32.4,0,32.4,32.4,-1,-30788,58852,89640,28064,0,-23377,0,0,0,,23377,-23377
7,02/14/2017,48,11:45,12:00,,30.85,0,30.85,30.85,-1,-30575,72013,102588,41438,0,-26928,0,0,0,,26928,-26928
7,02/14/2017,49,12:00,12:15,,32.4,0,32.4,32.4,-1,-32866,81830,114696,48964,0,-31152,0,0,0,,31152,-31152
7,02/14/2017,50,12:15,12:30,,29.93,0,29.93,29.93,-1,-35599,71676,107275,36077,0,-30516,0,0,0,,30516,-30516
7,02/14/2017,51,12:30,12:45,,26.9,0,26.9,26.9,-1,-32401,91885,124286,59484,0,-54242,0,0,0,,54242,-54242
7,02/14/2017,52,12:45,13:00,,16.5,0,16.5,16.5,-1,-27590,112931,140521,85341,0,-61495,0,0,0,,61495,-61495
7,02/14/2017,53,13:00,13:15,,16.5,0,16.5,16.5,-1,-29093,76754,105847,47661,0,-69739,0,0,0,,69739,-69739
7,02/14/2017,54,13:15,13:30,,32.51,0,32.51,32.51,-1,-28230,59540,87770,31310,0,-38667,0,0,0,,38667,-38667
7,02/14/2017,55,13:30,13:45,,,0,35.31,35.31,0,-26378,78409,104787,52031,0,-10543,0,0,0,,10543,-10543
7,02/14/2017,56,13:45,14:00,,33.14,0,33.14,33.14,-1,-27338,78454,105792,51116,0,-280,0,0,0,,280,-280
7,02/14/2017,57,14:00,14:15,,26.9,0,26.9,26.9,-1,-48923,101217,150140,52294,0,-29242,0,0,0,,29242,-29242
7,02/14/2017,58,14:15,14:30,,30.01,0,30.01,30.01,-1,-51539,101552,153091,50013,0,-41810,0,0,0,,41810,-41810
7,02/14/2017,59,14:30,14:45,,28.4,0,28.4,28.4,-1,-48308,96770,145078,48462,0,-50880,0,0,0,,50880,-50880
7,02/14/2017,60,14:45,15:00,,33.14,0,33.14,33.14,-1,-44613,83453,128066,38840,0,-32360,0,0,0,,32360,-32360
7,02/14/2017,61,15:00,15:15,,26.9,0,26.9,26.9,-1,-39616,65171,104787,25555,0,-15506,0,0,0,,15506,-15506
7,02/14/2017,62,15:15,15:30,,16.5,0,16.5,16.5,-1,-48017,62182,110199,14165,0,-33542,0,0,0,,33542,-33542
7,02/14/2017,63,15:30,15:45,36.43,16.5,0,36.43,36.43,1,-60195,40946,101141,-19249,0,-3904,720,0,0,,4624,-3184
7,02/14/2017,64,15:45,16:00,35.4,37.15,0,35.4,33.17,2,-72048,60695,132743,-11353,0,-10,943,0,0,,953,933
7,02/14/2017,65,16:00,16:15,,33.4,0,33.4,33.4,-1,-69738,45573,115311,-24165,0,-7341,0,0,0,,7341,-7341
7,02/14/2017,66,16:15,16:30,,,0,36.31,36.31,0,-49434,28459,77893,-20975,0,-540,0,0,0,,540,-540
7,02/14/2017,67,16:30,16:45,,,0,36.31,36.31,0,-56558,35629,92187,-20929,0,0,0,0,0,,0,0
7,02/14/2017,68,16:45,17:00,,37.21,0,37.21,37.21,-1,-70435,56436,126871,-13999,0,-85,0,0,0,,85,-85
7,02/14/2017,69,17:00,17:15,,37.21,0,37.21,37.21,-1,-87968,39813,127781,-48155,0,-197,0,0,0,,197,-197
7,02/14/2017,70,17:15,17:30,,,0,36.28,36.28,0,-85197,23548,108745,-61649,0,0,0,0,0,,0,0
7,02/14/2017,71,17:30,17:45,41.03,,0,41.03,41.03,1,-84812,37793,122605,-47019,0,0,366,0,0,,366,366
7,02/14/2017,72,17:45,18:00,77.21,,0,77.21,77.21,1,-87313,50401,137714,-36912,0,0,17892,0,0,,17892,17892
7,02/14/2017,73,18:00,18:15,39.42,31.43,0,31.43,31.43,-1,-44670,54122,98792,9452,0,-6102,7336,0,0,,13438,1234
7,02/14/2017,74,18:15,18:30,,35.01,0,35.01,35.01,-1,-49197,43638,92835,-5559,0,-4958,0,0,0,,4958,-4958
7,02/14/2017,75,18:30,18:45,,33.4,0,33.4,33.4,-1,-40748,40884,81632,136,0,-607,0,0,0,,607,-607
7,02/14/2017,76,18:45,19:00,,33.14,0,33.14,33.14,-1,-32789,39411,72200,6622,0,-6407,0,0,0,,6407,-6407
7,02/14/2017,77,19:00,19:15,,33.4,0,33.4,33.4,-1,-29556,38255,67811,8699,0,-6597,0,0,0,,6597,-6597
7,02/14/2017,78,19:15,19:30,,33.14,0,33.14,33.14,-1,-26556,41279,67835,14723,0,-10121,0,0,0,,10121,-10121
7,02/14/2017,79,19:30,19:45,,28.4,0,28.4,28.4,-1,-25704,66119,91823,40415,0,-27507,0,0,0,,27507,-27507
7,02/14/2017,80,19:45,20:00,,28.4,0,28.4,28.4,-1,-32710,69837,102547,37127,0,-46465,0,0,0,,46465,-46465
7,02/14/2017,81,20:00,20:15,,32.4,0,32.4,32.4,-1,-41579,72187,113766,30608,0,-25998,0,0,0,,25998,-25998
7,02/14/2017,82,20:15,20:30,,30.85,0,30.85,30.85,-1,-20472,54587,75059,34115,0,-29693,0,0,0,,29693,-29693
7,02/14/2017,83,20:30,20:45,,28.4,0,28.4,28.4,-1,-29341,67591,96932,38250,0,-38594,0,0,0,,38594,-38594
7,02/14/2017,84,20:45,21:00,,16.5,0,16.5,16.5,-1,-29582,89529,119111,59947,0,-48573,0,0,0,,48573,-48573
7,02/14/2017,85,21:00,21:15,78.97,-16.78,0,78.97,-16.78,2,-71250,51984,123234,-19266,0,-56760,481,0,0,,57241,-56279
7,02/14/2017,86,21:15,21:30,116.67,26.9,0,116.67,26.9,2,-48667,56927,105594,8260,0,-4952,5968,0,0,,10920,1016
7,02/14/2017,87,21:30,21:45,,16.5,0,16.5,16.5,-1,-50358,78159,128517,27801,0,-36534,0,0,0,,36534,-36534
7,02/14/2017,88,21:45,22:00,,16.5,0,16.5,16.5,-1,-61662,103207,164869,41545,0,-24263,0,0,0,,24263,-24263
7,02/14/2017,89,22:00,22:15,,-39.66,0,-39.66,-39.66,-1,-41087,73456,114543,32369,0,-50783,0,0,0,,50783,-50783
7,02/14/2017,90,22:15,22:30,,28.4,0,28.4,28.4,-1,-23927,56210,80137,32283,0,-14044,0,0,0,,14044,-14044
7,02/14/2017,91,22:30,22:45,,26.9,0,26.9,26.9,-1,-14912,73896,88808,58984,0,-55437,0,0,0,,55437,-55437
7,02/14/2017,92,22:45,23:00,,16.5,0,16.5,16.5,-1,-25411,108144,133555,82733,0,-71366,0,0,0,,71366,-71366
7,02/14/2017,93,23:00,23:15,,1.94,0,1.94,1.94,-1,-31334,69478,100812,38144,0,-67852,0,0,0,,67852,-67852
7,02/14/2017,94,23:15,23:30,,-16.78,0,-16.78,-16.78,-1,-30102,91082,121184,60980,0,-21999,0,0,0,,21999,-21999
7,02/14/2017,95,23:30,23:45,,-16.78,0,-16.78,-16.78,-1,-27972,101287,129259,73315,0,-75113,0,0,0,,75113,-75113
7,02/14/2017,96,23:45,0:00,,26.08,0,26.08,26.08,-1,-37634,120999,158633,83365,0,-64415,0,0,0,,64415,-64415
7,02/15/2017,1,0:00,0:15,36.02,26.08,0,36.02,36.02,1,-74496,39061,113557,-35435,0,-22552,856,0,0,,23408,-21696
7,02/15/2017,2,0:15,0:30,36.02,31.05,0,31.05,31.05,-1,-30763,54703,85466,23940,0,-17469,8,0,0,,17477,-17461
7,02/15/2017,3,0:30,0:45,,32.16,0,32.16,32.16,-1,-38268,67666,105934,29398,0,-32407,0,0,0,,32407,-32407
7,02/15/2017,4,0:45,1:00,,28.24,0,28.24,28.24,-1,-39447,97614,137061,58167,0,-42379,0,0,0,,42379,-42379
7,02/15/2017,5,1:00,1:15,35.32,33.27,0,35.32,33.27,2,-50994,29114,80108,-21880,0,-17079,851,0,0,,17930,-16228
7,02/15/2017,6,1:15,1:30,35.32,32.97,0,32.97,32.97,-1,-27708,33955,61663,6247,0,-1635,84,0,0,,1719,-1551
7,02/15/2017,7,1:30,1:45,,32.97,0,32.97,32.97,-1,-27539,54082,81621,26543,0,-10403,0,0,0,,10403,-10403
7,02/15/2017,8,1:45,2:00,,30.99,0,30.99,30.99,-1,-29644,62013,91657,32369,0,-27460,0,0,0,,27460,-27460
7,02/15/2017,9,2:00,2:15,,30.99,0,30.99,30.99,-1,-19201,58665,77866,39464,0,-22485,0,0,0,,22485,-22485
7,02/15/2017,10,2:15,2:30,,30.99,0,30.99,30.99,-1,-22338,60265,82603,37927,0,-2808,0,0,0,,2808,-2808
7,02/15/2017,11,2:30,2:45,,30.99,0,30.99,30.99,-1,-29224,71440,100664,42216,0,-11742,0,0,0,,11742,-11742
7,02/15/2017,12,2:45,3:00,,30.03,0,30.03,30.03,-1,-30301,69535,99836,39234,0,-29340,0,0,0,,29340,-29340
7,02/15/2017,13,3:00,3:15,34.97,31.97,0,34.97,34.97,1,-36885,34506,71391,-2379,0,-17374,358,0,0,,17732,-17016
7,02/15/2017,14,3:15,3:30,34.97,33.64,0,33.64,33.64,-1,-28035,34578,62613,6543,0,-735,49,0,0,,784,-686
7,02/15/2017,15,3:30,3:45,,32.97,0,32.97,32.97,-1,-29903,34887,64790,4984,0,-6270,0,0,0,,6270,-6270
7,02/15/2017,16,3:45,4:00,,33.75,0,33.75,33.75,-1,-33581,37492,71073,3911,0,-4454,0,0,0,,4454,-4454
7,02/15/2017,17,4:00,4:15,,33.75,0,33.75,33.75,-1,-43721,36114,79835,-7607,0,-2951,0,0,0,,2951,-2951
7,02/15/2017,18,4:15,4:30,,35.98,0,35.98,35.98,-1,-40097,37206,77303,-2891,0,-248,0,0,0,,248,-248
7,02/15/2017,19,4:30,4:45,,35.32,0,35.32,35.32,-1,-44943,34141,79084,-10802,0,-2291,0,0,0,,2291,-2291
7,02/15/2017,20,4:45,5:00,,35.21,0,35.21,35.21,-1,-43434,32205,75639,-11229,0,-311,0,0,0,,311,-311
7,02/15/2017,21,5:00,5:15,,26.68,0,26.68,26.68,-1,-39446,70412,109858,30966,0,-23122,0,0,0,,23122,-23122
7,02/15/2017,22,5:15,5:30,,31.62,0,31.62,31.62,-1,-29824,61418,91242,31594,0,-27820,0,0,0,,27820,-27820
7,02/15/2017,23,5:30,5:45,,35.75,0,35.75,35.75,-1,-31101,37948,69049,6847,0,-9090,0,0,0,,9090,-9090
7,02/15/2017,24,5:45,6:00,,32.16,0,32.16,32.16,-1,-32223,54584,86807,22361,0,-4802,0,0,0,,4802,-4802
7,02/15/2017,25,6:00,6:15,,27.14,0,27.14,27.14,-1,-106203,97325,203528,-8878,0,-3467,0,0,0,,3467,-3467
7,02/15/2017,26,6:15,6:30,,-17.76,0,-17.76,-17.76,-1,-42927,98687,141614,55760,0,-46668,0,0,0,,46668,-46668
7,02/15/2017,27,6:30,6:45,38.52,33.03,0,38.52,33.03,2,-78856,58748,137604,-20108,0,-4719,2466,0,0,,7185,-2253
7,02/15/2017,28,6:45,7:00,66.02,,0,66.02,66.02,1,-115934,74861,190795,-41073,0,0,4342,0,0,,4342,4342
7,02/15/2017,29,7:00,7:15,83.01,-40.64,0,83.01,-40.64,2,-15370,138242,153612,122872,0,-19093,5561,0,0,,24654,-13532
7,02/15/2017,30,7:15,7:30,,33.72,0,33.72,33.72,-1,-52215,40112,92327,-12103,0,-1442,0,0,0,,1442,-1442
7,02/15/2017,31,7:30,7:45,39.27,,0,39.27,39.27,1,-84756,52369,137125,-32387,0,0,806,0,0,,806,806
7,02/15/2017,32,7:45,8:00,79.06,,0,79.06,79.06,1,-139593,58046,197639,-81547,0,0,22799,0,0,,22799,22799
7,02/15/2017,33,8:00,8:15,37.02,32.16,0,37.02,32.16,2,-43912,72785,116697,28873,0,-2412,8205,0,0,,10617,5793
7,02/15/2017,34,8:15,8:30,,,0,35.28,35.28,0,-56794,50979,107773,-5815,0,-4,0,0,0,,4,-4
7,02/15/2017,35,8:30,8:45,,,0,35.3,35.3,0,-50796,31878,82674,-18918,0,0,0,0,0,,0,0
7,02/15/2017,36,8:45,9:00,,,0,35.26,35.26,0,-73716,41991,115707,-31725,0,0,0,0,0,,0,0
7,02/15/2017,37,9:00,9:15,,,0,35.77,35.77,0,-80016,49534,129550,-30482,0,0,0,0,0,,0,0
7,02/15/2017,38,9:15,9:30,35.46,,0,35.46,35.46,1,-72017,32057,104074,-39960,0,0,38,0,0,,38,38
7,02/15/2017,39,9:30,9:45,,,0,35.77,35.77,0,-71078,41384,112462,-29694,0,0,0,0,0,,0,0
7,02/15/2017,40,9:45,10:00,,,0,35.8,35.8,0,-64469,49862,114331,-14607,0,0,0,0,0,,0,0
7,02/15/2017,41,10:00,10:15,,35.32,0,35.32,35.32,-1,-66847,50259,117106,-16588,0,-29,0,0,0,,29,-29
7,02/15/2017,42,10:15,10:30,,32.16,0,32.16,32.16,-1,-58657,61510,120167,2853,0,-1808,0,0,0,,1808,-1808
7,02/15/2017,43,10:30,10:45,,32.16,0,32.16,32.16,-1,-44600,61182,105782,16582,0,-4139,0,0,0,,4139,-4139
7,02/15/2017,44,10:45,11:00,,31.14,0,31.14,31.14,-1,-49753,81293,131046,31540,0,-14353,0,0,0,,14353,-14353
7,02/15/2017,45,11:00,11:15,,24.91,0,24.91,24.91,-1,-27118,113427,140545,86309,0,-46282,0,0,0,,46282,-46282
7,02/15/2017,46,11:15,11:30,,27.27,0,27.27,27.27,-1,-32903,98034,130937,65131,0,-59429,0,0,0,,59429,-59429
7,02/15/2017,47,11:30,11:45,,25.92,0,25.92,25.92,-1,-19882,105163,125045,85281,0,-58581,0,0,0,,58581,-58581
7,02/15/2017,48,11:45,12:00,,20.19,0,20.19,20.19,-1,-19579,106318,125897,86739,0,-71169,0,0,0,,71169,-71169
7,02/15/2017,49,12:00,12:15,,25.07,0,25.07,25.07,-1,-18413,112008,130421,93595,0,-74042,0,0,0,,74042,-74042
7,02/15/2017,50,12:15,12:30,,13.35,0,13.35,13.35,-1,-14605,117580,132185,102975,0,-96473,0,0,0,,96473,-96473
7,02/15/2017,51,12:30,12:45,,11.92,0,11.92,11.92,-1,-22402,99359,121761,76957,0,-98010,0,0,0,,98010,-98010
7,02/15/2017,52,12:45,13:00,,25.07,0,25.07,25.07,-1,-29987,110566,140553,80579,0,-79858,0,0,0,,79858,-79858
7,02/15/2017,53,13:00,13:15,35.92,25.07,0,35.92,35.92,1,-84067,69546,153613,-14521,0,-30831,503,0,0,,31334,-30328
7,02/15/2017,54,13:15,13:30,35.92,32.14,0,32.14,32.14,-1,-74696,91202,165898,16506,0,-2194,44,0,0,,2238,-2150
7,02/15/2017,55,13:30,13:45,,31.14,0,31.14,31.14,-1,-66380,85025,151405,18645,0,-21907,0,0,0,,21907,-21907
7,02/15/2017,56,13:45,14:00,,30.29,0,30.29,30.29,-1,-49546,77353,126899,27807,0,-21801,0,0,0,,21801,-21801
7,02/15/2017,57,14:00,14:15,,29.99,0,29.99,29.99,-1,-68270,79117,147387,10847,0,-28191,0,0,0,,28191,-28191
7,02/15/2017,58,14:15,14:30,,30.99,0,30.99,30.99,-1,-60169,74715,134884,14546,0,-31175,0,0,0,,31175,-31175
7,02/15/2017,59,14:30,14:45,,31.14,0,31.14,31.14,-1,-56188,73853,130041,17665,0,-17272,0,0,0,,17272,-17272
7,02/15/2017,60,14:45,15:00,,27.14,0,27.14,27.14,-1,-46813,84879,131692,38066,0,-46436,0,0,0,,46436,-46436
7,02/15/2017,61,15:00,15:15,,34.03,0,34.03,34.03,-1,-65100,64694,129794,-406,0,-12965,0,0,0,,12965,-12965
7,02/15/2017,62,15:15,15:30,,33.52,0,33.52,33.52,-1,-60990,51814,112804,-9176,0,-2909,0,0,0,,2909,-2909
7,02/15/2017,63,15:30,15:45,,36.14,0,36.14,36.14,-1,-69826,42741,112567,-27085,0,-250,0,0,0,,250,-250
7,02/15/2017,64,15:45,16:00,,36.14,0,36.14,36.14,-1,-85696,46746,132442,-38950,0,-40,0,0,0,,40,-40
7,02/15/2017,65,16:00,16:15,,,0,35.14,35.14,0,-88423,33510,121933,-54913,0,0,0,0,0,,0,0
7,02/15/2017,66,16:15,16:30,,,0,35.14,35.14,0,-72244,46042,118286,-26202,0,0,0,0,0,,0,0
7,02/15/2017,67,16:30,16:45,,36.08,0,36.08,36.08,-1,-61963,59404,121367,-2559,0,-193,0,0,0,,193,-193
7,02/15/2017,68,16:45,17:00,,35.75,0,35.75,35.75,-1,-70499,68887,139386,-1612,0,-1589,0,0,0,,1589,-1589
7,02/15/2017,69,17:00,17:15,,35.52,0,35.52,35.52,-1,-111143,88740,199883,-22403,0,-2441,0,0,0,,2441,-2441
7,02/15/2017,70,17:15,17:30,,36.14,0,36.14,36.14,-1,-109095,82997,192092,-26098,0,-486,0,0,0,,486,-486
7,02/15/2017,71,17:30,17:45,37.05,34.59,0,37.05,34.59,2,-88567,74740,163307,-13827,0,-607,93,0,0,,700,-514
7,02/15/2017,72,17:45,18:00,38.27,,0,38.27,38.27,1,-99696,76813,176509,-22883,0,0,3130,0,0,,3130,3130
7,02/15/2017,73,18:00,18:15,35.46,,0,35.46,35.46,1,-118423,18471,136894,-99952,0,0,1040,0,0,,1040,1040
7,02/15/2017,74,18:15,18:30,160.04,,0,160.04,160.04,1,-127066,15838,142904,-111228,0,0,25638,0,0,,25638,25638
7,02/15/2017,75,18:30,18:45,160.04,,0,160.04,160.04,1,-110653,68234,178887,-42419,0,0,64969,0,0,,64969,64969
7,02/15/2017,76,18:45,19:00,38.39,,0,38.39,38.39,1,-79408,94642,174050,15234,0,0,5839,0,0,,5839,5839
7,02/15/2017,77,19:00,19:15,38.39,15.52,0,15.52,15.52,-1,-25137,64432,89569,39295,0,-14320,347,0,0,,14667,-13973
7,02/15/2017,78,19:15,19:30,,15.52,0,15.52,15.52,-1,-55615,68605,124220,12990,0,-34979,0,0,0,,34979,-34979
7,02/15/2017,79,19:30,19:45,,15.52,0,15.52,15.52,-1,-44854,96786,141640,51932,0,-36729,0,0,0,,36729,-36729
7,02/15/2017,80,19:45,20:00,,15.52,0,15.52,15.52,-1,-66979,75543,142522,8564,0,-38742,0,0,0,,38742,-38742
7,02/15/2017,81,20:00,20:15,41.09,34.59,0,41.09,41.09,1,-102073,78392,180465,-23681,0,-5307,6397,0,0,,11704,1090
7,02/15/2017,82,20:15,20:30,35.41,14.25,0,14.25,14.25,-1,-61129,90911,152040,29782,0,-10935,6929,0,0,,17864,-4006
7,02/15/2017,83,20:30,20:45,,14.25,0,14.25,14.25,-1,-47206,90116,137322,42910,0,-48642,0,0,0,,48642,-48642
7,02/15/2017,84,20:45,21:00,,25.07,0,25.07,25.07,-1,-53019,94839,147858,41820,0,-36778,0,0,0,,36778,-36778
7,02/15/2017,85,21:00,21:15,35.92,-51.62,0,35.92,-51.62,2,-74069,99621,173690,25552,0,-52153,189,0,0,,52342,-51964
7,02/15/2017,86,21:15,21:30,37.29,24.85,0,37.29,24.85,2,-50816,82842,133658,32026,0,-8901,2191,0,0,,11092,-6710
7,02/15/2017,87,21:30,21:45,,-20.39,0,-20.39,-20.39,-1,-43219,84699,127918,41480,0,-46354,0,0,0,,46354,-46354
7,02/15/2017,88,21:45,22:00,,24.85,0,24.85,24.85,-1,-33219,96632,129851,63413,0,-43679,0,0,0,,43679,-43679
7,02/15/2017,89,22:00,22:15,,13.93,0,13.93,13.93,-1,-43632,88008,131640,44376,0,-63738,0,0,0,,63738,-63738
7,02/15/2017,90,22:15,22:30,,32.14,0,32.14,32.14,-1,-60122,64898,125020,4776,0,-9444,0,0,0,,9444,-9444
7,02/15/2017,91,22:30,22:45,,27.14,0,27.14,27.14,-1,-31001,89126,120127,58125,0,-36184,0,0,0,,36184,-36184
7,02/15/2017,92,22:45,23:00,,13.93,0,13.93,13.93,-1,-35945,128350,164295,92405,0,-84013,0,0,0,,84013,-84013
7,02/15/2017,93,23:00,23:15,,,0,33.77,33.77,0,-57919,71674,129593,13755,0,-41240,0,0,0,,41240,-41240
7,02/15/2017,94,23:15,23:30,,23.71,0,23.71,23.71,-1,-41566,79357,120923,37791,0,-16526,0,0,0,,16526,-16526
7,02/15/2017,95,23:30,23:45,,25.71,0,25.71,25.71,-1,-41699,93985,135684,52286,0,-47784,0,0,0,,47784,-47784
7,02/15/2017,96,23:45,0:00,,-10.03,0,-10.03,-10.03,-1,-37066,123678,160744,86612,0,-64759,0,0,0,,64759,-64759
7,02/16/2017,1,0:00,0:15,32.22,-18.05,0,33.61,-18.05,2,-81184,124068,205252,42884,0,-65790,13,0,0,,65803,-65777
7,02/16/2017,2,0:15,0:30,35.56,16.73,0,35.56,16.73,2,-64621,90185,154806,25564,0,-10782,1159,0,0,,11941,-9623
7,02/16/2017,3,0:30,0:45,,2.78,0,2.78,2.78,-1,-51561,72682,124243,21121,0,-36975,0,0,0,,36975,-36975
7,02/16/2017,4,0:45,1:00,,30.73,0,30.73,30.73,-1,-71984,83053,155037,11069,0,-18356,0,0,0,,18356,-18356
7,02/16/2017,5,1:00,1:15,,29.87,0,29.87,29.87,-1,-53561,77928,131489,24367,0,-24725,0,0,0,,24725,-24725
7,02/16/2017,6,1:15,1:30,,28.09,0,28.09,28.09,-1,-50789,87142,137931,36353,0,-34222,0,0,0,,34222,-34222
7,02/16/2017,7,1:30,1:45,,29.93,0,29.93,29.93,-1,-52277,84017,136294,31740,0,-32882,0,0,0,,32882,-32882
7,02/16/2017,8,1:45,2:00,,29.26,0,29.26,29.26,-1,-50897,92808,143705,41911,0,-29411,0,0,0,,29411,-29411
7,02/16/2017,9,2:00,2:15,,26.9,0,26.9,26.9,-1,-46946,95831,142777,48885,0,-42729,0,0,0,,42729,-42729
7,02/16/2017,10,2:15,2:30,,26.9,0,26.9,26.9,-1,-45715,96515,142230,50800,0,-54560,0,0,0,,54560,-54560
7,02/16/2017,11,2:30,2:45,,28.53,0,28.53,28.53,-1,-53096,98815,151911,45719,0,-48595,0,0,0,,48595,-48595
7,02/16/2017,12,2:45,3:00,,16.5,0,16.5,16.5,-1,-38390,96254,134644,57864,0,-56974,0,0,0,,56974,-56974
7,02/16/2017,13,3:00,3:15,,26.74,0,26.74,26.74,-1,-47489,83756,131245,36267,0,-29087,0,0,0,,29087,-29087
7,02/16/2017,14,3:15,3:30,,29.14,0,29.14,29.14,-1,-35060,105568,140628,70508,0,-2082,0,0,0,,2082,-2082
7,02/16/2017,15,3:30,3:45,,29.14,0,29.14,29.14,-1,-31846,107556,139402,75710,0,-3406,0,0,0,,3406,-3406
7,02/16/2017,16,3:45,4:00,,28.13,0,28.13,28.13,-1,-29290,115105,144395,85815,0,-7232,0,0,0,,7232,-7232
7,02/16/2017,17,4:00,4:15,,-16.78,0,-16.78,-16.78,-1,-26975,110991,137966,84016,0,-64009,0,0,0,,64009,-64009
7,02/16/2017,18,4:15,4:30,,20.72,0,20.72,20.72,-1,-24634,98838,123472,74204,0,-75361,0,0,0,,75361,-75361
7,02/16/2017,19,4:30,4:45,,19.58,0,19.58,19.58,-1,-31274,107018,138292,75744,0,-76275,0,0,0,,76275,-76275
7,02/16/2017,20,4:45,5:00,,-6.78,0,-6.78,-6.78,-1,-38099,111256,149355,73157,0,-78606,0,0,0,,78606,-78606
7,02/16/2017,21,5:00,5:15,,10.58,0,10.58,10.58,-1,-54361,174842,229203,120481,0,-75966,0,0,0,,75966,-75966
7,02/16/2017,22,5:15,5:30,,10.58,0,10.58,10.58,-1,-36094,141535,177629,105441,0,-78181,0,0,0,,78181,-78181
7,02/16/2017,23,5:30,5:45,,30.9,0,30.9,30.9,-1,-36112,129419,165531,93307,0,-31442,0,0,0,,31442,-31442
7,02/16/2017,24,5:45,6:00,,34.93,0,34.93,34.93,-1,-46616,108447,155063,61831,0,-7734,0,0,0,,7734,-7734
7,02/16/2017,25,6:00,6:15,,10.83,0,10.83,10.83,-1,-115786,157424,273210,41638,0,-6178,0,0,0,,6178,-6178
7,02/16/2017,26,6:15,6:30,,-51.33,0,-51.33,-51.33,-1,-33637,132216,165853,98579,0,-65826,0,0,0,,65826,-65826
7,02/16/2017,27,6:30,6:45,,19.07,0,19.07,19.07,-1,-56370,141546,197916,85176,0,-63879,0,0,0,,63879,-63879
7,02/16/2017,28,6:45,7:00,,26.4,0,26.4,26.4,-1,-106502,164644,271146,58142,0,-67843,0,0,0,,67843,-67843
7,02/16/2017,29,7:00,7:15,,24.31,0,24.31,24.31,-1,-94225,135619,229844,41394,0,-31360,0,0,0,,31360,-31360
7,02/16/2017,30,7:15,7:30,,20.23,0,20.23,20.23,-1,-61788,96877,158665,35089,0,-40843,0,0,0,,40843,-40843
7,02/16/2017,31,7:30,7:45,34.57,32.53,0,34.57,34.57,1,-84676,79938,164614,-4738,0,-17839,425,0,0,,18264,-17414
7,02/16/2017,32,7:45,8:00,34.65,32.53,0,34.65,34.65,1,-128769,81833,210602,-46936,0,-182,2226,0,0,,2408,2044
7,02/16/2017,33,8:00,8:15,34.65,,0,34.65,34.65,1,-76686,97154,173840,20468,0,0,1802,0,0,,1802,1802
7,02/16/2017,34,8:15,8:30,33.77,,0,33.77,33.77,1,-73149,69289,142438,-3860,0,0,184,0,0,,184,184
7,02/16/2017,35,8:30,8:45,40.91,,0,40.91,40.91,1,-79015,29429,108444,-49586,0,0,14864,0,0,,14864,14864
7,02/16/2017,36,8:45,9:00,34.84,,0,34.84,34.84,1,-92922,37543,130465,-55379,0,0,14763,0,0,,14763,14763
7,02/16/2017,37,9:00,9:15,33.4,30.4,0,30.4,30.4,-1,-45522,76984,122506,31462,0,-6536,4956,0,0,,11492,-1580
7,02/16/2017,38,9:15,9:30,,29.11,0,29.11,29.11,-1,-46352,60723,107075,14371,0,-30749,0,0,0,,30749,-30749
7,02/16/2017,39,9:30,9:45,,31.4,0,31.4,31.4,-1,-44823,58194,103017,13371,0,-13071,0,0,0,,13071,-13071
7,02/16/2017,40,9:45,10:00,,31.4,0,31.4,31.4,-1,-49843,46541,96384,-3302,0,-20381,0,0,0,,20381,-20381
7,02/16/2017,41,10:00,10:15,39.15,34.82,0,39.15,33.36,2,-76787,49912,126699,-26875,0,-3856,1115,0,0,,4971,-2741
7,02/16/2017,42,10:15,10:30,37.4,34.82,0,37.4,37.4,1,-141968,36622,178590,-105346,0,-75,1380,0,0,,1455,1305
7,02/16/2017,43,10:30,10:45,36.54,,0,36.54,36.54,1,-138315,27480,165795,-110835,0,0,5632,0,0,,5632,5632
7,02/16/2017,44,10:45,11:00,136.12,,0,136.12,136.12,1,-175883,19980,195863,-155903,0,0,9285,0,0,,9285,9285
7,02/16/2017,45,11:00,11:15,136.12,,0,136.12,136.12,1,-185365,69838,255203,-115527,0,0,29552,0,0,,29552,29552
7,02/16/2017,46,11:15,11:30,40.98,,0,40.98,40.98,1,-165892,50882,216774,-115010,0,0,6384,0,0,,6384,6384
7,02/16/2017,47,11:30,11:45,54.12,,0,54.12,54.12,1,-174274,48509,222783,-125765,0,0,33926,0,0,,33926,33926
7,02/16/2017,48,11:45,12:00,39.95,,0,39.95,39.95,1,-178322,52572,230894,-125750,0,0,22088,0,0,,22088,22088
7,02/16/2017,49,12:00,12:15,66.12,,0,66.12,66.12,1,-154713,17967,172680,-136746,0,0,40248,0,0,,40248,40248
7,02/16/2017,50,12:15,12:30,34.98,,0,34.98,34.98,1,-127219,48396,175615,-78823,0,0,13169,0,0,,13169,13169
7,02/16/2017,51,12:30,12:45,36.12,,0,36.12,36.12,1,-111936,45977,157913,-65959,0,0,1358,0,0,,1358,1358
7,02/16/2017,52,12:45,13:00,,,0,33.59,33.59,0,-100907,48531,149438,-52376,0,0,466,0,0,,466,466
7,02/16/2017,53,13:00,13:15,,31.57,0,31.57,31.57,-1,-59734,99793,159527,40059,0,-1740,0,0,0,,1740,-1740
7,02/16/2017,54,13:15,13:30,,28.48,0,28.48,28.48,-1,-59900,90464,150364,30564,0,-32578,0,0,0,,32578,-32578
7,02/16/2017,55,13:30,13:45,,26.36,0,26.36,26.36,-1,-43168,96333,139501,53165,0,-38380,0,0,0,,38380,-38380
7,02/16/2017,56,13:45,14:00,,22.49,0,22.49,22.49,-1,-44831,110979,155810,66148,0,-68349,0,0,0,,68349,-68349
7,02/16/2017,57,14:00,14:15,,35.26,0,35.26,35.26,-1,-52173,84485,136658,32312,0,-21325,0,0,0,,21325,-21325
7,02/16/2017,58,14:15,14:30,,21.4,0,21.4,21.4,-1,-33397,112835,146232,79438,0,-32142,0,0,0,,32142,-32142
7,02/16/2017,59,14:30,14:45,,28.09,0,28.09,28.09,-1,-43687,100174,143861,56487,0,-60091,0,0,0,,60091,-60091
7,02/16/2017,60,14:45,15:00,,26.36,0,26.36,26.36,-1,-33909,106906,140815,72997,0,-54223,0,0,0,,54223,-54223
7,02/16/2017,61,15:00,15:15,,28.41,0,28.41,28.41,-1,-48405,53932,102337,5527,0,-31987,0,0,0,,31987,-31987
7,02/16/2017,62,15:15,15:30,35.71,28.41,0,35.71,35.71,1,-44979,49222,94201,4243,0,-41,101,0,0,,142,60
7,02/16/2017,63,15:30,15:45,37.21,,0,37.21,37.21,1,-73326,32797,106123,-40529,0,0,1067,0,0,,1067,1067
7,02/16/2017,64,15:45,16:00,49.26,,0,49.26,49.26,1,-76217,14386,90603,-61831,0,0,21051,0,0,,21051,21051
7,02/16/2017,65,16:00,16:15,56.71,,0,56.71,56.71,1,-92201,29645,121846,-62556,0,0,20745,0,0,,20745,20745
7,02/16/2017,66,16:15,16:30,44.1,,0,44.1,44.1,1,-101446,13965,115411,-87481,0,0,3869,0,0,,3869,3869
7,02/16/2017,67,16:30,16:45,41.95,,0,41.95,41.95,1,-95682,12108,107790,-83574,0,0,8343,0,0,,8343,8343
7,02/16/2017,68,16:45,17:00,45.71,,0,45.71,45.71,1,-119617,12686,132303,-106931,0,0,13940,0,0,,13940,13940
7,02/16/2017,69,17:00,17:15,39.3,,0,39.3,39.3,1,-74335,31612,105947,-42723,0,0,11447,0,0,,11447,11447
7,02/16/2017,70,17:15,17:30,,,0,37.54,37.54,0,-87461,26023,113484,-61438,0,0,128,0,0,,128,128
7,02/16/2017,71,17:30,17:45,,,0,37.54,37.54,0,-79221,32879,112100,-46342,0,0,0,0,0,,0,0
7,02/16/2017,72,17:45,18:00,129.14,,0,129.14,129.14,1,-91499,45685,137184,-45814,0,0,10717,0,0,,10717,10717
7,02/16/2017,73,18:00,18:15,37.46,,0,37.46,37.46,1,-116798,27907,144705,-88891,0,0,5251,0,0,,5251,5251
7,02/16/2017,74,18:15,18:30,250,,0,250,250,1,-109874,27834,137708,-82040,0,0,18883,0,0,,18883,18883
7,02/16/2017,75,18:30,18:45,250,,0,250,250,1,-77107,52971,130078,-24136,0,0,24963,0,0,,24963,24963
7,02/16/2017,76,18:45,19:00,33.59,,0,33.59,33.59,1,-67663,67937,135600,274,0,0,589,0,0,,589,589
7,02/16/2017,77,19:00,19:15,250,,0,250,250,1,-104777,28485,133262,-76292,0,0,17045,0,0,,17045,17045
7,02/16/2017,78,19:15,19:30,44.12,,0,44.12,44.12,1,-94351,50717,145068,-43634,0,0,11779,0,0,,11779,11779
7,02/16/2017,79,19:30,19:45,34.98,,0,34.98,34.98,1,-81939,51887,133826,-30052,0,0,2264,0,0,,2264,2264
7,02/16/2017,80,19:45,20:00,33.4,,0,33.4,33.4,1,-88483,65405,153888,-23078,0,0,177,0,0,,177,177
7,02/16/2017,81,20:00,20:15,129.12,35.38,0,129.12,33.75,2,-104612,29238,133850,-75374,0,-119,11363,0,0,,11482,11244
7,02/16/2017,82,20:15,20:30,134.12,,0,134.12,134.12,1,-85153,10924,96077,-74229,0,0,13749,0,0,,13749,13749
7,02/16/2017,83,20:30,20:45,,,0,33.63,33.63,0,-70503,25360,95863,-45143,0,0,27,0,0,,27,27
7,02/16/2017,84,20:45,21:00,,32.06,0,32.06,32.06,-1,-87781,46747,134528,-41034,0,-129,0,0,0,,129,-129
7,02/16/2017,85,21:00,21:15,39.9,25.97,0,39.9,25.97,2,-29370,84036,113406,54666,0,-8400,642,0,0,,9042,-7758
7,02/16/2017,86,21:15,21:30,40.63,31.4,0,40.63,31.4,2,-23897,79796,103693,55899,0,-336,2868,0,0,,3204,2532
7,02/16/2017,87,21:30,21:45,,26.25,0,26.25,26.25,-1,-18224,89900,108124,71676,0,-12535,0,0,0,,12535,-12535
7,02/16/2017,88,21:45,22:00,,-38.7,0,-38.7,-38.7,-1,-15927,113837,129764,97910,0,-63757,0,0,0,,63757,-63757
7,02/16/2017,89,22:00,22:15,43.98,31.78,0,43.98,31.78,2,-135414,16850,152264,-118564,0,-18600,4136,0,0,,22736,-14464
7,02/16/2017,90,22:15,22:30,34.65,33.77,0,33.77,33.77,-1,-45885,21898,67783,-23987,0,-54,2698,0,0,,2752,2644
7,02/16/2017,91,22:30,22:45,,24.31,0,24.31,24.31,-1,-17254,55177,72431,37923,0,-9020,0,0,0,,9020,-9020
7,02/16/2017,92,22:45,23:00,,13.49,0,13.49,13.49,-1,-27205,106744,133949,79539,0,-72233,0,0,0,,72233,-72233
7,02/16/2017,93,23:00,23:15,37.25,13.49,0,37.25,37.25,1,-140236,46379,186615,-93857,0,-26799,2246,0,0,,29045,-24553
7,02/16/2017,94,23:15,23:30,35.39,,0,35.39,35.39,1,-115724,31202,146926,-84522,0,0,4927,0,0,,4927,4927
7,02/16/2017,95,23:30,23:45,35.39,33.77,0,33.77,33.77,-1,-88629,79061,167690,-9568,0,-136,66,0,0,,202,-70
7,02/16/2017,96,23:45,0:00,,30.25,0,30.25,30.25,-1,-107224,115038,222262,7814,0,-12709,0,0,0,,12709,-12709
7,02/17/2017,1,0:00,0:15,31.16,29.96,0,31.98,29.96,2,-56142,76862,133004,20720,0,-7382,228,0,0,,7610,-7154
7,02/17/2017,2,0:15,0:30,32.04,29.96,0,32.04,32.04,1,-86889,48348,135237,-38541,0,-7,876,0,0,,883,869
7,02/17/2017,3,0:30,0:45,,,0,31.98,31.98,0,-148882,38859,187741,-110023,0,0,0,0,0,,0,0
7,02/17/2017,4,0:45,1:00,,,0,31.98,31.98,0,-159566,65997,225563,-93569,0,0,0,0,0,,0,0
7,02/17/2017,5,1:00,1:15,,,0,31.98,31.98,0,-117799,26990,144789,-90809,0,0,0,0,0,,0,0
7,02/17/2017,6,1:15,1:30,,,0,31.98,31.98,0,-85741,22344,108085,-63397,0,0,0,0,0,,0,0
7,02/17/2017,7,1:30,1:45,,,0,31.98,31.98,0,-49180,16187,65367,-32993,0,0,0,0,0,,0,0
7,02/17/2017,8,1:45,2:00,,31.41,0,31.41,31.41,-1,-30434,29216,59650,-1218,0,-300,0,0,0,,300,-300
7,02/17/2017,9,2:00,2:15,,26.41,0,26.41,26.41,-1,-40910,105749,146659,64839,0,-24099,0,0,0,,24099,-24099
7,02/17/2017,10,2:15,2:30,,25.85,0,25.85,25.85,-1,-30167,84957,115124,54790,0,-46007,0,0,0,,46007,-46007
7,02/17/2017,11,2:30,2:45,,24.43,0,24.43,24.43,-1,-29027,87728,116755,58701,0,-63510,0,0,0,,63510,-63510
7,02/17/2017,12,2:45,3:00,,27.67,0,27.67,27.67,-1,-27866,56366,84232,28500,0,-45787,0,0,0,,45787,-45787
7,02/17/2017,13,3:00,3:15,31.4,35.31,0,32.98,32.98,2,-55776,24005,79781,-31771,0,-8511,413,0,0,,8924,-8098
7,02/17/2017,14,3:15,3:30,,35.93,0,35.93,35.93,-1,-50556,34665,85221,-15891,0,-3,0,0,0,,3,-3
7,02/17/2017,15,3:30,3:45,,32.62,0,32.62,32.62,-1,-31776,37355,69131,5579,0,-5323,0,0,0,,5323,-5323
7,02/17/2017,16,3:45,4:00,,26.41,0,26.41,26.41,-1,-27249,67984,95233,40735,0,-16683,0,0,0,,16683,-16683
7,02/17/2017,17,4:00,4:15,,32.62,0,32.62,32.62,-1,-61347,43037,104384,-18310,0,-8301,0,0,0,,8301,-8301
7,02/17/2017,18,4:15,4:30,,,0,32.98,32.98,0,-47489,33765,81254,-13724,0,-29,0,0,0,,29,-29
7,02/17/2017,19,4:30,4:45,32.05,,0,32.05,32.05,1,-53078,28503,81581,-24575,0,0,861,0,0,,861,861
7,02/17/2017,20,4:45,5:00,,,0,33.48,33.48,0,-26886,27979,54865,1093,0,0,0,0,0,,0,0
7,02/17/2017,21,5:00,5:15,31.07,34.38,0,33.5,33.5,2,-60411,60033,120444,-378,0,-141,132,0,0,,273,-9
7,02/17/2017,22,5:15,5:30,,31.41,0,31.41,31.41,-1,-40782,45934,86716,5152,0,-9015,0,0,0,,9015,-9015
7,02/17/2017,23,5:30,5:45,,31.04,0,31.04,31.04,-1,-32796,32044,64840,-752,0,-5949,0,0,0,,5949,-5949
7,02/17/2017,24,5:45,6:00,,31.41,0,31.41,31.41,-1,-50466,55959,106425,5493,0,-3533,0,0,0,,3533,-3533
7,02/17/2017,25,6:00,6:15,,24.65,0,24.65,24.65,-1,-48311,99871,148182,51560,0,-32458,0,0,0,,32458,-32458
7,02/17/2017,26,6:15,6:30,31.39,30.38,0,31.39,31.39,1,-52873,49616,102489,-3257,0,-23673,78,0,0,,23751,-23595
7,02/17/2017,27,6:30,6:45,39.74,30.38,0,39.74,39.74,1,-60184,18535,78719,-41649,0,-771,1584,0,0,,2355,813
7,02/17/2017,28,6:45,7:00,58.26,,0,58.26,58.26,1,-70552,47970,118522,-22582,0,0,34455,0,0,,34455,34455
7,02/17/2017,29,7:00,7:15,36.74,,0,36.74,36.74,1,-116047,74980,191027,-41067,0,0,13511,0,0,,13511,13511
7,02/17/2017,30,7:15,7:30,117.02,,0,117.02,117.02,1,-103099,34873,137972,-68226,0,0,8460,0,0,,8460,8460
7,02/17/2017,31,7:30,7:45,136.02,,0,136.02,136.02,1,-101826,29562,131388,-72264,0,0,43732,0,0,,43732,43732
7,02/17/2017,32,7:45,8:00,75.02,,0,75.02,75.02,1,-109832,36049,145881,-73783,0,0,29962,0,0,,29962,29962
7,02/17/2017,33,8:00,8:15,49.81,33.74,0,33.74,33.74,-1,-68241,88975,157216,20734,0,-270,14444,0,0,,14714,14174
7,02/17/2017,34,8:15,8:30,35.58,32.25,0,35.58,32.25,2,-49924,38638,88562,-11286,0,-1720,465,0,0,,2185,-1255
7,02/17/2017,35,8:30,8:45,250,,0,250,250,1,-99276,23847,123123,-75429,0,0,24796,0,0,,24796,24796
7,02/17/2017,36,8:45,9:00,250,,0,250,250,1,-115724,38862,154586,-76862,0,0,69678,0,0,,69678,69678
7,02/17/2017,37,9:00,9:15,35.25,,0,35.25,35.25,1,-74429,55097,129526,-19332,0,0,18615,0,0,,18615,18615
7,02/17/2017,38,9:15,9:30,83.02,,0,83.02,83.02,1,-76113,38461,114574,-37652,0,0,4841,0,0,,4841,4841
7,02/17/2017,39,9:30,9:45,137.02,,0,137.02,137.02,1,-83069,48243,131312,-34826,0,0,35455,0,0,,35455,35455
7,02/17/2017,40,9:45,10:00,94.77,,0,94.77,94.77,1,-106759,51578,158337,-55181,0,0,18258,0,0,,18258,18258
7,02/17/2017,41,10:00,10:15,99.02,,0,99.02,99.02,1,-103684,82972,186656,-20712,0,0,34508,0,0,,34508,34508
7,02/17/2017,42,10:15,10:30,57.5,,0,57.5,57.5,1,-131789,87704,219493,-44085,0,0,25693,0,0,,25693,25693
7,02/17/2017,43,10:30,10:45,137.02,,0,137.02,137.02,1,-165780,80641,246421,-85139,0,0,33843,0,0,,33843,33843
7,02/17/2017,44,10:45,11:00,137.02,,0,137.02,137.02,1,-164755,78277,243032,-86478,0,0,37729,0,0,,37729,37729
7,02/17/2017,45,11:00,11:15,143.68,,0,143.68,143.68,1,-176342,66048,242390,-110294,0,0,20569,0,0,,20569,20569
7,02/17/2017,46,11:15,11:30,143.68,,0,143.68,143.68,1,-177718,51646,229364,-126072,0,0,75184,0,0,,75184,75184
7,02/17/2017,47,11:30,11:45,84.01,,0,84.01,84.01,1,-148973,63544,212517,-85429,0,0,44884,0,0,,44884,44884
7,02/17/2017,48,11:45,12:00,143.68,,0,143.68,143.68,1,-142343,60104,202447,-82239,0,0,33736,0,0,,33736,33736
7,02/17/2017,49,12:00,12:15,137.02,,0,137.02,137.02,1,-116154,60205,176359,-55949,0,0,61262,0,0,,61262,61262
7,02/17/2017,50,12:15,12:30,35.58,,0,35.58,35.58,1,-133461,64997,198458,-68464,0,0,17020,0,0,,17020,17020
7,02/17/2017,51,12:30,12:45,124.23,,0,124.23,124.23,1,-147439,49313,196752,-98126,0,0,14353,0,0,,14353,14353
7,02/17/2017,52,12:45,13:00,35.25,,0,35.25,35.25,1,-139360,45271,184631,-94089,0,0,16291,0,0,,16291,16291
7,02/17/2017,53,13:00,13:15,78.78,,0,78.78,78.78,1,-101577,37778,139355,-63799,0,0,35147,0,0,,35147,35147
7,02/17/2017,54,13:15,13:30,78.78,,0,78.78,78.78,1,-115371,52257,167628,-63114,0,0,38626,0,0,,38626,38626
7,02/17/2017,55,13:30,13:45,35.02,,0,35.02,35.02,1,-94578,60088,154666,-34490,0,0,3715,0,0,,3715,3715
7,02/17/2017,56,13:45,14:00,31.2,,0,31.2,31.2,1,-103280,52013,155293,-51267,0,0,1149,0,0,,1149,1149
7,02/17/2017,57,14:00,14:15,,,0,33.56,33.56,0,-24980,92831,117811,67851,0,0,0,0,0,,0,0
7,02/17/2017,58,14:15,14:30,,,0,33.56,33.56,0,-35210,70309,105519,35099,0,0,0,0,0,,0,0
7,02/17/2017,59,14:30,14:45,,29.4,0,29.4,29.4,-1,-24643,73127,97770,48484,0,-5061,0,0,0,,5061,-5061
7,02/17/2017,60,14:45,15:00,34.25,27.25,0,34.25,27.25,2,-72157,64507,136664,-7650,0,-20771,37,0,0,,20808,-20734
7,02/17/2017,61,15:00,15:15,139.88,27.25,0,139.88,139.88,1,-170336,34059,204395,-136277,0,-863,29709,0,0,,30572,28846
7,02/17/2017,62,15:15,15:30,41.43,,0,41.43,41.43,1,-167744,48315,216059,-119429,0,0,19798,0,0,,19798,19798
7,02/17/2017,63,15:30,15:45,139.88,,0,139.88,139.88,1,-173239,34306,207545,-138933,0,0,46560,0,0,,46560,46560
7,02/17/2017,64,15:45,16:00,70.65,,0,70.65,70.65,1,-162446,39815,202261,-122631,0,0,45998,0,0,,45998,45998
7,02/17/2017,65,16:00,16:15,54.81,,0,54.81,54.81,1,-163811,39750,203561,-124061,0,0,28853,0,0,,28853,28853
7,02/17/2017,66,16:15,16:30,127.02,,0,127.02,127.02,1,-173299,31333,204632,-141966,0,0,26494,0,0,,26494,26494
7,02/17/2017,67,16:30,16:45,140.52,,0,140.52,140.52,1,-169258,25587,194845,-143671,0,0,68333,0,0,,68333,68333
7,02/17/2017,68,16:45,17:00,140.52,,0,140.52,140.52,1,-154477,37494,191971,-116983,0,0,77866,0,0,,77866,77866
7,02/17/2017,69,17:00,17:15,140.52,-42.72,0,-42.72,-42.72,-1,-34678,99240,133918,64562,0,-16494,21692,0,0,,38186,5198
7,02/17/2017,70,17:15,17:30,,31.96,0,31.96,31.96,-1,-71177,57967,129144,-13210,0,-8568,0,0,0,,8568,-8568
7,02/17/2017,71,17:30,17:45,46.73,,0,46.73,46.73,1,-91424,60679,152103,-30745,0,0,6719,0,0,,6719,6719
7,02/17/2017,72,17:45,18:00,57.02,,0,57.02,57.02,1,-94618,56147,150765,-38471,0,0,32857,0,0,,32857,32857
7,02/17/2017,73,18:00,18:15,37.14,15.32,0,15.32,15.32,-1,-21380,61518,82898,40138,0,-15295,15925,0,0,,31220,630
7,02/17/2017,74,18:15,18:30,,31.96,0,31.96,31.96,-1,-26546,45853,72399,19307,0,-17126,0,0,0,,17126,-17126
7,02/17/2017,75,18:30,18:45,,34.03,0,34.03,34.03,-1,-28927,54517,83444,25590,0,-1660,0,0,0,,1660,-1660
7,02/17/2017,76,18:45,19:00,,,0,34.48,34.48,0,-29037,61643,90680,32606,0,-11,0,0,0,,11,-11
7,02/17/2017,77,19:00,19:15,35.25,,0,35.25,35.25,1,-55095,31352,86447,-23743,0,0,1152,0,0,,1152,1152
7,02/17/2017,78,19:15,19:30,35.81,,0,35.81,35.81,1,-52084,43010,95094,-9074,0,0,2315,0,0,,2315,2315
7,02/17/2017,79,19:30,19:45,,35.87,0,35.87,35.87,-1,-44461,49942,94403,5481,0,-155,0,0,0,,155,-155
7,02/17/2017,80,19:45,20:00,,31.64,0,31.64,31.64,-1,-37496,48063,85559,10567,0,-10806,0,0,0,,10806,-10806
7,02/17/2017,81,20:00,20:15,38.06,31.64,0,38.06,38.06,1,-80773,6821,87594,-73952,0,-1384,3866,0,0,,5250,2482
7,02/17/2017,82,20:15,20:30,32.02,,0,32.02,32.02,1,-67711,23831,91542,-43880,0,0,1724,0,0,,1724,1724
7,02/17/2017,83,20:30,20:45,30.95,,0,30.95,30.95,1,-44805,28992,73797,-15813,0,0,298,0,0,,298,298
7,02/17/2017,84,20:45,21:00,,,0,33.44,33.44,0,-48670,44144,92814,-4526,0,0,0,0,0,,0,0
7,02/17/2017,85,21:00,21:15,62.14,32.89,0,62.14,32.89,2,-46277,26782,73059,-19495,0,-650,6594,0,0,,7244,5944
7,02/17/2017,86,21:15,21:30,35.19,32.25,0,32.25,32.25,-1,-26325,28745,55070,2420,0,-497,5643,0,0,,6140,5146
7,02/17/2017,87,21:30,21:45,,30.69,0,30.69,30.69,-1,-25873,58518,84391,32645,0,-22265,0,0,0,,22265,-22265
7,02/17/2017,88,21:45,22:00,,25.72,0,25.72,25.72,-1,-23149,88688,111837,65539,0,-54744,0,0,0,,54744,-54744
7,02/17/2017,89,22:00,22:15,31.3,28.69,0,31.3,31.3,1,-68158,37740,105898,-30418,0,-37802,17,0,0,,37819,-37785
7,02/17/2017,90,22:15,22:30,34.25,32.25,0,34.25,32.25,2,-46408,38343,84751,-8065,0,-1263,487,0,0,,1750,-776
7,02/17/2017,91,22:30,22:45,,29.09,0,29.09,29.09,-1,-23409,67218,90627,43809,0,-21657,0,0,0,,21657,-21657
7,02/17/2017,92,22:45,23:00,,32.25,0,32.25,32.25,-1,-37810,71404,109214,33594,0,-24730,0,0,0,,24730,-24730
7,02/17/2017,93,23:00,23:15,34.1,32.03,0,34.1,32.03,2,-57679,45965,103644,-11714,0,-13864,502,0,0,,14366,-13362
7,02/17/2017,94,23:15,23:30,34.1,32.1,0,34.1,32.1,2,-35621,35277,70898,-344,0,-933,1025,0,0,,1958,92
7,02/17/2017,95,23:30,23:45,,26.54,0,26.54,26.54,-1,-21999,65599,87598,43600,0,-32904,0,0,0,,32904,-32904
7,02/17/2017,96,23:45,0:00,,23.51,0,23.51,23.51,-1,-23843,78695,102538,54852,0,-57823,0,0,0,,57823,-57823
8,02/18/2017,1,0:00,0:15,,18.78,0,18.78,18.78,-1,-46570,82493,129063,35923,0,-35680,0,0,0,,35680,-35680
8,02/18/2017,2,0:15,0:30,34.66,27.09,0,34.66,27.09,2,-36680,50142,86822,13462,0,-3578,388,0,0,,3966,-3190
8,02/18/2017,3,0:30,0:45,,21.68,0,21.68,21.68,-1,-21798,36112,57910,14314,0,-24295,0,0,0,,24295,-24295
8,02/18/2017,4,0:45,1:00,,28.65,0,28.65,28.65,-1,-28534,43628,72162,15094,0,-12779,0,0,0,,12779,-12779
8,02/18/2017,5,1:00,1:15,31.85,27.09,0,31.85,31.85,1,-37428,44543,81971,7115,0,-15393,9,0,0,,15402,-15384
8,02/18/2017,6,1:15,1:30,32.18,32.09,0,33.42,32.09,2,-24178,29312,53490,5134,0,-749,443,0,0,,1192,-306
8,02/18/2017,7,1:30,1:45,,30.3,0,30.3,30.3,-1,-10477,37537,48014,27060,0,-10537,0,0,0,,10537,-10537
8,02/18/2017,8,1:45,2:00,,24.32,0,24.32,24.32,-1,-3463,67807,71270,64344,0,-36867,0,0,0,,36867,-36867
8,02/18/2017,9,2:00,2:15,35.64,27.78,0,35.64,35.64,1,-36006,24819,60825,-11187,0,-22855,1293,0,0,,24148,-21562
8,02/18/2017,10,2:15,2:30,35.64,31.09,0,31.09,31.09,-1,-21420,25161,46581,3741,0,-3172,489,0,0,,3661,-2683
8,02/18/2017,11,2:30,2:45,,30.76,0,30.76,30.76,-1,-19467,39521,58988,20054,0,-25262,0,0,0,,25262,-25262
8,02/18/2017,12,2:45,3:00,,31.09,0,31.09,31.09,-1,-13241,41649,54890,28408,0,-13461,0,0,0,,13461,-13461
8,02/18/2017,13,3:00,3:15,,33.78,0,33.78,33.78,-1,-34927,27641,62568,-7286,0,-5943,0,0,0,,5943,-5943
8,02/18/2017,14,3:15,3:30,,32.09,0,32.09,32.09,-1,-21052,29277,50329,8225,0,-4402,0,0,0,,4402,-4402
8,02/18/2017,15,3:30,3:45,,32.09,0,32.09,32.09,-1,-20785,30619,51404,9834,0,-5118,0,0,0,,5118,-5118
8,02/18/2017,16,3:45,4:00,,32.09,0,32.09,32.09,-1,-18402,35658,54060,17256,0,-16691,0,0,0,,16691,-16691
8,02/18/2017,17,4:00,4:15,,33.78,0,33.78,33.78,-1,-23332,26749,50081,3417,0,-8318,0,0,0,,8318,-8318
8,02/18/2017,18,4:15,4:30,,34.99,0,34.99,34.99,-1,-20222,36040,56262,15818,0,-15,0,0,0,,15,-15
8,02/18/2017,19,4:30,4:45,,33.78,0,33.78,33.78,-1,-18577,34932,53509,16355,0,-1378,0,0,0,,1378,-1378
8,02/18/2017,20,4:45,5:00,,33.78,0,33.78,33.78,-1,-20114,29860,49974,9746,0,-2584,0,0,0,,2584,-2584
8,02/18/2017,21,5:00,5:15,,32.12,0,32.12,32.12,-1,-20183,39917,60100,19734,0,-5115,0,0,0,,5115,-5115
8,02/18/2017,22,5:15,5:30,,31.09,0,31.09,31.09,-1,-15692,40529,56221,24837,0,-17825,0,0,0,,17825,-17825
8,02/18/2017,23,5:30,5:45,,33.81,0,33.81,33.81,-1,-19346,30532,49878,11186,0,-9353,0,0,0,,9353,-9353
8,02/18/2017,24,5:45,6:00,,32.78,0,32.78,32.78,-1,-19416,25452,44868,6036,0,-4601,0,0,0,,4601,-4601
8,02/18/2017,25,6:00,6:15,,-6.64,0,-6.64,-6.64,-1,-14809,65126,79935,50317,0,-29503,0,0,0,,29503,-29503
8,02/18/2017,26,6:15,6:30,,25.78,0,25.78,25.78,-1,-17197,49331,66528,32134,0,-35128,0,0,0,,35128,-35128
8,02/18/2017,27,6:30,6:45,,32.12,0,32.12,32.12,-1,-33125,44111,77236,10986,0,-21292,0,0,0,,21292,-21292
8,02/18/2017,28,6:45,7:00,36.78,32.12,0,36.78,36.78,1,-43275,27382,70657,-15893,0,-4987,2030,0,0,,7017,-2957
8,02/18/2017,29,7:00,7:15,,14.45,0,14.45,14.45,-1,-14507,78020,92527,63513,0,-19644,0,0,0,,19644,-19644
8,02/18/2017,30,7:15,7:30,,27.64,0,27.64,27.64,-1,-30842,54117,84959,23275,0,-22837,0,0,0,,22837,-22837
8,02/18/2017,31,7:30,7:45,,,0,33.37,33.37,0,-35953,27310,63263,-8643,0,-639,0,0,0,,639,-639
8,02/18/2017,32,7:45,8:00,40.19,,0,40.19,40.19,1,-46141,32365,78506,-13776,0,0,6377,0,0,,6377,6377
8,02/18/2017,33,8:00,8:15,40.19,-0.11,0,-0.11,-0.11,-1,-13398,90508,103906,77110,0,-25314,2223,0,0,,27537,-23091
8,02/18/2017,34,8:15,8:30,36.77,30.78,0,36.77,36.77,1,-37826,29269,67095,-8557,0,-11141,1102,0,0,,12243,-10039
8,02/18/2017,35,8:30,8:45,43.99,,0,43.99,43.99,1,-64557,19279,83836,-45278,0,0,7594,0,0,,7594,7594
8,02/18/2017,36,8:45,9:00,41.81,,0,41.81,41.81,1,-90003,20833,110836,-69170,0,0,8412,0,0,,8412,8412
8,02/18/2017,37,9:00,9:15,43.89,,0,43.89,43.89,1,-5063,61252,66315,56189,0,0,5904,0,0,,5904,5904
8,02/18/2017,38,9:15,9:30,,,0,34.54,34.54,0,-19125,39237,58362,20112,0,0,0,0,0,,0,0
8,02/18/2017,39,9:30,9:45,,34.83,0,34.83,34.83,-1,-38415,34972,73387,-3443,0,-161,0,0,0,,161,-161
8,02/18/2017,40,9:45,10:00,,34.83,0,34.83,34.83,-1,-59367,36727,96094,-22640,0,-980,0,0,0,,980,-980
8,02/18/2017,41,10:00,10:15,,,0,34.15,34.15,0,-65895,36618,102513,-29277,0,-2,0,0,0,,2,-2
8,02/18/2017,42,10:15,10:30,,,0,34.15,34.15,0,-66320,40014,106334,-26306,0,0,0,0,0,,0,0
8,02/18/2017,43,10:30,10:45,,,0,34.15,34.15,0,-63759,35791,99550,-27968,0,0,0,0,0,,0,0
8,02/18/2017,44,10:45,11:00,,,0,34.15,34.15,0,-60439,38681,99120,-21758,0,0,0,0,0,,0,0
8,02/18/2017,45,11:00,11:15,,,0,34.15,34.15,0,-97482,36521,134003,-60961,0,0,0,0,0,,0,0
8,02/18/2017,46,11:15,11:30,,,0,34.15,34.15,0,-93892,36042,129934,-57850,0,0,0,0,0,,0,0
8,02/18/2017,47,11:30,11:45,,,0,34.15,34.15,0,-84422,34690,119112,-49732,0,0,0,0,0,,0,0
8,02/18/2017,48,11:45,12:00,,,0,34.15,34.15,0,-69532,48288,117820,-21244,0,0,0,0,0,,0,0
8,02/18/2017,49,12:00,12:15,,,0,33.46,33.46,0,-107062,54832,161894,-52230,0,0,0,0,0,,0,0
8,02/18/2017,50,12:15,12:30,,,0,33.46,33.46,0,-96383,63655,160038,-32728,0,0,0,0,0,,0,0
8,02/18/2017,51,12:30,12:45,,31.14,0,31.14,31.14,-1,-76934,79165,156099,2231,0,-2071,0,0,0,,2071,-2071
8,02/18/2017,52,12:45,13:00,,27.64,0,27.64,27.64,-1,-69702,92100,161802,22398,0,-18907,0,0,0,,18907,-18907
8,02/18/2017,53,13:00,13:15,,27.64,0,27.64,27.64,-1,-64482,104044,168526,39562,0,-39548,0,0,0,,39548,-39548
8,02/18/2017,54,13:15,13:30,,31.78,0,31.78,31.78,-1,-70682,82708,153390,12026,0,-14958,0,0,0,,14958,-14958
8,02/18/2017,55,13:30,13:45,,31.09,0,31.09,31.09,-1,-48909,88495,137404,39586,0,-16796,0,0,0,,16796,-16796
8,02/18/2017,56,13:45,14:00,,24.85,0,24.85,24.85,-1,-52068,122870,174938,70802,0,-37547,0,0,0,,37547,-37547
8,02/18/2017,57,14:00,14:15,,29.39,0,29.39,29.39,-1,-55152,114664,169816,59512,0,-39336,0,0,0,,39336,-39336
8,02/18/2017,58,14:15,14:30,,24,0,24,24,-1,-41891,118601,160492,76710,0,-45964,0,0,0,,45964,-45964
8,02/18/2017,59,14:30,14:45,,24,0,24,24,-1,-37224,121846,159070,84622,0,-68719,0,0,0,,68719,-68719
8,02/18/2017,60,14:45,15:00,,22.78,0,22.78,22.78,-1,-32024,122671,154695,90647,0,-75286,0,0,0,,75286,-75286
8,02/18/2017,61,15:00,15:15,,24,0,24,24,-1,-40919,102892,143811,61973,0,-75905,0,0,0,,75905,-75905
8,02/18/2017,62,15:15,15:30,,25.57,0,25.57,25.57,-1,-40562,112486,153048,71924,0,-69738,0,0,0,,69738,-69738
8,02/18/2017,63,15:30,15:45,,27.64,0,27.64,27.64,-1,-45233,102402,147635,57169,0,-45891,0,0,0,,45891,-45891
8,02/18/2017,64,15:45,16:00,,25.78,0,25.78,25.78,-1,-40203,100782,140985,60579,0,-48226,0,0,0,,48226,-48226
8,02/18/2017,65,16:00,16:15,,29.39,0,29.39,29.39,-1,-57031,91740,148771,34709,0,-40111,0,0,0,,40111,-40111
8,02/18/2017,66,16:15,16:30,,30.78,0,30.78,30.78,-1,-53699,68930,122629,15231,0,-26031,0,0,0,,26031,-26031
8,02/18/2017,67,16:30,16:45,,33.44,0,33.44,33.44,-1,-56948,64030,120978,7082,0,-15087,0,0,0,,15087,-15087
8,02/18/2017,68,16:45,17:00,,,0,33.46,33.46,0,-61975,68958,130933,6983,0,-1954,0,0,0,,1954,-1954
8,02/18/2017,69,17:00,17:15,,17.78,0,17.78,17.78,-1,-56673,118433,175106,61760,0,-19366,0,0,0,,19366,-19366
8,02/18/2017,70,17:15,17:30,,17.78,0,17.78,17.78,-1,-70747,94712,165459,23965,0,-38401,0,0,0,,38401,-38401
8,02/18/2017,71,17:30,17:45,,25.78,0,25.78,25.78,-1,-39379,85395,124774,46016,0,-29179,0,0,0,,29179,-29179
8,02/18/2017,72,17:45,18:00,,29.78,0,29.78,29.78,-1,-42622,82430,125052,39808,0,-33217,0,0,0,,33217,-33217
8,02/18/2017,73,18:00,18:15,,-0.11,0,-0.11,-0.11,-1,-35960,115854,151814,79894,0,-33258,0,0,0,,33258,-33258
8,02/18/2017,74,18:15,18:30,59.94,31.09,0,59.94,59.94,1,-76213,43995,120208,-32218,0,-11627,2745,0,0,,14372,-8882
8,02/18/2017,75,18:30,18:45,129.47,31.09,0,129.47,129.47,1,-64028,41356,105384,-22672,0,-10,24882,0,0,,24892,24872
8,02/18/2017,76,18:45,19:00,129.47,31.09,0,31.09,31.09,-1,-58958,75154,134112,16196,0,-698,971,0,0,,1669,273
8,02/18/2017,77,19:00,19:15,,29.92,0,29.92,29.92,-1,-53830,52742,106572,-1088,0,-3834,0,0,0,,3834,-3834
8,02/18/2017,78,19:15,19:30,,29.78,0,29.78,29.78,-1,-49872,55190,105062,5318,0,-2308,0,0,0,,2308,-2308
8,02/18/2017,79,19:30,19:45,,29.09,0,29.09,29.09,-1,-35051,63287,98338,28236,0,-22038,0,0,0,,22038,-22038
8,02/18/2017,80,19:45,20:00,,28.8,0,28.8,28.8,-1,-69180,81288,150468,12108,0,-30700,0,0,0,,30700,-30700
8,02/18/2017,81,20:00,20:15,,25.78,0,25.78,25.78,-1,-50263,107364,157627,57101,0,-19419,0,0,0,,19419,-19419
8,02/18/2017,82,20:15,20:30,,23.19,0,23.19,23.19,-1,-37058,78906,115964,41848,0,-7440,0,0,0,,7440,-7440
8,02/18/2017,83,20:30,20:45,,-0.11,0,-0.11,-0.11,-1,-27566,102901,130467,75335,0,-43415,0,0,0,,43415,-43415
8,02/18/2017,84,20:45,21:00,,-0.11,0,-0.11,-0.11,-1,-36952,116175,153127,79223,0,-68942,0,0,0,,68942,-68942
8,02/18/2017,85,21:00,21:15,,10.78,0,10.78,10.78,-1,-46629,79619,126248,32990,0,-46874,0,0,0,,46874,-46874
8,02/18/2017,86,21:15,21:30,34.09,24.85,0,34.09,24.85,2,-44839,65698,110537,20859,0,-4540,65,0,0,,4605,-4475
8,02/18/2017,87,21:30,21:45,,-4.78,0,-4.78,-4.78,-1,-41062,111939,153001,70877,0,-65851,0,0,0,,65851,-65851
8,02/18/2017,88,21:45,22:00,,-18.83,0,-18.83,-18.83,-1,-45434,145471,190905,100037,0,-100027,0,0,0,,100027,-100027
8,02/18/2017,89,22:00,22:15,,-2.22,0,-2.22,-2.22,-1,-34277,52334,86611,18057,0,-59624,0,0,0,,59624,-59624
8,02/18/2017,90,22:15,22:30,,24,0,24,24,-1,-43939,64087,108026,20148,0,-4908,0,0,0,,4908,-4908
8,02/18/2017,91,22:30,22:45,,-1.79,0,-1.79,-1.79,-1,-27256,93060,120316,65804,0,-55580,0,0,0,,55580,-55580
8,02/18/2017,92,22:45,23:00,,23.69,0,23.69,23.69,-1,-29729,90506,120235,60777,0,-66655,0,0,0,,66655,-66655
8,02/18/2017,93,23:00,23:15,,14.45,0,14.45,14.45,-1,-34595,126234,160829,91639,0,-67715,0,0,0,,67715,-67715
8,02/18/2017,94,23:15,23:30,,24.85,0,24.85,24.85,-1,-52586,87511,140097,34925,0,-50758,0,0,0,,50758,-50758
8,02/18/2017,95,23:30,23:45,,24.85,0,24.85,24.85,-1,-34450,94796,129246,60346,0,-51211,0,0,0,,51211,-51211
8,02/18/2017,96,23:45,0:00,,24.85,0,24.85,24.85,-1,-34864,121838,156702,86974,0,-60144,0,0,0,,60144,-60144
8,02/19/2017,1,0:00,0:15,,24.85,0,24.85,24.85,-1,-85714,69172,154886,-16542,0,-37160,0,0,0,,37160,-37160
8,02/19/2017,2,0:15,0:30,32.26,24.85,0,32.26,32.26,1,-55582,44417,99999,-11165,0,-1110,1253,0,0,,2363,143
8,02/19/2017,3,0:30,0:45,33.98,,0,33.98,33.98,1,-62616,41669,104285,-20947,0,0,4987,0,0,,4987,4987
8,02/19/2017,4,0:45,1:00,,,0,32.51,32.51,0,-99471,65396,164867,-34075,0,0,371,0,0,,371,371
8,02/19/2017,5,1:00,1:15,37.28,,0,37.28,37.28,1,-68882,46274,115156,-22608,0,0,8121,0,0,,8121,8121
8,02/19/2017,6,1:15,1:30,37.89,33.12,0,37.89,32.01,2,-57085,50221,107306,-6864,0,-89,20898,0,0,,20987,20809
8,02/19/2017,7,1:30,1:45,37.89,27.8,0,27.8,27.8,-1,-51759,70141,121900,18382,0,-1745,674,0,0,,2419,-1071
8,02/19/2017,8,1:45,2:00,,-17.03,0,-17.03,-17.03,-1,-45690,88470,134160,42780,0,-32836,0,0,0,,32836,-32836
8,02/19/2017,9,2:00,2:15,,30.63,0,30.63,30.63,-1,-16982,35685,52667,18703,0,-10896,0,0,0,,10896,-10896
8,02/19/2017,10,2:15,2:30,,25.63,0,25.63,25.63,-1,-19521,59068,78589,39547,0,-5715,0,0,0,,5715,-5715
8,02/19/2017,11,2:30,2:45,,27.81,0,27.81,27.81,-1,-20485,62144,82629,41659,0,-2086,0,0,0,,2086,-2086
8,02/19/2017,12,2:45,3:00,,-48.01,0,-48.01,-48.01,-1,-17668,61857,79525,44189,0,-31193,0,0,0,,31193,-31193
8,02/19/2017,13,3:00,3:15,,30.63,0,30.63,30.63,-1,-36392,48573,84965,12181,0,-8310,0,0,0,,8310,-8310
8,02/19/2017,14,3:15,3:30,,17.69,0,17.69,17.69,-1,-30304,60140,90444,29836,0,-6389,0,0,0,,6389,-6389
8,02/19/2017,15,3:30,3:45,,6.03,0,6.03,6.03,-1,-34318,64843,99161,30525,0,-33782,0,0,0,,33782,-33782
8,02/19/2017,16,3:45,4:00,,25.38,0,25.38,25.38,-1,-32267,65330,97597,33063,0,-37212,0,0,0,,37212,-37212
8,02/19/2017,17,4:00,4:15,,26.03,0,26.03,26.03,-1,-36781,68146,104927,31365,0,-20775,0,0,0,,20775,-20775
8,02/19/2017,18,4:15,4:30,,,0,32.51,32.51,0,-37173,71560,108733,34387,0,-104,0,0,0,,104,-104
8,02/19/2017,19,4:30,4:45,,27.81,0,27.81,27.81,-1,-38398,80601,118999,42203,0,-3383,0,0,0,,3383,-3383
8,02/19/2017,20,4:45,5:00,,26.03,0,26.03,26.03,-1,-34733,81691,116424,46958,0,-17803,0,0,0,,17803,-17803
8,02/19/2017,21,5:00,5:15,,0.03,0,0.03,0.03,-1,-31265,92712,123977,61447,0,-25684,0,0,0,,25684,-25684
8,02/19/2017,22,5:15,5:30,,0.03,0,0.03,0.03,-1,-40300,87896,128196,47596,0,-48380,0,0,0,,48380,-48380
8,02/19/2017,23,5:30,5:45,,25.63,0,25.63,25.63,-1,-35211,80739,115950,45528,0,-34446,0,0,0,,34446,-34446
8,02/19/2017,24,5:45,6:00,,-55.46,0,-55.46,-55.46,-1,-29691,86158,115849,56467,0,-39572,0,0,0,,39572,-39572
8,02/19/2017,25,6:00,6:15,,20.44,0,20.44,20.44,-1,-33316,92970,126286,59654,0,-32467,0,0,0,,32467,-32467
8,02/19/2017,26,6:15,6:30,,-52.45,0,-52.45,-52.45,-1,-30275,87152,117427,56877,0,-46105,0,0,0,,46105,-46105
8,02/19/2017,27,6:30,6:45,,18.69,0,18.69,18.69,-1,-32930,83776,116706,50846,0,-43685,0,0,0,,43685,-43685
8,02/19/2017,28,6:45,7:00,,26.03,0,26.03,26.03,-1,-29044,65686,94730,36642,0,-26531,0,0,0,,26531,-26531
8,02/19/2017,29,7:00,7:15,,-62.34,0,-62.34,-62.34,-1,-38738,119396,158134,80658,0,-38917,0,0,0,,38917,-38917
8,02/19/2017,30,7:15,7:30,,10.86,0,10.86,10.86,-1,-35277,103329,138606,68052,0,-44038,0,0,0,,44038,-44038
8,02/19/2017,31,7:30,7:45,,10.52,0,10.52,10.52,-1,-30505,79892,110397,49387,0,-52386,0,0,0,,52386,-52386
8,02/19/2017,32,7:45,8:00,,-5.81,0,-5.81,-5.81,-1,-17865,77335,95200,59470,0,-31768,0,0,0,,31768,-31768
8,02/19/2017,33,8:00,8:15,,-66.3,0,-66.3,-66.3,-1,-61971,136058,198029,74087,0,-59722,0,0,0,,59722,-59722
8,02/19/2017,34,8:15,8:30,,20.59,0,20.59,20.59,-1,-63493,120404,183897,56911,0,-54520,0,0,0,,54520,-54520
8,02/19/2017,35,8:30,8:45,32.49,26.43,0,32.49,32.49,1,-67821,73596,141417,5775,0,-30961,127,0,0,,31088,-30834
8,02/19/2017,36,8:45,9:00,36.43,30.65,0,36.43,30.65,2,-56331,38366,94697,-17965,0,-746,8486,0,0,,9232,7740
8,02/19/2017,37,9:00,9:15,36.43,-66.81,0,-66.81,-66.81,-1,-24470,137903,162373,113433,0,-42510,286,0,0,,42796,-42224
8,02/19/2017,38,9:15,9:30,,24.03,0,24.03,24.03,-1,-54855,88193,143048,33338,0,-49892,0,0,0,,49892,-49892
8,02/19/2017,39,9:30,9:45,,30.63,0,30.63,30.63,-1,-57129,60427,117556,3298,0,-19144,0,0,0,,19144,-19144
8,02/19/2017,40,9:45,10:00,32.63,30.63,0,32.63,32.63,1,-57826,46410,104236,-11416,0,-595,482,0,0,,1077,-113
8,02/19/2017,41,10:00,10:15,,33.39,0,33.39,33.39,-1,-70774,63998,134772,-6776,0,-446,0,0,0,,446,-446
8,02/19/2017,42,10:15,10:30,31.89,33.39,0,32.01,32.01,2,-65154,49111,114265,-16043,0,-1473,42,0,0,,1515,-1431
8,02/19/2017,43,10:30,10:45,32.63,,0,32.63,32.63,1,-66413,52104,118517,-14309,0,0,1828,0,0,,1828,1828
8,02/19/2017,44,10:45,11:00,30.63,,0,30.63,30.63,1,-75722,46055,121777,-29667,0,0,1080,0,0,,1080,1080
8,02/19/2017,45,11:00,11:15,30.63,-0.63,0,-0.63,-0.63,-1,-54699,114138,168837,59439,0,-22885,27,0,0,,22912,-22858
8,02/19/2017,46,11:15,11:30,,-3.57,0,-3.57,-3.57,-1,-34310,68572,102882,34262,0,-44973,0,0,0,,44973,-44973
8,02/19/2017,47,11:30,11:45,,27.51,0,27.51,27.51,-1,-40630,64157,104787,23527,0,-36607,0,0,0,,36607,-36607
8,02/19/2017,48,11:45,12:00,32.63,30.88,0,32.63,32.63,1,-47031,53152,100183,6121,0,-10363,391,0,0,,10754,-9972
8,02/19/2017,49,12:00,12:15,34.05,,0,34.05,34.05,1,-117079,63234,180313,-53845,0,0,2080,0,0,,2080,2080
8,02/19/2017,50,12:15,12:30,,,0,32.01,32.01,0,-98962,50230,149192,-48732,0,0,0,0,0,,0,0
8,02/19/2017,51,12:30,12:45,31.95,,0,31.95,31.95,1,-69439,60310,129749,-9129,0,0,456,0,0,,456,456
8,02/19/2017,52,12:45,13:00,31.95,32.29,0,32.01,32.01,2,-76046,53871,129917,-22175,0,-23,915,0,0,,938,892
8,02/19/2017,53,13:00,13:15,31.95,-66.12,0,-66.12,-66.12,-1,-20051,109224,129275,89173,0,-37386,63,0,0,,37449,-37323
8,02/19/2017,54,13:15,13:30,,26.43,0,26.43,26.43,-1,-50614,72095,122709,21481,0,-33843,0,0,0,,33843,-33843
8,02/19/2017,55,13:30,13:45,,25.63,0,25.63,25.63,-1,-59510,94836,154346,35326,0,-27000,0,0,0,,27000,-27000
8,02/19/2017,56,13:45,14:00,,25.63,0,25.63,25.63,-1,-65984,97140,163124,31156,0,-35259,0,0,0,,35259,-35259
8,02/19/2017,57,14:00,14:15,,30.88,0,30.88,30.88,-1,-54873,81864,136737,26991,0,-15060,0,0,0,,15060,-15060
8,02/19/2017,58,14:15,14:30,,,0,32.01,32.01,0,-52867,85090,137957,32223,0,-104,0,0,0,,104,-104
8,02/19/2017,59,14:30,14:45,,,0,32.01,32.01,0,-50188,102152,152340,51964,0,0,0,0,0,,0,0
8,02/19/2017,60,14:45,15:00,,26.8,0,26.8,26.8,-1,-42304,118307,160611,76003,0,-4637,0,0,0,,4637,-4637
8,02/19/2017,61,15:00,15:15,,26.84,0,26.84,26.84,-1,-41995,173403,215398,131408,0,-13430,0,0,0,,13430,-13430
8,02/19/2017,62,15:15,15:30,,4.14,0,4.14,4.14,-1,-42455,169403,211858,126948,0,-22423,0,0,0,,22423,-22423
8,02/19/2017,63,15:30,15:45,,-12.64,0,-12.64,-12.64,-1,-53588,168153,221741,114565,0,-46853,0,0,0,,46853,-46853
8,02/19/2017,64,15:45,16:00,,-5.28,0,-5.28,-5.28,-1,-65246,158826,224072,93580,0,-62841,0,0,0,,62841,-62841
8,02/19/2017,65,16:00,16:15,,26.98,0,26.98,26.98,-1,-73025,177726,250751,104701,0,-34578,0,0,0,,34578,-34578
8,02/19/2017,66,16:15,16:30,,30.42,0,30.42,30.42,-1,-42031,156844,198875,114813,0,-6447,0,0,0,,6447,-6447
8,02/19/2017,67,16:30,16:45,,30.42,0,30.42,30.42,-1,-34396,127767,162163,93371,0,-5691,0,0,0,,5691,-5691
8,02/19/2017,68,16:45,17:00,,,0,32.01,32.01,0,-29417,91406,120823,61989,0,-116,0,0,0,,116,-116
8,02/19/2017,69,17:00,17:15,,20.17,0,20.17,20.17,-1,-37510,132886,170396,95376,0,-9927,0,0,0,,9927,-9927
8,02/19/2017,70,17:15,17:30,,30.03,0,30.03,30.03,-1,-45338,89510,134848,44172,0,-14701,0,0,0,,14701,-14701
8,02/19/2017,71,17:30,17:45,36.63,30.03,0,36.63,36.63,1,-45523,45636,91159,113,0,-350,1598,0,0,,1948,1248
8,02/19/2017,72,17:45,18:00,87.83,,0,87.83,87.83,1,-73106,28150,101256,-44956,0,0,36989,0,0,,36989,36989
8,02/19/2017,73,18:00,18:15,40.09,-9.34,0,40.09,-9.34,2,-71999,126189,198188,54190,0,-11401,16859,0,0,,28260,5458
8,02/19/2017,74,18:15,18:30,,32.15,0,32.15,32.15,-1,-61794,82388,144182,20594,0,-3813,0,0,0,,3813,-3813
8,02/19/2017,75,18:30,18:45,,32.15,0,32.15,32.15,-1,-53030,83363,136393,30333,0,-1094,0,0,0,,1094,-1094
8,02/19/2017,76,18:45,19:00,,34.99,0,34.99,34.99,-1,-57649,85969,143618,28320,0,-196,0,0,0,,196,-196
8,02/19/2017,77,19:00,19:15,,,0,33.43,33.43,0,-93255,48478,141733,-44777,0,0,0,0,0,,0,0
8,02/19/2017,78,19:15,19:30,,,0,33.43,33.43,0,-108596,57365,165961,-51231,0,0,0,0,0,,0,0
8,02/19/2017,79,19:30,19:45,,,0,33.43,33.43,0,-113395,72647,186042,-40748,0,0,0,0,0,,0,0
8,02/19/2017,80,19:45,20:00,,,0,33.43,33.43,0,-135398,76378,211776,-59020,0,0,0,0,0,,0,0
8,02/19/2017,81,20:00,20:15,52.61,,0,52.61,52.61,1,-130723,44972,175695,-85751,0,0,13416,0,0,,13416,13416
8,02/19/2017,82,20:15,20:30,35.56,,0,35.56,35.56,1,-130740,64304,195044,-66436,0,0,9351,0,0,,9351,9351
8,02/19/2017,83,20:30,20:45,,32.29,0,32.29,32.29,-1,-111625,84532,196157,-27093,0,-87,0,0,0,,87,-87
8,02/19/2017,84,20:45,21:00,,29.63,0,29.63,29.63,-1,-103673,135518,239191,31845,0,-13503,0,0,0,,13503,-13503
8,02/19/2017,85,21:00,21:15,136.02,34.93,0,136.02,33.48,2,-102257,42759,145016,-59498,0,-5029,19298,0,0,,24327,14269
8,02/19/2017,86,21:15,21:30,36.12,,0,36.12,36.12,1,-71630,76455,148085,4825,0,0,8374,0,0,,8374,8374
8,02/19/2017,87,21:30,21:45,,32.36,0,32.36,32.36,-1,-58310,102045,160355,43735,0,-131,0,0,0,,131,-131
8,02/19/2017,88,21:45,22:00,,-18.61,0,-18.61,-18.61,-1,-61320,147697,209017,86377,0,-8954,0,0,0,,8954,-8954
8,02/19/2017,89,22:00,22:15,,-43.12,0,-43.12,-43.12,-1,-77731,49223,126954,-28508,0,-19276,0,0,0,,19276,-19276
8,02/19/2017,90,22:15,22:30,,25.63,0,25.63,25.63,-1,-66370,79281,145651,12911,0,-3922,0,0,0,,3922,-3922
8,02/19/2017,91,22:30,22:45,,25.26,0,25.26,25.26,-1,-62775,125220,187995,62445,0,-24025,0,0,0,,24025,-24025
8,02/19/2017,92,22:45,23:00,,-21.73,0,-21.73,-21.73,-1,-54373,151861,206234,97488,0,-56477,0,0,0,,56477,-56477
8,02/19/2017,93,23:00,23:15,32.36,-18.3,0,32.36,32.36,1,-85351,62221,147572,-23130,0,-42941,61,0,0,,43002,-42880
8,02/19/2017,94,23:15,23:30,32.63,29.38,0,32.63,29.38,2,-72418,74123,146541,1705,0,-1022,190,0,0,,1212,-832
8,02/19/2017,95,23:30,23:45,,4.13,0,4.13,4.13,-1,-38767,108061,146828,69294,0,-50097,0,0,0,,50097,-50097
8,02/19/2017,96,23:45,0:00,,21.03,0,21.03,21.03,-1,-43992,141148,185140,97156,0,-76023,0,0,0,,76023,-76023
8,02/20/2017,1,0:00,0:15,31.92,21.64,0,31.92,31.92,1,-46403,44956,91359,-1447,0,-41229,96,0,0,,41325,-41133
8,02/20/2017,2,0:15,0:30,32.59,21.64,0,32.59,32.59,1,-68097,58220,126317,-9877,0,-208,707,0,0,,915,499
8,02/20/2017,3,0:30,0:45,,34.93,0,34.93,34.93,-1,-77549,76197,153746,-1352,0,-145,0,0,0,,145,-145
8,02/20/2017,4,0:45,1:00,,19.59,0,19.59,19.59,-1,-65665,93126,158791,27461,0,-18219,0,0,0,,18219,-18219
8,02/20/2017,5,1:00,1:15,,18.29,0,18.29,18.29,-1,-54025,78393,132418,24368,0,-32563,0,0,0,,32563,-32563
8,02/20/2017,6,1:15,1:30,,29.56,0,29.56,29.56,-1,-53729,60846,114575,7117,0,-17837,0,0,0,,17837,-17837
8,02/20/2017,7,1:30,1:45,,25.77,0,25.77,25.77,-1,-43924,86518,130442,42594,0,-33325,0,0,0,,33325,-33325
8,02/20/2017,8,1:45,2:00,,-53.59,0,-53.59,-53.59,-1,-34263,105274,139537,71011,0,-62616,0,0,0,,62616,-62616
8,02/20/2017,9,2:00,2:15,,25.77,0,25.77,25.77,-1,-58821,61120,119941,2299,0,-23724,0,0,0,,23724,-23724
8,02/20/2017,10,2:15,2:30,,29.59,0,29.59,29.59,-1,-47156,62617,109773,15461,0,-12107,0,0,0,,12107,-12107
8,02/20/2017,11,2:30,2:45,,27.77,0,27.77,27.77,-1,-31802,63750,95552,31948,0,-20907,0,0,0,,20907,-20907
8,02/20/2017,12,2:45,3:00,,25.77,0,25.77,25.77,-1,-34919,72260,107179,37341,0,-41540,0,0,0,,41540,-41540
8,02/20/2017,13,3:00,3:15,,28.98,0,28.98,28.98,-1,-30174,53116,83290,22942,0,-25821,0,0,0,,25821,-25821
8,02/20/2017,14,3:15,3:30,,25.26,0,25.26,25.26,-1,-23399,57862,81261,34463,0,-10801,0,0,0,,10801,-10801
8,02/20/2017,15,3:30,3:45,,22.78,0,22.78,22.78,-1,-16575,60034,76609,43459,0,-32708,0,0,0,,32708,-32708
8,02/20/2017,16,3:45,4:00,,24.64,0,24.64,24.64,-1,-15202,63661,78863,48459,0,-32081,0,0,0,,32081,-32081
8,02/20/2017,17,4:00,4:15,,20.64,0,20.64,20.64,-1,-29828,62395,92223,32567,0,-45027,0,0,0,,45027,-45027
8,02/20/2017,18,4:15,4:30,,21.44,0,21.44,21.44,-1,-25207,74447,99654,49240,0,-35836,0,0,0,,35836,-35836
8,02/20/2017,19,4:30,4:45,,21.44,0,21.44,21.44,-1,-21182,84663,105845,63481,0,-54344,0,0,0,,54344,-54344
8,02/20/2017,20,4:45,5:00,,26.78,0,26.78,26.78,-1,-27865,71948,99813,44083,0,-42709,0,0,0,,42709,-42709
8,02/20/2017,21,5:00,5:15,,2.9,0,2.9,2.9,-1,-20680,82698,103378,62018,0,-52709,0,0,0,,52709,-52709
8,02/20/2017,22,5:15,5:30,,4.78,0,4.78,4.78,-1,-25480,104433,129913,78953,0,-92755,0,0,0,,92755,-92755
8,02/20/2017,23,5:30,5:45,,17.29,0,17.29,17.29,-1,-27655,81691,109346,54036,0,-73688,0,0,0,,73688,-73688
8,02/20/2017,24,5:45,6:00,,-18.78,0,-18.78,-18.78,-1,-18617,79741,98358,61124,0,-13779,0,0,0,,13779,-13779
8,02/20/2017,25,6:00,6:15,,-41.36,0,-41.36,-41.36,-1,-56262,100273,156535,44011,0,-37653,0,0,0,,37653,-37653
8,02/20/2017,26,6:15,6:30,,26.78,0,26.78,26.78,-1,-40749,87419,128168,46670,0,-29335,0,0,0,,29335,-29335
8,02/20/2017,27,6:30,6:45,,34.93,0,34.93,34.93,-1,-22713,34104,56817,11391,0,-7919,0,0,0,,7919,-7919
8,02/20/2017,28,6:45,7:00,30.59,,0,30.59,30.59,1,-46818,29364,76182,-17454,0,0,448,0,0,,448,448
8,02/20/2017,29,7:00,7:15,30.59,-42.72,0,-42.72,-42.72,-1,-20159,143984,164143,123825,0,-33159,43,0,0,,33202,-33116
8,02/20/2017,30,7:15,7:30,,-27.1,0,-27.1,-27.1,-1,-24821,86049,110870,61228,0,-69690,0,0,0,,69690,-69690
8,02/20/2017,31,7:30,7:45,,25.66,0,25.66,25.66,-1,-29734,68336,98070,38602,0,-48718,0,0,0,,48718,-48718
8,02/20/2017,32,7:45,8:00,,30.17,0,30.17,30.17,-1,-42436,58643,101079,16207,0,-12662,0,0,0,,12662,-12662
8,02/20/2017,33,8:00,8:15,,-50.87,0,-50.87,-50.87,-1,-31293,123804,155097,92511,0,-50050,0,0,0,,50050,-50050
8,02/20/2017,34,8:15,8:30,,25.26,0,25.26,25.26,-1,-55409,93084,148493,37675,0,-44289,0,0,0,,44289,-44289
8,02/20/2017,35,8:30,8:45,,30.59,0,30.59,30.59,-1,-56863,90077,146940,33214,0,-34001,0,0,0,,34001,-34001
8,02/20/2017,36,8:45,9:00,,31.09,0,31.09,31.09,-1,-61803,63454,125257,1651,0,-18414,0,0,0,,18414,-18414
8,02/20/2017,37,9:00,9:15,32.59,-7.78,0,33.79,-7.78,2,-29005,106298,135303,77293,0,-18878,31,0,0,,18909,-18847
8,02/20/2017,38,9:15,9:30,,26.43,0,26.43,26.43,-1,-30623,82357,112980,51734,0,-42116,0,0,0,,42116,-42116
8,02/20/2017,39,9:30,9:45,,26.43,0,26.43,26.43,-1,-34109,77636,111745,43527,0,-50488,0,0,0,,50488,-50488
8,02/20/2017,40,9:45,10:00,,30.59,0,30.59,30.59,-1,-47646,59263,106909,11617,0,-22434,0,0,0,,22434,-22434
8,02/20/2017,41,10:00,10:15,,30.42,0,30.42,30.42,-1,-47421,79022,126443,31601,0,-10241,0,0,0,,10241,-10241
8,02/20/2017,42,10:15,10:30,,29.59,0,29.59,29.59,-1,-51697,68264,119961,16567,0,-22325,0,0,0,,22325,-22325
8,02/20/2017,43,10:30,10:45,,31.58,0,31.58,31.58,-1,-60636,66644,127280,6008,0,-17894,0,0,0,,17894,-17894
8,02/20/2017,44,10:45,11:00,33.42,31.58,0,33.42,33.42,1,-60220,42052,102272,-18168,0,-3018,560,0,0,,3578,-2458
8,02/20/2017,45,11:00,11:15,49.85,,0,49.85,49.85,1,-99821,29057,128878,-70764,0,0,12661,0,0,,12661,12661
8,02/20/2017,46,11:15,11:30,36.77,,0,36.77,36.77,1,-99875,35722,135597,-64153,0,0,7045,0,0,,7045,7045
8,02/20/2017,47,11:30,11:45,60.85,,0,60.85,60.85,1,-93441,29723,123164,-63718,0,0,17097,0,0,,17097,17097
8,02/20/2017,48,11:45,12:00,34.85,,0,34.85,34.85,1,-87372,38993,126365,-48379,0,0,5045,0,0,,5045,5045
8,02/20/2017,49,12:00,12:15,143.98,,0,143.98,143.98,1,-93385,21984,115369,-71401,0,0,21189,0,0,,21189,21189
8,02/20/2017,50,12:15,12:30,39.48,34.72,0,34.72,34.72,-1,-57476,48289,105765,-9187,0,-3,9241,0,0,,9244,9238
8,02/20/2017,51,12:30,12:45,,33.52,0,33.52,33.52,-1,-50946,46891,97837,-4055,0,-426,0,0,0,,426,-426
8,02/20/2017,52,12:45,13:00,,32.82,0,32.82,32.82,-1,-68108,43695,111803,-24413,0,-1496,0,0,0,,1496,-1496
8,02/20/2017,53,13:00,13:15,54.7,34.72,0,54.7,54.7,1,-79475,26797,106272,-52678,0,-176,9579,0,0,,9755,9403
8,02/20/2017,54,13:15,13:30,54.7,,0,54.7,54.7,1,-72490,40435,112925,-32055,0,0,25221,0,0,,25221,25221
8,02/20/2017,55,13:30,13:45,,,0,33.3,33.3,0,-64352,48868,113220,-15484,0,0,4869,0,0,,4869,4869
8,02/20/2017,56,13:45,14:00,32.59,,0,32.59,32.59,1,-69901,53798,123699,-16103,0,0,248,0,0,,248,248
8,02/20/2017,57,14:00,14:15,34.19,,0,34.19,34.19,1,-45295,36259,81554,-9036,0,0,1009,0,0,,1009,1009
8,02/20/2017,58,14:15,14:30,34.19,,0,34.19,34.19,1,-40610,33865,74475,-6745,0,0,771,0,0,,771,771
8,02/20/2017,59,14:30,14:45,,34.22,0,34.22,34.22,-1,-31057,47286,78343,16229,0,-49,0,0,0,,49,-49
8,02/20/2017,60,14:45,15:00,,29.59,0,29.59,29.59,-1,-27904,51503,79407,23599,0,-2603,0,0,0,,2603,-2603
8,02/20/2017,61,15:00,15:15,,29.94,0,29.94,29.94,-1,-28424,53466,81890,25042,0,-1619,0,0,0,,1619,-1619
8,02/20/2017,62,15:15,15:30,,32.82,0,32.82,32.82,-1,-24212,42553,66765,18341,0,-287,0,0,0,,287,-287
8,02/20/2017,63,15:30,15:45,,30.59,0,30.59,30.59,-1,-29780,47712,77492,17932,0,-2100,0,0,0,,2100,-2100
8,02/20/2017,64,15:45,16:00,,25.19,0,25.19,25.19,-1,-23419,54408,77827,30989,0,-18997,0,0,0,,18997,-18997
8,02/20/2017,65,16:00,16:15,,26.77,0,26.77,26.77,-1,-39047,76718,115765,37671,0,-22021,0,0,0,,22021,-22021
8,02/20/2017,66,16:15,16:30,,26.77,0,26.77,26.77,-1,-33527,69834,103361,36307,0,-1481,0,0,0,,1481,-1481
8,02/20/2017,67,16:30,16:45,,21.09,0,21.09,21.09,-1,-22454,54336,76790,31882,0,-19063,0,0,0,,19063,-19063
8,02/20/2017,68,16:45,17:00,,32.82,0,32.82,32.82,-1,-45259,51694,96953,6435,0,-6324,0,0,0,,6324,-6324
8,02/20/2017,69,17:00,17:15,,29.49,0,29.49,29.49,-1,-50465,49263,99728,-1202,0,-5796,0,0,0,,5796,-5796
8,02/20/2017,70,17:15,17:30,,34.2,0,34.2,34.2,-1,-46520,37164,83684,-9356,0,-2946,0,0,0,,2946,-2946
8,02/20/2017,71,17:30,17:45,,33.68,0,33.68,33.68,-1,-40275,38492,78767,-1783,0,-1996,0,0,0,,1996,-1996
8,02/20/2017,72,17:45,18:00,36.59,34.79,0,36.59,32.74,2,-63455,46536,109991,-16919,0,-1066,2098,0,0,,3164,1032
8,02/20/2017,73,18:00,18:15,36.59,13.6,0,13.6,13.6,-1,-39810,79366,119176,39556,0,-20277,160,0,0,,20437,-20117
8,02/20/2017,74,18:15,18:30,,16.28,0,16.28,16.28,-1,-20483,83892,104375,63409,0,-50537,0,0,0,,50537,-50537
8,02/20/2017,75,18:30,18:45,,16.28,0,16.28,16.28,-1,-20824,100240,121064,79416,0,-68051,0,0,0,,68051,-68051
8,02/20/2017,76,18:45,19:00,,25.8,0,25.8,25.8,-1,-62499,103304,165803,40805,0,-45494,0,0,0,,45494,-45494
8,02/20/2017,77,19:00,19:15,,29.59,0,29.59,29.59,-1,-41700,60375,102075,18675,0,-24111,0,0,0,,24111,-24111
8,02/20/2017,78,19:15,19:30,,29.52,0,29.52,29.52,-1,-31594,50437,82031,18843,0,-4391,0,0,0,,4391,-4391
8,02/20/2017,79,19:30,19:45,,27.78,0,27.78,27.78,-1,-19506,42901,62407,23395,0,-22833,0,0,0,,22833,-22833
8,02/20/2017,80,19:45,20:00,,27.77,0,27.77,27.77,-1,-30216,52151,82367,21935,0,-20617,0,0,0,,20617,-20617
8,02/20/2017,81,20:00,20:15,32.59,26.78,0,32.59,26.78,2,-56185,31408,87593,-24777,0,-16962,521,0,0,,17483,-16441
8,02/20/2017,82,20:15,20:30,33.12,26.78,0,33.12,33.12,1,-67557,18970,86527,-48587,0,-312,775,0,0,,1087,463
8,02/20/2017,83,20:30,20:45,,31.09,0,31.09,31.09,-1,-27233,36164,63397,8931,0,-3431,0,0,0,,3431,-3431
8,02/20/2017,84,20:45,21:00,,27.77,0,27.77,27.77,-1,-36428,55145,91573,18717,0,-11010,0,0,0,,11010,-11010
8,02/20/2017,85,21:00,21:15,38.94,27.19,0,38.94,38.94,1,-54232,37133,91365,-17099,0,-8798,5575,0,0,,14373,-3223
8,02/20/2017,86,21:15,21:30,32.64,30.59,0,30.59,30.59,-1,-35985,41494,77479,5509,0,-488,4422,0,0,,4910,3934
8,02/20/2017,87,21:30,21:45,,25.66,0,25.66,25.66,-1,-27540,53909,81449,26369,0,-23380,0,0,0,,23380,-23380
8,02/20/2017,88,21:45,22:00,,25.8,0,25.8,25.8,-1,-32688,70119,102807,37431,0,-32726,0,0,0,,32726,-32726
8,02/20/2017,89,22:00,22:15,32.59,26.78,0,32.59,32.59,1,-44510,37852,82362,-6658,0,-19906,157,0,0,,20063,-19749
8,02/20/2017,90,22:15,22:30,32.59,26.78,0,32.59,32.59,1,-43580,37781,81361,-5799,0,-59,262,0,0,,321,203
8,02/20/2017,91,22:30,22:45,,22.4,0,22.4,22.4,-1,-36092,77834,113926,41742,0,-13730,0,0,0,,13730,-13730
8,02/20/2017,92,22:45,23:00,,12.62,0,12.62,12.62,-1,-45817,118310,164127,72493,0,-65509,0,0,0,,65509,-65509
8,02/20/2017,93,23:00,23:15,36.59,12.62,0,36.59,36.59,1,-77491,17670,95161,-59821,0,-24511,1860,0,0,,26371,-22651
8,02/20/2017,94,23:15,23:30,36.59,34.83,0,34.83,34.83,-1,-55331,40757,96088,-14574,0,-7,49,0,0,,56,42
8,02/20/2017,95,23:30,23:45,,21.49,0,21.49,21.49,-1,-39769,75945,115714,36176,0,-16786,0,0,0,,16786,-16786
8,02/20/2017,96,23:45,0:00,,-7.83,0,-7.83,-7.83,-1,-67616,109395,177011,41779,0,-65483,0,0,0,,65483,-65483
8,02/21/2017,1,0:00,0:15,,24.81,0,24.81,24.81,-1,-60920,115851,176771,54931,0,-26342,0,0,0,,26342,-26342
8,02/21/2017,2,0:15,0:30,,11.5,0,11.5,11.5,-1,-69214,83046,152260,13832,0,-19426,0,0,0,,19426,-19426
8,02/21/2017,3,0:30,0:45,37.53,11.5,0,37.53,37.53,1,-88627,61131,149758,-27496,0,-323,10047,0,0,,10370,9724
8,02/21/2017,4,0:45,1:00,37.53,30.53,0,30.53,30.53,-1,-82136,78858,160994,-3278,0,-1985,2115,0,0,,4100,130
8,02/21/2017,5,1:00,1:15,32.86,30.53,0,32.86,32.86,1,-42358,30741,73099,-11617,0,-2985,851,0,0,,3836,-2134
8,02/21/2017,6,1:15,1:30,32.86,32.43,0,32.43,32.43,-1,-41986,43200,85186,1214,0,-576,509,0,0,,1085,-67
8,02/21/2017,7,1:30,1:45,,31.53,0,31.53,31.53,-1,-49836,50393,100229,557,0,-3076,0,0,0,,3076,-3076
8,02/21/2017,8,1:45,2:00,,31.02,0,31.02,31.02,-1,-51463,58416,109879,6953,0,-2923,0,0,0,,2923,-2923
8,02/21/2017,9,2:00,2:15,,26.53,0,26.53,26.53,-1,-29046,48348,77394,19302,0,-7472,0,0,0,,7472,-7472
8,02/21/2017,10,2:15,2:30,,12.03,0,12.03,12.03,-1,-32071,34986,67057,2915,0,-19862,0,0,0,,19862,-19862
8,02/21/2017,11,2:30,2:45,,,0,32.76,32.76,0,-35168,43424,78592,8256,0,-3097,0,0,0,,3097,-3097
8,02/21/2017,12,2:45,3:00,,,0,32.76,32.76,0,-49817,34992,84809,-14825,0,0,0,0,0,,0,0
8,02/21/2017,13,3:00,3:15,,26.53,0,26.53,26.53,-1,-44581,34321,78902,-10260,0,-4333,0,0,0,,4333,-4333
8,02/21/2017,14,3:15,3:30,,30.63,0,30.63,30.63,-1,-44804,44555,89359,-249,0,-1376,0,0,0,,1376,-1376
8,02/21/2017,15,3:30,3:45,,30.53,0,30.53,30.53,-1,-38659,52325,90984,13666,0,-11035,0,0,0,,11035,-11035
8,02/21/2017,16,3:45,4:00,,26.53,0,26.53,26.53,-1,-37251,60511,97762,23260,0,-23661,0,0,0,,23661,-23661
8,02/21/2017,17,4:00,4:15,,0.49,0,0.49,0.49,-1,-46794,88909,135703,42115,0,-42301,0,0,0,,42301,-42301
8,02/21/2017,18,4:15,4:30,,24.03,0,24.03,24.03,-1,-54237,86985,141222,32748,0,-49447,0,0,0,,49447,-49447
8,02/21/2017,19,4:30,4:45,,29.65,0,29.65,29.65,-1,-51503,83169,134672,31666,0,-29325,0,0,0,,29325,-29325
8,02/21/2017,20,4:45,5:00,,-272.92,0,-272.92,-272.92,-1,-43024,98831,141855,55807,0,-36265,0,0,0,,36265,-36265
8,02/21/2017,21,5:00,5:15,,-4.03,0,-4.03,-4.03,-1,-53740,124984,178724,71244,0,-28258,0,0,0,,28258,-28258
8,02/21/2017,22,5:15,5:30,,-65.94,0,-65.94,-65.94,-1,-62219,87938,150157,25719,0,-36785,0,0,0,,36785,-36785
8,02/21/2017,23,5:30,5:45,,,0,32.76,32.76,0,-72891,71222,144113,-1669,0,-2817,0,0,0,,2817,-2817
8,02/21/2017,24,5:45,6:00,,31.53,0,31.53,31.53,-1,-42175,66077,108252,23902,0,-3188,0,0,0,,3188,-3188
8,02/21/2017,25,6:00,6:15,,-240.32,0,-240.32,-240.32,-1,-65361,146485,211846,81124,0,-42418,0,0,0,,42418,-42418
8,02/21/2017,26,6:15,6:30,,-5.03,0,-5.03,-5.03,-1,-51165,120713,171878,69548,0,-55272,0,0,0,,55272,-55272
8,02/21/2017,27,6:30,6:45,,31.53,0,31.53,31.53,-1,-38843,83104,121947,44261,0,-28295,0,0,0,,28295,-28295
8,02/21/2017,28,6:45,7:00,,,0,32.26,32.26,0,-34185,59149,93334,24964,0,-7626,0,0,0,,7626,-7626
8,02/21/2017,29,7:00,7:15,,-455.13,0,-455.13,-455.13,-1,-29683,154936,184619,125253,0,-40894,0,0,0,,40894,-40894
8,02/21/2017,30,7:15,7:30,,28.22,0,28.22,28.22,-1,-44651,76017,120668,31366,0,-29245,0,0,0,,29245,-29245
8,02/21/2017,31,7:30,7:45,33.42,31.53,0,33.42,31.53,2,-44765,54335,99100,9570,0,-18266,74,0,0,,18340,-18192
8,02/21/2017,32,7:45,8:00,33.53,31.53,0,33.53,33.53,1,-84394,45335,129729,-39059,0,-925,627,0,0,,1552,-298
8,02/21/2017,33,8:00,8:15,,21,0,21,21,-1,-62145,97973,160118,35828,0,-6401,0,0,0,,6401,-6401
8,02/21/2017,34,8:15,8:30,,23.16,0,23.16,23.16,-1,-77518,71333,148851,-6185,0,-11339,0,0,0,,11339,-11339
8,02/21/2017,35,8:30,8:45,,,0,34.3,34.3,0,-56033,41663,97696,-14370,0,-9,0,0,0,,9,-9
8,02/21/2017,36,8:45,9:00,,,0,34.27,34.27,0,-97219,59426,156645,-37793,0,0,0,0,0,,0,0
8,02/21/2017,37,9:00,9:15,,29.9,0,29.9,29.9,-1,-47180,90013,137193,42833,0,-6419,0,0,0,,6419,-6419
8,02/21/2017,38,9:15,9:30,,29.88,0,29.88,29.88,-1,-56482,75539,132021,19057,0,-10017,0,0,0,,10017,-10017
8,02/21/2017,39,9:30,9:45,,25.83,0,25.83,25.83,-1,-41240,103505,144745,62265,0,-18038,0,0,0,,18038,-18038
8,02/21/2017,40,9:45,10:00,,25.83,0,25.83,25.83,-1,-50436,83512,133948,33076,0,-32561,0,0,0,,32561,-32561
8,02/21/2017,41,10:00,10:15,,25.83,0,25.83,25.83,-1,-28910,92340,121250,63430,0,-28457,0,0,0,,28457,-28457
8,02/21/2017,42,10:15,10:30,,20.54,0,20.54,20.54,-1,-47458,99505,146963,52047,0,-50430,0,0,0,,50430,-50430
8,02/21/2017,43,10:30,10:45,,29.83,0,29.83,29.83,-1,-46231,95131,141362,48900,0,-27242,0,0,0,,27242,-27242
8,02/21/2017,44,10:45,11:00,,16.74,0,16.74,16.74,-1,-47898,119197,167095,71299,0,-48356,0,0,0,,48356,-48356
8,02/21/2017,45,11:00,11:15,,9.72,0,9.72,9.72,-1,-52321,119849,172170,67528,0,-59303,0,0,0,,59303,-59303
8,02/21/2017,46,11:15,11:30,,29.83,0,29.83,29.83,-1,-53167,128263,181430,75096,0,-26169,0,0,0,,26169,-26169
8,02/21/2017,47,11:30,11:45,,-27.41,0,-27.41,-27.41,-1,-33289,139087,172376,105798,0,-11543,0,0,0,,11543,-11543
8,02/21/2017,48,11:45,12:00,,-27.41,0,-27.41,-27.41,-1,-56706,96962,153668,40256,0,-12131,0,0,0,,12131,-12131
8,02/21/2017,49,12:00,12:15,,32.15,0,32.15,32.15,-1,-78868,118432,197300,39564,0,-1864,0,0,0,,1864,-1864
8,02/21/2017,50,12:15,12:30,,30.83,0,30.83,30.83,-1,-86143,112751,198894,26608,0,-4841,0,0,0,,4841,-4841
8,02/21/2017,51,12:30,12:45,,30.15,0,30.15,30.15,-1,-79857,114976,194833,35119,0,-5866,0,0,0,,5866,-5866
8,02/21/2017,52,12:45,13:00,,26.28,0,26.28,26.28,-1,-74779,121099,195878,46320,0,-20464,0,0,0,,20464,-20464
8,02/21/2017,53,13:00,13:15,,31.22,0,31.22,31.22,-1,-63483,112734,176217,49251,0,-20916,0,0,0,,20916,-20916
8,02/21/2017,54,13:15,13:30,,25.83,0,25.83,25.83,-1,-46614,120743,167357,74129,0,-9232,0,0,0,,9232,-9232
8,02/21/2017,55,13:30,13:45,,18.13,0,18.13,18.13,-1,-46649,99796,146445,53147,0,-21508,0,0,0,,21508,-21508
8,02/21/2017,56,13:45,14:00,,29.83,0,29.83,29.83,-1,-57996,86034,144030,28038,0,-30148,0,0,0,,30148,-30148
8,02/21/2017,57,14:00,14:15,,30.82,0,30.82,30.82,-1,-77339,136976,214315,59637,0,-32862,0,0,0,,32862,-32862
8,02/21/2017,58,14:15,14:30,,33.8,0,33.8,33.8,-1,-67799,110917,178716,43118,0,-4775,0,0,0,,4775,-4775
8,02/21/2017,59,14:30,14:45,,30.16,0,30.16,30.16,-1,-79885,108318,188203,28433,0,-21730,0,0,0,,21730,-21730
8,02/21/2017,60,14:45,15:00,34.98,33.73,0,34.98,34.98,1,-99671,94005,193676,-5666,0,-14466,219,0,0,,14685,-14247
8,02/21/2017,61,15:00,15:15,39.27,33.73,0,39.27,39.27,1,-100891,96262,197153,-4629,0,-322,5997,0,0,,6319,5675
8,02/21/2017,62,15:15,15:30,,,0,33.4,33.4,0,-84457,110719,195176,26262,0,0,91,0,0,,91,91
8,02/21/2017,63,15:30,15:45,33.03,35.1,0,33.4,33.4,2,-98838,87001,185839,-11837,0,-74,32,0,0,,106,-42
8,02/21/2017,64,15:45,16:00,37.16,,0,37.16,37.16,1,-98968,58457,157425,-40511,0,0,3467,0,0,,3467,3467
8,02/21/2017,65,16:00,16:15,37.16,29.11,0,29.11,29.11,-1,-57418,82586,140004,25168,0,-9795,13,0,0,,9808,-9782
8,02/21/2017,66,16:15,16:30,,32.48,0,32.48,32.48,-1,-56618,55584,112202,-1034,0,-9768,0,0,0,,9768,-9768
8,02/21/2017,67,16:30,16:45,,,0,33.34,33.34,0,-49187,57371,106558,8184,0,-44,0,0,0,,44,-44
8,02/21/2017,68,16:45,17:00,33.42,,0,33.42,33.42,1,-51011,45974,96985,-5037,0,0,226,0,0,,226,226
8,02/21/2017,69,17:00,17:15,33.42,,0,33.42,33.42,1,-115135,69900,185035,-45235,0,0,1797,0,0,,1797,1797
8,02/21/2017,70,17:15,17:30,33.03,,0,33.03,33.03,1,-118191,63018,181209,-55173,0,0,1175,0,0,,1175,1175
8,02/21/2017,71,17:30,17:45,36.15,,0,36.15,36.15,1,-104367,42733,147100,-61634,0,0,421,0,0,,421,421
8,02/21/2017,72,17:45,18:00,139.3,,0,139.3,139.3,1,-112071,18997,131068,-93074,0,0,41921,0,0,,41921,41921
8,02/21/2017,73,18:00,18:15,164.49,,0,164.49,164.49,1,-161375,22464,183839,-138911,0,0,54522,0,0,,54522,54522
8,02/21/2017,74,18:15,18:30,37.8,,0,37.8,37.8,1,-119158,32247,151405,-86911,0,0,3685,0,0,,3685,3685
8,02/21/2017,75,18:30,18:45,37.8,,0,37.8,37.8,1,-83712,26813,110525,-56899,0,0,1803,0,0,,1803,1803
8,02/21/2017,76,18:45,19:00,38.2,,0,38.2,38.2,1,-67779,32982,100761,-34797,0,0,1304,0,0,,1304,1304
8,02/21/2017,77,19:00,19:15,39.27,,0,39.27,39.27,1,-157182,47996,205178,-109186,0,0,8919,0,0,,8919,8919
8,02/21/2017,78,19:15,19:30,33.03,,0,33.03,33.03,1,-146090,63568,209658,-82522,0,0,3271,0,0,,3271,3271
8,02/21/2017,79,19:30,19:45,,33.8,0,33.8,33.8,-1,-110969,83246,194215,-27723,0,-38,0,0,0,,38,-38
8,02/21/2017,80,19:45,20:00,,14.71,0,14.71,14.71,-1,-80673,115440,196113,34767,0,-28486,0,0,0,,28486,-28486
8,02/21/2017,81,20:00,20:15,133.16,26.53,0,133.16,133.16,1,-112360,17070,129430,-95290,0,-22693,9069,0,0,,31762,-13624
8,02/21/2017,82,20:15,20:30,132.16,25.83,0,25.83,25.83,-1,-47092,45783,92875,-1309,0,-2327,13797,0,0,,16124,11470
8,02/21/2017,83,20:30,20:45,,-42.91,0,-42.91,-42.91,-1,-33009,62289,95298,29280,0,-30912,0,0,0,,30912,-30912
8,02/21/2017,84,20:45,21:00,,21.57,0,21.57,21.57,-1,-67902,62281,130183,-5621,0,-4467,0,0,0,,4467,-4467
8,02/21/2017,85,21:00,21:15,94.16,-27.36,0,94.16,-27.36,2,-94209,69123,163332,-25086,0,-17812,3306,0,0,,21118,-14506
8,02/21/2017,86,21:15,21:30,157.71,26.19,0,157.71,26.19,2,-54559,47021,101580,-7538,0,-1238,15922,0,0,,17160,14684
8,02/21/2017,87,21:30,21:45,,-43.01,0,-43.01,-43.01,-1,-54357,85657,140014,31300,0,-32496,0,0,0,,32496,-32496
8,02/21/2017,88,21:45,22:00,,30.53,0,30.53,30.53,-1,-105514,115138,220652,9624,0,-21975,0,0,0,,21975,-21975
8,02/21/2017,89,22:00,22:15,,26.53,0,26.53,26.53,-1,-36288,84519,120807,48231,0,-20350,0,0,0,,20350,-20350
8,02/21/2017,90,22:15,22:30,31.4,32.15,0,32.83,32.15,2,-47708,52191,99899,4483,0,-2034,345,0,0,,2379,-1689
8,02/21/2017,91,22:30,22:45,,22.86,0,22.86,22.86,-1,-40665,90105,130770,49440,0,-27419,0,0,0,,27419,-27419
8,02/21/2017,92,22:45,23:00,,-62.36,0,-62.36,-62.36,-1,-55660,107572,163232,51912,0,-63917,0,0,0,,63917,-63917
8,02/21/2017,93,23:00,23:15,32.68,-62.36,0,32.68,32.68,1,-66581,60605,127186,-5976,0,-6269,124,0,0,,6393,-6145
8,02/21/2017,94,23:15,23:30,,30.53,0,30.53,30.53,-1,-67057,73510,140567,6453,0,-957,0,0,0,,957,-957
8,02/21/2017,95,23:30,23:45,,-70.35,0,-70.35,-70.35,-1,-70070,107569,177639,37499,0,-35490,0,0,0,,35490,-35490
8,02/21/2017,96,23:45,0:00,,-70.35,0,-70.35,-70.35,-1,-100605,151553,252158,50948,0,-34656,0,0,0,,34656,-34656
8,02/22/2017,1,0:00,0:15,,29.68,0,29.68,29.68,-1,-92117,93333,185450,1216,0,-11478,0,0,0,,11478,-11478
8,02/22/2017,2,0:15,0:30,,27.59,0,27.59,27.59,-1,-72027,85124,157151,13097,0,-1003,0,0,0,,1003,-1003
8,02/22/2017,3,0:30,0:45,,25.68,0,25.68,25.68,-1,-86725,94046,180771,7321,0,-17776,0,0,0,,17776,-17776
8,02/22/2017,4,0:45,1:00,,29.49,0,29.49,29.49,-1,-97554,114496,212050,16942,0,-21771,0,0,0,,21771,-21771
8,02/22/2017,5,1:00,1:15,39.27,29.78,0,39.27,39.27,1,-75830,41810,117640,-34020,0,-12836,5729,0,0,,18565,-7107
8,02/22/2017,6,1:15,1:30,42.68,29.78,0,42.68,42.68,1,-118486,56824,175310,-61662,0,-189,18316,0,0,,18505,18127
8,02/22/2017,7,1:30,1:45,36.8,,0,36.8,36.8,1,-131062,97352,228414,-33710,0,0,16598,0,0,,16598,16598
8,02/22/2017,8,1:45,2:00,36.8,32.61,0,32.61,32.61,-1,-133625,108725,242350,-24900,0,-75,3851,0,0,,3926,3776
8,02/22/2017,9,2:00,2:15,36.68,32.61,0,36.68,29.95,2,-100576,64040,164616,-36536,0,-38,4086,0,0,,4124,4048
8,02/22/2017,10,2:15,2:30,38.1,,0,38.1,38.1,1,-137040,57708,194748,-79332,0,0,21500,0,0,,21500,21500
8,02/22/2017,11,2:30,2:45,39.09,,0,39.09,39.09,1,-138034,71550,209584,-66484,0,0,38087,0,0,,38087,38087
8,02/22/2017,12,2:45,3:00,33.59,,0,33.59,33.59,1,-137660,73249,210909,-64411,0,0,15331,0,0,,15331,15331
8,02/22/2017,13,3:00,3:15,35.65,,0,35.65,35.65,1,-133847,61510,195357,-72337,0,0,2908,0,0,,2908,2908
8,02/22/2017,14,3:15,3:30,35.65,,0,35.65,35.65,1,-123939,58816,182755,-65123,0,0,5282,0,0,,5282,5282
8,02/22/2017,15,3:30,3:45,,,0,31.64,31.64,0,-125383,64483,189866,-60900,0,0,0,0,0,,0,0
8,02/22/2017,16,3:45,4:00,,,0,31.64,31.64,0,-125029,58888,183917,-66141,0,0,0,0,0,,0,0
8,02/22/2017,17,4:00,4:15,32.87,,0,32.87,32.87,1,-119659,68999,188658,-50660,0,0,1199,0,0,,1199,1199
8,02/22/2017,18,4:15,4:30,36.68,,0,36.68,36.68,1,-119305,63063,182368,-56242,0,0,12270,0,0,,12270,12270
8,02/22/2017,19,4:30,4:45,33.53,,0,33.53,33.53,1,-120091,64678,184769,-55413,0,0,8498,0,0,,8498,8498
8,02/22/2017,20,4:45,5:00,30.5,,0,30.5,30.5,1,-123774,61315,185089,-62459,0,0,2157,0,0,,2157,2157
8,02/22/2017,21,5:00,5:15,38.1,,0,38.1,38.1,1,-140356,88377,228733,-51979,0,0,13570,0,0,,13570,13570
8,02/22/2017,22,5:15,5:30,32.68,29.1,0,29.1,29.1,-1,-112570,102985,215555,-9585,0,-1415,8039,0,0,,9454,6624
8,02/22/2017,23,5:30,5:45,47.23,29.1,0,47.23,47.23,1,-115175,57647,172822,-57528,0,-491,7060,0,0,,7551,6569
8,02/22/2017,24,5:45,6:00,47.23,,0,47.23,47.23,1,-136209,70076,206285,-66133,0,0,48442,0,0,,48442,48442
8,02/22/2017,25,6:00,6:15,34.39,23.5,0,23.5,23.5,-1,-136916,151502,288418,14586,0,-4217,17065,0,0,,21282,12848
8,02/22/2017,26,6:15,6:30,,30.88,0,30.88,30.88,-1,-129947,86916,216863,-43031,0,-2690,0,0,0,,2690,-2690
8,02/22/2017,27,6:30,6:45,36.87,,0,36.87,36.87,1,-128345,35675,164020,-92670,0,0,412,0,0,,412,412
8,02/22/2017,28,6:45,7:00,118.46,,0,118.46,118.46,1,-136103,22353,158456,-113750,0,0,49970,0,0,,49970,49970
8,02/22/2017,29,7:00,7:15,118.46,27.59,0,27.59,27.59,-1,-141597,190453,332050,48856,0,-5463,16436,0,0,,21899,10973
8,02/22/2017,30,7:15,7:30,33.97,32.93,0,33.97,33.97,1,-131055,108252,239307,-22803,0,-1084,499,0,0,,1583,-585
8,02/22/2017,31,7:30,7:45,34.59,,0,34.59,34.59,1,-97917,57214,155131,-40703,0,0,1758,0,0,,1758,1758
8,02/22/2017,32,7:45,8:00,34.9,,0,34.9,34.9,1,-105724,42382,148106,-63342,0,0,9279,0,0,,9279,9279
8,02/22/2017,33,8:00,8:15,34.9,33,0,33,33,-1,-122100,94940,217040,-27160,0,-272,1300,0,0,,1572,1028
8,02/22/2017,34,8:15,8:30,,33.5,0,33.5,33.5,-1,-130180,92305,222485,-37875,0,-302,0,0,0,,302,-302
8,02/22/2017,35,8:30,8:45,44.59,,0,44.59,44.59,1,-162026,49539,211565,-112487,0,0,6529,0,0,,6529,6529
8,02/22/2017,36,8:45,9:00,57.18,,0,57.18,57.18,1,-167051,38321,205372,-128730,0,0,31213,0,0,,31213,31213
8,02/22/2017,37,9:00,9:15,38.59,,0,38.59,38.59,1,-133175,86939,220114,-46236,0,0,20525,0,0,,20525,20525
8,02/22/2017,38,9:15,9:30,35.3,,0,35.3,35.3,1,-142371,91501,233872,-50870,0,0,1460,0,0,,1460,1460
8,02/22/2017,39,9:30,9:45,132.5,,0,132.5,132.5,1,-139299,63630,202929,-75669,0,0,33103,0,0,,33103,33103
8,02/22/2017,40,9:45,10:00,38.59,,0,38.59,38.59,1,-137138,87626,224764,-49512,0,0,24715,0,0,,24715,24715
8,02/22/2017,41,10:00,10:15,34.59,,0,34.59,34.59,1,-120195,100449,220644,-19746,0,0,1655,0,0,,1655,1655
8,02/22/2017,42,10:15,10:30,35.3,,0,35.3,35.3,1,-121311,88837,210148,-32474,0,0,3941,0,0,,3941,3941
8,02/22/2017,43,10:30,10:45,33.74,,0,33.74,33.74,1,-99301,77765,177066,-21536,0,0,1033,0,0,,1033,1033
8,02/22/2017,44,10:45,11:00,,,0,33.36,33.36,0,-92907,89218,182125,-3689,0,0,73,0,0,,73,73
8,02/22/2017,45,11:00,11:15,,,0,33.37,33.37,0,-94624,104192,198816,9568,0,0,0,0,0,,0,0
8,02/22/2017,46,11:15,11:30,34.59,,0,34.59,34.59,1,-97066,83266,180332,-13800,0,0,145,0,0,,145,145
8,02/22/2017,47,11:30,11:45,39.59,,0,39.59,39.59,1,-108082,72057,180139,-36025,0,0,19078,0,0,,19078,19078
8,02/22/2017,48,11:45,12:00,62.72,,0,62.72,62.72,1,-122138,58604,180742,-63534,0,0,30735,0,0,,30735,30735
8,02/22/2017,49,12:00,12:15,142.57,,0,142.57,142.57,1,-153507,61823,215330,-91684,0,0,59314,0,0,,59314,59314
8,02/22/2017,50,12:15,12:30,142.57,,0,142.57,142.57,1,-114548,73751,188299,-40797,0,0,50714,0,0,,50714,50714
8,02/22/2017,51,12:30,12:45,87.44,,0,87.44,87.44,1,-117036,77660,194696,-39376,0,0,16378,0,0,,16378,16378
8,02/22/2017,52,12:45,13:00,37.9,,0,37.9,37.9,1,-117120,84343,201463,-32777,0,0,25634,0,0,,25634,25634
8,02/22/2017,53,13:00,13:15,34.59,33.5,0,34.59,33.44,2,-94177,97046,191223,2869,0,-309,3052,0,0,,3361,2743
8,02/22/2017,54,13:15,13:30,37.9,,0,37.9,37.9,1,-117223,66186,183409,-51037,0,0,4598,0,0,,4598,4598
8,02/22/2017,55,13:30,13:45,142.33,,0,142.33,142.33,1,-121240,56414,177654,-64826,0,0,24919,0,0,,24919,24919
8,02/22/2017,56,13:45,14:00,43,,0,43,43,1,-125171,56431,181602,-68740,0,0,32939,0,0,,32939,32939
8,02/22/2017,57,14:00,14:15,139.74,,0,139.74,139.74,1,-165658,67551,233209,-98107,0,0,42329,0,0,,42329,42329
8,02/22/2017,58,14:15,14:30,139.74,,0,139.74,139.74,1,-123188,83059,206247,-40129,0,0,50812,0,0,,50812,50812
8,02/22/2017,59,14:30,14:45,33.74,33.5,0,33.74,33.43,2,-91472,75641,167113,-15831,0,-162,6177,0,0,,6339,6015
8,02/22/2017,60,14:45,15:00,52.9,,0,52.9,52.9,1,-131607,62327,193934,-69280,0,0,8613,0,0,,8613,8613
8,02/22/2017,61,15:00,15:15,137.65,,0,137.65,137.65,1,-124545,56110,180655,-68435,0,0,50579,0,0,,50579,50579
8,02/22/2017,62,15:15,15:30,52.01,,0,52.01,52.01,1,-105230,66247,171477,-38983,0,0,48864,0,0,,48864,48864
8,02/22/2017,63,15:30,15:45,37.7,,0,37.7,37.7,1,-98610,65584,164194,-33026,0,0,30777,0,0,,30777,30777
8,02/22/2017,64,15:45,16:00,36.47,,0,36.47,36.47,1,-135480,67352,202832,-68128,0,0,10330,0,0,,10330,10330
8,02/22/2017,65,16:00,16:15,38.1,,0,38.1,38.1,1,-104096,60359,164455,-43737,0,0,18687,0,0,,18687,18687
8,02/22/2017,66,16:15,16:30,37.9,,0,37.9,37.9,1,-105929,59510,165439,-46419,0,0,24359,0,0,,24359,24359
8,02/22/2017,67,16:30,16:45,35.3,,0,35.3,35.3,1,-85965,64226,150191,-21739,0,0,18050,0,0,,18050,18050
8,02/22/2017,68,16:45,17:00,34.59,,0,34.59,34.59,1,-94376,76321,170697,-18055,0,0,6471,0,0,,6471,6471
8,02/22/2017,69,17:00,17:15,33.3,,0,33.3,33.3,1,-90769,72125,162894,-18644,0,0,2837,0,0,,2837,2837
8,02/22/2017,70,17:15,17:30,33.74,,0,33.74,33.74,1,-103035,80224,183259,-22811,0,0,2098,0,0,,2098,2098
8,02/22/2017,71,17:30,17:45,33.35,,0,33.35,33.35,1,-86903,90299,177202,3396,0,0,2690,0,0,,2690,2690
8,02/22/2017,72,17:45,18:00,34.39,,0,34.39,34.39,1,-75284,85320,160604,10036,0,0,2172,0,0,,2172,2172
8,02/22/2017,73,18:00,18:15,34.39,29.78,0,29.78,29.78,-1,-86893,107482,194375,20589,0,-8269,306,0,0,,8575,-7963
8,02/22/2017,74,18:15,18:30,34.59,34.5,0,34.59,34.59,1,-95828,90627,186455,-5201,0,-1965,466,0,0,,2431,-1499
8,02/22/2017,75,18:30,18:45,34.59,,0,34.59,34.59,1,-93007,88437,181444,-4570,0,0,1550,0,0,,1550,1550
8,02/22/2017,76,18:45,19:00,34.59,,0,34.59,34.59,1,-88058,92292,180350,4234,0,0,1429,0,0,,1429,1429
8,02/22/2017,77,19:00,19:15,,,0,33.41,33.41,0,-100781,88313,189094,-12468,0,0,0,0,0,,0,0
8,02/22/2017,78,19:15,19:30,33.74,,0,33.74,33.74,1,-100239,77251,177490,-22988,0,0,909,0,0,,909,909
8,02/22/2017,79,19:30,19:45,34.39,,0,34.39,34.39,1,-106867,95745,202612,-11122,0,0,4695,0,0,,4695,4695
8,02/22/2017,80,19:45,20:00,34.39,31.59,0,31.59,31.59,-1,-98236,112498,210734,14262,0,-5321,150,0,0,,5471,-5171
8,02/22/2017,81,20:00,20:15,38.1,35.12,0,38.1,33.43,2,-139294,114536,253830,-24758,0,-980,5279,0,0,,6259,4299
8,02/22/2017,82,20:15,20:30,,,0,33.43,33.43,0,-114947,104149,219096,-10798,0,0,231,0,0,,231,231
8,02/22/2017,83,20:30,20:45,34.59,,0,34.59,34.59,1,-117618,106773,224391,-10845,0,0,1729,0,0,,1729,1729
8,02/22/2017,84,20:45,21:00,,32.59,0,32.59,32.59,-1,-111822,125831,237653,14009,0,-207,0,0,0,,207,-207
8,02/22/2017,85,21:00,21:15,36.47,32.59,0,36.47,32.59,2,-121301,112846,234147,-8455,0,-1105,1268,0,0,,2373,163
8,02/22/2017,86,21:15,21:30,38.1,,0,38.1,38.1,1,-118050,95717,213767,-22333,0,0,7998,0,0,,7998,7998
8,02/22/2017,87,21:30,21:45,32.59,,0,32.59,32.59,1,-114144,113644,227788,-500,0,0,440,0,0,,440,440
8,02/22/2017,88,21:45,22:00,,27.59,0,27.59,27.59,-1,-123572,150546,274118,26974,0,-11558,0,0,0,,11558,-11558
8,02/22/2017,89,22:00,22:15,31.31,23.5,0,31.31,31.31,1,-98582,95069,193651,-3513,0,-14525,21,0,0,,14546,-14504
8,02/22/2017,90,22:15,22:30,31.7,23.5,0,31.7,31.7,1,-126361,82641,209002,-43720,0,-41,985,0,0,,1026,944
8,02/22/2017,91,22:30,22:45,36.47,,0,36.47,36.47,1,-131774,81245,213019,-50529,0,0,2782,0,0,,2782,2782
8,02/22/2017,92,22:45,23:00,33.35,,0,33.35,33.35,1,-136360,118262,254622,-18098,0,0,2773,0,0,,2773,2773
8,02/22/2017,93,23:00,23:15,131.5,,0,131.5,131.5,1,-128369,70108,198477,-58261,0,0,17360,0,0,,17360,17360
8,02/22/2017,94,23:15,23:30,37.7,,0,37.7,37.7,1,-122924,95833,218757,-27091,0,0,14621,0,0,,14621,14621
8,02/22/2017,95,23:30,23:45,36.42,,0,36.42,36.42,1,-123817,104289,228106,-19528,0,0,3220,0,0,,3220,3220
8,02/22/2017,96,23:45,0:00,36.42,-5.5,0,-5.5,-5.5,-1,-123437,152450,275887,29013,0,-13884,181,0,0,,14065,-13703
8,02/23/2017,1,0:00,0:15,42.28,-7.83,0,42.28,-7.83,2,-121442,81101,202543,-40341,0,-14835,7045,0,0,,21880,-7790
8,02/23/2017,2,0:15,0:30,32.31,,0,32.31,32.31,1,-95037,64767,159804,-30270,0,0,7346,0,0,,7346,7346
8,02/23/2017,3,0:30,0:45,,,0,31.69,31.69,0,-95769,65066,160835,-30703,0,0,87,0,0,,87,87
8,02/23/2017,4,0:45,1:00,,,0,31.69,31.69,0,-109463,84670,194133,-24793,0,0,0,0,0,,0,0
8,02/23/2017,5,1:00,1:15,48.69,,0,48.69,48.69,1,-83566,34278,117844,-49288,0,0,13703,0,0,,13703,13703
8,02/23/2017,6,1:15,1:30,49.69,,0,49.69,49.69,1,-83552,32769,116321,-50783,0,0,36452,0,0,,36452,36452
8,02/23/2017,7,1:30,1:45,36.66,,0,36.66,36.66,1,-80922,46854,127776,-34068,0,0,6506,0,0,,6506,6506
8,02/23/2017,8,1:45,2:00,36.66,,0,36.66,36.66,1,-84907,48648,133555,-36259,0,0,8426,0,0,,8426,8426
8,02/23/2017,9,2:00,2:15,32.28,,0,32.28,32.28,1,-80865,71110,151975,-9755,0,0,1249,0,0,,1249,1249
8,02/23/2017,10,2:15,2:30,,,0,31.89,31.89,0,-66622,51011,117633,-15611,0,0,0,0,0,,0,0
8,02/23/2017,11,2:30,2:45,31.5,,0,31.5,31.5,1,-72731,47991,120722,-24740,0,0,110,0,0,,110,110
8,02/23/2017,12,2:45,3:00,31.5,,0,31.5,31.5,1,-82686,42929,125615,-39757,0,0,1781,0,0,,1781,1781
8,02/23/2017,13,3:00,3:15,32.28,,0,32.28,32.28,1,-75219,60174,135393,-15045,0,0,1427,0,0,,1427,1427
8,02/23/2017,14,3:15,3:30,32.28,30.28,0,30.28,30.28,-1,-58336,65161,123497,6825,0,-1303,8,0,0,,1311,-1295
8,02/23/2017,15,3:30,3:45,,30.28,0,30.28,30.28,-1,-64121,58123,122244,-5998,0,-2310,0,0,0,,2310,-2310
8,02/23/2017,16,3:45,4:00,,30.28,0,30.28,30.28,-1,-76940,46758,123698,-30182,0,-608,0,0,0,,608,-608
8,02/23/2017,17,4:00,4:15,126.22,30.28,0,126.22,126.22,1,-117606,48919,166525,-68687,0,-30,29683,0,0,,29713,29653
8,02/23/2017,18,4:15,4:30,36.35,,0,36.35,36.35,1,-94577,47397,141974,-47180,0,0,31324,0,0,,31324,31324
8,02/23/2017,19,4:30,4:45,42.28,,0,42.28,42.28,1,-103373,36543,139916,-66830,0,0,46574,0,0,,46574,46574
8,02/23/2017,20,4:45,5:00,38.35,,0,38.35,38.35,1,-97962,43493,141455,-54469,0,0,47302,0,0,,47302,47302
8,02/23/2017,21,5:00,5:15,38.35,-225.9,0,-225.9,-225.9,-1,-61955,125508,187463,63553,0,-7381,16824,0,0,,24205,9443
8,02/23/2017,22,5:15,5:30,,29.28,0,29.28,29.28,-1,-57269,71587,128856,14318,0,-4711,0,0,0,,4711,-4711
8,02/23/2017,23,5:30,5:45,,,0,31.07,31.07,0,-51463,61493,112956,10030,0,0,0,0,0,,0,0
8,02/23/2017,24,5:45,6:00,,,0,31.07,31.07,0,-58775,87522,146297,28747,0,0,0,0,0,,0,0
8,02/23/2017,25,6:00,6:15,,,0,32.52,32.52,0,-80815,55978,136793,-24837,0,0,0,0,0,,0,0
8,02/23/2017,26,6:15,6:30,,,0,32.52,32.52,0,-59004,52654,111658,-6350,0,0,0,0,0,,0,0
8,02/23/2017,27,6:30,6:45,,,0,32.52,32.52,0,-69977,45582,115559,-24395,0,0,0,0,0,,0,0
8,02/23/2017,28,6:45,7:00,37.79,,0,37.79,37.79,1,-90560,55791,146351,-34769,0,0,5996,0,0,,5996,5996
8,02/23/2017,29,7:00,7:15,31.68,,0,31.68,31.68,1,-127458,95641,223099,-31817,0,0,1261,0,0,,1261,1261
8,02/23/2017,30,7:15,7:30,,,0,33.49,33.49,0,-114172,93996,208168,-20176,0,0,0,0,0,,0,0
8,02/23/2017,31,7:30,7:45,,,0,33.49,33.49,0,-104371,74400,178771,-29971,0,0,0,0,0,,0,0
8,02/23/2017,32,7:45,8:00,,,0,33.49,33.49,0,-112758,57300,170058,-55458,0,0,0,0,0,,0,0
8,02/23/2017,33,8:00,8:15,,30.1,0,30.1,30.1,-1,-82769,100871,183640,18102,0,-1092,0,0,0,,1092,-1092
8,02/23/2017,34,8:15,8:30,,24.68,0,24.68,24.68,-1,-69686,93650,163336,23964,0,-17517,0,0,0,,17517,-17517
8,02/23/2017,35,8:30,8:45,32.17,24.68,0,32.17,32.17,1,-96899,58894,155793,-38005,0,-1962,742,0,0,,2704,-1220
8,02/23/2017,36,8:45,9:00,43.3,,0,43.3,43.3,1,-128437,41006,169443,-87431,0,0,10763,0,0,,10763,10763
8,02/23/2017,37,9:00,9:15,38.22,,0,38.22,38.22,1,-117055,46670,163725,-70385,0,0,10490,0,0,,10490,10490
8,02/23/2017,38,9:15,9:30,34.98,,0,34.98,34.98,1,-135541,41178,176719,-94363,0,0,5144,0,0,,5144,5144
8,02/23/2017,39,9:30,9:45,32.17,,0,32.17,32.17,1,-124275,44891,169166,-79384,0,0,3817,0,0,,3817,3817
8,02/23/2017,40,9:45,10:00,,,0,33.59,33.59,0,-114620,45422,160042,-69198,0,0,0,0,0,,0,0
8,02/23/2017,41,10:00,10:15,148.5,,0,148.5,148.5,1,-117862,36139,154001,-81723,0,0,22767,0,0,,22767,22767
8,02/23/2017,42,10:15,10:30,84.22,,0,84.22,84.22,1,-78728,33582,112310,-45146,0,0,41716,0,0,,41716,41716
8,02/23/2017,43,10:30,10:45,84.22,35.5,0,35.5,35.5,-1,-54946,49397,104343,-5549,0,-10,3958,0,0,,3968,3948
8,02/23/2017,44,10:45,11:00,,35.1,0,35.1,35.1,-1,-51598,57144,108742,5546,0,-167,0,0,0,,167,-167
8,02/23/2017,45,11:00,11:15,,,0,33.06,33.06,0,-72737,75113,147850,2376,0,0,0,0,0,,0,0
8,02/23/2017,46,11:15,11:30,,,0,33.06,33.06,0,-73556,81354,154910,7798,0,0,0,0,0,,0,0
8,02/23/2017,47,11:30,11:45,31.68,,0,31.68,31.68,1,-69314,79541,148855,10227,0,0,262,0,0,,262,262
8,02/23/2017,48,11:45,12:00,32.17,,0,32.17,32.17,1,-88109,86428,174537,-1681,0,0,3102,0,0,,3102,3102
8,02/23/2017,49,12:00,12:15,32.11,,0,32.11,32.11,1,-80070,98958,179028,18888,0,0,1240,0,0,,1240,1240
8,02/23/2017,50,12:15,12:30,32.17,,0,32.17,32.17,1,-96620,83571,180191,-13049,0,0,2239,0,0,,2239,2239
8,02/23/2017,51,12:30,12:45,33.66,,0,33.66,33.66,1,-96249,83241,179490,-13008,0,0,3483,0,0,,3483,3483
8,02/23/2017,52,12:45,13:00,31.5,29.79,0,32.59,29.79,2,-59617,64237,123854,4620,0,-1453,978,0,0,,2431,-475
8,02/23/2017,53,13:00,13:15,33.15,35.1,0,33.15,32.59,2,-105863,47014,152877,-58849,0,-639,2241,0,0,,2880,1602
8,02/23/2017,54,13:15,13:30,31.68,,0,31.68,31.68,1,-97396,41679,139075,-55717,0,0,2514,0,0,,2514,2514
8,02/23/2017,55,13:30,13:45,33.15,,0,33.15,33.15,1,-81037,47636,128673,-33401,0,0,2494,0,0,,2494,2494
8,02/23/2017,56,13:45,14:00,33.15,29.51,0,29.51,29.51,-1,-55334,70130,125464,14796,0,-5439,111,0,0,,5550,-5328
8,02/23/2017,57,14:00,14:15,,4.97,0,4.97,4.97,-1,-70632,131042,201674,60410,0,-39541,0,0,0,,39541,-39541
8,02/23/2017,58,14:15,14:30,,24.68,0,24.68,24.68,-1,-77238,127205,204443,49967,0,-37162,0,0,0,,37162,-37162
8,02/23/2017,59,14:30,14:45,,11.89,0,11.89,11.89,-1,-82037,108817,190854,26780,0,-39912,0,0,0,,39912,-39912
8,02/23/2017,60,14:45,15:00,,30.78,0,30.78,30.78,-1,-95333,106638,201971,11305,0,-16791,0,0,0,,16791,-16791
8,02/23/2017,61,15:00,15:15,,28.68,0,28.68,28.68,-1,-113359,125715,239074,12356,0,-17231,0,0,0,,17231,-17231
8,02/23/2017,62,15:15,15:30,32.11,27.48,0,32.59,27.48,2,-123688,91652,215340,-32036,0,-17849,353,0,0,,18202,-17496
8,02/23/2017,63,15:30,15:45,130.22,27.48,0,130.22,130.22,1,-134501,57807,192308,-76694,0,-553,24657,0,0,,25210,24104
8,02/23/2017,64,15:45,16:00,130.22,,0,130.22,130.22,1,-125269,63114,188383,-62155,0,0,56259,0,0,,56259,56259
8,02/23/2017,65,16:00,16:15,130.22,34.1,0,34.1,34.1,-1,-107417,105834,213251,-1583,0,-348,4345,0,0,,4693,3997
8,02/23/2017,66,16:15,16:30,33.15,34.1,0,33.15,33.15,1,-144066,105693,249759,-38373,0,-360,450,0,0,,810,90
8,02/23/2017,67,16:30,16:45,41.68,,0,41.68,41.68,1,-153781,95298,249079,-58483,0,0,27915,0,0,,27915,27915
8,02/23/2017,68,16:45,17:00,130.22,,0,130.22,130.22,1,-178431,81189,259620,-97242,0,0,46538,0,0,,46538,46538
8,02/23/2017,69,17:00,17:15,130.22,,0,130.22,130.22,1,-155440,95116,250556,-60324,0,0,29678,0,0,,29678,29678
8,02/23/2017,70,17:15,17:30,,,0,32.59,32.59,0,-134193,95628,229821,-38565,0,0,0,0,0,,0,0
8,02/23/2017,71,17:30,17:45,36.66,,0,36.66,36.66,1,-149253,104970,254223,-44283,0,0,1580,0,0,,1580,1580
8,02/23/2017,72,17:45,18:00,43.64,,0,43.64,43.64,1,-154375,121493,275868,-32882,0,0,26214,0,0,,26214,26214
8,02/23/2017,73,18:00,18:15,31.91,-150.22,0,32.75,-150.22,2,-45142,99795,144937,54653,0,-23653,5329,0,0,,28982,-18324
8,02/23/2017,74,18:15,18:30,33.15,29.68,0,33.15,29.68,2,-68184,74051,142235,5867,0,-7274,1207,0,0,,8481,-6067
8,02/23/2017,75,18:30,18:45,,4.22,0,4.22,4.22,-1,-75160,91585,166745,16425,0,-30165,0,0,0,,30165,-30165
8,02/23/2017,76,18:45,19:00,,24.68,0,24.68,24.68,-1,-55922,89696,145618,33774,0,-12405,0,0,0,,12405,-12405
8,02/23/2017,77,19:00,19:15,,21.22,0,21.22,21.22,-1,-121032,78379,199411,-42653,0,-16300,0,0,0,,16300,-16300
8,02/23/2017,78,19:15,19:30,31.38,21.22,0,31.38,31.38,1,-95208,72550,167758,-22658,0,-261,173,0,0,,434,-88
8,02/23/2017,79,19:30,19:45,,31.85,0,31.85,31.85,-1,-90181,92822,183003,2641,0,-558,0,0,0,,558,-558
8,02/23/2017,80,19:45,20:00,,26.22,0,26.22,26.22,-1,-91000,113523,204523,22523,0,-20297,0,0,0,,20297,-20297
8,02/23/2017,81,20:00,20:15,31.44,10.22,0,32.75,10.22,2,-110896,73940,184836,-36956,0,-29763,14,0,0,,29777,-29749
8,02/23/2017,82,20:15,20:30,32.11,28.68,0,32.75,28.68,2,-95945,77732,173677,-18213,0,-1888,392,0,0,,2280,-1496
8,02/23/2017,83,20:30,20:45,,19.53,0,19.53,19.53,-1,-91750,108303,200053,16553,0,-23298,0,0,0,,23298,-23298
8,02/23/2017,84,20:45,21:00,,26.78,0,26.78,26.78,-1,-125559,125264,250823,-295,0,-6267,0,0,0,,6267,-6267
8,02/23/2017,85,21:00,21:15,36.66,24.53,0,36.66,24.53,2,-96038,100214,196252,4176,0,-7962,2783,0,0,,10745,-5179
8,02/23/2017,86,21:15,21:30,37.79,24.53,0,37.79,37.79,1,-92408,90396,182804,-2012,0,-11,12245,0,0,,12256,12234
8,02/23/2017,87,21:30,21:45,37.79,28.53,0,28.53,28.53,-1,-93928,107188,201116,13260,0,-13196,84,0,0,,13280,-13112
8,02/23/2017,88,21:45,22:00,32.5,30.74,0,32.5,32.5,1,-118912,108983,227895,-9929,0,-11984,396,0,0,,12380,-11588
8,02/23/2017,89,22:00,22:15,44.55,30.74,0,44.55,44.55,1,-175938,53560,229498,-122378,0,-110,14604,0,0,,14714,14494
8,02/23/2017,90,22:15,22:30,44.55,,0,44.55,44.55,1,-176585,57106,233691,-119479,0,0,33026,0,0,,33026,33026
8,02/23/2017,91,22:30,22:45,126.22,,0,126.22,126.22,1,-171291,66434,237725,-104857,0,0,22888,0,0,,22888,22888
8,02/23/2017,92,22:45,23:00,126.22,,0,126.22,126.22,1,-120787,99572,220359,-21215,0,0,32374,0,0,,32374,32374
8,02/23/2017,93,23:00,23:15,,,0,33.42,33.42,0,-141849,76674,218523,-65175,0,0,395,0,0,,395,395
8,02/23/2017,94,23:15,23:30,,,0,32.76,32.76,0,-108620,77363,185983,-31257,0,0,0,0,0,,0,0
8,02/23/2017,95,23:30,23:45,,28.53,0,28.53,28.53,-1,-96587,123697,220284,27110,0,-1241,0,0,0,,1241,-1241
8,02/23/2017,96,23:45,0:00,,-90.78,0,-90.78,-90.78,-1,-128634,141136,269770,12502,0,-23699,0,0,0,,23699,-23699
8,02/24/2017,1,0:00,0:15,38.55,-90.78,0,38.55,38.55,1,-98337,59053,157390,-39284,0,-1665,3177,0,0,,4842,1512
8,02/24/2017,2,0:15,0:30,38.55,,0,38.55,38.55,1,-82128,45261,127389,-36867,0,0,11238,0,0,,11238,11238
8,02/24/2017,3,0:30,0:45,,,0,31.88,31.88,0,-82576,58357,140933,-24219,0,0,721,0,0,,721,721
8,02/24/2017,4,0:45,1:00,,31.48,0,31.48,31.48,-1,-79858,71080,150938,-8778,0,-2352,0,0,0,,2352,-2352
8,02/24/2017,5,1:00,1:15,32.52,29.53,0,32.52,32.52,1,-83293,72563,155856,-10730,0,-1176,138,0,0,,1314,-1038
8,02/24/2017,6,1:15,1:30,34.55,,0,34.55,34.55,1,-68655,28398,97053,-40257,0,0,6089,0,0,,6089,6089
8,02/24/2017,7,1:30,1:45,38.32,,0,38.32,38.32,1,-71055,28801,99856,-42254,0,0,11839,0,0,,11839,11839
8,02/24/2017,8,1:45,2:00,33.35,,0,33.35,33.35,1,-65142,16987,82129,-48155,0,0,11104,0,0,,11104,11104
8,02/24/2017,9,2:00,2:15,37.11,,0,37.11,37.11,1,-60855,50638,111493,-10217,0,0,7728,0,0,,7728,7728
8,02/24/2017,10,2:15,2:30,33.2,29.53,0,29.53,29.53,-1,-55983,53946,109929,-2037,0,-1214,6878,0,0,,8092,5664
8,02/24/2017,11,2:30,2:45,33.2,29.53,0,29.53,29.53,-1,-56551,60510,117061,3959,0,-2886,26,0,0,,2912,-2860
8,02/24/2017,12,2:45,3:00,,31.48,0,31.48,31.48,-1,-59312,47046,106358,-12266,0,-1008,0,0,0,,1008,-1008
8,02/24/2017,13,3:00,3:15,34.55,31.82,0,34.55,30.47,2,-56231,27022,83253,-29209,0,-106,5345,0,0,,5451,5239
8,02/24/2017,14,3:15,3:30,31.63,,0,31.63,31.63,1,-47733,38413,86146,-9320,0,0,1609,0,0,,1609,1609
8,02/24/2017,15,3:30,3:45,,,0,30.47,30.47,0,-41964,32184,74148,-9780,0,0,0,0,0,,0,0
8,02/24/2017,16,3:45,4:00,,28.53,0,28.53,28.53,-1,-36135,42146,78281,6011,0,-1385,0,0,0,,1385,-1385
8,02/24/2017,17,4:00,4:15,,28.53,0,28.53,28.53,-1,-67643,80324,147967,12681,0,-6668,0,0,0,,6668,-6668
8,02/24/2017,18,4:15,4:30,,28.53,0,28.53,28.53,-1,-31299,53267,84566,21968,0,-16765,0,0,0,,16765,-16765
8,02/24/2017,19,4:30,4:45,32.5,28.53,0,32.5,32.5,1,-33193,33924,67117,731,0,-4788,1401,0,0,,6189,-3387
8,02/24/2017,20,4:45,5:00,31.52,,0,31.52,31.52,1,-41706,25796,67502,-15910,0,0,36,0,0,,36,36
8,02/24/2017,21,5:00,5:15,31.51,24.08,0,24.08,24.08,-1,-58989,86812,145801,27823,0,-7230,88,0,0,,7318,-7142
8,02/24/2017,22,5:15,5:30,,28.53,0,28.53,28.53,-1,-54849,56663,111512,1814,0,-6961,0,0,0,,6961,-6961
8,02/24/2017,23,5:30,5:45,43.68,28.53,0,43.68,43.68,1,-88898,41577,130475,-47321,0,-154,9631,0,0,,9785,9477
8,02/24/2017,24,5:45,6:00,34.47,,0,34.47,34.47,1,-111181,70136,181317,-41045,0,0,14676,0,0,,14676,14676
8,02/24/2017,25,6:00,6:15,31.49,17.33,0,17.33,17.33,-1,-49527,79436,128963,29909,0,-3988,3222,0,0,,7210,-766
8,02/24/2017,26,6:15,6:30,,-61.49,0,-61.49,-61.49,-1,-47378,49131,96509,1753,0,-27586,0,0,0,,27586,-27586
8,02/24/2017,27,6:30,6:45,,,0,30.97,30.97,0,-33006,26928,59934,-6078,0,-362,0,0,0,,362,-362
8,02/24/2017,28,6:45,7:00,59.12,,0,59.12,59.12,1,-75951,28936,104887,-47015,0,0,10725,0,0,,10725,10725
8,02/24/2017,29,7:00,7:15,34.41,3.2,0,3.2,3.2,-1,-70931,125023,195954,54092,0,-9526,4728,0,0,,14254,-4798
8,02/24/2017,30,7:15,7:30,,-58.58,0,-58.58,-58.58,-1,-55017,69023,124040,14006,0,-36825,0,0,0,,36825,-36825
8,02/24/2017,31,7:30,7:45,31.68,29.2,0,31.83,29.2,2,-59230,56164,115394,-3066,0,-4800,4,0,0,,4804,-4796
8,02/24/2017,32,7:45,8:00,34.73,29.2,0,34.73,34.73,1,-78449,39783,118232,-38666,0,-281,4781,0,0,,5062,4500
8,02/24/2017,33,8:00,8:15,34.73,32.62,0,32.62,32.62,-1,-27100,129029,156129,101929,0,-1090,81,0,0,,1171,-1009
8,02/24/2017,34,8:15,8:30,,,0,32.73,32.73,0,-44222,85899,130121,41677,0,-241,0,0,0,,241,-241
8,02/24/2017,35,8:30,8:45,,,0,33.34,33.34,0,-56609,61675,118284,5066,0,0,0,0,0,,0,0
8,02/24/2017,36,8:45,9:00,34.02,,0,34.02,34.02,1,-97243,63670,160913,-33573,0,0,569,0,0,,569,569
8,02/24/2017,37,9:00,9:15,,,0,32.49,32.49,0,-29970,119888,149858,89918,0,0,96,0,0,,96,96
8,02/24/2017,38,9:15,9:30,,33.78,0,33.78,33.78,-1,-27311,104806,132117,77495,0,-289,0,0,0,,289,-289
8,02/24/2017,39,9:30,9:45,,33.74,0,33.74,33.74,-1,-24027,101765,125792,77738,0,-1135,0,0,0,,1135,-1135
8,02/24/2017,40,9:45,10:00,,31.82,0,31.82,31.82,-1,-35181,116710,151891,81529,0,-667,0,0,0,,667,-667
8,02/24/2017,41,10:00,10:15,,-58.76,0,-58.76,-58.76,-1,-33191,119928,153119,86737,0,-39437,0,0,0,,39437,-39437
8,02/24/2017,42,10:15,10:30,,-42.27,0,-42.27,-42.27,-1,-45757,102385,148142,56628,0,-73893,0,0,0,,73893,-73893
8,02/24/2017,43,10:30,10:45,,19.53,0,19.53,19.53,-1,-29899,109051,138950,79152,0,-65087,0,0,0,,65087,-65087
8,02/24/2017,44,10:45,11:00,,22.99,0,22.99,22.99,-1,-38793,111562,150355,72769,0,-68761,0,0,0,,68761,-68761
8,02/24/2017,45,11:00,11:15,,27.36,0,27.36,27.36,-1,-75753,114053,189806,38300,0,-44138,0,0,0,,44138,-44138
8,02/24/2017,46,11:15,11:30,,24.53,0,24.53,24.53,-1,-58911,118956,177867,60045,0,-41225,0,0,0,,41225,-41225
8,02/24/2017,47,11:30,11:45,,9.24,0,9.24,9.24,-1,-52093,124517,176610,72424,0,-68620,0,0,0,,68620,-68620
8,02/24/2017,48,11:45,12:00,,4.99,0,4.99,4.99,-1,-54121,135906,190027,81785,0,-60769,0,0,0,,60769,-60769
8,02/24/2017,49,12:00,12:15,,4.99,0,4.99,4.99,-1,-74705,103283,177988,28578,0,-40751,0,0,0,,40751,-40751
8,02/24/2017,50,12:15,12:30,,27.19,0,27.19,27.19,-1,-61865,102363,164228,40498,0,-23729,0,0,0,,23729,-23729
8,02/24/2017,51,12:30,12:45,,24.53,0,24.53,24.53,-1,-54022,114947,168969,60925,0,-41687,0,0,0,,41687,-41687
8,02/24/2017,52,12:45,13:00,,16.79,0,16.79,16.79,-1,-59342,131206,190548,71864,0,-68913,0,0,0,,68913,-68913
8,02/24/2017,53,13:00,13:15,,25.29,0,25.29,25.29,-1,-43536,104835,148371,61299,0,-56598,0,0,0,,56598,-56598
8,02/24/2017,54,13:15,13:30,,29.99,0,29.99,29.99,-1,-74608,103094,177702,28486,0,-25933,0,0,0,,25933,-25933
8,02/24/2017,55,13:30,13:45,,24.53,0,24.53,24.53,-1,-78440,110949,189389,32509,0,-13963,0,0,0,,13963,-13963
8,02/24/2017,56,13:45,14:00,,21.26,0,21.26,21.26,-1,-76005,142019,218024,66014,0,-57281,0,0,0,,57281,-57281
8,02/24/2017,57,14:00,14:15,,-10.17,0,-10.17,-10.17,-1,-48113,165216,213329,117103,0,-85078,0,0,0,,85078,-85078
8,02/24/2017,58,14:15,14:30,,-10.17,0,-10.17,-10.17,-1,-55445,120709,176154,65264,0,-70725,0,0,0,,70725,-70725
8,02/24/2017,59,14:30,14:45,,-40.25,0,-40.25,-40.25,-1,-45278,142551,187829,97273,0,-89669,0,0,0,,89669,-89669
8,02/24/2017,60,14:45,15:00,,16.79,0,16.79,16.79,-1,-47007,147257,194264,100250,0,-86981,0,0,0,,86981,-86981
8,02/24/2017,61,15:00,15:15,,-53.24,0,-53.24,-53.24,-1,-43348,165317,208665,121969,0,-95825,0,0,0,,95825,-95825
8,02/24/2017,62,15:15,15:30,,4.99,0,4.99,4.99,-1,-86029,123328,209357,37299,0,-62611,0,0,0,,62611,-62611
8,02/24/2017,63,15:30,15:45,,29.53,0,29.53,29.53,-1,-87179,124257,211436,37078,0,-8857,0,0,0,,8857,-8857
8,02/24/2017,64,15:45,16:00,,25.21,0,25.21,25.21,-1,-78531,127170,205701,48639,0,-30293,0,0,0,,30293,-30293
8,02/24/2017,65,16:00,16:15,33.14,33.74,0,33.16,33.16,2,-133826,107623,241449,-26203,0,-8242,353,0,0,,8595,-7889
8,02/24/2017,66,16:15,16:30,31.68,,0,31.68,31.68,1,-107357,87414,194771,-19943,0,0,80,0,0,,80,80
8,02/24/2017,67,16:30,16:45,41.99,,0,41.99,41.99,1,-109179,80457,189636,-28722,0,0,6865,0,0,,6865,6865
8,02/24/2017,68,16:45,17:00,34.27,,0,34.27,34.27,1,-113510,96367,209877,-17143,0,0,13363,0,0,,13363,13363
8,02/24/2017,69,17:00,17:15,34.27,13.85,0,13.85,13.85,-1,-71373,117663,189036,46290,0,-19197,2638,0,0,,21835,-16559
8,02/24/2017,70,17:15,17:30,,30.7,0,30.7,30.7,-1,-89402,98700,188102,9298,0,-12065,0,0,0,,12065,-12065
8,02/24/2017,71,17:30,17:45,,30.7,0,30.7,30.7,-1,-70184,93977,164161,23793,0,-10734,0,0,0,,10734,-10734
8,02/24/2017,72,17:45,18:00,,,0,33.16,33.16,0,-71014,98337,169351,27323,0,-2229,0,0,0,,2229,-2229
8,02/24/2017,73,18:00,18:15,,-36.84,0,-36.84,-36.84,-1,-58960,123242,182202,64282,0,-26025,0,0,0,,26025,-26025
8,02/24/2017,74,18:15,18:30,,30.93,0,30.93,30.93,-1,-100917,80433,181350,-20484,0,-10229,0,0,0,,10229,-10229
8,02/24/2017,75,18:30,18:45,32.14,,0,32.14,32.14,1,-100426,44180,144606,-56246,0,0,438,0,0,,438,438
8,02/24/2017,76,18:45,19:00,34.83,,0,34.83,34.83,1,-105707,30485,136192,-75222,0,0,1615,0,0,,1615,1615
8,02/24/2017,77,19:00,19:15,32.47,,0,32.47,32.47,1,-108011,52946,160957,-55065,0,0,1152,0,0,,1152,1152
8,02/24/2017,78,19:15,19:30,32.47,,0,32.47,32.47,1,-103012,52228,155240,-50784,0,0,1874,0,0,,1874,1874
8,02/24/2017,79,19:30,19:45,32.47,,0,32.47,32.47,1,-106390,53340,159730,-53050,0,0,1605,0,0,,1605,1605
8,02/24/2017,80,19:45,20:00,33.94,,0,33.94,33.94,1,-104653,45318,149971,-59335,0,0,1972,0,0,,1972,1972
8,02/24/2017,81,20:00,20:15,107.48,,0,107.48,107.48,1,-111452,8213,119665,-103239,0,0,11341,0,0,,11341,11341
8,02/24/2017,82,20:15,20:30,33.66,,0,33.66,33.66,1,-91902,26182,118084,-65720,0,0,4473,0,0,,4473,4473
8,02/24/2017,83,20:30,20:45,,,0,33.2,33.2,0,-88970,40005,128975,-48965,0,0,7,0,0,,7,7
8,02/24/2017,84,20:45,21:00,,,0,33.2,33.2,0,-98605,59649,158254,-38956,0,0,0,0,0,,0,0
8,02/24/2017,85,21:00,21:15,64.56,,0,64.56,64.56,1,-69055,49832,118887,-19223,0,0,7055,0,0,,7055,7055
8,02/24/2017,86,21:15,21:30,,,0,32.34,32.34,0,-48953,42948,91901,-6005,0,0,568,0,0,,568,568
8,02/24/2017,87,21:30,21:45,,29.99,0,29.99,29.99,-1,-39091,50479,89570,11388,0,-4653,0,0,0,,4653,-4653
8,02/24/2017,88,21:45,22:00,,27.69,0,27.69,27.69,-1,-40656,85529,126185,44873,0,-37186,0,0,0,,37186,-37186
8,02/24/2017,89,22:00,22:15,32.47,26.99,0,32.47,32.47,1,-71016,33585,104601,-37431,0,-23541,679,0,0,,24220,-22862
8,02/24/2017,90,22:15,22:30,32.47,31.39,0,31.39,31.39,-1,-41296,53937,95233,12641,0,-1656,272,0,0,,1928,-1384
8,02/24/2017,91,22:30,22:45,,29.53,0,29.53,29.53,-1,-32359,72512,104871,40153,0,-6212,0,0,0,,6212,-6212
8,02/24/2017,92,22:45,23:00,,30.62,0,30.62,30.62,-1,-34435,100630,135065,66195,0,-7918,0,0,0,,7918,-7918
8,02/24/2017,93,23:00,23:15,45.9,32.11,0,45.9,31.84,2,-77314,25457,102771,-51857,0,-1351,8492,0,0,,9843,7141
8,02/24/2017,94,23:15,23:30,31.36,,0,31.36,31.36,1,-42697,13072,55769,-29625,0,0,2118,0,0,,2118,2118
8,02/24/2017,95,23:30,23:45,,,0,31.84,31.84,0,-37806,44783,82589,6977,0,0,0,0,0,,0,0
8,02/24/2017,96,23:45,0:00,,-30.61,0,-30.61,-30.61,-1,-46750,75719,122469,28969,0,-6759,0,0,0,,6759,-6759
9,02/25/2017,1,0:00,0:15,,-65.19,0,-65.19,-65.19,-1,-35073,118040,153113,82967,0,-37304,0,0,0,,37304,-37304
9,02/25/2017,2,0:15,0:30,,29.07,0,29.07,29.07,-1,-53764,50418,104182,-3346,0,-2570,0,0,0,,2570,-2570
9,02/25/2017,3,0:30,0:45,,28.99,0,28.99,28.99,-1,-69222,60445,129667,-8777,0,-6750,0,0,0,,6750,-6750
9,02/25/2017,4,0:45,1:00,,25.07,0,25.07,25.07,-1,-65654,80171,145825,14517,0,-13543,0,0,0,,13543,-13543
9,02/25/2017,5,1:00,1:15,36.99,-1.03,0,36.99,36.99,1,-47654,52103,99757,4449,0,-18699,1303,0,0,,20002,-17396
9,02/25/2017,6,1:15,1:30,37.45,30.03,0,37.45,30.03,2,-53085,53090,106175,5,0,-1987,5575,0,0,,7562,3588
9,02/25/2017,7,1:30,1:45,,29.07,0,29.07,29.07,-1,-40019,64849,104868,24830,0,-15607,0,0,0,,15607,-15607
9,02/25/2017,8,1:45,2:00,,3.85,0,3.85,3.85,-1,-34170,94279,128449,60109,0,-47450,0,0,0,,47450,-47450
9,02/25/2017,9,2:00,2:15,35.59,-2.03,0,35.59,35.59,1,-38168,57825,95993,19657,0,-35912,776,0,0,,36688,-35136
9,02/25/2017,10,2:15,2:30,35.59,-2.03,0,35.59,35.59,1,-61334,74205,135539,12871,0,-4,735,0,0,,739,731
9,02/25/2017,11,2:30,2:45,,33.73,0,33.73,33.73,-1,-50492,92931,143423,42439,0,-165,0,0,0,,165,-165
9,02/25/2017,12,2:45,3:00,,32.8,0,32.8,32.8,-1,-70989,108758,179747,37769,0,-598,0,0,0,,598,-598
9,02/25/2017,13,3:00,3:15,,31.64,0,31.64,31.64,-1,-53098,100659,153757,47561,0,-862,0,0,0,,862,-862
9,02/25/2017,14,3:15,3:30,,30.07,0,30.07,30.07,-1,-52525,93382,145907,40857,0,-1840,0,0,0,,1840,-1840
9,02/25/2017,15,3:30,3:45,,,0,32.19,32.19,0,-50805,95054,145859,44249,0,-158,0,0,0,,158,-158
9,02/25/2017,16,3:45,4:00,,31.93,0,31.93,31.93,-1,-48223,86995,135218,38772,0,-137,0,0,0,,137,-137
9,02/25/2017,17,4:00,4:15,,27.71,0,27.71,27.71,-1,-59473,81279,140752,21806,0,-7482,0,0,0,,7482,-7482
9,02/25/2017,18,4:15,4:30,,27.71,0,27.71,27.71,-1,-55816,69369,125185,13553,0,-10849,0,0,0,,10849,-10849
9,02/25/2017,19,4:30,4:45,,27.84,0,27.84,27.84,-1,-54023,53590,107613,-433,0,-9132,0,0,0,,9132,-9132
9,02/25/2017,20,4:45,5:00,,34.37,0,34.37,34.37,-1,-53746,56461,110207,2715,0,-467,0,0,0,,467,-467
9,02/25/2017,21,5:00,5:15,,34.19,0,34.19,34.19,-1,-83508,67222,150730,-16286,0,-136,0,0,0,,136,-136
9,02/25/2017,22,5:15,5:30,,30.97,0,30.97,30.97,-1,-69365,71991,141356,2626,0,-4625,0,0,0,,4625,-4625
9,02/25/2017,23,5:30,5:45,,34.19,0,34.19,34.19,-1,-80239,70079,150318,-10160,0,-2081,0,0,0,,2081,-2081
9,02/25/2017,24,5:45,6:00,,,0,32.19,32.19,0,-87115,57723,144838,-29392,0,0,0,0,0,,0,0
9,02/25/2017,25,6:00,6:15,,31.01,0,31.01,31.01,-1,-84660,95605,180265,10945,0,-6175,0,0,0,,6175,-6175
9,02/25/2017,26,6:15,6:30,,32.08,0,32.08,32.08,-1,-68909,71942,140851,3033,0,-11681,0,0,0,,11681,-11681
9,02/25/2017,27,6:30,6:45,32.77,32.08,0,32.77,32.77,1,-75869,60348,136217,-15521,0,-1221,697,0,0,,1918,-524
9,02/25/2017,28,6:45,7:00,32.48,,0,32.48,32.48,1,-68060,87840,155900,19780,0,0,40,0,0,,40,40
9,02/25/2017,29,7:00,7:15,33.31,34.29,0,33.31,33.22,2,-101624,72897,174521,-28727,0,-22,697,0,0,,719,675
9,02/25/2017,30,7:15,7:30,,34.19,0,34.19,34.19,-1,-80974,57565,138539,-23409,0,-694,0,0,0,,694,-694
9,02/25/2017,31,7:30,7:45,,34.35,0,34.35,34.35,-1,-61268,47328,108596,-13940,0,-500,0,0,0,,500,-500
9,02/25/2017,32,7:45,8:00,,31.81,0,31.81,31.81,-1,-66516,67039,133555,523,0,-2115,0,0,0,,2115,-2115
9,02/25/2017,33,8:00,8:15,,-28.8,0,-28.8,-28.8,-1,-32061,71384,103445,39323,0,-16860,0,0,0,,16860,-16860
9,02/25/2017,34,8:15,8:30,,-28.8,0,-28.8,-28.8,-1,-74866,54196,129062,-20670,0,-26530,0,0,0,,26530,-26530
9,02/25/2017,35,8:30,8:45,,,0,33.31,33.31,0,-75184,58678,133862,-16506,0,-138,0,0,0,,138,-138
9,02/25/2017,36,8:45,9:00,,,0,33.31,33.31,0,-109781,70439,180220,-39342,0,0,0,0,0,,0,0
9,02/25/2017,37,9:00,9:15,,-24.16,0,-24.16,-24.16,-1,-24650,108438,133088,83788,0,-16758,0,0,0,,16758,-16758
9,02/25/2017,38,9:15,9:30,,30.49,0,30.49,30.49,-1,-44282,86454,130736,42172,0,-25165,0,0,0,,25165,-25165
9,02/25/2017,39,9:30,9:45,,28.12,0,28.12,28.12,-1,-47540,108117,155657,60577,0,-44645,0,0,0,,44645,-44645
9,02/25/2017,40,9:45,10:00,,28.99,0,28.99,28.99,-1,-58344,92601,150945,34257,0,-42207,0,0,0,,42207,-42207
9,02/25/2017,41,10:00,10:15,,34.19,0,34.19,34.19,-1,-82262,80328,162590,-1934,0,-6855,0,0,0,,6855,-6855
9,02/25/2017,42,10:15,10:30,,32.5,0,32.5,32.5,-1,-70810,80526,151336,9716,0,-1565,0,0,0,,1565,-1565
9,02/25/2017,43,10:30,10:45,,32.03,0,32.03,32.03,-1,-71407,80057,151464,8650,0,-6076,0,0,0,,6076,-6076
9,02/25/2017,44,10:45,11:00,,,0,33.34,33.34,0,-76643,57882,134525,-18761,0,-30,0,0,0,,30,-30
9,02/25/2017,45,11:00,11:15,511.19,,0,511.19,511.19,1,-83976,38578,122554,-45398,0,0,22146,0,0,,22146,22146
9,02/25/2017,46,11:15,11:30,511.19,26.35,0,26.35,26.35,-1,-30275,73991,104266,43716,0,-10044,6913,0,0,,16957,-3131
9,02/25/2017,47,11:30,11:45,34.81,26.35,0,34.81,34.81,1,-48446,53095,101541,4649,0,-19930,126,0,0,,20056,-19804
9,02/25/2017,48,11:45,12:00,35.2,30.49,0,35.2,30.49,2,-46447,73418,119865,26971,0,-5512,865,0,0,,6377,-4647
9,02/25/2017,49,12:00,12:15,34.15,30.49,0,34.15,34.15,1,-106761,60515,167276,-46246,0,-1009,727,0,0,,1736,-282
9,02/25/2017,50,12:15,12:30,30.02,,0,30.02,30.02,1,-69030,67535,136565,-1495,0,0,41,0,0,,41,41
9,02/25/2017,51,12:30,12:45,,32.81,0,32.81,32.81,-1,-62045,66706,128751,4661,0,-690,0,0,0,,690,-690
9,02/25/2017,52,12:45,13:00,,32.81,0,32.81,32.81,-1,-84494,72307,156801,-12187,0,-574,0,0,0,,574,-574
9,02/25/2017,53,13:00,13:15,53.02,34.35,0,53.02,53.02,1,-87338,52413,139751,-34925,0,-29,10422,0,0,,10451,10393
9,02/25/2017,54,13:15,13:30,55.8,,0,55.8,55.8,1,-92621,66561,159182,-26060,0,0,33025,0,0,,33025,33025
9,02/25/2017,55,13:30,13:45,38.84,,0,38.84,38.84,1,-72877,37828,110705,-35049,0,0,31870,0,0,,31870,31870
9,02/25/2017,56,13:45,14:00,38.81,,0,38.81,38.81,1,-98222,71757,169979,-26465,0,0,32496,0,0,,32496,32496
9,02/25/2017,57,14:00,14:15,32.04,-12.37,0,32.19,-12.37,2,-58297,101025,159322,42728,0,-14123,8526,0,0,,22649,-5597
9,02/25/2017,58,14:15,14:30,60.53,27.81,0,60.53,27.81,2,-45460,53444,98904,7984,0,-1949,8151,0,0,,10100,6202
9,02/25/2017,59,14:30,14:45,,-58.85,0,-58.85,-58.85,-1,-32849,76044,108893,43195,0,-39426,0,0,0,,39426,-39426
9,02/25/2017,60,14:45,15:00,32.27,-58.85,0,32.41,-58.85,2,-26259,103204,129463,76945,0,-14948,139,0,0,,15087,-14809
9,02/25/2017,61,15:00,15:15,32.21,-62.63,0,32.21,-62.63,2,-78319,110864,189183,32545,0,-43903,47,0,0,,43950,-43856
9,02/25/2017,62,15:15,15:30,37.89,-62.63,0,37.89,-62.63,2,-36548,110805,147353,74257,0,-21099,745,0,0,,21844,-20354
9,02/25/2017,63,15:30,15:45,32.04,-10.03,0,32.04,32.04,1,-80633,85369,166002,4736,0,-27981,65,0,0,,28046,-27916
9,02/25/2017,64,15:45,16:00,32.04,8.33,0,32.19,8.33,2,-52217,89859,142076,37642,0,-9082,223,0,0,,9305,-8859
9,02/25/2017,65,16:00,16:15,38.81,8.29,0,38.81,8.29,2,-84647,60857,145504,-23790,0,-14444,1543,0,0,,15987,-12901
9,02/25/2017,66,16:15,16:30,38.81,27.81,0,27.81,27.81,-1,-36753,63890,100643,27137,0,-13647,45,0,0,,13692,-13602
9,02/25/2017,67,16:30,16:45,,31.15,0,31.15,31.15,-1,-42646,62723,105369,20077,0,-27543,0,0,0,,27543,-27543
9,02/25/2017,68,16:45,17:00,,31.81,0,31.81,31.81,-1,-47041,66761,113802,19720,0,-21628,0,0,0,,21628,-21628
9,02/25/2017,69,17:00,17:15,74.02,31.81,0,74.02,74.02,1,-107805,38144,145949,-69661,0,-4280,14429,0,0,,18709,10149
9,02/25/2017,70,17:15,17:30,34.59,,0,34.59,34.59,1,-64217,49070,113287,-15147,0,0,6433,0,0,,6433,6433
9,02/25/2017,71,17:30,17:45,34.81,,0,34.81,34.81,1,-71689,52387,124076,-19302,0,0,4465,0,0,,4465,4465
9,02/25/2017,72,17:45,18:00,35.6,,0,35.6,35.6,1,-73384,65050,138434,-8334,0,0,3280,0,0,,3280,3280
9,02/25/2017,73,18:00,18:15,35.6,26.37,0,26.37,26.37,-1,-24764,56979,81743,32215,0,-12312,8,0,0,,12320,-12304
9,02/25/2017,74,18:15,18:30,41.5,31.81,0,41.5,41.5,1,-43413,28286,71699,-15127,0,-10566,1130,0,0,,11696,-9436
9,02/25/2017,75,18:30,18:45,41.5,32.81,0,41.5,32.51,2,-37520,20575,58095,-16945,0,-631,8326,0,0,,8957,7695
9,02/25/2017,76,18:45,19:00,33.77,32.81,0,33.77,33.77,1,-32428,31479,63907,-949,0,-215,302,0,0,,517,87
9,02/25/2017,77,19:00,19:15,32.05,,0,32.05,32.05,1,-26244,24627,50871,-1617,0,0,1102,0,0,,1102,1102
9,02/25/2017,78,19:15,19:30,32.05,31.81,0,31.81,31.81,-1,-27581,34525,62106,6944,0,-564,140,0,0,,704,-424
9,02/25/2017,79,19:30,19:45,,26.85,0,26.85,26.85,-1,-25106,63989,89095,38883,0,-26406,0,0,0,,26406,-26406
9,02/25/2017,80,19:45,20:00,,27.81,0,27.81,27.81,-1,-31876,72695,104571,40819,0,-49831,0,0,0,,49831,-49831
9,02/25/2017,81,20:00,20:15,,27.31,0,27.31,27.31,-1,-27759,67831,95590,40072,0,-30950,0,0,0,,30950,-30950
9,02/25/2017,82,20:15,20:30,,29.85,0,29.85,29.85,-1,-20111,51483,71594,31372,0,-15145,0,0,0,,15145,-15145
9,02/25/2017,83,20:30,20:45,,9.36,0,9.36,9.36,-1,-18339,79663,98002,61324,0,-46855,0,0,0,,46855,-46855
9,02/25/2017,84,20:45,21:00,,27.74,0,27.74,27.74,-1,-48682,83462,132144,34780,0,-44912,0,0,0,,44912,-44912
9,02/25/2017,85,21:00,21:15,,21.41,0,21.41,21.41,-1,-19751,109363,129114,89612,0,-32330,0,0,0,,32330,-32330
9,02/25/2017,86,21:15,21:30,,32.8,0,32.8,32.8,-1,-55722,91069,146791,35347,0,-10379,0,0,0,,10379,-10379
9,02/25/2017,87,21:30,21:45,,27.81,0,27.81,27.81,-1,-70303,104014,174317,33711,0,-21972,0,0,0,,21972,-21972
9,02/25/2017,88,21:45,22:00,,27.81,0,27.81,27.81,-1,-75700,90015,165715,14315,0,-36931,0,0,0,,36931,-36931
9,02/25/2017,89,22:00,22:15,33.81,33.73,0,33.81,32.19,2,-76027,63096,139123,-12931,0,-10649,763,0,0,,11412,-9886
9,02/25/2017,90,22:15,22:30,,,0,32.19,32.19,0,-59867,37289,97156,-22578,0,0,18,0,0,,18,18
9,02/25/2017,91,22:30,22:45,,25.99,0,25.99,25.99,-1,-27337,65319,92656,37982,0,-14916,0,0,0,,14916,-14916
9,02/25/2017,92,22:45,23:00,,24.61,0,24.61,24.61,-1,-33999,81244,115243,47245,0,-53006,0,0,0,,53006,-53006
9,02/25/2017,93,23:00,23:15,33.55,28.99,0,33.55,33.55,1,-76899,59552,136451,-17347,0,-22243,408,0,0,,22651,-21835
9,02/25/2017,94,23:15,23:30,33.65,,0,33.65,33.65,1,-81692,54773,136465,-26919,0,0,372,0,0,,372,372
9,02/25/2017,95,23:30,23:45,,31.81,0,31.81,31.81,-1,-75049,81645,156694,6596,0,-343,0,0,0,,343,-343
9,02/25/2017,96,23:45,0:00,,27.81,0,27.81,27.81,-1,-82987,87465,170452,4478,0,-8930,0,0,0,,8930,-8930
9,02/26/2017,1,0:00,0:15,34.09,33.31,0,34.09,34.09,1,-50193,50844,101037,651,0,-1087,1749,0,0,,2836,662
9,02/26/2017,2,0:15,0:30,36.52,33.67,0,36.52,31.74,2,-31985,18645,50630,-13340,0,-41,8267,0,0,,8308,8226
9,02/26/2017,3,0:30,0:45,36.52,32.31,0,32.31,32.31,-1,-43124,37441,80565,-5683,0,-2566,43,0,0,,2609,-2523
9,02/26/2017,4,0:45,1:00,,33.31,0,33.31,33.31,-1,-50906,57372,108278,6466,0,-814,0,0,0,,814,-814
9,02/26/2017,5,1:00,1:15,,31.67,0,31.67,31.67,-1,-40552,51668,92220,11116,0,-3322,0,0,0,,3322,-3322
9,02/26/2017,6,1:15,1:30,,32.31,0,32.31,32.31,-1,-39202,38763,77965,-439,0,-1774,0,0,0,,1774,-1774
9,02/26/2017,7,1:30,1:45,,30.14,0,30.14,30.14,-1,-34331,52818,87149,18487,0,-8551,0,0,0,,8551,-8551
9,02/26/2017,8,1:45,2:00,,26.99,0,26.99,26.99,-1,-30660,65625,96285,34965,0,-31734,0,0,0,,31734,-31734
9,02/26/2017,9,2:00,2:15,,28.31,0,28.31,28.31,-1,-36768,49574,86342,12806,0,-23243,0,0,0,,23243,-23243
9,02/26/2017,10,2:15,2:30,,15.69,0,15.69,15.69,-1,-31275,64454,95729,33179,0,-25258,0,0,0,,25258,-25258
9,02/26/2017,11,2:30,2:45,,28.31,0,28.31,28.31,-1,-37540,58306,95846,20766,0,-21050,0,0,0,,21050,-21050
9,02/26/2017,12,2:45,3:00,,18.53,0,18.53,18.53,-1,-36065,70685,106750,34620,0,-30462,0,0,0,,30462,-30462
9,02/26/2017,13,3:00,3:15,,26.8,0,26.8,26.8,-1,-32679,69418,102097,36739,0,-27471,0,0,0,,27471,-27471
9,02/26/2017,14,3:15,3:30,,28.31,0,28.31,28.31,-1,-32366,58415,90781,26049,0,-3128,0,0,0,,3128,-3128
9,02/26/2017,15,3:30,3:45,,28.03,0,28.03,28.03,-1,-32795,59294,92089,26499,0,-15997,0,0,0,,15997,-15997
9,02/26/2017,16,3:45,4:00,,27.78,0,27.78,27.78,-1,-33798,63421,97219,29623,0,-26056,0,0,0,,26056,-26056
9,02/26/2017,17,4:00,4:15,,28,0,28,28,-1,-40024,54703,94727,14679,0,-20722,0,0,0,,20722,-20722
9,02/26/2017,18,4:15,4:30,,25.59,0,25.59,25.59,-1,-38597,61615,100212,23018,0,-25623,0,0,0,,25623,-25623
9,02/26/2017,19,4:30,4:45,,26.8,0,26.8,26.8,-1,-33911,63471,97382,29560,0,-22134,0,0,0,,22134,-22134
9,02/26/2017,20,4:45,5:00,,15.69,0,15.69,15.69,-1,-33485,63517,97002,30032,0,-37716,0,0,0,,37716,-37716
9,02/26/2017,21,5:00,5:15,32.14,32.31,0,32.14,31.74,2,-40749,50625,91374,9876,0,-9956,159,0,0,,10115,-9797
9,02/26/2017,22,5:15,5:30,,28.31,0,28.31,28.31,-1,-38916,51963,90879,13047,0,-9564,0,0,0,,9564,-9564
9,02/26/2017,23,5:30,5:45,,28.31,0,28.31,28.31,-1,-47819,43730,91549,-4089,0,-6357,0,0,0,,6357,-6357
9,02/26/2017,24,5:45,6:00,,32.89,0,32.89,32.89,-1,-57375,38035,95410,-19340,0,-8803,0,0,0,,8803,-8803
9,02/26/2017,25,6:00,6:15,,,0,31.75,31.75,0,-57771,50731,108502,-7040,0,-395,0,0,0,,395,-395
9,02/26/2017,26,6:15,6:30,32.09,,0,32.09,32.09,1,-46410,45521,91931,-889,0,0,279,0,0,,279,279
9,02/26/2017,27,6:30,6:45,32.09,,0,32.09,32.09,1,-46159,48050,94209,1891,0,0,77,0,0,,77,77
9,02/26/2017,28,6:45,7:00,33.64,,0,33.64,33.64,1,-46711,37960,84671,-8751,0,0,747,0,0,,747,747
9,02/26/2017,29,7:00,7:15,,21.49,0,21.49,21.49,-1,-33447,70412,103859,36965,0,-13939,0,0,0,,13939,-13939
9,02/26/2017,30,7:15,7:30,,33.1,0,33.1,33.1,-1,-31450,41641,73091,10191,0,-12172,0,0,0,,12172,-12172
9,02/26/2017,31,7:30,7:45,,27.78,0,27.78,27.78,-1,-23528,43057,66585,19529,0,-22646,0,0,0,,22646,-22646
9,02/26/2017,32,7:45,8:00,,31.08,0,31.08,31.08,-1,-42720,45351,88071,2631,0,-24806,0,0,0,,24806,-24806
9,02/26/2017,33,8:00,8:15,,10.21,0,10.21,10.21,-1,-54542,111015,165557,56473,0,-38124,0,0,0,,38124,-38124
9,02/26/2017,34,8:15,8:30,,28.1,0,28.1,28.1,-1,-27608,51102,78710,23494,0,-18898,0,0,0,,18898,-18898
9,02/26/2017,35,8:30,8:45,,34.37,0,34.37,34.37,-1,-33150,41748,74898,8598,0,-2469,0,0,0,,2469,-2469
9,02/26/2017,36,8:45,9:00,,32.1,0,32.1,32.1,-1,-60804,47372,108176,-13432,0,-772,0,0,0,,772,-772
9,02/26/2017,37,9:00,9:15,,-12.78,0,-12.78,-12.78,-1,-17350,72336,89686,54986,0,-29360,0,0,0,,29360,-29360
9,02/26/2017,38,9:15,9:30,,27.88,0,27.88,27.88,-1,-29702,58213,87915,28511,0,-37228,0,0,0,,37228,-37228
9,02/26/2017,39,9:30,9:45,,29.75,0,29.75,29.75,-1,-36467,45535,82002,9068,0,-23696,0,0,0,,23696,-23696
9,02/26/2017,40,9:45,10:00,,34.31,0,34.31,34.31,-1,-50008,47205,97213,-2803,0,-3500,0,0,0,,3500,-3500
9,02/26/2017,41,10:00,10:15,85.64,,0,85.64,85.64,1,-107810,49339,157149,-58471,0,0,17306,0,0,,17306,17306
9,02/26/2017,42,10:15,10:30,39.1,,0,39.1,39.1,1,-76162,59063,135225,-17099,0,0,17344,0,0,,17344,17344
9,02/26/2017,43,10:30,10:45,50.1,,0,50.1,50.1,1,-83485,50004,133489,-33481,0,0,21944,0,0,,21944,21944
9,02/26/2017,44,10:45,11:00,39.1,,0,39.1,39.1,1,-92614,43455,136069,-49159,0,0,31317,0,0,,31317,31317
9,02/26/2017,45,11:00,11:15,35.1,-50.24,0,-50.24,-50.24,-1,-18705,73629,92334,54924,0,-11464,13249,0,0,,24713,1785
9,02/26/2017,46,11:15,11:30,39.91,-50.24,0,39.91,-50.24,2,-62170,67471,129641,5301,0,-32216,1002,0,0,,33218,-31214
9,02/26/2017,47,11:30,11:45,39.91,27.17,0,27.17,27.17,-1,-22875,47864,70739,24989,0,-6471,1105,0,0,,7576,-5366
9,02/26/2017,48,11:45,12:00,,21.49,0,21.49,21.49,-1,-29679,43345,73024,13666,0,-25380,0,0,0,,25380,-25380
9,02/26/2017,49,12:00,12:15,33.73,-50.24,0,33.73,-50.24,2,-24987,65625,90612,40638,0,-8772,131,0,0,,8903,-8641
9,02/26/2017,50,12:15,12:30,36.54,-50.24,0,36.54,-50.24,2,-70371,69164,139535,-1207,0,-22628,1075,0,0,,23703,-21553
9,02/26/2017,51,12:30,12:45,36.54,-50.24,0,-50.24,-50.24,-1,-29999,89507,119506,59508,0,-21405,183,0,0,,21588,-21222
9,02/26/2017,52,12:45,13:00,,27.78,0,27.78,27.78,-1,-57920,92738,150658,34818,0,-32327,0,0,0,,32327,-32327
9,02/26/2017,53,13:00,13:15,50.41,34.37,0,50.41,50.41,1,-116650,81518,198168,-35132,0,-7772,9265,0,0,,17037,1493
9,02/26/2017,54,13:15,13:30,53.12,,0,53.12,53.12,1,-114391,63622,178013,-50769,0,0,28665,0,0,,28665,28665
9,02/26/2017,55,13:30,13:45,41.19,,0,41.19,41.19,1,-105436,62056,167492,-43380,0,0,31717,0,0,,31717,31717
9,02/26/2017,56,13:45,14:00,41.19,33.75,0,33.75,33.75,-1,-97730,66224,163954,-31506,0,-432,6173,0,0,,6605,5741
9,02/26/2017,57,14:00,14:15,39.82,,0,39.82,39.82,1,-78658,72017,150675,-6641,0,0,8610,0,0,,8610,8610
9,02/26/2017,58,14:15,14:30,41.19,,0,41.19,41.19,1,-58458,43265,101723,-15193,0,0,31949,0,0,,31949,31949
9,02/26/2017,59,14:30,14:45,33.67,,0,33.67,33.67,1,-48906,46288,95194,-2618,0,0,8225,0,0,,8225,8225
9,02/26/2017,60,14:45,15:00,34.49,,0,34.49,34.49,1,-50500,45567,96067,-4933,0,0,5236,0,0,,5236,5236
9,02/26/2017,61,15:00,15:15,32.13,,0,32.13,32.13,1,-42995,62251,105246,19256,0,0,1281,0,0,,1281,1281
9,02/26/2017,62,15:15,15:30,32.13,,0,32.13,32.13,1,-39511,69037,108548,29526,0,0,329,0,0,,329,329
9,02/26/2017,63,15:30,15:45,,,0,32.25,32.25,0,-44531,60892,105423,16361,0,0,0,0,0,,0,0
9,02/26/2017,64,15:45,16:00,32.74,,0,32.74,32.74,1,-54949,61968,116917,7019,0,0,1153,0,0,,1153,1153
9,02/26/2017,65,16:00,16:15,32.12,,0,32.12,32.12,1,-21230,78667,99897,57437,0,0,313,0,0,,313,313
9,02/26/2017,66,16:15,16:30,,32.91,0,32.91,32.91,-1,-16314,90357,106671,74043,0,-298,0,0,0,,298,-298
9,02/26/2017,67,16:30,16:45,,32.04,0,32.04,32.04,-1,-26035,68174,94209,42139,0,-2909,0,0,0,,2909,-2909
9,02/26/2017,68,16:45,17:00,,32.91,0,32.91,32.91,-1,-33775,68922,102697,35147,0,-456,0,0,0,,456,-456
9,02/26/2017,69,17:00,17:15,,,0,32.25,32.25,0,-59177,86882,146059,27705,0,-155,0,0,0,,155,-155
9,02/26/2017,70,17:15,17:30,,,0,32.25,32.25,0,-43322,68984,112306,25662,0,0,0,0,0,,0,0
9,02/26/2017,71,17:30,17:45,,,0,32.25,32.25,0,-39961,58351,98312,18390,0,0,0,0,0,,0,0
9,02/26/2017,72,17:45,18:00,,29.17,0,29.17,29.17,-1,-48901,106158,155059,57257,0,-4029,0,0,0,,4029,-4029
9,02/26/2017,73,18:00,18:15,,-58.85,0,-58.85,-58.85,-1,-62757,83237,145994,20480,0,-24706,0,0,0,,24706,-24706
9,02/26/2017,74,18:15,18:30,,31.37,0,31.37,31.37,-1,-59902,55004,114906,-4898,0,-10033,0,0,0,,10033,-10033
9,02/26/2017,75,18:30,18:45,30.12,31.37,0,30.12,30.12,1,-63629,59820,123449,-3809,0,-47,131,0,0,,178,84
9,02/26/2017,76,18:45,19:00,39.1,,0,39.1,39.1,1,-52904,55776,108680,2872,0,0,1825,0,0,,1825,1825
9,02/26/2017,77,19:00,19:15,147.3,,0,147.3,147.3,1,-103890,18823,122713,-85067,0,0,32236,0,0,,32236,32236
9,02/26/2017,78,19:15,19:30,35.1,,0,35.1,35.1,1,-59952,36219,96171,-23733,0,0,8654,0,0,,8654,8654
9,02/26/2017,79,19:30,19:45,,34.31,0,34.31,34.31,-1,-51564,36526,88090,-15038,0,-78,0,0,0,,78,-78
9,02/26/2017,80,19:45,20:00,,32.1,0,32.1,32.1,-1,-45149,45158,90307,9,0,-2671,0,0,0,,2671,-2671
9,02/26/2017,81,20:00,20:15,,32.82,0,32.82,32.82,-1,-49516,46422,95938,-3094,0,-2473,0,0,0,,2473,-2473
9,02/26/2017,82,20:15,20:30,,31.12,0,31.12,31.12,-1,-40650,53169,93819,12519,0,-2041,0,0,0,,2041,-2041
9,02/26/2017,83,20:30,20:45,,25.98,0,25.98,25.98,-1,-38499,83884,122383,45385,0,-34560,0,0,0,,34560,-34560
9,02/26/2017,84,20:45,21:00,,25.98,0,25.98,25.98,-1,-71254,107613,178867,36359,0,-45421,0,0,0,,45421,-45421
9,02/26/2017,85,21:00,21:15,,22.6,0,22.6,22.6,-1,-28291,94700,122991,66409,0,-27170,0,0,0,,27170,-27170
9,02/26/2017,86,21:15,21:30,,23.78,0,23.78,23.78,-1,-27430,69036,96466,41606,0,-15667,0,0,0,,15667,-15667
9,02/26/2017,87,21:30,21:45,,23.1,0,23.1,23.1,-1,-39947,70768,110715,30821,0,-25466,0,0,0,,25466,-25466
9,02/26/2017,88,21:45,22:00,,8.78,0,8.78,8.78,-1,-43802,97667,141469,53865,0,-36986,0,0,0,,36986,-36986
9,02/26/2017,89,22:00,22:15,32.12,33.1,0,32.12,32.12,1,-40675,21662,62337,-19013,0,-21865,38,0,0,,21903,-21827
9,02/26/2017,90,22:15,22:30,32.18,,0,32.18,32.18,1,-48371,22537,70908,-25834,0,0,915,0,0,,915,915
9,02/26/2017,91,22:30,22:45,32.12,32.82,0,32.25,32.25,2,-32517,43275,75792,10758,0,-310,484,0,0,,794,174
9,02/26/2017,92,22:45,23:00,,32.82,0,32.82,32.82,-1,-45267,71983,117250,26716,0,-1150,0,0,0,,1150,-1150
9,02/26/2017,93,23:00,23:15,32.12,,0,32.12,32.12,1,-56101,14379,70480,-41722,0,0,348,0,0,,348,348
9,02/26/2017,94,23:15,23:30,32.12,,0,32.12,32.12,1,-51571,14925,66496,-36646,0,0,533,0,0,,533,533
9,02/26/2017,95,23:30,23:45,32.12,,0,32.12,32.12,1,-49649,35611,85260,-14038,0,0,239,0,0,,239,239
9,02/26/2017,96,23:45,0:00,,32.1,0,32.1,32.1,-1,-51224,59044,110268,7820,0,-463,0,0,0,,463,-463
9,02/27/2017,1,0:00,0:15,34.71,32.1,0,34.71,34.71,1,-78029,72774,150803,-5255,0,-614,1735,0,0,,2349,1121
9,02/27/2017,2,0:15,0:30,39.1,,0,39.1,39.1,1,-64954,25171,90125,-39783,0,0,21650,0,0,,21650,21650
9,02/27/2017,3,0:30,0:45,,,0,32.13,32.13,0,-68143,22292,90435,-45851,0,0,4780,0,0,,4780,4780
9,02/27/2017,4,0:45,1:00,,34.03,0,34.03,34.03,-1,-67611,31499,99110,-36112,0,-52,0,0,0,,52,-52
9,02/27/2017,5,1:00,1:15,45.1,34.03,0,45.1,45.1,1,-70866,30021,100887,-40845,0,-56,9834,0,0,,9890,9778
9,02/27/2017,6,1:15,1:30,47.02,,0,47.02,47.02,1,-70157,10690,80847,-59467,0,0,26753,0,0,,26753,26753
9,02/27/2017,7,1:30,1:45,39.1,,0,39.1,39.1,1,-67334,15908,83242,-51426,0,0,24763,0,0,,24763,24763
9,02/27/2017,8,1:45,2:00,33.67,32.72,0,32.72,32.72,-1,-61560,18405,79965,-43155,0,-61,13676,0,0,,13737,13615
9,02/27/2017,9,2:00,2:15,33.76,33.1,0,33.76,32.17,2,-52663,47946,100609,-4717,0,-215,2281,0,0,,2496,2066
9,02/27/2017,10,2:15,2:30,34.42,,0,34.42,34.42,1,-50734,26142,76876,-24592,0,0,6547,0,0,,6547,6547
9,02/27/2017,11,2:30,2:45,37.06,,0,37.06,37.06,1,-46694,26443,73137,-20251,0,0,17519,0,0,,17519,17519
9,02/27/2017,12,2:45,3:00,33.67,,0,33.67,33.67,1,-45458,27485,72943,-17973,0,0,15140,0,0,,15140,15140
9,02/27/2017,13,3:00,3:15,42.02,,0,42.02,42.02,1,-65053,33390,98443,-31663,0,0,21175,0,0,,21175,21175
9,02/27/2017,14,3:15,3:30,35.1,,0,35.1,35.1,1,-60928,35098,96026,-25830,0,0,22186,0,0,,22186,22186
9,02/27/2017,15,3:30,3:45,36.06,,0,36.06,36.06,1,-60507,37846,98353,-22661,0,0,20764,0,0,,20764,20764
9,02/27/2017,16,3:45,4:00,36.06,,0,36.06,36.06,1,-49063,47854,96917,-1209,0,0,20764,0,0,,20764,20764
9,02/27/2017,17,4:00,4:15,36.06,33.07,0,33.07,33.07,-1,-27799,54615,82414,26816,0,-945,2693,0,0,,3638,1748
9,02/27/2017,18,4:15,4:30,,32.1,0,32.1,32.1,-1,-22644,52454,75098,29810,0,-1412,0,0,0,,1412,-1412
9,02/27/2017,19,4:30,4:45,,27.03,0,27.03,27.03,-1,-23718,42198,65916,18480,0,-8190,0,0,0,,8190,-8190
9,02/27/2017,20,4:45,5:00,,32.45,0,32.45,32.45,-1,-27088,54383,81471,27295,0,-1021,0,0,0,,1021,-1021
9,02/27/2017,21,5:00,5:15,,32.1,0,32.1,32.1,-1,-39464,49681,89145,10217,0,-523,0,0,0,,523,-523
9,02/27/2017,22,5:15,5:30,,,0,32.15,32.15,0,-18262,36588,54850,18326,0,0,0,0,0,,0,0
9,02/27/2017,23,5:30,5:45,,33.1,0,33.1,33.1,-1,-36652,29369,66021,-7283,0,-585,0,0,0,,585,-585
9,02/27/2017,24,5:45,6:00,,34.37,0,34.37,34.37,-1,-46235,42313,88548,-3922,0,-415,0,0,0,,415,-415
9,02/27/2017,25,6:00,6:15,,32.1,0,32.1,32.1,-1,-49792,70721,120513,20929,0,-3527,0,0,0,,3527,-3527
9,02/27/2017,26,6:15,6:30,,35.8,0,35.8,35.8,-1,-49028,51770,100798,2742,0,-1636,0,0,0,,1636,-1636
9,02/27/2017,27,6:30,6:45,,36.1,0,36.1,36.1,-1,-76249,55708,131957,-20541,0,-96,0,0,0,,96,-96
9,02/27/2017,28,6:45,7:00,,,0,33.26,33.26,0,-95244,58544,153788,-36700,0,0,0,0,0,,0,0
9,02/27/2017,29,7:00,7:15,,34.62,0,34.62,34.62,-1,-87111,103112,190223,16001,0,-255,0,0,0,,255,-255
9,02/27/2017,30,7:15,7:30,,34.62,0,34.62,34.62,-1,-75797,92789,168586,16992,0,-621,0,0,0,,621,-621
9,02/27/2017,31,7:30,7:45,,34.62,0,34.62,34.62,-1,-103456,74693,178149,-28763,0,-619,0,0,0,,619,-619
9,02/27/2017,32,7:45,8:00,,,0,35.21,35.21,0,-131913,66496,198409,-65417,0,0,0,0,0,,0,0
9,02/27/2017,33,8:00,8:15,,27.32,0,27.32,27.32,-1,-61965,106204,168169,44239,0,-8750,0,0,0,,8750,-8750
9,02/27/2017,34,8:15,8:30,,35.4,0,35.4,35.4,-1,-80070,68765,148835,-11305,0,-1663,0,0,0,,1663,-1663
9,02/27/2017,35,8:30,8:45,,,0,35.21,35.21,0,-95366,67565,162931,-27801,0,0,0,0,0,,0,0
9,02/27/2017,36,8:45,9:00,,30.13,0,30.13,30.13,-1,-65749,62103,127852,-3646,0,-2346,0,0,0,,2346,-2346
9,02/27/2017,37,9:00,9:15,,8.16,0,8.16,8.16,-1,-28237,111194,139431,82957,0,-40106,0,0,0,,40106,-40106
9,02/27/2017,38,9:15,9:30,,8.16,0,8.16,8.16,-1,-41547,87782,129329,46235,0,-42007,0,0,0,,42007,-42007
9,02/27/2017,39,9:30,9:45,,29.02,0,29.02,29.02,-1,-35178,102766,137944,67588,0,-32409,0,0,0,,32409,-32409
9,02/27/2017,40,9:45,10:00,,21.49,0,21.49,21.49,-1,-28431,95145,123576,66714,0,-55286,0,0,0,,55286,-55286
9,02/27/2017,41,10:00,10:15,,29.02,0,29.02,29.02,-1,-38685,90735,129420,52050,0,-43551,0,0,0,,43551,-43551
9,02/27/2017,42,10:15,10:30,,29.02,0,29.02,29.02,-1,-37157,93849,131006,56692,0,-41441,0,0,0,,41441,-41441
9,02/27/2017,43,10:30,10:45,,31.49,0,31.49,31.49,-1,-42853,80869,123722,38016,0,-35471,0,0,0,,35471,-35471
9,02/27/2017,44,10:45,11:00,,32.87,0,32.87,32.87,-1,-56462,78957,135419,22495,0,-22887,0,0,0,,22887,-22887
9,02/27/2017,45,11:00,11:15,,34.46,0,34.46,34.46,-1,-72866,70832,143698,-2034,0,-7639,0,0,0,,7639,-7639
9,02/27/2017,46,11:15,11:30,66,34.46,0,66,66,1,-74789,56007,130796,-18782,0,-16,8918,0,0,,8934,8902
9,02/27/2017,47,11:30,11:45,70.62,,0,70.62,70.62,1,-85306,49165,134471,-36141,0,0,38647,0,0,,38647,38647
9,02/27/2017,48,11:45,12:00,39.7,,0,39.7,39.7,1,-91261,55680,146941,-35581,0,0,29872,0,0,,29872,29872
9,02/27/2017,49,12:00,12:15,42.02,,0,42.02,42.02,1,-109823,79159,188982,-30664,0,0,25871,0,0,,25871,25871
9,02/27/2017,50,12:15,12:30,38.9,,0,38.9,38.9,1,-110455,67056,177511,-43399,0,0,16710,0,0,,16710,16710
9,02/27/2017,51,12:30,12:45,55.1,,0,55.1,55.1,1,-109511,58407,167918,-51104,0,0,6291,0,0,,6291,6291
9,02/27/2017,52,12:45,13:00,46.64,,0,46.64,46.64,1,-118590,57639,176229,-60951,0,0,7921,0,0,,7921,7921
9,02/27/2017,53,13:00,13:15,134.02,,0,134.02,134.02,1,-122340,56029,178369,-66311,0,0,16054,0,0,,16054,16054
9,02/27/2017,54,13:15,13:30,134.02,,0,134.02,134.02,1,-152009,62691,214700,-89318,0,0,47187,0,0,,47187,47187
9,02/27/2017,55,13:30,13:45,97.02,,0,97.02,97.02,1,-133666,67232,200898,-66434,0,0,11608,0,0,,11608,11608
9,02/27/2017,56,13:45,14:00,134.02,,0,134.02,134.02,1,-157434,63632,221066,-93802,0,0,62822,0,0,,62822,62822
9,02/27/2017,57,14:00,14:15,135.53,,0,135.53,135.53,1,-181757,74163,255920,-107594,0,0,64727,0,0,,64727,64727
9,02/27/2017,58,14:15,14:30,135.53,,0,135.53,135.53,1,-195766,58224,253990,-137542,0,0,84940,0,0,,84940,84940
9,02/27/2017,59,14:30,14:45,109.02,,0,109.02,109.02,1,-136129,60472,196601,-75657,0,0,70931,0,0,,70931,70931
9,02/27/2017,60,14:45,15:00,55.1,,0,55.1,55.1,1,-155414,60645,216059,-94769,0,0,38990,0,0,,38990,38990
9,02/27/2017,61,15:00,15:15,42.02,,0,42.02,42.02,1,-97877,93508,191385,-4369,0,0,26212,0,0,,26212,26212
9,02/27/2017,62,15:15,15:30,42.02,33.42,0,33.42,33.42,-1,-88963,102090,191053,13127,0,-344,1798,0,0,,2142,1454
9,02/27/2017,63,15:30,15:45,,,0,34.3,34.3,0,-101177,100933,202110,-244,0,0,0,0,0,,0,0
9,02/27/2017,64,15:45,16:00,42.02,,0,42.02,42.02,1,-107238,86450,193688,-20788,0,0,5220,0,0,,5220,5220
9,02/27/2017,65,16:00,16:15,42.02,,0,42.02,42.02,1,-97172,84257,181429,-12915,0,0,12952,0,0,,12952,12952
9,02/27/2017,66,16:15,16:30,32.48,33.42,0,33.42,33.42,-1,-57073,75883,132956,18810,0,-977,868,0,0,,1845,-109
9,02/27/2017,67,16:30,16:45,,30.67,0,30.67,30.67,-1,-20954,101555,122509,80601,0,-9695,0,0,0,,9695,-9695
9,02/27/2017,68,16:45,17:00,,-39.82,0,-39.82,-39.82,-1,-15555,106298,121853,90743,0,-32737,0,0,0,,32737,-32737
9,02/27/2017,69,17:00,17:15,,-6.99,0,-6.99,-6.99,-1,-35452,121279,156731,85827,0,-37829,0,0,0,,37829,-37829
9,02/27/2017,70,17:15,17:30,,31.03,0,31.03,31.03,-1,-20916,107471,128387,86555,0,-11932,0,0,0,,11932,-11932
9,02/27/2017,71,17:30,17:45,,32.23,0,32.23,32.23,-1,-18503,117371,135874,98868,0,-1147,0,0,0,,1147,-1147
9,02/27/2017,72,17:45,18:00,,-0.5,0,-0.5,-0.5,-1,-17006,189222,206228,172216,0,-19107,0,0,0,,19107,-19107
9,02/27/2017,73,18:00,18:15,,22.99,0,22.99,22.99,-1,-47799,138948,186747,91149,0,-37492,0,0,0,,37492,-37492
9,02/27/2017,74,18:15,18:30,,32.23,0,32.23,32.23,-1,-37841,149222,187063,111381,0,-14926,0,0,0,,14926,-14926
9,02/27/2017,75,18:30,18:45,,,0,34.24,34.24,0,-52738,122993,175731,70255,0,-1178,0,0,0,,1178,-1178
9,02/27/2017,76,18:45,19:00,,36.1,0,36.1,36.1,-1,-46189,102224,148413,56035,0,-297,0,0,0,,297,-297
9,02/27/2017,77,19:00,19:15,,31.43,0,31.43,31.43,-1,-50329,66476,116805,16147,0,-4022,0,0,0,,4022,-4022
9,02/27/2017,78,19:15,19:30,,8.1,0,8.1,8.1,-1,-38537,83212,121749,44675,0,-29593,0,0,0,,29593,-29593
9,02/27/2017,79,19:30,19:45,,-17.04,0,-17.04,-17.04,-1,-36408,96833,133241,60425,0,-36280,0,0,0,,36280,-36280
9,02/27/2017,80,19:45,20:00,,-17.04,0,-17.04,-17.04,-1,-70595,56328,126923,-14267,0,-34298,0,0,0,,34298,-34298
9,02/27/2017,81,20:00,20:15,32.06,-17.04,0,32.06,32.06,1,-59365,72341,131706,12976,0,-1125,117,0,0,,1242,-1008
9,02/27/2017,82,20:15,20:30,32.06,25.02,0,25.02,25.02,-1,-59497,77014,136511,17517,0,-4486,20,0,0,,4506,-4466
9,02/27/2017,83,20:30,20:45,,11.95,0,11.95,11.95,-1,-35796,81982,117778,46186,0,-44129,0,0,0,,44129,-44129
9,02/27/2017,84,20:45,21:00,,-58.55,0,-58.55,-58.55,-1,-53843,124760,178603,70917,0,-39548,0,0,0,,39548,-39548
9,02/27/2017,85,21:00,21:15,130.58,-58.7,0,130.58,130.58,1,-97915,41270,139185,-56645,0,-26714,7843,0,0,,34557,-18871
9,02/27/2017,86,21:15,21:30,147.56,17.32,0,147.56,17.32,2,-57420,58765,116185,1345,0,-1120,24206,0,0,,25326,23086
9,02/27/2017,87,21:30,21:45,,-58.7,0,-58.7,-58.7,-1,-30227,59868,90095,29641,0,-27134,0,0,0,,27134,-27134
9,02/27/2017,88,21:45,22:00,,33.1,0,33.1,33.1,-1,-74406,82178,156584,7772,0,-312,0,0,0,,312,-312
9,02/27/2017,89,22:00,22:15,,33.1,0,33.1,33.1,-1,-72825,44132,116957,-28693,0,-1188,0,0,0,,1188,-1188
9,02/27/2017,90,22:15,22:30,,34.23,0,34.23,34.23,-1,-56709,43364,100073,-13345,0,-392,0,0,0,,392,-392
9,02/27/2017,91,22:30,22:45,,32.1,0,32.1,32.1,-1,-19710,58653,78363,38943,0,-3922,0,0,0,,3922,-3922
9,02/27/2017,92,22:45,23:00,,23.25,0,23.25,23.25,-1,-20875,76892,97767,56017,0,-20688,0,0,0,,20688,-20688
9,02/27/2017,93,23:00,23:15,46.78,6.03,0,46.78,6.03,2,-66747,54866,121613,-11881,0,-24940,1883,0,0,,26823,-23057
9,02/27/2017,94,23:15,23:30,48.11,27.41,0,27.41,27.41,-1,-51255,65816,117071,14561,0,-1031,3972,0,0,,5003,2941
9,02/27/2017,95,23:30,23:45,,-64.14,0,-64.14,-64.14,-1,-48970,70984,119954,22014,0,-19947,0,0,0,,19947,-19947
9,02/27/2017,96,23:45,0:00,,-64.14,0,-64.14,-64.14,-1,-50697,96431,147128,45734,0,-25556,0,0,0,,25556,-25556
9,02/28/2017,1,0:00,0:15,,22.78,0,22.78,22.78,-1,-93911,121797,215708,27886,0,-18962,0,0,0,,18962,-18962
9,02/28/2017,2,0:15,0:30,35.14,,0,35.14,35.14,1,-90650,67749,158399,-22901,0,0,3543,0,0,,3543,3543
9,02/28/2017,3,0:30,0:45,35,,0,35,35,1,-81297,59934,141231,-21363,0,0,2456,0,0,,2456,2456
9,02/28/2017,4,0:45,1:00,32.41,,0,32.41,32.41,1,-85471,69405,154876,-16066,0,0,905,0,0,,905,905
9,02/28/2017,5,1:00,1:15,46.74,,0,46.74,46.74,1,-73005,31180,104185,-41825,0,0,15415,0,0,,15415,15415
9,02/28/2017,6,1:15,1:30,37.55,,0,37.55,37.55,1,-65811,47066,112877,-18745,0,0,17536,0,0,,17536,17536
9,02/28/2017,7,1:30,1:45,41,,0,41,41,1,-64968,47102,112070,-17866,0,0,14199,0,0,,14199,14199
9,02/28/2017,8,1:45,2:00,42.74,,0,42.74,42.74,1,-72696,45162,117858,-27534,0,0,28338,0,0,,28338,28338
9,02/28/2017,9,2:00,2:15,53.88,,0,53.88,53.88,1,-83867,34867,118734,-49000,0,0,22900,0,0,,22900,22900
9,02/28/2017,10,2:15,2:30,53.88,,0,53.88,53.88,1,-78088,52169,130257,-25919,0,0,27797,0,0,,27797,27797
9,02/28/2017,11,2:30,2:45,31,30.74,0,31.87,30.74,2,-68440,57731,126171,-10709,0,-552,3681,0,0,,4233,3129
9,02/28/2017,12,2:45,3:00,31,32.67,0,31.87,31.87,2,-64671,71833,136504,7162,0,-82,494,0,0,,576,412
9,02/28/2017,13,3:00,3:15,,32.28,0,32.28,32.28,-1,-68482,88301,156783,19819,0,-1565,0,0,0,,1565,-1565
9,02/28/2017,14,3:15,3:30,,,0,31.87,31.87,0,-63920,60691,124611,-3229,0,-173,0,0,0,,173,-173
9,02/28/2017,15,3:30,3:45,35,,0,35,35,1,-66037,63668,129705,-2369,0,0,1987,0,0,,1987,1987
9,02/28/2017,16,3:45,4:00,33.57,,0,33.57,33.57,1,-77796,68033,145829,-9763,0,0,897,0,0,,897,897
9,02/28/2017,17,4:00,4:15,42.43,,0,42.43,42.43,1,-100302,66575,166877,-33727,0,0,19161,0,0,,19161,19161
9,02/28/2017,18,4:15,4:30,40,,0,40,40,1,-97852,64045,161897,-33807,0,0,27262,0,0,,27262,27262
9,02/28/2017,19,4:30,4:45,46.74,,0,46.74,46.74,1,-118684,55137,173821,-63547,0,0,41499,0,0,,41499,41499
9,02/28/2017,20,4:45,5:00,46.74,,0,46.74,46.74,1,-110703,71347,182050,-39356,0,0,47271,0,0,,47271,47271
9,02/28/2017,21,5:00,5:15,31,-109.31,0,-109.31,-109.31,-1,-66390,105446,171836,39056,0,-8227,10627,0,0,,18854,2400
9,02/28/2017,22,5:15,5:30,35,-109.31,0,35,-109.31,2,-96860,89398,186258,-7462,0,-22735,300,0,0,,23035,-22435
9,02/28/2017,23,5:30,5:45,35,31.47,0,31.47,31.47,-1,-61020,78114,139134,17094,0,-466,905,0,0,,1371,439
9,02/28/2017,24,5:45,6:00,,32.28,0,32.28,32.28,-1,-82125,90826,172951,8701,0,-1430,0,0,0,,1430,-1430
9,02/28/2017,25,6:00,6:15,,28,0,28,28,-1,-105437,101667,207104,-3770,0,-1778,0,0,0,,1778,-1778
9,02/28/2017,26,6:15,6:30,33.48,28,0,33.48,33.48,1,-61223,52463,113686,-8760,0,-2875,523,0,0,,3398,-2352
9,02/28/2017,27,6:30,6:45,46.74,,0,46.74,46.74,1,-98262,40978,139240,-57284,0,0,20036,0,0,,20036,20036
9,02/28/2017,28,6:45,7:00,178.37,,0,178.37,178.37,1,-128193,49314,177507,-78879,0,0,59497,0,0,,59497,59497
9,02/28/2017,29,7:00,7:15,38.74,28.74,0,38.74,28.74,2,-62615,93020,155635,30405,0,-1636,19800,0,0,,21436,18164
9,02/28/2017,30,7:15,7:30,,,0,32.38,32.38,0,-54836,61930,116766,7094,0,-312,0,0,0,,312,-312
9,02/28/2017,31,7:30,7:45,,,0,32.38,32.38,0,-74845,126148,200993,51303,0,0,0,0,0,,0,0
9,02/28/2017,32,7:45,8:00,31,,0,31,31,1,-98671,119020,217691,20349,0,0,130,0,0,,130,130
9,02/28/2017,33,8:00,8:15,34.89,,0,34.89,34.89,1,-50950,88569,139519,37619,0,0,1176,0,0,,1176,1176
9,02/28/2017,34,8:15,8:30,,,0,32.38,32.38,0,-73789,86682,160471,12893,0,0,0,0,0,,0,0
9,02/28/2017,35,8:30,8:45,269.32,,0,269.32,269.32,1,-127195,66299,193494,-60896,0,0,7410,0,0,,7410,7410
9,02/28/2017,36,8:45,9:00,269.32,,0,269.32,269.32,1,-131855,88867,220722,-42988,0,0,41819,0,0,,41819,41819
9,02/28/2017,37,9:00,9:15,33.39,31.47,0,31.47,31.47,-1,-55028,67617,122645,12589,0,-330,7239,0,0,,7569,6909
9,02/28/2017,38,9:15,9:30,,31.47,0,31.47,31.47,-1,-64060,101550,165610,37490,0,-1804,0,0,0,,1804,-1804
9,02/28/2017,39,9:30,9:45,,31.38,0,31.38,31.38,-1,-48469,108345,156814,59876,0,-2637,0,0,0,,2637,-2637
9,02/28/2017,40,9:45,10:00,,24,0,24,24,-1,-51296,92025,143321,40729,0,-9023,0,0,0,,9023,-9023
9,02/28/2017,41,10:00,10:15,,-58.88,0,-58.88,-58.88,-1,-54950,89653,144603,34703,0,-35990,0,0,0,,35990,-35990
9,02/28/2017,42,10:15,10:30,,24,0,24,24,-1,-53846,93170,147016,39324,0,-23693,0,0,0,,23693,-23693
9,02/28/2017,43,10:30,10:45,,27.27,0,27.27,27.27,-1,-74027,87632,161659,13605,0,-20692,0,0,0,,20692,-20692
9,02/28/2017,44,10:45,11:00,40,27.27,0,40,40,1,-93351,84187,177538,-9164,0,-1450,2437,0,0,,3887,987
9,02/28/2017,45,11:00,11:15,,,0,33.38,33.38,0,-95407,72155,167562,-23252,0,0,0,0,0,,0,0
9,02/28/2017,46,11:15,11:30,,28.74,0,28.74,28.74,-1,-71978,91037,163015,19059,0,-2405,0,0,0,,2405,-2405
9,02/28/2017,47,11:30,11:45,,28.78,0,28.78,28.78,-1,-82150,99572,181722,17422,0,-2905,0,0,0,,2905,-2905
9,02/28/2017,48,11:45,12:00,,30.74,0,30.74,30.74,-1,-87528,101908,189436,14380,0,-1072,0,0,0,,1072,-1072
9,02/28/2017,49,12:00,12:15,,26.74,0,26.74,26.74,-1,-84279,126836,211115,42557,0,-4682,0,0,0,,4682,-4682
9,02/28/2017,50,12:15,12:30,,26.74,0,26.74,26.74,-1,-65882,120824,186706,54942,0,-2891,0,0,0,,2891,-2891
9,02/28/2017,51,12:30,12:45,84.78,20,0,84.78,20,2,-72483,98683,171166,26200,0,-10020,176,0,0,,10196,-9844
9,02/28/2017,52,12:45,13:00,84.78,20,0,84.78,84.78,1,-214325,101763,316088,-112562,0,-256,14430,0,0,,14686,14174
9,02/28/2017,53,13:00,13:15,200.62,,0,200.62,200.62,1,-209799,125915,335714,-83884,0,0,44670,0,0,,44670,44670
9,02/28/2017,54,13:15,13:30,84.78,,0,84.78,84.78,1,-189678,126375,316053,-63303,0,0,44115,0,0,,44115,44115
9,02/28/2017,55,13:30,13:45,45.12,,0,45.12,45.12,1,-184772,104661,289433,-80111,0,0,29756,0,0,,29756,29756
9,02/28/2017,56,13:45,14:00,,,0,33.38,33.38,0,-196727,111143,307870,-85584,0,0,6978,0,0,,6978,6978
9,02/28/2017,57,14:00,14:15,,,0,33.38,33.38,0,-145984,131000,276984,-14984,0,0,0,0,0,,0,0
9,02/28/2017,58,14:15,14:30,,,0,33.38,33.38,0,-164437,96831,261268,-67606,0,0,0,0,0,,0,0
9,02/28/2017,59,14:30,14:45,33.57,,0,33.57,33.57,1,-172298,109508,281806,-62790,0,0,80,0,0,,80,80
9,02/28/2017,60,14:45,15:00,37.55,,0,37.55,37.55,1,-125507,100114,225621,-25393,0,0,1565,0,0,,1565,1565
9,02/28/2017,61,15:00,15:15,,20,0,20,20,-1,-46002,135375,181377,89373,0,-5932,0,0,0,,5932,-5932
9,02/28/2017,62,15:15,15:30,,30.78,0,30.78,30.78,-1,-52085,120612,172697,68527,0,-3503,0,0,0,,3503,-3503
9,02/28/2017,63,15:30,15:45,,,0,33.38,33.38,0,-63534,92556,156090,29022,0,0,0,0,0,,0,0
9,02/28/2017,64,15:45,16:00,,,0,33.38,33.38,0,-69372,89550,158922,20178,0,0,0,0,0,,0,0
9,02/28/2017,65,16:00,16:15,,28.74,0,28.74,28.74,-1,-46894,135043,181937,88149,0,-969,0,0,0,,969,-969
9,02/28/2017,66,16:15,16:30,,,0,33.38,33.38,0,-53381,132646,186027,79265,0,0,0,0,0,,0,0
9,02/28/2017,67,16:30,16:45,,,0,33.38,33.38,0,-50644,123434,174078,72790,0,0,0,0,0,,0,0
9,02/28/2017,68,16:45,17:00,,,0,33.38,33.38,0,-53144,131457,184601,78313,0,0,0,0,0,,0,0
9,02/28/2017,69,17:00,17:15,,28.74,0,28.74,28.74,-1,-60916,169760,230676,108844,0,-4563,0,0,0,,4563,-4563
9,02/28/2017,70,17:15,17:30,,25.13,0,25.13,25.13,-1,-67388,165265,232653,97877,0,-16619,0,0,0,,16619,-16619
9,02/28/2017,71,17:30,17:45,,,0,33.38,33.38,0,-70424,124766,195190,54342,0,-1492,0,0,0,,1492,-1492
9,02/28/2017,72,17:45,18:00,34.89,,0,34.89,34.89,1,-65743,96675,162418,30932,0,0,242,0,0,,242,242
9,02/28/2017,73,18:00,18:15,35.54,,0,35.54,35.54,1,-157883,109173,267056,-48710,0,0,504,0,0,,504,504
9,02/28/2017,74,18:15,18:30,35.54,,0,35.54,35.54,1,-142671,88261,230932,-54410,0,0,31,0,0,,31,31
9,02/28/2017,75,18:30,18:45,40.91,,0,40.91,40.91,1,-171675,69681,241356,-101994,0,0,8319,0,0,,8319,8319
9,02/28/2017,76,18:45,19:00,209.44,,0,209.44,209.44,1,-178442,58191,236633,-120251,0,0,23854,0,0,,23854,23854
9,02/28/2017,77,19:00,19:15,197.13,,0,197.13,197.13,1,-158524,66857,225381,-91667,0,0,66046,0,0,,66046,66046
9,02/28/2017,78,19:15,19:30,38.74,,0,38.74,38.74,1,-124710,95570,220280,-29140,0,0,14926,0,0,,14926,14926
9,02/28/2017,79,19:30,19:45,,,0,34.38,34.38,0,-112489,98372,210861,-14117,0,0,0,0,0,,0,0
9,02/28/2017,80,19:45,20:00,,16.9,0,16.9,16.9,-1,-96167,103316,199483,7149,0,-15679,0,0,0,,15679,-15679
9,02/28/2017,81,20:00,20:15,197.97,35.14,0,197.97,197.97,1,-80770,54290,135060,-26480,0,-3801,12023,0,0,,15824,8222
9,02/28/2017,82,20:15,20:30,175.19,14,0,14,14,-1,-48782,88347,137129,39565,0,-1697,17225,0,0,,18922,15528
9,02/28/2017,83,20:30,20:45,175.19,-6.99,0,-6.99,-6.99,-1,-49269,85399,134668,36130,0,-12406,38,0,0,,12444,-12368
9,02/28/2017,84,20:45,21:00,,29.78,0,29.78,29.78,-1,-83510,87066,170576,3556,0,-5715,0,0,0,,5715,-5715
9,02/28/2017,85,21:00,21:15,174.07,25.35,0,174.07,174.07,1,-104427,44390,148817,-60037,0,-6577,8855,0,0,,15432,2278
9,02/28/2017,86,21:15,21:30,174.07,25.35,0,174.07,174.07,1,-116480,58877,175357,-57603,0,-90,45804,0,0,,45894,45714
9,02/28/2017,87,21:30,21:45,36.26,,0,36.26,36.26,1,-60707,56237,116944,-4470,0,0,2151,0,0,,2151,2151
9,02/28/2017,88,21:45,22:00,36.26,36.14,0,36.14,36.14,-1,-123402,88848,212250,-34554,0,-3,28,0,0,,31,25
9,02/28/2017,89,22:00,22:15,,28.12,0,28.12,28.12,-1,-70542,81204,151746,10662,0,-2556,0,0,0,,2556,-2556
9,02/28/2017,90,22:15,22:30,,14,0,14,14,-1,-67124,66431,133555,-693,0,-3055,0,0,0,,3055,-3055
9,02/28/2017,91,22:30,22:45,,2,0,2,2,-1,-68342,91560,159902,23218,0,-20157,0,0,0,,20157,-20157
9,02/28/2017,92,22:45,23:00,,-66.24,0,-66.24,-66.24,-1,-58561,116928,175489,58367,0,-14775,0,0,0,,14775,-14775
9,02/28/2017,93,23:00,23:15,129.52,-66.24,0,129.52,129.52,1,-153081,27028,180109,-126053,0,-7801,29830,0,0,,37631,22029
9,02/28/2017,94,23:15,23:30,58.75,,0,58.75,58.75,1,-85576,35360,120936,-50216,0,0,42206,0,0,,42206,42206
9,02/28/2017,95,23:30,23:45,40.14,,0,40.14,40.14,1,-85626,44621,130247,-41005,0,0,38939,0,0,,38939,38939
9,02/28/2017,96,23:45,0:00,35.12,,0,35.12,35.12,1,-88387,74995,163382,-13392,0,0,19544,0,0,,19544,19544
9,03-01-17,1,0:00,0:15,119.07,,0,119.07,119.07,1,-117394,26914,144308,-90480,0,0,30752,0,0,,30752,30752
9,03-01-17,2,0:15,0:30,119.07,,0,119.07,119.07,1,-106408,22856,129264,-83552,0,0,60338,0,0,,60338,60338
9,03-01-17,3,0:30,0:45,38.72,,0,38.72,38.72,1,-92836,34757,127593,-58079,0,0,18134,0,0,,18134,18134
9,03-01-17,4,0:45,1:00,,,0,32.94,32.94,0,-84582,29087,113669,-55495,0,0,366,0,0,,366,366
9,03-01-17,5,1:00,1:15,49.42,,0,49.42,49.42,1,-81490,31082,112572,-50408,0,0,16053,0,0,,16053,16053
9,03-01-17,6,1:15,1:30,51.58,,0,51.58,51.58,1,-75396,29808,105204,-45588,0,0,43812,0,0,,43812,43812
9,03-01-17,7,1:30,1:45,34.02,,0,34.02,34.02,1,-71625,41214,112839,-30411,0,0,10230,0,0,,10230,10230
9,03-01-17,8,1:45,2:00,32.99,,0,32.99,32.99,1,-61087,48481,109568,-12606,0,0,1541,0,0,,1541,1541
9,03-01-17,9,2:00,2:15,31.53,,0,31.53,31.53,1,-62514,53307,115821,-9207,0,0,1785,0,0,,1785,1785
9,03-01-17,10,2:15,2:30,35.38,,0,35.38,35.38,1,-65766,45602,111368,-20164,0,0,3728,0,0,,3728,3728
9,03-01-17,11,2:30,2:45,35.38,,0,35.38,35.38,1,-66577,47329,113906,-19248,0,0,2704,0,0,,2704,2704
9,03-01-17,12,2:45,3:00,39.09,,0,39.09,39.09,1,-73196,42450,115646,-30746,0,0,3380,0,0,,3380,3380
9,03-01-17,13,3:00,3:15,62.29,,0,62.29,62.29,1,-97982,46842,144824,-51140,0,0,31795,0,0,,31795,31795
9,03-01-17,14,3:15,3:30,45.09,,0,45.09,45.09,1,-95482,43013,138495,-52469,0,0,39505,0,0,,39505,39505
9,03-01-17,15,3:30,3:45,35.38,,0,35.38,35.38,1,-72407,46250,118657,-26157,0,0,11661,0,0,,11661,11661
9,03-01-17,16,3:45,4:00,35.38,,0,35.38,35.38,1,-57501,55348,112849,-2153,0,0,4841,0,0,,4841,4841
9,03-01-17,17,4:00,4:15,,,0,32.88,32.88,0,-33119,53497,86616,20378,0,0,19,0,0,,19,19
9,03-01-17,18,4:15,4:30,,,0,32.38,32.38,0,-13530,57796,71326,44266,0,0,0,0,0,,0,0
9,03-01-17,19,4:30,4:45,,,0,32.38,32.38,0,-17339,32929,50268,15590,0,0,0,0,0,,0,0
9,03-01-17,20,4:45,5:00,,,0,32.38,32.38,0,-32726,53419,86145,20693,0,0,0,0,0,,0,0
9,03-01-17,21,5:00,5:15,,-13,0,-13,-13,-1,-23994,77497,101491,53503,0,-23408,0,0,0,,23408,-23408
9,03-01-17,22,5:15,5:30,,28.09,0,28.09,28.09,-1,-28920,50122,79042,21202,0,-28571,0,0,0,,28571,-28571
9,03-01-17,23,5:30,5:45,,28.09,0,28.09,28.09,-1,-35007,62754,97761,27747,0,-24895,0,0,0,,24895,-24895
9,03-01-17,24,5:45,6:00,,27.74,0,27.74,27.74,-1,-41179,78776,119955,37597,0,-10400,0,0,0,,10400,-10400
9,03-01-17,25,6:00,6:15,,-46.18,0,-46.18,-46.18,-1,-22560,88522,111082,65962,0,-43175,0,0,0,,43175,-43175
9,03-01-17,26,6:15,6:30,,27.74,0,27.74,27.74,-1,-29509,65773,95282,36264,0,-23556,0,0,0,,23556,-23556
9,03-01-17,27,6:30,6:45,,28.74,0,28.74,28.74,-1,-41778,45206,86984,3428,0,-14450,0,0,0,,14450,-14450
9,03-01-17,28,6:45,7:00,40.18,28.74,0,40.18,40.18,1,-75813,74023,149836,-1790,0,-217,1109,0,0,,1326,892
9,03-01-17,29,7:00,7:15,47.96,,0,47.96,47.96,1,-119372,78065,197437,-41307,0,0,5170,0,0,,5170,5170
9,03-01-17,30,7:15,7:30,31.26,,0,31.26,31.26,1,-79237,77463,156700,-1774,0,0,760,0,0,,760,760
9,03-01-17,31,7:30,7:45,33.45,,0,33.45,33.45,1,-99236,61358,160594,-37878,0,0,2369,0,0,,2369,2369
9,03-01-17,32,7:45,8:00,301.42,,0,301.42,301.42,1,-132954,57379,190333,-75575,0,0,19231,0,0,,19231,19231
9,03-01-17,33,8:00,8:15,34.86,28.9,0,28.9,28.9,-1,-83267,80857,164124,-2410,0,-347,8282,0,0,,8629,7935
9,03-01-17,34,8:15,8:30,,27.63,0,27.63,27.63,-1,-85622,73222,158844,-12400,0,-4590,0,0,0,,4590,-4590
9,03-01-17,35,8:30,8:45,,,0,32.9,32.9,0,-98041,50784,148825,-47257,0,-6,0,0,0,,6,-6
9,03-01-17,36,8:45,9:00,,,0,32.9,32.9,0,-134683,52013,186696,-82670,0,0,0,0,0,,0,0
9,03-01-17,37,9:00,9:15,36.71,,0,36.71,36.71,1,-127686,48289,175975,-79397,0,0,1302,0,0,,1302,1302
9,03-01-17,38,9:15,9:30,33.19,,0,33.19,33.19,1,-138317,45121,183438,-93196,0,0,693,0,0,,693,693
9,03-01-17,39,9:30,9:45,34.49,,0,34.49,34.49,1,-122081,52513,174594,-69568,0,0,1112,0,0,,1112,1112
9,03-01-17,40,9:45,10:00,,,0,32.91,32.91,0,-105738,58823,164561,-46915,0,0,0,0,0,,0,0
9,03-01-17,41,10:00,10:15,36.08,,0,36.08,36.08,1,-158024,53265,211289,-104759,0,0,4105,0,0,,4105,4105
9,03-01-17,42,10:15,10:30,31.06,,0,31.06,31.06,1,-114769,53742,168511,-61027,0,0,1629,0,0,,1629,1629
9,03-01-17,43,10:30,10:45,,,0,32.32,32.32,0,-108388,57003,165391,-51385,0,0,0,0,0,,0,0
9,03-01-17,44,10:45,11:00,,,0,32.32,32.32,0,-97824,78411,176235,-19413,0,0,0,0,0,,0,0
9,03-01-17,45,11:00,11:15,,,0,32.05,32.05,0,-87628,101757,189385,14129,0,0,0,0,0,,0,0
9,03-01-17,46,11:15,11:30,,,0,32.05,32.05,0,-78391,106060,184451,27669,0,0,0,0,0,,0,0
9,03-01-17,47,11:30,11:45,,,0,32.05,32.05,0,-58920,112739,171659,53819,0,0,0,0,0,,0,0
9,03-01-17,48,11:45,12:00,,,0,32.05,32.05,0,-80004,122160,202164,42156,0,0,0,0,0,,0,0
9,03-01-17,49,12:00,12:15,,29.52,0,29.52,29.52,-1,-93417,113368,206785,19951,0,-466,0,0,0,,466,-466
9,03-01-17,50,12:15,12:30,,28.36,0,28.36,28.36,-1,-83101,115360,198461,32259,0,-571,0,0,0,,571,-571
9,03-01-17,51,12:30,12:45,,24.36,0,24.36,24.36,-1,-78472,117210,195682,38738,0,-7117,0,0,0,,7117,-7117
9,03-01-17,52,12:45,13:00,,28.36,0,28.36,28.36,-1,-77549,111406,188955,33857,0,-1782,0,0,0,,1782,-1782
9,03-01-17,53,13:00,13:15,,24.36,0,24.36,24.36,-1,-75907,120861,196768,44954,0,-16414,0,0,0,,16414,-16414
9,03-01-17,54,13:15,13:30,,17.82,0,17.82,17.82,-1,-70773,117171,187944,46398,0,-26731,0,0,0,,26731,-26731
9,03-01-17,55,13:30,13:45,,3.3,0,3.3,3.3,-1,-52447,114110,166557,61663,0,-59952,0,0,0,,59952,-59952
9,03-01-17,56,13:45,14:00,,17.82,0,17.82,17.82,-1,-46185,108242,154427,62057,0,-58744,0,0,0,,58744,-58744
9,03-01-17,57,14:00,14:15,,27.03,0,27.03,27.03,-1,-48626,94140,142766,45514,0,-47202,0,0,0,,47202,-47202
9,03-01-17,58,14:15,14:30,31.99,29.03,0,31.99,31.99,1,-61744,71542,133286,9798,0,-18573,209,0,0,,18782,-18364
9,03-01-17,59,14:30,14:45,31.36,29.03,0,31.36,31.36,1,-57849,63395,121244,5546,0,-17,229,0,0,,246,212
9,03-01-17,60,14:45,15:00,,28.74,0,28.74,28.74,-1,-57138,71969,129107,14831,0,-7087,0,0,0,,7087,-7087
9,03-01-17,61,15:00,15:15,,28.36,0,28.36,28.36,-1,-55079,65106,120185,10027,0,-12395,0,0,0,,12395,-12395
9,03-01-17,62,15:15,15:30,,30.74,0,30.74,30.74,-1,-54119,69514,123633,15395,0,-6925,0,0,0,,6925,-6925
9,03-01-17,63,15:30,15:45,,29.52,0,29.52,29.52,-1,-60293,61410,121703,1117,0,-5593,0,0,0,,5593,-5593
9,03-01-17,64,15:45,16:00,35.24,29.52,0,35.24,35.24,1,-63845,50368,114213,-13477,0,-414,996,0,0,,1410,582
9,03-01-17,65,16:00,16:15,,,0,32.37,32.37,0,-74206,63008,137214,-11198,0,0,41,0,0,,41,41
9,03-01-17,66,16:15,16:30,31.36,,0,31.36,31.36,1,-83087,58925,142012,-24162,0,0,215,0,0,,215,215
9,03-01-17,67,16:30,16:45,35.11,,0,35.11,35.11,1,-101113,60313,161426,-40800,0,0,2725,0,0,,2725,2725
9,03-01-17,68,16:45,17:00,31.99,,0,31.99,31.99,1,-123733,57152,180885,-66581,0,0,795,0,0,,795,795
9,03-01-17,69,17:00,17:15,33.54,,0,33.54,33.54,1,-117280,46379,163659,-70901,0,0,2329,0,0,,2329,2329
9,03-01-17,70,17:15,17:30,35.24,,0,35.24,35.24,1,-136608,52719,189327,-83889,0,0,6826,0,0,,6826,6826
9,03-01-17,71,17:30,17:45,40.08,,0,40.08,40.08,1,-133593,53180,186773,-80413,0,0,11177,0,0,,11177,11177
9,03-01-17,72,17:45,18:00,201.37,,0,201.37,201.37,1,-140216,53114,193330,-87102,0,0,36447,0,0,,36447,36447
9,03-01-17,73,18:00,18:15,46.99,31.18,0,31.18,31.18,-1,-93019,93843,186862,824,0,-98,18683,0,0,,18781,18585
9,03-01-17,74,18:15,18:30,31.99,31.44,0,32.89,31.44,2,-88255,73262,161517,-14993,0,-938,19,0,0,,957,-919
9,03-01-17,75,18:30,18:45,78.02,,0,78.02,78.02,1,-98011,44245,142256,-53766,0,0,20541,0,0,,20541,20541
9,03-01-17,76,18:45,19:00,42.74,,0,42.74,42.74,1,-115999,43872,159871,-72127,0,0,28926,0,0,,28926,28926
9,03-01-17,77,19:00,19:15,31.36,,0,31.36,31.36,1,-86816,59716,146532,-27100,0,0,8386,0,0,,8386,8386
9,03-01-17,78,19:15,19:30,,,0,32.91,32.91,0,-88898,63399,152297,-25499,0,0,0,0,0,,0,0
9,03-01-17,79,19:30,19:45,32.38,,0,32.38,32.38,1,-132260,65493,197753,-66767,0,0,319,0,0,,319,319
9,03-01-17,80,19:45,20:00,33.02,,0,33.02,33.02,1,-136821,57470,194291,-79351,0,0,1680,0,0,,1680,1680
9,03-01-17,81,20:00,20:15,139.38,,0,139.38,139.38,1,-132416,85497,217913,-46919,0,0,24083,0,0,,24083,24083
9,03-01-17,82,20:15,20:30,46.74,,0,46.74,46.74,1,-115931,96686,212617,-19245,0,0,37894,0,0,,37894,37894
9,03-01-17,83,20:30,20:45,46.74,29.77,0,29.77,29.77,-1,-96312,103501,199813,7189,0,-1367,3438,0,0,,4805,2071
9,03-01-17,84,20:45,21:00,,30.74,0,30.74,30.74,-1,-109500,118567,228067,9067,0,-71,0,0,0,,71,-71
9,03-01-17,85,21:00,21:15,185.62,30.74,0,185.62,185.62,1,-106204,78491,184695,-27713,0,-289,9829,0,0,,10118,9540
9,03-01-17,86,21:15,21:30,185.62,,0,185.62,185.62,1,-114350,88373,202723,-25977,0,0,33394,0,0,,33394,33394
9,03-01-17,87,21:30,21:45,,,0,31.88,31.88,0,-120537,121907,242444,1370,0,0,959,0,0,,959,959
9,03-01-17,88,21:45,22:00,,29.26,0,29.26,29.26,-1,-135914,114614,250528,-21300,0,-452,0,0,0,,452,-452
9,03-01-17,89,22:00,22:15,55.3,28.03,0,55.3,28.03,2,-126402,128493,254895,2091,0,-2743,2546,0,0,,5289,-197
9,03-01-17,90,22:15,22:30,78.46,,0,78.46,78.46,1,-152974,77765,230739,-75209,0,0,18713,0,0,,18713,18713
9,03-01-17,91,22:30,22:45,113.21,,0,113.21,113.21,1,-134047,71570,205617,-62477,0,0,15394,0,0,,15394,15394
9,03-01-17,92,22:45,23:00,127.92,,0,127.92,127.92,1,-133355,74256,207611,-59099,0,0,50171,0,0,,50171,50171
9,03-01-17,93,23:00,23:15,128.64,,0,128.64,128.64,1,-145994,64643,210637,-81351,0,0,17097,0,0,,17097,17097
9,03-01-17,94,23:15,23:30,128.02,,0,128.02,128.02,1,-130371,74628,204999,-55743,0,0,38654,0,0,,38654,38654
9,03-01-17,95,23:30,23:45,35.09,,0,35.09,35.09,1,-114131,90736,204867,-23395,0,0,1509,0,0,,1509,1509
9,03-01-17,96,23:45,0:00,34.38,30.25,0,30.25,30.25,-1,-114981,118477,233458,3496,0,-622,1288,0,0,,1910,666
9,03-02-17,1,0:00,0:15,,18.78,0,18.78,18.78,-1,-68337,99827,168164,31490,0,-9207,0,0,0,,9207,-9207
9,03-02-17,2,0:15,0:30,,23.78,0,23.78,23.78,-1,-48749,69557,118306,20808,0,-5890,0,0,0,,5890,-5890
9,03-02-17,3,0:30,0:45,,21.87,0,21.87,21.87,-1,-56142,86221,142363,30079,0,-14224,0,0,0,,14224,-14224
9,03-02-17,4,0:45,1:00,,-7.3,0,-7.3,-7.3,-1,-56671,120848,177519,64177,0,-36412,0,0,0,,36412,-36412
9,03-02-17,5,1:00,1:15,128.12,-7.3,0,128.12,128.12,1,-109499,32248,141747,-77251,0,-17249,14328,0,0,,31577,-2921
9,03-02-17,6,1:15,1:30,128.12,,0,128.12,128.12,1,-107442,31754,139196,-75688,0,0,67069,0,0,,67069,67069
9,03-02-17,7,1:30,1:45,38.48,32,0,32,32,-1,-73149,70138,143287,-3011,0,-19,7651,0,0,,7670,7632
9,03-02-17,8,1:45,2:00,,23.74,0,23.74,23.74,-1,-40683,80572,121255,39889,0,-14039,0,0,0,,14039,-14039
9,03-02-17,9,2:00,2:15,,-102.26,0,-102.26,-102.26,-1,-74289,114083,188372,39794,0,-35886,0,0,0,,35886,-35886
9,03-02-17,10,2:15,2:30,29.78,29.65,0,31.43,29.65,2,-60058,45846,105904,-14212,0,-7922,25,0,0,,7947,-7897
9,03-02-17,11,2:30,2:45,,,0,31.43,31.43,0,-52357,50171,102528,-2186,0,0,0,0,0,,0,0
9,03-02-17,12,2:45,3:00,,32,0,32,32,-1,-59181,49852,109033,-9329,0,-985,0,0,0,,985,-985
9,03-02-17,13,3:00,3:15,75.26,32.39,0,75.26,75.26,1,-123756,65669,189425,-58087,0,-168,14768,0,0,,14936,14600
9,03-02-17,14,3:15,3:30,51.74,,0,51.74,51.74,1,-114440,39438,153878,-75002,0,0,40791,0,0,,40791,40791
9,03-02-17,15,3:30,3:45,51.74,,0,51.74,51.74,1,-99522,48600,148122,-50922,0,0,37067,0,0,,37067,37067
9,03-02-17,16,3:45,4:00,38.74,,0,38.74,38.74,1,-91762,64284,156046,-27478,0,0,28717,0,0,,28717,28717
9,03-02-17,17,4:00,4:15,29.78,28.15,0,28.15,28.15,-1,-90430,61263,151693,-29167,0,-515,7310,0,0,,7825,6795
9,03-02-17,18,4:15,4:30,,20.67,0,20.67,20.67,-1,-70486,114073,184559,43587,0,-13797,0,0,0,,13797,-13797
9,03-02-17,19,4:30,4:45,,27.78,0,27.78,27.78,-1,-37147,117008,154155,79861,0,-4076,0,0,0,,4076,-4076
9,03-02-17,20,4:45,5:00,,8.78,0,8.78,8.78,-1,-34104,152503,186607,118399,0,-31150,0,0,0,,31150,-31150
9,03-02-17,21,5:00,5:15,,23.74,0,23.74,23.74,-1,-45520,121806,167326,76286,0,-33875,0,0,0,,33875,-33875
9,03-02-17,22,5:15,5:30,,28.15,0,28.15,28.15,-1,-56694,129009,185703,72315,0,-15288,0,0,0,,15288,-15288
9,03-02-17,23,5:30,5:45,,,0,31.76,31.76,0,-49164,124645,173809,75481,0,-227,0,0,0,,227,-227
9,03-02-17,24,5:45,6:00,,,0,31.76,31.76,0,-70873,142863,213736,71990,0,0,0,0,0,,0,0
9,03-02-17,25,6:00,6:15,,23.74,0,23.74,23.74,-1,-67358,169828,237186,102470,0,-3590,0,0,0,,3590,-3590
9,03-02-17,26,6:15,6:30,,32.39,0,32.39,32.39,-1,-77704,112802,190506,35098,0,-480,0,0,0,,480,-480
9,03-02-17,27,6:30,6:45,33.49,32.39,0,33.49,33.49,1,-90071,76096,166167,-13975,0,-12,1493,0,0,,1505,1481
9,03-02-17,28,6:45,7:00,37.49,,0,37.49,37.49,1,-65511,66185,131696,674,0,0,4942,0,0,,4942,4942
9,03-02-17,29,7:00,7:15,,,0,31.93,31.93,0,-130468,103169,233637,-27299,0,0,1081,0,0,,1081,1081
9,03-02-17,30,7:15,7:30,,12.08,0,12.08,12.08,-1,-78229,102915,181144,24686,0,-10114,0,0,0,,10114,-10114
9,03-02-17,31,7:30,7:45,,1.52,0,1.52,1.52,-1,-78897,72990,151887,-5907,0,-22293,0,0,0,,22293,-22293
9,03-02-17,32,7:45,8:00,,,0,31.93,31.93,0,-108806,87763,196569,-21043,0,-265,0,0,0,,265,-265
9,03-02-17,33,8:00,8:15,53.49,21.23,0,53.49,21.23,2,-68626,97216,165842,28590,0,-11189,234,0,0,,11423,-10955
9,03-02-17,34,8:15,8:30,272.42,21.23,0,299.66,299.66,1,-65295,89365,154660,24070,0,-713,26735,0,12384,,39832,38406
9,03-02-17,35,8:30,8:45,263.97,-26.02,0,290.37,-26.02,2,-35710,133833,169543,98123,0,-17717,1163,15000,72592,,106472,71038
9,03-02-17,36,8:45,9:00,,25.23,0,25.23,25.23,-1,-78953,100985,179938,22032,0,-17563,0,0,25765,,43328,8202
9,03-02-17,37,9:00,9:15,,28.31,0,28.31,28.31,-1,-54890,52566,107456,-2324,0,-12580,0,0,0,,12580,-12580
9,03-02-17,38,9:15,9:30,30.9,28.31,0,30.9,30.9,1,-69769,65185,134954,-4584,0,-919,79,0,0,,998,-840
9,03-02-17,39,9:30,9:45,29.12,,0,29.12,29.12,1,-82384,62163,144547,-20221,0,0,36,0,0,,36,36
9,03-02-17,40,9:45,10:00,29.12,,0,29.12,29.12,1,-92769,57299,150068,-35470,0,0,75,0,0,,75,75
9,03-02-17,41,10:00,10:15,30.85,,0,30.85,30.85,1,-97206,50548,147754,-46658,0,0,455,0,0,,455,455
9,03-02-17,42,10:15,10:30,31.74,,0,31.74,31.74,1,-96878,54969,151847,-41909,0,0,189,0,0,,189,189
9,03-02-17,43,10:30,10:45,33.8,,0,33.8,33.8,1,-110894,56204,167098,-54690,0,0,717,0,0,,717,717
9,03-02-17,44,10:45,11:00,42.92,,0,42.92,42.92,1,-119641,53156,172797,-66485,0,0,5630,0,0,,5630,5630
9,03-02-17,45,11:00,11:15,32.13,,0,32.13,32.13,1,-143378,73063,216441,-70315,0,0,2919,0,0,,2919,2919
9,03-02-17,46,11:15,11:30,31.74,,0,31.74,31.74,1,-139357,61272,200629,-78085,0,0,334,0,0,,334,334
9,03-02-17,47,11:30,11:45,38.73,,0,38.73,38.73,1,-150323,57359,207682,-92964,0,0,4450,0,0,,4450,4450
9,03-02-17,48,11:45,12:00,53.49,,0,53.49,53.49,1,-144143,51227,195370,-92916,0,0,14011,0,0,,14011,14011
9,03-02-17,49,12:00,12:15,36.45,,0,36.45,36.45,1,-138814,57970,196784,-80844,0,0,6407,0,0,,6407,6407
9,03-02-17,50,12:15,12:30,38.73,,0,38.73,38.73,1,-142008,38996,181004,-103012,0,0,3179,0,0,,3179,3179
9,03-02-17,51,12:30,12:45,31.74,,0,31.74,31.74,1,-101552,33384,134936,-68168,0,0,1417,0,0,,1417,1417
9,03-02-17,52,12:45,13:00,,,0,31.93,31.93,0,-85124,42200,127324,-42924,0,0,0,0,0,,0,0
9,03-02-17,53,13:00,13:15,,,0,31.93,31.93,0,-78308,47985,126293,-30323,0,0,0,0,0,,0,0
9,03-02-17,54,13:15,13:30,,,0,31.93,31.93,0,-72839,57209,130048,-15630,0,0,0,0,0,,0,0
9,03-02-17,55,13:30,13:45,,,0,31.93,31.93,0,-64850,65014,129864,164,0,0,0,0,0,,0,0
9,03-02-17,56,13:45,14:00,,31.1,0,31.1,31.1,-1,-99274,70862,170136,-28412,0,-1292,0,0,0,,1292,-1292
9,03-02-17,57,14:00,14:15,,27.09,0,27.09,27.09,-1,-78626,109913,188539,31287,0,-8675,0,0,0,,8675,-8675
9,03-02-17,58,14:15,14:30,,26.74,0,26.74,26.74,-1,-73908,91780,165688,17872,0,-14301,0,0,0,,14301,-14301
9,03-02-17,59,14:30,14:45,,28.3,0,28.3,28.3,-1,-74218,86358,160576,12140,0,-13356,0,0,0,,13356,-13356
9,03-02-17,60,14:45,15:00,,25.23,0,25.23,25.23,-1,-61728,83490,145218,21762,0,-17112,0,0,0,,17112,-17112
9,03-02-17,61,15:00,15:15,32.13,32.74,0,32.13,32.13,1,-98728,72607,171335,-26121,0,-5625,246,0,0,,5871,-5379
9,03-02-17,62,15:15,15:30,,28.3,0,28.3,28.3,-1,-79413,80070,159483,657,0,-2499,0,0,0,,2499,-2499
9,03-02-17,63,15:30,15:45,,,0,31.93,31.93,0,-102483,77839,180322,-24644,0,0,0,0,0,,0,0
9,03-02-17,64,15:45,16:00,,,0,31.93,31.93,0,-98432,67654,166086,-30778,0,0,0,0,0,,0,0
9,03-02-17,65,16:00,16:15,,29.74,0,29.74,29.74,-1,-110244,97327,207571,-12917,0,-278,0,0,0,,278,-278
9,03-02-17,66,16:15,16:30,,24.1,0,24.1,24.1,-1,-76723,103831,180554,27108,0,-8179,0,0,0,,8179,-8179
9,03-02-17,67,16:30,16:45,,30,0,30,30,-1,-68789,91028,159817,22239,0,-1558,0,0,0,,1558,-1558
9,03-02-17,68,16:45,17:00,,,0,33.24,33.24,0,-65927,81651,147578,15724,0,-110,0,0,0,,110,-110
9,03-02-17,69,17:00,17:15,,,0,32.93,32.93,0,-114212,83697,197909,-30515,0,0,0,0,0,,0,0
9,03-02-17,70,17:15,17:30,,,0,32.93,32.93,0,-102879,78448,181327,-24431,0,0,0,0,0,,0,0
9,03-02-17,71,17:30,17:45,40.74,,0,40.74,40.74,1,-81634,62622,144256,-19012,0,0,3907,0,0,,3907,3907
9,03-02-17,72,17:45,18:00,40.74,,0,40.74,40.74,1,-80351,47835,128186,-32516,0,0,19363,0,0,,19363,19363
9,03-02-17,73,18:00,18:15,31.74,-53.76,0,32.93,-53.76,2,-60421,101181,161602,40760,0,-19656,7764,0,0,,27420,-11892
9,03-02-17,74,18:15,18:30,31.74,26.74,0,31.74,31.74,1,-73276,78662,151938,5386,0,-6868,23,0,0,,6891,-6845
9,03-02-17,75,18:30,18:45,56,,0,56,56,1,-77309,47080,124389,-30229,0,0,2269,0,0,,2269,2269
9,03-02-17,76,18:45,19:00,201.38,,0,201.38,201.38,1,-83956,23212,107168,-60744,0,0,47432,0,0,,47432,47432
9,03-02-17,77,19:00,19:15,55.8,,0,55.8,55.8,1,-72364,49835,122199,-22529,0,0,34144,0,0,,34144,34144
9,03-02-17,78,19:15,19:30,31.74,28.59,0,32.93,28.59,2,-54851,62197,117048,7346,0,-1009,4483,0,0,,5492,3474
9,03-02-17,79,19:30,19:45,34.86,,0,34.86,34.86,1,-59110,46089,105199,-13021,0,0,1913,0,0,,1913,1913
9,03-02-17,80,19:45,20:00,31.74,,0,31.74,31.74,1,-79226,47780,127006,-31446,0,0,1161,0,0,,1161,1161
9,03-02-17,81,20:00,20:15,48.74,,0,48.74,48.74,1,-87224,51431,138655,-35793,0,0,5498,0,0,,5498,5498
9,03-02-17,82,20:15,20:30,31.74,,0,31.74,31.74,1,-72492,37873,110365,-34619,0,0,682,0,0,,682,682
9,03-02-17,83,20:30,20:45,,,0,33.24,33.24,0,-61554,43469,105023,-18085,0,0,0,0,0,,0,0
9,03-02-17,84,20:45,21:00,,27.12,0,27.12,27.12,-1,-52324,61340,113664,9016,0,-980,0,0,0,,980,-980
9,03-02-17,85,21:00,21:15,35.98,25.23,0,35.98,25.23,2,-82344,89385,171729,7041,0,-3085,766,0,0,,3851,-2319
9,03-02-17,86,21:15,21:30,35.98,28.44,0,28.44,28.44,-1,-56025,81319,137344,25294,0,-429,292,0,0,,721,-137
9,03-02-17,87,21:30,21:45,,1.09,0,1.09,1.09,-1,-42794,89544,132338,46750,0,-14376,0,0,0,,14376,-14376
9,03-02-17,88,21:45,22:00,,4.25,0,4.25,4.25,-1,-54987,88277,143264,33290,0,-28792,0,0,0,,28792,-28792
9,03-02-17,89,22:00,22:15,34.99,26.78,0,34.99,34.99,1,-56602,29493,86095,-27109,0,-12741,390,0,0,,13131,-12351
9,03-02-17,90,22:15,22:30,37.27,26.78,0,37.27,37.27,1,-76667,14500,91167,-62167,0,-120,2369,0,0,,2489,2249
9,03-02-17,91,22:30,22:45,,30,0,30,30,-1,-38917,43292,82209,4375,0,-206,0,0,0,,206,-206
9,03-02-17,92,22:45,23:00,,12.09,0,12.09,12.09,-1,-39273,67611,106884,28338,0,-23314,0,0,0,,23314,-23314
9,03-02-17,93,23:00,23:15,49.88,21.87,0,49.88,21.87,2,-43329,20094,63423,-23235,0,-20039,2731,0,0,,22770,-17308
9,03-02-17,94,23:15,23:30,,,0,31.93,31.93,0,-70228,36731,106959,-33497,0,0,151,0,0,,151,151
9,03-02-17,95,23:30,23:45,,,0,31.93,31.93,0,-48465,43005,91470,-5460,0,0,0,0,0,,0,0
9,03-02-17,96,23:45,0:00,,26.74,0,26.74,26.74,-1,-49754,57581,107335,7827,0,-1503,0,0,0,,1503,-1503
9,03-03-17,1,0:00,0:15,,28.49,0,28.49,28.49,-1,-71867,54871,126738,-16996,0,-2856,0,0,0,,2856,-2856
9,03-03-17,2,0:15,0:30,,32.86,0,32.86,32.86,-1,-46190,44968,91158,-1222,0,-16,0,0,0,,16,-16
9,03-03-17,3,0:30,0:45,,31.4,0,31.4,31.4,-1,-47399,48770,96169,1371,0,-1094,0,0,0,,1094,-1094
9,03-03-17,4,0:45,1:00,,31.4,0,31.4,31.4,-1,-48049,47963,96012,-86,0,-1867,0,0,0,,1867,-1867
9,03-03-17,5,1:00,1:15,,29.49,0,29.49,29.49,-1,-56551,77069,133620,20518,0,-2253,0,0,0,,2253,-2253
9,03-03-17,6,1:15,1:30,31.34,29.74,0,32.1,29.74,2,-37921,40491,78412,2570,0,-51,58,0,0,,109,7
9,03-03-17,7,1:30,1:45,,28.49,0,28.49,28.49,-1,-38858,64495,103353,25637,0,-2906,0,0,0,,2906,-2906
9,03-03-17,8,1:45,2:00,,12.72,0,12.72,12.72,-1,-35344,86358,121702,51014,0,-36448,0,0,0,,36448,-36448
9,03-03-17,9,2:00,2:15,,21.85,0,21.85,21.85,-1,-47833,55659,103492,7826,0,-28510,0,0,0,,28510,-28510
9,03-03-17,10,2:15,2:30,,24.49,0,24.49,24.49,-1,-43553,68927,112480,25374,0,-10638,0,0,0,,10638,-10638
9,03-03-17,11,2:30,2:45,,24.49,0,24.49,24.49,-1,-48861,63082,111943,14221,0,-19790,0,0,0,,19790,-19790
9,03-03-17,12,2:45,3:00,,29.49,0,29.49,29.49,-1,-59170,49525,108695,-9645,0,-2612,0,0,0,,2612,-2612
9,03-03-17,13,3:00,3:15,,11.74,0,11.74,11.74,-1,-49488,97667,147155,48179,0,-18310,0,0,0,,18310,-18310
9,03-03-17,14,3:15,3:30,,29.49,0,29.49,29.49,-1,-57367,42747,100114,-14620,0,-6167,0,0,0,,6167,-6167
9,03-03-17,15,3:30,3:45,,,0,32.1,32.1,0,-65214,51959,117173,-13255,0,-26,0,0,0,,26,-26
9,03-03-17,16,3:45,4:00,31.34,,0,31.34,31.34,1,-71065,43129,114194,-27936,0,0,5,0,0,,5,5
9,03-03-17,17,4:00,4:15,31.73,,0,31.73,31.73,1,-98256,37158,135414,-61098,0,0,1109,0,0,,1109,1109
9,03-03-17,18,4:15,4:30,29.02,,0,29.02,29.02,1,-84602,41764,126366,-42838,0,0,276,0,0,,276,276
9,03-03-17,19,4:30,4:45,,,0,30.94,30.94,0,-83602,44459,128061,-39143,0,0,0,0,0,,0,0
9,03-03-17,20,4:45,5:00,,,0,30.94,30.94,0,-72043,61519,133562,-10524,0,0,0,0,0,,0,0
9,03-03-17,21,5:00,5:15,,,0,30.94,30.94,0,-108348,42133,150481,-66215,0,0,0,0,0,,0,0
9,03-03-17,22,5:15,5:30,,,0,32.1,32.1,0,-67455,37303,104758,-30152,0,0,0,0,0,,0,0
9,03-03-17,23,5:30,5:45,,,0,32.13,32.13,0,-80576,25439,106015,-55137,0,0,0,0,0,,0,0
9,03-03-17,24,5:45,6:00,,,0,30.94,30.94,0,-76074,65692,141766,-10382,0,0,0,0,0,,0,0
9,03-03-17,25,6:00,6:15,,30.88,0,30.88,30.88,-1,-82229,23872,106101,-58357,0,-127,0,0,0,,127,-127
9,03-03-17,26,6:15,6:30,,30.88,0,30.88,30.88,-1,-56668,41341,98009,-15327,0,-1259,0,0,0,,1259,-1259
9,03-03-17,27,6:30,6:45,37.88,32.86,0,37.88,37.88,1,-96521,8376,104897,-88145,0,-23,709,0,0,,732,686
9,03-03-17,28,6:45,7:00,103.02,,0,103.02,103.02,1,-110451,26618,137069,-83833,0,0,22723,0,0,,22723,22723
9,03-03-17,29,7:00,7:15,34.02,-50.69,0,34.02,-50.69,2,-33728,117932,151660,84204,0,-25709,7386,0,0,,33095,-18323
9,03-03-17,30,7:15,7:30,,21.98,0,21.98,21.98,-1,-27023,90664,117687,63641,0,-36665,0,0,0,,36665,-36665
9,03-03-17,31,7:30,7:45,,29.26,0,29.26,29.26,-1,-39360,69999,109359,30639,0,-25145,0,0,0,,25145,-25145
9,03-03-17,32,7:45,8:00,,29.26,0,29.26,29.26,-1,-70281,47194,117475,-23087,0,-15220,0,0,0,,15220,-15220
9,03-03-17,33,8:00,8:15,,-38.97,0,-38.97,-38.97,-1,-12252,147540,159792,135288,0,-38954,0,0,0,,38954,-38954
9,03-03-17,34,8:15,8:30,,5.92,0,5.92,5.92,-1,-30325,85005,115330,54680,0,-48479,0,0,0,,48479,-48479
9,03-03-17,35,8:30,8:45,,28.74,0,28.74,28.74,-1,-31249,60578,91827,29329,0,-20712,0,0,0,,20712,-20712
9,03-03-17,36,8:45,9:00,,25.74,0,25.74,25.74,-1,-43519,62622,106141,19103,0,-24788,0,0,0,,24788,-24788
9,03-03-17,37,9:00,9:15,,30.88,0,30.88,30.88,-1,-37739,130356,168095,92617,0,-17932,0,0,0,,17932,-17932
9,03-03-17,38,9:15,9:30,,31.66,0,31.66,31.66,-1,-44026,105906,149932,61880,0,-8690,0,0,0,,8690,-8690
9,03-03-17,39,9:30,9:45,,31.03,0,31.03,31.03,-1,-43534,99187,142721,55653,0,-1859,0,0,0,,1859,-1859
9,03-03-17,40,9:45,10:00,,30.88,0,30.88,30.88,-1,-41564,88052,129616,46488,0,-3324,0,0,0,,3324,-3324
9,03-03-17,41,10:00,10:15,,26.88,0,26.88,26.88,-1,-42087,79276,121363,37189,0,-4546,0,0,0,,4546,-4546
9,03-03-17,42,10:15,10:30,,32.47,0,32.47,32.47,-1,-38289,74696,112985,36407,0,-736,0,0,0,,736,-736
9,03-03-17,43,10:30,10:45,,31.88,0,31.88,31.88,-1,-27853,78122,105975,50269,0,-3120,0,0,0,,3120,-3120
9,03-03-17,44,10:45,11:00,,30.88,0,30.88,30.88,-1,-21768,76488,98256,54720,0,-5838,0,0,0,,5838,-5838
9,03-03-17,45,11:00,11:15,,32.86,0,32.86,32.86,-1,-43212,66231,109443,23019,0,-1670,0,0,0,,1670,-1670
9,03-03-17,46,11:15,11:30,32.2,,0,32.2,32.2,1,-54050,47245,101295,-6805,0,0,119,0,0,,119,119
9,03-03-17,47,11:30,11:45,35.88,,0,35.88,35.88,1,-58934,43658,102592,-15276,0,0,2009,0,0,,2009,2009
9,03-03-17,48,11:45,12:00,35.88,,0,35.88,35.88,1,-79175,40800,119975,-38375,0,0,1611,0,0,,1611,1611
9,03-03-17,49,12:00,12:15,37.88,,0,37.88,37.88,1,-89931,31034,120965,-58897,0,0,3790,0,0,,3790,3790
9,03-03-17,50,12:15,12:30,32.88,,0,32.88,32.88,1,-108897,27407,136304,-81490,0,0,901,0,0,,901,901
9,03-03-17,51,12:30,12:45,32.59,,0,32.59,32.59,1,-105333,40306,145639,-65027,0,0,1813,0,0,,1813,1813
9,03-03-17,52,12:45,13:00,32.2,,0,32.2,32.2,1,-109301,39656,148957,-69645,0,0,703,0,0,,703,703
9,03-03-17,53,13:00,13:15,66.82,,0,66.82,66.82,1,-119766,30288,150054,-89478,0,0,15472,0,0,,15472,15472
9,03-03-17,54,13:15,13:30,45.83,,0,45.83,45.83,1,-112817,14834,127651,-97983,0,0,30146,0,0,,30146,30146
9,03-03-17,55,13:30,13:45,45.83,,0,45.83,45.83,1,-98838,20701,119539,-78137,0,0,27835,0,0,,27835,27835
9,03-03-17,56,13:45,14:00,40.6,,0,40.6,40.6,1,-99699,19070,118769,-80629,0,0,23142,0,0,,23142,23142
9,03-03-17,57,14:00,14:15,285.59,,0,285.59,285.59,1,-153178,19860,173038,-133318,0,0,29807,0,0,,29807,29807
9,03-03-17,58,14:15,14:30,45.1,,0,45.1,45.1,1,-115985,25280,141265,-90705,0,0,26703,0,0,,26703,26703
9,03-03-17,59,14:30,14:45,,,0,32.53,32.53,0,-107534,30732,138266,-76802,0,0,2372,0,0,,2372,2372
9,03-03-17,60,14:45,15:00,,,0,32.53,32.53,0,-106527,46338,152865,-60189,0,0,0,0,0,,0,0
9,03-03-17,61,15:00,15:15,,,0,32.53,32.53,0,-96690,61845,158535,-34845,0,0,0,0,0,,0,0
9,03-03-17,62,15:15,15:30,,31.66,0,31.66,31.66,-1,-56731,60574,117305,3843,0,-71,0,0,0,,71,-71
9,03-03-17,63,15:30,15:45,,31.03,0,31.03,31.03,-1,-59762,79489,139251,19727,0,-1662,0,0,0,,1662,-1662
9,03-03-17,64,15:45,16:00,,32.86,0,32.86,32.86,-1,-59700,101305,161005,41605,0,-624,0,0,0,,624,-624
9,03-03-17,65,16:00,16:15,,,0,32.53,32.53,0,-77676,103974,181650,26298,0,0,0,0,0,,0,0
9,03-03-17,66,16:15,16:30,,,0,32.53,32.53,0,-63907,111615,175522,47708,0,0,0,0,0,,0,0
9,03-03-17,67,16:30,16:45,33.75,,0,33.75,33.75,1,-85686,89905,175591,4219,0,0,44,0,0,,44,44
9,03-03-17,68,16:45,17:00,52.13,,0,52.13,52.13,1,-115975,80602,196577,-35373,0,0,17787,0,0,,17787,17787
9,03-03-17,69,17:00,17:15,37.88,,0,37.88,37.88,1,-77106,66821,143927,-10285,0,0,13467,0,0,,13467,13467
9,03-03-17,70,17:15,17:30,33.66,,0,33.66,33.66,1,-71386,60812,132198,-10574,0,0,913,0,0,,913,913
9,03-03-17,71,17:30,17:45,35.88,,0,35.88,35.88,1,-73722,71403,145125,-2319,0,0,4911,0,0,,4911,4911
9,03-03-17,72,17:45,18:00,32.2,,0,32.2,32.2,1,-43245,64706,107951,21461,0,0,1742,0,0,,1742,1742
9,03-03-17,73,18:00,18:15,,13.75,0,13.75,13.75,-1,-75525,89377,164902,13852,0,-14501,0,0,0,,14501,-14501
9,03-03-17,74,18:15,18:30,,30.47,0,30.47,30.47,-1,-74231,96464,170695,22233,0,-11044,0,0,0,,11044,-11044
9,03-03-17,75,18:30,18:45,,32.86,0,32.86,32.86,-1,-75285,106283,181568,30998,0,-304,0,0,0,,304,-304
9,03-03-17,76,18:45,19:00,,32.86,0,32.86,32.86,-1,-65440,126907,192347,61467,0,-216,0,0,0,,216,-216
9,03-03-17,77,19:00,19:15,35.32,,0,35.32,35.32,1,-113248,83968,197216,-29280,0,0,802,0,0,,802,802
9,03-03-17,78,19:15,19:30,35.32,,0,35.32,35.32,1,-99793,80922,180715,-18871,0,0,916,0,0,,916,916
9,03-03-17,79,19:30,19:45,35.32,13.76,0,13.76,13.76,-1,-69970,102348,172318,32378,0,-2297,48,0,0,,2345,-2249
9,03-03-17,80,19:45,20:00,,12.24,0,12.24,12.24,-1,-66515,100081,166596,33566,0,-32574,0,0,0,,32574,-32574
9,03-03-17,81,20:00,20:15,,28.62,0,28.62,28.62,-1,-84103,94324,178427,10221,0,-18206,0,0,0,,18206,-18206
9,03-03-17,82,20:15,20:30,,26.11,0,26.11,26.11,-1,-64088,97025,161113,32937,0,-11050,0,0,0,,11050,-11050
9,03-03-17,83,20:30,20:45,,30.88,0,30.88,30.88,-1,-43067,72799,115866,29732,0,-14608,0,0,0,,14608,-14608
9,03-03-17,84,20:45,21:00,,-12.8,0,-12.8,-12.8,-1,-31950,82020,113970,50070,0,-26827,0,0,0,,26827,-26827
9,03-03-17,85,21:00,21:15,32.2,-48.75,0,32.53,-48.75,2,-77093,95277,172370,18184,0,-32857,2,0,0,,32859,-32855
9,03-03-17,86,21:15,21:30,32.59,12.1,0,32.59,12.1,2,-40877,99288,140165,58411,0,-1695,242,0,0,,1937,-1453
9,03-03-17,87,21:30,21:45,,-27.22,0,-27.22,-27.22,-1,-29440,82800,112240,53360,0,-11328,0,0,0,,11328,-11328
9,03-03-17,88,21:45,22:00,,-48.1,0,-48.1,-48.1,-1,-37723,107367,145090,69644,0,-20001,0,0,0,,20001,-20001
9,03-03-17,89,22:00,22:15,43.88,-46.19,0,43.88,43.88,1,-126579,57255,183834,-69324,0,-24022,1677,0,0,,25699,-22345
9,03-03-17,90,22:15,22:30,32.59,30.88,0,30.88,30.88,-1,-88578,68396,156974,-20182,0,-176,1319,0,0,,1495,1143
9,03-03-17,91,22:30,22:45,,30.03,0,30.03,30.03,-1,-52857,69272,122129,16415,0,-2919,0,0,0,,2919,-2919
9,03-03-17,92,22:45,23:00,,4.32,0,4.32,4.32,-1,-50500,79841,130341,29341,0,-27689,0,0,0,,27689,-27689
9,03-03-17,93,23:00,23:15,,-4.19,0,-4.19,-4.19,-1,-71554,50636,122190,-20918,0,-33848,0,0,0,,33848,-33848
9,03-03-17,94,23:15,23:30,32.59,-4.19,0,32.59,32.59,1,-75047,64842,139889,-10205,0,-393,348,0,0,,741,-45
9,03-03-17,95,23:30,23:45,,29.03,0,29.03,29.03,-1,-44622,68383,113005,23761,0,-4126,0,0,0,,4126,-4126
9,03-03-17,96,23:45,0:00,,14.64,0,14.64,14.64,-1,-51516,84844,136360,33328,0,-26058,0,0,0,,26058,-26058
10,03-04-17,1,0:00,0:15,,-65.64,0,-65.64,-65.64,-1,-91268,201979,293247,110711,0,-37747,0,0,0,,37747,-37747
10,03-04-17,2,0:15,0:30,,32.1,0,32.1,32.1,-1,-122567,118117,240684,-4450,0,-2426,0,0,0,,2426,-2426
10,03-04-17,3,0:30,0:45,,32.1,0,32.1,32.1,-1,-119433,104218,223651,-15215,0,-842,0,0,0,,842,-842
10,03-04-17,4,0:45,1:00,,32.38,0,32.38,32.38,-1,-106312,71355,177667,-34957,0,-141,0,0,0,,141,-141
10,03-04-17,5,1:00,1:15,33.32,32.1,0,33.32,30.61,2,-89531,91158,180689,1627,0,-112,219,0,0,,331,107
10,03-04-17,6,1:15,1:30,42.69,,0,42.69,42.69,1,-128197,75192,203389,-53005,0,0,16592,0,0,,16592,16592
10,03-04-17,7,1:30,1:45,39.05,,0,39.05,39.05,1,-119362,62892,182254,-56470,0,0,21497,0,0,,21497,21497
10,03-04-17,8,1:45,2:00,29.12,,0,29.12,29.12,1,-114903,65536,180439,-49367,0,0,6712,0,0,,6712,6712
10,03-04-17,9,2:00,2:15,129.12,,0,129.12,129.12,1,-142049,46914,188963,-95135,0,0,21312,0,0,,21312,21312
10,03-04-17,10,2:15,2:30,39.05,,0,39.05,39.05,1,-133221,66852,200073,-66369,0,0,13566,0,0,,13566,13566
10,03-04-17,11,2:30,2:45,34.8,,0,34.8,34.8,1,-124922,62626,187548,-62296,0,0,2170,0,0,,2170,2170
10,03-04-17,12,2:45,3:00,,,0,30.61,30.61,0,-127338,69124,196462,-58214,0,0,0,0,0,,0,0
10,03-04-17,13,3:00,3:15,45.42,,0,45.42,45.42,1,-139366,89419,228785,-49947,0,0,4068,0,0,,4068,4068
10,03-04-17,14,3:15,3:30,48.46,,0,48.46,48.46,1,-132153,69979,202132,-62174,0,0,20129,0,0,,20129,20129
10,03-04-17,15,3:30,3:45,41.74,,0,41.74,41.74,1,-128890,69657,198547,-59233,0,0,18076,0,0,,18076,18076
10,03-04-17,16,3:45,4:00,33.12,,0,33.12,33.12,1,-126927,77351,204278,-49576,0,0,11004,0,0,,11004,11004
10,03-04-17,17,4:00,4:15,95.89,,0,95.89,95.89,1,-126030,71789,197819,-54241,0,0,20527,0,0,,20527,20527
10,03-04-17,18,4:15,4:30,92.12,,0,92.12,92.12,1,-116920,82891,199811,-34029,0,0,37660,0,0,,37660,37660
10,03-04-17,19,4:30,4:45,33.12,,0,33.12,33.12,1,-111003,84997,196000,-26006,0,0,14479,0,0,,14479,14479
10,03-04-17,20,4:45,5:00,31.4,,0,31.4,31.4,1,-107442,83927,191369,-23515,0,0,3328,0,0,,3328,3328
10,03-04-17,21,5:00,5:15,31.4,,0,31.4,31.4,1,-108589,87459,196048,-21130,0,0,1328,0,0,,1328,1328
10,03-04-17,22,5:15,5:30,,,0,30.61,30.61,0,-115280,90931,206211,-24349,0,0,136,0,0,,136,136
10,03-04-17,23,5:30,5:45,,,0,30.61,30.61,0,-116524,100994,217518,-15530,0,0,0,0,0,,0,0
10,03-04-17,24,5:45,6:00,,,0,30.61,30.61,0,-100520,105383,205903,4863,0,0,0,0,0,,0,0
10,03-04-17,25,6:00,6:15,,26.74,0,26.74,26.74,-1,-92261,114771,207032,22510,0,-6093,0,0,0,,6093,-6093
10,03-04-17,26,6:15,6:30,,31.71,0,31.71,31.71,-1,-77975,115401,193376,37426,0,-2270,0,0,0,,2270,-2270
10,03-04-17,27,6:30,6:45,,32.1,0,32.1,32.1,-1,-85096,118492,203588,33396,0,-297,0,0,0,,297,-297
10,03-04-17,28,6:45,7:00,,,0,30.61,30.61,0,-86850,101830,188680,14980,0,0,0,0,0,,0,0
10,03-04-17,29,7:00,7:15,,,0,30.61,30.61,0,-89243,76775,166018,-12468,0,0,0,0,0,,0,0
10,03-04-17,30,7:15,7:30,,,0,30.61,30.61,0,-70922,74246,145168,3324,0,0,0,0,0,,0,0
10,03-04-17,31,7:30,7:45,,30.9,0,30.9,30.9,-1,-72390,72599,144989,209,0,-236,0,0,0,,236,-236
10,03-04-17,32,7:45,8:00,,28.15,0,28.15,28.15,-1,-93246,108741,201987,15495,0,-2026,0,0,0,,2026,-2026
10,03-04-17,33,8:00,8:15,,25.8,0,25.8,25.8,-1,-70680,67359,138039,-3321,0,-2297,0,0,0,,2297,-2297
10,03-04-17,34,8:15,8:30,32.93,25.78,0,32.93,25.78,2,-67249,65513,132762,-1736,0,-9001,174,0,0,,9175,-8827
10,03-04-17,35,8:30,8:45,132.12,25.78,0,132.12,132.12,1,-103444,31012,134456,-72432,0,-81,30742,0,0,,30823,30661
10,03-04-17,36,8:45,9:00,44.74,,0,44.74,44.74,1,-123826,49092,172918,-74734,0,0,45095,0,0,,45095,45095
10,03-04-17,37,9:00,9:15,39.66,,0,39.66,39.66,1,-77338,47161,124499,-30177,0,0,21599,0,0,,21599,21599
10,03-04-17,38,9:15,9:30,45.34,,0,45.34,45.34,1,-89496,32053,121549,-57443,0,0,3815,0,0,,3815,3815
10,03-04-17,39,9:30,9:45,57.12,,0,57.12,57.12,1,-123327,43241,166568,-80086,0,0,37234,0,0,,37234,37234
10,03-04-17,40,9:45,10:00,65.12,,0,65.12,65.12,1,-147728,48163,195891,-99565,0,0,49928,0,0,,49928,49928
10,03-04-17,41,10:00,10:15,46,,0,46,46,1,-95134,48480,143614,-46654,0,0,42326,0,0,,42326,42326
10,03-04-17,42,10:15,10:30,,,0,31.45,31.45,0,-91420,51099,142519,-40321,0,0,6091,0,0,,6091,6091
10,03-04-17,43,10:30,10:45,,,0,31.45,31.45,0,-106097,43001,149098,-63096,0,0,0,0,0,,0,0
10,03-04-17,44,10:45,11:00,,,0,31.45,31.45,0,-126610,42134,168744,-84476,0,0,0,0,0,,0,0
10,03-04-17,45,11:00,11:15,39.66,,0,39.66,39.66,1,-127695,46371,174066,-81324,0,0,4140,0,0,,4140,4140
10,03-04-17,46,11:15,11:30,30.8,,0,30.8,30.8,1,-107575,40387,147962,-67188,0,0,68,0,0,,68,68
10,03-04-17,47,11:30,11:45,30.8,,0,30.8,30.8,1,-96400,45093,141493,-51307,0,0,36,0,0,,36,36
10,03-04-17,48,11:45,12:00,30.8,,0,30.8,30.8,1,-88235,63584,151819,-24651,0,0,44,0,0,,44,44
10,03-04-17,49,12:00,12:15,44.86,,0,44.86,44.86,1,-103169,45962,149131,-57207,0,0,12586,0,0,,12586,12586
10,03-04-17,50,12:15,12:30,36.83,,0,36.83,36.83,1,-83146,39609,122755,-43537,0,0,14362,0,0,,14362,14362
10,03-04-17,51,12:30,12:45,30.8,,0,30.8,30.8,1,-75365,72472,147837,-2893,0,0,534,0,0,,534,534
10,03-04-17,52,12:45,13:00,30.8,26.22,0,31.45,26.22,2,-81001,99167,180168,18166,0,-2541,382,0,0,,2923,-2159
10,03-04-17,53,13:00,13:15,,21.8,0,21.8,21.8,-1,-78304,102127,180431,23823,0,-24146,0,0,0,,24146,-24146
10,03-04-17,54,13:15,13:30,32.93,21.8,0,32.93,32.93,1,-96816,38595,135411,-58221,0,-7042,784,0,0,,7826,-6258
10,03-04-17,55,13:30,13:45,,,0,31.45,31.45,0,-97347,26619,123966,-70728,0,0,0,0,0,,0,0
10,03-04-17,56,13:45,14:00,30.8,,0,30.8,30.8,1,-118060,24492,142552,-93568,0,0,441,0,0,,441,441
10,03-04-17,57,14:00,14:15,30.8,,0,30.8,30.8,1,-95795,54257,150052,-41538,0,0,145,0,0,,145,145
10,03-04-17,58,14:15,14:30,30.8,,0,30.8,30.8,1,-101793,33478,135271,-68315,0,0,101,0,0,,101,101
10,03-04-17,59,14:30,14:45,34.72,,0,34.72,34.72,1,-120087,25952,146039,-94135,0,0,1993,0,0,,1993,1993
10,03-04-17,60,14:45,15:00,31.86,,0,31.86,31.86,1,-117756,24093,141849,-93663,0,0,1373,0,0,,1373,1373
10,03-04-17,61,15:00,15:15,127.12,,0,127.12,127.12,1,-95063,19108,114171,-75955,0,0,33085,0,0,,33085,33085
10,03-04-17,62,15:15,15:30,50.74,,0,50.74,50.74,1,-91765,42489,134254,-49276,0,0,49848,0,0,,49848,49848
10,03-04-17,63,15:30,15:45,43.77,,0,43.77,43.77,1,-93536,38763,132299,-54773,0,0,36767,0,0,,36767,36767
10,03-04-17,64,15:45,16:00,47.74,,0,47.74,47.74,1,-115927,40053,155980,-75874,0,0,40653,0,0,,40653,40653
10,03-04-17,65,16:00,16:15,47.74,,0,47.74,47.74,1,-99257,48990,148247,-50267,0,0,31195,0,0,,31195,31195
10,03-04-17,66,16:15,16:30,,,0,31.45,31.45,0,-81563,55386,136949,-26177,0,0,3080,0,0,,3080,3080
10,03-04-17,67,16:30,16:45,,,0,31.45,31.45,0,-89136,53416,142552,-35720,0,0,0,0,0,,0,0
10,03-04-17,68,16:45,17:00,,,0,31.45,31.45,0,-96945,44156,141101,-52789,0,0,0,0,0,,0,0
10,03-04-17,69,17:00,17:15,,29.67,0,29.67,29.67,-1,-76525,48181,124706,-28344,0,-73,0,0,0,,73,-73
10,03-04-17,70,17:15,17:30,30.8,,0,30.8,30.8,1,-78107,23838,101945,-54269,0,0,38,0,0,,38,38
10,03-04-17,71,17:30,17:45,30.8,,0,30.8,30.8,1,-88500,50287,138787,-38213,0,0,131,0,0,,131,131
10,03-04-17,72,17:45,18:00,39.66,,0,39.66,39.66,1,-108458,75757,184215,-32701,0,0,1399,0,0,,1399,1399
10,03-04-17,73,18:00,18:15,50.69,9.04,0,50.69,9.04,2,-75637,121805,197442,46168,0,-11583,3686,0,0,,15269,-7897
10,03-04-17,74,18:15,18:30,,26.39,0,26.39,26.39,-1,-84896,93056,177952,8160,0,-8779,0,0,0,,8779,-8779
10,03-04-17,75,18:30,18:45,39.45,,0,39.45,39.45,1,-105865,86100,191965,-19765,0,0,2196,0,0,,2196,2196
10,03-04-17,76,18:45,19:00,47.74,,0,47.74,47.74,1,-120288,90672,210960,-29616,0,0,25706,0,0,,25706,25706
10,03-04-17,77,19:00,19:15,53.25,,0,53.25,53.25,1,-107612,74226,181838,-33386,0,0,20840,0,0,,20840,20840
10,03-04-17,78,19:15,19:30,53.25,,0,53.25,53.25,1,-101899,81781,183680,-20118,0,0,23259,0,0,,23259,23259
10,03-04-17,79,19:30,19:45,32.93,,0,32.93,32.93,1,-96304,91273,187577,-5031,0,0,8175,0,0,,8175,8175
10,03-04-17,80,19:45,20:00,36.83,,0,36.83,36.83,1,-100822,81312,182134,-19510,0,0,1140,0,0,,1140,1140
10,03-04-17,81,20:00,20:15,137.96,,0,137.96,137.96,1,-137775,77923,215698,-59852,0,0,35782,0,0,,35782,35782
10,03-04-17,82,20:15,20:30,41.14,,0,41.14,41.14,1,-109880,55753,165633,-54127,0,0,14522,0,0,,14522,14522
10,03-04-17,83,20:30,20:45,41.14,,0,41.14,41.14,1,-90052,70768,160820,-19284,0,0,4370,0,0,,4370,4370
10,03-04-17,84,20:45,21:00,31.47,28.98,0,31.47,28.98,2,-73219,80558,153777,7339,0,-56,3224,0,0,,3280,3168
10,03-04-17,85,21:00,21:15,34.8,28.74,0,34.8,28.74,2,-84757,59360,144117,-25397,0,-448,445,0,0,,893,-3
10,03-04-17,86,21:15,21:30,45,,0,45,45,1,-75623,51596,127219,-24027,0,0,13060,0,0,,13060,13060
10,03-04-17,87,21:30,21:45,,,0,31.45,31.45,0,-73861,63201,137062,-10660,0,0,1419,0,0,,1419,1419
10,03-04-17,88,21:45,22:00,,21.8,0,21.8,21.8,-1,-70405,90576,160981,20171,0,-3961,0,0,0,,3961,-3961
10,03-04-17,89,22:00,22:15,,21.8,0,21.8,21.8,-1,-149753,76096,225849,-73657,0,-4590,0,0,0,,4590,-4590
10,03-04-17,90,22:15,22:30,,,0,31.45,31.45,0,-134222,84593,218815,-49629,0,0,0,0,0,,0,0
10,03-04-17,91,22:30,22:45,30.8,,0,30.8,30.8,1,-111517,99497,211014,-12020,0,0,225,0,0,,225,225
10,03-04-17,92,22:45,23:00,,31.71,0,31.71,31.71,-1,-110935,146705,257640,35770,0,-26,0,0,0,,26,-26
10,03-04-17,93,23:00,23:15,138.37,31.71,0,138.37,138.37,1,-207521,76489,284010,-131032,0,-135,10689,0,0,,10824,10554
10,03-04-17,94,23:15,23:30,138.37,,0,138.37,138.37,1,-165796,99702,265498,-66094,0,0,14906,0,0,,14906,14906
10,03-04-17,95,23:30,23:45,30.8,,0,30.8,30.8,1,-136141,118822,254963,-17319,0,0,417,0,0,,417,417
10,03-04-17,96,23:45,0:00,,-3.2,0,-3.2,-3.2,-1,-130872,156932,287804,26060,0,-15238,0,0,0,,15238,-15238
10,03-05-17,1,0:00,0:15,70.02,-60.08,0,70.02,-60.08,2,-55016,42158,97174,-12858,0,-26733,2358,0,0,,29091,-24375
10,03-05-17,2,0:15,0:30,73.33,26.39,0,73.33,26.39,2,-27678,28093,55771,415,0,-3025,4433,0,0,,7458,1408
10,03-05-17,3,0:30,0:45,,21.6,0,21.6,21.6,-1,-40736,49029,89765,8293,0,-15178,0,0,0,,15178,-15178
10,03-05-17,4,0:45,1:00,,27.22,0,27.22,27.22,-1,-61202,69270,130472,8068,0,-11330,0,0,0,,11330,-11330
10,03-05-17,5,1:00,1:15,,28.98,0,28.98,28.98,-1,-46944,79920,126864,32976,0,-7589,0,0,0,,7589,-7589
10,03-05-17,6,1:15,1:30,35.81,28.98,0,35.81,35.81,1,-50422,9460,59882,-40962,0,-476,1366,0,0,,1842,890
10,03-05-17,7,1:30,1:45,44.22,,0,44.22,44.22,1,-66469,8393,74862,-58076,0,0,28463,0,0,,28463,28463
10,03-05-17,8,1:45,2:00,34.51,31.22,0,31.22,31.22,-1,-48123,22135,70258,-25988,0,-174,12699,0,0,,12873,12525
10,03-05-17,9,2:00,2:15,38.22,31.22,0,38.22,38.22,1,-82299,24638,106937,-57661,0,-65,5787,0,0,,5852,5722
10,03-05-17,10,2:15,2:30,38.22,,0,38.22,38.22,1,-64390,19349,83739,-45041,0,0,13060,0,0,,13060,13060
10,03-05-17,11,2:30,2:45,,,0,29.62,29.62,0,-58407,16364,74771,-42043,0,0,270,0,0,,270,270
10,03-05-17,12,2:45,3:00,,,0,29.62,29.62,0,-48354,27909,76263,-20445,0,0,0,0,0,,0,0
10,03-05-17,13,3:00,3:15,127.02,,0,127.02,127.02,1,-96804,22924,119728,-73880,0,0,23408,0,0,,23408,23408
10,03-05-17,14,3:15,3:30,36.02,,0,36.02,36.02,1,-91477,54174,145651,-37303,0,0,23919,0,0,,23919,23919
10,03-05-17,15,3:30,3:45,35.8,,0,35.8,35.8,1,-91442,33807,125249,-57635,0,0,19486,0,0,,19486,19486
10,03-05-17,16,3:45,4:00,40.45,,0,40.45,40.45,1,-93683,29568,123251,-64115,0,0,21289,0,0,,21289,21289
10,03-05-17,17,4:00,4:15,90.02,,0,90.02,90.02,1,-105654,32868,138522,-72786,0,0,52078,0,0,,52078,52078
10,03-05-17,18,4:15,4:30,44.22,,0,44.22,44.22,1,-105375,48142,153517,-57233,0,0,36129,0,0,,36129,36129
10,03-05-17,19,4:30,4:45,42.66,,0,42.66,42.66,1,-115866,38058,153924,-77808,0,0,19854,0,0,,19854,19854
10,03-05-17,20,4:45,5:00,44.22,,0,44.22,44.22,1,-126028,39880,165908,-86148,0,0,36900,0,0,,36900,36900
10,03-05-17,21,5:00,5:15,34.22,,0,34.22,34.22,1,-96221,68378,164599,-27843,0,0,26102,0,0,,26102,26102
10,03-05-17,22,5:15,5:30,36.02,,0,36.02,36.02,1,-82571,44714,127285,-37857,0,0,11576,0,0,,11576,11576
10,03-05-17,23,5:30,5:45,38.22,,0,38.22,38.22,1,-90387,39299,129686,-51088,0,0,26276,0,0,,26276,26276
10,03-05-17,24,5:45,6:00,40.45,,0,40.45,40.45,1,-93010,53639,146649,-39371,0,0,27890,0,0,,27890,27890
10,03-05-17,25,6:00,6:15,44.22,,0,44.22,44.22,1,-87034,50642,137676,-36392,0,0,18891,0,0,,18891,18891
10,03-05-17,26,6:15,6:30,34.4,,0,34.4,34.4,1,-66194,58787,124981,-7407,0,0,17177,0,0,,17177,17177
10,03-05-17,27,6:30,6:45,31.02,,0,31.02,31.02,1,-53194,57805,110999,4611,0,0,3595,0,0,,3595,3595
10,03-05-17,28,6:45,7:00,,,0,29.62,29.62,0,-47098,59880,106978,12782,0,0,0,0,0,,0,0
10,03-05-17,29,7:00,7:15,,31.22,0,31.22,31.22,-1,-40552,81823,122375,41271,0,-129,0,0,0,,129,-129
10,03-05-17,30,7:15,7:30,,30.54,0,30.54,30.54,-1,-26570,84824,111394,58254,0,-2519,0,0,0,,2519,-2519
10,03-05-17,31,7:30,7:45,,30.54,0,30.54,30.54,-1,-29110,73971,103081,44861,0,-5834,0,0,0,,5834,-5834
10,03-05-17,32,7:45,8:00,,31.61,0,31.61,31.61,-1,-46220,74097,120317,27877,0,-2722,0,0,0,,2722,-2722
10,03-05-17,33,8:00,8:15,,,0,31.12,31.12,0,-16835,85075,101910,68240,0,0,0,0,0,,0,0
10,03-05-17,34,8:15,8:30,,,0,31.12,31.12,0,-36658,53702,90360,17044,0,0,0,0,0,,0,0
10,03-05-17,35,8:30,8:45,,,0,31.12,31.12,0,-46563,60498,107061,13935,0,0,0,0,0,,0,0
10,03-05-17,36,8:45,9:00,,,0,31.12,31.12,0,-41735,68079,109814,26344,0,0,0,0,0,,0,0
10,03-05-17,37,9:00,9:15,,-50.24,0,-50.24,-50.24,-1,-48511,113972,162483,65461,0,-13870,0,0,0,,13870,-13870
10,03-05-17,38,9:15,9:30,,-50.24,0,-50.24,-50.24,-1,-77128,96710,173838,19582,0,-22296,0,0,0,,22296,-22296
10,03-05-17,39,9:30,9:45,,29.71,0,29.71,29.71,-1,-46176,102883,149059,56707,0,-8329,0,0,0,,8329,-8329
10,03-05-17,40,9:45,10:00,,27.22,0,27.22,27.22,-1,-47557,122218,169775,74661,0,-20758,0,0,0,,20758,-20758
10,03-05-17,41,10:00,10:15,,-67.44,0,-67.44,-67.44,-1,-79543,141433,220976,61890,0,-42810,0,0,0,,42810,-42810
10,03-05-17,42,10:15,10:30,,28.01,0,28.01,28.01,-1,-77377,142312,219689,64935,0,-17794,0,0,0,,17794,-17794
10,03-05-17,43,10:30,10:45,,27.22,0,27.22,27.22,-1,-63926,154006,217932,90080,0,-29988,0,0,0,,29988,-29988
10,03-05-17,44,10:45,11:00,,26.04,0,26.04,26.04,-1,-56464,139468,195932,83004,0,-37177,0,0,0,,37177,-37177
10,03-05-17,45,11:00,11:15,,28.01,0,28.01,28.01,-1,-61349,142606,203955,81257,0,-19759,0,0,0,,19759,-19759
10,03-05-17,46,11:15,11:30,,31.22,0,31.22,31.22,-1,-60872,155479,216351,94607,0,-493,0,0,0,,493,-493
10,03-05-17,47,11:30,11:45,,26.56,0,26.56,26.56,-1,-65599,187476,253075,121877,0,-6124,0,0,0,,6124,-6124
10,03-05-17,48,11:45,12:00,,-65.64,0,-65.64,-65.64,-1,-44031,195642,239673,151611,0,-48920,0,0,0,,48920,-48920
10,03-05-17,49,12:00,12:15,,-63.24,0,-63.24,-63.24,-1,-76363,153669,230032,77306,0,-61262,0,0,0,,61262,-61262
10,03-05-17,50,12:15,12:30,,-63.24,0,-63.24,-63.24,-1,-56589,159840,216429,103251,0,-63224,0,0,0,,63224,-63224
10,03-05-17,51,12:30,12:45,,28.15,0,28.15,28.15,-1,-44981,164297,209278,119316,0,-11499,0,0,0,,11499,-11499
10,03-05-17,52,12:45,13:00,,27.22,0,27.22,27.22,-1,-54758,152945,207703,98187,0,-7923,0,0,0,,7923,-7923
10,03-05-17,53,13:00,13:15,,,0,31.62,31.62,0,-81605,161349,242954,79744,0,0,0,0,0,,0,0
10,03-05-17,54,13:15,13:30,,,0,31.62,31.62,0,-91209,116962,208171,25753,0,0,0,0,0,,0,0
10,03-05-17,55,13:30,13:45,122.32,,0,122.32,122.32,1,-127974,85433,213407,-42541,0,0,16070,0,0,,16070,16070
10,03-05-17,56,13:45,14:00,131.02,,0,131.02,131.02,1,-128673,71675,200348,-56998,0,0,65162,0,0,,65162,65162
10,03-05-17,57,14:00,14:15,131.02,15.03,0,15.03,15.03,-1,-48892,155032,203924,106140,0,-2096,14035,0,0,,16131,11939
10,03-05-17,58,14:15,14:30,,,0,30.12,30.12,0,-63058,103501,166559,40443,0,0,0,0,0,,0,0
10,03-05-17,59,14:30,14:45,,32.22,0,32.22,32.22,-1,-65798,82514,148312,16716,0,-34,0,0,0,,34,-34
10,03-05-17,60,14:45,15:00,,31.22,0,31.22,31.22,-1,-73890,59781,133671,-14109,0,-969,0,0,0,,969,-969
10,03-05-17,61,15:00,15:15,,32.22,0,32.22,32.22,-1,-60449,110113,170562,49664,0,-1071,0,0,0,,1071,-1071
10,03-05-17,62,15:15,15:30,,29.71,0,29.71,29.71,-1,-57597,95509,153106,37912,0,-527,0,0,0,,527,-527
10,03-05-17,63,15:30,15:45,,29.71,0,29.71,29.71,-1,-50257,89470,139727,39213,0,-1422,0,0,0,,1422,-1422
10,03-05-17,64,15:45,16:00,,31.71,0,31.71,31.71,-1,-63636,81836,145472,18200,0,-1786,0,0,0,,1786,-1786
10,03-05-17,65,16:00,16:15,,32.1,0,32.1,32.1,-1,-83621,98446,182067,14825,0,-2218,0,0,0,,2218,-2218
10,03-05-17,66,16:15,16:30,39.87,,0,39.87,39.87,1,-101109,58250,159359,-42859,0,0,3526,0,0,,3526,3526
10,03-05-17,67,16:30,16:45,44.22,,0,44.22,44.22,1,-108037,56054,164091,-51983,0,0,23458,0,0,,23458,23458
10,03-05-17,68,16:45,17:00,35.98,,0,35.98,35.98,1,-107037,69135,176172,-37902,0,0,20490,0,0,,20490,20490
10,03-05-17,69,17:00,17:15,34.22,,0,34.22,34.22,1,-165993,94108,260101,-71885,0,0,2646,0,0,,2646,2646
10,03-05-17,70,17:15,17:30,38.22,,0,38.22,38.22,1,-139340,63135,202475,-76205,0,0,5037,0,0,,5037,5037
10,03-05-17,71,17:30,17:45,74.52,,0,74.52,74.52,1,-138947,48187,187134,-90760,0,0,39525,0,0,,39525,39525
10,03-05-17,72,17:45,18:00,107.47,,0,107.47,107.47,1,-166118,99517,265635,-66601,0,0,75100,0,0,,75100,75100
10,03-05-17,73,18:00,18:15,107.47,31.22,0,31.22,31.22,-1,-65113,63085,128198,-2028,0,-942,12982,0,0,,13924,12040
10,03-05-17,74,18:15,18:30,,,0,32.15,32.15,0,-75989,38087,114076,-37902,0,-189,0,0,0,,189,-189
10,03-05-17,75,18:30,18:45,122.79,,0,122.79,122.79,1,-134461,32591,167052,-101870,0,0,16114,0,0,,16114,16114
10,03-05-17,76,18:45,19:00,122.79,,0,122.79,122.79,1,-174576,54111,228687,-120465,0,0,77183,0,0,,77183,77183
10,03-05-17,77,19:00,19:15,118.69,,0,118.69,118.69,1,-146009,31371,177380,-114638,0,0,81215,0,0,,81215,81215
10,03-05-17,78,19:15,19:30,134.12,,0,134.12,134.12,1,-151092,43570,194662,-107522,0,0,70893,0,0,,70893,70893
10,03-05-17,79,19:30,19:45,39.53,,0,39.53,39.53,1,-145180,51144,196324,-94036,0,0,40917,0,0,,40917,40917
10,03-05-17,80,19:45,20:00,52.77,,0,52.77,52.77,1,-151488,33204,184692,-118284,0,0,26337,0,0,,26337,26337
10,03-05-17,81,20:00,20:15,131.02,,0,131.02,131.02,1,-137634,46750,184384,-90884,0,0,57830,0,0,,57830,57830
10,03-05-17,82,20:15,20:30,49.02,,0,49.02,49.02,1,-130028,60339,190367,-69689,0,0,52302,0,0,,52302,52302
10,03-05-17,83,20:30,20:45,38.43,,0,38.43,38.43,1,-116826,80117,196943,-36709,0,0,16648,0,0,,16648,16648
10,03-05-17,84,20:45,21:00,38.22,,0,38.22,38.22,1,-110370,97287,207657,-13083,0,0,21007,0,0,,21007,21007
10,03-05-17,85,21:00,21:15,38.22,31.22,0,31.22,31.22,-1,-107320,127132,234452,19812,0,-789,2425,0,0,,3214,1636
10,03-05-17,86,21:15,21:30,37.1,,0,37.1,37.1,1,-98044,71841,169885,-26203,0,0,3546,0,0,,3546,3546
10,03-05-17,87,21:30,21:45,36.8,,0,36.8,36.8,1,-98811,71400,170211,-27411,0,0,13240,0,0,,13240,13240
10,03-05-17,88,21:45,22:00,31.03,32.22,0,32.22,32.22,-1,-93807,92587,186394,-1220,0,-11,4506,0,0,,4517,4495
10,03-05-17,89,22:00,22:15,,32.22,0,32.22,32.22,-1,-101576,44362,145938,-57214,0,-55,0,0,0,,55,-55
10,03-05-17,90,22:15,22:30,,,0,31.85,31.85,0,-101387,21822,123209,-79565,0,0,0,0,0,,0,0
10,03-05-17,91,22:30,22:45,36.66,,0,36.66,36.66,1,-94655,40209,134864,-54446,0,0,1423,0,0,,1423,1423
10,03-05-17,92,22:45,23:00,37.44,,0,37.44,37.44,1,-89880,63273,153153,-26607,0,0,5809,0,0,,5809,5809
10,03-05-17,93,23:00,23:15,33.03,,0,33.03,33.03,1,-99898,67614,167512,-32284,0,0,498,0,0,,498,498
10,03-05-17,94,23:15,23:30,33.03,,0,33.03,33.03,1,-90659,53301,143960,-37358,0,0,469,0,0,,469,469
10,03-05-17,95,23:30,23:45,,,0,31.43,31.43,0,-72145,76061,148206,3916,0,0,0,0,0,,0,0
10,03-05-17,96,23:45,0:00,,31.22,0,31.22,31.22,-1,-69398,112806,182204,43408,0,-547,0,0,0,,547,-547
10,03-06-17,1,0:00,0:15,,30.24,0,30.24,30.24,-1,-50064,57147,107211,7083,0,-1620,0,0,0,,1620,-1620
10,03-06-17,2,0:15,0:30,,,0,31.06,31.06,0,-30048,37657,67705,7609,0,0,0,0,0,,0,0
10,03-06-17,3,0:30,0:45,34.21,,0,34.21,34.21,1,-49108,28828,77936,-20280,0,0,2265,0,0,,2265,2265
10,03-06-17,4,0:45,1:00,30.64,30.34,0,31.06,30.34,2,-58348,38206,96554,-20142,0,-24,613,0,0,,637,589
10,03-06-17,5,1:00,1:15,,30,0,30,30,-1,-34762,87970,122732,53208,0,-1112,0,0,0,,1112,-1112
10,03-06-17,6,1:15,1:30,,31.6,0,31.6,31.6,-1,-51187,33756,84943,-17431,0,-580,0,0,0,,580,-580
10,03-06-17,7,1:30,1:45,30.64,,0,30.64,30.64,1,-49326,25537,74863,-23789,0,0,43,0,0,,43,43
10,03-06-17,8,1:45,2:00,31.03,,0,31.03,31.03,1,-52591,19439,72030,-33152,0,0,1253,0,0,,1253,1253
10,03-06-17,9,2:00,2:15,,,0,31.06,31.06,0,-55795,79397,135192,23602,0,0,106,0,0,,106,106
10,03-06-17,10,2:15,2:30,,,0,31.06,31.06,0,-61367,60909,122276,-458,0,0,0,0,0,,0,0
10,03-06-17,11,2:30,2:45,31.03,,0,31.03,31.03,1,-61007,53205,114212,-7802,0,0,520,0,0,,520,520
10,03-06-17,12,2:45,3:00,30.64,26.24,0,26.24,26.24,-1,-58059,58424,116483,365,0,-547,253,0,0,,800,-294
10,03-06-17,13,3:00,3:15,,25.18,0,25.18,25.18,-1,-43927,76418,120345,32491,0,-3841,0,0,0,,3841,-3841
10,03-06-17,14,3:15,3:30,,,0,31.06,31.06,0,-44835,73383,118218,28548,0,0,0,0,0,,0,0
10,03-06-17,15,3:30,3:45,,31.24,0,31.24,31.24,-1,-37252,70497,107749,33245,0,-940,0,0,0,,940,-940
10,03-06-17,16,3:45,4:00,,31.99,0,31.99,31.99,-1,-44176,60573,104749,16397,0,-596,0,0,0,,596,-596
10,03-06-17,17,4:00,4:15,,,0,31.05,31.05,0,-47268,22448,69716,-24820,0,0,0,0,0,,0,0
10,03-06-17,18,4:15,4:30,,,0,31.05,31.05,0,-52118,36979,89097,-15139,0,0,0,0,0,,0,0
10,03-06-17,19,4:30,4:45,,,0,30.55,30.55,0,-44558,54919,99477,10361,0,0,0,0,0,,0,0
10,03-06-17,20,4:45,5:00,,26.24,0,26.24,26.24,-1,-43300,116398,159698,73098,0,-1794,0,0,0,,1794,-1794
10,03-06-17,21,5:00,5:15,,31.59,0,31.59,31.59,-1,-72249,23206,95455,-49043,0,-537,0,0,0,,537,-537
10,03-06-17,22,5:15,5:30,33.24,,0,33.24,33.24,1,-43046,15069,58115,-27977,0,0,394,0,0,,394,394
10,03-06-17,23,5:30,5:45,34.88,,0,34.88,34.88,1,-57182,39902,97084,-17280,0,0,760,0,0,,760,760
10,03-06-17,24,5:45,6:00,35.1,,0,35.1,35.1,1,-62882,86812,149694,23930,0,0,2503,0,0,,2503,2503
10,03-06-17,25,6:00,6:15,40.73,,0,40.73,40.73,1,-105461,34399,139860,-71062,0,0,7333,0,0,,7333,7333
10,03-06-17,26,6:15,6:30,53.2,,0,53.2,53.2,1,-69971,19480,89451,-50491,0,0,6556,0,0,,6556,6556
10,03-06-17,27,6:30,6:45,182.13,,0,182.13,182.13,1,-70203,28582,98785,-41621,0,0,46401,0,0,,46401,46401
10,03-06-17,28,6:45,7:00,40.69,,0,40.69,40.69,1,-108268,117363,225631,9095,0,0,5067,0,0,,5067,5067
10,03-06-17,29,7:00,7:15,40.95,,0,40.95,40.95,1,-85855,51764,137619,-34091,0,0,5309,0,0,,5309,5309
10,03-06-17,30,7:15,7:30,40.7,,0,40.7,40.7,1,-96130,34613,130743,-61517,0,0,11472,0,0,,11472,11472
10,03-06-17,31,7:30,7:45,30.02,,0,30.02,30.02,1,-100911,55075,155986,-45836,0,0,1274,0,0,,1274,1274
10,03-06-17,32,7:45,8:00,48.4,,0,48.4,48.4,1,-132543,60970,193513,-71573,0,0,11564,0,0,,11564,11564
10,03-06-17,33,8:00,8:15,39.28,,0,39.28,39.28,1,-38306,49687,87993,11381,0,0,12022,0,0,,12022,12022
10,03-06-17,34,8:15,8:30,38.59,32.12,0,38.59,32.12,2,-66114,31210,97324,-34904,0,-176,3484,0,0,,3660,3308
10,03-06-17,35,8:30,8:45,62.12,,0,62.12,62.12,1,-81158,19129,100287,-62029,0,0,19951,0,0,,19951,19951
10,03-06-17,36,8:45,9:00,250,,0,250,250,1,-97472,30202,127674,-67270,0,0,51505,0,0,,51505,51505
10,03-06-17,37,9:00,9:15,41.52,,0,41.52,41.52,1,-45938,35825,81763,-10113,0,0,18815,0,0,,18815,18815
10,03-06-17,38,9:15,9:30,41.06,,0,41.06,41.06,1,-54112,32503,86615,-21609,0,0,11225,0,0,,11225,11225
10,03-06-17,39,9:30,9:45,35.71,,0,35.71,35.71,1,-50455,52759,103214,2304,0,0,9286,0,0,,9286,9286
10,03-06-17,40,9:45,10:00,,,0,33.77,33.77,0,-54548,56827,111375,2279,0,0,156,0,0,,156,156
10,03-06-17,41,10:00,10:15,39.05,,0,39.05,39.05,1,-63957,39346,103303,-24611,0,0,6119,0,0,,6119,6119
10,03-06-17,42,10:15,10:30,30.02,,0,30.02,30.02,1,-42574,46914,89488,4340,0,0,1264,0,0,,1264,1264
10,03-06-17,43,10:30,10:45,,36.52,0,36.52,36.52,-1,-47550,56999,104549,9449,0,-366,0,0,0,,366,-366
10,03-06-17,44,10:45,11:00,,36.52,0,36.52,36.52,-1,-48493,51876,100369,3383,0,-128,0,0,0,,128,-128
10,03-06-17,45,11:00,11:15,30.02,,0,30.02,30.02,1,-45351,48996,94347,3645,0,0,307,0,0,,307,307
10,03-06-17,46,11:15,11:30,30.02,,0,30.02,30.02,1,-44750,90241,134991,45491,0,0,119,0,0,,119,119
10,03-06-17,47,11:30,11:45,,,0,33.77,33.77,0,-42699,115242,157941,72543,0,0,0,0,0,,0,0
10,03-06-17,48,11:45,12:00,,,0,33.78,33.78,0,-39577,132316,171893,92739,0,0,0,0,0,,0,0
10,03-06-17,49,12:00,12:15,,31.24,0,31.24,31.24,-1,-52120,118431,170551,66311,0,-191,0,0,0,,191,-191
10,03-06-17,50,12:15,12:30,,10.25,0,10.25,10.25,-1,-43159,136822,179981,93663,0,-15185,0,0,0,,15185,-15185
10,03-06-17,51,12:30,12:45,,10.25,0,10.25,10.25,-1,-42319,111056,153375,68737,0,-42600,0,0,0,,42600,-42600
10,03-06-17,52,12:45,13:00,,26.24,0,26.24,26.24,-1,-45022,96501,141523,51479,0,-22645,0,0,0,,22645,-22645
10,03-06-17,53,13:00,13:15,30.02,26.22,0,33.77,26.22,2,-48320,62821,111141,14501,0,-15767,7,0,0,,15774,-15760
10,03-06-17,54,13:15,13:30,30.67,26.22,0,30.67,30.67,1,-57865,50966,108831,-6899,0,-562,1267,0,0,,1829,705
10,03-06-17,55,13:30,13:45,,,0,33.77,33.77,0,-53907,54243,108150,336,0,0,36,0,0,,36,36
10,03-06-17,56,13:45,14:00,,31.24,0,31.24,31.24,-1,-46331,55802,102133,9471,0,-2754,0,0,0,,2754,-2754
10,03-06-17,57,14:00,14:15,,31.24,0,31.24,31.24,-1,-60841,51701,112542,-9140,0,-3391,0,0,0,,3391,-3391
10,03-06-17,58,14:15,14:30,,,0,33.77,33.77,0,-53408,50916,104324,-2492,0,0,0,0,0,,0,0
10,03-06-17,59,14:30,14:45,,,0,33.71,33.71,0,-57450,46100,103550,-11350,0,0,0,0,0,,0,0
10,03-06-17,60,14:45,15:00,,,0,33.48,33.48,0,-53355,54712,108067,1357,0,0,0,0,0,,0,0
10,03-06-17,61,15:00,15:15,39.05,,0,39.05,39.05,1,-67871,29245,97116,-38626,0,0,3183,0,0,,3183,3183
10,03-06-17,62,15:15,15:30,,,0,33.77,33.77,0,-66750,51452,118202,-15298,0,0,21,0,0,,21,21
10,03-06-17,63,15:30,15:45,,,0,33.78,33.78,0,-64143,43508,107651,-20635,0,0,0,0,0,,0,0
10,03-06-17,64,15:45,16:00,30.64,,0,30.64,30.64,1,-61930,29051,90981,-32879,0,0,293,0,0,,293,293
10,03-06-17,65,16:00,16:15,33.32,,0,33.32,33.32,1,-84914,32617,117531,-52297,0,0,2360,0,0,,2360,2360
10,03-06-17,66,16:15,16:30,30.02,,0,30.02,30.02,1,-78476,35897,114373,-42579,0,0,1303,0,0,,1303,1303
10,03-06-17,67,16:30,16:45,35.71,,0,35.71,35.71,1,-70043,27853,97896,-42190,0,0,3730,0,0,,3730,3730
10,03-06-17,68,16:45,17:00,,,0,33.77,33.77,0,-85445,31590,117035,-53855,0,0,576,0,0,,576,576
10,03-06-17,69,17:00,17:15,39.05,,0,39.05,39.05,1,-130737,30589,161326,-100148,0,0,2336,0,0,,2336,2336
10,03-06-17,70,17:15,17:30,43.52,,0,43.52,43.52,1,-131991,31536,163527,-100455,0,0,9152,0,0,,9152,9152
10,03-06-17,71,17:30,17:45,43.53,,0,43.53,43.53,1,-121024,32628,153652,-88396,0,0,10623,0,0,,10623,10623
10,03-06-17,72,17:45,18:00,35.71,,0,35.71,35.71,1,-114437,32765,147202,-81672,0,0,5859,0,0,,5859,5859
10,03-06-17,73,18:00,18:15,30.02,,0,30.02,30.02,1,-123214,36587,159801,-86627,0,0,1367,0,0,,1367,1367
10,03-06-17,74,18:15,18:30,30.02,,0,30.02,30.02,1,-106778,30673,137451,-76105,0,0,147,0,0,,147,147
10,03-06-17,75,18:30,18:45,43.52,,0,43.52,43.52,1,-121762,27026,148788,-94736,0,0,3583,0,0,,3583,3583
10,03-06-17,76,18:45,19:00,238.17,,0,238.17,238.17,1,-154722,26598,181320,-128124,0,0,48512,0,0,,48512,48512
10,03-06-17,77,19:00,19:15,208.97,,0,208.97,208.97,1,-107596,45898,153494,-61698,0,0,63172,0,0,,63172,63172
10,03-06-17,78,19:15,19:30,,,0,33.78,33.78,0,-90062,48276,138338,-41786,0,0,6614,0,0,,6614,6614
10,03-06-17,79,19:30,19:45,,,0,32.45,32.45,0,-97924,25073,122997,-72851,0,0,0,0,0,,0,0
10,03-06-17,80,19:45,20:00,,,0,32.48,32.48,0,-91615,32540,124155,-59075,0,0,0,0,0,,0,0
10,03-06-17,81,20:00,20:15,186.24,,0,186.24,186.24,1,-114286,29121,143407,-85165,0,0,17861,0,0,,17861,17861
10,03-06-17,82,20:15,20:30,33.32,,0,33.32,33.32,1,-84288,43983,128271,-40305,0,0,4324,0,0,,4324,4324
10,03-06-17,83,20:30,20:45,,,0,32.34,32.34,0,-70827,37964,108791,-32863,0,0,0,0,0,,0,0
10,03-06-17,84,20:45,21:00,,26.24,0,26.24,26.24,-1,-62943,60977,123920,-1966,0,-1838,0,0,0,,1838,-1838
10,03-06-17,85,21:00,21:15,244.41,12.78,0,244.41,12.78,2,-95492,34890,130382,-60602,0,-7780,6545,0,0,,14325,-1235
10,03-06-17,86,21:15,21:30,244.41,,0,244.41,244.41,1,-97008,51749,148757,-45259,0,0,11474,0,0,,11474,11474
10,03-06-17,87,21:30,21:45,,,0,32.5,32.5,0,-66410,40334,106744,-26076,0,0,0,0,0,,0,0
10,03-06-17,88,21:45,22:00,37.12,26.24,0,37.12,26.24,2,-72741,46958,119699,-25783,0,-469,3130,0,0,,3599,2661
10,03-06-17,89,22:00,22:15,35.71,-43.13,0,35.71,-43.13,2,-64987,98886,163873,33899,0,-22242,42,0,0,,22284,-22200
10,03-06-17,90,22:15,22:30,68.54,-43.13,0,68.54,68.54,1,-88508,29166,117674,-59342,0,-68,11858,0,0,,11926,11790
10,03-06-17,91,22:30,22:45,232.66,,0,232.66,232.66,1,-92010,25623,117633,-66387,0,0,25281,0,0,,25281,25281
10,03-06-17,92,22:45,23:00,232.66,,0,232.66,232.66,1,-109400,64104,173504,-45296,0,0,49618,0,0,,49618,49618
10,03-06-17,93,23:00,23:15,50.84,30.81,0,50.84,30.81,2,-55888,42316,98204,-13572,0,-631,7460,0,0,,8091,6829
10,03-06-17,94,23:15,23:30,132.12,29.83,0,132.12,29.83,2,-56745,50482,107227,-6263,0,-392,22733,0,0,,23125,22341
10,03-06-17,95,23:30,23:45,132.12,23.17,0,23.17,23.17,-1,-57233,65164,122397,7931,0,-12701,69,0,0,,12770,-12632
10,03-06-17,96,23:45,0:00,,30.92,0,30.92,30.92,-1,-73167,84268,157435,11101,0,-5316,0,0,0,,5316,-5316
10,03-07-17,1,0:00,0:15,32.2,29.64,0,32.2,32.2,1,-71975,79048,151023,7073,0,-2655,346,0,0,,3001,-2309
10,03-07-17,2,0:15,0:30,43.35,,0,43.35,43.35,1,-72923,40554,113477,-32369,0,0,9775,0,0,,9775,9775
10,03-07-17,3,0:30,0:45,34.59,,0,34.59,34.59,1,-69425,37403,106828,-32022,0,0,11009,0,0,,11009,11009
10,03-07-17,4,0:45,1:00,,,0,31.19,31.19,0,-65077,55025,120102,-10052,0,0,152,0,0,,152,152
10,03-07-17,5,1:00,1:15,37.93,,0,37.93,37.93,1,-64238,26473,90711,-37765,0,0,4282,0,0,,4282,4282
10,03-07-17,6,1:15,1:30,,,0,31.19,31.19,0,-56331,28450,84781,-27881,0,0,19,0,0,,19,19
10,03-07-17,7,1:30,1:45,30.35,,0,30.35,30.35,1,-51176,31562,82738,-19614,0,0,6,0,0,,6,6
10,03-07-17,8,1:45,2:00,,32.03,0,32.03,32.03,-1,-51234,42494,93728,-8740,0,-6,0,0,0,,6,-6
10,03-07-17,9,2:00,2:15,34.59,31.35,0,34.59,31.19,2,-44092,34017,78109,-10075,0,-414,1415,0,0,,1829,1001
10,03-07-17,10,2:15,2:30,31.35,,0,31.35,31.35,1,-45454,33603,79057,-11851,0,0,2216,0,0,,2216,2216
10,03-07-17,11,2:30,2:45,,,0,31.19,31.19,0,-38066,39203,77269,1137,0,0,88,0,0,,88,88
10,03-07-17,12,2:45,3:00,,32.03,0,32.03,32.03,-1,-39697,42751,82448,3054,0,-143,0,0,0,,143,-143
10,03-07-17,13,3:00,3:15,,32.03,0,32.03,32.03,-1,-23724,41765,65489,18041,0,-423,0,0,0,,423,-423
10,03-07-17,14,3:15,3:30,,30.35,0,30.35,30.35,-1,-18644,39045,57689,20401,0,-172,0,0,0,,172,-172
10,03-07-17,15,3:30,3:45,,30.35,0,30.35,30.35,-1,-17492,40473,57965,22981,0,-543,0,0,0,,543,-543
10,03-07-17,16,3:45,4:00,,,0,31.19,31.19,0,-19547,43389,62936,23842,0,0,0,0,0,,0,0
10,03-07-17,17,4:00,4:15,,29.97,0,29.97,29.97,-1,-28559,56662,85221,28103,0,-1340,0,0,0,,1340,-1340
10,03-07-17,18,4:15,4:30,,31.35,0,31.35,31.35,-1,-31137,39148,70285,8011,0,-827,0,0,0,,827,-827
10,03-07-17,19,4:30,4:45,,32.03,0,32.03,32.03,-1,-26095,40352,66447,14257,0,-218,0,0,0,,218,-218
10,03-07-17,20,4:45,5:00,,31.35,0,31.35,31.35,-1,-31289,54453,85742,23164,0,-2500,0,0,0,,2500,-2500
10,03-07-17,21,5:00,5:15,,,0,31.19,31.19,0,-93972,44084,138056,-49888,0,-218,0,0,0,,218,-218
10,03-07-17,22,5:15,5:30,,30.35,0,30.35,30.35,-1,-26369,33226,59595,6857,0,-848,0,0,0,,848,-848
10,03-07-17,23,5:30,5:45,,28.32,0,28.32,28.32,-1,-46118,46646,92764,528,0,-1915,0,0,0,,1915,-1915
10,03-07-17,24,5:45,6:00,40.32,28.32,0,40.32,40.32,1,-74999,56226,131225,-18773,0,-105,6799,0,0,,6904,6694
10,03-07-17,25,6:00,6:15,32.2,,0,32.2,32.2,1,-95696,79799,175495,-15897,0,0,1944,0,0,,1944,1944
10,03-07-17,26,6:15,6:30,32.2,27.93,0,27.93,27.93,-1,-33697,89806,123503,56109,0,-719,123,0,0,,842,-596
10,03-07-17,27,6:30,6:45,42,,0,42,42,1,-58662,58486,117148,-176,0,0,505,0,0,,505,505
10,03-07-17,28,6:45,7:00,268.44,,0,268.44,268.44,1,-111065,90424,201489,-20641,0,0,28347,0,0,,28347,28347
10,03-07-17,29,7:00,7:15,30.19,-21.78,0,31.16,-21.78,2,-26726,84477,111203,57751,0,-13295,1606,0,0,,14901,-11689
10,03-07-17,30,7:15,7:30,,27.88,0,27.88,27.88,-1,-33069,52276,85345,19207,0,-6358,0,0,0,,6358,-6358
10,03-07-17,31,7:30,7:45,56.19,30.91,0,56.19,56.19,1,-61692,35888,97580,-25804,0,-3062,1771,0,0,,4833,-1291
10,03-07-17,32,7:45,8:00,56.19,30.91,0,56.19,56.19,1,-120658,48980,169638,-71678,0,-29,4391,0,0,,4420,4362
10,03-07-17,33,8:00,8:15,56.19,21.28,0,21.28,21.28,-1,-12791,82810,95601,70019,0,-5974,38,0,0,,6012,-5936
10,03-07-17,34,8:15,8:30,,,0,31.23,31.23,0,-29854,38068,67922,8214,0,-210,0,0,0,,210,-210
10,03-07-17,35,8:30,8:45,,,0,31.23,31.23,0,-34771,25100,59871,-9671,0,0,0,0,0,,0,0
10,03-07-17,36,8:45,9:00,,,0,31.23,31.23,0,-54978,28297,83275,-26681,0,0,0,0,0,,0,0
10,03-07-17,37,9:00,9:15,38.46,,0,38.46,38.46,1,-31638,22097,53735,-9541,0,0,1595,0,0,,1595,1595
10,03-07-17,38,9:15,9:30,35.43,,0,35.43,35.43,1,-35082,18287,53369,-16795,0,0,3495,0,0,,3495,3495
10,03-07-17,39,9:30,9:45,30.74,,0,30.74,30.74,1,-40476,24153,64629,-16323,0,0,338,0,0,,338,338
10,03-07-17,40,9:45,10:00,34.54,,0,34.54,34.54,1,-48962,19435,68397,-29527,0,0,2133,0,0,,2133,2133
10,03-07-17,41,10:00,10:15,42.49,,0,42.49,42.49,1,-72655,46950,119605,-25705,0,0,11769,0,0,,11769,11769
10,03-07-17,42,10:15,10:30,34.54,,0,34.54,34.54,1,-66996,58189,125185,-8807,0,0,7880,0,0,,7880,7880
10,03-07-17,43,10:30,10:45,33.93,,0,33.93,33.93,1,-63323,54316,117639,-9007,0,0,1209,0,0,,1209,1209
10,03-07-17,44,10:45,11:00,31.39,,0,31.39,31.39,1,-56311,64641,120952,8330,0,0,1553,0,0,,1553,1553
10,03-07-17,45,11:00,11:15,34.54,,0,34.54,34.54,1,-66490,32173,98663,-34317,0,0,1930,0,0,,1930,1930
10,03-07-17,46,11:15,11:30,36.59,,0,36.59,36.59,1,-62276,27114,89390,-35162,0,0,5095,0,0,,5095,5095
10,03-07-17,47,11:30,11:45,42.24,,0,42.24,42.24,1,-62674,30697,93371,-31977,0,0,10743,0,0,,10743,10743
10,03-07-17,48,11:45,12:00,42.24,22.88,0,22.88,22.88,-1,-58349,39602,97951,-18747,0,-1561,1880,0,0,,3441,319
10,03-07-17,49,12:00,12:15,,6.12,0,6.12,6.12,-1,-77271,24184,101455,-53087,0,-12217,0,0,0,,12217,-12217
10,03-07-17,50,12:15,12:30,,31.7,0,31.7,31.7,-1,-54460,29529,83989,-24931,0,-94,0,0,0,,94,-94
10,03-07-17,51,12:30,12:45,,29.71,0,29.71,29.71,-1,-40510,45380,85890,4870,0,-4146,0,0,0,,4146,-4146
10,03-07-17,52,12:45,13:00,,22.88,0,22.88,22.88,-1,-29834,55048,84882,25214,0,-23791,0,0,0,,23791,-23791
10,03-07-17,53,13:00,13:15,29.88,30.13,0,29.88,29.88,1,-81104,55560,136664,-25544,0,-8751,182,0,0,,8933,-8569
10,03-07-17,54,13:15,13:30,29.88,,0,29.88,29.88,1,-70662,61111,131773,-9551,0,0,779,0,0,,779,779
10,03-07-17,55,13:30,13:45,,26.43,0,26.43,26.43,-1,-58736,78405,137141,19669,0,-10590,0,0,0,,10590,-10590
10,03-07-17,56,13:45,14:00,,23.89,0,23.89,23.89,-1,-60946,85375,146321,24429,0,-27793,0,0,0,,27793,-27793
10,03-07-17,57,14:00,14:15,,22.88,0,22.88,22.88,-1,-68678,103109,171787,34431,0,-40327,0,0,0,,40327,-40327
10,03-07-17,58,14:15,14:30,,25.8,0,25.8,25.8,-1,-74586,90033,164619,15447,0,-36620,0,0,0,,36620,-36620
10,03-07-17,59,14:30,14:45,,22.88,0,22.88,22.88,-1,-70534,96926,167460,26392,0,-27812,0,0,0,,27812,-27812
10,03-07-17,60,14:45,15:00,,25.8,0,25.8,25.8,-1,-69140,91573,160713,22433,0,-34859,0,0,0,,34859,-34859
10,03-07-17,61,15:00,15:15,,22.88,0,22.88,22.88,-1,-71939,99380,171319,27441,0,-26867,0,0,0,,26867,-26867
10,03-07-17,62,15:15,15:30,,27.53,0,27.53,27.53,-1,-67740,93598,161338,25858,0,-16376,0,0,0,,16376,-16376
10,03-07-17,63,15:30,15:45,,28.96,0,28.96,28.96,-1,-74934,92147,167081,17213,0,-17442,0,0,0,,17442,-17442
10,03-07-17,64,15:45,16:00,29.88,28.96,0,29.88,29.88,1,-75593,74072,149665,-1521,0,-2168,59,0,0,,2227,-2109
10,03-07-17,65,16:00,16:15,,,0,32.59,32.59,0,-59726,71506,131232,11780,0,0,0,0,0,,0,0
10,03-07-17,66,16:15,16:30,,31.04,0,31.04,31.04,-1,-53134,61175,114309,8041,0,-88,0,0,0,,88,-88
10,03-07-17,67,16:30,16:45,,27.88,0,27.88,27.88,-1,-51767,54823,106590,3056,0,-5049,0,0,0,,5049,-5049
10,03-07-17,68,16:45,17:00,,,0,32.29,32.29,0,-91093,57713,148806,-33380,0,-27,0,0,0,,27,-27
10,03-07-17,69,17:00,17:15,,,0,31.95,31.95,0,-56192,18870,75062,-37322,0,0,0,0,0,,0,0
10,03-07-17,70,17:15,17:30,,,0,32.25,32.25,0,-45721,11472,57193,-34249,0,0,0,0,0,,0,0
10,03-07-17,71,17:30,17:45,,,0,31.9,31.9,0,-45782,21454,67236,-24328,0,0,0,0,0,,0,0
10,03-07-17,72,17:45,18:00,,30.39,0,30.39,30.39,-1,-46677,45629,92306,-1048,0,-247,0,0,0,,247,-247
10,03-07-17,73,18:00,18:15,,23.89,0,23.89,23.89,-1,-43371,35662,79033,-7709,0,-13973,0,0,0,,13973,-13973
10,03-07-17,74,18:15,18:30,,,0,31.92,31.92,0,-32111,29067,61178,-3044,0,-1975,0,0,0,,1975,-1975
10,03-07-17,75,18:30,18:45,,,0,32.32,32.32,0,-41661,19192,60853,-22469,0,0,0,0,0,,0,0
10,03-07-17,76,18:45,19:00,559.19,,0,559.19,559.19,1,-96594,15036,111630,-81558,0,0,25443,0,0,,25443,25443
10,03-07-17,77,19:00,19:15,186.35,30.39,0,30.39,30.39,-1,-33545,63309,96854,29764,0,-104,27942,0,0,,28046,27838
10,03-07-17,78,19:15,19:30,186.35,27.88,0,27.88,27.88,-1,-26645,72820,99465,46175,0,-3079,72,0,0,,3151,-3007
10,03-07-17,79,19:30,19:45,,27.88,0,27.88,27.88,-1,-38929,54555,93484,15626,0,-2298,0,0,0,,2298,-2298
10,03-07-17,80,19:45,20:00,,27.84,0,27.84,27.84,-1,-32367,41936,74303,9569,0,-9698,0,0,0,,9698,-9698
10,03-07-17,81,20:00,20:15,31.93,27.84,0,31.93,31.93,1,-54698,43112,97810,-11586,0,-1292,610,0,0,,1902,-682
10,03-07-17,82,20:15,20:30,34.55,26.59,0,34.55,26.59,2,-31983,42869,74852,10886,0,-713,1947,0,0,,2660,1234
10,03-07-17,83,20:30,20:45,,23.9,0,23.9,23.9,-1,-25939,42771,68710,16832,0,-6050,0,0,0,,6050,-6050
10,03-07-17,84,20:45,21:00,,26.74,0,26.74,26.74,-1,-28586,57429,86015,28843,0,-9635,0,0,0,,9635,-9635
10,03-07-17,85,21:00,21:15,39.77,26.49,0,39.77,26.49,2,-89083,52134,141217,-36949,0,-8028,3084,0,0,,11112,-4944
10,03-07-17,86,21:15,21:30,29.88,26.49,0,29.88,29.88,1,-54646,43757,98403,-10889,0,-33,1131,0,0,,1164,1098
10,03-07-17,87,21:30,21:45,,21.63,0,21.63,21.63,-1,-26649,58768,85417,32119,0,-10875,0,0,0,,10875,-10875
10,03-07-17,88,21:45,22:00,,21.37,0,21.37,21.37,-1,-28104,78752,106856,50648,0,-38283,0,0,0,,38283,-38283
10,03-07-17,89,22:00,22:15,36.52,21.37,0,36.52,36.52,1,-103219,23962,127181,-79257,0,-23451,594,0,0,,24045,-22857
10,03-07-17,90,22:15,22:30,,,0,30.96,30.96,0,-68078,23595,91673,-44483,0,-12,361,0,0,,373,349
10,03-07-17,91,22:30,22:45,,22.88,0,22.88,22.88,-1,-36896,65042,101938,28146,0,-2784,0,0,0,,2784,-2784
10,03-07-17,92,22:45,23:00,,22.88,0,22.88,22.88,-1,-42851,54945,97796,12094,0,-19365,0,0,0,,19365,-19365
10,03-07-17,93,23:00,23:15,31.16,22.88,0,31.16,31.16,1,-78993,79942,158935,949,0,-11810,160,0,0,,11970,-11650
10,03-07-17,94,23:15,23:30,31.16,30.08,0,31.16,29.96,2,-54565,48318,102883,-6247,0,-195,1608,0,0,,1803,1413
10,03-07-17,95,23:30,23:45,,22.74,0,22.74,22.74,-1,-38368,72419,110787,34051,0,-16588,0,0,0,,16588,-16588
10,03-07-17,96,23:45,0:00,,-30.43,0,-30.43,-30.43,-1,-35437,102669,138106,67232,0,-40375,0,0,0,,40375,-40375
10,03-08-17,1,0:00,0:15,33.5,-32.24,0,33.5,-32.24,2,-70270,52240,122510,-18030,0,-28171,868,0,0,,29039,-27303
10,03-08-17,2,0:15,0:30,33.5,26.41,0,26.41,26.41,-1,-36986,58789,95775,21803,0,-3388,297,0,0,,3685,-3091
10,03-08-17,3,0:30,0:45,,22.51,0,22.51,22.51,-1,-33364,76107,109471,42743,0,-24389,0,0,0,,24389,-24389
10,03-08-17,4,0:45,1:00,,-10.6,0,-10.6,-10.6,-1,-30490,94491,124981,64001,0,-46929,0,0,0,,46929,-46929
10,03-08-17,5,1:00,1:15,36.64,23,0,36.64,36.64,1,-34331,54672,89003,20341,0,-17119,528,0,0,,17647,-16591
10,03-08-17,6,1:15,1:30,37.79,-8.75,0,37.79,-8.75,2,-24311,72770,97081,48459,0,-5369,1175,0,0,,6544,-4194
10,03-08-17,7,1:30,1:45,,-54.52,0,-54.52,-54.52,-1,-24883,78436,103319,53553,0,-25521,0,0,0,,25521,-25521
10,03-08-17,8,1:45,2:00,,-8.75,0,-8.75,-8.75,-1,-28421,97923,126344,69502,0,-47663,0,0,0,,47663,-47663
10,03-08-17,9,2:00,2:15,,10.15,0,10.15,10.15,-1,-48711,64469,113180,15758,0,-39295,0,0,0,,39295,-39295
10,03-08-17,10,2:15,2:30,,22.78,0,22.78,22.78,-1,-40711,55189,95900,14478,0,-4002,0,0,0,,4002,-4002
10,03-08-17,11,2:30,2:45,,21.59,0,21.59,21.59,-1,-34681,65064,99745,30383,0,-25458,0,0,0,,25458,-25458
10,03-08-17,12,2:45,3:00,,-5.61,0,-5.61,-5.61,-1,-23412,81039,104451,57627,0,-36529,0,0,0,,36529,-36529
10,03-08-17,13,3:00,3:15,30,21.59,0,30,30,1,-60742,52985,113727,-7757,0,-24323,9,0,0,,24332,-24314
10,03-08-17,14,3:15,3:30,30,26.41,0,30.15,26.41,2,-48839,58452,107291,9613,0,-935,203,0,0,,1138,-732
10,03-08-17,15,3:30,3:45,,21.59,0,21.59,21.59,-1,-38563,78432,116995,39869,0,-32085,0,0,0,,32085,-32085
10,03-08-17,16,3:45,4:00,,-25.56,0,-25.56,-25.56,-1,-30687,112985,143672,82298,0,-63796,0,0,0,,63796,-63796
10,03-08-17,17,4:00,4:15,,31.9,0,31.9,31.9,-1,-56126,50139,106265,-5987,0,-25331,0,0,0,,25331,-25331
10,03-08-17,18,4:15,4:30,,10.15,0,10.15,10.15,-1,-27837,74773,102610,46936,0,-14188,0,0,0,,14188,-14188
10,03-08-17,19,4:30,4:45,,10.15,0,10.15,10.15,-1,-26830,76365,103195,49535,0,-42783,0,0,0,,42783,-42783
10,03-08-17,20,4:45,5:00,,23,0,23,23,-1,-23523,85509,109032,61986,0,-37634,0,0,0,,37634,-37634
10,03-08-17,21,5:00,5:15,,25.14,0,25.14,25.14,-1,-55970,53482,109452,-2488,0,-28188,0,0,0,,28188,-28188
10,03-08-17,22,5:15,5:30,,28,0,28,28,-1,-43830,47186,91016,3356,0,-13227,0,0,0,,13227,-13227
10,03-08-17,23,5:30,5:45,30,28,0,30,30,1,-57095,33027,90122,-24068,0,-2074,306,0,0,,2380,-1768
10,03-08-17,24,5:45,6:00,30,28,0,31.15,28,2,-70776,77688,148464,6912,0,-901,162,0,0,,1063,-739
10,03-08-17,25,6:00,6:15,,,0,31.15,31.15,0,-60184,74851,135035,14667,0,-603,0,0,0,,603,-603
10,03-08-17,26,6:15,6:30,,23,0,23,23,-1,-47342,75939,123281,28597,0,-8035,0,0,0,,8035,-8035
10,03-08-17,27,6:30,6:45,,28,0,28,28,-1,-65153,62471,127624,-2682,0,-9207,0,0,0,,9207,-9207
10,03-08-17,28,6:45,7:00,33.4,28,0,33.4,33.4,1,-94236,61522,155758,-32714,0,-2,717,0,0,,719,715
10,03-08-17,29,7:00,7:15,33.4,-42.03,0,-42.03,-42.03,-1,-34251,111774,146025,77523,0,-29852,6,0,0,,29858,-29846
10,03-08-17,30,7:15,7:30,,29.94,0,29.94,29.94,-1,-67685,56785,124470,-10900,0,-2015,0,0,0,,2015,-2015
10,03-08-17,31,7:30,7:45,,32.1,0,32.1,32.1,-1,-79267,31781,111048,-47486,0,-168,0,0,0,,168,-168
10,03-08-17,32,7:45,8:00,36.36,,0,36.36,36.36,1,-114094,13844,127938,-100250,0,0,1305,0,0,,1305,1305
10,03-08-17,33,8:00,8:15,36.36,,0,36.36,36.36,1,-40832,50197,91029,9365,0,0,1444,0,0,,1444,1444
10,03-08-17,34,8:15,8:30,,,0,31.05,31.05,0,-60609,23801,84410,-36808,0,0,0,0,0,,0,0
10,03-08-17,35,8:30,8:45,30.81,,0,30.81,30.81,1,-65565,13003,78568,-52562,0,0,723,0,0,,723,723
10,03-08-17,36,8:45,9:00,30,,0,30,30,1,-71006,11577,82583,-59429,0,0,901,0,0,,901,901
10,03-08-17,37,9:00,9:15,,30.24,0,30.24,30.24,-1,-28563,59277,87840,30714,0,-1743,0,0,0,,1743,-1743
10,03-08-17,38,9:15,9:30,,23,0,23,23,-1,-37222,66074,103296,28852,0,-19133,0,0,0,,19133,-19133
10,03-08-17,39,9:30,9:45,,27,0,27,27,-1,-57333,78032,135365,20699,0,-32116,0,0,0,,32116,-32116
10,03-08-17,40,9:45,10:00,30.81,28.99,0,30.81,30.81,1,-67688,56815,124503,-10873,0,-22669,43,0,0,,22712,-22626
10,03-08-17,41,10:00,10:15,45.72,28.99,0,45.72,45.72,1,-85896,14797,100693,-71099,0,-1558,10387,0,0,,11945,8829
10,03-08-17,42,10:15,10:30,30,,0,30,30,1,-75801,2919,78720,-72882,0,0,2132,0,0,,2132,2132
10,03-08-17,43,10:30,10:45,38.26,,0,38.26,38.26,1,-65504,8286,73790,-57218,0,0,3254,0,0,,3254,3254
10,03-08-17,44,10:45,11:00,30,,0,30,30,1,-58698,5811,64509,-52887,0,0,203,0,0,,203,203
10,03-08-17,45,11:00,11:15,38.07,,0,38.07,38.07,1,-54460,11290,65750,-43170,0,0,2874,0,0,,2874,2874
10,03-08-17,46,11:15,11:30,134.52,,0,134.52,134.52,1,-77187,5771,82958,-71416,0,0,17959,0,0,,17959,17959
10,03-08-17,47,11:30,11:45,134.52,,0,134.52,134.52,1,-53219,10816,64035,-42403,0,0,29009,0,0,,29009,29009
10,03-08-17,48,11:45,12:00,35.04,,0,35.04,35.04,1,-56922,19993,76915,-36929,0,0,4369,0,0,,4369,4369
10,03-08-17,49,12:00,12:15,,,0,31.15,31.15,0,-51150,56631,107781,5481,0,0,216,0,0,,216,216
10,03-08-17,50,12:15,12:30,,,0,31.15,31.15,0,-53963,60816,114779,6853,0,0,0,0,0,,0,0
10,03-08-17,51,12:30,12:45,,,0,31.15,31.15,0,-61408,58497,119905,-2911,0,0,0,0,0,,0,0
10,03-08-17,52,12:45,13:00,,31.9,0,31.9,31.9,-1,-51683,53052,104735,1369,0,-30,0,0,0,,30,-30
10,03-08-17,53,13:00,13:15,,29.9,0,29.9,29.9,-1,-66844,71928,138772,5084,0,-1087,0,0,0,,1087,-1087
10,03-08-17,54,13:15,13:30,43.35,,0,43.35,43.35,1,-80274,34292,114566,-45982,0,0,11836,0,0,,11836,11836
10,03-08-17,55,13:30,13:45,76.12,,0,76.12,76.12,1,-83736,23038,106774,-60698,0,0,45148,0,0,,45148,45148
10,03-08-17,56,13:45,14:00,68.12,,0,68.12,68.12,1,-107878,20040,127918,-87838,0,0,50881,0,0,,50881,50881
10,03-08-17,57,14:00,14:15,56.12,,0,56.12,56.12,1,-133380,13428,146808,-119952,0,0,51267,0,0,,51267,51267
10,03-08-17,58,14:15,14:30,37.79,,0,37.79,37.79,1,-122189,12202,134391,-109987,0,0,28128,0,0,,28128,28128
10,03-08-17,59,14:30,14:45,45.12,,0,45.12,45.12,1,-139781,14666,154447,-125115,0,0,28805,0,0,,28805,28805
10,03-08-17,60,14:45,15:00,47.51,,0,47.51,47.51,1,-178271,16415,194686,-161856,0,0,37460,0,0,,37460,37460
10,03-08-17,61,15:00,15:15,35.34,,0,35.34,35.34,1,-76826,65081,141907,-11745,0,0,18065,0,0,,18065,18065
10,03-08-17,62,15:15,15:30,35.34,,0,35.34,35.34,1,-88541,52664,141205,-35877,0,0,664,0,0,,664,664
10,03-08-17,63,15:30,15:45,132.12,,0,132.12,132.12,1,-104005,36877,140882,-67128,0,0,34548,0,0,,34548,34548
10,03-08-17,64,15:45,16:00,43.35,,0,43.35,43.35,1,-98218,30321,128539,-67897,0,0,50231,0,0,,50231,50231
10,03-08-17,65,16:00,16:15,33.81,30.83,0,33.81,30.83,2,-74651,70481,145132,-4170,0,-259,14698,0,0,,14957,14439
10,03-08-17,66,16:15,16:30,,,0,31.18,31.18,0,-66931,89148,156079,22217,0,0,0,0,0,,0,0
10,03-08-17,67,16:30,16:45,34.4,,0,34.4,34.4,1,-67244,73966,141210,6722,0,0,909,0,0,,909,909
10,03-08-17,68,16:45,17:00,34.4,,0,34.4,34.4,1,-54365,66250,120615,11885,0,0,4536,0,0,,4536,4536
10,03-08-17,69,17:00,17:15,34.4,27.74,0,27.74,27.74,-1,-81384,96774,178158,15390,0,-3141,491,0,0,,3632,-2650
10,03-08-17,70,17:15,17:30,,32.06,0,32.06,32.06,-1,-93144,71601,164745,-21543,0,-310,0,0,0,,310,-310
10,03-08-17,71,17:30,17:45,40.13,,0,40.13,40.13,1,-77442,55266,132708,-22176,0,0,2772,0,0,,2772,2772
10,03-08-17,72,17:45,18:00,40.74,,0,40.74,40.74,1,-73411,77041,150452,3630,0,0,8073,0,0,,8073,8073
10,03-08-17,73,18:00,18:15,40.74,-55.85,0,-55.85,-55.85,-1,-62365,109347,171712,46982,0,-26444,21,0,0,,26465,-26423
10,03-08-17,74,18:15,18:30,,23,0,23,23,-1,-50238,105716,155954,55478,0,-34914,0,0,0,,34914,-34914
10,03-08-17,75,18:30,18:45,,11.98,0,11.98,11.98,-1,-64159,97460,161619,33301,0,-47588,0,0,0,,47588,-47588
10,03-08-17,76,18:45,19:00,40.74,33.24,0,40.74,40.74,1,-91283,62392,153675,-28891,0,-8320,2882,0,0,,11202,-5438
10,03-08-17,77,19:00,19:15,40.74,,0,40.74,40.74,1,-96385,63114,159499,-33271,0,0,3566,0,0,,3566,3566
10,03-08-17,78,19:15,19:30,,,0,31.03,31.03,0,-87286,52634,139920,-34652,0,0,0,0,0,,0,0
10,03-08-17,79,19:30,19:45,,,0,31.03,31.03,0,-86946,60073,147019,-26873,0,0,0,0,0,,0,0
10,03-08-17,80,19:45,20:00,,26.19,0,26.19,26.19,-1,-74145,76097,150242,1952,0,-1328,0,0,0,,1328,-1328
10,03-08-17,81,20:00,20:15,,23,0,23,23,-1,-54551,115738,170289,61187,0,-12736,0,0,0,,12736,-12736
10,03-08-17,82,20:15,20:30,,24.39,0,24.39,24.39,-1,-62647,82562,145209,19915,0,-19263,0,0,0,,19263,-19263
10,03-08-17,83,20:30,20:45,,21.66,0,21.66,21.66,-1,-36446,96116,132562,59670,0,-20563,0,0,0,,20563,-20563
10,03-08-17,84,20:45,21:00,,-10.51,0,-10.51,-10.51,-1,-24476,111247,135723,86771,0,-39162,0,0,0,,39162,-39162
10,03-08-17,85,21:00,21:15,125.56,-18.75,0,125.56,-18.75,2,-73881,33202,107083,-40679,0,-24310,5902,0,0,,30212,-18408
10,03-08-17,86,21:15,21:30,30,,0,30,30,1,-63854,45641,109495,-18213,0,0,1177,0,0,,1177,1177
10,03-08-17,87,21:30,21:45,,32.29,0,32.29,32.29,-1,-55518,81505,137023,25987,0,-17,0,0,0,,17,-17
10,03-08-17,88,21:45,22:00,,-33.39,0,-33.39,-33.39,-1,-42271,104827,147098,62556,0,-15995,0,0,0,,15995,-15995
10,03-08-17,89,22:00,22:15,160.36,-28.85,0,160.36,160.36,1,-134392,29715,164107,-104677,0,-22323,4086,0,0,,26409,-18237
10,03-08-17,90,22:15,22:30,173.92,29.9,0,173.92,29.9,2,-88004,61805,149809,-26199,0,-120,9568,0,0,,9688,9448
10,03-08-17,91,22:30,22:45,,23,0,23,23,-1,-50186,81166,131352,30980,0,-16525,0,0,0,,16525,-16525
10,03-08-17,92,22:45,23:00,,12.19,0,12.19,12.19,-1,-41498,74563,116061,33065,0,-39732,0,0,0,,39732,-39732
10,03-08-17,93,23:00,23:15,35.34,12.19,0,35.34,35.34,1,-107777,39350,147127,-68427,0,-6444,1143,0,0,,7587,-5301
10,03-08-17,94,23:15,23:30,,,0,31.15,31.15,0,-92241,32674,124915,-59567,0,0,0,0,0,,0,0
10,03-08-17,95,23:30,23:45,,,0,31.15,31.15,0,-62393,39203,101596,-23190,0,0,0,0,0,,0,0
10,03-08-17,96,23:45,0:00,,28,0,28,28,-1,-51220,75110,126330,23890,0,-2914,0,0,0,,2914,-2914
10,03-09-17,1,0:00,0:15,36.09,28,0,36.09,36.09,1,-94953,43537,138490,-51416,0,-399,5032,0,0,,5431,4633
10,03-09-17,2,0:15,0:30,29.6,,0,29.6,29.6,1,-57728,44205,101933,-13523,0,0,1577,0,0,,1577,1577
10,03-09-17,3,0:30,0:45,,,0,30.01,30.01,0,-33739,41363,75102,7624,0,0,0,0,0,,0,0
10,03-09-17,4,0:45,1:00,,28.88,0,28.88,28.88,-1,-53934,61905,115839,7971,0,-1713,0,0,0,,1713,-1713
10,03-09-17,5,1:00,1:15,,,0,30.13,30.13,0,-51461,32580,84041,-18881,0,-22,0,0,0,,22,-22
10,03-09-17,6,1:15,1:30,,,0,30.13,30.13,0,-45578,29948,75526,-15630,0,0,0,0,0,,0,0
10,03-09-17,7,1:30,1:45,,,0,30.13,30.13,0,-36473,34236,70709,-2237,0,0,0,0,0,,0,0
10,03-09-17,8,1:45,2:00,,32,0,32,32,-1,-46081,38995,85076,-7086,0,-405,0,0,0,,405,-405
10,03-09-17,9,2:00,2:15,,31.61,0,31.61,31.61,-1,-49189,46087,95276,-3102,0,-683,0,0,0,,683,-683
10,03-09-17,10,2:15,2:30,,30.23,0,30.23,30.23,-1,-42223,40537,82760,-1686,0,-2580,0,0,0,,2580,-2580
10,03-09-17,11,2:30,2:45,,31.61,0,31.61,31.61,-1,-38465,37775,76240,-690,0,-1394,0,0,0,,1394,-1394
10,03-09-17,12,2:45,3:00,,32,0,32,32,-1,-39618,27805,67423,-11813,0,-223,0,0,0,,223,-223
10,03-09-17,13,3:00,3:15,,31.61,0,31.61,31.61,-1,-47832,47723,95555,-109,0,-443,0,0,0,,443,-443
10,03-09-17,14,3:15,3:30,,23.26,0,23.26,23.26,-1,-44933,68977,113910,24044,0,-10360,0,0,0,,10360,-10360
10,03-09-17,15,3:30,3:45,,23.26,0,23.26,23.26,-1,-40144,52788,92932,12644,0,-22991,0,0,0,,22991,-22991
10,03-09-17,16,3:45,4:00,30.26,32,0,30.26,30.01,2,-55648,53158,108806,-2490,0,-2807,444,0,0,,3251,-2363
10,03-09-17,17,4:00,4:15,,32,0,32,32,-1,-57888,33190,91078,-24698,0,-121,0,0,0,,121,-121
10,03-09-17,18,4:15,4:30,,32,0,32,32,-1,-59134,41020,100154,-18114,0,-250,0,0,0,,250,-250
10,03-09-17,19,4:30,4:45,,32,0,32,32,-1,-54672,32283,86955,-22389,0,-190,0,0,0,,190,-190
10,03-09-17,20,4:45,5:00,,,0,30.13,30.13,0,-63321,43963,107284,-19358,0,0,0,0,0,,0,0
10,03-09-17,21,5:00,5:15,,32.01,0,32.01,32.01,-1,-86558,40182,126740,-46376,0,-46,0,0,0,,46,-46
10,03-09-17,22,5:15,5:30,,31.62,0,31.62,31.62,-1,-63339,38924,102263,-24415,0,-987,0,0,0,,987,-987
10,03-09-17,23,5:30,5:45,,32.01,0,32.01,32.01,-1,-66348,28403,94751,-37945,0,-444,0,0,0,,444,-444
10,03-09-17,24,5:45,6:00,,,0,30.14,30.14,0,-80208,40125,120333,-40083,0,0,0,0,0,,0,0
10,03-09-17,25,6:00,6:15,,32.02,0,32.02,32.02,-1,-59510,75900,135410,16390,0,-364,0,0,0,,364,-364
10,03-09-17,26,6:15,6:30,29.48,32.02,0,29.48,29.48,1,-53517,59465,112982,5948,0,-412,42,0,0,,454,-370
10,03-09-17,27,6:30,6:45,30.26,,0,30.26,30.26,1,-75290,50602,125892,-24688,0,0,1596,0,0,,1596,1596
10,03-09-17,28,6:45,7:00,264.93,,0,264.93,264.93,1,-118154,49678,167832,-68476,0,0,24605,0,0,,24605,24605
10,03-09-17,29,7:00,7:15,39.09,,0,39.09,39.09,1,-55411,71110,126521,15699,0,0,13331,0,0,,13331,13331
10,03-09-17,30,7:15,7:30,37.67,,0,37.67,37.67,1,-94909,60717,155626,-34192,0,0,1828,0,0,,1828,1828
10,03-09-17,31,7:30,7:45,38.64,,0,38.64,38.64,1,-117623,68186,185809,-49437,0,0,6242,0,0,,6242,6242
10,03-09-17,32,7:45,8:00,338.56,,0,338.56,338.56,1,-151642,73520,225162,-78122,0,0,26386,0,0,,26386,26386
10,03-09-17,33,8:00,8:15,45.02,,0,45.02,45.02,1,-83798,100900,184698,17102,0,0,19851,0,0,,19851,19851
10,03-09-17,34,8:15,8:30,32.6,,0,32.6,32.6,1,-92216,65109,157325,-27107,0,0,2285,0,0,,2285,2285
10,03-09-17,35,8:30,8:45,,,0,31.99,31.99,0,-90201,48992,139193,-41209,0,0,113,0,0,,113,113
10,03-09-17,36,8:45,9:00,29.48,,0,29.48,29.48,1,-59680,38425,98105,-21255,0,0,14,0,0,,14,14
10,03-09-17,37,9:00,9:15,42.34,,0,42.34,42.34,1,-76076,47838,123914,-28238,0,0,8527,0,0,,8527,8527
10,03-09-17,38,9:15,9:30,34.84,,0,34.84,34.84,1,-68637,43946,112583,-24691,0,0,8397,0,0,,8397,8397
10,03-09-17,39,9:30,9:45,,,0,31.94,31.94,0,-64007,42170,106177,-21837,0,0,11,0,0,,11,11
10,03-09-17,40,9:45,10:00,,31.62,0,31.62,31.62,-1,-54234,57117,111351,2883,0,-346,0,0,0,,346,-346
10,03-09-17,41,10:00,10:15,143.79,32.02,0,143.79,143.79,1,-109946,40012,149958,-69934,0,-100,16970,0,0,,17070,16870
10,03-09-17,42,10:15,10:30,54.62,,0,54.62,54.62,1,-77932,42584,120516,-35348,0,0,43899,0,0,,43899,43899
10,03-09-17,43,10:30,10:45,37.67,30.82,0,37.67,30.82,2,-39878,52326,92204,12448,0,-342,10632,0,0,,10974,10290
10,03-09-17,44,10:45,11:00,,21.44,0,21.44,21.44,-1,-30489,97406,127895,66917,0,-2583,0,0,0,,2583,-2583
10,03-09-17,45,11:00,11:15,,-6.47,0,-6.47,-6.47,-1,-24646,72244,96890,47598,0,-38923,0,0,0,,38923,-38923
10,03-09-17,46,11:15,11:30,,3.5,0,3.5,3.5,-1,-37265,95416,132681,58151,0,-38913,0,0,0,,38913,-38913
10,03-09-17,47,11:30,11:45,,3.5,0,3.5,3.5,-1,-45174,111884,157058,66710,0,-63797,0,0,0,,63797,-63797
10,03-09-17,48,11:45,12:00,,-13.71,0,-13.71,-13.71,-1,-30645,114715,145360,84070,0,-71212,0,0,0,,71212,-71212
10,03-09-17,49,12:00,12:15,32.6,21.03,0,32.6,32.6,1,-96002,37079,133081,-58923,0,-29047,241,0,0,,29288,-28806
10,03-09-17,50,12:15,12:30,32.6,28.1,0,28.1,28.1,-1,-75935,70421,146356,-5514,0,-1040,59,0,0,,1099,-981
10,03-09-17,51,12:30,12:45,,16.94,0,16.94,16.94,-1,-54520,106225,160745,51705,0,-38442,0,0,0,,38442,-38442
10,03-09-17,52,12:45,13:00,,9.03,0,9.03,9.03,-1,-48549,119885,168434,71336,0,-65718,0,0,0,,65718,-65718
10,03-09-17,53,13:00,13:15,,16.92,0,16.92,16.92,-1,-54872,110012,164884,55140,0,-36244,0,0,0,,36244,-36244
10,03-09-17,54,13:15,13:30,,-5.88,0,-5.88,-5.88,-1,-49678,101757,151435,52079,0,-57161,0,0,0,,57161,-57161
10,03-09-17,55,13:30,13:45,,-44.77,0,-44.77,-44.77,-1,-38854,120850,159704,81996,0,-52933,0,0,0,,52933,-52933
10,03-09-17,56,13:45,14:00,,-44.77,0,-44.77,-44.77,-1,-51555,94039,145594,42484,0,-52188,0,0,0,,52188,-52188
10,03-09-17,57,14:00,14:15,,-13.03,0,-13.03,-13.03,-1,-36430,105502,141932,69072,0,-59211,0,0,0,,59211,-59211
10,03-09-17,58,14:15,14:30,,-33.57,0,-33.57,-33.57,-1,-47206,121665,168871,74459,0,-61884,0,0,0,,61884,-61884
10,03-09-17,59,14:30,14:45,,-40.02,0,-40.02,-40.02,-1,-45205,126615,171820,81410,0,-62700,0,0,0,,62700,-62700
10,03-09-17,60,14:45,15:00,,-43.05,0,-43.05,-43.05,-1,-48680,133482,182162,84802,0,-72098,0,0,0,,72098,-72098
10,03-09-17,61,15:00,15:15,,-3.1,0,-3.1,-3.1,-1,-54413,123033,177446,68620,0,-61247,0,0,0,,61247,-61247
10,03-09-17,62,15:15,15:30,,-8.24,0,-8.24,-8.24,-1,-51154,101234,152388,50080,0,-65598,0,0,0,,65598,-65598
10,03-09-17,63,15:30,15:45,,23.03,0,23.03,23.03,-1,-53560,109940,163500,56380,0,-44691,0,0,0,,44691,-44691
10,03-09-17,64,15:45,16:00,,22.02,0,22.02,22.02,-1,-52334,98952,151286,46618,0,-48627,0,0,0,,48627,-48627
10,03-09-17,65,16:00,16:15,,26.19,0,26.19,26.19,-1,-66164,101617,167781,35453,0,-35004,0,0,0,,35004,-35004
10,03-09-17,66,16:15,16:30,,,0,30.16,30.16,0,-66509,92203,158712,25694,0,-7857,0,0,0,,7857,-7857
10,03-09-17,67,16:30,16:45,,,0,30.16,30.16,0,-69112,88615,157727,19503,0,0,0,0,0,,0,0
10,03-09-17,68,16:45,17:00,,31.67,0,31.67,31.67,-1,-90171,93115,183286,2944,0,-90,0,0,0,,90,-90
10,03-09-17,69,17:00,17:15,,29.09,0,29.09,29.09,-1,-92135,84300,176435,-7835,0,-3749,0,0,0,,3749,-3749
10,03-09-17,70,17:15,17:30,,,0,31.89,31.89,0,-98568,61813,160381,-36755,0,-33,0,0,0,,33,-33
10,03-09-17,71,17:30,17:45,29.48,,0,29.48,29.48,1,-80403,71335,151738,-9068,0,0,16,0,0,,16,16
10,03-09-17,72,17:45,18:00,29.87,29.29,0,31.89,29.29,2,-67815,75546,143361,7731,0,-97,599,0,0,,696,502
10,03-09-17,73,18:00,18:15,,-46.78,0,-46.78,-46.78,-1,-33941,94060,128001,60119,0,-32218,0,0,0,,32218,-32218
10,03-09-17,74,18:15,18:30,,-44.48,0,-44.48,-44.48,-1,-25260,99811,125071,74551,0,-33119,0,0,0,,33119,-33119
10,03-09-17,75,18:30,18:45,,23.03,0,23.03,23.03,-1,-36940,87114,124054,50174,0,-42744,0,0,0,,42744,-42744
10,03-09-17,76,18:45,19:00,30.52,28.1,0,30.52,30.52,1,-98169,77170,175339,-20999,0,-20295,487,0,0,,20782,-19808
10,03-09-17,77,19:00,19:15,30.52,23.26,0,23.26,23.26,-1,-77326,118395,195721,41069,0,-16201,54,0,0,,16255,-16147
10,03-09-17,78,19:15,19:30,,3.87,0,3.87,3.87,-1,-48608,102838,151446,54230,0,-43724,0,0,0,,43724,-43724
10,03-09-17,79,19:30,19:45,,23.26,0,23.26,23.26,-1,-66313,101538,167851,35225,0,-33347,0,0,0,,33347,-33347
10,03-09-17,80,19:45,20:00,,23.26,0,23.26,23.26,-1,-63067,89025,152092,25958,0,-41988,0,0,0,,41988,-41988
10,03-09-17,81,20:00,20:15,,-15.8,0,-15.8,-15.8,-1,-40298,108643,148941,68345,0,-41941,0,0,0,,41941,-41941
10,03-09-17,82,20:15,20:30,,-5.61,0,-5.61,-5.61,-1,-31714,80942,112656,49228,0,-9720,0,0,0,,9720,-9720
10,03-09-17,83,20:30,20:45,,-41.83,0,-41.83,-41.83,-1,-40507,39668,80175,-839,0,-20817,0,0,0,,20817,-20817
10,03-09-17,84,20:45,21:00,,31.63,0,31.63,31.63,-1,-58071,52942,111013,-5129,0,-256,0,0,0,,256,-256
10,03-09-17,85,21:00,21:15,126.28,30.64,0,126.28,126.28,1,-80030,41606,121636,-38424,0,-162,13245,0,0,,13407,13083
10,03-09-17,86,21:15,21:30,37.29,,0,37.29,37.29,1,-63171,65211,128382,2040,0,0,15077,0,0,,15077,15077
10,03-09-17,87,21:30,21:45,37.29,32.02,0,32.02,32.02,-1,-60279,58700,118979,-1579,0,-90,35,0,0,,125,-55
10,03-09-17,88,21:45,22:00,,22.84,0,22.84,22.84,-1,-55052,69362,124414,14310,0,-5794,0,0,0,,5794,-5794
10,03-09-17,89,22:00,22:15,,21.84,0,21.84,21.84,-1,-84553,73109,157662,-11444,0,-8607,0,0,0,,8607,-8607
10,03-09-17,90,22:15,22:30,,,0,30.14,30.14,0,-78072,55107,133179,-22965,0,-16,0,0,0,,16,-16
10,03-09-17,91,22:30,22:45,,,0,30.14,30.14,0,-55627,45972,101599,-9655,0,0,0,0,0,,0,0
10,03-09-17,92,22:45,23:00,32.39,,0,32.39,32.39,1,-74666,65023,139689,-9643,0,0,2948,0,0,,2948,2948
10,03-09-17,93,23:00,23:15,,,0,30.13,30.13,0,-79654,54590,134244,-25064,0,0,321,0,0,,321,321
10,03-09-17,94,23:15,23:30,,,0,30.13,30.13,0,-77566,40410,117976,-37156,0,0,0,0,0,,0,0
10,03-09-17,95,23:30,23:45,28.26,,0,28.26,28.26,1,-57632,44067,101699,-13565,0,0,42,0,0,,42,42
10,03-09-17,96,23:45,0:00,28.26,,0,28.26,28.26,1,-49804,69246,119050,19442,0,0,184,0,0,,184,184
10,03-10-17,1,0:00,0:15,48.96,,0,48.96,48.96,1,-86081,32879,118960,-53202,0,0,10061,0,0,,10061,10061
10,03-10-17,2,0:15,0:30,33.61,,0,33.61,33.61,1,-61799,36016,97815,-25783,0,0,15114,0,0,,15114,15114
10,03-10-17,3,0:30,0:45,33.61,,0,33.61,33.61,1,-51387,15363,66750,-36024,0,0,15169,0,0,,15169,15169
10,03-10-17,4,0:45,1:00,29.08,,0,29.08,29.08,1,-71984,20944,92928,-51040,0,0,5752,0,0,,5752,5752
10,03-10-17,5,1:00,1:15,30.54,,0,30.54,30.54,1,-66277,41054,107331,-25223,0,0,452,0,0,,452,452
10,03-10-17,6,1:15,1:30,30.54,,0,30.54,30.54,1,-50413,42535,92948,-7878,0,0,1314,0,0,,1314,1314
10,03-10-17,7,1:30,1:45,30.54,31.93,0,30.54,30.54,1,-55762,35071,90833,-20691,0,-78,542,0,0,,620,464
10,03-10-17,8,1:45,2:00,32.2,31.54,0,31.54,31.54,-1,-55472,44045,99517,-11427,0,-21,1054,0,0,,1075,1033
10,03-10-17,9,2:00,2:15,,26.61,0,26.61,26.61,-1,-34241,32935,67176,-1306,0,-1383,0,0,0,,1383,-1383
10,03-10-17,10,2:15,2:30,29.47,,0,29.47,29.47,1,-45382,29702,75084,-15680,0,0,825,0,0,,825,825
10,03-10-17,11,2:30,2:45,32.2,,0,32.2,32.2,1,-41567,25243,66810,-16324,0,0,3856,0,0,,3856,3856
10,03-10-17,12,2:45,3:00,33.32,,0,33.32,33.32,1,-48832,32445,81277,-16387,0,0,7827,0,0,,7827,7827
10,03-10-17,13,3:00,3:15,33.32,27.61,0,27.61,27.61,-1,-47817,41950,89767,-5867,0,-655,773,0,0,,1428,118
10,03-10-17,14,3:15,3:30,29.61,,0,29.61,29.61,1,-58116,43338,101454,-14778,0,0,608,0,0,,608,608
10,03-10-17,15,3:30,3:45,29.61,,0,29.61,29.61,1,-60555,40876,101431,-19679,0,0,2744,0,0,,2744,2744
10,03-10-17,16,3:45,4:00,29.61,22.61,0,22.61,22.61,-1,-58853,42838,101691,-16015,0,-404,335,0,0,,739,-69
10,03-10-17,17,4:00,4:15,,-11.78,0,-11.78,-11.78,-1,-26693,66793,93486,40100,0,-25036,0,0,0,,25036,-25036
10,03-10-17,18,4:15,4:30,,-17.49,0,-17.49,-17.49,-1,-33690,37730,71420,4040,0,-24253,0,0,0,,24253,-24253
10,03-10-17,19,4:30,4:45,,20.78,0,20.78,20.78,-1,-54357,24381,78738,-29976,0,-17090,0,0,0,,17090,-17090
10,03-10-17,20,4:45,5:00,29.47,20.78,0,29.47,29.47,1,-57733,29451,87184,-28282,0,-28,1516,0,0,,1544,1488
10,03-10-17,21,5:00,5:15,29.08,31.54,0,31.54,31.54,-1,-22184,42577,64761,20393,0,-465,596,0,0,,1061,131
10,03-10-17,22,5:15,5:30,,30.73,0,30.73,30.73,-1,-31941,45246,77187,13305,0,-1550,0,0,0,,1550,-1550
10,03-10-17,23,5:30,5:45,29.61,31.93,0,29.77,29.77,2,-53785,43688,97473,-10097,0,-221,260,0,0,,481,39
10,03-10-17,24,5:45,6:00,30.54,,0,30.54,30.54,1,-64167,60971,125138,-3196,0,0,2669,0,0,,2669,2669
10,03-10-17,25,6:00,6:15,34.44,,0,34.44,34.44,1,-96650,60556,157206,-36094,0,0,5888,0,0,,5888,5888
10,03-10-17,26,6:15,6:30,29.08,,0,29.08,29.08,1,-38529,38476,77005,-53,0,0,427,0,0,,427,427
10,03-10-17,27,6:30,6:45,45.12,,0,45.12,45.12,1,-92975,38131,131106,-54844,0,0,4257,0,0,,4257,4257
10,03-10-17,28,6:45,7:00,106.12,,0,106.12,106.12,1,-108888,84160,193048,-24728,0,0,21700,0,0,,21700,21700
10,03-10-17,29,7:00,7:15,106.12,-18.32,0,-18.32,-18.32,-1,-52531,109227,161758,56696,0,-19807,1860,0,0,,21667,-17947
10,03-10-17,30,7:15,7:30,,27.51,0,27.51,27.51,-1,-56360,38108,94468,-18252,0,-3474,0,0,0,,3474,-3474
10,03-10-17,31,7:30,7:45,30.54,,0,30.54,30.54,1,-99704,32168,131872,-67536,0,0,92,0,0,,92,92
10,03-10-17,32,7:45,8:00,301.53,,0,301.53,301.53,1,-154695,28453,183148,-126242,0,0,38629,0,0,,38629,38629
10,03-10-17,33,8:00,8:15,301.53,22.51,0,22.51,22.51,-1,-30743,80177,110920,49434,0,-1772,30489,0,0,,32261,28717
10,03-10-17,34,8:15,8:30,,22.51,0,22.51,22.51,-1,-23999,52422,76421,28423,0,-4955,0,0,0,,4955,-4955
10,03-10-17,35,8:30,8:45,,29.57,0,29.57,29.57,-1,-31149,50576,81725,19427,0,-4889,0,0,0,,4889,-4889
10,03-10-17,36,8:45,9:00,,30.16,0,30.16,30.16,-1,-37213,52496,89709,15283,0,-1888,0,0,0,,1888,-1888
10,03-10-17,37,9:00,9:15,,27.07,0,27.07,27.07,-1,-35849,70248,106097,34399,0,-11354,0,0,0,,11354,-11354
10,03-10-17,38,9:15,9:30,,26.51,0,26.51,26.51,-1,-37382,84109,121491,46727,0,-21023,0,0,0,,21023,-21023
10,03-10-17,39,9:30,9:45,,-3.5,0,-3.5,-3.5,-1,-32903,119073,151976,86170,0,-22305,0,0,0,,22305,-22305
10,03-10-17,40,9:45,10:00,,-13.17,0,-13.17,-13.17,-1,-32632,103713,136345,71081,0,-30136,0,0,0,,30136,-30136
10,03-10-17,41,10:00,10:15,,3.21,0,3.21,3.21,-1,-49121,102890,152011,53769,0,-27532,0,0,0,,27532,-27532
10,03-10-17,42,10:15,10:30,,-15.54,0,-15.54,-15.54,-1,-51257,99412,150669,48155,0,-52250,0,0,0,,52250,-52250
10,03-10-17,43,10:30,10:45,,15.49,0,15.49,15.49,-1,-43657,109569,153226,65912,0,-40187,0,0,0,,40187,-40187
10,03-10-17,44,10:45,11:00,,15.78,0,15.78,15.78,-1,-51955,115432,167387,63477,0,-59814,0,0,0,,59814,-59814
10,03-10-17,45,11:00,11:15,,17.22,0,17.22,17.22,-1,-47913,140439,188352,92526,0,-59123,0,0,0,,59123,-59123
10,03-10-17,46,11:15,11:30,,22.51,0,22.51,22.51,-1,-46053,97629,143682,51576,0,-53539,0,0,0,,53539,-53539
10,03-10-17,47,11:30,11:45,,23.78,0,23.78,23.78,-1,-48287,98872,147159,50585,0,-43306,0,0,0,,43306,-43306
10,03-10-17,48,11:45,12:00,,23.78,0,23.78,23.78,-1,-57181,101533,158714,44352,0,-40257,0,0,0,,40257,-40257
10,03-10-17,49,12:00,12:15,,25.8,0,25.8,25.8,-1,-52410,82007,134417,29597,0,-26314,0,0,0,,26314,-26314
10,03-10-17,50,12:15,12:30,,27.01,0,27.01,27.01,-1,-56297,71824,128121,15527,0,-12540,0,0,0,,12540,-12540
10,03-10-17,51,12:30,12:45,,23.79,0,23.79,23.79,-1,-55455,94424,149879,38969,0,-21574,0,0,0,,21574,-21574
10,03-10-17,52,12:45,13:00,,23.79,0,23.79,23.79,-1,-60548,91371,151919,30823,0,-31064,0,0,0,,31064,-31064
10,03-10-17,53,13:00,13:15,,16.81,0,16.81,16.81,-1,-33989,94377,128366,60388,0,-37673,0,0,0,,37673,-37673
10,03-10-17,54,13:15,13:30,,28.04,0,28.04,28.04,-1,-46718,42899,89617,-3819,0,-13254,0,0,0,,13254,-13254
10,03-10-17,55,13:30,13:45,29.08,28.04,0,29.08,29.08,1,-49551,36973,86524,-12578,0,-187,473,0,0,,660,286
10,03-10-17,56,13:45,14:00,,26.51,0,26.51,26.51,-1,-36124,49573,85697,13449,0,-9605,0,0,0,,9605,-9605
10,03-10-17,57,14:00,14:15,,22.51,0,22.51,22.51,-1,-34160,81891,116051,47731,0,-26680,0,0,0,,26680,-26680
10,03-10-17,58,14:15,14:30,,28.78,0,28.78,28.78,-1,-36923,56858,93781,19935,0,-11604,0,0,0,,11604,-11604
10,03-10-17,59,14:30,14:45,,27.51,0,27.51,27.51,-1,-38429,58160,96589,19731,0,-2008,0,0,0,,2008,-2008
10,03-10-17,60,14:45,15:00,,27.51,0,27.51,27.51,-1,-40865,60240,101105,19375,0,-3829,0,0,0,,3829,-3829
10,03-10-17,61,15:00,15:15,,31.61,0,31.61,31.61,-1,-57560,54155,111715,-3405,0,-1380,0,0,0,,1380,-1380
10,03-10-17,62,15:15,15:30,,,0,29.81,29.81,0,-67635,55359,122994,-12276,0,0,0,0,0,,0,0
10,03-10-17,63,15:30,15:45,,,0,29.81,29.81,0,-57619,50300,107919,-7319,0,0,0,0,0,,0,0
10,03-10-17,64,15:45,16:00,,29.61,0,29.61,29.61,-1,-49026,58102,107128,9076,0,-754,0,0,0,,754,-754
10,03-10-17,65,16:00,16:15,,29.61,0,29.61,29.61,-1,-66515,60381,126896,-6134,0,-891,0,0,0,,891,-891
10,03-10-17,66,16:15,16:30,,,0,29.81,29.81,0,-50717,59573,110290,8856,0,0,0,0,0,,0,0
10,03-10-17,67,16:30,16:45,,,0,29.81,29.81,0,-61659,43404,105063,-18255,0,0,0,0,0,,0,0
10,03-10-17,68,16:45,17:00,40.15,,0,40.15,40.15,1,-77383,32495,109878,-44888,0,0,4132,0,0,,4132,4132
10,03-10-17,69,17:00,17:15,30.83,,0,30.83,30.83,1,-115478,72092,187570,-43386,0,0,1339,0,0,,1339,1339
10,03-10-17,70,17:15,17:30,46.37,,0,46.37,46.37,1,-94795,57617,152412,-37178,0,0,7746,0,0,,7746,7746
10,03-10-17,71,17:30,17:45,34.96,,0,34.96,34.96,1,-75149,55179,130328,-19970,0,0,10143,0,0,,10143,10143
10,03-10-17,72,17:45,18:00,35.37,,0,35.37,35.37,1,-74978,57241,132219,-17737,0,0,2594,0,0,,2594,2594
10,03-10-17,73,18:00,18:15,35.37,26.11,0,26.11,26.11,-1,-58507,63854,122361,5347,0,-3961,207,0,0,,4168,-3754
10,03-10-17,74,18:15,18:30,,26.51,0,26.51,26.51,-1,-61408,55738,117146,-5670,0,-6298,0,0,0,,6298,-6298
10,03-10-17,75,18:30,18:45,,,0,30.54,30.54,0,-53017,53800,106817,783,0,-492,0,0,0,,492,-492
10,03-10-17,76,18:45,19:00,492.5,,0,492.5,492.5,1,-89980,36968,126948,-53012,0,0,17619,0,0,,17619,17619
10,03-10-17,77,19:00,19:15,527.56,,0,527.56,527.56,1,-64986,73434,138420,8448,0,0,24936,0,0,,24936,24936
10,03-10-17,78,19:15,19:30,527.56,31.98,0,31.98,31.98,-1,-41688,83521,125209,41833,0,-622,106,0,0,,728,-516
10,03-10-17,79,19:30,19:45,,22.51,0,22.51,22.51,-1,-45798,74557,120355,28759,0,-11307,0,0,0,,11307,-11307
10,03-10-17,80,19:45,20:00,,21.87,0,21.87,21.87,-1,-37194,74683,111877,37489,0,-35079,0,0,0,,35079,-35079
10,03-10-17,81,20:00,20:15,32.2,21.87,0,32.2,32.2,1,-55653,53412,109065,-2241,0,-14141,689,0,0,,14830,-13452
10,03-10-17,82,20:15,20:30,32.2,31.58,0,31.58,31.58,-1,-39108,58922,98030,19814,0,-226,9,0,0,,235,-217
10,03-10-17,83,20:30,20:45,,26.2,0,26.2,26.2,-1,-27479,90347,117826,62868,0,-15815,0,0,0,,15815,-15815
10,03-10-17,84,20:45,21:00,,21.57,0,21.57,21.57,-1,-27831,119963,147794,92132,0,-21413,0,0,0,,21413,-21413
10,03-10-17,85,21:00,21:15,29.61,28.01,0,29.61,29.61,1,-66895,82746,149641,15851,0,-11598,494,0,0,,12092,-11104
10,03-10-17,86,21:15,21:30,,,0,33.26,33.26,0,-50899,88321,139220,37422,0,0,4,0,0,,4,4
10,03-10-17,87,21:30,21:45,,26.51,0,26.51,26.51,-1,-49070,131688,180758,82618,0,-1874,0,0,0,,1874,-1874
10,03-10-17,88,21:45,22:00,,-6.87,0,-6.87,-6.87,-1,-37603,129107,166710,91504,0,-42444,0,0,0,,42444,-42444
10,03-10-17,89,22:00,22:15,,30.76,0,30.76,30.76,-1,-61347,52056,113403,-9291,0,-10973,0,0,0,,10973,-10973
10,03-10-17,90,22:15,22:30,,23.77,0,23.77,23.77,-1,-31061,67060,98121,35999,0,-19831,0,0,0,,19831,-19831
10,03-10-17,91,22:30,22:45,,16.84,0,16.84,16.84,-1,-16443,85536,101979,69093,0,-30826,0,0,0,,30826,-30826
10,03-10-17,92,22:45,23:00,,16.84,0,16.84,16.84,-1,-40877,105848,146725,64971,0,-47788,0,0,0,,47788,-47788
10,03-10-17,93,23:00,23:15,30.54,6.98,0,31.5,6.98,2,-42696,47297,89993,4601,0,-29133,146,0,0,,29279,-28987
10,03-10-17,94,23:15,23:30,31.95,6.98,0,31.95,6.98,2,-33342,57525,90867,24183,0,-6027,695,0,0,,6722,-5332
10,03-10-17,95,23:30,23:45,,6.98,0,6.98,6.98,-1,-23661,76473,100134,52812,0,-24715,0,0,0,,24715,-24715
10,03-10-17,96,23:45,0:00,,-28.38,0,-28.38,-28.38,-1,-29902,72990,102892,43088,0,-39928,0,0,0,,39928,-39928
11,03-11-17,1,0:00,0:15,,-66.06,0,-66.06,-66.06,-1,-38332,128022,166354,89690,0,-34154,0,0,0,,34154,-34154
11,03-11-17,2,0:15,0:30,,,0,30.08,30.08,0,-44723,62957,107680,18234,0,-538,0,0,0,,538,-538
11,03-11-17,3,0:30,0:45,36.35,,0,36.35,36.35,1,-50631,31919,82550,-18712,0,0,4595,0,0,,4595,4595
11,03-11-17,4,0:45,1:00,32.98,,0,32.98,32.98,1,-118317,45980,164297,-72337,0,0,2621,0,0,,2621,2621
11,03-11-17,5,1:00,1:15,,29.98,0,29.98,29.98,-1,-38814,113090,151904,74276,0,-1269,0,0,0,,1269,-1269
11,03-11-17,6,1:15,1:30,,25.98,0,25.98,25.98,-1,-34035,49668,83703,15633,0,-1009,0,0,0,,1009,-1009
11,03-11-17,7,1:30,1:45,,24.09,0,24.09,24.09,-1,-26908,72522,99430,45614,0,-4492,0,0,0,,4492,-4492
11,03-11-17,8,1:45,2:00,,25.72,0,25.72,25.72,-1,-21329,87979,109308,66650,0,-6362,0,0,0,,6362,-6362
11,03-11-17,9,2:00,2:15,,21.44,0,21.44,21.44,-1,-27903,68089,95992,40186,0,-9155,0,0,0,,9155,-9155
11,03-11-17,10,2:15,2:30,,,0,30.87,30.87,0,-27286,61818,89104,34532,0,-110,0,0,0,,110,-110
11,03-11-17,11,2:30,2:45,,28.56,0,28.56,28.56,-1,-19583,61585,81168,42002,0,-1230,0,0,0,,1230,-1230
11,03-11-17,12,2:45,3:00,,-6.01,0,-6.01,-6.01,-1,-17955,60661,78616,42706,0,-23895,0,0,0,,23895,-23895
11,03-11-17,13,3:00,3:15,,25.98,0,25.98,25.98,-1,-30053,71792,101845,41739,0,-16270,0,0,0,,16270,-16270
11,03-11-17,14,3:15,3:30,,,0,30.86,30.86,0,-41155,62967,104122,21812,0,-284,0,0,0,,284,-284
11,03-11-17,15,3:30,3:45,,,0,30.86,30.86,0,-43316,64221,107537,20905,0,0,0,0,0,,0,0
11,03-11-17,16,3:45,4:00,,,0,30.86,30.86,0,-43439,67924,111363,24485,0,0,0,0,0,,0,0
11,03-11-17,17,4:00,4:15,,,0,30.86,30.86,0,-32708,76945,109653,44237,0,0,0,0,0,,0,0
11,03-11-17,18,4:15,4:30,,,0,30.86,30.86,0,-35547,78963,114510,43416,0,0,0,0,0,,0,0
11,03-11-17,19,4:30,4:45,,,0,30.86,30.86,0,-36093,76612,112705,40519,0,0,0,0,0,,0,0
11,03-11-17,20,4:45,5:00,,,0,30.86,30.86,0,-46574,68129,114703,21555,0,0,0,0,0,,0,0
11,03-11-17,21,5:00,5:15,,,0,30.86,30.86,0,-39601,81471,121072,41870,0,0,0,0,0,,0,0
11,03-11-17,22,5:15,5:30,,,0,30.86,30.86,0,-28596,72225,100821,43629,0,0,0,0,0,,0,0
11,03-11-17,23,5:30,5:45,,,0,30.86,30.86,0,-32955,60901,93856,27946,0,0,0,0,0,,0,0
11,03-11-17,24,5:45,6:00,,,0,30.86,30.86,0,-40386,57573,97959,17187,0,0,0,0,0,,0,0
11,03-11-17,25,6:00,6:15,,29.3,0,29.3,29.3,-1,-27437,101641,129078,74204,0,-17,0,0,0,,17,-17
11,03-11-17,26,6:15,6:30,,21.21,0,21.21,21.21,-1,-31256,73603,104859,42347,0,-3523,0,0,0,,3523,-3523
11,03-11-17,27,6:30,6:45,,,0,30.66,30.66,0,-49949,55195,105144,5246,0,0,0,0,0,,0,0
11,03-11-17,28,6:45,7:00,,,0,30.66,30.66,0,-55085,64704,119789,9619,0,0,0,0,0,,0,0
11,03-11-17,29,7:00,7:15,,,0,30.67,30.67,0,-67239,82194,149433,14955,0,0,0,0,0,,0,0
11,03-11-17,30,7:15,7:30,,31.03,0,31.03,31.03,-1,-50495,79603,130098,29108,0,-117,0,0,0,,117,-117
11,03-11-17,31,7:30,7:45,,,0,30.43,30.43,0,-65230,72571,137801,7341,0,0,0,0,0,,0,0
11,03-11-17,32,7:45,8:00,,,0,30.43,30.43,0,-80463,82739,163202,2276,0,0,0,0,0,,0,0
11,03-11-17,33,8:00,8:15,,29.55,0,29.55,29.55,-1,-23687,100012,123699,76325,0,-938,0,0,0,,938,-938
11,03-11-17,34,8:15,8:30,,26.92,0,26.92,26.92,-1,-18327,83535,101862,65208,0,-2775,0,0,0,,2775,-2775
11,03-11-17,35,8:30,8:45,,25.92,0,25.92,25.92,-1,-27936,50517,78453,22581,0,-2377,0,0,0,,2377,-2377
11,03-11-17,36,8:45,9:00,,29.55,0,29.55,29.55,-1,-54876,45203,100079,-9673,0,-1980,0,0,0,,1980,-1980
11,03-11-17,37,9:00,9:15,,31.37,0,31.37,31.37,-1,-22111,75649,97760,53538,0,-1608,0,0,0,,1608,-1608
11,03-11-17,38,9:15,9:30,,32.84,0,32.84,32.84,-1,-19504,59804,79308,40300,0,-110,0,0,0,,110,-110
11,03-11-17,39,9:30,9:45,,32.84,0,32.84,32.84,-1,-19515,71665,91180,52150,0,-405,0,0,0,,405,-405
11,03-11-17,40,9:45,10:00,,21.92,0,21.92,21.92,-1,-20252,89005,109257,68753,0,-2655,0,0,0,,2655,-2655
11,03-11-17,41,10:00,10:15,36.35,9.9,0,36.35,9.9,2,-70660,68342,139002,-2318,0,-13283,1004,0,0,,14287,-12279
11,03-11-17,42,10:15,10:30,36.35,9.9,0,36.35,36.35,1,-66022,61237,127259,-4785,0,-89,5914,0,0,,6003,5825
11,03-11-17,43,10:30,10:45,29.82,32.34,0,31.28,31.28,2,-59461,71748,131209,12287,0,-124,356,0,0,,480,232
11,03-11-17,44,10:45,11:00,,26.92,0,26.92,26.92,-1,-53014,68418,121432,15404,0,-355,0,0,0,,355,-355
11,03-11-17,45,11:00,11:15,,26.92,0,26.92,26.92,-1,-70959,69779,140738,-1180,0,-1268,0,0,0,,1268,-1268
11,03-11-17,46,11:15,11:30,,,0,31.16,31.16,0,-77138,50437,127575,-26701,0,0,0,0,0,,0,0
11,03-11-17,47,11:30,11:45,,,0,31.16,31.16,0,-81373,48517,129890,-32856,0,0,0,0,0,,0,0
11,03-11-17,48,11:45,12:00,,,0,31.16,31.16,0,-71526,49708,121234,-21818,0,0,0,0,0,,0,0
11,03-11-17,49,12:00,12:15,121.01,,0,121.01,121.01,1,-87286,45311,132597,-41975,0,0,20571,0,0,,20571,20571
11,03-11-17,50,12:15,12:30,42.3,,0,42.3,42.3,1,-54513,62215,116728,7702,0,0,24230,0,0,,24230,24230
11,03-11-17,51,12:30,12:45,42.3,32.19,0,32.19,32.19,-1,-42875,71206,114081,28331,0,-145,172,0,0,,317,27
11,03-11-17,52,12:45,13:00,,31.8,0,31.8,31.8,-1,-37495,68420,105915,30925,0,-292,0,0,0,,292,-292
11,03-11-17,53,13:00,13:15,,31.56,0,31.56,31.56,-1,-30362,78285,108647,47923,0,-1189,0,0,0,,1189,-1189
11,03-11-17,54,13:15,13:30,,25.92,0,25.92,25.92,-1,-37119,69050,106169,31931,0,-1661,0,0,0,,1661,-1661
11,03-11-17,55,13:30,13:45,,21.92,0,21.92,21.92,-1,-34620,68323,102943,33703,0,-19122,0,0,0,,19122,-19122
11,03-11-17,56,13:45,14:00,,26.21,0,26.21,26.21,-1,-38776,59227,98003,20451,0,-14432,0,0,0,,14432,-14432
11,03-11-17,57,14:00,14:15,,31.79,0,31.79,31.79,-1,-59675,51654,111329,-8021,0,-1774,0,0,0,,1774,-1774
11,03-11-17,58,14:15,14:30,36.35,,0,36.35,36.35,1,-63674,38293,101967,-25381,0,0,8774,0,0,,8774,8774
11,03-11-17,59,14:30,14:45,42.3,,0,42.3,42.3,1,-82706,36012,118718,-46694,0,0,37930,0,0,,37930,37930
11,03-11-17,60,14:45,15:00,42.3,,0,42.3,42.3,1,-89865,38464,128329,-51401,0,0,41949,0,0,,41949,41949
11,03-11-17,61,15:00,15:15,49.17,,0,49.17,49.17,1,-98411,28303,126714,-70108,0,0,49089,0,0,,49089,49089
11,03-11-17,62,15:15,15:30,52.29,,0,52.29,52.29,1,-94987,27574,122561,-67413,0,0,56640,0,0,,56640,56640
11,03-11-17,63,15:30,15:45,42.3,,0,42.3,42.3,1,-92429,30916,123345,-61513,0,0,49265,0,0,,49265,49265
11,03-11-17,64,15:45,16:00,42.3,,0,42.3,42.3,1,-80406,31632,112038,-48774,0,0,48240,0,0,,48240,48240
11,03-11-17,65,16:00,16:15,42.3,25.92,0,25.92,25.92,-1,-73892,77207,151099,3315,0,-1324,15630,0,0,,16954,14306
11,03-11-17,66,16:15,16:30,,,0,29.93,29.93,0,-78856,65097,143953,-13759,0,-71,0,0,0,,71,-71
11,03-11-17,67,16:30,16:45,36.35,,0,36.35,36.35,1,-96932,65985,162917,-30947,0,0,3520,0,0,,3520,3520
11,03-11-17,68,16:45,17:00,36.35,,0,36.35,36.35,1,-103624,68651,172275,-34973,0,0,13773,0,0,,13773,13773
11,03-11-17,69,17:00,17:15,32.3,26.92,0,26.92,26.92,-1,-97750,61463,159213,-36287,0,-577,7817,0,0,,8394,7240
11,03-11-17,70,17:15,17:30,32.3,25.21,0,25.21,25.21,-1,-51185,63649,114834,12464,0,-11937,40,0,0,,11977,-11897
11,03-11-17,71,17:30,17:45,,27.3,0,27.3,27.3,-1,-59376,77689,137065,18313,0,-8303,0,0,0,,8303,-8303
11,03-11-17,72,17:45,18:00,,,0,29.94,29.94,0,-61659,102357,164016,40698,0,-706,0,0,0,,706,-706
11,03-11-17,73,18:00,18:15,,9.57,0,9.57,9.57,-1,-70390,83645,154035,13255,0,-9503,0,0,0,,9503,-9503
11,03-11-17,74,18:15,18:30,,9.57,0,9.57,9.57,-1,-81149,72010,153159,-9139,0,-16295,0,0,0,,16295,-16295
11,03-11-17,75,18:30,18:45,32.3,9.57,0,32.3,32.3,1,-68988,60780,129768,-8208,0,-64,93,0,0,,157,29
11,03-11-17,76,18:45,19:00,94.02,,0,94.02,94.02,1,-94365,56069,150434,-38296,0,0,17924,0,0,,17924,17924
11,03-11-17,77,19:00,19:15,185.3,,0,185.3,185.3,1,-96944,52185,149129,-44759,0,0,49404,0,0,,49404,49404
11,03-11-17,78,19:15,19:30,35.18,23.75,0,23.75,23.75,-1,-61182,81087,142269,19905,0,-1540,16284,0,0,,17824,14744
11,03-11-17,79,19:30,19:45,35.18,21.92,0,21.92,21.92,-1,-45286,78701,123987,33415,0,-14035,15,0,0,,14050,-14020
11,03-11-17,80,19:45,20:00,,18.96,0,18.96,18.96,-1,-44399,74914,119313,30515,0,-41235,0,0,0,,41235,-41235
11,03-11-17,81,20:00,20:15,31.28,26.03,0,31.28,31.28,1,-59848,70042,129890,10194,0,-16936,631,0,0,,17567,-16305
11,03-11-17,82,20:15,20:30,,6.03,0,6.03,6.03,-1,-38355,72508,110863,34153,0,-16317,0,0,0,,16317,-16317
11,03-11-17,83,20:30,20:45,,3.5,0,3.5,3.5,-1,-39440,70103,109543,30663,0,-27244,0,0,0,,27244,-27244
11,03-11-17,84,20:45,21:00,,-15.28,0,-15.28,-15.28,-1,-39072,92694,131766,53622,0,-49138,0,0,0,,49138,-49138
11,03-11-17,85,21:00,21:15,30.21,21.92,0,30.21,30.21,1,-92166,72136,164302,-20030,0,-21600,44,0,0,,21644,-21556
11,03-11-17,86,21:15,21:30,30.3,21.92,0,30.3,30.3,1,-50289,79404,129693,29115,0,-5,583,0,0,,588,578
11,03-11-17,87,21:30,21:45,,27.5,0,27.5,27.5,-1,-32329,87374,119703,55045,0,-1322,0,0,0,,1322,-1322
11,03-11-17,88,21:45,22:00,,-66.06,0,-66.06,-66.06,-1,-28886,125599,154485,96713,0,-19781,0,0,0,,19781,-19781
11,03-11-17,89,22:00,22:15,,-66.06,0,-66.06,-66.06,-1,-65868,38987,104855,-26881,0,-24779,0,0,0,,24779,-24779
11,03-11-17,90,22:15,22:30,29.82,,0,29.82,29.82,1,-58150,32271,90421,-25879,0,0,6,0,0,,6,6
11,03-11-17,91,22:30,22:45,36.3,,0,36.3,36.3,1,-80217,53900,134117,-26317,0,0,3933,0,0,,3933,3933
11,03-11-17,92,22:45,23:00,36.3,,0,36.3,36.3,1,-102114,76468,178582,-25646,0,0,15090,0,0,,15090,15090
11,03-11-17,93,23:00,23:15,131.02,,0,131.02,131.02,1,-159642,69938,229580,-89704,0,0,29152,0,0,,29152,29152
11,03-11-17,94,23:15,23:30,131.02,,0,131.02,131.02,1,-127295,38314,165609,-88981,0,0,81155,0,0,,81155,81155
11,03-11-17,95,23:30,23:45,48.4,,0,48.4,48.4,1,-125986,62066,188052,-63920,0,0,58531,0,0,,58531,58531
11,03-11-17,96,23:45,0:00,68.02,,0,68.02,68.02,1,-140872,71163,212035,-69709,0,0,52567,0,0,,52567,52567
11,03-12-17,1,0:00,0:15,68.02,-17.78,0,-17.78,-17.78,-1,-83492,122969,206461,39477,0,-13601,11824,0,0,,25425,-1777
11,03-12-17,2,0:15,0:30,33.07,31.08,0,33.07,30.45,2,-101248,67624,168872,-33624,0,-585,1635,0,0,,2220,1050
11,03-12-17,3,0:30,0:45,36.3,,0,36.3,36.3,1,-91016,35100,126116,-55916,0,0,6160,0,0,,6160,6160
11,03-12-17,4,0:45,1:00,36.83,,0,36.83,36.83,1,-94051,28093,122144,-65958,0,0,6408,0,0,,6408,6408
11,03-12-17,5,1:00,1:15,29.12,31.08,0,31.08,31.08,-1,-71223,49718,120941,-21505,0,-120,1534,0,0,,1654,1414
11,03-12-17,6,1:15,1:30,29.82,,0,29.82,29.82,1,-63221,32163,95384,-31058,0,0,480,0,0,,480,480
11,03-12-17,7,1:30,1:45,,,0,30.1,30.1,0,-47839,37190,85029,-10649,0,0,0,0,0,,0,0
11,03-12-17,8,1:45,2:00,,25.3,0,25.3,25.3,-1,-38072,54905,92977,16833,0,-5643,0,0,0,,5643,-5643
11,03-12-17,9,2:00,2:15,34.82,18.31,0,34.82,18.31,2,-68418,47720,116138,-20698,0,-15665,558,0,0,,16223,-15107
11,03-12-17,10,2:15,2:30,42.3,18.31,0,42.3,42.3,1,-72165,30197,102362,-41968,0,-88,14365,0,0,,14453,14277
11,03-12-17,11,2:30,2:45,31.37,,0,31.37,31.37,1,-58801,31218,90019,-27583,0,0,7600,0,0,,7600,7600
11,03-12-17,12,2:45,3:00,,,0,30.45,30.45,0,-44911,27728,72639,-17183,0,0,380,0,0,,380,380
11,03-12-17,13,3:00,3:15,34.8,,0,34.8,34.8,1,-39806,21564,61370,-18242,0,0,4443,0,0,,4443,4443
11,03-12-17,14,3:15,3:30,29.12,30.3,0,30.3,30.3,-1,-27131,32890,60021,5759,0,-86,967,0,0,,1053,881
11,03-12-17,15,3:30,3:45,,29.3,0,29.3,29.3,-1,-19317,34536,53853,15219,0,-1375,0,0,0,,1375,-1375
11,03-12-17,16,3:45,4:00,,29.25,0,29.25,29.25,-1,-16690,40615,57305,23925,0,-2812,0,0,0,,2812,-2812
11,03-12-17,17,4:00,4:15,,30.3,0,30.3,30.3,-1,-21740,44000,65740,22260,0,-256,0,0,0,,256,-256
11,03-12-17,18,4:15,4:30,,26.67,0,26.67,26.67,-1,-17040,48840,65880,31800,0,-10066,0,0,0,,10066,-10066
11,03-12-17,19,4:30,4:45,,26.71,0,26.71,26.71,-1,-13127,42797,55924,29670,0,-14550,0,0,0,,14550,-14550
11,03-12-17,20,4:45,5:00,,,0,30.14,30.14,0,-9919,34815,44734,24896,0,-1229,0,0,0,,1229,-1229
11,03-12-17,21,5:00,5:15,,31.15,0,31.15,31.15,-1,-29992,25749,55741,-4243,0,-79,0,0,0,,79,-79
11,03-12-17,22,5:15,5:30,,,0,30.14,30.14,0,-29178,31514,60692,2336,0,0,0,0,0,,0,0
11,03-12-17,23,5:30,5:45,,,0,30.14,30.14,0,-30446,34554,65000,4108,0,0,0,0,0,,0,0
11,03-12-17,24,5:45,6:00,,,0,30.14,30.14,0,-27840,39267,67107,11427,0,0,0,0,0,,0,0
11,03-12-17,25,6:00,6:15,,,0,30.15,30.15,0,-39951,37580,77531,-2371,0,0,0,0,0,,0,0
11,03-12-17,26,6:15,6:30,33.94,,0,33.94,33.94,1,-40237,23095,63332,-17142,0,0,3992,0,0,,3992,3992
11,03-12-17,27,6:30,6:45,34.05,,0,34.05,34.05,1,-36510,15136,51646,-21374,0,0,8568,0,0,,8568,8568
11,03-12-17,28,6:45,7:00,31.87,29.37,0,29.37,29.37,-1,-19225,25638,44863,6413,0,-148,4923,0,0,,5071,4775
11,03-12-17,29,7:00,7:15,31.87,27.78,0,27.78,27.78,-1,-44577,53631,98208,9054,0,-3855,8,0,0,,3863,-3847
11,03-12-17,30,7:15,7:30,,25.93,0,25.93,25.93,-1,-30819,49105,79924,18286,0,-10604,0,0,0,,10604,-10604
11,03-12-17,31,7:30,7:45,42.37,29.32,0,42.37,29.32,2,-38300,21946,60246,-16354,0,-8956,1946,0,0,,10902,-7010
11,03-12-17,32,7:45,8:00,51.94,29.32,0,51.94,51.94,1,-59844,20462,80306,-39382,0,-250,33325,0,0,,33575,33075
11,03-12-17,33,8:00,8:15,33.83,26.89,0,26.89,26.89,-1,-42953,52177,95130,9224,0,-2318,15275,0,0,,17593,12957
11,03-12-17,34,8:15,8:30,,29.85,0,29.85,29.85,-1,-45139,52791,97930,7652,0,-1989,0,0,0,,1989,-1989
11,03-12-17,35,8:30,8:45,32.94,29.85,0,32.94,32.94,1,-65007,33902,98909,-31105,0,-53,3148,0,0,,3201,3095
11,03-12-17,36,8:45,9:00,35.32,,0,35.32,35.32,1,-68609,42699,111308,-25910,0,0,18644,0,0,,18644,18644
11,03-12-17,37,9:00,9:15,32.37,22.63,0,32.37,22.63,2,-28163,62923,91086,34760,0,-4577,10476,0,0,,15053,5899
11,03-12-17,38,9:15,9:30,32.37,-1.54,0,-1.54,-1.54,-1,-38087,100534,138621,62447,0,-19197,26,0,0,,19223,-19171
11,03-12-17,39,9:30,9:45,,-32.44,0,-32.44,-32.44,-1,-58531,98908,157439,40377,0,-47771,0,0,0,,47771,-47771
11,03-12-17,40,9:45,10:00,,-1.78,0,-1.78,-1.78,-1,-53916,129548,183464,75632,0,-50935,0,0,0,,50935,-50935
11,03-12-17,41,10:00,10:15,36.37,26.69,0,36.37,36.37,1,-73817,62827,136644,-10990,0,-23403,935,0,0,,24338,-22468
11,03-12-17,42,10:15,10:30,41.07,28.73,0,41.07,28.73,2,-51680,61804,113484,10124,0,-849,5641,0,0,,6490,4792
11,03-12-17,43,10:30,10:45,,-32.16,0,-32.16,-32.16,-1,-38821,86782,125603,47961,0,-35629,0,0,0,,35629,-35629
11,03-12-17,44,10:45,11:00,,26.8,0,26.8,26.8,-1,-37301,69568,106869,32267,0,-28267,0,0,0,,28267,-28267
11,03-12-17,45,11:00,11:15,42.37,29.37,0,42.37,42.37,1,-68314,50338,118652,-17976,0,-12811,2520,0,0,,15331,-10291
11,03-12-17,46,11:15,11:30,42.37,29.37,0,42.37,42.37,1,-67301,49875,117176,-17426,0,-30,20729,0,0,,20759,20699
11,03-12-17,47,11:30,11:45,30.21,,0,30.21,30.21,1,-64045,63487,127532,-558,0,0,2935,0,0,,2935,2935
11,03-12-17,48,11:45,12:00,,,0,31.1,31.1,0,-38085,68178,106263,30093,0,0,59,0,0,,59,59
11,03-12-17,49,12:00,12:15,,,0,30.95,30.95,0,-70330,65957,136287,-4373,0,0,0,0,0,,0,0
11,03-12-17,50,12:15,12:30,36.37,,0,36.37,36.37,1,-76457,56283,132740,-20174,0,0,6232,0,0,,6232,6232
11,03-12-17,51,12:30,12:45,32.37,,0,32.37,32.37,1,-72007,71087,143094,-920,0,0,8446,0,0,,8446,8446
11,03-12-17,52,12:45,13:00,29.82,28.13,0,30.95,28.13,2,-69509,81556,151065,12047,0,-669,700,0,0,,1369,31
11,03-12-17,53,13:00,13:15,,-55.56,0,-55.56,-55.56,-1,-36535,118378,154913,81843,0,-42127,0,0,0,,42127,-42127
11,03-12-17,54,13:15,13:30,,18.78,0,18.78,18.78,-1,-38317,83052,121369,44735,0,-57797,0,0,0,,57797,-57797
11,03-12-17,55,13:30,13:45,,23.78,0,23.78,23.78,-1,-62751,85003,147754,22252,0,-49083,0,0,0,,49083,-49083
11,03-12-17,56,13:45,14:00,,25.37,0,25.37,25.37,-1,-78701,96475,175176,17774,0,-15303,0,0,0,,15303,-15303
11,03-12-17,57,14:00,14:15,,25.37,0,25.37,25.37,-1,-40247,97638,137885,57391,0,-15201,0,0,0,,15201,-15201
11,03-12-17,58,14:15,14:30,,17.71,0,17.71,17.71,-1,-21342,117749,139091,96407,0,-33815,0,0,0,,33815,-33815
11,03-12-17,59,14:30,14:45,,-50.59,0,-50.59,-50.59,-1,-25194,87327,112521,62133,0,-59111,0,0,0,,59111,-59111
11,03-12-17,60,14:45,15:00,,-9.91,0,-9.91,-9.91,-1,-43006,107590,150596,64584,0,-51393,0,0,0,,51393,-51393
11,03-12-17,61,15:00,15:15,,-58.94,0,-58.94,-58.94,-1,-66007,129755,195762,63748,0,-40311,0,0,0,,40311,-40311
11,03-12-17,62,15:15,15:30,,23.85,0,23.85,23.85,-1,-59652,128555,188207,68903,0,-5883,0,0,0,,5883,-5883
11,03-12-17,63,15:30,15:45,,19.16,0,19.16,19.16,-1,-64261,106552,170813,42291,0,-23871,0,0,0,,23871,-23871
11,03-12-17,64,15:45,16:00,,27.02,0,27.02,27.02,-1,-69446,91054,160500,21608,0,-22457,0,0,0,,22457,-22457
11,03-12-17,65,16:00,16:15,,12.2,0,12.2,12.2,-1,-71584,125410,196994,53826,0,-28726,0,0,0,,28726,-28726
11,03-12-17,66,16:15,16:30,,11.4,0,11.4,11.4,-1,-59184,102783,161967,43599,0,-44265,0,0,0,,44265,-44265
11,03-12-17,67,16:30,16:45,42.37,29.37,0,42.37,42.37,1,-76875,72865,149740,-4010,0,-13335,1724,0,0,,15059,-11611
11,03-12-17,68,16:45,17:00,51.27,,0,51.27,51.27,1,-97617,55897,153514,-41720,0,0,30509,0,0,,30509,30509
11,03-12-17,69,17:00,17:15,51.27,20.01,0,20.01,20.01,-1,-47489,113392,160881,65903,0,-5228,12055,0,0,,17283,6827
11,03-12-17,70,17:15,17:30,,31.41,0,31.41,31.41,-1,-52874,71142,124016,18268,0,-2183,0,0,0,,2183,-2183
11,03-12-17,71,17:30,17:45,,31.41,0,31.41,31.41,-1,-58706,59931,118637,1225,0,-802,0,0,0,,802,-802
11,03-12-17,72,17:45,18:00,,30.34,0,30.34,30.34,-1,-72314,72307,144621,-7,0,-2213,0,0,0,,2213,-2213
11,03-12-17,73,18:00,18:15,,-3.18,0,-3.18,-3.18,-1,-51228,87087,138315,35859,0,-9690,0,0,0,,9690,-9690
11,03-12-17,74,18:15,18:30,,-16.78,0,-16.78,-16.78,-1,-26333,73711,100044,47378,0,-34055,0,0,0,,34055,-34055
11,03-12-17,75,18:30,18:45,,,0,30.99,30.99,0,-29484,83116,112600,53632,0,-1156,0,0,0,,1156,-1156
11,03-12-17,76,18:45,19:00,36.37,,0,36.37,36.37,1,-65483,79640,145123,14157,0,0,679,0,0,,679,679
11,03-12-17,77,19:00,19:15,168.55,,0,168.55,168.55,1,-116965,24875,141840,-92090,0,0,43517,0,0,,43517,43517
11,03-12-17,78,19:15,19:30,48.12,,0,48.12,48.12,1,-55691,32990,88681,-22701,0,0,32501,0,0,,32501,32501
11,03-12-17,79,19:30,19:45,32.94,,0,32.94,32.94,1,-55194,49916,105110,-5278,0,0,10182,0,0,,10182,10182
11,03-12-17,80,19:45,20:00,36.09,,0,36.09,36.09,1,-51811,43334,95145,-8477,0,0,3822,0,0,,3822,3822
11,03-12-17,81,20:00,20:15,57.42,,0,57.42,57.42,1,-85229,42040,127269,-43189,0,0,29825,0,0,,29825,29825
11,03-12-17,82,20:15,20:30,39.44,,0,39.44,39.44,1,-80408,40051,120459,-40357,0,0,35797,0,0,,35797,35797
11,03-12-17,83,20:30,20:45,39.44,17.01,0,17.01,17.01,-1,-46048,64341,110389,18293,0,-4793,14920,0,0,,19713,10127
11,03-12-17,84,20:45,21:00,,17.01,0,17.01,17.01,-1,-49246,69716,118962,20470,0,-10839,0,0,0,,10839,-10839
11,03-12-17,85,21:00,21:15,,21.99,0,21.99,21.99,-1,-37807,91814,129621,54007,0,-10295,0,0,0,,10295,-10295
11,03-12-17,86,21:15,21:30,,13.05,0,13.05,13.05,-1,-31287,89004,120291,57717,0,-4336,0,0,0,,4336,-4336
11,03-12-17,87,21:30,21:45,,13.05,0,13.05,13.05,-1,-28134,65116,93250,36982,0,-8194,0,0,0,,8194,-8194
11,03-12-17,88,21:45,22:00,,25.99,0,25.99,25.99,-1,-34994,96330,131324,61336,0,-656,0,0,0,,656,-656
11,03-12-17,89,22:00,22:15,46.85,24.14,0,46.85,24.14,2,-72618,40478,113096,-32140,0,-3157,5200,0,0,,8357,2043
11,03-12-17,90,22:15,22:30,84.12,,0,84.12,84.12,1,-72030,33160,105190,-38870,0,0,36921,0,0,,36921,36921
11,03-12-17,91,22:30,22:45,32.37,30.38,0,32.37,30.38,2,-44160,67071,111231,22911,0,-344,10321,0,0,,10665,9977
11,03-12-17,92,22:45,23:00,,29.21,0,29.21,29.21,-1,-39736,92581,132317,52845,0,-133,0,0,0,,133,-133
11,03-12-17,93,23:00,23:15,,21.99,0,21.99,21.99,-1,-62764,81580,144344,18816,0,-6077,0,0,0,,6077,-6077
11,03-12-17,94,23:15,23:30,,9.9,0,9.9,9.9,-1,-47925,68194,116119,20269,0,-5722,0,0,0,,5722,-5722
11,03-12-17,95,23:30,23:45,,1.29,0,1.29,1.29,-1,-33362,70655,104017,37293,0,-18279,0,0,0,,18279,-18279
11,03-12-17,96,23:45,0:00,,13.65,0,13.65,13.65,-1,-43369,66961,110330,23592,0,-25118,0,0,0,,25118,-25118
11,03/13/2017,1,0:00,0:15,,-41.19,0,-41.19,-41.19,-1,-52749,133179,185928,80430,0,-24137,0,0,0,,24137,-24137
11,03/13/2017,2,0:15,0:30,,31.81,0,31.81,31.81,-1,-54450,69118,123568,14668,0,-1054,0,0,0,,1054,-1054
11,03/13/2017,3,0:30,0:45,,25.37,0,25.37,25.37,-1,-52889,74802,127691,21913,0,-3877,0,0,0,,3877,-3877
11,03/13/2017,4,0:45,1:00,,25.03,0,25.03,25.03,-1,-51371,61492,112863,10121,0,-22870,0,0,0,,22870,-22870
11,03/13/2017,5,1:00,1:15,36.37,31.4,0,36.37,36.37,1,-38651,38393,77044,-258,0,-3390,1340,0,0,,4730,-2050
11,03/13/2017,6,1:15,1:30,37.4,25.24,0,37.4,25.24,2,-32243,53312,85555,21069,0,-3146,4791,0,0,,7937,1645
11,03/13/2017,7,1:30,1:45,,24.92,0,24.92,24.92,-1,-28587,47128,75715,18541,0,-8049,0,0,0,,8049,-8049
11,03/13/2017,8,1:45,2:00,,29.37,0,29.37,29.37,-1,-30293,34520,64813,4227,0,-1947,0,0,0,,1947,-1947
11,03/13/2017,9,2:00,2:15,,31.37,0,31.37,31.37,-1,-11580,53913,65493,42333,0,-1206,0,0,0,,1206,-1206
11,03/13/2017,10,2:15,2:30,,,0,30.79,30.79,0,-25969,48284,74253,22315,0,-43,0,0,0,,43,-43
11,03/13/2017,11,2:30,2:45,,,0,30.79,30.79,0,-30306,45137,75443,14831,0,0,0,0,0,,0,0
11,03/13/2017,12,2:45,3:00,,27.03,0,27.03,27.03,-1,-35590,48637,84227,13047,0,-2380,0,0,0,,2380,-2380
11,03/13/2017,13,3:00,3:15,,27.03,0,27.03,27.03,-1,-15018,66975,81993,51957,0,-2868,0,0,0,,2868,-2868
11,03/13/2017,14,3:15,3:30,,29.37,0,29.37,29.37,-1,-18465,50932,69397,32467,0,-489,0,0,0,,489,-489
11,03/13/2017,15,3:30,3:45,,,0,30.35,30.35,0,-18325,45587,63912,27262,0,-74,0,0,0,,74,-74
11,03/13/2017,16,3:45,4:00,,,0,30.35,30.35,0,-19388,46790,66178,27402,0,0,0,0,0,,0,0
11,03/13/2017,17,4:00,4:15,,,0,30.75,30.75,0,-31953,57222,89175,25269,0,0,0,0,0,,0,0
11,03/13/2017,18,4:15,4:30,,25.85,0,25.85,25.85,-1,-22109,66489,88598,44380,0,-5284,0,0,0,,5284,-5284
11,03/13/2017,19,4:30,4:45,,29.37,0,29.37,29.37,-1,-3972,66922,70894,62950,0,-4876,0,0,0,,4876,-4876
11,03/13/2017,20,4:45,5:00,,29.37,0,29.37,29.37,-1,-6913,114112,121025,107199,0,-587,0,0,0,,587,-587
11,03/13/2017,21,5:00,5:15,34.06,,0,34.06,34.06,1,-45886,57953,103839,12067,0,0,1277,0,0,,1277,1277
11,03/13/2017,22,5:15,5:30,,31.67,0,31.67,31.67,-1,-22587,70410,92997,47823,0,-151,0,0,0,,151,-151
11,03/13/2017,23,5:30,5:45,,31.67,0,31.67,31.67,-1,-29791,66954,96745,37163,0,-8,0,0,0,,8,-8
11,03/13/2017,24,5:45,6:00,,31.28,0,31.28,31.28,-1,-35790,101122,136912,65332,0,-357,0,0,0,,357,-357
11,03/13/2017,25,6:00,6:15,46.33,31.28,0,46.33,46.33,1,-158113,66778,224891,-91335,0,-33,10000,0,0,,10033,9967
11,03/13/2017,26,6:15,6:30,46.33,30.37,0,30.37,30.37,-1,-32819,74831,107650,42012,0,-245,199,0,0,,444,-46
11,03/13/2017,27,6:30,6:45,,29.27,0,29.27,29.27,-1,-23966,85003,108969,61037,0,-2587,0,0,0,,2587,-2587
11,03/13/2017,28,6:45,7:00,,,0,31.2,31.2,0,-59593,120188,179781,60595,0,0,0,0,0,,0,0
11,03/13/2017,29,7:00,7:15,,21.99,0,21.99,21.99,-1,-23966,102939,126905,78973,0,-4762,0,0,0,,4762,-4762
11,03/13/2017,30,7:15,7:30,,-10.41,0,-10.41,-10.41,-1,-18034,72702,90736,54668,0,-29676,0,0,0,,29676,-29676
11,03/13/2017,31,7:30,7:45,,6.98,0,6.98,6.98,-1,-12124,57184,69308,45060,0,-31967,0,0,0,,31967,-31967
11,03/13/2017,32,7:45,8:00,,31.3,0,31.3,31.3,-1,-35222,59935,95157,24713,0,-10617,0,0,0,,10617,-10617
11,03/13/2017,33,8:00,8:15,,-46.36,0,-46.36,-46.36,-1,-23763,155924,179687,132161,0,-48624,0,0,0,,48624,-48624
11,03/13/2017,34,8:15,8:30,,8.57,0,8.57,8.57,-1,-58112,100774,158886,42662,0,-40500,0,0,0,,40500,-40500
11,03/13/2017,35,8:30,8:45,,24.79,0,24.79,24.79,-1,-59580,76808,136388,17228,0,-31544,0,0,0,,31544,-31544
11,03/13/2017,36,8:45,9:00,,34.31,0,34.31,34.31,-1,-53923,47190,101113,-6733,0,-6206,0,0,0,,6206,-6206
11,03/13/2017,37,9:00,9:15,,,0,31.89,31.89,0,-60643,57068,117711,-3575,0,0,0,0,0,,0,0
11,03/13/2017,38,9:15,9:30,,29.31,0,29.31,29.31,-1,-48429,56018,104447,7589,0,-2474,0,0,0,,2474,-2474
11,03/13/2017,39,9:30,9:45,,3.5,0,3.5,3.5,-1,-29580,84944,114524,55364,0,-36160,0,0,0,,36160,-36160
11,03/13/2017,40,9:45,10:00,,21.77,0,21.77,21.77,-1,-44155,90470,134625,46315,0,-45736,0,0,0,,45736,-45736
11,03/13/2017,41,10:00,10:15,34.22,29.03,0,34.22,34.22,1,-74082,53172,127254,-20910,0,-17135,963,0,0,,18098,-16172
11,03/13/2017,42,10:15,10:30,34.22,29.03,0,29.03,29.03,-1,-45491,59245,104736,13754,0,-3828,206,0,0,,4034,-3622
11,03/13/2017,43,10:30,10:45,,26.99,0,26.99,26.99,-1,-28987,50173,79160,21186,0,-18993,0,0,0,,18993,-18993
11,03/13/2017,44,10:45,11:00,,14.63,0,14.63,14.63,-1,-25825,73199,99024,47374,0,-28767,0,0,0,,28767,-28767
11,03/13/2017,45,11:00,11:15,,29.55,0,29.55,29.55,-1,-66834,62265,129099,-4569,0,-14557,0,0,0,,14557,-14557
11,03/13/2017,46,11:15,11:30,,,0,31.6,31.6,0,-65355,64397,129752,-958,0,-1957,0,0,0,,1957,-1957
11,03/13/2017,47,11:30,11:45,,,0,31.6,31.6,0,-57861,62313,120174,4452,0,0,0,0,0,,0,0
11,03/13/2017,48,11:45,12:00,,31.48,0,31.48,31.48,-1,-61420,49699,111119,-11721,0,-28,0,0,0,,28,-28
11,03/13/2017,49,12:00,12:15,,27.85,0,27.85,27.85,-1,-63970,71547,135517,7577,0,-2071,0,0,0,,2071,-2071
11,03/13/2017,50,12:15,12:30,,26.99,0,26.99,26.99,-1,-61260,66955,128215,5695,0,-6092,0,0,0,,6092,-6092
11,03/13/2017,51,12:30,12:45,,27.4,0,27.4,27.4,-1,-47693,65914,113607,18221,0,-5198,0,0,0,,5198,-5198
11,03/13/2017,52,12:45,13:00,,25.99,0,25.99,25.99,-1,-37150,60211,97361,23061,0,-2568,0,0,0,,2568,-2568
11,03/13/2017,53,13:00,13:15,,25.76,0,25.76,25.76,-1,-83742,90669,174411,6927,0,-5327,0,0,0,,5327,-5327
11,03/13/2017,54,13:15,13:30,,,0,30.91,30.91,0,-56440,68582,125022,12142,0,-70,0,0,0,,70,-70
11,03/13/2017,55,13:30,13:45,,,0,30.91,30.91,0,-52927,66413,119340,13486,0,0,0,0,0,,0,0
11,03/13/2017,56,13:45,14:00,,,0,30.91,30.91,0,-69168,60721,129889,-8447,0,0,0,0,0,,0,0
11,03/13/2017,57,14:00,14:15,29.82,,0,29.82,29.82,1,-83855,49057,132912,-34798,0,0,62,0,0,,62,62
11,03/13/2017,58,14:15,14:30,32.37,,0,32.37,32.37,1,-103611,39601,143212,-64010,0,0,2436,0,0,,2436,2436
11,03/13/2017,59,14:30,14:45,29.82,,0,29.82,29.82,1,-97589,27427,125016,-70162,0,0,163,0,0,,163,163
11,03/13/2017,60,14:45,15:00,29.82,,0,29.82,29.82,1,-107978,42015,149993,-65963,0,0,61,0,0,,61,61
11,03/13/2017,61,15:00,15:15,131.02,,0,131.02,131.02,1,-105066,54480,159546,-50586,0,0,16803,0,0,,16803,16803
11,03/13/2017,62,15:15,15:30,32.37,,0,32.37,32.37,1,-74881,71076,145957,-3805,0,0,4257,0,0,,4257,4257
11,03/13/2017,63,15:30,15:45,36.37,,0,36.37,36.37,1,-71060,56136,127196,-14924,0,0,9977,0,0,,9977,9977
11,03/13/2017,64,15:45,16:00,37.14,,0,37.14,37.14,1,-70679,52951,123630,-17728,0,0,18715,0,0,,18715,18715
11,03/13/2017,65,16:00,16:15,37.14,32,0,32,32,-1,-63908,83433,147341,19525,0,-416,2821,0,0,,3237,2405
11,03/13/2017,66,16:15,16:30,,32,0,32,32,-1,-44186,67470,111656,23284,0,-888,0,0,0,,888,-888
11,03/13/2017,67,16:30,16:45,33.32,32,0,33.32,31.22,2,-42607,47155,89762,4548,0,-190,237,0,0,,427,47
11,03/13/2017,68,16:45,17:00,42.61,,0,42.61,42.61,1,-69672,32829,102501,-36843,0,0,22441,0,0,,22441,22441
11,03/13/2017,69,17:00,17:15,32.37,26.99,0,26.99,26.99,-1,-42305,47983,90288,5678,0,-4505,10034,0,0,,14539,5529
11,03/13/2017,70,17:15,17:30,29.82,26.99,0,29.82,29.82,1,-48576,19421,67997,-29155,0,-5726,12,0,0,,5738,-5714
11,03/13/2017,71,17:30,17:45,31.98,,0,31.98,31.98,1,-65867,23214,89081,-42653,0,0,938,0,0,,938,938
11,03/13/2017,72,17:45,18:00,31.88,,0,31.88,31.88,1,-62295,40124,102419,-22171,0,0,2682,0,0,,2682,2682
11,03/13/2017,73,18:00,18:15,31.88,15.71,0,15.71,15.71,-1,-22897,52971,75868,30074,0,-16159,319,0,0,,16478,-15840
11,03/13/2017,74,18:15,18:30,,26.99,0,26.99,26.99,-1,-19335,60314,79649,40979,0,-27136,0,0,0,,27136,-27136
11,03/13/2017,75,18:30,18:45,31.67,29.71,0,31.67,31.67,1,-22427,50853,73280,28426,0,-16864,14,0,0,,16878,-16850
11,03/13/2017,76,18:45,19:00,55.9,29.71,0,55.9,55.9,1,-56846,21678,78524,-35168,0,-1064,10123,0,0,,11187,9059
11,03/13/2017,77,19:00,19:15,69.49,,0,69.49,69.49,1,-53923,41918,95841,-12005,0,0,19672,0,0,,19672,19672
11,03/13/2017,78,19:15,19:30,36.91,,0,36.91,36.91,1,-51582,40833,92415,-10749,0,0,2126,0,0,,2126,2126
11,03/13/2017,79,19:30,19:45,,,0,31.57,31.57,0,-45931,45941,91872,10,0,0,586,0,0,,586,586
11,03/13/2017,80,19:45,20:00,,29.03,0,29.03,29.03,-1,-40410,46831,87241,6421,0,-1824,0,0,0,,1824,-1824
11,03/13/2017,81,20:00,20:15,55.51,29.03,0,55.51,55.51,1,-69509,32924,102433,-36585,0,-76,5981,0,0,,6057,5905
11,03/13/2017,82,20:15,20:30,,,0,31.67,31.67,0,-53368,37870,91238,-15498,0,0,458,0,0,,458,458
11,03/13/2017,83,20:30,20:45,,21.99,0,21.99,21.99,-1,-33470,59382,92852,25912,0,-10186,0,0,0,,10186,-10186
11,03/13/2017,84,20:45,21:00,,21.99,0,21.99,21.99,-1,-36009,72521,108530,36512,0,-31293,0,0,0,,31293,-31293
11,03/13/2017,85,21:00,21:15,32.37,28.72,0,32.37,32.37,1,-94649,36083,130732,-58566,0,-14486,532,0,0,,15018,-13954
11,03/13/2017,86,21:15,21:30,32.37,30.78,0,30.78,30.78,-1,-45546,38093,83639,-7453,0,-101,127,0,0,,228,26
11,03/13/2017,87,21:30,21:45,,21.99,0,21.99,21.99,-1,-21071,54382,75453,33311,0,-19459,0,0,0,,19459,-19459
11,03/13/2017,88,21:45,22:00,,-0.38,0,-0.38,-0.38,-1,-40689,99206,139895,58517,0,-58313,0,0,0,,58313,-58313
11,03/13/2017,89,22:00,22:15,32.94,-0.38,0,32.94,32.94,1,-87859,10642,98501,-77217,0,-18141,770,0,0,,18911,-17371
11,03/13/2017,90,22:15,22:30,32.94,,0,32.94,32.94,1,-56021,26937,82958,-29084,0,0,2276,0,0,,2276,2276
11,03/13/2017,91,22:30,22:45,,,0,31.61,31.61,0,-33527,38594,72121,5067,0,0,434,0,0,,434,434
11,03/13/2017,92,22:45,23:00,,8.57,0,8.57,8.57,-1,-70110,86702,156812,16592,0,-7570,0,0,0,,7570,-7570
11,03/13/2017,93,23:00,23:15,32.94,-63.73,0,32.94,-63.73,2,-36130,62621,98751,26491,0,-16753,675,0,0,,17428,-16078
11,03/13/2017,94,23:15,23:30,32.94,29.97,0,29.97,29.97,-1,-45893,39060,84953,-6833,0,-157,360,0,0,,517,203
11,03/13/2017,95,23:30,23:45,,28.67,0,28.67,28.67,-1,-36931,59398,96329,22467,0,-2872,0,0,0,,2872,-2872
11,03/13/2017,96,23:45,0:00,,8.57,0,8.57,8.57,-1,-37465,78934,116399,41469,0,-21029,0,0,0,,21029,-21029
11,03/14/2017,1,0:00,0:15,,-52.91,0,-52.91,-52.91,-1,-67757,54914,122671,-12843,0,-36509,0,0,0,,36509,-36509
11,03/14/2017,2,0:15,0:30,29.41,20.92,0,29.71,20.92,2,-69879,54436,124315,-15443,0,-2738,521,0,0,,3259,-2217
11,03/14/2017,3,0:30,0:45,,7.91,0,7.91,7.91,-1,-36002,54498,90500,18496,0,-8174,0,0,0,,8174,-8174
11,03/14/2017,4,0:45,1:00,,19.35,0,19.35,19.35,-1,-38344,85663,124007,47319,0,-29567,0,0,0,,29567,-29567
11,03/14/2017,5,1:00,1:15,44.76,22.41,0,44.76,44.76,1,-37408,41826,79234,4418,0,-21210,1139,0,0,,22349,-20071
11,03/14/2017,6,1:15,1:30,56.79,,0,56.79,56.79,1,-30073,67649,97722,37576,0,0,9628,0,0,,9628,9628
11,03/14/2017,7,1:30,1:45,56.79,26.41,0,26.41,26.41,-1,-19393,106088,125481,86695,0,-1644,44,0,0,,1688,-1600
11,03/14/2017,8,1:45,2:00,,-60.22,0,-60.22,-60.22,-1,-16020,118009,134029,101989,0,-22915,0,0,0,,22915,-22915
11,03/14/2017,9,2:00,2:15,,-61.58,0,-61.58,-61.58,-1,-45109,59455,104564,14346,0,-43171,0,0,0,,43171,-43171
11,03/14/2017,10,2:15,2:30,,-62.26,0,-62.26,-62.26,-1,-20211,81950,102161,61739,0,-15674,0,0,0,,15674,-15674
11,03/14/2017,11,2:30,2:45,,-62.26,0,-62.26,-62.26,-1,-40294,74635,114929,34341,0,-42664,0,0,0,,42664,-42664
11,03/14/2017,12,2:45,3:00,,-18.59,0,-18.59,-18.59,-1,-28667,91780,120447,63113,0,-52086,0,0,0,,52086,-52086
11,03/14/2017,13,3:00,3:15,,14.78,0,14.78,14.78,-1,-35880,60243,96123,24363,0,-30264,0,0,0,,30264,-30264
11,03/14/2017,14,3:15,3:30,,15.55,0,15.55,15.55,-1,-15004,66555,81559,51551,0,-1567,0,0,0,,1567,-1567
11,03/14/2017,15,3:30,3:45,,-30.64,0,-30.64,-30.64,-1,-13764,54464,68228,40700,0,-26511,0,0,0,,26511,-26511
11,03/14/2017,16,3:45,4:00,,15.55,0,15.55,15.55,-1,-16158,60714,76872,44556,0,-22530,0,0,0,,22530,-22530
11,03/14/2017,17,4:00,4:15,,26.41,0,26.41,26.41,-1,-29431,41220,70651,11789,0,-13689,0,0,0,,13689,-13689
11,03/14/2017,18,4:15,4:30,,29.55,0,29.55,29.55,-1,-28138,45929,74067,17791,0,-233,0,0,0,,233,-233
11,03/14/2017,19,4:30,4:45,,27.41,0,27.41,27.41,-1,-28807,80301,109108,51494,0,-2732,0,0,0,,2732,-2732
11,03/14/2017,20,4:45,5:00,,24.78,0,24.78,24.78,-1,-31603,93177,124780,61574,0,-9025,0,0,0,,9025,-9025
11,03/14/2017,21,5:00,5:15,,,0,29.71,29.71,0,-41063,78363,119426,37300,0,-1646,0,0,0,,1646,-1646
11,03/14/2017,22,5:15,5:30,,,0,29.71,29.71,0,-25408,62697,88105,37289,0,0,0,0,0,,0,0
11,03/14/2017,23,5:30,5:45,,,0,29.71,29.71,0,-31150,71752,102902,40602,0,0,0,0,0,,0,0
11,03/14/2017,24,5:45,6:00,,,0,30.24,30.24,0,-38856,73831,112687,34975,0,0,0,0,0,,0,0
11,03/14/2017,25,6:00,6:15,,19.35,0,19.35,19.35,-1,-84570,99036,183606,14466,0,-2717,0,0,0,,2717,-2717
11,03/14/2017,26,6:15,6:30,,8.25,0,8.25,8.25,-1,-34881,70467,105348,35586,0,-16476,0,0,0,,16476,-16476
11,03/14/2017,27,6:30,6:45,,,0,30.59,30.59,0,-33491,39413,72904,5922,0,-72,0,0,0,,72,-72
11,03/14/2017,28,6:45,7:00,29.57,,0,29.57,29.57,1,-58915,52324,111239,-6591,0,0,527,0,0,,527,527
11,03/14/2017,29,7:00,7:15,29.18,-52.91,0,30.59,-52.91,2,-45192,141001,186193,95809,0,-34669,109,0,0,,34778,-34560
11,03/14/2017,30,7:15,7:30,,13.86,0,13.86,13.86,-1,-46852,95628,142480,48776,0,-59405,0,0,0,,59405,-59405
11,03/14/2017,31,7:30,7:45,32.37,26.41,0,32.37,26.41,2,-74663,60054,134717,-14609,0,-15037,718,0,0,,15755,-14319
11,03/14/2017,32,7:45,8:00,,,0,30.59,30.59,0,-103810,53534,157344,-50276,0,0,3,0,0,,3,3
11,03/14/2017,33,8:00,8:15,,30,0,30,30,-1,-82398,122976,205374,40578,0,-2,0,0,0,,2,-2
11,03/14/2017,34,8:15,8:30,,30,0,30,30,-1,-81350,92679,174029,11329,0,-232,0,0,0,,232,-232
11,03/14/2017,35,8:30,8:45,29.57,,0,29.57,29.57,1,-92012,63703,155715,-28309,0,0,609,0,0,,609,609
11,03/14/2017,36,8:45,9:00,37.1,,0,37.1,37.1,1,-87427,55963,143390,-31464,0,0,4179,0,0,,4179,4179
11,03/14/2017,37,9:00,9:15,29.57,,0,29.57,29.57,1,-97867,89268,187135,-8599,0,0,2573,0,0,,2573,2573
11,03/14/2017,38,9:15,9:30,29.57,4.69,0,4.69,4.69,-1,-75764,117186,192950,41422,0,-19705,583,0,0,,20288,-19122
11,03/14/2017,39,9:30,9:45,,-52.91,0,-52.91,-52.91,-1,-42208,128163,170371,85955,0,-71595,0,0,0,,71595,-71595
11,03/14/2017,40,9:45,10:00,,-52.91,0,-52.91,-52.91,-1,-39960,118751,158711,78791,0,-90828,0,0,0,,90828,-90828
11,03/14/2017,41,10:00,10:15,49,19.34,0,49,49,1,-95406,56280,151686,-39126,0,-28811,1509,0,0,,30320,-27302
11,03/14/2017,42,10:15,10:30,29.18,22.41,0,22.41,22.41,-1,-71697,96821,168518,25124,0,-6192,855,0,0,,7047,-5337
11,03/14/2017,43,10:30,10:45,,14.77,0,14.77,14.77,-1,-54001,110603,164604,56602,0,-47372,0,0,0,,47372,-47372
11,03/14/2017,44,10:45,11:00,,4.3,0,4.3,4.3,-1,-52332,123019,175351,70687,0,-74029,0,0,0,,74029,-74029
11,03/14/2017,45,11:00,11:15,,12.82,0,12.82,12.82,-1,-91920,96881,188801,4961,0,-35976,0,0,0,,35976,-35976
11,03/14/2017,46,11:15,11:30,,22.41,0,22.41,22.41,-1,-66073,93974,160047,27901,0,-32016,0,0,0,,32016,-32016
11,03/14/2017,47,11:30,11:45,,4.65,0,4.65,4.65,-1,-51877,105362,157239,53485,0,-46807,0,0,0,,46807,-46807
11,03/14/2017,48,11:45,12:00,,-10.43,0,-10.43,-10.43,-1,-52820,122981,175801,70161,0,-73848,0,0,0,,73848,-73848
11,03/14/2017,49,12:00,12:15,,3.94,0,3.94,3.94,-1,-34913,143007,177920,108094,0,-79924,0,0,0,,79924,-79924
11,03/14/2017,50,12:15,12:30,,14.66,0,14.66,14.66,-1,-41140,118867,160007,77727,0,-67951,0,0,0,,67951,-67951
11,03/14/2017,51,12:30,12:45,,9.57,0,9.57,9.57,-1,-44327,118124,162451,73797,0,-69110,0,0,0,,69110,-69110
11,03/14/2017,52,12:45,13:00,,0.78,0,0.78,0.78,-1,-70099,114626,184725,44527,0,-68241,0,0,0,,68241,-68241
11,03/14/2017,53,13:00,13:15,,22.41,0,22.41,22.41,-1,-58877,117374,176251,58497,0,-23000,0,0,0,,23000,-23000
11,03/14/2017,54,13:15,13:30,31.68,22.41,0,31.68,31.68,1,-93098,87237,180335,-5861,0,-65,1267,0,0,,1332,1202
11,03/14/2017,55,13:30,13:45,29.34,,0,29.34,29.34,1,-118300,90172,208472,-28128,0,0,257,0,0,,257,257
11,03/14/2017,56,13:45,14:00,,,0,29.06,29.06,0,-131337,107690,239027,-23647,0,0,28,0,0,,28,28
11,03/14/2017,57,14:00,14:15,,,0,29.06,29.06,0,-121628,90475,212103,-31153,0,0,0,0,0,,0,0
11,03/14/2017,58,14:15,14:30,,,0,29.06,29.06,0,-120615,82373,202988,-38242,0,0,0,0,0,,0,0
11,03/14/2017,59,14:30,14:45,,,0,29.06,29.06,0,-118600,74827,193427,-43773,0,0,0,0,0,,0,0
11,03/14/2017,60,14:45,15:00,29.34,,0,29.34,29.34,1,-128135,53762,181897,-74373,0,0,7,0,0,,7,7
11,03/14/2017,61,15:00,15:15,42.37,,0,42.37,42.37,1,-207223,94970,302193,-112253,0,0,11417,0,0,,11417,11417
11,03/14/2017,62,15:15,15:30,185.37,,0,185.37,185.37,1,-168287,97570,265857,-70717,0,0,42471,0,0,,42471,42471
11,03/14/2017,63,15:30,15:45,42.37,,0,42.37,42.37,1,-149855,112209,262064,-37646,0,0,17737,0,0,,17737,17737
11,03/14/2017,64,15:45,16:00,185.37,,0,185.37,185.37,1,-176435,99738,276173,-76697,0,0,41854,0,0,,41854,41854
11,03/14/2017,65,16:00,16:15,32.37,,0,32.37,32.37,1,-208921,166593,375514,-42328,0,0,8514,0,0,,8514,8514
11,03/14/2017,66,16:15,16:30,,28.29,0,28.29,28.29,-1,-181275,161543,342818,-19732,0,-846,0,0,0,,846,-846
11,03/14/2017,67,16:30,16:45,34.54,29.36,0,34.54,34.54,1,-185563,138402,323965,-47161,0,-453,423,0,0,,876,-30
11,03/14/2017,68,16:45,17:00,36.56,,0,36.56,36.56,1,-219769,122090,341859,-97679,0,0,9726,0,0,,9726,9726
11,03/14/2017,69,17:00,17:15,40.41,,0,40.41,40.41,1,-228765,113700,342465,-115065,0,0,22668,0,0,,22668,22668
11,03/14/2017,70,17:15,17:30,47.15,,0,47.15,47.15,1,-224490,104324,328814,-120166,0,0,9232,0,0,,9232,9232
11,03/14/2017,71,17:30,17:45,87.23,,0,87.23,87.23,1,-226843,109834,336677,-117009,0,0,26440,0,0,,26440,26440
11,03/14/2017,72,17:45,18:00,57.23,,0,57.23,57.23,1,-200460,123106,323566,-77354,0,0,25146,0,0,,25146,25146
11,03/14/2017,73,18:00,18:15,37.23,-0.57,0,-0.57,-0.57,-1,-119758,149644,269402,29886,0,-10170,12844,0,0,,23014,2674
11,03/14/2017,74,18:15,18:30,34.54,-0.57,0,34.54,34.54,1,-146386,137733,284119,-8653,0,-16947,214,0,0,,17161,-16733
11,03/14/2017,75,18:30,18:45,39.05,27.41,0,39.05,27.41,2,-139378,133619,272997,-5759,0,-1108,1190,0,0,,2298,82
11,03/14/2017,76,18:45,19:00,34.54,27.41,0,34.54,34.54,1,-147891,122068,269959,-25823,0,-33,1222,0,0,,1255,1189
11,03/14/2017,77,19:00,19:15,34.54,18.95,0,18.95,18.95,-1,-125683,156392,282075,30709,0,-11792,1380,0,0,,13172,-10412
11,03/14/2017,78,19:15,19:30,,24,0,24,24,-1,-125532,162420,287952,36888,0,-24216,0,0,0,,24216,-24216
11,03/14/2017,79,19:30,19:45,,15.23,0,15.23,15.23,-1,-127139,171912,299051,44773,0,-36872,0,0,0,,36872,-36872
11,03/14/2017,80,19:45,20:00,,22.41,0,22.41,22.41,-1,-127960,157429,285389,29469,0,-35080,0,0,0,,35080,-35080
11,03/14/2017,81,20:00,20:15,36.37,27.41,0,36.37,27.41,2,-174314,167624,341938,-6690,0,-12906,2524,0,0,,15430,-10382
11,03/14/2017,82,20:15,20:30,,22.56,0,22.56,22.56,-1,-141348,161028,302376,19680,0,-4849,0,0,0,,4849,-4849
11,03/14/2017,83,20:30,20:45,,20.35,0,20.35,20.35,-1,-140756,173973,314729,33217,0,-31240,0,0,0,,31240,-31240
11,03/14/2017,84,20:45,21:00,,7.91,0,7.91,7.91,-1,-151882,194389,346271,42507,0,-50986,0,0,0,,50986,-50986
11,03/14/2017,85,21:00,21:15,32.3,13.23,0,32.3,13.23,2,-131382,154622,286004,23240,0,-29449,314,0,0,,29763,-29135
11,03/14/2017,86,21:15,21:30,32.37,-16.9,0,32.37,-16.9,2,-129521,176872,306393,47351,0,-16371,238,0,0,,16609,-16133
11,03/14/2017,87,21:30,21:45,,-18.61,0,-18.61,-18.61,-1,-134396,189532,323928,55136,0,-55877,0,0,0,,55877,-55877
11,03/14/2017,88,21:45,22:00,,7.91,0,7.91,7.91,-1,-154598,211683,366281,57085,0,-52821,0,0,0,,52821,-52821
11,03/14/2017,89,22:00,22:15,,1.23,0,1.23,1.23,-1,-120214,73642,193856,-46572,0,-39452,0,0,0,,39452,-39452
11,03/14/2017,90,22:15,22:30,32.3,24.1,0,32.3,24.1,2,-110536,67656,178192,-42880,0,-4517,174,0,0,,4691,-4343
11,03/14/2017,91,22:30,22:45,,-68.22,0,-68.22,-68.22,-1,-75309,127063,202372,51754,0,-39268,0,0,0,,39268,-39268
11,03/14/2017,92,22:45,23:00,,-68.22,0,-68.22,-68.22,-1,-110921,137044,247965,26123,0,-84131,0,0,0,,84131,-84131
11,03/14/2017,93,23:00,23:15,32.3,22.41,0,32.3,22.41,2,-48252,26285,74537,-21967,0,-22711,188,0,0,,22899,-22523
11,03/14/2017,94,23:15,23:30,,8.91,0,8.91,8.91,-1,-25923,42822,68745,16899,0,-8579,0,0,0,,8579,-8579
11,03/14/2017,95,23:30,23:45,,-1.3,0,-1.3,-1.3,-1,-42099,67807,109906,25708,0,-29383,0,0,0,,29383,-29383
11,03/14/2017,96,23:45,0:00,,26.32,0,26.32,26.32,-1,-56756,76066,132822,19310,0,-20527,0,0,0,,20527,-20527
11,03/15/2017,1,0:00,0:15,,10.09,0,10.09,10.09,-1,-30419,97614,128033,67195,0,-20109,0,0,0,,20109,-20109
11,03/15/2017,2,0:15,0:30,,19.18,0,19.18,19.18,-1,-22748,72835,95583,50087,0,-23588,0,0,0,,23588,-23588
11,03/15/2017,3,0:30,0:45,,8.9,0,8.9,8.9,-1,-31537,70274,101811,38737,0,-37483,0,0,0,,37483,-37483
11,03/15/2017,4,0:45,1:00,,21.64,0,21.64,21.64,-1,-38223,84455,122678,46232,0,-28282,0,0,0,,28282,-28282
11,03/15/2017,5,1:00,1:15,28.74,21.03,0,28.74,28.74,1,-27162,38882,66044,11720,0,-20497,108,0,0,,20605,-20389
11,03/15/2017,6,1:15,1:30,30.16,8.9,0,30.16,8.9,2,-30247,67553,97800,37306,0,-11997,82,0,0,,12079,-11915
11,03/15/2017,7,1:30,1:45,,9.22,0,9.22,9.22,-1,-37195,58104,95299,20909,0,-30373,0,0,0,,30373,-30373
11,03/15/2017,8,1:45,2:00,,23.73,0,23.73,23.73,-1,-39009,65364,104373,26355,0,-12377,0,0,0,,12377,-12377
11,03/15/2017,9,2:00,2:15,,23.73,0,23.73,23.73,-1,-31604,36151,67755,4547,0,-16537,0,0,0,,16537,-16537
11,03/15/2017,10,2:15,2:30,,23.73,0,23.73,23.73,-1,-27487,39625,67112,12138,0,-4680,0,0,0,,4680,-4680
11,03/15/2017,11,2:30,2:45,,23.03,0,23.03,23.03,-1,-29716,41352,71068,11636,0,-13132,0,0,0,,13132,-13132
11,03/15/2017,12,2:45,3:00,,21.74,0,21.74,21.74,-1,-31815,51526,83341,19711,0,-13691,0,0,0,,13691,-13691
11,03/15/2017,13,3:00,3:15,,21.74,0,21.74,21.74,-1,-13738,58360,72098,44622,0,-29804,0,0,0,,29804,-29804
11,03/15/2017,14,3:15,3:30,,6.6,0,6.6,6.6,-1,-15449,68054,83503,52605,0,-41132,0,0,0,,41132,-41132
11,03/15/2017,15,3:30,3:45,,21.74,0,21.74,21.74,-1,-36471,63541,100012,27070,0,-36540,0,0,0,,36540,-36540
11,03/15/2017,16,3:45,4:00,,27.99,0,27.99,27.99,-1,-53516,71343,124859,17827,0,-17770,0,0,0,,17770,-17770
11,03/15/2017,17,4:00,4:15,33.38,27.99,0,33.38,33.38,1,-53579,84098,137677,30519,0,-10425,1799,0,0,,12224,-8626
11,03/15/2017,18,4:15,4:30,33.38,27.99,0,33.38,33.38,1,-55214,77774,132988,22560,0,-13,4834,0,0,,4847,4821
11,03/15/2017,19,4:30,4:45,28.74,,0,28.74,28.74,1,-52890,77797,130687,24907,0,0,1016,0,0,,1016,1016
11,03/15/2017,20,4:45,5:00,38.74,,0,38.74,38.74,1,-55258,70030,125288,14772,0,0,3400,0,0,,3400,3400
11,03/15/2017,21,5:00,5:15,42.39,29.29,0,42.39,28.67,2,-146965,139913,286878,-7052,0,-220,6919,0,0,,7139,6699
11,03/15/2017,22,5:15,5:30,32.74,26.74,0,32.74,26.74,2,-126194,129779,255973,3585,0,-2501,625,0,0,,3126,-1876
11,03/15/2017,23,5:30,5:45,36.89,,0,36.89,36.89,1,-118524,117244,235768,-1280,0,0,9122,0,0,,9122,9122
11,03/15/2017,24,5:45,6:00,38.74,,0,38.74,38.74,1,-111803,121513,233316,9710,0,0,21520,0,0,,21520,21520
11,03/15/2017,25,6:00,6:15,34.06,21.87,0,34.06,21.87,2,-218164,206241,424405,-11923,0,-894,16506,0,0,,17400,15612
11,03/15/2017,26,6:15,6:30,34.06,-11.2,0,-11.2,-11.2,-1,-163772,191782,355554,28010,0,-16299,1799,0,0,,18098,-14500
11,03/15/2017,27,6:30,6:45,34.06,-11.2,0,34.06,34.06,1,-167821,160040,327861,-7781,0,-182,2647,0,0,,2829,2465
11,03/15/2017,28,6:45,7:00,36.55,,0,36.55,36.55,1,-212929,178475,391404,-34454,0,0,16614,0,0,,16614,16614
11,03/15/2017,29,7:00,7:15,29.09,6.6,0,29.71,6.6,2,-148778,209491,358269,60713,0,-7778,7237,0,0,,15015,-541
11,03/15/2017,30,7:15,7:30,,30.33,0,30.33,30.33,-1,-159467,178612,338079,19145,0,-1355,0,0,0,,1355,-1355
11,03/15/2017,31,7:30,7:45,36.55,30.33,0,36.55,36.55,1,-198158,169364,367522,-28794,0,-242,3672,0,0,,3914,3430
11,03/15/2017,32,7:45,8:00,30.16,,0,30.16,30.16,1,-242946,171886,414832,-71060,0,0,2760,0,0,,2760,2760
11,03/15/2017,33,8:00,8:15,130.57,,0,130.57,130.57,1,-198259,192089,390348,-6170,0,0,7661,0,0,,7661,7661
11,03/15/2017,34,8:15,8:30,443.23,29.29,0,443.23,29.29,2,-177654,187042,364696,9388,0,-32,34451,0,0,,34483,34419
11,03/15/2017,35,8:30,8:45,32.55,20.05,0,32.55,20.05,2,-174420,175825,350245,1405,0,-7898,1739,0,0,,9637,-6159
11,03/15/2017,36,8:45,9:00,38,20.05,0,38,38,1,-193699,162848,356547,-30851,0,-6,3493,0,0,,3499,3487
11,03/15/2017,37,9:00,9:15,48.4,,0,48.4,48.4,1,-206356,164603,370959,-41753,0,0,10925,0,0,,10925,10925
11,03/15/2017,38,9:15,9:30,32.55,,0,32.55,32.55,1,-191556,177696,369252,-13860,0,0,6166,0,0,,6166,6166
11,03/15/2017,39,9:30,9:45,32.55,5.23,0,5.23,5.23,-1,-193870,246037,439907,52167,0,-12158,378,0,0,,12536,-11780
11,03/15/2017,40,9:45,10:00,,-1.86,0,-1.86,-1.86,-1,-195316,223671,418987,28355,0,-36927,0,0,0,,36927,-36927
11,03/15/2017,41,10:00,10:15,30.16,29.45,0,30.16,29.45,2,-179968,183271,363239,3303,0,-2525,267,0,0,,2792,-2258
11,03/15/2017,42,10:15,10:30,,-4.3,0,-4.3,-4.3,-1,-169616,221236,390852,51620,0,-28319,0,0,0,,28319,-28319
11,03/15/2017,43,10:30,10:45,,-48.19,0,-48.19,-48.19,-1,-152192,233638,385830,81446,0,-51812,0,0,0,,51812,-51812
11,03/15/2017,44,10:45,11:00,,-52.03,0,-52.03,-52.03,-1,-143092,245678,388770,102586,0,-102642,0,0,0,,102642,-102642
11,03/15/2017,45,11:00,11:15,,-8.56,0,-8.56,-8.56,-1,-132369,199564,331933,67195,0,-50944,0,0,0,,50944,-50944
11,03/15/2017,46,11:15,11:30,,20.09,0,20.09,20.09,-1,-132075,205035,337110,72960,0,-46433,0,0,0,,46433,-46433
11,03/15/2017,47,11:30,11:45,,6.6,0,6.6,6.6,-1,-139468,223419,362887,83951,0,-55011,0,0,0,,55011,-55011
11,03/15/2017,48,11:45,12:00,,6.6,0,6.6,6.6,-1,-138093,215059,353152,76966,0,-60527,0,0,0,,60527,-60527
11,03/15/2017,49,12:00,12:15,,21.38,0,21.38,21.38,-1,-156989,194929,351918,37940,0,-44170,0,0,0,,44170,-44170
11,03/15/2017,50,12:15,12:30,,6.26,0,6.26,6.26,-1,-148064,202397,350461,54333,0,-48417,0,0,0,,48417,-48417
11,03/15/2017,51,12:30,12:45,,6.26,0,6.26,6.26,-1,-142841,209615,352456,66774,0,-66640,0,0,0,,66640,-66640
11,03/15/2017,52,12:45,13:00,,-5.73,0,-5.73,-5.73,-1,-139615,221733,361348,82118,0,-78361,0,0,0,,78361,-78361
11,03/15/2017,53,13:00,13:15,,-52.68,0,-52.68,-52.68,-1,-148181,203442,351623,55261,0,-85058,0,0,0,,85058,-85058
11,03/15/2017,54,13:15,13:30,,-52.68,0,-52.68,-52.68,-1,-189229,178183,367412,-11046,0,-69483,0,0,0,,69483,-69483
11,03/15/2017,55,13:30,13:45,,-9,0,-9,-9,-1,-158503,172634,331137,14131,0,-61466,0,0,0,,61466,-61466
11,03/15/2017,56,13:45,14:00,,14.3,0,14.3,14.3,-1,-168686,166177,334863,-2509,0,-62937,0,0,0,,62937,-62937
11,03/15/2017,57,14:00,14:15,,7.6,0,7.6,7.6,-1,-159976,196974,356950,36998,0,-61950,0,0,0,,61950,-61950
11,03/15/2017,58,14:15,14:30,,22.56,0,22.56,22.56,-1,-168177,176170,344347,7993,0,-40951,0,0,0,,40951,-40951
11,03/15/2017,59,14:30,14:45,,25.03,0,25.03,25.03,-1,-172698,181152,353850,8454,0,-28006,0,0,0,,28006,-28006
11,03/15/2017,60,14:45,15:00,,12.87,0,12.87,12.87,-1,-158861,189234,348095,30373,0,-45275,0,0,0,,45275,-45275
11,03/15/2017,61,15:00,15:15,,13.19,0,13.19,13.19,-1,-144741,192463,337204,47722,0,-57807,0,0,0,,57807,-57807
11,03/15/2017,62,15:15,15:30,,25.72,0,25.72,25.72,-1,-151890,177832,329722,25942,0,-26241,0,0,0,,26241,-26241
11,03/15/2017,63,15:30,15:45,,25.72,0,25.72,25.72,-1,-149660,190948,340608,41288,0,-6420,0,0,0,,6420,-6420
11,03/15/2017,64,15:45,16:00,,26.72,0,26.72,26.72,-1,-154964,182372,337336,27408,0,-8322,0,0,0,,8322,-8322
11,03/15/2017,65,16:00,16:15,,6.6,0,6.6,6.6,-1,-151239,189531,340770,38292,0,-24558,0,0,0,,24558,-24558
11,03/15/2017,66,16:15,16:30,,6.6,0,6.6,6.6,-1,-171084,188903,359987,17819,0,-37700,0,0,0,,37700,-37700
11,03/15/2017,67,16:30,16:45,30.65,6.6,0,30.65,30.65,1,-175794,172864,348658,-2930,0,-4402,582,0,0,,4984,-3820
11,03/15/2017,68,16:45,17:00,28.7,,0,28.7,28.7,1,-183763,156451,340214,-27312,0,0,881,0,0,,881,881
11,03/15/2017,69,17:00,17:15,,,0,29.65,29.65,0,-177910,153222,331132,-24688,0,0,0,0,0,,0,0
11,03/15/2017,70,17:15,17:30,,,0,29.65,29.65,0,-194082,144365,338447,-49717,0,0,0,0,0,,0,0
11,03/15/2017,71,17:30,17:45,29.09,,0,29.09,29.09,1,-189455,143813,333268,-45642,0,0,24,0,0,,24,24
11,03/15/2017,72,17:45,18:00,75.02,,0,75.02,75.02,1,-189224,157076,346300,-32148,0,0,18937,0,0,,18937,18937
11,03/15/2017,73,18:00,18:15,34.06,-46.34,0,-46.34,-46.34,-1,-137198,190984,328182,53786,0,-16009,8327,0,0,,24336,-7682
11,03/15/2017,74,18:15,18:30,,-46.34,0,-46.34,-46.34,-1,-149476,176854,326330,27378,0,-30082,0,0,0,,30082,-30082
11,03/15/2017,75,18:30,18:45,,,0,29.65,29.65,0,-146731,169023,315754,22292,0,-1528,0,0,0,,1528,-1528
11,03/15/2017,76,18:45,19:00,36.89,,0,36.89,36.89,1,-165518,163056,328574,-2462,0,0,580,0,0,,580,580
11,03/15/2017,77,19:00,19:15,37.96,,0,37.96,37.96,1,-162245,156030,318275,-6215,0,0,3070,0,0,,3070,3070
11,03/15/2017,78,19:15,19:30,185.55,,0,185.55,185.55,1,-179417,146146,325563,-33271,0,0,13658,0,0,,13658,13658
11,03/15/2017,79,19:30,19:45,119,,0,119,119,1,-154488,144281,298769,-10207,0,0,31481,0,0,,31481,31481
11,03/15/2017,80,19:45,20:00,119,28.97,0,28.97,28.97,-1,-139721,161865,301586,22144,0,-1950,2037,0,0,,3987,87
11,03/15/2017,81,20:00,20:15,30.16,29.92,0,30.16,29.65,2,-189450,180667,370117,-8783,0,-1401,444,0,0,,1845,-957
11,03/15/2017,82,20:15,20:30,30.16,,0,30.16,30.16,1,-179928,171282,351210,-8646,0,0,928,0,0,,928,928
11,03/15/2017,83,20:30,20:45,32.55,,0,32.55,32.55,1,-156722,155568,312290,-1154,0,0,1116,0,0,,1116,1116
11,03/15/2017,84,20:45,21:00,,29.11,0,29.11,29.11,-1,-143622,154822,298444,11200,0,-308,0,0,0,,308,-308
11,03/15/2017,85,21:00,21:15,219.33,29.28,0,219.33,29.28,2,-201199,161409,362608,-39790,0,-258,19389,0,0,,19647,19131
11,03/15/2017,86,21:15,21:30,36.98,26.72,0,26.72,26.72,-1,-163753,190385,354138,26632,0,-528,9961,0,0,,10489,9433
11,03/15/2017,87,21:30,21:45,,25.72,0,25.72,25.72,-1,-140170,190488,330658,50318,0,-4408,0,0,0,,4408,-4408
11,03/15/2017,88,21:45,22:00,,6.6,0,6.6,6.6,-1,-132130,203236,335366,71106,0,-25743,0,0,0,,25743,-25743
11,03/15/2017,89,22:00,22:15,,6.6,0,6.6,6.6,-1,-218389,163027,381416,-55362,0,-20172,0,0,0,,20172,-20172
11,03/15/2017,90,22:15,22:30,30.55,29.29,0,30.55,29.29,2,-170941,163071,334012,-7870,0,-164,740,0,0,,904,576
11,03/15/2017,91,22:30,22:45,30.55,25.72,0,25.72,25.72,-1,-133683,185446,319129,51763,0,-4228,8,0,0,,4236,-4220
11,03/15/2017,92,22:45,23:00,,-52.68,0,-52.68,-52.68,-1,-129805,214063,343868,84258,0,-35501,0,0,0,,35501,-35501
11,03/15/2017,93,23:00,23:15,32.55,-52.68,0,32.55,32.55,1,-116593,92688,209281,-23905,0,-29285,90,0,0,,29375,-29195
11,03/15/2017,94,23:15,23:30,34.66,-52.68,0,34.66,34.66,1,-96201,88027,184228,-8174,0,-206,1168,0,0,,1374,962
11,03/15/2017,95,23:30,23:45,32.55,,0,32.55,32.55,1,-75280,85795,161075,10515,0,0,1185,0,0,,1185,1185
11,03/15/2017,96,23:45,0:00,32.55,-28.76,0,-28.76,-28.76,-1,-92942,130877,223819,37935,0,-10033,1,0,0,,10034,-10032
11,03/16/2017,1,0:00,0:15,,-68.34,0,-68.34,-68.34,-1,-62355,141745,204100,79390,0,-50240,0,0,0,,50240,-50240
11,03/16/2017,2,0:15,0:30,,26.04,0,26.04,26.04,-1,-44731,56051,100782,11320,0,-14974,0,0,0,,14974,-14974
11,03/16/2017,3,0:30,0:45,,25.04,0,25.04,25.04,-1,-36387,48480,84867,12093,0,-28588,0,0,0,,28588,-28588
11,03/16/2017,4,0:45,1:00,30.4,30.09,0,30.4,28.82,2,-74183,53857,128040,-20326,0,-8644,805,0,0,,9449,-7839
11,03/16/2017,5,1:00,1:15,39.04,28.29,0,39.04,28.29,2,-62749,41354,104103,-21395,0,-1418,2231,0,0,,3649,813
11,03/16/2017,6,1:15,1:30,28.94,30.19,0,30.19,30.19,-1,-47822,48601,96423,779,0,-143,500,0,0,,643,357
11,03/16/2017,7,1:30,1:45,,29.21,0,29.21,29.21,-1,-40618,34016,74634,-6602,0,-645,0,0,0,,645,-645
11,03/16/2017,8,1:45,2:00,,28.29,0,28.29,28.29,-1,-36154,40185,76339,4031,0,-785,0,0,0,,785,-785
11,03/16/2017,9,2:00,2:15,39.04,27.69,0,39.04,27.69,2,-60811,36131,96942,-24680,0,-1930,4342,0,0,,6272,2412
11,03/16/2017,10,2:15,2:30,39.04,,0,39.04,39.04,1,-62963,38163,101126,-24800,0,0,6085,0,0,,6085,6085
11,03/16/2017,11,2:30,2:45,,,0,28.77,28.77,0,-67771,45057,112828,-22714,0,0,0,0,0,,0,0
11,03/16/2017,12,2:45,3:00,,30.49,0,30.49,30.49,-1,-66722,48400,115122,-18322,0,-149,0,0,0,,149,-149
11,03/16/2017,13,3:00,3:15,30.4,30.46,0,30.4,28.77,2,-40708,37785,78493,-2923,0,-422,157,0,0,,579,-265
11,03/16/2017,14,3:15,3:30,32.06,,0,32.06,32.06,1,-57664,31447,89111,-26217,0,0,3973,0,0,,3973,3973
11,03/16/2017,15,3:30,3:45,,,0,28.77,28.77,0,-52860,34428,87288,-18432,0,0,0,0,0,,0,0
11,03/16/2017,16,3:45,4:00,,,0,28.77,28.77,0,-50239,37943,88182,-12296,0,0,0,0,0,,0,0
11,03/16/2017,17,4:00,4:15,,25.04,0,25.04,25.04,-1,-22431,54718,77149,32287,0,-2675,0,0,0,,2675,-2675
11,03/16/2017,18,4:15,4:30,,19.85,0,19.85,19.85,-1,-23465,54092,77557,30627,0,-29493,0,0,0,,29493,-29493
11,03/16/2017,19,4:30,4:45,,25.1,0,25.1,25.1,-1,-14578,42687,57265,28109,0,-8739,0,0,0,,8739,-8739
11,03/16/2017,20,4:45,5:00,,23.11,0,23.11,23.11,-1,-9909,50997,60906,41088,0,-12862,0,0,0,,12862,-12862
11,03/16/2017,21,5:00,5:15,,-24.76,0,-24.76,-24.76,-1,-8409,91988,100397,83579,0,-32809,0,0,0,,32809,-32809
11,03/16/2017,22,5:15,5:30,,0.72,0,0.72,0.72,-1,-19995,69164,89159,49169,0,-52271,0,0,0,,52271,-52271
11,03/16/2017,23,5:30,5:45,,30.09,0,30.09,30.09,-1,-21126,53160,74286,32034,0,-7390,0,0,0,,7390,-7390
11,03/16/2017,24,5:45,6:00,32.06,,0,32.06,32.06,1,-22720,59915,82635,37195,0,0,1252,0,0,,1252,1252
11,03/16/2017,25,6:00,6:15,32.06,,0,32.06,32.06,1,-82166,70523,152689,-11643,0,0,1061,0,0,,1061,1061
11,03/16/2017,26,6:15,6:30,,22.39,0,22.39,22.39,-1,-29233,69983,99216,40750,0,-7680,0,0,0,,7680,-7680
11,03/16/2017,27,6:30,6:45,,28.13,0,28.13,28.13,-1,-41545,66562,108107,25017,0,-10507,0,0,0,,10507,-10507
11,03/16/2017,28,6:45,7:00,,28.13,0,28.13,28.13,-1,-56449,83451,139900,27002,0,-2431,0,0,0,,2431,-2431
11,03/16/2017,29,7:00,7:15,,-50.09,0,-50.09,-50.09,-1,-76839,142603,219442,65764,0,-32403,0,0,0,,32403,-32403
11,03/16/2017,30,7:15,7:30,,29.13,0,29.13,29.13,-1,-75586,82738,158324,7152,0,-2963,0,0,0,,2963,-2963
11,03/16/2017,31,7:30,7:45,,26.52,0,26.52,26.52,-1,-47074,41166,88240,-5908,0,-9297,0,0,0,,9297,-9297
11,03/16/2017,32,7:45,8:00,,,0,29.7,29.7,0,-90961,36264,127225,-54697,0,-526,0,0,0,,526,-526
11,03/16/2017,33,8:00,8:15,28.94,,0,28.94,28.94,1,-90377,123496,213873,33119,0,0,62,0,0,,62,62
11,03/16/2017,34,8:15,8:30,28.94,,0,28.94,28.94,1,-98411,103283,201694,4872,0,0,121,0,0,,121,121
11,03/16/2017,35,8:30,8:45,,34.19,0,34.19,34.19,-1,-91833,88962,180795,-2871,0,-234,0,0,0,,234,-234
11,03/16/2017,36,8:45,9:00,,29.99,0,29.99,29.99,-1,-74890,80974,155864,6084,0,-3845,0,0,0,,3845,-3845
11,03/16/2017,37,9:00,9:15,,34.79,0,34.79,34.79,-1,-99147,89936,189083,-9211,0,-619,0,0,0,,619,-619
11,03/16/2017,38,9:15,9:30,,29.05,0,29.05,29.05,-1,-85020,94684,179704,9664,0,-8506,0,0,0,,8506,-8506
11,03/16/2017,39,9:30,9:45,,13.74,0,13.74,13.74,-1,-60214,114125,174339,53911,0,-40405,0,0,0,,40405,-40405
11,03/16/2017,40,9:45,10:00,,13.74,0,13.74,13.74,-1,-75016,121934,196950,46918,0,-55495,0,0,0,,55495,-55495
11,03/16/2017,41,10:00,10:15,32.06,25.13,0,32.06,32.06,1,-117802,113382,231184,-4420,0,-20862,395,0,0,,21257,-20467
11,03/16/2017,42,10:15,10:30,32.06,25.13,0,25.13,25.13,-1,-88407,114515,202922,26108,0,-12477,34,0,0,,12511,-12443
11,03/16/2017,43,10:30,10:45,,20.9,0,20.9,20.9,-1,-75419,126201,201620,50782,0,-47177,0,0,0,,47177,-47177
11,03/16/2017,44,10:45,11:00,,1.1,0,1.1,1.1,-1,-69906,143461,213367,73555,0,-60996,0,0,0,,60996,-60996
11,03/16/2017,45,11:00,11:15,,20.13,0,20.13,20.13,-1,-108517,124529,233046,16012,0,-27267,0,0,0,,27267,-27267
11,03/16/2017,46,11:15,11:30,,18.28,0,18.28,18.28,-1,-77051,130234,207285,53183,0,-17784,0,0,0,,17784,-17784
11,03/16/2017,47,11:30,11:45,,0.33,0,0.33,0.33,-1,-74449,143292,217741,68843,0,-62399,0,0,0,,62399,-62399
11,03/16/2017,48,11:45,12:00,,11.62,0,11.62,11.62,-1,-70574,141839,212413,71265,0,-57298,0,0,0,,57298,-57298
11,03/16/2017,49,12:00,12:15,,9.78,0,9.78,9.78,-1,-89465,113679,203144,24214,0,-44641,0,0,0,,44641,-44641
11,03/16/2017,50,12:15,12:30,,-2.02,0,-2.02,-2.02,-1,-82780,127286,210066,44506,0,-20572,0,0,0,,20572,-20572
11,03/16/2017,51,12:30,12:45,,-17.36,0,-17.36,-17.36,-1,-82535,130703,213238,48168,0,-51398,0,0,0,,51398,-51398
11,03/16/2017,52,12:45,13:00,,9.14,0,9.14,9.14,-1,-77604,144325,221929,66721,0,-52429,0,0,0,,52429,-52429
11,03/16/2017,53,13:00,13:15,,22.27,0,22.27,22.27,-1,-93673,130791,224464,37118,0,-30354,0,0,0,,30354,-30354
11,03/16/2017,54,13:15,13:30,,7.51,0,7.51,7.51,-1,-82965,141387,224352,58422,0,-4611,0,0,0,,4611,-4611
11,03/16/2017,55,13:30,13:45,,-7.79,0,-7.79,-7.79,-1,-81036,127975,209011,46939,0,-37915,0,0,0,,37915,-37915
11,03/16/2017,56,13:45,14:00,,19.25,0,19.25,19.25,-1,-78225,131629,209854,53404,0,-41530,0,0,0,,41530,-41530
11,03/16/2017,57,14:00,14:15,,26.18,0,26.18,26.18,-1,-90900,95691,186591,4791,0,-21441,0,0,0,,21441,-21441
11,03/16/2017,58,14:15,14:30,,33.19,0,33.19,33.19,-1,-88694,99176,187870,10482,0,-677,0,0,0,,677,-677
11,03/16/2017,59,14:30,14:45,,33.19,0,33.19,33.19,-1,-76850,87833,164683,10983,0,-1310,0,0,0,,1310,-1310
11,03/16/2017,60,14:45,15:00,,29.89,0,29.89,29.89,-1,-73369,108149,181518,34780,0,-3181,0,0,0,,3181,-3181
11,03/16/2017,61,15:00,15:15,,29.86,0,29.86,29.86,-1,-65253,96450,161703,31197,0,-1670,0,0,0,,1670,-1670
11,03/16/2017,62,15:15,15:30,,,0,31.42,31.42,0,-71929,87015,158944,15086,0,0,0,0,0,,0,0
11,03/16/2017,63,15:30,15:45,,,0,31.52,31.52,0,-70596,81360,151956,10764,0,0,0,0,0,,0,0
11,03/16/2017,64,15:45,16:00,,28.13,0,28.13,28.13,-1,-69705,107860,177565,38155,0,-2298,0,0,0,,2298,-2298
11,03/16/2017,65,16:00,16:15,,12.54,0,12.54,12.54,-1,-39628,160192,199820,120564,0,-40412,0,0,0,,40412,-40412
11,03/16/2017,66,16:15,16:30,,25.13,0,25.13,25.13,-1,-43389,132633,176022,89244,0,-43205,0,0,0,,43205,-43205
11,03/16/2017,67,16:30,16:45,,29.86,0,29.86,29.86,-1,-41902,109045,150947,67143,0,-11342,0,0,0,,11342,-11342
11,03/16/2017,68,16:45,17:00,,28.13,0,28.13,28.13,-1,-52707,102779,155486,50072,0,-946,0,0,0,,946,-946
11,03/16/2017,69,17:00,17:15,,6.5,0,6.5,6.5,-1,-56869,108298,165167,51429,0,-29201,0,0,0,,29201,-29201
11,03/16/2017,70,17:15,17:30,,29.78,0,29.78,29.78,-1,-69825,78329,148154,8504,0,-6570,0,0,0,,6570,-6570
11,03/16/2017,71,17:30,17:45,,30.25,0,30.25,30.25,-1,-70899,79071,149970,8172,0,-846,0,0,0,,846,-846
11,03/16/2017,72,17:45,18:00,,,0,31.97,31.97,0,-79347,84968,164315,5621,0,0,0,0,0,,0,0
11,03/16/2017,73,18:00,18:15,,26.31,0,26.31,26.31,-1,-78191,74813,153004,-3378,0,-4101,0,0,0,,4101,-4101
11,03/16/2017,74,18:15,18:30,,31.99,0,31.99,31.99,-1,-73415,76771,150186,3356,0,-2710,0,0,0,,2710,-2710
11,03/16/2017,75,18:30,18:45,,34.79,0,34.79,34.79,-1,-63789,52839,116628,-10950,0,-300,0,0,0,,300,-300
11,03/16/2017,76,18:45,19:00,136.66,,0,136.66,136.66,1,-93474,33029,126503,-60445,0,0,21184,0,0,,21184,21184
11,03/16/2017,77,19:00,19:15,49.29,,0,49.29,49.29,1,-67853,38566,106419,-29287,0,0,24612,0,0,,24612,24612
11,03/16/2017,78,19:15,19:30,56.1,,0,56.1,56.1,1,-70606,27350,97956,-43256,0,0,28448,0,0,,28448,28448
11,03/16/2017,79,19:30,19:45,35.87,,0,35.87,35.87,1,-61611,35875,97486,-25736,0,0,15378,0,0,,15378,15378
11,03/16/2017,80,19:45,20:00,35.87,30.03,0,30.03,30.03,-1,-50433,39649,90082,-10784,0,-322,466,0,0,,788,144
11,03/16/2017,81,20:00,20:15,,29.78,0,29.78,29.78,-1,-48331,45840,94171,-2491,0,-1167,0,0,0,,1167,-1167
11,03/16/2017,82,20:15,20:30,,17.09,0,17.09,17.09,-1,-17974,47162,65136,29188,0,-20372,0,0,0,,20372,-20372
11,03/16/2017,83,20:30,20:45,,24.71,0,24.71,24.71,-1,-47636,59135,106771,11499,0,-20262,0,0,0,,20262,-20262
11,03/16/2017,84,20:45,21:00,,-28.52,0,-28.52,-28.52,-1,-43511,90601,134112,47090,0,-31168,0,0,0,,31168,-31168
11,03/16/2017,85,21:00,21:15,101.12,-52.44,0,101.12,-52.44,2,-100897,28109,129006,-72788,0,-30537,5842,0,0,,36379,-24695
11,03/16/2017,86,21:15,21:30,129.12,-52.44,0,129.12,129.12,1,-74192,43030,117222,-31162,0,-1,19833,0,0,,19834,19832
11,03/16/2017,87,21:30,21:45,129.12,6.84,0,6.84,6.84,-1,-41638,79218,120856,37580,0,-6132,595,0,0,,6727,-5537
11,03/16/2017,88,21:45,22:00,,-8.76,0,-8.76,-8.76,-1,-63229,75565,138794,12336,0,-29281,0,0,0,,29281,-29281
11,03/16/2017,89,22:00,22:15,42.13,23.13,0,42.13,23.13,2,-112646,59161,171807,-53485,0,-8080,1321,0,0,,9401,-6759
11,03/16/2017,90,22:15,22:30,128.12,23.13,0,128.12,128.12,1,-128305,40596,168901,-87709,0,-186,21945,0,0,,22131,21759
11,03/16/2017,91,22:30,22:45,42.13,,0,42.13,42.13,1,-109443,59160,168603,-50283,0,0,7941,0,0,,7941,7941
11,03/16/2017,92,22:45,23:00,28.94,,0,28.94,28.94,1,-95874,54690,150564,-41184,0,0,1300,0,0,,1300,1300
11,03/16/2017,93,23:00,23:15,49.64,,0,49.64,49.64,1,-165631,47266,212897,-118365,0,0,6543,0,0,,6543,6543
11,03/16/2017,94,23:15,23:30,81.32,,0,81.32,81.32,1,-140126,22053,162179,-118073,0,0,33254,0,0,,33254,33254
11,03/16/2017,95,23:30,23:45,,,0,29.46,29.46,0,-93317,15182,108499,-78135,0,0,4230,0,0,,4230,4230
11,03/16/2017,96,23:45,0:00,,,0,29.86,29.86,0,-97240,32961,130201,-64279,0,0,0,0,0,,0,0
11,03/17/2017,1,0:00,0:15,30.41,,0,30.41,30.41,1,-138965,39189,178154,-99776,0,0,133,0,0,,133,133
11,03/17/2017,2,0:15,0:30,30.41,,0,30.41,30.41,1,-121188,17913,139101,-103275,0,0,503,0,0,,503,503
11,03/17/2017,3,0:30,0:45,28.95,,0,28.95,28.95,1,-123909,14660,138569,-109249,0,0,259,0,0,,259,259
11,03/17/2017,4,0:45,1:00,28.95,,0,28.95,28.95,1,-159421,29791,189212,-129630,0,0,954,0,0,,954,954
11,03/17/2017,5,1:00,1:15,,,0,28.75,28.75,0,-44324,43680,88004,-644,0,0,113,0,0,,113,113
11,03/17/2017,6,1:15,1:30,,20.98,0,20.98,20.98,-1,-29258,40093,69351,10835,0,-5021,0,0,0,,5021,-5021
11,03/17/2017,7,1:30,1:45,,9.47,0,9.47,9.47,-1,-25696,61286,86982,35590,0,-37239,0,0,0,,37239,-37239
11,03/17/2017,8,1:45,2:00,,-5.03,0,-5.03,-5.03,-1,-28014,89983,117997,61969,0,-54467,0,0,0,,54467,-54467
11,03/17/2017,9,2:00,2:15,,12.03,0,12.03,12.03,-1,-28697,69943,98640,41246,0,-40601,0,0,0,,40601,-40601
11,03/17/2017,10,2:15,2:30,,-50.51,0,-50.51,-50.51,-1,-23788,84125,107913,60337,0,-19391,0,0,0,,19391,-19391
11,03/17/2017,11,2:30,2:45,,-50.51,0,-50.51,-50.51,-1,-47162,77584,124746,30422,0,-41057,0,0,0,,41057,-41057
11,03/17/2017,12,2:45,3:00,,-20.61,0,-20.61,-20.61,-1,-29899,96824,126723,66925,0,-38201,0,0,0,,38201,-38201
11,03/17/2017,13,3:00,3:15,,18.29,0,18.29,18.29,-1,-49503,80092,129595,30589,0,-31924,0,0,0,,31924,-31924
11,03/17/2017,14,3:15,3:30,,24.98,0,24.98,24.98,-1,-54173,63399,117572,9226,0,-12424,0,0,0,,12424,-12424
11,03/17/2017,15,3:30,3:45,27.18,24.98,0,27.18,27.18,1,-49036,30090,79126,-18946,0,-3362,78,0,0,,3440,-3284
11,03/17/2017,16,3:45,4:00,27.18,,0,27.18,27.18,1,-44026,22187,66213,-21839,0,0,392,0,0,,392,392
11,03/17/2017,17,4:00,4:15,,29.09,0,29.09,29.09,-1,-32210,39713,71923,7503,0,-339,0,0,0,,339,-339
11,03/17/2017,18,4:15,4:30,,29.09,0,29.09,29.09,-1,-53330,15235,68565,-38095,0,-633,0,0,0,,633,-633
11,03/17/2017,19,4:30,4:45,,,0,28.66,28.66,0,-57452,11671,69123,-45781,0,0,0,0,0,,0,0
11,03/17/2017,20,4:45,5:00,31.02,,0,31.02,31.02,1,-78764,11504,90268,-67260,0,0,2304,0,0,,2304,2304
11,03/17/2017,21,5:00,5:15,30.41,,0,30.41,30.41,1,-62652,17523,80175,-45129,0,0,899,0,0,,899,899
11,03/17/2017,22,5:15,5:30,33.18,27.99,0,33.18,27.99,2,-65305,43041,108346,-22264,0,-921,513,0,0,,1434,-408
11,03/17/2017,23,5:30,5:45,33.25,,0,33.25,33.25,1,-63824,31016,94840,-32808,0,0,1202,0,0,,1202,1202
11,03/17/2017,24,5:45,6:00,,27.44,0,27.44,27.44,-1,-33581,68352,101933,34771,0,-1993,0,0,0,,1993,-1993
11,03/17/2017,25,6:00,6:15,,26.47,0,26.47,26.47,-1,-69629,70657,140286,1028,0,-1205,0,0,0,,1205,-1205
11,03/17/2017,26,6:15,6:30,,24.84,0,24.84,24.84,-1,-35970,76176,112146,40206,0,-12364,0,0,0,,12364,-12364
11,03/17/2017,27,6:30,6:45,,29.14,0,29.14,29.14,-1,-46079,69458,115537,23379,0,-3772,0,0,0,,3772,-3772
11,03/17/2017,28,6:45,7:00,,,0,30.78,30.78,0,-59787,66150,125937,6363,0,-402,0,0,0,,402,-402
11,03/17/2017,29,7:00,7:15,,-159.73,0,-159.73,-159.73,-1,-27302,171539,198841,144237,0,-37525,0,0,0,,37525,-37525
11,03/17/2017,30,7:15,7:30,,17.75,0,17.75,17.75,-1,-35759,77704,113463,41945,0,-30826,0,0,0,,30826,-30826
11,03/17/2017,31,7:30,7:45,,28.03,0,28.03,28.03,-1,-29386,42766,72152,13380,0,-20070,0,0,0,,20070,-20070
11,03/17/2017,32,7:45,8:00,51.18,28.03,0,51.18,51.18,1,-107366,22204,129570,-85162,0,-3561,4855,0,0,,8416,1294
11,03/17/2017,33,8:00,8:15,182.89,,0,182.89,182.89,1,-109088,56398,165486,-52690,0,0,50314,0,0,,50314,50314
11,03/17/2017,34,8:15,8:30,56.38,,0,56.38,56.38,1,-76445,42558,119003,-33887,0,0,29685,0,0,,29685,29685
11,03/17/2017,35,8:30,8:45,131.02,,0,131.02,131.02,1,-98474,33679,132153,-64795,0,0,53167,0,0,,53167,53167
11,03/17/2017,36,8:45,9:00,56.38,,0,56.38,56.38,1,-70302,38411,108713,-31891,0,0,44786,0,0,,44786,44786
11,03/17/2017,37,9:00,9:15,56.38,29.35,0,29.35,29.35,-1,-49874,96883,146757,47009,0,-451,4018,0,0,,4469,3567
11,03/17/2017,38,9:15,9:30,,22.15,0,22.15,22.15,-1,-13136,131225,144361,118089,0,-3875,0,0,0,,3875,-3875
11,03/17/2017,39,9:30,9:45,,-0.33,0,-0.33,-0.33,-1,-21891,156270,178161,134379,0,-36322,0,0,0,,36322,-36322
11,03/17/2017,40,9:45,10:00,,-46.36,0,-46.36,-46.36,-1,-44787,106571,151358,61784,0,-62577,0,0,0,,62577,-62577
11,03/17/2017,41,10:00,10:15,139.3,29.2,0,139.3,139.3,1,-112085,40731,152816,-71354,0,-7239,14215,0,0,,21454,6976
11,03/17/2017,42,10:15,10:30,139.3,,0,139.3,139.3,1,-60698,65803,126501,5105,0,0,25189,0,0,,25189,25189
11,03/17/2017,43,10:30,10:45,47.9,,0,47.9,47.9,1,-66160,33310,99470,-32850,0,0,10617,0,0,,10617,10617
11,03/17/2017,44,10:45,11:00,47.9,,0,47.9,47.9,1,-70263,45437,115700,-24826,0,0,15104,0,0,,15104,15104
11,03/17/2017,45,11:00,11:15,130.02,,0,130.02,130.02,1,-149281,37052,186333,-112229,0,0,20086,0,0,,20086,20086
11,03/17/2017,46,11:15,11:30,130.02,,0,130.02,130.02,1,-149639,37915,187554,-111724,0,0,78689,0,0,,78689,78689
11,03/17/2017,47,11:30,11:45,51.83,,0,51.83,51.83,1,-122140,37943,160083,-84197,0,0,52972,0,0,,52972,52972
11,03/17/2017,48,11:45,12:00,68.46,,0,68.46,68.46,1,-141218,34137,175355,-107081,0,0,55139,0,0,,55139,55139
11,03/17/2017,49,12:00,12:15,130.02,,0,130.02,130.02,1,-197550,54941,252491,-142609,0,0,63585,0,0,,63585,63585
11,03/17/2017,50,12:15,12:30,124.23,,0,124.23,124.23,1,-147286,36350,183636,-110936,0,0,47970,0,0,,47970,47970
11,03/17/2017,51,12:30,12:45,35.77,,0,35.77,35.77,1,-94209,45441,139650,-48768,0,0,6754,0,0,,6754,6754
11,03/17/2017,52,12:45,13:00,29.34,29.93,0,29.93,29.93,-1,-70674,47659,118333,-23015,0,-13,1591,0,0,,1604,1578
11,03/17/2017,53,13:00,13:15,,24.84,0,24.84,24.84,-1,-34371,64819,99190,30448,0,-9137,0,0,0,,9137,-9137
11,03/17/2017,54,13:15,13:30,,3.5,0,3.5,3.5,-1,-20588,82717,103305,62129,0,-38632,0,0,0,,38632,-38632
11,03/17/2017,55,13:30,13:45,,15.13,0,15.13,15.13,-1,-18336,93158,111494,74822,0,-46932,0,0,0,,46932,-46932
11,03/17/2017,56,13:45,14:00,,-18.61,0,-18.61,-18.61,-1,-34104,116357,150461,82253,0,-73866,0,0,0,,73866,-73866
11,03/17/2017,57,14:00,14:15,,1.49,0,1.49,1.49,-1,-39802,109555,149357,69753,0,-45021,0,0,0,,45021,-45021
11,03/17/2017,58,14:15,14:30,,-20.28,0,-20.28,-20.28,-1,-70882,121320,192202,50438,0,-42112,0,0,0,,42112,-42112
11,03/17/2017,59,14:30,14:45,,17.56,0,17.56,17.56,-1,-54669,130201,184870,75532,0,-41375,0,0,0,,41375,-41375
11,03/17/2017,60,14:45,15:00,,10.04,0,10.04,10.04,-1,-57403,137763,195166,80360,0,-55313,0,0,0,,55313,-55313
11,03/17/2017,61,15:00,15:15,,-33.78,0,-33.78,-33.78,-1,-50765,142581,193346,91816,0,-75330,0,0,0,,75330,-75330
11,03/17/2017,62,15:15,15:30,,22.08,0,22.08,22.08,-1,-52814,132708,185522,79894,0,-40314,0,0,0,,40314,-40314
11,03/17/2017,63,15:30,15:45,,27.79,0,27.79,27.79,-1,-55894,119132,175026,63238,0,-14720,0,0,0,,14720,-14720
11,03/17/2017,64,15:45,16:00,,,0,30.34,30.34,0,-55902,101968,157870,46066,0,0,0,0,0,,0,0
11,03/17/2017,65,16:00,16:15,,,0,30.37,30.37,0,-39426,73461,112887,34035,0,0,0,0,0,,0,0
11,03/17/2017,66,16:15,16:30,34.79,,0,34.79,34.79,1,-63410,56301,119711,-7109,0,0,2830,0,0,,2830,2830
11,03/17/2017,67,16:30,16:45,34.83,,0,34.83,34.83,1,-83814,54322,138136,-29492,0,0,13897,0,0,,13897,13897
11,03/17/2017,68,16:45,17:00,35.77,,0,35.77,35.77,1,-84221,53896,138117,-30325,0,0,23381,0,0,,23381,23381
11,03/17/2017,69,17:00,17:15,31.04,6.17,0,31.04,6.17,2,-36185,59408,95593,23223,0,-8394,9967,0,0,,18361,1573
11,03/17/2017,70,17:15,17:30,,30.93,0,30.93,30.93,-1,-62711,45216,107927,-17495,0,-793,0,0,0,,793,-793
11,03/17/2017,71,17:30,17:45,,,0,30.41,30.41,0,-60361,43083,103444,-17278,0,0,0,0,0,,0,0
11,03/17/2017,72,17:45,18:00,,,0,30.51,30.51,0,-69901,59517,129418,-10384,0,0,0,0,0,,0,0
11,03/17/2017,73,18:00,18:15,,32.69,0,32.69,32.69,-1,-76104,47617,123721,-28487,0,-18,0,0,0,,18,-18
11,03/17/2017,74,18:15,18:30,,30.57,0,30.57,30.57,-1,-52186,52624,104810,438,0,-853,0,0,0,,853,-853
11,03/17/2017,75,18:30,18:45,,31.65,0,31.65,31.65,-1,-43686,47168,90854,3482,0,-1021,0,0,0,,1021,-1021
11,03/17/2017,76,18:45,19:00,46.1,31.65,0,46.1,46.1,1,-74816,53427,128243,-21389,0,-2,1948,0,0,,1950,1946
11,03/17/2017,77,19:00,19:15,105.02,,0,105.02,105.02,1,-75340,28515,103855,-46825,0,0,27070,0,0,,27070,27070
11,03/17/2017,78,19:15,19:30,28.95,,0,28.95,28.95,1,-59657,41592,101249,-18065,0,0,5989,0,0,,5989,5989
11,03/17/2017,79,19:30,19:45,,28.68,0,28.68,28.68,-1,-39611,51748,91359,12137,0,-2329,0,0,0,,2329,-2329
11,03/17/2017,80,19:45,20:00,,28.68,0,28.68,28.68,-1,-45901,59228,105129,13327,0,-7161,0,0,0,,7161,-7161
11,03/17/2017,81,20:00,20:15,,27.03,0,27.03,27.03,-1,-59057,52745,111802,-6312,0,-7975,0,0,0,,7975,-7975
11,03/17/2017,82,20:15,20:30,,,0,31.43,31.43,0,-64658,54667,119325,-9991,0,-169,0,0,0,,169,-169
11,03/17/2017,83,20:30,20:45,,5.48,0,5.48,5.48,-1,-40322,70843,111165,30521,0,-5981,0,0,0,,5981,-5981
11,03/17/2017,84,20:45,21:00,,-2.82,0,-2.82,-2.82,-1,-123228,69766,192994,-53462,0,-19277,0,0,0,,19277,-19277
11,03/17/2017,85,21:00,21:15,38.68,27.44,0,38.68,27.44,2,-30725,48245,78970,17520,0,-3293,557,0,0,,3850,-2736
11,03/17/2017,86,21:15,21:30,50.74,28.25,0,50.74,28.25,2,-42240,33098,75338,-9142,0,-234,14483,0,0,,14717,14249
11,03/17/2017,87,21:30,21:45,50.74,17.67,0,17.67,17.67,-1,-14874,60288,75162,45414,0,-27167,187,0,0,,27354,-26980
11,03/17/2017,88,21:45,22:00,,6.85,0,6.85,6.85,-1,-22477,79002,101479,56525,0,-57986,0,0,0,,57986,-57986
11,03/17/2017,89,22:00,22:15,77.32,6.85,0,77.32,77.32,1,-62087,24542,86629,-37545,0,-25267,3711,0,0,,28978,-21556
11,03/17/2017,90,22:15,22:30,28.95,27.64,0,27.64,27.64,-1,-25021,37920,62941,12899,0,-496,754,0,0,,1250,258
11,03/17/2017,91,22:30,22:45,,25.13,0,25.13,25.13,-1,-10947,73115,84062,62168,0,-4799,0,0,0,,4799,-4799
11,03/17/2017,92,22:45,23:00,,12.77,0,12.77,12.77,-1,-7597,112185,119782,104588,0,-27320,0,0,0,,27320,-27320
11,03/17/2017,93,23:00,23:15,,23.16,0,23.16,23.16,-1,-19432,56594,76026,37162,0,-15479,0,0,0,,15479,-15479
11,03/17/2017,94,23:15,23:30,,-14.24,0,-14.24,-14.24,-1,-22606,35965,58571,13359,0,-20937,0,0,0,,20937,-20937
11,03/17/2017,95,23:30,23:45,,-14.24,0,-14.24,-14.24,-1,-20849,69123,89972,48274,0,-21026,0,0,0,,21026,-21026
11,03/17/2017,96,23:45,0:00,,-19.6,0,-19.6,-19.6,-1,-47301,53552,100853,6251,0,-33543,0,0,0,,33543,-33543
12,03/18/2017,1,0:00,0:15,34.28,-19.6,0,34.28,34.28,1,-80442,25416,105858,-55026,0,-2839,2017,0,0,,4856,-822
12,03/18/2017,2,0:15,0:30,,29.68,0,29.68,29.68,-1,-52497,37847,90344,-14650,0,-68,0,0,0,,68,-68
12,03/18/2017,3,0:30,0:45,,6.29,0,6.29,6.29,-1,-32140,61832,93972,29692,0,-16976,0,0,0,,16976,-16976
12,03/18/2017,4,0:45,1:00,,7.15,0,7.15,7.15,-1,-67341,94132,161473,26791,0,-34094,0,0,0,,34094,-34094
12,03/18/2017,5,1:00,1:15,,-54.87,0,-54.87,-54.87,-1,-92462,129758,222220,37296,0,-43083,0,0,0,,43083,-43083
12,03/18/2017,6,1:15,1:30,,-54.87,0,-54.87,-54.87,-1,-56066,108772,164838,52706,0,-24316,0,0,0,,24316,-24316
12,03/18/2017,7,1:30,1:45,,25.68,0,25.68,25.68,-1,-40879,81430,122309,40551,0,-12438,0,0,0,,12438,-12438
12,03/18/2017,8,1:45,2:00,,-12.78,0,-12.78,-12.78,-1,-34121,81309,115430,47188,0,-32400,0,0,0,,32400,-32400
12,03/18/2017,9,2:00,2:15,54.76,-12.78,0,54.76,54.76,1,-76437,33692,110129,-42745,0,-8997,9774,0,0,,18771,777
12,03/18/2017,10,2:15,2:30,31.2,29.59,0,29.59,29.59,-1,-43792,48778,92570,4986,0,-445,2888,0,0,,3333,2443
12,03/18/2017,11,2:30,2:45,,25.68,0,25.68,25.68,-1,-40485,55375,95860,14890,0,-8148,0,0,0,,8148,-8148
12,03/18/2017,12,2:45,3:00,,25.68,0,25.68,25.68,-1,-46251,55239,101490,8988,0,-13819,0,0,0,,13819,-13819
12,03/18/2017,13,3:00,3:15,,23.92,0,23.92,23.92,-1,-36212,56624,92836,20412,0,-14281,0,0,0,,14281,-14281
12,03/18/2017,14,3:15,3:30,,23.92,0,23.92,23.92,-1,-35300,44375,79675,9075,0,-10482,0,0,0,,10482,-10482
12,03/18/2017,15,3:30,3:45,,23.17,0,23.17,23.17,-1,-28516,52408,80924,23892,0,-19666,0,0,0,,19666,-19666
12,03/18/2017,16,3:45,4:00,,13.29,0,13.29,13.29,-1,-21900,53134,75034,31234,0,-32106,0,0,0,,32106,-32106
12,03/18/2017,17,4:00,4:15,,13.29,0,13.29,13.29,-1,-20278,56208,76486,35930,0,-39308,0,0,0,,39308,-39308
12,03/18/2017,18,4:15,4:30,,19.78,0,19.78,19.78,-1,-25365,53125,78490,27760,0,-27920,0,0,0,,27920,-27920
12,03/18/2017,19,4:30,4:45,,14.23,0,14.23,14.23,-1,-21802,57167,78969,35365,0,-25104,0,0,0,,25104,-25104
12,03/18/2017,20,4:45,5:00,,14.23,0,14.23,14.23,-1,-24073,57967,82040,33894,0,-30416,0,0,0,,30416,-30416
12,03/18/2017,21,5:00,5:15,,19.49,0,19.49,19.49,-1,-17728,65060,82788,47332,0,-25569,0,0,0,,25569,-25569
12,03/18/2017,22,5:15,5:30,,2.78,0,2.78,2.78,-1,-17370,64015,81385,46645,0,-39556,0,0,0,,39556,-39556
12,03/18/2017,23,5:30,5:45,,28.43,0,28.43,28.43,-1,-19442,55902,75344,36460,0,-21004,0,0,0,,21004,-21004
12,03/18/2017,24,5:45,6:00,,29.68,0,29.68,29.68,-1,-26953,48427,75380,21474,0,-9592,0,0,0,,9592,-9592
12,03/18/2017,25,6:00,6:15,,28.68,0,28.68,28.68,-1,-40329,99164,139493,58835,0,-986,0,0,0,,986,-986
12,03/18/2017,26,6:15,6:30,,28.68,0,28.68,28.68,-1,-37237,80396,117633,43159,0,-1388,0,0,0,,1388,-1388
12,03/18/2017,27,6:30,6:45,,,0,29.85,29.85,0,-37486,42037,79523,4551,0,-316,0,0,0,,316,-316
12,03/18/2017,28,6:45,7:00,,28.68,0,28.68,28.68,-1,-40589,66532,107121,25943,0,-110,0,0,0,,110,-110
12,03/18/2017,29,7:00,7:15,,-55.19,0,-55.19,-55.19,-1,-16232,103596,119828,87364,0,-33857,0,0,0,,33857,-33857
12,03/18/2017,30,7:15,7:30,,-13.1,0,-13.1,-13.1,-1,-24430,83609,108039,59179,0,-36634,0,0,0,,36634,-36634
12,03/18/2017,31,7:30,7:45,,-17.78,0,-17.78,-17.78,-1,-36706,44566,81272,7860,0,-33937,0,0,0,,33937,-33937
12,03/18/2017,32,7:45,8:00,28.58,-17.78,0,28.58,28.58,1,-39787,67912,107699,28125,0,-342,195,0,0,,537,-147
12,03/18/2017,33,8:00,8:15,,25.68,0,25.68,25.68,-1,-13277,149566,162843,136289,0,-10075,0,0,0,,10075,-10075
12,03/18/2017,34,8:15,8:30,,23.92,0,23.92,23.92,-1,-28473,110250,138723,81777,0,-16428,0,0,0,,16428,-16428
12,03/18/2017,35,8:30,8:45,,,0,30.44,30.44,0,-31015,85792,116807,54777,0,-615,0,0,0,,615,-615
12,03/18/2017,36,8:45,9:00,33.68,,0,33.68,33.68,1,-61299,62749,124048,1450,0,0,608,0,0,,608,608
12,03/18/2017,37,9:00,9:15,36.03,,0,36.03,36.03,1,-60007,61787,121794,1780,0,0,979,0,0,,979,979
12,03/18/2017,38,9:15,9:30,127.31,,0,127.31,127.31,1,-83933,21058,104991,-62875,0,0,38419,0,0,,38419,38419
12,03/18/2017,39,9:30,9:45,127.31,,0,127.31,127.31,1,-112432,58627,171059,-53805,0,0,73251,0,0,,73251,73251
12,03/18/2017,40,9:45,10:00,69.1,,0,69.1,69.1,1,-137140,72391,209531,-64749,0,0,37194,0,0,,37194,37194
12,03/18/2017,41,10:00,10:15,130.12,,0,130.12,130.12,1,-96352,35297,131649,-61055,0,0,65586,0,0,,65586,65586
12,03/18/2017,42,10:15,10:30,56.12,,0,56.12,56.12,1,-115067,46204,161271,-68863,0,0,69080,0,0,,69080,69080
12,03/18/2017,43,10:30,10:45,129.59,,0,129.59,129.59,1,-157000,41724,198724,-115276,0,0,74753,0,0,,74753,74753
12,03/18/2017,44,10:45,11:00,129.59,,0,129.59,129.59,1,-185439,56937,242376,-128502,0,0,92656,0,0,,92656,92656
12,03/18/2017,45,11:00,11:15,71.12,,0,71.12,71.12,1,-136776,102173,238949,-34603,0,0,64220,0,0,,64220,64220
12,03/18/2017,46,11:15,11:30,37.52,,0,37.52,37.52,1,-150082,114844,264926,-35238,0,0,4825,0,0,,4825,4825
12,03/18/2017,47,11:30,11:45,50.28,,0,50.28,50.28,1,-154962,98843,253805,-56119,0,0,42321,0,0,,42321,42321
12,03/18/2017,48,11:45,12:00,40.53,,0,40.53,40.53,1,-148548,104994,253542,-43554,0,0,43939,0,0,,43939,43939
12,03/18/2017,49,12:00,12:15,35.12,,0,35.12,35.12,1,-145032,124816,269848,-20216,0,0,22995,0,0,,22995,22995
12,03/18/2017,50,12:15,12:30,36.68,,0,36.68,36.68,1,-148555,112481,261036,-36074,0,0,24710,0,0,,24710,24710
12,03/18/2017,51,12:30,12:45,33.68,,0,33.68,33.68,1,-137400,117912,255312,-19488,0,0,17350,0,0,,17350,17350
12,03/18/2017,52,12:45,13:00,31.7,,0,31.7,31.7,1,-127075,122265,249340,-4810,0,0,6869,0,0,,6869,6869
12,03/18/2017,53,13:00,13:15,31.7,29.91,0,29.91,29.91,-1,-116338,137917,254255,21579,0,-103,41,0,0,,144,-62
12,03/18/2017,54,13:15,13:30,,,0,29.28,29.28,0,-123505,126720,250225,3215,0,0,0,0,0,,0,0
12,03/18/2017,55,13:30,13:45,34.55,,0,34.55,34.55,1,-123467,107519,230986,-15948,0,0,6098,0,0,,6098,6098
12,03/18/2017,56,13:45,14:00,35.52,,0,35.52,35.52,1,-124048,95262,219310,-28786,0,0,20581,0,0,,20581,20581
12,03/18/2017,57,14:00,14:15,33.59,29.91,0,29.91,29.91,-1,-101065,100368,201433,-697,0,-8,11392,0,0,,11400,11384
12,03/18/2017,58,14:15,14:30,34.56,29.52,0,34.56,29.26,2,-101970,86683,188653,-15287,0,-343,881,0,0,,1224,538
12,03/18/2017,59,14:30,14:45,63.43,,0,63.43,63.43,1,-111407,70765,182172,-40642,0,0,30952,0,0,,30952,30952
12,03/18/2017,60,14:45,15:00,35.12,,0,35.12,35.12,1,-109940,79122,189062,-30818,0,0,22413,0,0,,22413,22413
12,03/18/2017,61,15:00,15:15,35.12,28.44,0,28.44,28.44,-1,-77685,117124,194809,39439,0,-1045,4357,0,0,,5402,3312
12,03/18/2017,62,15:15,15:30,34.55,,0,34.55,34.55,1,-82506,70447,152953,-12059,0,0,2391,0,0,,2391,2391
12,03/18/2017,63,15:30,15:45,36.68,,0,36.68,36.68,1,-88444,54820,143264,-33624,0,0,26702,0,0,,26702,26702
12,03/18/2017,64,15:45,16:00,36.54,,0,36.54,36.54,1,-106298,64913,171211,-41385,0,0,31745,0,0,,31745,31745
12,03/18/2017,65,16:00,16:15,130.56,,0,130.56,130.56,1,-121281,43074,164355,-78207,0,0,51180,0,0,,51180,51180
12,03/18/2017,66,16:15,16:30,130.56,,0,130.56,130.56,1,-107011,45034,152045,-61977,0,0,73148,0,0,,73148,73148
12,03/18/2017,67,16:30,16:45,40.61,,0,40.61,40.61,1,-105684,57344,163028,-48340,0,0,44637,0,0,,44637,44637
12,03/18/2017,68,16:45,17:00,130.56,,0,130.56,130.56,1,-134373,47722,182095,-86651,0,0,54577,0,0,,54577,54577
12,03/18/2017,69,17:00,17:15,130.56,10.35,0,10.35,10.35,-1,-48670,119362,168032,70692,0,-3844,18918,0,0,,22762,15074
12,03/18/2017,70,17:15,17:30,,30.31,0,30.31,30.31,-1,-69576,61529,131105,-8047,0,-648,0,0,0,,648,-648
12,03/18/2017,71,17:30,17:45,28.58,,0,28.58,28.58,1,-83505,97934,181439,14429,0,0,406,0,0,,406,406
12,03/18/2017,72,17:45,18:00,28.12,,0,28.12,28.12,1,-105473,145156,250629,39683,0,0,70,0,0,,70,70
12,03/18/2017,73,18:00,18:15,,,0,31.65,31.65,0,-47285,106141,153426,58856,0,0,0,0,0,,0,0
12,03/18/2017,74,18:15,18:30,,24.8,0,24.8,24.8,-1,-40307,93246,133553,52939,0,-5862,0,0,0,,5862,-5862
12,03/18/2017,75,18:30,18:45,,,0,32.31,32.31,0,-44414,95917,140331,51503,0,-316,0,0,0,,316,-316
12,03/18/2017,76,18:45,19:00,,,0,32.31,32.31,0,-59313,123531,182844,64218,0,0,0,0,0,,0,0
12,03/18/2017,77,19:00,19:15,38.61,35.49,0,38.61,32.31,2,-72106,38970,111076,-33136,0,-35,3013,0,0,,3048,2978
12,03/18/2017,78,19:15,19:30,42.5,,0,42.5,42.5,1,-67791,38287,106078,-29504,0,0,29944,0,0,,29944,29944
12,03/18/2017,79,19:30,19:45,31.12,,0,31.12,31.12,1,-60945,48803,109748,-12142,0,0,11752,0,0,,11752,11752
12,03/18/2017,80,19:45,20:00,38.04,,0,38.04,38.04,1,-54244,38301,92545,-15943,0,0,8480,0,0,,8480,8480
12,03/18/2017,81,20:00,20:15,48.4,,0,48.4,48.4,1,-94254,41147,135401,-53107,0,0,33335,0,0,,33335,33335
12,03/18/2017,82,20:15,20:30,39.26,,0,39.26,39.26,1,-74417,58641,133058,-15776,0,0,20692,0,0,,20692,20692
12,03/18/2017,83,20:30,20:45,28.58,27.6,0,30.8,27.6,2,-65787,65808,131595,21,0,-343,445,0,0,,788,102
12,03/18/2017,84,20:45,21:00,,25.8,0,25.8,25.8,-1,-52441,47834,100275,-4607,0,-2357,0,0,0,,2357,-2357
12,03/18/2017,85,21:00,21:15,,27.92,0,27.92,27.92,-1,-70273,95220,165493,24947,0,-1690,0,0,0,,1690,-1690
12,03/18/2017,86,21:15,21:30,,,0,30.33,30.33,0,-71591,84989,156580,13398,0,0,0,0,0,,0,0
12,03/18/2017,87,21:30,21:45,,,0,30.1,30.1,0,-57216,79648,136864,22432,0,0,0,0,0,,0,0
12,03/18/2017,88,21:45,22:00,,31.26,0,31.26,31.26,-1,-45421,88327,133748,42906,0,-5,0,0,0,,5,-5
12,03/18/2017,89,22:00,22:15,75.61,29.55,0,75.61,29.55,2,-93600,43835,137435,-49765,0,-177,10624,0,0,,10801,10447
12,03/18/2017,90,22:15,22:30,71.12,,0,71.12,71.12,1,-64702,57880,122582,-6822,0,0,17895,0,0,,17895,17895
12,03/18/2017,91,22:30,22:45,71.12,28.12,0,28.12,28.12,-1,-42605,71714,114319,29109,0,-599,118,0,0,,717,-481
12,03/18/2017,92,22:45,23:00,,23.45,0,23.45,23.45,-1,-37391,78527,115918,41136,0,-6302,0,0,0,,6302,-6302
12,03/18/2017,93,23:00,23:15,134.7,28.2,0,134.7,134.7,1,-90405,36042,126447,-54363,0,-4100,11664,0,0,,15764,7564
12,03/18/2017,94,23:15,23:30,134.7,,0,134.7,134.7,1,-71272,47852,119124,-23420,0,0,35421,0,0,,35421,35421
12,03/18/2017,95,23:30,23:45,134.7,29.62,0,29.62,29.62,-1,-41959,50567,92526,8608,0,-775,2362,0,0,,3137,1587
12,03/18/2017,96,23:45,0:00,52.45,30.01,0,52.45,29.21,2,-102588,60611,163199,-41977,0,-388,5534,0,0,,5922,5146
12,03/19/2017,1,0:00,0:15,52.45,26.05,0,26.05,26.05,-1,-31067,144339,175406,113272,0,-1509,1860,0,0,,3369,351
12,03/19/2017,2,0:15,0:30,,9.1,0,9.1,9.1,-1,-30074,71210,101284,41136,0,-3697,0,0,0,,3697,-3697
12,03/19/2017,3,0:30,0:45,,0.74,0,0.74,0.74,-1,-22586,74652,97238,52066,0,-29060,0,0,0,,29060,-29060
12,03/19/2017,4,0:45,1:00,,-1.66,0,-1.66,-1.66,-1,-38207,79631,117838,41424,0,-42032,0,0,0,,42032,-42032
12,03/19/2017,5,1:00,1:15,42.09,30.09,0,42.09,42.09,1,-67217,28260,95477,-38957,0,-6287,5111,0,0,,11398,-1176
12,03/19/2017,6,1:15,1:30,32.09,13.84,0,13.84,13.84,-1,-40406,47980,88386,7574,0,-2917,4569,0,0,,7486,1652
12,03/19/2017,7,1:30,1:45,,13.84,0,13.84,13.84,-1,-30081,47731,77812,17650,0,-13815,0,0,0,,13815,-13815
12,03/19/2017,8,1:45,2:00,,23.77,0,23.77,23.77,-1,-38221,87664,125885,49443,0,-16649,0,0,0,,16649,-16649
12,03/19/2017,9,2:00,2:15,31.7,24.66,0,31.7,31.7,1,-48476,58394,106870,9918,0,-10118,215,0,0,,10333,-9903
12,03/19/2017,10,2:15,2:30,31.7,24.66,0,31.7,31.7,1,-48320,52923,101243,4603,0,-91,241,0,0,,332,150
12,03/19/2017,11,2:30,2:45,,16.12,0,16.12,16.12,-1,-41093,72652,113745,31559,0,-2221,0,0,0,,2221,-2221
12,03/19/2017,12,2:45,3:00,,-87.14,0,-87.14,-87.14,-1,-41254,101259,142513,60005,0,-44101,0,0,0,,44101,-44101
12,03/19/2017,13,3:00,3:15,,22.67,0,22.67,22.67,-1,-63023,73113,136136,10090,0,-15278,0,0,0,,15278,-15278
12,03/19/2017,14,3:15,3:30,,15.71,0,15.71,15.71,-1,-47352,111602,158954,64250,0,-1004,0,0,0,,1004,-1004
12,03/19/2017,15,3:30,3:45,,-11.4,0,-11.4,-11.4,-1,-36741,112440,149181,75699,0,-35603,0,0,0,,35603,-35603
12,03/19/2017,16,3:45,4:00,,-94.91,0,-94.91,-94.91,-1,-39872,135066,174938,95194,0,-55884,0,0,0,,55884,-55884
12,03/19/2017,17,4:00,4:15,,0.93,0,0.93,0.93,-1,-41304,94665,135969,53361,0,-31708,0,0,0,,31708,-31708
12,03/19/2017,18,4:15,4:30,,23.43,0,23.43,23.43,-1,-27640,99188,126828,71548,0,-289,0,0,0,,289,-289
12,03/19/2017,19,4:30,4:45,,2.03,0,2.03,2.03,-1,-16961,114726,131687,97765,0,-18460,0,0,0,,18460,-18460
12,03/19/2017,20,4:45,5:00,,-94.3,0,-94.3,-94.3,-1,-10746,125353,136099,114607,0,-47504,0,0,0,,47504,-47504
12,03/19/2017,21,5:00,5:15,31.7,-75,0,31.7,31.7,1,-89717,36828,126545,-52889,0,-28148,221,0,0,,28369,-27927
12,03/19/2017,22,5:15,5:30,31.7,22.47,0,22.47,22.47,-1,-60070,70385,130455,10315,0,-4748,123,0,0,,4871,-4625
12,03/19/2017,23,5:30,5:45,,22.47,0,22.47,22.47,-1,-66660,78285,144945,11625,0,-8626,0,0,0,,8626,-8626
12,03/19/2017,24,5:45,6:00,,24.66,0,24.66,24.66,-1,-68350,82200,150550,13850,0,-8007,0,0,0,,8007,-8007
12,03/19/2017,25,6:00,6:15,,29.7,0,29.7,29.7,-1,-107855,44938,152793,-62917,0,-2625,0,0,0,,2625,-2625
12,03/19/2017,26,6:15,6:30,,,0,29.15,29.15,0,-107213,37232,144445,-69981,0,0,0,0,0,,0,0
12,03/19/2017,27,6:30,6:45,,,0,29.15,29.15,0,-103585,55144,158729,-48441,0,0,0,0,0,,0,0
12,03/19/2017,28,6:45,7:00,,,0,29.15,29.15,0,-111016,81006,192022,-30010,0,0,0,0,0,,0,0
12,03/19/2017,29,7:00,7:15,30.06,,0,30.06,30.06,1,-125696,62619,188315,-63077,0,0,465,0,0,,465,465
12,03/19/2017,30,7:15,7:30,33.96,,0,33.96,33.96,1,-122248,49361,171609,-72887,0,0,3515,0,0,,3515,3515
12,03/19/2017,31,7:30,7:45,,,0,29.15,29.15,0,-101228,67998,169226,-33230,0,0,8,0,0,,8,8
12,03/19/2017,32,7:45,8:00,,,0,29.15,29.15,0,-65980,84826,150806,18846,0,0,0,0,0,,0,0
12,03/19/2017,33,8:00,8:15,,-94.91,0,-94.91,-94.91,-1,-20206,148906,169112,128700,0,-20097,0,0,0,,20097,-20097
12,03/19/2017,34,8:15,8:30,,3.73,0,3.73,3.73,-1,-30798,136243,167041,105445,0,-15595,0,0,0,,15595,-15595
12,03/19/2017,35,8:30,8:45,,22.1,0,22.1,22.1,-1,-30740,104084,134824,73344,0,-11478,0,0,0,,11478,-11478
12,03/19/2017,36,8:45,9:00,,28.73,0,28.73,28.73,-1,-29891,94141,124032,64250,0,-146,0,0,0,,146,-146
12,03/19/2017,37,9:00,9:15,,5.94,0,5.94,5.94,-1,-16621,136808,153429,120187,0,-17654,0,0,0,,17654,-17654
12,03/19/2017,38,9:15,9:30,,18.44,0,18.44,18.44,-1,-25493,114187,139680,88694,0,-18547,0,0,0,,18547,-18547
12,03/19/2017,39,9:30,9:45,,-118.64,0,-118.64,-118.64,-1,-40281,82286,122567,42005,0,-34252,0,0,0,,34252,-34252
12,03/19/2017,40,9:45,10:00,,18.44,0,18.44,18.44,-1,-31658,82179,113837,50521,0,-8189,0,0,0,,8189,-8189
12,03/19/2017,41,10:00,10:15,,9.12,0,9.12,9.12,-1,-67056,53091,120147,-13965,0,-14431,0,0,0,,14431,-14431
12,03/19/2017,42,10:15,10:30,30.06,28.09,0,30.06,28.09,2,-51804,57837,109641,6033,0,-2565,407,0,0,,2972,-2158
12,03/19/2017,43,10:30,10:45,,,0,29.11,29.11,0,-56931,59599,116530,2668,0,-532,0,0,0,,532,-532
12,03/19/2017,44,10:45,11:00,32.09,,0,32.09,32.09,1,-58481,60494,118975,2013,0,0,1966,0,0,,1966,1966
12,03/19/2017,45,11:00,11:15,42.09,,0,42.09,42.09,1,-62011,50057,112068,-11954,0,0,9561,0,0,,9561,9561
12,03/19/2017,46,11:15,11:30,28.6,,0,28.6,28.6,1,-42859,61112,103971,18253,0,0,1854,0,0,,1854,1854
12,03/19/2017,47,11:30,11:45,,29.09,0,29.09,29.09,-1,-43587,63771,107358,20184,0,-589,0,0,0,,589,-589
12,03/19/2017,48,11:45,12:00,,29.09,0,29.09,29.09,-1,-44131,82471,126602,38340,0,-914,0,0,0,,914,-914
12,03/19/2017,49,12:00,12:15,,,0,28.85,28.85,0,-63119,55701,118820,-7418,0,0,0,0,0,,0,0
12,03/19/2017,50,12:15,12:30,,,0,28.85,28.85,0,-41114,51685,92799,10571,0,0,0,0,0,,0,0
12,03/19/2017,51,12:30,12:45,,,0,28.85,28.85,0,-34278,63338,97616,29060,0,0,0,0,0,,0,0
12,03/19/2017,52,12:45,13:00,,,0,28.85,28.85,0,-33536,83684,117220,50148,0,0,0,0,0,,0,0
12,03/19/2017,53,13:00,13:15,33.63,,0,33.63,33.63,1,-39392,40659,80051,1267,0,0,2546,0,0,,2546,2546
12,03/19/2017,54,13:15,13:30,33.63,10.37,0,10.37,10.37,-1,-27240,66225,93465,38985,0,-2070,6,0,0,,2076,-2064
12,03/19/2017,55,13:30,13:45,38.98,-111.65,0,38.98,-111.65,2,-49284,49679,98963,395,0,-16730,1012,0,0,,17742,-15718
12,03/19/2017,56,13:45,14:00,38.98,-111.65,0,-111.65,-111.65,-1,-30099,84548,114647,54449,0,-21235,107,0,0,,21342,-21128
12,03/19/2017,57,14:00,14:15,,22.1,0,22.1,22.1,-1,-46504,86645,133149,40141,0,-11930,0,0,0,,11930,-11930
12,03/19/2017,58,14:15,14:30,,26.39,0,26.39,26.39,-1,-25795,105508,131303,79713,0,-2709,0,0,0,,2709,-2709
12,03/19/2017,59,14:30,14:45,,-111.31,0,-111.31,-111.31,-1,-34841,80974,115815,46133,0,-25824,0,0,0,,25824,-25824
12,03/19/2017,60,14:45,15:00,,-111.31,0,-111.31,-111.31,-1,-25445,76895,102340,51450,0,-14841,0,0,0,,14841,-14841
12,03/19/2017,61,15:00,15:15,,17.94,0,17.94,17.94,-1,-35425,70188,105613,34763,0,-10916,0,0,0,,10916,-10916
12,03/19/2017,62,15:15,15:30,39,-37.74,0,39,-37.74,2,-45452,59004,104456,13552,0,-18330,947,0,0,,19277,-17383
12,03/19/2017,63,15:30,15:45,39,27.3,0,39,27.3,2,-28661,56709,85370,28048,0,-1989,1074,0,0,,3063,-915
12,03/19/2017,64,15:45,16:00,,29.09,0,29.09,29.09,-1,-35721,71742,107463,36021,0,-20,0,0,0,,20,-20
12,03/19/2017,65,16:00,16:15,,25.09,0,25.09,25.09,-1,-21430,79090,100520,57660,0,-5315,0,0,0,,5315,-5315
12,03/19/2017,66,16:15,16:30,,27.14,0,27.14,27.14,-1,-24967,76266,101233,51299,0,-6518,0,0,0,,6518,-6518
12,03/19/2017,67,16:30,16:45,32.09,27.14,0,32.09,32.09,1,-35844,43960,79804,8116,0,-158,376,0,0,,534,218
12,03/19/2017,68,16:45,17:00,42.09,,0,42.09,42.09,1,-55473,26463,81936,-29010,0,0,17082,0,0,,17082,17082
12,03/19/2017,69,17:00,17:15,31.72,27,0,31.72,27,2,-34623,52458,87081,17835,0,-1828,8622,0,0,,10450,6794
12,03/19/2017,70,17:15,17:30,36.79,27,0,36.79,36.79,1,-36420,31078,67498,-5342,0,-470,3281,0,0,,3751,2811
12,03/19/2017,71,17:30,17:45,42.5,,0,42.5,42.5,1,-57320,19902,77222,-37418,0,0,34448,0,0,,34448,34448
12,03/19/2017,72,17:45,18:00,47.82,,0,47.82,47.82,1,-74657,45861,120518,-28796,0,0,44363,0,0,,44363,44363
12,03/19/2017,73,18:00,18:15,47.82,-67.11,0,-67.11,-67.11,-1,-15603,76655,92258,61052,0,-16141,6504,0,0,,22645,-9637
12,03/19/2017,74,18:15,18:30,,-47.29,0,-47.29,-47.29,-1,-29645,79411,109056,49766,0,-19611,0,0,0,,19611,-19611
12,03/19/2017,75,18:30,18:45,,-67.11,0,-67.11,-67.11,-1,-68964,79528,148492,10564,0,-29036,0,0,0,,29036,-29036
12,03/19/2017,76,18:45,19:00,,21.03,0,21.03,21.03,-1,-37772,91805,129577,54033,0,-9583,0,0,0,,9583,-9583
12,03/19/2017,77,19:00,19:15,,21.03,0,21.03,21.03,-1,-11538,102690,114228,91152,0,-13134,0,0,0,,13134,-13134
12,03/19/2017,78,19:15,19:30,,19.3,0,19.3,19.3,-1,-28110,66199,94309,38089,0,-29822,0,0,0,,29822,-29822
12,03/19/2017,79,19:30,19:45,,25.09,0,25.09,25.09,-1,-29036,59392,88428,30356,0,-15312,0,0,0,,15312,-15312
12,03/19/2017,80,19:45,20:00,,17.94,0,17.94,17.94,-1,-20967,55313,76280,34346,0,-28982,0,0,0,,28982,-28982
12,03/19/2017,81,20:00,20:15,31.99,28.24,0,31.99,28.24,2,-45769,45301,91070,-468,0,-9368,930,0,0,,10298,-8438
12,03/19/2017,82,20:15,20:30,,20.15,0,20.15,20.15,-1,-31435,46611,78046,15176,0,-5150,0,0,0,,5150,-5150
12,03/19/2017,83,20:30,20:45,,-66.06,0,-66.06,-66.06,-1,-43371,62151,105522,18780,0,-34423,0,0,0,,34423,-34423
12,03/19/2017,84,20:45,21:00,,-30.33,0,-30.33,-30.33,-1,-29477,75847,105324,46370,0,-24751,0,0,0,,24751,-24751
12,03/19/2017,85,21:00,21:15,42.09,25.09,0,42.09,25.09,2,-43809,41463,85272,-2346,0,-10970,1913,0,0,,12883,-9057
12,03/19/2017,86,21:15,21:30,,13.02,0,13.02,13.02,-1,-28567,60874,89441,32307,0,-19293,0,0,0,,19293,-19293
12,03/19/2017,87,21:30,21:45,,20.15,0,20.15,20.15,-1,-24921,50840,75761,25919,0,-27877,0,0,0,,27877,-27877
12,03/19/2017,88,21:45,22:00,,13.59,0,13.59,13.59,-1,-25332,67424,92756,42092,0,-33272,0,0,0,,33272,-33272
12,03/19/2017,89,22:00,22:15,31.99,28.04,0,31.99,31.99,1,-43011,29433,72444,-13578,0,-13094,559,0,0,,13653,-12535
12,03/19/2017,90,22:15,22:30,31.99,27,0,27,27,-1,-43537,47998,91535,4461,0,-2404,128,0,0,,2532,-2276
12,03/19/2017,91,22:30,22:45,,25.09,0,25.09,25.09,-1,-30320,55394,85714,25074,0,-10100,0,0,0,,10100,-10100
12,03/19/2017,92,22:45,23:00,,20.15,0,20.15,20.15,-1,-33543,80135,113678,46592,0,-26679,0,0,0,,26679,-26679
12,03/19/2017,93,23:00,23:15,31.72,28.85,0,31.72,28.85,2,-77213,45156,122369,-32057,0,-10120,659,0,0,,10779,-9461
12,03/19/2017,94,23:15,23:30,,,0,29.8,29.8,0,-68652,38928,107580,-29724,0,0,53,0,0,,53,53
12,03/19/2017,95,23:30,23:45,32.09,,0,32.09,32.09,1,-67066,47179,114245,-19887,0,0,1148,0,0,,1148,1148
12,03/19/2017,96,23:45,0:00,,29.89,0,29.89,29.89,-1,-78258,69572,147830,-8686,0,-32,0,0,0,,32,-32
12,03/20/2017,1,0:00,0:15,,25.08,0,25.08,25.08,-1,-52654,52061,104715,-593,0,-2351,0,0,0,,2351,-2351
12,03/20/2017,2,0:15,0:30,,25.08,0,25.08,25.08,-1,-52989,59820,112809,6831,0,-2312,0,0,0,,2312,-2312
12,03/20/2017,3,0:30,0:45,,20.15,0,20.15,20.15,-1,-49636,75743,125379,26107,0,-20267,0,0,0,,20267,-20267
12,03/20/2017,4,0:45,1:00,,26.39,0,26.39,26.39,-1,-71314,73920,145234,2606,0,-8486,0,0,0,,8486,-8486
12,03/20/2017,5,1:00,1:15,,26.39,0,26.39,26.39,-1,-62645,64506,127151,1861,0,-2002,0,0,0,,2002,-2002
12,03/20/2017,6,1:15,1:30,,28.34,0,28.34,28.34,-1,-58494,51402,109896,-7092,0,-1722,0,0,0,,1722,-1722
12,03/20/2017,7,1:30,1:45,,30.08,0,30.08,30.08,-1,-59495,46705,106200,-12790,0,-571,0,0,0,,571,-571
12,03/20/2017,8,1:45,2:00,,30.08,0,30.08,30.08,-1,-74750,59379,134129,-15371,0,-1399,0,0,0,,1399,-1399
12,03/20/2017,9,2:00,2:15,,26.39,0,26.39,26.39,-1,-40647,51957,92604,11310,0,-4010,0,0,0,,4010,-4010
12,03/20/2017,10,2:15,2:30,,25.08,0,25.08,25.08,-1,-60392,62824,123216,2432,0,-9339,0,0,0,,9339,-9339
12,03/20/2017,11,2:30,2:45,,25.08,0,25.08,25.08,-1,-60921,61176,122097,255,0,-22247,0,0,0,,22247,-22247
12,03/20/2017,12,2:45,3:00,,30.08,0,30.08,30.08,-1,-73761,63264,137025,-10497,0,-4232,0,0,0,,4232,-4232
12,03/20/2017,13,3:00,3:15,,17.94,0,17.94,17.94,-1,-53570,95631,149201,42061,0,-8539,0,0,0,,8539,-8539
12,03/20/2017,14,3:15,3:30,,7.92,0,7.92,7.92,-1,-36962,69375,106337,32413,0,-17563,0,0,0,,17563,-17563
12,03/20/2017,15,3:30,3:45,,25.08,0,25.08,25.08,-1,-37194,50420,87614,13226,0,-19953,0,0,0,,19953,-19953
12,03/20/2017,16,3:45,4:00,,28.34,0,28.34,28.34,-1,-44003,62805,106808,18802,0,-2281,0,0,0,,2281,-2281
12,03/20/2017,17,4:00,4:15,,-500,0,-500,-500,-1,-48841,74575,123416,25734,0,-19043,0,0,0,,19043,-19043
12,03/20/2017,18,4:15,4:30,,29.08,0,29.08,29.08,-1,-65491,67909,133400,2418,0,-3677,0,0,0,,3677,-3677
12,03/20/2017,19,4:30,4:45,,30.08,0,30.08,30.08,-1,-75098,61183,136281,-13915,0,-1669,0,0,0,,1669,-1669
12,03/20/2017,20,4:45,5:00,,25.22,0,25.22,25.22,-1,-67892,63250,131142,-4642,0,-1724,0,0,0,,1724,-1724
12,03/20/2017,21,5:00,5:15,43.12,25.22,0,43.12,43.12,1,-140853,71613,212466,-69240,0,-379,8731,0,0,,9110,8352
12,03/20/2017,22,5:15,5:30,29.64,,0,29.64,29.64,1,-77898,54075,131973,-23823,0,0,2514,0,0,,2514,2514
12,03/20/2017,23,5:30,5:45,28.6,,0,28.6,28.6,1,-106234,47609,153843,-58625,0,0,1,0,0,,1,1
12,03/20/2017,24,5:45,6:00,29.64,29.08,0,29.64,28.84,2,-110861,86027,196888,-24834,0,-33,556,0,0,,589,523
12,03/20/2017,25,6:00,6:15,,29.08,0,29.08,29.08,-1,-115886,71110,186996,-44776,0,-73,0,0,0,,73,-73
12,03/20/2017,26,6:15,6:30,,,0,28.88,28.88,0,-91249,41944,133193,-49305,0,0,0,0,0,,0,0
12,03/20/2017,27,6:30,6:45,28.67,,0,28.67,28.67,1,-97407,33090,130497,-64317,0,0,15,0,0,,15,15
12,03/20/2017,28,6:45,7:00,185.08,,0,185.08,185.08,1,-130675,54243,184918,-76432,0,0,18789,0,0,,18789,18789
12,03/20/2017,29,7:00,7:15,32.08,28.17,0,28.17,28.17,-1,-126982,104395,231377,-22587,0,-112,6918,0,0,,7030,6806
12,03/20/2017,30,7:15,7:30,,28.02,0,28.02,28.02,-1,-67163,64523,131686,-2640,0,-1187,0,0,0,,1187,-1187
12,03/20/2017,31,7:30,7:45,32.08,28.02,0,32.08,32.08,1,-93282,58493,151775,-34789,0,-6,1457,0,0,,1463,1451
12,03/20/2017,32,7:45,8:00,334.48,,0,334.48,334.48,1,-132699,51710,184409,-80989,0,0,23227,0,0,,23227,23227
12,03/20/2017,33,8:00,8:15,33.31,,0,33.31,33.31,1,-53977,130906,184883,76929,0,0,9514,0,0,,9514,9514
12,03/20/2017,34,8:15,8:30,,,0,28.54,28.54,0,-44553,91195,135748,46642,0,0,0,0,0,,0,0
12,03/20/2017,35,8:30,8:45,,,0,31.63,31.63,0,-35943,57005,92948,21062,0,0,0,0,0,,0,0
12,03/20/2017,36,8:45,9:00,,34.99,0,34.99,34.99,-1,-46237,47055,93292,818,0,-395,0,0,0,,395,-395
12,03/20/2017,37,9:00,9:15,48,34.99,0,48,48,1,-68784,66900,135684,-1884,0,-247,2734,0,0,,2981,2487
12,03/20/2017,38,9:15,9:30,266.94,,0,266.94,266.94,1,-93794,77503,171297,-16291,0,0,29110,0,0,,29110,29110
12,03/20/2017,39,9:30,9:45,266.94,22.17,0,22.17,22.17,-1,-58230,82036,140266,23806,0,-5489,3733,0,0,,9222,-1756
12,03/20/2017,40,9:45,10:00,48,28.14,0,48,48,1,-55383,40674,96057,-14709,0,-2283,841,0,0,,3124,-1442
12,03/20/2017,41,10:00,10:15,257.64,,0,257.64,257.64,1,-70040,56347,126387,-13693,0,0,22266,0,0,,22266,22266
12,03/20/2017,42,10:15,10:30,29.96,,0,29.96,29.96,1,-45427,58640,104067,13213,0,0,1249,0,0,,1249,1249
12,03/20/2017,43,10:30,10:45,30.94,,0,30.94,30.94,1,-38804,39704,78508,900,0,0,2469,0,0,,2469,2469
12,03/20/2017,44,10:45,11:00,,,0,31.83,31.83,0,-35104,40079,75183,4975,0,0,77,0,0,,77,77
12,03/20/2017,45,11:00,11:15,435.24,,0,435.24,435.24,1,-74402,32339,106741,-42063,0,0,19020,0,0,,19020,19020
12,03/20/2017,46,11:15,11:30,40.62,28.15,0,40.62,28.15,2,-43935,49144,93079,5209,0,-74,12603,0,0,,12677,12529
12,03/20/2017,47,11:30,11:45,33.12,,0,33.12,33.12,1,-42197,46232,88429,4035,0,0,965,0,0,,965,965
12,03/20/2017,48,11:45,12:00,38.62,,0,38.62,38.62,1,-47949,35075,83024,-12874,0,0,7322,0,0,,7322,7322
12,03/20/2017,49,12:00,12:15,36.46,,0,36.46,36.46,1,-64183,56227,120410,-7956,0,0,9983,0,0,,9983,9983
12,03/20/2017,50,12:15,12:30,36.46,28.41,0,28.41,28.41,-1,-66510,67361,133871,851,0,-174,129,0,0,,303,-45
12,03/20/2017,51,12:30,12:45,,28.15,0,28.15,28.15,-1,-55965,79788,135753,23823,0,-1399,0,0,0,,1399,-1399
12,03/20/2017,52,12:45,13:00,,34.29,0,34.29,34.29,-1,-48886,77662,126548,28776,0,-291,0,0,0,,291,-291
12,03/20/2017,53,13:00,13:15,,,0,31.38,31.38,0,-37881,56419,94300,18538,0,0,0,0,0,,0,0
12,03/20/2017,54,13:15,13:30,,,0,31.53,31.53,0,-40500,44279,84779,3779,0,0,0,0,0,,0,0
12,03/20/2017,55,13:30,13:45,32.08,,0,32.08,32.08,1,-44526,40596,85122,-3930,0,0,815,0,0,,815,815
12,03/20/2017,56,13:45,14:00,32.08,,0,32.08,32.08,1,-49995,38855,88850,-11140,0,0,722,0,0,,722,722
12,03/20/2017,57,14:00,14:15,29.06,,0,29.06,29.06,1,-52624,39881,92505,-12743,0,0,1001,0,0,,1001,1001
12,03/20/2017,58,14:15,14:30,29.06,28.02,0,28.02,28.02,-1,-52043,36530,88573,-15513,0,-122,22,0,0,,144,-100
12,03/20/2017,59,14:30,14:45,,26.34,0,26.34,26.34,-1,-38848,35597,74445,-3251,0,-1431,0,0,0,,1431,-1431
12,03/20/2017,60,14:45,15:00,,26.34,0,26.34,26.34,-1,-50901,36470,87371,-14431,0,-1407,0,0,0,,1407,-1407
12,03/20/2017,61,15:00,15:15,,23.78,0,23.78,23.78,-1,-35464,46342,81806,10878,0,-5725,0,0,0,,5725,-5725
12,03/20/2017,62,15:15,15:30,,21.34,0,21.34,21.34,-1,-42095,43543,85638,1448,0,-21168,0,0,0,,21168,-21168
12,03/20/2017,63,15:30,15:45,,,0,31.58,31.58,0,-53129,45497,98626,-7632,0,-2895,0,0,0,,2895,-2895
12,03/20/2017,64,15:45,16:00,,23.86,0,23.86,23.86,-1,-50909,51166,102075,257,0,-1444,0,0,0,,1444,-1444
12,03/20/2017,65,16:00,16:15,29.06,23.78,0,29.06,29.06,1,-56821,38029,94850,-18792,0,-3082,84,0,0,,3166,-2998
12,03/20/2017,66,16:15,16:30,37.02,,0,37.02,37.02,1,-56245,28188,84433,-28057,0,0,10291,0,0,,10291,10291
12,03/20/2017,67,16:30,16:45,32.38,,0,32.38,32.38,1,-44295,39656,83951,-4639,0,0,6704,0,0,,6704,6704
12,03/20/2017,68,16:45,17:00,29.06,,0,29.06,29.06,1,-60359,56055,116414,-4304,0,0,82,0,0,,82,82
12,03/20/2017,69,17:00,17:15,32.08,,0,32.08,32.08,1,-80970,40137,121107,-40833,0,0,452,0,0,,452,452
12,03/20/2017,70,17:15,17:30,,,0,31.83,31.83,0,-75785,35313,111098,-40472,0,0,0,0,0,,0,0
12,03/20/2017,71,17:30,17:45,,,0,31.83,31.83,0,-74634,48782,123416,-25852,0,0,0,0,0,,0,0
12,03/20/2017,72,17:45,18:00,32.08,,0,32.08,32.08,1,-70037,93625,163662,23588,0,0,772,0,0,,772,772
12,03/20/2017,73,18:00,18:15,32.08,9.89,0,9.89,9.89,-1,-74086,77302,151388,3216,0,-5445,487,0,0,,5932,-4958
12,03/20/2017,74,18:15,18:30,28.67,9.89,0,31.83,9.89,2,-61456,56829,118285,-4627,0,-14014,3,0,0,,14017,-14011
12,03/20/2017,75,18:30,18:45,32.08,9.89,0,32.08,32.08,1,-48560,57296,105856,8736,0,-64,1205,0,0,,1269,1141
12,03/20/2017,76,18:45,19:00,28.67,,0,28.67,28.67,1,-72286,83667,155953,11381,0,0,100,0,0,,100,100
12,03/20/2017,77,19:00,19:15,,,0,31.83,31.83,0,-44913,79948,124861,35035,0,0,0,0,0,,0,0
12,03/20/2017,78,19:15,19:30,34.08,,0,34.08,34.08,1,-75745,69271,145016,-6474,0,0,648,0,0,,648,648
12,03/20/2017,79,19:30,19:45,34.08,,0,34.08,34.08,1,-80002,63774,143776,-16228,0,0,588,0,0,,588,588
12,03/20/2017,80,19:45,20:00,,,0,31.28,31.28,0,-93167,66989,160156,-26178,0,0,0,0,0,,0,0
12,03/20/2017,81,20:00,20:15,,,0,31.88,31.88,0,-85290,67261,152551,-18029,0,0,0,0,0,,0,0
12,03/20/2017,82,20:15,20:30,,,0,31.53,31.53,0,-89171,41224,130395,-47947,0,0,0,0,0,,0,0
12,03/20/2017,83,20:30,20:45,29.06,,0,29.06,29.06,1,-81653,25915,107568,-55738,0,0,570,0,0,,570,570
12,03/20/2017,84,20:45,21:00,35.41,,0,35.41,35.41,1,-119503,19896,139399,-99607,0,0,4707,0,0,,4707,4707
12,03/20/2017,85,21:00,21:15,,,0,31.83,31.83,0,-117056,76510,193566,-40546,0,0,528,0,0,,528,528
12,03/20/2017,86,21:15,21:30,34.62,,0,34.62,34.62,1,-107826,52989,160815,-54837,0,0,1558,0,0,,1558,1558
12,03/20/2017,87,21:30,21:45,34.62,,0,34.62,34.62,1,-86315,49103,135418,-37212,0,0,1080,0,0,,1080,1080
12,03/20/2017,88,21:45,22:00,28.67,,0,28.67,28.67,1,-98643,38400,137043,-60243,0,0,192,0,0,,192,192
12,03/20/2017,89,22:00,22:15,28.67,,0,28.67,28.67,1,-129412,57782,187194,-71630,0,0,465,0,0,,465,465
12,03/20/2017,90,22:15,22:30,28.67,,0,28.67,28.67,1,-96634,54496,151130,-42138,0,0,205,0,0,,205,205
12,03/20/2017,91,22:30,22:45,36.08,,0,36.08,36.08,1,-67249,47305,114554,-19944,0,0,6198,0,0,,6198,6198
12,03/20/2017,92,22:45,23:00,36.08,25.34,0,36.08,25.34,2,-63279,63341,126620,62,0,-311,14881,0,0,,15192,14570
12,03/20/2017,93,23:00,23:15,355.38,25.34,0,355.38,25.34,2,-107300,22300,129600,-85000,0,-570,14973,0,0,,15543,14403
12,03/20/2017,94,23:15,23:30,39.7,,0,39.7,39.7,1,-84083,40225,124308,-43858,0,0,18019,0,0,,18019,18019
12,03/20/2017,95,23:30,23:45,,,0,28.54,28.54,0,-67274,49186,116460,-18088,0,0,206,0,0,,206,206
12,03/20/2017,96,23:45,0:00,29.06,,0,29.06,29.06,1,-71658,67310,138968,-4348,0,0,165,0,0,,165,165
12,03/21/2017,1,0:00,0:15,350.99,,0,350.99,350.99,1,-123810,25967,149777,-97843,0,0,31568,0,0,,31568,31568
12,03/21/2017,2,0:15,0:30,35.57,,0,35.57,35.57,1,-66552,38914,105466,-27638,0,0,14431,0,0,,14431,14431
12,03/21/2017,3,0:30,0:45,48.02,,0,48.02,48.02,1,-85631,54872,140503,-30759,0,0,20136,0,0,,20136,20136
12,03/21/2017,4,0:45,1:00,39.02,,0,39.02,39.02,1,-104228,64635,168863,-39593,0,0,21756,0,0,,21756,21756
12,03/21/2017,5,1:00,1:15,340.21,,0,340.21,340.21,1,-126097,46552,172649,-79545,0,0,51445,0,0,,51445,51445
12,03/21/2017,6,1:15,1:30,44.02,,0,44.02,44.02,1,-98015,65210,163225,-32805,0,0,37078,0,0,,37078,37078
12,03/21/2017,7,1:30,1:45,235.78,,0,235.78,235.78,1,-93782,45272,139054,-48510,0,0,24232,0,0,,24232,24232
12,03/21/2017,8,1:45,2:00,235.78,,0,235.78,235.78,1,-114348,65905,180253,-48443,0,0,45181,0,0,,45181,45181
12,03/21/2017,9,2:00,2:15,28.94,17.89,0,29.67,17.89,2,-60961,80623,141584,19662,0,-3232,11453,0,0,,14685,8221
12,03/21/2017,10,2:15,2:30,206.7,17.89,0,206.7,206.7,1,-75198,30390,105588,-44808,0,-104,21856,0,0,,21960,21752
12,03/21/2017,11,2:30,2:45,44.02,,0,44.02,44.02,1,-63802,39886,103688,-23916,0,0,40208,0,0,,40208,40208
12,03/21/2017,12,2:45,3:00,41.57,,0,41.57,41.57,1,-65650,39927,105577,-25723,0,0,15626,0,0,,15626,15626
12,03/21/2017,13,3:00,3:15,41.57,,0,41.57,41.57,1,-84352,54709,139061,-29643,0,0,15306,0,0,,15306,15306
12,03/21/2017,14,3:15,3:30,31.57,,0,31.57,31.57,1,-77558,67559,145117,-9999,0,0,7119,0,0,,7119,7119
12,03/21/2017,15,3:30,3:45,41.57,,0,41.57,41.57,1,-76700,52502,129202,-24198,0,0,6507,0,0,,6507,6507
12,03/21/2017,16,3:45,4:00,31.57,,0,31.57,31.57,1,-75977,68057,144034,-7920,0,0,6163,0,0,,6163,6163
12,03/21/2017,17,4:00,4:15,44.02,,0,44.02,44.02,1,-73092,54435,127527,-18657,0,0,10033,0,0,,10033,10033
12,03/21/2017,18,4:15,4:30,44.02,,0,44.02,44.02,1,-59455,53734,113189,-5721,0,0,23123,0,0,,23123,23123
12,03/21/2017,19,4:30,4:45,44.02,27.71,0,27.71,27.71,-1,-43174,49981,93155,6807,0,-927,3007,0,0,,3934,2080
12,03/21/2017,20,4:45,5:00,31.67,27.71,0,31.67,31.67,1,-55973,48671,104644,-7302,0,-174,1514,0,0,,1688,1340
12,03/21/2017,21,5:00,5:15,,,0,29.19,29.19,0,-41548,49411,90959,7863,0,0,0,0,0,,0,0
12,03/21/2017,22,5:15,5:30,34.96,,0,34.96,34.96,1,-48532,24618,73150,-23914,0,0,2891,0,0,,2891,2891
12,03/21/2017,23,5:30,5:45,34.96,,0,34.96,34.96,1,-81119,23737,104856,-57382,0,0,655,0,0,,655,655
12,03/21/2017,24,5:45,6:00,41.57,,0,41.57,41.57,1,-87232,22751,109983,-64481,0,0,5451,0,0,,5451,5451
12,03/21/2017,25,6:00,6:15,28.94,,0,28.94,28.94,1,-87628,35922,123550,-51706,0,0,1544,0,0,,1544,1544
12,03/21/2017,26,6:15,6:30,28.94,25.35,0,25.35,25.35,-1,-46966,50645,97611,3679,0,-1355,256,0,0,,1611,-1099
12,03/21/2017,27,6:30,6:45,,,0,28.42,28.42,0,-70641,42366,113007,-28275,0,-9,0,0,0,,9,-9
12,03/21/2017,28,6:45,7:00,35.57,,0,35.57,35.57,1,-112048,73609,185657,-38439,0,0,4295,0,0,,4295,4295
12,03/21/2017,29,7:00,7:15,28.55,25.13,0,28.55,25.13,2,-53253,53402,106655,149,0,-1054,1415,0,0,,2469,361
12,03/21/2017,30,7:15,7:30,79.01,,0,79.01,79.01,1,-54822,30296,85118,-24526,0,0,14598,0,0,,14598,14598
12,03/21/2017,31,7:30,7:45,387.01,,0,387.01,387.01,1,-76599,25128,101727,-51471,0,0,18585,0,0,,18585,18585
12,03/21/2017,32,7:45,8:00,387.01,,0,387.01,387.01,1,-86657,50820,137477,-35837,0,0,39620,0,0,,39620,39620
12,03/21/2017,33,8:00,8:15,49.2,,0,49.2,49.2,1,-82170,57792,139962,-24378,0,0,16654,0,0,,16654,16654
12,03/21/2017,34,8:15,8:30,72.02,,0,72.02,72.02,1,-78096,39669,117765,-38427,0,0,28496,0,0,,28496,28496
12,03/21/2017,35,8:30,8:45,29.59,25.17,0,25.17,25.17,-1,-47385,60309,107694,12924,0,-1762,8457,0,0,,10219,6695
12,03/21/2017,36,8:45,9:00,,25.17,0,25.17,25.17,-1,-50655,64222,114877,13567,0,-5661,0,0,0,,5661,-5661
12,03/21/2017,37,9:00,9:15,,27.9,0,27.9,27.9,-1,-72986,66128,139114,-6858,0,-2988,0,0,0,,2988,-2988
12,03/21/2017,38,9:15,9:30,,14.63,0,14.63,14.63,-1,-28539,47380,75919,18841,0,-16339,0,0,0,,16339,-16339
12,03/21/2017,39,9:30,9:45,,-10.24,0,-10.24,-10.24,-1,-10903,55477,66380,44574,0,-35115,0,0,0,,35115,-35115
12,03/21/2017,40,9:45,10:00,,-10.24,0,-10.24,-10.24,-1,-52172,54325,106497,2153,0,-29704,0,0,0,,29704,-29704
12,03/21/2017,41,10:00,10:15,29.59,-10.24,0,29.59,29.59,1,-80089,86495,166584,6406,0,-561,839,0,0,,1400,278
12,03/21/2017,42,10:15,10:30,,,0,30.07,30.07,0,-68794,80351,149145,11557,0,0,22,0,0,,22,22
12,03/21/2017,43,10:30,10:45,,26.34,0,26.34,26.34,-1,-36159,102192,138351,66033,0,-343,0,0,0,,343,-343
12,03/21/2017,44,10:45,11:00,,26.34,0,26.34,26.34,-1,-13625,110032,123657,96407,0,-1708,0,0,0,,1708,-1708
12,03/21/2017,45,11:00,11:15,,,0,30.22,30.22,0,-47641,69859,117500,22218,0,-105,0,0,0,,105,-105
12,03/21/2017,46,11:15,11:30,,20,0,20,20,-1,-43064,100193,143257,57129,0,-9663,0,0,0,,9663,-9663
12,03/21/2017,47,11:30,11:45,,25.1,0,25.1,25.1,-1,-34864,100295,135159,65431,0,-14891,0,0,0,,14891,-14891
12,03/21/2017,48,11:45,12:00,,,0,30.07,30.07,0,-24465,92533,116998,68068,0,-1257,0,0,0,,1257,-1257
12,03/21/2017,49,12:00,12:15,,26.34,0,26.34,26.34,-1,-45471,91459,136930,45988,0,-501,0,0,0,,501,-501
12,03/21/2017,50,12:15,12:30,,20,0,20,20,-1,-45910,89825,135735,43915,0,-9588,0,0,0,,9588,-9588
12,03/21/2017,51,12:30,12:45,,17.89,0,17.89,17.89,-1,-65734,81182,146916,15448,0,-16836,0,0,0,,16836,-16836
12,03/21/2017,52,12:45,13:00,,25.35,0,25.35,25.35,-1,-59256,84269,143525,25013,0,-2420,0,0,0,,2420,-2420
12,03/21/2017,53,13:00,13:15,,27.9,0,27.9,27.9,-1,-69932,78700,148632,8768,0,-2850,0,0,0,,2850,-2850
12,03/21/2017,54,13:15,13:30,,,0,30.22,30.22,0,-90262,62635,152897,-27627,0,-141,0,0,0,,141,-141
12,03/21/2017,55,13:30,13:45,,,0,30.07,30.07,0,-102895,50820,153715,-52075,0,0,0,0,0,,0,0
12,03/21/2017,56,13:45,14:00,,,0,30.02,30.02,0,-119122,52327,171449,-66795,0,0,0,0,0,,0,0
12,03/21/2017,57,14:00,14:15,120.02,,0,120.02,120.02,1,-136732,41538,178270,-95194,0,0,8224,0,0,,8224,8224
12,03/21/2017,58,14:15,14:30,120.02,,0,120.02,120.02,1,-121006,51957,172963,-69049,0,0,44415,0,0,,44415,44415
12,03/21/2017,59,14:30,14:45,28.55,,0,28.55,28.55,1,-99913,66270,166183,-33643,0,0,6911,0,0,,6911,6911
12,03/21/2017,60,14:45,15:00,,,0,29.87,29.87,0,-105648,52133,157781,-53515,0,0,0,0,0,,0,0
12,03/21/2017,61,15:00,15:15,,26.35,0,26.35,26.35,-1,-63789,70998,134787,7209,0,-21,0,0,0,,21,-21
12,03/21/2017,62,15:15,15:30,,,0,29.97,29.97,0,-72639,58877,131516,-13762,0,0,0,0,0,,0,0
12,03/21/2017,63,15:30,15:45,,,0,30.07,30.07,0,-87825,47789,135614,-40036,0,0,0,0,0,,0,0
12,03/21/2017,64,15:45,16:00,34.79,,0,34.79,34.79,1,-92167,48336,140503,-43831,0,0,1413,0,0,,1413,1413
12,03/21/2017,65,16:00,16:15,,,0,30.22,30.22,0,-51470,89048,140518,37578,0,0,47,0,0,,47,47
12,03/21/2017,66,16:15,16:30,,,0,30.02,30.02,0,-55863,68729,124592,12866,0,0,0,0,0,,0,0
12,03/21/2017,67,16:30,16:45,32.59,,0,32.59,32.59,1,-70515,73292,143807,2777,0,0,914,0,0,,914,914
12,03/21/2017,68,16:45,17:00,41.57,,0,41.57,41.57,1,-82697,59482,142179,-23215,0,0,16156,0,0,,16156,16156
12,03/21/2017,69,17:00,17:15,31.57,22.05,0,31.57,22.05,2,-59853,93528,153381,33675,0,-2079,8786,0,0,,10865,6707
12,03/21/2017,70,17:15,17:30,31.57,31.39,0,31.39,31.39,-1,-69693,63819,133512,-5874,0,-1114,23,0,0,,1137,-1091
12,03/21/2017,71,17:30,17:45,115.63,,0,115.63,115.63,1,-101106,53428,154534,-47678,0,0,8531,0,0,,8531,8531
12,03/21/2017,72,17:45,18:00,147.65,,0,147.65,147.65,1,-94060,66614,160674,-27446,0,0,27807,0,0,,27807,27807
12,03/21/2017,73,18:00,18:15,,,0,29.82,29.82,0,-67146,48127,115273,-19019,0,0,6002,0,0,,6002,6002
12,03/21/2017,74,18:15,18:30,37.98,,0,37.98,37.98,1,-72747,37107,109854,-35640,0,0,488,0,0,,488,488
12,03/21/2017,75,18:30,18:45,130.52,,0,130.52,130.52,1,-79877,47421,127298,-32456,0,0,16653,0,0,,16653,16653
12,03/21/2017,76,18:45,19:00,346.99,,0,346.99,346.99,1,-91364,42588,133952,-48776,0,0,34294,0,0,,34294,34294
12,03/21/2017,77,19:00,19:15,31.67,28.29,0,28.29,28.29,-1,-59223,46132,105355,-13091,0,-71,14752,0,0,,14823,14681
12,03/21/2017,78,19:15,19:30,397.65,,0,397.65,397.65,1,-95537,14067,109604,-81470,0,0,18994,0,0,,18994,18994
12,03/21/2017,79,19:30,19:45,397.65,,0,397.65,397.65,1,-69600,37961,107561,-31639,0,0,44841,0,0,,44841,44841
12,03/21/2017,80,19:45,20:00,31.67,,0,31.67,31.67,1,-66583,33728,100311,-32855,0,0,8024,0,0,,8024,8024
12,03/21/2017,81,20:00,20:15,370.25,,0,370.25,370.25,1,-148715,55967,204682,-92748,0,0,23518,0,0,,23518,23518
12,03/21/2017,82,20:15,20:30,33.02,,0,33.02,33.02,1,-117311,69883,187194,-47428,0,0,12121,0,0,,12121,12121
12,03/21/2017,83,20:30,20:45,,,0,28.42,28.42,0,-109855,80513,190368,-29342,0,0,55,0,0,,55,55
12,03/21/2017,84,20:45,21:00,,-50.56,0,-50.56,-50.56,-1,-49471,89031,138502,39560,0,-17867,0,0,0,,17867,-17867
12,03/21/2017,85,21:00,21:15,401.3,23.74,0,401.3,23.74,2,-98544,39416,137960,-59128,0,-4779,17196,0,0,,21975,12417
12,03/21/2017,86,21:15,21:30,35.57,,0,35.57,35.57,1,-48668,96120,144788,47452,0,0,8477,0,0,,8477,8477
12,03/21/2017,87,21:30,21:45,,25.35,0,25.35,25.35,-1,-32753,99577,132330,66824,0,-885,0,0,0,,885,-885
12,03/21/2017,88,21:45,22:00,,-70.87,0,-70.87,-70.87,-1,-50241,103818,154059,53577,0,-36940,0,0,0,,36940,-36940
12,03/21/2017,89,22:00,22:15,455.69,-70.87,0,455.69,455.69,1,-85083,41528,126611,-43555,0,-9487,13310,0,0,,22797,3823
12,03/21/2017,90,22:15,22:30,455.69,-34.18,0,-34.18,-34.18,-1,-31645,78482,110127,46837,0,-21661,2147,0,0,,23808,-19514
12,03/21/2017,91,22:30,22:45,,26.34,0,26.34,26.34,-1,-22256,91092,113348,68836,0,-10447,0,0,0,,10447,-10447
12,03/21/2017,92,22:45,23:00,,-50.72,0,-50.72,-50.72,-1,-18250,141961,160211,123711,0,-25363,0,0,0,,25363,-25363
12,03/21/2017,93,23:00,23:15,297.08,-20.23,0,297.08,-20.23,2,-73088,30004,103092,-43084,0,-24745,4684,0,0,,29429,-20061
12,03/21/2017,94,23:15,23:30,29.92,-50.78,0,-50.78,-50.78,-1,-36751,77016,113767,40265,0,-6867,2234,0,0,,9101,-4633
12,03/21/2017,95,23:30,23:45,,-50.78,0,-50.78,-50.78,-1,-58042,85752,143794,27710,0,-21214,0,0,0,,21214,-21214
12,03/21/2017,96,23:45,0:00,,-50.78,0,-50.78,-50.78,-1,-42122,113526,155648,71404,0,-26127,0,0,0,,26127,-26127
12,03/22/2017,1,0:00,0:15,35.4,-20.24,0,35.4,-20.24,2,-91767,62009,153776,-29758,0,-18994,1064,0,0,,20058,-17930
12,03/22/2017,2,0:15,0:30,35.4,27.78,0,27.78,27.78,-1,-49542,79417,128959,29875,0,-844,7,0,0,,851,-837
12,03/22/2017,3,0:30,0:45,,27.78,0,27.78,27.78,-1,-51507,60168,111675,8661,0,-2292,0,0,0,,2292,-2292
12,03/22/2017,4,0:45,1:00,,,0,29.7,29.7,0,-90992,22722,113714,-68270,0,0,0,0,0,,0,0
12,03/22/2017,5,1:00,1:15,43.03,,0,43.03,43.03,1,-91882,12506,104388,-79376,0,0,2626,0,0,,2626,2626
12,03/22/2017,6,1:15,1:30,48,,0,48,48,1,-81046,6674,87720,-74372,0,0,9766,0,0,,9766,9766
12,03/22/2017,7,1:30,1:45,56.12,,0,56.12,56.12,1,-77137,20811,97948,-56326,0,0,13871,0,0,,13871,13871
12,03/22/2017,8,1:45,2:00,34.03,,0,34.03,34.03,1,-77360,34980,112340,-42380,0,0,9076,0,0,,9076,9076
12,03/22/2017,9,2:00,2:15,28.89,,0,28.89,28.89,1,-49490,40569,90059,-8921,0,0,226,0,0,,226,226
12,03/22/2017,10,2:15,2:30,31.57,,0,31.57,31.57,1,-43932,36649,80581,-7283,0,0,1820,0,0,,1820,1820
12,03/22/2017,11,2:30,2:45,,,0,29.01,29.01,0,-42476,47919,90395,5443,0,0,0,0,0,,0,0
12,03/22/2017,12,2:45,3:00,,28.57,0,28.57,28.57,-1,-47120,52310,99430,5190,0,-361,0,0,0,,361,-361
12,03/22/2017,13,3:00,3:15,,28.13,0,28.13,28.13,-1,-25933,62508,88441,36575,0,-1917,0,0,0,,1917,-1917
12,03/22/2017,14,3:15,3:30,,26.91,0,26.91,26.91,-1,-31214,55199,86413,23985,0,-768,0,0,0,,768,-768
12,03/22/2017,15,3:30,3:45,,24.57,0,24.57,24.57,-1,-24667,70136,94803,45469,0,-3430,0,0,0,,3430,-3430
12,03/22/2017,16,3:45,4:00,,-0.14,0,-0.14,-0.14,-1,-31582,85209,116791,53627,0,-38209,0,0,0,,38209,-38209
12,03/22/2017,17,4:00,4:15,,28.57,0,28.57,28.57,-1,-73157,56172,129329,-16985,0,-10982,0,0,0,,10982,-10982
12,03/22/2017,18,4:15,4:30,,,0,29.7,29.7,0,-31354,70271,101625,38917,0,0,0,0,0,,0,0
12,03/22/2017,19,4:30,4:45,,,0,29.01,29.01,0,-29218,74217,103435,44999,0,0,0,0,0,,0,0
12,03/22/2017,20,4:45,5:00,29.96,,0,29.96,29.96,1,-40975,66030,107005,25055,0,0,77,0,0,,77,77
12,03/22/2017,21,5:00,5:15,35.67,24.57,0,35.67,24.57,2,-56806,53637,110443,-3169,0,-1491,1194,0,0,,2685,-297
12,03/22/2017,22,5:15,5:30,31.57,24.57,0,31.57,24.57,2,-61627,38304,99931,-23323,0,-3881,173,0,0,,4054,-3708
12,03/22/2017,23,5:30,5:45,31.57,,0,31.57,31.57,1,-61597,55255,116852,-6342,0,0,1208,0,0,,1208,1208
12,03/22/2017,24,5:45,6:00,35.67,,0,35.67,35.67,1,-61068,96979,158047,35911,0,0,5279,0,0,,5279,5279
12,03/22/2017,25,6:00,6:15,,30.87,0,30.87,30.87,-1,-79073,107802,186875,28729,0,-149,0,0,0,,149,-149
12,03/22/2017,26,6:15,6:30,,30.87,0,30.87,30.87,-1,-53881,78735,132616,24854,0,-482,0,0,0,,482,-482
12,03/22/2017,27,6:30,6:45,,28.22,0,28.22,28.22,-1,-70030,75498,145528,5468,0,-1136,0,0,0,,1136,-1136
12,03/22/2017,28,6:45,7:00,36.69,28.22,0,36.69,36.69,1,-95309,72837,168146,-22472,0,-15,4545,0,0,,4560,4530
12,03/22/2017,29,7:00,7:15,36.69,-66.4,0,-66.4,-66.4,-1,-23907,185604,209511,161697,0,-18121,485,0,0,,18606,-17636
12,03/22/2017,30,7:15,7:30,,30.58,0,30.58,30.58,-1,-45330,103634,148964,58304,0,-1266,0,0,0,,1266,-1266
12,03/22/2017,31,7:30,7:45,,,0,29.74,29.74,0,-66147,79444,145591,13297,0,-14,0,0,0,,14,-14
12,03/22/2017,32,7:45,8:00,36.69,,0,36.69,36.69,1,-96172,59298,155470,-36874,0,0,3569,0,0,,3569,3569
12,03/22/2017,33,8:00,8:15,31.22,28.22,0,31.22,28.22,2,-67130,105197,172327,38067,0,-2379,2582,0,0,,4961,203
12,03/22/2017,34,8:15,8:30,,30.87,0,30.87,30.87,-1,-61834,78105,139939,16271,0,-110,0,0,0,,110,-110
12,03/22/2017,35,8:30,8:45,,28.81,0,28.81,28.81,-1,-40142,65514,105656,25372,0,-1569,0,0,0,,1569,-1569
12,03/22/2017,36,8:45,9:00,,24.22,0,24.22,24.22,-1,-34409,75599,110008,41190,0,-9666,0,0,0,,9666,-9666
12,03/22/2017,37,9:00,9:15,,20.46,0,20.46,20.46,-1,-73961,60902,134863,-13059,0,-12399,0,0,0,,12399,-12399
12,03/22/2017,38,9:15,9:30,,-0.88,0,-0.88,-0.88,-1,-50113,101169,151282,51056,0,-18829,0,0,0,,18829,-18829
12,03/22/2017,39,9:30,9:45,,9.65,0,9.65,9.65,-1,-54388,94708,149096,40320,0,-28410,0,0,0,,28410,-28410
12,03/22/2017,40,9:45,10:00,,-11.78,0,-11.78,-11.78,-1,-57146,120406,177552,63260,0,-57742,0,0,0,,57742,-57742
12,03/22/2017,41,10:00,10:15,29.96,25.78,0,29.96,25.78,2,-117844,82785,200629,-35059,0,-16430,312,0,0,,16742,-16118
12,03/22/2017,42,10:15,10:30,,-0.22,0,-0.22,-0.22,-1,-82775,125490,208265,42715,0,-10472,0,0,0,,10472,-10472
12,03/22/2017,43,10:30,10:45,,-5.75,0,-5.75,-5.75,-1,-92716,123362,216078,30646,0,-36029,0,0,0,,36029,-36029
12,03/22/2017,44,10:45,11:00,,7.73,0,7.73,7.73,-1,-65606,119580,185186,53974,0,-31555,0,0,0,,31555,-31555
12,03/22/2017,45,11:00,11:15,,7.4,0,7.4,7.4,-1,-87124,110607,197731,23483,0,-26493,0,0,0,,26493,-26493
12,03/22/2017,46,11:15,11:30,,28.22,0,28.22,28.22,-1,-76898,109441,186339,32543,0,-17738,0,0,0,,17738,-17738
12,03/22/2017,47,11:30,11:45,,24.22,0,24.22,24.22,-1,-76064,110039,186103,33975,0,-22532,0,0,0,,22532,-22532
12,03/22/2017,48,11:45,12:00,,24.22,0,24.22,24.22,-1,-72505,107263,179768,34758,0,-20788,0,0,0,,20788,-20788
12,03/22/2017,49,12:00,12:15,269.82,24.22,0,269.82,269.82,1,-129895,65506,195401,-64389,0,-4302,14320,0,0,,18622,10018
12,03/22/2017,50,12:15,12:30,34.59,30.1,0,30.1,30.1,-1,-79559,94596,174155,15037,0,-26,5384,0,0,,5410,5358
12,03/22/2017,51,12:30,12:45,,29.78,0,29.78,29.78,-1,-67291,97509,164800,30218,0,-1124,0,0,0,,1124,-1124
12,03/22/2017,52,12:45,13:00,,30.1,0,30.1,30.1,-1,-77021,79779,156800,2758,0,-693,0,0,0,,693,-693
12,03/22/2017,53,13:00,13:15,41.95,30.1,0,41.95,41.95,1,-124745,60558,185303,-64187,0,-77,4966,0,0,,5043,4889
12,03/22/2017,54,13:15,13:30,42.12,,0,42.12,42.12,1,-143230,48200,191430,-95030,0,0,15783,0,0,,15783,15783
12,03/22/2017,55,13:30,13:45,268.16,,0,268.16,268.16,1,-149497,42706,192203,-106791,0,0,38019,0,0,,38019,38019
12,03/22/2017,56,13:45,14:00,35.32,,0,35.32,35.32,1,-136891,53534,190425,-83357,0,0,17263,0,0,,17263,17263
12,03/22/2017,57,14:00,14:15,36.19,,0,36.19,36.19,1,-68723,55000,123723,-13723,0,0,7325,0,0,,7325,7325
12,03/22/2017,58,14:15,14:30,35.32,,0,35.32,35.32,1,-80032,52699,132731,-27333,0,0,14887,0,0,,14887,14887
12,03/22/2017,59,14:30,14:45,41.72,,0,41.72,41.72,1,-82976,44631,127607,-38345,0,0,29969,0,0,,29969,29969
12,03/22/2017,60,14:45,15:00,36.19,,0,36.19,36.19,1,-80774,45892,126666,-34882,0,0,22456,0,0,,22456,22456
12,03/22/2017,61,15:00,15:15,36.19,29.03,0,29.03,29.03,-1,-46735,70444,117179,23709,0,-260,1259,0,0,,1519,999
12,03/22/2017,62,15:15,15:30,28.5,,0,28.5,28.5,1,-50181,54027,104208,3846,0,0,2,0,0,,2,2
12,03/22/2017,63,15:30,15:45,42.35,,0,42.35,42.35,1,-69551,40618,110169,-28933,0,0,11025,0,0,,11025,11025
12,03/22/2017,64,15:45,16:00,35.32,,0,35.32,35.32,1,-81097,43536,124633,-37561,0,0,22032,0,0,,22032,22032
12,03/22/2017,65,16:00,16:15,34.59,,0,34.59,34.59,1,-42466,43191,85657,725,0,0,12551,0,0,,12551,12551
12,03/22/2017,66,16:15,16:30,,,0,29.7,29.7,0,-58280,32794,91074,-25486,0,0,132,0,0,,132,132
12,03/22/2017,67,16:30,16:45,273.42,,0,273.42,273.42,1,-98541,38038,136579,-60503,0,0,19842,0,0,,19842,19842
12,03/22/2017,68,16:45,17:00,273.42,,0,273.42,273.42,1,-104159,54430,158589,-49729,0,0,54779,0,0,,54779,54779
12,03/22/2017,69,17:00,17:15,28.5,,0,28.5,28.5,1,-56565,15340,71905,-41225,0,0,11464,0,0,,11464,11464
12,03/22/2017,70,17:15,17:30,,,0,29.7,29.7,0,-102730,13213,115943,-89517,0,0,0,0,0,,0,0
12,03/22/2017,71,17:30,17:45,325.85,,0,325.85,325.85,1,-130828,17725,148553,-113103,0,0,11349,0,0,,11349,11349
12,03/22/2017,72,17:45,18:00,325.85,,0,325.85,325.85,1,-98946,31259,130205,-67687,0,0,50394,0,0,,50394,50394
12,03/22/2017,73,18:00,18:15,36.46,,0,36.46,36.46,1,-81581,54961,136542,-26620,0,0,14663,0,0,,14663,14663
12,03/22/2017,74,18:15,18:30,48.4,,0,48.4,48.4,1,-75730,47859,123589,-27871,0,0,2069,0,0,,2069,2069
12,03/22/2017,75,18:30,18:45,48.4,,0,48.4,48.4,1,-60072,54673,114745,-5399,0,0,13444,0,0,,13444,13444
12,03/22/2017,76,18:45,19:00,48.4,,0,48.4,48.4,1,-95976,69105,165081,-26871,0,0,17098,0,0,,17098,17098
12,03/22/2017,77,19:00,19:15,35,,0,35,35,1,-51680,47525,99205,-4155,0,0,11479,0,0,,11479,11479
12,03/22/2017,78,19:15,19:30,28.4,,0,28.4,28.4,1,-76599,35097,111696,-41502,0,0,359,0,0,,359,359
12,03/22/2017,79,19:30,19:45,28.4,,0,28.4,28.4,1,-65502,43593,109095,-21909,0,0,1325,0,0,,1325,1325
12,03/22/2017,80,19:45,20:00,,,0,29.65,29.65,0,-52718,54493,107211,1775,0,0,11,0,0,,11,11
12,03/22/2017,81,20:00,20:15,44.98,,0,44.98,44.98,1,-84699,52275,136974,-32424,0,0,4621,0,0,,4621,4621
12,03/22/2017,82,20:15,20:30,28.4,,0,28.4,28.4,1,-64032,45917,109949,-18115,0,0,162,0,0,,162,162
12,03/22/2017,83,20:30,20:45,,28.29,0,28.29,28.29,-1,-43725,53513,97238,9788,0,-532,0,0,0,,532,-532
12,03/22/2017,84,20:45,21:00,,25.4,0,25.4,25.4,-1,-58623,74128,132751,15505,0,-14880,0,0,0,,14880,-14880
12,03/22/2017,85,21:00,21:15,41.72,21.4,0,41.72,41.72,1,-64914,49485,114399,-15429,0,-13466,2383,0,0,,15849,-11083
12,03/22/2017,86,21:15,21:30,28.5,21.4,0,28.5,28.5,1,-53287,42742,96029,-10545,0,-249,2377,0,0,,2626,2128
12,03/22/2017,87,21:30,21:45,,,0,29.65,29.65,0,-54878,58558,113436,3680,0,0,0,0,0,,0,0
12,03/22/2017,88,21:45,22:00,,25.4,0,25.4,25.4,-1,-59123,78756,137879,19633,0,-3754,0,0,0,,3754,-3754
12,03/22/2017,89,22:00,22:15,35.23,21.78,0,35.23,21.78,2,-88029,20789,108818,-67240,0,-6100,3139,0,0,,9239,-2961
12,03/22/2017,90,22:15,22:30,28.5,,0,28.5,28.5,1,-70041,28709,98750,-41332,0,0,2358,0,0,,2358,2358
12,03/22/2017,91,22:30,22:45,,,0,29.65,29.65,0,-41032,38257,79289,-2775,0,0,0,0,0,,0,0
12,03/22/2017,92,22:45,23:00,,25.4,0,25.4,25.4,-1,-54773,62467,117240,7694,0,-2307,0,0,0,,2307,-2307
12,03/22/2017,93,23:00,23:15,,30.02,0,30.02,30.02,-1,-80582,34812,115394,-45770,0,-1162,0,0,0,,1162,-1162
12,03/22/2017,94,23:15,23:30,,30.41,0,30.41,30.41,-1,-58489,22058,80547,-36431,0,-4,0,0,0,,4,-4
12,03/22/2017,95,23:30,23:45,,28.29,0,28.29,28.29,-1,-45056,47088,92144,2032,0,-988,0,0,0,,988,-988
12,03/22/2017,96,23:45,0:00,,-19.55,0,-19.55,-19.55,-1,-42567,75324,117891,32757,0,-13909,0,0,0,,13909,-13909
12,03/23/2017,1,0:00,0:15,313.44,-21.49,0,313.44,-21.49,2,-72971,16482,89453,-56489,0,-21778,7503,0,0,,29281,-14275
12,03/23/2017,2,0:15,0:30,313.44,-5.34,0,313.44,-5.34,2,-27095,53494,80589,26399,0,-2166,18466,0,0,,20632,16300
12,03/23/2017,3,0:30,0:45,313.44,-63.35,0,-63.35,-63.35,-1,-38885,77323,116208,38438,0,-37207,14,0,0,,37221,-37193
12,03/23/2017,4,0:45,1:00,,23.86,0,23.86,23.86,-1,-79251,76411,155662,-2840,0,-28485,0,0,0,,28485,-28485
12,03/23/2017,5,1:00,1:15,31.22,23.86,0,31.22,31.22,1,-53994,67452,121446,13458,0,-5423,881,0,0,,6304,-4542
12,03/23/2017,6,1:15,1:30,,,0,29.7,29.7,0,-43825,81169,124994,37344,0,0,22,0,0,,22,22
12,03/23/2017,7,1:30,1:45,,,0,29.7,29.7,0,-44417,74068,118485,29651,0,0,0,0,0,,0,0
12,03/23/2017,8,1:45,2:00,,25.42,0,25.42,25.42,-1,-38885,78160,117045,39275,0,-3760,0,0,0,,3760,-3760
12,03/23/2017,9,2:00,2:15,,28.09,0,28.09,28.09,-1,-31034,51502,82536,20468,0,-2107,0,0,0,,2107,-2107
12,03/23/2017,10,2:15,2:30,31.19,,0,31.19,31.19,1,-49051,37085,86136,-11966,0,0,814,0,0,,814,814
12,03/23/2017,11,2:30,2:45,,,0,29.72,29.72,0,-51697,43420,95117,-8277,0,0,0,0,0,,0,0
12,03/23/2017,12,2:45,3:00,,26.42,0,26.42,26.42,-1,-51274,47752,99026,-3522,0,-2724,0,0,0,,2724,-2724
12,03/23/2017,13,3:00,3:15,,31.42,0,31.42,31.42,-1,-60067,42610,102677,-17457,0,-841,0,0,0,,841,-841
12,03/23/2017,14,3:15,3:30,,,0,29.75,29.75,0,-61126,23970,85096,-37156,0,0,0,0,0,,0,0
12,03/23/2017,15,3:30,3:45,,,0,29.75,29.75,0,-70924,19789,90713,-51135,0,0,0,0,0,,0,0
12,03/23/2017,16,3:45,4:00,,,0,29.75,29.75,0,-70623,12314,82937,-58309,0,0,0,0,0,,0,0
12,03/23/2017,17,4:00,4:15,28.46,,0,28.46,28.46,1,-57232,27278,84510,-29954,0,0,214,0,0,,214,214
12,03/23/2017,18,4:15,4:30,28.07,,0,28.07,28.07,1,-68372,22399,90771,-45973,0,0,897,0,0,,897,897
12,03/23/2017,19,4:30,4:45,,,0,29.76,29.76,0,-71068,40337,111405,-30731,0,0,9,0,0,,9,9
12,03/23/2017,20,4:45,5:00,31.19,,0,31.19,31.19,1,-69654,55356,125010,-14298,0,0,116,0,0,,116,116
12,03/23/2017,21,5:00,5:15,314,,0,314,314,1,-113360,17651,131011,-95709,0,0,28470,0,0,,28470,28470
12,03/23/2017,22,5:15,5:30,41.22,,0,41.22,41.22,1,-79298,33251,112549,-46047,0,0,28408,0,0,,28408,28408
12,03/23/2017,23,5:30,5:45,35.22,,0,35.22,35.22,1,-92183,59166,151349,-33017,0,0,12100,0,0,,12100,12100
12,03/23/2017,24,5:45,6:00,354.82,,0,354.82,354.82,1,-114084,63033,177117,-51051,0,0,13915,0,0,,13915,13915
12,03/23/2017,25,6:00,6:15,34.84,,0,34.84,34.84,1,-154337,96648,250985,-57689,0,0,13387,0,0,,13387,13387
12,03/23/2017,26,6:15,6:30,31.19,,0,31.19,31.19,1,-124294,77787,202081,-46507,0,0,4099,0,0,,4099,4099
12,03/23/2017,27,6:30,6:45,53.02,,0,53.02,53.02,1,-139250,66001,205251,-73249,0,0,6458,0,0,,6458,6458
12,03/23/2017,28,6:45,7:00,358.42,,0,358.42,358.42,1,-150982,72632,223614,-78350,0,0,43300,0,0,,43300,43300
12,03/23/2017,29,7:00,7:15,358.42,-89.06,0,-89.06,-89.06,-1,-102489,176091,278580,73602,0,-10062,5875,0,0,,15937,-4187
12,03/23/2017,30,7:15,7:30,,31.51,0,31.51,31.51,-1,-75794,81359,157153,5565,0,-565,0,0,0,,565,-565
12,03/23/2017,31,7:30,7:45,33.43,31.51,0,33.43,33.43,1,-78414,57613,136027,-20801,0,-217,760,0,0,,977,543
12,03/23/2017,32,7:45,8:00,36.26,,0,36.26,36.26,1,-110755,41927,152682,-68828,0,0,14108,0,0,,14108,14108
12,03/23/2017,33,8:00,8:15,30.02,,0,30.02,30.02,1,-104320,113977,218297,9657,0,0,6398,0,0,,6398,6398
12,03/23/2017,34,8:15,8:30,35.5,,0,35.5,35.5,1,-119421,98019,217440,-21402,0,0,9349,0,0,,9349,9349
12,03/23/2017,35,8:30,8:45,30.84,,0,30.84,30.84,1,-105527,108802,214329,3275,0,0,7196,0,0,,7196,7196
12,03/23/2017,36,8:45,9:00,31.19,,0,31.19,31.19,1,-115480,99872,215352,-15608,0,0,2874,0,0,,2874,2874
12,03/23/2017,37,9:00,9:15,31.19,23.86,0,23.86,23.86,-1,-103927,115697,219624,11770,0,-1595,362,0,0,,1957,-1233
12,03/23/2017,38,9:15,9:30,,-2.89,0,-2.89,-2.89,-1,-91007,133946,224953,42939,0,-17117,0,0,0,,17117,-17117
12,03/23/2017,39,9:30,9:45,,-19.98,0,-19.98,-19.98,-1,-107384,134662,242046,27278,0,-33524,0,0,0,,33524,-33524
12,03/23/2017,40,9:45,10:00,,-15.6,0,-15.6,-15.6,-1,-111033,158894,269927,47861,0,-36985,0,0,0,,36985,-36985
12,03/23/2017,41,10:00,10:15,,23.86,0,23.86,23.86,-1,-142966,86610,229576,-56356,0,-10796,0,0,0,,10796,-10796
12,03/23/2017,42,10:15,10:30,,20.92,0,20.92,20.92,-1,-122194,128739,250933,6545,0,-2708,0,0,0,,2708,-2708
12,03/23/2017,43,10:30,10:45,,8.91,0,8.91,8.91,-1,-100932,147084,248016,46152,0,-27956,0,0,0,,27956,-27956
12,03/23/2017,44,10:45,11:00,,-2.1,0,-2.1,-2.1,-1,-105606,156591,262197,50985,0,-49104,0,0,0,,49104,-49104
12,03/23/2017,45,11:00,11:15,,17.41,0,17.41,17.41,-1,-63949,99029,162978,35080,0,-39477,0,0,0,,39477,-39477
12,03/23/2017,46,11:15,11:30,,-17.03,0,-17.03,-17.03,-1,-58716,113863,172579,55147,0,-51355,0,0,0,,51355,-51355
12,03/23/2017,47,11:30,11:45,,-23.03,0,-23.03,-23.03,-1,-66687,131639,198326,64952,0,-62519,0,0,0,,62519,-62519
12,03/23/2017,48,11:45,12:00,,-6.18,0,-6.18,-6.18,-1,-80514,150316,230830,69802,0,-63939,0,0,0,,63939,-63939
12,03/23/2017,49,12:00,12:15,,-6.18,0,-6.18,-6.18,-1,-92580,119596,212176,27016,0,-44946,0,0,0,,44946,-44946
12,03/23/2017,50,12:15,12:30,,-23.03,0,-23.03,-23.03,-1,-90854,146071,236925,55217,0,-36090,0,0,0,,36090,-36090
12,03/23/2017,51,12:30,12:45,,-6.18,0,-6.18,-6.18,-1,-93908,152930,246838,59022,0,-60823,0,0,0,,60823,-60823
12,03/23/2017,52,12:45,13:00,,-6.18,0,-6.18,-6.18,-1,-93539,152986,246525,59447,0,-59064,0,0,0,,59064,-59064
12,03/23/2017,53,13:00,13:15,,20.92,0,20.92,20.92,-1,-93515,117372,210887,23857,0,-27619,0,0,0,,27619,-27619
12,03/23/2017,54,13:15,13:30,,,0,29.85,29.85,0,-82321,118350,200671,36029,0,-448,0,0,0,,448,-448
12,03/23/2017,55,13:30,13:45,,7.3,0,7.3,7.3,-1,-78143,122040,200183,43897,0,-11307,0,0,0,,11307,-11307
12,03/23/2017,56,13:45,14:00,,20.03,0,20.03,20.03,-1,-80635,110885,191520,30250,0,-27383,0,0,0,,27383,-27383
12,03/23/2017,57,14:00,14:15,,20.03,0,20.03,20.03,-1,-82155,108584,190739,26429,0,-29694,0,0,0,,29694,-29694
12,03/23/2017,58,14:15,14:30,,24.92,0,24.92,24.92,-1,-81435,100721,182156,19286,0,-12391,0,0,0,,12391,-12391
12,03/23/2017,59,14:30,14:45,,25.92,0,25.92,25.92,-1,-80279,93332,173611,13053,0,-7468,0,0,0,,7468,-7468
12,03/23/2017,60,14:45,15:00,,24.92,0,24.92,24.92,-1,-89916,102644,192560,12728,0,-6525,0,0,0,,6525,-6525
12,03/23/2017,61,15:00,15:15,,26.89,0,26.89,26.89,-1,-112482,112591,225073,109,0,-3420,0,0,0,,3420,-3420
12,03/23/2017,62,15:15,15:30,,20.92,0,20.92,20.92,-1,-101316,115063,216379,13747,0,-16144,0,0,0,,16144,-16144
12,03/23/2017,63,15:30,15:45,34.84,25.92,0,34.84,34.84,1,-110144,99735,209879,-10409,0,-9497,505,0,0,,10002,-8992
12,03/23/2017,64,15:45,16:00,44.35,25.92,0,44.35,44.35,1,-122686,90074,212760,-32612,0,-107,22146,0,0,,22253,22039
12,03/23/2017,65,16:00,16:15,44.35,-62.66,0,-62.66,-62.66,-1,-54395,151546,205941,97151,0,-27350,3696,0,0,,31046,-23654
12,03/23/2017,66,16:15,16:30,,-20.03,0,-20.03,-20.03,-1,-67876,127870,195746,59994,0,-56539,0,0,0,,56539,-56539
12,03/23/2017,67,16:30,16:45,,17.41,0,17.41,17.41,-1,-77441,116076,193517,38635,0,-39951,0,0,0,,39951,-39951
12,03/23/2017,68,16:45,17:00,,-12.79,0,-12.79,-12.79,-1,-63826,124187,188013,60361,0,-34576,0,0,0,,34576,-34576
12,03/23/2017,69,17:00,17:15,34.45,20.92,0,34.45,34.45,1,-135749,120620,256369,-15129,0,-17842,181,0,0,,18023,-17661
12,03/23/2017,70,17:15,17:30,36.57,20.92,0,36.57,36.57,1,-120340,116036,236376,-4304,0,-512,3217,0,0,,3729,2705
12,03/23/2017,71,17:30,17:45,28.07,,0,28.07,28.07,1,-121007,113477,234484,-7530,0,0,468,0,0,,468,468
12,03/23/2017,72,17:45,18:00,30.84,,0,30.84,30.84,1,-119851,109212,229063,-10639,0,0,2759,0,0,,2759,2759
12,03/23/2017,73,18:00,18:15,30,,0,30,30,1,-136720,87449,224169,-49271,0,0,2225,0,0,,2225,2225
12,03/23/2017,74,18:15,18:30,28.46,,0,28.46,28.46,1,-122316,112016,234332,-10300,0,0,333,0,0,,333,333
12,03/23/2017,75,18:30,18:45,,24.92,0,24.92,24.92,-1,-97989,103898,201887,5909,0,-5431,0,0,0,,5431,-5431
12,03/23/2017,76,18:45,19:00,,25.92,0,25.92,25.92,-1,-106326,95814,202140,-10512,0,-482,0,0,0,,482,-482
12,03/23/2017,77,19:00,19:15,,-53.31,0,-53.31,-53.31,-1,-97142,139734,236876,42592,0,-24262,0,0,0,,24262,-24262
12,03/23/2017,78,19:15,19:30,39.98,31.24,0,39.98,39.98,1,-114009,88621,202630,-25388,0,-2285,3098,0,0,,5383,813
12,03/23/2017,79,19:30,19:45,45.9,30.43,0,45.9,29.85,2,-91434,91720,183154,286,0,-49,12486,0,0,,12535,12437
12,03/23/2017,80,19:45,20:00,45.9,22.94,0,22.94,22.94,-1,-82578,109800,192378,27222,0,-7767,140,0,0,,7907,-7627
12,03/23/2017,81,20:00,20:15,37.77,22.28,0,37.77,37.77,1,-64859,61509,126368,-3350,0,-7021,2548,0,0,,9569,-4473
12,03/23/2017,82,20:15,20:30,37.77,22.28,0,37.77,37.77,1,-43999,62862,106861,18863,0,-70,4473,0,0,,4543,4403
12,03/23/2017,83,20:30,20:45,,5.97,0,5.97,5.97,-1,-32728,83570,116298,50842,0,-3394,0,0,0,,3394,-3394
12,03/23/2017,84,20:45,21:00,,-9.63,0,-9.63,-9.63,-1,-45522,85354,130876,39832,0,-27503,0,0,0,,27503,-27503
12,03/23/2017,85,21:00,21:15,,24.92,0,24.92,24.92,-1,-53672,77676,131348,24004,0,-16503,0,0,0,,16503,-16503
12,03/23/2017,86,21:15,21:30,,5.97,0,5.97,5.97,-1,-30430,87557,117987,57127,0,-4462,0,0,0,,4462,-4462
12,03/23/2017,87,21:30,21:45,,-10.03,0,-10.03,-10.03,-1,-33388,78289,111677,44901,0,-29283,0,0,0,,29283,-29283
12,03/23/2017,88,21:45,22:00,,-53.31,0,-53.31,-53.31,-1,-51830,104821,156651,52991,0,-31221,0,0,0,,31221,-31221
12,03/23/2017,89,22:00,22:15,30.84,-53.31,0,30.84,-53.31,2,-95104,60094,155198,-35010,0,-27180,907,0,0,,28087,-26273
12,03/23/2017,90,22:15,22:30,30.84,-66.3,0,-66.3,-66.3,-1,-38388,99187,137575,60799,0,-23345,176,0,0,,23521,-23169
12,03/23/2017,91,22:30,22:45,,-9.63,0,-9.63,-9.63,-1,-45547,117209,162756,71662,0,-44462,0,0,0,,44462,-44462
12,03/23/2017,92,22:45,23:00,,-29.39,0,-29.39,-29.39,-1,-56091,143599,199690,87508,0,-54255,0,0,0,,54255,-54255
12,03/23/2017,93,23:00,23:15,34.61,-29.39,0,34.61,-29.39,2,-126230,55058,181288,-71172,0,-39809,307,0,0,,40116,-39502
12,03/23/2017,94,23:15,23:30,34.84,-29.39,0,34.84,34.84,1,-87288,69225,156513,-18063,0,-568,889,0,0,,1457,321
12,03/23/2017,95,23:30,23:45,,21.07,0,21.07,21.07,-1,-74604,100769,175373,26165,0,-5806,0,0,0,,5806,-5806
12,03/23/2017,96,23:45,0:00,,-8.75,0,-8.75,-8.75,-1,-82292,137490,219782,55198,0,-48455,0,0,0,,48455,-48455
12,03/24/2017,1,0:00,0:15,30.69,7.22,0,30.69,30.69,1,-45967,62890,108857,16923,0,-27132,295,0,0,,27427,-26837
12,03/24/2017,2,0:15,0:30,30.69,-53.12,0,-53.12,-53.12,-1,-24399,89861,114260,65462,0,-14836,98,0,0,,14934,-14738
12,03/24/2017,3,0:30,0:45,,-53.12,0,-53.12,-53.12,-1,-45693,75175,120868,29482,0,-28731,0,0,0,,28731,-28731
12,03/24/2017,4,0:45,1:00,,-45.7,0,-45.7,-45.7,-1,-37844,91750,129594,53906,0,-47669,0,0,0,,47669,-47669
12,03/24/2017,5,1:00,1:15,,13.78,0,13.78,13.78,-1,-43346,55524,98870,12178,0,-25320,0,0,0,,25320,-25320
12,03/24/2017,6,1:15,1:30,,23.84,0,23.84,23.84,-1,-25667,46792,72459,21125,0,-3907,0,0,0,,3907,-3907
12,03/24/2017,7,1:30,1:45,,23.84,0,23.84,23.84,-1,-42093,49667,91760,7574,0,-4343,0,0,0,,4343,-4343
12,03/24/2017,8,1:45,2:00,,27.84,0,27.84,27.84,-1,-52539,56648,109187,4109,0,-732,0,0,0,,732,-732
12,03/24/2017,9,2:00,2:15,,27.84,0,27.84,27.84,-1,-38925,29700,68625,-9225,0,-1084,0,0,0,,1084,-1084
12,03/24/2017,10,2:15,2:30,,,0,29.83,29.83,0,-51340,31205,82545,-20135,0,0,0,0,0,,0,0
12,03/24/2017,11,2:30,2:45,,,0,29.83,29.83,0,-54198,36470,90668,-17728,0,0,0,0,0,,0,0
12,03/24/2017,12,2:45,3:00,,28.34,0,28.34,28.34,-1,-52353,49799,102152,-2554,0,-659,0,0,0,,659,-659
12,03/24/2017,13,3:00,3:15,,27.78,0,27.78,27.78,-1,-75370,74968,150338,-402,0,-2465,0,0,0,,2465,-2465
12,03/24/2017,14,3:15,3:30,,28.34,0,28.34,28.34,-1,-75963,75101,151064,-862,0,-698,0,0,0,,698,-698
12,03/24/2017,15,3:30,3:45,,30.84,0,30.84,30.84,-1,-69309,66891,136200,-2418,0,-536,0,0,0,,536,-536
12,03/24/2017,16,3:45,4:00,,18.98,0,18.98,18.98,-1,-61895,67993,129888,6098,0,-7566,0,0,0,,7566,-7566
12,03/24/2017,17,4:00,4:15,,-6.18,0,-6.18,-6.18,-1,-42473,72307,114780,29834,0,-39015,0,0,0,,39015,-39015
12,03/24/2017,18,4:15,4:30,,-6.18,0,-6.18,-6.18,-1,-44650,83516,128166,38866,0,-29318,0,0,0,,29318,-29318
12,03/24/2017,19,4:30,4:45,,-6.18,0,-6.18,-6.18,-1,-45814,81261,127075,35447,0,-42335,0,0,0,,42335,-42335
12,03/24/2017,20,4:45,5:00,,22.78,0,22.78,22.78,-1,-53490,85777,139267,32287,0,-40301,0,0,0,,40301,-40301
12,03/24/2017,21,5:00,5:15,,-23.03,0,-23.03,-23.03,-1,-29775,116223,145998,86448,0,-52031,0,0,0,,52031,-52031
12,03/24/2017,22,5:15,5:30,,16.78,0,16.78,16.78,-1,-37143,101208,138351,64065,0,-44596,0,0,0,,44596,-44596
12,03/24/2017,23,5:30,5:45,,25.78,0,25.78,25.78,-1,-30558,91136,121694,60578,0,-16828,0,0,0,,16828,-16828
12,03/24/2017,24,5:45,6:00,,25.65,0,25.65,25.65,-1,-39723,80552,120275,40829,0,-2392,0,0,0,,2392,-2392
12,03/24/2017,25,6:00,6:15,,8.86,0,8.86,8.86,-1,-44479,120799,165278,76320,0,-16679,0,0,0,,16679,-16679
12,03/24/2017,26,6:15,6:30,,8.86,0,8.86,8.86,-1,-43758,109537,153295,65779,0,-24807,0,0,0,,24807,-24807
12,03/24/2017,27,6:30,6:45,,31.19,0,31.19,31.19,-1,-40594,81789,122383,41195,0,-4010,0,0,0,,4010,-4010
12,03/24/2017,28,6:45,7:00,,29.11,0,29.11,29.11,-1,-61067,66418,127485,5351,0,-754,0,0,0,,754,-754
12,03/24/2017,29,7:00,7:15,,-53.36,0,-53.36,-53.36,-1,-64867,111115,175982,46248,0,-18356,0,0,0,,18356,-18356
12,03/24/2017,30,7:15,7:30,,31.19,0,31.19,31.19,-1,-65584,67290,132874,1706,0,-2221,0,0,0,,2221,-2221
12,03/24/2017,31,7:30,7:45,31.11,31.19,0,31.11,29.8,2,-58300,39678,97978,-18622,0,-1353,55,0,0,,1408,-1298
12,03/24/2017,32,7:45,8:00,432.77,31.19,0,432.77,432.77,1,-120055,19146,139201,-100909,0,-9,32530,0,0,,32539,32521
12,03/24/2017,33,8:00,8:15,449.54,,0,449.54,449.54,1,-138910,126570,265480,-12340,0,0,57071,0,0,,57071,57071
12,03/24/2017,34,8:15,8:30,31.97,30.38,0,31.97,30.01,2,-128126,131409,259535,3283,0,-99,1559,0,0,,1658,1460
12,03/24/2017,35,8:30,8:45,73.22,,0,73.22,73.22,1,-132107,94979,227086,-37128,0,0,23802,0,0,,23802,23802
12,03/24/2017,36,8:45,9:00,72.22,,0,72.22,72.22,1,-133344,81977,215321,-51367,0,0,45621,0,0,,45621,45621
12,03/24/2017,37,9:00,9:15,296.61,,0,296.61,296.61,1,-142831,73316,216147,-69515,0,0,62681,0,0,,62681,62681
12,03/24/2017,38,9:15,9:30,47.09,,0,47.09,47.09,1,-140115,106485,246600,-33630,0,0,34265,0,0,,34265,34265
12,03/24/2017,39,9:30,9:45,47.09,,0,47.09,47.09,1,-135664,120013,255677,-15651,0,0,25576,0,0,,25576,25576
12,03/24/2017,40,9:45,10:00,47.09,30.39,0,30.39,30.39,-1,-132820,136620,269440,3800,0,-570,2995,0,0,,3565,2425
12,03/24/2017,41,10:00,10:15,,30.31,0,30.31,30.31,-1,-23038,107577,130615,84539,0,-2708,0,0,0,,2708,-2708
12,03/24/2017,42,10:15,10:30,,31.59,0,31.59,31.59,-1,-17880,107918,125798,90038,0,-1530,0,0,0,,1530,-1530
12,03/24/2017,43,10:30,10:45,,34.99,0,34.99,34.99,-1,-14614,104342,118956,89728,0,-43,0,0,0,,43,-43
12,03/24/2017,44,10:45,11:00,,28.11,0,28.11,28.11,-1,-17412,104824,122236,87412,0,-552,0,0,0,,552,-552
12,03/24/2017,45,11:00,11:15,,,0,29.82,29.82,0,-62406,141611,204017,79205,0,-5,0,0,0,,5,-5
12,03/24/2017,46,11:15,11:30,,33.19,0,33.19,33.19,-1,-58438,150542,208980,92104,0,-13,0,0,0,,13,-13
12,03/24/2017,47,11:30,11:45,,24.11,0,24.11,24.11,-1,-57150,158803,215953,101653,0,-2730,0,0,0,,2730,-2730
12,03/24/2017,48,11:45,12:00,,29.11,0,29.11,29.11,-1,-53501,160233,213734,106732,0,-9,0,0,0,,9,-9
12,03/24/2017,49,12:00,12:15,,19.98,0,19.98,19.98,-1,-41954,97978,139932,56024,0,-15838,0,0,0,,15838,-15838
12,03/24/2017,50,12:15,12:30,,7.25,0,7.25,7.25,-1,-41381,88005,129386,46624,0,-35222,0,0,0,,35222,-35222
12,03/24/2017,51,12:30,12:45,,3.37,0,3.37,3.37,-1,-48194,80345,128539,32151,0,-34702,0,0,0,,34702,-34702
12,03/24/2017,52,12:45,13:00,,17.36,0,17.36,17.36,-1,-52011,95990,148001,43979,0,-32984,0,0,0,,32984,-32984
12,03/24/2017,53,13:00,13:15,31.54,21.34,0,31.54,31.54,1,-56709,49707,106416,-7002,0,-19951,499,0,0,,20450,-19452
12,03/24/2017,54,13:15,13:30,31.54,25.6,0,25.6,25.6,-1,-53852,62148,116000,8296,0,-1353,231,0,0,,1584,-1122
12,03/24/2017,55,13:30,13:45,,6.26,0,6.26,6.26,-1,-53500,82167,135667,28667,0,-28605,0,0,0,,28605,-28605
12,03/24/2017,56,13:45,14:00,,-50.78,0,-50.78,-50.78,-1,-62803,105515,168318,42712,0,-41425,0,0,0,,41425,-41425
12,03/24/2017,57,14:00,14:15,,-50.78,0,-50.78,-50.78,-1,-53850,84812,138662,30962,0,-37032,0,0,0,,37032,-37032
12,03/24/2017,58,14:15,14:30,,-8.8,0,-8.8,-8.8,-1,-35735,90465,126200,54730,0,-7149,0,0,0,,7149,-7149
12,03/24/2017,59,14:30,14:45,,-10.22,0,-10.22,-10.22,-1,-48527,103131,151658,54604,0,-35378,0,0,0,,35378,-35378
12,03/24/2017,60,14:45,15:00,,-50.78,0,-50.78,-50.78,-1,-47667,122652,170319,74985,0,-48455,0,0,0,,48455,-48455
12,03/24/2017,61,15:00,15:15,37.3,-50.78,0,37.3,37.3,1,-125003,99466,224469,-25537,0,-13206,1592,0,0,,14798,-11614
12,03/24/2017,62,15:15,15:30,37.3,17.36,0,17.36,17.36,-1,-84908,107301,192209,22393,0,-11186,8,0,0,,11194,-11178
12,03/24/2017,63,15:30,15:45,,11.33,0,11.33,11.33,-1,-91940,102021,193961,10081,0,-25656,0,0,0,,25656,-25656
12,03/24/2017,64,15:45,16:00,,-8.8,0,-8.8,-8.8,-1,-92191,121138,213329,28947,0,-11463,0,0,0,,11463,-11463
12,03/24/2017,65,16:00,16:15,,28.11,0,28.11,28.11,-1,-129940,126262,256202,-3678,0,-7619,0,0,0,,7619,-7619
12,03/24/2017,66,16:15,16:30,,31.89,0,31.89,31.89,-1,-104266,132468,236734,28202,0,-129,0,0,0,,129,-129
12,03/24/2017,67,16:30,16:45,,-14.22,0,-14.22,-14.22,-1,-96414,137134,233548,40720,0,-16601,0,0,0,,16601,-16601
12,03/24/2017,68,16:45,17:00,,28.11,0,28.11,28.11,-1,-102769,105281,208050,2512,0,-2110,0,0,0,,2110,-2110
12,03/24/2017,69,17:00,17:15,31.11,5.92,0,31.51,5.92,2,-135364,99182,234546,-36182,0,-7674,494,0,0,,8168,-7180
12,03/24/2017,70,17:15,17:30,31.11,,0,31.11,31.11,1,-123250,79629,202879,-43621,0,0,423,0,0,,423,423
12,03/24/2017,71,17:30,17:45,31.11,,0,31.11,31.11,1,-121719,56813,178532,-64906,0,0,417,0,0,,417,417
12,03/24/2017,72,17:45,18:00,35.11,,0,35.11,35.11,1,-126013,46333,172346,-79680,0,0,9103,0,0,,9103,9103
12,03/24/2017,73,18:00,18:15,57.22,,0,57.22,57.22,1,-186842,68817,255659,-118025,0,0,10857,0,0,,10857,10857
12,03/24/2017,74,18:15,18:30,67.79,,0,67.79,67.79,1,-171470,66168,237638,-105302,0,0,35387,0,0,,35387,35387
12,03/24/2017,75,18:30,18:45,30.41,,0,30.41,30.41,1,-148983,99408,248391,-49575,0,0,9619,0,0,,9619,9619
12,03/24/2017,76,18:45,19:00,293.84,,0,293.84,293.84,1,-156145,83358,239503,-72787,0,0,9056,0,0,,9056,9056
12,03/24/2017,77,19:00,19:15,34.22,,0,34.22,34.22,1,-163141,158072,321213,-5069,0,0,5749,0,0,,5749,5749
12,03/24/2017,78,19:15,19:30,37.96,,0,37.96,37.96,1,-176231,106477,282708,-69754,0,0,3019,0,0,,3019,3019
12,03/24/2017,79,19:30,19:45,37.96,,0,37.96,37.96,1,-181327,83819,265146,-97508,0,0,7997,0,0,,7997,7997
12,03/24/2017,80,19:45,20:00,48.96,,0,48.96,48.96,1,-187241,75788,263029,-111453,0,0,22256,0,0,,22256,22256
12,03/24/2017,81,20:00,20:15,28.41,,0,28.41,28.41,1,-50140,51502,101642,1362,0,0,7216,0,0,,7216,7216
12,03/24/2017,82,20:15,20:30,28.41,20.22,0,20.22,20.22,-1,-29679,62229,91908,32550,0,-3538,17,0,0,,3555,-3521
12,03/24/2017,83,20:30,20:45,,-13.3,0,-13.3,-13.3,-1,-15058,64348,79406,49290,0,-43160,0,0,0,,43160,-43160
12,03/24/2017,84,20:45,21:00,,-58.64,0,-58.64,-58.64,-1,-27410,94189,121599,66779,0,-50624,0,0,0,,50624,-50624
12,03/24/2017,85,21:00,21:15,231.92,-48.24,0,231.92,-48.24,2,-69063,25593,94656,-43470,0,-40455,4947,0,0,,45402,-35508
12,03/24/2017,86,21:15,21:30,426.79,6.26,0,426.79,6.26,2,-16369,43941,60310,27572,0,-1691,13904,0,0,,15595,12213
12,03/24/2017,87,21:30,21:45,426.79,-27.81,0,-27.81,-27.81,-1,-9279,97449,106728,88170,0,-19453,25,0,0,,19478,-19428
12,03/24/2017,88,21:45,22:00,,-52.93,0,-52.93,-52.93,-1,-29085,103013,132098,73928,0,-66451,0,0,0,,66451,-66451
12,03/24/2017,89,22:00,22:15,,10.36,0,10.36,10.36,-1,-47951,11703,59654,-36248,0,-22134,0,0,0,,22134,-22134
12,03/24/2017,90,22:15,22:30,28.02,,0,28.02,28.02,1,-64280,23906,88186,-40374,0,0,387,0,0,,387,387
12,03/24/2017,91,22:30,22:45,31.11,,0,31.11,31.11,1,-60706,52341,113047,-8365,0,0,1404,0,0,,1404,1404
12,03/24/2017,92,22:45,23:00,29.11,-26.21,0,-26.21,-26.21,-1,-16124,82784,98908,66660,0,-7984,702,0,0,,8686,-7282
12,03/24/2017,93,23:00,23:15,,-27.81,0,-27.81,-27.81,-1,-55961,62180,118141,6219,0,-12476,0,0,0,,12476,-12476
12,03/24/2017,94,23:15,23:30,,17.36,0,17.36,17.36,-1,-35075,52935,88010,17860,0,-6815,0,0,0,,6815,-6815
12,03/24/2017,95,23:30,23:45,,14.29,0,14.29,14.29,-1,-32018,52573,84591,20555,0,-13906,0,0,0,,13906,-13906
12,03/24/2017,96,23:45,0:00,,-15.65,0,-15.65,-15.65,-1,-38304,77163,115467,38859,0,-8446,0,0,0,,8446,-8446
13,03/25/2017,1,0:00,0:15,35.11,-54.67,0,35.11,-54.67,2,-50378,56046,106424,5668,0,-15777,862,0,0,,16639,-14915
13,03/25/2017,2,0:15,0:30,35.11,-54.67,0,35.11,35.11,1,-27152,40242,67394,13090,0,-1,1291,0,0,,1292,1290
13,03/25/2017,3,0:30,0:45,,28.31,0,28.31,28.31,-1,-43734,24891,68625,-18843,0,-589,0,0,0,,589,-589
13,03/25/2017,4,0:45,1:00,,27.61,0,27.61,27.61,-1,-117829,61936,179765,-55893,0,-473,0,0,0,,473,-473
13,03/25/2017,5,1:00,1:15,28.02,27.61,0,29.2,27.61,2,-20284,64728,85012,44444,0,-1286,57,0,0,,1343,-1229
13,03/25/2017,6,1:15,1:30,28.02,5.24,0,5.24,5.24,-1,-24140,65653,89793,41513,0,-5269,33,0,0,,5302,-5236
13,03/25/2017,7,1:30,1:45,,-4.15,0,-4.15,-4.15,-1,-25246,69323,94569,44077,0,-18187,0,0,0,,18187,-18187
13,03/25/2017,8,1:45,2:00,,0.93,0,0.93,0.93,-1,-37182,79599,116781,42417,0,-25743,0,0,0,,25743,-25743
13,03/25/2017,9,2:00,2:15,,-15.65,0,-15.65,-15.65,-1,-20962,70029,90991,49067,0,-30032,0,0,0,,30032,-30032
13,03/25/2017,10,2:15,2:30,,9.79,0,9.79,9.79,-1,-21382,72298,93680,50916,0,-3157,0,0,0,,3157,-3157
13,03/25/2017,11,2:30,2:45,,5.58,0,5.58,5.58,-1,-20610,70542,91152,49932,0,-10356,0,0,0,,10356,-10356
13,03/25/2017,12,2:45,3:00,,-54.71,0,-54.71,-54.71,-1,-28084,70939,99023,42855,0,-43658,0,0,0,,43658,-43658
13,03/25/2017,13,3:00,3:15,28.41,23.61,0,28.41,28.41,1,-28034,55994,84028,27960,0,-20475,77,0,0,,20552,-20398
13,03/25/2017,14,3:15,3:30,28.41,28.8,0,29.34,28.8,2,-27257,39662,66919,12405,0,-182,92,0,0,,274,-90
13,03/25/2017,15,3:30,3:45,,23.9,0,23.9,23.9,-1,-25955,45347,71302,19392,0,-5523,0,0,0,,5523,-5523
13,03/25/2017,16,3:45,4:00,,25.03,0,25.03,25.03,-1,-32288,40873,73161,8585,0,-11454,0,0,0,,11454,-11454
13,03/25/2017,17,4:00,4:15,,30.95,0,30.95,30.95,-1,-22003,52478,74481,30475,0,-1897,0,0,0,,1897,-1897
13,03/25/2017,18,4:15,4:30,,,0,29.49,29.49,0,-27611,41058,68669,13447,0,0,0,0,0,,0,0
13,03/25/2017,19,4:30,4:45,30.61,,0,30.61,30.61,1,-42805,43076,85881,271,0,0,1272,0,0,,1272,1272
13,03/25/2017,20,4:45,5:00,,,0,29.49,29.49,0,-34443,39589,74032,5146,0,0,634,0,0,,634,634
13,03/25/2017,21,5:00,5:15,30.61,,0,30.61,30.61,1,-41417,34098,75515,-7319,0,0,1683,0,0,,1683,1683
13,03/25/2017,22,5:15,5:30,29.87,,0,29.87,29.87,1,-43170,36894,80064,-6276,0,0,2871,0,0,,2871,2871
13,03/25/2017,23,5:30,5:45,30.61,,0,30.61,30.61,1,-54839,41797,96636,-13042,0,0,3969,0,0,,3969,3969
13,03/25/2017,24,5:45,6:00,,,0,29.55,29.55,0,-55835,47304,103139,-8531,0,0,314,0,0,,314,314
13,03/25/2017,25,6:00,6:15,29.99,,0,29.99,29.99,1,-47907,43346,91253,-4561,0,0,862,0,0,,862,862
13,03/25/2017,26,6:15,6:30,,,0,29.65,29.65,0,-32223,53682,85905,21459,0,0,24,0,0,,24,24
13,03/25/2017,27,6:30,6:45,,28.34,0,28.34,28.34,-1,-33421,61568,94989,28147,0,-185,0,0,0,,185,-185
13,03/25/2017,28,6:45,7:00,,28.34,0,28.34,28.34,-1,-40318,53988,94306,13670,0,-563,0,0,0,,563,-563
13,03/25/2017,29,7:00,7:15,,,0,29.62,29.62,0,-37730,75388,113118,37658,0,0,0,0,0,,0,0
13,03/25/2017,30,7:15,7:30,,,0,29.62,29.62,0,-33776,39235,73011,5459,0,0,0,0,0,,0,0
13,03/25/2017,31,7:30,7:45,34.92,,0,34.92,34.92,1,-38605,17340,55945,-21265,0,0,756,0,0,,756,756
13,03/25/2017,32,7:45,8:00,40.92,,0,40.92,40.92,1,-57184,27855,85039,-29329,0,0,17614,0,0,,17614,17614
13,03/25/2017,33,8:00,8:15,40.92,28.34,0,28.34,28.34,-1,-22355,104890,127245,82535,0,-841,5611,0,0,,6452,4770
13,03/25/2017,34,8:15,8:30,,,0,29.47,29.47,0,-12933,67085,80018,54152,0,0,0,0,0,,0,0
13,03/25/2017,35,8:30,8:45,,,0,29.41,29.41,0,-14181,61781,75962,47600,0,0,0,0,0,,0,0
13,03/25/2017,36,8:45,9:00,,,0,29.41,29.41,0,-18556,101980,120536,83424,0,0,0,0,0,,0,0
13,03/25/2017,37,9:00,9:15,,,0,29.25,29.25,0,-29423,87295,116718,57872,0,0,0,0,0,,0,0
13,03/25/2017,38,9:15,9:30,,,0,29.25,29.25,0,-29928,104857,134785,74929,0,0,0,0,0,,0,0
13,03/25/2017,39,9:30,9:45,,27.92,0,27.92,27.92,-1,-26882,117998,144880,91116,0,-605,0,0,0,,605,-605
13,03/25/2017,40,9:45,10:00,,23.92,0,23.92,23.92,-1,-24681,133491,158172,108810,0,-16802,0,0,0,,16802,-16802
13,03/25/2017,41,10:00,10:15,,23.92,0,23.92,23.92,-1,-23956,133845,157801,109889,0,-23361,0,0,0,,23361,-23361
13,03/25/2017,42,10:15,10:30,,23.92,0,23.92,23.92,-1,-22376,121965,144341,99589,0,-7006,0,0,0,,7006,-7006
13,03/25/2017,43,10:30,10:45,,-52.4,0,-52.4,-52.4,-1,-23162,127382,150544,104220,0,-34482,0,0,0,,34482,-34482
13,03/25/2017,44,10:45,11:00,,19.05,0,19.05,19.05,-1,-25244,120167,145411,94923,0,-21383,0,0,0,,21383,-21383
13,03/25/2017,45,11:00,11:15,,25.03,0,25.03,25.03,-1,-47644,68190,115834,20546,0,-12271,0,0,0,,12271,-12271
13,03/25/2017,46,11:15,11:30,,24.84,0,24.84,24.84,-1,-42600,97642,140242,55042,0,-1008,0,0,0,,1008,-1008
13,03/25/2017,47,11:30,11:45,,5.36,0,5.36,5.36,-1,-39442,108206,147648,68764,0,-20312,0,0,0,,20312,-20312
13,03/25/2017,48,11:45,12:00,,13.68,0,13.68,13.68,-1,-38837,136993,175830,98156,0,-24365,0,0,0,,24365,-24365
13,03/25/2017,49,12:00,12:15,,23.92,0,23.92,23.92,-1,-53542,91254,144796,37712,0,-20354,0,0,0,,20354,-20354
13,03/25/2017,50,12:15,12:30,,-39.17,0,-39.17,-39.17,-1,-51663,112080,163743,60417,0,-32985,0,0,0,,32985,-32985
13,03/25/2017,51,12:30,12:45,,22.44,0,22.44,22.44,-1,-53770,127289,181059,73519,0,-21165,0,0,0,,21165,-21165
13,03/25/2017,52,12:45,13:00,,-56.36,0,-56.36,-56.36,-1,-54879,145268,200147,90389,0,-33296,0,0,0,,33296,-33296
13,03/25/2017,53,13:00,13:15,,11.7,0,11.7,11.7,-1,-46196,115779,161975,69583,0,-33088,0,0,0,,33088,-33088
13,03/25/2017,54,13:15,13:30,,-59.18,0,-59.18,-59.18,-1,-51698,121685,173383,69987,0,-61109,0,0,0,,61109,-61109
13,03/25/2017,55,13:30,13:45,,-41.66,0,-41.66,-41.66,-1,-73422,145415,218837,71993,0,-66929,0,0,0,,66929,-66929
13,03/25/2017,56,13:45,14:00,,-59.18,0,-59.18,-59.18,-1,-88300,162198,250498,73898,0,-80271,0,0,0,,80271,-80271
13,03/25/2017,57,14:00,14:15,,-12.03,0,-12.03,-12.03,-1,-61517,127543,189060,66026,0,-60066,0,0,0,,60066,-60066
13,03/25/2017,58,14:15,14:30,,-81.47,0,-81.47,-81.47,-1,-61170,147039,208209,85869,0,-51591,0,0,0,,51591,-51591
13,03/25/2017,59,14:30,14:45,,-81.47,0,-81.47,-81.47,-1,-72971,145075,218046,72104,0,-72285,0,0,0,,72285,-72285
13,03/25/2017,60,14:45,15:00,,-81.47,0,-81.47,-81.47,-1,-59198,141379,200577,82181,0,-72838,0,0,0,,72838,-72838
13,03/25/2017,61,15:00,15:15,,6.71,0,6.71,6.71,-1,-84208,134571,218779,50363,0,-33177,0,0,0,,33177,-33177
13,03/25/2017,62,15:15,15:30,,,0,28.71,28.71,0,-65636,149946,215582,84310,0,0,0,0,0,,0,0
13,03/25/2017,63,15:30,15:45,,29.39,0,29.39,29.39,-1,-54675,139213,193888,84538,0,-147,0,0,0,,147,-147
13,03/25/2017,64,15:45,16:00,,29,0,29,29,-1,-46026,129261,175287,83235,0,-1267,0,0,0,,1267,-1267
13,03/25/2017,65,16:00,16:15,,-58.78,0,-58.78,-58.78,-1,-48326,167949,216275,119623,0,-36280,0,0,0,,36280,-36280
13,03/25/2017,66,16:15,16:30,,8.47,0,8.47,8.47,-1,-52312,127482,179794,75170,0,-23535,0,0,0,,23535,-23535
13,03/25/2017,67,16:30,16:45,,,0,28.77,28.77,0,-42000,120251,162251,78251,0,0,0,0,0,,0,0
13,03/25/2017,68,16:45,17:00,,23.92,0,23.92,23.92,-1,-38062,91656,129718,53594,0,-452,0,0,0,,452,-452
13,03/25/2017,69,17:00,17:15,,4.32,0,4.32,4.32,-1,-24528,152304,176832,127776,0,-22688,0,0,0,,22688,-22688
13,03/25/2017,70,17:15,17:30,,26.62,0,26.62,26.62,-1,-35171,106157,141328,70986,0,-4963,0,0,0,,4963,-4963
13,03/25/2017,71,17:30,17:45,,,0,28.71,28.71,0,-37724,71470,109194,33746,0,0,0,0,0,,0,0
13,03/25/2017,72,17:45,18:00,28.53,,0,28.53,28.53,1,-31724,39666,71390,7942,0,0,337,0,0,,337,337
13,03/25/2017,73,18:00,18:15,28.53,,0,28.53,28.53,1,-49838,70690,120528,20852,0,0,276,0,0,,276,276
13,03/25/2017,74,18:15,18:30,,,0,28.77,28.77,0,-39325,67925,107250,28600,0,0,0,0,0,,0,0
13,03/25/2017,75,18:30,18:45,,18.62,0,18.62,18.62,-1,-25796,71491,97287,45695,0,-5631,0,0,0,,5631,-5631
13,03/25/2017,76,18:45,19:00,,17.48,0,17.48,17.48,-1,-29736,62138,91874,32402,0,-13834,0,0,0,,13834,-13834
13,03/25/2017,77,19:00,19:15,,6.03,0,6.03,6.03,-1,-67479,117181,184660,49702,0,-9967,0,0,0,,9967,-9967
13,03/25/2017,78,19:15,19:30,34.92,26.03,0,34.92,34.92,1,-81699,66678,148377,-15021,0,-2878,639,0,0,,3517,-2239
13,03/25/2017,79,19:30,19:45,45.17,,0,45.17,45.17,1,-84715,46395,131110,-38320,0,0,23055,0,0,,23055,23055
13,03/25/2017,80,19:45,20:00,33.02,,0,33.02,33.02,1,-75528,50227,125755,-25301,0,0,13602,0,0,,13602,13602
13,03/25/2017,81,20:00,20:15,34.92,,0,34.92,34.92,1,-74077,31727,105804,-42350,0,0,2544,0,0,,2544,2544
13,03/25/2017,82,20:15,20:30,31.26,,0,31.26,31.26,1,-71518,39406,110924,-32112,0,0,2611,0,0,,2611,2611
13,03/25/2017,83,20:30,20:45,,,0,28.94,28.94,0,-65250,61058,126308,-4192,0,0,143,0,0,,143,143
13,03/25/2017,84,20:45,21:00,,25.15,0,25.15,25.15,-1,-58335,57906,116241,-429,0,-512,0,0,0,,512,-512
13,03/25/2017,85,21:00,21:15,,26.03,0,26.03,26.03,-1,-88570,90816,179386,2246,0,-364,0,0,0,,364,-364
13,03/25/2017,86,21:15,21:30,,24.84,0,24.84,24.84,-1,-74334,87083,161417,12749,0,-1276,0,0,0,,1276,-1276
13,03/25/2017,87,21:30,21:45,,23.92,0,23.92,23.92,-1,-73936,81123,155059,7187,0,-2986,0,0,0,,2986,-2986
13,03/25/2017,88,21:45,22:00,,13.4,0,13.4,13.4,-1,-64900,100371,165271,35471,0,-29880,0,0,0,,29880,-29880
13,03/25/2017,89,22:00,22:15,28.53,24.42,0,28.53,28.53,1,-65850,54235,120085,-11615,0,-14602,151,0,0,,14753,-14451
13,03/25/2017,90,22:15,22:30,,20.92,0,20.92,20.92,-1,-67230,80770,148000,13540,0,-7942,0,0,0,,7942,-7942
13,03/25/2017,91,22:30,22:45,,23.92,0,23.92,23.92,-1,-56467,94641,151108,38174,0,-17239,0,0,0,,17239,-17239
13,03/25/2017,92,22:45,23:00,,27.81,0,27.81,27.81,-1,-52601,115340,167941,62739,0,-2324,0,0,0,,2324,-2324
13,03/25/2017,93,23:00,23:15,,20.92,0,20.92,20.92,-1,-51373,67143,118516,15770,0,-4209,0,0,0,,4209,-4209
13,03/25/2017,94,23:15,23:30,,23.92,0,23.92,23.92,-1,-49475,68948,118423,19473,0,-15728,0,0,0,,15728,-15728
13,03/25/2017,95,23:30,23:45,,23.92,0,23.92,23.92,-1,-44939,74377,119316,29438,0,-19496,0,0,0,,19496,-19496
13,03/25/2017,96,23:45,0:00,,5.36,0,5.36,5.36,-1,-40272,87827,128099,47555,0,-26699,0,0,0,,26699,-26699
13,03/26/2017,1,0:00,0:15,,23.92,0,23.92,23.92,-1,-40323,48883,89206,8560,0,-19134,0,0,0,,19134,-19134
13,03/26/2017,2,0:15,0:30,,18.62,0,18.62,18.62,-1,-18987,42037,61024,23050,0,-17260,0,0,0,,17260,-17260
13,03/26/2017,3,0:30,0:45,,-8.2,0,-8.2,-8.2,-1,-19881,55189,75070,35308,0,-11551,0,0,0,,11551,-11551
13,03/26/2017,4,0:45,1:00,34.05,-5.27,0,34.05,-5.27,2,-55692,40223,95915,-15469,0,-20771,525,0,0,,21296,-20246
13,03/26/2017,5,1:00,1:15,34.05,27.92,0,27.92,27.92,-1,-43499,62040,105539,18541,0,-2075,100,0,0,,2175,-1975
13,03/26/2017,6,1:15,1:30,,27.92,0,27.92,27.92,-1,-36344,35695,72039,-649,0,-1753,0,0,0,,1753,-1753
13,03/26/2017,7,1:30,1:45,,23.92,0,23.92,23.92,-1,-34461,46133,80594,11672,0,-4378,0,0,0,,4378,-4378
13,03/26/2017,8,1:45,3:00,,21.78,0,21.78,21.78,-1,-36547,64606,101153,28059,0,-23335,0,0,0,,23335,-23335
13,03/26/2017,9,3:00,3:15,31.26,10,0,31.26,31.26,1,-18564,52919,71483,34355,0,-16080,252,0,0,,16332,-15828
13,03/26/2017,10,3:15,3:30,33.5,0,0,33.5,0,2,-17991,46946,64937,28955,0,-3976,1198,0,0,,5174,-2778
13,03/26/2017,11,3:30,3:45,,-105.33,0,-105.33,-105.33,-1,-23551,57665,81216,34114,0,-33277,0,0,0,,33277,-33277
13,03/26/2017,12,3:45,4:00,,5.36,0,5.36,5.36,-1,-32199,73333,105532,41134,0,-31312,0,0,0,,31312,-31312
13,03/26/2017,13,4:00,4:15,,11.12,0,11.12,11.12,-1,-31405,61140,92545,29735,0,-23565,0,0,0,,23565,-23565
13,03/26/2017,14,4:15,4:30,,,0,31.37,31.37,0,-35222,61164,96386,25942,0,-56,0,0,0,,56,-56
13,03/26/2017,15,4:30,4:45,,,0,31.37,31.37,0,-30629,73646,104275,43017,0,0,0,0,0,,0,0
13,03/26/2017,16,4:45,5:00,,,0,31.37,31.37,0,-25493,88827,114320,63334,0,0,0,0,0,,0,0
13,03/26/2017,17,5:00,5:15,,,0,31.4,31.4,0,-26404,108756,135160,82352,0,0,0,0,0,,0,0
13,03/26/2017,18,5:15,5:30,,,0,31.4,31.4,0,-22640,88524,111164,65884,0,0,0,0,0,,0,0
13,03/26/2017,19,5:30,5:45,,25.78,0,25.78,25.78,-1,-32396,89518,121914,57122,0,-823,0,0,0,,823,-823
13,03/26/2017,20,5:45,6:00,,23.92,0,23.92,23.92,-1,-24291,81609,105900,57318,0,-2666,0,0,0,,2666,-2666
13,03/26/2017,21,6:00,6:15,,-18.78,0,-18.78,-18.78,-1,-20615,111401,132016,90786,0,-20039,0,0,0,,20039,-20039
13,03/26/2017,22,6:15,6:30,,27.92,0,27.92,27.92,-1,-33822,90993,124815,57171,0,-11638,0,0,0,,11638,-11638
13,03/26/2017,23,6:30,6:45,,14.37,0,14.37,14.37,-1,-30377,88526,118903,58149,0,-6712,0,0,0,,6712,-6712
13,03/26/2017,24,6:45,7:00,,27.92,0,27.92,27.92,-1,-27703,63406,91109,35703,0,-4599,0,0,0,,4599,-4599
13,03/26/2017,25,7:00,7:15,,17.49,0,17.49,17.49,-1,-17184,74445,91629,57261,0,-20364,0,0,0,,20364,-20364
13,03/26/2017,26,7:15,7:30,,15.79,0,15.79,15.79,-1,-11658,62393,74051,50735,0,-37588,0,0,0,,37588,-37588
13,03/26/2017,27,7:30,7:45,,7.71,0,7.71,7.71,-1,-17207,66661,83868,49454,0,-39974,0,0,0,,39974,-39974
13,03/26/2017,28,7:45,8:00,,7.71,0,7.71,7.71,-1,-29582,46592,76174,17010,0,-27843,0,0,0,,27843,-27843
13,03/26/2017,29,8:00,8:15,,,0,31.44,31.44,0,-39305,61033,100338,21728,0,-783,0,0,0,,783,-783
13,03/26/2017,30,8:15,8:30,30.54,,0,30.54,30.54,1,-27747,46343,74090,18596,0,0,17,0,0,,17,17
13,03/26/2017,31,8:30,8:45,,,0,31.44,31.44,0,-19637,27561,47198,7924,0,0,0,0,0,,0,0
13,03/26/2017,32,8:45,9:00,28.54,,0,28.54,28.54,1,-41197,27358,68555,-13839,0,0,190,0,0,,190,190
13,03/26/2017,33,9:00,9:15,46.99,,0,46.99,46.99,1,-70328,34552,104880,-35776,0,0,11512,0,0,,11512,11512
13,03/26/2017,34,9:15,9:30,29.35,,0,29.35,29.35,1,-49314,22741,72055,-26573,0,0,4488,0,0,,4488,4488
13,03/26/2017,35,9:30,9:45,28.54,,0,28.54,28.54,1,-43646,45951,89597,2305,0,0,1759,0,0,,1759,1759
13,03/26/2017,36,9:45,10:00,,,0,31.36,31.36,0,-50921,61136,112057,10215,0,0,0,0,0,,0,0
13,03/26/2017,37,10:00,10:15,31.42,,0,31.42,31.42,1,-22111,31325,53436,9214,0,0,870,0,0,,870,870
13,03/26/2017,38,10:15,10:30,32.1,,0,32.1,32.1,1,-28304,33234,61538,4930,0,0,5890,0,0,,5890,5890
13,03/26/2017,39,10:30,10:45,,,0,31.25,31.25,0,-23404,56658,80062,33254,0,0,26,0,0,,26,26
13,03/26/2017,40,10:45,11:00,,,0,31.25,31.25,0,-28934,69544,98478,40610,0,0,0,0,0,,0,0
13,03/26/2017,41,11:00,11:15,,-35.69,0,-35.69,-35.69,-1,-11520,95067,106587,83547,0,-18854,0,0,0,,18854,-18854
13,03/26/2017,42,11:15,11:30,,7.38,0,7.38,7.38,-1,-18826,87804,106630,68978,0,-22536,0,0,0,,22536,-22536
13,03/26/2017,43,11:30,11:45,,24.42,0,24.42,24.42,-1,-20067,86797,106864,66730,0,-26932,0,0,0,,26932,-26932
13,03/26/2017,44,11:45,12:00,,-16.95,0,-16.95,-16.95,-1,-13611,81233,94844,67622,0,-37920,0,0,0,,37920,-37920
13,03/26/2017,45,12:00,12:15,,24.42,0,24.42,24.42,-1,-31534,52212,83746,20678,0,-14344,0,0,0,,14344,-14344
13,03/26/2017,46,12:15,12:30,,,0,30.38,30.38,0,-28297,65614,93911,37317,0,-77,0,0,0,,77,-77
13,03/26/2017,47,12:30,12:45,,,0,30.38,30.38,0,-34493,71830,106323,37337,0,0,0,0,0,,0,0
13,03/26/2017,48,12:45,13:00,,32.27,0,32.27,32.27,-1,-44299,74039,118338,29740,0,-105,0,0,0,,105,-105
13,03/26/2017,49,13:00,13:15,,31.55,0,31.55,31.55,-1,-68421,102887,171308,34466,0,-1016,0,0,0,,1016,-1016
13,03/26/2017,50,13:15,13:30,,31.89,0,31.89,31.89,-1,-62036,106887,168923,44851,0,-70,0,0,0,,70,-70
13,03/26/2017,51,13:30,13:45,,1.78,0,1.78,1.78,-1,-58911,109843,168754,50932,0,-14849,0,0,0,,14849,-14849
13,03/26/2017,52,13:45,14:00,,4.33,0,4.33,4.33,-1,-68654,111379,180033,42725,0,-20435,0,0,0,,20435,-20435
13,03/26/2017,53,14:00,14:15,28.54,4.39,0,28.54,28.54,1,-56364,58232,114596,1868,0,-19765,31,0,0,,19796,-19734
13,03/26/2017,54,14:15,14:30,29.35,16.78,0,29.96,16.78,2,-46549,78820,125369,32271,0,-3000,183,0,0,,3183,-2817
13,03/26/2017,55,14:30,14:45,,-270.1,0,-270.1,-270.1,-1,-41762,82161,123923,40399,0,-35967,0,0,0,,35967,-35967
13,03/26/2017,56,14:45,15:00,,24.42,0,24.42,24.42,-1,-52197,73924,126121,21727,0,-15563,0,0,0,,15563,-15563
13,03/26/2017,57,15:00,15:15,,-414.99,0,-414.99,-414.99,-1,-51460,116282,167742,64822,0,-34674,0,0,0,,34674,-34674
13,03/26/2017,58,15:15,15:30,,24.42,0,24.42,24.42,-1,-53479,101579,155058,48100,0,-22875,0,0,0,,22875,-22875
13,03/26/2017,59,15:30,15:45,,18.41,0,18.41,18.41,-1,-59250,109579,168829,50329,0,-18137,0,0,0,,18137,-18137
13,03/26/2017,60,15:45,16:00,,-175.63,0,-175.63,-175.63,-1,-50239,109710,159949,59471,0,-46795,0,0,0,,46795,-46795
13,03/26/2017,61,16:00,16:15,,16.58,0,16.58,16.58,-1,-40812,126382,167194,85570,0,-31233,0,0,0,,31233,-31233
13,03/26/2017,62,16:15,16:30,,,0,29.86,29.86,0,-37835,109240,147075,71405,0,-947,0,0,0,,947,-947
13,03/26/2017,63,16:30,16:45,,26.79,0,26.79,26.79,-1,-36761,95265,132026,58504,0,-775,0,0,0,,775,-775
13,03/26/2017,64,16:45,17:00,,26.79,0,26.79,26.79,-1,-39424,60634,100058,21210,0,-1962,0,0,0,,1962,-1962
13,03/26/2017,65,17:00,17:15,,-3.78,0,-3.78,-3.78,-1,-31625,174183,205808,142558,0,-15229,0,0,0,,15229,-15229
13,03/26/2017,66,17:15,17:30,,24.42,0,24.42,24.42,-1,-32481,129191,161672,96710,0,-22493,0,0,0,,22493,-22493
13,03/26/2017,67,17:30,17:45,,11.13,0,11.13,11.13,-1,-35500,82603,118103,47103,0,-22033,0,0,0,,22033,-22033
13,03/26/2017,68,17:45,18:00,,0.63,0,0.63,0.63,-1,-39198,101569,140767,62371,0,-16302,0,0,0,,16302,-16302
13,03/26/2017,69,18:00,18:15,30.89,1.78,0,30.89,30.89,1,-44969,48109,93078,3140,0,-12819,736,0,0,,13555,-12083
13,03/26/2017,70,18:15,18:30,30.89,1.78,0,30.89,30.89,1,-25522,50461,75983,24939,0,-14,144,0,0,,158,130
13,03/26/2017,71,18:30,18:45,,,0,30.08,30.08,0,-23728,55816,79544,32088,0,0,0,0,0,,0,0
13,03/26/2017,72,18:45,19:00,31.42,,0,31.42,31.42,1,-30025,45520,75545,15495,0,0,201,0,0,,201,201
13,03/26/2017,73,19:00,19:15,31.42,31.83,0,31.42,30.19,2,-56219,56532,112751,313,0,-209,1593,0,0,,1802,1384
13,03/26/2017,74,19:15,19:30,,31.83,0,31.83,31.83,-1,-44314,67977,112291,23663,0,-337,0,0,0,,337,-337
13,03/26/2017,75,19:30,19:45,,32.22,0,32.22,32.22,-1,-37061,67472,104533,30411,0,-42,0,0,0,,42,-42
13,03/26/2017,76,19:45,20:00,,32.22,0,32.22,32.22,-1,-41061,71900,112961,30839,0,-89,0,0,0,,89,-89
13,03/26/2017,77,20:00,20:15,,,0,30.29,30.29,0,-31521,78987,110508,47466,0,0,0,0,0,,0,0
13,03/26/2017,78,20:15,20:30,59.4,,0,59.4,59.4,1,-66585,34891,101476,-31694,0,0,8178,0,0,,8178,8178
13,03/26/2017,79,20:30,20:45,59.4,,0,59.4,59.4,1,-47668,39415,87083,-8253,0,0,24200,0,0,,24200,24200
13,03/26/2017,80,20:45,21:00,59.4,22.36,0,22.36,22.36,-1,-18317,65937,84254,47620,0,-4214,1793,0,0,,6007,-2421
13,03/26/2017,81,21:00,21:15,28.15,27.78,0,28.15,28.15,1,-60864,51587,112451,-9277,0,-3112,130,0,0,,3242,-2982
13,03/26/2017,82,21:15,21:30,28.15,28.42,0,28.42,28.42,-1,-44045,50302,94347,6257,0,-67,71,0,0,,138,4
13,03/26/2017,83,21:30,21:45,,26.67,0,26.67,26.67,-1,-39113,56153,95266,17040,0,-8435,0,0,0,,8435,-8435
13,03/26/2017,84,21:45,22:00,,22.36,0,22.36,22.36,-1,-36014,72092,108106,36078,0,-23168,0,0,0,,23168,-23168
13,03/26/2017,85,22:00,22:15,34.54,27.42,0,34.54,27.42,2,-65617,38685,104302,-26932,0,-11576,1604,0,0,,13180,-9972
13,03/26/2017,86,22:15,22:30,34.54,24.42,0,24.42,24.42,-1,-37319,48046,85365,10727,0,-1521,336,0,0,,1857,-1185
13,03/26/2017,87,22:30,22:45,,24.42,0,24.42,24.42,-1,-27164,60715,87879,33551,0,-5606,0,0,0,,5606,-5606
13,03/26/2017,88,22:45,23:00,,-52.37,0,-52.37,-52.37,-1,-18924,89208,108132,70284,0,-19706,0,0,0,,19706,-19706
13,03/26/2017,89,23:00,23:15,,26.78,0,26.78,26.78,-1,-65546,34244,99790,-31302,0,-12871,0,0,0,,12871,-12871
13,03/26/2017,90,23:15,23:30,,25.89,0,25.89,25.89,-1,-45796,48781,94577,2985,0,-1717,0,0,0,,1717,-1717
13,03/26/2017,91,23:30,23:45,,24.42,0,24.42,24.42,-1,-43686,80510,124196,36824,0,-6185,0,0,0,,6185,-6185
13,03/26/2017,92,23:45,0:00,,-11.34,0,-11.34,-11.34,-1,-53752,106097,159849,52345,0,-40814,0,0,0,,40814,-40814
13,03/27/2017,1,0:00,0:15,,18.89,0,18.89,18.89,-1,-47181,66028,113209,18847,0,-23310,0,0,0,,23310,-23310
13,03/27/2017,2,0:15,0:30,,-5.26,0,-5.26,-5.26,-1,-21647,66698,88345,45051,0,-10557,0,0,0,,10557,-10557
13,03/27/2017,3,0:30,0:45,,-5.26,0,-5.26,-5.26,-1,-41483,77563,119046,36080,0,-28584,0,0,0,,28584,-28584
13,03/27/2017,4,0:45,1:00,,23.89,0,23.89,23.89,-1,-64108,97468,161576,33360,0,-28472,0,0,0,,28472,-28472
13,03/27/2017,5,1:00,1:15,,19.49,0,19.49,19.49,-1,-15234,72032,87266,56798,0,-25114,0,0,0,,25114,-25114
13,03/27/2017,6,1:15,1:30,,-16.95,0,-16.95,-16.95,-1,-9973,75402,85375,65429,0,-39031,0,0,0,,39031,-39031
13,03/27/2017,7,1:30,1:45,,-16.95,0,-16.95,-16.95,-1,-18123,68174,86297,50051,0,-34465,0,0,0,,34465,-34465
13,03/27/2017,8,1:45,2:00,,-11.34,0,-11.34,-11.34,-1,-10647,76002,86649,65355,0,-20659,0,0,0,,20659,-20659
13,03/27/2017,9,2:00,2:15,,26.03,0,26.03,26.03,-1,-36082,81585,117667,45503,0,-12098,0,0,0,,12098,-12098
13,03/27/2017,10,2:15,2:30,,,0,31.05,31.05,0,-23805,78997,102802,55192,0,-31,0,0,0,,31,-31
13,03/27/2017,11,2:30,2:45,,,0,31.05,31.05,0,-24124,82857,106981,58733,0,0,0,0,0,,0,0
13,03/27/2017,12,2:45,3:00,,26.03,0,26.03,26.03,-1,-23161,76373,99534,53212,0,-5102,0,0,0,,5102,-5102
13,03/27/2017,13,3:00,3:15,,33.8,0,33.8,33.8,-1,-16876,74562,91438,57686,0,-1752,0,0,0,,1752,-1752
13,03/27/2017,14,3:15,3:30,,34.19,0,34.19,34.19,-1,-16972,62892,79864,45920,0,-2,0,0,0,,2,-2
13,03/27/2017,15,3:30,3:45,,27.89,0,27.89,27.89,-1,-18525,71829,90354,53304,0,-566,0,0,0,,566,-566
13,03/27/2017,16,3:45,4:00,,19.7,0,19.7,19.7,-1,-17971,72844,90815,54873,0,-9071,0,0,0,,9071,-9071
13,03/27/2017,17,4:00,4:15,,9.92,0,9.92,9.92,-1,-39100,79863,118963,40763,0,-17521,0,0,0,,17521,-17521
13,03/27/2017,18,4:15,4:30,,28.89,0,28.89,28.89,-1,-23089,78970,102059,55881,0,-2042,0,0,0,,2042,-2042
13,03/27/2017,19,4:30,4:45,,34.13,0,34.13,34.13,-1,-24744,58091,82835,33347,0,-1025,0,0,0,,1025,-1025
13,03/27/2017,20,4:45,5:00,,27.25,0,27.25,27.25,-1,-25601,87523,113124,61922,0,-651,0,0,0,,651,-651
13,03/27/2017,21,5:00,5:15,34.89,27.89,0,34.89,27.89,2,-100457,94262,194719,-6195,0,-159,1529,0,0,,1688,1370
13,03/27/2017,22,5:15,5:30,,-0.03,0,-0.03,-0.03,-1,-21038,68651,89689,47613,0,-20931,0,0,0,,20931,-20931
13,03/27/2017,23,5:30,5:45,,22.36,0,22.36,22.36,-1,-22256,90685,112941,68429,0,-18745,0,0,0,,18745,-18745
13,03/27/2017,24,5:45,6:00,30.89,22.36,0,30.89,30.89,1,-34690,124350,159040,89660,0,-2722,44,0,0,,2766,-2678
13,03/27/2017,25,6:00,6:15,31.27,28.72,0,31.49,28.72,2,-88316,102547,190863,14231,0,-471,362,0,0,,833,-109
13,03/27/2017,26,6:15,6:30,,28.72,0,28.72,28.72,-1,-26337,96196,122533,69859,0,-527,0,0,0,,527,-527
13,03/27/2017,27,6:30,6:45,34.72,,0,34.72,34.72,1,-39368,60579,99947,21211,0,0,321,0,0,,321,321
13,03/27/2017,28,6:45,7:00,281.5,,0,281.5,281.5,1,-76246,53743,129989,-22503,0,0,24461,0,0,,24461,24461
13,03/27/2017,29,7:00,7:15,30.72,-31.51,0,31.59,-31.51,2,-24651,114015,138666,89364,0,-8145,4278,0,0,,12423,-3867
13,03/27/2017,30,7:15,7:30,,27.03,0,27.03,27.03,-1,-25366,69978,95344,44612,0,-6022,0,0,0,,6022,-6022
13,03/27/2017,31,7:30,7:45,,25,0,25,25,-1,-46707,55627,102334,8920,0,-7994,0,0,0,,7994,-7994
13,03/27/2017,32,7:45,8:00,,,0,31.59,31.59,0,-79903,44874,124777,-35029,0,-121,0,0,0,,121,-121
13,03/27/2017,33,8:00,8:15,,23.72,0,23.72,23.72,-1,-21613,78610,100223,56997,0,-7054,0,0,0,,7054,-7054
13,03/27/2017,34,8:15,8:30,,26.75,0,26.75,26.75,-1,-26160,47422,73582,21262,0,-10920,0,0,0,,10920,-10920
13,03/27/2017,35,8:30,8:45,33.51,26.75,0,33.51,33.51,1,-64030,38871,102901,-25159,0,-2160,1148,0,0,,3308,-1012
13,03/27/2017,36,8:45,9:00,,,0,31.55,31.55,0,-60659,42045,102704,-18614,0,0,0,0,0,,0,0
13,03/27/2017,37,9:00,9:15,426.42,,0,426.42,426.42,1,-96409,12223,108632,-84186,0,0,17940,0,0,,17940,17940
13,03/27/2017,38,9:15,9:30,31.27,,0,31.27,31.27,1,-50335,29093,79428,-21242,0,0,6861,0,0,,6861,6861
13,03/27/2017,39,9:30,9:45,28.15,,0,28.15,28.15,1,-35744,29250,64994,-6494,0,0,761,0,0,,761,761
13,03/27/2017,40,9:45,10:00,,27.72,0,27.72,27.72,-1,-28851,47250,76101,18399,0,-2705,0,0,0,,2705,-2705
13,03/27/2017,41,10:00,10:15,119.02,27.72,0,119.02,119.02,1,-72230,28656,100886,-43574,0,-324,13682,0,0,,14006,13358
13,03/27/2017,42,10:15,10:30,36.02,28.72,0,28.72,28.72,-1,-28929,34564,63493,5635,0,-74,13733,0,0,,13807,13659
13,03/27/2017,43,10:30,10:45,36.02,19.06,0,19.06,19.06,-1,-26071,57535,83606,31464,0,-17350,92,0,0,,17442,-17258
13,03/27/2017,44,10:45,11:00,,23.72,0,23.72,23.72,-1,-35866,55013,90879,19147,0,-25473,0,0,0,,25473,-25473
13,03/27/2017,45,11:00,11:15,34.7,17.88,0,34.7,17.88,2,-31057,43706,74763,12649,0,-22199,177,0,0,,22376,-22022
13,03/27/2017,46,11:15,11:30,37.96,18.53,0,37.96,18.53,2,-32765,46068,78833,13303,0,-1789,1674,0,0,,3463,-115
13,03/27/2017,47,11:30,11:45,,11.6,0,11.6,11.6,-1,-33578,47385,80963,13807,0,-9557,0,0,0,,9557,-9557
13,03/27/2017,48,11:45,12:00,,23.72,0,23.72,23.72,-1,-32146,58625,90771,26479,0,-12533,0,0,0,,12533,-12533
13,03/27/2017,49,12:00,12:15,,27.72,0,27.72,27.72,-1,-51346,61792,113138,10446,0,-7480,0,0,0,,7480,-7480
13,03/27/2017,50,12:15,12:30,28.15,27.72,0,30.23,27.72,2,-49355,76681,126036,27326,0,-502,19,0,0,,521,-483
13,03/27/2017,51,12:30,12:45,,27.72,0,27.72,27.72,-1,-39001,89818,128819,50817,0,-1510,0,0,0,,1510,-1510
13,03/27/2017,52,12:45,13:00,,-21.77,0,-21.77,-21.77,-1,-40679,97847,138526,57168,0,-24598,0,0,0,,24598,-24598
13,03/27/2017,53,13:00,13:15,,-21.8,0,-21.8,-21.8,-1,-30556,77535,108091,46979,0,-27838,0,0,0,,27838,-27838
13,03/27/2017,54,13:15,13:30,,20.11,0,20.11,20.11,-1,-35775,64500,100275,28725,0,-2939,0,0,0,,2939,-2939
13,03/27/2017,55,13:30,13:45,,18.48,0,18.48,18.48,-1,-31513,86591,118104,55078,0,-19304,0,0,0,,19304,-19304
13,03/27/2017,56,13:45,14:00,,19.06,0,19.06,19.06,-1,-30459,94690,125149,64231,0,-11082,0,0,0,,11082,-11082
13,03/27/2017,57,14:00,14:15,,28.52,0,28.52,28.52,-1,-45139,75329,120468,30190,0,-5439,0,0,0,,5439,-5439
13,03/27/2017,58,14:15,14:30,,,0,29.42,29.42,0,-42068,66464,108532,24396,0,-12,0,0,0,,12,-12
13,03/27/2017,59,14:30,14:45,,,0,29.42,29.42,0,-42008,77659,119667,35651,0,0,0,0,0,,0,0
13,03/27/2017,60,14:45,15:00,,,0,29.42,29.42,0,-43497,99423,142920,55926,0,0,0,0,0,,0,0
13,03/27/2017,61,15:00,15:15,,,0,29.2,29.2,0,-54870,85418,140288,30548,0,0,0,0,0,,0,0
13,03/27/2017,62,15:15,15:30,,,0,29.2,29.2,0,-34876,83613,118489,48737,0,0,0,0,0,,0,0
13,03/27/2017,63,15:30,15:45,,,0,29.2,29.2,0,-37241,83518,120759,46277,0,0,0,0,0,,0,0
13,03/27/2017,64,15:45,16:00,,,0,29.2,29.2,0,-33663,77307,110970,43644,0,0,0,0,0,,0,0
13,03/27/2017,65,16:00,16:15,,28.72,0,28.72,28.72,-1,-30934,96035,126969,65101,0,-386,0,0,0,,386,-386
13,03/27/2017,66,16:15,16:30,,25.89,0,25.89,25.89,-1,-30597,112209,142806,81612,0,-9637,0,0,0,,9637,-9637
13,03/27/2017,67,16:30,16:45,,28.78,0,28.78,28.78,-1,-32295,87276,119571,54981,0,-4009,0,0,0,,4009,-4009
13,03/27/2017,68,16:45,17:00,,6.05,0,6.05,6.05,-1,-37538,94848,132386,57310,0,-12823,0,0,0,,12823,-12823
13,03/27/2017,69,17:00,17:15,,27.72,0,27.72,27.72,-1,-40142,84645,124787,44503,0,-6420,0,0,0,,6420,-6420
13,03/27/2017,70,17:15,17:30,,27.72,0,27.72,27.72,-1,-40655,90717,131372,50062,0,-5121,0,0,0,,5121,-5121
13,03/27/2017,71,17:30,17:45,,28.9,0,28.9,28.9,-1,-37894,83900,121794,46006,0,-2402,0,0,0,,2402,-2402
13,03/27/2017,72,17:45,18:00,,30.1,0,30.1,30.1,-1,-40034,85298,125332,45264,0,-983,0,0,0,,983,-983
13,03/27/2017,73,18:00,18:15,,,0,29.29,29.29,0,-63986,17613,81599,-46373,0,0,0,0,0,,0,0
13,03/27/2017,74,18:15,18:30,,,0,29.29,29.29,0,-34502,19149,53651,-15353,0,0,0,0,0,,0,0
13,03/27/2017,75,18:30,18:45,28.54,,0,28.54,28.54,1,-37235,27410,64645,-9825,0,0,294,0,0,,294,294
13,03/27/2017,76,18:45,19:00,29.9,,0,29.9,29.9,1,-42768,27448,70216,-15320,0,0,1605,0,0,,1605,1605
13,03/27/2017,77,19:00,19:15,,,0,29.45,29.45,0,-56469,32360,88829,-24109,0,0,158,0,0,,158,158
13,03/27/2017,78,19:15,19:30,28.15,,0,28.15,28.15,1,-50529,30141,80670,-20388,0,0,83,0,0,,83,83
13,03/27/2017,79,19:30,19:45,28.54,,0,28.54,28.54,1,-50147,33220,83367,-16927,0,0,310,0,0,,310,310
13,03/27/2017,80,19:45,20:00,35.55,,0,35.55,35.55,1,-61399,32377,93776,-29022,0,0,2486,0,0,,2486,2486
13,03/27/2017,81,20:00,20:15,,,0,29.62,29.62,0,-29740,68998,98738,39258,0,0,643,0,0,,643,643
13,03/27/2017,82,20:15,20:30,426.42,,0,426.42,426.42,1,-76024,29665,105689,-46359,0,0,11771,0,0,,11771,11771
13,03/27/2017,83,20:30,20:45,426.42,,0,426.42,426.42,1,-93536,15023,108559,-78513,0,0,62587,0,0,,62587,62587
13,03/27/2017,84,20:45,21:00,41.02,27.72,0,41.02,27.72,2,-34655,44801,79456,10146,0,-735,17040,0,0,,17775,16305
13,03/27/2017,85,21:00,21:15,35.55,27.72,0,35.55,35.55,1,-46862,42800,89662,-4062,0,-42,701,0,0,,743,659
13,03/27/2017,86,21:15,21:30,38.5,,0,38.5,38.5,1,-32876,41034,73910,8158,0,0,5670,0,0,,5670,5670
13,03/27/2017,87,21:30,21:45,,,0,29.88,29.88,0,-18888,52135,71023,33247,0,0,81,0,0,,81,81
13,03/27/2017,88,21:45,22:00,,6.39,0,6.39,6.39,-1,-19889,73773,93662,53884,0,-2518,0,0,0,,2518,-2518
13,03/27/2017,89,22:00,22:15,33.19,-10.03,0,33.19,-10.03,2,-98558,34168,132726,-64390,0,-10685,785,0,0,,11470,-9900
13,03/27/2017,90,22:15,22:30,,,0,30.09,30.09,0,-73880,40321,114201,-33559,0,0,333,0,0,,333,333
13,03/27/2017,91,22:30,22:45,,31.63,0,31.63,31.63,-1,-31452,54969,86421,23517,0,-764,0,0,0,,764,-764
13,03/27/2017,92,22:45,23:00,,-8.67,0,-8.67,-8.67,-1,-27400,77722,105122,50322,0,-5621,0,0,0,,5621,-5621
13,03/27/2017,93,23:00,23:15,28.15,-11.73,0,28.15,28.15,1,-90508,28401,118909,-62107,0,-9729,68,0,0,,9797,-9661
13,03/27/2017,94,23:15,23:30,28.15,,0,28.15,28.15,1,-60399,14856,75255,-45543,0,0,358,0,0,,358,358
13,03/27/2017,95,23:30,23:45,,28.72,0,28.72,28.72,-1,-33664,33105,66769,-559,0,-102,0,0,0,,102,-102
13,03/27/2017,96,23:45,0:00,,23.72,0,23.72,23.72,-1,-28060,44486,72546,16426,0,-12549,0,0,0,,12549,-12549
13,03/28/2017,1,0:00,0:15,51.12,21.36,0,51.12,21.36,2,-40321,17250,57571,-23071,0,-10634,2683,0,0,,13317,-7951
13,03/28/2017,2,0:15,0:30,72.12,21.36,0,72.12,72.12,1,-40471,24057,64528,-16414,0,-138,8214,0,0,,8352,8076
13,03/28/2017,3,0:30,0:45,,23.23,0,23.23,23.23,-1,-25567,52672,78239,27105,0,-5573,0,0,0,,5573,-5573
13,03/28/2017,4,0:45,1:00,,27.72,0,27.72,27.72,-1,-60646,73577,134223,12931,0,-12213,0,0,0,,12213,-12213
13,03/28/2017,5,1:00,1:15,47.7,28.72,0,47.7,47.7,1,-39531,29048,68579,-10483,0,-6291,5384,0,0,,11675,-907
13,03/28/2017,6,1:15,1:30,52.61,23.72,0,52.61,23.72,2,-25952,37914,63866,11962,0,-702,12679,0,0,,13381,11977
13,03/28/2017,7,1:30,1:45,52.61,22.8,0,22.8,22.8,-1,-26672,38235,64907,11563,0,-5602,6,0,0,,5608,-5596
13,03/28/2017,8,1:45,2:00,,3.26,0,3.26,3.26,-1,-14386,53925,68311,39539,0,-15710,0,0,0,,15710,-15710
13,03/28/2017,9,2:00,2:15,,3.26,0,3.26,3.26,-1,-29505,34885,64390,5380,0,-21296,0,0,0,,21296,-21296
13,03/28/2017,10,2:15,2:30,27.54,3.26,0,27.54,27.54,1,-30096,33015,63111,2919,0,-245,327,0,0,,572,82
13,03/28/2017,11,2:30,2:45,,28.72,0,28.72,28.72,-1,-17782,27159,44941,9377,0,-666,0,0,0,,666,-666
13,03/28/2017,12,2:45,3:00,,23.72,0,23.72,23.72,-1,-14158,31465,45623,17307,0,-3135,0,0,0,,3135,-3135
13,03/28/2017,13,3:00,3:15,,23.72,0,23.72,23.72,-1,-15478,48455,63933,32977,0,-7268,0,0,0,,7268,-7268
13,03/28/2017,14,3:15,3:30,,32.38,0,32.38,32.38,-1,-16909,29302,46211,12393,0,-421,0,0,0,,421,-421
13,03/28/2017,15,3:30,3:45,,27.72,0,27.72,27.72,-1,-15235,39853,55088,24618,0,-4855,0,0,0,,4855,-4855
13,03/28/2017,16,3:45,4:00,,27.72,0,27.72,27.72,-1,-13471,33896,47367,20425,0,-9369,0,0,0,,9369,-9369
13,03/28/2017,17,4:00,4:15,,23.72,0,23.72,23.72,-1,-13131,47543,60674,34412,0,-15271,0,0,0,,15271,-15271
13,03/28/2017,18,4:15,4:30,,26.09,0,26.09,26.09,-1,-20352,36951,57303,16599,0,-16119,0,0,0,,16119,-16119
13,03/28/2017,19,4:30,4:45,,33.47,0,33.47,33.47,-1,-23043,35883,58926,12840,0,-3057,0,0,0,,3057,-3057
13,03/28/2017,20,4:45,5:00,,28.72,0,28.72,28.72,-1,-21147,32024,53171,10877,0,-2154,0,0,0,,2154,-2154
13,03/28/2017,21,5:00,5:15,,33.59,0,33.59,33.59,-1,-23435,53709,77144,30274,0,-1573,0,0,0,,1573,-1573
13,03/28/2017,22,5:15,5:30,,23.72,0,23.72,23.72,-1,-3310,40086,43396,36776,0,-5686,0,0,0,,5686,-5686
13,03/28/2017,23,5:30,5:45,,26.58,0,26.58,26.58,-1,-17360,22107,39467,4747,0,-7003,0,0,0,,7003,-7003
13,03/28/2017,24,5:45,6:00,28.61,26.58,0,28.61,28.61,1,-32228,17180,49408,-15048,0,-239,791,0,0,,1030,552
13,03/28/2017,25,6:00,6:15,28.61,23.72,0,30.55,23.72,2,-29762,101844,131606,72082,0,-8328,160,0,0,,8488,-8168
13,03/28/2017,26,6:15,6:30,,,0,30.55,30.55,0,-21053,54133,75186,33080,0,-779,0,0,0,,779,-779
13,03/28/2017,27,6:30,6:45,32.51,,0,32.51,32.51,1,-39623,43472,83095,3849,0,0,716,0,0,,716,716
13,03/28/2017,28,6:45,7:00,410.56,,0,410.56,410.56,1,-101296,53032,154328,-48264,0,0,29981,0,0,,29981,29981
13,03/28/2017,29,7:00,7:15,30.72,23.72,0,30.72,23.72,2,-13276,115509,128785,102233,0,-1526,9615,0,0,,11141,8089
13,03/28/2017,30,7:15,7:30,,,0,30.52,30.52,0,-14861,79694,94555,64833,0,0,0,0,0,,0,0
13,03/28/2017,31,7:30,7:45,,,0,30.52,30.52,0,-52254,50803,103057,-1451,0,0,0,0,0,,0,0
13,03/28/2017,32,7:45,8:00,36.13,,0,36.13,36.13,1,-97758,33360,131118,-64398,0,0,1838,0,0,,1838,1838
13,03/28/2017,33,8:00,8:15,35.34,,0,35.34,35.34,1,-62681,63990,126671,1309,0,0,1833,0,0,,1833,1833
13,03/28/2017,34,8:15,8:30,,,0,30.48,30.48,0,-73831,32834,106665,-40997,0,0,0,0,0,,0,0
13,03/28/2017,35,8:30,8:45,,,0,30.48,30.48,0,-75640,20709,96349,-54931,0,0,0,0,0,,0,0
13,03/28/2017,36,8:45,9:00,27.54,,0,27.54,27.54,1,-92073,22878,114951,-69195,0,0,809,0,0,,809,809
13,03/28/2017,37,9:00,9:15,27.15,,0,27.15,27.15,1,-99734,21039,120773,-78695,0,0,1003,0,0,,1003,1003
13,03/28/2017,38,9:15,9:30,27.15,,0,27.15,27.15,1,-84507,13926,98433,-70581,0,0,613,0,0,,613,613
13,03/28/2017,39,9:30,9:45,,,0,30.36,30.36,0,-46257,15958,62215,-30299,0,0,0,0,0,,0,0
13,03/28/2017,40,9:45,10:00,,31.18,0,31.18,31.18,-1,-26558,27468,54026,910,0,-473,0,0,0,,473,-473
13,03/28/2017,41,10:00,10:15,45.95,31.8,0,45.95,30.12,2,-96635,18738,115373,-77897,0,-148,7326,0,0,,7474,7178
13,03/28/2017,42,10:15,10:30,34.95,,0,34.95,34.95,1,-59304,22311,81615,-36993,0,0,8354,0,0,,8354,8354
13,03/28/2017,43,10:30,10:45,34.95,33.09,0,33.09,33.09,-1,-40994,28318,69312,-12676,0,-3,335,0,0,,338,332
13,03/28/2017,44,10:45,11:00,,27.72,0,27.72,27.72,-1,-33841,40498,74339,6657,0,-4731,0,0,0,,4731,-4731
13,03/28/2017,45,11:00,11:15,,,0,29.81,29.81,0,-68154,56046,124200,-12108,0,-771,0,0,0,,771,-771
13,03/28/2017,46,11:15,11:30,29.12,,0,29.12,29.12,1,-75010,41123,116133,-33887,0,0,282,0,0,,282,282
13,03/28/2017,47,11:30,11:45,30.74,,0,30.74,30.74,1,-74915,45038,119953,-29877,0,0,2216,0,0,,2216,2216
13,03/28/2017,48,11:45,12:00,27.15,,0,27.15,27.15,1,-72320,45911,118231,-26409,0,0,382,0,0,,382,382
13,03/28/2017,49,12:00,12:15,27.15,,0,27.15,27.15,1,-72727,41925,114652,-30802,0,0,505,0,0,,505,505
13,03/28/2017,50,12:15,12:30,,,0,29.44,29.44,0,-61828,33413,95241,-28415,0,0,0,0,0,,0,0
13,03/28/2017,51,12:30,12:45,27.54,,0,27.54,27.54,1,-57009,37394,94403,-19615,0,0,103,0,0,,103,103
13,03/28/2017,52,12:45,13:00,27.54,,0,27.54,27.54,1,-58669,36095,94764,-22574,0,0,1468,0,0,,1468,1468
13,03/28/2017,53,13:00,13:15,27.83,,0,27.83,27.83,1,-63040,58667,121707,-4373,0,0,590,0,0,,590,590
13,03/28/2017,54,13:15,13:30,32.38,,0,32.38,32.38,1,-62406,43299,105705,-19107,0,0,4567,0,0,,4567,4567
13,03/28/2017,55,13:30,13:45,27.15,,0,27.15,27.15,1,-50343,41083,91426,-9260,0,0,211,0,0,,211,211
13,03/28/2017,56,13:45,14:00,27.15,,0,27.15,27.15,1,-39442,42451,81893,3009,0,0,137,0,0,,137,137
13,03/28/2017,57,14:00,14:15,,,0,28.8,28.8,0,-29809,54851,84660,25042,0,0,0,0,0,,0,0
13,03/28/2017,58,14:15,14:30,,,0,28.8,28.8,0,-23289,52466,75755,29177,0,0,0,0,0,,0,0
13,03/28/2017,59,14:30,14:45,,23.72,0,23.72,23.72,-1,-19521,62807,82328,43286,0,-8565,0,0,0,,8565,-8565
13,03/28/2017,60,14:45,15:00,,20.32,0,20.32,20.32,-1,-20460,63383,83843,42923,0,-30652,0,0,0,,30652,-30652
13,03/28/2017,61,15:00,15:15,,21.36,0,21.36,21.36,-1,-11868,53810,65678,41942,0,-24402,0,0,0,,24402,-24402
13,03/28/2017,62,15:15,15:30,,5.39,0,5.39,5.39,-1,-32839,78122,110961,45283,0,-8051,0,0,0,,8051,-8051
13,03/28/2017,63,15:30,15:45,,5.39,0,5.39,5.39,-1,-60984,63022,124006,2038,0,-26410,0,0,0,,26410,-26410
13,03/28/2017,64,15:45,16:00,,16.49,0,16.49,16.49,-1,-47472,82794,130266,35322,0,-13576,0,0,0,,13576,-13576
13,03/28/2017,65,16:00,16:15,,26.39,0,26.39,26.39,-1,-91667,53215,144882,-38452,0,-9720,0,0,0,,9720,-9720
13,03/28/2017,66,16:15,16:30,,,0,28.9,28.9,0,-66299,54907,121206,-11392,0,-12,0,0,0,,12,-12
13,03/28/2017,67,16:30,16:45,,28.72,0,28.72,28.72,-1,-57572,47110,104682,-10462,0,-294,0,0,0,,294,-294
13,03/28/2017,68,16:45,17:00,,,0,28.9,28.9,0,-63559,45320,108879,-18239,0,0,0,0,0,,0,0
13,03/28/2017,69,17:00,17:15,,,0,28.91,28.91,0,-83754,14295,98049,-69459,0,0,0,0,0,,0,0
13,03/28/2017,70,17:15,17:30,27.54,,0,27.54,27.54,1,-73904,18382,92286,-55522,0,0,234,0,0,,234,234
13,03/28/2017,71,17:30,17:45,33.94,,0,33.94,33.94,1,-80729,26593,107322,-54136,0,0,1720,0,0,,1720,1720
13,03/28/2017,72,17:45,18:00,33.94,,0,33.94,33.94,1,-66044,39858,105902,-26186,0,0,1305,0,0,,1305,1305
13,03/28/2017,73,18:00,18:15,115.12,,0,115.12,115.12,1,-157771,16694,174465,-141077,0,0,13798,0,0,,13798,13798
13,03/28/2017,74,18:15,18:30,30.72,,0,30.72,30.72,1,-73523,32094,105617,-41429,0,0,3868,0,0,,3868,3868
13,03/28/2017,75,18:30,18:45,,28.72,0,28.72,28.72,-1,-40685,42027,82712,1342,0,-1154,0,0,0,,1154,-1154
13,03/28/2017,76,18:45,19:00,,29.58,0,29.58,29.58,-1,-53756,58189,111945,4433,0,-1343,0,0,0,,1343,-1343
13,03/28/2017,77,19:00,19:15,,,0,29.16,29.16,0,-94908,40142,135050,-54766,0,0,0,0,0,,0,0
13,03/28/2017,78,19:15,19:30,,,0,29.16,29.16,0,-80180,37452,117632,-42728,0,0,0,0,0,,0,0
13,03/28/2017,79,19:30,19:45,,,0,29.16,29.16,0,-87519,36016,123535,-51503,0,0,0,0,0,,0,0
13,03/28/2017,80,19:45,20:00,,,0,29.16,29.16,0,-59272,26691,85963,-32581,0,0,0,0,0,,0,0
13,03/28/2017,81,20:00,20:15,,,0,29.43,29.43,0,-58229,38604,96833,-19625,0,0,0,0,0,,0,0
13,03/28/2017,82,20:15,20:30,,,0,29.43,29.43,0,-73177,23209,96386,-49968,0,0,0,0,0,,0,0
13,03/28/2017,83,20:30,20:45,47.01,,0,47.01,47.01,1,-108644,21644,130288,-87000,0,0,5728,0,0,,5728,5728
13,03/28/2017,84,20:45,21:00,31.45,,0,31.45,31.45,1,-119424,27180,146604,-92244,0,0,6095,0,0,,6095,6095
13,03/28/2017,85,21:00,21:15,115.12,,0,115.12,115.12,1,-153736,22578,176314,-131158,0,0,26342,0,0,,26342,26342
13,03/28/2017,86,21:15,21:30,37.96,,0,37.96,37.96,1,-127305,29396,156701,-97909,0,0,25727,0,0,,25727,25727
13,03/28/2017,87,21:30,21:45,,,0,29.48,29.48,0,-91542,41117,132659,-50425,0,0,1711,0,0,,1711,1711
13,03/28/2017,88,21:45,22:00,,27.78,0,27.78,27.78,-1,-99260,74110,173370,-25150,0,-1155,0,0,0,,1155,-1155
13,03/28/2017,89,22:00,22:15,367.84,27.78,0,367.84,367.84,1,-162835,26329,189164,-136506,0,-69,15374,0,0,,15443,15305
13,03/28/2017,90,22:15,22:30,367.84,,0,367.84,367.84,1,-128161,77211,205372,-50950,0,0,32717,0,0,,32717,32717
13,03/28/2017,91,22:30,22:45,367.84,23.72,0,23.72,23.72,-1,-114913,128469,243382,13556,0,-1165,697,0,0,,1862,-468
13,03/28/2017,92,22:45,23:00,,19.11,0,19.11,19.11,-1,-103398,151668,255066,48270,0,-7428,0,0,0,,7428,-7428
13,03/28/2017,93,23:00,23:15,298.59,-10.55,0,298.59,-10.55,2,-98074,48248,146322,-49826,0,-16009,4303,0,0,,20312,-11706
13,03/28/2017,94,23:15,23:30,337.41,22.8,0,337.41,22.8,2,-77632,85894,163526,8262,0,-418,19796,0,0,,20214,19378
13,03/28/2017,95,23:30,23:45,337.41,5.05,0,5.05,5.05,-1,-51100,101449,152549,50349,0,-5542,15,0,0,,5557,-5527
13,03/28/2017,96,23:45,0:00,,-10.55,0,-10.55,-10.55,-1,-45369,93241,138610,47872,0,-17055,0,0,0,,17055,-17055
13,03/29/2017,1,0:00,0:15,156.23,4.89,0,156.23,156.23,1,-117840,59046,176886,-58794,0,-14020,6597,0,0,,20617,-7423
13,03/29/2017,2,0:15,0:30,33.86,24.83,0,24.83,24.83,-1,-89426,82998,172424,-6428,0,-120,7672,0,0,,7792,7552
13,03/29/2017,3,0:30,0:45,33.86,23.83,0,23.83,23.83,-1,-79767,48576,128343,-31191,0,-1704,10,0,0,,1714,-1694
13,03/29/2017,4,0:45,1:00,,,0,29.08,29.08,0,-100764,44545,145309,-56219,0,0,0,0,0,,0,0
13,03/29/2017,5,1:00,1:15,,24.64,0,24.64,24.64,-1,-85255,100798,186053,15543,0,-1812,0,0,0,,1812,-1812
13,03/29/2017,6,1:15,1:30,,,0,29.15,29.15,0,-112939,57965,170904,-54974,0,0,0,0,0,,0,0
13,03/29/2017,7,1:30,1:45,,,0,29.15,29.15,0,-110114,36702,146816,-73412,0,0,0,0,0,,0,0
13,03/29/2017,8,1:45,2:00,,,0,29.15,29.15,0,-97775,47605,145380,-50170,0,0,0,0,0,,0,0
13,03/29/2017,9,2:00,2:15,30.72,,0,30.72,30.72,1,-86201,43232,129433,-42969,0,0,1125,0,0,,1125,1125
13,03/29/2017,10,2:15,2:30,33.03,,0,33.03,33.03,1,-88849,35378,124227,-53471,0,0,1730,0,0,,1730,1730
13,03/29/2017,11,2:30,2:45,28.1,,0,28.1,28.1,1,-96612,39513,136125,-57099,0,0,1018,0,0,,1018,1018
13,03/29/2017,12,2:45,3:00,27.45,,0,27.45,27.45,1,-102256,51107,153363,-51149,0,0,1130,0,0,,1130,1130
13,03/29/2017,13,3:00,3:15,30.72,,0,30.72,30.72,1,-86886,81894,168780,-4992,0,0,2961,0,0,,2961,2961
13,03/29/2017,14,3:15,3:30,27.06,,0,27.06,27.06,1,-65438,68048,133486,2610,0,0,449,0,0,,449,449
13,03/29/2017,15,3:30,3:45,27.06,,0,27.06,27.06,1,-68405,69339,137744,934,0,0,58,0,0,,58,58
13,03/29/2017,16,3:45,4:00,27.45,,0,27.45,27.45,1,-78842,71671,150513,-7171,0,0,1048,0,0,,1048,1048
13,03/29/2017,17,4:00,4:15,27.06,,0,27.06,27.06,1,-50661,82246,132907,31585,0,0,938,0,0,,938,938
13,03/29/2017,18,4:15,4:30,,,0,29.22,29.22,0,-41521,77756,119277,36235,0,0,5,0,0,,5,5
13,03/29/2017,19,4:30,4:45,,,0,29.22,29.22,0,-28577,66539,95116,37962,0,0,0,0,0,,0,0
13,03/29/2017,20,4:45,5:00,,,0,29.22,29.22,0,-24459,60247,84706,35788,0,0,0,0,0,,0,0
13,03/29/2017,21,5:00,5:15,,-30.4,0,-30.4,-30.4,-1,-31323,99374,130697,68051,0,-15989,0,0,0,,15989,-15989
13,03/29/2017,22,5:15,5:30,,-30.4,0,-30.4,-30.4,-1,-32775,45515,78290,12740,0,-25132,0,0,0,,25132,-25132
13,03/29/2017,23,5:30,5:45,,24.83,0,24.83,24.83,-1,-32996,60651,93647,27655,0,-4398,0,0,0,,4398,-4398
13,03/29/2017,24,5:45,6:00,,24.83,0,24.83,24.83,-1,-48312,66358,114670,18046,0,-2326,0,0,0,,2326,-2326
13,03/29/2017,25,6:00,6:15,,15.79,0,15.79,15.79,-1,-70959,121767,192726,50808,0,-9825,0,0,0,,9825,-9825
13,03/29/2017,26,6:15,6:30,,13.23,0,13.23,13.23,-1,-39665,56470,96135,16805,0,-30896,0,0,0,,30896,-30896
13,03/29/2017,27,6:30,6:45,30.18,13.23,0,30.18,30.18,1,-73041,17360,90401,-55681,0,-6479,975,0,0,,7454,-5504
13,03/29/2017,28,6:45,7:00,228.54,,0,228.54,228.54,1,-143724,36265,179989,-107459,0,0,18089,0,0,,18089,18089
13,03/29/2017,29,7:00,7:15,228.54,18.28,0,18.28,18.28,-1,-16735,68780,85515,52045,0,-3318,6671,0,0,,9989,3353
13,03/29/2017,30,7:15,7:30,,26.44,0,26.44,26.44,-1,-35924,38115,74039,2191,0,-1047,0,0,0,,1047,-1047
13,03/29/2017,31,7:30,7:45,,24.83,0,24.83,24.83,-1,-86175,48986,135161,-37189,0,-2390,0,0,0,,2390,-2390
13,03/29/2017,32,7:45,8:00,45.56,,0,45.56,45.56,1,-125262,55931,181193,-69331,0,0,10700,0,0,,10700,10700
13,03/29/2017,33,8:00,8:15,30.72,32.21,0,32.21,32.21,-1,-44806,76191,120997,31385,0,-88,4837,0,0,,4925,4749
13,03/29/2017,34,8:15,8:30,,32.21,0,32.21,32.21,-1,-39925,42786,82711,2861,0,-117,0,0,0,,117,-117
13,03/29/2017,35,8:30,8:45,,32.21,0,32.21,32.21,-1,-45956,33562,79518,-12394,0,-363,0,0,0,,363,-363
13,03/29/2017,36,8:45,9:00,,,0,29.64,29.64,0,-56772,32464,89236,-24308,0,0,0,0,0,,0,0
13,03/29/2017,37,9:00,9:15,,32.15,0,32.15,32.15,-1,-69169,26783,95952,-42386,0,-22,0,0,0,,22,-22
13,03/29/2017,38,9:15,9:30,28.52,,0,28.52,28.52,1,-103537,18736,122273,-84801,0,0,1300,0,0,,1300,1300
13,03/29/2017,39,9:30,9:45,27.45,,0,27.45,27.45,1,-97538,23979,121517,-73559,0,0,1026,0,0,,1026,1026
13,03/29/2017,40,9:45,10:00,30.72,,0,30.72,30.72,1,-93846,23459,117305,-70387,0,0,175,0,0,,175,175
13,03/29/2017,41,10:00,10:15,140.63,,0,140.63,140.63,1,-105157,41673,146830,-63484,0,0,22373,0,0,,22373,22373
13,03/29/2017,42,10:15,10:30,30.72,,0,30.72,30.72,1,-72344,37344,109688,-35000,0,0,8146,0,0,,8146,8146
13,03/29/2017,43,10:30,10:45,27.06,30.42,0,30.42,30.42,-1,-62731,46308,109039,-16423,0,-47,1656,0,0,,1703,1609
13,03/29/2017,44,10:45,11:00,,26.41,0,26.41,26.41,-1,-60554,48151,108705,-12403,0,-514,0,0,0,,514,-514
13,03/29/2017,45,11:00,11:15,,,0,29.28,29.28,0,-62516,57713,120229,-4803,0,0,0,0,0,,0,0
13,03/29/2017,46,11:15,11:30,,,0,29.28,29.28,0,-79270,44554,123824,-34716,0,0,0,0,0,,0,0
13,03/29/2017,47,11:30,11:45,34.72,,0,34.72,34.72,1,-84712,38751,123463,-45961,0,0,4161,0,0,,4161,4161
13,03/29/2017,48,11:45,12:00,27.06,,0,27.06,27.06,1,-102124,52959,155083,-49165,0,0,222,0,0,,222,222
13,03/29/2017,49,12:00,12:15,30.64,,0,30.64,30.64,1,-102057,35780,137837,-66277,0,0,1806,0,0,,1806,1806
13,03/29/2017,50,12:15,12:30,27.06,,0,27.06,27.06,1,-114077,37394,151471,-76683,0,0,920,0,0,,920,920
13,03/29/2017,51,12:30,12:45,,,0,29.05,29.05,0,-107290,44844,152134,-62446,0,0,0,0,0,,0,0
13,03/29/2017,52,12:45,13:00,27.06,,0,27.06,27.06,1,-109071,52967,162038,-56104,0,0,74,0,0,,74,74
13,03/29/2017,53,13:00,13:15,71.45,,0,71.45,71.45,1,-143193,41075,184268,-102118,0,0,13204,0,0,,13204,13204
13,03/29/2017,54,13:15,13:30,71.45,,0,71.45,71.45,1,-118317,35009,153326,-83308,0,0,16568,0,0,,16568,16568
13,03/29/2017,55,13:30,13:45,,,0,28.86,28.86,0,-107959,24571,132530,-83388,0,0,582,0,0,,582,582
13,03/29/2017,56,13:45,14:00,34.72,,0,34.72,34.72,1,-131296,22640,153936,-108656,0,0,5138,0,0,,5138,5138
13,03/29/2017,57,14:00,14:15,34.72,,0,34.72,34.72,1,-103661,22112,125773,-81549,0,0,10436,0,0,,10436,10436
13,03/29/2017,58,14:15,14:30,34.72,,0,34.72,34.72,1,-83254,19838,103092,-63416,0,0,6962,0,0,,6962,6962
13,03/29/2017,59,14:30,14:45,35.28,,0,35.28,35.28,1,-107907,21816,129723,-86091,0,0,2715,0,0,,2715,2715
13,03/29/2017,60,14:45,15:00,27.45,,0,27.45,27.45,1,-86021,20638,106659,-65383,0,0,1148,0,0,,1148,1148
13,03/29/2017,61,15:00,15:15,35.28,,0,35.28,35.28,1,-89137,69965,159102,-19172,0,0,4818,0,0,,4818,4818
13,03/29/2017,62,15:15,15:30,27.45,,0,27.45,27.45,1,-74517,58777,133294,-15740,0,0,204,0,0,,204,204
13,03/29/2017,63,15:30,15:45,27.74,,0,27.74,27.74,1,-77352,64365,141717,-12987,0,0,1963,0,0,,1963,1963
13,03/29/2017,64,15:45,16:00,30.72,,0,30.72,30.72,1,-93678,68304,161982,-25374,0,0,2830,0,0,,2830,2830
13,03/29/2017,65,16:00,16:15,27.45,,0,27.45,27.45,1,-89837,49032,138869,-40805,0,0,532,0,0,,532,532
13,03/29/2017,66,16:15,16:30,30.72,,0,30.72,30.72,1,-75577,37909,113486,-37668,0,0,4215,0,0,,4215,4215
13,03/29/2017,67,16:30,16:45,29.22,,0,29.22,29.22,1,-83921,38895,122816,-45026,0,0,4569,0,0,,4569,4569
13,03/29/2017,68,16:45,17:00,30.72,,0,30.72,30.72,1,-118231,37603,155834,-80628,0,0,1682,0,0,,1682,1682
13,03/29/2017,69,17:00,17:15,30.98,,0,30.98,30.98,1,-92618,29656,122274,-62962,0,0,921,0,0,,921,921
13,03/29/2017,70,17:15,17:30,30.72,,0,30.72,30.72,1,-83625,24045,107670,-59580,0,0,245,0,0,,245,245
13,03/29/2017,71,17:30,17:45,41.01,,0,41.01,41.01,1,-74654,29416,104070,-45238,0,0,6090,0,0,,6090,6090
13,03/29/2017,72,17:45,18:00,41.01,,0,41.01,41.01,1,-59380,53342,112722,-6038,0,0,13671,0,0,,13671,13671
13,03/29/2017,73,18:00,18:15,,,0,28.65,28.65,0,-74657,20533,95190,-54124,0,0,1261,0,0,,1261,1261
13,03/29/2017,74,18:15,18:30,,,0,28.65,28.65,0,-63403,28244,91647,-35159,0,0,0,0,0,,0,0
13,03/29/2017,75,18:30,18:45,,,0,28.65,28.65,0,-71365,43237,114602,-28128,0,0,0,0,0,,0,0
13,03/29/2017,76,18:45,19:00,28.1,,0,28.1,28.1,1,-75458,59632,135090,-15826,0,0,362,0,0,,362,362
13,03/29/2017,77,19:00,19:15,28.1,4.96,0,4.96,4.96,-1,-50790,68099,118889,17309,0,-12217,335,0,0,,12552,-11882
13,03/29/2017,78,19:15,19:30,,4.96,0,4.96,4.96,-1,-85706,63629,149335,-22077,0,-15958,0,0,0,,15958,-15958
13,03/29/2017,79,19:30,19:45,,,0,28.73,28.73,0,-89569,67267,156836,-22302,0,-13,0,0,0,,13,-13
13,03/29/2017,80,19:45,20:00,33.03,,0,33.03,33.03,1,-92603,48358,140961,-44245,0,0,1031,0,0,,1031,1031
13,03/29/2017,81,20:00,20:15,,,0,28.87,28.87,0,-43427,55508,98935,12081,0,0,94,0,0,,94,94
13,03/29/2017,82,20:15,20:30,38.88,,0,38.88,38.88,1,-82451,37410,119861,-45041,0,0,6106,0,0,,6106,6106
13,03/29/2017,83,20:30,20:45,102.02,,0,102.02,102.02,1,-81341,32533,113874,-48808,0,0,45815,0,0,,45815,45815
13,03/29/2017,84,20:45,21:00,33.86,25.03,0,25.03,25.03,-1,-50007,47426,97433,-2581,0,-259,18123,0,0,,18382,17864
13,03/29/2017,85,21:00,21:15,33.86,25.03,0,25.03,25.03,-1,-47725,77363,125088,29638,0,-215,3,0,0,,218,-212
13,03/29/2017,86,21:15,21:30,,,0,28.88,28.88,0,-28399,84552,112951,56153,0,0,0,0,0,,0,0
13,03/29/2017,87,21:30,21:45,,,0,28.88,28.88,0,-21662,73142,94804,51480,0,0,0,0,0,,0,0
13,03/29/2017,88,21:45,22:00,,-30.4,0,-30.4,-30.4,-1,-19062,100228,119290,81166,0,-21398,0,0,0,,21398,-21398
13,03/29/2017,89,22:00,22:15,41.07,-30.4,0,41.07,-30.4,2,-82851,34324,117175,-48527,0,-19886,3238,0,0,,23124,-16648
13,03/29/2017,90,22:15,22:30,27.45,,0,27.45,27.45,1,-62005,41436,103441,-20569,0,0,1217,0,0,,1217,1217
13,03/29/2017,91,22:30,22:45,,,0,28.91,28.91,0,-29801,71197,100998,41396,0,0,0,0,0,,0,0
13,03/29/2017,92,22:45,23:00,,,0,28.91,28.91,0,-27519,87104,114623,59585,0,0,0,0,0,,0,0
13,03/29/2017,93,23:00,23:15,27.45,26.39,0,29,26.39,2,-70912,30400,101312,-40512,0,-186,302,0,0,,488,116
13,03/29/2017,94,23:15,23:30,27.06,,0,27.06,27.06,1,-57795,20496,78291,-37299,0,0,485,0,0,,485,485
13,03/29/2017,95,23:30,23:45,27.45,,0,27.45,27.45,1,-44511,33792,78303,-10719,0,0,522,0,0,,522,522
13,03/29/2017,96,23:45,0:00,27.45,,0,27.45,27.45,1,-71864,62191,134055,-9673,0,0,323,0,0,,323,323
13,03/30/2017,1,0:00,0:15,27.17,,0,27.17,27.17,1,-50191,24364,74555,-25827,0,0,341,0,0,,341,341
13,03/30/2017,2,0:15,0:30,30.68,,0,30.68,30.68,1,-54173,20715,74888,-33458,0,0,3374,0,0,,3374,3374
13,03/30/2017,3,0:30,0:45,27.82,,0,27.82,27.82,1,-76925,34113,111038,-42812,0,0,1092,0,0,,1092,1092
13,03/30/2017,4,0:45,1:00,26.91,,0,26.91,26.91,1,-105156,50941,156097,-54215,0,0,1693,0,0,,1693,1693
13,03/30/2017,5,1:00,1:15,30.91,,0,30.91,30.91,1,-69159,57167,126326,-11992,0,0,1959,0,0,,1959,1959
13,03/30/2017,6,1:15,1:30,26.91,,0,26.91,26.91,1,-58643,24000,82643,-34643,0,0,1923,0,0,,1923,1923
13,03/30/2017,7,1:30,1:45,26.91,,0,26.91,26.91,1,-51244,14547,65791,-36697,0,0,1379,0,0,,1379,1379
13,03/30/2017,8,1:45,2:00,26.78,,0,26.78,26.78,1,-39783,31269,71052,-8514,0,0,924,0,0,,924,924
13,03/30/2017,9,2:00,2:15,43.79,,0,43.79,43.79,1,-61162,9487,70649,-51675,0,0,11786,0,0,,11786,11786
13,03/30/2017,10,2:15,2:30,30.91,24.91,0,24.91,24.91,-1,-35361,21931,57292,-13430,0,-468,6407,0,0,,6875,5939
13,03/30/2017,11,2:30,2:45,,24.91,0,24.91,24.91,-1,-52590,16029,68619,-36561,0,-1183,0,0,0,,1183,-1183
13,03/30/2017,12,2:45,3:00,,30.21,0,30.21,30.21,-1,-57597,18839,76436,-38758,0,-49,0,0,0,,49,-49
13,03/30/2017,13,3:00,3:15,42.11,23.91,0,42.11,23.91,2,-72813,22494,95307,-50319,0,-889,6817,0,0,,7706,5928
13,03/30/2017,14,3:15,3:30,30.91,,0,30.91,30.91,1,-59682,29108,88790,-30574,0,0,5273,0,0,,5273,5273
13,03/30/2017,15,3:30,3:45,26.78,,0,26.78,26.78,1,-51342,28208,79550,-23134,0,0,138,0,0,,138,138
13,03/30/2017,16,3:45,4:00,26.78,,0,26.78,26.78,1,-53924,20144,74068,-33780,0,0,480,0,0,,480,480
13,03/30/2017,17,4:00,4:15,26.91,,0,26.91,26.91,1,-40096,32515,72611,-7581,0,0,1671,0,0,,1671,1671
13,03/30/2017,18,4:15,4:30,26.91,,0,26.91,26.91,1,-39557,21095,60652,-18462,0,0,1645,0,0,,1645,1645
13,03/30/2017,19,4:30,4:45,26.91,,0,26.91,26.91,1,-22031,25637,47668,3606,0,0,1620,0,0,,1620,1620
13,03/30/2017,20,4:45,5:00,,,0,28.29,28.29,0,-26764,36570,63334,9806,0,0,90,0,0,,90,90
13,03/30/2017,21,5:00,5:15,,23.91,0,23.91,23.91,-1,-25406,49991,75397,24585,0,-1461,0,0,0,,1461,-1461
13,03/30/2017,22,5:15,5:30,,23.91,0,23.91,23.91,-1,-4909,48558,53467,43649,0,-4389,0,0,0,,4389,-4389
13,03/30/2017,23,5:30,5:45,,-74.89,0,-74.89,-74.89,-1,-16219,85760,101979,69541,0,-28166,0,0,0,,28166,-28166
13,03/30/2017,24,5:45,6:00,,20.5,0,20.5,20.5,-1,-45266,116142,161408,70876,0,-25991,0,0,0,,25991,-25991
13,03/30/2017,25,6:00,6:15,,-54.6,0,-54.6,-54.6,-1,-61816,115962,177778,54146,0,-17106,0,0,0,,17106,-17106
13,03/30/2017,26,6:15,6:30,,-55.91,0,-55.91,-55.91,-1,-32773,94755,127528,61982,0,-58142,0,0,0,,58142,-58142
13,03/30/2017,27,6:30,6:45,,4.34,0,4.34,4.34,-1,-41217,101317,142534,60100,0,-26553,0,0,0,,26553,-26553
13,03/30/2017,28,6:45,7:00,,4.68,0,4.68,4.68,-1,-55636,88261,143897,32625,0,-28344,0,0,0,,28344,-28344
13,03/30/2017,29,7:00,7:15,,,0,29.2,29.2,0,-34546,84573,119119,50027,0,-1521,0,0,0,,1521,-1521
13,03/30/2017,30,7:15,7:30,,22.56,0,22.56,22.56,-1,-16726,57516,74242,40790,0,-2027,0,0,0,,2027,-2027
13,03/30/2017,31,7:30,7:45,,19.76,0,19.76,19.76,-1,-43483,35710,79193,-7773,0,-7119,0,0,0,,7119,-7119
13,03/30/2017,32,7:45,8:00,30.08,19.76,0,30.08,30.08,1,-76637,38099,114736,-38538,0,-11,636,0,0,,647,625
13,03/30/2017,33,8:00,8:15,27.17,,0,27.17,27.17,1,-55340,65158,120498,9818,0,0,104,0,0,,104,104
13,03/30/2017,34,8:15,8:30,33.05,,0,33.05,33.05,1,-60408,29276,89684,-31132,0,0,3854,0,0,,3854,3854
13,03/30/2017,35,8:30,8:45,27.17,,0,27.17,27.17,1,-71417,12940,84357,-58477,0,0,2177,0,0,,2177,2177
13,03/30/2017,36,8:45,9:00,26.78,,0,26.78,26.78,1,-86337,16142,102479,-70195,0,0,226,0,0,,226,226
13,03/30/2017,37,9:00,9:15,29.12,,0,29.12,29.12,1,-87809,22733,110542,-65076,0,0,1463,0,0,,1463,1463
13,03/30/2017,38,9:15,9:30,29.17,,0,29.17,29.17,1,-78225,13562,91787,-64663,0,0,2574,0,0,,2574,2574
13,03/30/2017,39,9:30,9:45,30.08,,0,30.08,30.08,1,-59032,13971,73003,-45061,0,0,1255,0,0,,1255,1255
13,03/30/2017,40,9:45,10:00,,,0,29.99,29.99,0,-44860,14096,58956,-30764,0,0,0,0,0,,0,0
13,03/30/2017,41,10:00,10:15,91.12,,0,91.12,91.12,1,-66857,20056,86913,-46801,0,0,11829,0,0,,11829,11829
13,03/30/2017,42,10:15,10:30,27.98,,0,27.98,27.98,1,-43662,33871,77533,-9791,0,0,3274,0,0,,3274,3274
13,03/30/2017,43,10:30,10:45,26.78,31.59,0,31.59,31.59,-1,-31453,45169,76622,13716,0,-22,236,0,0,,258,214
13,03/30/2017,44,10:45,11:00,,19.76,0,19.76,19.76,-1,-23847,62212,86059,38365,0,-13772,0,0,0,,13772,-13772
13,03/30/2017,45,11:00,11:15,,32.59,0,32.59,32.59,-1,-55698,43112,98810,-12586,0,-2492,0,0,0,,2492,-2492
13,03/30/2017,46,11:15,11:30,,29.28,0,29.28,29.28,-1,-50540,51355,101895,815,0,-3060,0,0,0,,3060,-3060
13,03/30/2017,47,11:30,11:45,,32.59,0,32.59,32.59,-1,-40280,44927,85207,4647,0,-2047,0,0,0,,2047,-2047
13,03/30/2017,48,11:45,12:00,,32.59,0,32.59,32.59,-1,-45117,57235,102352,12118,0,-1416,0,0,0,,1416,-1416
13,03/30/2017,49,12:00,12:15,,27.48,0,27.48,27.48,-1,-67464,58295,125759,-9169,0,-448,0,0,0,,448,-448
13,03/30/2017,50,12:15,12:30,,24.76,0,24.76,24.76,-1,-59683,62737,122420,3054,0,-2688,0,0,0,,2688,-2688
13,03/30/2017,51,12:30,12:45,,23.76,0,23.76,23.76,-1,-58578,78828,137406,20250,0,-20541,0,0,0,,20541,-20541
13,03/30/2017,52,12:45,13:00,,24.76,0,24.76,24.76,-1,-55599,69239,124838,13640,0,-16391,0,0,0,,16391,-16391
13,03/30/2017,53,13:00,13:15,,14.79,0,14.79,14.79,-1,-67131,69339,136470,2208,0,-17349,0,0,0,,17349,-17349
13,03/30/2017,54,13:15,13:30,,,0,28.99,28.99,0,-77473,43137,120610,-34336,0,-780,0,0,0,,780,-780
13,03/30/2017,55,13:30,13:45,,25.78,0,25.78,25.78,-1,-75336,75158,150494,-178,0,-1852,0,0,0,,1852,-1852
13,03/30/2017,56,13:45,14:00,,24.78,0,24.78,24.78,-1,-72189,82049,154238,9860,0,-14481,0,0,0,,14481,-14481
13,03/30/2017,57,14:00,14:15,,19.76,0,19.76,19.76,-1,-61908,111246,173154,49338,0,-16018,0,0,0,,16018,-16018
13,03/30/2017,58,14:15,14:30,,17.48,0,17.48,17.48,-1,-58603,93263,151866,34660,0,-10212,0,0,0,,10212,-10212
13,03/30/2017,59,14:30,14:45,,-8.75,0,-8.75,-8.75,-1,-73042,81095,154137,8053,-5000,-21160,0,0,0,,26160,-26160
13,03/30/2017,60,14:45,15:00,27.17,28.97,0,28.49,28.49,2,-80902,61955,142857,-18947,0,-1363,548,0,0,,1911,-815
13,03/30/2017,61,15:00,15:15,27.17,23.79,0,23.79,23.79,-1,-44520,89132,133652,44612,0,-2944,2,0,0,,2946,-2942
13,03/30/2017,62,15:15,15:30,,28.78,0,28.78,28.78,-1,-44144,63250,107394,19106,0,-272,0,0,0,,272,-272
13,03/30/2017,63,15:30,15:45,90.12,28.78,0,90.12,90.12,1,-77751,35113,112864,-42638,0,-290,8491,0,0,,8781,8201
13,03/30/2017,64,15:45,16:00,101.12,,0,101.12,101.12,1,-76768,67658,144426,-9110,0,0,28660,0,0,,28660,28660
13,03/30/2017,65,16:00,16:15,101.12,23.76,0,23.76,23.76,-1,-50912,79109,130021,28197,0,-3872,1386,0,0,,5258,-2486
13,03/30/2017,66,16:15,16:30,,30.99,0,30.99,30.99,-1,-49750,42932,92682,-6818,0,-1819,0,0,0,,1819,-1819
13,03/30/2017,67,16:30,16:45,37.22,30.99,0,37.22,37.22,1,-59790,38180,97970,-21610,0,-83,1437,0,0,,1520,1354
13,03/30/2017,68,16:45,17:00,39.29,,0,39.29,39.29,1,-77035,50573,127608,-26462,0,0,14127,0,0,,14127,14127
13,03/30/2017,69,17:00,17:15,30.92,,0,30.92,30.92,1,-62515,26904,89419,-35611,0,0,4610,0,0,,4610,4610
13,03/30/2017,70,17:15,17:30,128.96,,0,128.96,128.96,1,-92852,19441,112293,-73411,0,0,13469,0,0,,13469,13469
13,03/30/2017,71,17:30,17:45,128.96,,0,128.96,128.96,1,-87955,40530,128485,-47425,0,0,43536,0,0,,43536,43536
13,03/30/2017,72,17:45,18:00,42.93,,0,42.93,42.93,1,-96106,84931,181037,-11175,0,0,34739,0,0,,34739,34739
13,03/30/2017,73,18:00,18:15,26.78,,0,26.78,26.78,1,-88306,57149,145455,-31157,0,0,4292,0,0,,4292,4292
13,03/30/2017,74,18:15,18:30,89.23,,0,89.23,89.23,1,-94436,41553,135989,-52883,0,0,7782,0,0,,7782,7782
13,03/30/2017,75,18:30,18:45,100.83,,0,100.83,100.83,1,-91091,61076,152167,-30015,0,0,21975,0,0,,21975,21975
13,03/30/2017,76,18:45,19:00,37.18,,0,37.18,37.18,1,-99038,68951,167989,-30087,0,0,24335,0,0,,24335,24335
13,03/30/2017,77,19:00,19:15,30.08,,0,30.08,30.08,1,-103132,73959,177091,-29173,0,0,11622,0,0,,11622,11622
13,03/30/2017,78,19:15,19:30,,,0,29.94,29.94,0,-98594,60791,159385,-37803,0,0,20,0,0,,20,20
13,03/30/2017,79,19:30,19:45,,,0,29.94,29.94,0,-105033,49425,154458,-55608,0,0,0,0,0,,0,0
13,03/30/2017,80,19:45,20:00,46.46,,0,46.46,46.46,1,-136982,37444,174426,-99538,0,0,9047,0,0,,9047,9047
13,03/30/2017,81,20:00,20:15,30.68,,0,30.68,30.68,1,-83531,92498,176029,8967,0,0,4849,0,0,,4849,4849
13,03/30/2017,82,20:15,20:30,139.75,,0,139.75,139.75,1,-122102,54376,176478,-67726,0,0,17842,0,0,,17842,17842
13,03/30/2017,83,20:30,20:45,139.75,,0,139.75,139.75,1,-157559,46501,204060,-111058,0,0,76632,0,0,,76632,76632
13,03/30/2017,84,20:45,21:00,140.07,,0,140.07,140.07,1,-133566,69470,203036,-64096,0,0,62672,16250,0,,78922,78922
13,03/30/2017,85,21:00,21:15,36.39,,0,36.39,36.39,1,-134784,93660,228444,-41124,0,0,6808,0,0,,6808,6808
13,03/30/2017,86,21:15,21:30,41,,0,41,41,1,-102197,90627,192824,-11570,0,0,14294,0,0,,14294,14294
13,03/30/2017,87,21:30,21:45,,,0,28.45,28.45,0,-82941,79597,162538,-3344,0,0,536,0,0,,536,536
13,03/30/2017,88,21:45,22:00,27.98,,0,27.98,27.98,1,-84074,68839,152913,-15235,0,0,656,0,0,,656,656
13,03/30/2017,89,22:00,22:15,40.37,,0,40.37,40.37,1,-128651,37024,165675,-91627,0,0,5400,0,0,,5400,5400
13,03/30/2017,90,22:15,22:30,26.78,,0,26.78,26.78,1,-98332,46938,145270,-51394,0,0,1167,0,0,,1167,1167
13,03/30/2017,91,22:30,22:45,31.84,,0,31.84,31.84,1,-61831,67819,129650,5988,0,0,951,0,0,,951,951
13,03/30/2017,92,22:45,23:00,,,0,29.39,29.39,0,-57154,84929,142083,27775,0,0,0,0,0,,0,0
13,03/30/2017,93,23:00,23:15,206.79,,0,206.79,206.79,1,-123370,46941,170311,-76429,0,0,18696,0,0,,18696,18696
13,03/30/2017,94,23:15,23:30,38.58,29.79,0,29.79,29.79,-1,-96288,73191,169479,-23097,0,-40,20862,0,0,,20902,20822
13,03/30/2017,95,23:30,23:45,38.58,23.76,0,23.76,23.76,-1,-81341,98368,179709,17027,0,-531,338,0,0,,869,-193
13,03/30/2017,96,23:45,0:00,,-27.45,0,-27.45,-27.45,-1,-68108,116896,185004,48788,0,-27146,0,0,0,,27146,-27146
13,03/31/2017,1,0:00,0:15,34.54,20.74,0,34.54,34.54,1,-118705,97651,216356,-21054,0,-19616,730,0,0,,20346,-18886
13,03/31/2017,2,0:15,0:30,37.85,20.38,0,37.85,20.38,2,-50718,61575,112293,10857,0,-1760,2252,0,0,,4012,492
13,03/31/2017,3,0:30,0:45,,-6.49,0,-6.49,-6.49,-1,-27599,61725,89324,34126,0,-37112,0,0,0,,37112,-37112
13,03/31/2017,4,0:45,1:00,,17.1,0,17.1,17.1,-1,-47244,73516,120760,26272,0,-43360,0,0,0,,43360,-43360
13,03/31/2017,5,1:00,1:15,,-63.66,0,-63.66,-63.66,-1,-37144,159971,197115,122827,0,-43233,0,0,0,,43233,-43233
13,03/31/2017,6,1:15,1:30,,-64.71,0,-64.71,-64.71,-1,-38871,119667,158538,80796,0,-26945,0,0,0,,26945,-26945
13,03/31/2017,7,1:30,1:45,,-67.14,0,-67.14,-67.14,-1,-35587,70518,106105,34931,0,-40323,0,0,0,,40323,-40323
13,03/31/2017,8,1:45,2:00,,-67.14,0,-67.14,-67.14,-1,-44557,86694,131251,42137,0,-38896,0,0,0,,38896,-38896
13,03/31/2017,9,2:00,2:15,,8.91,0,8.91,8.91,-1,-37154,80538,117692,43384,0,-23007,0,0,0,,23007,-23007
13,03/31/2017,10,2:15,2:30,,-15.91,0,-15.91,-15.91,-1,-34160,75796,109956,41636,0,-8294,0,0,0,,8294,-8294
13,03/31/2017,11,2:30,2:45,,-15.91,0,-15.91,-15.91,-1,-50455,69232,119687,18777,0,-24040,0,0,0,,24040,-24040
13,03/31/2017,12,2:45,3:00,,-15.91,0,-15.91,-15.91,-1,-30851,72174,103025,41323,0,-36797,0,0,0,,36797,-36797
13,03/31/2017,13,3:00,3:15,,8.91,0,8.91,8.91,-1,-57755,55051,112806,-2704,0,-27604,0,0,0,,27604,-27604
13,03/31/2017,14,3:15,3:30,,5.22,0,5.22,5.22,-1,-53786,80733,134519,26947,0,-23550,0,0,0,,23550,-23550
13,03/31/2017,15,3:30,3:45,,5.22,0,5.22,5.22,-1,-55132,92158,147290,37026,0,-36719,0,0,0,,36719,-36719
13,03/31/2017,16,3:45,4:00,,23.84,0,23.84,23.84,-1,-51524,86985,138509,35461,0,-24543,0,0,0,,24543,-24543
13,03/31/2017,17,4:00,4:15,,25.38,0,25.38,25.38,-1,-40515,83215,123730,42700,0,-10714,0,0,0,,10714,-10714
13,03/31/2017,18,4:15,4:30,,24.51,0,24.51,24.51,-1,-38577,86342,124919,47765,0,-226,0,0,0,,226,-226
13,03/31/2017,19,4:30,4:45,,20.38,0,20.38,20.38,-1,-38077,76058,114135,37981,0,-8929,0,0,0,,8929,-8929
13,03/31/2017,20,4:45,5:00,,20.38,0,20.38,20.38,-1,-34478,84094,118572,49616,0,-15276,0,0,0,,15276,-15276
13,03/31/2017,21,5:00,5:15,,-48.5,0,-48.5,-48.5,-1,-38034,98700,136734,60666,0,-23846,0,0,0,,23846,-23846
13,03/31/2017,22,5:15,5:30,,-57.58,0,-57.58,-57.58,-1,-53627,65367,118994,11740,0,-41183,0,0,0,,41183,-41183
13,03/31/2017,23,5:30,5:45,,20.38,0,20.38,20.38,-1,-41739,84034,125773,42295,0,-21881,0,0,0,,21881,-21881
13,03/31/2017,24,5:45,6:00,,17.1,0,17.1,17.1,-1,-68151,124436,192587,56285,0,-23912,0,0,0,,23912,-23912
13,03/31/2017,25,6:00,6:15,,17.03,0,17.03,17.03,-1,-63818,108435,172253,44617,0,-25020,0,0,0,,25020,-25020
13,03/31/2017,26,6:15,6:30,,25.67,0,25.67,25.67,-1,-46127,75679,121806,29552,0,-11981,0,0,0,,11981,-11981
13,03/31/2017,27,6:30,6:45,,,0,30.25,30.25,0,-72091,75804,147895,3713,0,-98,0,0,0,,98,-98
13,03/31/2017,28,6:45,7:00,35.1,,0,35.1,35.1,1,-103832,70027,173859,-33805,0,0,1203,0,0,,1203,1203
13,03/31/2017,29,7:00,7:15,35.1,30.55,0,30.55,30.55,-1,-35736,104096,139832,68360,0,-656,46,0,0,,702,-610
13,03/31/2017,30,7:15,7:30,,26.74,0,26.74,26.74,-1,-39420,97722,137142,58302,0,-5309,0,0,0,,5309,-5309
13,03/31/2017,31,7:30,7:45,,26.74,0,26.74,26.74,-1,-55408,73011,128419,17603,0,-8880,0,0,0,,8880,-8880
13,03/31/2017,32,7:45,8:00,32.95,26.74,0,32.95,32.95,1,-79988,49334,129322,-30654,0,-1335,784,0,0,,2119,-551
13,03/31/2017,33,8:00,8:15,32.95,24.6,0,24.6,24.6,-1,-52387,91785,144172,39398,0,-6222,11,0,0,,6233,-6211
13,03/31/2017,34,8:15,8:30,,29.6,0,29.6,29.6,-1,-81738,66880,148618,-14858,0,-4266,0,0,0,,4266,-4266
13,03/31/2017,35,8:30,8:45,,,0,30.28,30.28,0,-104988,40995,145983,-63993,0,0,0,0,0,,0,0
13,03/31/2017,36,8:45,9:00,27.67,,0,27.67,27.67,1,-117018,33842,150860,-83176,0,0,161,0,0,,161,161
13,03/31/2017,37,9:00,9:15,48.74,,0,48.74,48.74,1,-138323,47799,186122,-90524,0,0,13393,0,0,,13393,13393
13,03/31/2017,38,9:15,9:30,151.61,,0,151.61,151.61,1,-136779,34994,171773,-101785,0,0,42737,0,0,,42737,42737
13,03/31/2017,39,9:30,9:45,59.02,,0,59.02,59.02,1,-106384,45042,151426,-61342,0,0,51974,0,0,,51974,51974
13,03/31/2017,40,9:45,10:00,,,0,30.21,30.21,0,-79639,41615,121254,-38024,0,0,8053,0,0,,8053,8053
13,03/31/2017,41,10:00,10:15,145.49,,0,145.49,145.49,1,-132168,35177,167345,-96991,0,0,25181,0,0,,25181,25181
13,03/31/2017,42,10:15,10:30,145.49,,0,145.49,145.49,1,-123884,38374,162258,-85510,0,0,79675,0,0,,79675,79675
13,03/31/2017,43,10:30,10:45,27.76,,0,27.76,27.76,1,-87545,40323,127868,-47222,0,0,22429,0,0,,22429,22429
13,03/31/2017,44,10:45,11:00,,,0,29.34,29.34,0,-93101,39610,132711,-53491,0,0,0,0,0,,0,0
13,03/31/2017,45,11:00,11:15,,,0,29.21,29.21,0,-95779,69636,165415,-26143,0,0,0,0,0,,0,0
13,03/31/2017,46,11:15,11:30,,,0,29.21,29.21,0,-101416,70460,171876,-30956,0,0,0,0,0,,0,0
13,03/31/2017,47,11:30,11:45,,,0,29.21,29.21,0,-94798,71907,166705,-22891,0,0,0,0,0,,0,0
13,03/31/2017,48,11:45,12:00,,28.6,0,28.6,28.6,-1,-109434,74724,184158,-34710,0,-1,0,0,0,,1,-1
13,03/31/2017,49,12:00,12:15,,28.6,0,28.6,28.6,-1,-109444,98200,207644,-11244,0,-345,0,0,0,,345,-345
13,03/31/2017,50,12:15,12:30,,27.5,0,27.5,27.5,-1,-107447,96432,203879,-11015,0,-1750,0,0,0,,1750,-1750
13,03/31/2017,51,12:30,12:45,,26.74,0,26.74,26.74,-1,-104636,113768,218404,9132,0,-2085,0,0,0,,2085,-2085
13,03/31/2017,52,12:45,13:00,,26.74,0,26.74,26.74,-1,-101477,106541,208018,5064,0,-6005,0,0,0,,6005,-6005
13,03/31/2017,53,13:00,13:15,48.74,29.6,0,48.74,29.13,2,-119617,65328,184945,-54289,0,-1326,6981,0,0,,8307,5655
13,03/31/2017,54,13:15,13:30,31.19,,0,31.19,31.19,1,-110162,51912,162074,-58250,0,0,3557,0,0,,3557,3557
13,03/31/2017,55,13:30,13:45,,,0,29.13,29.13,0,-90179,61010,151189,-29169,0,0,0,0,0,,0,0
13,03/31/2017,56,13:45,14:00,,,0,29.13,29.13,0,-102941,73785,176726,-29156,0,0,0,0,0,,0,0
13,03/31/2017,57,14:00,14:15,,17.1,0,17.1,17.1,-1,-32636,75239,107875,42603,0,-10180,0,0,0,,10180,-10180
13,03/31/2017,58,14:15,14:30,,13.13,0,13.13,13.13,-1,-31949,70380,102329,38431,0,-30447,0,0,0,,30447,-30447
13,03/31/2017,59,14:30,14:45,,8.09,0,8.09,8.09,-1,-36349,93876,130225,57527,0,-35293,0,0,0,,35293,-35293
13,03/31/2017,60,14:45,15:00,,8.09,0,8.09,8.09,-1,-69665,94831,164496,25166,0,-38769,0,0,0,,38769,-38769
13,03/31/2017,61,15:00,15:15,,24.6,0,24.6,24.6,-1,-55524,112656,168180,57132,0,-11440,0,0,0,,11440,-11440
13,03/31/2017,62,15:15,15:30,,24.6,0,24.6,24.6,-1,-41350,134930,176280,93580,0,-2915,0,0,0,,2915,-2915
13,03/31/2017,63,15:30,15:45,,29.6,0,29.6,29.6,-1,-36870,138623,175493,101753,0,-1144,0,0,0,,1144,-1144
13,03/31/2017,64,15:45,16:00,,19.31,0,19.31,19.31,-1,-41295,134754,176049,93459,0,-6653,0,0,0,,6653,-6653
13,03/31/2017,65,16:00,16:15,,7.64,0,7.64,7.64,-1,-30990,142946,173936,111956,0,-32947,0,0,0,,32947,-32947
13,03/31/2017,66,16:15,16:30,,26.46,0,26.46,26.46,-1,-37596,131126,168722,93530,0,-16174,0,0,0,,16174,-16174
13,03/31/2017,67,16:30,16:45,31.67,26.46,0,31.67,31.67,1,-65902,60849,126751,-5053,0,-641,2993,0,0,,3634,2352
13,03/31/2017,68,16:45,17:00,48.74,,0,48.74,48.74,1,-100721,63285,164006,-37436,0,0,23994,0,0,,23994,23994
13,03/31/2017,69,17:00,17:15,31.67,,0,31.67,31.67,1,-112124,58401,170525,-53723,0,0,7021,0,0,,7021,7021
13,03/31/2017,70,17:15,17:30,33.79,,0,33.79,33.79,1,-110531,63562,174093,-46969,0,0,2482,0,0,,2482,2482
13,03/31/2017,71,17:30,17:45,31.67,,0,31.67,31.67,1,-101661,91641,193302,-10020,0,0,1410,0,0,,1410,1410
13,03/31/2017,72,17:45,18:00,32.31,,0,32.31,32.31,1,-124893,97542,222435,-27351,0,0,10985,0,0,,10985,10985
13,03/31/2017,73,18:00,18:15,32.31,-11.99,0,-11.99,-11.99,-1,-26710,70618,97328,43908,0,-19299,1409,0,0,,20708,-17890
13,03/31/2017,74,18:15,18:30,,27.34,0,27.34,27.34,-1,-56063,41792,97855,-14271,0,-3405,0,0,0,,3405,-3405
13,03/31/2017,75,18:30,18:45,,28.6,0,28.6,28.6,-1,-36675,53406,90081,16731,0,-188,0,0,0,,188,-188
13,03/31/2017,76,18:45,19:00,,26.74,0,26.74,26.74,-1,-43029,70782,113811,27753,0,-2156,0,0,0,,2156,-2156
13,03/31/2017,77,19:00,19:15,,26.46,0,26.46,26.46,-1,-78837,69333,148170,-9504,0,-2374,0,0,0,,2374,-2374
13,03/31/2017,78,19:15,19:30,,,0,30.21,30.21,0,-86262,72113,158375,-14149,0,0,0,0,0,,0,0
13,03/31/2017,79,19:30,19:45,,24.6,0,24.6,24.6,-1,-33775,70112,103887,36337,0,-3695,0,0,0,,3695,-3695
13,03/31/2017,80,19:45,20:00,,29.74,0,29.74,29.74,-1,-21224,52364,73588,31140,0,-843,0,0,0,,843,-843
13,03/31/2017,81,20:00,20:15,,8.28,0,8.28,8.28,-1,-8437,132455,140892,124018,0,-11083,0,0,0,,11083,-11083
13,03/31/2017,82,20:15,20:30,32.31,8.18,0,32.31,32.31,1,-56714,70741,127455,14027,0,-15528,237,0,0,,15765,-15291
13,03/31/2017,83,20:30,20:45,34.96,8.18,0,34.96,34.96,1,-55877,71652,127529,15775,0,-107,2427,0,0,,2534,2320
13,03/31/2017,84,20:45,21:00,,20.74,0,20.74,20.74,-1,-55044,97259,152303,42215,0,-4584,0,0,0,,4584,-4584
13,03/31/2017,85,21:00,21:15,42.74,20.74,0,42.74,42.74,1,-97502,81627,179129,-15875,0,-7366,3780,0,0,,11146,-3586
13,03/31/2017,86,21:15,21:30,42.74,27.11,0,42.74,27.11,2,-75158,77213,152371,2055,0,-176,8979,0,0,,9155,8803
13,03/31/2017,87,21:30,21:45,42.74,24.6,0,24.6,24.6,-1,-53689,77484,131173,23795,0,-5012,44,0,0,,5056,-4968
13,03/31/2017,88,21:45,22:00,,13.25,0,13.25,13.25,-1,-46979,97455,144434,50476,0,-20454,0,0,0,,20454,-20454
13,03/31/2017,89,22:00,22:15,215.02,13.25,0,215.02,215.02,1,-70866,34240,105106,-36626,0,-7845,9203,0,0,,17048,1358
13,03/31/2017,90,22:15,22:30,215.02,25.55,0,25.55,25.55,-1,-47774,70566,118340,22792,0,-2756,1202,0,0,,3958,-1554
13,03/31/2017,91,22:30,22:45,,24.6,0,24.6,24.6,-1,-52689,71773,124462,19084,0,-8354,0,0,0,,8354,-8354
13,03/31/2017,92,22:45,23:00,,26.47,0,26.47,26.47,-1,-60863,73225,134088,12362,0,-361,0,0,0,,361,-361
13,03/31/2017,93,23:00,23:15,,20.03,0,20.03,20.03,-1,-49962,140180,190142,90218,0,-24518,0,0,0,,24518,-24518
13,03/31/2017,94,23:15,23:30,,24.6,0,24.6,24.6,-1,-52811,82345,135156,29534,0,-17197,0,0,0,,17197,-17197
13,03/31/2017,95,23:30,23:45,,29.6,0,29.6,29.6,-1,-74328,78851,153179,4523,0,-1223,0,0,0,,1223,-1223
13,03/31/2017,96,23:45,0:00,,24.6,0,24.6,24.6,-1,-75169,100039,175208,24870,0,-4496,0,0,0,,4496,-4496
14,04-01-17,1,0:00,0:15,248.8,24.29,0,248.8,24.29,2,-116946,41522,158468,-75424,0,-5166,9052,0,0,,14218,3886
14,04-01-17,2,0:15,0:30,34.9,,0,34.9,34.9,1,-83413,45661,129074,-37752,0,0,7612,0,0,,7612,7612
14,04-01-17,3,0:30,0:45,,,0,29.06,29.06,0,-88121,57260,145381,-30861,0,0,0,0,0,,0,0
14,04-01-17,4,0:45,1:00,,,0,29.17,29.17,0,-126959,67976,194935,-58983,0,0,0,0,0,,0,0
14,04-01-17,5,1:00,1:15,,27.26,0,27.26,27.26,-1,-56795,56890,113685,95,0,-1642,0,0,0,,1642,-1642
14,04-01-17,6,1:15,1:30,,,0,28.8,28.8,0,-60930,35315,96245,-25615,0,-6,0,0,0,,6,-6
14,04-01-17,7,1:30,1:45,,,0,28.8,28.8,0,-45733,25671,71404,-20062,0,0,0,0,0,,0,0
14,04-01-17,8,1:45,2:00,,,0,28.7,28.7,0,-48998,24236,73234,-24762,0,0,0,0,0,,0,0
14,04-01-17,9,2:00,2:15,41.1,,0,41.1,41.1,1,-53137,20280,73417,-32857,0,0,4210,0,0,,4210,4210
14,04-01-17,10,2:15,2:30,66.02,,0,66.02,66.02,1,-47712,8470,56182,-39242,0,0,27953,0,0,,27953,27953
14,04-01-17,11,2:30,2:45,29.1,,0,29.1,29.1,1,-33957,15335,49292,-18622,0,0,3359,0,0,,3359,3359
14,04-01-17,12,2:45,3:00,,,0,28.43,28.43,0,-34055,27489,61544,-6566,0,0,155,0,0,,155,155
14,04-01-17,13,3:00,3:15,29.1,,0,29.1,29.1,1,-53661,41300,94961,-12361,0,0,1721,0,0,,1721,1721
14,04-01-17,14,3:15,3:30,29.1,,0,29.1,29.1,1,-33860,30024,63884,-3836,0,0,1473,0,0,,1473,1473
14,04-01-17,15,3:30,3:45,,,0,28.43,28.43,0,-36464,35155,71619,-1309,0,0,0,0,0,,0,0
14,04-01-17,16,3:45,4:00,,29.1,0,29.1,29.1,-1,-32586,42726,75312,10140,0,-118,0,0,0,,118,-118
14,04-01-17,17,4:00,4:15,,28.1,0,28.1,28.1,-1,-29762,38731,68493,8969,0,-1557,0,0,0,,1557,-1557
14,04-01-17,18,4:15,4:30,,24.39,0,24.39,24.39,-1,-13737,42262,55999,28525,0,-7801,0,0,0,,7801,-7801
14,04-01-17,19,4:30,4:45,,24.39,0,24.39,24.39,-1,-25000,34450,59450,9450,0,-10093,0,0,0,,10093,-10093
14,04-01-17,20,4:45,5:00,,,0,28.43,28.43,0,-21758,32153,53911,10395,0,-447,0,0,0,,447,-447
14,04-01-17,21,5:00,5:15,,24.59,0,24.59,24.59,-1,-28474,48293,76767,19819,0,-4787,0,0,0,,4787,-4787
14,04-01-17,22,5:15,5:30,,24.1,0,24.1,24.1,-1,-33753,48201,81954,14448,0,-20579,0,0,0,,20579,-20579
14,04-01-17,23,5:30,5:45,29.1,24.1,0,29.1,29.1,1,-85992,47667,133659,-38325,0,-3769,398,0,0,,4167,-3371
14,04-01-17,24,5:45,6:00,29.1,,0,29.1,29.1,1,-107341,45843,153184,-61498,0,0,1341,0,0,,1341,1341
14,04-01-17,25,6:00,6:15,182.92,,0,182.92,182.92,1,-125317,86564,211881,-38753,0,0,13160,0,0,,13160,13160
14,04-01-17,26,6:15,6:30,207.53,,0,207.53,207.53,1,-85864,82719,168583,-3145,0,0,24750,0,0,,24750,24750
14,04-01-17,27,6:30,6:45,27.92,,0,27.92,27.92,1,-77741,72265,150006,-5476,0,0,549,0,0,,549,549
14,04-01-17,28,6:45,7:00,32.36,,0,32.36,32.36,1,-69136,70440,139576,1304,0,0,11064,0,0,,11064,11064
14,04-01-17,29,7:00,7:15,32.36,-21.13,0,-21.13,-21.13,-1,-51438,88692,140130,37254,0,-12743,3611,0,0,,16354,-9132
14,04-01-17,30,7:15,7:30,,26.99,0,26.99,26.99,-1,-52930,55475,108405,2545,0,-3554,0,0,0,,3554,-3554
14,04-01-17,31,7:30,7:45,,26.03,0,26.03,26.03,-1,-44384,62583,106967,18199,0,-8965,0,0,0,,8965,-8965
14,04-01-17,32,7:45,8:00,32.36,26.03,0,32.36,32.36,1,-59762,53923,113685,-5839,0,-816,3725,0,0,,4541,2909
14,04-01-17,33,8:00,8:15,32.36,-10.83,0,-10.83,-10.83,-1,-25611,125607,151218,99996,0,-22944,660,0,0,,23604,-22284
14,04-01-17,34,8:15,8:30,,21.18,0,21.18,21.18,-1,-28408,78156,106564,49748,0,-14287,0,0,0,,14287,-14287
14,04-01-17,35,8:30,8:45,,,0,28.45,28.45,0,-14574,71732,86306,57158,0,-45,0,0,0,,45,-45
14,04-01-17,36,8:45,9:00,,,0,28.46,28.46,0,-39426,48835,88261,9409,0,0,0,0,0,,0,0
14,04-01-17,37,9:00,9:15,,,0,28.7,28.7,0,-19982,77489,97471,57507,0,0,0,0,0,,0,0
14,04-01-17,38,9:15,9:30,,,0,28.76,28.76,0,-15055,51671,66726,36616,0,0,0,0,0,,0,0
14,04-01-17,39,9:30,9:45,,,0,28.81,28.81,0,-22456,36881,59337,14425,0,0,0,0,0,,0,0
14,04-01-17,40,9:45,10:00,,,0,28.91,28.91,0,-21241,33381,54622,12140,0,0,0,0,0,,0,0
14,04-01-17,41,10:00,10:15,261.06,,0,261.06,261.06,1,-116305,59366,175671,-56939,0,0,24100,0,0,,24100,24100
14,04-01-17,42,10:15,10:30,68.06,29,0,29,29,-1,-82627,89553,172180,6926,0,-11,28959,0,0,,28970,28948
14,04-01-17,43,10:30,10:45,30.8,27.59,0,30.8,27.59,2,-80359,85278,165637,4919,0,-267,226,0,0,,493,-41
14,04-01-17,44,10:45,11:00,54.22,,0,54.22,54.22,1,-103956,67776,171732,-36180,0,0,20334,0,0,,20334,20334
14,04-01-17,45,11:00,11:15,78.29,,0,78.29,78.29,1,-127796,70860,198656,-56936,0,0,41651,0,0,,41651,41651
14,04-01-17,46,11:15,11:30,47.76,,0,47.76,47.76,1,-122738,69479,192217,-53259,0,0,49124,0,0,,49124,49124
14,04-01-17,47,11:30,11:45,47.76,,0,47.76,47.76,1,-116728,64467,181195,-52261,0,0,46306,0,0,,46306,46306
14,04-01-17,48,11:45,12:00,245.22,,0,245.22,245.22,1,-119698,52749,172447,-66949,0,0,56602,0,0,,56602,56602
14,04-01-17,49,12:00,12:15,147.12,,0,147.12,147.12,1,-128788,66698,195486,-62090,0,0,68958,0,0,,68958,68958
14,04-01-17,50,12:15,12:30,37.84,,0,37.84,37.84,1,-103946,73436,177382,-30510,0,0,26160,0,0,,26160,26160
14,04-01-17,51,12:30,12:45,68.22,,0,68.22,68.22,1,-106854,67861,174715,-38993,0,0,20919,0,0,,20919,20919
14,04-01-17,52,12:45,13:00,37.84,,0,37.84,37.84,1,-100973,73889,174862,-27084,0,0,33762,0,0,,33762,33762
14,04-01-17,53,13:00,13:15,30.28,27.11,0,30.28,27.11,2,-86485,83884,170369,-2601,0,-71,11448,0,0,,11519,11377
14,04-01-17,54,13:15,13:30,42.14,,0,42.14,42.14,1,-85855,60145,146000,-25710,0,0,6702,0,0,,6702,6702
14,04-01-17,55,13:30,13:45,32.27,,0,32.27,32.27,1,-90366,57159,147525,-33207,0,0,16188,0,0,,16188,16188
14,04-01-17,56,13:45,14:00,42.14,,0,42.14,42.14,1,-96235,66414,162649,-29821,0,0,25856,0,0,,25856,25856
14,04-01-17,57,14:00,14:15,42.14,24.38,0,24.38,24.38,-1,-52344,84518,136862,32174,0,-2295,5764,0,0,,8059,3469
14,04-01-17,58,14:15,14:30,,28.42,0,28.42,28.42,-1,-48653,72813,121466,24160,0,-104,0,0,0,,104,-104
14,04-01-17,59,14:30,14:45,,28.42,0,28.42,28.42,-1,-51210,79843,131053,28633,0,-1995,0,0,0,,1995,-1995
14,04-01-17,60,14:45,15:00,,25.55,0,25.55,25.55,-1,-41647,42932,84579,1285,0,-883,0,0,0,,883,-883
14,04-01-17,61,15:00,15:15,,23.42,0,23.42,23.42,-1,-26650,92298,118948,65648,0,-16076,0,0,0,,16076,-16076
14,04-01-17,62,15:15,15:30,,3.9,0,3.9,3.9,-1,-40995,139116,180111,98121,0,-28195,0,0,0,,28195,-28195
14,04-01-17,63,15:30,15:45,,21.08,0,21.08,21.08,-1,-43166,129745,172911,86579,0,-37640,0,0,0,,37640,-37640
14,04-01-17,64,15:45,16:00,,24.69,0,24.69,24.69,-1,-44118,110443,154561,66325,0,-23907,0,0,0,,23907,-23907
14,04-01-17,65,16:00,16:15,,-60.56,0,-60.56,-60.56,-1,-35836,107261,143097,71425,0,-39938,0,0,0,,39938,-39938
14,04-01-17,66,16:15,16:30,,23.42,0,23.42,23.42,-1,-46543,70402,116945,23859,0,-25153,0,0,0,,25153,-25153
14,04-01-17,67,16:30,16:45,,22.63,0,22.63,22.63,-1,-42991,67421,110412,24430,0,-26899,0,0,0,,26899,-26899
14,04-01-17,68,16:45,17:00,30.35,22.63,0,30.35,30.35,1,-45558,22651,68209,-22907,0,-5855,1985,0,0,,7840,-3870
14,04-01-17,69,17:00,17:15,30.88,,0,30.88,30.88,1,-80472,49580,130052,-30892,0,0,5208,0,0,,5208,5208
14,04-01-17,70,17:15,17:30,93.02,,0,93.02,93.02,1,-81501,27209,108710,-54292,0,0,10091,0,0,,10091,10091
14,04-01-17,71,17:30,17:45,127.67,,0,127.67,127.67,1,-73450,21619,95069,-51831,0,0,51586,0,0,,51586,51586
14,04-01-17,72,17:45,18:00,30.42,27.42,0,30.42,27.42,2,-49366,54609,103975,5243,0,-173,11203,0,0,,11376,11030
14,04-01-17,73,18:00,18:15,53.02,,0,53.02,53.02,1,-75825,18789,94614,-57036,0,0,12774,0,0,,12774,12774
14,04-01-17,74,18:15,18:30,28.42,,0,28.42,28.42,1,-49396,30610,80006,-18786,0,0,3043,0,0,,3043,3043
14,04-01-17,75,18:30,18:45,29.63,,0,29.63,29.63,1,-44806,24938,69744,-19868,0,0,1304,0,0,,1304,1304
14,04-01-17,76,18:45,19:00,31.19,,0,31.19,31.19,1,-50568,25987,76555,-24581,0,0,6478,0,0,,6478,6478
14,04-01-17,77,19:00,19:15,31.19,27.42,0,27.42,27.42,-1,-38796,34684,73480,-4112,0,-802,391,0,0,,1193,-411
14,04-01-17,78,19:15,19:30,,27.42,0,27.42,27.42,-1,-34324,41728,76052,7404,0,-391,0,0,0,,391,-391
14,04-01-17,79,19:30,19:45,,27.03,0,27.03,27.03,-1,-36800,46283,83083,9483,0,-7694,0,0,0,,7694,-7694
14,04-01-17,80,19:45,20:00,33.07,27.03,0,33.07,33.07,1,-49139,29118,78257,-20021,0,-176,2677,0,0,,2853,2501
14,04-01-17,81,20:00,20:15,29.6,28.09,0,34.63,28.09,2,-61033,67160,128193,6127,0,-685,1946,0,0,,2631,1261
14,04-01-17,82,20:15,20:30,,,0,34.63,34.63,0,-91656,49228,140884,-42428,0,0,0,0,0,,0,0
14,04-01-17,83,20:30,20:45,,,0,34.63,34.63,0,-87275,57863,145138,-29412,0,0,0,0,0,,0,0
14,04-01-17,84,20:45,21:00,,,0,34.63,34.63,0,-83896,49337,133233,-34559,0,0,0,0,0,,0,0
14,04-01-17,85,21:00,21:15,34.42,,0,34.42,34.42,1,-39669,60683,100352,21014,0,0,5813,0,0,,5813,5813
14,04-01-17,86,21:15,21:30,,,0,34.48,34.48,0,-26671,57822,84493,31151,0,0,184,0,0,,184,184
14,04-01-17,87,21:30,21:45,,,0,34.48,34.48,0,-19247,82099,101346,62852,0,0,0,0,0,,0,0
14,04-01-17,88,21:45,22:00,,27.03,0,27.03,27.03,-1,-24293,112398,136691,88105,0,-584,0,0,0,,584,-584
14,04-01-17,89,22:00,22:15,,26.99,0,26.99,26.99,-1,-53709,32392,86101,-21317,0,-1525,0,0,0,,1525,-1525
14,04-01-17,90,22:15,22:30,,28.42,0,28.42,28.42,-1,-57130,47093,104223,-10037,0,-116,0,0,0,,116,-116
14,04-01-17,91,22:30,22:45,,28.42,0,28.42,28.42,-1,-49516,72446,121962,22930,0,-2137,0,0,0,,2137,-2137
14,04-01-17,92,22:45,23:00,,27.28,0,27.28,27.28,-1,-39457,101184,140641,61727,0,-2294,0,0,0,,2294,-2294
14,04-01-17,93,23:00,23:15,180.49,39.92,0,180.49,180.49,1,-122357,31028,153385,-91329,0,-1285,16087,0,0,,17372,14802
14,04-01-17,94,23:15,23:30,180.49,,0,180.49,180.49,1,-105227,47234,152461,-57993,0,0,31863,0,0,,31863,31863
14,04-01-17,95,23:30,23:45,180.49,28.42,0,28.42,28.42,-1,-57771,84371,142142,26600,0,-1382,3241,0,0,,4623,1859
14,04-01-17,96,23:45,0:00,,7.96,0,7.96,7.96,-1,-47316,95779,143095,48463,0,-5960,0,0,0,,5960,-5960
14,04-02-17,1,0:00,0:15,31.84,-200,0,31.84,-200,2,-45580,20730,66310,-24850,0,-15330,321,0,0,,15651,-15009
14,04-02-17,2,0:15,0:30,81.12,-200,0,81.12,81.12,1,-77506,7068,84574,-70438,0,-21,14673,0,0,,14694,14652
14,04-02-17,3,0:30,0:45,28.22,,0,28.22,28.22,1,-64962,16359,81321,-48603,0,0,2151,0,0,,2151,2151
14,04-02-17,4,0:45,1:00,33.92,,0,33.92,33.92,1,-119467,25026,144493,-94441,0,0,1325,0,0,,1325,1325
14,04-02-17,5,1:00,1:15,33.92,,0,33.92,33.92,1,-83880,18238,102118,-65642,0,0,2840,0,0,,2840,2840
14,04-02-17,6,1:15,1:30,27.92,,0,27.92,27.92,1,-89702,3123,92825,-86579,0,0,1144,0,0,,1144,1144
14,04-02-17,7,1:30,1:45,33.92,,0,33.92,33.92,1,-113128,9397,122525,-103731,0,0,5002,0,0,,5002,5002
14,04-02-17,8,1:45,2:00,27.92,,0,27.92,27.92,1,-97308,16801,114109,-80507,0,0,777,0,0,,777,777
14,04-02-17,9,2:00,2:15,39.92,,0,39.92,39.92,1,-42883,10468,53351,-32415,0,0,2254,0,0,,2254,2254
14,04-02-17,10,2:15,2:30,52.72,,0,52.72,52.72,1,-37614,12541,50155,-25073,0,0,16032,0,0,,16032,16032
14,04-02-17,11,2:30,2:45,52.72,26.78,0,26.78,26.78,-1,-21537,22937,44474,1400,0,-1799,879,0,0,,2678,-920
14,04-02-17,12,2:45,3:00,,22.89,0,22.89,22.89,-1,-26396,24929,51325,-1467,0,-8405,0,0,0,,8405,-8405
14,04-02-17,13,3:00,3:15,27.92,22.92,0,27.92,22.92,2,-23394,23690,47084,296,0,-4900,56,0,0,,4956,-4844
14,04-02-17,14,3:15,3:30,27.92,22.92,0,27.92,27.92,1,-32673,23062,55735,-9611,0,-53,753,0,0,,806,700
14,04-02-17,15,3:30,3:45,,27.92,0,27.92,27.92,-1,-28884,28500,57384,-384,0,-942,0,0,0,,942,-942
14,04-02-17,16,3:45,4:00,,22.92,0,22.92,22.92,-1,-30932,28673,59605,-2259,0,-3456,0,0,0,,3456,-3456
14,04-02-17,17,4:00,4:15,,22.92,0,22.92,22.92,-1,-19802,41479,61281,21677,0,-4067,0,0,0,,4067,-4067
14,04-02-17,18,4:15,4:30,,22.92,0,22.92,22.92,-1,-18525,29345,47870,10820,0,-1935,0,0,0,,1935,-1935
14,04-02-17,19,4:30,4:45,,22.24,0,22.24,22.24,-1,-16185,32031,48216,15846,0,-6010,0,0,0,,6010,-6010
14,04-02-17,20,4:45,5:00,,27.92,0,27.92,27.92,-1,-19449,27248,46697,7799,0,-1871,0,0,0,,1871,-1871
14,04-02-17,21,5:00,5:15,,,0,27.92,27.92,0,-36755,33638,70393,-3117,0,0,0,0,0,,0,0
14,04-02-17,22,5:15,5:30,,,0,27.92,27.92,0,-29345,30304,59649,959,0,0,0,0,0,,0,0
14,04-02-17,23,5:30,5:45,27.92,,0,27.92,27.92,1,-33185,28633,61818,-4552,0,0,1718,0,0,,1718,1718
14,04-02-17,24,5:45,6:00,30.12,,0,30.12,30.12,1,-30577,31970,62547,1393,0,0,4534,0,0,,4534,4534
14,04-02-17,25,6:00,6:15,30.12,28.09,0,28.09,28.09,-1,-21008,43071,64079,22063,0,-12,58,0,0,,70,46
14,04-02-17,26,6:15,6:30,,26.78,0,26.78,26.78,-1,-14533,30926,45459,16393,0,-1795,0,0,0,,1795,-1795
14,04-02-17,27,6:30,6:45,,,0,28.09,28.09,0,-25153,23043,48196,-2110,0,0,0,0,0,,0,0
14,04-02-17,28,6:45,7:00,28.09,,0,28.09,28.09,1,-26593,42343,68936,15750,0,0,8,0,0,,8,8
14,04-02-17,29,7:00,7:15,34.09,,0,34.09,34.09,1,-53843,15169,69012,-38674,0,0,4944,0,0,,4944,4944
14,04-02-17,30,7:15,7:30,28.09,,0,28.09,28.09,1,-33261,23323,56584,-9938,0,0,477,0,0,,477,477
14,04-02-17,31,7:30,7:45,40.09,,0,40.09,40.09,1,-52367,9387,61754,-42980,0,0,3033,0,0,,3033,3033
14,04-02-17,32,7:45,8:00,250,,0,250,250,1,-56413,21977,78390,-34436,0,0,33260,0,0,,33260,33260
14,04-02-17,33,8:00,8:15,30.09,18.59,0,18.59,18.59,-1,-23736,80311,104047,56575,0,-2827,5895,0,0,,8722,3068
14,04-02-17,34,8:15,8:30,,5.65,0,5.65,5.65,-1,-32042,41750,73792,9708,0,-12313,0,0,0,,12313,-12313
14,04-02-17,35,8:30,8:45,31.44,5.65,0,31.44,31.44,1,-41613,29212,70825,-12401,0,-170,898,0,0,,1068,728
14,04-02-17,36,8:45,9:00,40.09,,0,40.09,40.09,1,-49187,39030,88217,-10157,0,0,17954,0,0,,17954,17954
14,04-02-17,37,9:00,9:15,30.09,,0,30.09,30.09,1,-32658,26663,59321,-5995,0,0,8107,0,0,,8107,8107
14,04-02-17,38,9:15,9:30,34.09,,0,34.09,34.09,1,-34111,26202,60313,-7909,0,0,10427,0,0,,10427,10427
14,04-02-17,39,9:30,9:45,30.09,,0,30.09,30.09,1,-32290,33355,65645,1065,0,0,8223,0,0,,8223,8223
14,04-02-17,40,9:45,10:00,,,0,28.24,28.24,0,-37554,45896,83450,8342,0,0,85,0,0,,85,85
14,04-02-17,41,10:00,10:15,30.09,,0,30.09,30.09,1,-41387,32139,73526,-9248,0,0,1476,0,0,,1476,1476
14,04-02-17,42,10:15,10:30,28.15,,0,28.15,28.15,1,-32938,30338,63276,-2600,0,0,606,0,0,,606,606
14,04-02-17,43,10:30,10:45,28.15,,0,28.15,28.15,1,-17853,33203,51056,15350,0,0,440,0,0,,440,440
14,04-02-17,44,10:45,11:00,,22.69,0,22.69,22.69,-1,-13417,43515,56932,30098,0,-4423,0,0,0,,4423,-4423
14,04-02-17,45,11:00,11:15,,22.59,0,22.59,22.59,-1,-29476,46648,76124,17172,0,-10185,0,0,0,,10185,-10185
14,04-02-17,46,11:15,11:30,,,0,34.08,34.08,0,-23238,42862,66100,19624,0,-746,0,0,0,,746,-746
14,04-02-17,47,11:30,11:45,,21.94,0,21.94,21.94,-1,-24443,52045,76488,27602,0,-14560,0,0,0,,14560,-14560
14,04-02-17,48,11:45,12:00,,25.55,0,25.55,25.55,-1,-24316,35854,60170,11538,0,-12933,0,0,0,,12933,-12933
14,04-02-17,49,12:00,12:15,,27.39,0,27.39,27.39,-1,-52224,51405,103629,-819,0,-3110,0,0,0,,3110,-3110
14,04-02-17,50,12:15,12:30,,27.39,0,27.39,27.39,-1,-51282,54382,105664,3100,0,-1380,0,0,0,,1380,-1380
14,04-02-17,51,12:30,12:45,,,0,34.12,34.12,0,-42853,63127,105980,20274,0,0,0,0,0,,0,0
14,04-02-17,52,12:45,13:00,,24.59,0,24.59,24.59,-1,-51658,56441,108099,4783,0,-5591,0,0,0,,5591,-5591
14,04-02-17,53,13:00,13:15,30.09,24.59,0,30.09,30.09,1,-44640,52135,96775,7495,0,-159,1016,0,0,,1175,857
14,04-02-17,54,13:15,13:30,32.79,25.55,0,34.12,25.55,2,-42979,51030,94009,8051,0,-352,7394,0,0,,7746,7042
14,04-02-17,55,13:30,13:45,27.76,23.49,0,34.12,23.49,2,-41875,59543,101418,17668,0,-8337,15,0,0,,8352,-8322
14,04-02-17,56,13:45,14:00,28.39,23.49,0,28.39,28.39,1,-58869,51345,110214,-7524,0,-44,649,0,0,,693,605
14,04-02-17,57,14:00,14:15,35.54,,0,35.54,35.54,1,-56663,38543,95206,-18120,0,0,11550,0,0,,11550,11550
14,04-02-17,58,14:15,14:30,30.44,,0,30.44,30.44,1,-42531,41994,84525,-537,0,0,11218,0,0,,11218,11218
14,04-02-17,59,14:30,14:45,30.44,40.51,0,40.51,40.51,-1,-30064,57022,87086,26958,0,-70,154,0,0,,224,84
14,04-02-17,60,14:45,15:00,,28.59,0,28.59,28.59,-1,-33498,81947,115445,48449,0,-1495,0,0,0,,1495,-1495
14,04-02-17,61,15:00,15:15,,40.52,0,40.52,40.52,-1,-15412,73830,89242,58418,0,-302,0,0,0,,302,-302
14,04-02-17,62,15:15,15:30,,,0,34.14,34.14,0,-17330,74150,91480,56820,0,0,0,0,0,,0,0
14,04-02-17,63,15:30,15:45,,,0,34.14,34.14,0,-27565,73044,100609,45479,0,0,0,0,0,,0,0
14,04-02-17,64,15:45,16:00,,27.59,0,27.59,27.59,-1,-25206,74045,99251,48839,0,-402,0,0,0,,402,-402
14,04-02-17,65,16:00,16:15,,-189.81,0,-189.81,-189.81,-1,-18946,137596,156542,118650,0,-22935,0,0,0,,22935,-22935
14,04-02-17,66,16:15,16:30,,26.46,0,26.46,26.46,-1,-47235,79746,126981,32511,0,-9471,0,0,0,,9471,-9471
14,04-02-17,67,16:30,16:45,28.39,26.46,0,28.39,28.39,1,-46403,53642,100045,7239,0,-8,83,0,0,,91,75
14,04-02-17,68,16:45,17:00,29.71,,0,29.71,29.71,1,-51195,32053,83248,-19142,0,0,1795,0,0,,1795,1795
14,04-02-17,69,17:00,17:15,,,0,34.14,34.14,0,-32692,83071,115763,50379,0,0,0,0,0,,0,0
14,04-02-17,70,17:15,17:30,,,0,34.14,34.14,0,-26381,51342,77723,24961,0,0,0,0,0,,0,0
14,04-02-17,71,17:30,17:45,,,0,34.14,34.14,0,-37230,40257,77487,3027,0,0,0,0,0,,0,0
14,04-02-17,72,17:45,18:00,32.95,,0,32.95,32.95,1,-61604,52887,114491,-8717,0,0,4263,0,0,,4263,4263
14,04-02-17,73,18:00,18:15,30.88,,0,30.88,30.88,1,-79915,37370,117285,-42545,0,0,2446,0,0,,2446,2446
14,04-02-17,74,18:15,18:30,,,0,34.13,34.13,0,-29441,39680,69121,10239,0,0,0,0,0,,0,0
14,04-02-17,75,18:30,18:45,,,0,34.13,34.13,0,-35861,40197,76058,4336,0,0,0,0,0,,0,0
14,04-02-17,76,18:45,19:00,28.59,,0,28.59,28.59,1,-33049,52227,85276,19178,0,0,598,0,0,,598,598
14,04-02-17,77,19:00,19:15,28.15,,0,28.15,28.15,1,-42412,43382,85794,970,0,0,422,0,0,,422,422
14,04-02-17,78,19:15,19:30,,40.45,0,40.45,40.45,-1,-39517,48026,87543,8509,0,-237,0,0,0,,237,-237
14,04-02-17,79,19:30,19:45,,40.45,0,40.45,40.45,-1,-32760,34391,67151,1631,0,-223,0,0,0,,223,-223
14,04-02-17,80,19:45,20:00,,40.45,0,40.45,40.45,-1,-46470,28787,75257,-17683,0,-226,0,0,0,,226,-226
14,04-02-17,81,20:00,20:15,,23.59,0,23.59,23.59,-1,-16568,99865,116433,83297,0,-2776,0,0,0,,2776,-2776
14,04-02-17,82,20:15,20:30,,28.59,0,28.59,28.59,-1,-26553,60856,87409,34303,0,-95,0,0,0,,95,-95
14,04-02-17,83,20:30,20:45,28.15,28.59,0,34.11,28.59,2,-50968,40972,91940,-9996,0,-1469,56,0,0,,1525,-1413
14,04-02-17,84,20:45,21:00,30.59,,0,30.59,30.59,1,-45857,34727,80584,-11130,0,0,776,0,0,,776,776
14,04-02-17,85,21:00,21:15,114.29,,0,114.29,114.29,1,-66148,21669,87817,-44479,0,0,14226,0,0,,14226,14226
14,04-02-17,86,21:15,21:30,55.53,,0,55.53,55.53,1,-60722,26481,87203,-34241,0,0,35658,0,0,,35658,35658
14,04-02-17,87,21:30,21:45,30.59,27.59,0,34.08,27.59,2,-46552,40698,87250,-5854,0,-635,10802,0,0,,11437,10167
14,04-02-17,88,21:45,22:00,44.53,,0,44.53,44.53,1,-59620,33136,92756,-26484,0,0,8965,0,0,,8965,8965
14,04-02-17,89,22:00,22:15,85.22,,0,85.22,85.22,1,-76825,28184,105009,-48641,0,0,34970,0,0,,34970,34970
14,04-02-17,90,22:15,22:30,47,,0,47,47,1,-59450,31800,91250,-27650,0,0,41607,0,0,,41607,41607
14,04-02-17,91,22:30,22:45,47,34.65,0,34.65,34.65,-1,-39311,28140,67451,-11171,0,-656,8952,0,0,,9608,8296
14,04-02-17,92,22:45,23:00,30.59,,0,30.59,30.59,1,-37111,35811,72922,-1300,0,0,1142,0,0,,1142,1142
14,04-02-17,93,23:00,23:15,84.22,,0,84.22,84.22,1,-86086,33946,120032,-52140,0,0,16472,0,0,,16472,16472
14,04-02-17,94,23:15,23:30,35.22,,0,35.22,35.22,1,-57008,33575,90583,-23433,0,0,24676,0,0,,24676,24676
14,04-02-17,95,23:30,23:45,29.9,,0,29.9,29.9,1,-28365,22432,50797,-5933,0,0,8519,0,0,,8519,8519
14,04-02-17,96,23:45,0:00,,,0,34.04,34.04,0,-23738,30044,53782,6306,0,0,19,0,0,,19,19
14,04-03-17,1,0:00,0:15,,,0,28.43,28.43,0,-40468,35510,75978,-4958,0,0,0,0,0,,0,0
14,04-03-17,2,0:15,0:30,,,0,28.43,28.43,0,-33558,24284,57842,-9274,0,0,0,0,0,,0,0
14,04-03-17,3,0:30,0:45,28.8,,0,28.8,28.8,1,-27471,17343,44814,-10128,0,0,600,0,0,,600,600
14,04-03-17,4,0:45,1:00,,26.03,0,26.03,26.03,-1,-35502,39039,74541,3537,0,-2327,0,0,0,,2327,-2327
14,04-03-17,5,1:00,1:15,,25.67,0,25.67,25.67,-1,-32479,38442,70921,5963,0,-9104,0,0,0,,9104,-9104
14,04-03-17,6,1:15,1:30,,28.21,0,28.21,28.21,-1,-46668,26374,73042,-20294,0,-1872,0,0,0,,1872,-1872
14,04-03-17,7,1:30,1:45,,,0,27.68,27.68,0,-40127,27615,67742,-12512,0,-90,0,0,0,,90,-90
14,04-03-17,8,1:45,2:00,,28.21,0,28.21,28.21,-1,-37266,32809,70075,-4457,0,-480,0,0,0,,480,-480
14,04-03-17,9,2:00,2:15,32.64,27.89,0,32.64,27.7,2,-42893,26800,69693,-16093,0,-429,1377,0,0,,1806,948
14,04-03-17,10,2:15,2:30,32.67,,0,32.67,32.67,1,-40584,21674,62258,-18910,0,0,3074,0,0,,3074,3074
14,04-03-17,11,2:30,2:45,28.8,,0,28.8,28.8,1,-36112,16850,52962,-19262,0,0,2784,0,0,,2784,2784
14,04-03-17,12,2:45,3:00,26.67,,0,26.67,26.67,1,-39355,19624,58979,-19731,0,0,201,0,0,,201,201
14,04-03-17,13,3:00,3:15,32.74,,0,32.74,32.74,1,-51901,21548,73449,-30353,0,0,6364,0,0,,6364,6364
14,04-03-17,14,3:15,3:30,26.67,,0,26.67,26.67,1,-44964,22570,67534,-22394,0,0,1340,0,0,,1340,1340
14,04-03-17,15,3:30,3:45,,27.82,0,27.82,27.82,-1,-29928,43601,73529,13673,0,-83,0,0,0,,83,-83
14,04-03-17,16,3:45,4:00,,26.67,0,26.67,26.67,-1,-29349,48954,78303,19605,0,-883,0,0,0,,883,-883
14,04-03-17,17,4:00,4:15,,26.19,0,26.19,26.19,-1,-39329,31194,70523,-8135,0,-1153,0,0,0,,1153,-1153
14,04-03-17,18,4:15,4:30,,27.1,0,27.1,27.1,-1,-32369,34434,66803,2065,0,-2261,0,0,0,,2261,-2261
14,04-03-17,19,4:30,4:45,,28.01,0,28.01,28.01,-1,-36497,33537,70034,-2960,0,-2216,0,0,0,,2216,-2216
14,04-03-17,20,4:45,5:00,,26.67,0,26.67,26.67,-1,-40016,33128,73144,-6888,0,-931,0,0,0,,931,-931
14,04-03-17,21,5:00,5:15,,,0,27.95,27.95,0,-96926,58334,155260,-38592,0,-23,0,0,0,,23,-23
14,04-03-17,22,5:15,5:30,,29.22,0,29.22,29.22,-1,-45360,47801,93161,2441,0,-8,0,0,0,,8,-8
14,04-03-17,23,5:30,5:45,,26.29,0,26.29,26.29,-1,-36589,47857,84446,11268,0,-2812,0,0,0,,2812,-2812
14,04-03-17,24,5:45,6:00,,29.22,0,29.22,29.22,-1,-62620,75020,137640,12400,0,-62,0,0,0,,62,-62
14,04-03-17,25,6:00,6:15,,26.76,0,26.76,26.76,-1,-47476,48095,95571,619,0,-1708,0,0,0,,1708,-1708
14,04-03-17,26,6:15,6:30,28.15,26.76,0,28.15,28.15,1,-48097,54877,102974,6780,0,-19,261,0,0,,280,242
14,04-03-17,27,6:30,6:45,350.02,,0,350.02,350.02,1,-78091,30990,109081,-47101,0,0,20628,0,0,,20628,20628
14,04-03-17,28,6:45,7:00,350.02,,0,350.02,350.02,1,-91945,64925,156870,-27020,0,0,58623,0,0,,58623,58623
14,04-03-17,29,7:00,7:15,350.02,-31.9,0,-31.9,-31.9,-1,-25374,126753,152127,101379,0,-9205,7380,0,0,,16585,-1825
14,04-03-17,30,7:15,7:30,,26.34,0,26.34,26.34,-1,-26840,87547,114387,60707,0,-3776,0,0,0,,3776,-3776
14,04-03-17,31,7:30,7:45,,28.73,0,28.73,28.73,-1,-59144,44324,103468,-14820,0,-1007,0,0,0,,1007,-1007
14,04-03-17,32,7:45,8:00,28.8,,0,28.8,28.8,1,-119564,38451,158015,-81113,0,0,461,0,0,,461,461
14,04-03-17,33,8:00,8:15,28.15,,0,28.15,28.15,1,-80030,47383,127413,-32647,0,0,1050,0,0,,1050,1050
14,04-03-17,34,8:15,8:30,34.49,,0,34.49,34.49,1,-109402,29413,138815,-79989,0,0,760,0,0,,760,760
14,04-03-17,35,8:30,8:45,75.17,,0,75.17,75.17,1,-138704,24125,162829,-114579,0,0,28793,0,0,,28793,28793
14,04-03-17,36,8:45,9:00,60.02,,0,60.02,60.02,1,-149733,22769,172502,-126964,0,0,42693,0,0,,42693,42693
14,04-03-17,37,9:00,9:15,60.02,,0,60.02,60.02,1,-130244,35242,165486,-95002,0,0,22313,0,0,,22313,22313
14,04-03-17,38,9:15,9:30,306.13,,0,306.13,306.13,1,-155664,38700,194364,-116964,0,0,47577,0,0,,47577,47577
14,04-03-17,39,9:30,9:45,34.79,,0,34.79,34.79,1,-130258,38168,168426,-92090,0,0,17371,0,0,,17371,17371
14,04-03-17,40,9:45,10:00,239.74,,0,239.74,239.74,1,-165123,33961,199084,-131162,0,0,24248,0,0,,24248,24248
14,04-03-17,41,10:00,10:15,298.44,,0,298.44,298.44,1,-150668,44071,194739,-106597,0,0,72049,0,0,,72049,72049
14,04-03-17,42,10:15,10:30,75.02,,0,75.02,75.02,1,-128232,63563,191795,-64669,0,0,53623,0,0,,53623,53623
14,04-03-17,43,10:30,10:45,43.43,,0,43.43,43.43,1,-134587,66555,201142,-68032,0,0,31586,0,0,,31586,31586
14,04-03-17,44,10:45,11:00,43.43,,0,43.43,43.43,1,-140634,45108,185742,-95526,0,0,20355,0,0,,20355,20355
14,04-03-17,45,11:00,11:15,249.02,,0,249.02,249.02,1,-141581,56183,197764,-85398,0,0,52518,0,0,,52518,52518
14,04-03-17,46,11:15,11:30,57.45,,0,57.45,57.45,1,-119484,71731,191215,-47753,0,0,46957,0,0,,46957,46957
14,04-03-17,47,11:30,11:45,249.02,,0,249.02,249.02,1,-120858,41947,162805,-78911,0,0,42561,0,0,,42561,42561
14,04-03-17,48,11:45,12:00,249.02,,0,249.02,249.02,1,-108927,43261,152188,-65666,0,0,58771,0,0,,58771,58771
14,04-03-17,49,12:00,12:15,33.93,,0,33.93,33.93,1,-84084,53876,137960,-30208,0,0,33618,0,0,,33618,33618
14,04-03-17,50,12:15,12:30,29.71,27.17,0,27.17,27.17,-1,-77205,70570,147775,-6635,0,-254,14778,0,0,,15032,14524
14,04-03-17,51,12:30,12:45,29.71,25.76,0,25.76,25.76,-1,-67177,84000,151177,16823,0,-1842,326,0,0,,2168,-1516
14,04-03-17,52,12:45,13:00,,,0,28.53,28.53,0,-66673,61713,128386,-4960,0,0,0,0,0,,0,0
14,04-03-17,53,13:00,13:15,115.02,,0,115.02,115.02,1,-82152,44732,126884,-37420,0,0,16490,0,0,,16490,16490
14,04-03-17,54,13:15,13:30,32.76,,0,32.76,32.76,1,-69789,45204,114993,-24585,0,0,21588,0,0,,21588,21588
14,04-03-17,55,13:30,13:45,26.76,,0,26.76,26.76,1,-56814,54475,111289,-2339,0,0,4276,0,0,,4276,4276
14,04-03-17,56,13:45,14:00,,25.82,0,25.82,25.82,-1,-48826,64110,112936,15284,0,-5419,0,0,0,,5419,-5419
14,04-03-17,57,14:00,14:15,,25.76,0,25.76,25.76,-1,-55972,45185,101157,-10787,0,-7116,0,0,0,,7116,-7116
14,04-03-17,58,14:15,14:30,,-51.6,0,-51.6,-51.6,-1,-55089,56883,111972,1794,0,-24590,0,0,0,,24590,-24590
14,04-03-17,59,14:30,14:45,,27.11,0,27.11,27.11,-1,-60239,70490,130729,10251,0,-3207,0,0,0,,3207,-3207
14,04-03-17,60,14:45,15:00,,17.33,0,17.33,17.33,-1,-39742,78918,118660,39176,0,-21188,0,0,0,,21188,-21188
14,04-03-17,61,15:00,15:15,,17.33,0,17.33,17.33,-1,-31937,87088,119025,55151,0,-23434,0,0,0,,23434,-23434
14,04-03-17,62,15:15,15:30,,,0,28.48,28.48,0,-33411,89974,123385,56563,0,-329,0,0,0,,329,-329
14,04-03-17,63,15:30,15:45,,,0,29.38,29.38,0,-24411,96812,121223,72401,0,0,0,0,0,,0,0
14,04-03-17,64,15:45,16:00,,31.24,0,31.24,31.24,-1,-23966,92867,116833,68901,0,-70,0,0,0,,70,-70
14,04-03-17,65,16:00,16:15,,31.24,0,31.24,31.24,-1,-35864,75159,111023,39295,0,-660,0,0,0,,660,-660
14,04-03-17,66,16:15,16:30,,31.99,0,31.99,31.99,-1,-31300,90985,122285,59685,0,-433,0,0,0,,433,-433
14,04-03-17,67,16:30,16:45,,27.11,0,27.11,27.11,-1,-40781,84117,124898,43336,0,-565,0,0,0,,565,-565
14,04-03-17,68,16:45,17:00,,26.76,0,26.76,26.76,-1,-51087,79840,130927,28753,0,-2112,0,0,0,,2112,-2112
14,04-03-17,69,17:00,17:15,26.76,,0,26.76,26.76,1,-58789,63886,122675,5097,0,0,7,0,0,,7,7
14,04-03-17,70,17:15,17:30,30.88,,0,30.88,30.88,1,-71883,56703,128586,-15180,0,0,7016,0,0,,7016,7016
14,04-03-17,71,17:30,17:45,28.76,,0,28.76,28.76,1,-77431,70141,147572,-7290,0,0,6603,0,0,,6603,6603
14,04-03-17,72,17:45,18:00,28.76,,0,28.76,28.76,1,-73994,76245,150239,2251,0,0,2585,0,0,,2585,2585
14,04-03-17,73,18:00,18:15,28.8,,0,28.8,28.8,1,-105725,25192,130917,-80533,0,0,1991,0,0,,1991,1991
14,04-03-17,74,18:15,18:30,35.54,,0,35.54,35.54,1,-77270,30042,107312,-47228,0,0,1867,0,0,,1867,1867
14,04-03-17,75,18:30,18:45,35.64,,0,35.64,35.64,1,-62782,44285,107067,-18497,0,0,4589,0,0,,4589,4589
14,04-03-17,76,18:45,19:00,32.76,,0,32.76,32.76,1,-72511,48780,121291,-23731,0,0,12997,0,0,,12997,12997
14,04-03-17,77,19:00,19:15,31.78,,0,31.78,31.78,1,-86205,22958,109163,-63247,0,0,9389,0,0,,9389,9389
14,04-03-17,78,19:15,19:30,29.71,,0,29.71,29.71,1,-82126,22325,104451,-59801,0,0,346,0,0,,346,346
14,04-03-17,79,19:30,19:45,34.84,,0,34.84,34.84,1,-85693,26338,112031,-59355,0,0,4422,0,0,,4422,4422
14,04-03-17,80,19:45,20:00,36.78,,0,36.78,36.78,1,-90468,28086,118554,-62382,0,0,21771,0,0,,21771,21771
14,04-03-17,81,20:00,20:15,29.71,6.33,0,29.71,6.33,2,-26659,107049,133708,80390,0,-11206,9424,0,0,,20630,-1782
14,04-03-17,82,20:15,20:30,,25.76,0,25.76,25.76,-1,-49784,48423,98207,-1361,0,-5415,0,0,0,,5415,-5415
14,04-03-17,83,20:30,20:45,168.5,,0,168.5,168.5,1,-86373,14717,101090,-71656,0,0,13875,0,0,,13875,13875
14,04-03-17,84,20:45,21:00,168.5,,0,168.5,168.5,1,-64477,33273,97750,-31204,0,0,27113,0,0,,27113,27113
14,04-03-17,85,21:00,21:15,252.1,,0,252.1,252.1,1,-120476,44899,165375,-75577,0,0,26993,0,0,,26993,26993
14,04-03-17,86,21:15,21:30,40.84,,0,40.84,40.84,1,-91022,47865,138887,-43157,0,0,26351,0,0,,26351,26351
14,04-03-17,87,21:30,21:45,,,0,28.38,28.38,0,-62956,22746,85702,-40210,0,0,961,0,0,,961,961
14,04-03-17,88,21:45,22:00,,,0,28.33,28.33,0,-59697,36761,96458,-22936,0,0,0,0,0,,0,0
14,04-03-17,89,22:00,22:15,143.23,,0,143.23,143.23,1,-117221,18353,135574,-98868,0,0,22442,0,0,,22442,22442
14,04-03-17,90,22:15,22:30,233.54,,0,233.54,233.54,1,-57979,37994,95973,-19985,0,0,47027,0,0,,47027,47027
14,04-03-17,91,22:30,22:45,233.54,26.76,0,26.76,26.76,-1,-20499,68027,88526,47528,0,-375,580,0,0,,955,205
14,04-03-17,92,22:45,23:00,,17.33,0,17.33,17.33,-1,-14004,85596,99600,71592,0,-5055,0,0,0,,5055,-5055
14,04-03-17,93,23:00,23:15,217.52,17.33,0,217.52,217.52,1,-139637,30719,170356,-108918,0,-4776,20128,0,0,,24904,15352
14,04-03-17,94,23:15,23:30,217.52,,0,217.52,217.52,1,-77829,39644,117473,-38185,0,0,55936,0,0,,55936,55936
14,04-03-17,95,23:30,23:45,,,0,27.93,27.93,0,-40025,59956,99981,19931,0,0,2226,0,0,,2226,2226
14,04-03-17,96,23:45,0:00,,10.83,0,10.83,10.83,-1,-28758,75554,104312,46796,0,-14654,0,0,0,,14654,-14654
14,04-04-17,1,0:00,0:15,74.12,27.78,0,74.12,27.78,2,-78098,42451,120549,-35647,0,-5574,8041,0,0,,13615,2467
14,04-04-17,2,0:15,0:30,30.14,,0,30.14,30.14,1,-52745,41093,93838,-11652,0,0,6646,0,0,,6646,6646
14,04-04-17,3,0:30,0:45,,,0,28.7,28.7,0,-41346,30841,72187,-10505,0,0,0,0,0,,0,0
14,04-04-17,4,0:45,1:00,,27.78,0,27.78,27.78,-1,-44833,45736,90569,903,0,-1789,0,0,0,,1789,-1789
14,04-04-17,5,1:00,1:15,92.38,27.64,0,92.38,27.64,2,-79381,47846,127227,-31535,0,-1791,10016,0,0,,11807,8225
14,04-04-17,6,1:15,1:30,30.12,,0,30.12,30.12,1,-37258,38965,76223,1707,0,0,6249,0,0,,6249,6249
14,04-04-17,7,1:30,1:45,,28.5,0,28.5,28.5,-1,-38730,41263,79993,2533,0,-591,0,0,0,,591,-591
14,04-04-17,8,1:45,2:00,,25.76,0,25.76,25.76,-1,-35500,57235,92735,21735,0,-7300,0,0,0,,7300,-7300
14,04-04-17,9,2:00,2:15,30.14,25.67,0,30.14,30.14,1,-54118,49352,103470,-4766,0,-7221,1272,0,0,,8493,-5949
14,04-04-17,10,2:15,2:30,31.31,25.67,0,31.31,31.31,1,-46561,35830,82391,-10731,0,-8,6472,0,0,,6480,6464
14,04-04-17,11,2:30,2:45,,,0,27.77,27.77,0,-40897,32681,73578,-8216,0,0,1461,0,0,,1461,1461
14,04-04-17,12,2:45,3:00,,26.76,0,26.76,26.76,-1,-27489,39337,66826,11848,0,-867,0,0,0,,867,-867
14,04-04-17,13,3:00,3:15,28.19,26.76,0,28.19,28.19,1,-62920,48427,111347,-14493,0,-1135,431,0,0,,1566,-704
14,04-04-17,14,3:15,3:30,28.76,,0,28.76,28.76,1,-70916,35218,106134,-35698,0,0,2518,0,0,,2518,2518
14,04-04-17,15,3:30,3:45,,,0,27.77,27.77,0,-65827,35729,101556,-30098,0,0,0,0,0,,0,0
14,04-04-17,16,3:45,4:00,,,0,27.77,27.77,0,-64826,34618,99444,-30208,0,0,0,0,0,,0,0
14,04-04-17,17,4:00,4:15,26.76,,0,26.76,26.76,1,-62754,37593,100347,-25161,0,0,463,0,0,,463,463
14,04-04-17,18,4:15,4:30,28.19,,0,28.19,28.19,1,-54130,32646,86776,-21484,0,0,1788,0,0,,1788,1788
14,04-04-17,19,4:30,4:45,26.76,,0,26.76,26.76,1,-47379,38565,85944,-8814,0,0,791,0,0,,791,791
14,04-04-17,20,4:45,5:00,30.1,,0,30.1,30.1,1,-56305,36532,92837,-19773,0,0,2283,0,0,,2283,2283
14,04-04-17,21,5:00,5:15,30.12,,0,30.12,30.12,1,-41204,41675,82879,471,0,0,2598,0,0,,2598,2598
14,04-04-17,22,5:15,5:30,28.76,,0,28.76,28.76,1,-38309,28572,66881,-9737,0,0,164,0,0,,164,164
14,04-04-17,23,5:30,5:45,32.76,,0,32.76,32.76,1,-59613,25962,85575,-33651,0,0,4453,0,0,,4453,4453
14,04-04-17,24,5:45,6:00,44.39,,0,44.39,44.39,1,-81673,27075,108748,-54598,0,0,26698,0,0,,26698,26698
14,04-04-17,25,6:00,6:15,30.75,6.09,0,30.75,6.09,2,-5401,87949,93350,82548,0,-8445,9231,0,0,,17676,786
14,04-04-17,26,6:15,6:30,,27.78,0,27.78,27.78,-1,-11717,47412,59129,35695,0,-3181,0,0,0,,3181,-3181
14,04-04-17,27,6:30,6:45,,31.51,0,31.51,31.51,-1,-58552,53894,112446,-4658,0,-118,0,0,0,,118,-118
14,04-04-17,28,6:45,7:00,36.17,,0,36.17,36.17,1,-109033,72336,181369,-36697,0,0,4999,0,0,,4999,4999
14,04-04-17,29,7:00,7:15,36.17,-9.95,0,-9.95,-9.95,-1,-17396,79855,97251,62459,0,-13656,874,0,0,,14530,-12782
14,04-04-17,30,7:15,7:30,,24.81,0,24.81,24.81,-1,-24064,52226,76290,28162,0,-10544,0,0,0,,10544,-10544
14,04-04-17,31,7:30,7:45,37.01,30.94,0,37.01,37.01,1,-66228,43209,109437,-23019,0,-3218,2573,0,0,,5791,-645
14,04-04-17,32,7:45,8:00,57.01,,0,57.01,57.01,1,-99396,53067,152463,-46329,0,0,24788,0,0,,24788,24788
14,04-04-17,33,8:00,8:15,31,28.62,0,31,28.62,2,-37495,73881,111376,36386,0,-281,8707,0,0,,8988,8426
14,04-04-17,34,8:15,8:30,30.1,,0,30.1,30.1,1,-42493,42676,85169,183,0,0,117,0,0,,117,117
14,04-04-17,35,8:30,8:45,30.1,,0,30.1,30.1,1,-48127,41360,89487,-6767,0,0,747,0,0,,747,747
14,04-04-17,36,8:45,9:00,32.39,,0,32.39,32.39,1,-59784,54819,114603,-4965,0,0,135,0,0,,135,135
14,04-04-17,37,9:00,9:15,45.94,,0,45.94,45.94,1,-34213,58950,93163,24737,0,0,3603,0,0,,3603,3603
14,04-04-17,38,9:15,9:30,,,0,31.11,31.11,0,-25059,63347,88406,38288,0,0,0,0,0,,0,0
14,04-04-17,39,9:30,9:45,,26.86,0,26.86,26.86,-1,-21359,69435,90794,48076,0,-1641,0,0,0,,1641,-1641
14,04-04-17,40,9:45,10:00,,16.86,0,16.86,16.86,-1,-15094,70888,85982,55794,0,-30788,0,0,0,,30788,-30788
14,04-04-17,41,10:00,10:15,33.3,16.86,0,33.3,33.3,1,-49062,42023,91085,-7039,0,-9389,756,0,0,,10145,-8633
14,04-04-17,42,10:15,10:30,,25.86,0,25.86,25.86,-1,-31775,62782,94557,31007,0,-1786,0,0,0,,1786,-1786
14,04-04-17,43,10:30,10:45,,21.86,0,21.86,21.86,-1,-21822,54429,76251,32607,0,-10401,0,0,0,,10401,-10401
14,04-04-17,44,10:45,11:00,,21.86,0,21.86,21.86,-1,-19858,50988,70846,31130,0,-23714,0,0,0,,23714,-23714
14,04-04-17,45,11:00,11:15,30.75,27.78,0,30.75,30.75,1,-68143,49942,118085,-18201,0,-11164,520,0,0,,11684,-10644
14,04-04-17,46,11:15,11:30,,,0,31.04,31.04,0,-64184,55441,119625,-8743,0,-60,155,0,0,,215,95
14,04-04-17,47,11:30,11:45,,26.86,0,26.86,26.86,-1,-38756,62280,101036,23524,0,-3739,0,0,0,,3739,-3739
14,04-04-17,48,11:45,12:00,,25.98,0,25.98,25.98,-1,-33294,58236,91530,24942,0,-13161,0,0,0,,13161,-13161
14,04-04-17,49,12:00,12:15,29.71,25.98,0,29.71,29.71,1,-76095,48097,124192,-27998,0,-2503,833,0,0,,3336,-1670
14,04-04-17,50,12:15,12:30,,,0,30.5,30.5,0,-80033,52362,132395,-27671,0,0,0,0,0,,0,0
14,04-04-17,51,12:30,12:45,34.16,,0,34.16,34.16,1,-71505,49791,121296,-21714,0,0,5695,0,0,,5695,5695
14,04-04-17,52,12:45,13:00,29.16,,0,29.16,29.16,1,-78188,42869,121057,-35319,0,0,3580,0,0,,3580,3580
14,04-04-17,53,13:00,13:15,43.72,,0,43.72,43.72,1,-83287,45347,128634,-37940,0,0,10859,0,0,,10859,10859
14,04-04-17,54,13:15,13:30,35.46,,0,35.46,35.46,1,-92940,44773,137713,-48167,0,0,25869,0,0,,25869,25869
14,04-04-17,55,13:30,13:45,36.43,,0,36.43,36.43,1,-89896,42879,132775,-47017,0,0,14637,0,0,,14637,14637
14,04-04-17,56,13:45,14:00,31.66,,0,31.66,31.66,1,-92742,42002,134744,-50740,0,0,16425,0,0,,16425,16425
14,04-04-17,57,14:00,14:15,37.24,,0,37.24,37.24,1,-67357,42273,109630,-25084,0,0,6006,0,0,,6006,6006
14,04-04-17,58,14:15,14:30,37.25,,0,37.25,37.25,1,-67603,39129,106732,-28474,0,0,17235,0,0,,17235,17235
14,04-04-17,59,14:30,14:45,26.86,,0,26.86,26.86,1,-62656,32229,94885,-30427,0,0,6183,0,0,,6183,6183
14,04-04-17,60,14:45,15:00,,,0,29.42,29.42,0,-62038,33625,95663,-28413,0,0,0,0,0,,0,0
14,04-04-17,61,15:00,15:15,,,0,29.42,29.42,0,-36684,39687,76371,3003,0,0,0,0,0,,0,0
14,04-04-17,62,15:15,15:30,,,0,29.43,29.43,0,-38809,42678,81487,3869,0,0,0,0,0,,0,0
14,04-04-17,63,15:30,15:45,,,0,29.49,29.49,0,-43673,43192,86865,-481,0,0,0,0,0,,0,0
14,04-04-17,64,15:45,16:00,,,0,29.48,29.48,0,-57194,39586,96780,-17608,0,0,0,0,0,,0,0
14,04-04-17,65,16:00,16:15,26.86,,0,26.86,26.86,1,-53291,34721,88012,-18570,0,0,60,0,0,,60,60
14,04-04-17,66,16:15,16:30,29.71,,0,29.71,29.71,1,-49252,47531,96783,-1721,0,0,730,0,0,,730,730
14,04-04-17,67,16:30,16:45,,,0,29.55,29.55,0,-57539,53714,111253,-3825,0,0,0,0,0,,0,0
14,04-04-17,68,16:45,17:00,26.86,,0,26.86,26.86,1,-81756,48139,129895,-33617,0,0,161,0,0,,161,161
14,04-04-17,69,17:00,17:15,27.49,,0,27.49,27.49,1,-50609,42239,92848,-8370,0,0,96,0,0,,96,96
14,04-04-17,70,17:15,17:30,27.49,,0,27.49,27.49,1,-61456,36803,98259,-24653,0,0,225,0,0,,225,225
14,04-04-17,71,17:30,17:45,27.49,,0,27.49,27.49,1,-86060,49705,135765,-36355,0,0,1380,0,0,,1380,1380
14,04-04-17,72,17:45,18:00,28.86,,0,28.86,28.86,1,-92015,69185,161200,-22830,0,0,1097,0,0,,1097,1097
14,04-04-17,73,18:00,18:15,30.1,,0,30.1,30.1,1,-111135,41314,152449,-69821,0,0,1995,0,0,,1995,1995
14,04-04-17,74,18:15,18:30,37.13,,0,37.13,37.13,1,-82612,43840,126452,-38772,0,0,2866,0,0,,2866,2866
14,04-04-17,75,18:30,18:45,47.59,,0,47.59,47.59,1,-64580,61315,125895,-3265,0,0,4456,0,0,,4456,4456
14,04-04-17,76,18:45,19:00,,,0,30.7,30.7,0,-50894,62849,113743,11955,0,0,0,0,0,,0,0
14,04-04-17,77,19:00,19:15,,,0,30.72,30.72,0,-61771,52156,113927,-9615,0,0,0,0,0,,0,0
14,04-04-17,78,19:15,19:30,30.75,,0,30.75,30.75,1,-62209,57215,119424,-4994,0,0,1479,0,0,,1479,1479
14,04-04-17,79,19:30,19:45,30.75,,0,30.75,30.75,1,-46567,71951,118518,25384,0,0,2106,0,0,,2106,2106
14,04-04-17,80,19:45,20:00,28.86,,0,28.86,28.86,1,-52478,62559,115037,10081,0,0,92,0,0,,92,92
14,04-04-17,81,20:00,20:15,,-52.27,0,-52.27,-52.27,-1,-12765,132959,145724,120194,0,-37576,0,0,0,,37576,-37576
14,04-04-17,82,20:15,20:30,,21.86,0,21.86,21.86,-1,-45940,85326,131266,39386,0,-34895,0,0,0,,34895,-34895
14,04-04-17,83,20:30,20:45,35.17,26.86,0,35.17,35.17,1,-71197,43015,114212,-28182,0,-13574,783,0,0,,14357,-12791
14,04-04-17,84,20:45,21:00,35.97,26.86,0,35.97,35.97,1,-87622,45909,133531,-41713,0,-13,2287,0,0,,2300,2274
14,04-04-17,85,21:00,21:15,37.45,,0,37.45,37.45,1,-66994,38317,105311,-28677,0,0,6625,0,0,,6625,6625
14,04-04-17,86,21:15,21:30,30.75,,0,30.75,30.75,1,-57594,28260,85854,-29334,0,0,6004,0,0,,6004,6004
14,04-04-17,87,21:30,21:45,,,0,30.31,30.31,0,-38114,38167,76281,53,0,0,51,0,0,,51,51
14,04-04-17,88,21:45,22:00,,27.78,0,27.78,27.78,-1,-29054,63512,92566,34458,0,-376,0,0,0,,376,-376
14,04-04-17,89,22:00,22:15,28.91,27.78,0,30.06,27.78,2,-83937,24331,108268,-59606,0,-441,1230,0,0,,1671,789
14,04-04-17,90,22:15,22:30,28.86,,0,28.86,28.86,1,-54797,17060,71857,-37737,0,0,703,0,0,,703,703
14,04-04-17,91,22:30,22:45,,,0,29.84,29.84,0,-18837,30630,49467,11793,0,0,0,0,0,,0,0
14,04-04-17,92,22:45,23:00,,,0,29.72,29.72,0,-10636,69504,80140,58868,0,0,0,0,0,,0,0
14,04-04-17,93,23:00,23:15,32.83,,0,32.83,32.83,1,-68034,27933,95967,-40101,0,0,2817,0,0,,2817,2817
14,04-04-17,94,23:15,23:30,,,0,28.75,28.75,0,-46256,26078,72334,-20178,0,0,56,0,0,,56,56
14,04-04-17,95,23:30,23:45,,29.39,0,29.39,29.39,-1,-39269,35191,74460,-4078,0,-11,0,0,0,,11,-11
14,04-04-17,96,23:45,0:00,,17.53,0,17.53,17.53,-1,-37122,57852,94974,20730,0,-12711,0,0,0,,12711,-12711
14,04-05-17,1,0:00,0:15,130.02,26.06,0,130.02,26.06,2,-80227,27935,108162,-52292,0,-12621,4916,0,0,,17537,-7705
14,04-05-17,2,0:15,0:30,27.06,26.06,0,27.06,27.06,1,-40653,18989,59642,-21664,0,-74,2694,0,0,,2768,2620
14,04-05-17,3,0:30,0:45,22.86,28.2,0,28.2,28.2,-1,-24320,25161,49481,841,0,-89,418,0,0,,507,329
14,04-05-17,4,0:45,1:00,,26.06,0,26.06,26.06,-1,-32922,49407,82329,16485,0,-14185,0,0,0,,14185,-14185
14,04-05-17,5,1:00,1:15,129.35,26,0,129.35,26,2,-37062,18880,55942,-18182,0,-15298,3089,0,0,,18387,-12209
14,04-05-17,6,1:15,1:30,182.06,26.06,0,182.06,26.06,2,-16621,32717,49338,16096,0,-655,13298,0,0,,13953,12643
14,04-05-17,7,1:30,1:45,182.06,25.98,0,25.98,25.98,-1,-6826,68878,75704,62052,0,-2715,16,0,0,,2731,-2699
14,04-05-17,8,1:45,2:00,,6.78,0,6.78,6.78,-1,-6567,74999,81566,68432,0,-31778,0,0,0,,31778,-31778
14,04-05-17,9,2:00,2:15,33.06,6.03,0,33.06,33.06,1,-38988,34984,73972,-4004,0,-29792,1081,0,0,,30873,-28711
14,04-05-17,10,2:15,2:30,33.06,27.06,0,33.06,26.63,2,-13981,28763,42744,14782,0,-811,1992,0,0,,2803,1181
14,04-05-17,11,2:30,2:45,,26.8,0,26.8,26.8,-1,-19911,29747,49658,9836,0,-7795,0,0,0,,7795,-7795
14,04-05-17,12,2:45,3:00,,27.03,0,27.03,27.03,-1,-29845,52970,82815,23125,0,-11665,0,0,0,,11665,-11665
14,04-05-17,13,3:00,3:15,30.83,27.88,0,30.83,30.83,1,-41291,37708,78999,-3583,0,-6073,1797,0,0,,7870,-4276
14,04-05-17,14,3:15,3:30,30.83,,0,30.83,30.83,1,-39411,37929,77340,-1482,0,0,1588,0,0,,1588,1588
14,04-05-17,15,3:30,3:45,27.06,,0,27.06,27.06,1,-31650,26332,57982,-5318,0,0,1051,0,0,,1051,1051
14,04-05-17,16,3:45,4:00,27.06,,0,27.06,27.06,1,-34200,17663,51863,-16537,0,0,2590,0,0,,2590,2590
14,04-05-17,17,4:00,4:15,27.06,,0,27.06,27.06,1,-59797,16830,76627,-42967,0,0,2006,0,0,,2006,2006
14,04-05-17,18,4:15,4:30,,,0,26.65,26.65,0,-53486,15065,68551,-38421,0,0,186,0,0,,186,186
14,04-05-17,19,4:30,4:45,29.92,,0,29.92,29.92,1,-53483,21166,74649,-32317,0,0,719,0,0,,719,719
14,04-05-17,20,4:45,5:00,33.06,,0,33.06,33.06,1,-37912,21135,59047,-16777,0,0,9574,0,0,,9574,9574
14,04-05-17,21,5:00,5:15,,,0,26.63,26.63,0,-84844,24780,109624,-60064,0,0,1012,0,0,,1012,1012
14,04-05-17,22,5:15,5:30,33.06,,0,33.06,33.06,1,-79015,19693,98708,-59322,0,0,347,0,0,,347,347
14,04-05-17,23,5:30,5:45,211.01,,0,211.01,211.01,1,-91457,17169,108626,-74288,0,0,41990,0,0,,41990,41990
14,04-05-17,24,5:45,6:00,211.01,29.8,0,29.8,29.8,-1,-75545,92550,168095,17005,0,-47,27777,0,0,,27824,27730
14,04-05-17,25,6:00,6:15,,28.23,0,28.23,28.23,-1,-76481,70992,147473,-5489,0,-1268,0,0,0,,1268,-1268
14,04-05-17,26,6:15,6:30,,,0,29.55,29.55,0,-78170,65420,143590,-12750,0,-21,0,0,0,,21,-21
14,04-05-17,27,6:30,6:45,242.94,,0,242.94,242.94,1,-105678,58677,164355,-47001,0,0,10285,0,0,,10285,10285
14,04-05-17,28,6:45,7:00,242.94,,0,242.94,242.94,1,-116823,79506,196329,-37317,0,0,20490,0,0,,20490,20490
14,04-05-17,29,7:00,7:15,242.94,-28.58,0,-28.58,-28.58,-1,-18169,86671,104840,68502,0,-15539,3388,0,0,,18927,-12151
14,04-05-17,30,7:15,7:30,,29.63,0,29.63,29.63,-1,-22749,58621,81370,35872,0,-3046,0,0,0,,3046,-3046
14,04-05-17,31,7:30,7:45,,,0,30.91,30.91,0,-45177,60201,105378,15024,0,-13,0,0,0,,13,-13
14,04-05-17,32,7:45,8:00,,,0,31.45,31.45,0,-74705,78262,152967,3557,0,0,0,0,0,,0,0
14,04-05-17,33,8:00,8:15,,22.5,0,22.5,22.5,-1,-39225,87866,127091,48641,0,-9935,0,0,0,,9935,-9935
14,04-05-17,34,8:15,8:30,,29.04,0,29.04,29.04,-1,-34807,48663,83470,13856,0,-8769,0,0,0,,8769,-8769
14,04-05-17,35,8:30,8:45,,31.18,0,31.18,31.18,-1,-31453,31195,62648,-258,0,-3900,0,0,0,,3900,-3900
14,04-05-17,36,8:45,9:00,38.1,31.18,0,38.1,38.1,1,-63621,19157,82778,-44464,0,-13,218,0,0,,231,205
14,04-05-17,37,9:00,9:15,254.39,,0,254.39,254.39,1,-111407,37264,148671,-74143,0,0,40314,0,0,,40314,40314
14,04-05-17,38,9:15,9:30,28.88,27.58,0,27.58,27.58,-1,-66702,68722,135424,2020,0,-995,15712,0,0,,16707,14717
14,04-05-17,39,9:30,9:45,,25.5,0,25.5,25.5,-1,-46071,71443,117514,25372,0,-22038,0,0,0,,22038,-22038
14,04-05-17,40,9:45,10:00,,22.5,0,22.5,22.5,-1,-39598,71329,110927,31731,0,-39141,0,0,0,,39141,-39141
14,04-05-17,41,10:00,10:15,,26.67,0,26.67,26.67,-1,-35318,84465,119783,49147,0,-20648,0,0,0,,20648,-20648
14,04-05-17,42,10:15,10:30,,15.55,0,15.55,15.55,-1,-26634,98216,124850,71582,0,-30497,0,0,0,,30497,-30497
14,04-05-17,43,10:30,10:45,,22.5,0,22.5,22.5,-1,-25823,85023,110846,59200,0,-38562,0,0,0,,38562,-38562
14,04-05-17,44,10:45,11:00,,22.5,0,22.5,22.5,-1,-22596,78282,100878,55686,0,-43897,0,0,0,,43897,-43897
14,04-05-17,45,11:00,11:15,49.45,25.03,0,49.45,49.45,1,-65449,56898,122347,-8551,0,-21802,1227,0,0,,23029,-20575
14,04-05-17,46,11:15,11:30,55.95,,0,55.95,55.95,1,-64101,58809,122910,-5292,0,0,7024,0,0,,7024,7024
14,04-05-17,47,11:30,11:45,55.95,28.23,0,28.23,28.23,-1,-51746,68560,120306,16814,0,-1362,467,0,0,,1829,-895
14,04-05-17,48,11:45,12:00,,28.03,0,28.03,28.03,-1,-46589,66218,112807,19629,0,-4973,0,0,0,,4973,-4973
14,04-05-17,49,12:00,12:15,27.5,22.5,0,29.36,22.5,2,-64344,73541,137885,9197,0,-9110,67,0,0,,9177,-9043
14,04-05-17,50,12:15,12:30,29.5,27.98,0,29.5,27.98,2,-53840,65425,119265,11585,0,-721,797,0,0,,1518,76
14,04-05-17,51,12:30,12:45,,27.58,0,27.58,27.58,-1,-39446,48589,88035,9143,0,-1105,0,0,0,,1105,-1105
14,04-05-17,52,12:45,13:00,,,0,29.13,29.13,0,-43577,39698,83275,-3879,0,0,0,0,0,,0,0
14,04-05-17,53,13:00,13:15,67.02,,0,67.02,67.02,1,-132658,44829,177487,-87829,0,0,9338,0,0,,9338,9338
14,04-05-17,54,13:15,13:30,67.02,,0,67.02,67.02,1,-106096,57565,163661,-48531,0,0,12370,0,0,,12370,12370
14,04-05-17,55,13:30,13:45,,,0,28.86,28.86,0,-93434,60101,153535,-33333,0,0,0,0,0,,0,0
14,04-05-17,56,13:45,14:00,,,0,28.86,28.86,0,-95336,63341,158677,-31995,0,0,0,0,0,,0,0
14,04-05-17,57,14:00,14:15,232.66,,0,232.66,232.66,1,-99575,34312,133887,-65263,0,0,22137,0,0,,22137,22137
14,04-05-17,58,14:15,14:30,41,28.23,0,28.23,28.23,-1,-53496,51826,105322,-1670,0,-62,20323,0,0,,20385,20261
14,04-05-17,59,14:30,14:45,,27.5,0,27.5,27.5,-1,-37762,48119,85881,10357,0,-1055,0,0,0,,1055,-1055
14,04-05-17,60,14:45,15:00,,27.5,0,27.5,27.5,-1,-48271,49366,97637,1095,0,-2023,0,0,0,,2023,-2023
14,04-05-17,61,15:00,15:15,,28.23,0,28.23,28.23,-1,-56315,50791,107106,-5524,0,-1954,0,0,0,,1954,-1954
14,04-05-17,62,15:15,15:30,,30.21,0,30.21,30.21,-1,-62963,61040,124003,-1923,0,-1291,0,0,0,,1291,-1291
14,04-05-17,63,15:30,15:45,,,0,28.86,28.86,0,-57868,56166,114034,-1702,0,-71,0,0,0,,71,-71
14,04-05-17,64,15:45,16:00,,,0,28.86,28.86,0,-66308,65490,131798,-818,0,0,0,0,0,,0,0
14,04-05-17,65,16:00,16:15,27.5,,0,27.5,27.5,1,-69333,69972,139305,639,0,0,99,0,0,,99,99
14,04-05-17,66,16:15,16:30,27.5,,0,27.5,27.5,1,-62823,74144,136967,11321,0,0,526,0,0,,526,526
14,04-05-17,67,16:30,16:45,33.57,,0,33.57,33.57,1,-91260,72257,163517,-19003,0,0,3914,0,0,,3914,3914
14,04-05-17,68,16:45,17:00,33.57,,0,33.57,33.57,1,-121985,80595,202580,-41390,0,0,16324,0,0,,16324,16324
14,04-05-17,69,17:00,17:15,39.5,,0,39.5,39.5,1,-95591,31389,126980,-64202,0,0,18916,0,0,,18916,18916
14,04-05-17,70,17:15,17:30,39.5,,0,39.5,39.5,1,-88790,43993,132783,-44797,0,0,21115,0,0,,21115,21115
14,04-05-17,71,17:30,17:45,30.84,,0,30.84,30.84,1,-86840,68599,155439,-18241,0,0,11678,0,0,,11678,11678
14,04-05-17,72,17:45,18:00,31.49,,0,31.49,31.49,1,-89254,86048,175302,-3206,0,0,9440,0,0,,9440,9440
14,04-05-17,73,18:00,18:15,31.49,30.42,0,30.42,30.42,-1,-55091,59065,114156,3974,0,-176,642,0,0,,818,466
14,04-05-17,74,18:15,18:30,,27.58,0,27.58,27.58,-1,-37249,58072,95321,20823,0,-2902,0,0,0,,2902,-2902
14,04-05-17,75,18:30,18:45,,28.23,0,28.23,28.23,-1,-39439,67880,107319,28441,0,-1346,0,0,0,,1346,-1346
14,04-05-17,76,18:45,19:00,,,0,29.96,29.96,0,-40213,83894,124107,43681,0,0,0,0,0,,0,0
14,04-05-17,77,19:00,19:15,,,0,30.39,30.39,0,-58681,40857,99538,-17824,0,0,0,0,0,,0,0
14,04-05-17,78,19:15,19:30,,,0,30.29,30.29,0,-58202,54188,112390,-4014,0,0,0,0,0,,0,0
14,04-05-17,79,19:30,19:45,30.84,,0,30.84,30.84,1,-66954,50403,117357,-16551,0,0,2182,0,0,,2182,2182
14,04-05-17,80,19:45,20:00,31.49,,0,31.49,31.49,1,-64024,47153,111177,-16871,0,0,7612,0,0,,7612,7612
14,04-05-17,81,20:00,20:15,27.5,,0,27.5,27.5,1,-28115,100748,128863,72633,0,0,2372,0,0,,2372,2372
14,04-05-17,82,20:15,20:30,,30.34,0,30.34,30.34,-1,-37137,71005,108142,33868,0,-1099,0,0,0,,1099,-1099
14,04-05-17,83,20:30,20:45,60.02,30.34,0,60.02,60.02,1,-67878,28310,96188,-39568,0,-71,7328,0,0,,7399,7257
14,04-05-17,84,20:45,21:00,60.65,,0,60.65,60.65,1,-79704,45978,125682,-33726,0,0,19631,0,0,,19631,19631
14,04-05-17,85,21:00,21:15,244.41,,0,244.41,244.41,1,-96319,55385,151704,-40934,0,0,23803,0,0,,23803,23803
14,04-05-17,86,21:15,21:30,43.4,27.58,0,27.58,27.58,-1,-60283,65550,125833,5267,0,-122,27797,0,0,,27919,27675
14,04-05-17,87,21:30,21:45,43.4,22.5,0,22.5,22.5,-1,-34521,72375,106896,37854,0,-10308,1205,0,0,,11513,-9103
14,04-05-17,88,21:45,22:00,,-28.58,0,-28.58,-28.58,-1,-29890,88121,118011,58231,0,-20236,0,0,0,,20236,-20236
14,04-05-17,89,22:00,22:15,33.57,-28.58,0,33.57,33.57,1,-75128,68272,143400,-6856,0,-21010,1629,0,0,,22639,-19381
14,04-05-17,90,22:15,22:30,27.5,22.5,0,22.5,22.5,-1,-54258,75900,130158,21642,0,-2729,1212,0,0,,3941,-1517
14,04-05-17,91,22:30,22:45,,22.5,0,22.5,22.5,-1,-30971,79226,110197,48255,0,-7763,0,0,0,,7763,-7763
14,04-05-17,92,22:45,23:00,,6.78,0,6.78,6.78,-1,-31379,95582,126961,64203,0,-37811,0,0,0,,37811,-37811
14,04-05-17,93,23:00,23:15,129.38,6.78,0,129.38,129.38,1,-131222,46393,177615,-84829,0,-13926,13488,0,0,,27414,-438
14,04-05-17,94,23:15,23:30,129.38,,0,129.38,129.38,1,-73147,53620,126767,-19527,0,0,36772,0,0,,36772,36772
14,04-05-17,95,23:30,23:45,129.38,28.03,0,28.03,28.03,-1,-42057,48386,90443,6329,0,-1330,473,0,0,,1803,-857
14,04-05-17,96,23:45,0:00,27.5,28.03,0,27.5,27.5,1,-63641,41558,105199,-22083,0,-21,2,0,0,,23,-19
14,04-06-17,1,0:00,0:15,50.51,,0,50.51,50.51,1,-113296,68832,182128,-44464,0,0,18348,0,0,,18348,18348
14,04-06-17,2,0:15,0:30,100.86,,0,100.86,100.86,1,-95554,27957,123511,-67597,0,0,66272,0,0,,66272,66272
14,04-06-17,3,0:30,0:45,33.38,27.38,0,27.38,27.38,-1,-46294,35146,81440,-11148,0,-130,21124,0,0,,21254,20994
14,04-06-17,4,0:45,1:00,,25.9,0,25.9,25.9,-1,-36731,64895,101626,28164,0,-12191,0,0,0,,12191,-12191
14,04-06-17,5,1:00,1:15,,26.78,0,26.78,26.78,-1,-38005,46880,84885,8875,0,-9844,0,0,0,,9844,-9844
14,04-06-17,6,1:15,1:30,,26.38,0,26.38,26.38,-1,-30881,53323,84204,22442,0,-794,0,0,0,,794,-794
14,04-06-17,7,1:30,1:45,,18.1,0,18.1,18.1,-1,-27511,57476,84987,29965,0,-23575,0,0,0,,23575,-23575
14,04-06-17,8,1:45,2:00,,22.38,0,22.38,22.38,-1,-31376,89695,121071,58319,0,-31432,0,0,0,,31432,-31432
14,04-06-17,9,2:00,2:15,,22.38,0,22.38,22.38,-1,-29883,55127,85010,25244,0,-17666,0,0,0,,17666,-17666
14,04-06-17,10,2:15,2:30,,,0,28.7,28.7,0,-41285,70168,111453,28883,0,0,0,0,0,,0,0
14,04-06-17,11,2:30,2:45,,,0,28.7,28.7,0,-42537,75263,117800,32726,0,0,0,0,0,,0,0
14,04-06-17,12,2:45,3:00,,18.1,0,18.1,18.1,-1,-28240,70270,98510,42030,0,-2421,0,0,0,,2421,-2421
14,04-06-17,13,3:00,3:15,,20.37,0,20.37,20.37,-1,-18697,75242,93939,56545,0,-11896,0,0,0,,11896,-11896
14,04-06-17,14,3:15,3:30,,26.38,0,26.38,26.38,-1,-42003,60567,102570,18564,0,-14556,0,0,0,,14556,-14556
14,04-06-17,15,3:30,3:45,,27.68,0,27.68,27.68,-1,-34910,51497,86407,16587,0,-9657,0,0,0,,9657,-9657
14,04-06-17,16,3:45,4:00,,20.37,0,20.37,20.37,-1,-31516,59896,91412,28380,0,-21982,0,0,0,,21982,-21982
14,04-06-17,17,4:00,4:15,,17.38,0,17.38,17.38,-1,-28773,90369,119142,61596,0,-40982,0,0,0,,40982,-40982
14,04-06-17,18,4:15,4:30,,30.07,0,30.07,30.07,-1,-35660,67310,102970,31650,0,-8765,0,0,0,,8765,-8765
14,04-06-17,19,4:30,4:45,,26.09,0,26.09,26.09,-1,-24195,80889,105084,56694,0,-6758,0,0,0,,6758,-6758
14,04-06-17,20,4:45,5:00,,26.91,0,26.91,26.91,-1,-26412,74910,101322,48498,0,-10207,0,0,0,,10207,-10207
14,04-06-17,21,5:00,5:15,,-44.39,0,-44.39,-44.39,-1,-28520,98065,126585,69545,0,-28323,0,0,0,,28323,-28323
14,04-06-17,22,5:15,5:30,,25.54,0,25.54,25.54,-1,-29318,52469,81787,23151,0,-24329,0,0,0,,24329,-24329
14,04-06-17,23,5:30,5:45,29.38,25.54,0,29.38,29.38,1,-44769,47070,91839,2301,0,-5597,191,0,0,,5788,-5406
14,04-06-17,24,5:45,6:00,39.38,,0,39.38,39.38,1,-64045,73462,137507,9417,0,0,10632,0,0,,10632,10632
14,04-06-17,25,6:00,6:15,39.38,27.33,0,27.33,27.33,-1,-53856,89967,143823,36111,0,-1076,421,0,0,,1497,-655
14,04-06-17,26,6:15,6:30,,29.6,0,29.6,29.6,-1,-21578,80883,102461,59305,0,-302,0,0,0,,302,-302
14,04-06-17,27,6:30,6:45,29.33,30.7,0,29.33,29.33,1,-51511,79016,130527,27505,0,-303,32,0,0,,335,-271
14,04-06-17,28,6:45,7:00,164.5,,0,164.5,164.5,1,-81292,51601,132893,-29691,0,0,22126,0,0,,22126,22126
14,04-06-17,29,7:00,7:15,30.97,27.4,0,30.97,27.4,2,-32077,70247,102324,38170,0,-974,4839,0,0,,5813,3865
14,04-06-17,30,7:15,7:30,,,0,29.73,29.73,0,-32367,91941,124308,59574,0,0,0,0,0,,0,0
14,04-06-17,31,7:30,7:45,,,0,29.94,29.94,0,-58299,59152,117451,853,0,0,0,0,0,,0,0
14,04-06-17,32,7:45,8:00,35.97,,0,35.97,35.97,1,-109381,37270,146651,-72111,0,0,5337,0,0,,5337,5337
14,04-06-17,33,8:00,8:15,37.3,,0,37.3,37.3,1,-41702,54286,95988,12584,0,0,9381,0,0,,9381,9381
14,04-06-17,34,8:15,8:30,,,0,30.23,30.23,0,-47809,35694,83503,-12115,0,0,155,0,0,,155,155
14,04-06-17,35,8:30,8:45,37.3,,0,37.3,37.3,1,-53810,22788,76598,-31022,0,0,2990,0,0,,2990,2990
14,04-06-17,36,8:45,9:00,37.52,,0,37.52,37.52,1,-59022,27948,86970,-31074,0,0,17101,0,0,,17101,17101
14,04-06-17,37,9:00,9:15,31.5,,0,31.5,31.5,1,-61193,53978,115171,-7215,0,0,10159,0,0,,10159,10159
14,04-06-17,38,9:15,9:30,,,0,31.08,31.08,0,-47406,48280,95686,874,0,0,81,0,0,,81,81
14,04-06-17,39,9:30,9:45,,30.91,0,30.91,30.91,-1,-51338,40010,91348,-11328,0,-552,0,0,0,,552,-552
14,04-06-17,40,9:45,10:00,57.5,,0,57.5,57.5,1,-57891,22446,80337,-35445,0,0,3735,0,0,,3735,3735
14,04-06-17,41,10:00,10:15,57.2,,0,57.2,57.2,1,-66872,32803,99675,-34069,0,0,32356,0,0,,32356,32356
14,04-06-17,42,10:15,10:30,37.55,,0,37.55,37.55,1,-59948,32442,92390,-27506,0,0,20350,0,0,,20350,20350
14,04-06-17,43,10:30,10:45,46.2,,0,46.2,46.2,1,-76769,35527,112296,-41242,0,0,32832,0,0,,32832,32832
14,04-06-17,44,10:45,11:00,46.2,,0,46.2,46.2,1,-79852,35555,115407,-44297,0,0,42461,0,0,,42461,42461
14,04-06-17,45,11:00,11:15,76.12,,0,76.12,76.12,1,-104097,38771,142868,-65326,0,0,50100,0,0,,50100,50100
14,04-06-17,46,11:15,11:30,49.8,,0,49.8,49.8,1,-83758,44094,127852,-39664,0,0,44317,0,0,,44317,44317
14,04-06-17,47,11:30,11:45,49.8,,0,49.8,49.8,1,-87386,42227,129613,-45159,0,0,36570,0,0,,36570,36570
14,04-06-17,48,11:45,12:00,49.8,,0,49.8,49.8,1,-91602,39955,131557,-51647,0,0,40632,0,0,,40632,40632
14,04-06-17,49,12:00,12:15,60.12,,0,60.12,60.12,1,-111759,35282,147041,-76477,0,0,32583,0,0,,32583,32583
14,04-06-17,50,12:15,12:30,67.12,,0,67.12,67.12,1,-96103,35551,131654,-60552,0,0,36924,0,0,,36924,36924
14,04-06-17,51,12:30,12:45,29.33,,0,29.33,29.33,1,-90128,33697,123825,-56431,0,0,6833,0,0,,6833,6833
14,04-06-17,52,12:45,13:00,94.12,,0,94.12,94.12,1,-88808,23387,112195,-65421,0,0,14183,0,0,,14183,14183
14,04-06-17,53,13:00,13:15,37.5,,0,37.5,37.5,1,-90119,31350,121469,-58769,0,0,32135,0,0,,32135,32135
14,04-06-17,54,13:15,13:30,33.45,,0,33.45,33.45,1,-89401,30730,120131,-58671,0,0,27090,0,0,,27090,27090
14,04-06-17,55,13:30,13:45,33.33,,0,33.33,33.33,1,-77938,30414,108352,-47524,0,0,17827,0,0,,17827,17827
14,04-06-17,56,13:45,14:00,31.37,,0,31.37,31.37,1,-82643,31542,114185,-51101,0,0,9013,0,0,,9013,9013
14,04-06-17,57,14:00,14:15,94.12,,0,94.12,94.12,1,-89224,41434,130658,-47790,0,0,23032,0,0,,23032,23032
14,04-06-17,58,14:15,14:30,38.69,,0,38.69,38.69,1,-85305,52096,137401,-33209,0,0,27317,0,0,,27317,27317
14,04-06-17,59,14:30,14:45,,,0,30.38,30.38,0,-80252,59048,139300,-21204,0,0,2700,0,0,,2700,2700
14,04-06-17,60,14:45,15:00,,31.11,0,31.11,31.11,-1,-67091,61557,128648,-5534,0,-190,0,0,0,,190,-190
14,04-06-17,61,15:00,15:15,,27.46,0,27.46,27.46,-1,-46283,69157,115440,22874,0,-2934,0,0,0,,2934,-2934
14,04-06-17,62,15:15,15:30,,26.55,0,26.55,26.55,-1,-50106,66489,116595,16383,0,-12430,0,0,0,,12430,-12430
14,04-06-17,63,15:30,15:45,29.33,28.78,0,29.33,29.33,1,-67833,63246,131079,-4587,0,-6553,354,0,0,,6907,-6199
14,04-06-17,64,15:45,16:00,29.33,28.34,0,30.35,28.34,2,-68349,73447,141796,5098,0,-539,1154,0,0,,1693,615
14,04-06-17,65,16:00,16:15,,27.46,0,27.46,27.46,-1,-53734,52090,105824,-1644,0,-1727,0,0,0,,1727,-1727
14,04-06-17,66,16:15,16:30,,26.33,0,26.33,26.33,-1,-55117,71296,126413,16179,0,-11384,0,0,0,,11384,-11384
14,04-06-17,67,16:30,16:45,,30.2,0,30.2,30.2,-1,-54283,60931,115214,6648,0,-4140,0,0,0,,4140,-4140
14,04-06-17,68,16:45,17:00,,28.34,0,28.34,28.34,-1,-53380,65816,119196,12436,0,-4386,0,0,0,,4386,-4386
14,04-06-17,69,17:00,17:15,,28.11,0,28.11,28.11,-1,-27744,98897,126641,71153,0,-3242,0,0,0,,3242,-3242
14,04-06-17,70,17:15,17:30,,,0,29.81,29.81,0,-25966,66794,92760,40828,0,-290,0,0,0,,290,-290
14,04-06-17,71,17:30,17:45,,31.21,0,31.21,31.21,-1,-42192,61236,103428,19044,0,-196,0,0,0,,196,-196
14,04-06-17,72,17:45,18:00,,25.38,0,25.38,25.38,-1,-46064,78139,124203,32075,0,-5216,0,0,0,,5216,-5216
14,04-06-17,73,18:00,18:15,,32.32,0,32.32,32.32,-1,-84152,31801,115953,-52351,0,-1416,0,0,0,,1416,-1416
14,04-06-17,74,18:15,18:30,33.33,,0,33.33,33.33,1,-60849,32991,93840,-27858,0,0,1588,0,0,,1588,1588
14,04-06-17,75,18:30,18:45,33.33,,0,33.33,33.33,1,-56152,42025,98177,-14127,0,0,3128,0,0,,3128,3128
14,04-06-17,76,18:45,19:00,29.33,,0,29.33,29.33,1,-63511,47592,111103,-15919,0,0,2211,0,0,,2211,2211
14,04-06-17,77,19:00,19:15,29.33,,0,29.33,29.33,1,-64783,32058,96841,-32725,0,0,278,0,0,,278,278
14,04-06-17,78,19:15,19:30,29.33,,0,29.33,29.33,1,-51606,37207,88813,-14399,0,0,56,0,0,,56,56
14,04-06-17,79,19:30,19:45,,,0,31.21,31.21,0,-48880,38914,87794,-9966,0,0,0,0,0,,0,0
14,04-06-17,80,19:45,20:00,33.45,,0,33.45,33.45,1,-56919,34683,91602,-22236,0,0,2384,0,0,,2384,2384
14,04-06-17,81,20:00,20:15,33.45,26.33,0,26.33,26.33,-1,-23488,77467,100955,53979,0,-4105,417,0,0,,4522,-3688
14,04-06-17,82,20:15,20:30,30.87,33.23,0,30.87,30.87,1,-71652,54073,125725,-17579,0,-442,45,0,0,,487,-397
14,04-06-17,83,20:30,20:45,261.41,,0,261.41,261.41,1,-131645,50477,182122,-81168,0,0,31639,0,0,,31639,31639
14,04-06-17,84,20:45,21:00,261.41,,0,261.41,261.41,1,-152838,83298,236136,-69540,0,0,69890,13750,0,,83640,83640
14,04-06-17,85,21:00,21:15,261.41,27.33,0,27.33,27.33,-1,-113234,145430,258664,32196,0,-416,7598,0,0,,8014,7182
14,04-06-17,86,21:15,21:30,,,0,30.79,30.79,0,-102957,138486,241443,35529,0,0,0,0,0,,0,0
14,04-06-17,87,21:30,21:45,,,0,30.37,30.37,0,-78937,134826,213763,55889,0,0,0,0,0,,0,0
14,04-06-17,88,21:45,22:00,,22.33,0,22.33,22.33,-1,-67389,127252,194641,59863,0,-1432,0,0,0,,1432,-1432
14,04-06-17,89,22:00,22:15,244.41,18.1,0,244.41,18.1,2,-101400,60972,162372,-40428,0,-6601,9517,0,0,,16118,2916
14,04-06-17,90,22:15,22:30,244.41,15.86,0,15.86,15.86,-1,-55878,75638,131516,19760,0,-2634,16058,0,0,,18692,13424
14,04-06-17,91,22:30,22:45,,-1.78,0,-1.78,-1.78,-1,-35200,67755,102955,32555,0,-34736,0,0,0,,34736,-34736
14,04-06-17,92,22:45,23:00,,-28.7,0,-28.7,-28.7,-1,-27491,83734,111225,56243,0,-34237,0,0,0,,34237,-34237
14,04-06-17,93,23:00,23:15,182.33,18.1,0,182.33,182.33,1,-91700,21867,113567,-69833,0,-22767,6549,0,0,,29316,-16218
14,04-06-17,94,23:15,23:30,210.03,18.1,0,210.03,18.1,2,-56569,55138,111707,-1431,0,-420,32384,0,0,,32804,31964
14,04-06-17,95,23:30,23:45,210.03,-52.62,0,-52.62,-52.62,-1,-36005,77175,113180,41170,0,-31602,336,0,0,,31938,-31266
14,04-06-17,96,23:45,0:00,,18.1,0,18.1,18.1,-1,-51493,75574,127067,24081,0,-11497,0,0,0,,11497,-11497
14,04-07-17,1,0:00,0:15,206.71,22.35,0,206.71,206.71,1,-87578,45567,133145,-42011,0,-10989,5830,0,0,,16819,-5159
14,04-07-17,2,0:15,0:30,233.59,27.35,0,233.59,27.35,2,-53833,51571,105404,-2262,0,-230,23531,0,0,,23761,23301
14,04-07-17,3,0:30,0:45,233.59,18.18,0,18.18,18.18,-1,-29866,56858,86724,26992,0,-19370,380,0,0,,19750,-18990
14,04-07-17,4,0:45,1:00,,7.06,0,7.06,7.06,-1,-32334,74107,106441,41773,0,-25259,0,0,0,,25259,-25259
14,04-07-17,5,1:00,1:15,39.35,7.06,0,39.35,39.35,1,-51976,43467,95443,-8509,0,-17628,2295,0,0,,19923,-15333
14,04-07-17,6,1:15,1:30,44.02,30.5,0,44.02,28.93,2,-48516,50414,98930,1898,0,-5,6417,0,0,,6422,6412
14,04-07-17,7,1:30,1:45,,30.5,0,30.5,30.5,-1,-46539,52257,98796,5718,0,-243,0,0,0,,243,-243
14,04-07-17,8,1:45,2:00,,27.35,0,27.35,27.35,-1,-44643,59595,104238,14952,0,-4702,0,0,0,,4702,-4702
14,04-07-17,9,2:00,2:15,34.42,30.5,0,34.42,34.42,1,-65560,44259,109819,-21301,0,-1534,6652,0,0,,8186,5118
14,04-07-17,10,2:15,2:30,35.02,,0,35.02,35.02,1,-59569,45041,104610,-14528,0,0,14365,0,0,,14365,14365
14,04-07-17,11,2:30,2:45,35.02,30.11,0,30.11,30.11,-1,-60014,56361,116375,-3653,0,-416,202,0,0,,618,-214
14,04-07-17,12,2:45,3:00,,,0,28.93,28.93,0,-53788,69561,123349,15773,0,0,0,0,0,,0,0
14,04-07-17,13,3:00,3:15,27.35,,0,27.35,27.35,1,-49624,57944,107568,8320,0,0,3,0,0,,3,3
14,04-07-17,14,3:15,3:30,29.55,,0,29.55,29.55,1,-50781,48681,99462,-2100,0,0,1618,0,0,,1618,1618
14,04-07-17,15,3:30,3:45,,,0,28.93,28.93,0,-51084,54579,105663,3495,0,0,7,0,0,,7,7
14,04-07-17,16,3:45,4:00,31.8,,0,31.8,31.8,1,-54249,37813,92062,-16436,0,0,5283,0,0,,5283,5283
14,04-07-17,17,4:00,4:15,29.35,,0,29.35,29.35,1,-58466,50840,109306,-7626,0,0,4285,0,0,,4285,4285
14,04-07-17,18,4:15,4:30,32.71,,0,32.71,32.71,1,-61985,42818,104803,-19167,0,0,4125,0,0,,4125,4125
14,04-07-17,19,4:30,4:45,33.35,,0,33.35,33.35,1,-66154,37831,103985,-28323,0,0,15593,0,0,,15593,15593
14,04-07-17,20,4:45,5:00,34.74,,0,34.74,34.74,1,-75351,45211,120562,-30140,0,0,26423,0,0,,26423,26423
14,04-07-17,21,5:00,5:15,29.35,18.5,0,29.35,18.5,2,-61011,97368,158379,36357,0,-5868,10206,0,0,,16074,4338
14,04-07-17,22,5:15,5:30,,28.03,0,28.03,28.03,-1,-68612,88589,157201,19977,0,-6446,0,0,0,,6446,-6446
14,04-07-17,23,5:30,5:45,48.8,28.03,0,48.8,48.8,1,-75504,47813,123317,-27691,0,-826,6675,0,0,,7501,5849
14,04-07-17,24,5:45,6:00,159.19,,0,159.19,159.19,1,-77640,79024,156664,1384,0,0,33944,0,0,,33944,33944
14,04-07-17,25,6:00,6:15,159.19,-52.22,0,-52.22,-52.22,-1,-70564,129316,199880,58752,0,-15070,3196,0,0,,18266,-11874
14,04-07-17,26,6:15,6:30,,7.06,0,7.06,7.06,-1,-44688,96516,141204,51828,0,-18921,0,0,0,,18921,-18921
14,04-07-17,27,6:30,6:45,,26.43,0,26.43,26.43,-1,-52083,85161,137244,33078,0,-16231,0,0,0,,16231,-16231
14,04-07-17,28,6:45,7:00,,31.54,0,31.54,31.54,-1,-60653,103886,164539,43233,0,-5818,0,0,0,,5818,-5818
14,04-07-17,29,7:00,7:15,,25.43,0,25.43,25.43,-1,-81269,112058,193327,30789,0,-4965,0,0,0,,4965,-4965
14,04-07-17,30,7:15,7:30,,30.74,0,30.74,30.74,-1,-56274,77094,133368,20820,0,-173,0,0,0,,173,-173
14,04-07-17,31,7:30,7:45,45.97,,0,45.97,45.97,1,-63925,27290,91215,-36635,0,0,1018,0,0,,1018,1018
14,04-07-17,32,7:45,8:00,257,,0,257,257,1,-98720,24854,123574,-73866,0,0,44548,0,0,,44548,44548
14,04-07-17,33,8:00,8:15,257,25.43,0,25.43,25.43,-1,-43859,87890,131749,44031,0,-834,15598,0,0,,16432,14764
14,04-07-17,34,8:15,8:30,36.09,,0,36.09,36.09,1,-44201,37932,82133,-6269,0,0,335,0,0,,335,335
14,04-07-17,35,8:30,8:45,65.23,,0,65.23,65.23,1,-75006,38633,113639,-36373,0,0,23186,0,0,,23186,23186
14,04-07-17,36,8:45,9:00,60.89,,0,60.89,60.89,1,-98340,55611,153951,-42729,0,0,31648,0,0,,31648,31648
14,04-07-17,37,9:00,9:15,43.23,,0,43.23,43.23,1,-48793,54321,103114,5528,0,0,18634,0,0,,18634,18634
14,04-07-17,38,9:15,9:30,43.23,26.95,0,26.95,26.95,-1,-41242,60700,101942,19458,0,-2126,376,0,0,,2502,-1750
14,04-07-17,39,9:30,9:45,,25.43,0,25.43,25.43,-1,-43804,65118,108922,21314,0,-8113,0,0,0,,8113,-8113
14,04-07-17,40,9:45,10:00,,22.43,0,22.43,22.43,-1,-47804,68127,115931,20323,0,-9837,0,0,0,,9837,-9837
14,04-07-17,41,10:00,10:15,,22.43,0,22.43,22.43,-1,-36224,92981,129205,56757,0,-9407,0,0,0,,9407,-9407
14,04-07-17,42,10:15,10:30,,-8.54,0,-8.54,-8.54,-1,-41918,103623,145541,61705,0,-44965,0,0,0,,44965,-44965
14,04-07-17,43,10:30,10:45,,-8.54,0,-8.54,-8.54,-1,-39317,114346,153663,75029,0,-59076,0,0,0,,59076,-59076
14,04-07-17,44,10:45,11:00,,-8.54,0,-8.54,-8.54,-1,-32693,90067,122760,57374,0,-64661,0,0,0,,64661,-64661
14,04-07-17,45,11:00,11:15,33.88,22.88,0,33.88,33.88,1,-49852,49033,98885,-819,0,-22259,419,0,0,,22678,-21840
14,04-07-17,46,11:15,11:30,33.88,17.43,0,17.43,17.43,-1,-33011,66034,99045,33023,0,-9287,16,0,0,,9303,-9271
14,04-07-17,47,11:30,11:45,,17.43,0,17.43,17.43,-1,-40789,67744,108533,26955,0,-25553,0,0,0,,25553,-25553
14,04-07-17,48,11:45,12:00,,18.5,0,18.5,18.5,-1,-43492,91776,135268,48284,0,-21505,0,0,0,,21505,-21505
14,04-07-17,49,12:00,12:15,29.43,25.43,0,29.43,29.43,1,-63175,49775,112950,-13400,0,-14382,13,0,0,,14395,-14369
14,04-07-17,50,12:15,12:30,30.47,25.43,0,30.47,30.47,1,-76435,48961,125396,-27474,0,-268,1616,0,0,,1884,1348
14,04-07-17,51,12:30,12:45,30.47,27.86,0,27.86,27.86,-1,-60840,66139,126979,5299,0,-385,83,0,0,,468,-302
14,04-07-17,52,12:45,13:00,,26.43,0,26.43,26.43,-1,-77081,76740,153821,-341,0,-7131,0,0,0,,7131,-7131
14,04-07-17,53,13:00,13:15,33.88,26.43,0,33.88,33.88,1,-74963,46478,121441,-28485,0,-813,1814,0,0,,2627,1001
14,04-07-17,54,13:15,13:30,38.14,,0,38.14,38.14,1,-85941,36898,122839,-49043,0,0,4594,0,0,,4594,4594
14,04-07-17,55,13:30,13:45,31.15,,0,31.15,31.15,1,-82401,44286,126687,-38115,0,0,436,0,0,,436,436
14,04-07-17,56,13:45,14:00,,,0,31.58,31.58,0,-82121,42687,124808,-39434,0,0,0,0,0,,0,0
14,04-07-17,57,14:00,14:15,44.6,,0,44.6,44.6,1,-61919,40768,102687,-21151,0,0,9288,0,0,,9288,9288
14,04-07-17,58,14:15,14:30,39.64,,0,39.64,39.64,1,-64653,42429,107082,-22224,0,0,18530,0,0,,18530,18530
14,04-07-17,59,14:30,14:45,39.64,25.78,0,25.78,25.78,-1,-42788,48337,91125,5549,0,-3401,1665,0,0,,5066,-1736
14,04-07-17,60,14:45,15:00,,25.78,0,25.78,25.78,-1,-42944,49977,92921,7033,0,-10962,0,0,0,,10962,-10962
14,04-07-17,61,15:00,15:15,,25.43,0,25.43,25.43,-1,-35885,67682,103567,31797,0,-9991,0,0,0,,9991,-9991
14,04-07-17,62,15:15,15:30,,18.5,0,18.5,18.5,-1,-27483,66826,94309,39343,0,-7836,0,0,0,,7836,-7836
14,04-07-17,63,15:30,15:45,,26.43,0,26.43,26.43,-1,-47162,54759,101921,7597,0,-9416,0,0,0,,9416,-9416
14,04-07-17,64,15:45,16:00,,28.51,0,28.51,28.51,-1,-67481,53345,120826,-14136,0,-2757,0,0,0,,2757,-2757
14,04-07-17,65,16:00,16:15,,31.29,0,31.29,31.29,-1,-58838,57725,116563,-1113,0,-227,0,0,0,,227,-227
14,04-07-17,66,16:15,16:30,29.43,,0,29.43,29.43,1,-56869,50222,107091,-6647,0,0,850,0,0,,850,850
14,04-07-17,67,16:30,16:45,33.43,,0,33.43,33.43,1,-62370,45406,107776,-16964,0,0,2003,0,0,,2003,2003
14,04-07-17,68,16:45,17:00,33.43,,0,33.43,33.43,1,-70747,58432,129179,-12315,0,0,7763,0,0,,7763,7763
14,04-07-17,69,17:00,17:15,33.43,26.43,0,26.43,26.43,-1,-31992,56391,88383,24399,0,-2358,332,0,0,,2690,-2026
14,04-07-17,70,17:15,17:30,,33.29,0,33.29,33.29,-1,-38911,32175,71086,-6736,0,-2488,0,0,0,,2488,-2488
14,04-07-17,71,17:30,17:45,,,0,31.61,31.61,0,-39824,46178,86002,6354,0,-112,0,0,0,,112,-112
14,04-07-17,72,17:45,18:00,,28.97,0,28.97,28.97,-1,-37637,60394,98031,22757,0,-400,0,0,0,,400,-400
14,04-07-17,73,18:00,18:15,,,0,31.98,31.98,0,-71267,33666,104933,-37601,0,0,0,0,0,,0,0
14,04-07-17,74,18:15,18:30,30.12,,0,30.12,30.12,1,-63837,32794,96631,-31043,0,0,157,0,0,,157,157
14,04-07-17,75,18:30,18:45,30.12,,0,30.12,30.12,1,-45021,29658,74679,-15363,0,0,1565,0,0,,1565,1565
14,04-07-17,76,18:45,19:00,29.43,,0,29.43,29.43,1,-38830,49314,88144,10484,0,0,1851,0,0,,1851,1851
14,04-07-17,77,19:00,19:15,29.08,,0,29.08,29.08,1,-50806,34414,85220,-16392,0,0,354,0,0,,354,354
14,04-07-17,78,19:15,19:30,30.91,,0,30.91,30.91,1,-37220,29241,66461,-7979,0,0,1504,0,0,,1504,1504
14,04-07-17,79,19:30,19:45,30.91,,0,30.91,30.91,1,-33433,41001,74434,7568,0,0,859,0,0,,859,859
14,04-07-17,80,19:45,20:00,,31.54,0,31.54,31.54,-1,-42960,41625,84585,-1335,0,-278,0,0,0,,278,-278
14,04-07-17,81,20:00,20:15,,18.5,0,18.5,18.5,-1,-20358,83287,103645,62929,0,-16289,0,0,0,,16289,-16289
14,04-07-17,82,20:15,20:30,,27.03,0,27.03,27.03,-1,-25875,60860,86735,34985,0,-12521,0,0,0,,12521,-12521
14,04-07-17,83,20:30,20:45,,28.51,0,28.51,28.51,-1,-51858,53104,104962,1246,0,-3197,0,0,0,,3197,-3197
14,04-07-17,84,20:45,21:00,31.8,28.51,0,31.8,31.8,1,-75201,57703,132904,-17498,0,-13,1970,0,0,,1983,1957
14,04-07-17,85,21:00,21:15,45.31,,0,45.31,45.31,1,-65575,48485,114060,-17090,0,0,12980,0,0,,12980,12980
14,04-07-17,86,21:15,21:30,31.15,,0,31.15,31.15,1,-50286,45868,96154,-4418,0,0,9143,0,0,,9143,9143
14,04-07-17,87,21:30,21:45,,,0,30.41,30.41,0,-29656,46383,76039,16727,0,0,1230,0,0,,1230,1230
14,04-07-17,88,21:45,22:00,,18.5,0,18.5,18.5,-1,-21026,68576,89602,47550,0,-3611,0,0,0,,3611,-3611
14,04-07-17,89,22:00,22:15,255.48,12.03,0,255.48,12.03,2,-75345,31300,106645,-44045,0,-7551,10064,0,0,,17615,2513
14,04-07-17,90,22:15,22:30,255.48,27.86,0,255.48,27.86,2,-37547,47750,85297,10203,0,-202,26204,0,0,,26406,26002
14,04-07-17,91,22:30,22:45,255.48,25.43,0,25.43,25.43,-1,-18496,64677,83173,46181,0,-2355,7,0,0,,2362,-2348
14,04-07-17,92,22:45,23:00,,15.83,0,15.83,15.83,-1,-18833,78994,97827,60161,0,-7667,0,0,0,,7667,-7667
14,04-07-17,93,23:00,23:15,151.49,15.83,0,151.49,151.49,1,-68436,33751,102187,-34685,0,-8487,10153,0,0,,18640,1666
14,04-07-17,94,23:15,23:30,35.02,,0,35.02,35.02,1,-36877,33791,70668,-3086,0,0,12597,0,0,,12597,12597
14,04-07-17,95,23:30,23:45,35.02,30.5,0,30.5,30.5,-1,-33018,39421,72439,6403,0,-701,24,0,0,,725,-677
14,04-07-17,96,23:45,0:00,,27.03,0,27.03,27.03,-1,-46847,60724,107571,13877,0,-3164,0,0,0,,3164,-3164
15,04-08-17,1,0:00,0:15,,32.34,0,32.34,32.34,-1,-64437,46677,111114,-17760,0,-1333,0,0,0,,1333,-1333
15,04-08-17,2,0:15,0:30,27.33,,0,27.33,27.33,1,-76409,12926,89335,-63483,0,0,168,0,0,,168,168
15,04-08-17,3,0:30,0:45,27.33,,0,27.33,27.33,1,-68059,8708,76767,-59351,0,0,421,0,0,,421,421
15,04-08-17,4,0:45,1:00,27.33,,0,27.33,27.33,1,-87971,24510,112481,-63461,0,0,315,0,0,,315,315
15,04-08-17,5,1:00,1:15,220.66,,0,220.66,220.66,1,-72131,12340,84471,-59791,0,0,9547,0,0,,9547,9547
15,04-08-17,6,1:15,1:30,220.66,,0,220.66,220.66,1,-58188,31141,89329,-27047,0,0,20474,0,0,,20474,20474
15,04-08-17,7,1:30,1:45,27.33,,0,27.33,27.33,1,-33509,38533,72042,5024,0,0,1337,0,0,,1337,1337
15,04-08-17,8,1:45,2:00,,,0,28.92,28.92,0,-28686,56271,84957,27585,0,0,0,0,0,,0,0
15,04-08-17,9,2:00,2:15,31.15,,0,31.15,31.15,1,-41065,28406,69471,-12659,0,0,2017,0,0,,2017,2017
15,04-08-17,10,2:15,2:30,,,0,28.92,28.92,0,-23223,26635,49858,3412,0,0,279,0,0,,279,279
15,04-08-17,11,2:30,2:45,,29.03,0,29.03,29.03,-1,-21009,21419,42428,410,0,-1103,0,0,0,,1103,-1103
15,04-08-17,12,2:45,3:00,,22.33,0,22.33,22.33,-1,-21833,23156,44989,1323,0,-4463,0,0,0,,4463,-4463
15,04-08-17,13,3:00,3:15,39.33,17.33,0,39.33,17.33,2,-35977,38527,74504,2550,0,-14223,1564,0,0,,15787,-12659
15,04-08-17,14,3:15,3:30,106.01,17.33,0,106.01,106.01,1,-31261,24482,55743,-6779,0,-406,18188,0,0,,18594,17782
15,04-08-17,15,3:30,3:45,30.12,,0,30.12,30.12,1,-22985,20489,43474,-2496,0,0,1223,0,0,,1223,1223
15,04-08-17,16,3:45,4:00,30.76,,0,30.76,30.76,1,-27982,20238,48220,-7744,0,0,2123,0,0,,2123,2123
15,04-08-17,17,4:00,4:15,27.33,,0,27.33,27.33,1,-19630,22219,41849,2589,0,0,632,0,0,,632,632
15,04-08-17,18,4:15,4:30,33.33,,0,33.33,33.33,1,-44247,19190,63437,-25057,0,0,9513,0,0,,9513,9513
15,04-08-17,19,4:30,4:45,31.8,,0,31.8,31.8,1,-34295,13752,48047,-20543,0,0,14836,0,0,,14836,14836
15,04-08-17,20,4:45,5:00,29.22,,0,29.22,29.22,1,-23436,13176,36612,-10260,0,0,6152,0,0,,6152,6152
15,04-08-17,21,5:00,5:15,30.76,,0,30.76,30.76,1,-23677,14529,38206,-9148,0,0,4055,0,0,,4055,4055
15,04-08-17,22,5:15,5:30,27.33,,0,27.33,27.33,1,-24124,17321,41445,-6803,0,0,477,0,0,,477,477
15,04-08-17,23,5:30,5:45,31.8,,0,31.8,31.8,1,-30772,11320,42092,-19452,0,0,6789,0,0,,6789,6789
15,04-08-17,24,5:45,6:00,33.19,,0,33.19,33.19,1,-39904,16549,56453,-23355,0,0,10087,0,0,,10087,10087
15,04-08-17,25,6:00,6:15,26.67,,0,26.67,26.67,1,-12285,53138,65423,40853,0,0,3213,0,0,,3213,3213
15,04-08-17,26,6:15,6:30,,,0,28.48,28.48,0,-25982,36414,62396,10432,0,0,0,0,0,,0,0
15,04-08-17,27,6:30,6:45,28.67,,0,28.67,28.67,1,-49193,37421,86614,-11772,0,0,100,0,0,,100,100
15,04-08-17,28,6:45,7:00,28.67,,0,28.67,28.67,1,-52035,53775,105810,1740,0,0,2652,0,0,,2652,2652
15,04-08-17,29,7:00,7:15,27.91,,0,27.91,27.91,1,-14502,46248,60750,31746,0,0,905,0,0,,905,905
15,04-08-17,30,7:15,7:30,28.67,,0,28.67,28.67,1,-28834,21911,50745,-6923,0,0,2095,0,0,,2095,2095
15,04-08-17,31,7:30,7:45,32.91,,0,32.91,32.91,1,-46123,23351,69474,-22772,0,0,10219,0,0,,10219,10219
15,04-08-17,32,7:45,8:00,35.54,,0,35.54,35.54,1,-75383,25996,101379,-49387,0,0,18484,0,0,,18484,18484
15,04-08-17,33,8:00,8:15,30.53,25.67,0,30.53,25.67,2,-12753,43171,55924,30418,0,-2985,8159,0,0,,11144,5174
15,04-08-17,34,8:15,8:30,,28.69,0,28.69,28.69,-1,-29255,32641,61896,3386,0,-1561,0,0,0,,1561,-1561
15,04-08-17,35,8:30,8:45,29.43,29.39,0,29.43,29.43,1,-74592,34253,108845,-40339,0,-634,284,0,0,,918,-350
15,04-08-17,36,8:45,9:00,36.44,,0,36.44,36.44,1,-96711,31958,128669,-64753,0,0,11359,0,0,,11359,11359
15,04-08-17,37,9:00,9:15,30.53,,0,30.53,30.53,1,-46154,32909,79063,-13245,0,0,4178,0,0,,4178,4178
15,04-08-17,38,9:15,9:30,33.99,,0,33.99,33.99,1,-62859,31945,94804,-30914,0,0,1638,0,0,,1638,1638
15,04-08-17,39,9:30,9:45,44.99,,0,44.99,44.99,1,-69075,33899,102974,-35176,0,0,20242,0,0,,20242,20242
15,04-08-17,40,9:45,10:00,31.57,,0,31.57,31.57,1,-72432,54944,127376,-17488,0,0,11810,0,0,,11810,11810
15,04-08-17,41,10:00,10:15,43.6,,0,43.6,43.6,1,-70297,32618,102915,-37679,0,0,14119,0,0,,14119,14119
15,04-08-17,42,10:15,10:30,30.53,,0,30.53,30.53,1,-76231,36618,112849,-39613,0,0,7765,0,0,,7765,7765
15,04-08-17,43,10:30,10:45,27.6,,0,27.6,27.6,1,-68035,44096,112131,-23939,0,0,2296,0,0,,2296,2296
15,04-08-17,44,10:45,11:00,,21.67,0,21.67,21.67,-1,-51012,56795,107807,5783,0,-5350,0,0,0,,5350,-5350
15,04-08-17,45,11:00,11:15,,21.67,0,21.67,21.67,-1,-53160,64299,117459,11139,0,-20083,0,0,0,,20083,-20083
15,04-08-17,46,11:15,11:30,,29.09,0,29.09,29.09,-1,-48098,46415,94513,-1683,0,-2960,0,0,0,,2960,-2960
15,04-08-17,47,11:30,11:45,,28.34,0,28.34,28.34,-1,-46216,51999,98215,5783,0,-3334,0,0,0,,3334,-3334
15,04-08-17,48,11:45,12:00,,28.24,0,28.24,28.24,-1,-43386,42734,86120,-652,0,-3781,0,0,0,,3781,-3781
15,04-08-17,49,12:00,12:15,,28.19,0,28.19,28.19,-1,-57770,46311,104081,-11459,0,-2577,0,0,0,,2577,-2577
15,04-08-17,50,12:15,12:30,,26.67,0,26.67,26.67,-1,-48454,46855,95309,-1599,0,-1889,0,0,0,,1889,-1889
15,04-08-17,51,12:30,12:45,,25.67,0,25.67,25.67,-1,-30472,49830,80302,19358,0,-4388,0,0,0,,4388,-4388
15,04-08-17,52,12:45,13:00,,21.67,0,21.67,21.67,-1,-19229,52379,71608,33150,0,-11786,0,0,0,,11786,-11786
15,04-08-17,53,13:00,13:15,32.67,25.67,0,32.67,25.67,2,-34452,57495,91947,23043,0,-13194,1144,0,0,,14338,-12050
15,04-08-17,54,13:15,13:30,32.67,18.29,0,32.67,18.29,2,-20224,57828,78052,37604,0,-6025,1357,0,0,,7382,-4668
15,04-08-17,55,13:30,13:45,,18.29,0,18.29,18.29,-1,-17894,53896,71790,36002,0,-18465,0,0,0,,18465,-18465
15,04-08-17,56,13:45,14:00,,-8.75,0,-8.75,-8.75,-1,-18648,68981,87629,50333,0,-34861,0,0,0,,34861,-34861
15,04-08-17,57,14:00,14:15,,21.67,0,21.67,21.67,-1,-28078,90834,118912,62756,0,-20714,0,0,0,,20714,-20714
15,04-08-17,58,14:15,14:30,,,0,28.47,28.47,0,-19259,88869,108128,69610,0,-131,0,0,0,,131,-131
15,04-08-17,59,14:30,14:45,,,0,28.47,28.47,0,-18566,97402,115968,78836,0,0,0,0,0,,0,0
15,04-08-17,60,14:45,15:00,,-8.75,0,-8.75,-8.75,-1,-14921,112555,127476,97634,0,-26870,0,0,0,,26870,-26870
15,04-08-17,61,15:00,15:15,,25.67,0,25.67,25.67,-1,-36586,133437,170023,96851,0,-13016,0,0,0,,13016,-13016
15,04-08-17,62,15:15,15:30,,6.85,0,6.85,6.85,-1,-34415,128762,163177,94347,0,-23432,0,0,0,,23432,-23432
15,04-08-17,63,15:30,15:45,,6.85,0,6.85,6.85,-1,-34478,108170,142648,73692,0,-35737,0,0,0,,35737,-35737
15,04-08-17,64,15:45,16:00,,16.67,0,16.67,16.67,-1,-35729,96272,132001,60543,0,-44859,0,0,0,,44859,-44859
15,04-08-17,65,16:00,16:15,,21.67,0,21.67,21.67,-1,-40112,106040,146152,65928,0,-30224,0,0,0,,30224,-30224
15,04-08-17,66,16:15,16:30,,18.29,0,18.29,18.29,-1,-48179,100128,148307,51949,0,-34377,0,0,0,,34377,-34377
15,04-08-17,67,16:30,16:45,,26.78,0,26.78,26.78,-1,-32120,87134,119254,55014,0,-8034,0,0,0,,8034,-8034
15,04-08-17,68,16:45,17:00,,26.74,0,26.74,26.74,-1,-36543,77686,114229,41143,0,-5678,0,0,0,,5678,-5678
15,04-08-17,69,17:00,17:15,,6.85,0,6.85,6.85,-1,-86693,107917,194610,21224,0,-7980,0,0,0,,7980,-7980
15,04-08-17,70,17:15,17:30,,-6.99,0,-6.99,-6.99,-1,-38418,93248,131666,54830,0,-42650,0,0,0,,42650,-42650
15,04-08-17,71,17:30,17:45,,26.74,0,26.74,26.74,-1,-33497,71385,104882,37888,0,-10836,0,0,0,,10836,-10836
15,04-08-17,72,17:45,18:00,,,0,28.83,28.83,0,-34688,70063,104751,35375,0,-1122,0,0,0,,1122,-1122
15,04-08-17,73,18:00,18:15,,,0,29.28,29.28,0,-69493,53371,122864,-16122,0,0,0,0,0,,0,0
15,04-08-17,74,18:15,18:30,,28.83,0,28.83,28.83,-1,-40065,55991,96056,15926,0,-1102,0,0,0,,1102,-1102
15,04-08-17,75,18:30,18:45,,,0,29.28,29.28,0,-34503,43460,77963,8957,0,0,0,0,0,,0,0
15,04-08-17,76,18:45,19:00,,,0,29.28,29.28,0,-30929,41391,72320,10462,0,0,0,0,0,,0,0
15,04-08-17,77,19:00,19:15,,26.67,0,26.67,26.67,-1,-24903,46958,71861,22055,0,-2469,0,0,0,,2469,-2469
15,04-08-17,78,19:15,19:30,,31.09,0,31.09,31.09,-1,-24378,47340,71718,22962,0,-3278,0,0,0,,3278,-3278
15,04-08-17,79,19:30,19:45,,29.74,0,29.74,29.74,-1,-25906,36492,62398,10586,0,-3439,0,0,0,,3439,-3439
15,04-08-17,80,19:45,20:00,,,0,30.33,30.33,0,-33953,34385,68338,432,0,-345,0,0,0,,345,-345
15,04-08-17,81,20:00,20:15,,21.67,0,21.67,21.67,-1,-23853,61994,85847,38141,0,-10568,0,0,0,,10568,-10568
15,04-08-17,82,20:15,20:30,,26.74,0,26.74,26.74,-1,-38473,60682,99155,22209,0,-9958,0,0,0,,9958,-9958
15,04-08-17,83,20:30,20:45,33.65,26.74,0,33.65,33.65,1,-68417,44786,113203,-23631,0,-249,1522,0,0,,1771,1273
15,04-08-17,84,20:45,21:00,100.19,,0,100.19,100.19,1,-78658,34255,112913,-44403,0,0,26941,0,0,,26941,26941
15,04-08-17,85,21:00,21:15,36.58,,0,36.58,36.58,1,-51316,49849,101165,-1467,0,0,24957,0,0,,24957,24957
15,04-08-17,86,21:15,21:30,31.58,,0,31.58,31.58,1,-46691,42478,89169,-4213,0,0,5604,0,0,,5604,5604
15,04-08-17,87,21:30,21:45,31.58,,0,31.58,31.58,1,-36059,43766,79825,7707,0,0,2199,0,0,,2199,2199
15,04-08-17,88,21:45,22:00,28.67,,0,28.67,28.67,1,-33388,59583,92971,26195,0,0,91,0,0,,91,91
15,04-08-17,89,22:00,22:15,33.65,,0,33.65,33.65,1,-77003,47346,124349,-29657,0,0,2207,0,0,,2207,2207
15,04-08-17,90,22:15,22:30,,21.67,0,21.67,21.67,-1,-37429,53270,90699,15841,0,-3104,0,0,0,,3104,-3104
15,04-08-17,91,22:30,22:45,,20.75,0,20.75,20.75,-1,-34558,49182,83740,14624,0,-7512,0,0,0,,7512,-7512
15,04-08-17,92,22:45,23:00,,28.92,0,28.92,28.92,-1,-19326,69991,89317,50665,0,-87,0,0,0,,87,-87
15,04-08-17,93,23:00,23:15,,28.3,0,28.3,28.3,-1,-43874,35422,79296,-8452,0,-568,0,0,0,,568,-568
15,04-08-17,94,23:15,23:30,28.67,,0,28.67,28.67,1,-29466,31205,60671,1739,0,0,183,0,0,,183,183
15,04-08-17,95,23:30,23:45,,,0,29.68,29.68,0,-16250,43238,59488,26988,0,0,0,0,0,,0,0
15,04-08-17,96,23:45,0:00,,16.67,0,16.67,16.67,-1,-17805,53481,71286,35676,0,-8675,0,0,0,,8675,-8675
15,04-09-17,1,0:00,0:15,,16.67,0,16.67,16.67,-1,-63233,58824,122057,-4409,0,-14105,0,0,0,,14105,-14105
15,04-09-17,2,0:15,0:30,,31.24,0,31.24,31.24,-1,-53397,27961,81358,-25436,0,-705,0,0,0,,705,-705
15,04-09-17,3,0:30,0:45,,30.27,0,30.27,30.27,-1,-54798,26870,81668,-27928,0,-880,0,0,0,,880,-880
15,04-09-17,4,0:45,1:00,,30.73,0,30.73,30.73,-1,-133455,35075,168530,-98380,0,-203,0,0,0,,203,-203
15,04-09-17,5,1:00,1:15,36.67,,0,36.67,36.67,1,-83324,55913,139237,-27411,0,0,6792,0,0,,6792,6792
15,04-09-17,6,1:15,1:30,30.65,,0,30.65,30.65,1,-52597,44144,96741,-8453,0,0,5140,0,0,,5140,5140
15,04-09-17,7,1:30,1:45,,29.88,0,29.88,29.88,-1,-46583,51557,98140,4974,0,-192,0,0,0,,192,-192
15,04-09-17,8,1:45,2:00,,27.03,0,27.03,27.03,-1,-44992,57776,102768,12784,0,-9255,0,0,0,,9255,-9255
15,04-09-17,9,2:00,2:15,32.07,27.68,0,32.07,27.68,2,-68894,48713,117607,-20181,0,-4697,2136,0,0,,6833,-2561
15,04-09-17,10,2:15,2:30,26.62,21.67,0,21.67,21.67,-1,-40556,49243,89799,8687,0,-1405,886,0,0,,2291,-519
15,04-09-17,11,2:30,2:45,,9.47,0,9.47,9.47,-1,-5329,53632,58961,48303,0,-37890,0,0,0,,37890,-37890
15,04-09-17,12,2:45,3:00,,25.67,0,25.67,25.67,-1,-11851,61228,73079,49377,0,-35505,0,0,0,,35505,-35505
15,04-09-17,13,3:00,3:15,,26.03,0,26.03,26.03,-1,-9659,51969,61628,42310,0,-15452,0,0,0,,15452,-15452
15,04-09-17,14,3:15,3:30,,19.65,0,19.65,19.65,-1,-10904,58079,68983,47175,0,-2633,0,0,0,,2633,-2633
15,04-09-17,15,3:30,3:45,,16.67,0,16.67,16.67,-1,-10516,64374,74890,53858,0,-19436,0,0,0,,19436,-19436
15,04-09-17,16,3:45,4:00,,-6.77,0,-6.77,-6.77,-1,-16596,62859,79455,46263,0,-38164,0,0,0,,38164,-38164
15,04-09-17,17,4:00,4:15,,-27.59,0,-27.59,-27.59,-1,-10298,104961,115259,94663,0,-34748,0,0,0,,34748,-34748
15,04-09-17,18,4:15,4:30,,25.67,0,25.67,25.67,-1,-6253,80348,86601,74095,0,-1298,0,0,0,,1298,-1298
15,04-09-17,19,4:30,4:45,,25.67,0,25.67,25.67,-1,-6182,79916,86098,73734,0,-1559,0,0,0,,1559,-1559
15,04-09-17,20,4:45,5:00,,30.27,0,30.27,30.27,-1,-11108,83575,94683,72467,0,-15,0,0,0,,15,-15
15,04-09-17,21,5:00,5:15,,,0,28.45,28.45,0,-12027,76232,88259,64205,0,0,0,0,0,,0,0
15,04-09-17,22,5:15,5:30,,,0,28.45,28.45,0,-22155,61141,83296,38986,0,0,0,0,0,,0,0
15,04-09-17,23,5:30,5:45,,,0,28.45,28.45,0,-11289,66622,77911,55333,0,0,0,0,0,,0,0
15,04-09-17,24,5:45,6:00,,,0,28.45,28.45,0,-12767,72196,84963,59429,0,0,0,0,0,,0,0
15,04-09-17,25,6:00,6:15,,11.33,0,11.33,11.33,-1,-22490,81432,103922,58942,0,-15220,0,0,0,,15220,-15220
15,04-09-17,26,6:15,6:30,,11.33,0,11.33,11.33,-1,-31456,69857,101313,38401,0,-22577,0,0,0,,22577,-22577
15,04-09-17,27,6:30,6:45,,26.74,0,26.74,26.74,-1,-29965,65495,95460,35530,0,-1545,0,0,0,,1545,-1545
15,04-09-17,28,6:45,7:00,,4.06,0,4.06,4.06,-1,-24509,78107,102616,53598,0,-7834,0,0,0,,7834,-7834
15,04-09-17,29,7:00,7:15,,11.33,0,11.33,11.33,-1,-48242,52252,100494,4010,0,-9721,0,0,0,,9721,-9721
15,04-09-17,30,7:15,7:30,29.26,11.33,0,29.26,29.26,1,-45302,45871,91173,569,0,-86,1077,0,0,,1163,991
15,04-09-17,31,7:30,7:45,33.15,,0,33.15,33.15,1,-54346,41629,95975,-12717,0,0,10891,0,0,,10891,10891
15,04-09-17,32,7:45,8:00,29.99,,0,29.99,29.99,1,-80877,44755,125632,-36122,0,0,11364,0,0,,11364,11364
15,04-09-17,33,8:00,8:15,39.26,,0,39.26,39.26,1,-82944,27787,110731,-55157,0,0,14318,0,0,,14318,14318
15,04-09-17,34,8:15,8:30,47.02,,0,47.02,47.02,1,-71385,16504,87889,-54881,0,0,32702,0,0,,32702,32702
15,04-09-17,35,8:30,8:45,33.66,,0,33.66,33.66,1,-57943,35092,93035,-22851,0,0,30686,0,0,,30686,30686
15,04-09-17,36,8:45,9:00,33.66,30.27,0,30.27,30.27,-1,-65453,54744,120197,-10709,0,-24,5843,0,0,,5867,5819
15,04-09-17,37,9:00,9:15,,29.39,0,29.39,29.39,-1,-42450,57446,99896,14996,0,-470,0,0,0,,470,-470
15,04-09-17,38,9:15,9:30,,29.7,0,29.7,29.7,-1,-45284,69024,114308,23740,0,-949,0,0,0,,949,-949
15,04-09-17,39,9:30,9:45,,30.24,0,30.24,30.24,-1,-55175,83407,138582,28232,0,-32,0,0,0,,32,-32
15,04-09-17,40,9:45,10:00,,30.24,0,30.24,30.24,-1,-58704,96826,155530,38122,0,-63,0,0,0,,63,-63
15,04-09-17,41,10:00,10:15,27.26,,0,27.26,27.26,1,-49800,55526,105326,5726,0,0,10,0,0,,10,10
15,04-09-17,42,10:15,10:30,30.9,,0,30.9,30.9,1,-61291,53651,114942,-7640,0,0,2182,0,0,,2182,2182
15,04-09-17,43,10:30,10:45,,,0,28.29,28.29,0,-54976,50782,105758,-4194,0,0,0,0,0,,0,0
15,04-09-17,44,10:45,11:00,,26.74,0,26.74,26.74,-1,-47367,53620,100987,6253,0,-4905,0,0,0,,4905,-4905
15,04-09-17,45,11:00,11:15,33.26,28.3,0,33.26,28.3,2,-52709,38720,91429,-13989,0,-1989,1668,0,0,,3657,-321
15,04-09-17,46,11:15,11:30,33.66,26.26,0,33.66,26.26,2,-45952,42646,88598,-3306,0,-597,7039,0,0,,7636,6442
15,04-09-17,47,11:30,11:45,,26.26,0,26.26,26.26,-1,-50667,44987,95654,-5680,0,-1737,0,0,0,,1737,-1737
15,04-09-17,48,11:45,12:00,,22.26,0,22.26,22.26,-1,-51617,45983,97600,-5634,0,-8101,0,0,0,,8101,-8101
15,04-09-17,49,12:00,12:15,115.32,27.26,0,115.32,27.26,2,-73386,34091,107477,-39295,0,-4218,18415,0,0,,22633,14197
15,04-09-17,50,12:15,12:30,36.02,28.3,0,28.3,28.3,-1,-55250,45762,101012,-9488,0,-14,21902,0,0,,21916,21888
15,04-09-17,51,12:30,12:45,29.26,27.26,0,29.26,27.26,2,-60556,49696,110252,-10860,0,-373,1050,0,0,,1423,677
15,04-09-17,52,12:45,13:00,34.33,,0,34.33,34.33,1,-58230,45578,103808,-12652,0,0,4825,0,0,,4825,4825
15,04-09-17,53,13:00,13:15,34.44,,0,34.44,34.44,1,-60979,46724,107703,-14255,0,0,7051,0,0,,7051,7051
15,04-09-17,54,13:15,13:30,,,0,28.71,28.71,0,-56106,56178,112284,72,0,0,0,0,0,,0,0
15,04-09-17,55,13:30,13:45,,22.26,0,22.26,22.26,-1,-48442,63193,111635,14751,0,-10026,0,0,0,,10026,-10026
15,04-09-17,56,13:45,14:00,,21.31,0,21.31,21.31,-1,-41161,66666,107827,25505,0,-28912,0,0,0,,28912,-28912
15,04-09-17,57,14:00,14:15,30.9,26.26,0,30.9,26.26,2,-62336,55630,117966,-6706,0,-13102,344,0,0,,13446,-12758
15,04-09-17,58,14:15,14:30,33.26,26.26,0,33.26,33.26,1,-59218,51846,111064,-7372,0,-740,4919,0,0,,5659,4179
15,04-09-17,59,14:30,14:45,,,0,28.73,28.73,0,-46603,50514,97117,3911,0,0,643,0,0,,643,643
15,04-09-17,60,14:45,15:00,,23.72,0,23.72,23.72,-1,-37398,53851,91249,16453,0,-3262,0,0,0,,3262,-3262
15,04-09-17,61,15:00,15:15,,22.26,0,22.26,22.26,-1,-52849,50801,103650,-2048,0,-8857,0,0,0,,8857,-8857
15,04-09-17,62,15:15,15:30,,27.26,0,27.26,27.26,-1,-46862,47903,94765,1041,0,-4588,0,0,0,,4588,-4588
15,04-09-17,63,15:30,15:45,,28.71,0,28.71,28.71,-1,-41641,44187,85828,2546,0,-565,0,0,0,,565,-565
15,04-09-17,64,15:45,16:00,,28.69,0,28.69,28.69,-1,-47036,51289,98325,4253,0,-1537,0,0,0,,1537,-1537
15,04-09-17,65,16:00,16:15,,30.27,0,30.27,30.27,-1,-59996,50536,110532,-9460,0,-489,0,0,0,,489,-489
15,04-09-17,66,16:15,16:30,,,0,28.77,28.77,0,-69900,50901,120801,-18999,0,0,0,0,0,,0,0
15,04-09-17,67,16:30,16:45,48.17,,0,48.17,48.17,1,-90378,43197,133575,-47181,0,0,11611,0,0,,11611,11611
15,04-09-17,68,16:45,17:00,48.17,,0,48.17,48.17,1,-104226,56322,160548,-47904,0,0,33880,0,0,,33880,33880
15,04-09-17,69,17:00,17:15,48.17,15.56,0,15.56,15.56,-1,-88970,130040,219010,41070,0,-9992,4514,0,0,,14506,-5478
15,04-09-17,70,17:15,17:30,27.82,27.99,0,27.82,27.82,1,-95052,90683,185735,-4369,0,-3046,64,0,0,,3110,-2982
15,04-09-17,71,17:30,17:45,29.99,,0,29.99,29.99,1,-98466,92179,190645,-6287,0,0,1712,0,0,,1712,1712
15,04-09-17,72,17:45,18:00,27.26,,0,27.26,27.26,1,-103848,151904,255752,48056,0,0,156,0,0,,156,156
15,04-09-17,73,18:00,18:15,129.02,,0,129.02,129.02,1,-165063,27355,192418,-137708,0,0,26320,0,0,,26320,26320
15,04-09-17,74,18:15,18:30,57.33,,0,57.33,57.33,1,-110465,65442,175907,-45023,0,0,21416,0,0,,21416,21416
15,04-09-17,75,18:30,18:45,29.26,,0,29.26,29.26,1,-106480,67568,174048,-38912,0,0,97,0,0,,97,97
15,04-09-17,76,18:45,19:00,39.26,,0,39.26,39.26,1,-101996,43443,145439,-58553,0,0,5438,0,0,,5438,5438
15,04-09-17,77,19:00,19:15,248.53,,0,248.53,248.53,1,-184917,20148,205065,-164769,0,0,39406,0,0,,39406,39406
15,04-09-17,78,19:15,19:30,31.57,,0,31.57,31.57,1,-118776,34526,153302,-84250,0,0,7282,0,0,,7282,7282
15,04-09-17,79,19:30,19:45,83.02,,0,83.02,83.02,1,-124976,19333,144309,-105643,0,0,16071,0,0,,16071,16071
15,04-09-17,80,19:45,20:00,64.79,,0,64.79,64.79,1,-123507,19404,142911,-104103,0,0,44129,0,0,,44129,44129
15,04-09-17,81,20:00,20:15,64.79,27.26,0,27.26,27.26,-1,-66920,73741,140661,6821,0,-629,13559,0,0,,14188,12930
15,04-09-17,82,20:15,20:30,,,0,30.81,30.81,0,-89388,40531,129919,-48857,0,-32,0,0,0,,32,-32
15,04-09-17,83,20:30,20:45,45.53,,0,45.53,45.53,1,-115198,31533,146731,-83665,0,0,5376,0,0,,5376,5376
15,04-09-17,84,20:45,21:00,254.84,,0,254.84,254.84,1,-136906,29275,166181,-107631,0,0,56841,0,0,,56841,56841
15,04-09-17,85,21:00,21:15,245.24,,0,245.24,245.24,1,-131277,51627,182904,-79650,0,0,81926,0,0,,81926,81926
15,04-09-17,86,21:15,21:30,245.24,29.88,0,29.88,29.88,-1,-71173,74540,145713,3367,0,-106,21034,0,0,,21140,20928
15,04-09-17,87,21:30,21:45,,29.55,0,29.55,29.55,-1,-30599,56524,87123,25925,0,-760,0,0,0,,760,-760
15,04-09-17,88,21:45,22:00,,14.21,0,14.21,14.21,-1,-10206,71001,81207,60795,0,-15710,0,0,0,,15710,-15710
15,04-09-17,89,22:00,22:15,256.66,27.26,0,256.66,256.66,1,-101532,20632,122164,-80900,0,-6716,18277,0,0,,24993,11561
15,04-09-17,90,22:15,22:30,42.02,,0,42.02,42.02,1,-34344,38329,72673,3985,0,0,19727,0,0,,19727,19727
15,04-09-17,91,22:30,22:45,42.02,13.66,0,13.66,13.66,-1,-7619,83772,91391,76153,0,-11485,113,0,0,,11598,-11372
15,04-09-17,92,22:45,23:00,,4.42,0,4.42,4.42,-1,-13396,108157,121553,94761,0,-57426,0,0,0,,57426,-57426
15,04-09-17,93,23:00,23:15,28.95,14.76,0,29.45,14.76,2,-57822,86758,144580,28936,0,-36904,104,0,0,,37008,-36800
15,04-09-17,94,23:15,23:30,29.34,-56.54,0,29.39,-56.54,2,-27150,81079,108229,53929,0,-11569,162,0,0,,11731,-11407
15,04-09-17,95,23:30,23:45,,-56.54,0,-56.54,-56.54,-1,-40293,112460,152753,72167,0,-57262,0,0,0,,57262,-57262
15,04-09-17,96,23:45,0:00,,-56.54,0,-56.54,-56.54,-1,-53381,152940,206321,99559,0,-80419,0,0,0,,80419,-80419
15,04-10-17,1,0:00,0:15,33.5,-56.54,0,33.5,33.5,1,-49185,22238,71423,-26947,0,-20812,1464,0,0,,22276,-19348
15,04-10-17,2,0:15,0:30,33.5,24.39,0,24.39,24.39,-1,-35687,57492,93179,21805,0,-2450,238,0,0,,2688,-2212
15,04-10-17,3,0:30,0:45,,22.26,0,22.26,22.26,-1,-56018,73606,129624,17588,0,-8063,0,0,0,,8063,-8063
15,04-10-17,4,0:45,1:00,,17.82,0,17.82,17.82,-1,-57883,90284,148167,32401,0,-34034,0,0,0,,34034,-34034
15,04-10-17,5,1:00,1:15,,16.78,0,16.78,16.78,-1,-33761,158459,192220,124698,0,-32127,0,0,0,,32127,-32127
15,04-10-17,6,1:15,1:30,,-138.44,0,-138.44,-138.44,-1,-43975,147512,191487,103537,0,-43935,0,0,0,,43935,-43935
15,04-10-17,7,1:30,1:45,,-13.78,0,-13.78,-13.78,-1,-32663,102968,135631,70305,0,-54383,0,0,0,,54383,-54383
15,04-10-17,8,1:45,2:00,,-138.44,0,-138.44,-138.44,-1,-39285,100123,139408,60838,0,-62297,0,0,0,,62297,-62297
15,04-10-17,9,2:00,2:15,,-16.18,0,-16.18,-16.18,-1,-30772,90284,121056,59512,0,-43387,0,0,0,,43387,-43387
15,04-10-17,10,2:15,2:30,,-102,0,-102,-102,-1,-36649,68726,105375,32077,0,-52018,0,0,0,,52018,-52018
15,04-10-17,11,2:30,2:45,,-17.78,0,-17.78,-17.78,-1,-32249,84543,116792,52294,0,-54646,0,0,0,,54646,-54646
15,04-10-17,12,2:45,3:00,,17.66,0,17.66,17.66,-1,-43068,64437,107505,21369,0,-46424,0,0,0,,46424,-46424
15,04-10-17,13,3:00,3:15,,23.94,0,23.94,23.94,-1,-48024,59520,107544,11496,0,-25666,0,0,0,,25666,-25666
15,04-10-17,14,3:15,3:30,29.26,23.94,0,29.26,29.26,1,-61255,48752,110007,-12503,0,-2244,1145,0,0,,3389,-1099
15,04-10-17,15,3:30,3:45,,,0,28.49,28.49,0,-55758,38536,94294,-17222,0,0,0,0,0,,0,0
15,04-10-17,16,3:45,4:00,26.71,,0,26.71,26.71,1,-68031,49721,117752,-18310,0,0,209,0,0,,209,209
15,04-10-17,17,4:00,4:15,26.69,22.26,0,22.26,22.26,-1,-59676,68594,128270,8918,0,-4134,83,0,0,,4217,-4051
15,04-10-17,18,4:15,4:30,,8.2,0,8.2,8.2,-1,-57471,67159,124630,9688,0,-36980,0,0,0,,36980,-36980
15,04-10-17,19,4:30,4:45,,0.21,0,0.21,0.21,-1,-40254,65039,105293,24785,0,-52127,0,0,0,,52127,-52127
15,04-10-17,20,4:45,5:00,,-59.63,0,-59.63,-59.63,-1,-31358,87750,119108,56392,0,-55358,0,0,0,,55358,-55358
15,04-10-17,21,5:00,5:15,,5.6,0,5.6,5.6,-1,-64458,102804,167262,38346,0,-44261,0,0,0,,44261,-44261
15,04-10-17,22,5:15,5:30,,-2.78,0,-2.78,-2.78,-1,-46743,110625,157368,63882,0,-42158,0,0,0,,42158,-42158
15,04-10-17,23,5:30,5:45,,20.91,0,20.91,20.91,-1,-45335,81236,126571,35901,0,-39823,0,0,0,,39823,-39823
15,04-10-17,24,5:45,6:00,,25.78,0,25.78,25.78,-1,-64455,95881,160336,31426,0,-14794,0,0,0,,14794,-14794
15,04-10-17,25,6:00,6:15,,-28.23,0,-28.23,-28.23,-1,-67786,108476,176262,40690,0,-27427,0,0,0,,27427,-27427
15,04-10-17,26,6:15,6:30,,-52.15,0,-52.15,-52.15,-1,-32347,103287,135634,70940,0,-75130,0,0,0,,75130,-75130
15,04-10-17,27,6:30,6:45,,-7.78,0,-7.78,-7.78,-1,-36180,113434,149614,77254,0,-57941,0,0,0,,57941,-57941
15,04-10-17,28,6:45,7:00,,-7.98,0,-7.98,-7.98,-1,-66768,97478,164246,30710,0,-53202,0,0,0,,53202,-53202
15,04-10-17,29,7:00,7:15,,-8.47,0,-8.47,-8.47,-1,-46258,106542,152800,60284,0,-39071,0,0,0,,39071,-39071
15,04-10-17,30,7:15,7:30,,23.69,0,23.69,23.69,-1,-40825,58692,99517,17867,0,-30338,0,0,0,,30338,-30338
15,04-10-17,31,7:30,7:45,49.17,25.26,0,49.17,49.17,1,-107570,40286,147856,-67284,0,-13412,2739,0,0,,16151,-10673
15,04-10-17,32,7:45,8:00,272.67,25.85,0,272.67,25.85,2,-137606,23206,160812,-114400,0,-288,25801,0,0,,26089,25513
15,04-10-17,33,8:00,8:15,272.67,-28.23,0,-28.23,-28.23,-1,-63714,73877,137591,10163,0,-17068,317,0,0,,17385,-16751
15,04-10-17,34,8:15,8:30,31.22,-28.23,0,31.22,31.22,1,-56908,40286,97194,-16622,0,-467,748,0,0,,1215,281
15,04-10-17,35,8:30,8:45,,28.58,0,28.58,28.58,-1,-52049,38750,90799,-13299,0,-811,0,0,0,,811,-811
15,04-10-17,36,8:45,9:00,,25.26,0,25.26,25.26,-1,-54539,51706,106245,-2833,0,-548,0,0,0,,548,-548
15,04-10-17,37,9:00,9:15,30.79,18.57,0,30.79,18.57,2,-38701,48418,87119,9717,0,-13142,6,0,0,,13148,-13136
15,04-10-17,38,9:15,9:30,32.78,18.57,0,32.78,32.78,1,-20517,43190,63707,22673,0,-189,539,0,0,,728,350
15,04-10-17,39,9:30,9:45,,,0,30.4,30.4,0,-20895,43763,64658,22868,0,0,0,0,0,,0,0
15,04-10-17,40,9:45,10:00,,,0,30.4,30.4,0,-21402,37941,59343,16539,0,0,0,0,0,,0,0
15,04-10-17,41,10:00,10:15,306.13,,0,306.13,306.13,1,-84016,23836,107852,-60180,0,0,23055,0,0,,23055,23055
15,04-10-17,42,10:15,10:30,45,,0,45,45,1,-83777,45536,129313,-38241,0,0,35527,0,0,,35527,35527
15,04-10-17,43,10:30,10:45,306.13,,0,306.13,306.13,1,-108091,41241,149332,-66850,0,0,45562,0,0,,45562,45562
15,04-10-17,44,10:45,11:00,306.13,,0,306.13,306.13,1,-139727,51136,190863,-88591,0,0,79162,0,0,,79162,79162
15,04-10-17,45,11:00,11:15,294.47,,0,294.47,294.47,1,-124246,28362,152608,-95884,0,0,81395,0,0,,81395,81395
15,04-10-17,46,11:15,11:30,42.62,,0,42.62,42.62,1,-93697,54436,148133,-39261,0,0,25189,0,0,,25189,25189
15,04-10-17,47,11:30,11:45,294.47,,0,294.47,294.47,1,-103650,46425,150075,-57225,0,0,38098,0,0,,38098,38098
15,04-10-17,48,11:45,12:00,36.34,,0,36.34,36.34,1,-84320,67625,151945,-16695,0,0,19321,0,0,,19321,19321
15,04-10-17,49,12:00,12:15,74.12,,0,74.12,74.12,1,-83696,45074,128770,-38622,0,0,26703,0,0,,26703,26703
15,04-10-17,50,12:15,12:30,33.74,,0,33.74,33.74,1,-79420,58336,137756,-21084,0,0,22902,0,0,,22902,22902
15,04-10-17,51,12:30,12:45,34.84,,0,34.84,34.84,1,-76971,58010,134981,-18961,0,0,10874,0,0,,10874,10874
15,04-10-17,52,12:45,13:00,35,,0,35,35,1,-81931,55978,137909,-25953,0,0,14409,0,0,,14409,14409
15,04-10-17,53,13:00,13:15,243.43,,0,243.43,243.43,1,-130741,69643,200384,-61098,0,0,32167,0,0,,32167,32167
15,04-10-17,54,13:15,13:30,243.43,,0,243.43,243.43,1,-145569,76715,222284,-68854,0,0,68428,0,0,,68428,68428
15,04-10-17,55,13:30,13:45,43.2,,0,43.2,43.2,1,-137617,97052,234669,-40565,0,0,43099,0,0,,43099,43099
15,04-10-17,56,13:45,14:00,43.2,,0,43.2,43.2,1,-129585,91846,221431,-37739,0,0,40070,0,0,,40070,40070
15,04-10-17,57,14:00,14:15,43.2,25.78,0,25.78,25.78,-1,-59200,121906,181106,62706,0,-1663,10724,0,0,,12387,9061
15,04-10-17,58,14:15,14:30,,25.85,0,25.85,25.85,-1,-38828,91954,130782,53126,0,-808,0,0,0,,808,-808
15,04-10-17,59,14:30,14:45,,17.26,0,17.26,17.26,-1,-39279,101584,140863,62305,0,-19764,0,0,0,,19764,-19764
15,04-10-17,60,14:45,15:00,,-8.47,0,-8.47,-8.47,-1,-43255,89376,132631,46121,0,-37449,0,0,0,,37449,-37449
15,04-10-17,61,15:00,15:15,,24.49,0,24.49,24.49,-1,-30007,49805,79812,19798,0,-15944,0,0,0,,15944,-15944
15,04-10-17,62,15:15,15:30,29.26,24.49,0,29.26,29.26,1,-57371,49856,107227,-7515,0,-55,1803,0,0,,1858,1748
15,04-10-17,63,15:30,15:45,28.26,,0,28.26,28.26,1,-55692,51728,107420,-3964,0,0,251,0,0,,251,251
15,04-10-17,64,15:45,16:00,30.27,,0,30.27,30.27,1,-80089,53086,133175,-27003,0,0,3079,0,0,,3079,3079
15,04-10-17,65,16:00,16:15,39.26,,0,39.26,39.26,1,-91466,26983,118449,-64483,0,0,11538,0,0,,11538,11538
15,04-10-17,66,16:15,16:30,31.04,,0,31.04,31.04,1,-74408,37591,111999,-36817,0,0,14099,0,0,,14099,14099
15,04-10-17,67,16:30,16:45,46.59,,0,46.59,46.59,1,-85366,32671,118037,-52695,0,0,8520,0,0,,8520,8520
15,04-10-17,68,16:45,17:00,62.38,,0,62.38,62.38,1,-92929,47135,140064,-45794,0,0,30326,0,0,,30326,30326
15,04-10-17,69,17:00,17:15,35.84,,0,35.84,35.84,1,-85787,19231,105018,-66556,0,0,9325,0,0,,9325,9325
15,04-10-17,70,17:15,17:30,53.12,,0,53.12,53.12,1,-99792,17067,116859,-82725,0,0,41618,0,0,,41618,41618
15,04-10-17,71,17:30,17:45,116.12,,0,116.12,116.12,1,-94014,31158,125172,-62856,0,0,59943,0,0,,59943,59943
15,04-10-17,72,17:45,18:00,33.26,,0,33.26,33.26,1,-77141,45549,122690,-31592,0,0,16657,0,0,,16657,16657
15,04-10-17,73,18:00,18:15,38.06,,0,38.06,38.06,1,-67639,36748,104387,-30891,0,0,10948,0,0,,10948,10948
15,04-10-17,74,18:15,18:30,28.26,,0,28.26,28.26,1,-52097,42751,94848,-9346,0,0,200,0,0,,200,200
15,04-10-17,75,18:30,18:45,130.12,,0,130.12,130.12,1,-64509,29874,94383,-34635,0,0,6720,0,0,,6720,6720
15,04-10-17,76,18:45,19:00,130.12,,0,130.12,130.12,1,-59007,62067,121074,3060,0,0,10089,0,0,,10089,10089
15,04-10-17,77,19:00,19:15,130.12,18.57,0,18.57,18.57,-1,-62748,83573,146321,20825,0,-11005,5,0,0,,11010,-11000
15,04-10-17,78,19:15,19:30,,28.58,0,28.58,28.58,-1,-69260,69458,138718,198,0,-1913,0,0,0,,1913,-1913
15,04-10-17,79,19:30,19:45,,26.99,0,26.99,26.99,-1,-63514,66346,129860,2832,0,-1561,0,0,0,,1561,-1561
15,04-10-17,80,19:45,20:00,30.83,,0,30.83,30.83,1,-74121,52790,126911,-21331,0,0,744,0,0,,744,744
15,04-10-17,81,20:00,20:15,30.83,-52.15,0,-52.15,-52.15,-1,-19341,121137,140478,101796,0,-28632,114,0,0,,28746,-28518
15,04-10-17,82,20:15,20:30,,17.26,0,17.26,17.26,-1,-31625,68208,99833,36583,0,-38060,0,0,0,,38060,-38060
15,04-10-17,83,20:30,20:45,33.74,27.99,0,33.74,33.74,1,-69017,49618,118635,-19399,0,-8203,400,0,0,,8603,-7803
15,04-10-17,84,20:45,21:00,33.95,,0,33.95,33.95,1,-90510,40371,130881,-50139,0,0,10714,0,0,,10714,10714
15,04-10-17,85,21:00,21:15,248.13,,0,248.13,248.13,1,-114076,10215,124291,-103861,0,0,37731,0,0,,37731,37731
15,04-10-17,86,21:15,21:30,248.13,,0,248.13,248.13,1,-74566,45622,120188,-28944,0,0,64707,0,0,,64707,64707
15,04-10-17,87,21:30,21:45,248.13,22.26,0,22.26,22.26,-1,-33727,92370,126097,58643,0,-2956,4081,0,0,,7037,1125
15,04-10-17,88,21:45,22:00,,18.57,0,18.57,18.57,-1,-37804,72821,110625,35017,0,-13842,0,0,0,,13842,-13842
15,04-10-17,89,22:00,22:15,273.8,18.57,0,273.8,273.8,1,-107341,34466,141807,-72875,0,-3579,22509,0,0,,26088,18930
15,04-10-17,90,22:15,22:30,273.8,-52.15,0,-52.15,-52.15,-1,-44678,94524,139202,49846,0,-4761,20850,0,0,,25611,16089
15,04-10-17,91,22:30,22:45,,-52.15,0,-52.15,-52.15,-1,-33398,69348,102746,35950,0,-16296,0,0,0,,16296,-16296
15,04-10-17,92,22:45,23:00,,25.94,0,25.94,25.94,-1,-32931,61187,94118,28256,0,-345,0,0,0,,345,-345
15,04-10-17,93,23:00,23:15,59.12,23.78,0,59.12,23.78,2,-66490,55444,121934,-11046,0,-1789,10625,0,0,,12414,8836
15,04-10-17,94,23:15,23:30,34.63,,0,34.63,34.63,1,-45983,18043,64026,-27940,0,0,21680,0,0,,21680,21680
15,04-10-17,95,23:30,23:45,28.26,,0,28.26,28.26,1,-46967,38501,85468,-8466,0,0,7679,0,0,,7679,7679
15,04-10-17,96,23:45,0:00,30.27,,0,30.27,30.27,1,-71778,52855,124633,-18923,0,0,2556,0,0,,2556,2556
15,04-11-17,1,0:00,0:15,34.9,,0,34.9,34.9,1,-65274,33224,98498,-32050,0,0,4243,0,0,,4243,4243
15,04-11-17,2,0:15,0:30,34.9,,0,34.9,34.9,1,-76908,16298,93206,-60610,0,0,8623,0,0,,8623,8623
15,04-11-17,3,0:30,0:45,82.02,,0,82.02,82.02,1,-112628,19347,131975,-93281,0,0,12679,0,0,,12679,12679
15,04-11-17,4,0:45,1:00,177.88,,0,177.88,177.88,1,-106171,33367,139538,-72804,0,0,41118,0,0,,41118,41118
15,04-11-17,5,1:00,1:15,,,0,30.39,30.39,0,-73002,38093,111095,-34909,0,0,4487,0,0,,4487,4487
15,04-11-17,6,1:15,1:30,,28.98,0,28.98,28.98,-1,-45342,35414,80756,-9928,0,-430,0,0,0,,430,-430
15,04-11-17,7,1:30,1:45,,33.49,0,33.49,33.49,-1,-50162,32030,82192,-18132,0,-40,0,0,0,,40,-40
15,04-11-17,8,1:45,2:00,,32.89,0,32.89,32.89,-1,-49713,14772,64485,-34941,0,-460,0,0,0,,460,-460
15,04-11-17,9,2:00,2:15,48.02,33.49,0,48.02,48.02,1,-85518,21184,106702,-64334,0,-42,8572,0,0,,8614,8530
15,04-11-17,10,2:15,2:30,48.76,,0,48.76,48.76,1,-52809,30985,83794,-21824,0,0,15259,0,0,,15259,15259
15,04-11-17,11,2:30,2:45,48.76,31.39,0,31.39,31.39,-1,-35634,21630,57264,-14004,0,-317,105,0,0,,422,-212
15,04-11-17,12,2:45,3:00,,27.28,0,27.28,27.28,-1,-17986,23961,41947,5975,0,-3052,0,0,0,,3052,-3052
15,04-11-17,13,3:00,3:15,33.28,27.28,0,33.28,33.28,1,-36357,19688,56045,-16669,0,-2428,1308,0,0,,3736,-1120
15,04-11-17,14,3:15,3:30,33.4,,0,33.4,33.4,1,-40928,27264,68192,-13664,0,0,6397,0,0,,6397,6397
15,04-11-17,15,3:30,3:45,,,0,30.39,30.39,0,-32711,35324,68035,2613,0,0,6,0,0,,6,6
15,04-11-17,16,3:45,4:00,29.28,,0,29.28,29.28,1,-48791,26055,74846,-22736,0,0,1087,0,0,,1087,1087
15,04-11-17,17,4:00,4:15,35,,0,35,35,1,-48658,31271,79929,-17387,0,0,7082,0,0,,7082,7082
15,04-11-17,18,4:15,4:30,35,,0,35,35,1,-47063,28438,75501,-18625,0,0,15084,0,0,,15084,15084
15,04-11-17,19,4:30,4:45,29.76,,0,29.76,29.76,1,-40669,27400,68069,-13269,0,0,9529,0,0,,9529,9529
15,04-11-17,20,4:45,5:00,33.43,,0,33.43,33.43,1,-35697,42103,77800,6406,0,0,11819,0,0,,11819,11819
15,04-11-17,21,5:00,5:15,33.43,29.63,0,29.63,29.63,-1,-54870,67369,122239,12499,0,-860,913,0,0,,1773,53
15,04-11-17,22,5:15,5:30,,27.28,0,27.28,27.28,-1,-33319,61393,94712,28074,0,-9216,0,0,0,,9216,-9216
15,04-11-17,23,5:30,5:45,28.72,26.28,0,30.39,26.28,2,-38062,29996,68058,-8066,0,-13964,20,0,0,,13984,-13944
15,04-11-17,24,5:45,6:00,48.82,26.28,0,48.82,48.82,1,-62362,27786,90148,-34576,0,-1393,11168,0,0,,12561,9775
15,04-11-17,25,6:00,6:15,48.82,25.01,0,25.01,25.01,-1,-79584,82734,162318,3150,0,-2949,2235,0,0,,5184,-714
15,04-11-17,26,6:15,6:30,,21.92,0,21.92,21.92,-1,-42946,64922,107868,21976,0,-15622,0,0,0,,15622,-15622
15,04-11-17,27,6:30,6:45,27.91,27.59,0,27.91,27.91,1,-65837,50264,116101,-15573,0,-9773,2,0,0,,9775,-9771
15,04-11-17,28,6:45,7:00,36.2,27.59,0,36.2,36.2,1,-116040,63099,179139,-52941,0,-184,4295,0,0,,4479,4111
15,04-11-17,29,7:00,7:15,39.9,25.01,0,39.9,25.01,2,-51814,89917,141731,38103,0,-3668,4863,0,0,,8531,1195
15,04-11-17,30,7:15,7:30,,31.39,0,31.39,31.39,-1,-75040,75225,150265,185,0,-2022,0,0,0,,2022,-2022
15,04-11-17,31,7:30,7:45,93.59,31.39,0,93.59,93.59,1,-109010,56086,165096,-52924,0,-205,10656,0,0,,10861,10451
15,04-11-17,32,7:45,8:00,281.15,,0,281.15,281.15,1,-140284,65642,205926,-74642,0,0,50043,0,0,,50043,50043
15,04-11-17,33,8:00,8:15,281.15,14.81,0,14.81,14.81,-1,-32667,88050,120717,55383,0,-7111,11124,0,0,,18235,4013
15,04-11-17,34,8:15,8:30,,14.81,0,14.81,14.81,-1,-46552,48544,95096,1992,0,-14103,0,0,0,,14103,-14103
15,04-11-17,35,8:30,8:45,41.97,14.81,0,41.97,41.97,1,-45829,31033,76862,-14796,0,-115,7959,0,0,,8074,7844
15,04-11-17,36,8:45,9:00,46.97,,0,46.97,46.97,1,-65918,41003,106921,-24915,0,0,14414,0,0,,14414,14414
15,04-11-17,37,9:00,9:15,60,25.92,0,60,25.92,2,-60640,65248,125888,4608,0,-352,16915,0,0,,17267,16563
15,04-11-17,38,9:15,9:30,60,21.92,0,21.92,21.92,-1,-37556,53252,90808,15696,0,-9514,781,0,0,,10295,-8733
15,04-11-17,39,9:30,9:45,,25.92,0,25.92,25.92,-1,-26904,52768,79672,25864,0,-11626,0,0,0,,11626,-11626
15,04-11-17,40,9:45,10:00,,25.92,0,25.92,25.92,-1,-21968,52478,74446,30510,0,-13055,0,0,0,,13055,-13055
15,04-11-17,41,10:00,10:15,,32.89,0,32.89,32.89,-1,-18048,105025,123073,86977,0,-3062,0,0,0,,3062,-3062
15,04-11-17,42,10:15,10:30,,12.28,0,12.28,12.28,-1,-10471,133126,143597,122655,0,-3653,0,0,0,,3653,-3653
15,04-11-17,43,10:30,10:45,,-2.64,0,-2.64,-2.64,-1,-28647,97684,126331,69037,0,-20651,0,0,0,,20651,-20651
15,04-11-17,44,10:45,11:00,,28.51,0,28.51,28.51,-1,-29042,113560,142602,84518,0,-8669,0,0,0,,8669,-8669
15,04-11-17,45,11:00,11:15,,25.92,0,25.92,25.92,-1,-30720,76803,107523,46083,0,-7138,0,0,0,,7138,-7138
15,04-11-17,46,11:15,11:30,,25.92,0,25.92,25.92,-1,-20382,85243,105625,64861,0,-8571,0,0,0,,8571,-8571
15,04-11-17,47,11:30,11:45,,24.95,0,24.95,24.95,-1,-28976,93292,122268,64316,0,-8888,0,0,0,,8888,-8888
15,04-11-17,48,11:45,12:00,,22.76,0,22.76,22.76,-1,-27772,91316,119088,63544,0,-19262,0,0,0,,19262,-19262
15,04-11-17,49,12:00,12:15,31.32,26.92,0,31.32,31.32,1,-82624,47036,129660,-35588,0,-11632,1150,0,0,,12782,-10482
15,04-11-17,50,12:15,12:30,31.32,24.89,0,24.89,24.89,-1,-52869,64503,117372,11634,0,-2800,89,0,0,,2889,-2711
15,04-11-17,51,12:30,12:45,,21.92,0,21.92,21.92,-1,-51414,90137,141551,38723,0,-27488,0,0,0,,27488,-27488
15,04-11-17,52,12:45,13:00,,24.03,0,24.03,24.03,-1,-65116,95436,160552,30320,0,-31907,0,0,0,,31907,-31907
15,04-11-17,53,13:00,13:15,32.92,27.94,0,32.92,32.92,1,-61042,61186,122228,144,0,-13751,923,0,0,,14674,-12828
15,04-11-17,54,13:15,13:30,,,0,30.7,30.7,0,-52949,48503,101452,-4446,0,-23,301,0,0,,324,278
15,04-11-17,55,13:30,13:45,,31.39,0,31.39,31.39,-1,-51285,51519,102804,234,0,-176,0,0,0,,176,-176
15,04-11-17,56,13:45,14:00,,26.92,0,26.92,26.92,-1,-50909,52440,103349,1531,0,-5276,0,0,0,,5276,-5276
15,04-11-17,57,14:00,14:15,,,0,30.24,30.24,0,-56193,40772,96965,-15421,0,-482,0,0,0,,482,-482
15,04-11-17,58,14:15,14:30,26.98,,0,26.98,26.98,1,-59422,42211,101633,-17211,0,0,1023,0,0,,1023,1023
15,04-11-17,59,14:30,14:45,28.92,,0,28.92,28.92,1,-54925,42497,97422,-12428,0,0,3476,0,0,,3476,3476
15,04-11-17,60,14:45,15:00,28.92,21.92,0,21.92,21.92,-1,-44534,56085,100619,11551,0,-4436,74,0,0,,4510,-4362
15,04-11-17,61,15:00,15:15,,21.92,0,21.92,21.92,-1,-72029,75618,147647,3589,0,-5602,0,0,0,,5602,-5602
15,04-11-17,62,15:15,15:30,26.92,,0,26.92,26.92,1,-68833,75994,144827,7161,0,0,142,0,0,,142,142
15,04-11-17,63,15:30,15:45,,,0,30.21,30.21,0,-62920,77104,140024,14184,0,0,0,0,0,,0,0
15,04-11-17,64,15:45,16:00,,21.92,0,21.92,21.92,-1,-57492,88225,145717,30733,0,-10232,0,0,0,,10232,-10232
15,04-11-17,65,16:00,16:15,,26.92,0,26.92,26.92,-1,-58391,93624,152015,35233,0,-15087,0,0,0,,15087,-15087
15,04-11-17,66,16:15,16:30,,21.2,0,21.2,21.2,-1,-49636,102566,152202,52930,0,-23883,0,0,0,,23883,-23883
15,04-11-17,67,16:30,16:45,,21.92,0,21.92,21.92,-1,-42571,92847,135418,50276,0,-31404,0,0,0,,31404,-31404
15,04-11-17,68,16:45,17:00,,25.92,0,25.92,25.92,-1,-43780,80652,124432,36872,0,-26785,0,0,0,,26785,-26785
15,04-11-17,69,17:00,17:15,,26.92,0,26.92,26.92,-1,-45539,67378,112917,21839,0,-19698,0,0,0,,19698,-19698
15,04-11-17,70,17:15,17:30,,26.92,0,26.92,26.92,-1,-45916,51819,97735,5903,0,-14200,0,0,0,,14200,-14200
15,04-11-17,71,17:30,17:45,,,0,30.21,30.21,0,-30413,52529,82942,22116,0,-1168,0,0,0,,1168,-1168
15,04-11-17,72,17:45,18:00,,25.92,0,25.92,25.92,-1,-26734,72746,99480,46012,0,-1435,0,0,0,,1435,-1435
15,04-11-17,73,18:00,18:15,,25.92,0,25.92,25.92,-1,-49836,39420,89256,-10416,0,-5407,0,0,0,,5407,-5407
15,04-11-17,74,18:15,18:30,,26.47,0,26.47,26.47,-1,-27142,55110,82252,27968,0,-13768,0,0,0,,13768,-13768
15,04-11-17,75,18:30,18:45,,26.92,0,26.92,26.92,-1,-13859,65115,78974,51256,0,-11814,0,0,0,,11814,-11814
15,04-11-17,76,18:45,19:00,,,0,30.72,30.72,0,-11373,83183,94556,71810,0,-1194,0,0,0,,1194,-1194
15,04-11-17,77,19:00,19:15,,19.78,0,19.78,19.78,-1,-18323,37103,55426,18780,0,-11452,0,0,0,,11452,-11452
15,04-11-17,78,19:15,19:30,,21.84,0,21.84,21.84,-1,-34561,35784,70345,1223,0,-13624,0,0,0,,13624,-13624
15,04-11-17,79,19:30,19:45,,16.92,0,16.92,16.92,-1,-11939,56271,68210,44332,0,-15772,0,0,0,,15772,-15772
15,04-11-17,80,19:45,20:00,,24.89,0,24.89,24.89,-1,-28131,30729,58860,2598,0,-16637,0,0,0,,16637,-16637
15,04-11-17,81,20:00,20:15,,1.63,0,1.63,1.63,-1,-5675,89700,95375,84025,0,-20266,0,0,0,,20266,-20266
15,04-11-17,82,20:15,20:30,,25.92,0,25.92,25.92,-1,-17489,45639,63128,28150,0,-14185,0,0,0,,14185,-14185
15,04-11-17,83,20:30,20:45,33.27,25.92,0,33.27,33.27,1,-45172,38261,83433,-6911,0,-227,765,0,0,,992,538
15,04-11-17,84,20:45,21:00,38.27,,0,38.27,38.27,1,-88170,35226,123396,-52944,0,0,9800,0,0,,9800,9800
15,04-11-17,85,21:00,21:15,249.21,,0,249.21,249.21,1,-88147,36823,124970,-51324,0,0,32206,0,0,,32206,32206
15,04-11-17,86,21:15,21:30,44.38,32.19,0,32.19,32.19,-1,-52580,53073,105653,493,0,-1,27786,0,0,,27787,27785
15,04-11-17,87,21:30,21:45,44.38,28.53,0,28.53,28.53,-1,-21887,68669,90556,46782,0,-1060,1681,0,0,,2741,621
15,04-11-17,88,21:45,22:00,,-43.2,0,-43.2,-43.2,-1,-25458,100260,125718,74802,0,-32020,0,0,0,,32020,-32020
15,04-11-17,89,22:00,22:15,32.92,-43.2,0,32.92,32.92,1,-126662,30445,157107,-96217,0,-9937,1762,0,0,,11699,-8175
15,04-11-17,90,22:15,22:30,32.92,,0,32.92,32.92,1,-101084,36141,137225,-64943,0,0,1754,0,0,,1754,1754
15,04-11-17,91,22:30,22:45,31.32,,0,31.32,31.32,1,-60303,44771,105074,-15532,0,0,984,0,0,,984,984
15,04-11-17,92,22:45,23:00,27.08,,0,27.08,27.08,1,-61345,58854,120199,-2491,0,0,621,0,0,,621,621
15,04-11-17,93,23:00,23:15,211.35,31.39,0,211.35,30.21,2,-128826,41002,169828,-87824,0,-195,13422,0,0,,13617,13227
15,04-11-17,94,23:15,23:30,32.92,,0,32.92,32.92,1,-72146,41296,113442,-30850,0,0,8608,0,0,,8608,8608
15,04-11-17,95,23:30,23:45,26.92,31.39,0,30.21,30.21,2,-40776,45967,86743,5191,0,-11,13,0,0,,24,2
15,04-11-17,96,23:45,0:00,,21.99,0,21.99,21.99,-1,-73023,63369,136392,-9654,0,-11739,0,0,0,,11739,-11739
15,04-12-17,1,0:00,0:15,36.2,21.99,0,36.2,36.2,1,-99098,84244,183342,-14854,0,-1793,3320,0,0,,5113,1527
15,04-12-17,2,0:15,0:30,36.8,,0,36.8,36.8,1,-60264,29701,89965,-30563,0,0,13090,0,0,,13090,13090
15,04-12-17,3,0:30,0:45,,,0,30.71,30.71,0,-46016,28909,74925,-17107,0,0,438,0,0,,438,438
15,04-12-17,4,0:45,1:00,,26.92,0,26.92,26.92,-1,-44211,51077,95288,6866,0,-2293,0,0,0,,2293,-2293
15,04-12-17,5,1:00,1:15,27.06,25.78,0,30.71,25.78,2,-43301,36906,80207,-6395,0,-3145,410,0,0,,3555,-2735
15,04-12-17,6,1:15,1:30,27.06,,0,27.06,27.06,1,-38001,25551,63552,-12450,0,0,1931,0,0,,1931,1931
15,04-12-17,7,1:30,1:45,,,0,30.71,30.71,0,-37487,48902,86389,11415,0,0,0,0,0,,0,0
15,04-12-17,8,1:45,2:00,,29.33,0,29.33,29.33,-1,-40197,57424,97621,17227,0,-715,0,0,0,,715,-715
15,04-12-17,9,2:00,2:15,41.22,29.36,0,41.22,41.22,1,-47916,18744,66660,-29172,0,-1677,3614,0,0,,5291,1937
15,04-12-17,10,2:15,2:30,76.28,,0,76.28,76.28,1,-55202,17239,72441,-37963,0,0,18896,0,0,,18896,18896
15,04-12-17,11,2:30,2:45,32.92,,0,32.92,32.92,1,-63271,20965,84236,-42306,0,0,2245,0,0,,2245,2245
15,04-12-17,12,2:45,3:00,38.92,,0,38.92,38.92,1,-62858,23398,86256,-39460,0,0,24038,0,0,,24038,24038
15,04-12-17,13,3:00,3:15,36.8,,0,36.8,36.8,1,-50711,17132,67843,-33579,0,0,20137,0,0,,20137,20137
15,04-12-17,14,3:15,3:30,37.59,,0,37.59,37.59,1,-54317,18142,72459,-36175,0,0,29766,0,0,,29766,29766
15,04-12-17,15,3:30,3:45,26.92,,0,26.92,26.92,1,-52317,29668,81985,-22649,0,0,6843,0,0,,6843,6843
15,04-12-17,16,3:45,4:00,26.92,,0,26.92,26.92,1,-49025,37026,86051,-11999,0,0,1620,0,0,,1620,1620
15,04-12-17,17,4:00,4:15,26.92,29.36,0,29.36,29.36,-1,-23319,43488,66807,20169,0,-1591,16,0,0,,1607,-1575
15,04-12-17,18,4:15,4:30,,33.2,0,33.2,33.2,-1,-25593,50198,75791,24605,0,-2219,0,0,0,,2219,-2219
15,04-12-17,19,4:30,4:45,26.92,32.5,0,30.71,30.71,2,-27158,46658,73816,19500,0,-2832,7,0,0,,2839,-2825
15,04-12-17,20,4:45,5:00,36.2,32.5,0,36.2,36.2,1,-32617,40338,72955,7721,0,-384,7483,0,0,,7867,7099
15,04-12-17,21,5:00,5:15,36.2,25.9,0,25.9,25.9,-1,-44812,53252,98064,8440,0,-7996,99,0,0,,8095,-7897
15,04-12-17,22,5:15,5:30,,26.92,0,26.92,26.92,-1,-41397,27873,69270,-13524,0,-13040,0,0,0,,13040,-13040
15,04-12-17,23,5:30,5:45,57.58,26.92,0,57.58,57.58,1,-75153,24389,99542,-50764,0,-562,5877,0,0,,6439,5315
15,04-12-17,24,5:45,6:00,117.46,,0,117.46,117.46,1,-102095,47833,149928,-54262,0,0,41723,0,0,,41723,41723
15,04-12-17,25,6:00,6:15,28.5,,0,28.5,28.5,1,-87949,41996,129945,-45953,0,0,3886,0,0,,3886,3886
15,04-12-17,26,6:15,6:30,32.42,,0,32.42,32.42,1,-70382,24320,94702,-46062,0,0,2532,0,0,,2532,2532
15,04-12-17,27,6:30,6:45,32.42,,0,32.42,32.42,1,-92656,38802,131458,-53854,0,0,2000,0,0,,2000,2000
15,04-12-17,28,6:45,7:00,32.42,,0,32.42,32.42,1,-135396,77460,212856,-57936,0,0,3029,0,0,,3029,3029
15,04-12-17,29,7:00,7:15,32.42,-53.27,0,-53.27,-53.27,-1,-43766,112695,156461,68929,0,-27646,452,0,0,,28098,-27194
15,04-12-17,30,7:15,7:30,,26.78,0,26.78,26.78,-1,-60963,47754,108717,-13209,0,-4321,0,0,0,,4321,-4321
15,04-12-17,31,7:30,7:45,147.02,,0,147.02,147.02,1,-72015,33199,105214,-38816,0,0,8873,0,0,,8873,8873
15,04-12-17,32,7:45,8:00,250,,0,250,250,1,-118982,57350,176332,-61632,0,0,60775,0,0,,60775,60775
15,04-12-17,33,8:00,8:15,250,-29.35,0,-29.35,-29.35,-1,-48122,80464,128586,32342,0,-8523,13102,0,0,,21625,4579
15,04-12-17,34,8:15,8:30,28.5,-29.35,0,28.5,28.5,1,-77626,38010,115636,-39616,0,-127,98,0,0,,225,-29
15,04-12-17,35,8:30,8:45,281.15,,0,281.15,281.15,1,-89176,20614,109790,-68562,0,0,27404,0,0,,27404,27404
15,04-12-17,36,8:45,9:00,50.9,,0,50.9,50.9,1,-84214,34864,119078,-49350,0,0,19848,0,0,,19848,19848
15,04-12-17,37,9:00,9:15,36.2,,0,36.2,36.2,1,-73079,73484,146563,405,0,0,3398,0,0,,3398,3398
15,04-12-17,38,9:15,9:30,30.04,,0,30.04,30.04,1,-70996,80263,151259,9267,0,0,3223,0,0,,3223,3223
15,04-12-17,39,9:30,9:45,30.04,27.46,0,27.46,27.46,-1,-58060,93565,151625,35505,0,-283,495,0,0,,778,212
15,04-12-17,40,9:45,10:00,,21.42,0,21.42,21.42,-1,-45495,106323,151818,60828,0,-4914,0,0,0,,4914,-4914
15,04-12-17,41,10:00,10:15,,21.42,0,21.42,21.42,-1,-53158,95366,148524,42208,0,-5200,0,0,0,,5200,-5200
15,04-12-17,42,10:15,10:30,,6.01,0,6.01,6.01,-1,-42038,103431,145469,61393,0,-11319,0,0,0,,11319,-11319
15,04-12-17,43,10:30,10:45,,6.01,0,6.01,6.01,-1,-61514,76266,137780,14752,0,-26929,0,0,0,,26929,-26929
15,04-12-17,44,10:45,11:00,28.42,6.01,0,28.42,28.42,1,-68022,70592,138614,2570,0,-2160,352,0,0,,2512,-1808
15,04-12-17,45,11:00,11:15,,25.42,0,25.42,25.42,-1,-73749,110976,184725,37227,0,-11492,0,0,0,,11492,-11492
15,04-12-17,46,11:15,11:30,,24.73,0,24.73,24.73,-1,-76324,104852,181176,28528,0,-15693,0,0,0,,15693,-15693
15,04-12-17,47,11:30,11:45,,23.42,0,23.42,23.42,-1,-81898,95407,177305,13509,0,-22735,0,0,0,,22735,-22735
15,04-12-17,48,11:45,12:00,,28.78,0,28.78,28.78,-1,-80268,95563,175831,15295,0,-13531,0,0,0,,13531,-13531
15,04-12-17,49,12:00,12:15,216.29,28.78,0,216.29,216.29,1,-108214,43585,151799,-64629,0,-4358,15960,0,0,,20318,11602
15,04-12-17,50,12:15,12:30,31.57,25.57,0,31.57,25.57,2,-65720,79718,145438,13998,0,-2617,5375,0,0,,7992,2758
15,04-12-17,51,12:30,12:45,,33.2,0,33.2,33.2,-1,-73780,63309,137089,-10471,0,-548,0,0,0,,548,-548
15,04-12-17,52,12:45,13:00,,28.97,0,28.97,28.97,-1,-70421,60708,131129,-9713,0,-242,0,0,0,,242,-242
15,04-12-17,53,13:00,13:15,,26.57,0,26.57,26.57,-1,-74785,46156,120941,-28629,0,-1555,0,0,0,,1555,-1555
15,04-12-17,54,13:15,13:30,,,0,30.54,30.54,0,-80058,37432,117490,-42626,0,0,0,0,0,,0,0
15,04-12-17,55,13:30,13:45,32.74,,0,32.74,32.74,1,-70272,33960,104232,-36312,0,0,3540,0,0,,3540,3540
15,04-12-17,56,13:45,14:00,,,0,30.54,30.54,0,-71333,36654,107987,-34679,0,0,201,0,0,,201,201
15,04-12-17,57,14:00,14:15,219.92,,0,219.92,219.92,1,-122953,39660,162613,-83293,0,0,16271,0,0,,16271,16271
15,04-12-17,58,14:15,14:30,219.92,,0,219.92,219.92,1,-115782,54926,170708,-60856,0,0,40952,0,0,,40952,40952
15,04-12-17,59,14:30,14:45,,,0,30.54,30.54,0,-101125,49907,151032,-51218,0,0,2068,0,0,,2068,2068
15,04-12-17,60,14:45,15:00,,,0,30.54,30.54,0,-100720,37803,138523,-62917,0,0,0,0,0,,0,0
15,04-12-17,61,15:00,15:15,,33.2,0,33.2,33.2,-1,-81490,77404,158894,-4086,0,-411,0,0,0,,411,-411
15,04-12-17,62,15:15,15:30,32.57,33.9,0,32.57,32.57,1,-82281,58862,141143,-23419,0,-167,937,0,0,,1104,770
15,04-12-17,63,15:30,15:45,32.57,,0,32.57,32.57,1,-82276,56143,138419,-26133,0,0,7290,0,0,,7290,7290
15,04-12-17,64,15:45,16:00,26.96,,0,26.96,26.96,1,-79488,66701,146189,-12787,0,0,4717,0,0,,4717,4717
15,04-12-17,65,16:00,16:15,31.57,,0,31.57,31.57,1,-80731,54533,135264,-26198,0,0,7352,0,0,,7352,7352
15,04-12-17,66,16:15,16:30,36.2,,0,36.2,36.2,1,-88200,38635,126835,-49565,0,0,15793,0,0,,15793,15793
15,04-12-17,67,16:30,16:45,33.28,,0,33.28,33.28,1,-83166,32042,115208,-51124,0,0,27275,0,0,,27275,27275
15,04-12-17,68,16:45,17:00,192.02,,0,192.02,192.02,1,-119095,42617,161712,-76478,0,0,41844,0,0,,41844,41844
15,04-12-17,69,17:00,17:15,32.57,,0,32.57,32.57,1,-84084,62917,147001,-21167,0,0,17914,0,0,,17914,17914
15,04-12-17,70,17:15,17:30,32.57,,0,32.57,32.57,1,-93832,62513,156345,-31319,0,0,5000,0,0,,5000,5000
15,04-12-17,71,17:30,17:45,73.12,,0,73.12,73.12,1,-98620,58715,157335,-39905,0,0,14735,0,0,,14735,14735
15,04-12-17,72,17:45,18:00,192.76,,0,192.76,192.76,1,-112274,72910,185184,-39364,0,0,49918,0,0,,49918,49918
15,04-12-17,73,18:00,18:15,64.06,,0,64.06,64.06,1,-146586,53665,200251,-92921,0,0,48884,0,0,,48884,48884
15,04-12-17,74,18:15,18:30,217.47,,0,217.47,217.47,1,-158106,60418,218524,-97688,0,0,44567,0,0,,44567,44567
15,04-12-17,75,18:30,18:45,217.47,,0,217.47,217.47,1,-186706,86206,272912,-100500,0,0,77538,0,0,,77538,77538
15,04-12-17,76,18:45,19:00,217.47,,0,217.47,217.47,1,-177547,128394,305941,-49153,0,0,69718,0,0,,69718,69718
15,04-12-17,77,19:00,19:15,85.27,,0,85.27,85.27,1,-172113,94911,267024,-77202,0,0,37132,0,0,,37132,37132
15,04-12-17,78,19:15,19:30,226.68,,0,226.68,226.68,1,-164164,95611,259775,-68553,0,0,43924,0,0,,43924,43924
15,04-12-17,79,19:30,19:45,58.12,,0,58.12,58.12,1,-144600,105687,250287,-38913,0,0,43616,0,0,,43616,43616
15,04-12-17,80,19:45,20:00,226.68,,0,226.68,226.68,1,-160354,98462,258816,-61892,0,0,47735,0,0,,47735,47735
15,04-12-17,81,20:00,20:15,47.12,-53.27,0,-53.27,-53.27,-1,-102773,149877,252650,47104,0,-10074,23684,0,0,,33758,13610
15,04-12-17,82,20:15,20:30,36.2,-53.27,0,36.2,36.2,1,-133634,106147,239781,-27487,0,-6579,1518,0,0,,8097,-5061
15,04-12-17,83,20:30,20:45,258.42,,0,258.42,258.42,1,-181174,78018,259192,-103156,0,0,47666,0,0,,47666,47666
15,04-12-17,84,20:45,21:00,258.42,,0,258.42,258.42,1,-178154,97706,275860,-80448,0,0,83702,0,0,,83702,83702
15,04-12-17,85,21:00,21:15,70.64,26.57,0,70.64,26.57,2,-118992,155588,274580,36596,0,-316,29432,6250,0,,35998,35366
15,04-12-17,86,21:15,21:30,,26.57,0,26.57,26.57,-1,-84869,142988,227857,58119,0,-823,0,0,0,,823,-823
15,04-12-17,87,21:30,21:45,,21.57,0,21.57,21.57,-1,-62531,114224,176755,51693,0,-7163,0,0,0,,7163,-7163
15,04-12-17,88,21:45,22:00,,21.57,0,21.57,21.57,-1,-65522,86598,152120,21076,0,-18537,0,0,0,,18537,-18537
15,04-12-17,89,22:00,22:15,,27.78,0,27.78,27.78,-1,-75435,94429,169864,18994,0,-8817,0,0,0,,8817,-8817
15,04-12-17,90,22:15,22:30,,25.57,0,25.57,25.57,-1,-54674,71606,126280,16932,0,-2497,0,0,0,,2497,-2497
15,04-12-17,91,22:30,22:45,,6.01,0,6.01,6.01,-1,-10491,57930,68421,47439,0,-9542,0,0,0,,9542,-9542
15,04-12-17,92,22:45,23:00,,6.01,0,6.01,6.01,-1,-17104,76175,93279,59071,0,-26954,0,0,0,,26954,-26954
15,04-12-17,93,23:00,23:15,189.07,7.78,0,189.07,189.07,1,-117416,29746,147162,-87670,0,-16721,9234,0,0,,25955,-7487
15,04-12-17,94,23:15,23:30,213.65,,0,213.65,213.65,1,-93489,49889,143378,-43600,0,0,42778,0,0,,42778,42778
15,04-12-17,95,23:30,23:45,26.57,28.97,0,30.54,28.97,2,-66279,60390,126669,-5889,0,-689,2712,0,0,,3401,2023
15,04-12-17,96,23:45,0:00,32.57,,0,32.57,32.57,1,-111717,68620,180337,-43097,0,0,2715,0,0,,2715,2715
15,04/13/2017,1,0:00,0:15,250,,0,250,250,1,-142330,63515,205845,-78815,0,0,9162,0,0,,9162,9162
15,04/13/2017,2,0:15,0:30,250,,0,250,250,1,-145333,76125,221458,-69208,0,0,53644,0,0,,53644,53644
15,04/13/2017,3,0:30,0:45,250,26.57,0,26.57,26.57,-1,-100634,95576,196210,-5058,0,-57,4250,0,0,,4307,4193
15,04/13/2017,4,0:45,1:00,,26.57,0,26.57,26.57,-1,-80437,90989,171426,10552,0,-398,0,0,0,,398,-398
15,04/13/2017,5,1:00,1:15,,26.57,0,26.57,26.57,-1,-49418,55580,104998,6162,0,-931,0,0,0,,931,-931
15,04/13/2017,6,1:15,1:30,,25.57,0,25.57,25.57,-1,-39708,59639,99347,19931,0,-321,0,0,0,,321,-321
15,04/13/2017,7,1:30,1:45,,25.57,0,25.57,25.57,-1,-52119,63398,115517,11279,0,-1749,0,0,0,,1749,-1749
15,04/13/2017,8,1:45,2:00,,33.5,0,33.5,33.5,-1,-49471,38843,88314,-10628,0,-970,0,0,0,,970,-970
15,04/13/2017,9,2:00,2:15,250,34,0,250,250,1,-101755,30245,132000,-71510,0,-161,23719,0,0,,23880,23558
15,04/13/2017,10,2:15,2:30,250,,0,250,250,1,-94946,73897,168843,-21049,0,0,40378,0,0,,40378,40378
15,04/13/2017,11,2:30,2:45,250,23.03,0,23.03,23.03,-1,-45805,74922,120727,29117,0,-6139,671,0,0,,6810,-5468
15,04/13/2017,12,2:45,3:00,,21.57,0,21.57,21.57,-1,-43105,72988,116093,29883,0,-13758,0,0,0,,13758,-13758
15,04/13/2017,13,3:00,3:15,250,26.57,0,250,250,1,-91874,61086,152960,-30788,0,-7015,5524,0,0,,12539,-1491
15,04/13/2017,14,3:15,3:30,250,26.57,0,250,250,1,-89439,75743,165182,-13696,0,-14,19975,0,0,,19989,19961
15,04/13/2017,15,3:30,3:45,32.57,,0,32.57,32.57,1,-70977,60083,131060,-10894,0,0,3348,0,0,,3348,3348
15,04/13/2017,16,3:45,4:00,30.02,,0,30.02,30.02,1,-62932,66685,129617,3753,0,0,4823,0,0,,4823,4823
15,04/13/2017,17,4:00,4:15,35.9,,0,35.9,35.9,1,-78994,57942,136936,-21052,0,0,7624,0,0,,7624,7624
15,04/13/2017,18,4:15,4:30,28.57,,0,28.57,28.57,1,-67157,56156,123313,-11001,0,0,7390,0,0,,7390,7390
15,04/13/2017,19,4:30,4:45,28.57,,0,28.57,28.57,1,-61453,52618,114071,-8835,0,0,6471,0,0,,6471,6471
15,04/13/2017,20,4:45,5:00,29.5,,0,29.5,29.5,1,-65981,53468,119449,-12513,0,0,3896,0,0,,3896,3896
15,04/13/2017,21,5:00,5:15,29.5,12.03,0,12.03,12.03,-1,-66308,98169,164477,31861,0,-9425,596,0,0,,10021,-8829
15,04/13/2017,22,5:15,5:30,,9.21,0,9.21,9.21,-1,-54532,48275,102807,-6257,0,-19759,0,0,0,,19759,-19759
15,04/13/2017,23,5:30,5:45,34.7,9.21,0,34.7,34.7,1,-53800,26686,80486,-27114,0,-651,1854,0,0,,2505,1203
15,04/13/2017,24,5:45,6:00,58.02,,0,58.02,58.02,1,-56058,15091,71149,-40967,0,0,33873,0,0,,33873,33873
15,04/13/2017,25,6:00,6:15,31.02,,0,31.02,31.02,1,-115985,69928,185913,-46057,0,0,12809,0,0,,12809,12809
15,04/13/2017,26,6:15,6:30,,,0,30.58,30.58,0,-62690,42320,105010,-20370,0,0,0,0,0,,0,0
15,04/13/2017,27,6:30,6:45,28.65,,0,28.65,28.65,1,-47526,39580,87106,-7946,0,0,1430,0,0,,1430,1430
15,04/13/2017,28,6:45,7:00,31.04,,0,31.04,31.04,1,-92964,54627,147591,-38337,0,0,1962,0,0,,1962,1962
15,04/13/2017,29,7:00,7:15,31.04,-52.92,0,-52.92,-52.92,-1,-23788,130153,153941,106365,0,-36149,65,0,0,,36214,-36084
15,04/13/2017,30,7:15,7:30,,21.65,0,21.65,21.65,-1,-27361,88368,115729,61007,0,-35669,0,0,0,,35669,-35669
15,04/13/2017,31,7:30,7:45,32.65,21.65,0,32.65,32.65,1,-60217,81353,141570,21136,0,-7914,174,0,0,,8088,-7740
15,04/13/2017,32,7:45,8:00,,,0,30.95,30.95,0,-94921,98204,193125,3283,0,0,0,0,0,,0,0
15,04/13/2017,33,8:00,8:15,,,0,31.48,31.48,0,-57792,71353,129145,13561,0,0,0,0,0,,0,0
15,04/13/2017,34,8:15,8:30,32.04,,0,32.04,32.04,1,-61570,52952,114522,-8618,0,0,1684,0,0,,1684,1684
15,04/13/2017,35,8:30,8:45,32.16,,0,32.16,32.16,1,-79750,41509,121259,-38241,0,0,1860,0,0,,1860,1860
15,04/13/2017,36,8:45,9:00,37.04,,0,37.04,37.04,1,-95683,43090,138773,-52593,0,0,16037,0,0,,16037,16037
15,04/13/2017,37,9:00,9:15,74.02,,0,74.02,74.02,1,-51196,32092,83288,-19104,0,0,26632,0,0,,26632,26632
15,04/13/2017,38,9:15,9:30,35,,0,35,35,1,-52260,31604,83864,-20656,0,0,12034,0,0,,12034,12034
15,04/13/2017,39,9:30,9:45,35.9,,0,35.9,35.9,1,-60008,28931,88939,-31077,0,0,10049,0,0,,10049,10049
15,04/13/2017,40,9:45,10:00,32.62,,0,32.62,32.62,1,-59544,41889,101433,-17655,0,0,7892,0,0,,7892,7892
15,04/13/2017,41,10:00,10:15,31.95,,0,31.95,31.95,1,-55526,49758,105284,-5768,0,0,1966,0,0,,1966,1966
15,04/13/2017,42,10:15,10:30,35,,0,35,35,1,-56630,36485,93115,-20145,0,0,6244,0,0,,6244,6244
15,04/13/2017,43,10:30,10:45,35,,0,35,35,1,-57108,40471,97579,-16637,0,0,2052,0,0,,2052,2052
15,04/13/2017,44,10:45,11:00,35,,0,35,35,1,-56424,55881,112305,-543,0,0,1621,0,0,,1621,1621
15,04/13/2017,45,11:00,11:15,,,0,31.43,31.43,0,-40522,40448,80970,-74,0,0,0,0,0,,0,0
15,04/13/2017,46,11:15,11:30,,,0,31.43,31.43,0,-42263,64806,107069,22543,0,0,0,0,0,,0,0
15,04/13/2017,47,11:30,11:45,,,0,31.43,31.43,0,-37341,63656,100997,26315,0,0,0,0,0,,0,0
15,04/13/2017,48,11:45,12:00,,,0,31.43,31.43,0,-32525,72955,105480,40430,0,0,0,0,0,,0,0
15,04/13/2017,49,12:00,12:15,48.02,,0,48.02,48.02,1,-125063,102597,227660,-22466,0,0,7276,0,0,,7276,7276
15,04/13/2017,50,12:15,12:30,48.02,17.8,0,17.8,17.8,-1,-108099,132508,240607,24409,0,-1168,13042,0,0,,14210,11874
15,04/13/2017,51,12:30,12:45,48.02,-29,0,-29,-29,-1,-82051,159807,241858,77756,0,-49559,103,0,0,,49662,-49456
15,04/13/2017,52,12:45,13:00,,-9.24,0,-9.24,-9.24,-1,-88005,161763,249768,73758,0,-44393,0,0,0,,44393,-44393
15,04/13/2017,53,13:00,13:15,,-29,0,-29,-29,-1,-86836,146721,233557,59885,0,-43790,0,0,0,,43790,-43790
15,04/13/2017,54,13:15,13:30,,4.84,0,4.84,4.84,-1,-90189,140237,230426,50048,0,-12000,0,0,0,,12000,-12000
15,04/13/2017,55,13:30,13:45,,4.84,0,4.84,4.84,-1,-102012,136590,238602,34578,0,-35748,0,0,0,,35748,-35748
15,04/13/2017,56,13:45,14:00,,27.16,0,27.16,27.16,-1,-114743,141124,255867,26381,0,-9578,0,0,0,,9578,-9578
15,04/13/2017,57,14:00,14:15,,27.03,0,27.03,27.03,-1,-113463,166853,280316,53390,0,-1651,0,0,0,,1651,-1651
15,04/13/2017,58,14:15,14:30,,25.65,0,25.65,25.65,-1,-102922,157663,260585,54741,0,-2974,0,0,0,,2974,-2974
15,04/13/2017,59,14:30,14:45,,19.99,0,19.99,19.99,-1,-98774,167632,266406,68858,0,-10378,0,0,0,,10378,-10378
15,04/13/2017,60,14:45,15:00,,17.8,0,17.8,17.8,-1,-95479,172297,267776,76818,0,-28979,0,0,0,,28979,-28979
15,04/13/2017,61,15:00,15:15,,21.65,0,21.65,21.65,-1,-84175,178849,263024,94674,0,-33490,0,0,0,,33490,-33490
15,04/13/2017,62,15:15,15:30,,17.8,0,17.8,17.8,-1,-82086,165600,247686,83514,0,-47371,0,0,0,,47371,-47371
15,04/13/2017,63,15:30,15:45,,25.65,0,25.65,25.65,-1,-87390,156805,244195,69415,0,-33275,0,0,0,,33275,-33275
15,04/13/2017,64,15:45,16:00,,16.65,0,16.65,16.65,-1,-81714,168377,250091,86663,0,-45690,0,0,0,,45690,-45690
15,04/13/2017,65,16:00,16:15,,21.65,0,21.65,21.65,-1,-103536,165451,268987,61915,0,-23273,0,0,0,,23273,-23273
15,04/13/2017,66,16:15,16:30,,26.25,0,26.25,26.25,-1,-94383,167773,262156,73390,0,-2590,0,0,0,,2590,-2590
15,04/13/2017,67,16:30,16:45,,26.25,0,26.25,26.25,-1,-91409,173657,265066,82248,0,-2784,0,0,0,,2784,-2784
15,04/13/2017,68,16:45,17:00,,26.65,0,26.65,26.65,-1,-95423,172543,267966,77120,0,-4385,0,0,0,,4385,-4385
15,04/13/2017,69,17:00,17:15,,25.08,0,25.08,25.08,-1,-100389,181660,282049,81271,0,-12491,0,0,0,,12491,-12491
15,04/13/2017,70,17:15,17:30,,33.5,0,33.5,33.5,-1,-104178,161736,265914,57558,0,-3468,0,0,0,,3468,-3468
15,04/13/2017,71,17:30,17:45,,,0,30.58,30.58,0,-104738,162278,267016,57540,0,-101,0,0,0,,101,-101
15,04/13/2017,72,17:45,18:00,,,0,30.58,30.58,0,-102728,159535,262263,56807,0,0,0,0,0,,0,0
15,04/13/2017,73,18:00,18:15,,6.36,0,6.36,6.36,-1,-87209,139845,227054,52636,0,-15047,0,0,0,,15047,-15047
15,04/13/2017,74,18:15,18:30,,25.65,0,25.65,25.65,-1,-82058,135471,217529,53413,0,-18672,0,0,0,,18672,-18672
15,04/13/2017,75,18:30,18:45,237.21,17.8,0,237.21,17.8,2,-106498,143859,250357,37361,0,-17026,849,0,0,,17875,-16177
15,04/13/2017,76,18:45,19:00,237.21,17.8,0,237.21,237.21,1,-254379,141791,396170,-112588,0,-1617,44013,0,0,,45630,42396
15,04/13/2017,77,19:00,19:15,35,,0,35,35,1,-227695,138171,365866,-89524,0,0,12777,0,0,,12777,12777
15,04/13/2017,78,19:15,19:30,,,0,31.43,31.43,0,-231045,148249,379294,-82796,0,0,0,0,0,,0,0
15,04/13/2017,79,19:30,19:45,53.02,,0,53.02,53.02,1,-249719,134228,383947,-115491,0,0,12011,0,0,,12011,12011
15,04/13/2017,80,19:45,20:00,257.15,,0,257.15,257.15,1,-257896,122848,380744,-135048,0,0,59775,0,0,,59775,59775
15,04/13/2017,81,20:00,20:15,257.15,-52.92,0,-52.92,-52.92,-1,-98529,153086,251615,54557,0,-13483,16560,0,0,,30043,3077
15,04/13/2017,82,20:15,20:30,,27.16,0,27.16,27.16,-1,-142498,121839,264337,-20659,0,-1991,0,0,0,,1991,-1991
15,04/13/2017,83,20:30,20:45,48.24,,0,48.24,48.24,1,-148946,94273,243219,-54673,0,0,1673,0,0,,1673,1673
15,04/13/2017,84,20:45,21:00,268.12,,0,268.12,268.12,1,-192918,87747,280665,-105171,0,0,50565,0,0,,50565,50565
15,04/13/2017,85,21:00,21:15,256.66,,0,256.66,256.66,1,-184270,74369,258639,-109901,0,0,84442,0,0,,84442,84442
15,04/13/2017,86,21:15,21:30,256.66,,0,256.66,256.66,1,-131175,82574,213749,-48601,0,0,68249,0,0,,68249,68249
15,04/13/2017,87,21:30,21:45,103.97,6.36,0,6.36,6.36,-1,-106427,137491,243918,31064,0,-7899,5710,13750,0,,27359,11561
15,04/13/2017,88,21:45,22:00,130.02,-9.24,0,130.02,-9.24,2,-149239,138808,288047,-10431,0,-29153,1000,0,0,,30153,-28153
15,04/13/2017,89,22:00,22:15,258.81,-9.24,0,258.81,258.81,1,-226422,75160,301582,-151262,0,-133,52329,0,0,,52462,52196
15,04/13/2017,90,22:15,22:30,258.81,,0,258.81,258.81,1,-179946,127874,307820,-52072,0,0,65955,0,0,,65955,65955
15,04/13/2017,91,22:30,22:45,30.34,,0,30.34,30.34,1,-166383,160839,327222,-5544,0,0,7886,0,0,,7886,7886
15,04/13/2017,92,22:45,23:00,48.02,,0,48.02,48.02,1,-166100,139368,305468,-26732,0,0,15513,0,0,,15513,15513
15,04/13/2017,93,23:00,23:15,251.12,,0,251.12,251.12,1,-217928,96608,314536,-121320,0,0,64275,0,0,,64275,64275
15,04/13/2017,94,23:15,23:30,251.12,,0,251.12,251.12,1,-173662,112978,286640,-60684,0,0,70596,0,0,,70596,70596
15,04/13/2017,95,23:30,23:45,44.77,,0,44.77,44.77,1,-155310,118792,274102,-36518,0,0,12996,0,0,,12996,12996
15,04/13/2017,96,23:45,0:00,251.12,,0,251.12,251.12,1,-163870,107544,271414,-56326,0,0,43438,0,0,,43438,43438
15,04/14/2017,1,0:00,0:15,26.61,-9.32,0,28.35,-9.32,2,-82739,195585,278324,112846,0,-17635,7678,0,0,,25313,-9957
15,04/14/2017,2,0:15,0:30,,25.78,0,25.78,25.78,-1,-43278,96000,139278,52722,0,-6204,0,0,0,,6204,-6204
15,04/14/2017,3,0:30,0:45,,27.08,0,27.08,27.08,-1,-42608,92313,134921,49705,0,-3731,0,0,0,,3731,-3731
15,04/14/2017,4,0:45,1:00,,6.28,0,6.28,6.28,-1,-60290,120177,180467,59887,0,-17294,0,0,0,,17294,-17294
15,04/14/2017,5,1:00,1:15,,25.61,0,25.61,25.61,-1,-160642,164626,325268,3984,0,-8732,0,0,0,,8732,-8732
15,04/14/2017,6,1:15,1:30,,,0,28.35,28.35,0,-135542,143934,279476,8392,0,0,0,0,0,,0,0
15,04/14/2017,7,1:30,1:45,,,0,28.35,28.35,0,-133823,137630,271453,3807,0,0,0,0,0,,0,0
15,04/14/2017,8,1:45,2:00,,17.72,0,17.72,17.72,-1,-136767,152476,289243,15709,0,-3791,0,0,0,,3791,-3791
15,04/14/2017,9,2:00,2:15,,16.61,0,16.61,16.61,-1,-115998,152158,268156,36160,0,-12521,0,0,0,,12521,-12521
15,04/14/2017,10,2:15,2:30,,14.9,0,14.9,14.9,-1,-120631,151556,272187,30925,0,-30438,0,0,0,,30438,-30438
15,04/14/2017,11,2:30,2:45,,21.61,0,21.61,21.61,-1,-127260,160509,287769,33249,0,-36328,0,0,0,,36328,-36328
15,04/14/2017,12,2:45,3:00,,21.61,0,21.61,21.61,-1,-133232,176819,310051,43587,0,-22806,0,0,0,,22806,-22806
15,04/14/2017,13,3:00,3:15,,21.23,0,21.23,21.23,-1,-69745,119512,189257,49767,0,-13820,0,0,0,,13820,-13820
15,04/14/2017,14,3:15,3:30,,,0,28.35,28.35,0,-76010,126147,202157,50137,0,-105,0,0,0,,105,-105
15,04/14/2017,15,3:30,3:45,,,0,28.35,28.35,0,-76828,127981,204809,51153,0,0,0,0,0,,0,0
15,04/14/2017,16,3:45,4:00,,,0,28.35,28.35,0,-72262,118916,191178,46654,0,0,0,0,0,,0,0
15,04/14/2017,17,4:00,4:15,,,0,28.35,28.35,0,-86067,93780,179847,7713,0,0,0,0,0,,0,0
15,04/14/2017,18,4:15,4:30,,26.61,0,26.61,26.61,-1,-80134,84128,164262,3994,0,-604,0,0,0,,604,-604
15,04/14/2017,19,4:30,4:45,,26.61,0,26.61,26.61,-1,-69034,76783,145817,7749,0,-3768,0,0,0,,3768,-3768
15,04/14/2017,20,4:45,5:00,,25.61,0,25.61,25.61,-1,-63958,78412,142370,14454,0,-4859,0,0,0,,4859,-4859
15,04/14/2017,21,5:00,5:15,,25.61,0,25.61,25.61,-1,-95444,90194,185638,-5250,0,-4915,0,0,0,,4915,-4915
15,04/14/2017,22,5:15,5:30,,21.61,0,21.61,21.61,-1,-72010,91574,163584,19564,0,-7882,0,0,0,,7882,-7882
15,04/14/2017,23,5:30,5:45,130.38,26.17,0,130.38,130.38,1,-107201,71546,178747,-35655,0,-4932,4801,0,0,,9733,-131
15,04/14/2017,24,5:45,6:00,275.22,,0,275.22,275.22,1,-89521,74504,164025,-15017,0,0,31295,0,0,,31295,31295
15,04/14/2017,25,6:00,6:15,275.22,17.72,0,17.72,17.72,-1,-103819,139502,243321,35683,0,-13039,788,0,0,,13827,-12251
15,04/14/2017,26,6:15,6:30,,24.09,0,24.09,24.09,-1,-97000,113120,210120,16120,0,-4064,0,0,0,,4064,-4064
15,04/14/2017,27,6:30,6:45,30.3,21.29,0,30.3,21.29,2,-111134,105386,216520,-5748,0,-6934,564,0,0,,7498,-6370
15,04/14/2017,28,6:45,7:00,30.95,21.29,0,30.95,30.95,1,-119980,110257,230237,-9723,0,-15,3553,0,0,,3568,3538
15,04/14/2017,29,7:00,7:15,32.07,26.29,0,32.07,26.29,2,-106197,106704,212901,507,0,-552,1179,0,0,,1731,627
15,04/14/2017,30,7:15,7:30,32.33,,0,32.33,32.33,1,-77546,81649,159195,4103,0,0,1981,0,0,,1981,1981
15,04/14/2017,31,7:30,7:45,57.22,,0,57.22,57.22,1,-87464,63881,151345,-23583,0,0,3720,0,0,,3720,3720
15,04/14/2017,32,7:45,8:00,275.22,,0,275.22,275.22,1,-114726,52964,167690,-61762,0,0,47045,0,0,,47045,47045
15,04/14/2017,33,8:00,8:15,31.76,26.69,0,31.76,26.69,2,-71336,121215,192551,49879,0,-232,11176,0,0,,11408,10944
15,04/14/2017,34,8:15,8:30,50.98,,0,50.98,50.98,1,-95663,63746,159409,-31917,0,0,18505,0,0,,18505,18505
15,04/14/2017,35,8:30,8:45,64.95,,0,64.95,64.95,1,-91048,46284,137332,-44764,0,0,27389,0,0,,27389,27389
15,04/14/2017,36,8:45,9:00,281.54,,0,281.54,281.54,1,-114617,42068,156685,-72549,0,0,56619,0,0,,56619,56619
15,04/14/2017,37,9:00,9:15,357.6,,0,357.6,357.6,1,-126131,42843,168974,-83288,0,0,67571,0,0,,67571,67571
15,04/14/2017,38,9:15,9:30,357.6,,0,357.6,357.6,1,-126720,42400,169120,-84320,0,0,79382,0,0,,79382,79382
15,04/14/2017,39,9:30,9:45,275.22,,0,275.22,275.22,1,-123640,56455,180095,-67185,0,0,71614,0,0,,71614,71614
15,04/14/2017,40,9:45,10:00,84.22,,0,84.22,84.22,1,-120382,53884,174266,-66498,0,0,53313,0,0,,53313,53313
15,04/14/2017,41,10:00,10:15,368.97,,0,368.97,368.97,1,-139135,56855,195990,-82280,0,0,61527,0,0,,61527,61527
15,04/14/2017,42,10:15,10:30,368.97,,0,368.97,368.97,1,-116623,65406,182029,-51217,0,0,65876,0,0,,65876,65876
15,04/14/2017,43,10:30,10:45,226.29,,0,226.29,226.29,1,-111024,63606,174630,-47418,0,0,24782,0,0,,24782,24782
15,04/14/2017,44,10:45,11:00,368.97,,0,368.97,368.97,1,-114380,55301,169681,-59079,0,0,52649,0,0,,52649,52649
15,04/14/2017,45,11:00,11:15,360.2,,0,360.2,360.2,1,-131348,15159,146507,-116189,0,0,63135,0,0,,63135,63135
15,04/14/2017,46,11:15,11:30,360.2,,0,360.2,360.2,1,-128095,13954,142049,-114141,0,0,84404,0,0,,84404,84404
15,04/14/2017,47,11:30,11:45,318.76,,0,318.76,318.76,1,-111334,29858,141192,-81476,0,0,79848,0,0,,79848,79848
15,04/14/2017,48,11:45,12:00,261.04,,0,261.04,261.04,1,-109100,45308,154408,-63792,0,0,47766,3750,0,,51516,51516
15,04/14/2017,49,12:00,12:15,48.31,,0,48.31,48.31,1,-109551,97233,206784,-12318,0,0,16047,0,0,,16047,16047
15,04/14/2017,50,12:15,12:30,63.45,,0,63.45,63.45,1,-101824,73134,174958,-28690,0,0,35826,0,0,,35826,35826
15,04/14/2017,51,12:30,12:45,32.29,,0,32.29,32.29,1,-93679,72896,166575,-20783,0,0,12858,0,0,,12858,12858
15,04/14/2017,52,12:45,13:00,243.38,,0,243.38,243.38,1,-89766,54312,144078,-35454,0,0,19794,0,0,,19794,19794
15,04/14/2017,53,13:00,13:15,275.22,,0,275.22,275.22,1,-266040,31938,297978,-234102,0,0,68468,0,0,,68468,68468
15,04/14/2017,54,13:15,13:30,275.22,,0,302.74,302.74,1,-228329,38747,267076,-189582,0,0,84961,17500,18173,,120634,120634
15,04/14/2017,55,13:30,13:45,275.22,,0,302.74,302.74,1,-186927,74719,261646,-112208,0,0,47743,17500,73285,,138528,138528
15,04/14/2017,56,13:45,14:00,32.91,,0,242.91,242.91,1,-167501,74979,242480,-92522,0,0,594,0,82279,,82873,82873
15,04/14/2017,57,14:00,14:15,43.77,,0,237.77,237.77,1,-158129,69948,228077,-88181,0,0,14611,0,58824,,73435,73435
15,04/14/2017,58,14:15,14:30,32.77,25.29,0,25.29,25.29,-1,-137985,79778,217763,-58207,0,-317,16740,0,58749,,75806,75172
15,04/14/2017,59,14:30,14:45,48.31,17.72,0,237.77,17.72,2,-101314,41687,143001,-59627,0,-10382,2071,0,41374,,53827,33063
15,04/14/2017,60,14:45,15:00,275.22,17.72,0,275.22,275.22,1,-134582,80097,214679,-54485,0,-51,42664,0,0,,42715,42613
15,04/14/2017,61,15:00,15:15,49.22,,0,49.22,49.22,1,-110957,74893,185850,-36064,0,0,38805,0,0,,38805,38805
15,04/14/2017,62,15:15,15:30,40.66,26.09,0,40.66,26.09,2,-70449,60205,130654,-10244,0,-1284,11813,0,0,,13097,10529
15,04/14/2017,63,15:30,15:45,48.31,,0,48.31,48.31,1,-75018,78730,153748,3712,0,0,13248,0,0,,13248,13248
15,04/14/2017,64,15:45,16:00,48.31,26.29,0,26.29,26.29,-1,-61218,90763,151981,29545,0,-334,239,0,0,,573,-95
15,04/14/2017,65,16:00,16:15,,-9.32,0,-9.32,-9.32,-1,-12969,194442,207411,181473,0,-32318,0,0,0,,32318,-32318
15,04/14/2017,66,16:15,16:30,,25.29,0,25.29,25.29,-1,-11106,137279,148385,126173,0,-15763,0,0,0,,15763,-15763
15,04/14/2017,67,16:30,16:45,,,0,28.19,28.19,0,-11350,134158,145508,122808,0,-22,0,0,0,,22,-22
15,04/14/2017,68,16:45,17:00,,-1.37,0,-1.37,-1.37,-1,-15921,126875,142796,110954,0,-16802,0,0,0,,16802,-16802
15,04/14/2017,69,17:00,17:15,,6.28,0,6.28,6.28,-1,-27051,101594,128645,74543,0,-44751,0,0,0,,44751,-44751
15,04/14/2017,70,17:15,17:30,,29.65,0,29.65,29.65,-1,-35694,63890,99584,28196,0,-5877,0,0,0,,5877,-5877
15,04/14/2017,71,17:30,17:45,,,0,28.19,28.19,0,-26547,61183,87730,34636,0,0,0,0,0,,0,0
15,04/14/2017,72,17:45,18:00,,,0,28.19,28.19,0,-27318,75235,102553,47917,0,0,0,0,0,,0,0
15,04/14/2017,73,18:00,18:15,,20.66,0,20.66,20.66,-1,-29803,54222,84025,24419,0,-4687,0,0,0,,4687,-4687
15,04/14/2017,74,18:15,18:30,,17.72,0,17.72,17.72,-1,-33858,62193,96051,28335,0,-20298,0,0,0,,20298,-20298
15,04/14/2017,75,18:30,18:45,,25,0,25,25,-1,-36809,73346,110155,36537,0,-16501,0,0,0,,16501,-16501
15,04/14/2017,76,18:45,19:00,,,0,28.5,28.5,0,-25109,79575,104684,54466,0,-4661,0,0,0,,4661,-4661
15,04/14/2017,77,19:00,19:15,,6.28,0,6.28,6.28,-1,-19375,63459,82834,44084,0,-11897,0,0,0,,11897,-11897
15,04/14/2017,78,19:15,19:30,,17.72,0,17.72,17.72,-1,-17716,86309,104025,68593,0,-26670,0,0,0,,26670,-26670
15,04/14/2017,79,19:30,19:45,,-1.37,0,-1.37,-1.37,-1,-27962,94867,122829,66905,0,-48996,0,0,0,,48996,-48996
15,04/14/2017,80,19:45,20:00,,21.29,0,21.29,21.29,-1,-36600,83526,120126,46926,0,-32696,0,0,0,,32696,-32696
15,04/14/2017,81,20:00,20:15,,25,0,25,25,-1,-56787,74005,130792,17218,0,-20806,0,0,0,,20806,-20806
15,04/14/2017,82,20:15,20:30,,,0,29.19,29.19,0,-67352,71202,138554,3850,0,-566,0,0,0,,566,-566
15,04/14/2017,83,20:30,20:45,,29.65,0,29.65,29.65,-1,-59109,58726,117835,-383,0,-126,0,0,0,,126,-126
15,04/14/2017,84,20:45,21:00,,29.65,0,29.65,29.65,-1,-62345,51069,113414,-11276,0,-82,0,0,0,,82,-82
15,04/14/2017,85,21:00,21:15,55.22,,0,55.22,55.22,1,-105546,69473,175019,-36073,0,0,10794,0,0,,10794,10794
15,04/14/2017,86,21:15,21:30,30.95,26.29,0,26.29,26.29,-1,-77719,81476,159195,3757,0,-52,5295,0,0,,5347,5243
15,04/14/2017,87,21:30,21:45,,21.29,0,21.29,21.29,-1,-58679,114424,173103,55745,0,-3374,0,0,0,,3374,-3374
15,04/14/2017,88,21:45,22:00,,-9.32,0,-9.32,-9.32,-1,-47146,104281,151427,57135,0,-29293,0,0,0,,29293,-29293
15,04/14/2017,89,22:00,22:15,56.44,25.29,0,56.44,25.29,2,-143978,50990,194968,-92988,0,-10419,4123,0,0,,14542,-6296
15,04/14/2017,90,22:15,22:30,27.45,,0,27.45,27.45,1,-88786,51930,140716,-36856,0,0,2214,0,0,,2214,2214
15,04/14/2017,91,22:30,22:45,,17.72,0,17.72,17.72,-1,-36126,94740,130866,58614,0,-4430,0,0,0,,4430,-4430
15,04/14/2017,92,22:45,23:00,,-29.08,0,-29.08,-29.08,-1,-20640,129653,150293,109013,0,-56341,0,0,0,,56341,-56341
15,04/14/2017,93,23:00,23:15,33.03,-9.32,0,33.03,-9.32,2,-139736,141925,281661,2189,0,-44479,189,0,0,,44668,-44290
15,04/14/2017,94,23:15,23:30,130.12,-9.32,0,130.12,130.12,1,-143618,57125,200743,-86493,0,-42,26911,0,0,,26953,26869
15,04/14/2017,95,23:30,23:45,33.03,,0,33.03,33.03,1,-115675,51151,166826,-64524,0,0,19634,0,0,,19634,19634
15,04/14/2017,96,23:45,0:00,33.03,24.09,0,24.09,24.09,-1,-61784,59949,121733,-1835,0,-2107,1107,0,0,,3214,-1000
16,04/15/2017,1,0:00,0:15,46.09,24.31,0,46.09,24.31,2,-94912,81734,176646,-13178,0,-8742,4116,0,0,,12858,-4626
16,04/15/2017,2,0:15,0:30,29.31,,0,29.31,29.31,1,-71918,58107,130025,-13811,0,0,1612,0,0,,1612,1612
16,04/15/2017,3,0:30,0:45,29.31,,0,29.31,29.31,1,-86482,73601,160083,-12881,0,0,226,0,0,,226,226
16,04/15/2017,4,0:45,1:00,29.45,27.73,0,29.45,27.73,2,-127908,119819,247727,-8089,0,-248,1014,0,0,,1262,766
16,04/15/2017,5,1:00,1:15,31.53,-67.9,0,31.53,-67.9,2,-32404,69983,102387,37579,0,-22167,201,0,0,,22368,-21966
16,04/15/2017,6,1:15,1:30,31.53,27.73,0,27.73,27.73,-1,-54834,69243,124077,14409,0,-4310,473,0,0,,4783,-3837
16,04/15/2017,7,1:30,1:45,,28.31,0,28.31,28.31,-1,-81471,71389,152860,-10082,0,-4467,0,0,0,,4467,-4467
16,04/15/2017,8,1:45,2:00,,27.73,0,27.73,27.73,-1,-80583,77086,157669,-3497,0,-11950,0,0,0,,11950,-11950
16,04/15/2017,9,2:00,2:15,46.09,28.31,0,46.09,28.26,2,-75806,57434,133240,-18372,0,-10406,4120,0,0,,14526,-6286
16,04/15/2017,10,2:15,2:30,57.02,28.31,0,57.02,57.02,1,-94999,62129,157128,-32870,0,-276,29109,0,0,,29385,28833
16,04/15/2017,11,2:30,2:45,35.31,,0,35.31,35.31,1,-101940,72975,174915,-28965,0,0,23933,0,0,,23933,23933
16,04/15/2017,12,2:45,3:00,127.67,,0,127.67,127.67,1,-125172,42722,167894,-82450,0,0,41688,0,0,,41688,41688
16,04/15/2017,13,3:00,3:15,127.49,,0,127.49,127.49,1,-147729,73653,221382,-74076,0,0,48938,0,0,,48938,48938
16,04/15/2017,14,3:15,3:30,46.09,,0,46.09,46.09,1,-126602,75876,202478,-50726,0,0,44019,0,0,,44019,44019
16,04/15/2017,15,3:30,3:45,33.6,,0,33.6,33.6,1,-110113,78652,188765,-31461,0,0,27072,0,0,,27072,27072
16,04/15/2017,16,3:45,4:00,30.36,11.68,0,11.68,11.68,-1,-75315,76855,152170,1540,0,-3145,11513,0,0,,14658,8368
16,04/15/2017,17,4:00,4:15,41.24,11.68,0,41.24,11.68,2,-86921,69509,156430,-17412,0,-4878,9020,0,0,,13898,4142
16,04/15/2017,18,4:15,4:30,32.5,,0,32.5,32.5,1,-92331,67378,159709,-24953,0,0,20852,0,0,,20852,20852
16,04/15/2017,19,4:30,4:45,32.5,,0,32.5,32.5,1,-84924,65250,150174,-19674,0,0,22484,0,0,,22484,22484
16,04/15/2017,20,4:45,5:00,29.31,,0,29.31,29.31,1,-64899,49083,113982,-15816,0,0,7482,0,0,,7482,7482
16,04/15/2017,21,5:00,5:15,,29.68,0,29.68,29.68,-1,-53250,74193,127443,20943,0,-25,0,0,0,,25,-25
16,04/15/2017,22,5:15,5:30,29.31,29.31,0,29.31,28.37,2,-67941,62394,130335,-5547,0,-695,10,0,0,,705,-685
16,04/15/2017,23,5:30,5:45,33.6,,0,33.6,33.6,1,-72466,64374,136840,-8092,0,0,5714,0,0,,5714,5714
16,04/15/2017,24,5:45,6:00,37.02,,0,37.02,37.02,1,-105496,79666,185162,-25830,0,0,14508,0,0,,14508,14508
16,04/15/2017,25,6:00,6:15,29.45,29.68,0,29.68,29.68,-1,-84861,116273,201134,31412,0,-109,6748,0,0,,6857,6639
16,04/15/2017,26,6:15,6:30,29.45,19.37,0,19.37,19.37,-1,-77449,123385,200834,45936,0,-7053,3,0,0,,7056,-7050
16,04/15/2017,27,6:30,6:45,,12.26,0,12.26,12.26,-1,-51001,121477,172478,70476,0,-30502,0,0,0,,30502,-30502
16,04/15/2017,28,6:45,7:00,,-0.97,0,-0.97,-0.97,-1,-52736,112413,165149,59677,0,-33086,0,0,0,,33086,-33086
16,04/15/2017,29,7:00,7:15,,2.07,0,2.07,2.07,-1,-61724,102841,164565,41117,0,-36264,0,0,0,,36264,-36264
16,04/15/2017,30,7:15,7:30,,6.03,0,6.03,6.03,-1,-36679,84944,121623,48265,0,-39428,0,0,0,,39428,-39428
16,04/15/2017,31,7:30,7:45,31.37,28.37,0,31.37,31.37,1,-52987,58816,111803,5829,0,-9974,128,0,0,,10102,-9846
16,04/15/2017,32,7:45,8:00,31.53,,0,31.53,31.53,1,-59396,74656,134052,15260,0,0,3749,0,0,,3749,3749
16,04/15/2017,33,8:00,8:15,,,0,27.4,27.4,0,-58332,42989,101321,-15343,0,0,0,0,0,,0,0
16,04/15/2017,34,8:15,8:30,,,0,27.4,27.4,0,-45213,61909,107122,16696,0,0,0,0,0,,0,0
16,04/15/2017,35,8:30,8:45,36.55,,0,36.55,36.55,1,-62566,43490,106056,-19076,0,0,2915,0,0,,2915,2915
16,04/15/2017,36,8:45,9:00,47.55,,0,47.55,47.55,1,-106843,49229,156072,-57614,0,0,34321,0,0,,34321,34321
16,04/15/2017,37,9:00,9:15,48.02,,0,48.02,48.02,1,-89435,36610,126045,-52825,0,0,43959,0,0,,43959,43959
16,04/15/2017,38,9:15,9:30,48.02,,0,48.02,48.02,1,-73403,34606,108009,-38797,0,0,32475,0,0,,32475,32475
16,04/15/2017,39,9:30,9:45,37.02,,0,37.02,37.02,1,-67862,46032,113894,-21830,0,0,29291,0,0,,29291,29291
16,04/15/2017,40,9:45,10:00,32.02,,0,32.02,32.02,1,-73869,54313,128182,-19556,0,0,3818,0,0,,3818,3818
16,04/15/2017,41,10:00,10:15,32.36,,0,32.36,32.36,1,-81664,53650,135314,-28014,0,0,4245,0,0,,4245,4245
16,04/15/2017,42,10:15,10:30,36.6,,0,36.6,36.6,1,-78862,57289,136151,-21573,0,0,9972,0,0,,9972,9972
16,04/15/2017,43,10:30,10:45,36.6,26.31,0,26.31,26.31,-1,-71224,81959,153183,10735,0,-4018,895,0,0,,4913,-3123
16,04/15/2017,44,10:45,11:00,,8.01,0,8.01,8.01,-1,-55221,104185,159406,48964,0,-22949,0,0,0,,22949,-22949
16,04/15/2017,45,11:00,11:15,,24.03,0,24.03,24.03,-1,-58931,70602,129533,11671,0,-28170,0,0,0,,28170,-28170
16,04/15/2017,46,11:15,11:30,,29.37,0,29.37,29.37,-1,-58136,62752,120888,4616,0,-6455,0,0,0,,6455,-6455
16,04/15/2017,47,11:30,11:45,,29.29,0,29.29,29.29,-1,-46986,67069,114055,20083,0,-3253,0,0,0,,3253,-3253
16,04/15/2017,48,11:45,12:00,,,0,29.36,29.36,0,-49453,69271,118724,19818,0,-397,0,0,0,,397,-397
16,04/15/2017,49,12:00,12:15,,,0,29.36,29.36,0,-47840,83216,131056,35376,0,0,0,0,0,,0,0
16,04/15/2017,50,12:15,12:30,,,0,29.36,29.36,0,-40754,110564,151318,69810,0,0,0,0,0,,0,0
16,04/15/2017,51,12:30,12:45,,-60.59,0,-60.59,-60.59,-1,-35828,145733,181561,109905,0,-32450,0,0,0,,32450,-32450
16,04/15/2017,52,12:45,13:00,,19.37,0,19.37,19.37,-1,-36488,98156,134644,61668,0,-19820,0,0,0,,19820,-19820
16,04/15/2017,53,13:00,13:15,,23.65,0,23.65,23.65,-1,-48960,199820,248780,150860,0,-8292,0,0,0,,8292,-8292
16,04/15/2017,54,13:15,13:30,,26.31,0,26.31,26.31,-1,-46489,171143,217632,124654,0,-7764,0,0,0,,7764,-7764
16,04/15/2017,55,13:30,13:45,,29.37,0,29.37,29.37,-1,-47537,150730,198267,103193,0,-2803,0,0,0,,2803,-2803
16,04/15/2017,56,13:45,14:00,,29.68,0,29.68,29.68,-1,-43923,147706,191629,103783,0,-1211,0,0,0,,1211,-1211
16,04/15/2017,57,14:00,14:15,,,0,26.97,26.97,0,-54788,107361,162149,52573,0,0,0,0,0,,0,0
16,04/15/2017,58,14:15,14:30,,,0,26.96,26.96,0,-58512,106286,164798,47774,0,0,0,0,0,,0,0
16,04/15/2017,59,14:30,14:45,,,0,26.96,26.96,0,-64909,86556,151465,21647,0,0,0,0,0,,0,0
16,04/15/2017,60,14:45,15:00,,,0,26.96,26.96,0,-70646,89992,160638,19346,0,0,0,0,0,,0,0
16,04/15/2017,61,15:00,15:15,29.37,,0,29.37,29.37,1,-60075,56217,116292,-3858,0,0,395,0,0,,395,395
16,04/15/2017,62,15:15,15:30,29.37,,0,29.37,29.37,1,-55727,63473,119200,7746,0,0,1135,0,0,,1135,1135
16,04/15/2017,63,15:30,15:45,32.49,,0,32.49,32.49,1,-55562,51101,106663,-4461,0,0,2055,0,0,,2055,2055
16,04/15/2017,64,15:45,16:00,40.14,,0,40.14,40.14,1,-65290,43541,108831,-21749,0,0,23408,0,0,,23408,23408
16,04/15/2017,65,16:00,16:15,29.37,28.64,0,28.64,28.64,-1,-48895,79708,128603,30813,0,-432,9444,0,0,,9876,9012
16,04/15/2017,66,16:15,16:30,,,0,26.83,26.83,0,-51169,75421,126590,24252,0,-106,0,0,0,,106,-106
16,04/15/2017,67,16:30,16:45,28.49,,0,28.49,28.49,1,-49860,54692,104552,4832,0,0,1,0,0,,1,1
16,04/15/2017,68,16:45,17:00,28.61,,0,28.61,28.61,1,-47994,45458,93452,-2536,0,0,1313,0,0,,1313,1313
16,04/15/2017,69,17:00,17:15,28.49,,0,28.49,28.49,1,-52702,122478,175180,69776,0,0,242,0,0,,242,242
16,04/15/2017,70,17:15,17:30,,,0,26.82,26.82,0,-34699,92300,126999,57601,0,0,0,0,0,,0,0
16,04/15/2017,71,17:30,17:45,,27.73,0,27.73,27.73,-1,-35797,80929,116726,45132,0,-1352,0,0,0,,1352,-1352
16,04/15/2017,72,17:45,18:00,,29.37,0,29.37,29.37,-1,-31354,74213,105567,42859,0,-1341,0,0,0,,1341,-1341
16,04/15/2017,73,18:00,18:15,,15.28,0,15.28,15.28,-1,-45986,97509,143495,51523,0,-20944,0,0,0,,20944,-20944
16,04/15/2017,74,18:15,18:30,,27.03,0,27.03,27.03,-1,-58646,78045,136691,19399,0,-8580,0,0,0,,8580,-8580
16,04/15/2017,75,18:30,18:45,,,0,26.84,26.84,0,-55331,69750,125081,14419,0,-38,0,0,0,,38,-38
16,04/15/2017,76,18:45,19:00,29.45,,0,29.45,29.45,1,-59414,56382,115796,-3032,0,0,237,0,0,,237,237
16,04/15/2017,77,19:00,19:15,29.45,,0,29.45,29.45,1,-58910,53305,112215,-5605,0,0,1716,0,0,,1716,1716
16,04/15/2017,78,19:15,19:30,29.45,,0,29.45,29.45,1,-53433,42621,96054,-10812,0,0,605,0,0,,605,605
16,04/15/2017,79,19:30,19:45,130.02,,0,130.02,130.02,1,-77971,25311,103282,-52660,0,0,21967,0,0,,21967,21967
16,04/15/2017,80,19:45,20:00,184.37,,0,184.37,184.37,1,-55373,47922,103295,-7451,0,0,45366,0,0,,45366,45366
16,04/15/2017,81,20:00,20:15,184.37,18.71,0,18.71,18.71,-1,-35262,80868,116130,45606,0,-3907,2568,0,0,,6475,-1339
16,04/15/2017,82,20:15,20:30,28.8,30.31,0,28.8,28.8,1,-39452,46740,86192,7288,0,-58,118,0,0,,176,60
16,04/15/2017,83,20:30,20:45,32.6,,0,32.6,32.6,1,-59614,64127,123741,4513,0,0,2271,0,0,,2271,2271
16,04/15/2017,84,20:45,21:00,211.36,,0,211.36,211.36,1,-103087,50001,153088,-53086,0,0,20729,0,0,,20729,20729
16,04/15/2017,85,21:00,21:15,43,,0,43,43,1,-71619,84421,156040,12802,0,0,18681,0,0,,18681,18681
16,04/15/2017,86,21:15,21:30,43,29.37,0,29.37,29.37,-1,-59337,67047,126384,7710,0,-55,239,0,0,,294,184
16,04/15/2017,87,21:30,21:45,,27.73,0,27.73,27.73,-1,-58237,80989,139226,22752,0,-4432,0,0,0,,4432,-4432
16,04/15/2017,88,21:45,22:00,,24.31,0,24.31,24.31,-1,-54164,95001,149165,40837,0,-16823,0,0,0,,16823,-16823
16,04/15/2017,89,22:00,22:15,,23.65,0,23.65,23.65,-1,-61007,81880,142887,20873,0,-14324,0,0,0,,14324,-14324
16,04/15/2017,90,22:15,22:30,,28.64,0,28.64,28.64,-1,-44222,88547,132769,44325,0,-2005,0,0,0,,2005,-2005
16,04/15/2017,91,22:30,22:45,,28.64,0,28.64,28.64,-1,-39257,52331,91588,13074,0,-909,0,0,0,,909,-909
16,04/15/2017,92,22:45,23:00,,26.56,0,26.56,26.56,-1,-27595,47182,74777,19587,0,-3093,0,0,0,,3093,-3093
16,04/15/2017,93,23:00,23:15,,29.37,0,29.37,29.37,-1,-64411,31643,96054,-32768,0,-1261,0,0,0,,1261,-1261
16,04/15/2017,94,23:15,23:30,,28.37,0,28.37,28.37,-1,-35658,33020,68678,-2638,0,-1284,0,0,0,,1284,-1284
16,04/15/2017,95,23:30,23:45,28.49,29.68,0,29.36,29.36,2,-39900,30097,69997,-9803,0,-205,474,0,0,,679,269
16,04/15/2017,96,23:45,0:00,28.49,27.73,0,27.73,27.73,-1,-50133,46517,96650,-3616,0,-5669,1,0,0,,5670,-5668
16,04/16/2017,1,0:00,0:15,83.12,29.37,0,83.12,83.12,1,-27516,68197,95713,40681,0,-1479,10370,0,0,,11849,8891
16,04/16/2017,2,0:15,0:30,92.38,,0,92.38,92.38,1,-18214,84869,103083,66655,0,0,22543,0,0,,22543,22543
16,04/16/2017,3,0:30,0:45,92.38,29.37,0,29.37,29.37,-1,-21965,97789,119754,75824,0,-311,1264,0,0,,1575,953
16,04/16/2017,4,0:45,1:00,,28.37,0,28.37,28.37,-1,-28425,115018,143443,86593,0,-3675,0,0,0,,3675,-3675
16,04/16/2017,5,1:00,1:15,,24.09,0,24.09,24.09,-1,-50040,87673,137713,37633,0,-4169,0,0,0,,4169,-4169
16,04/16/2017,6,1:15,1:30,,17.75,0,17.75,17.75,-1,-36370,81064,117434,44694,0,-27519,0,0,0,,27519,-27519
16,04/16/2017,7,1:30,1:45,,24.09,0,24.09,24.09,-1,-25321,76765,102086,51444,0,-27165,0,0,0,,27165,-27165
16,04/16/2017,8,1:45,2:00,,6.31,0,6.31,6.31,-1,-27002,90915,117917,63913,0,-48933,0,0,0,,48933,-48933
16,04/16/2017,9,2:00,2:15,,2.78,0,2.78,2.78,-1,-27402,108379,135781,80977,0,-65134,0,0,0,,65134,-65134
16,04/16/2017,10,2:15,2:30,,-29.05,0,-29.05,-29.05,-1,-18026,98223,116249,80197,0,-72698,0,0,0,,72698,-72698
16,04/16/2017,11,2:30,2:45,,2.78,0,2.78,2.78,-1,-18681,88408,107089,69727,0,-67642,0,0,0,,67642,-67642
16,04/16/2017,12,2:45,3:00,,-29.05,0,-29.05,-29.05,-1,-21186,108191,129377,87005,0,-66889,0,0,0,,66889,-66889
16,04/16/2017,13,3:00,3:15,,-29.05,0,-29.05,-29.05,-1,-30845,110388,141233,79543,0,-79269,0,0,0,,79269,-79269
16,04/16/2017,14,3:15,3:30,,19,0,19,19,-1,-39360,86758,126118,47398,0,-51183,0,0,0,,51183,-51183
16,04/16/2017,15,3:30,3:45,,24.37,0,24.37,24.37,-1,-25773,82331,108104,56558,0,-30732,0,0,0,,30732,-30732
16,04/16/2017,16,3:45,4:00,,-9.29,0,-9.29,-9.29,-1,-23926,82571,106497,58645,0,-46299,0,0,0,,46299,-46299
16,04/16/2017,17,4:00,4:15,,-52.97,0,-52.97,-52.97,-1,-11833,83714,95547,71881,0,-38266,0,0,0,,38266,-38266
16,04/16/2017,18,4:15,4:30,,,0,27.88,27.88,0,-13560,83995,97555,70435,0,-163,0,0,0,,163,-163
16,04/16/2017,19,4:30,4:45,,,0,27.88,27.88,0,-7462,76212,83674,68750,0,0,0,0,0,,0,0
16,04/16/2017,20,4:45,5:00,,,0,27.88,27.88,0,-7757,70487,78244,62730,0,0,0,0,0,,0,0
16,04/16/2017,21,5:00,5:15,,6.31,0,6.31,6.31,-1,-14945,86189,101134,71244,0,-10858,0,0,0,,10858,-10858
16,04/16/2017,22,5:15,5:30,,27.83,0,27.83,27.83,-1,-13577,61052,74629,47475,0,-12424,0,0,0,,12424,-12424
16,04/16/2017,23,5:30,5:45,,24.37,0,24.37,24.37,-1,-22213,48272,70485,26059,0,-23578,0,0,0,,23578,-23578
16,04/16/2017,24,5:45,6:00,,28.37,0,28.37,28.37,-1,-25908,69870,95778,43962,0,-10031,0,0,0,,10031,-10031
16,04/16/2017,25,6:00,6:15,,,0,27.86,27.86,0,-29953,96553,126506,66600,0,-888,0,0,0,,888,-888
16,04/16/2017,26,6:15,6:30,,,0,27.86,27.86,0,-28839,58209,87048,29370,0,0,0,0,0,,0,0
16,04/16/2017,27,6:30,6:45,,27.78,0,27.78,27.78,-1,-39199,70603,109802,31404,0,-2239,0,0,0,,2239,-2239
16,04/16/2017,28,6:45,7:00,,26.49,0,26.49,26.49,-1,-33118,87224,120342,54106,0,-3919,0,0,0,,3919,-3919
16,04/16/2017,29,7:00,7:15,,26.49,0,26.49,26.49,-1,-25587,58991,84578,33404,0,-2176,0,0,0,,2176,-2176
16,04/16/2017,30,7:15,7:30,,,0,27.76,27.76,0,-31972,46260,78232,14288,0,0,0,0,0,,0,0
16,04/16/2017,31,7:30,7:45,41.59,,0,41.59,41.59,1,-61415,40774,102189,-20641,0,0,4676,0,0,,4676,4676
16,04/16/2017,32,7:45,8:00,61.32,,0,61.32,61.32,1,-61662,60764,122426,-898,0,0,32545,0,0,,32545,32545
16,04/16/2017,33,8:00,8:15,61.32,29.68,0,29.68,29.68,-1,-41613,75903,117516,34290,0,-364,2688,0,0,,3052,2324
16,04/16/2017,34,8:15,8:30,,29.68,0,29.68,29.68,-1,-26504,59401,85905,32897,0,-540,0,0,0,,540,-540
16,04/16/2017,35,8:30,8:45,130.12,,0,130.12,130.12,1,-90737,54878,145615,-35859,0,0,9303,0,0,,9303,9303
16,04/16/2017,36,8:45,9:00,130.12,,0,130.12,130.12,1,-75774,82004,157778,6230,0,0,22779,0,0,,22779,22779
16,04/16/2017,37,9:00,9:15,44.9,,0,44.9,44.9,1,-90329,53619,143948,-36710,0,0,7782,0,0,,7782,7782
16,04/16/2017,38,9:15,9:30,59.12,,0,59.12,59.12,1,-112780,72941,185721,-39839,0,0,36761,0,0,,36761,36761
16,04/16/2017,39,9:30,9:45,35.37,,0,35.37,35.37,1,-113309,72734,186043,-40575,0,0,22622,0,0,,22622,22622
16,04/16/2017,40,9:45,10:00,41.37,,0,41.37,41.37,1,-122586,68126,190712,-54460,0,0,34924,0,0,,34924,34924
16,04/16/2017,41,10:00,10:15,39.59,,0,39.59,39.59,1,-96544,75862,172406,-20682,0,0,33114,0,0,,33114,33114
16,04/16/2017,42,10:15,10:30,35.37,,0,35.37,35.37,1,-99079,75418,174497,-23661,0,0,9672,0,0,,9672,9672
16,04/16/2017,43,10:30,10:45,41.37,28.37,0,41.37,27.79,2,-81681,82937,164618,1256,0,-26,19260,0,0,,19286,19234
16,04/16/2017,44,10:45,11:00,29.37,24.37,0,29.37,24.37,2,-82897,84998,167895,2101,0,-5368,2311,0,0,,7679,-3057
16,04/16/2017,45,11:00,11:15,152.42,24.37,0,152.42,152.42,1,-99097,51226,150323,-47871,0,-42,26160,0,0,,26202,26118
16,04/16/2017,46,11:15,11:30,41.37,24.37,0,24.37,24.37,-1,-71458,70223,141681,-1235,0,-603,21877,0,0,,22480,21274
16,04/16/2017,47,11:30,11:45,41.37,11.23,0,11.23,11.23,-1,-52477,75539,128016,23062,0,-20957,285,0,0,,21242,-20672
16,04/16/2017,48,11:45,12:00,,19.37,0,19.37,19.37,-1,-53308,76273,129581,22965,0,-14899,0,0,0,,14899,-14899
16,04/16/2017,49,12:00,12:15,29.45,19.37,0,29.45,29.45,1,-69508,76005,145513,6497,0,-14506,667,0,0,,15173,-13839
16,04/16/2017,50,12:15,12:30,29.45,-9.29,0,-9.29,-9.29,-1,-37283,75441,112724,38158,0,-21649,346,0,0,,21995,-21303
16,04/16/2017,51,12:30,12:45,,-9.29,0,-9.29,-9.29,-1,-33402,86166,119568,52764,0,-26106,0,0,0,,26106,-26106
16,04/16/2017,52,12:45,13:00,,-9.29,0,-9.29,-9.29,-1,-38823,65398,104221,26575,0,-45480,0,0,0,,45480,-45480
16,04/16/2017,53,13:00,13:15,,,0,30.15,30.15,0,-44221,64420,108641,20199,0,-5673,0,0,0,,5673,-5673
16,04/16/2017,54,13:15,13:30,,-52.97,0,-52.97,-52.97,-1,-29060,96016,125076,66956,0,-10131,0,0,0,,10131,-10131
16,04/16/2017,55,13:30,13:45,,-52.97,0,-52.97,-52.97,-1,-46432,96927,143359,50495,0,-56583,0,0,0,,56583,-56583
16,04/16/2017,56,13:45,14:00,,6.98,0,6.98,6.98,-1,-56002,82618,138620,26616,0,-47086,0,0,0,,47086,-47086
16,04/16/2017,57,14:00,14:15,,1.7,0,1.7,1.7,-1,-28863,199204,228067,170341,0,-46231,0,0,0,,46231,-46231
16,04/16/2017,58,14:15,14:30,,-21.15,0,-21.15,-21.15,-1,-38499,126596,165095,88097,0,-48418,0,0,0,,48418,-48418
16,04/16/2017,59,14:30,14:45,,-21.15,0,-21.15,-21.15,-1,-47215,103665,150880,56450,0,-68026,0,0,0,,68026,-68026
16,04/16/2017,60,14:45,15:00,,-73.64,0,-73.64,-73.64,-1,-58537,115820,174357,57283,0,-62741,0,0,0,,62741,-62741
16,04/16/2017,61,15:00,15:15,,10.18,0,10.18,10.18,-1,-55321,135827,191148,80506,0,-52220,0,0,0,,52220,-52220
16,04/16/2017,62,15:15,15:30,,-9.29,0,-9.29,-9.29,-1,-45084,139901,184985,94817,0,-63467,0,0,0,,63467,-63467
16,04/16/2017,63,15:30,15:45,,-29.05,0,-29.05,-29.05,-1,-52734,146114,198848,93380,0,-77996,0,0,0,,77996,-77996
16,04/16/2017,64,15:45,16:00,,-9.29,0,-9.29,-9.29,-1,-54347,144837,199184,90490,0,-85183,0,0,0,,85183,-85183
16,04/16/2017,65,16:00,16:15,,,0,27.43,27.43,0,-58797,164708,223505,105911,0,-36751,0,0,0,,36751,-36751
16,04/16/2017,66,16:15,16:30,,,0,27.43,27.43,0,-51090,179967,231057,128877,0,0,0,0,0,,0,0
16,04/16/2017,67,16:30,16:45,,,0,30.15,30.15,0,-57655,143427,201082,85772,0,0,0,0,0,,0,0
16,04/16/2017,68,16:45,17:00,,,0,30.15,30.15,0,-56023,127470,183493,71447,0,0,0,0,0,,0,0
16,04/16/2017,69,17:00,17:15,,10.18,0,10.18,10.18,-1,-62478,211931,274409,149453,0,-9553,0,0,0,,9553,-9553
16,04/16/2017,70,17:15,17:30,,29.37,0,29.37,29.37,-1,-58577,163259,221836,104682,0,-1932,0,0,0,,1932,-1932
16,04/16/2017,71,17:30,17:45,,,0,30.15,30.15,0,-57849,130098,187947,72249,0,-3,0,0,0,,3,-3
16,04/16/2017,72,17:45,18:00,,,0,30.15,30.15,0,-68422,127279,195701,58857,0,0,0,0,0,,0,0
16,04/16/2017,73,18:00,18:15,,6.31,0,6.31,6.31,-1,-79916,110553,190469,30637,0,-3532,0,0,0,,3532,-3532
16,04/16/2017,74,18:15,18:30,,-52.97,0,-52.97,-52.97,-1,-50517,81677,132194,31160,0,-38726,0,0,0,,38726,-38726
16,04/16/2017,75,18:30,18:45,,29.37,0,29.37,29.37,-1,-51229,60505,111734,9276,0,-3343,0,0,0,,3343,-3343
16,04/16/2017,76,18:45,19:00,,29.68,0,29.68,29.68,-1,-49649,63718,113367,14069,0,-265,0,0,0,,265,-265
16,04/16/2017,77,19:00,19:15,30.36,-9.29,0,30.36,-9.29,2,-66072,74005,140077,7933,0,-3945,1328,0,0,,5273,-2617
16,04/16/2017,78,19:15,19:30,,-52.97,0,-52.97,-52.97,-1,-33002,64539,97541,31537,0,-20327,0,0,0,,20327,-20327
16,04/16/2017,79,19:30,19:45,,24.37,0,24.37,24.37,-1,-43939,57412,101351,13473,0,-11817,0,0,0,,11817,-11817
16,04/16/2017,80,19:45,20:00,29.02,28.37,0,29.02,29.02,1,-55198,62623,117821,7425,0,-6565,198,0,0,,6763,-6367
16,04/16/2017,81,20:00,20:15,30.36,17.75,0,30.36,17.75,2,-45678,75458,121136,29780,0,-7733,1269,0,0,,9002,-6464
16,04/16/2017,82,20:15,20:30,,27.11,0,27.11,27.11,-1,-50922,63536,114458,12614,0,-7199,0,0,0,,7199,-7199
16,04/16/2017,83,20:30,20:45,28.48,,0,28.48,28.48,1,-68679,71204,139883,2525,0,0,43,0,0,,43,43
16,04/16/2017,84,20:45,21:00,36.36,,0,36.36,36.36,1,-93455,77810,171265,-15645,0,0,10914,0,0,,10914,10914
16,04/16/2017,85,21:00,21:15,39.9,,0,39.9,39.9,1,-77867,53600,131467,-24267,0,0,20099,0,0,,20099,20099
16,04/16/2017,86,21:15,21:30,31.53,,0,31.53,31.53,1,-73185,59208,132393,-13977,0,0,13668,0,0,,13668,13668
16,04/16/2017,87,21:30,21:45,29.45,,0,29.45,29.45,1,-63489,53648,117137,-9841,0,0,5599,0,0,,5599,5599
16,04/16/2017,88,21:45,22:00,31.53,,0,31.53,31.53,1,-66368,62587,128955,-3781,0,0,6272,0,0,,6272,6272
16,04/16/2017,89,22:00,22:15,94.12,,0,94.12,94.12,1,-99639,44412,144051,-55227,0,0,17662,0,0,,17662,17662
16,04/16/2017,90,22:15,22:30,37.48,,0,37.48,37.48,1,-61986,42163,104149,-19823,0,0,16407,0,0,,16407,16407
16,04/16/2017,91,22:30,22:45,47.48,,0,47.48,47.48,1,-64679,31658,96337,-33021,0,0,21820,0,0,,21820,21820
16,04/16/2017,92,22:45,23:00,38.13,,0,38.13,38.13,1,-67909,66536,134445,-1373,0,0,20392,0,0,,20392,20392
16,04/16/2017,93,23:00,23:15,142.61,,0,142.61,142.61,1,-135866,50769,186635,-85097,0,0,30417,0,0,,30417,30417
16,04/16/2017,94,23:15,23:30,142.61,,0,142.61,142.61,1,-95953,43307,139260,-52646,0,0,62456,0,0,,62456,62456
16,04/16/2017,95,23:30,23:45,39.59,28.09,0,28.09,28.09,-1,-62047,64878,126925,2831,0,-341,24026,0,0,,24367,23685
16,04/16/2017,96,23:45,0:00,31.53,26.2,0,31.53,26.2,2,-64100,53421,117521,-10679,0,-1712,603,0,0,,2315,-1109
16,04/17/2017,1,0:00,0:15,,-51.68,0,-51.68,-51.68,-1,-29208,112532,141740,83324,0,-33177,0,0,0,,33177,-33177
16,04/17/2017,2,0:15,0:30,,25.65,0,25.65,25.65,-1,-29727,35033,64760,5306,0,-12011,0,0,0,,12011,-12011
16,04/17/2017,3,0:30,0:45,,25.53,0,25.53,25.53,-1,-30776,23316,54092,-7460,0,-6740,0,0,0,,6740,-6740
16,04/17/2017,4,0:45,1:00,,23.13,0,23.13,23.13,-1,-57486,62746,120232,5260,0,-1604,0,0,0,,1604,-1604
16,04/17/2017,5,1:00,1:15,,13.4,0,13.4,13.4,-1,-36181,68980,105161,32799,0,-8939,0,0,0,,8939,-8939
16,04/17/2017,6,1:15,1:30,,0.95,0,0.95,0.95,-1,-18525,58375,76900,39850,0,-16602,0,0,0,,16602,-16602
16,04/17/2017,7,1:30,1:45,,0.95,0,0.95,0.95,-1,-26130,59691,85821,33561,0,-38474,0,0,0,,38474,-38474
16,04/17/2017,8,1:45,2:00,,26.2,0,26.2,26.2,-1,-29795,50096,79891,20301,0,-17007,0,0,0,,17007,-17007
16,04/17/2017,9,2:00,2:15,127.67,26.03,0,127.67,26.03,2,-57295,21532,78827,-35763,0,-6555,5387,0,0,,11942,-1168
16,04/17/2017,10,2:15,2:30,127.67,26.03,0,127.67,127.67,1,-46353,22593,68946,-23760,0,-79,32192,0,0,,32271,32113
16,04/17/2017,11,2:30,2:45,127.67,26.09,0,26.09,26.09,-1,-26195,36718,62913,10523,0,-2766,2022,0,0,,4788,-744
16,04/17/2017,12,2:45,3:00,,23.13,0,23.13,23.13,-1,-26813,37443,64256,10630,0,-20509,0,0,0,,20509,-20509
16,04/17/2017,13,3:00,3:15,29.45,23.03,0,29.45,29.45,1,-27518,22287,49805,-5231,0,-23388,229,0,0,,23617,-23159
16,04/17/2017,14,3:15,3:30,32.48,14.22,0,32.48,14.22,2,-15565,30045,45610,14480,0,-6684,1186,0,0,,7870,-5498
16,04/17/2017,15,3:30,3:45,,14.22,0,14.22,14.22,-1,-20778,22419,43197,1641,0,-21013,0,0,0,,21013,-21013
16,04/17/2017,16,3:45,4:00,,18.67,0,18.67,18.67,-1,-18460,34429,52889,15969,0,-18577,0,0,0,,18577,-18577
16,04/17/2017,17,4:00,4:15,29.37,18.59,0,29.37,29.37,1,-28566,26360,54926,-2206,0,-18986,219,0,0,,19205,-18767
16,04/17/2017,18,4:15,4:30,30.36,25.48,0,30.36,25.48,2,-19155,27884,47039,8729,0,-993,1214,0,0,,2207,221
16,04/17/2017,19,4:30,4:45,,23.13,0,23.13,23.13,-1,-14800,35961,50761,21161,0,-7249,0,0,0,,7249,-7249
16,04/17/2017,20,4:45,5:00,,18.67,0,18.67,18.67,-1,-11727,49489,61216,37762,0,-28890,0,0,0,,28890,-28890
16,04/17/2017,21,5:00,5:15,29.37,26.48,0,29.37,29.37,1,-14659,51979,66638,37320,0,-7778,21,0,0,,7799,-7757
16,04/17/2017,22,5:15,5:30,29.37,,0,29.37,29.37,1,-34429,40251,74680,5822,0,0,158,0,0,,158,158
16,04/17/2017,23,5:30,5:45,,,0,26.29,26.29,0,-43083,42370,85453,-713,0,0,0,0,0,,0,0
16,04/17/2017,24,5:45,6:00,,,0,26.29,26.29,0,-41458,45620,87078,4162,0,0,0,0,0,,0,0
16,04/17/2017,25,6:00,6:15,28.48,,0,28.48,28.48,1,-44435,56925,101360,12490,0,0,982,0,0,,982,982
16,04/17/2017,26,6:15,6:30,22.61,,0,22.61,22.61,1,-30720,67786,98506,37066,0,0,581,0,0,,581,581
16,04/17/2017,27,6:30,6:45,,,0,26.31,26.31,0,-20101,81932,102033,61831,0,0,0,0,0,,0,0
16,04/17/2017,28,6:45,7:00,,18.56,0,18.56,18.56,-1,-6275,107911,114186,101636,0,-5512,0,0,0,,5512,-5512
16,04/17/2017,29,7:00,7:15,,-60.59,0,-60.59,-60.59,-1,-27150,118146,145296,90996,0,-55784,0,0,0,,55784,-55784
16,04/17/2017,30,7:15,7:30,,-60.59,0,-60.59,-60.59,-1,-13796,111224,125020,97428,0,-65080,0,0,0,,65080,-65080
16,04/17/2017,31,7:30,7:45,,17.44,0,17.44,17.44,-1,-22301,104345,126646,82044,0,-45420,0,0,0,,45420,-45420
16,04/17/2017,32,7:45,8:00,,25.03,0,25.03,25.03,-1,-26192,132665,158857,106473,0,-1959,0,0,0,,1959,-1959
16,04/17/2017,33,8:00,8:15,,-16.84,0,-16.84,-16.84,-1,-27906,137859,165765,109953,0,-34014,0,0,0,,34014,-34014
16,04/17/2017,34,8:15,8:30,,23.13,0,23.13,23.13,-1,-34287,101685,135972,67398,0,-20451,0,0,0,,20451,-20451
16,04/17/2017,35,8:30,8:45,,,0,26.25,26.25,0,-50516,89983,140499,39467,0,0,0,0,0,,0,0
16,04/17/2017,36,8:45,9:00,,,0,26.25,26.25,0,-33766,108146,141912,74380,0,0,0,0,0,,0,0
16,04/17/2017,37,9:00,9:15,,-60.59,0,-60.59,-60.59,-1,-22086,150863,172949,128777,0,-20004,0,0,0,,20004,-20004
16,04/17/2017,38,9:15,9:30,,-60.59,0,-60.59,-60.59,-1,-30102,121737,151839,91635,0,-81232,0,0,0,,81232,-81232
16,04/17/2017,39,9:30,9:45,,3.41,0,3.41,3.41,-1,-48676,102328,151004,53652,0,-64116,0,0,0,,64116,-64116
16,04/17/2017,40,9:45,10:00,,14.75,0,14.75,14.75,-1,-46265,104260,150525,57995,0,-25023,0,0,0,,25023,-25023
16,04/17/2017,41,10:00,10:15,,15.79,0,15.79,15.79,-1,-61276,131065,192341,69789,0,-27941,0,0,0,,27941,-27941
16,04/17/2017,42,10:15,10:30,,27.11,0,27.11,27.11,-1,-49854,145166,195020,95312,0,-6618,0,0,0,,6618,-6618
16,04/17/2017,43,10:30,10:45,,15.79,0,15.79,15.79,-1,-52107,157857,209964,105750,0,-4034,0,0,0,,4034,-4034
16,04/17/2017,44,10:45,11:00,,-60.59,0,-60.59,-60.59,-1,-60430,171166,231596,110736,0,-34427,0,0,0,,34427,-34427
16,04/17/2017,45,11:00,11:15,,25.03,0,25.03,25.03,-1,-76330,126923,203253,50593,0,-21095,0,0,0,,21095,-21095
16,04/17/2017,46,11:15,11:30,,,0,26.07,26.07,0,-78821,140872,219693,62051,0,-1384,0,0,0,,1384,-1384
16,04/17/2017,47,11:30,11:45,,23.13,0,23.13,23.13,-1,-75817,181748,257565,105931,0,-684,0,0,0,,684,-684
16,04/17/2017,48,11:45,12:00,,-60.59,0,-60.59,-60.59,-1,-84830,178638,263468,93808,0,-34161,0,0,0,,34161,-34161
16,04/17/2017,49,12:00,12:15,,26.48,0,26.48,26.48,-1,-95180,161568,256748,66388,0,-4628,0,0,0,,4628,-4628
16,04/17/2017,50,12:15,12:30,,17.42,0,17.42,17.42,-1,-99524,168878,268402,69354,0,-11901,0,0,0,,11901,-11901
16,04/17/2017,51,12:30,12:45,,23.13,0,23.13,23.13,-1,-81736,175257,256993,93521,0,-17896,0,0,0,,17896,-17896
16,04/17/2017,52,12:45,13:00,,-0.03,0,-0.03,-0.03,-1,-72601,194247,266848,121646,0,-48749,0,0,0,,48749,-48749
16,04/17/2017,53,13:00,13:15,,23.12,0,23.12,23.12,-1,-66094,171894,237988,105800,0,-33701,0,0,0,,33701,-33701
16,04/17/2017,54,13:15,13:30,,-60.61,0,-60.61,-60.61,-1,-61945,195911,257856,133966,0,-49338,0,0,0,,49338,-49338
16,04/17/2017,55,13:30,13:45,,-60.61,0,-60.61,-60.61,-1,-79174,182207,261381,103033,0,-63425,0,0,0,,63425,-63425
16,04/17/2017,56,13:45,14:00,,-60.61,0,-60.61,-60.61,-1,-81104,194585,275689,113481,0,-62559,0,0,0,,62559,-62559
16,04/17/2017,57,14:00,14:15,,10.74,0,10.74,10.74,-1,-52008,187759,239767,135751,0,-51725,0,0,0,,51725,-51725
16,04/17/2017,58,14:15,14:30,,10.74,0,10.74,10.74,-1,-75245,191519,266764,116274,0,-21740,0,0,0,,21740,-21740
16,04/17/2017,59,14:30,14:45,,-249.36,0,-249.36,-249.36,-1,-94811,207105,301916,112294,0,-28116,0,0,0,,28116,-28116
16,04/17/2017,60,14:45,15:00,,3.21,0,3.21,3.21,-1,-67906,218509,286415,150603,0,-26315,0,0,0,,26315,-26315
16,04/17/2017,61,15:00,15:15,46.69,26.48,0,46.69,26.48,2,-127709,87568,215277,-40141,0,-8356,8843,0,0,,17199,487
16,04/17/2017,62,15:15,15:30,31.53,,0,31.53,31.53,1,-102050,102461,204511,411,0,0,8718,0,0,,8718,8718
16,04/17/2017,63,15:30,15:45,,,0,29.21,29.21,0,-110088,146230,256318,36142,0,0,155,0,0,,155,155
16,04/17/2017,64,15:45,16:00,,,0,29.21,29.21,0,-105305,143847,249152,38542,0,0,0,0,0,,0,0
16,04/17/2017,65,16:00,16:15,,,0,29.21,29.21,0,-106171,163226,269397,57055,0,0,0,0,0,,0,0
16,04/17/2017,66,16:15,16:30,,,0,29.21,29.21,0,-115406,162235,277641,46829,0,0,0,0,0,,0,0
16,04/17/2017,67,16:30,16:45,,25.48,0,25.48,25.48,-1,-80673,172535,253208,91862,0,-3170,0,0,0,,3170,-3170
16,04/17/2017,68,16:45,17:00,,25.03,0,25.03,25.03,-1,-100181,144471,244652,44290,0,-4422,0,0,0,,4422,-4422
16,04/17/2017,69,17:00,17:15,,-182.92,0,-182.92,-182.92,-1,-54529,218790,273319,164261,0,-21332,0,0,0,,21332,-21332
16,04/17/2017,70,17:15,17:30,,24.01,0,24.01,24.01,-1,-65188,139182,204370,73994,0,-14788,0,0,0,,14788,-14788
16,04/17/2017,71,17:30,17:45,,,0,34.46,34.46,0,-52961,102043,155004,49082,0,-110,0,0,0,,110,-110
16,04/17/2017,72,17:45,18:00,,,0,34.46,34.46,0,-48241,106630,154871,58389,0,0,0,0,0,,0,0
16,04/17/2017,73,18:00,18:15,,,0,29.21,29.21,0,-81733,116951,198684,35218,0,0,0,0,0,,0,0
16,04/17/2017,74,18:15,18:30,,,0,29.21,29.21,0,-61335,105536,166871,44201,0,0,0,0,0,,0,0
16,04/17/2017,75,18:30,18:45,,,0,29.21,29.21,0,-42821,110245,153066,67424,0,0,0,0,0,,0,0
16,04/17/2017,76,18:45,19:00,,29.68,0,29.68,29.68,-1,-69905,114959,184864,45054,0,-62,0,0,0,,62,-62
16,04/17/2017,77,19:00,19:15,,-50.35,0,-50.35,-50.35,-1,-48086,149751,197837,101665,0,-7957,0,0,0,,7957,-7957
16,04/17/2017,78,19:15,19:30,,-50.35,0,-50.35,-50.35,-1,-57183,93631,150814,36448,0,-33198,0,0,0,,33198,-33198
16,04/17/2017,79,19:30,19:45,,24.01,0,24.01,24.01,-1,-33253,129362,162615,96109,0,-2512,0,0,0,,2512,-2512
16,04/17/2017,80,19:45,20:00,,24.01,0,24.01,24.01,-1,-40888,88135,129023,47247,0,-1581,0,0,0,,1581,-1581
16,04/17/2017,81,20:00,20:15,,-33.83,0,-33.83,-33.83,-1,-37185,143234,180419,106049,0,-15829,0,0,0,,15829,-15829
16,04/17/2017,82,20:15,20:30,,-50.32,0,-50.32,-50.32,-1,-53242,82189,135431,28947,0,-31154,0,0,0,,31154,-31154
16,04/17/2017,83,20:30,20:45,,-1.19,0,-1.19,-1.19,-1,-50220,106718,156938,56498,0,-34548,0,0,0,,34548,-34548
16,04/17/2017,84,20:45,21:00,,24.01,0,24.01,24.01,-1,-57328,76874,134202,19546,0,-25048,0,0,0,,25048,-25048
16,04/17/2017,85,21:00,21:15,33.44,24.01,0,33.44,33.44,1,-72610,81438,154048,8828,0,-1253,2965,0,0,,4218,1712
16,04/17/2017,86,21:15,21:30,33.44,-5.03,0,-5.03,-5.03,-1,-46570,108474,155044,61904,0,-4583,30,0,0,,4613,-4553
16,04/17/2017,87,21:30,21:45,,-50.35,0,-50.35,-50.35,-1,-59944,117238,177182,57294,0,-50483,0,0,0,,50483,-50483
16,04/17/2017,88,21:45,22:00,,0.03,0,0.03,0.03,-1,-68377,126403,194780,58026,0,-52014,0,0,0,,52014,-52014
16,04/17/2017,89,22:00,22:15,36.4,23.13,0,36.4,23.13,2,-77772,79101,156873,1329,0,-15533,1138,0,0,,16671,-14395
16,04/17/2017,90,22:15,22:30,,-5.54,0,-5.54,-5.54,-1,-49801,87825,137626,38024,0,-34760,0,0,0,,34760,-34760
16,04/17/2017,91,22:30,22:45,,24.01,0,24.01,24.01,-1,-60429,103367,163796,42938,0,-26304,0,0,0,,26304,-26304
16,04/17/2017,92,22:45,23:00,,11.68,0,11.68,11.68,-1,-63951,113151,177102,49200,0,-27275,0,0,0,,27275,-27275
16,04/17/2017,93,23:00,23:15,,26.48,0,26.48,26.48,-1,-40881,60395,101276,19514,0,-9520,0,0,0,,9520,-9520
16,04/17/2017,94,23:15,23:30,,25.48,0,25.48,25.48,-1,-46342,62838,109180,16496,0,-3391,0,0,0,,3391,-3391
16,04/17/2017,95,23:30,23:45,,25.48,0,25.48,25.48,-1,-51396,73366,124762,21970,0,-8174,0,0,0,,8174,-8174
16,04/17/2017,96,23:45,0:00,28.41,26.2,0,29.21,26.2,2,-79640,64369,144009,-15271,0,-1330,82,0,0,,1412,-1248
16,04/18/2017,1,0:00,0:15,,22.74,0,22.74,22.74,-1,-54413,79564,133977,25151,0,-5725,0,0,0,,5725,-5725
16,04/18/2017,2,0:15,0:30,,20.97,0,20.97,20.97,-1,-60888,76110,136998,15222,0,-2591,0,0,0,,2591,-2591
16,04/18/2017,3,0:30,0:45,,15.28,0,15.28,15.28,-1,-53007,60335,113342,7328,0,-15093,0,0,0,,15093,-15093
16,04/18/2017,4,0:45,1:00,,19.74,0,19.74,19.74,-1,-47715,68431,116146,20716,0,-3854,0,0,0,,3854,-3854
16,04/18/2017,5,1:00,1:15,,14.22,0,14.22,14.22,-1,-32251,62025,94276,29774,0,-14726,0,0,0,,14726,-14726
16,04/18/2017,6,1:15,1:30,,29.68,0,29.68,29.68,-1,-49829,55375,105204,5546,0,-356,0,0,0,,356,-356
16,04/18/2017,7,1:30,1:45,,27.73,0,27.73,27.73,-1,-51648,62825,114473,11177,0,-4414,0,0,0,,4414,-4414
16,04/18/2017,8,1:45,2:00,,25.73,0,25.73,25.73,-1,-62603,56433,119036,-6170,0,-12302,0,0,0,,12302,-12302
16,04/18/2017,9,2:00,2:15,,,0,29.58,29.58,0,-53400,59021,112421,5621,0,-745,0,0,0,,745,-745
16,04/18/2017,10,2:15,2:30,,29.29,0,29.29,29.29,-1,-66226,66752,132978,526,0,-612,0,0,0,,612,-612
16,04/18/2017,11,2:30,2:45,,29.29,0,29.29,29.29,-1,-76101,56602,132703,-19499,0,-652,0,0,0,,652,-652
16,04/18/2017,12,2:45,3:00,31.53,,0,31.53,31.53,1,-87064,49105,136169,-37959,0,0,3398,0,0,,3398,3398
16,04/18/2017,13,3:00,3:15,,,0,29.58,29.58,0,-67540,91408,158948,23868,0,0,778,0,0,,778,778
16,04/18/2017,14,3:15,3:30,,26.2,0,26.2,26.2,-1,-61865,90458,152323,28593,0,-3668,0,0,0,,3668,-3668
16,04/18/2017,15,3:30,3:45,,-18.16,0,-18.16,-18.16,-1,-45684,111640,157324,65956,0,-33331,0,0,0,,33331,-33331
16,04/18/2017,16,3:45,4:00,,-17.78,0,-17.78,-17.78,-1,-68566,106016,174582,37450,0,-48316,0,0,0,,48316,-48316
16,04/18/2017,17,4:00,4:15,,24.37,0,24.37,24.37,-1,-82518,105852,188370,23334,0,-25058,0,0,0,,25058,-25058
16,04/18/2017,18,4:15,4:30,34.87,24.37,0,34.87,34.87,1,-93730,93314,187044,-416,0,-1628,1680,0,0,,3308,52
16,04/18/2017,19,4:30,4:45,29.45,28.37,0,29.58,28.37,2,-85967,85216,171183,-751,0,-801,318,0,0,,1119,-483
16,04/18/2017,20,4:45,5:00,29.45,-14.96,0,-14.96,-14.96,-1,-69112,162991,232103,93879,0,-10789,264,0,0,,11053,-10525
16,04/18/2017,21,5:00,5:15,,-25.18,0,-25.18,-25.18,-1,-94220,105670,199890,11450,0,-38970,0,0,0,,38970,-38970
16,04/18/2017,22,5:15,5:30,29.31,29.68,0,29.58,29.58,2,-105630,85767,191397,-19863,0,-4855,294,0,0,,5149,-4561
16,04/18/2017,23,5:30,5:45,34.87,,0,34.87,34.87,1,-130517,68519,199036,-61998,0,0,3765,0,0,,3765,3765
16,04/18/2017,24,5:45,6:00,40.87,,0,40.87,40.87,1,-118410,113999,232409,-4411,0,0,13600,0,0,,13600,13600
16,04/18/2017,25,6:00,6:15,,,0,29.7,29.7,0,-109862,59959,169821,-49903,0,0,787,0,0,,787,787
16,04/18/2017,26,6:15,6:30,29.69,,0,29.69,29.69,1,-99005,21093,120098,-77912,0,0,1254,0,0,,1254,1254
16,04/18/2017,27,6:30,6:45,52.12,,0,52.12,52.12,1,-126095,14949,141044,-111146,0,0,7165,0,0,,7165,7165
16,04/18/2017,28,6:45,7:00,256.85,,0,256.85,256.85,1,-142672,29662,172334,-113010,0,0,48723,0,0,,48723,48723
16,04/18/2017,29,7:00,7:15,33.35,24.36,0,33.35,24.36,2,-96604,71546,168150,-25058,0,-1152,13033,0,0,,14185,11881
16,04/18/2017,30,7:15,7:30,28.65,,0,28.65,28.65,1,-75436,30984,106420,-44452,0,0,189,0,0,,189,189
16,04/18/2017,31,7:30,7:45,105.12,,0,105.12,105.12,1,-129924,20578,150502,-109346,0,0,15775,0,0,,15775,15775
16,04/18/2017,32,7:45,8:00,273.55,,0,273.55,273.55,1,-162872,25286,188158,-137586,0,0,54983,0,0,,54983,54983
16,04/18/2017,33,8:00,8:15,227.81,-0.13,0,-0.13,-0.13,-1,-70042,97562,167604,27520,0,-2293,38471,0,0,,40764,36178
16,04/18/2017,34,8:15,8:30,52.89,-9.05,0,52.89,-9.05,2,-77159,55761,132920,-21398,0,-5472,2388,0,0,,7860,-3084
16,04/18/2017,35,8:30,8:45,84.12,,0,84.12,84.12,1,-81777,70187,151964,-11590,0,0,24699,0,0,,24699,24699
16,04/18/2017,36,8:45,9:00,75.12,27.35,0,75.12,27.35,2,-89092,62289,151381,-26803,0,-1132,4326,0,0,,5458,3194
16,04/18/2017,37,9:00,9:15,289.91,,0,289.91,289.91,1,-167736,55067,222803,-112669,0,0,60806,0,0,,60806,60806
16,04/18/2017,38,9:15,9:30,289.91,,0,289.91,289.91,1,-118367,69313,187680,-49054,0,0,72504,0,0,,72504,72504
16,04/18/2017,39,9:30,9:45,30.6,25.27,0,30.6,25.27,2,-106005,102954,208959,-3051,0,-1058,8087,0,0,,9145,7029
16,04/18/2017,40,9:45,10:00,36.69,29.36,0,36.69,29.36,2,-115971,117553,233524,1582,0,-219,1899,0,0,,2118,1680
16,04/18/2017,41,10:00,10:15,28.62,28.36,0,29.68,28.36,2,-82146,92714,174860,10568,0,-357,42,0,0,,399,-315
16,04/18/2017,42,10:15,10:30,,19.36,0,19.36,19.36,-1,-87498,109534,197032,22036,0,-17172,0,0,0,,17172,-17172
16,04/18/2017,43,10:30,10:45,49.3,19.36,0,49.3,49.3,1,-119290,97726,217016,-21564,0,-1341,10111,0,0,,11452,8770
16,04/18/2017,44,10:45,11:00,38.3,,0,38.3,38.3,1,-123665,105862,229527,-17803,0,0,17478,0,0,,17478,17478
16,04/18/2017,45,11:00,11:15,255.14,,0,255.14,255.14,1,-159805,82232,242037,-77573,0,0,37693,0,0,,37693,37693
16,04/18/2017,46,11:15,11:30,255.14,,0,255.14,255.14,1,-139319,93920,233239,-45399,0,0,49402,0,0,,49402,49402
16,04/18/2017,47,11:30,11:45,84.93,,0,84.93,84.93,1,-136762,112406,249168,-24356,0,0,44280,0,0,,44280,44280
16,04/18/2017,48,11:45,12:00,83.12,28.39,0,83.12,28.39,2,-130964,95225,226189,-35739,0,-207,8998,0,0,,9205,8791
16,04/18/2017,49,12:00,12:15,239.46,,0,239.46,239.46,1,-157787,84106,241893,-73681,0,0,51657,0,0,,51657,51657
16,04/18/2017,50,12:15,12:30,42.39,,0,42.39,42.39,1,-126010,96135,222145,-29875,0,0,27285,0,0,,27285,27285
16,04/18/2017,51,12:30,12:45,55.25,,0,55.25,55.25,1,-141265,91617,232882,-49648,0,0,36805,0,0,,36805,36805
16,04/18/2017,52,12:45,13:00,62.43,,0,62.43,62.43,1,-127968,98074,226042,-29894,0,0,44129,0,0,,44129,44129
16,04/18/2017,53,13:00,13:15,62.43,17.99,0,17.99,17.99,-1,-106883,165020,271903,58137,0,-11592,5347,0,0,,16939,-6245
16,04/18/2017,54,13:15,13:30,,28,0,28,28,-1,-89811,102956,192767,13145,0,-8172,0,0,0,,8172,-8172
16,04/18/2017,55,13:30,13:45,,24.36,0,24.36,24.36,-1,-90608,110808,201416,20200,0,-3015,0,0,0,,3015,-3015
16,04/18/2017,56,13:45,14:00,,19.36,0,19.36,19.36,-1,-77465,97328,174793,19863,0,-18381,0,0,0,,18381,-18381
16,04/18/2017,57,14:00,14:15,35.74,19.36,0,35.74,35.74,1,-111434,83007,194441,-28427,0,-1164,7679,0,0,,8843,6515
16,04/18/2017,58,14:15,14:30,32.62,,0,32.62,32.62,1,-97523,67390,164913,-30133,0,0,7996,0,0,,7996,7996
16,04/18/2017,59,14:30,14:45,28.65,,0,28.65,28.65,1,-101300,60404,161704,-40896,0,0,3584,0,0,,3584,3584
16,04/18/2017,60,14:45,15:00,28.62,,0,28.62,28.62,1,-74446,55782,130228,-18664,0,0,701,0,0,,701,701
16,04/18/2017,61,15:00,15:15,132.63,,0,132.63,132.63,1,-125159,53531,178690,-71628,0,0,14773,0,0,,14773,14773
16,04/18/2017,62,15:15,15:30,132.63,,0,132.63,132.63,1,-126456,82199,208655,-44257,0,0,37882,0,0,,37882,37882
16,04/18/2017,63,15:30,15:45,29.03,29.56,0,29.68,29.56,2,-89361,82930,172291,-6431,0,-308,1437,0,0,,1745,1129
16,04/18/2017,64,15:45,16:00,29.69,22.74,0,29.69,22.74,2,-65227,77713,142940,12486,0,-2900,875,0,0,,3775,-2025
16,04/18/2017,65,16:00,16:15,43.74,17.99,0,43.74,17.99,2,-84136,76114,160250,-8022,0,-11226,2772,0,0,,13998,-8454
16,04/18/2017,66,16:15,16:30,29.03,19.36,0,29.68,19.36,2,-64332,102963,167295,38631,0,-6331,1377,0,0,,7708,-4954
16,04/18/2017,67,16:30,16:45,,26,0,26,26,-1,-61397,101674,163071,40277,0,-4193,0,0,0,,4193,-4193
16,04/18/2017,68,16:45,17:00,,28.36,0,28.36,28.36,-1,-65226,79694,144920,14468,0,-2536,0,0,0,,2536,-2536
16,04/18/2017,69,17:00,17:15,,29.56,0,29.56,29.56,-1,-95234,106900,202134,11666,0,-596,0,0,0,,596,-596
16,04/18/2017,70,17:15,17:30,,26.44,0,26.44,26.44,-1,-38606,65313,103919,26707,0,-4437,0,0,0,,4437,-4437
16,04/18/2017,71,17:30,17:45,,24.36,0,24.36,24.36,-1,-23083,58044,81127,34961,0,-12761,0,0,0,,12761,-12761
16,04/18/2017,72,17:45,18:00,,28.36,0,28.36,28.36,-1,-17637,69422,87059,51785,0,-4175,0,0,0,,4175,-4175
16,04/18/2017,73,18:00,18:15,,28.36,0,28.36,28.36,-1,-93057,27810,120867,-65247,0,-1799,0,0,0,,1799,-1799
16,04/18/2017,74,18:15,18:30,,,0,29.68,29.68,0,-42841,39043,81884,-3798,0,0,0,0,0,,0,0
16,04/18/2017,75,18:30,18:45,28.62,,0,28.62,28.62,1,-35578,38792,74370,3214,0,0,820,0,0,,820,820
16,04/18/2017,76,18:45,19:00,28.62,,0,28.62,28.62,1,-21005,39954,60959,18949,0,0,198,0,0,,198,198
16,04/18/2017,77,19:00,19:15,29.69,,0,29.69,29.69,1,-63573,42541,106114,-21032,0,0,1399,0,0,,1399,1399
16,04/18/2017,78,19:15,19:30,42.4,,0,42.4,42.4,1,-70056,41668,111724,-28388,0,0,17842,0,0,,17842,17842
16,04/18/2017,79,19:30,19:45,42.4,,0,42.4,42.4,1,-59736,43425,103161,-16311,0,0,24870,0,0,,24870,24870
16,04/18/2017,80,19:45,20:00,66.12,,0,66.12,66.12,1,-71916,38062,109978,-33854,0,0,22081,0,0,,22081,22081
16,04/18/2017,81,20:00,20:15,30.6,19.36,0,19.36,19.36,-1,-44750,103626,148376,58876,0,-3854,10376,0,0,,14230,6522
16,04/18/2017,82,20:15,20:30,,19.36,0,19.36,19.36,-1,-26991,79119,106110,52128,0,-9269,0,0,0,,9269,-9269
16,04/18/2017,83,20:30,20:45,,28.36,0,28.36,28.36,-1,-28449,72708,101157,44259,0,-2413,0,0,0,,2413,-2413
16,04/18/2017,84,20:45,21:00,,,0,29.68,29.68,0,-50447,75138,125585,24691,0,-182,0,0,0,,182,-182
16,04/18/2017,85,21:00,21:15,,17.99,0,17.99,17.99,-1,-45940,95552,141492,49612,0,-13626,0,0,0,,13626,-13626
16,04/18/2017,86,21:15,21:30,,19.74,0,19.74,19.74,-1,-43121,78459,121580,35338,0,-9685,0,0,0,,9685,-9685
16,04/18/2017,87,21:30,21:45,,17.99,0,17.99,17.99,-1,-38428,65827,104255,27399,0,-27548,0,0,0,,27548,-27548
16,04/18/2017,88,21:45,22:00,,19.36,0,19.36,19.36,-1,-34528,64771,99299,30243,0,-5929,0,0,0,,5929,-5929
16,04/18/2017,89,22:00,22:15,,6.55,0,6.55,6.55,-1,-51015,72152,123167,21137,0,-23711,0,0,0,,23711,-23711
16,04/18/2017,90,22:15,22:30,,17.99,0,17.99,17.99,-1,-48190,73489,121679,25299,0,-13062,0,0,0,,13062,-13062
16,04/18/2017,91,22:30,22:45,29.03,17.99,0,29.03,29.03,1,-46361,44406,90767,-1955,0,-17313,148,0,0,,17461,-17165
16,04/18/2017,92,22:45,23:00,29.03,17.78,0,17.78,17.78,-1,-35142,63686,98828,28544,0,-8119,355,0,0,,8474,-7764
16,04/18/2017,93,23:00,23:15,104.12,17.46,0,104.12,104.12,1,-74846,41887,116733,-32959,0,-9463,7042,0,0,,16505,-2421
16,04/18/2017,94,23:15,23:30,32.62,29.36,0,29.36,29.36,-1,-58595,50874,109469,-7721,0,-16,9024,0,0,,9040,9008
16,04/18/2017,95,23:30,23:45,32.62,19.36,0,19.36,19.36,-1,-42050,62488,104538,20438,0,-15150,14,0,0,,15164,-15136
16,04/18/2017,96,23:45,0:00,,11.23,0,11.23,11.23,-1,-50357,93418,143775,43061,0,-22225,0,0,0,,22225,-22225
16,04/19/2017,1,0:00,0:15,,19.36,0,19.36,19.36,-1,-49344,37671,87015,-11673,0,-15455,0,0,0,,15455,-15455
16,04/19/2017,2,0:15,0:30,,28.36,0,28.36,28.36,-1,-27987,30009,57996,2022,0,-796,0,0,0,,796,-796
16,04/19/2017,3,0:30,0:45,,24.36,0,24.36,24.36,-1,-28438,47536,75974,19098,0,-8772,0,0,0,,8772,-8772
16,04/19/2017,4,0:45,1:00,,0.61,0,0.61,0.61,-1,-20592,81180,101772,60588,0,-44399,0,0,0,,44399,-44399
16,04/19/2017,5,1:00,1:15,32.02,0.61,0,32.02,32.02,1,-21387,34690,56077,13303,0,-31012,484,0,0,,31496,-30528
16,04/19/2017,6,1:15,1:30,37.74,,0,37.74,37.74,1,-38808,53490,92298,14682,0,0,3314,0,0,,3314,3314
16,04/19/2017,7,1:30,1:45,,,0,29.76,29.76,0,-33343,79473,112816,46130,0,0,0,0,0,,0,0
16,04/19/2017,8,1:45,2:00,,-8.8,0,-8.8,-8.8,-1,-38315,87054,125369,48739,0,-13148,0,0,0,,13148,-13148
16,04/19/2017,9,2:00,2:15,,-8.8,0,-8.8,-8.8,-1,-31053,77413,108466,46360,0,-33890,0,0,0,,33890,-33890
16,04/19/2017,10,2:15,2:30,,27.6,0,27.6,27.6,-1,-36698,71612,108310,34914,0,-22362,0,0,0,,22362,-22362
16,04/19/2017,11,2:30,2:45,,28.03,0,28.03,28.03,-1,-42898,68533,111431,25635,0,-18471,0,0,0,,18471,-18471
16,04/19/2017,12,2:45,3:00,,28.36,0,28.36,28.36,-1,-42087,65766,107853,23679,0,-5373,0,0,0,,5373,-5373
16,04/19/2017,13,3:00,3:15,,28.36,0,28.36,28.36,-1,-28623,62605,91228,33982,0,-1902,0,0,0,,1902,-1902
16,04/19/2017,14,3:15,3:30,,,0,29.76,29.76,0,-34427,31623,66050,-2804,0,0,0,0,0,,0,0
16,04/19/2017,15,3:30,3:45,29.36,,0,29.36,29.36,1,-41786,26325,68111,-15461,0,0,2322,0,0,,2322,2322
16,04/19/2017,16,3:45,4:00,28.9,,0,28.9,28.9,1,-45956,22335,68291,-23621,0,0,2364,0,0,,2364,2364
16,04/19/2017,17,4:00,4:15,,,0,29.76,29.76,0,-28043,30038,58081,1995,0,0,17,0,0,,17,17
16,04/19/2017,18,4:15,4:30,,28.36,0,28.36,28.36,-1,-22804,24068,46872,1264,0,-2401,0,0,0,,2401,-2401
16,04/19/2017,19,4:30,4:45,,29.36,0,29.36,29.36,-1,-31950,28606,60556,-3344,0,-2963,0,0,0,,2963,-2963
16,04/19/2017,20,4:45,5:00,28.77,29.36,0,28.77,28.77,1,-33272,20672,53944,-12600,0,-9,758,0,0,,767,749
16,04/19/2017,21,5:00,5:15,,24.36,0,24.36,24.36,-1,-32389,86170,118559,53781,0,-6415,0,0,0,,6415,-6415
16,04/19/2017,22,5:15,5:30,,29.36,0,29.36,29.36,-1,-32622,57766,90388,25144,0,-487,0,0,0,,487,-487
16,04/19/2017,23,5:30,5:45,28.77,,0,28.77,28.77,1,-40213,38669,78882,-1544,0,0,78,0,0,,78,78
16,04/19/2017,24,5:45,6:00,33.02,,0,33.02,33.02,1,-51781,35860,87641,-15921,0,0,6507,0,0,,6507,6507
16,04/19/2017,25,6:00,6:15,33.02,27.6,0,27.6,27.6,-1,-48769,101747,150516,52978,0,-1135,148,0,0,,1283,-987
16,04/19/2017,26,6:15,6:30,,28.25,0,28.25,28.25,-1,-39373,87144,126517,47771,0,-1909,0,0,0,,1909,-1909
16,04/19/2017,27,6:30,6:45,,29.36,0,29.36,29.36,-1,-35077,76403,111480,41326,0,-163,0,0,0,,163,-163
16,04/19/2017,28,6:45,7:00,,24.36,0,24.36,24.36,-1,-45023,61408,106431,16385,0,-1491,0,0,0,,1491,-1491
16,04/19/2017,29,7:00,7:15,,-52.48,0,-52.48,-52.48,-1,-47900,104671,152571,56771,0,-39147,0,0,0,,39147,-39147
16,04/19/2017,30,7:15,7:30,,28.36,0,28.36,28.36,-1,-56549,61267,117816,4718,0,-5835,0,0,0,,5835,-5835
16,04/19/2017,31,7:30,7:45,52.88,29.36,0,52.88,52.88,1,-76182,46315,122497,-29867,0,-596,3347,0,0,,3943,2751
16,04/19/2017,32,7:45,8:00,290.84,,0,290.84,290.84,1,-107581,49952,157533,-57629,0,0,48721,0,0,,48721,48721
16,04/19/2017,33,8:00,8:15,290.84,-8.8,0,-8.8,-8.8,-1,-23000,119943,142943,96943,0,-4297,11610,0,0,,15907,7313
16,04/19/2017,34,8:15,8:30,,,0,29.82,29.82,0,-38212,95180,133392,56968,0,0,0,0,0,,0,0
16,04/19/2017,35,8:30,8:45,,19.36,0,19.36,19.36,-1,-52612,100603,153215,47991,0,-6510,0,0,0,,6510,-6510
16,04/19/2017,36,8:45,9:00,,19.36,0,19.36,19.36,-1,-60706,82159,142865,21453,0,-17193,0,0,0,,17193,-17193
16,04/19/2017,37,9:00,9:15,,29.36,0,29.36,29.36,-1,-52718,68001,120719,15283,0,-3840,0,0,0,,3840,-3840
16,04/19/2017,38,9:15,9:30,,6.8,0,6.8,6.8,-1,-35946,84195,120141,48249,0,-14172,0,0,0,,14172,-14172
16,04/19/2017,39,9:30,9:45,,6.8,0,6.8,6.8,-1,-32694,60245,92939,27551,0,-23620,0,0,0,,23620,-23620
16,04/19/2017,40,9:45,10:00,,24.36,0,24.36,24.36,-1,-35534,75854,111388,40320,0,-25963,0,0,0,,25963,-25963
16,04/19/2017,41,10:00,10:15,28.74,27.03,0,28.74,28.74,1,-24036,27378,51414,3342,0,-15994,49,0,0,,16043,-15945
16,04/19/2017,42,10:15,10:30,28.74,24.36,0,24.36,24.36,-1,-20319,40628,60947,20309,0,-9639,20,0,0,,9659,-9619
16,04/19/2017,43,10:30,10:45,,28.25,0,28.25,28.25,-1,-32158,49115,81273,16957,0,-9772,0,0,0,,9772,-9772
16,04/19/2017,44,10:45,11:00,,24.36,0,24.36,24.36,-1,-33846,57272,91118,23426,0,-21666,0,0,0,,21666,-21666
16,04/19/2017,45,11:00,11:15,,28.36,0,28.36,28.36,-1,-34704,63189,97893,28485,0,-7178,0,0,0,,7178,-7178
16,04/19/2017,46,11:15,11:30,,,0,29.74,29.74,0,-29566,51272,80838,21706,0,0,0,0,0,,0,0
16,04/19/2017,47,11:30,11:45,,,0,29.74,29.74,0,-28931,58385,87316,29454,0,0,0,0,0,,0,0
16,04/19/2017,48,11:45,12:00,,28.36,0,28.36,28.36,-1,-30289,55099,85388,24810,0,-41,0,0,0,,41,-41
16,04/19/2017,49,12:00,12:15,,24.36,0,24.36,24.36,-1,-50696,76231,126927,25535,0,-9908,0,0,0,,9908,-9908
16,04/19/2017,50,12:15,12:30,,24.36,0,24.36,24.36,-1,-52529,72323,124852,19794,0,-20134,0,0,0,,20134,-20134
16,04/19/2017,51,12:30,12:45,,25.03,0,25.03,25.03,-1,-46553,72076,118629,25523,0,-19681,0,0,0,,19681,-19681
16,04/19/2017,52,12:45,13:00,,26.69,0,26.69,26.69,-1,-50423,69183,119606,18760,0,-18888,0,0,0,,18888,-18888
16,04/19/2017,53,13:00,13:15,42.61,29.36,0,42.61,29.36,2,-68183,56381,124564,-11802,0,-7276,3769,0,0,,11045,-3507
16,04/19/2017,54,13:15,13:30,28.74,,0,28.74,28.74,1,-52684,43511,96195,-9173,0,0,2083,0,0,,2083,2083
16,04/19/2017,55,13:30,13:45,28.74,,0,28.74,28.74,1,-56522,41585,98107,-14937,0,0,300,0,0,,300,300
16,04/19/2017,56,13:45,14:00,,,0,29.74,29.74,0,-71601,34100,105701,-37501,0,0,0,0,0,,0,0
16,04/19/2017,57,14:00,14:15,39.74,,0,39.74,39.74,1,-59865,28933,88798,-30932,0,0,6082,0,0,,6082,6082
16,04/19/2017,58,14:15,14:30,40.47,,0,40.47,40.47,1,-71096,20678,91774,-50418,0,0,22280,0,0,,22280,22280
16,04/19/2017,59,14:30,14:45,32.74,,0,32.74,32.74,1,-61466,23799,85265,-37667,0,0,17629,0,0,,17629,17629
16,04/19/2017,60,14:45,15:00,,,0,29.74,29.74,0,-64209,23540,87749,-40669,0,0,885,0,0,,885,885
16,04/19/2017,61,15:00,15:15,39.74,,0,39.74,39.74,1,-73461,31391,104852,-42070,0,0,6225,0,0,,6225,6225
16,04/19/2017,62,15:15,15:30,29.36,,0,29.36,29.36,1,-68771,33087,101858,-35684,0,0,5730,0,0,,5730,5730
16,04/19/2017,63,15:30,15:45,32.74,,0,32.74,32.74,1,-69458,31844,101302,-37614,0,0,1818,0,0,,1818,1818
16,04/19/2017,64,15:45,16:00,,,0,29.74,29.74,0,-67647,31409,99056,-36238,0,0,0,0,0,,0,0
16,04/19/2017,65,16:00,16:15,32.74,,0,32.74,32.74,1,-58575,55116,113691,-3459,0,0,4149,0,0,,4149,4149
16,04/19/2017,66,16:15,16:30,32.74,,0,32.74,32.74,1,-58705,41527,100232,-17178,0,0,12014,0,0,,12014,12014
16,04/19/2017,67,16:30,16:45,32.74,,0,32.74,32.74,1,-56290,42176,98466,-14114,0,0,11336,0,0,,11336,11336
16,04/19/2017,68,16:45,17:00,32.74,,0,32.74,32.74,1,-59670,32061,91731,-27609,0,0,16662,0,0,,16662,16662
16,04/19/2017,69,17:00,17:15,29.36,,0,29.36,29.36,1,-81198,23502,104700,-57696,0,0,9453,0,0,,9453,9453
16,04/19/2017,70,17:15,17:30,32.74,,0,32.74,32.74,1,-73744,12158,85902,-61586,0,0,8686,0,0,,8686,8686
16,04/19/2017,71,17:30,17:45,43.74,,0,43.74,43.74,1,-65046,23385,88431,-41661,0,0,10731,0,0,,10731,10731
16,04/19/2017,72,17:45,18:00,80.53,,0,80.53,80.53,1,-63221,32034,95255,-31187,0,0,35309,0,0,,35309,35309
16,04/19/2017,73,18:00,18:15,30.85,28.36,0,28.36,28.36,-1,-62415,21470,83885,-40945,0,-26,13058,0,0,,13084,13032
16,04/19/2017,74,18:15,18:30,,28.36,0,28.36,28.36,-1,-40651,41538,82189,887,0,-13,0,0,0,,13,-13
16,04/19/2017,75,18:30,18:45,,,0,29.74,29.74,0,-37625,52788,90413,15163,0,0,0,0,0,,0,0
16,04/19/2017,76,18:45,19:00,,,0,29.74,29.74,0,-38550,53135,91685,14585,0,0,0,0,0,,0,0
16,04/19/2017,77,19:00,19:15,28.74,,0,28.74,28.74,1,-51425,38441,89866,-12984,0,0,47,0,0,,47,47
16,04/19/2017,78,19:15,19:30,,,0,29.74,29.74,0,-46023,39757,85780,-6266,0,0,0,0,0,,0,0
16,04/19/2017,79,19:30,19:45,,,0,29.74,29.74,0,-41606,49802,91408,8196,0,0,0,0,0,,0,0
16,04/19/2017,80,19:45,20:00,,,0,29.74,29.74,0,-51781,42879,94660,-8902,0,0,0,0,0,,0,0
16,04/19/2017,81,20:00,20:15,34.01,,0,34.01,34.01,1,-62269,41076,103345,-21193,0,0,1770,0,0,,1770,1770
16,04/19/2017,82,20:15,20:30,29.29,,0,29.29,29.29,1,-57732,47005,104737,-10727,0,0,2974,0,0,,2974,2974
16,04/19/2017,83,20:30,20:45,50.01,,0,50.01,50.01,1,-68851,44715,113566,-24136,0,0,10833,0,0,,10833,10833
16,04/19/2017,84,20:45,21:00,92.14,,0,92.14,92.14,1,-91523,39832,131355,-51691,0,0,36390,0,0,,36390,36390
16,04/19/2017,85,21:00,21:15,33.06,28.36,0,28.36,28.36,-1,-59962,68085,128047,8123,0,-281,15978,0,0,,16259,15697
16,04/19/2017,86,21:15,21:30,33.06,28.36,0,28.36,28.36,-1,-51261,51982,103243,721,0,-279,47,0,0,,326,-232
16,04/19/2017,87,21:30,21:45,,29.36,0,29.36,29.36,-1,-45470,68587,114057,23117,0,-1,0,0,0,,1,-1
16,04/19/2017,88,21:45,22:00,,18.24,0,18.24,18.24,-1,-46950,78631,125581,31681,0,-8419,0,0,0,,8419,-8419
16,04/19/2017,89,22:00,22:15,40.9,10.72,0,40.9,10.72,2,-92322,46195,138517,-46127,0,-16197,1671,0,0,,17868,-14526
16,04/19/2017,90,22:15,22:30,40.9,26.69,0,26.69,26.69,-1,-61416,50478,111894,-10938,0,-684,547,0,0,,1231,-137
16,04/19/2017,91,22:30,22:45,,24.36,0,24.36,24.36,-1,-29939,57594,87533,27655,0,-14040,0,0,0,,14040,-14040
16,04/19/2017,92,22:45,23:00,,18.24,0,18.24,18.24,-1,-31068,81423,112491,50355,0,-42487,0,0,0,,42487,-42487
16,04/19/2017,93,23:00,23:15,221.15,18.24,0,221.15,221.15,1,-82531,27597,110128,-54934,0,-19286,8491,0,0,,27777,-10795
16,04/19/2017,94,23:15,23:30,221.15,-8.8,0,221.15,-8.8,2,-30484,55218,85702,24734,0,-3524,19670,0,0,,23194,16146
16,04/19/2017,95,23:30,23:45,221.15,-52.48,0,-52.48,-52.48,-1,-14847,72024,86871,57177,0,-57408,23,0,0,,57431,-57385
16,04/19/2017,96,23:45,0:00,,18.24,0,18.24,18.24,-1,-37337,87090,124427,49753,0,-53429,0,0,0,,53429,-53429
16,04/20/2017,1,0:00,0:15,73.32,19.36,0,73.32,19.36,2,-60701,31764,92465,-28937,0,-29623,1509,0,0,,31132,-28114
16,04/20/2017,2,0:15,0:30,116.12,28.36,0,116.12,28.36,2,-28209,17359,45568,-10850,0,-460,5771,0,0,,6231,5311
16,04/20/2017,3,0:30,0:45,,18.96,0,18.96,18.96,-1,-14136,38903,53039,24767,0,-25742,0,0,0,,25742,-25742
16,04/20/2017,4,0:45,1:00,,23.59,0,23.59,23.59,-1,-32109,66042,98151,33933,0,-39652,0,0,0,,39652,-39652
16,04/20/2017,5,1:00,1:15,93.12,24.36,0,93.12,93.12,1,-16445,7927,24372,-8518,0,-19013,5223,0,0,,24236,-13790
16,04/20/2017,6,1:15,1:30,94.12,,0,94.12,94.12,1,-18981,28533,47514,9552,0,0,8744,0,0,,8744,8744
16,04/20/2017,7,1:30,1:45,,,0,30,30,0,-14944,55420,70364,40476,0,0,2,0,0,,2,2
16,04/20/2017,8,1:45,2:00,,28.36,0,28.36,28.36,-1,-22591,50469,73060,27878,0,-962,0,0,0,,962,-962
16,04/20/2017,9,2:00,2:15,,26.24,0,26.24,26.24,-1,-29591,28417,58008,-1174,0,-2813,0,0,0,,2813,-2813
16,04/20/2017,10,2:15,2:30,29.36,,0,29.36,29.36,1,-28388,33207,61595,4819,0,0,1203,0,0,,1203,1203
16,04/20/2017,11,2:30,2:45,29.36,,0,29.36,29.36,1,-29630,27624,57254,-2006,0,0,2546,0,0,,2546,2546
16,04/20/2017,12,2:45,3:00,29.36,29.36,0,29.36,29.36,-1,-28641,43896,72537,15255,0,-8,1829,0,0,,1837,1821
16,04/20/2017,13,3:00,3:15,,28.36,0,28.36,28.36,-1,-19521,34645,54166,15124,0,-423,0,0,0,,423,-423
16,04/20/2017,14,3:15,3:30,,,0,30,30,0,-21340,35476,56816,14136,0,0,0,0,0,,0,0
16,04/20/2017,15,3:30,3:45,,,0,30,30,0,-21922,39536,61458,17614,0,0,0,0,0,,0,0
16,04/20/2017,16,3:45,4:00,,,0,30,30,0,-20787,31359,52146,10572,0,0,0,0,0,,0,0
16,04/20/2017,17,4:00,4:15,29.62,,0,29.62,29.62,1,-21678,23748,45426,2070,0,0,1374,0,0,,1374,1374
16,04/20/2017,18,4:15,4:30,29.36,,0,29.36,29.36,1,-21575,27276,48851,5701,0,0,355,0,0,,355,355
16,04/20/2017,19,4:30,4:45,30.01,,0,30.01,30.01,1,-26915,17530,44445,-9385,0,0,5146,0,0,,5146,5146
16,04/20/2017,20,4:45,5:00,30.01,,0,30.01,30.01,1,-30515,31690,62205,1175,0,0,2825,0,0,,2825,2825
16,04/20/2017,21,5:00,5:15,30.01,,0,30.01,30.01,1,-40894,44102,84996,3208,0,0,1635,0,0,,1635,1635
16,04/20/2017,22,5:15,5:30,30.01,,0,30.01,30.01,1,-24915,23294,48209,-1621,0,0,428,0,0,,428,428
16,04/20/2017,23,5:30,5:45,39.61,,0,39.61,39.61,1,-47009,15439,62448,-31570,0,0,18539,0,0,,18539,18539
16,04/20/2017,24,5:45,6:00,39.61,,0,39.61,39.61,1,-52311,13498,65809,-38813,0,0,33710,0,0,,33710,33710
16,04/20/2017,25,6:00,6:15,35.12,7.52,0,35.12,7.52,2,-38108,97705,135813,59597,0,-10012,13855,0,0,,23867,3843
16,04/20/2017,26,6:15,6:30,35.12,18.96,0,18.96,18.96,-1,-22929,73771,96700,50842,0,-35653,15,0,0,,35668,-35638
16,04/20/2017,27,6:30,6:45,,19.23,0,19.23,19.23,-1,-41382,70533,111915,29151,0,-39061,0,0,0,,39061,-39061
16,04/20/2017,28,6:45,7:00,30.01,28.23,0,30.18,28.23,2,-64128,76440,140568,12312,0,-4286,243,0,0,,4529,-4043
16,04/20/2017,29,7:00,7:15,,-50.03,0,-50.03,-50.03,-1,-16400,131320,147720,114920,0,-46711,0,0,0,,46711,-46711
16,04/20/2017,30,7:15,7:30,,24.23,0,24.23,24.23,-1,-36270,67590,103860,31320,0,-17830,0,0,0,,17830,-17830
16,04/20/2017,31,7:30,7:45,,28.32,0,28.32,28.32,-1,-42972,36553,79525,-6419,0,-11022,0,0,0,,11022,-11022
16,04/20/2017,32,7:45,8:00,38.41,29.23,0,38.41,29.23,2,-68408,30942,99350,-37466,0,-742,2021,0,0,,2763,1279
16,04/20/2017,33,8:00,8:15,,-27.84,0,-27.84,-27.84,-1,-71915,32430,104345,-39485,0,-16807,0,0,0,,16807,-16807
16,04/20/2017,34,8:15,8:30,32.74,-27.84,0,32.74,32.74,1,-58685,34675,93360,-24010,0,-20,1296,0,0,,1316,1276
16,04/20/2017,35,8:30,8:45,,29.23,0,29.23,29.23,-1,-31942,35942,67884,4000,0,-903,0,0,0,,903,-903
16,04/20/2017,36,8:45,9:00,,29.23,0,29.23,29.23,-1,-50746,33066,83812,-17680,0,-1444,0,0,0,,1444,-1444
16,04/20/2017,37,9:00,9:15,,24.23,0,24.23,24.23,-1,-7774,47241,55015,39467,0,-3345,0,0,0,,3345,-3345
16,04/20/2017,38,9:15,9:30,,18.96,0,18.96,18.96,-1,-5650,62821,68471,57171,0,-35709,0,0,0,,35709,-35709
16,04/20/2017,39,9:30,9:45,,-1.78,0,-1.78,-1.78,-1,-6836,92172,99008,85336,0,-40454,0,0,0,,40454,-40454
16,04/20/2017,40,9:45,10:00,,-1.78,0,-1.78,-1.78,-1,-12088,87212,99300,75124,0,-61474,0,0,0,,61474,-61474
16,04/20/2017,41,10:00,10:15,29.62,24.23,0,29.99,24.23,2,-36139,80916,117055,44777,0,-27106,318,0,0,,27424,-26788
16,04/20/2017,42,10:15,10:30,,11.38,0,11.38,11.38,-1,-28753,92202,120955,63449,0,-23959,0,0,0,,23959,-23959
16,04/20/2017,43,10:30,10:45,,24.23,0,24.23,24.23,-1,-31206,92524,123730,61318,0,-35510,0,0,0,,35510,-35510
16,04/20/2017,44,10:45,11:00,,19.23,0,19.23,19.23,-1,-28153,99208,127361,71055,0,-49282,0,0,0,,49282,-49282
16,04/20/2017,45,11:00,11:15,43.74,21.74,0,43.74,21.74,2,-55257,40604,95861,-14653,0,-27956,1682,0,0,,29638,-26274
16,04/20/2017,46,11:15,11:30,43.74,11.07,0,11.07,11.07,-1,-38784,78030,116814,39246,0,-13678,2333,0,0,,16011,-11345
16,04/20/2017,47,11:30,11:45,,11.07,0,11.07,11.07,-1,-47383,87879,135262,40496,0,-43641,0,0,0,,43641,-43641
16,04/20/2017,48,11:45,12:00,,18.96,0,18.96,18.96,-1,-46091,82368,128459,36277,0,-31528,0,0,0,,31528,-31528
16,04/20/2017,49,12:00,12:15,,13.78,0,13.78,13.78,-1,-71651,84762,156413,13111,0,-29347,0,0,0,,29347,-29347
16,04/20/2017,50,12:15,12:30,,24.74,0,24.74,24.74,-1,-57434,81876,139310,24442,0,-14576,0,0,0,,14576,-14576
16,04/20/2017,51,12:30,12:45,,7.52,0,7.52,7.52,-1,-42888,111471,154359,68583,0,-49534,0,0,0,,49534,-49534
16,04/20/2017,52,12:45,13:00,,7.52,0,7.52,7.52,-1,-48051,122830,170881,74779,0,-78295,0,0,0,,78295,-78295
16,04/20/2017,53,13:00,13:15,,18.96,0,18.96,18.96,-1,-83507,109070,192577,25563,0,-48504,0,0,0,,48504,-48504
16,04/20/2017,54,13:15,13:30,29.23,28.23,0,29.99,28.23,2,-65140,74907,140047,9767,0,-2576,12,0,0,,2588,-2564
16,04/20/2017,55,13:30,13:45,,27.78,0,27.78,27.78,-1,-58242,73207,131449,14965,0,-5698,0,0,0,,5698,-5698
16,04/20/2017,56,13:45,14:00,,26.56,0,26.56,26.56,-1,-57621,80437,138058,22816,0,-18099,0,0,0,,18099,-18099
16,04/20/2017,57,14:00,14:15,,24.23,0,24.23,24.23,-1,-50898,91349,142247,40451,0,-32487,0,0,0,,32487,-32487
16,04/20/2017,58,14:15,14:30,,24.74,0,24.74,24.74,-1,-40306,79021,119327,38715,0,-35786,0,0,0,,35786,-35786
16,04/20/2017,59,14:30,14:45,,24.23,0,24.23,24.23,-1,-38951,77044,115995,38093,0,-37304,0,0,0,,37304,-37304
16,04/20/2017,60,14:45,15:00,,25.61,0,25.61,25.61,-1,-37667,72051,109718,34384,0,-31786,0,0,0,,31786,-31786
16,04/20/2017,61,15:00,15:15,,18.96,0,18.96,18.96,-1,-33725,93842,127567,60117,0,-47786,0,0,0,,47786,-47786
16,04/20/2017,62,15:15,15:30,,18.78,0,18.78,18.78,-1,-44377,99705,144082,55328,0,-62655,0,0,0,,62655,-62655
16,04/20/2017,63,15:30,15:45,,24.74,0,24.74,24.74,-1,-51780,92284,144064,40504,0,-38509,0,0,0,,38509,-38509
16,04/20/2017,64,15:45,16:00,,26.24,0,26.24,26.24,-1,-48739,76128,124867,27389,0,-32638,0,0,0,,32638,-32638
16,04/20/2017,65,16:00,16:15,,21.74,0,21.74,21.74,-1,-41517,91372,132889,49855,0,-38554,0,0,0,,38554,-38554
16,04/20/2017,66,16:15,16:30,,24.23,0,24.23,24.23,-1,-42612,75530,118142,32918,0,-38129,0,0,0,,38129,-38129
16,04/20/2017,67,16:30,16:45,,24.23,0,24.23,24.23,-1,-40961,68717,109678,27756,0,-26429,0,0,0,,26429,-26429
16,04/20/2017,68,16:45,17:00,29.23,24.23,0,29.23,29.23,1,-33537,40166,73703,6629,0,-5832,114,0,0,,5946,-5718
16,04/20/2017,69,17:00,17:15,,,0,29.99,29.99,0,-66046,45418,111464,-20628,0,0,0,0,0,,0,0
16,04/20/2017,70,17:15,17:30,30.01,29.74,0,30.01,29.74,2,-48713,34732,83445,-13981,0,-446,183,0,0,,629,-263
16,04/20/2017,71,17:30,17:45,33.94,,0,33.94,33.94,1,-47823,35050,82873,-12773,0,0,2800,0,0,,2800,2800
16,04/20/2017,72,17:45,18:00,33.94,,0,33.94,33.94,1,-48722,38886,87608,-9836,0,0,4752,0,0,,4752,4752
16,04/20/2017,73,18:00,18:15,29.94,,0,29.94,29.94,1,-81900,24151,106051,-57749,0,0,2207,0,0,,2207,2207
16,04/20/2017,74,18:15,18:30,34.94,,0,34.94,34.94,1,-73246,36258,109504,-36988,0,0,1877,0,0,,1877,1877
16,04/20/2017,75,18:30,18:45,34.94,,0,34.94,34.94,1,-73928,29812,103740,-44116,0,0,7260,0,0,,7260,7260
16,04/20/2017,76,18:45,19:00,45.94,,0,45.94,45.94,1,-77007,21822,98829,-55185,0,0,23850,0,0,,23850,23850
16,04/20/2017,77,19:00,19:15,35.01,,0,35.01,35.01,1,-98364,6239,104603,-92125,0,0,15911,0,0,,15911,15911
16,04/20/2017,78,19:15,19:30,55.12,,0,55.12,55.12,1,-93271,4543,97814,-88728,0,0,12482,0,0,,12482,12482
16,04/20/2017,79,19:30,19:45,281.68,,0,281.68,281.68,1,-87577,15059,102636,-72518,0,0,33609,0,0,,33609,33609
16,04/20/2017,80,19:45,20:00,43.74,,0,43.74,43.74,1,-70534,26488,97022,-44046,0,0,9789,0,0,,9789,9789
16,04/20/2017,81,20:00,20:15,43.74,,0,43.74,43.74,1,-34923,39572,74495,4649,0,0,6558,0,0,,6558,6558
16,04/20/2017,82,20:15,20:30,36.61,,0,36.61,36.61,1,-43311,28380,71691,-14931,0,0,3873,0,0,,3873,3873
16,04/20/2017,83,20:30,20:45,30.66,,0,30.66,30.66,1,-52502,27974,80476,-24528,0,0,1796,0,0,,1796,1796
16,04/20/2017,84,20:45,21:00,75.48,,0,75.48,75.48,1,-87647,11569,99216,-76078,0,0,17492,0,0,,17492,17492
16,04/20/2017,85,21:00,21:15,78.25,,0,78.25,78.25,1,-72224,75751,147975,3527,0,0,25066,0,0,,25066,25066
16,04/20/2017,86,21:15,21:30,118.12,,0,118.12,118.12,1,-67358,69073,136431,1715,0,0,44683,0,0,,44683,44683
16,04/20/2017,87,21:30,21:45,31.73,,0,31.73,31.73,1,-53694,68436,122130,14742,0,0,19157,0,0,,19157,19157
16,04/20/2017,88,21:45,22:00,29.94,,0,29.94,29.94,1,-53032,76936,129968,23904,0,0,3789,0,0,,3789,3789
16,04/20/2017,89,22:00,22:15,37.74,28.23,0,37.74,28.23,2,-69285,70623,139908,1338,0,-807,4931,0,0,,5738,4124
16,04/20/2017,90,22:15,22:30,29.23,21.74,0,21.74,21.74,-1,-44720,55343,100063,10623,0,-2352,2235,0,0,,4587,-117
16,04/20/2017,91,22:30,22:45,,19.23,0,19.23,19.23,-1,-33231,55379,88610,22148,0,-24008,0,0,0,,24008,-24008
16,04/20/2017,92,22:45,23:00,,10.77,0,10.77,10.77,-1,-36441,65209,101650,28768,0,-17324,0,0,0,,17324,-17324
16,04/20/2017,93,23:00,23:15,184.23,3.78,0,184.23,3.78,2,-90256,22080,112336,-68176,0,-13605,8471,0,0,,22076,-5134
16,04/20/2017,94,23:15,23:30,30.66,,0,30.66,30.66,1,-98948,25313,124261,-73635,0,0,6969,0,0,,6969,6969
16,04/20/2017,95,23:30,23:45,222.52,,0,222.52,222.52,1,-76423,18535,94958,-57888,0,0,16562,0,0,,16562,16562
16,04/20/2017,96,23:45,0:00,31.12,,0,31.12,31.12,1,-79057,39172,118229,-39885,0,0,9714,0,0,,9714,9714
16,04/21/2017,1,0:00,0:15,56.82,,0,56.82,56.82,1,-100715,81921,182636,-18794,0,0,11140,0,0,,11140,11140
16,04/21/2017,2,0:15,0:30,81.49,,0,81.49,81.49,1,-86992,43571,130563,-43421,0,0,40148,0,0,,40148,40148
16,04/21/2017,3,0:30,0:45,,,0,27.88,27.88,0,-70162,32511,102673,-37651,0,0,5855,0,0,,5855,5855
16,04/21/2017,4,0:45,1:00,,,0,27.88,27.88,0,-78274,56209,134483,-22065,0,0,0,0,0,,0,0
16,04/21/2017,5,1:00,1:15,143.22,,0,143.22,143.22,1,-84556,23919,108475,-60637,0,0,18844,0,0,,18844,18844
16,04/21/2017,6,1:15,1:30,35.09,,0,35.09,35.09,1,-63374,23921,87295,-39453,0,0,13442,0,0,,13442,13442
16,04/21/2017,7,1:30,1:45,39.94,,0,39.94,39.94,1,-82407,20863,103270,-61544,0,0,6499,0,0,,6499,6499
16,04/21/2017,8,1:45,2:00,27.94,,0,27.94,27.94,1,-73376,24608,97984,-48768,0,0,2960,0,0,,2960,2960
16,04/21/2017,9,2:00,2:15,33.94,,0,33.94,33.94,1,-61215,25414,86629,-35801,0,0,4544,0,0,,4544,4544
16,04/21/2017,10,2:15,2:30,33.57,,0,33.57,33.57,1,-57952,27025,84977,-30927,0,0,10742,0,0,,10742,10742
16,04/21/2017,11,2:30,2:45,25.96,,0,25.96,25.96,1,-55816,28332,84148,-27484,0,0,1225,0,0,,1225,1225
16,04/21/2017,12,2:45,3:00,25.96,,0,25.96,25.96,1,-47362,32776,80138,-14586,0,0,16,0,0,,16,16
16,04/21/2017,13,3:00,3:15,25.92,,0,25.92,25.92,1,-50599,34357,84956,-16242,0,0,499,0,0,,499,499
16,04/21/2017,14,3:15,3:30,25.92,,0,25.92,25.92,1,-54486,30404,84890,-24082,0,0,372,0,0,,372,372
16,04/21/2017,15,3:30,3:45,33.86,,0,33.86,33.86,1,-63910,23173,87083,-40737,0,0,5110,0,0,,5110,5110
16,04/21/2017,16,3:45,4:00,27.94,,0,27.94,27.94,1,-68208,19459,87667,-48749,0,0,2350,0,0,,2350,2350
16,04/21/2017,17,4:00,4:15,27.94,,0,27.94,27.94,1,-83458,25274,108732,-58184,0,0,1748,0,0,,1748,1748
16,04/21/2017,18,4:15,4:30,25.85,,0,25.85,25.85,1,-97387,29407,126794,-67980,0,0,270,0,0,,270,270
16,04/21/2017,19,4:30,4:45,,,0,27.82,27.82,0,-95598,26078,121676,-69520,0,0,0,0,0,,0,0
16,04/21/2017,20,4:45,5:00,27.94,,0,27.94,27.94,1,-92843,28561,121404,-64282,0,0,632,0,0,,632,632
16,04/21/2017,21,5:00,5:15,,,0,27.82,27.82,0,-69803,35473,105276,-34330,0,0,0,0,0,,0,0
16,04/21/2017,22,5:15,5:30,36.09,,0,36.09,36.09,1,-83441,26844,110285,-56597,0,0,2503,0,0,,2503,2503
16,04/21/2017,23,5:30,5:45,126.8,,0,126.8,126.8,1,-106981,23905,130886,-83076,0,0,48927,0,0,,48927,48927
16,04/21/2017,24,5:45,6:00,116.02,,0,116.02,116.02,1,-82825,47692,130517,-35133,0,0,60748,0,0,,60748,60748
16,04/21/2017,25,6:00,6:15,29.79,,0,29.79,29.79,1,-172904,76278,249182,-96626,0,0,13165,0,0,,13165,13165
16,04/21/2017,26,6:15,6:30,29.79,26.79,0,26.79,26.79,-1,-65958,70919,136877,4961,0,-2630,357,0,0,,2987,-2273
16,04/21/2017,27,6:30,6:45,33.79,27.79,0,33.79,27.79,2,-74234,45926,120160,-28308,0,-3474,219,0,0,,3693,-3255
16,04/21/2017,28,6:45,7:00,133.56,27.79,0,133.56,133.56,1,-124065,48234,172299,-75831,0,-77,30974,0,0,,31051,30897
16,04/21/2017,29,7:00,7:15,32.16,-4.79,0,32.16,-4.79,2,-42746,87366,130112,44620,0,-10438,6572,0,0,,17010,-3866
16,04/21/2017,30,7:15,7:30,29.79,29.29,0,29.79,27.91,2,-46070,43485,89555,-2585,0,-816,461,0,0,,1277,-355
16,04/21/2017,31,7:30,7:45,132.02,,0,132.02,132.02,1,-112535,47595,160130,-64940,0,0,18602,0,0,,18602,18602
16,04/21/2017,32,7:45,8:00,114.51,,0,114.51,114.51,1,-140382,50966,191348,-89416,0,0,52944,0,0,,52944,52944
16,04/21/2017,33,8:00,8:15,35.07,,0,35.07,35.07,1,-78378,50345,128723,-28033,0,0,23847,0,0,,23847,23847
16,04/21/2017,34,8:15,8:30,58.67,,0,58.67,58.67,1,-93883,41491,135374,-52392,0,0,18344,0,0,,18344,18344
16,04/21/2017,35,8:30,8:45,76.02,,0,76.02,76.02,1,-100264,41449,141713,-58815,0,0,42747,0,0,,42747,42747
16,04/21/2017,36,8:45,9:00,47.67,,0,47.67,47.67,1,-114814,53298,168112,-61516,0,0,39744,0,0,,39744,39744
16,04/21/2017,37,9:00,9:15,60,,0,60,60,1,-118556,61376,179932,-57180,0,0,51593,0,0,,51593,51593
16,04/21/2017,38,9:15,9:30,61.76,,0,61.76,61.76,1,-131769,57811,189580,-73958,0,0,58172,0,0,,58172,58172
16,04/21/2017,39,9:30,9:45,60,,0,60,60,1,-111408,67705,179113,-43703,0,0,53825,0,0,,53825,53825
16,04/21/2017,40,9:45,10:00,25.68,,0,25.68,25.68,1,-100824,79546,180370,-21278,0,0,14175,0,0,,14175,14175
16,04/21/2017,41,10:00,10:15,131.02,,0,131.02,131.02,1,-125792,77320,203112,-48472,0,0,12215,0,0,,12215,12215
16,04/21/2017,42,10:15,10:30,131.02,26.79,0,26.79,26.79,-1,-75081,77686,152767,2605,0,-295,24275,0,0,,24570,23980
16,04/21/2017,43,10:30,10:45,131.02,19.8,0,19.8,19.8,-1,-60614,77946,138560,17332,0,-17068,19,0,0,,17087,-17049
16,04/21/2017,44,10:45,11:00,,28.03,0,28.03,28.03,-1,-75290,75562,150852,272,0,-7793,0,0,0,,7793,-7793
16,04/21/2017,45,11:00,11:15,35.07,29.29,0,35.07,27.61,2,-103927,73986,177913,-29941,0,-1074,4099,0,0,,5173,3025
16,04/21/2017,46,11:15,11:30,25.42,,0,25.42,25.42,1,-70515,74897,145412,4382,0,0,707,0,0,,707,707
16,04/21/2017,47,11:30,11:45,,27.79,0,27.79,27.79,-1,-62756,69459,132215,6703,0,-2050,0,0,0,,2050,-2050
16,04/21/2017,48,11:45,12:00,,22.86,0,22.86,22.86,-1,-47316,73932,121248,26616,0,-21581,0,0,0,,21581,-21581
16,04/21/2017,49,12:00,12:15,36.09,25.41,0,36.09,25.41,2,-87972,76221,164193,-11751,0,-18576,1517,0,0,,20093,-17059
16,04/21/2017,50,12:15,12:30,36.09,29.29,0,29.29,29.29,-1,-63252,58887,122139,-4365,0,-173,1574,0,0,,1747,1401
16,04/21/2017,51,12:30,12:45,,27.79,0,27.79,27.79,-1,-51438,66515,117953,15077,0,-2643,0,0,0,,2643,-2643
16,04/21/2017,52,12:45,13:00,,26.79,0,26.79,26.79,-1,-44094,64561,108655,20467,0,-12866,0,0,0,,12866,-12866
16,04/21/2017,53,13:00,13:15,130.02,24.03,0,130.02,24.03,2,-98154,41882,140036,-56272,0,-12748,9871,0,0,,22619,-2877
16,04/21/2017,54,13:15,13:30,142.39,17.92,0,142.39,17.92,2,-54277,49190,103467,-5087,0,-549,35809,0,0,,36358,35260
16,04/21/2017,55,13:30,13:45,33.79,-27.08,0,33.79,-27.08,2,-47885,57015,104900,9130,0,-17940,919,0,0,,18859,-17021
16,04/21/2017,56,13:45,14:00,36.09,27.33,0,36.09,27.33,2,-52099,41644,93743,-10455,0,-194,4341,0,0,,4535,4147
16,04/21/2017,57,14:00,14:15,142.69,26.79,0,142.69,26.79,2,-82651,29219,111870,-53432,0,-1484,11832,0,0,,13316,10348
16,04/21/2017,58,14:15,14:30,142.69,,0,142.69,142.69,1,-74951,47456,122407,-27495,0,0,46618,0,0,,46618,46618
16,04/21/2017,59,14:30,14:45,,,0,27.36,27.36,0,-62580,61332,123912,-1248,0,0,4734,0,0,,4734,4734
16,04/21/2017,60,14:45,15:00,,26.79,0,26.79,26.79,-1,-50762,56913,107675,6151,0,-3165,0,0,0,,3165,-3165
16,04/21/2017,61,15:00,15:15,36.09,26.79,0,36.09,26.79,2,-66293,51513,117806,-14780,0,-4014,5813,0,0,,9827,1799
16,04/21/2017,62,15:15,15:30,53.02,,0,53.02,53.02,1,-72120,45017,117137,-27103,0,0,19185,0,0,,19185,19185
16,04/21/2017,63,15:30,15:45,34.02,,0,34.02,34.02,1,-75198,74786,149984,-412,0,0,21168,0,0,,21168,21168
16,04/21/2017,64,15:45,16:00,,,0,27.33,27.33,0,-82530,61843,144373,-20687,0,0,1687,0,0,,1687,1687
16,04/21/2017,65,16:00,16:15,35.09,,0,35.09,35.09,1,-75577,51107,126684,-24470,0,0,8568,0,0,,8568,8568
16,04/21/2017,66,16:15,16:30,29.79,,0,29.79,29.79,1,-75258,66862,142120,-8396,0,0,10046,0,0,,10046,10046
16,04/21/2017,67,16:30,16:45,,,0,27.31,27.31,0,-60402,71376,131778,10974,0,0,1106,0,0,,1106,1106
16,04/21/2017,68,16:45,17:00,29.15,,0,29.15,29.15,1,-65487,69223,134710,3736,0,0,1367,0,0,,1367,1367
16,04/21/2017,69,17:00,17:15,40.37,,0,40.37,40.37,1,-43096,20439,63535,-22657,0,0,4335,0,0,,4335,4335
16,04/21/2017,70,17:15,17:30,42.5,,0,42.5,42.5,1,-67442,27150,94592,-40292,0,0,22918,0,0,,22918,22918
16,04/21/2017,71,17:30,17:45,40.37,,0,40.37,40.37,1,-73076,22842,95918,-50234,0,0,31449,0,0,,31449,31449
16,04/21/2017,72,17:45,18:00,35.09,,0,35.09,35.09,1,-66952,32849,99801,-34103,0,0,31571,0,0,,31571,31571
16,04/21/2017,73,18:00,18:15,32.66,,0,32.66,32.66,1,-62312,54262,116574,-8050,0,0,16980,0,0,,16980,16980
16,04/21/2017,74,18:15,18:30,29.79,,0,29.79,29.79,1,-49655,48750,98405,-905,0,0,1744,0,0,,1744,1744
16,04/21/2017,75,18:30,18:45,40.37,,0,40.37,40.37,1,-52929,29922,82851,-23007,0,0,7618,0,0,,7618,7618
16,04/21/2017,76,18:45,19:00,40.37,,0,40.37,40.37,1,-44605,44412,89017,-193,0,0,13998,0,0,,13998,13998
16,04/21/2017,77,19:00,19:15,30.58,,0,30.58,30.58,1,-89979,48812,138791,-41167,0,0,1149,0,0,,1149,1149
16,04/21/2017,78,19:15,19:30,29.15,,0,29.15,29.15,1,-86921,41607,128528,-45314,0,0,1395,0,0,,1395,1395
16,04/21/2017,79,19:30,19:45,29.79,,0,29.79,29.79,1,-75721,40892,116613,-34829,0,0,3371,0,0,,3371,3371
16,04/21/2017,80,19:45,20:00,50.22,,0,50.22,50.22,1,-87890,41078,128968,-46812,0,0,24109,0,0,,24109,24109
16,04/21/2017,81,20:00,20:15,33.79,18.88,0,18.88,18.88,-1,-70202,100099,170301,29897,0,-1608,16210,0,0,,17818,14602
16,04/21/2017,82,20:15,20:30,33.79,7.44,0,7.44,7.44,-1,-59443,59348,118791,-95,0,-16925,93,0,0,,17018,-16832
16,04/21/2017,83,20:30,20:45,,26.79,0,26.79,26.79,-1,-56763,58609,115372,1846,0,-2873,0,0,0,,2873,-2873
16,04/21/2017,84,20:45,21:00,,27.33,0,27.33,27.33,-1,-59977,68377,128354,8400,0,-4267,0,0,0,,4267,-4267
16,04/21/2017,85,21:00,21:15,35.09,27.03,0,35.09,27.03,2,-101254,101532,202786,278,0,-5195,4552,0,0,,9747,-643
16,04/21/2017,86,21:15,21:30,24.87,22.79,0,22.79,22.79,-1,-64629,94336,158965,29707,0,-8162,1940,0,0,,10102,-6222
16,04/21/2017,87,21:30,21:45,,22.79,0,22.79,22.79,-1,-68162,87207,155369,19045,0,-29447,0,0,0,,29447,-29447
16,04/21/2017,88,21:45,22:00,,25.49,0,25.49,25.49,-1,-69204,92572,161776,23368,0,-24868,0,0,0,,24868,-24868
16,04/21/2017,89,22:00,22:15,35.09,22.67,0,35.09,22.67,2,-83372,67224,150596,-16148,0,-18091,859,0,0,,18950,-17232
16,04/21/2017,90,22:15,22:30,36.09,26.16,0,36.09,26.16,2,-61845,55447,117292,-6398,0,-1113,2138,0,0,,3251,1025
16,04/21/2017,91,22:30,22:45,,22.79,0,22.79,22.79,-1,-40846,59762,100608,18916,0,-8179,0,0,0,,8179,-8179
16,04/21/2017,92,22:45,23:00,,17.92,0,17.92,17.92,-1,-44478,60599,105077,16121,0,-5330,0,0,0,,5330,-5330
16,04/21/2017,93,23:00,23:15,184.15,18.03,0,184.15,184.15,1,-68343,21305,89648,-47038,0,-6426,9835,0,0,,16261,3409
16,04/21/2017,94,23:15,23:30,184.15,26.93,0,184.15,26.93,2,-44574,29459,74033,-15115,0,-173,31699,0,0,,31872,31526
16,04/21/2017,95,23:30,23:45,184.15,21.65,0,21.65,21.65,-1,-21475,46778,68253,25303,0,-3644,200,0,0,,3844,-3444
16,04/21/2017,96,23:45,0:00,,29.66,0,29.66,29.66,-1,-49739,42731,92470,-7008,0,-1395,0,0,0,,1395,-1395
17,04/22/2017,1,0:00,0:15,139.3,29.66,0,139.3,139.3,1,-75606,19471,95077,-56135,0,-197,18859,0,0,,19056,18662
17,04/22/2017,2,0:15,0:30,45.9,27.79,0,27.79,27.79,-1,-51471,34269,85740,-17202,0,-17,25706,0,0,,25723,25689
17,04/22/2017,3,0:30,0:45,45.9,27.62,0,27.62,27.62,-1,-33371,25242,58613,-8129,0,-238,486,0,0,,724,248
17,04/22/2017,4,0:45,1:00,,26.31,0,26.31,26.31,-1,-13947,20850,34797,6903,0,-3910,0,0,0,,3910,-3910
17,04/22/2017,5,1:00,1:15,99.28,26.31,0,99.28,99.28,1,-64817,23816,88633,-41001,0,-502,14899,0,0,,15401,14397
17,04/22/2017,6,1:15,1:30,94.12,26.31,0,26.31,26.31,-1,-37135,28476,65611,-8659,0,-433,19169,0,0,,19602,18736
17,04/22/2017,7,1:30,1:45,94.12,26.31,0,26.31,26.31,-1,-18133,24108,42241,5975,0,-2923,18,0,0,,2941,-2905
17,04/22/2017,8,1:45,2:00,,27.62,0,27.62,27.62,-1,-22699,33174,55873,10475,0,-823,0,0,0,,823,-823
17,04/22/2017,9,2:00,2:15,41.17,27.62,0,41.17,41.17,1,-37053,8628,45681,-28425,0,-7,8753,0,0,,8760,8746
17,04/22/2017,10,2:15,2:30,31.17,,0,31.17,31.17,1,-20782,5835,26617,-14947,0,0,13458,0,0,,13458,13458
17,04/22/2017,11,2:30,2:45,31.17,22.31,0,22.31,22.31,-1,-10145,25817,35962,15672,0,-1519,1778,0,0,,3297,259
17,04/22/2017,12,2:45,3:00,,17.31,0,17.31,17.31,-1,-7751,29682,37433,21931,0,-28333,0,0,0,,28333,-28333
17,04/22/2017,13,3:00,3:15,31.17,29.18,0,31.17,31.17,1,-39596,11704,51300,-27892,0,-7485,1728,0,0,,9213,-5757
17,04/22/2017,14,3:15,3:30,32.21,,0,32.21,32.21,1,-31346,13715,45061,-17631,0,0,6818,0,0,,6818,6818
17,04/22/2017,15,3:30,3:45,29.17,,0,29.17,29.17,1,-23142,22803,45945,-339,0,0,2304,0,0,,2304,2304
17,04/22/2017,16,3:45,4:00,29.17,27.31,0,29.17,27.31,2,-22257,29387,51644,7130,0,-42,458,0,0,,500,416
17,04/22/2017,17,4:00,4:15,,26.78,0,26.78,26.78,-1,-18812,26991,45803,8179,0,-3127,0,0,0,,3127,-3127
17,04/22/2017,18,4:15,4:30,29.29,27.31,0,29.29,27.31,2,-22553,30613,53166,8060,0,-170,1040,0,0,,1210,870
17,04/22/2017,19,4:30,4:45,,21.59,0,21.59,21.59,-1,-15117,57610,72727,42493,0,-13786,0,0,0,,13786,-13786
17,04/22/2017,20,4:45,5:00,,22.31,0,22.31,22.31,-1,-25713,63897,89610,38184,0,-24943,0,0,0,,24943,-24943
17,04/22/2017,21,5:00,5:15,29.17,26.31,0,29.17,29.17,1,-29895,53077,82972,23182,0,-15376,27,0,0,,15403,-15349
17,04/22/2017,22,5:15,5:30,29.17,27.31,0,29.17,27.31,2,-24555,45454,70009,20899,0,-865,65,0,0,,930,-800
17,04/22/2017,23,5:30,5:45,,,0,27.63,27.63,0,-37586,30343,67929,-7243,0,-13,0,0,0,,13,-13
17,04/22/2017,24,5:45,6:00,31.04,,0,31.04,31.04,1,-65654,24119,89773,-41535,0,0,1316,0,0,,1316,1316
17,04/22/2017,25,6:00,6:15,31.08,,0,31.08,31.08,1,-57172,34609,91781,-22563,0,0,4689,0,0,,4689,4689
17,04/22/2017,26,6:15,6:30,29.08,,0,29.08,29.08,1,-41831,33670,75501,-8161,0,0,1632,0,0,,1632,1632
17,04/22/2017,27,6:30,6:45,,,0,27.67,27.67,0,-42548,33910,76458,-8638,0,0,371,0,0,,371,371
17,04/22/2017,28,6:45,7:00,,,0,27.67,27.67,0,-63031,44142,107173,-18889,0,0,0,0,0,,0,0
17,04/22/2017,29,7:00,7:15,35.33,,0,35.33,35.33,1,-64647,58715,123362,-5932,0,0,6100,0,0,,6100,6100
17,04/22/2017,30,7:15,7:30,31.04,26.04,0,31.04,26.04,2,-46678,63529,110207,16851,0,-1341,5106,0,0,,6447,3765
17,04/22/2017,31,7:30,7:45,60.83,,0,60.83,60.83,1,-64011,29963,93974,-34048,0,0,19880,0,0,,19880,19880
17,04/22/2017,32,7:45,8:00,33.89,-23.04,0,-23.04,-23.04,-1,-43648,90741,134389,47093,0,-10867,8695,0,0,,19562,-2172
17,04/22/2017,33,8:00,8:15,67.09,-23.04,0,67.09,67.09,1,-90585,60263,150848,-30322,0,-6437,10618,0,0,,17055,4181
17,04/22/2017,34,8:15,8:30,31.08,,0,31.08,31.08,1,-84767,76939,161706,-7828,0,0,9216,0,0,,9216,9216
17,04/22/2017,35,8:30,8:45,31.08,20.31,0,20.31,20.31,-1,-73808,91945,165753,18137,0,-11096,565,0,0,,11661,-10531
17,04/22/2017,36,8:45,9:00,29.09,20.31,0,29.09,29.09,1,-86046,80782,166828,-5264,0,-677,707,0,0,,1384,30
17,04/22/2017,37,9:00,9:15,29.09,-20.98,0,-20.98,-20.98,-1,-65449,116323,181772,50874,0,-23692,19,0,0,,23711,-23673
17,04/22/2017,38,9:15,9:30,,5.27,0,5.27,5.27,-1,-70385,106916,177301,36531,0,-13285,0,0,0,,13285,-13285
17,04/22/2017,39,9:30,9:45,,5.27,0,5.27,5.27,-1,-62652,88548,151200,25896,0,-30271,0,0,0,,30271,-30271
17,04/22/2017,40,9:45,10:00,,22.96,0,22.96,22.96,-1,-69864,93734,163598,23870,0,-28118,0,0,0,,28118,-28118
17,04/22/2017,41,10:00,10:15,,22.04,0,22.04,22.04,-1,-38136,80938,119074,42802,0,-29114,0,0,0,,29114,-29114
17,04/22/2017,42,10:15,10:30,,22.04,0,22.04,22.04,-1,-47678,87016,134694,39338,0,-35535,0,0,0,,35535,-35535
17,04/22/2017,43,10:30,10:45,,21.38,0,21.38,21.38,-1,-47158,83811,130969,36653,0,-37648,0,0,0,,37648,-37648
17,04/22/2017,44,10:45,11:00,,17.04,0,17.04,17.04,-1,-60668,69435,130103,8767,0,-39953,0,0,0,,39953,-39953
17,04/22/2017,45,11:00,11:15,53.85,17.04,0,53.85,53.85,1,-51104,30948,82052,-20156,0,-6140,12339,0,0,,18479,6199
17,04/22/2017,46,11:15,11:30,33.04,26.04,0,26.04,26.04,-1,-51118,58737,109855,7619,0,-539,11417,0,0,,11956,10878
17,04/22/2017,47,11:30,11:45,33.04,22.04,0,22.04,22.04,-1,-35779,61307,97086,25528,0,-15984,86,0,0,,16070,-15898
17,04/22/2017,48,11:45,12:00,55.15,28.53,0,55.15,28.53,2,-56989,36911,93900,-20078,0,-5575,8765,0,0,,14340,3190
17,04/22/2017,49,12:00,12:15,35.08,,0,35.08,35.08,1,-74507,52347,126854,-22160,0,0,20899,0,0,,20899,20899
17,04/22/2017,50,12:15,12:30,29.08,,0,29.08,29.08,1,-58406,41351,99757,-17055,0,0,7666,0,0,,7666,7666
17,04/22/2017,51,12:30,12:45,29.48,,0,29.48,29.48,1,-58593,49052,107645,-9541,0,0,1534,0,0,,1534,1534
17,04/22/2017,52,12:45,13:00,29.48,26.04,0,26.04,26.04,-1,-48737,57701,106438,8964,0,-1179,357,0,0,,1536,-822
17,04/22/2017,53,13:00,13:15,,26.04,0,26.04,26.04,-1,-35531,38187,73718,2656,0,-1257,0,0,0,,1257,-1257
17,04/22/2017,54,13:15,13:30,31.08,,0,31.08,31.08,1,-55562,41903,97465,-13659,0,0,2477,0,0,,2477,2477
17,04/22/2017,55,13:30,13:45,31.08,26.04,0,26.04,26.04,-1,-47012,54771,101783,7759,0,-709,205,0,0,,914,-504
17,04/22/2017,56,13:45,14:00,35.08,23.33,0,35.08,23.33,2,-66359,47701,114060,-18658,0,-5099,1149,0,0,,6248,-3950
17,04/22/2017,57,14:00,14:15,41.08,26.04,0,41.08,26.04,2,-55988,62416,118404,6428,0,-690,11723,0,0,,12413,11033
17,04/22/2017,58,14:15,14:30,30.13,26.04,0,30.13,30.13,1,-69182,63042,132224,-6140,0,-964,840,0,0,,1804,-124
17,04/22/2017,59,14:30,14:45,30.13,24.78,0,24.78,24.78,-1,-64519,77965,142484,13446,0,-3737,324,0,0,,4061,-3413
17,04/22/2017,60,14:45,15:00,,20.31,0,20.31,20.31,-1,-44567,84047,128614,39480,0,-19804,0,0,0,,19804,-19804
17,04/22/2017,61,15:00,15:15,29.08,25.78,0,29.08,29.08,1,-41514,44051,85565,2537,0,-13610,52,0,0,,13662,-13558
17,04/22/2017,62,15:15,15:30,31.08,25.78,0,31.08,31.08,1,-51135,51746,102881,611,0,-103,944,0,0,,1047,841
17,04/22/2017,63,15:30,15:45,,,0,27.66,27.66,0,-31368,60262,91630,28894,0,0,152,0,0,,152,152
17,04/22/2017,64,15:45,16:00,,,0,27.66,27.66,0,-42225,79038,121263,36813,0,0,0,0,0,,0,0
17,04/22/2017,65,16:00,16:15,,,0,27.67,27.67,0,-28539,101460,129999,72921,0,0,0,0,0,,0,0
17,04/22/2017,66,16:15,16:30,,29.57,0,29.57,29.57,-1,-26328,80100,106428,53772,0,-4,0,0,0,,4,-4
17,04/22/2017,67,16:30,16:45,,29.57,0,29.57,29.57,-1,-17583,66187,83770,48604,0,-570,0,0,0,,570,-570
17,04/22/2017,68,16:45,17:00,,,0,27.67,27.67,0,-24011,51233,75244,27222,0,-59,0,0,0,,59,-59
17,04/22/2017,69,17:00,17:15,,28.53,0,28.53,28.53,-1,-47202,89829,137031,42627,0,-596,0,0,0,,596,-596
17,04/22/2017,70,17:15,17:30,,29.18,0,29.18,29.18,-1,-41154,51272,92426,10118,0,-1038,0,0,0,,1038,-1038
17,04/22/2017,71,17:30,17:45,31.08,,0,31.08,31.08,1,-41558,48335,89893,6777,0,0,156,0,0,,156,156
17,04/22/2017,72,17:45,18:00,63.12,,0,63.12,63.12,1,-70352,53242,123594,-17110,0,0,18814,0,0,,18814,18814
17,04/22/2017,73,18:00,18:15,31.04,,0,31.04,31.04,1,-54490,39401,93891,-15089,0,0,3647,0,0,,3647,3647
17,04/22/2017,74,18:15,18:30,31.08,,0,31.08,31.08,1,-46948,44006,90954,-2942,0,0,2702,0,0,,2702,2702
17,04/22/2017,75,18:30,18:45,41.12,,0,41.12,41.12,1,-60778,31201,91979,-29577,0,0,14494,0,0,,14494,14494
17,04/22/2017,76,18:45,19:00,34.89,,0,34.89,34.89,1,-43096,41253,84349,-1843,0,0,19269,0,0,,19269,19269
17,04/22/2017,77,19:00,19:15,41.08,26.04,0,41.08,26.04,2,-64241,49854,114095,-14387,0,-2039,4154,0,0,,6193,2115
17,04/22/2017,78,19:15,19:30,87.12,,0,87.12,87.12,1,-67063,46035,113098,-21028,0,0,31112,0,0,,31112,31112
17,04/22/2017,79,19:30,19:45,87.12,17.04,0,17.04,17.04,-1,-39636,58541,98177,18905,0,-9761,4678,0,0,,14439,-5083
17,04/22/2017,80,19:45,20:00,29.08,26.04,0,29.08,26.04,2,-33817,38797,72614,4980,0,-1899,67,0,0,,1966,-1832
17,04/22/2017,81,20:00,20:15,,15.43,0,15.43,15.43,-1,-58348,88968,147316,30620,0,-21511,0,0,0,,21511,-21511
17,04/22/2017,82,20:15,20:30,95.12,15.43,0,95.12,95.12,1,-79265,61092,140357,-18173,0,-2820,15742,0,0,,18562,12922
17,04/22/2017,83,20:30,20:45,95.12,-37.16,0,-37.16,-37.16,-1,-46579,82192,128771,35613,0,-19991,2787,0,0,,22778,-17204
17,04/22/2017,84,20:45,21:00,41.08,26.04,0,41.08,26.04,2,-68056,62950,131006,-5106,0,-3068,4381,0,0,,7449,1313
17,04/22/2017,85,21:00,21:15,45.9,22.04,0,45.9,22.04,2,-74411,51456,125867,-22955,0,-2440,3293,0,0,,5733,853
17,04/22/2017,86,21:15,21:30,75.61,,0,75.61,75.61,1,-70935,42626,113561,-28309,0,0,31537,0,0,,31537,31537
17,04/22/2017,87,21:30,21:45,75.61,17.04,0,17.04,17.04,-1,-43393,65639,109032,22246,0,-9267,4759,0,0,,14026,-4508
17,04/22/2017,88,21:45,22:00,36.89,16.78,0,37.34,16.78,2,-40931,41193,82124,262,0,-29325,578,0,0,,29903,-28747
17,04/22/2017,89,22:00,22:15,41.1,17.04,0,41.1,17.04,2,-49852,80842,130694,30990,0,-6985,2073,0,0,,9058,-4912
17,04/22/2017,90,22:15,22:30,41.1,16.78,0,41.1,16.78,2,-73426,50936,124362,-22490,0,-11994,2739,0,0,,14733,-9255
17,04/22/2017,91,22:30,22:45,41.1,,0,41.1,41.1,1,-59986,37309,97295,-22677,0,0,15738,0,0,,15738,15738
17,04/22/2017,92,22:45,23:00,29.48,26.45,0,26.45,26.45,-1,-39706,36010,75716,-3696,0,-295,8114,0,0,,8409,7819
17,04/22/2017,93,23:00,23:15,102.12,26.04,0,102.12,26.04,2,-75915,43857,119772,-32058,0,-705,11238,0,0,,11943,10533
17,04/22/2017,94,23:15,23:30,102.12,22.04,0,102.12,22.04,2,-51287,39185,90472,-12102,0,-95,35561,0,0,,35656,35466
17,04/22/2017,95,23:30,23:45,41.08,-51.02,0,41.08,-51.02,2,-41689,48302,89991,6613,0,-18137,1987,0,0,,20124,-16150
17,04/22/2017,96,23:45,0:00,208.17,-51.02,0,208.17,208.17,1,-109380,68237,177617,-41143,0,-10,26943,0,0,,26953,26933
17,04/23/2017,1,0:00,0:15,48.11,,0,48.11,48.11,1,-71271,34098,105369,-37173,0,0,21230,0,0,,21230,21230
17,04/23/2017,2,0:15,0:30,31.37,22.42,0,22.42,22.42,-1,-34405,51355,85760,16950,0,-3735,9725,0,0,,13460,5990
17,04/23/2017,3,0:30,0:45,45.86,19.49,0,45.86,19.49,2,-38267,19579,57846,-18688,0,-19456,620,0,0,,20076,-18836
17,04/23/2017,4,0:45,1:00,139.2,19.49,0,139.2,139.2,1,-78317,21783,100100,-56534,0,-436,38173,0,0,,38609,37737
17,04/23/2017,5,1:00,1:15,70.02,,0,70.02,70.02,1,-98659,42946,141605,-55713,0,0,45549,0,0,,45549,45549
17,04/23/2017,6,1:15,1:30,41.37,,0,41.37,41.37,1,-71469,51402,122871,-20067,0,0,32706,0,0,,32706,32706
17,04/23/2017,7,1:30,1:45,44.49,27.87,0,44.49,27.87,2,-66330,48708,115038,-17622,0,-940,6265,0,0,,7205,5325
17,04/23/2017,8,1:45,2:00,131.02,,0,131.02,131.02,1,-90168,44201,134369,-45967,0,0,37001,0,0,,37001,37001
17,04/23/2017,9,2:00,2:15,34.87,23.87,0,23.87,23.87,-1,-28922,34382,63304,5460,0,-779,19176,0,0,,19955,18397
17,04/23/2017,10,2:15,2:30,34.87,23.87,0,34.87,23.87,2,-35635,19224,54859,-16411,0,-6299,1444,0,0,,7743,-4855
17,04/23/2017,11,2:30,2:45,131.02,,0,131.02,131.02,1,-77502,17080,94582,-60422,0,0,39476,0,0,,39476,39476
17,04/23/2017,12,2:45,3:00,44.49,,0,44.49,44.49,1,-79118,58671,137789,-20447,0,0,33989,0,0,,33989,33989
17,04/23/2017,13,3:00,3:15,44.49,28.53,0,44.49,28.53,2,-74888,54078,128966,-20810,0,-231,5747,0,0,,5978,5516
17,04/23/2017,14,3:15,3:30,120.32,,0,120.32,120.32,1,-73502,42595,116097,-30907,0,0,32281,0,0,,32281,32281
17,04/23/2017,15,3:30,3:45,30.87,,0,30.87,30.87,1,-45707,35299,81006,-10408,0,0,5758,0,0,,5758,5758
17,04/23/2017,16,3:45,4:00,40.87,,0,40.87,40.87,1,-58658,30009,88667,-28649,0,0,10726,0,0,,10726,10726
17,04/23/2017,17,4:00,4:15,44.49,,0,44.49,44.49,1,-60859,42106,102965,-18753,0,0,9843,0,0,,9843,9843
17,04/23/2017,18,4:15,4:30,53.02,,0,53.02,53.02,1,-57756,45486,103242,-12270,0,0,25566,0,0,,25566,25566
17,04/23/2017,19,4:30,4:45,28.87,28.53,0,29.22,28.53,2,-63431,64343,127774,912,0,-694,2989,0,0,,3683,2295
17,04/23/2017,20,4:45,5:00,30.87,,0,30.87,30.87,1,-62726,65630,128356,2904,0,0,1384,0,0,,1384,1384
17,04/23/2017,21,5:00,5:15,,27.87,0,27.87,27.87,-1,-47263,56595,103858,9332,0,-3133,0,0,0,,3133,-3133
17,04/23/2017,22,5:15,5:30,127.19,27.87,0,127.19,127.19,1,-76690,22474,99164,-54216,0,-335,10911,0,0,,11246,10576
17,04/23/2017,23,5:30,5:45,127.19,,0,127.19,127.19,1,-122868,24228,147096,-98640,0,0,73781,0,0,,73781,73781
17,04/23/2017,24,5:45,6:00,55.02,28.53,0,28.53,28.53,-1,-77043,56062,133105,-20981,0,-61,41850,0,0,,41911,41789
17,04/23/2017,25,6:00,6:15,55.02,27.03,0,27.03,27.03,-1,-55590,68544,124134,12954,0,-1826,293,0,0,,2119,-1533
17,04/23/2017,26,6:15,6:30,,23.66,0,23.66,23.66,-1,-42376,66555,108931,24179,0,-4773,0,0,0,,4773,-4773
17,04/23/2017,27,6:30,6:45,,22.42,0,22.42,22.42,-1,-35727,78932,114659,43205,0,-27768,0,0,0,,27768,-27768
17,04/23/2017,28,6:45,7:00,31.12,29.18,0,31.12,31.12,1,-38354,57035,95389,18681,0,-8035,127,0,0,,8162,-7908
17,04/23/2017,29,7:00,7:15,34.66,,0,34.66,34.66,1,-61500,45744,107244,-15756,0,0,10235,0,0,,10235,10235
17,04/23/2017,30,7:15,7:30,40.66,,0,40.66,40.66,1,-62491,43259,105750,-19232,0,0,3038,0,0,,3038,3038
17,04/23/2017,31,7:30,7:45,44.49,25.46,0,44.49,25.46,2,-67244,61826,129070,-5418,0,-71,20523,0,0,,20594,20452
17,04/23/2017,32,7:45,8:00,44.49,18.66,0,18.66,18.66,-1,-54158,75453,129611,21295,0,-18385,1011,0,0,,19396,-17374
17,04/23/2017,33,8:00,8:15,,21.21,0,21.21,21.21,-1,-31001,59278,90279,28277,0,-24261,0,0,0,,24261,-24261
17,04/23/2017,34,8:15,8:30,,16.82,0,16.82,16.82,-1,-28573,65268,93841,36695,0,-24199,0,0,0,,24199,-24199
17,04/23/2017,35,8:30,8:45,,-20.24,0,-20.24,-20.24,-1,-19226,80155,99381,60929,0,-47316,0,0,0,,47316,-47316
17,04/23/2017,36,8:45,9:00,,-20.24,0,-20.24,-20.24,-1,-24901,63899,88800,38998,0,-46833,0,0,0,,46833,-46833
17,04/23/2017,37,9:00,9:15,,18.66,0,18.66,18.66,-1,-34615,69530,104145,34915,0,-35835,0,0,0,,35835,-35835
17,04/23/2017,38,9:15,9:30,,18.66,0,18.66,18.66,-1,-56142,82140,138282,25998,0,-40285,0,0,0,,40285,-40285
17,04/23/2017,39,9:30,9:45,,23.02,0,23.02,23.02,-1,-53112,75066,128178,21954,0,-24077,0,0,0,,24077,-24077
17,04/23/2017,40,9:45,10:00,,17.79,0,17.79,17.79,-1,-61707,86069,147776,24362,0,-34128,0,0,0,,34128,-34128
17,04/23/2017,41,10:00,10:15,40.66,28.66,0,40.66,28.66,2,-93874,88977,182851,-4897,0,-8516,2643,0,0,,11159,-5873
17,04/23/2017,42,10:15,10:30,30.87,28.66,0,36.71,28.66,2,-79809,68678,148487,-11131,0,-285,591,0,0,,876,306
17,04/23/2017,43,10:30,10:45,44.49,,0,44.49,44.49,1,-67230,61232,128462,-5998,0,0,15813,0,0,,15813,15813
17,04/23/2017,44,10:45,11:00,33.19,19.01,0,36.71,19.01,2,-53480,61744,115224,8264,0,-8118,2039,0,0,,10157,-6079
17,04/23/2017,45,11:00,11:15,43.4,25.46,0,43.4,25.46,2,-29632,43249,72881,13617,0,-581,4593,0,0,,5174,4012
17,04/23/2017,46,11:15,11:30,,24.39,0,24.39,24.39,-1,-32844,39901,72745,7057,0,-3732,0,0,0,,3732,-3732
17,04/23/2017,47,11:30,11:45,28.66,24.39,0,28.66,28.66,1,-27525,27422,54947,-103,0,-374,30,0,0,,404,-344
17,04/23/2017,48,11:45,12:00,169.39,,0,169.39,169.39,1,-69364,23906,93270,-45458,0,0,22189,0,0,,22189,22189
17,04/23/2017,49,12:00,12:15,44.49,19.22,0,19.22,19.22,-1,-46312,65547,111859,19235,0,-2326,17038,0,0,,19364,14712
17,04/23/2017,50,12:15,12:30,44.49,-51.02,0,-51.02,-51.02,-1,-29764,51317,81081,21553,0,-32823,83,0,0,,32906,-32740
17,04/23/2017,51,12:30,12:45,32.95,-51.02,0,32.95,32.95,1,-39517,28429,67946,-11088,0,-2230,1371,0,0,,3601,-859
17,04/23/2017,52,12:45,13:00,48.18,,0,48.18,48.18,1,-64856,31290,96146,-33566,0,0,14103,0,0,,14103,14103
17,04/23/2017,53,13:00,13:15,29.83,27.5,0,27.5,27.5,-1,-51624,85449,137073,33825,0,-932,5669,0,0,,6601,4737
17,04/23/2017,54,13:15,13:30,,22.42,0,22.42,22.42,-1,-45293,82090,127383,36797,0,-17061,0,0,0,,17061,-17061
17,04/23/2017,55,13:30,13:45,,19.7,0,19.7,19.7,-1,-54038,74364,128402,20326,0,-35124,0,0,0,,35124,-35124
17,04/23/2017,56,13:45,14:00,41,27.66,0,41,27.66,2,-71836,73803,145639,1967,0,-7452,2894,0,0,,10346,-4558
17,04/23/2017,57,14:00,14:15,41,23.66,0,23.66,23.66,-1,-77737,90508,168245,12771,0,-7975,9,0,0,,7984,-7966
17,04/23/2017,58,14:15,14:30,28.66,23.66,0,28.66,28.66,1,-76613,65755,142368,-10858,0,-224,319,0,0,,543,95
17,04/23/2017,59,14:30,14:45,34.66,,0,34.66,34.66,1,-77005,56584,133589,-20421,0,0,11035,0,0,,11035,11035
17,04/23/2017,60,14:45,15:00,31.29,,0,31.29,31.29,1,-91000,70101,161101,-20899,0,0,15602,0,0,,15602,15602
17,04/23/2017,61,15:00,15:15,30.66,27.66,0,30.66,27.28,2,-73278,85856,159134,12578,0,-123,8200,0,0,,8323,8077
17,04/23/2017,62,15:15,15:30,30.66,24.69,0,24.69,24.69,-1,-63833,97383,161216,33550,0,-11108,220,0,0,,11328,-10888
17,04/23/2017,63,15:30,15:45,,26.99,0,26.99,26.99,-1,-67344,90477,157821,23133,0,-6588,0,0,0,,6588,-6588
17,04/23/2017,64,15:45,16:00,,,0,27.28,27.28,0,-66464,112466,178930,46002,0,0,0,0,0,,0,0
17,04/23/2017,65,16:00,16:15,,23.66,0,23.66,23.66,-1,-47372,156543,203915,109171,0,-5883,0,0,0,,5883,-5883
17,04/23/2017,66,16:15,16:30,,28.66,0,28.66,28.66,-1,-48842,99408,148250,50566,0,-1614,0,0,0,,1614,-1614
17,04/23/2017,67,16:30,16:45,,,0,27.23,27.23,0,-52927,60919,113846,7992,0,0,0,0,0,,0,0
17,04/23/2017,68,16:45,17:00,47.69,,0,47.69,47.69,1,-87009,53965,140974,-33044,0,0,13720,0,0,,13720,13720
17,04/23/2017,69,17:00,17:15,30.66,20.38,0,30.66,20.38,2,-18977,119605,138582,100628,0,-5826,6182,0,0,,12008,356
17,04/23/2017,70,17:15,17:30,,,0,29.16,29.16,0,-47821,84283,132104,36462,0,-241,0,0,0,,241,-241
17,04/23/2017,71,17:30,17:45,64.22,,0,64.22,64.22,1,-84018,55812,139830,-28206,0,0,3796,0,0,,3796,3796
17,04/23/2017,72,17:45,18:00,127.07,,0,127.07,127.07,1,-95043,76894,171937,-18149,0,0,36412,0,0,,36412,36412
17,04/23/2017,73,18:00,18:15,30.66,,0,30.66,30.66,1,-83848,59214,143062,-24634,0,0,3769,0,0,,3769,3769
17,04/23/2017,74,18:15,18:30,31.29,,0,31.29,31.29,1,-63320,52969,116289,-10351,0,0,2578,0,0,,2578,2578
17,04/23/2017,75,18:30,18:45,30.66,,0,30.66,30.66,1,-54655,51856,106511,-2799,0,0,2423,0,0,,2423,2423
17,04/23/2017,76,18:45,19:00,93.22,,0,93.22,93.22,1,-74748,40984,115732,-33764,0,0,18556,0,0,,18556,18556
17,04/23/2017,77,19:00,19:15,159.88,,0,159.88,159.88,1,-83572,63314,146886,-20258,0,0,39698,0,0,,39698,39698
17,04/23/2017,78,19:15,19:30,159.88,27.66,0,27.66,27.66,-1,-31252,74306,105558,43054,0,-507,848,0,0,,1355,341
17,04/23/2017,79,19:30,19:45,,,0,37.89,37.89,0,-38622,51847,90469,13225,0,0,0,0,0,,0,0
17,04/23/2017,80,19:45,20:00,30.72,,0,30.72,30.72,1,-33129,46094,79223,12965,0,0,26,0,0,,26,26
17,04/23/2017,81,20:00,20:15,35.96,,0,35.96,35.96,1,-64098,51797,115895,-12301,0,0,969,0,0,,969,969
17,04/23/2017,82,20:15,20:30,,,0,37.84,37.84,0,-57894,58822,116716,928,0,0,0,0,0,,0,0
17,04/23/2017,83,20:30,20:45,,,0,37.84,37.84,0,-54287,75846,130133,21559,0,0,0,0,0,,0,0
17,04/23/2017,84,20:45,21:00,,,0,37.84,37.84,0,-53064,78719,131783,25655,0,0,0,0,0,,0,0
17,04/23/2017,85,21:00,21:15,,,0,37.25,37.25,0,-47892,104339,152231,56447,0,0,0,0,0,,0,0
17,04/23/2017,86,21:15,21:30,,,0,37.25,37.25,0,-54482,79184,133666,24702,0,0,0,0,0,,0,0
17,04/23/2017,87,21:30,21:45,41.03,,0,41.03,41.03,1,-59483,44643,104126,-14840,0,0,4602,0,0,,4602,4602
17,04/23/2017,88,21:45,22:00,29.83,,0,29.83,29.83,1,-40844,50498,91342,9654,0,0,1243,0,0,,1243,1243
17,04/23/2017,89,22:00,22:15,192.02,,0,192.02,192.02,1,-96659,49262,145921,-47397,0,0,14680,0,0,,14680,14680
17,04/23/2017,90,22:15,22:30,38.22,,0,38.22,38.22,1,-53827,67662,121489,13835,0,0,6970,0,0,,6970,6970
17,04/23/2017,91,22:30,22:45,,,0,37.26,37.26,0,-27782,67553,95335,39771,0,0,0,0,0,,0,0
17,04/23/2017,92,22:45,23:00,,-19.81,0,-19.81,-19.81,-1,-12283,95096,107379,82813,0,-13023,0,0,0,,13023,-13023
17,04/23/2017,93,23:00,23:15,49.22,23.48,0,49.22,23.48,2,-93589,59829,153418,-33760,0,-8564,4948,0,0,,13512,-3616
17,04/23/2017,94,23:15,23:30,29.16,23.66,0,23.66,23.66,-1,-56340,68358,124698,12018,0,-348,832,0,0,,1180,484
17,04/23/2017,95,23:30,23:45,,0.26,0,0.26,0.26,-1,-20762,89675,110437,68913,0,-34335,0,0,0,,34335,-34335
17,04/23/2017,96,23:45,0:00,,-18.22,0,-18.22,-18.22,-1,-19692,95157,114849,75465,0,-61832,0,0,0,,61832,-61832
17,04/24/2017,1,0:00,0:15,103.12,-205.42,0,103.12,-205.42,2,-76137,93565,169702,17428,0,-45938,686,0,0,,46624,-45252
17,04/24/2017,2,0:15,0:30,207.67,-205.42,0,207.67,-205.42,2,-52956,81871,134827,28915,0,-6518,8634,0,0,,15152,2116
17,04/24/2017,3,0:30,0:45,31.64,-162.07,0,31.64,-162.07,2,-43706,40370,84076,-3336,0,-19582,579,0,0,,20161,-19003
17,04/24/2017,4,0:45,1:00,31.64,-100.73,0,-100.73,-100.73,-1,-45246,72862,118108,27616,0,-7814,547,0,0,,8361,-7267
17,04/24/2017,5,1:00,1:15,36.99,-205.42,0,36.99,-205.42,2,-64645,86641,151286,21996,0,-29943,323,0,0,,30266,-29620
17,04/24/2017,6,1:15,1:30,40.8,-205.42,0,40.8,40.8,1,-34068,37662,71730,3594,0,-77,1925,0,0,,2002,1848
17,04/24/2017,7,1:30,1:45,28.8,,0,28.8,28.8,1,-36807,44552,81359,7745,0,0,700,0,0,,700,700
17,04/24/2017,8,1:45,2:00,,3.59,0,3.59,3.59,-1,-28071,63350,91421,35279,0,-9060,0,0,0,,9060,-9060
17,04/24/2017,9,2:00,2:15,,3.59,0,3.59,3.59,-1,-35853,61613,97466,25760,0,-11768,0,0,0,,11768,-11768
17,04/24/2017,10,2:15,2:30,,,0,27.57,27.57,0,-33365,63382,96747,30017,0,-5,0,0,0,,5,-5
17,04/24/2017,11,2:30,2:45,,27.8,0,27.8,27.8,-1,-25982,84667,110649,58685,0,-126,0,0,0,,126,-126
17,04/24/2017,12,2:45,3:00,,-100.24,0,-100.24,-100.24,-1,-33682,85719,119401,52037,0,-29051,0,0,0,,29051,-29051
17,04/24/2017,13,3:00,3:15,31.78,27.8,0,31.78,27.5,2,-57238,36417,93655,-20821,0,-8275,1169,0,0,,9444,-7106
17,04/24/2017,14,3:15,3:30,,,0,27.5,27.5,0,-46252,47289,93541,1037,0,0,0,0,0,,0,0
17,04/24/2017,15,3:30,3:45,,,0,27.5,27.5,0,-37420,69858,107278,32438,0,0,0,0,0,,0,0
17,04/24/2017,16,3:45,4:00,,,0,27.5,27.5,0,-37649,94439,132088,56790,0,0,0,0,0,,0,0
17,04/24/2017,17,4:00,4:15,30.8,,0,30.8,30.8,1,-70587,55248,125835,-15339,0,0,670,0,0,,670,670
17,04/24/2017,18,4:15,4:30,34.8,,0,34.8,34.8,1,-70380,60366,130746,-10014,0,0,8557,0,0,,8557,8557
17,04/24/2017,19,4:30,4:45,,,0,27.43,27.43,0,-51064,65604,116668,14540,0,0,334,0,0,,334,334
17,04/24/2017,20,4:45,5:00,,28.8,0,28.8,28.8,-1,-32764,80779,113543,48015,0,-150,0,0,0,,150,-150
17,04/24/2017,21,5:00,5:15,40.8,28.99,0,40.8,28.99,2,-102904,31389,134293,-71515,0,-80,3279,0,0,,3359,3199
17,04/24/2017,22,5:15,5:30,50.14,,0,50.14,50.14,1,-59649,32396,92045,-27253,0,0,24771,0,0,,24771,24771
17,04/24/2017,23,5:30,5:45,50.14,28.8,0,28.8,28.8,-1,-44770,64978,109748,20208,0,-791,4080,0,0,,4871,3289
17,04/24/2017,24,5:45,6:00,,18.8,0,18.8,18.8,-1,-43283,124376,167659,81093,0,-8132,0,0,0,,8132,-8132
17,04/24/2017,25,6:00,6:15,,27.65,0,27.65,27.65,-1,-107119,85373,192492,-21746,0,-9437,0,0,0,,9437,-9437
17,04/24/2017,26,6:15,6:30,,6.31,0,6.31,6.31,-1,-42394,82329,124723,39935,0,-23390,0,0,0,,23390,-23390
17,04/24/2017,27,6:30,6:45,,18.19,0,18.19,18.19,-1,-37602,86600,124202,48998,0,-42863,0,0,0,,42863,-42863
17,04/24/2017,28,6:45,7:00,,21.3,0,21.3,21.3,-1,-54861,59778,114639,4917,0,-25365,0,0,0,,25365,-25365
17,04/24/2017,29,7:00,7:15,,-8.61,0,-8.61,-8.61,-1,-46169,99928,146097,53759,0,-31035,0,0,0,,31035,-31035
17,04/24/2017,30,7:15,7:30,,11.17,0,11.17,11.17,-1,-35631,75664,111295,40033,0,-19907,0,0,0,,19907,-19907
17,04/24/2017,31,7:30,7:45,,11.08,0,11.08,11.08,-1,-44159,53521,97680,9362,0,-28740,0,0,0,,28740,-28740
17,04/24/2017,32,7:45,8:00,32.21,11.08,0,32.21,32.21,1,-82897,39631,122528,-43266,0,-3045,4396,0,0,,7441,1351
17,04/24/2017,33,8:00,8:15,32.21,64.02,0,64.02,64.02,-1,-20532,92344,112876,71812,0,-1,356,0,0,,357,355
17,04/24/2017,34,8:15,8:30,,28.99,0,28.99,28.99,-1,-21863,67775,89638,45912,0,-2209,0,0,0,,2209,-2209
17,04/24/2017,35,8:30,8:45,,25.59,0,25.59,25.59,-1,-31777,68320,100097,36543,0,-6373,0,0,0,,6373,-6373
17,04/24/2017,36,8:45,9:00,,6.99,0,6.99,6.99,-1,-36197,64865,101062,28668,0,-13708,0,0,0,,13708,-13708
17,04/24/2017,37,9:00,9:15,,-52.94,0,-52.94,-52.94,-1,-24080,140165,164245,116085,0,-45157,0,0,0,,45157,-45157
17,04/24/2017,38,9:15,9:30,,-58.92,0,-58.92,-58.92,-1,-13119,126639,139758,113520,0,-13193,0,0,0,,13193,-13193
17,04/24/2017,39,9:30,9:45,,-65.04,0,-65.04,-65.04,-1,-29436,58945,88381,29509,0,-28163,0,0,0,,28163,-28163
17,04/24/2017,40,9:45,10:00,,-65.04,0,-65.04,-65.04,-1,-21866,98636,120502,76770,0,-33792,0,0,0,,33792,-33792
17,04/24/2017,41,10:00,10:15,,-16.01,0,-16.01,-16.01,-1,-14438,94457,108895,80019,0,-22148,0,0,0,,22148,-22148
17,04/24/2017,42,10:15,10:30,,-33.96,0,-33.96,-33.96,-1,-26359,56767,83126,30408,0,-31194,0,0,0,,31194,-31194
17,04/24/2017,43,10:30,10:45,,-8.61,0,-8.61,-8.61,-1,-14300,73776,88076,59476,0,-30393,0,0,0,,30393,-30393
17,04/24/2017,44,10:45,11:00,,27.78,0,27.78,27.78,-1,-28516,45480,73996,16964,0,-10142,0,0,0,,10142,-10142
17,04/24/2017,45,11:00,11:15,,18.65,0,18.65,18.65,-1,-35361,57379,92740,22018,0,-9250,0,0,0,,9250,-9250
17,04/24/2017,46,11:15,11:30,,18.65,0,18.65,18.65,-1,-33286,42024,75310,8738,0,-22064,0,0,0,,22064,-22064
17,04/24/2017,47,11:30,11:45,,51.07,0,51.07,51.07,-1,-30456,46034,76490,15578,0,-3573,0,0,0,,3573,-3573
17,04/24/2017,48,11:45,12:00,,27.03,0,27.03,27.03,-1,-29096,48687,77783,19591,0,-10528,0,0,0,,10528,-10528
17,04/24/2017,49,12:00,12:15,,,0,36.16,36.16,0,-31451,41586,73037,10135,0,-1181,0,0,0,,1181,-1181
17,04/24/2017,50,12:15,12:30,,27.65,0,27.65,27.65,-1,-32828,52316,85144,19488,0,-4034,0,0,0,,4034,-4034
17,04/24/2017,51,12:30,12:45,,28.04,0,28.04,28.04,-1,-34969,56149,91118,21180,0,-9747,0,0,0,,9747,-9747
17,04/24/2017,52,12:45,13:00,,28.78,0,28.78,28.78,-1,-48234,48796,97030,562,0,-7128,0,0,0,,7128,-7128
17,04/24/2017,53,13:00,13:15,31.15,28.78,0,31.15,31.15,1,-49945,46407,96352,-3538,0,-104,185,0,0,,289,81
17,04/24/2017,54,13:15,13:30,41.15,,0,41.15,41.15,1,-81322,42483,123805,-38839,0,0,14739,0,0,,14739,14739
17,04/24/2017,55,13:30,13:45,41.15,,0,41.15,41.15,1,-66023,42794,108817,-23229,0,0,25564,0,0,,25564,25564
17,04/24/2017,56,13:45,14:00,31.15,28.99,0,43.14,28.99,2,-59504,56214,115718,-3290,0,-585,4788,0,0,,5373,4203
17,04/24/2017,57,14:00,14:15,31.15,,0,31.15,31.15,1,-57363,76724,134087,19361,0,0,725,0,0,,725,725
17,04/24/2017,58,14:15,14:30,32.95,,0,32.95,32.95,1,-75225,56285,131510,-18940,0,0,9239,0,0,,9239,9239
17,04/24/2017,59,14:30,14:45,36.99,,0,36.99,36.99,1,-99655,55642,155297,-44013,0,0,23946,0,0,,23946,23946
17,04/24/2017,60,14:45,15:00,34.12,,0,34.12,34.12,1,-119594,65288,184882,-54306,0,0,20025,0,0,,20025,20025
17,04/24/2017,61,15:00,15:15,34.12,-0.68,0,-0.68,-0.68,-1,-35526,88879,124405,53353,0,-14085,3430,0,0,,17515,-10655
17,04/24/2017,62,15:15,15:30,35.15,0.1,0,35.15,35.15,1,-78645,53650,132295,-24995,0,-20411,383,0,0,,20794,-20028
17,04/24/2017,63,15:30,15:45,41.15,0.1,0,41.15,41.15,1,-95094,61052,156146,-34042,0,-64,6374,0,0,,6438,6310
17,04/24/2017,64,15:45,16:00,54.12,,0,54.12,54.12,1,-114671,57701,172372,-56970,0,0,18791,0,0,,18791,18791
17,04/24/2017,65,16:00,16:15,31.15,28.78,0,37.06,28.78,2,-87191,103945,191136,16754,0,-1354,9292,0,0,,10646,7938
17,04/24/2017,66,16:15,16:30,,44.63,0,44.63,44.63,-1,-66151,68365,134516,2214,0,-81,0,0,0,,81,-81
17,04/24/2017,67,16:30,16:45,41.15,,0,41.15,41.15,1,-89969,54337,144306,-35632,0,0,8559,0,0,,8559,8559
17,04/24/2017,68,16:45,17:00,105.12,,0,105.12,105.12,1,-114793,43113,157906,-71680,0,0,51152,0,0,,51152,51152
17,04/24/2017,69,17:00,17:15,105.12,25.33,0,25.33,25.33,-1,-63694,74246,137940,10552,0,-1643,27186,0,0,,28829,25543
17,04/24/2017,70,17:15,17:30,35.15,25.33,0,35.15,35.15,1,-85228,55640,140868,-29588,0,-304,1336,0,0,,1640,1032
17,04/24/2017,71,17:30,17:45,41.15,,0,41.15,41.15,1,-77239,36617,113856,-40622,0,0,17384,0,0,,17384,17384
17,04/24/2017,72,17:45,18:00,68.54,,0,68.54,68.54,1,-88506,35156,123662,-53350,0,0,38240,0,0,,38240,38240
17,04/24/2017,73,18:00,18:15,110.36,,0,110.36,110.36,1,-120095,46210,166305,-73885,0,0,54203,0,0,,54203,54203
17,04/24/2017,74,18:15,18:30,32.95,,0,32.95,32.95,1,-72929,60787,133716,-12142,0,0,17843,0,0,,17843,17843
17,04/24/2017,75,18:30,18:45,29.15,,0,29.15,29.15,1,-67496,63197,130693,-4299,0,0,28,0,0,,28,28
17,04/24/2017,76,18:45,19:00,30.87,,0,30.87,30.87,1,-76023,78947,154970,2924,0,0,837,0,0,,837,837
17,04/24/2017,77,19:00,19:15,38.3,,0,38.3,38.3,1,-81849,39763,121612,-42086,0,0,11217,0,0,,11217,11217
17,04/24/2017,78,19:15,19:30,33.3,,0,33.3,33.3,1,-44815,45779,90594,964,0,0,8667,0,0,,8667,8667
17,04/24/2017,79,19:30,19:45,,,0,44.35,44.35,0,-41948,54027,95975,12079,0,0,21,0,0,,21,21
17,04/24/2017,80,19:45,20:00,,,0,44.35,44.35,0,-42781,53514,96295,10733,0,0,0,0,0,,0,0
17,04/24/2017,81,20:00,20:15,,56.54,0,56.54,56.54,-1,-47074,69272,116346,22198,0,-38,0,0,0,,38,-38
17,04/24/2017,82,20:15,20:30,,24.21,0,24.21,24.21,-1,-43171,82547,125718,39376,0,-12725,0,0,0,,12725,-12725
17,04/24/2017,83,20:30,20:45,,28.65,0,28.65,28.65,-1,-52653,64789,117442,12136,0,-7916,0,0,0,,7916,-7916
17,04/24/2017,84,20:45,21:00,29.09,,0,29.09,29.09,1,-58320,60089,118409,1769,0,0,129,0,0,,129,129
17,04/24/2017,85,21:00,21:15,,,0,43.28,43.28,0,-38731,75829,114560,37098,0,0,0,0,0,,0,0
17,04/24/2017,86,21:15,21:30,,12.94,0,12.94,12.94,-1,-31760,69697,101457,37937,0,-9656,0,0,0,,9656,-9656
17,04/24/2017,87,21:30,21:45,,12.07,0,12.07,12.07,-1,-40984,58009,98993,17025,0,-18918,0,0,0,,18918,-18918
17,04/24/2017,88,21:45,22:00,,3.59,0,3.59,3.59,-1,-38463,82420,120883,43957,0,-13833,0,0,0,,13833,-13833
17,04/24/2017,89,22:00,22:15,,27.65,0,27.65,27.65,-1,-68097,40230,108327,-27867,0,-7435,0,0,0,,7435,-7435
17,04/24/2017,90,22:15,22:30,,18.65,0,18.65,18.65,-1,-28116,57353,85469,29237,0,-8012,0,0,0,,8012,-8012
17,04/24/2017,91,22:30,22:45,,18.65,0,18.65,18.65,-1,-28702,62441,91143,33739,0,-23583,0,0,0,,23583,-23583
17,04/24/2017,92,22:45,23:00,,3.59,0,3.59,3.59,-1,-23222,107832,131054,84610,0,-29976,0,0,0,,29976,-29976
17,04/24/2017,93,23:00,23:15,29.15,28.65,0,29.15,29.15,1,-64673,32722,97395,-31951,0,-10323,361,0,0,,10684,-9962
17,04/24/2017,94,23:15,23:30,29.15,27.65,0,27.65,27.65,-1,-35251,50715,85966,15464,0,-135,628,0,0,,763,493
17,04/24/2017,95,23:30,23:45,,23.65,0,23.65,23.65,-1,-27799,96984,124783,69185,0,-4394,0,0,0,,4394,-4394
17,04/24/2017,96,23:45,0:00,,-15.53,0,-15.53,-15.53,-1,-25997,123991,149988,97994,0,-44801,0,0,0,,44801,-44801
17,04/25/2017,1,0:00,0:15,34.65,16.74,0,34.65,34.65,1,-87919,40872,128791,-47047,0,-31067,1076,0,0,,32143,-29991
17,04/25/2017,2,0:15,0:30,30.65,,0,30.65,30.65,1,-73345,34592,107937,-38753,0,0,1646,0,0,,1646,1646
17,04/25/2017,3,0:30,0:45,28.65,,0,28.65,28.65,1,-64428,31159,95587,-33269,0,0,1882,0,0,,1882,1882
17,04/25/2017,4,0:45,1:00,,,0,29.52,29.52,0,-76070,64351,140421,-11719,0,0,0,0,0,,0,0
17,04/25/2017,5,1:00,1:15,,26.32,0,26.32,26.32,-1,-24213,71313,95526,47100,0,-2437,0,0,0,,2437,-2437
17,04/25/2017,6,1:15,1:30,,-19.25,0,-19.25,-19.25,-1,-32947,102186,135133,69239,0,-46453,0,0,0,,46453,-46453
17,04/25/2017,7,1:30,1:45,,-19.25,0,-19.25,-19.25,-1,-24765,91948,116713,67183,0,-80065,0,0,0,,80065,-80065
17,04/25/2017,8,1:45,2:00,,-12.38,0,-12.38,-12.38,-1,-28193,116871,145064,88678,0,-90691,0,0,0,,90691,-90691
17,04/25/2017,9,2:00,2:15,,4.62,0,4.62,4.62,-1,-9294,82863,92157,73569,0,-42744,0,0,0,,42744,-42744
17,04/25/2017,10,2:15,2:30,,-57.47,0,-57.47,-57.47,-1,-14100,124105,138205,110005,0,-28636,0,0,0,,28636,-28636
17,04/25/2017,11,2:30,2:45,,-57.47,0,-57.47,-57.47,-1,-22781,136582,159363,113801,0,-102326,0,0,0,,102326,-102326
17,04/25/2017,12,2:45,3:00,,-20.84,0,-20.84,-20.84,-1,-29356,162584,191940,133228,0,-110248,0,0,0,,110248,-110248
17,04/25/2017,13,3:00,3:15,,-20.84,0,-20.84,-20.84,-1,-24940,98560,123500,73620,0,-49688,0,0,0,,49688,-49688
17,04/25/2017,14,3:15,3:30,,28.65,0,28.65,28.65,-1,-34252,111625,145877,77373,0,-20,0,0,0,,20,-20
17,04/25/2017,15,3:30,3:45,,-50.8,0,-50.8,-50.8,-1,-17525,94125,111650,76600,0,-38039,0,0,0,,38039,-38039
17,04/25/2017,16,3:45,4:00,,10.96,0,10.96,10.96,-1,-23455,97181,120636,73726,0,-65025,0,0,0,,65025,-65025
17,04/25/2017,17,4:00,4:15,28.65,18.65,0,28.65,28.65,1,-70285,74258,144543,3973,0,-33086,56,0,0,,33142,-33030
17,04/25/2017,18,4:15,4:30,29.87,27.65,0,29.87,27.65,2,-73439,76210,149649,2771,0,-582,571,0,0,,1153,-11
17,04/25/2017,19,4:30,4:45,,-12.03,0,-12.03,-12.03,-1,-59874,104237,164111,44363,0,-37499,0,0,0,,37499,-37499
17,04/25/2017,20,4:45,5:00,,26.32,0,26.32,26.32,-1,-87257,101697,188954,14440,0,-22674,0,0,0,,22674,-22674
17,04/25/2017,21,5:00,5:15,28.65,26.32,0,28.65,28.65,1,-143453,90679,234132,-52774,0,-3385,16,0,0,,3401,-3369
17,04/25/2017,22,5:15,5:30,28.65,,0,28.65,28.65,1,-97785,67422,165207,-30363,0,0,259,0,0,,259,259
17,04/25/2017,23,5:30,5:45,29.15,,0,29.15,29.15,1,-71388,52693,124081,-18695,0,0,168,0,0,,168,168
17,04/25/2017,24,5:45,6:00,29.15,,0,29.15,29.15,1,-77125,60279,137404,-16846,0,0,7,0,0,,7,7
17,04/25/2017,25,6:00,6:15,,8.11,0,8.11,8.11,-1,-93553,133931,227484,40378,0,-3791,0,0,0,,3791,-3791
17,04/25/2017,26,6:15,6:30,,-51.51,0,-51.51,-51.51,-1,-35390,129600,164990,94210,0,-77118,0,0,0,,77118,-77118
17,04/25/2017,27,6:30,6:45,,17.03,0,17.03,17.03,-1,-54718,81479,136197,26761,0,-51679,0,0,0,,51679,-51679
17,04/25/2017,28,6:45,7:00,,26.32,0,26.32,26.32,-1,-66010,84338,150348,18328,0,-9225,0,0,0,,9225,-9225
17,04/25/2017,29,7:00,7:15,,-55.46,0,-55.46,-55.46,-1,-25926,181449,207375,155523,0,-33448,0,0,0,,33448,-33448
17,04/25/2017,30,7:15,7:30,,29.22,0,29.22,29.22,-1,-39912,132238,172150,92326,0,-1616,0,0,0,,1616,-1616
17,04/25/2017,31,7:30,7:45,,,0,29.81,29.81,0,-38022,100803,138825,62781,0,-63,0,0,0,,63,-63
17,04/25/2017,32,7:45,8:00,,,0,29.81,29.81,0,-75300,75855,151155,555,0,0,0,0,0,,0,0
17,04/25/2017,33,8:00,8:15,,29.61,0,29.61,29.61,-1,-53544,106213,159757,52669,0,-184,0,0,0,,184,-184
17,04/25/2017,34,8:15,8:30,,29.74,0,29.74,29.74,-1,-54726,79064,133790,24338,0,-378,0,0,0,,378,-378
17,04/25/2017,35,8:30,8:45,,,0,29.81,29.81,0,-41599,70758,112357,29159,0,0,0,0,0,,0,0
17,04/25/2017,36,8:45,9:00,,27.65,0,27.65,27.65,-1,-40492,81323,121815,40831,0,-186,0,0,0,,186,-186
17,04/25/2017,37,9:00,9:15,,-54.79,0,-54.79,-54.79,-1,-42978,153926,196904,110948,0,-37852,0,0,0,,37852,-37852
17,04/25/2017,38,9:15,9:30,,13.03,0,13.03,13.03,-1,-54994,120030,175024,65036,0,-56435,0,0,0,,56435,-56435
17,04/25/2017,39,9:30,9:45,,-0.69,0,-0.69,-0.69,-1,-36930,129562,166492,92632,0,-64402,0,0,0,,64402,-64402
17,04/25/2017,40,9:45,10:00,,11.33,0,11.33,11.33,-1,-31095,108457,139552,77362,0,-59354,0,0,0,,59354,-59354
17,04/25/2017,41,10:00,10:15,,16.74,0,16.74,16.74,-1,-30798,107910,138708,77112,0,-27735,0,0,0,,27735,-27735
17,04/25/2017,42,10:15,10:30,,,0,29.78,29.78,0,-38753,122429,161182,83676,0,0,0,0,0,,0,0
17,04/25/2017,43,10:30,10:45,,,0,29.78,29.78,0,-12682,129458,142140,116776,0,0,0,0,0,,0,0
17,04/25/2017,44,10:45,11:00,,,0,30.1,30.1,0,-24408,121596,146004,97188,0,0,0,0,0,,0,0
17,04/25/2017,45,11:00,11:15,,23.65,0,23.65,23.65,-1,-106542,147356,253898,40814,0,-11220,0,0,0,,11220,-11220
17,04/25/2017,46,11:15,11:30,,18.65,0,18.65,18.65,-1,-77027,115851,192878,38824,0,-37630,0,0,0,,37630,-37630
17,04/25/2017,47,11:30,11:45,,16.74,0,16.74,16.74,-1,-67123,116397,183520,49274,0,-42470,0,0,0,,42470,-42470
17,04/25/2017,48,11:45,12:00,29.15,23.65,0,29.45,23.65,2,-108830,104338,213168,-4492,0,-25511,11,0,0,,25522,-25500
17,04/25/2017,49,12:00,12:15,,16.74,0,16.74,16.74,-1,-82574,91179,173753,8605,0,-29816,0,0,0,,29816,-29816
17,04/25/2017,50,12:15,12:30,31.15,16.74,0,31.15,31.15,1,-108096,71678,179774,-36418,0,-4575,554,0,0,,5129,-4021
17,04/25/2017,51,12:30,12:45,142.42,,0,142.42,142.42,1,-118007,54674,172681,-63333,0,0,13800,0,0,,13800,13800
17,04/25/2017,52,12:45,13:00,38.74,27.03,0,27.03,27.03,-1,-94228,85607,179835,-8621,0,-735,13943,0,0,,14678,13208
17,04/25/2017,53,13:00,13:15,,27.03,0,27.03,27.03,-1,-85795,74256,160051,-11539,0,-2392,0,0,0,,2392,-2392
17,04/25/2017,54,13:15,13:30,,19.67,0,19.67,19.67,-1,-71589,97691,169280,26102,0,-8222,0,0,0,,8222,-8222
17,04/25/2017,55,13:30,13:45,35.15,20.32,0,35.15,20.32,2,-77355,61387,138742,-15968,0,-7493,2163,0,0,,9656,-5330
17,04/25/2017,56,13:45,14:00,35.15,23.65,0,23.65,23.65,-1,-54835,79910,134745,25075,0,-9823,189,0,0,,10012,-9634
17,04/25/2017,57,14:00,14:15,,21.74,0,21.74,21.74,-1,-17882,111072,128954,93190,0,-13499,0,0,0,,13499,-13499
17,04/25/2017,58,14:15,14:30,,27.62,0,27.62,27.62,-1,-45226,89653,134879,44427,0,-9740,0,0,0,,9740,-9740
17,04/25/2017,59,14:30,14:45,,,0,29.45,29.45,0,-17893,65015,82908,47122,0,-112,0,0,0,,112,-112
17,04/25/2017,60,14:45,15:00,,-5.22,0,-5.22,-5.22,-1,-11251,79416,90667,68165,0,-9216,0,0,0,,9216,-9216
17,04/25/2017,61,15:00,15:15,,-50.83,0,-50.83,-50.83,-1,-40151,74852,115003,34701,0,-30981,0,0,0,,30981,-30981
17,04/25/2017,62,15:15,15:30,,-10.08,0,-10.08,-10.08,-1,-28410,115821,144231,87411,0,-37891,0,0,0,,37891,-37891
17,04/25/2017,63,15:30,15:45,,18.65,0,18.65,18.65,-1,-19108,136191,155299,117083,0,-40222,0,0,0,,40222,-40222
17,04/25/2017,64,15:45,16:00,,-50.83,0,-50.83,-50.83,-1,-19541,147165,166706,127624,0,-51954,0,0,0,,51954,-51954
17,04/25/2017,65,16:00,16:15,,-63.24,0,-63.24,-63.24,-1,-102805,74814,177619,-27991,0,-51858,0,0,0,,51858,-51858
17,04/25/2017,66,16:15,16:30,,-50.83,0,-50.83,-50.83,-1,-77674,101465,179139,23791,0,-60124,0,0,0,,60124,-60124
17,04/25/2017,67,16:30,16:45,,-50.83,0,-50.83,-50.83,-1,-64078,89605,153683,25527,0,-55610,0,0,0,,55610,-55610
17,04/25/2017,68,16:45,17:00,,-28.14,0,-28.14,-28.14,-1,-103631,149858,253489,46227,0,-9611,0,0,0,,9611,-9611
17,04/25/2017,69,17:00,17:15,,-52.82,0,-52.82,-52.82,-1,-77065,89983,167048,12918,0,-45400,0,0,0,,45400,-45400
17,04/25/2017,70,17:15,17:30,,19.21,0,19.21,19.21,-1,-64240,85041,149281,20801,0,-5028,0,0,0,,5028,-5028
17,04/25/2017,71,17:30,17:45,29.15,18.65,0,29.45,18.65,2,-75453,65031,140484,-10422,0,-18345,3,0,0,,18348,-18342
17,04/25/2017,72,17:45,18:00,32.6,18.65,0,32.6,32.6,1,-94045,59251,153296,-34794,0,-219,2411,0,0,,2630,2192
17,04/25/2017,73,18:00,18:15,,28.65,0,28.65,28.65,-1,-76864,73070,149934,-3794,0,-26,0,0,0,,26,-26
17,04/25/2017,74,18:15,18:30,,16.74,0,16.74,16.74,-1,-63474,98430,161904,34956,0,-20712,0,0,0,,20712,-20712
17,04/25/2017,75,18:30,18:45,,7.09,0,7.09,7.09,-1,-74463,113801,188264,39338,0,-36377,0,0,0,,36377,-36377
17,04/25/2017,76,18:45,19:00,227.26,23.65,0,227.26,227.26,1,-102453,62306,164759,-40147,0,-18001,4582,0,0,,22583,-13419
17,04/25/2017,77,19:00,19:15,269.68,23.65,0,269.68,269.68,1,-118930,53895,172825,-65035,0,-16,40946,0,0,,40962,40930
17,04/25/2017,78,19:15,19:30,31.82,29.61,0,29.61,29.61,-1,-43372,58353,101725,14981,0,-4,6247,0,0,,6251,6243
17,04/25/2017,79,19:30,19:45,,16.74,0,16.74,16.74,-1,-19669,54130,73799,34461,0,-20372,0,0,0,,20372,-20372
17,04/25/2017,80,19:45,20:00,,23.65,0,23.65,23.65,-1,-36032,37421,73453,1389,0,-23537,0,0,0,,23537,-23537
17,04/25/2017,81,20:00,20:15,,19.67,0,19.67,19.67,-1,-23415,58754,82169,35339,0,-15957,0,0,0,,15957,-15957
17,04/25/2017,82,20:15,20:30,,27.56,0,27.56,27.56,-1,-42330,42808,85138,478,0,-13120,0,0,0,,13120,-13120
17,04/25/2017,83,20:30,20:45,,,0,29.81,29.81,0,-59501,48666,108167,-10835,0,-656,0,0,0,,656,-656
17,04/25/2017,84,20:45,21:00,,,0,29.81,29.81,0,-80913,30456,111369,-50457,0,0,0,0,0,,0,0
17,04/25/2017,85,21:00,21:15,,12.03,0,12.03,12.03,-1,-51208,112917,164125,61709,0,-17279,0,0,0,,17279,-17279
17,04/25/2017,86,21:15,21:30,35.61,27.65,0,35.61,35.61,1,-75265,53126,128391,-22139,0,-3876,3823,0,0,,7699,-53
17,04/25/2017,87,21:30,21:45,30.91,,0,30.91,30.91,1,-59933,55537,115470,-4396,0,0,3377,0,0,,3377,3377
17,04/25/2017,88,21:45,22:00,,,0,29.81,29.81,0,-70690,68333,139023,-2357,0,0,0,0,0,,0,0
17,04/25/2017,89,22:00,22:15,,23.65,0,23.65,23.65,-1,-43994,65440,109434,21446,0,-4259,0,0,0,,4259,-4259
17,04/25/2017,90,22:15,22:30,,20.35,0,20.35,20.35,-1,-27582,53246,80828,25664,0,-22069,0,0,0,,22069,-22069
17,04/25/2017,91,22:30,22:45,,23.65,0,23.65,23.65,-1,-16044,61628,77672,45584,0,-23956,0,0,0,,23956,-23956
17,04/25/2017,92,22:45,23:00,,-1.49,0,-1.49,-1.49,-1,-48977,92714,141691,43737,0,-26574,0,0,0,,26574,-26574
17,04/25/2017,93,23:00,23:15,173.46,-17.19,0,173.46,-17.19,2,-53871,28517,82388,-25354,0,-23413,4009,0,0,,27422,-19404
17,04/25/2017,94,23:15,23:30,173.46,20.35,0,20.35,20.35,-1,-35517,42291,77808,6774,0,-1051,6276,0,0,,7327,5225
17,04/25/2017,95,23:30,23:45,,-36.07,0,-36.07,-36.07,-1,-28082,84693,112775,56611,0,-41614,0,0,0,,41614,-41614
17,04/25/2017,96,23:45,0:00,,9.75,0,9.75,9.75,-1,-32894,97704,130598,64810,0,-38129,0,0,0,,38129,-38129
17,04/26/2017,1,0:00,0:15,29.15,16.66,0,29.15,29.15,1,-55607,57616,113223,2009,0,-21067,8,0,0,,21075,-21059
17,04/26/2017,2,0:15,0:30,29.15,,0,29.15,29.15,1,-33631,21972,55603,-11659,0,0,873,0,0,,873,873
17,04/26/2017,3,0:30,0:45,29.15,28.8,0,28.8,28.8,-1,-34558,27898,62456,-6660,0,-244,4,0,0,,248,-240
17,04/26/2017,4,0:45,1:00,,27.65,0,27.65,27.65,-1,-37529,47660,85189,10131,0,-2760,0,0,0,,2760,-2760
17,04/26/2017,5,1:00,1:15,,27.65,0,27.65,27.65,-1,-46666,44972,91638,-1694,0,-3537,0,0,0,,3537,-3537
17,04/26/2017,6,1:15,1:30,,23.65,0,23.65,23.65,-1,-36506,95447,131953,58941,0,-3655,0,0,0,,3655,-3655
17,04/26/2017,7,1:30,1:45,,23.65,0,23.65,23.65,-1,-39467,98542,138009,59075,0,-7644,0,0,0,,7644,-7644
17,04/26/2017,8,1:45,2:00,,23.65,0,23.65,23.65,-1,-41492,74315,115807,32823,0,-23326,0,0,0,,23326,-23326
17,04/26/2017,9,2:00,2:15,30.84,26.39,0,30.84,30.84,1,-38806,41246,80052,2440,0,-13068,539,0,0,,13607,-12529
17,04/26/2017,10,2:15,2:30,30.84,28.73,0,28.73,28.73,-1,-42827,45602,88429,2775,0,-40,139,0,0,,179,99
17,04/26/2017,11,2:30,2:45,,28.65,0,28.65,28.65,-1,-47473,61658,109131,14185,0,-1786,0,0,0,,1786,-1786
17,04/26/2017,12,2:45,3:00,,22.42,0,22.42,22.42,-1,-51878,72018,123896,20140,0,-14201,0,0,0,,14201,-14201
17,04/26/2017,13,3:00,3:15,33.89,25.54,0,33.89,33.89,1,-50927,41601,92528,-9326,0,-11993,1609,0,0,,13602,-10384
17,04/26/2017,14,3:15,3:30,41.15,25.54,0,41.15,41.15,1,-57198,29508,86706,-27690,0,-76,10536,0,0,,10612,10460
17,04/26/2017,15,3:30,3:45,32.92,,0,32.92,32.92,1,-64366,32583,96949,-31783,0,0,12595,0,0,,12595,12595
17,04/26/2017,16,3:45,4:00,31.15,,0,31.15,31.15,1,-49536,27028,76564,-22508,0,0,10793,0,0,,10793,10793
17,04/26/2017,17,4:00,4:15,32.92,,0,32.92,32.92,1,-43722,7026,50748,-36696,0,0,4947,0,0,,4947,4947
17,04/26/2017,18,4:15,4:30,33.54,,0,33.54,33.54,1,-48100,8761,56861,-39339,0,0,15285,0,0,,15285,15285
17,04/26/2017,19,4:30,4:45,35.15,,0,35.15,35.15,1,-50187,15308,65495,-34879,0,0,5980,0,0,,5980,5980
17,04/26/2017,20,4:45,5:00,52.61,,0,52.61,52.61,1,-57837,14384,72221,-43453,0,0,23374,0,0,,23374,23374
17,04/26/2017,21,5:00,5:15,126.23,,0,126.23,126.23,1,-129803,17949,147752,-111854,0,0,42446,0,0,,42446,42446
17,04/26/2017,22,5:15,5:30,126.23,,0,126.23,126.23,1,-91735,37798,129533,-53937,0,0,45894,0,0,,45894,45894
17,04/26/2017,23,5:30,5:45,31.15,,0,31.15,31.15,1,-58127,50606,108733,-7521,0,0,12409,0,0,,12409,12409
17,04/26/2017,24,5:45,6:00,31.15,27.57,0,27.57,27.57,-1,-56635,90654,147289,34019,0,-696,995,0,0,,1691,299
17,04/26/2017,25,6:00,6:15,,24.94,0,24.94,24.94,-1,-67712,88889,156601,21177,0,-6717,0,0,0,,6717,-6717
17,04/26/2017,26,6:15,6:30,,,0,36.78,36.78,0,-58331,55316,113647,-3015,0,0,0,0,0,,0,0
17,04/26/2017,27,6:30,6:45,,,0,36.78,36.78,0,-49016,46888,95904,-2128,0,0,0,0,0,,0,0
17,04/26/2017,28,6:45,7:00,,,0,36.78,36.78,0,-63549,57219,120768,-6330,0,0,0,0,0,,0,0
17,04/26/2017,29,7:00,7:15,29.06,18.4,0,36.8,18.4,2,-22551,77525,100076,54974,0,-5738,5,0,0,,5743,-5733
17,04/26/2017,30,7:15,7:30,30.1,18.4,0,30.1,30.1,1,-15461,48120,63581,32659,0,-14,832,0,0,,846,818
17,04/26/2017,31,7:30,7:45,29.45,,0,29.45,29.45,1,-39606,48740,88346,9134,0,0,288,0,0,,288,288
17,04/26/2017,32,7:45,8:00,48.89,,0,48.89,48.89,1,-71469,57109,128578,-14360,0,0,14064,0,0,,14064,14064
17,04/26/2017,33,8:00,8:15,58.45,,0,58.45,58.45,1,-80762,31600,112362,-49162,0,0,31707,0,0,,31707,31707
17,04/26/2017,34,8:15,8:30,47.45,25.52,0,25.52,25.52,-1,-30105,46935,77040,16830,0,-768,24690,0,0,,25458,23922
17,04/26/2017,35,8:30,8:45,47.45,18.65,0,18.65,18.65,-1,-46499,68912,115411,22413,0,-10040,1031,0,0,,11071,-9009
17,04/26/2017,36,8:45,9:00,,28.65,0,28.65,28.65,-1,-59842,87010,146852,27168,0,-8167,0,0,0,,8167,-8167
17,04/26/2017,37,9:00,9:15,,34.69,0,34.69,34.69,-1,-62378,71914,134292,9536,0,-2271,0,0,0,,2271,-2271
17,04/26/2017,38,9:15,9:30,,18.65,0,18.65,18.65,-1,-49568,75767,125335,26199,0,-11859,0,0,0,,11859,-11859
17,04/26/2017,39,9:30,9:45,,10.21,0,10.21,10.21,-1,-52845,46355,99200,-6490,0,-57948,0,0,0,,57948,-57948
17,04/26/2017,40,9:45,10:00,,10.21,0,10.21,10.21,-1,-68105,24570,92675,-43535,0,-79163,0,0,0,,79163,-79163
17,04/26/2017,41,10:00,10:15,,8.94,0,8.94,8.94,-1,-148283,16515,164798,-131768,0,-47818,0,0,0,,47818,-47818
17,04/26/2017,42,10:15,10:30,260.67,8.94,0,260.67,260.67,1,-137600,5037,142637,-132563,0,-701,26393,0,0,,27094,25692
17,04/26/2017,43,10:30,10:45,260.67,,0,260.67,260.67,1,-62140,37886,100026,-24254,0,0,81769,0,0,,81769,81769
17,04/26/2017,44,10:45,11:00,340.72,-42.86,0,-42.86,-42.86,-1,-37290,78583,115873,41293,0,-19564,64737,8750,0,,93051,53923
17,04/26/2017,45,11:00,11:15,59.21,10.49,0,59.21,59.21,1,-79169,57523,136692,-21646,0,-9983,6910,0,0,,16893,-3073
17,04/26/2017,46,11:15,11:30,59.21,,0,59.21,59.21,1,-65176,71941,137117,6765,0,0,8367,0,0,,8367,8367
17,04/26/2017,47,11:30,11:45,59.21,,0,59.21,59.21,1,-77750,53501,131251,-24249,0,0,4953,0,0,,4953,4953
17,04/26/2017,48,11:45,12:00,54.12,28.8,0,54.12,28.8,2,-58861,66193,125054,7332,0,-34,15384,0,0,,15418,15350
17,04/26/2017,49,12:00,12:15,54.12,28.65,0,28.65,28.65,-1,-80897,101287,182184,20390,0,-633,432,0,0,,1065,-201
17,04/26/2017,50,12:15,12:30,,,0,29.92,29.92,0,-54937,89361,144298,34424,0,0,0,0,0,,0,0
17,04/26/2017,51,12:30,12:45,,,0,29.92,29.92,0,-49586,80964,130550,31378,0,0,0,0,0,,0,0
17,04/26/2017,52,12:45,13:00,29.06,,0,29.06,29.06,1,-64916,76586,141502,11670,0,0,78,0,0,,78,78
17,04/26/2017,53,13:00,13:15,31.55,32.44,0,31.55,31.13,2,-70461,74839,145300,4378,0,-242,590,0,0,,832,348
17,04/26/2017,54,13:15,13:30,57.3,,0,57.3,57.3,1,-94853,81954,176807,-12899,0,0,16138,0,0,,16138,16138
17,04/26/2017,55,13:30,13:45,57.3,27.65,0,27.65,27.65,-1,-73312,119609,192921,46297,0,-1649,1672,0,0,,3321,23
17,04/26/2017,56,13:45,14:00,,26.85,0,26.85,26.85,-1,-68910,106932,175842,38022,0,-10721,0,0,0,,10721,-10721
17,04/26/2017,57,14:00,14:15,35.15,30.94,0,35.15,30.94,2,-95041,78912,173953,-16129,0,-4073,2704,0,0,,6777,-1369
17,04/26/2017,58,14:15,14:30,29.15,,0,29.15,29.15,1,-90232,91738,181970,1506,0,0,2940,0,0,,2940,2940
17,04/26/2017,59,14:30,14:45,29.15,27.65,0,27.65,27.65,-1,-89300,99416,188716,10116,0,-2459,941,0,0,,3400,-1518
17,04/26/2017,60,14:45,15:00,,26.74,0,26.74,26.74,-1,-88297,96360,184657,8063,0,-5080,0,0,0,,5080,-5080
17,04/26/2017,61,15:00,15:15,,27.62,0,27.62,27.62,-1,-91582,98348,189930,6766,0,-9045,0,0,0,,9045,-9045
17,04/26/2017,62,15:15,15:30,,27.65,0,27.65,27.65,-1,-84379,95329,179708,10950,0,-7615,0,0,0,,7615,-7615
17,04/26/2017,63,15:30,15:45,,25.52,0,25.52,25.52,-1,-64636,91081,155717,26445,0,-6944,0,0,0,,6944,-6944
17,04/26/2017,64,15:45,16:00,,27.62,0,27.62,27.62,-1,-64256,76959,141215,12703,0,-9524,0,0,0,,9524,-9524
17,04/26/2017,65,16:00,16:15,29.15,27.62,0,29.15,29.15,1,-70845,54318,125163,-16527,0,-2863,36,0,0,,2899,-2827
17,04/26/2017,66,16:15,16:30,35.49,,0,35.49,35.49,1,-50688,35420,86108,-15268,0,0,5253,0,0,,5253,5253
17,04/26/2017,67,16:30,16:45,,,0,29.02,29.02,0,-53300,38528,91828,-14772,0,0,700,0,0,,700,700
17,04/26/2017,68,16:45,17:00,29.15,,0,29.15,29.15,1,-77214,36558,113772,-40656,0,0,362,0,0,,362,362
17,04/26/2017,69,17:00,17:15,29.15,-200,0,-200,-200,-1,-40953,87401,128354,46448,0,-19657,17,0,0,,19674,-19640
17,04/26/2017,70,17:15,17:30,54.42,-200,0,54.42,54.42,1,-89902,58030,147932,-31872,0,-3190,2595,0,0,,5785,-595
17,04/26/2017,71,17:30,17:45,36.92,,0,36.92,36.92,1,-58618,50376,108994,-8242,0,0,8201,0,0,,8201,8201
17,04/26/2017,72,17:45,18:00,31.92,,0,31.92,31.92,1,-66501,74309,140810,7808,0,0,3827,0,0,,3827,3827
17,04/26/2017,73,18:00,18:15,30.19,,0,30.19,30.19,1,-88212,30702,118914,-57510,0,0,837,0,0,,837,837
17,04/26/2017,74,18:15,18:30,,,0,29.3,29.3,0,-53580,43895,97475,-9685,0,0,80,0,0,,80,80
17,04/26/2017,75,18:30,18:45,,26.24,0,26.24,26.24,-1,-50560,64662,115222,14102,0,-7523,0,0,0,,7523,-7523
17,04/26/2017,76,18:45,19:00,,28.8,0,28.8,28.8,-1,-63304,51340,114644,-11964,0,-799,0,0,0,,799,-799
17,04/26/2017,77,19:00,19:15,31.86,,0,31.86,31.86,1,-95617,41401,137018,-54216,0,0,1506,0,0,,1506,1506
17,04/26/2017,78,19:15,19:30,30.19,,0,30.19,30.19,1,-77265,44416,121681,-32849,0,0,1095,0,0,,1095,1095
17,04/26/2017,79,19:30,19:45,,27.65,0,27.65,27.65,-1,-41169,48004,89173,6835,0,-3098,0,0,0,,3098,-3098
17,04/26/2017,80,19:45,20:00,30.19,28.69,0,30.19,30.19,1,-51886,48463,100349,-3423,0,-1272,7,0,0,,1279,-1265
17,04/26/2017,81,20:00,20:15,38.72,,0,38.72,38.72,1,-58360,42905,101265,-15455,0,0,9546,0,0,,9546,9546
17,04/26/2017,82,20:15,20:30,38.72,,0,38.72,38.72,1,-49321,37834,87155,-11487,0,0,14718,0,0,,14718,14718
17,04/26/2017,83,20:30,20:45,29.06,,0,29.06,29.06,1,-39619,49207,88826,9588,0,0,3644,0,0,,3644,3644
17,04/26/2017,84,20:45,21:00,,28.65,0,28.65,28.65,-1,-40008,38585,78593,-1423,0,-161,0,0,0,,161,-161
17,04/26/2017,85,21:00,21:15,,28.65,0,28.65,28.65,-1,-38931,109826,148757,70895,0,-614,0,0,0,,614,-614
17,04/26/2017,86,21:15,21:30,,,0,31.18,31.18,0,-45748,79743,125491,33995,0,0,0,0,0,,0,0
17,04/26/2017,87,21:30,21:45,,,0,28.93,28.93,0,-52857,67074,119931,14217,0,0,0,0,0,,0,0
17,04/26/2017,88,21:45,22:00,31.01,,0,31.01,31.01,1,-76660,39793,116453,-36867,0,0,684,0,0,,684,684
17,04/26/2017,89,22:00,22:15,87.12,,0,87.12,87.12,1,-70283,9058,79341,-61225,0,0,8892,0,0,,8892,8892
17,04/26/2017,90,22:15,22:30,29.06,10.21,0,10.21,10.21,-1,-20064,46133,66197,26069,0,-7538,1313,0,0,,8851,-6225
17,04/26/2017,91,22:30,22:45,,-36.88,0,-36.88,-36.88,-1,-16583,68959,85542,52376,0,-46911,0,0,0,,46911,-46911
17,04/26/2017,92,22:45,23:00,,19.54,0,19.54,19.54,-1,-25581,61508,87089,35927,0,-25706,0,0,0,,25706,-25706
17,04/26/2017,93,23:00,23:15,,10.21,0,10.21,10.21,-1,-67405,82121,149526,14716,0,-22561,0,0,0,,22561,-22561
17,04/26/2017,94,23:15,23:30,,18.65,0,18.65,18.65,-1,-56603,79060,135663,22457,0,-10969,0,0,0,,10969,-10969
17,04/26/2017,95,23:30,23:45,,10.21,0,10.21,10.21,-1,-49554,81631,131185,32077,0,-32800,0,0,0,,32800,-32800
17,04/26/2017,96,23:45,0:00,,23.65,0,23.65,23.65,-1,-43570,69195,112765,25625,0,-31716,0,0,0,,31716,-31716
17,04/27/2017,1,0:00,0:15,182.4,26.99,0,182.4,182.4,1,-103154,35743,138897,-67411,0,-14061,9642,0,0,,23703,-4419
17,04/27/2017,2,0:15,0:30,182.4,26.99,0,182.4,182.4,1,-95355,53462,148817,-41893,0,-10,22383,0,0,,22393,22373
17,04/27/2017,3,0:30,0:45,,,0,28.51,28.51,0,-94537,53590,148127,-40947,0,0,2538,0,0,,2538,2538
17,04/27/2017,4,0:45,1:00,,26.26,0,26.26,26.26,-1,-84829,66085,150914,-18744,0,-388,0,0,0,,388,-388
17,04/27/2017,5,1:00,1:15,27.4,17.99,0,28.52,17.99,2,-44463,41318,85781,-3145,0,-19270,11,0,0,,19281,-19259
17,04/27/2017,6,1:15,1:30,33.4,24.25,0,33.4,24.25,2,-33868,26346,60214,-7522,0,-2515,1702,0,0,,4217,-813
17,04/27/2017,7,1:30,1:45,27.4,22.99,0,28.54,22.99,2,-35393,23494,58887,-11899,0,-11865,2,0,0,,11867,-11863
17,04/27/2017,8,1:45,2:00,27.4,22.99,0,27.4,27.4,1,-67156,20724,87880,-46432,0,-28,1548,0,0,,1576,1520
17,04/27/2017,9,2:00,2:15,32.74,,0,32.74,32.74,1,-30673,17437,48110,-13236,0,0,3803,0,0,,3803,3803
17,04/27/2017,10,2:15,2:30,29.4,,0,29.4,29.4,1,-43112,15500,58612,-27612,0,0,4992,0,0,,4992,4992
17,04/27/2017,11,2:30,2:45,,,0,28.54,28.54,0,-26235,12090,38325,-14145,0,0,90,0,0,,90,90
17,04/27/2017,12,2:45,3:00,,27.99,0,27.99,27.99,-1,-22164,25478,47642,3314,0,-270,0,0,0,,270,-270
17,04/27/2017,13,3:00,3:15,32.09,28.03,0,32.09,28.03,2,-37061,17793,54854,-19268,0,-630,1599,0,0,,2229,969
17,04/27/2017,14,3:15,3:30,31.99,,0,31.99,31.99,1,-42687,22339,65026,-20348,0,0,5610,0,0,,5610,5610
17,04/27/2017,15,3:30,3:45,29.4,,0,29.4,29.4,1,-42750,21342,64092,-21408,0,0,5119,0,0,,5119,5119
17,04/27/2017,16,3:45,4:00,27.4,,0,27.4,27.4,1,-41004,20996,62000,-20008,0,0,1218,0,0,,1218,1218
17,04/27/2017,17,4:00,4:15,,,0,28.54,28.54,0,-50041,22181,72222,-27860,0,0,0,0,0,,0,0
17,04/27/2017,18,4:15,4:30,,27.99,0,27.99,27.99,-1,-38181,38968,77149,787,0,-65,0,0,0,,65,-65
17,04/27/2017,19,4:30,4:45,,22.99,0,22.99,22.99,-1,-37234,67206,104440,29972,0,-17933,0,0,0,,17933,-17933
17,04/27/2017,20,4:45,5:00,,27.88,0,27.88,27.88,-1,-54060,36308,90368,-17752,0,-5614,0,0,0,,5614,-5614
17,04/27/2017,21,5:00,5:15,27.4,,0,27.4,27.4,1,-81614,11959,93573,-69655,0,0,120,0,0,,120,120
17,04/27/2017,22,5:15,5:30,27.4,,0,27.4,27.4,1,-27744,13663,41407,-14081,0,0,506,0,0,,506,506
17,04/27/2017,23,5:30,5:45,27.4,,0,27.4,27.4,1,-33148,10457,43605,-22691,0,0,549,0,0,,549,549
17,04/27/2017,24,5:45,6:00,27.4,24.25,0,28.22,24.25,2,-19823,44134,63957,24311,0,-2460,1387,0,0,,3847,-1073
17,04/27/2017,25,6:00,6:15,33.39,24.64,0,33.39,33.39,1,-99398,38188,137586,-61210,0,-3963,1653,0,0,,5616,-2310
17,04/27/2017,26,6:15,6:30,34.14,,0,34.14,34.14,1,-42182,28940,71122,-13242,0,0,6736,0,0,,6736,6736
17,04/27/2017,27,6:30,6:45,32.74,,0,32.74,32.74,1,-48044,38382,86426,-9662,0,0,7049,0,0,,7049,7049
17,04/27/2017,28,6:45,7:00,,,0,36.98,36.98,0,-43040,52500,95540,9460,0,0,1017,0,0,,1017,1017
17,04/27/2017,29,7:00,7:15,,25.8,0,25.8,25.8,-1,-50569,67342,117911,16773,0,-10933,0,0,0,,10933,-10933
17,04/27/2017,30,7:15,7:30,,21.78,0,21.78,21.78,-1,-48219,69537,117756,21318,0,-6557,0,0,0,,6557,-6557
17,04/27/2017,31,7:30,7:45,,17.99,0,17.99,17.99,-1,-41977,93606,135583,51629,0,-43192,0,0,0,,43192,-43192
17,04/27/2017,32,7:45,8:00,,17.99,0,17.99,17.99,-1,-41935,103163,145098,61228,0,-53311,0,0,0,,53311,-53311
17,04/27/2017,33,8:00,8:15,,17.99,0,17.99,17.99,-1,-46339,117957,164296,71618,0,-67887,0,0,0,,67887,-67887
17,04/27/2017,34,8:15,8:30,,17.99,0,17.99,17.99,-1,-39776,88568,128344,48792,0,-61023,0,0,0,,61023,-61023
17,04/27/2017,35,8:30,8:45,,22.99,0,22.99,22.99,-1,-36692,82179,118871,45487,0,-39725,0,0,0,,39725,-39725
17,04/27/2017,36,8:45,9:00,,18.52,0,18.52,18.52,-1,-35070,96027,131097,60957,0,-47298,0,0,0,,47298,-47298
17,04/27/2017,37,9:00,9:15,,22.99,0,22.99,22.99,-1,-53578,109352,162930,55774,0,-44245,0,0,0,,44245,-44245
17,04/27/2017,38,9:15,9:30,,22.99,0,22.99,22.99,-1,-54177,108856,163033,54679,0,-35831,0,0,0,,35831,-35831
17,04/27/2017,39,9:30,9:45,,18.52,0,18.52,18.52,-1,-44189,101240,145429,57051,0,-46013,0,0,0,,46013,-46013
17,04/27/2017,40,9:45,10:00,,17.99,0,17.99,17.99,-1,-44257,94269,138526,50012,0,-61463,0,0,0,,61463,-61463
17,04/27/2017,41,10:00,10:15,,17.99,0,17.99,17.99,-1,-52729,100819,153548,48090,0,-42858,0,0,0,,42858,-42858
17,04/27/2017,42,10:15,10:30,,17.99,0,17.99,17.99,-1,-54594,84385,138979,29791,0,-46683,0,0,0,,46683,-46683
17,04/27/2017,43,10:30,10:45,,-8.52,0,-8.52,-8.52,-1,-52995,107479,160474,54484,0,-22181,0,0,0,,22181,-22181
17,04/27/2017,44,10:45,11:00,30.32,-20.49,0,36.94,-20.49,2,-90629,96015,186644,5386,0,-34719,25,0,0,,34744,-34694
17,04/27/2017,45,11:00,11:15,38.02,18.52,0,38.02,18.52,2,-67031,90484,157515,23453,0,-3020,2232,0,0,,5252,-788
17,04/27/2017,46,11:15,11:30,,-8.52,0,-8.52,-8.52,-1,-75678,107663,183341,31985,0,-33576,0,0,0,,33576,-33576
17,04/27/2017,47,11:30,11:45,,-8.52,0,-8.52,-8.52,-1,-77548,121865,199413,44317,0,-11747,0,0,0,,11747,-11747
17,04/27/2017,48,11:45,12:00,,-28.28,0,-28.28,-28.28,-1,-93108,126001,219109,32893,0,-43914,0,0,0,,43914,-43914
17,04/27/2017,49,12:00,12:15,,28.76,0,28.76,28.76,-1,-77769,79283,157052,1514,0,-9380,0,0,0,,9380,-9380
17,04/27/2017,50,12:15,12:30,27.4,26.46,0,36.03,26.46,2,-61406,71800,133206,10394,0,-1542,13,0,0,,1555,-1529
17,04/27/2017,51,12:30,12:45,,19.03,0,19.03,19.03,-1,-67995,87277,155272,19282,0,-25802,0,0,0,,25802,-25802
17,04/27/2017,52,12:45,13:00,,7.08,0,7.08,7.08,-1,-54852,107395,162247,52543,0,-19940,0,0,0,,19940,-19940
17,04/27/2017,53,13:00,13:15,,6.27,0,6.27,6.27,-1,-55780,93459,149239,37679,0,-37512,0,0,0,,37512,-37512
17,04/27/2017,54,13:15,13:30,,18.52,0,18.52,18.52,-1,-49417,112494,161911,63077,0,-47868,0,0,0,,47868,-47868
17,04/27/2017,55,13:30,13:45,,11.16,0,11.16,11.16,-1,-52313,131037,183350,78724,0,-69208,0,0,0,,69208,-69208
17,04/27/2017,56,13:45,14:00,,7.08,0,7.08,7.08,-1,-55776,144434,200210,88658,0,-79709,0,0,0,,79709,-79709
17,04/27/2017,57,14:00,14:15,,17.38,0,17.38,17.38,-1,-95114,113007,208121,17893,0,-34883,0,0,0,,34883,-34883
17,04/27/2017,58,14:15,14:30,,17.99,0,17.99,17.99,-1,-65458,115451,180909,49993,0,-32060,0,0,0,,32060,-32060
17,04/27/2017,59,14:30,14:45,,19.88,0,19.88,19.88,-1,-67068,123870,190938,56802,0,-45757,0,0,0,,45757,-45757
17,04/27/2017,60,14:45,15:00,,19.03,0,19.03,19.03,-1,-65164,124544,189708,59380,0,-54601,0,0,0,,54601,-54601
17,04/27/2017,61,15:00,15:15,,19.21,0,19.21,19.21,-1,-64576,114482,179058,49906,0,-42607,0,0,0,,42607,-42607
17,04/27/2017,62,15:15,15:30,,17.99,0,17.99,17.99,-1,-63401,123616,187017,60215,0,-58539,0,0,0,,58539,-58539
17,04/27/2017,63,15:30,15:45,,22.99,0,22.99,22.99,-1,-68657,112618,181275,43961,0,-46369,0,0,0,,46369,-46369
17,04/27/2017,64,15:45,16:00,,-0.97,0,-0.97,-0.97,-1,-48279,120581,168860,72302,0,-53438,0,0,0,,53438,-53438
17,04/27/2017,65,16:00,16:15,,-3.03,0,-3.03,-3.03,-1,-81605,129800,211405,48195,0,-61364,0,0,0,,61364,-61364
17,04/27/2017,66,16:15,16:30,,8.41,0,8.41,8.41,-1,-65791,129885,195676,64094,0,-45211,0,0,0,,45211,-45211
17,04/27/2017,67,16:30,16:45,,8.08,0,8.08,8.08,-1,-71101,125708,196809,54607,0,-61061,0,0,0,,61061,-61061
17,04/27/2017,68,16:45,17:00,,22.99,0,22.99,22.99,-1,-79823,115367,195190,35544,0,-37989,0,0,0,,37989,-37989
17,04/27/2017,69,17:00,17:15,,11.16,0,11.16,11.16,-1,-101012,164208,265220,63196,0,-55063,0,0,0,,55063,-55063
17,04/27/2017,70,17:15,17:30,,17.99,0,17.99,17.99,-1,-99473,158706,258179,59233,0,-40826,0,0,0,,40826,-40826
17,04/27/2017,71,17:30,17:45,,17.99,0,17.99,17.99,-1,-94829,134589,229418,39760,0,-43177,0,0,0,,43177,-43177
17,04/27/2017,72,17:45,18:00,,22.99,0,22.99,22.99,-1,-87461,118849,206310,31388,0,-17034,0,0,0,,17034,-17034
17,04/27/2017,73,18:00,18:15,,17.99,0,17.99,17.99,-1,-70426,115661,186087,45235,0,-40735,0,0,0,,40735,-40735
17,04/27/2017,74,18:15,18:30,,26.99,0,26.99,26.99,-1,-75185,112283,187468,37098,0,-31938,0,0,0,,31938,-31938
17,04/27/2017,75,18:30,18:45,,19.35,0,19.35,19.35,-1,-58923,115861,174784,56938,0,-45334,0,0,0,,45334,-45334
17,04/27/2017,76,18:45,19:00,,22.99,0,22.99,22.99,-1,-69652,106795,176447,37143,0,-47507,0,0,0,,47507,-47507
17,04/27/2017,77,19:00,19:15,,9.32,0,9.32,9.32,-1,-68114,141893,210007,73779,0,-59406,0,0,0,,59406,-59406
17,04/27/2017,78,19:15,19:30,,12.16,0,12.16,12.16,-1,-67295,115490,182785,48195,0,-63110,0,0,0,,63110,-63110
17,04/27/2017,79,19:30,19:45,,22.99,0,22.99,22.99,-1,-74447,106221,180668,31774,0,-37677,0,0,0,,37677,-37677
17,04/27/2017,80,19:45,20:00,,26.34,0,26.34,26.34,-1,-72143,107589,179732,35446,0,-22961,0,0,0,,22961,-22961
17,04/27/2017,81,20:00,20:15,,17.99,0,17.99,17.99,-1,-34011,121550,155561,87539,0,-51814,0,0,0,,51814,-51814
17,04/27/2017,82,20:15,20:30,,22.99,0,22.99,22.99,-1,-63034,107011,170045,43977,0,-31354,0,0,0,,31354,-31354
17,04/27/2017,83,20:30,20:45,,26.99,0,26.99,26.99,-1,-66688,111091,177779,44403,0,-15940,0,0,0,,15940,-15940
17,04/27/2017,84,20:45,21:00,,18.52,0,18.52,18.52,-1,-63760,108858,172618,45098,0,-11949,0,0,0,,11949,-11949
17,04/27/2017,85,21:00,21:15,,-7.21,0,-7.21,-7.21,-1,-34788,144823,179611,110035,0,-50814,0,0,0,,50814,-50814
17,04/27/2017,86,21:15,21:30,,27.95,0,27.95,27.95,-1,-53374,108348,161722,54974,0,-7065,0,0,0,,7065,-7065
17,04/27/2017,87,21:30,21:45,,26.99,0,26.99,26.99,-1,-39344,109419,148763,70075,0,-5133,0,0,0,,5133,-5133
17,04/27/2017,88,21:45,22:00,,18.75,0,18.75,18.75,-1,-37516,103922,141438,66406,0,-12194,0,0,0,,12194,-12194
17,04/27/2017,89,22:00,22:15,,-3.03,0,-3.03,-3.03,-1,-24089,103010,127099,78921,0,-55807,0,0,0,,55807,-55807
17,04/27/2017,90,22:15,22:30,,9.33,0,9.33,9.33,-1,-29317,94172,123489,64855,0,-72914,0,0,0,,72914,-72914
17,04/27/2017,91,22:30,22:45,,17.99,0,17.99,17.99,-1,-35268,105359,140627,70091,0,-66147,0,0,0,,66147,-66147
17,04/27/2017,92,22:45,23:00,,14.34,0,14.34,14.34,-1,-53462,121603,175065,68141,0,-71837,0,0,0,,71837,-71837
17,04/27/2017,93,23:00,23:15,32.3,17.99,0,32.3,32.3,1,-40235,29910,70145,-10325,0,-32375,1009,0,0,,33384,-31366
17,04/27/2017,94,23:15,23:30,32.3,26.19,0,26.19,26.19,-1,-51622,53654,105276,2032,0,-1827,116,0,0,,1943,-1711
17,04/27/2017,95,23:30,23:45,,24.24,0,24.24,24.24,-1,-52070,85471,137541,33401,0,-7026,0,0,0,,7026,-7026
17,04/27/2017,96,23:45,0:00,,-8.52,0,-8.52,-8.52,-1,-59047,98674,157721,39627,0,-42923,0,0,0,,42923,-42923
17,04/28/2017,1,0:00,0:15,,8.49,0,8.49,8.49,-1,-43856,82445,126301,38589,0,-30972,0,0,0,,30972,-30972
17,04/28/2017,2,0:15,0:30,,17.75,0,17.75,17.75,-1,-49705,73285,122990,23580,0,-12472,0,0,0,,12472,-12472
17,04/28/2017,3,0:30,0:45,,17.75,0,17.75,17.75,-1,-57506,44909,102415,-12597,0,-22960,0,0,0,,22960,-22960
17,04/28/2017,4,0:45,1:00,29.38,17.75,0,29.38,29.38,1,-101321,55380,156701,-45941,0,-1349,1372,0,0,,2721,23
17,04/28/2017,5,1:00,1:15,,22.38,0,22.38,22.38,-1,-47962,83913,131875,35951,0,-8950,0,0,0,,8950,-8950
17,04/28/2017,6,1:15,1:30,,22.38,0,22.38,22.38,-1,-53705,54044,107749,339,0,-17556,0,0,0,,17556,-17556
17,04/28/2017,7,1:30,1:45,27.38,26.38,0,28.55,26.38,2,-59920,68530,128450,8610,0,-1295,306,0,0,,1601,-989
17,04/28/2017,8,1:45,2:00,,22.38,0,22.38,22.38,-1,-49262,68159,117421,18897,0,-6289,0,0,0,,6289,-6289
17,04/28/2017,9,2:00,2:15,,19.04,0,19.04,19.04,-1,-31336,68637,99973,37301,0,-29809,0,0,0,,29809,-29809
17,04/28/2017,10,2:15,2:30,27.38,26.32,0,27.38,27.38,1,-36471,39692,76163,3221,0,-16065,169,0,0,,16234,-15896
17,04/28/2017,11,2:30,2:45,29.09,27.38,0,29.09,27.38,2,-45595,56136,101731,10541,0,-621,153,0,0,,774,-468
17,04/28/2017,12,2:45,3:00,,27.38,0,27.38,27.38,-1,-42007,51086,93093,9079,0,-2297,0,0,0,,2297,-2297
17,04/28/2017,13,3:00,3:15,,26.38,0,26.38,26.38,-1,-36506,42474,78980,5968,0,-4065,0,0,0,,4065,-4065
17,04/28/2017,14,3:15,3:30,,,0,28.58,28.58,0,-37026,30636,67662,-6390,0,-497,0,0,0,,497,-497
17,04/28/2017,15,3:30,3:45,,27.49,0,27.49,27.49,-1,-40751,33195,73946,-7556,0,-753,0,0,0,,753,-753
17,04/28/2017,16,3:45,4:00,27.38,27.49,0,27.38,27.38,1,-53110,26420,79530,-26690,0,-60,797,0,0,,857,737
17,04/28/2017,17,4:00,4:15,26.34,,0,26.34,26.34,1,-35569,40979,76548,5410,0,0,345,0,0,,345,345
17,04/28/2017,18,4:15,4:30,,,0,28.56,28.56,0,-36292,39292,75584,3000,0,0,0,0,0,,0,0
17,04/28/2017,19,4:30,4:45,,,0,28.56,28.56,0,-36010,38770,74780,2760,0,0,0,0,0,,0,0
17,04/28/2017,20,4:45,5:00,29.38,29.05,0,29.38,27.89,2,-47858,44545,92403,-3313,0,-326,98,0,0,,424,-228
17,04/28/2017,21,5:00,5:15,32.42,,0,32.42,32.42,1,-61555,11493,73048,-50062,0,0,1187,0,0,,1187,1187
17,04/28/2017,22,5:15,5:30,33.38,,0,33.38,33.38,1,-47891,28372,76263,-19519,0,0,2801,0,0,,2801,2801
17,04/28/2017,23,5:30,5:45,36.53,,0,36.53,36.53,1,-70576,36636,107212,-33940,0,0,16427,0,0,,16427,16427
17,04/28/2017,24,5:45,6:00,45.45,,0,45.45,45.45,1,-58881,36447,95328,-22434,0,0,16840,0,0,,16840,16840
17,04/28/2017,25,6:00,6:15,29.75,,0,29.75,29.75,1,-65128,36825,101953,-28303,0,0,7755,0,0,,7755,7755
17,04/28/2017,26,6:15,6:30,29.75,19.04,0,19.04,19.04,-1,-40599,70310,110909,29711,0,-16270,41,0,0,,16311,-16229
17,04/28/2017,27,6:30,6:45,,24.56,0,24.56,24.56,-1,-42141,61698,103839,19557,0,-25393,0,0,0,,25393,-25393
17,04/28/2017,28,6:45,7:00,28.4,22.75,0,28.53,22.75,2,-45092,58075,103167,12983,0,-8693,532,0,0,,9225,-8161
17,04/28/2017,29,7:00,7:15,,-27.76,0,-27.76,-27.76,-1,-63768,102127,165895,38359,0,-28179,0,0,0,,28179,-28179
17,04/28/2017,30,7:15,7:30,,26.9,0,26.9,26.9,-1,-68853,78287,147140,9434,0,-3771,0,0,0,,3771,-3771
17,04/28/2017,31,7:30,7:45,34.25,27.75,0,34.25,27.75,2,-61536,48545,110081,-12991,0,-2815,1513,0,0,,4328,-1302
17,04/28/2017,32,7:45,8:00,34.25,27.75,0,34.25,34.25,1,-78798,53033,131831,-25765,0,-6,8880,0,0,,8886,8874
17,04/28/2017,33,8:00,8:15,34.25,19.04,0,19.04,19.04,-1,-80650,106184,186834,25534,0,-8579,2893,0,0,,11472,-5686
17,04/28/2017,34,8:15,8:30,,27.75,0,27.75,27.75,-1,-77057,86655,163712,9598,0,-1756,0,0,0,,1756,-1756
17,04/28/2017,35,8:30,8:45,,27.75,0,27.75,27.75,-1,-73433,68586,142019,-4847,0,-2390,0,0,0,,2390,-2390
17,04/28/2017,36,8:45,9:00,,26.9,0,26.9,26.9,-1,-65399,72402,137801,7003,0,-579,0,0,0,,579,-579
17,04/28/2017,37,9:00,9:15,,22.75,0,22.75,22.75,-1,-63928,73445,137373,9517,0,-7994,0,0,0,,7994,-7994
17,04/28/2017,38,9:15,9:30,29.7,29.05,0,32.35,29.05,2,-72935,78007,150942,5072,0,-218,59,0,0,,277,-159
17,04/28/2017,39,9:30,9:45,,28.4,0,28.4,28.4,-1,-69597,66068,135665,-3529,0,-1061,0,0,0,,1061,-1061
17,04/28/2017,40,9:45,10:00,30.4,,0,30.4,30.4,1,-78245,53312,131557,-24933,0,0,1985,0,0,,1985,1985
17,04/28/2017,41,10:00,10:15,34.12,,0,34.12,34.12,1,-77676,50485,128161,-27191,0,0,8744,0,0,,8744,8744
17,04/28/2017,42,10:15,10:30,30.4,,0,30.4,30.4,1,-76929,42736,119665,-34193,0,0,4054,0,0,,4054,4054
17,04/28/2017,43,10:30,10:45,30.9,,0,30.9,30.9,1,-71784,50871,122655,-20913,0,0,2381,0,0,,2381,2381
17,04/28/2017,44,10:45,11:00,30.4,,0,30.4,30.4,1,-78783,61422,140205,-17361,0,0,2797,0,0,,2797,2797
17,04/28/2017,45,11:00,11:15,32.82,,0,32.82,32.82,1,-93268,62122,155390,-31146,0,0,5966,0,0,,5966,5966
17,04/28/2017,46,11:15,11:30,38.39,,0,38.39,38.39,1,-97871,66317,164188,-31554,0,0,13784,0,0,,13784,13784
17,04/28/2017,47,11:30,11:45,38.49,,0,38.49,38.49,1,-80588,51913,132501,-28675,0,0,27917,0,0,,27917,27917
17,04/28/2017,48,11:45,12:00,31.12,,0,31.12,31.12,1,-76142,48463,124605,-27679,0,0,14393,0,0,,14393,14393
17,04/28/2017,49,12:00,12:15,133.4,,0,133.4,133.4,1,-104586,36464,141050,-68122,0,0,21708,0,0,,21708,21708
17,04/28/2017,50,12:15,12:30,35.83,,0,35.83,35.83,1,-103699,42428,146127,-61271,0,0,37906,0,0,,37906,37906
17,04/28/2017,51,12:30,12:45,43.68,,0,43.68,43.68,1,-106391,56843,163234,-49548,0,0,30774,0,0,,30774,30774
17,04/28/2017,52,12:45,13:00,34.4,,0,34.4,34.4,1,-90317,74486,164803,-15831,0,0,25934,0,0,,25934,25934
17,04/28/2017,53,13:00,13:15,32.82,,0,32.82,32.82,1,-86608,75444,162052,-11164,0,0,2924,0,0,,2924,2924
17,04/28/2017,54,13:15,13:30,126.01,,0,126.01,126.01,1,-105687,60536,166223,-45151,0,0,32592,0,0,,32592,32592
17,04/28/2017,55,13:30,13:45,33.79,26.75,0,26.75,26.75,-1,-89161,94088,183249,4927,0,-430,15822,0,0,,16252,15392
17,04/28/2017,56,13:45,14:00,33.79,26.59,0,26.59,26.59,-1,-83093,96442,179535,13349,0,-7378,23,0,0,,7401,-7355
17,04/28/2017,57,14:00,14:15,35.89,26.75,0,35.89,26.75,2,-88407,68819,157226,-19588,0,-6269,4060,0,0,,10329,-2209
17,04/28/2017,58,14:15,14:30,30.74,26.75,0,30.74,30.74,1,-67057,64177,131234,-2880,0,-6,5819,0,0,,5825,5813
17,04/28/2017,59,14:30,14:45,30.74,21.48,0,21.48,21.48,-1,-53010,77347,130357,24337,0,-17082,1123,0,0,,18205,-15959
17,04/28/2017,60,14:45,15:00,,21.48,0,21.48,21.48,-1,-52552,75296,127848,22744,0,-24554,0,0,0,,24554,-24554
17,04/28/2017,61,15:00,15:15,40.4,21.25,0,40.4,40.4,1,-61549,44040,105589,-17509,0,-13341,3212,0,0,,16553,-10129
17,04/28/2017,62,15:15,15:30,43.08,29.05,0,43.08,29.05,2,-59799,50252,110051,-9547,0,-46,12883,0,0,,12929,12837
17,04/28/2017,63,15:30,15:45,43.08,27.75,0,27.75,27.75,-1,-42560,54178,96738,11618,0,-2519,147,0,0,,2666,-2372
17,04/28/2017,64,15:45,16:00,,26.27,0,26.27,26.27,-1,-39325,50852,90177,11527,0,-10692,0,0,0,,10692,-10692
17,04/28/2017,65,16:00,16:15,,27.52,0,27.52,27.52,-1,-32473,46034,78507,13561,0,-8132,0,0,0,,8132,-8132
17,04/28/2017,66,16:15,16:30,,27.52,0,27.52,27.52,-1,-27799,35204,63003,7405,0,-5467,0,0,0,,5467,-5467
17,04/28/2017,67,16:30,16:45,33.89,30.21,0,33.89,29.89,2,-54370,30884,85254,-23486,0,-3088,1041,0,0,,4129,-2047
17,04/28/2017,68,16:45,17:00,33.99,30.21,0,33.99,33.99,1,-59205,32451,91656,-26754,0,-84,2177,0,0,,2261,2093
17,04/28/2017,69,17:00,17:15,,,0,29.84,29.84,0,-36110,42684,78794,6574,0,0,0,0,0,,0,0
17,04/28/2017,70,17:15,17:30,,27.75,0,27.75,27.75,-1,-31488,47425,78913,15937,0,-2035,0,0,0,,2035,-2035
17,04/28/2017,71,17:30,17:45,,27.75,0,27.75,27.75,-1,-43044,47765,90809,4721,0,-2068,0,0,0,,2068,-2068
17,04/28/2017,72,17:45,18:00,32.53,27.75,0,32.53,32.53,1,-56771,29304,86075,-27467,0,-142,831,0,0,,973,689
17,04/28/2017,73,18:00,18:15,,,0,31.75,31.75,0,-71670,25634,97304,-46036,0,0,92,0,0,,92,92
17,04/28/2017,74,18:15,18:30,30.4,,0,30.4,30.4,1,-50465,39408,89873,-11057,0,0,396,0,0,,396,396
17,04/28/2017,75,18:30,18:45,30.4,24.85,0,31.75,24.85,2,-46837,49219,96056,2382,0,-5041,381,0,0,,5422,-4660
17,04/28/2017,76,18:45,19:00,30.4,30.21,0,32.35,30.21,2,-57347,42827,100174,-14520,0,-1802,837,0,0,,2639,-965
17,04/28/2017,77,19:00,19:15,30.4,19.04,0,19.04,19.04,-1,-65831,105996,171827,40165,0,-15269,20,0,0,,15289,-15249
17,04/28/2017,78,19:15,19:30,,22.99,0,22.99,22.99,-1,-80706,86134,166840,5428,0,-18095,0,0,0,,18095,-18095
17,04/28/2017,79,19:30,19:45,,26.75,0,26.75,26.75,-1,-72408,87791,160199,15383,0,-3560,0,0,0,,3560,-3560
17,04/28/2017,80,19:45,20:00,,26.75,0,26.75,26.75,-1,-79373,85647,165020,6274,0,-7309,0,0,0,,7309,-7309
17,04/28/2017,81,20:00,20:15,147.52,26.75,0,147.52,147.52,1,-96803,50554,147357,-46249,0,-646,16803,0,0,,17449,16157
17,04/28/2017,82,20:15,20:30,32.99,31.99,0,31.99,31.99,-1,-59975,67442,127417,7467,0,-61,6844,0,0,,6905,6783
17,04/28/2017,83,20:30,20:45,,31.89,0,31.89,31.89,-1,-64871,75079,139950,10208,0,-310,0,0,0,,310,-310
17,04/28/2017,84,20:45,21:00,,27.75,0,27.75,27.75,-1,-79265,72484,151749,-6781,0,-70,0,0,0,,70,-70
17,04/28/2017,85,21:00,21:15,,19.04,0,19.04,19.04,-1,-31221,71371,102592,40150,0,-13181,0,0,0,,13181,-13181
17,04/28/2017,86,21:15,21:30,31.65,19.04,0,31.65,31.65,1,-59361,37112,96473,-22249,0,-227,470,0,0,,697,243
17,04/28/2017,87,21:30,21:45,46.45,,0,46.45,46.45,1,-75646,29266,104912,-46380,0,0,15049,0,0,,15049,15049
17,04/28/2017,88,21:45,22:00,30.74,26.75,0,30.74,26.75,2,-64103,35445,99548,-28658,0,-253,9137,0,0,,9390,8884
17,04/28/2017,89,22:00,22:15,30.74,7.51,0,7.51,7.51,-1,-50470,102429,152899,51959,0,-32197,149,0,0,,32346,-32048
17,04/28/2017,90,22:15,22:30,,22.75,0,22.75,22.75,-1,-42591,57509,100100,14918,0,-18011,0,0,0,,18011,-18011
17,04/28/2017,91,22:30,22:45,,19.04,0,19.04,19.04,-1,-23941,67945,91886,44004,0,-42135,0,0,0,,42135,-42135
17,04/28/2017,92,22:45,23:00,,14.51,0,14.51,14.51,-1,-21838,69394,91232,47556,0,-57359,0,0,0,,57359,-57359
17,04/28/2017,93,23:00,23:15,40.4,19.04,0,40.4,40.4,1,-53845,61480,115325,7635,0,-27908,859,0,0,,28767,-27049
17,04/28/2017,94,23:15,23:30,40.4,27.75,0,40.4,27.75,2,-31488,51134,82622,19646,0,-270,2322,0,0,,2592,2052
17,04/28/2017,95,23:30,23:45,,22.75,0,22.75,22.75,-1,-18585,81982,100567,63397,0,-1599,0,0,0,,1599,-1599
17,04/28/2017,96,23:45,0:00,,7.6,0,7.6,7.6,-1,-36683,96551,133234,59868,0,-27458,0,0,0,,27458,-27458
18,04/29/2017,1,0:00,0:15,52.7,28.24,0,52.7,52.7,1,-86729,64120,150849,-22609,0,-5744,5031,0,0,,10775,-713
18,04/29/2017,2,0:15,0:30,52.7,28.62,0,52.7,28.62,2,-31492,38874,70366,7382,0,-14,13713,0,0,,13727,13699
18,04/29/2017,3,0:30,0:45,56.02,27.52,0,56.02,27.52,2,-55521,27766,83287,-27755,0,-452,4876,0,0,,5328,4424
18,04/29/2017,4,0:45,1:00,157.38,,0,157.38,157.38,1,-108662,45553,154215,-63109,0,0,35274,0,0,,35274,35274
18,04/29/2017,5,1:00,1:15,40.83,28.56,0,28.56,28.56,-1,-30417,38342,68759,7925,0,-230,16128,0,0,,16358,15898
18,04/29/2017,6,1:15,1:30,40.83,14.37,0,14.37,14.37,-1,-19221,71494,90715,52273,0,-5853,64,0,0,,5917,-5789
18,04/29/2017,7,1:30,1:45,,10.08,0,10.08,10.08,-1,-15165,71741,86906,56576,0,-10775,0,0,0,,10775,-10775
18,04/29/2017,8,1:45,2:00,,-15.99,0,-15.99,-15.99,-1,-17519,93318,110837,75799,0,-29116,0,0,0,,29116,-29116
18,04/29/2017,9,2:00,2:15,,27.24,0,27.24,27.24,-1,-35298,43857,79155,8559,0,-16072,0,0,0,,16072,-16072
18,04/29/2017,10,2:15,2:30,,,0,30.78,30.78,0,-22671,59072,81743,36401,0,0,0,0,0,,0,0
18,04/29/2017,11,2:30,2:45,,27.52,0,27.52,27.52,-1,-14100,69962,84062,55862,0,-111,0,0,0,,111,-111
18,04/29/2017,12,2:45,3:00,,14.65,0,14.65,14.65,-1,-11047,81602,92649,70555,0,-17304,0,0,0,,17304,-17304
18,04/29/2017,13,3:00,3:15,,16.49,0,16.49,16.49,-1,-32466,42347,74813,9881,0,-15270,0,0,0,,15270,-15270
18,04/29/2017,14,3:15,3:30,28.74,16.49,0,28.74,28.74,1,-23382,43694,67076,20312,0,-258,167,0,0,,425,-91
18,04/29/2017,15,3:30,3:45,,,0,30.27,30.27,0,-26791,33319,60110,6528,0,0,0,0,0,,0,0
18,04/29/2017,16,3:45,4:00,30.74,,0,30.74,30.74,1,-30702,21928,52630,-8774,0,0,2025,0,0,,2025,2025
18,04/29/2017,17,4:00,4:15,34.74,,0,34.74,34.74,1,-31073,10800,41873,-20273,0,0,8690,0,0,,8690,8690
18,04/29/2017,18,4:15,4:30,30.74,,0,30.74,30.74,1,-26973,26472,53445,-501,0,0,7452,0,0,,7452,7452
18,04/29/2017,19,4:30,4:45,28.74,,0,28.74,28.74,1,-44434,42578,87012,-1856,0,0,638,0,0,,638,638
18,04/29/2017,20,4:45,5:00,66.46,,0,66.46,66.46,1,-82694,38058,120752,-44636,0,0,15314,0,0,,15314,15314
18,04/29/2017,21,5:00,5:15,216.21,,0,216.21,216.21,1,-124134,47348,171482,-76786,0,0,63647,0,0,,63647,63647
18,04/29/2017,22,5:15,5:30,216.21,,0,216.21,216.21,1,-91250,61550,152800,-29700,0,0,54357,0,0,,54357,54357
18,04/29/2017,23,5:30,5:45,30.74,27.52,0,30.74,27.52,2,-66189,62075,128264,-4114,0,-381,2198,0,0,,2579,1817
18,04/29/2017,24,5:45,6:00,43.38,,0,43.38,43.38,1,-73898,56698,130596,-17200,0,0,12025,0,0,,12025,12025
18,04/29/2017,25,6:00,6:15,43.38,20.23,0,20.23,20.23,-1,-45350,81445,126795,36095,0,-14595,3102,0,0,,17697,-11493
18,04/29/2017,26,6:15,6:30,,25.73,0,25.73,25.73,-1,-41594,67998,109592,26404,0,-20669,0,0,0,,20669,-20669
18,04/29/2017,27,6:30,6:45,30.9,29.21,0,30.9,30.9,1,-39384,34644,74028,-4740,0,-5038,1220,0,0,,6258,-3818
18,04/29/2017,28,6:45,7:00,34.74,,0,34.74,34.74,1,-40349,22109,62458,-18240,0,0,4048,0,0,,4048,4048
18,04/29/2017,29,7:00,7:15,,,0,26.88,26.88,0,-18664,91423,110087,72759,0,0,862,0,0,,862,862
18,04/29/2017,30,7:15,7:30,,,0,26.88,26.88,0,-14423,64483,78906,50060,0,0,0,0,0,,0,0
18,04/29/2017,31,7:30,7:45,,,0,26.88,26.88,0,-19601,66188,85789,46587,0,0,0,0,0,,0,0
18,04/29/2017,32,7:45,8:00,,,0,26.89,26.89,0,-26684,87388,114072,60704,0,0,0,0,0,,0,0
18,04/29/2017,33,8:00,8:15,50.75,,0,50.75,50.75,1,-110317,92813,203130,-17504,0,0,3254,0,0,,3254,3254
18,04/29/2017,34,8:15,8:30,50.75,,0,50.75,50.75,1,-93490,74078,167568,-19412,0,0,18935,0,0,,18935,18935
18,04/29/2017,35,8:30,8:45,30.74,,0,30.74,30.74,1,-77050,70093,147143,-6957,0,0,7842,0,0,,7842,7842
18,04/29/2017,36,8:45,9:00,33.59,,0,33.59,33.59,1,-77041,63213,140254,-13828,0,0,5590,0,0,,5590,5590
18,04/29/2017,37,9:00,9:15,29.01,,0,29.01,29.01,1,-41129,98176,139305,57047,0,0,1708,0,0,,1708,1708
18,04/29/2017,38,9:15,9:30,,23.24,0,23.24,23.24,-1,-45785,95121,140906,49336,0,-8819,0,0,0,,8819,-8819
18,04/29/2017,39,9:30,9:45,,27.81,0,27.81,27.81,-1,-55027,61472,116499,6445,0,-1580,0,0,0,,1580,-1580
18,04/29/2017,40,9:45,10:00,,25.73,0,25.73,25.73,-1,-57129,76571,133700,19442,0,-14288,0,0,0,,14288,-14288
18,04/29/2017,41,10:00,10:15,,28.62,0,28.62,28.62,-1,-52276,73801,126077,21525,0,-4536,0,0,0,,4536,-4536
18,04/29/2017,42,10:15,10:30,30.74,28.62,0,30.74,30.74,1,-57025,57728,114753,703,0,-19,469,0,0,,488,450
18,04/29/2017,43,10:30,10:45,30.74,,0,30.74,30.74,1,-56394,68977,125371,12583,0,0,999,0,0,,999,999
18,04/29/2017,44,10:45,11:00,30.74,31.89,0,31.89,31.89,-1,-58357,65155,123512,6798,0,-235,23,0,0,,258,-212
18,04/29/2017,45,11:00,11:15,,31.59,0,31.59,31.59,-1,-19009,46484,65493,27475,0,-648,0,0,0,,648,-648
18,04/29/2017,46,11:15,11:30,,27.24,0,27.24,27.24,-1,-18636,48640,67276,30004,0,-3233,0,0,0,,3233,-3233
18,04/29/2017,47,11:30,11:45,,31.49,0,31.49,31.49,-1,-24713,38852,63565,14139,0,-439,0,0,0,,439,-439
18,04/29/2017,48,11:45,12:00,,28.24,0,28.24,28.24,-1,-18765,39751,58516,20986,0,-1042,0,0,0,,1042,-1042
18,04/29/2017,49,12:00,12:15,30.74,28.24,0,30.74,30.74,1,-35951,37611,73562,1660,0,-48,281,0,0,,329,233
18,04/29/2017,50,12:15,12:30,30.74,,0,30.74,30.74,1,-38856,29310,68166,-9546,0,0,2826,0,0,,2826,2826
18,04/29/2017,51,12:30,12:45,32.59,,0,32.59,32.59,1,-41734,30675,72409,-11059,0,0,9612,0,0,,9612,9612
18,04/29/2017,52,12:45,13:00,30.74,,0,30.74,30.74,1,-37143,30847,67990,-6296,0,0,10448,0,0,,10448,10448
18,04/29/2017,53,13:00,13:15,30.74,23.24,0,23.24,23.24,-1,-28971,87442,116413,58471,0,-7487,1006,0,0,,8493,-6481
18,04/29/2017,54,13:15,13:30,,28.24,0,28.24,28.24,-1,-32587,56721,89308,24134,0,-6137,0,0,0,,6137,-6137
18,04/29/2017,55,13:30,13:45,,27.24,0,27.24,27.24,-1,-32555,54997,87552,22442,0,-1355,0,0,0,,1355,-1355
18,04/29/2017,56,13:45,14:00,,26.35,0,26.35,26.35,-1,-34124,66667,100791,32543,0,-11489,0,0,0,,11489,-11489
18,04/29/2017,57,14:00,14:15,,25.42,0,25.42,25.42,-1,-25628,103116,128744,77488,0,-8373,0,0,0,,8373,-8373
18,04/29/2017,58,14:15,14:30,,,0,28.36,28.36,0,-24666,61341,86007,36675,0,-195,0,0,0,,195,-195
18,04/29/2017,59,14:30,14:45,,17.98,0,17.98,17.98,-1,-18040,62205,80245,44165,0,-12595,0,0,0,,12595,-12595
18,04/29/2017,60,14:45,15:00,,18.24,0,18.24,18.24,-1,-20563,53374,73937,32811,0,-35710,0,0,0,,35710,-35710
18,04/29/2017,61,15:00,15:15,,23.24,0,23.24,23.24,-1,-27345,73560,100905,46215,0,-20477,0,0,0,,20477,-20477
18,04/29/2017,62,15:15,15:30,,28.56,0,28.56,28.56,-1,-26213,81460,107673,55247,0,-852,0,0,0,,852,-852
18,04/29/2017,63,15:30,15:45,,27.24,0,27.24,27.24,-1,-20187,74372,94559,54185,0,-6051,0,0,0,,6051,-6051
18,04/29/2017,64,15:45,16:00,,22.32,0,22.32,22.32,-1,-25515,63429,88944,37914,0,-8358,0,0,0,,8358,-8358
18,04/29/2017,65,16:00,16:15,,-58.23,0,-58.23,-58.23,-1,-13484,111140,124624,97656,0,-54576,0,0,0,,54576,-54576
18,04/29/2017,66,16:15,16:30,,22.32,0,22.32,22.32,-1,-26343,85058,111401,58715,0,-36065,0,0,0,,36065,-36065
18,04/29/2017,67,16:30,16:45,,22.32,0,22.32,22.32,-1,-34926,79140,114066,44214,0,-34035,0,0,0,,34035,-34035
18,04/29/2017,68,16:45,17:00,,27.24,0,27.24,27.24,-1,-31635,61447,93082,29812,0,-12856,0,0,0,,12856,-12856
18,04/29/2017,69,17:00,17:15,,27.24,0,27.24,27.24,-1,-65439,73935,139374,8496,0,-9650,0,0,0,,9650,-9650
18,04/29/2017,70,17:15,17:30,,25.42,0,25.42,25.42,-1,-43909,68276,112185,24367,0,-13359,0,0,0,,13359,-13359
18,04/29/2017,71,17:30,17:45,,28.24,0,28.24,28.24,-1,-39704,44877,84581,5173,0,-11386,0,0,0,,11386,-11386
18,04/29/2017,72,17:45,18:00,25.79,18.45,0,28.94,18.45,2,-31654,58010,89664,26356,0,-4828,18,0,0,,4846,-4810
18,04/29/2017,73,18:00,18:15,,18.45,0,18.45,18.45,-1,-73480,37956,111436,-35524,0,-6867,0,0,0,,6867,-6867
18,04/29/2017,74,18:15,18:30,,27.24,0,27.24,27.24,-1,-22157,37075,59232,14918,0,-6292,0,0,0,,6292,-6292
18,04/29/2017,75,18:30,18:45,,27.52,0,27.52,27.52,-1,-16643,39360,56003,22717,0,-13713,0,0,0,,13713,-13713
18,04/29/2017,76,18:45,19:00,,28.24,0,28.24,28.24,-1,-18643,41232,59875,22589,0,-12557,0,0,0,,12557,-12557
18,04/29/2017,77,19:00,19:15,28.74,28.24,0,28.74,28.74,1,-38461,23395,61856,-15066,0,-2495,552,0,0,,3047,-1943
18,04/29/2017,78,19:15,19:30,28.74,,0,28.74,28.74,1,-33359,31536,64895,-1823,0,0,833,0,0,,833,833
18,04/29/2017,79,19:30,19:45,30.06,,0,30.06,30.06,1,-40037,28997,69034,-11040,0,0,1465,0,0,,1465,1465
18,04/29/2017,80,19:45,20:00,30.74,,0,30.74,30.74,1,-38491,34271,72762,-4220,0,0,2372,0,0,,2372,2372
18,04/29/2017,81,20:00,20:15,30.9,,0,30.9,30.9,1,-65060,17047,82107,-48013,0,0,6156,0,0,,6156,6156
18,04/29/2017,82,20:15,20:30,30.9,,0,30.9,30.9,1,-45538,18419,63957,-27119,0,0,5168,0,0,,5168,5168
18,04/29/2017,83,20:30,20:45,,,0,27.71,27.71,0,-38415,21493,59908,-16922,0,0,416,0,0,,416,416
18,04/29/2017,84,20:45,21:00,,28.24,0,28.24,28.24,-1,-25683,36476,62159,10793,0,-685,0,0,0,,685,-685
18,04/29/2017,85,21:00,21:15,,27.52,0,27.52,27.52,-1,-13117,80880,93997,67763,0,-2950,0,0,0,,2950,-2950
18,04/29/2017,86,21:15,21:30,,33.39,0,33.39,33.39,-1,-35445,55369,90814,19924,0,-482,0,0,0,,482,-482
18,04/29/2017,87,21:30,21:45,,,0,29.51,29.51,0,-37260,43301,80561,6041,0,0,0,0,0,,0,0
18,04/29/2017,88,21:45,22:00,,29.6,0,29.6,29.6,-1,-34302,62203,96505,27901,0,-23,0,0,0,,23,-23
18,04/29/2017,89,22:00,22:15,,29.6,0,29.6,29.6,-1,-66846,37638,104484,-29208,0,-393,0,0,0,,393,-393
18,04/29/2017,90,22:15,22:30,,27.24,0,27.24,27.24,-1,-42338,40130,82468,-2208,0,-946,0,0,0,,946,-946
18,04/29/2017,91,22:30,22:45,,27.24,0,27.24,27.24,-1,-28294,64500,92794,36206,0,-2074,0,0,0,,2074,-2074
18,04/29/2017,92,22:45,23:00,,18.24,0,18.24,18.24,-1,-48830,94899,143729,46069,0,-10372,0,0,0,,10372,-10372
18,04/29/2017,93,23:00,23:15,,15.79,0,15.79,15.79,-1,-41394,66670,108064,25276,0,-20889,0,0,0,,20889,-20889
18,04/29/2017,94,23:15,23:30,,18.24,0,18.24,18.24,-1,-27752,50666,78418,22914,0,-4131,0,0,0,,4131,-4131
18,04/29/2017,95,23:30,23:45,,7.01,0,7.01,7.01,-1,-27616,71805,99421,44189,0,-38487,0,0,0,,38487,-38487
18,04/29/2017,96,23:45,0:00,,-14.08,0,-14.08,-14.08,-1,-27527,81292,108819,53765,0,-42147,0,0,0,,42147,-42147
18,04/30/2017,1,0:00,0:15,31.06,-32.24,0,31.06,-32.24,2,-36779,76927,113706,40148,0,-33653,412,0,0,,34065,-33241
18,04/30/2017,2,0:15,0:30,31.06,23.2,0,31.06,23.2,2,-16412,66909,83321,50497,0,-859,498,0,0,,1357,-361
18,04/30/2017,3,0:30,0:45,,8.43,0,8.43,8.43,-1,-16793,83168,99961,66375,0,-33236,0,0,0,,33236,-33236
18,04/30/2017,4,0:45,1:00,,23.2,0,23.2,23.2,-1,-50709,80865,131574,30156,0,-37055,0,0,0,,37055,-37055
18,04/30/2017,5,1:00,1:15,29.2,24.24,0,29.2,24.24,2,-18179,84289,102468,66110,0,-19608,136,0,0,,19744,-19472
18,04/30/2017,6,1:15,1:30,31.81,25.21,0,31.81,25.21,2,-29302,61934,91236,32632,0,-2259,1070,0,0,,3329,-1189
18,04/30/2017,7,1:30,1:45,,23.2,0,23.2,23.2,-1,-25836,86019,111855,60183,0,-7313,0,0,0,,7313,-7313
18,04/30/2017,8,1:45,2:00,,17.33,0,17.33,17.33,-1,-25464,81388,106852,55924,0,-30699,0,0,0,,30699,-30699
18,04/30/2017,9,2:00,2:15,,26.2,0,26.2,26.2,-1,-13598,84914,98512,71316,0,-14380,0,0,0,,14380,-14380
18,04/30/2017,10,2:15,2:30,,,0,27.78,27.78,0,-16444,81598,98042,65154,0,-41,0,0,0,,41,-41
18,04/30/2017,11,2:30,2:45,,18.2,0,18.2,18.2,-1,-10533,102084,112617,91551,0,-1422,0,0,0,,1422,-1422
18,04/30/2017,12,2:45,3:00,,-18.03,0,-18.03,-18.03,-1,-18844,84250,103094,65406,0,-35777,0,0,0,,35777,-35777
18,04/30/2017,13,3:00,3:15,,27.2,0,27.2,27.2,-1,-37209,68157,105366,30948,0,-6163,0,0,0,,6163,-6163
18,04/30/2017,14,3:15,3:30,,27.2,0,27.2,27.2,-1,-27924,60051,87975,32127,0,-167,0,0,0,,167,-167
18,04/30/2017,15,3:30,3:45,,26.2,0,26.2,26.2,-1,-19373,78734,98107,59361,0,-3587,0,0,0,,3587,-3587
18,04/30/2017,16,3:45,4:00,,-18.22,0,-18.22,-18.22,-1,-12147,93073,105220,80926,0,-41582,0,0,0,,41582,-41582
18,04/30/2017,17,4:00,4:15,,14.79,0,14.79,14.79,-1,-38645,71803,110448,33158,0,-27632,0,0,0,,27632,-27632
18,04/30/2017,18,4:15,4:30,,19.42,0,19.42,19.42,-1,-33736,81091,114827,47355,0,-14612,0,0,0,,14612,-14612
18,04/30/2017,19,4:30,4:45,,18.2,0,18.2,18.2,-1,-41270,92124,133394,50854,0,-46584,0,0,0,,46584,-46584
18,04/30/2017,20,4:45,5:00,,22.78,0,22.78,22.78,-1,-37032,100180,137212,63148,0,-38583,0,0,0,,38583,-38583
18,04/30/2017,21,5:00,5:15,,18.2,0,18.2,18.2,-1,-57506,81980,139486,24474,0,-37915,0,0,0,,37915,-37915
18,04/30/2017,22,5:15,5:30,,18.2,0,18.2,18.2,-1,-46568,85315,131883,38747,0,-27099,0,0,0,,27099,-27099
18,04/30/2017,23,5:30,5:45,,18.2,0,18.2,18.2,-1,-40809,97515,138324,56706,0,-38300,0,0,0,,38300,-38300
18,04/30/2017,24,5:45,6:00,,18.2,0,18.2,18.2,-1,-32115,121258,153373,89143,0,-38803,0,0,0,,38803,-38803
18,04/30/2017,25,6:00,6:15,,21.72,0,21.72,21.72,-1,-39652,80210,119862,40558,0,-31752,0,0,0,,31752,-31752
18,04/30/2017,26,6:15,6:30,,-26.15,0,-26.15,-26.15,-1,-37162,99813,136975,62651,0,-56174,0,0,0,,56174,-56174
18,04/30/2017,27,6:30,6:45,,16.48,0,16.48,16.48,-1,-35565,70767,106332,35202,0,-50198,0,0,0,,50198,-50198
18,04/30/2017,28,6:45,7:00,,21.72,0,21.72,21.72,-1,-41974,84457,126431,42483,0,-46524,0,0,0,,46524,-46524
18,04/30/2017,29,7:00,7:15,,,0,27.53,27.53,0,-90423,67897,158320,-22526,0,-16945,0,0,0,,16945,-16945
18,04/30/2017,30,7:15,7:30,30.17,27.46,0,30.17,27.46,2,-80739,66064,146803,-14675,0,-222,26,0,0,,248,-196
18,04/30/2017,31,7:30,7:45,,28.52,0,28.52,28.52,-1,-93396,65503,158899,-27893,0,-539,0,0,0,,539,-539
18,04/30/2017,32,7:45,8:00,,,0,29.47,29.47,0,-82483,66443,148926,-16040,0,-9,0,0,0,,9,-9
18,04/30/2017,33,8:00,8:15,32.86,,0,32.86,32.86,1,-62403,37805,100208,-24598,0,0,1244,0,0,,1244,1244
18,04/30/2017,34,8:15,8:30,34.17,,0,34.17,34.17,1,-74171,46077,120248,-28094,0,0,15428,0,0,,15428,15428
18,04/30/2017,35,8:30,8:45,29.17,,0,29.17,29.17,1,-70218,65259,135477,-4959,0,0,6773,0,0,,6773,6773
18,04/30/2017,36,8:45,9:00,29.17,29.56,0,29.56,29.56,-1,-66352,91866,158218,25514,0,-339,4,0,0,,343,-335
18,04/30/2017,37,9:00,9:15,,28.94,0,28.94,28.94,-1,-59024,123740,182764,64716,0,-356,0,0,0,,356,-356
18,04/30/2017,38,9:15,9:30,,,0,27.51,27.51,0,-45916,111933,157849,66017,0,0,0,0,0,,0,0
18,04/30/2017,39,9:30,9:45,,26.17,0,26.17,26.17,-1,-40821,132427,173248,91606,0,-1325,0,0,0,,1325,-1325
18,04/30/2017,40,9:45,10:00,,23.82,0,23.82,23.82,-1,-34332,140677,175009,106345,0,-11408,0,0,0,,11408,-11408
18,04/30/2017,41,10:00,10:15,,-26.15,0,-26.15,-26.15,-1,-47098,113984,161082,66886,0,-21779,0,0,0,,21779,-21779
18,04/30/2017,42,10:15,10:30,,-21.55,0,-21.55,-21.55,-1,-59066,82559,141625,23493,0,-27826,0,0,0,,27826,-27826
18,04/30/2017,43,10:30,10:45,,-26.15,0,-26.15,-26.15,-1,-30487,126467,156954,95980,0,-24461,0,0,0,,24461,-24461
18,04/30/2017,44,10:45,11:00,,23.17,0,23.17,23.17,-1,-33319,116189,149508,82870,0,-17631,0,0,0,,17631,-17631
18,04/30/2017,45,11:00,11:15,35.65,26.17,0,35.65,26.17,2,-84857,48310,133167,-36547,0,-8924,3644,0,0,,12568,-5280
18,04/30/2017,46,11:15,11:30,35.65,-10.55,0,-10.55,-10.55,-1,-68358,108578,176936,40220,0,-14022,1312,0,0,,15334,-12710
18,04/30/2017,47,11:30,11:45,,-21.55,0,-21.55,-21.55,-1,-79436,127567,207003,48131,0,-38535,0,0,0,,38535,-38535
18,04/30/2017,48,11:45,12:00,,21.48,0,21.48,21.48,-1,-80773,147609,228382,66836,0,-28637,0,0,0,,28637,-28637
18,04/30/2017,49,12:00,12:15,,29.09,0,29.09,29.09,-1,-73246,101925,175171,28679,0,-9102,0,0,0,,9102,-9102
18,04/30/2017,50,12:15,12:30,,26.17,0,26.17,26.17,-1,-69322,88662,157984,19340,0,-4534,0,0,0,,4534,-4534
18,04/30/2017,51,12:30,12:45,,26.17,0,26.17,26.17,-1,-67357,93069,160426,25712,0,-4839,0,0,0,,4839,-4839
18,04/30/2017,52,12:45,13:00,,27.21,0,27.21,27.21,-1,-75705,113325,189030,37620,0,-263,0,0,0,,263,-263
18,04/30/2017,53,13:00,13:15,,,0,28.03,28.03,0,-71847,73750,145597,1903,0,0,0,0,0,,0,0
18,04/30/2017,54,13:15,13:30,,,0,28.01,28.01,0,-74825,79664,154489,4839,0,0,0,0,0,,0,0
18,04/30/2017,55,13:30,13:45,,26.36,0,26.36,26.36,-1,-75842,87185,163027,11343,0,-7937,0,0,0,,7937,-7937
18,04/30/2017,56,13:45,14:00,,18.17,0,18.17,18.17,-1,-69507,97188,166695,27681,0,-23530,0,0,0,,23530,-23530
18,04/30/2017,57,14:00,14:15,35.24,27.15,0,35.24,27.15,2,-84458,69010,153468,-15448,0,-11112,4504,0,0,,15616,-6608
18,04/30/2017,58,14:15,14:30,26.64,,0,26.64,26.64,1,-56354,85748,142102,29394,0,0,589,0,0,,589,589
18,04/30/2017,59,14:30,14:45,,,0,28.27,28.27,0,-51221,98259,149480,47038,0,0,0,0,0,,0,0
18,04/30/2017,60,14:45,15:00,,29.09,0,29.09,29.09,-1,-55616,101283,156899,45667,0,-245,0,0,0,,245,-245
18,04/30/2017,61,15:00,15:15,,23.55,0,23.55,23.55,-1,-70256,88248,158504,17992,0,-10059,0,0,0,,10059,-10059
18,04/30/2017,62,15:15,15:30,32.09,23.55,0,32.09,32.09,1,-79133,66922,146055,-12211,0,-1464,4709,0,0,,6173,3245
18,04/30/2017,63,15:30,15:45,30.17,,0,30.17,30.17,1,-70081,62073,132154,-8008,0,0,1401,0,0,,1401,1401
18,04/30/2017,64,15:45,16:00,34.22,,0,34.22,34.22,1,-78015,57938,135953,-20077,0,0,14493,0,0,,14493,14493
18,04/30/2017,65,16:00,16:15,34.38,,0,34.38,34.38,1,-70303,57512,127815,-12791,0,0,15858,0,0,,15858,15858
18,04/30/2017,66,16:15,16:30,40.17,,0,40.17,40.17,1,-78705,43731,122436,-34974,0,0,19758,0,0,,19758,19758
18,04/30/2017,67,16:30,16:45,40.17,,0,40.17,40.17,1,-85491,40774,126265,-44717,0,0,39841,0,0,,39841,39841
18,04/30/2017,68,16:45,17:00,88.48,,0,88.48,88.48,1,-102578,32283,134861,-70295,0,0,45250,0,0,,45250,45250
18,04/30/2017,69,17:00,17:15,88.48,-26.15,0,-26.15,-26.15,-1,-10693,158988,169681,148295,0,-18918,12690,0,0,,31608,-6228
18,04/30/2017,70,17:15,17:30,,-18.92,0,-18.92,-18.92,-1,-42356,80427,122783,38071,0,-18946,0,0,0,,18946,-18946
18,04/30/2017,71,17:30,17:45,,26.17,0,26.17,26.17,-1,-38361,94087,132448,55726,0,-4818,0,0,0,,4818,-4818
18,04/30/2017,72,17:45,18:00,,29.09,0,29.09,29.09,-1,-68745,69546,138291,801,0,-2519,0,0,0,,2519,-2519
18,04/30/2017,73,18:00,18:15,,,0,28.34,28.34,0,-27802,94566,122368,66764,0,0,0,0,0,,0,0
18,04/30/2017,74,18:15,18:30,,,0,28.31,28.31,0,-30097,90900,120997,60803,0,0,0,0,0,,0,0
18,04/30/2017,75,18:30,18:45,,27.17,0,27.17,27.17,-1,-35461,72114,107575,36653,0,-1682,0,0,0,,1682,-1682
18,04/30/2017,76,18:45,19:00,,29.48,0,29.48,29.48,-1,-49893,55148,105041,5255,0,-1668,0,0,0,,1668,-1668
18,04/30/2017,77,19:00,19:15,30.17,,0,30.17,30.17,1,-65800,57203,123003,-8597,0,0,364,0,0,,364,364
18,04/30/2017,78,19:15,19:30,34.17,,0,34.17,34.17,1,-56235,40025,96260,-16210,0,0,5871,0,0,,5871,5871
18,04/30/2017,79,19:30,19:45,40.17,,0,40.17,40.17,1,-70488,38886,109374,-31602,0,0,24913,0,0,,24913,24913
18,04/30/2017,80,19:45,20:00,34.17,,0,34.17,34.17,1,-54403,50000,104403,-4403,0,0,22366,0,0,,22366,22366
18,04/30/2017,81,20:00,20:15,259.84,,0,259.84,259.84,1,-150091,27159,177250,-122932,0,0,49542,0,0,,49542,49542
18,04/30/2017,82,20:15,20:30,52.12,,0,52.12,52.12,1,-70062,63434,133496,-6628,0,0,29967,0,0,,29967,29967
18,04/30/2017,83,20:30,20:45,52.12,23.17,0,23.17,23.17,-1,-55235,79029,134264,23794,0,-12620,80,0,0,,12700,-12540
18,04/30/2017,84,20:45,21:00,36.09,28,0,36.09,28,2,-69213,43015,112228,-26198,0,-5805,4593,0,0,,10398,-1212
18,04/30/2017,85,21:00,21:15,31.69,28.44,0,31.69,28.44,2,-35410,140649,176059,105239,0,-389,2726,0,0,,3115,2337
18,04/30/2017,86,21:15,21:30,263.27,,0,263.27,263.27,1,-60706,81181,141887,20475,0,0,24970,0,0,,24970,24970
18,04/30/2017,87,21:30,21:45,36.25,,0,36.25,36.25,1,-50281,104937,155218,54656,0,0,25763,0,0,,25763,25763
18,04/30/2017,88,21:45,22:00,36.25,27.88,0,27.88,27.88,-1,-41556,104773,146329,63217,0,-71,2572,0,0,,2643,2501
18,04/30/2017,89,22:00,22:15,,23.17,0,23.17,23.17,-1,-39379,102000,141379,62621,0,-2302,0,0,0,,2302,-2302
18,04/30/2017,90,22:15,22:30,,12.69,0,12.69,12.69,-1,-25439,90692,116131,65253,0,-15635,0,0,0,,15635,-15635
18,04/30/2017,91,22:30,22:45,,8.68,0,8.68,8.68,-1,-18959,74610,93569,55651,0,-19440,0,0,0,,19440,-19440
18,04/30/2017,92,22:45,23:00,,23.17,0,23.17,23.17,-1,-12826,98927,111753,86101,0,-5255,0,0,0,,5255,-5255
18,04/30/2017,93,23:00,23:15,40.67,23.17,0,40.67,23.17,2,-71366,44315,115681,-27051,0,-5566,5440,0,0,,11006,-126
18,04/30/2017,94,23:15,23:30,30.67,26.36,0,26.36,26.36,-1,-33838,41386,75224,7548,0,-999,3669,0,0,,4668,2670
18,04/30/2017,95,23:30,23:45,,26.17,0,26.17,26.17,-1,-21084,45081,66165,23997,0,-3650,0,0,0,,3650,-3650
18,04/30/2017,96,23:45,0:00,,27.78,0,27.78,27.78,-1,-69030,46744,115774,-22286,0,-1897,0,0,0,,1897,-1897
18,05-01-17,1,0:00,0:15,,29.09,0,29.09,29.09,-1,-44694,144087,188781,99393,0,-614,0,0,0,,614,-614
18,05-01-17,2,0:15,0:30,54.99,,0,54.99,54.99,1,-55174,77160,132334,21986,0,0,14659,0,0,,14659,14659
18,05-01-17,3,0:30,0:45,34.17,,0,34.17,34.17,1,-28023,56083,84106,28060,0,0,25545,0,0,,25545,25545
18,05-01-17,4,0:45,1:00,28.17,27.17,0,27.17,27.17,-1,-19823,66580,86403,46757,0,-82,8631,0,0,,8713,8549
18,05-01-17,5,1:00,1:15,47.29,27.17,0,47.29,47.29,1,-65048,95940,160988,30892,0,-127,5434,0,0,,5561,5307
18,05-01-17,6,1:15,1:30,47.29,,0,47.29,47.29,1,-57743,104147,161890,46404,0,0,12966,0,0,,12966,12966
18,05-01-17,7,1:30,1:45,,,0,28.83,28.83,0,-52262,123631,175893,71369,0,0,1799,0,0,,1799,1799
18,05-01-17,8,1:45,2:00,,18.17,0,18.17,18.17,-1,-42856,139786,182642,96930,0,-10855,0,0,0,,10855,-10855
18,05-01-17,9,2:00,2:15,144.27,18.17,0,144.27,144.27,1,-115039,74338,189377,-40701,0,-2441,34396,0,0,,36837,31955
18,05-01-17,10,2:15,2:30,40.61,,0,40.61,40.61,1,-55929,50042,105971,-5887,0,0,37579,0,0,,37579,37579
18,05-01-17,11,2:30,2:45,32.24,,0,32.24,32.24,1,-60520,63432,123952,2912,0,0,22752,0,0,,22752,22752
18,05-01-17,12,2:45,3:00,29.19,23.17,0,23.17,23.17,-1,-52836,78332,131168,25496,0,-954,10164,0,0,,11118,9210
18,05-01-17,13,3:00,3:15,29.19,6.99,0,6.99,6.99,-1,-43031,109832,152863,66801,0,-19448,15,0,0,,19463,-19433
18,05-01-17,14,3:15,3:30,37.32,6.99,0,37.32,37.32,1,-33412,54404,87816,20992,0,-1802,8937,0,0,,10739,7135
18,05-01-17,15,3:30,3:45,39.22,,0,39.22,39.22,1,-35050,42039,77089,6989,0,0,32931,0,0,,32931,32931
18,05-01-17,16,3:45,4:00,34.17,,0,34.17,34.17,1,-36460,72775,109235,36315,0,0,27137,0,0,,27137,27137
18,05-01-17,17,4:00,4:15,34.17,29.09,0,34.17,28.14,2,-56566,76335,132901,19769,0,-129,7486,0,0,,7615,7357
18,05-01-17,18,4:15,4:30,40.17,,0,40.17,40.17,1,-59452,63925,123377,4473,0,0,32479,0,0,,32479,32479
18,05-01-17,19,4:30,4:45,222.27,,0,222.27,222.27,1,-76330,49192,125522,-27138,0,0,61801,0,0,,61801,61801
18,05-01-17,20,4:45,5:00,75.02,6.71,0,6.71,6.71,-1,-72489,138537,211026,66048,0,-1082,35520,0,0,,36602,34438
18,05-01-17,21,5:00,5:15,40.17,-64.03,0,40.17,-64.03,2,-58016,87287,145303,29271,0,-14358,1326,0,0,,15684,-13032
18,05-01-17,22,5:15,5:30,136.68,,0,136.68,136.68,1,-70195,64651,134846,-5544,0,0,26165,0,0,,26165,26165
18,05-01-17,23,5:30,5:45,34.02,23.17,0,23.17,23.17,-1,-101888,138743,240631,36855,0,-1361,14877,0,0,,16238,13516
18,05-01-17,24,5:45,6:00,28.17,23.17,0,28.83,23.17,2,-97042,136007,233049,38965,0,-6596,143,0,0,,6739,-6453
18,05-01-17,25,6:00,6:15,32.69,26.3,0,32.69,26.3,2,-87935,82430,170365,-5505,0,-2200,2017,0,0,,4217,-183
18,05-01-17,26,6:15,6:30,32.69,22.9,0,22.9,22.9,-1,-75343,83202,158545,7859,0,-5689,425,0,0,,6114,-5264
18,05-01-17,27,6:30,6:45,30.17,26.9,0,30.17,26.9,2,-99787,107855,207642,8068,0,-2089,846,0,0,,2935,-1243
18,05-01-17,28,6:45,7:00,26.86,26.9,0,28.14,26.9,2,-115871,128694,244565,12823,0,-1370,32,0,0,,1402,-1338
18,05-01-17,29,7:00,7:15,231.82,26.9,0,231.82,231.82,1,-181833,97475,279308,-84358,0,-300,46262,0,0,,46562,45962
18,05-01-17,30,7:15,7:30,142.18,-8.75,0,-8.75,-8.75,-1,-108385,130651,239036,22266,0,-2454,34617,0,0,,37071,32163
18,05-01-17,31,7:30,7:45,93.02,-8.75,0,93.02,-8.75,2,-122954,92064,215018,-30890,0,-10702,5836,0,0,,16538,-4866
18,05-01-17,32,7:45,8:00,129.02,-8.75,0,129.02,129.02,1,-181482,145346,326828,-36136,0,-11,47318,0,0,,47329,47307
18,05-01-17,33,8:00,8:15,129.02,-3.63,0,-3.63,-3.63,-1,-23024,158799,181823,135775,0,-17772,2225,0,0,,19997,-15547
18,05-01-17,34,8:15,8:30,,27.65,0,27.65,27.65,-1,-43565,106312,149877,62747,0,-5967,0,0,0,,5967,-5967
18,05-01-17,35,8:30,8:45,28.17,31.69,0,28.17,28.17,1,-75571,88108,163679,12537,0,-405,24,0,0,,429,-381
18,05-01-17,36,8:45,9:00,40.17,,0,40.17,40.17,1,-109810,91227,201037,-18583,0,0,16327,0,0,,16327,16327
18,05-01-17,37,9:00,9:15,34.17,29.42,0,34.17,29.42,2,-62712,81663,144375,18951,0,-14,19772,0,0,,19786,19758
18,05-01-17,38,9:15,9:30,42,28.62,0,42,28.62,2,-59357,59305,118662,-52,0,-568,7274,0,0,,7842,6706
18,05-01-17,39,9:30,9:45,42,,0,42,42,1,-69506,64108,133614,-5398,0,0,18775,0,0,,18775,18775
18,05-01-17,40,9:45,10:00,34.09,,0,34.09,34.09,1,-76435,68669,145104,-7766,0,0,15565,0,0,,15565,15565
18,05-01-17,41,10:00,10:15,33.79,,0,33.79,33.79,1,-63585,58867,122452,-4718,0,0,19542,0,0,,19542,19542
18,05-01-17,42,10:15,10:30,31.63,,0,31.63,31.63,1,-56677,59853,116530,3176,0,0,15979,0,0,,15979,15979
18,05-01-17,43,10:30,10:45,32.8,,0,32.8,32.8,1,-57255,58781,116036,1526,0,0,8652,0,0,,8652,8652
18,05-01-17,44,10:45,11:00,30.17,,0,30.17,30.17,1,-56940,66486,123426,9546,0,0,5462,0,0,,5462,5462
18,05-01-17,45,11:00,11:15,33.79,,0,33.79,33.79,1,-60388,52561,112949,-7827,0,0,12489,0,0,,12489,12489
18,05-01-17,46,11:15,11:30,30.72,,0,30.72,30.72,1,-39040,51241,90281,12201,0,0,9213,0,0,,9213,9213
18,05-01-17,47,11:30,11:45,28.17,,0,28.17,28.17,1,-47150,51249,98399,4099,0,0,157,0,0,,157,157
18,05-01-17,48,11:45,12:00,43.29,,0,43.29,43.29,1,-58534,36771,95305,-21763,0,0,15236,0,0,,15236,15236
18,05-01-17,49,12:00,12:15,32.8,,0,32.8,32.8,1,-58077,60036,118113,1959,0,0,17461,0,0,,17461,17461
18,05-01-17,50,12:15,12:30,32.79,,0,32.79,32.79,1,-65642,54629,120271,-11013,0,0,11066,0,0,,11066,11066
18,05-01-17,51,12:30,12:45,30.17,,0,30.17,30.17,1,-64418,55311,119729,-9107,0,0,12145,0,0,,12145,12145
18,05-01-17,52,12:45,13:00,31.63,,0,31.63,31.63,1,-63515,45658,109173,-17857,0,0,10241,0,0,,10241,10241
18,05-01-17,53,13:00,13:15,,,0,29.99,29.99,0,-45019,92259,137278,47240,0,0,2525,0,0,,2525,2525
18,05-01-17,54,13:15,13:30,,31.39,0,31.39,31.39,-1,-58042,80840,138882,22798,0,-154,0,0,0,,154,-154
18,05-01-17,55,13:30,13:45,,29.42,0,29.42,29.42,-1,-60869,71164,132033,10295,0,-995,0,0,0,,995,-995
18,05-01-17,56,13:45,14:00,,,0,29.94,29.94,0,-56259,59649,115908,3390,0,-46,0,0,0,,46,-46
18,05-01-17,57,14:00,14:15,34.17,,0,34.17,34.17,1,-83307,68004,151311,-15303,0,0,6227,0,0,,6227,6227
18,05-01-17,58,14:15,14:30,33.49,,0,33.49,33.49,1,-77374,64168,141542,-13206,0,0,5749,0,0,,5749,5749
18,05-01-17,59,14:30,14:45,34.17,,0,34.17,34.17,1,-77735,69598,147333,-8137,0,0,14572,0,0,,14572,14572
18,05-01-17,60,14:45,15:00,,,0,29.99,29.99,0,-68781,70244,139025,1463,0,0,553,0,0,,553,553
18,05-01-17,61,15:00,15:15,29.68,22.9,0,31.59,22.9,2,-79111,78493,157604,-618,0,-4034,1,0,0,,4035,-4033
18,05-01-17,62,15:15,15:30,46.36,,0,46.36,46.36,1,-92843,74540,167383,-18303,0,0,11475,0,0,,11475,11475
18,05-01-17,63,15:30,15:45,46.36,,0,46.36,46.36,1,-100554,87037,187591,-13517,0,0,21224,0,0,,21224,21224
18,05-01-17,64,15:45,16:00,33.59,,0,33.59,33.59,1,-100123,85714,185837,-14409,0,0,18861,0,0,,18861,18861
18,05-01-17,65,16:00,16:15,33.59,27.25,0,27.25,27.25,-1,-58000,104842,162842,46842,0,-3176,4929,0,0,,8105,1753
18,05-01-17,66,16:15,16:30,,32.89,0,32.89,32.89,-1,-48539,101496,150035,52957,0,-632,0,0,0,,632,-632
18,05-01-17,67,16:30,16:45,,,0,31.24,31.24,0,-69570,104710,174280,35140,0,0,0,0,0,,0,0
18,05-01-17,68,16:45,17:00,,,0,31.19,31.19,0,-90627,104566,195193,13939,0,0,0,0,0,,0,0
18,05-01-17,69,17:00,17:15,,,0,31.14,31.14,0,-73023,118876,191899,45853,0,0,0,0,0,,0,0
18,05-01-17,70,17:15,17:30,,,0,31.19,31.19,0,-77356,108400,185756,31044,0,0,0,0,0,,0,0
18,05-01-17,71,17:30,17:45,,,0,31.24,31.24,0,-85550,107666,193216,22116,0,0,0,0,0,,0,0
18,05-01-17,72,17:45,18:00,,,0,31.24,31.24,0,-75383,98337,173720,22954,0,0,0,0,0,,0,0
18,05-01-17,73,18:00,18:15,,,0,29.78,29.78,0,-94629,99291,193920,4662,0,0,0,0,0,,0,0
18,05-01-17,74,18:15,18:30,,,0,29.74,29.74,0,-65332,98823,164155,33491,0,0,0,0,0,,0,0
18,05-01-17,75,18:30,18:45,,,0,29.79,29.79,0,-49834,100680,150514,50846,0,0,0,0,0,,0,0
18,05-01-17,76,18:45,19:00,,,0,29.94,29.94,0,-48498,90019,138517,41521,0,0,0,0,0,,0,0
18,05-01-17,77,19:00,19:15,,,0,29.55,29.55,0,-90540,86217,176757,-4323,0,0,0,0,0,,0,0
18,05-01-17,78,19:15,19:30,30.17,,0,30.17,30.17,1,-75806,88839,164645,13033,0,0,200,0,0,,200,200
18,05-01-17,79,19:30,19:45,29.7,,0,29.7,29.7,1,-72404,95177,167581,22773,0,0,250,0,0,,250,250
18,05-01-17,80,19:45,20:00,32.01,,0,32.01,32.01,1,-64541,76971,141512,12430,0,0,1409,0,0,,1409,1409
18,05-01-17,81,20:00,20:15,33.38,,0,33.38,33.38,1,-105059,99742,204801,-5317,0,0,8119,0,0,,8119,8119
18,05-01-17,82,20:15,20:30,33.38,28.37,0,28.37,28.37,-1,-77175,117732,194907,40557,0,-397,519,0,0,,916,122
18,05-01-17,83,20:30,20:45,,27.9,0,27.9,27.9,-1,-66231,113808,180039,47577,0,-1120,0,0,0,,1120,-1120
18,05-01-17,84,20:45,21:00,,29.39,0,29.39,29.39,-1,-60593,115161,175754,54568,0,-1302,0,0,0,,1302,-1302
18,05-01-17,85,21:00,21:15,,31.79,0,31.79,31.79,-1,-57216,134286,191502,77070,0,-859,0,0,0,,859,-859
18,05-01-17,86,21:15,21:30,,29.02,0,29.02,29.02,-1,-72413,132537,204950,60124,0,-280,0,0,0,,280,-280
18,05-01-17,87,21:30,21:45,,27.9,0,27.9,27.9,-1,-83929,130311,214240,46382,0,-532,0,0,0,,532,-532
18,05-01-17,88,21:45,22:00,,27.25,0,27.25,27.25,-1,-68698,128655,197353,59957,0,-3793,0,0,0,,3793,-3793
18,05-01-17,89,22:00,22:15,32.4,29.03,0,32.4,29.03,2,-131321,124203,255524,-7118,0,-2044,575,0,0,,2619,-1469
18,05-01-17,90,22:15,22:30,105.82,,0,105.82,105.82,1,-149645,119572,269217,-30073,0,0,11081,0,0,,11081,11081
18,05-01-17,91,22:30,22:45,105.82,26.99,0,26.99,26.99,-1,-93227,145642,238869,52415,0,-4923,955,0,0,,5878,-3968
18,05-01-17,92,22:45,23:00,,27.9,0,27.9,27.9,-1,-92493,143089,235582,50596,0,-7834,0,0,0,,7834,-7834
18,05-01-17,93,23:00,23:15,,26.9,0,26.9,26.9,-1,-131112,166118,297230,35006,0,-10314,0,0,0,,10314,-10314
18,05-01-17,94,23:15,23:30,,15.59,0,15.59,15.59,-1,-124826,150321,275147,25495,0,-18779,0,0,0,,18779,-18779
18,05-01-17,95,23:30,23:45,,16.72,0,16.72,16.72,-1,-128140,151719,279859,23579,0,-28528,0,0,0,,28528,-28528
18,05-01-17,96,23:45,0:00,,29.01,0,29.01,29.01,-1,-120097,115728,235825,-4369,0,-6259,0,0,0,,6259,-6259
18,05-02-17,1,0:00,0:15,127.34,29.01,0,127.34,127.34,1,-80581,30012,110593,-50569,0,-192,22279,0,0,,22471,22087
18,05-02-17,2,0:15,0:30,127.34,,0,127.34,127.34,1,-120296,13875,134171,-106421,0,0,101989,0,0,,101989,101989
18,05-02-17,3,0:30,0:45,79.02,,0,79.02,79.02,1,-74198,29386,103584,-44812,0,0,75591,0,0,,75591,75591
18,05-02-17,4,0:45,1:00,33.52,,0,33.52,33.52,1,-73152,62260,135412,-10892,0,0,24474,0,0,,24474,24474
18,05-02-17,5,1:00,1:15,130.12,,0,130.12,130.12,1,-137291,54213,191504,-83078,0,0,41502,0,0,,41502,41502
18,05-02-17,6,1:15,1:30,130.12,,0,130.12,130.12,1,-102480,40107,142587,-62373,0,0,95947,0,0,,95947,95947
18,05-02-17,7,1:30,1:45,47.5,,0,47.5,47.5,1,-92457,59408,151865,-33049,0,0,60767,0,0,,60767,60767
18,05-02-17,8,1:45,2:00,52.39,,0,52.39,52.39,1,-90143,65748,155891,-24395,0,0,59674,0,0,,59674,59674
18,05-02-17,9,2:00,2:15,77.32,,0,77.32,77.32,1,-118859,44604,163463,-74255,0,0,44016,0,0,,44016,44016
18,05-02-17,10,2:15,2:30,130.12,,0,130.12,130.12,1,-116346,43944,160290,-72402,0,0,68841,0,0,,68841,68841
18,05-02-17,11,2:30,2:45,62.41,,0,62.41,62.41,1,-108391,32136,140527,-76255,0,0,51405,0,0,,51405,51405
18,05-02-17,12,2:45,3:00,131.12,,0,131.12,131.12,1,-138305,26268,164573,-112037,0,0,85868,0,0,,85868,85868
18,05-02-17,13,3:00,3:15,80.17,,0,80.17,80.17,1,-95676,39133,134809,-56543,0,0,80644,0,0,,80644,80644
18,05-02-17,14,3:15,3:30,51.26,,0,51.26,51.26,1,-104624,39091,143715,-65533,0,0,59414,0,0,,59414,59414
18,05-02-17,15,3:30,3:45,60.12,,0,60.12,60.12,1,-102254,48714,150968,-53540,0,0,61735,0,0,,61735,61735
18,05-02-17,16,3:45,4:00,53.66,,0,53.66,53.66,1,-110331,44787,155118,-65544,0,0,59389,0,0,,59389,59389
18,05-02-17,17,4:00,4:15,39.52,,0,39.52,39.52,1,-106462,48334,154796,-58128,0,0,56401,0,0,,56401,56401
18,05-02-17,18,4:15,4:30,39.52,,0,39.52,39.52,1,-92525,54323,146848,-38202,0,0,46515,0,0,,46515,46515
18,05-02-17,19,4:30,4:45,30.94,,0,30.94,30.94,1,-85465,57566,143031,-27899,0,0,26266,0,0,,26266,26266
18,05-02-17,20,4:45,5:00,29.94,26.52,0,29.94,26.52,2,-75321,67950,143271,-7371,0,-2061,10568,0,0,,12629,8507
18,05-02-17,21,5:00,5:15,29.94,-0.18,0,-0.18,-0.18,-1,-46448,110110,156558,63662,0,-32190,5,0,0,,32195,-32185
18,05-02-17,22,5:15,5:30,,23.64,0,23.64,23.64,-1,-53835,74953,128788,21118,0,-26863,0,0,0,,26863,-26863
18,05-02-17,23,5:30,5:45,31.79,26.52,0,31.79,31.79,1,-70988,69774,140762,-1214,0,-16285,676,0,0,,16961,-15609
18,05-02-17,24,5:45,6:00,40.94,26.52,0,40.94,40.94,1,-79636,63776,143412,-15860,0,-720,20066,0,0,,20786,19346
18,05-02-17,25,6:00,6:15,40.94,22.52,0,22.52,22.52,-1,-62681,131281,193962,68600,0,-4155,3658,0,0,,7813,-497
18,05-02-17,26,6:15,6:30,,22.52,0,22.52,22.52,-1,-63434,81024,144458,17590,0,-6790,0,0,0,,6790,-6790
18,05-02-17,27,6:30,6:45,,,0,29.14,29.14,0,-78116,86690,164806,8574,0,-536,0,0,0,,536,-536
18,05-02-17,28,6:45,7:00,30.17,,0,30.17,30.17,1,-92865,103346,196211,10481,0,0,834,0,0,,834,834
18,05-02-17,29,7:00,7:15,136.83,,0,136.83,136.83,1,-154374,44586,198960,-109788,0,0,37261,0,0,,37261,37261
18,05-02-17,30,7:15,7:30,44.97,,0,44.97,44.97,1,-26655,40955,67610,14300,0,0,26392,0,0,,26392,26392
18,05-02-17,31,7:30,7:45,28.97,27.7,0,29.38,27.7,2,-64712,74081,138793,9369,0,-470,76,0,0,,546,-394
18,05-02-17,32,7:45,8:00,94.83,,0,94.83,94.83,1,-80596,35739,116335,-44857,0,0,25888,0,0,,25888,25888
18,05-02-17,33,8:00,8:15,34.98,,0,34.98,34.98,1,-38635,53708,92343,15073,0,0,12798,0,0,,12798,12798
18,05-02-17,34,8:15,8:30,29.68,,0,29.68,29.68,1,-48839,39147,87986,-9692,0,0,51,0,0,,51,51
18,05-02-17,35,8:30,8:45,35.44,,0,35.44,35.44,1,-74867,54350,129217,-20517,0,0,9441,0,0,,9441,9441
18,05-02-17,36,8:45,9:00,45.98,,0,45.98,45.98,1,-95394,56296,151690,-39098,0,0,23538,0,0,,23538,23538
18,05-02-17,37,9:00,9:15,363.43,,0,363.43,363.43,1,-125797,19308,145105,-106489,0,0,58585,0,0,,58585,58585
18,05-02-17,38,9:15,9:30,154.48,,0,154.48,154.48,1,-88321,19894,108215,-68427,0,0,68294,0,0,,68294,68294
18,05-02-17,39,9:30,9:45,67.7,,0,67.7,67.7,1,-89090,27120,116210,-61970,0,0,55848,0,0,,55848,55848
18,05-02-17,40,9:45,10:00,363.43,,0,363.43,363.43,1,-109668,23157,132825,-86511,0,0,58861,0,0,,58861,58861
18,05-02-17,41,10:00,10:15,335.51,,0,335.51,335.51,1,-144199,55949,200148,-88250,0,0,79546,0,0,,79546,79546
18,05-02-17,42,10:15,10:30,182.1,,0,182.1,182.1,1,-122981,60082,183063,-62899,0,0,67721,0,0,,67721,67721
18,05-02-17,43,10:30,10:45,335.51,,0,335.51,335.51,1,-122125,37843,159968,-84282,0,0,62745,0,0,,62745,62745
18,05-02-17,44,10:45,11:00,335.51,,0,335.51,335.51,1,-130948,44570,175518,-86378,0,0,75550,0,0,,75550,75550
18,05-02-17,45,11:00,11:15,301.23,,0,301.23,301.23,1,-138625,38126,176751,-100499,0,0,76334,0,0,,76334,76334
18,05-02-17,46,11:15,11:30,301.23,,0,301.23,301.23,1,-124731,23424,148155,-101307,0,0,77035,0,0,,77035,77035
18,05-02-17,47,11:30,11:45,301.23,,0,301.23,301.23,1,-132475,22777,155252,-109698,0,0,84520,0,0,,84520,84520
18,05-02-17,48,11:45,12:00,301.23,,0,331.35,331.35,1,-123508,23873,147381,-99635,0,0,84959,0,164,,85123,85123
18,05-02-17,49,12:00,12:15,256.66,,0,282.33,282.33,1,-178480,40896,219376,-137584,0,0,84183,2500,43521,,130204,130204
18,05-02-17,50,12:15,12:30,114.38,17.22,0,17.22,17.22,-1,-91085,33567,124652,-57518,0,-2653,31495,15000,67794,,116942,111636
18,05-02-17,51,12:30,12:45,256.66,19.25,0,256.66,256.66,1,-80752,29967,110719,-50785,0,-3219,14723,0,3234,,21176,14738
18,05-02-17,52,12:45,13:00,256.66,,0,256.66,256.66,1,-71811,53354,125165,-18457,0,0,44997,0,0,,44997,44997
18,05-02-17,53,13:00,13:15,73.29,,0,73.29,73.29,1,-52095,40289,92384,-11806,0,0,7096,0,0,,7096,7096
18,05-02-17,54,13:15,13:30,131.12,,0,131.12,131.12,1,-66755,41156,107911,-25599,0,0,34209,0,0,,34209,34209
18,05-02-17,55,13:30,13:45,30.51,,0,30.51,30.51,1,-57715,59662,117377,1947,0,0,8762,0,0,,8762,8762
18,05-02-17,56,13:45,14:00,34.34,,0,34.34,34.34,1,-75739,62265,138004,-13474,0,0,6948,0,0,,6948,6948
18,05-02-17,57,14:00,14:15,30.25,,0,30.25,30.25,1,-56182,52417,108599,-3765,0,0,1764,0,0,,1764,1764
18,05-02-17,58,14:15,14:30,30.25,26.52,0,26.52,26.52,-1,-38167,56823,94990,18656,0,-5272,162,0,0,,5434,-5110
18,05-02-17,59,14:30,14:45,,23.6,0,23.6,23.6,-1,-27803,62864,90667,35061,0,-24799,0,0,0,,24799,-24799
18,05-02-17,60,14:45,15:00,,24.51,0,24.51,24.51,-1,-29784,69079,98863,39295,0,-34920,0,0,0,,34920,-34920
18,05-02-17,61,15:00,15:15,,22.52,0,22.52,22.52,-1,-29111,72046,101157,42935,0,-35132,0,0,0,,35132,-35132
18,05-02-17,62,15:15,15:30,,21.43,0,21.43,21.43,-1,-26850,74949,101799,48099,0,-47963,0,0,0,,47963,-47963
18,05-02-17,63,15:30,15:45,,26.52,0,26.52,26.52,-1,-45389,68160,113549,22771,0,-28630,0,0,0,,28630,-28630
18,05-02-17,64,15:45,16:00,,28.09,0,28.09,28.09,-1,-60855,68338,129193,7483,0,-9843,0,0,0,,9843,-9843
18,05-02-17,65,16:00,16:15,,-0.16,0,-0.16,-0.16,-1,-17877,99462,117339,81585,0,-22831,0,0,0,,22831,-22831
18,05-02-17,66,16:15,16:30,,-0.78,0,-0.78,-0.78,-1,-24687,53251,77938,28564,0,-43799,0,0,0,,43799,-43799
18,05-02-17,67,16:30,16:45,,2.93,0,2.93,2.93,-1,-20278,91432,111710,71154,0,-41582,0,0,0,,41582,-41582
18,05-02-17,68,16:45,17:00,,-4.57,0,-4.57,-4.57,-1,-21697,80583,102280,58886,0,-73444,0,0,0,,73444,-73444
18,05-02-17,69,17:00,17:15,182.2,-4.57,0,182.2,182.2,1,-94855,59707,154562,-35148,0,-21790,7411,0,0,,29201,-14379
18,05-02-17,70,17:15,17:30,161.24,,0,161.24,161.24,1,-88711,60703,149414,-28008,0,0,28964,0,0,,28964,28964
18,05-02-17,71,17:30,17:45,34.17,,0,34.17,34.17,1,-78649,58675,137324,-19974,0,0,7036,0,0,,7036,7036
18,05-02-17,72,17:45,18:00,41,,0,41,41,1,-70152,60636,130788,-9516,0,0,21569,0,0,,21569,21569
18,05-02-17,73,18:00,18:15,32.87,,0,32.87,32.87,1,-71610,37088,108698,-34522,0,0,15104,0,0,,15104,15104
18,05-02-17,74,18:15,18:30,,,0,28.98,28.98,0,-57630,43373,101003,-14257,0,0,1238,0,0,,1238,1238
18,05-02-17,75,18:30,18:45,,29.78,0,29.78,29.78,-1,-48403,61852,110255,13449,0,-242,0,0,0,,242,-242
18,05-02-17,76,18:45,19:00,,28.24,0,28.24,28.24,-1,-49953,77779,127732,27826,0,-1921,0,0,0,,1921,-1921
18,05-02-17,77,19:00,19:15,42.12,28.24,0,42.12,42.12,1,-84048,51834,135882,-32214,0,-109,10148,0,0,,10257,10039
18,05-02-17,78,19:15,19:30,34.34,,0,34.34,34.34,1,-83777,48817,132594,-34960,0,0,24659,0,0,,24659,24659
18,05-02-17,79,19:30,19:45,30.69,,0,30.69,30.69,1,-75265,45646,120911,-29619,0,0,17170,0,0,,17170,17170
18,05-02-17,80,19:45,20:00,183.17,,0,183.17,183.17,1,-101593,43679,145272,-57914,0,0,37527,0,0,,37527,37527
18,05-02-17,81,20:00,20:15,212.87,,0,212.87,212.87,1,-95373,61283,156656,-34090,0,0,47597,0,0,,47597,47597
18,05-02-17,82,20:15,20:30,212.87,29.61,0,29.61,29.61,-1,-47268,61338,108606,14070,0,-1359,1315,0,0,,2674,-44
18,05-02-17,83,20:30,20:45,,29.61,0,29.61,29.61,-1,-53390,46111,99501,-7279,0,-1523,0,0,0,,1523,-1523
18,05-02-17,84,20:45,21:00,,,0,29.11,29.11,0,-67930,41056,108986,-26874,0,0,0,0,0,,0,0
18,05-02-17,85,21:00,21:15,,,0,29.07,29.07,0,-54806,78403,133209,23597,0,0,0,0,0,,0,0
18,05-02-17,86,21:15,21:30,34.17,,0,34.17,34.17,1,-91237,51830,143067,-39407,0,0,7001,0,0,,7001,7001
18,05-02-17,87,21:30,21:45,30.65,,0,30.65,30.65,1,-75812,55474,131286,-20338,0,0,4395,0,0,,4395,4395
18,05-02-17,88,21:45,22:00,30.65,22.52,0,22.52,22.52,-1,-58861,56290,115151,-2571,0,-4651,13,0,0,,4664,-4638
18,05-02-17,89,22:00,22:15,36.88,17.52,0,36.88,17.52,2,-80633,65207,145840,-15426,0,-9748,3032,0,0,,12780,-6716
18,05-02-17,90,22:15,22:30,37.12,,0,37.12,37.12,1,-61392,60996,122388,-396,0,0,6280,0,0,,6280,6280
18,05-02-17,91,22:30,22:45,,-6.26,0,-6.26,-6.26,-1,-29135,89730,118865,60595,0,-25992,0,0,0,,25992,-25992
18,05-02-17,92,22:45,23:00,,-8.11,0,-8.11,-8.11,-1,-33965,107718,141683,73753,0,-94569,0,0,0,,94569,-94569
18,05-02-17,93,23:00,23:15,83.65,-11.78,0,83.65,83.65,1,-89893,43775,133668,-46118,0,-56408,2163,0,0,,58571,-54245
18,05-02-17,94,23:15,23:30,196.79,26.52,0,196.79,26.52,2,-71206,44026,115232,-27180,0,-222,22720,0,0,,22942,22498
18,05-02-17,95,23:30,23:45,196.79,0.85,0,0.85,0.85,-1,-30715,84415,115130,53700,0,-40803,493,0,0,,41296,-40310
18,05-02-17,96,23:45,0:00,,19.25,0,19.25,19.25,-1,-30411,76760,107171,46349,0,-55606,0,0,0,,55606,-55606
18,05-03-17,1,0:00,0:15,63.16,24.17,0,63.16,63.16,1,-74746,59788,134534,-14958,0,-19486,3616,0,0,,23102,-15870
18,05-03-17,2,0:15,0:30,68.07,27.12,0,68.07,27.12,2,-52877,41004,93881,-11873,0,-132,17924,0,0,,18056,17792
18,05-03-17,3,0:30,0:45,68.07,20.95,0,20.95,20.95,-1,-38563,35103,73666,-3460,0,-10772,411,0,0,,11183,-10361
18,05-03-17,4,0:45,1:00,27.52,27.79,0,27.76,27.76,2,-50389,31766,82155,-18623,0,-3109,36,0,0,,3145,-3073
18,05-03-17,5,1:00,1:15,68.95,27.79,0,68.95,68.95,1,-65708,13445,79153,-52263,0,-236,20075,0,0,,20311,19839
18,05-03-17,6,1:15,1:30,33.52,26.52,0,26.52,26.52,-1,-45998,30815,76813,-15183,0,-612,13110,0,0,,13722,12498
18,05-03-17,7,1:30,1:45,32.1,26.52,0,32.1,26.52,2,-45447,32766,78213,-12681,0,-1864,1734,0,0,,3598,-130
18,05-03-17,8,1:45,2:00,31.58,27.52,0,31.58,27.52,2,-44310,35754,80064,-8556,0,-904,3255,0,0,,4159,2351
18,05-03-17,9,2:00,2:15,39.52,27.52,0,39.52,39.52,1,-71807,40167,111974,-31640,0,-92,7411,0,0,,7503,7319
18,05-03-17,10,2:15,2:30,39.52,,0,39.52,39.52,1,-69878,37422,107300,-32456,0,0,24071,0,0,,24071,24071
18,05-03-17,11,2:30,2:45,29.52,27.52,0,27.52,27.52,-1,-67003,55729,122732,-11274,0,-135,8117,0,0,,8252,7982
18,05-03-17,12,2:45,3:00,29.52,22.52,0,22.52,22.52,-1,-42870,57236,100106,14366,0,-4003,63,0,0,,4066,-3940
18,05-03-17,13,3:00,3:15,,21.21,0,21.21,21.21,-1,-35667,58052,93719,22385,0,-21011,0,0,0,,21011,-21011
18,05-03-17,14,3:15,3:30,,25.42,0,25.42,25.42,-1,-28934,49889,78823,20955,0,-25279,0,0,0,,25279,-25279
18,05-03-17,15,3:30,3:45,,22.52,0,22.52,22.52,-1,-23422,52670,76092,29248,0,-31629,0,0,0,,31629,-31629
18,05-03-17,16,3:45,4:00,,21.21,0,21.21,21.21,-1,-22311,46563,68874,24252,0,-32598,0,0,0,,32598,-32598
18,05-03-17,17,4:00,4:15,,22.52,0,22.52,22.52,-1,-22951,47802,70753,24851,0,-28897,0,0,0,,28897,-28897
18,05-03-17,18,4:15,4:30,,18.24,0,18.24,18.24,-1,-19419,52130,71549,32711,0,-41893,0,0,0,,41893,-41893
18,05-03-17,19,4:30,4:45,,22.52,0,22.52,22.52,-1,-26315,48396,74711,22081,0,-37932,0,0,0,,37932,-37932
18,05-03-17,20,4:45,5:00,,27.01,0,27.01,27.01,-1,-35889,39948,75837,4059,0,-17186,0,0,0,,17186,-17186
18,05-03-17,21,5:00,5:15,,29.99,0,29.99,29.99,-1,-42383,28047,70430,-14336,0,-780,0,0,0,,780,-780
18,05-03-17,22,5:15,5:30,,29.08,0,29.08,29.08,-1,-32913,20913,53826,-12000,0,-1130,0,0,0,,1130,-1130
18,05-03-17,23,5:30,5:45,,26.52,0,26.52,26.52,-1,-31456,39936,71392,8480,0,-6651,0,0,0,,6651,-6651
18,05-03-17,24,5:45,6:00,,21.21,0,21.21,21.21,-1,-54863,74766,129629,19903,0,-5231,0,0,0,,5231,-5231
18,05-03-17,25,6:00,6:15,,22.89,0,22.89,22.89,-1,-59800,33281,93081,-26519,0,-4977,0,0,0,,4977,-4977
18,05-03-17,26,6:15,6:30,,10.38,0,10.38,10.38,-1,-22739,48621,71360,25882,0,-12276,0,0,0,,12276,-12276
18,05-03-17,27,6:30,6:45,42.55,0.35,0,42.55,0.35,2,-55160,40572,95732,-14588,0,-22830,856,0,0,,23686,-21974
18,05-03-17,28,6:45,7:00,48.23,22.5,0,48.23,22.5,2,-67406,51361,118767,-16045,0,-407,7322,0,0,,7729,6915
18,05-03-17,29,7:00,7:15,48.23,-38.05,0,-38.05,-38.05,-1,-7319,150853,158172,143534,0,-74351,252,0,0,,74603,-74099
18,05-03-17,30,7:15,7:30,,20.29,0,20.29,20.29,-1,-21339,65443,86782,44104,0,-45270,0,0,0,,45270,-45270
18,05-03-17,31,7:30,7:45,,17.89,0,17.89,17.89,-1,-44679,55902,100581,11223,0,-41149,0,0,0,,41149,-41149
18,05-03-17,32,7:45,8:00,40.29,29.71,0,40.29,29.71,2,-85067,63300,148367,-21767,0,-1897,4722,0,0,,6619,2825
18,05-03-17,33,8:00,8:15,40.29,27.89,0,27.89,27.89,-1,-23919,76479,100398,52560,0,-2584,254,0,0,,2838,-2330
18,05-03-17,34,8:15,8:30,,,0,37.12,37.12,0,-41554,69684,111238,28130,0,0,0,0,0,,0,0
18,05-03-17,35,8:30,8:45,31.98,,0,31.98,31.98,1,-58750,48286,107036,-10464,0,0,640,0,0,,640,640
18,05-03-17,36,8:45,9:00,51,,0,51,51,1,-81195,47989,129184,-33206,0,0,18210,0,0,,18210,18210
18,05-03-17,37,9:00,9:15,51,22.89,0,22.89,22.89,-1,-31620,62633,94253,31013,0,-4607,9777,0,0,,14384,5170
18,05-03-17,38,9:15,9:30,30.54,27.89,0,30.54,27.89,2,-47713,48133,95846,420,0,-3229,136,0,0,,3365,-3093
18,05-03-17,39,9:30,9:45,37.8,27.89,0,37.8,37.8,1,-59733,46505,106238,-13228,0,-99,10685,0,0,,10784,10586
18,05-03-17,40,9:45,10:00,42.59,,0,42.59,42.59,1,-73377,46309,119686,-27068,0,0,13278,0,0,,13278,13278
18,05-03-17,41,10:00,10:15,48.23,,0,48.23,48.23,1,-68612,46434,115046,-22178,0,0,23399,0,0,,23399,23399
18,05-03-17,42,10:15,10:30,47.9,,0,47.9,47.9,1,-62905,31139,94044,-31766,0,0,32583,0,0,,32583,32583
18,05-03-17,43,10:30,10:45,42.59,,0,42.59,42.59,1,-56670,31194,87864,-25476,0,0,29740,0,0,,29740,29740
18,05-03-17,44,10:45,11:00,39.02,,0,39.02,39.02,1,-54223,43444,97667,-10779,0,0,24831,0,0,,24831,24831
18,05-03-17,45,11:00,11:15,43.02,,0,43.02,43.02,1,-56059,31195,87254,-24864,0,0,21946,0,0,,21946,21946
18,05-03-17,46,11:15,11:30,37.2,,0,37.2,37.2,1,-53720,38438,92158,-15282,0,0,13387,0,0,,13387,13387
18,05-03-17,47,11:30,11:45,42.2,,0,42.2,42.2,1,-64835,42892,107727,-21943,0,0,20006,0,0,,20006,20006
18,05-03-17,48,11:45,12:00,32.24,,0,32.24,32.24,1,-54657,48737,103394,-5920,0,0,14726,0,0,,14726,14726
18,05-03-17,49,12:00,12:15,,,0,37.4,37.4,0,-64042,50057,114099,-13985,0,0,4738,0,0,,4738,4738
18,05-03-17,50,12:15,12:30,,0,0,0,0,-1,-40078,61862,101940,21784,0,-5000,0,0,0,,5000,-5000
18,05-03-17,51,12:30,12:45,,22.89,0,22.89,22.89,-1,-39633,50158,89791,10525,0,-16368,0,0,0,,16368,-16368
18,05-03-17,52,12:45,13:00,,28.03,0,28.03,28.03,-1,-47717,42468,90185,-5249,0,-9921,0,0,0,,9921,-9921
18,05-03-17,53,13:00,13:15,30.54,28.08,0,36.82,28.08,2,-46170,47215,93385,1045,0,-4688,1021,0,0,,5709,-3667
18,05-03-17,54,13:15,13:30,34.54,28.08,0,34.54,34.54,1,-62644,37358,100002,-25286,0,-48,7747,0,0,,7795,7699
18,05-03-17,55,13:30,13:45,40.29,,0,40.29,40.29,1,-52775,30207,82982,-22568,0,0,11676,0,0,,11676,11676
18,05-03-17,56,13:45,14:00,42.59,26.89,0,42.59,26.89,2,-32558,35277,67835,2719,0,-920,12076,0,0,,12996,11156
18,05-03-17,57,14:00,14:15,42.59,17.89,0,17.89,17.89,-1,-37083,70167,107250,33084,0,-27360,397,0,0,,27757,-26963
18,05-03-17,58,14:15,14:30,,22.89,0,22.89,22.89,-1,-44739,69734,114473,24995,0,-21816,0,0,0,,21816,-21816
18,05-03-17,59,14:30,14:45,,23.09,0,23.09,23.09,-1,-56445,82151,138596,25706,0,-32436,0,0,0,,32436,-32436
18,05-03-17,60,14:45,15:00,,21.21,0,21.21,21.21,-1,-43832,87060,130892,43228,0,-37693,0,0,0,,37693,-37693
18,05-03-17,61,15:00,15:15,,21.21,0,21.21,21.21,-1,-53960,55987,109947,2027,0,-30954,0,0,0,,30954,-30954
18,05-03-17,62,15:15,15:30,,29.99,0,29.99,29.99,-1,-59749,56582,116331,-3167,0,-1329,0,0,0,,1329,-1329
18,05-03-17,63,15:30,15:45,30.54,28.44,0,30.54,28.44,2,-70747,64601,135348,-6146,0,-1352,94,0,0,,1446,-1258
18,05-03-17,64,15:45,16:00,32.39,,0,32.39,32.39,1,-68443,63883,132326,-4560,0,0,5452,0,0,,5452,5452
18,05-03-17,65,16:00,16:15,32.39,24.43,0,24.43,24.43,-1,-60759,100004,160763,39245,0,-10568,908,0,0,,11476,-9660
18,05-03-17,66,16:15,16:30,,19.15,0,19.15,19.15,-1,-61649,107878,169527,46229,0,-31941,0,0,0,,31941,-31941
18,05-03-17,67,16:30,16:45,,24.03,0,24.03,24.03,-1,-49842,108167,158009,58325,0,-26214,0,0,0,,26214,-26214
18,05-03-17,68,16:45,17:00,,,0,29.23,29.23,0,-52239,112762,165001,60523,0,-598,0,0,0,,598,-598
18,05-03-17,69,17:00,17:15,30.54,,0,30.54,30.54,1,-75119,63810,138929,-11309,0,0,315,0,0,,315,315
18,05-03-17,70,17:15,17:30,,27.44,0,27.44,27.44,-1,-43855,55056,98911,11201,0,-7232,0,0,0,,7232,-7232
18,05-03-17,71,17:30,17:45,30.54,28.55,0,30.54,28.55,2,-40141,46282,86423,6141,0,-2911,62,0,0,,2973,-2849
18,05-03-17,72,17:45,18:00,40.29,28.55,0,40.29,40.29,1,-35131,29926,65057,-5205,0,-135,9915,0,0,,10050,9780
18,05-03-17,73,18:00,18:15,30.18,28.89,0,28.89,28.89,-1,-33107,40849,73956,7742,0,-269,4119,0,0,,4388,3850
18,05-03-17,74,18:15,18:30,,26.89,0,26.89,26.89,-1,-20562,66316,86878,45754,0,-7087,0,0,0,,7087,-7087
18,05-03-17,75,18:30,18:45,,27.89,0,27.89,27.89,-1,-23154,78159,101313,55005,0,-8117,0,0,0,,8117,-8117
18,05-03-17,76,18:45,19:00,,28.03,0,28.03,28.03,-1,-21065,86123,107188,65058,0,-5471,0,0,0,,5471,-5471
18,05-03-17,77,19:00,19:15,32.14,28.45,0,32.14,32.14,1,-48864,27309,76173,-21555,0,-2112,1926,0,0,,4038,-186
18,05-03-17,78,19:15,19:30,42.59,28.45,0,42.59,42.59,1,-49234,24231,73465,-25003,0,-19,15253,0,0,,15272,15234
18,05-03-17,79,19:30,19:45,31.55,26.89,0,26.89,26.89,-1,-32264,39340,71604,7076,0,-1118,14961,0,0,,16079,13843
18,05-03-17,80,19:45,20:00,31.55,26.89,0,26.89,26.89,-1,-24032,46135,70167,22103,0,-12303,402,0,0,,12705,-11901
18,05-03-17,81,20:00,20:15,32.16,27.03,0,32.16,27.03,2,-59387,48559,107946,-10828,0,-8489,1018,0,0,,9507,-7471
18,05-03-17,82,20:15,20:30,32.16,22.89,0,22.89,22.89,-1,-28912,62242,91154,33330,0,-10245,582,0,0,,10827,-9663
18,05-03-17,83,20:30,20:45,,23.09,0,23.09,23.09,-1,-27795,81490,109285,53695,0,-41510,0,0,0,,41510,-41510
18,05-03-17,84,20:45,21:00,,19.15,0,19.15,19.15,-1,-30134,94457,124591,64323,0,-58485,0,0,0,,58485,-58485
18,05-03-17,85,21:00,21:15,,18.76,0,18.76,18.76,-1,-28212,76472,104684,48260,0,-48981,0,0,0,,48981,-48981
18,05-03-17,86,21:15,21:30,30.54,28.03,0,30.54,28.03,2,-49660,43106,92766,-6554,0,-10530,622,0,0,,11152,-9908
18,05-03-17,87,21:30,21:45,,,0,29.22,29.22,0,-55481,45396,100877,-10085,0,0,0,0,0,,0,0
18,05-03-17,88,21:45,22:00,28.54,,0,28.54,28.54,1,-90889,45916,136805,-44973,0,0,776,0,0,,776,776
18,05-03-17,89,22:00,22:15,66.08,,0,66.08,66.08,1,-71599,55624,127223,-15975,0,0,4528,0,0,,4528,4528
18,05-03-17,90,22:15,22:30,131.02,-8.62,0,131.02,-8.62,2,-50870,43338,94208,-7532,0,-571,33931,0,0,,34502,33360
18,05-03-17,91,22:30,22:45,131.02,-21.17,0,-21.17,-21.17,-1,-24412,53024,77436,28612,0,-13998,547,0,0,,14545,-13451
18,05-03-17,92,22:45,23:00,,2.83,0,2.83,2.83,-1,-24520,80683,105203,56163,0,-35709,0,0,0,,35709,-35709
18,05-03-17,93,23:00,23:15,76.02,21.21,0,76.02,76.02,1,-60394,42870,103264,-17524,0,-18335,6231,0,0,,24566,-12104
18,05-03-17,94,23:15,23:30,34.54,,0,34.54,34.54,1,-47034,33783,80817,-13251,0,0,16405,0,0,,16405,16405
18,05-03-17,95,23:30,23:45,34.54,26.89,0,26.89,26.89,-1,-36546,47053,83599,10507,0,-4930,2406,0,0,,7336,-2524
18,05-03-17,96,23:45,0:00,,24.16,0,24.16,24.16,-1,-46930,66640,113570,19710,0,-23042,0,0,0,,23042,-23042
18,05-04-17,1,0:00,0:15,91.2,27.3,0,91.2,91.2,1,-72237,40721,112958,-31516,0,-8176,4766,0,0,,12942,-3410
18,05-04-17,2,0:15,0:30,182.3,27.3,0,182.3,182.3,1,-58762,14284,73046,-44478,0,-55,38155,0,0,,38210,38100
18,05-04-17,3,0:30,0:45,148.7,,0,148.7,148.7,1,-86216,24042,110258,-62174,0,0,36773,0,0,,36773,36773
18,05-04-17,4,0:45,1:00,48.04,30.21,0,30.21,30.21,-1,-62546,50433,112979,-12113,0,-4,23958,0,0,,23962,23954
18,05-04-17,5,1:00,1:15,128.12,21.21,0,128.12,21.21,2,-82336,55336,137672,-27000,0,-3596,4967,0,0,,8563,1371
18,05-04-17,6,1:15,1:30,123.47,,0,123.47,123.47,1,-73060,44334,117394,-28726,0,0,33628,0,0,,33628,33628
18,05-04-17,7,1:30,1:45,33.3,28.57,0,33.3,28.57,2,-61388,48311,109699,-13077,0,-200,3627,0,0,,3827,3427
18,05-04-17,8,1:45,2:00,39.3,,0,39.3,39.3,1,-60696,46616,107312,-14080,0,0,10457,0,0,,10457,10457
18,05-04-17,9,2:00,2:15,67.58,,0,67.58,67.58,1,-97616,43245,140861,-54371,0,0,20775,0,0,,20775,20775
18,05-04-17,10,2:15,2:30,66.64,,0,66.64,66.64,1,-87864,46409,134273,-41455,0,0,44093,0,0,,44093,44093
18,05-04-17,11,2:30,2:45,31.05,,0,31.05,31.05,1,-73397,52779,126176,-20618,0,0,19464,0,0,,19464,19464
18,05-04-17,12,2:45,3:00,31.05,22.3,0,22.3,22.3,-1,-63089,61237,124326,-1852,0,-5725,3124,0,0,,8849,-2601
18,05-04-17,13,3:00,3:15,42.59,22.3,0,42.59,42.59,1,-91094,56654,147748,-34440,0,-964,9469,0,0,,10433,8505
18,05-04-17,14,3:15,3:30,52.08,29.31,0,52.08,27.98,2,-85854,64468,150322,-21386,0,-26,30694,0,0,,30720,30668
18,05-04-17,15,3:30,3:45,33.9,27.91,0,33.9,27.91,2,-77997,60118,138115,-17879,0,-438,3032,0,0,,3470,2594
18,05-04-17,16,3:45,4:00,39.3,,0,39.3,39.3,1,-71966,51765,123731,-20201,0,0,21098,0,0,,21098,21098
18,05-04-17,17,4:00,4:15,33.3,28.15,0,33.3,28,2,-75860,56907,132767,-18953,0,-85,11634,0,0,,11719,11549
18,05-04-17,18,4:15,4:30,33.3,22.3,0,22.3,22.3,-1,-60478,58321,118799,-2157,0,-7441,1580,0,0,,9021,-5861
18,05-04-17,19,4:30,4:45,31.84,22.3,0,31.84,31.84,1,-62483,61665,124148,-818,0,-752,1672,0,0,,2424,920
18,05-04-17,20,4:45,5:00,30.12,,0,30.12,30.12,1,-69182,64893,134075,-4289,0,0,2572,0,0,,2572,2572
18,05-04-17,21,5:00,5:15,33.3,,0,33.3,33.3,1,-79240,55361,134601,-23879,0,0,5375,0,0,,5375,5375
18,05-04-17,22,5:15,5:30,29.3,,0,29.3,29.3,1,-57715,58357,116072,642,0,0,3640,0,0,,3640,3640
18,05-04-17,23,5:30,5:45,27.3,,0,27.3,27.3,1,-63175,74019,137194,10844,0,0,85,0,0,,85,85
18,05-04-17,24,5:45,6:00,34.82,,0,34.82,34.82,1,-58462,55023,113485,-3439,0,0,6782,0,0,,6782,6782
18,05-04-17,25,6:00,6:15,34.82,-13,0,-13,-13,-1,-37230,92658,129888,55428,0,-20231,102,0,0,,20333,-20129
18,05-04-17,26,6:15,6:30,,-12.78,0,-12.78,-12.78,-1,-53802,53764,107566,-38,0,-34447,0,0,0,,34447,-34447
18,05-04-17,27,6:30,6:45,,,0,27.83,27.83,0,-64870,53245,118115,-11625,0,-379,0,0,0,,379,-379
18,05-04-17,28,6:45,7:00,30.29,26.6,0,30.29,26.6,2,-70893,71852,142745,959,0,-876,1196,0,0,,2072,320
18,05-04-17,29,7:00,7:15,30.29,27.29,0,36.54,27.29,2,-87669,70535,158204,-17134,0,-2910,419,0,0,,3329,-2491
18,05-04-17,30,7:15,7:30,,,0,36.53,36.53,0,-36117,72240,108357,36123,0,0,104,0,0,,104,104
18,05-04-17,31,7:30,7:45,,,0,36.93,36.93,0,-59598,79070,138668,19472,0,0,0,0,0,,0,0
18,05-04-17,32,7:45,8:00,28.94,,0,28.94,28.94,1,-100468,91637,192105,-8831,0,0,212,0,0,,212,212
18,05-04-17,33,8:00,8:15,30.35,,0,30.35,30.35,1,-52102,66864,118966,14762,0,0,325,0,0,,325,325
18,05-04-17,34,8:15,8:30,32.23,,0,32.23,32.23,1,-54671,53919,108590,-752,0,0,326,0,0,,326,326
18,05-04-17,35,8:30,8:45,239.36,,0,239.36,239.36,1,-71359,36440,107799,-34919,0,0,21373,0,0,,21373,21373
18,05-04-17,36,8:45,9:00,305.64,,0,305.64,305.64,1,-77660,61964,139624,-15696,0,0,40480,0,0,,40480,40480
18,05-04-17,37,9:00,9:15,305.64,40.77,0,40.77,40.77,-1,-46201,92658,138859,46457,0,-1359,1658,0,0,,3017,299
18,05-04-17,38,9:15,9:30,,43.16,0,43.16,43.16,-1,-38881,91213,130094,52332,0,-2181,0,0,0,,2181,-2181
18,05-04-17,39,9:30,9:45,,40.77,0,40.77,40.77,-1,-34616,99450,134066,64834,0,-298,0,0,0,,298,-298
18,05-04-17,40,9:45,10:00,,40.77,0,40.77,40.77,-1,-38058,105241,143299,67183,0,-1993,0,0,0,,1993,-1993
18,05-04-17,41,10:00,10:15,,27.69,0,27.69,27.69,-1,-56310,107046,163356,50736,0,-854,0,0,0,,854,-854
18,05-04-17,42,10:15,10:30,,27.29,0,27.29,27.29,-1,-43930,96389,140319,52459,0,-2511,0,0,0,,2511,-2511
18,05-04-17,43,10:30,10:45,,22.55,0,22.55,22.55,-1,-32675,99798,132473,67123,0,-5162,0,0,0,,5162,-5162
18,05-04-17,44,10:45,11:00,,19.28,0,19.28,19.28,-1,-35884,108780,144664,72896,0,-38430,0,0,0,,38430,-38430
18,05-04-17,45,11:00,11:15,,15.36,0,15.36,15.36,-1,-56160,141609,197769,85449,0,-42892,0,0,0,,42892,-42892
18,05-04-17,46,11:15,11:30,,18.29,0,18.29,18.29,-1,-73477,134008,207485,60531,0,-28378,0,0,0,,28378,-28378
18,05-04-17,47,11:30,11:45,,23.29,0,23.29,23.29,-1,-62732,124686,187418,61954,0,-28170,0,0,0,,28170,-28170
18,05-04-17,48,11:45,12:00,,27.29,0,27.29,27.29,-1,-63760,109521,173281,45761,0,-13187,0,0,0,,13187,-13187
18,05-04-17,49,12:00,12:15,,27.71,0,27.71,27.71,-1,-84096,93397,177493,9301,0,-4150,0,0,0,,4150,-4150
18,05-04-17,50,12:15,12:30,,23.29,0,23.29,23.29,-1,-64111,95294,159405,31183,0,-13054,0,0,0,,13054,-13054
18,05-04-17,51,12:30,12:45,,27.29,0,27.29,27.29,-1,-62698,85080,147778,22382,0,-14179,0,0,0,,14179,-14179
18,05-04-17,52,12:45,13:00,,25.64,0,25.64,25.64,-1,-54725,83713,138438,28988,0,-18614,0,0,0,,18614,-18614
18,05-04-17,53,13:00,13:15,,28.29,0,28.29,28.29,-1,-52544,72625,125169,20081,0,-10318,0,0,0,,10318,-10318
18,05-04-17,54,13:15,13:30,32.2,28.29,0,32.2,32.2,1,-67908,69455,137363,1547,0,-43,244,0,0,,287,201
18,05-04-17,55,13:30,13:45,,,0,37.8,37.8,0,-54803,82457,137260,27654,0,0,0,0,0,,0,0
18,05-04-17,56,13:45,14:00,,29.42,0,29.42,29.42,-1,-44090,88693,132783,44603,0,-175,0,0,0,,175,-175
18,05-04-17,57,14:00,14:15,,28.78,0,28.78,28.78,-1,-40903,86641,127544,45738,0,-276,0,0,0,,276,-276
18,05-04-17,58,14:15,14:30,,27.3,0,27.3,27.3,-1,-27303,93452,120755,66149,0,-1285,0,0,0,,1285,-1285
18,05-04-17,59,14:30,14:45,,25.25,0,25.25,25.25,-1,-20569,92938,113507,72369,0,-13894,0,0,0,,13894,-13894
18,05-04-17,60,14:45,15:00,,26.35,0,26.35,26.35,-1,-29857,94759,124616,64902,0,-10928,0,0,0,,10928,-10928
18,05-04-17,61,15:00,15:15,,29.25,0,29.25,29.25,-1,-45132,84767,129899,39635,0,-2479,0,0,0,,2479,-2479
18,05-04-17,62,15:15,15:30,,40.35,0,40.35,40.35,-1,-41925,68944,110869,27019,0,-11,0,0,0,,11,-11
18,05-04-17,63,15:30,15:45,,28.29,0,28.29,28.29,-1,-40587,60494,101081,19907,0,-2084,0,0,0,,2084,-2084
18,05-04-17,64,15:45,16:00,,18.29,0,18.29,18.29,-1,-25611,69747,95358,44136,0,-14325,0,0,0,,14325,-14325
18,05-04-17,65,16:00,16:15,,23.29,0,23.29,23.29,-1,-27811,66337,94148,38526,0,-33394,0,0,0,,33394,-33394
18,05-04-17,66,16:15,16:30,,27.83,0,27.83,27.83,-1,-17301,61378,78679,44077,0,-17871,0,0,0,,17871,-17871
18,05-04-17,67,16:30,16:45,,28.78,0,28.78,28.78,-1,-28807,73501,102308,44694,0,-4213,0,0,0,,4213,-4213
18,05-04-17,68,16:45,17:00,,40.33,0,40.33,40.33,-1,-52868,62853,115721,9985,0,-18,0,0,0,,18,-18
18,05-04-17,69,17:00,17:15,,24.94,0,24.94,24.94,-1,-32265,54854,87119,22589,0,-8345,0,0,0,,8345,-8345
18,05-04-17,70,17:15,17:30,30.95,29.89,0,34.64,29.89,2,-44081,34952,79033,-9129,0,-2179,1297,0,0,,3476,-882
18,05-04-17,71,17:30,17:45,30.95,26.55,0,26.55,26.55,-1,-26996,45320,72316,18324,0,-5470,202,0,0,,5672,-5268
18,05-04-17,72,17:45,18:00,,23.29,0,23.29,23.29,-1,-22582,54369,76951,31787,0,-21955,0,0,0,,21955,-21955
18,05-04-17,73,18:00,18:15,28.95,27.29,0,28.95,28.95,1,-61272,42941,104213,-18331,0,-13776,121,0,0,,13897,-13655
18,05-04-17,74,18:15,18:30,28.95,27.29,0,34.65,27.29,2,-32285,53816,86101,21531,0,-5907,68,0,0,,5975,-5839
18,05-04-17,75,18:30,18:45,,27.29,0,27.29,27.29,-1,-35156,47551,82707,12395,0,-12136,0,0,0,,12136,-12136
18,05-04-17,76,18:45,19:00,,23.29,0,23.29,23.29,-1,-29226,66029,95255,36803,0,-21846,0,0,0,,21846,-21846
18,05-04-17,77,19:00,19:15,30.95,26.79,0,30.95,30.95,1,-61119,37567,98686,-23552,0,-12999,433,0,0,,13432,-12566
18,05-04-17,78,19:15,19:30,30.95,26.79,0,30.95,30.95,1,-64156,43682,107838,-20474,0,-28,1417,0,0,,1445,1389
18,05-04-17,79,19:30,19:45,30.95,,0,30.95,30.95,1,-67615,40832,108447,-26783,0,0,2797,0,0,,2797,2797
18,05-04-17,80,19:45,20:00,31.08,27.29,0,36.94,27.29,2,-55438,66336,121774,10898,0,-81,2971,0,0,,3052,2890
18,05-04-17,81,20:00,20:15,,10.13,0,10.13,10.13,-1,-48555,78687,127242,30132,0,-12683,0,0,0,,12683,-12683
18,05-04-17,82,20:15,20:30,,27.29,0,27.29,27.29,-1,-45440,66931,112371,21491,0,-6499,0,0,0,,6499,-6499
18,05-04-17,83,20:30,20:45,,29.78,0,29.78,29.78,-1,-47646,48616,96262,970,0,-2150,0,0,0,,2150,-2150
18,05-04-17,84,20:45,21:00,,25.27,0,25.27,25.27,-1,-51420,69829,121249,18409,0,-11011,0,0,0,,11011,-11011
18,05-04-17,85,21:00,21:15,34.29,28.29,0,34.29,34.29,1,-32970,31580,64550,-1390,0,-5908,2160,0,0,,8068,-3748
18,05-04-17,86,21:15,21:30,42.54,,0,42.54,42.54,1,-44653,28337,72990,-16316,0,0,24374,0,0,,24374,24374
18,05-04-17,87,21:30,21:45,28.29,,0,28.29,28.29,1,-54918,48398,103316,-6520,0,0,7925,0,0,,7925,7925
18,05-04-17,88,21:45,22:00,,10.14,0,10.14,10.14,-1,-44140,60702,104842,16562,0,-6765,0,0,0,,6765,-6765
18,05-04-17,89,22:00,22:15,34.29,-9.88,0,34.35,-9.88,2,-41312,49813,91125,8501,0,-27494,581,0,0,,28075,-26913
18,05-04-17,90,22:15,22:30,34.29,27.29,0,34.35,27.29,2,-54949,67099,122048,12150,0,-503,3437,0,0,,3940,2934
18,05-04-17,91,22:30,22:45,,16.22,0,16.22,16.22,-1,-51698,92688,144386,40990,0,-29998,0,0,0,,29998,-29998
18,05-04-17,92,22:45,23:00,,18.29,0,18.29,18.29,-1,-64229,98300,162529,34071,0,-24421,0,0,0,,24421,-24421
18,05-04-17,93,23:00,23:15,42.59,15.19,0,42.59,15.19,2,-91089,66759,157848,-24330,0,-18265,3197,0,0,,21462,-15068
18,05-04-17,94,23:15,23:30,30.83,15.19,0,30.83,30.83,1,-69212,67082,136294,-2130,0,-9,2657,0,0,,2666,2648
18,05-04-17,95,23:30,23:45,,27.64,0,27.64,27.64,-1,-61872,70481,132353,8609,0,-4612,0,0,0,,4612,-4612
18,05-04-17,96,23:45,0:00,35.12,27.64,0,35.12,35.12,1,-72565,57025,129590,-15540,0,-667,4292,0,0,,4959,3625
18,05-05-17,1,0:00,0:15,28.09,27.04,0,28.09,27.04,2,-55136,63130,118266,7994,0,-1240,1023,0,0,,2263,-217
18,05-05-17,2,0:15,0:30,40.09,27.04,0,40.09,40.09,1,-68029,57963,125992,-10066,0,-1,5626,0,0,,5627,5625
18,05-05-17,3,0:30,0:45,28.09,27.09,0,27.09,27.09,-1,-66200,78310,144510,12110,0,-665,1830,0,0,,2495,1165
18,05-05-17,4,0:45,1:00,,2.73,0,2.73,2.73,-1,-64624,109589,174213,44965,0,-37143,0,0,0,,37143,-37143
18,05-05-17,5,1:00,1:15,,12.03,0,12.03,12.03,-1,-65560,76007,141567,10447,0,-35257,0,0,0,,35257,-35257
18,05-05-17,6,1:15,1:30,,23.09,0,23.09,23.09,-1,-79976,85036,165012,5060,0,-4031,0,0,0,,4031,-4031
18,05-05-17,7,1:30,1:45,,-3.03,0,-3.03,-3.03,-1,-28604,88108,116712,59504,0,-47257,0,0,0,,47257,-47257
18,05-05-17,8,1:45,2:00,,2.15,0,2.15,2.15,-1,-15360,89990,105350,74630,0,-65732,0,0,0,,65732,-65732
18,05-05-17,9,2:00,2:15,,-8.36,0,-8.36,-8.36,-1,-41337,88886,130223,47549,0,-63273,0,0,0,,63273,-63273
18,05-05-17,10,2:15,2:30,,18.09,0,18.09,18.09,-1,-57407,106150,163557,48743,0,-46367,0,0,0,,46367,-46367
18,05-05-17,11,2:30,2:45,,18.09,0,18.09,18.09,-1,-52642,108475,161117,55833,0,-54204,0,0,0,,54204,-54204
18,05-05-17,12,2:45,3:00,,22.45,0,22.45,22.45,-1,-45510,99164,144674,53654,0,-43869,0,0,0,,43869,-43869
18,05-05-17,13,3:00,3:15,,18.09,0,18.09,18.09,-1,-31510,88875,120385,57365,0,-53889,0,0,0,,53889,-53889
18,05-05-17,14,3:15,3:30,,21.21,0,21.21,21.21,-1,-53277,88437,141714,35160,0,-51892,0,0,0,,51892,-51892
18,05-05-17,15,3:30,3:45,,23.09,0,23.09,23.09,-1,-84450,102027,186477,17577,0,-37073,0,0,0,,37073,-37073
18,05-05-17,16,3:45,4:00,,17.19,0,17.19,17.19,-1,-86486,116795,203281,30309,0,-18057,0,0,0,,18057,-18057
18,05-05-17,17,4:00,4:15,,10.58,0,10.58,10.58,-1,-60168,138623,198791,78455,0,-37654,0,0,0,,37654,-37654
18,05-05-17,18,4:15,4:30,,28.79,0,28.79,28.79,-1,-54011,131588,185599,77577,0,-4542,0,0,0,,4542,-4542
18,05-05-17,19,4:30,4:45,,18.09,0,18.09,18.09,-1,-43399,109308,152707,65909,0,-8804,0,0,0,,8804,-8804
18,05-05-17,20,4:45,5:00,,28.67,0,28.67,28.67,-1,-40285,94879,135164,54594,0,-219,0,0,0,,219,-219
18,05-05-17,21,5:00,5:15,,22.37,0,22.37,22.37,-1,-65436,91810,157246,26374,0,-5334,0,0,0,,5334,-5334
18,05-05-17,22,5:15,5:30,,8.37,0,8.37,8.37,-1,-26522,84703,111225,58181,0,-63890,0,0,0,,63890,-63890
18,05-05-17,23,5:30,5:45,,18.09,0,18.09,18.09,-1,-25744,84988,110732,59244,0,-61552,0,0,0,,61552,-61552
18,05-05-17,24,5:45,6:00,,18.09,0,18.09,18.09,-1,-20168,93148,113316,72980,0,-50364,0,0,0,,50364,-50364
18,05-05-17,25,6:00,6:15,,27.03,0,27.03,27.03,-1,-134770,119275,254045,-15495,0,-20369,0,0,0,,20369,-20369
18,05-05-17,26,6:15,6:30,,-21.27,0,-21.27,-21.27,-1,-40218,136080,176298,95862,0,-53021,0,0,0,,53021,-53021
18,05-05-17,27,6:30,6:45,,7.29,0,7.29,7.29,-1,-49324,111275,160599,61951,0,-68375,0,0,0,,68375,-68375
18,05-05-17,28,6:45,7:00,27.38,17.38,0,28.1,17.38,2,-56561,94182,150743,37621,0,-12712,143,0,0,,12855,-12569
18,05-05-17,29,7:00,7:15,,3.81,0,3.81,3.81,-1,-66798,155032,221830,88234,0,-67674,0,0,0,,67674,-67674
18,05-05-17,30,7:15,7:30,,11.85,0,11.85,11.85,-1,-41263,145331,186594,104068,0,-91250,0,0,0,,91250,-91250
18,05-05-17,31,7:30,7:45,,7.03,0,7.03,7.03,-1,-38893,84653,123546,45760,0,-68892,0,0,0,,68892,-68892
18,05-05-17,32,7:45,8:00,29.38,22.38,0,29.38,22.38,2,-48302,67716,116018,19414,0,-6432,537,0,0,,6969,-5895
18,05-05-17,33,8:00,8:15,,21.21,0,21.21,21.21,-1,-71271,99947,171218,28676,0,-26518,0,0,0,,26518,-26518
18,05-05-17,34,8:15,8:30,30.99,21.21,0,30.99,30.99,1,-80842,87668,168510,6826,0,-2772,236,0,0,,3008,-2536
18,05-05-17,35,8:30,8:45,30.02,,0,30.02,30.02,1,-87735,53115,140850,-34620,0,0,1448,0,0,,1448,1448
18,05-05-17,36,8:45,9:00,40.29,,0,40.29,40.29,1,-116693,32735,149428,-83958,0,0,6070,0,0,,6070,6070
18,05-05-17,37,9:00,9:15,38.29,,0,38.29,38.29,1,-67558,45250,112808,-22308,0,0,4974,0,0,,4974,4974
18,05-05-17,38,9:15,9:30,55.91,,0,55.91,55.91,1,-78118,35843,113961,-42275,0,0,8312,0,0,,8312,8312
18,05-05-17,39,9:30,9:45,39.91,,0,39.91,39.91,1,-93897,33685,127582,-60212,0,0,14374,0,0,,14374,14374
18,05-05-17,40,9:45,10:00,129.93,,0,129.93,129.93,1,-131667,28507,160174,-103160,0,0,26705,0,0,,26705,26705
18,05-05-17,41,10:00,10:15,98.48,,0,98.48,98.48,1,-121087,48520,169607,-72567,0,0,42284,0,0,,42284,42284
18,05-05-17,42,10:15,10:30,55.82,,0,55.82,55.82,1,-119582,51174,170756,-68408,0,0,40741,0,0,,40741,40741
18,05-05-17,43,10:30,10:45,87.15,,0,87.15,87.15,1,-122910,61001,183911,-61909,0,0,48111,0,0,,48111,48111
18,05-05-17,44,10:45,11:00,132.02,,0,132.02,132.02,1,-135483,54986,190469,-80497,0,0,52262,0,0,,52262,52262
18,05-05-17,45,11:00,11:15,257.15,,0,257.15,257.15,1,-135524,46961,182485,-88563,0,0,36423,0,0,,36423,36423
18,05-05-17,46,11:15,11:30,257.15,,0,257.15,257.15,1,-130592,66897,197489,-63695,0,0,56768,0,0,,56768,56768
18,05-05-17,47,11:30,11:45,46,,0,46,46,1,-131666,61991,193657,-69675,0,0,35163,0,0,,35163,35163
18,05-05-17,48,11:45,12:00,46,,0,46,46,1,-153372,51733,205105,-101639,0,0,29204,0,0,,29204,29204
18,05-05-17,49,12:00,12:15,40.29,,0,40.29,40.29,1,-135257,61503,196760,-73754,0,0,14403,0,0,,14403,14403
18,05-05-17,50,12:15,12:30,32,,0,32,32,1,-137452,68104,205556,-69348,0,0,3908,0,0,,3908,3908
18,05-05-17,51,12:30,12:45,183.02,,0,183.02,183.02,1,-125409,65553,190962,-59856,0,0,24430,0,0,,24430,24430
18,05-05-17,52,12:45,13:00,37,,0,37,37,1,-111886,88151,200037,-23735,0,0,16453,0,0,,16453,16453
18,05-05-17,53,13:00,13:15,35.09,,0,35.09,35.09,1,-96225,97778,194003,1553,0,0,7714,0,0,,7714,7714
18,05-05-17,54,13:15,13:30,30.09,29.89,0,30.09,28.09,2,-97282,88517,185799,-8765,0,-97,891,0,0,,988,794
18,05-05-17,55,13:30,13:45,31.06,,0,31.06,31.06,1,-100252,83228,183480,-17024,0,0,6444,0,0,,6444,6444
18,05-05-17,56,13:45,14:00,30.31,,0,30.31,30.31,1,-96920,76930,173850,-19990,0,0,7866,0,0,,7866,7866
18,05-05-17,57,14:00,14:15,34.02,,0,34.02,34.02,1,-97864,92001,189865,-5863,0,0,9882,0,0,,9882,9882
18,05-05-17,58,14:15,14:30,29.38,,0,29.38,29.38,1,-91604,81443,173047,-10161,0,0,5872,0,0,,5872,5872
18,05-05-17,59,14:30,14:45,30.02,,0,30.02,30.02,1,-91720,70051,161771,-21669,0,0,5575,0,0,,5575,5575
18,05-05-17,60,14:45,15:00,28.02,,0,28.02,28.02,1,-84483,69821,154304,-14662,0,0,3002,0,0,,3002,3002
18,05-05-17,61,15:00,15:15,41.37,,0,41.37,41.37,1,-82545,48538,131083,-34007,0,0,5546,0,0,,5546,5546
18,05-05-17,62,15:15,15:30,30.02,,0,30.02,30.02,1,-84083,62287,146370,-21796,0,0,6778,0,0,,6778,6778
18,05-05-17,63,15:30,15:45,,,0,27.96,27.96,0,-86166,67358,153524,-18808,0,0,771,0,0,,771,771
18,05-05-17,64,15:45,16:00,28.02,,0,28.02,28.02,1,-100509,79120,179629,-21389,0,0,1614,0,0,,1614,1614
18,05-05-17,65,16:00,16:15,,,0,27.92,27.92,0,-82603,97602,180205,14999,0,0,144,0,0,,144,144
18,05-05-17,66,16:15,16:30,28.02,,0,28.02,28.02,1,-96972,88627,185599,-8345,0,0,330,0,0,,330,330
18,05-05-17,67,16:30,16:45,30.02,,0,30.02,30.02,1,-102093,88839,190932,-13254,0,0,3962,0,0,,3962,3962
18,05-05-17,68,16:45,17:00,28.02,,0,28.02,28.02,1,-109026,78995,188021,-30031,0,0,3285,0,0,,3285,3285
18,05-05-17,69,17:00,17:15,30.39,,0,30.39,30.39,1,-72847,56971,129818,-15876,0,0,555,0,0,,555,555
18,05-05-17,70,17:15,17:30,32.9,,0,32.9,32.9,1,-68520,38444,106964,-30076,0,0,8797,0,0,,8797,8797
18,05-05-17,71,17:30,17:45,28.02,,0,28.02,28.02,1,-64061,51441,115502,-12620,0,0,4017,0,0,,4017,4017
18,05-05-17,72,17:45,18:00,31.2,,0,31.2,31.2,1,-68449,50731,119180,-17718,0,0,3718,0,0,,3718,3718
18,05-05-17,73,18:00,18:15,30.02,,0,30.02,30.02,1,-102893,30502,133395,-72391,0,0,1312,0,0,,1312,1312
18,05-05-17,74,18:15,18:30,30.02,,0,30.02,30.02,1,-94138,35964,130102,-58174,0,0,13,0,0,,13,13
18,05-05-17,75,18:30,18:45,30.02,,0,30.02,30.02,1,-96146,48498,144644,-47648,0,0,308,0,0,,308,308
18,05-05-17,76,18:45,19:00,30.14,,0,30.14,30.14,1,-95805,59504,155309,-36301,0,0,1776,0,0,,1776,1776
18,05-05-17,77,19:00,19:15,32.09,,0,32.09,32.09,1,-126454,25175,151629,-101279,0,0,2303,0,0,,2303,2303
18,05-05-17,78,19:15,19:30,37.09,,0,37.09,37.09,1,-111619,20727,132346,-90892,0,0,7053,0,0,,7053,7053
18,05-05-17,79,19:30,19:45,42.59,,0,42.59,42.59,1,-114817,27182,141999,-87635,0,0,12526,0,0,,12526,12526
18,05-05-17,80,19:45,20:00,32,,0,32,32,1,-111071,27972,139043,-83099,0,0,4525,0,0,,4525,4525
18,05-05-17,81,20:00,20:15,47.16,,0,47.16,47.16,1,-145500,34149,179649,-111351,0,0,16315,0,0,,16315,16315
18,05-05-17,82,20:15,20:30,32.02,,0,32.02,32.02,1,-101881,36797,138678,-65084,0,0,11072,0,0,,11072,11072
18,05-05-17,83,20:30,20:45,,,0,29.71,29.71,0,-104417,44669,149086,-59748,0,0,294,0,0,,294,294
18,05-05-17,84,20:45,21:00,,,0,29.71,29.71,0,-106790,39829,146619,-66961,0,0,0,0,0,,0,0
18,05-05-17,85,21:00,21:15,,,0,29.51,29.51,0,-92548,78745,171293,-13803,0,0,0,0,0,,0,0
18,05-05-17,86,21:15,21:30,,,0,29.51,29.51,0,-98690,63949,162639,-34741,0,0,0,0,0,,0,0
18,05-05-17,87,21:30,21:45,,,0,29.51,29.51,0,-102113,67128,169241,-34985,0,0,0,0,0,,0,0
18,05-05-17,88,21:45,22:00,,27.38,0,27.38,27.38,-1,-99067,74378,173445,-24689,0,-706,0,0,0,,706,-706
18,05-05-17,89,22:00,22:15,,22.38,0,22.38,22.38,-1,-59225,48525,107750,-10700,0,-5436,0,0,0,,5436,-5436
18,05-05-17,90,22:15,22:30,,29.46,0,29.46,29.46,-1,-64105,42868,106973,-21237,0,-3,0,0,0,,3,-3
18,05-05-17,91,22:30,22:45,33.19,29.42,0,33.19,29.42,2,-74548,39638,114186,-34910,0,-189,705,0,0,,894,516
18,05-05-17,92,22:45,23:00,31.65,,0,31.65,31.65,1,-109429,46288,155717,-63141,0,0,2112,0,0,,2112,2112
18,05-05-17,93,23:00,23:15,31.44,,0,31.44,31.44,1,-84238,55148,139386,-29090,0,0,883,0,0,,883,883
18,05-05-17,94,23:15,23:30,33.38,,0,33.38,33.38,1,-73090,46085,119175,-27005,0,0,4783,0,0,,4783,4783
18,05-05-17,95,23:30,23:45,,30.03,0,30.03,30.03,-1,-35675,44719,80394,9044,0,-256,0,0,0,,256,-256
18,05-05-17,96,23:45,0:00,,11.85,0,11.85,11.85,-1,-49952,72083,122035,22131,0,-18312,0,0,0,,18312,-18312
19,05-06-17,1,0:00,0:15,33.81,23.09,0,33.81,33.81,1,-65274,95516,160790,30242,0,-15366,849,0,0,,16215,-14517
19,05-06-17,2,0:15,0:30,46.59,28.1,0,46.59,27.88,2,-63212,32112,95324,-31100,0,-75,7160,0,0,,7235,7085
19,05-06-17,3,0:30,0:45,46.59,28.54,0,28.54,28.54,-1,-78599,32042,110641,-46557,0,-1183,2,0,0,,1185,-1181
19,05-06-17,4,0:45,1:00,,29.22,0,29.22,29.22,-1,-118933,24976,143909,-93957,0,-430,0,0,0,,430,-430
19,05-06-17,5,1:00,1:15,39.72,28.47,0,39.72,27.88,2,-44888,62058,106946,17170,0,-664,1108,0,0,,1772,444
19,05-06-17,6,1:15,1:30,68.81,,0,68.81,68.81,1,-62131,15964,78095,-46167,0,0,19145,0,0,,19145,19145
19,05-06-17,7,1:30,1:45,29.83,,0,29.83,29.83,1,-41091,25179,66270,-15912,0,0,4534,0,0,,4534,4534
19,05-06-17,8,1:45,2:00,27.72,,0,27.72,27.72,1,-88081,21692,109773,-66389,0,0,2086,0,0,,2086,2086
19,05-06-17,9,2:00,2:15,34.04,,0,34.04,34.04,1,-57867,41103,98970,-16764,0,0,6833,0,0,,6833,6833
19,05-06-17,10,2:15,2:30,38.54,,0,38.54,38.54,1,-47529,27273,74802,-20256,0,0,22052,0,0,,22052,22052
19,05-06-17,11,2:30,2:45,27.72,28.31,0,28.31,28.31,-1,-27296,28169,55465,873,0,-313,8006,0,0,,8319,7693
19,05-06-17,12,2:45,3:00,27.72,28.42,0,28.42,28.42,-1,-15910,39300,55210,23390,0,-2032,13,0,0,,2045,-2019
19,05-06-17,13,3:00,3:15,,,0,27.97,27.97,0,-29776,36470,66246,6694,0,-51,0,0,0,,51,-51
19,05-06-17,14,3:15,3:30,,,0,27.97,27.97,0,-23955,37780,61735,13825,0,0,0,0,0,,0,0
19,05-06-17,15,3:30,3:45,,,0,27.98,27.98,0,-17417,54697,72114,37280,0,0,0,0,0,,0,0
19,05-06-17,16,3:45,4:00,,,0,27.98,27.98,0,-17302,51266,68568,33964,0,0,0,0,0,,0,0
19,05-06-17,17,4:00,4:15,,,0,27.97,27.97,0,-8602,49641,58243,41039,0,0,0,0,0,,0,0
19,05-06-17,18,4:15,4:30,,,0,27.98,27.98,0,-7815,40240,48055,32425,0,0,0,0,0,,0,0
19,05-06-17,19,4:30,4:45,,,0,27.98,27.98,0,-5400,54965,60365,49565,0,0,0,0,0,,0,0
19,05-06-17,20,4:45,5:00,,,0,27.98,27.98,0,-6191,61547,67738,55356,0,0,0,0,0,,0,0
19,05-06-17,21,5:00,5:15,,28.94,0,28.94,28.94,-1,-11770,83726,95496,71956,0,-937,0,0,0,,937,-937
19,05-06-17,22,5:15,5:30,,28.94,0,28.94,28.94,-1,-13681,82798,96479,69117,0,-364,0,0,0,,364,-364
19,05-06-17,23,5:30,5:45,,-0.25,0,-0.25,-0.25,-1,-12368,80791,93159,68423,0,-23791,0,0,0,,23791,-23791
19,05-06-17,24,5:45,6:00,,10.55,0,10.55,10.55,-1,-18964,83002,101966,64038,0,-43890,0,0,0,,43890,-43890
19,05-06-17,25,6:00,6:15,,21.21,0,21.21,21.21,-1,-32155,69822,101977,37667,0,-23915,0,0,0,,23915,-23915
19,05-06-17,26,6:15,6:30,,21.21,0,21.21,21.21,-1,-18003,71114,89117,53111,0,-13938,0,0,0,,13938,-13938
19,05-06-17,27,6:30,6:45,,26.42,0,26.42,26.42,-1,-11048,69578,80626,58530,0,-13005,0,0,0,,13005,-13005
19,05-06-17,28,6:45,7:00,,,0,27.96,27.96,0,-18867,88757,107624,69890,0,-219,0,0,0,,219,-219
19,05-06-17,29,7:00,7:15,27.42,,0,27.42,27.42,1,-77009,47641,124650,-29368,0,0,1651,0,0,,1651,1651
19,05-06-17,30,7:15,7:30,26.08,,0,26.08,26.08,1,-21874,38890,60764,17016,0,0,377,0,0,,377,377
19,05-06-17,31,7:30,7:45,,28.6,0,28.6,28.6,-1,-23010,45378,68388,22368,0,-261,0,0,0,,261,-261
19,05-06-17,32,7:45,8:00,,,0,27.92,27.92,0,-44490,73070,117560,28580,0,-37,0,0,0,,37,-37
19,05-06-17,33,8:00,8:15,,,0,27.87,27.87,0,-25761,52415,78176,26654,0,0,0,0,0,,0,0
19,05-06-17,34,8:15,8:30,,,0,27.87,27.87,0,-19161,53983,73144,34822,0,0,0,0,0,,0,0
19,05-06-17,35,8:30,8:45,,,0,27.86,27.86,0,-33497,47902,81399,14405,0,0,0,0,0,,0,0
19,05-06-17,36,8:45,9:00,27.04,,0,27.04,27.04,1,-44402,54512,98914,10110,0,0,827,0,0,,827,827
19,05-06-17,37,9:00,9:15,27.04,,0,27.04,27.04,1,-30448,57993,88441,27545,0,0,488,0,0,,488,488
19,05-06-17,38,9:15,9:30,,,0,27.8,27.8,0,-25894,49740,75634,23846,0,0,0,0,0,,0,0
19,05-06-17,39,9:30,9:45,,,0,27.79,27.79,0,-27473,54699,82172,27226,0,0,0,0,0,,0,0
19,05-06-17,40,9:45,10:00,,,0,27.79,27.79,0,-32484,55996,88480,23512,0,0,0,0,0,,0,0
19,05-06-17,41,10:00,10:15,,,0,28.47,28.47,0,-33874,50391,84265,16517,0,0,0,0,0,,0,0
19,05-06-17,42,10:15,10:30,,,0,28.47,28.47,0,-22460,45553,68013,23093,0,0,0,0,0,,0,0
19,05-06-17,43,10:30,10:45,,,0,28.47,28.47,0,-16374,55409,71783,39035,0,0,0,0,0,,0,0
19,05-06-17,44,10:45,11:00,,17.42,0,17.42,17.42,-1,-16288,62358,78646,46070,0,-8328,0,0,0,,8328,-8328
19,05-06-17,45,11:00,11:15,,26.42,0,26.42,26.42,-1,-26402,106219,132621,79817,0,-7288,0,0,0,,7288,-7288
19,05-06-17,46,11:15,11:30,,28.01,0,28.01,28.01,-1,-17797,109858,127655,92061,0,-1606,0,0,0,,1606,-1606
19,05-06-17,47,11:30,11:45,,26.42,0,26.42,26.42,-1,-11235,132365,143600,121130,0,-8789,0,0,0,,8789,-8789
19,05-06-17,48,11:45,12:00,,23.43,0,23.43,23.43,-1,-11647,159135,170782,147488,0,-16676,0,0,0,,16676,-16676
19,05-06-17,49,12:00,12:15,,27.42,0,27.42,27.42,-1,-28588,116693,145281,88105,0,-7441,0,0,0,,7441,-7441
19,05-06-17,50,12:15,12:30,,22.42,0,22.42,22.42,-1,-16450,138588,155038,122138,0,-3988,0,0,0,,3988,-3988
19,05-06-17,51,12:30,12:45,,22.42,0,22.42,22.42,-1,-16557,179319,195876,162762,0,-12615,0,0,0,,12615,-12615
19,05-06-17,52,12:45,13:00,,-27.18,0,-27.18,-27.18,-1,-24797,204499,229296,179702,0,-39514,0,0,0,,39514,-39514
19,05-06-17,53,13:00,13:15,,-49.05,0,-49.05,-49.05,-1,-30014,143747,173761,113733,0,-29262,0,0,0,,29262,-29262
19,05-06-17,54,13:15,13:30,,20.6,0,20.6,20.6,-1,-31430,174491,205921,143061,0,-1255,0,0,0,,1255,-1255
19,05-06-17,55,13:30,13:45,,-2.08,0,-2.08,-2.08,-1,-32427,190543,222970,158116,0,-36389,0,0,0,,36389,-36389
19,05-06-17,56,13:45,14:00,,-20.66,0,-20.66,-20.66,-1,-49981,168520,218501,118539,0,-70921,0,0,0,,70921,-70921
19,05-06-17,57,14:00,14:15,,-33.23,0,-33.23,-33.23,-1,-40057,195050,235107,154993,0,-95878,0,0,0,,95878,-95878
19,05-06-17,58,14:15,14:30,,-33.23,0,-33.23,-33.23,-1,-58581,151296,209877,92715,0,-88719,0,0,0,,88719,-88719
19,05-06-17,59,14:30,14:45,,16.24,0,16.24,16.24,-1,-81741,167909,249650,86168,0,-39239,0,0,0,,39239,-39239
19,05-06-17,60,14:45,15:00,,-33.23,0,-33.23,-33.23,-1,-88864,153662,242526,64798,0,-58106,0,0,0,,58106,-58106
19,05-06-17,61,15:00,15:15,,26.42,0,26.42,26.42,-1,-81405,134713,216118,53308,0,-13382,0,0,0,,13382,-13382
19,05-06-17,62,15:15,15:30,,27.42,0,27.42,27.42,-1,-73827,129504,203331,55677,0,-1774,0,0,0,,1774,-1774
19,05-06-17,63,15:30,15:45,,27.42,0,27.42,27.42,-1,-67269,122178,189447,54909,0,-4567,0,0,0,,4567,-4567
19,05-06-17,64,15:45,16:00,,22.42,0,22.42,22.42,-1,-68943,121711,190654,52768,0,-14933,0,0,0,,14933,-14933
19,05-06-17,65,16:00,16:15,,26.79,0,26.79,26.79,-1,-69263,105709,174972,36446,0,-7673,0,0,0,,7673,-7673
19,05-06-17,66,16:15,16:30,,,0,28.47,28.47,0,-57825,98338,156163,40513,0,-37,0,0,0,,37,-37
19,05-06-17,67,16:30,16:45,,,0,28.47,28.47,0,-65029,93982,159011,28953,0,0,0,0,0,,0,0
19,05-06-17,68,16:45,17:00,,,0,28.47,28.47,0,-60252,82074,142326,21822,0,0,0,0,0,,0,0
19,05-06-17,69,17:00,17:15,,26.42,0,26.42,26.42,-1,-48284,125545,173829,77261,0,-427,0,0,0,,427,-427
19,05-06-17,70,17:15,17:30,,10.66,0,10.66,10.66,-1,-26791,118250,145041,91459,0,-17995,0,0,0,,17995,-17995
19,05-06-17,71,17:30,17:45,,26.42,0,26.42,26.42,-1,-29473,97177,126650,67704,0,-13152,0,0,0,,13152,-13152
19,05-06-17,72,17:45,18:00,,,0,28.47,28.47,0,-35688,74927,110615,39239,0,-1327,0,0,0,,1327,-1327
19,05-06-17,73,18:00,18:15,,,0,27.95,27.95,0,-57916,86746,144662,28830,0,0,0,0,0,,0,0
19,05-06-17,74,18:15,18:30,,,0,27.94,27.94,0,-44656,81085,125741,36429,0,0,0,0,0,,0,0
19,05-06-17,75,18:30,18:45,29.04,,0,29.04,29.04,1,-54610,70126,124736,15516,0,0,201,0,0,,201,201
19,05-06-17,76,18:45,19:00,29.04,,0,29.04,29.04,1,-51695,65308,117003,13613,0,0,620,0,0,,620,620
19,05-06-17,77,19:00,19:15,43.94,,0,43.94,43.94,1,-108645,47071,155716,-61574,0,0,15777,0,0,,15777,15777
19,05-06-17,78,19:15,19:30,33.04,,0,33.04,33.04,1,-104692,46129,150821,-58563,0,0,24817,0,0,,24817,24817
19,05-06-17,79,19:30,19:45,70.77,,0,70.77,70.77,1,-93751,36658,130409,-57093,0,0,34892,0,0,,34892,34892
19,05-06-17,80,19:45,20:00,32.89,,0,32.89,32.89,1,-64579,54531,119110,-10048,0,0,18423,0,0,,18423,18423
19,05-06-17,81,20:00,20:15,32.61,,0,32.61,32.61,1,-78198,73052,151250,-5146,0,0,6057,0,0,,6057,6057
19,05-06-17,82,20:15,20:30,29.9,,0,29.9,29.9,1,-73564,63244,136808,-10320,0,0,6992,0,0,,6992,6992
19,05-06-17,83,20:30,20:45,29.6,29.89,0,29.89,29.89,-1,-62182,75061,137243,12879,0,-5,4364,0,0,,4369,4359
19,05-06-17,84,20:45,21:00,29.6,29.33,0,29.33,29.33,-1,-48429,84952,133381,36523,0,-743,21,0,0,,764,-722
19,05-06-17,85,21:00,21:15,,22.42,0,22.42,22.42,-1,-13187,155173,168360,141986,0,-9830,0,0,0,,9830,-9830
19,05-06-17,86,21:15,21:30,,27.42,0,27.42,27.42,-1,-26117,120101,146218,93984,0,-7232,0,0,0,,7232,-7232
19,05-06-17,87,21:30,21:45,,,0,28.14,28.14,0,-47602,97341,144943,49739,0,-95,0,0,0,,95,-95
19,05-06-17,88,21:45,22:00,,26.42,0,26.42,26.42,-1,-56115,101170,157285,45055,0,-89,0,0,0,,89,-89
19,05-06-17,89,22:00,22:15,,24.78,0,24.78,24.78,-1,-45428,66682,112110,21254,0,-5577,0,0,0,,5577,-5577
19,05-06-17,90,22:15,22:30,,21.21,0,21.21,21.21,-1,-39936,70486,110422,30550,0,-17988,0,0,0,,17988,-17988
19,05-06-17,91,22:30,22:45,,24.78,0,24.78,24.78,-1,-36118,66276,102394,30158,0,-14762,0,0,0,,14762,-14762
19,05-06-17,92,22:45,23:00,,,0,28.21,28.21,0,-32900,80093,112993,47193,0,-282,0,0,0,,282,-282
19,05-06-17,93,23:00,23:15,31.31,,0,31.31,31.31,1,-36952,47375,84327,10423,0,0,145,0,0,,145,145
19,05-06-17,94,23:15,23:30,,22.42,0,22.42,22.42,-1,-19878,65798,85676,45920,0,-3800,0,0,0,,3800,-3800
19,05-06-17,95,23:30,23:45,,26.42,0,26.42,26.42,-1,-18348,91303,109651,72955,0,-5043,0,0,0,,5043,-5043
19,05-06-17,96,23:45,0:00,,22.42,0,22.42,22.42,-1,-17571,105043,122614,87472,0,-2542,0,0,0,,2542,-2542
19,05-07-17,1,0:00,0:15,,20.03,0,20.03,20.03,-1,-23900,71312,95212,47412,0,-3746,0,0,0,,3746,-3746
19,05-07-17,2,0:15,0:30,,22.27,0,22.27,22.27,-1,-21018,60159,81177,39141,0,-2632,0,0,0,,2632,-2632
19,05-07-17,3,0:30,0:45,,21.86,0,21.86,21.86,-1,-46140,54241,100381,8101,0,-9347,0,0,0,,9347,-9347
19,05-07-17,4,0:45,1:00,30.53,28.92,0,30.53,28.92,2,-115779,57766,173545,-58013,0,-4588,1644,0,0,,6232,-2944
19,05-07-17,5,1:00,1:15,44.34,,0,44.34,44.34,1,-96073,40640,136713,-55433,0,0,15668,0,0,,15668,15668
19,05-07-17,6,1:15,1:30,38.29,,0,38.29,38.29,1,-95575,47684,143259,-47891,0,0,37569,0,0,,37569,37569
19,05-07-17,7,1:30,1:45,40.19,,0,40.19,40.19,1,-105914,59658,165572,-46256,0,0,18176,0,0,,18176,18176
19,05-07-17,8,1:45,2:00,51.93,,0,51.93,51.93,1,-125610,63530,189140,-62080,0,0,41325,0,0,,41325,41325
19,05-07-17,9,2:00,2:15,51.93,26.6,0,26.6,26.6,-1,-17699,79423,97122,61724,0,-741,9157,0,0,,9898,8416
19,05-07-17,10,2:15,2:30,,24.19,0,24.19,24.19,-1,-23352,45894,69246,22542,0,-9488,0,0,0,,9488,-9488
19,05-07-17,11,2:30,2:45,,26.27,0,26.27,26.27,-1,-22734,43601,66335,20867,0,-11320,0,0,0,,11320,-11320
19,05-07-17,12,2:45,3:00,,27.46,0,27.46,27.46,-1,-24024,35362,59386,11338,0,-8268,0,0,0,,8268,-8268
19,05-07-17,13,3:00,3:15,,17.27,0,17.27,17.27,-1,-26153,60056,86209,33903,0,-20832,0,0,0,,20832,-20832
19,05-07-17,14,3:15,3:30,,17.27,0,17.27,17.27,-1,-23660,56448,80108,32788,0,-36694,0,0,0,,36694,-36694
19,05-07-17,15,3:30,3:45,,24.03,0,24.03,24.03,-1,-24333,54140,78473,29807,0,-21483,0,0,0,,21483,-21483
19,05-07-17,16,3:45,4:00,,19.02,0,19.02,19.02,-1,-20068,57330,77398,37262,0,-19807,0,0,0,,19807,-19807
19,05-07-17,17,4:00,4:15,,16.83,0,16.83,16.83,-1,-12866,76540,89406,63674,0,-21304,0,0,0,,21304,-21304
19,05-07-17,18,4:15,4:30,,,0,27.93,27.93,0,-11964,52662,64626,40698,0,-341,0,0,0,,341,-341
19,05-07-17,19,4:30,4:45,,,0,27.93,27.93,0,-9843,56783,66626,46940,0,0,0,0,0,,0,0
19,05-07-17,20,4:45,5:00,,14.29,0,14.29,14.29,-1,-9644,66690,76334,57046,0,-7302,0,0,0,,7302,-7302
19,05-07-17,21,5:00,5:15,,9.86,0,9.86,9.86,-1,-18949,60371,79320,41422,0,-14929,0,0,0,,14929,-14929
19,05-07-17,22,5:15,5:30,,26.27,0,26.27,26.27,-1,-18268,34807,53075,16539,0,-4631,0,0,0,,4631,-4631
19,05-07-17,23,5:30,5:45,,25.19,0,25.19,25.19,-1,-28687,45428,74115,16741,0,-8750,0,0,0,,8750,-8750
19,05-07-17,24,5:45,6:00,,21.21,0,21.21,21.21,-1,-19629,54529,74158,34900,0,-19264,0,0,0,,19264,-19264
19,05-07-17,25,6:00,6:15,,25.98,0,25.98,25.98,-1,-23433,59059,82492,35626,0,-15288,0,0,0,,15288,-15288
19,05-07-17,26,6:15,6:30,,15.81,0,15.81,15.81,-1,-23244,61236,84480,37992,0,-16605,0,0,0,,16605,-16605
19,05-07-17,27,6:30,6:45,,17.37,0,17.37,17.37,-1,-17384,59504,76888,42120,0,-38459,0,0,0,,38459,-38459
19,05-07-17,28,6:45,7:00,,24.03,0,24.03,24.03,-1,-23185,56889,80074,33704,0,-23227,0,0,0,,23227,-23227
19,05-07-17,29,7:00,7:15,,26.37,0,26.37,26.37,-1,-44442,69126,113568,24684,0,-877,0,0,0,,877,-877
19,05-07-17,30,7:15,7:30,,20.49,0,20.49,20.49,-1,-19297,66249,85546,46952,0,-10242,0,0,0,,10242,-10242
19,05-07-17,31,7:30,7:45,,20.28,0,20.28,20.28,-1,-14218,66456,80674,52238,0,-24762,0,0,0,,24762,-24762
19,05-07-17,32,7:45,8:00,,6.75,0,6.75,6.75,-1,-20668,86052,106720,65384,0,-46694,0,0,0,,46694,-46694
19,05-07-17,33,8:00,8:15,,17.37,0,17.37,17.37,-1,-52908,92803,145711,39895,0,-46821,0,0,0,,46821,-46821
19,05-07-17,34,8:15,8:30,,26.37,0,26.37,26.37,-1,-49553,79430,128983,29877,0,-16592,0,0,0,,16592,-16592
19,05-07-17,35,8:30,8:45,,28.21,0,28.21,28.21,-1,-46643,58126,104769,11483,0,-3819,0,0,0,,3819,-3819
19,05-07-17,36,8:45,9:00,29.87,,0,29.87,29.87,1,-57318,52641,109959,-4677,0,0,3293,0,0,,3293,3293
19,05-07-17,37,9:00,9:15,28.88,27.75,0,28.88,27.75,2,-62067,67210,129277,5143,0,-267,3033,0,0,,3300,2766
19,05-07-17,38,9:15,9:30,,27.37,0,27.37,27.37,-1,-54651,47292,101943,-7359,0,-2418,0,0,0,,2418,-2418
19,05-07-17,39,9:30,9:45,,29.79,0,29.79,29.79,-1,-65075,38782,103857,-26293,0,-136,0,0,0,,136,-136
19,05-07-17,40,9:45,10:00,,,0,28.41,28.41,0,-84379,38902,123281,-45477,0,0,0,0,0,,0,0
19,05-07-17,41,10:00,10:15,,,0,28.41,28.41,0,-79346,47685,127031,-31661,0,0,0,0,0,,0,0
19,05-07-17,42,10:15,10:30,30.34,,0,30.34,30.34,1,-79082,42204,121286,-36878,0,0,1592,0,0,,1592,1592
19,05-07-17,43,10:30,10:45,33.87,,0,33.87,33.87,1,-83854,40016,123870,-43838,0,0,5573,0,0,,5573,5573
19,05-07-17,44,10:45,11:00,29.87,,0,29.87,29.87,1,-83756,42052,125808,-41704,0,0,6460,0,0,,6460,6460
19,05-07-17,45,11:00,11:15,,,0,28.41,28.41,0,-79438,67975,147413,-11463,0,0,1103,0,0,,1103,1103
19,05-07-17,46,11:15,11:30,33.83,,0,33.83,33.83,1,-81823,60859,142682,-20964,0,0,1409,0,0,,1409,1409
19,05-07-17,47,11:30,11:45,32.27,,0,32.27,32.27,1,-82600,73325,155925,-9275,0,0,8085,0,0,,8085,8085
19,05-07-17,48,11:45,12:00,33.87,,0,33.87,33.87,1,-94973,70913,165886,-24060,0,0,14550,0,0,,14550,14550
19,05-07-17,49,12:00,12:15,39.87,,0,39.87,39.87,1,-104540,67771,172311,-36769,0,0,30753,0,0,,30753,30753
19,05-07-17,50,12:15,12:30,31.96,,0,31.96,31.96,1,-97405,65028,162433,-32377,0,0,20242,0,0,,20242,20242
19,05-07-17,51,12:30,12:45,28.85,,0,28.85,28.85,1,-84856,68822,153678,-16034,0,0,8207,0,0,,8207,8207
19,05-07-17,52,12:45,13:00,27.87,,0,27.87,27.87,1,-80387,67744,148131,-12643,0,0,2479,0,0,,2479,2479
19,05-07-17,53,13:00,13:15,28.88,,0,28.88,28.88,1,-76304,67419,143723,-8885,0,0,5726,0,0,,5726,5726
19,05-07-17,54,13:15,13:30,28.88,27.37,0,28.88,27.37,2,-67874,65548,133422,-2326,0,-48,5559,0,0,,5607,5511
19,05-07-17,55,13:30,13:45,28.88,20.83,0,20.83,20.83,-1,-52657,71608,124265,18951,0,-7017,60,0,0,,7077,-6957
19,05-07-17,56,13:45,14:00,,20.49,0,20.49,20.49,-1,-42011,70717,112728,28706,0,-20002,0,0,0,,20002,-20002
19,05-07-17,57,14:00,14:15,,26.37,0,26.37,26.37,-1,-41802,71770,113572,29968,0,-10008,0,0,0,,10008,-10008
19,05-07-17,58,14:15,14:30,,,0,27.83,27.83,0,-47854,70485,118339,22631,0,-243,0,0,0,,243,-243
19,05-07-17,59,14:30,14:45,,,0,27.84,27.84,0,-41676,81691,123367,40015,0,0,0,0,0,,0,0
19,05-07-17,60,14:45,15:00,,,0,27.84,27.84,0,-32963,87485,120448,54522,0,0,0,0,0,,0,0
19,05-07-17,61,15:00,15:15,,,0,27.81,27.81,0,-34400,71314,105714,36914,0,0,0,0,0,,0,0
19,05-07-17,62,15:15,15:30,,,0,27.81,27.81,0,-42684,71377,114061,28693,0,0,0,0,0,,0,0
19,05-07-17,63,15:30,15:45,,,0,27.82,27.82,0,-33125,83567,116692,50442,0,0,0,0,0,,0,0
19,05-07-17,64,15:45,16:00,,,0,27.82,27.82,0,-36887,88961,125848,52074,0,0,0,0,0,,0,0
19,05-07-17,65,16:00,16:15,,26.37,0,26.37,26.37,-1,-37901,119934,157835,82033,0,-1028,0,0,0,,1028,-1028
19,05-07-17,66,16:15,16:30,,26.37,0,26.37,26.37,-1,-37603,105200,142803,67597,0,-2915,0,0,0,,2915,-2915
19,05-07-17,67,16:30,16:45,,,0,27.82,27.82,0,-54548,84830,139378,30282,0,-99,0,0,0,,99,-99
19,05-07-17,68,16:45,17:00,,,0,27.81,27.81,0,-62071,83146,145217,21075,0,0,0,0,0,,0,0
19,05-07-17,69,17:00,17:15,,26.37,0,26.37,26.37,-1,-60055,114707,174762,54652,0,-1468,0,0,0,,1468,-1468
19,05-07-17,70,17:15,17:30,,26.37,0,26.37,26.37,-1,-37081,100727,137808,63646,0,-2437,0,0,0,,2437,-2437
19,05-07-17,71,17:30,17:45,,25.48,0,25.48,25.48,-1,-33025,77574,110599,44549,0,-1922,0,0,0,,1922,-1922
19,05-07-17,72,17:45,18:00,,,0,27.82,27.82,0,-32555,62503,95058,29948,0,-137,0,0,0,,137,-137
19,05-07-17,73,18:00,18:15,39.87,,0,39.87,39.87,1,-103454,70892,174346,-32562,0,0,8806,0,0,,8806,8806
19,05-07-17,74,18:15,18:30,29.05,,0,29.05,29.05,1,-58205,81098,139303,22893,0,0,2954,0,0,,2954,2954
19,05-07-17,75,18:30,18:45,,,0,27.85,27.85,0,-57448,75259,132707,17811,0,0,0,0,0,,0,0
19,05-07-17,76,18:45,19:00,,,0,27.86,27.86,0,-57671,75625,133296,17954,0,0,0,0,0,,0,0
19,05-07-17,77,19:00,19:15,38.29,,0,38.29,38.29,1,-105958,66371,172329,-39587,0,0,5653,0,0,,5653,5653
19,05-07-17,78,19:15,19:30,27.87,,0,27.87,27.87,1,-57147,73169,130316,16022,0,0,1332,0,0,,1332,1332
19,05-07-17,79,19:30,19:45,,,0,27.93,27.93,0,-58156,79813,137969,21657,0,0,0,0,0,,0,0
19,05-07-17,80,19:45,20:00,29.87,,0,29.87,29.87,1,-62991,68298,131289,5307,0,0,1643,0,0,,1643,1643
19,05-07-17,81,20:00,20:15,29.87,26.37,0,26.37,26.37,-1,-57980,93233,151213,35253,0,-3507,282,0,0,,3789,-3225
19,05-07-17,82,20:15,20:30,,22.37,0,22.37,22.37,-1,-53193,76572,129765,23379,0,-14210,0,0,0,,14210,-14210
19,05-07-17,83,20:30,20:45,,25.13,0,25.13,25.13,-1,-55533,82151,137684,26618,0,-14046,0,0,0,,14046,-14046
19,05-07-17,84,20:45,21:00,,14.29,0,14.29,14.29,-1,-43456,103208,146664,59752,0,-37853,0,0,0,,37853,-37853
19,05-07-17,85,21:00,21:15,,18.69,0,18.69,18.69,-1,-59391,74582,133973,15191,0,-27647,0,0,0,,27647,-27647
19,05-07-17,86,21:15,21:30,,27.37,0,27.37,27.37,-1,-54524,55023,109547,499,0,-4035,0,0,0,,4035,-4035
19,05-07-17,87,21:30,21:45,50.72,27.37,0,50.72,50.72,1,-77014,39441,116455,-37573,0,-200,14224,0,0,,14424,14024
19,05-07-17,88,21:45,22:00,39.02,,0,39.02,39.02,1,-71165,56362,127527,-14803,0,0,23190,0,0,,23190,23190
19,05-07-17,89,22:00,22:15,72.26,,0,72.26,72.26,1,-80422,41366,121788,-39056,0,0,9330,0,0,,9330,9330
19,05-07-17,90,22:15,22:30,39.02,44.87,0,44.87,44.87,-1,-69121,53103,122224,-16018,0,-33,14550,0,0,,14583,14517
19,05-07-17,91,22:30,22:45,39.02,26.37,0,26.37,26.37,-1,-64679,76109,140788,11430,0,-2283,1290,0,0,,3573,-993
19,05-07-17,92,22:45,23:00,,26.37,0,26.37,26.37,-1,-55278,80898,136176,25620,0,-1052,0,0,0,,1052,-1052
19,05-07-17,93,23:00,23:15,,27.37,0,27.37,27.37,-1,-50538,67577,118115,17039,0,-2115,0,0,0,,2115,-2115
19,05-07-17,94,23:15,23:30,,27.37,0,27.37,27.37,-1,-51020,64247,115267,13227,0,-1449,0,0,0,,1449,-1449
19,05-07-17,95,23:30,23:45,,27.05,0,27.05,27.05,-1,-34102,91444,125546,57342,0,-5301,0,0,0,,5301,-5301
19,05-07-17,96,23:45,0:00,,13.75,0,13.75,13.75,-1,-48070,99547,147617,51477,0,-18610,0,0,0,,18610,-18610
19,05-08-17,1,0:00,0:15,,-35.14,0,-35.14,-35.14,-1,-42054,125275,167329,83221,0,-42033,0,0,0,,42033,-42033
19,05-08-17,2,0:15,0:30,,-1.73,0,-1.73,-1.73,-1,-42313,81349,123662,39036,0,-14013,0,0,0,,14013,-14013
19,05-08-17,3,0:30,0:45,,0.55,0,0.55,0.55,-1,-34875,83026,117901,48151,0,-37652,0,0,0,,37652,-37652
19,05-08-17,4,0:45,1:00,,7.69,0,7.69,7.69,-1,-35207,87472,122679,52265,0,-47613,0,0,0,,47613,-47613
19,05-08-17,5,1:00,1:15,27.37,-8.78,0,27.37,27.37,1,-26723,62926,89649,36203,0,-31628,2,0,0,,31630,-31626
19,05-08-17,6,1:15,1:30,27.37,1.39,0,27.37,1.39,2,-29798,66130,95928,36332,0,-6764,220,0,0,,6984,-6544
19,05-08-17,7,1:30,1:45,,-13.78,0,-13.78,-13.78,-1,-28733,72362,101095,43629,0,-26857,0,0,0,,26857,-26857
19,05-08-17,8,1:45,2:00,,26.37,0,26.37,26.37,-1,-31052,77939,108991,46887,0,-17594,0,0,0,,17594,-17594
19,05-08-17,9,2:00,2:15,,21.78,0,21.78,21.78,-1,-32133,71535,103668,39402,0,-11671,0,0,0,,11671,-11671
19,05-08-17,10,2:15,2:30,,22.37,0,22.37,22.37,-1,-42426,60681,103107,18255,0,-9063,0,0,0,,9063,-9063
19,05-08-17,11,2:30,2:45,,22.37,0,22.37,22.37,-1,-43102,69651,112753,26549,0,-16350,0,0,0,,16350,-16350
19,05-08-17,12,2:45,3:00,,21.84,0,21.84,21.84,-1,-41495,65678,107173,24183,0,-23655,0,0,0,,23655,-23655
19,05-08-17,13,3:00,3:15,27.37,21.89,0,27.37,27.37,1,-37303,48813,86116,11510,0,-13855,96,0,0,,13951,-13759
19,05-08-17,14,3:15,3:30,27.37,28.28,0,28.28,28.28,-1,-45615,59352,104967,13737,0,-154,45,0,0,,199,-109
19,05-08-17,15,3:30,3:45,,27.8,0,27.8,27.8,-1,-52837,40643,93480,-12194,0,-1016,0,0,0,,1016,-1016
19,05-08-17,16,3:45,4:00,,25.57,0,25.57,25.57,-1,-51785,54457,106242,2672,0,-3108,0,0,0,,3108,-3108
19,05-08-17,17,4:00,4:15,,27.47,0,27.47,27.47,-1,-49692,77377,127069,27685,0,-2875,0,0,0,,2875,-2875
19,05-08-17,18,4:15,4:30,,,0,27.2,27.2,0,-50146,58847,108993,8701,0,0,0,0,0,,0,0
19,05-08-17,19,4:30,4:45,,,0,27.19,27.19,0,-50770,59470,110240,8700,0,0,0,0,0,,0,0
19,05-08-17,20,4:45,5:00,,,0,27.2,27.2,0,-49802,61197,110999,11395,0,0,0,0,0,,0,0
19,05-08-17,21,5:00,5:15,27.37,,0,27.37,27.37,1,-80287,78156,158443,-2131,0,0,938,0,0,,938,938
19,05-08-17,22,5:15,5:30,25.84,,0,25.84,25.84,1,-57865,78564,136429,20699,0,0,63,0,0,,63,63
19,05-08-17,23,5:30,5:45,,26.8,0,26.8,26.8,-1,-60679,67675,128354,6996,0,-1024,0,0,0,,1024,-1024
19,05-08-17,24,5:45,6:00,,26.37,0,26.37,26.37,-1,-58803,76102,134905,17299,0,-7156,0,0,0,,7156,-7156
19,05-08-17,25,6:00,6:15,29.65,28.45,0,29.65,27.38,2,-94900,59956,154856,-34944,0,-4771,660,0,0,,5431,-4111
19,05-08-17,26,6:15,6:30,,26.78,0,26.78,26.78,-1,-64320,58928,123248,-5392,0,-1939,0,0,0,,1939,-1939
19,05-08-17,27,6:30,6:45,27.65,28.88,0,27.65,27.65,1,-104112,47661,151773,-56451,0,-307,33,0,0,,340,-274
19,05-08-17,28,6:45,7:00,32.54,,0,32.54,32.54,1,-129752,49037,178789,-80715,0,0,5164,0,0,,5164,5164
19,05-08-17,29,7:00,7:15,46.27,,0,46.27,46.27,1,-108328,60247,168575,-48081,0,0,5363,0,0,,5363,5363
19,05-08-17,30,7:15,7:30,67.74,,0,67.74,67.74,1,-108590,48613,157203,-59977,0,0,37083,0,0,,37083,37083
19,05-08-17,31,7:30,7:45,32.94,27.82,0,27.82,27.82,-1,-90689,87368,178057,-3321,0,-362,16744,0,0,,17106,16382
19,05-08-17,32,7:45,8:00,33.65,27.19,0,33.65,27.19,2,-135917,114455,250372,-21462,0,-163,3320,0,0,,3483,3157
19,05-08-17,33,8:00,8:15,29.65,26.42,0,37.06,26.42,2,-80293,98845,179138,18552,0,-1824,1058,0,0,,2882,-766
19,05-08-17,34,8:15,8:30,,,0,37.05,37.05,0,-70487,97377,167864,26890,0,-8,0,0,0,,8,-8
19,05-08-17,35,8:30,8:45,,,0,36.99,36.99,0,-91642,99509,191151,7867,0,0,0,0,0,,0,0
19,05-08-17,36,8:45,9:00,47.15,,0,47.15,47.15,1,-119398,93591,212989,-25807,0,0,14886,0,0,,14886,14886
19,05-08-17,37,9:00,9:15,34.9,,0,34.9,34.9,1,-83141,60818,143959,-22323,0,0,22735,0,0,,22735,22735
19,05-08-17,38,9:15,9:30,145.22,,0,145.22,145.22,1,-116426,54818,171244,-61608,0,0,38298,0,0,,38298,38298
19,05-08-17,39,9:30,9:45,145.22,,0,145.22,145.22,1,-100871,68226,169097,-32645,0,0,47620,0,0,,47620,47620
19,05-08-17,40,9:45,10:00,34.9,29.54,0,37.05,29.54,2,-81289,82698,163987,1409,0,-419,6247,0,0,,6666,5828
19,05-08-17,41,10:00,10:15,54.8,,0,54.8,54.8,1,-93350,67918,161268,-25432,0,0,15430,0,0,,15430,15430
19,05-08-17,42,10:15,10:30,43.8,,0,43.8,43.8,1,-86550,60184,146734,-26366,0,0,18408,0,0,,18408,18408
19,05-08-17,43,10:30,10:45,38.8,,0,38.8,38.8,1,-81924,58024,139948,-23900,0,0,28644,0,0,,28644,28644
19,05-08-17,44,10:45,11:00,38.8,,0,38.8,38.8,1,-75631,53054,128685,-22577,0,0,26013,0,0,,26013,26013
19,05-08-17,45,11:00,11:15,39.44,,0,39.44,39.44,1,-73847,39494,113341,-34353,0,0,23119,0,0,,23119,23119
19,05-08-17,46,11:15,11:30,102.54,,0,102.54,102.54,1,-84949,39338,124287,-45611,0,0,34675,0,0,,34675,34675
19,05-08-17,47,11:30,11:45,102.54,,0,102.54,102.54,1,-73690,37744,111434,-35946,0,0,47528,0,0,,47528,47528
19,05-08-17,48,11:45,12:00,112.8,,0,112.8,112.8,1,-79701,32036,111737,-47665,0,0,41090,0,0,,41090,41090
19,05-08-17,49,12:00,12:15,141.17,,0,141.17,141.17,1,-195154,13837,208991,-181317,0,0,77360,0,0,,77360,77360
19,05-08-17,50,12:15,12:30,141.17,,0,141.17,141.17,1,-135328,39525,174853,-95803,0,0,62651,0,0,,62651,62651
19,05-08-17,51,12:30,12:45,29.79,29.51,0,29.79,29.35,2,-67738,58241,125979,-9497,0,-24,2582,0,0,,2606,2558
19,05-08-17,52,12:45,13:00,30.34,,0,30.34,30.34,1,-68396,64639,133035,-3757,0,0,3279,0,0,,3279,3279
19,05-08-17,53,13:00,13:15,,,0,30.76,30.76,0,-33838,101501,135339,67663,0,0,234,0,0,,234,234
19,05-08-17,54,13:15,13:30,,,0,29.31,29.31,0,-24751,125465,150216,100714,0,0,0,0,0,,0,0
19,05-08-17,55,13:30,13:45,,,0,29.34,29.34,0,-9557,125097,134654,115540,0,0,0,0,0,,0,0
19,05-08-17,56,13:45,14:00,,27.78,0,27.78,27.78,-1,-5527,132527,138054,127000,0,-2158,0,0,0,,2158,-2158
19,05-08-17,57,14:00,14:15,,28.48,0,28.48,28.48,-1,-30292,167893,198185,137601,0,-1967,0,0,0,,1967,-1967
19,05-08-17,58,14:15,14:30,,27.42,0,27.42,27.42,-1,-25632,160082,185714,134450,0,-424,0,0,0,,424,-424
19,05-08-17,59,14:30,14:45,,17.42,0,17.42,17.42,-1,-17024,203915,220939,186891,0,-12622,0,0,0,,12622,-12622
19,05-08-17,60,14:45,15:00,,10.89,0,10.89,10.89,-1,-21439,210370,231809,188931,0,-47689,0,0,0,,47689,-47689
19,05-08-17,61,15:00,15:15,,23.13,0,23.13,23.13,-1,-56997,174461,231458,117464,0,-23787,0,0,0,,23787,-23787
19,05-08-17,62,15:15,15:30,,25.64,0,25.64,25.64,-1,-61525,196628,258153,135103,0,-29904,0,0,0,,29904,-29904
19,05-08-17,63,15:30,15:45,,24.13,0,24.13,24.13,-1,-57428,208357,265785,150929,0,-28849,0,0,0,,28849,-28849
19,05-08-17,64,15:45,16:00,,2.53,0,2.53,2.53,-1,-51206,202265,253471,151059,0,-57031,0,0,0,,57031,-57031
19,05-08-17,65,16:00,16:15,,27.86,0,27.86,27.86,-1,-67709,170693,238402,102984,0,-12687,0,0,0,,12687,-12687
19,05-08-17,66,16:15,16:30,,30.14,0,30.14,30.14,-1,-63366,215915,279281,152549,0,-643,0,0,0,,643,-643
19,05-08-17,67,16:30,16:45,,26.42,0,26.42,26.42,-1,-55847,220664,276511,164817,0,-5300,0,0,0,,5300,-5300
19,05-08-17,68,16:45,17:00,,25.78,0,25.78,25.78,-1,-49464,209149,258613,159685,0,-8747,0,0,0,,8747,-8747
19,05-08-17,69,17:00,17:15,,28.37,0,28.37,28.37,-1,-82060,184734,266794,102674,0,-5804,0,0,0,,5804,-5804
19,05-08-17,70,17:15,17:30,,27.34,0,27.34,27.34,-1,-82835,195983,278818,113148,0,-7320,0,0,0,,7320,-7320
19,05-08-17,71,17:30,17:45,,22.42,0,22.42,22.42,-1,-60174,200309,260483,140135,0,-16929,0,0,0,,16929,-16929
19,05-08-17,72,17:45,18:00,,18.46,0,18.46,18.46,-1,-50388,203861,254249,153473,0,-18105,0,0,0,,18105,-18105
19,05-08-17,73,18:00,18:15,,-7.36,0,-7.36,-7.36,-1,-43132,170413,213545,127281,0,-52030,0,0,0,,52030,-52030
19,05-08-17,74,18:15,18:30,,22.42,0,22.42,22.42,-1,-44781,176943,221724,132162,0,-18053,0,0,0,,18053,-18053
19,05-08-17,75,18:30,18:45,,-40.06,0,-40.06,-40.06,-1,-37234,167226,204460,129992,0,-45079,0,0,0,,45079,-45079
19,05-08-17,76,18:45,19:00,,28.53,0,28.53,28.53,-1,-29743,165258,195001,135515,0,-6350,0,0,0,,6350,-6350
19,05-08-17,77,19:00,19:15,,11.65,0,11.65,11.65,-1,-51299,142103,193402,90804,0,-21326,0,0,0,,21326,-21326
19,05-08-17,78,19:15,19:30,,22.78,0,22.78,22.78,-1,-58875,112579,171454,53704,0,-19198,0,0,0,,19198,-19198
19,05-08-17,79,19:30,19:45,,27.69,0,27.69,27.69,-1,-55475,111056,166531,55581,0,-6440,0,0,0,,6440,-6440
19,05-08-17,80,19:45,20:00,29.65,27.69,0,29.65,29.65,1,-67132,73207,140339,6075,0,-1298,580,0,0,,1878,-718
19,05-08-17,81,20:00,20:15,29.65,28.37,0,28.37,28.37,-1,-59514,72816,132330,13302,0,-332,1217,0,0,,1549,885
19,05-08-17,82,20:15,20:30,,26.26,0,26.26,26.26,-1,-58021,70792,128813,12771,0,-6513,0,0,0,,6513,-6513
19,05-08-17,83,20:30,20:45,,28.86,0,28.86,28.86,-1,-63371,65903,129274,2532,0,-2492,0,0,0,,2492,-2492
19,05-08-17,84,20:45,21:00,29.65,28.85,0,29.65,28.57,2,-64844,46972,111816,-17872,0,-423,1330,0,0,,1753,907
19,05-08-17,85,21:00,21:15,27.99,,0,27.99,27.99,1,-31499,101866,133365,70367,0,0,346,0,0,,346,346
19,05-08-17,86,21:15,21:30,,,0,30.34,30.34,0,-35541,68656,104197,33115,0,0,0,0,0,,0,0
19,05-08-17,87,21:30,21:45,35.04,,0,35.04,35.04,1,-74955,50979,125934,-23976,0,0,4104,0,0,,4104,4104
19,05-08-17,88,21:45,22:00,43.99,,0,43.99,43.99,1,-88924,44820,133744,-44104,0,0,20649,0,0,,20649,20649
19,05-08-17,89,22:00,22:15,43.99,28.34,0,28.34,28.34,-1,-73737,65062,138799,-8675,0,-650,1899,0,0,,2549,1249
19,05-08-17,90,22:15,22:30,,28.34,0,28.34,28.34,-1,-64552,53655,118207,-10897,0,-78,0,0,0,,78,-78
19,05-08-17,91,22:30,22:45,,28.34,0,28.34,28.34,-1,-50357,67563,117920,17206,0,-3017,0,0,0,,3017,-3017
19,05-08-17,92,22:45,23:00,,22.42,0,22.42,22.42,-1,-44159,83366,127525,39207,0,-11555,0,0,0,,11555,-11555
19,05-08-17,93,23:00,23:15,39.65,26.29,0,39.65,26.29,2,-70134,41273,111407,-28861,0,-8899,3781,0,0,,12680,-5118
19,05-08-17,94,23:15,23:30,29.05,,0,29.05,29.05,1,-57830,43226,101056,-14604,0,0,2110,0,0,,2110,2110
19,05-08-17,95,23:30,23:45,29.47,29.51,0,29.47,28.58,2,-59709,37318,97027,-22391,0,-89,1008,0,0,,1097,919
19,05-08-17,96,23:45,0:00,29.13,28.4,0,29.13,28.4,2,-60396,48769,109165,-11627,0,-35,1527,0,0,,1562,1492
19,05-09-17,1,0:00,0:15,,26.69,0,26.69,26.69,-1,-49775,80193,129968,30418,0,-487,0,0,0,,487,-487
19,05-09-17,2,0:15,0:30,,,0,29.49,29.49,0,-29790,72773,102563,42983,0,0,0,0,0,,0,0
19,05-09-17,3,0:30,0:45,,27.43,0,27.43,27.43,-1,-22364,47448,69812,25084,0,-1326,0,0,0,,1326,-1326
19,05-09-17,4,0:45,1:00,,27.78,0,27.78,27.78,-1,-29202,54815,84017,25613,0,-5992,0,0,0,,5992,-5992
19,05-09-17,5,1:00,1:15,,28.24,0,28.24,28.24,-1,-26607,55263,81870,28656,0,-2881,0,0,0,,2881,-2881
19,05-09-17,6,1:15,1:30,26.98,,0,26.98,26.98,1,-17516,36472,53988,18956,0,0,7,0,0,,7,7
19,05-09-17,7,1:30,1:45,28.44,,0,28.44,28.44,1,-23485,28999,52484,5514,0,0,1052,0,0,,1052,1052
19,05-09-17,8,1:45,2:00,28.44,,0,28.44,28.44,1,-21290,28356,49646,7066,0,0,935,0,0,,935,935
19,05-09-17,9,2:00,2:15,,27.3,0,27.3,27.3,-1,-26171,50660,76831,24489,0,-1958,0,0,0,,1958,-1958
19,05-09-17,10,2:15,2:30,,26.98,0,26.98,26.98,-1,-32919,49015,81934,16096,0,-3216,0,0,0,,3216,-3216
19,05-09-17,11,2:30,2:45,,27.87,0,27.87,27.87,-1,-27130,47667,74797,20537,0,-1078,0,0,0,,1078,-1078
19,05-09-17,12,2:45,3:00,,,0,27.63,27.63,0,-31551,41577,73128,10026,0,0,0,0,0,,0,0
19,05-09-17,13,3:00,3:15,,,0,27.63,27.63,0,-37774,53465,91239,15691,0,0,0,0,0,,0,0
19,05-09-17,14,3:15,3:30,,,0,27.63,27.63,0,-33633,48698,82331,15065,0,0,0,0,0,,0,0
19,05-09-17,15,3:30,3:45,,28.27,0,28.27,28.27,-1,-23482,52679,76161,29197,0,-317,0,0,0,,317,-317
19,05-09-17,16,3:45,4:00,,28.27,0,28.27,28.27,-1,-30501,47328,77829,16827,0,-234,0,0,0,,234,-234
19,05-09-17,17,4:00,4:15,26.98,,0,26.98,26.98,1,-25909,44431,70340,18522,0,0,78,0,0,,78,78
19,05-09-17,18,4:15,4:30,,,0,27.63,27.63,0,-22711,44130,66841,21419,0,0,0,0,0,,0,0
19,05-09-17,19,4:30,4:45,,,0,27.62,27.62,0,-19480,40334,59814,20854,0,0,0,0,0,,0,0
19,05-09-17,20,4:45,5:00,28.98,,0,28.98,28.98,1,-31203,48470,79673,17267,0,0,421,0,0,,421,421
19,05-09-17,21,5:00,5:15,28.98,,0,28.98,28.98,1,-91168,55856,147024,-35312,0,0,2342,0,0,,2342,2342
19,05-09-17,22,5:15,5:30,32.98,,0,32.98,32.98,1,-69414,39005,108419,-30409,0,0,1479,0,0,,1479,1479
19,05-09-17,23,5:30,5:45,38.98,,0,38.98,38.98,1,-46337,25739,72076,-20598,0,0,7481,0,0,,7481,7481
19,05-09-17,24,5:45,6:00,28.98,,0,28.98,28.98,1,-69673,43465,113138,-26208,0,0,6070,0,0,,6070,6070
19,05-09-17,25,6:00,6:15,28.59,26.06,0,36.75,26.06,2,-28283,52640,80923,24357,0,-2166,2736,0,0,,4902,570
19,05-09-17,26,6:15,6:30,,27.2,0,27.2,27.2,-1,-28057,34293,62350,6236,0,-559,0,0,0,,559,-559
19,05-09-17,27,6:30,6:45,28.47,,0,28.47,28.47,1,-52316,15261,67577,-37055,0,0,169,0,0,,169,169
19,05-09-17,28,6:45,7:00,48.83,,0,48.83,48.83,1,-79768,28353,108121,-51415,0,0,9091,0,0,,9091,9091
19,05-09-17,29,7:00,7:15,30.45,24.1,0,36.76,24.1,2,-49745,82796,132541,33051,0,-2214,3157,0,0,,5371,943
19,05-09-17,30,7:15,7:30,30.45,24.1,0,30.45,30.45,1,-50085,33482,83567,-16603,0,-65,603,0,0,,668,538
19,05-09-17,31,7:30,7:45,29.91,,0,29.91,29.91,1,-61505,28407,89912,-33098,0,0,2854,0,0,,2854,2854
19,05-09-17,32,7:45,8:00,36.79,,0,36.79,36.79,1,-90236,34878,125114,-55358,0,0,6365,0,0,,6365,6365
19,05-09-17,33,8:00,8:15,36.79,26.06,0,26.06,26.06,-1,-57329,82759,140088,25430,0,-2905,2589,0,0,,5494,-316
19,05-09-17,34,8:15,8:30,,26.04,0,26.04,26.04,-1,-38492,76366,114858,37874,0,-4493,0,0,0,,4493,-4493
19,05-09-17,35,8:30,8:45,,18.33,0,18.33,18.33,-1,-32161,70076,102237,37915,0,-27489,0,0,0,,27489,-27489
19,05-09-17,36,8:45,9:00,,26.43,0,26.43,26.43,-1,-46489,76408,122897,29919,0,-18654,0,0,0,,18654,-18654
19,05-09-17,37,9:00,9:15,,26.04,0,26.04,26.04,-1,-37724,73707,111431,35983,0,-21224,0,0,0,,21224,-21224
19,05-09-17,38,9:15,9:30,,17.06,0,17.06,17.06,-1,-33387,60620,94007,27233,0,-30589,0,0,0,,30589,-30589
19,05-09-17,39,9:30,9:45,,13.92,0,13.92,13.92,-1,-25869,68573,94442,42704,0,-29866,0,0,0,,29866,-29866
19,05-09-17,40,9:45,10:00,,13.92,0,13.92,13.92,-1,-38498,64352,102850,25854,0,-34510,0,0,0,,34510,-34510
19,05-09-17,41,10:00,10:15,50.75,13.92,0,50.75,50.75,1,-98517,76198,174715,-22319,0,-4173,820,0,0,,4993,-3353
19,05-09-17,42,10:15,10:30,,,0,29.37,29.37,0,-64828,60386,125214,-4442,0,0,0,0,0,,0,0
19,05-09-17,43,10:30,10:45,,,0,29.37,29.37,0,-70901,57995,128896,-12906,0,0,0,0,0,,0,0
19,05-09-17,44,10:45,11:00,,,0,28.79,28.79,0,-66388,49080,115468,-17308,0,0,0,0,0,,0,0
19,05-09-17,45,11:00,11:15,,,0,28.76,28.76,0,-91672,58999,150671,-32673,0,0,0,0,0,,0,0
19,05-09-17,46,11:15,11:30,29.42,,0,29.42,29.42,1,-105313,35388,140701,-69925,0,0,116,0,0,,116,116
19,05-09-17,47,11:30,11:45,30.48,,0,30.48,30.48,1,-105367,29998,135365,-75369,0,0,4366,0,0,,4366,4366
19,05-09-17,48,11:45,12:00,33.83,,0,33.83,33.83,1,-122510,24892,147402,-97618,0,0,11909,0,0,,11909,11909
19,05-09-17,49,12:00,12:15,40.99,,0,40.99,40.99,1,-150037,29305,179342,-120732,0,0,19404,0,0,,19404,19404
19,05-09-17,50,12:15,12:30,31.63,,0,31.63,31.63,1,-148759,33640,182399,-115119,0,0,20239,0,0,,20239,20239
19,05-09-17,51,12:30,12:45,35.63,,0,35.63,35.63,1,-148051,28537,176588,-119514,0,0,20699,0,0,,20699,20699
19,05-09-17,52,12:45,13:00,35.63,,0,35.63,35.63,1,-136598,31094,167692,-105504,0,0,21375,0,0,,21375,21375
19,05-09-17,53,13:00,13:15,34.19,,0,34.19,34.19,1,-145916,44790,190706,-101126,0,0,11628,0,0,,11628,11628
19,05-09-17,54,13:15,13:30,44,,0,44,44,1,-141587,42198,183785,-99389,0,0,17828,0,0,,17828,17828
19,05-09-17,55,13:30,13:45,28.54,,0,28.54,28.54,1,-116043,41302,157345,-74741,0,0,7037,0,0,,7037,7037
19,05-09-17,56,13:45,14:00,,,0,28.39,28.39,0,-125301,43645,168946,-81656,0,0,70,0,0,,70,70
19,05-09-17,57,14:00,14:15,33.7,,0,33.7,33.7,1,-121941,55937,177878,-66004,0,0,4645,0,0,,4645,4645
19,05-09-17,58,14:15,14:30,28.49,,0,28.49,28.49,1,-113551,53749,167300,-59802,0,0,3950,0,0,,3950,3950
19,05-09-17,59,14:30,14:45,,,0,28.37,28.37,0,-96670,51175,147845,-45495,0,0,319,0,0,,319,319
19,05-09-17,60,14:45,15:00,,,0,28.37,28.37,0,-85865,55914,141779,-29951,0,0,0,0,0,,0,0
19,05-09-17,61,15:00,15:15,,,0,28.37,28.37,0,-85585,41431,127016,-44154,0,0,0,0,0,,0,0
19,05-09-17,62,15:15,15:30,,,0,28.37,28.37,0,-80905,47890,128795,-33015,0,0,0,0,0,,0,0
19,05-09-17,63,15:30,15:45,29.2,,0,29.2,29.2,1,-78127,44098,122225,-34029,0,0,234,0,0,,234,234
19,05-09-17,64,15:45,16:00,,,0,28.37,28.37,0,-78347,37001,115348,-41346,0,0,0,0,0,,0,0
19,05-09-17,65,16:00,16:15,,27.9,0,27.9,27.9,-1,-74653,66806,141459,-7847,0,-1850,0,0,0,,1850,-1850
19,05-09-17,66,16:15,16:30,,27.06,0,27.06,27.06,-1,-60672,54110,114782,-6562,0,-7861,0,0,0,,7861,-7861
19,05-09-17,67,16:30,16:45,,28.75,0,28.75,28.75,-1,-56873,47323,104196,-9550,0,-1814,0,0,0,,1814,-1814
19,05-09-17,68,16:45,17:00,29.91,,0,29.91,29.91,1,-79963,39512,119475,-40451,0,0,3699,0,0,,3699,3699
19,05-09-17,69,17:00,17:15,,,0,29.52,29.52,0,-65429,28990,94419,-36439,0,0,849,0,0,,849,849
19,05-09-17,70,17:15,17:30,29.64,,0,29.64,29.64,1,-85041,28907,113948,-56134,0,0,131,0,0,,131,131
19,05-09-17,71,17:30,17:45,45.64,,0,45.64,45.64,1,-96371,38692,135063,-57679,0,0,7538,0,0,,7538,7538
19,05-09-17,72,17:45,18:00,73.5,,0,73.5,73.5,1,-80071,38185,118256,-41886,0,0,32726,0,0,,32726,32726
19,05-09-17,73,18:00,18:15,30.23,,0,30.23,30.23,1,-140558,12431,152989,-128127,0,0,13266,0,0,,13266,13266
19,05-09-17,74,18:15,18:30,29.7,,0,29.7,29.7,1,-117529,22139,139668,-95390,0,0,7454,0,0,,7454,7454
19,05-09-17,75,18:30,18:45,29.52,,0,29.52,29.52,1,-110649,24895,135544,-85754,0,0,1821,0,0,,1821,1821
19,05-09-17,76,18:45,19:00,29.7,,0,29.7,29.7,1,-95976,40292,136268,-55684,0,0,408,0,0,,408,408
19,05-09-17,77,19:00,19:15,29.7,,0,29.7,29.7,1,-78295,28544,106839,-49751,0,0,327,0,0,,327,327
19,05-09-17,78,19:15,19:30,,,0,30.14,30.14,0,-83409,32445,115854,-50964,0,0,0,0,0,,0,0
19,05-09-17,79,19:30,19:45,30.5,,0,30.5,30.5,1,-88972,28922,117894,-60050,0,0,682,0,0,,682,682
19,05-09-17,80,19:45,20:00,40.99,,0,40.99,40.99,1,-100349,32713,133062,-67636,0,0,2896,0,0,,2896,2896
19,05-09-17,81,20:00,20:15,107.41,,0,107.41,107.41,1,-90354,18232,108586,-72122,0,0,27945,0,0,,27945,27945
19,05-09-17,82,20:15,20:30,31.33,,0,31.33,31.33,1,-75693,30446,106139,-45247,0,0,11821,0,0,,11821,11821
19,05-09-17,83,20:30,20:45,,,0,37.27,37.27,0,-68918,29539,98457,-39379,0,0,204,0,0,,204,204
19,05-09-17,84,20:45,21:00,,,0,37.27,37.27,0,-63961,26768,90729,-37193,0,0,0,0,0,,0,0
19,05-09-17,85,21:00,21:15,,28.96,0,28.96,28.96,-1,-33289,61977,95266,28688,0,-931,0,0,0,,931,-931
19,05-09-17,86,21:15,21:30,,,0,37.3,37.3,0,-45489,50832,96321,5343,0,0,0,0,0,,0,0
19,05-09-17,87,21:30,21:45,41.93,,0,41.93,41.93,1,-75949,35409,111358,-40540,0,0,3695,0,0,,3695,3695
19,05-09-17,88,21:45,22:00,29.7,,0,29.7,29.7,1,-88064,27287,115351,-60777,0,0,5249,0,0,,5249,5249
19,05-09-17,89,22:00,22:15,182.7,,0,182.7,182.7,1,-111623,29512,141135,-82111,0,0,29673,0,0,,29673,29673
19,05-09-17,90,22:15,22:30,47.59,,0,47.59,47.59,1,-63918,31251,95169,-32667,0,0,45816,0,0,,45816,45816
19,05-09-17,91,22:30,22:45,47.59,27.2,0,27.2,27.2,-1,-38219,52420,90639,14201,0,-522,9027,0,0,,9549,8505
19,05-09-17,92,22:45,23:00,,29.02,0,29.02,29.02,-1,-37273,71787,109060,34514,0,-59,0,0,0,,59,-59
19,05-09-17,93,23:00,23:15,29.66,28.02,0,29.66,28.02,2,-63591,48924,112515,-14667,0,-196,260,0,0,,456,64
19,05-09-17,94,23:15,23:30,,28.01,0,28.01,28.01,-1,-36451,38048,74499,1597,0,-134,0,0,0,,134,-134
19,05-09-17,95,23:30,23:45,,27.91,0,27.91,27.91,-1,-29186,48894,78080,19708,0,-443,0,0,0,,443,-443
19,05-09-17,96,23:45,0:00,,22.06,0,22.06,22.06,-1,-26864,59943,86807,33079,0,-14734,0,0,0,,14734,-14734
19,05-10-17,1,0:00,0:15,27.92,26.64,0,27.92,27.92,1,-56550,50107,106657,-6443,0,-9646,208,0,0,,9854,-9438
19,05-10-17,2,0:15,0:30,28.73,26.64,0,28.73,28.73,1,-39232,33086,72318,-6146,0,-57,1380,0,0,,1437,1323
19,05-10-17,3,0:30,0:45,28.73,25.64,0,25.64,25.64,-1,-26446,28991,55437,2545,0,-1382,8,0,0,,1390,-1374
19,05-10-17,4,0:45,1:00,,23.5,0,23.5,23.5,-1,-24558,59253,83811,34695,0,-20213,0,0,0,,20213,-20213
19,05-10-17,5,1:00,1:15,29.92,27.56,0,29.92,27.56,2,-47392,9206,56598,-38186,0,-9364,996,0,0,,10360,-8368
19,05-10-17,6,1:15,1:30,29.92,27.79,0,27.79,27.79,-1,-24026,18380,42406,-5646,0,-256,85,0,0,,341,-171
19,05-10-17,7,1:30,1:45,,27.2,0,27.2,27.2,-1,-14229,26184,40413,11955,0,-2949,0,0,0,,2949,-2949
19,05-10-17,8,1:45,2:00,,26.64,0,26.64,26.64,-1,-18693,27821,46514,9128,0,-6670,0,0,0,,6670,-6670
19,05-10-17,9,2:00,2:15,32.64,26.64,0,32.64,32.64,1,-39073,20934,60007,-18139,0,-2155,3821,0,0,,5976,1666
19,05-10-17,10,2:15,2:30,28.64,,0,28.64,28.64,1,-33019,19063,52082,-13956,0,0,5678,0,0,,5678,5678
19,05-10-17,11,2:30,2:45,28.64,,0,28.64,28.64,1,-27833,15308,43141,-12525,0,0,4058,0,0,,4058,4058
19,05-10-17,12,2:45,3:00,28.64,27.26,0,28.64,27.26,2,-15799,24765,40564,8966,0,-240,4692,0,0,,4932,4452
19,05-10-17,13,3:00,3:15,28.64,27.12,0,28.64,27.12,2,-21352,23644,44996,2292,0,-382,1136,0,0,,1518,754
19,05-10-17,14,3:15,3:30,28.64,,0,28.64,28.64,1,-19446,19930,39376,484,0,0,2633,0,0,,2633,2633
19,05-10-17,15,3:30,3:45,28.64,,0,28.64,28.64,1,-22035,17731,39766,-4304,0,0,1680,0,0,,1680,1680
19,05-10-17,16,3:45,4:00,28.64,,0,28.64,28.64,1,-28255,19755,48010,-8500,0,0,1890,0,0,,1890,1890
19,05-10-17,17,4:00,4:15,28.64,,0,28.64,28.64,1,-36742,24396,61138,-12346,0,0,5003,0,0,,5003,5003
19,05-10-17,18,4:15,4:30,28.64,,0,28.64,28.64,1,-36889,20340,57229,-16549,0,0,8965,0,0,,8965,8965
19,05-10-17,19,4:30,4:45,28.64,,0,28.64,28.64,1,-29748,28522,58270,-1226,0,0,5324,0,0,,5324,5324
19,05-10-17,20,4:45,5:00,26.64,,0,26.64,26.64,1,-31168,30970,62138,-198,0,0,1645,0,0,,1645,1645
19,05-10-17,21,5:00,5:15,26.64,,0,26.64,26.64,1,-11464,44378,55842,32914,0,0,215,0,0,,215,215
19,05-10-17,22,5:15,5:30,28.64,,0,28.64,28.64,1,-25129,34757,59886,9628,0,0,429,0,0,,429,429
19,05-10-17,23,5:30,5:45,28.78,,0,28.78,28.78,1,-39129,36534,75663,-2595,0,0,3183,0,0,,3183,3183
19,05-10-17,24,5:45,6:00,,12.16,0,12.16,12.16,-1,-46443,53593,100036,7150,0,-1611,0,0,0,,1611,-1611
19,05-10-17,25,6:00,6:15,,-22.1,0,-22.1,-22.1,-1,-29059,56849,85908,27790,0,-25142,0,0,0,,25142,-25142
19,05-10-17,26,6:15,6:30,,28.78,0,28.78,28.78,-1,-30444,38103,68547,7659,0,-1957,0,0,0,,1957,-1957
19,05-10-17,27,6:30,6:45,29.61,29.89,0,36.64,29.89,2,-61153,29002,90155,-32151,0,-344,1039,0,0,,1383,695
19,05-10-17,28,6:45,7:00,182.61,,0,182.61,182.61,1,-100942,39677,140619,-61265,0,0,20182,0,0,,20182,20182
19,05-10-17,29,7:00,7:15,37.09,11.02,0,37.09,11.02,2,-27468,99341,126809,71873,0,-10580,8042,0,0,,18622,-2538
19,05-10-17,30,7:15,7:30,29.87,26.58,0,29.87,29.87,1,-45270,52886,98156,7616,0,-11256,103,0,0,,11359,-11153
19,05-10-17,31,7:30,7:45,29.98,26.58,0,29.98,29.98,1,-91697,30897,122594,-60800,0,-177,858,0,0,,1035,681
19,05-10-17,32,7:45,8:00,250,,0,250,250,1,-156913,38040,194953,-118873,0,0,22918,0,0,,22918,22918
19,05-10-17,33,8:00,8:15,55.87,21.66,0,55.87,21.66,2,-68772,46009,114781,-22763,0,-1234,7903,0,0,,9137,6669
19,05-10-17,34,8:15,8:30,60.87,,0,60.87,60.87,1,-66702,31626,98328,-35076,0,0,12542,0,0,,12542,12542
19,05-10-17,35,8:30,8:45,71.87,,0,71.87,71.87,1,-94784,33605,128389,-61179,0,0,13180,0,0,,13180,13180
19,05-10-17,36,8:45,9:00,154.06,,0,154.06,154.06,1,-132476,34231,166707,-98245,0,0,34534,0,0,,34534,34534
19,05-10-17,37,9:00,9:15,53.85,42.05,0,42.05,42.05,-1,-36595,37271,73866,676,0,-132,20384,0,0,,20516,20252
19,05-10-17,38,9:15,9:30,53.85,41.87,0,41.87,41.87,-1,-37298,37653,74951,355,0,-516,117,0,0,,633,-399
19,05-10-17,39,9:30,9:45,,30.59,0,30.59,30.59,-1,-35800,39522,75322,3722,0,-3283,0,0,0,,3283,-3283
19,05-10-17,40,9:45,10:00,,42.03,0,42.03,42.03,-1,-48438,35075,83513,-13363,0,-3720,0,0,0,,3720,-3720
19,05-10-17,41,10:00,10:15,38.11,42.03,0,38.11,38.11,1,-51848,47971,99819,-3877,0,-307,1876,0,0,,2183,1569
19,05-10-17,42,10:15,10:30,28.79,,0,28.79,28.79,1,-47551,47473,95024,-78,0,0,445,0,0,,445,445
19,05-10-17,43,10:30,10:45,28.48,42.32,0,42.32,42.32,-1,-43880,44184,88064,304,0,-1073,188,0,0,,1261,-885
19,05-10-17,44,10:45,11:00,,30.59,0,30.59,30.59,-1,-42063,44379,86442,2316,0,-2507,0,0,0,,2507,-2507
19,05-10-17,45,11:00,11:15,,45.35,0,45.35,45.35,-1,-51390,49219,100609,-2171,0,-975,0,0,0,,975,-975
19,05-10-17,46,11:15,11:30,,,0,37.17,37.17,0,-51973,60039,112012,8066,0,0,0,0,0,,0,0
19,05-10-17,47,11:30,11:45,,45.86,0,45.86,45.86,-1,-37852,62087,99939,24235,0,-80,0,0,0,,80,-80
19,05-10-17,48,11:45,12:00,,45.86,0,45.86,45.86,-1,-38022,71257,109279,33235,0,-255,0,0,0,,255,-255
19,05-10-17,49,12:00,12:15,,27.16,0,27.16,27.16,-1,-34856,67878,102734,33022,0,-263,0,0,0,,263,-263
19,05-10-17,50,12:15,12:30,,21.66,0,21.66,21.66,-1,-29953,83417,113370,53464,0,-17175,0,0,0,,17175,-17175
19,05-10-17,51,12:30,12:45,,24.66,0,24.66,24.66,-1,-19684,78699,98383,59015,0,-22976,0,0,0,,22976,-22976
19,05-10-17,52,12:45,13:00,,4.78,0,4.78,4.78,-1,-19711,83348,103059,63637,0,-39358,0,0,0,,39358,-39358
19,05-10-17,53,13:00,13:15,28.89,17.37,0,28.89,28.89,1,-55320,59392,114712,4072,0,-24886,107,0,0,,24993,-24779
19,05-10-17,54,13:15,13:30,28.89,26.24,0,37.27,26.24,2,-42236,56851,99087,14615,0,-2521,23,0,0,,2544,-2498
19,05-10-17,55,13:30,13:45,,28.07,0,28.07,28.07,-1,-32012,74510,106522,42498,0,-1878,0,0,0,,1878,-1878
19,05-10-17,56,13:45,14:00,,16.66,0,16.66,16.66,-1,-20422,89430,109852,69008,0,-7771,0,0,0,,7771,-7771
19,05-10-17,57,14:00,14:15,,25.79,0,25.79,25.79,-1,-30042,97876,127918,67834,0,-7814,0,0,0,,7814,-7814
19,05-10-17,58,14:15,14:30,,26.66,0,26.66,26.66,-1,-39840,113158,152998,73318,0,-528,0,0,0,,528,-528
19,05-10-17,59,14:30,14:45,,7.11,0,7.11,7.11,-1,-33591,120960,154551,87369,0,-6077,0,0,0,,6077,-6077
19,05-10-17,60,14:45,15:00,,-8.61,0,-8.61,-8.61,-1,-45616,95579,141195,49963,0,-39000,0,0,0,,39000,-39000
19,05-10-17,61,15:00,15:15,,25.66,0,25.66,25.66,-1,-35099,74672,109771,39573,0,-15846,0,0,0,,15846,-15846
19,05-10-17,62,15:15,15:30,,28.24,0,28.24,28.24,-1,-30400,80260,110660,49860,0,-686,0,0,0,,686,-686
19,05-10-17,63,15:30,15:45,,27.24,0,27.24,27.24,-1,-25490,78636,104126,53146,0,-791,0,0,0,,791,-791
19,05-10-17,64,15:45,16:00,,25.11,0,25.11,25.11,-1,-31165,71798,102963,40633,0,-3322,0,0,0,,3322,-3322
19,05-10-17,65,16:00,16:15,29.61,27.73,0,29.61,29.61,1,-80516,79928,160444,-588,0,-2782,400,0,0,,3182,-2382
19,05-10-17,66,16:15,16:30,29.61,,0,29.61,29.61,1,-71286,83063,154349,11777,0,0,1137,0,0,,1137,1137
19,05-10-17,67,16:30,16:45,27.61,,0,27.61,27.61,1,-69785,67694,137479,-2091,0,0,240,0,0,,240,240
19,05-10-17,68,16:45,17:00,27.61,,0,27.61,27.61,1,-70566,65781,136347,-4785,0,0,546,0,0,,546,546
19,05-10-17,69,17:00,17:15,,26.66,0,26.66,26.66,-1,-44556,82361,126917,37805,0,-1394,0,0,0,,1394,-1394
19,05-10-17,70,17:15,17:30,,27.86,0,27.86,27.86,-1,-49429,64781,114210,15352,0,-1858,0,0,0,,1858,-1858
19,05-10-17,71,17:30,17:45,31.08,27.86,0,31.08,31.08,1,-60228,54166,114394,-6062,0,-2,582,0,0,,584,580
19,05-10-17,72,17:45,18:00,32.32,,0,32.32,32.32,1,-70025,47862,117887,-22163,0,0,8044,0,0,,8044,8044
19,05-10-17,73,18:00,18:15,29.61,,0,29.61,29.61,1,-102190,21091,123281,-81099,0,0,5470,0,0,,5470,5470
19,05-10-17,74,18:15,18:30,,,0,37.89,37.89,0,-92975,27195,120170,-65780,0,0,51,0,0,,51,51
19,05-10-17,75,18:30,18:45,54.59,,0,54.59,54.59,1,-94038,37358,131396,-56680,0,0,3599,0,0,,3599,3599
19,05-10-17,76,18:45,19:00,117.65,,0,117.65,117.65,1,-86923,42265,129188,-44658,0,0,34240,0,0,,34240,34240
19,05-10-17,77,19:00,19:15,38.04,,0,38.04,38.04,1,-63594,38073,101667,-25521,0,0,19959,0,0,,19959,19959
19,05-10-17,78,19:15,19:30,31.31,,0,31.31,31.31,1,-54321,38360,92681,-15961,0,0,596,0,0,,596,596
19,05-10-17,79,19:30,19:45,54.04,,0,54.04,54.04,1,-61749,41426,103175,-20323,0,0,13721,0,0,,13721,13721
19,05-10-17,80,19:45,20:00,54.59,,0,54.59,54.59,1,-66098,38745,104843,-27353,0,0,35116,0,0,,35116,35116
19,05-10-17,81,20:00,20:15,37.09,,0,37.09,37.09,1,-88001,22260,110261,-65741,0,0,17146,0,0,,17146,17146
19,05-10-17,82,20:15,20:30,37.35,,0,37.35,37.35,1,-77430,21879,99309,-55551,0,0,11337,0,0,,11337,11337
19,05-10-17,83,20:30,20:45,37.35,,0,37.35,37.35,1,-65257,25759,91016,-39498,0,0,5111,0,0,,5111,5111
19,05-10-17,84,20:45,21:00,37.35,27.52,0,37.89,27.52,2,-58929,26884,85813,-32045,0,-83,8342,0,0,,8425,8259
19,05-10-17,85,21:00,21:15,37.35,26.62,0,26.62,26.62,-1,-30709,77958,108667,47249,0,-755,358,0,0,,1113,-397
19,05-10-17,86,21:15,21:30,,,0,37.2,37.2,0,-42213,63950,106163,21737,0,0,0,0,0,,0,0
19,05-10-17,87,21:30,21:45,43.04,,0,43.04,43.04,1,-59101,59874,118975,773,0,0,1078,0,0,,1078,1078
19,05-10-17,88,21:45,22:00,77.3,,0,77.3,77.3,1,-99375,51443,150818,-47932,0,0,20298,0,0,,20298,20298
19,05-10-17,89,22:00,22:15,,,0,37.25,37.25,0,-67429,46820,114249,-20609,0,0,3051,0,0,,3051,3051
19,05-10-17,90,22:15,22:30,,6.39,0,6.39,6.39,-1,-49488,99420,148908,49932,0,-6481,0,0,0,,6481,-6481
19,05-10-17,91,22:30,22:45,,1.9,0,1.9,1.9,-1,-29422,99165,128587,69743,0,-17354,0,0,0,,17354,-17354
19,05-10-17,92,22:45,23:00,,-36.98,0,-36.98,-36.98,-1,-20192,118548,138740,98356,0,-33006,0,0,0,,33006,-33006
19,05-10-17,93,23:00,23:15,,12.16,0,12.16,12.16,-1,-105466,72447,177913,-33019,0,-19563,0,0,0,,19563,-19563
19,05-10-17,94,23:15,23:30,,25.66,0,25.66,25.66,-1,-70999,67507,138506,-3492,0,-2090,0,0,0,,2090,-2090
19,05-10-17,95,23:30,23:45,,-0.59,0,-0.59,-0.59,-1,-29203,99679,128882,70476,0,-21025,0,0,0,,21025,-21025
19,05-10-17,96,23:45,0:00,,-9.14,0,-9.14,-9.14,-1,-53378,109352,162730,55974,0,-49749,0,0,0,,49749,-49749
19,05-11-17,1,0:00,0:15,64.51,26.72,0,64.51,26.72,2,-73792,40202,113994,-33590,0,-11354,5309,0,0,,16663,-6045
19,05-11-17,2,0:15,0:30,28.72,27.85,0,27.85,27.85,-1,-38887,49174,88061,10287,0,-68,3851,0,0,,3919,3783
19,05-11-17,3,0:30,0:45,,27.43,0,27.43,27.43,-1,-42640,48275,90915,5635,0,-2257,0,0,0,,2257,-2257
19,05-11-17,4,0:45,1:00,,28.15,0,28.15,28.15,-1,-27104,72064,99168,44960,0,-1477,0,0,0,,1477,-1477
19,05-11-17,5,1:00,1:15,32.72,27.59,0,32.72,32.72,1,-56210,44283,100493,-11927,0,-73,4351,0,0,,4424,4278
19,05-11-17,6,1:15,1:30,35.98,27.36,0,35.98,27.36,2,-45622,57811,103433,12189,0,-117,9925,0,0,,10042,9808
19,05-11-17,7,1:30,1:45,35.98,27.36,0,27.36,27.36,-1,-27672,65511,93183,37839,0,-142,87,0,0,,229,-55
19,05-11-17,8,1:45,2:00,,27.41,0,27.41,27.41,-1,-24922,74297,99219,49375,0,-1766,0,0,0,,1766,-1766
19,05-11-17,9,2:00,2:15,,27.16,0,27.16,27.16,-1,-36306,63178,99484,26872,0,-1315,0,0,0,,1315,-1315
19,05-11-17,10,2:15,2:30,,,0,28.76,28.76,0,-27834,53833,81667,25999,0,0,0,0,0,,0,0
19,05-11-17,11,2:30,2:45,,27.28,0,27.28,27.28,-1,-21447,67751,89198,46304,0,-2188,0,0,0,,2188,-2188
19,05-11-17,12,2:45,3:00,,25.72,0,25.72,25.72,-1,-21971,63996,85967,42025,0,-8608,0,0,0,,8608,-8608
19,05-11-17,13,3:00,3:15,26.72,28.03,0,26.72,26.72,1,-17829,46723,64552,28894,0,-3941,9,0,0,,3950,-3932
19,05-11-17,14,3:15,3:30,28.52,,0,28.52,28.52,1,-16250,43589,59839,27339,0,0,386,0,0,,386,386
19,05-11-17,15,3:30,3:45,26.72,,0,26.72,26.72,1,-13907,62532,76439,48625,0,0,250,0,0,,250,250
19,05-11-17,16,3:45,4:00,,,0,28.76,28.76,0,-13132,52691,65823,39559,0,0,8,0,0,,8,8
19,05-11-17,17,4:00,4:15,,,0,28.76,28.76,0,-16251,49795,66046,33544,0,0,0,0,0,,0,0
19,05-11-17,18,4:15,4:30,,,0,28.76,28.76,0,-22192,50126,72318,27934,0,0,0,0,0,,0,0
19,05-11-17,19,4:30,4:45,,,0,28.76,28.76,0,-16459,51619,68078,35160,0,0,0,0,0,,0,0
19,05-11-17,20,4:45,5:00,,30.09,0,30.09,30.09,-1,-16373,69534,85907,53161,0,-64,0,0,0,,64,-64
19,05-11-17,21,5:00,5:15,,,0,28.76,28.76,0,-47886,99022,146908,51136,0,0,0,0,0,,0,0
19,05-11-17,22,5:15,5:30,,30.09,0,30.09,30.09,-1,-31970,87157,119127,55187,0,-40,0,0,0,,40,-40
19,05-11-17,23,5:30,5:45,,30.09,0,30.09,30.09,-1,-15021,80294,95315,65273,0,-297,0,0,0,,297,-297
19,05-11-17,24,5:45,6:00,,30.09,0,30.09,30.09,-1,-15617,87122,102739,71505,0,-60,0,0,0,,60,-60
19,05-11-17,25,6:00,6:15,,-56.86,0,-56.86,-56.86,-1,-10207,147664,157871,137457,0,-30967,0,0,0,,30967,-30967
19,05-11-17,26,6:15,6:30,,11.05,0,11.05,11.05,-1,-17846,70831,88677,52985,0,-65978,0,0,0,,65978,-65978
19,05-11-17,27,6:30,6:45,,26.03,0,26.03,26.03,-1,-23318,44779,68097,21461,0,-14412,0,0,0,,14412,-14412
19,05-11-17,28,6:45,7:00,28.82,26.03,0,28.82,28.82,1,-51175,46278,97453,-4897,0,-10,1397,0,0,,1407,1387
19,05-11-17,29,7:00,7:15,28.82,-36.16,0,-36.16,-36.16,-1,-32849,132435,165284,99586,0,-30153,48,0,0,,30201,-30105
19,05-11-17,30,7:15,7:30,,26.82,0,26.82,26.82,-1,-39508,63482,102990,23974,0,-7585,0,0,0,,7585,-7585
19,05-11-17,31,7:30,7:45,,27.22,0,27.22,27.22,-1,-36194,39233,75427,3039,0,-1275,0,0,0,,1275,-1275
19,05-11-17,32,7:45,8:00,38.1,30.79,0,38.1,29.62,2,-87093,35804,122897,-51289,0,-167,5677,0,0,,5844,5510
19,05-11-17,33,8:00,8:15,29.45,,0,29.45,29.45,1,-69159,52722,121881,-16437,0,0,4173,0,0,,4173,4173
19,05-11-17,34,8:15,8:30,39.49,,0,39.49,39.49,1,-71180,41461,112641,-29719,0,0,8007,0,0,,8007,8007
19,05-11-17,35,8:30,8:45,50.49,,0,50.49,50.49,1,-87095,43285,130380,-43810,0,0,20033,0,0,,20033,20033
19,05-11-17,36,8:45,9:00,50.49,,0,50.49,50.49,1,-89921,50018,139939,-39903,0,0,30651,0,0,,30651,30651
19,05-11-17,37,9:00,9:15,31.49,27.21,0,31.49,27.21,2,-53449,67904,121353,14455,0,-368,11737,0,0,,12105,11369
19,05-11-17,38,9:15,9:30,,,0,29.66,29.66,0,-56767,66594,123361,9827,0,0,0,0,0,,0,0
19,05-11-17,39,9:30,9:45,,,0,29.66,29.66,0,-56665,78202,134867,21537,0,0,0,0,0,,0,0
19,05-11-17,40,9:45,10:00,,28.03,0,28.03,28.03,-1,-59109,83615,142724,24506,0,-1985,0,0,0,,1985,-1985
19,05-11-17,41,10:00,10:15,,29.03,0,29.03,29.03,-1,-38655,91810,130465,53155,0,-732,0,0,0,,732,-732
19,05-11-17,42,10:15,10:30,,30.09,0,30.09,30.09,-1,-26835,95193,122028,68358,0,-109,0,0,0,,109,-109
19,05-11-17,43,10:30,10:45,,27.24,0,27.24,27.24,-1,-31644,96243,127887,64599,0,-1796,0,0,0,,1796,-1796
19,05-11-17,44,10:45,11:00,,27.3,0,27.3,27.3,-1,-35894,102071,137965,66177,0,-2116,0,0,0,,2116,-2116
19,05-11-17,45,11:00,11:15,,25.82,0,25.82,25.82,-1,-45120,97770,142890,52650,0,-11334,0,0,0,,11334,-11334
19,05-11-17,46,11:15,11:30,,24.55,0,24.55,24.55,-1,-48199,82730,130929,34531,0,-21504,0,0,0,,21504,-21504
19,05-11-17,47,11:30,11:45,28.91,26.82,0,29.66,26.82,2,-48873,79389,128262,30516,0,-2958,206,0,0,,3164,-2752
19,05-11-17,48,11:45,12:00,,25.82,0,25.82,25.82,-1,-46957,85932,132889,38975,0,-8609,0,0,0,,8609,-8609
19,05-11-17,49,12:00,12:15,,26.82,0,26.82,26.82,-1,-49120,68277,117397,19157,0,-5562,0,0,0,,5562,-5562
19,05-11-17,50,12:15,12:30,,21.82,0,21.82,21.82,-1,-54607,74905,129512,20298,0,-18429,0,0,0,,18429,-18429
19,05-11-17,51,12:30,12:45,,25.82,0,25.82,25.82,-1,-64372,80346,144718,15974,0,-20140,0,0,0,,20140,-20140
19,05-11-17,52,12:45,13:00,,23.03,0,23.03,23.03,-1,-63258,83605,146863,20347,0,-4529,0,0,0,,4529,-4529
19,05-11-17,53,13:00,13:15,,23.03,0,23.03,23.03,-1,-73353,95529,168882,22176,0,-7625,0,0,0,,7625,-7625
19,05-11-17,54,13:15,13:30,28.52,23.03,0,28.52,28.52,1,-79939,92413,172352,12474,0,-16,53,0,0,,69,37
19,05-11-17,55,13:30,13:45,29.45,,0,29.45,29.45,1,-71781,82549,154330,10768,0,0,709,0,0,,709,709
19,05-11-17,56,13:45,14:00,29.45,,0,29.45,29.45,1,-74480,82176,156656,7696,0,0,1110,0,0,,1110,1110
19,05-11-17,57,14:00,14:15,32.91,,0,32.91,32.91,1,-84879,82275,167154,-2604,0,0,5468,0,0,,5468,5468
19,05-11-17,58,14:15,14:30,28.9,,0,28.9,28.9,1,-86304,81437,167741,-4867,0,0,5596,0,0,,5596,5596
19,05-11-17,59,14:30,14:45,,,0,29.66,29.66,0,-79869,67861,147730,-12008,0,0,408,0,0,,408,408
19,05-11-17,60,14:45,15:00,28.92,,0,28.92,28.92,1,-87719,62521,150240,-25198,0,0,1971,0,0,,1971,1971
19,05-11-17,61,15:00,15:15,28.59,,0,28.59,28.59,1,-72059,81850,153909,9791,0,0,87,0,0,,87,87
19,05-11-17,62,15:15,15:30,28.82,,0,28.82,28.82,1,-79314,65236,144550,-14078,0,0,4373,0,0,,4373,4373
19,05-11-17,63,15:30,15:45,39.82,,0,39.82,39.82,1,-87123,49231,136354,-37892,0,0,11054,0,0,,11054,11054
19,05-11-17,64,15:45,16:00,39.82,,0,39.82,39.82,1,-104056,50749,154805,-53307,0,0,14591,0,0,,14591,14591
19,05-11-17,65,16:00,16:15,26.82,,0,26.82,26.82,1,-90847,37067,127914,-53780,0,0,4092,0,0,,4092,4092
19,05-11-17,66,16:15,16:30,,,0,28.81,28.81,0,-101340,24854,126194,-76486,0,0,0,0,0,,0,0
19,05-11-17,67,16:30,16:45,28.82,,0,28.82,28.82,1,-99235,23336,122571,-75899,0,0,723,0,0,,723,723
19,05-11-17,68,16:45,17:00,29.55,,0,29.55,29.55,1,-117447,13640,131087,-103807,0,0,7053,0,0,,7053,7053
19,05-11-17,69,17:00,17:15,69.96,,0,69.96,69.96,1,-142494,14390,156884,-128104,0,0,22209,0,0,,22209,22209
19,05-11-17,70,17:15,17:30,41.02,,0,41.02,41.02,1,-123619,20082,143701,-103537,0,0,30161,0,0,,30161,30161
19,05-11-17,71,17:30,17:45,37.29,,0,37.29,37.29,1,-122683,21399,144082,-101284,0,0,24599,0,0,,24599,24599
19,05-11-17,72,17:45,18:00,181.82,,0,181.82,181.82,1,-112909,29055,141964,-83854,0,0,35290,0,0,,35290,35290
19,05-11-17,73,18:00,18:15,181.82,,0,181.82,181.82,1,-100680,36955,137635,-63725,0,0,51833,0,0,,51833,51833
19,05-11-17,74,18:15,18:30,29.06,27.46,0,29.68,27.46,2,-54619,62531,117150,7912,0,-219,8763,0,0,,8982,8544
19,05-11-17,75,18:30,18:45,49.1,,0,49.1,49.1,1,-69363,45102,114465,-24261,0,0,6024,0,0,,6024,6024
19,05-11-17,76,18:45,19:00,49.1,,0,49.1,49.1,1,-53477,47276,100753,-6201,0,0,11229,0,0,,11229,11229
19,05-11-17,77,19:00,19:15,54.79,,0,54.79,54.79,1,-89239,48376,137615,-40863,0,0,15676,0,0,,15676,15676
19,05-11-17,78,19:15,19:30,39.24,,0,39.24,39.24,1,-68967,53806,122773,-15161,0,0,20426,0,0,,20426,20426
19,05-11-17,79,19:30,19:45,31.61,,0,31.61,31.61,1,-62667,53209,115876,-9458,0,0,3294,0,0,,3294,3294
19,05-11-17,80,19:45,20:00,31.7,,0,31.7,31.7,1,-61960,50881,112841,-11079,0,0,1255,0,0,,1255,1255
19,05-11-17,81,20:00,20:15,28.82,,0,28.82,28.82,1,-76929,58825,135754,-18104,0,0,1042,0,0,,1042,1042
19,05-11-17,82,20:15,20:30,31.48,,0,31.48,31.48,1,-62004,58020,120024,-3984,0,0,2653,0,0,,2653,2653
19,05-11-17,83,20:30,20:45,28.26,26.87,0,29.53,26.87,2,-50178,48467,98645,-1711,0,-974,43,0,0,,1017,-931
19,05-11-17,84,20:45,21:00,29.85,,0,29.85,29.85,1,-53691,32996,86687,-20695,0,0,745,0,0,,745,745
19,05-11-17,85,21:00,21:15,30.2,,0,30.2,30.2,1,-68198,50515,118713,-17683,0,0,1534,0,0,,1534,1534
19,05-11-17,86,21:15,21:30,32.31,,0,32.31,32.31,1,-62779,49964,112743,-12815,0,0,6878,0,0,,6878,6878
19,05-11-17,87,21:30,21:45,32.31,28.15,0,28.15,28.15,-1,-54351,55084,109435,733,0,-732,330,0,0,,1062,-402
19,05-11-17,88,21:45,22:00,28.82,30.09,0,28.82,28.82,1,-59960,57454,117414,-2506,0,-367,7,0,0,,374,-360
19,05-11-17,89,22:00,22:15,308.77,,0,308.77,308.77,1,-122757,22267,145024,-100490,0,0,31731,0,0,,31731,31731
19,05-11-17,90,22:15,22:30,63.02,27.28,0,27.28,27.28,-1,-53707,39384,93091,-14323,0,-28,30406,0,0,,30434,30378
19,05-11-17,91,22:30,22:45,63.02,25.82,0,25.82,25.82,-1,-45362,47773,93135,2411,0,-1893,900,0,0,,2793,-993
19,05-11-17,92,22:45,23:00,56.54,25.82,0,56.54,56.54,1,-91608,46099,137707,-45509,0,-78,10897,0,0,,10975,10819
19,05-11-17,93,23:00,23:15,275.51,23.75,0,275.51,23.75,2,-80564,74424,154988,-6140,0,-595,6845,0,0,,7440,6250
19,05-11-17,94,23:15,23:30,275.51,,0,275.51,275.51,1,-108475,41023,149498,-67452,0,0,52852,0,0,,52852,52852
19,05-11-17,95,23:30,23:45,275.51,27.85,0,27.85,27.85,-1,-54092,60429,114521,6337,0,-175,4844,0,0,,5019,4669
19,05-11-17,96,23:45,0:00,,26.89,0,26.89,26.89,-1,-37361,44750,82111,7389,0,-831,0,0,0,,831,-831
19,05-12-17,1,0:00,0:15,264.3,31.29,0,264.3,264.3,1,-143634,10850,154484,-132784,0,-213,28397,0,0,,28610,28184
19,05-12-17,2,0:15,0:30,264.3,,0,264.3,264.3,1,-102826,41049,143875,-61777,0,0,75242,0,0,,75242,75242
19,05-12-17,3,0:30,0:45,47.46,,0,47.46,47.46,1,-83995,56513,140508,-27482,0,0,9887,0,0,,9887,9887
19,05-12-17,4,0:45,1:00,99.42,,0,99.42,99.42,1,-68002,45270,113272,-22732,0,0,23611,0,0,,23611,23611
19,05-12-17,5,1:00,1:15,99.42,22.12,0,22.12,22.12,-1,-38507,65932,104439,27425,0,-1405,5012,0,0,,6417,3607
19,05-12-17,6,1:15,1:30,,27.12,0,27.12,27.12,-1,-29822,35730,65552,5908,0,-3171,0,0,0,,3171,-3171
19,05-12-17,7,1:30,1:45,,28.17,0,28.17,28.17,-1,-23588,36957,60545,13369,0,-2132,0,0,0,,2132,-2132
19,05-12-17,8,1:45,2:00,,27.12,0,27.12,27.12,-1,-28132,34610,62742,6478,0,-3699,0,0,0,,3699,-3699
19,05-12-17,9,2:00,2:15,57.96,27.57,0,57.96,27.54,2,-50925,18412,69337,-32513,0,-3121,9673,0,0,,12794,6552
19,05-12-17,10,2:15,2:30,60.12,,0,60.12,60.12,1,-53726,30669,84395,-23057,0,0,26228,0,0,,26228,26228
19,05-12-17,11,2:30,2:45,28.82,,0,28.82,28.82,1,-43972,34747,78719,-9225,0,0,9863,0,0,,9863,9863
19,05-12-17,12,2:45,3:00,26.82,27.78,0,27.78,27.78,-1,-53887,48800,102687,-5087,0,-1094,3408,0,0,,4502,2314
19,05-12-17,13,3:00,3:15,33.26,27.78,0,33.26,33.26,1,-49096,37279,86375,-11817,0,-946,2389,0,0,,3335,1443
19,05-12-17,14,3:15,3:30,35.27,27.8,0,35.27,27.26,2,-56993,44651,101644,-12342,0,-170,10606,0,0,,10776,10436
19,05-12-17,15,3:30,3:45,28.66,27.85,0,28.66,28.66,1,-50003,35619,85622,-14384,0,-274,516,0,0,,790,242
19,05-12-17,16,3:45,4:00,28.68,,0,28.68,28.68,1,-53126,51706,104832,-1420,0,0,1149,0,0,,1149,1149
19,05-12-17,17,4:00,4:15,,,0,27.22,27.22,0,-38695,62053,100748,23358,0,0,0,0,0,,0,0
19,05-12-17,18,4:15,4:30,,,0,27.16,27.16,0,-46582,55071,101653,8489,0,0,0,0,0,,0,0
19,05-12-17,19,4:30,4:45,26.82,,0,26.82,26.82,1,-50907,55237,106144,4330,0,0,16,0,0,,16,16
19,05-12-17,20,4:45,5:00,28.24,,0,28.24,28.24,1,-44754,41747,86501,-3007,0,0,2005,0,0,,2005,2005
19,05-12-17,21,5:00,5:15,28.24,26.12,0,26.12,26.12,-1,-54713,42920,97633,-11793,0,-1086,18,0,0,,1104,-1068
19,05-12-17,22,5:15,5:30,,26.12,0,26.12,26.12,-1,-35309,36382,71691,1073,0,-7855,0,0,0,,7855,-7855
19,05-12-17,23,5:30,5:45,26.82,26.12,0,26.82,26.82,1,-44631,46557,91188,1926,0,-116,669,0,0,,785,553
19,05-12-17,24,5:45,6:00,,28.22,0,28.22,28.22,-1,-44763,54899,99662,10136,0,-81,0,0,0,,81,-81
19,05-12-17,25,6:00,6:15,,26.87,0,26.87,26.87,-1,-32501,69225,101726,36724,0,-4349,0,0,0,,4349,-4349
19,05-12-17,26,6:15,6:30,,27.41,0,27.41,27.41,-1,-36834,53214,90048,16380,0,-1560,0,0,0,,1560,-1560
19,05-12-17,27,6:30,6:45,40.37,,0,40.37,40.37,1,-71493,28363,99856,-43130,0,0,1979,0,0,,1979,1979
19,05-12-17,28,6:45,7:00,380.46,,0,380.46,380.46,1,-120586,50681,171267,-69905,0,0,47096,0,0,,47096,47096
19,05-12-17,29,7:00,7:15,28.2,23.51,0,37.8,23.51,2,-34496,169869,204365,135373,0,-2132,8986,0,0,,11118,6854
19,05-12-17,30,7:15,7:30,,29.78,0,29.78,29.78,-1,-51198,108199,159397,57001,0,-472,0,0,0,,472,-472
19,05-12-17,31,7:30,7:45,37.4,,0,37.4,37.4,1,-90793,80625,171418,-10168,0,0,1523,0,0,,1523,1523
19,05-12-17,32,7:45,8:00,138.26,,0,138.26,138.26,1,-123355,76079,199434,-47276,0,0,29945,0,0,,29945,29945
19,05-12-17,33,8:00,8:15,31.49,30.89,0,30.89,30.89,-1,-47906,80831,128737,32925,0,-522,9792,0,0,,10314,9270
19,05-12-17,34,8:15,8:30,46.49,31.39,0,46.49,46.49,1,-80025,71096,151121,-8929,0,-269,4074,0,0,,4343,3805
19,05-12-17,35,8:30,8:45,569.97,,0,569.97,569.97,1,-108839,55474,164313,-53365,0,0,37219,0,0,,37219,37219
19,05-12-17,36,8:45,9:00,569.97,,0,569.97,569.97,1,-114082,63161,177243,-50921,0,0,55570,0,0,,55570,55570
19,05-12-17,37,9:00,9:15,569.97,27.33,0,27.33,27.33,-1,-19679,67098,86777,47419,0,-716,16689,0,0,,17405,15973
19,05-12-17,38,9:15,9:30,,26.29,0,26.29,26.29,-1,-48150,52946,101096,4796,0,-8340,0,0,0,,8340,-8340
19,05-12-17,39,9:30,9:45,31.29,26.29,0,31.29,31.29,1,-52710,48487,101197,-4223,0,-1529,1542,0,0,,3071,13
19,05-12-17,40,9:45,10:00,32.33,,0,32.33,32.33,1,-69924,50141,120065,-19783,0,0,6535,0,0,,6535,6535
19,05-12-17,41,10:00,10:15,32.33,22.29,0,22.29,22.29,-1,-61771,93099,154870,31328,0,-5264,3064,0,0,,8328,-2200
19,05-12-17,42,10:15,10:30,28.2,21.99,0,37.76,21.99,2,-68301,76199,144500,7898,0,-15578,9,0,0,,15587,-15569
19,05-12-17,43,10:30,10:45,30.42,21.99,0,30.42,30.42,1,-68828,67444,136272,-1384,0,-757,2379,0,0,,3136,1622
19,05-12-17,44,10:45,11:00,28.2,,0,28.2,28.2,1,-54899,75908,130807,21009,0,0,504,0,0,,504,504
19,05-12-17,45,11:00,11:15,,14.15,0,14.15,14.15,-1,-29175,89344,118519,60169,0,-9202,0,0,0,,9202,-9202
19,05-12-17,46,11:15,11:30,,6.02,0,6.02,6.02,-1,-31742,81974,113716,50232,0,-35211,0,0,0,,35211,-35211
19,05-12-17,47,11:30,11:45,,17.88,0,17.88,17.88,-1,-38292,83035,121327,44743,0,-23360,0,0,0,,23360,-23360
19,05-12-17,48,11:45,12:00,,18.21,0,18.21,18.21,-1,-47920,92809,140729,44889,0,-28515,0,0,0,,28515,-28515
19,05-12-17,49,12:00,12:15,,25.17,0,25.17,25.17,-1,-58851,81143,139994,22292,0,-16135,0,0,0,,16135,-16135
19,05-12-17,50,12:15,12:30,,22.29,0,22.29,22.29,-1,-57844,62674,120518,4830,0,-10541,0,0,0,,10541,-10541
19,05-12-17,51,12:30,12:45,,26.75,0,26.75,26.75,-1,-46512,56587,103099,10075,0,-4833,0,0,0,,4833,-4833
19,05-12-17,52,12:45,13:00,,27.29,0,27.29,27.29,-1,-36514,58115,94629,21601,0,-9386,0,0,0,,9386,-9386
19,05-12-17,53,13:00,13:15,32.07,27.29,0,32.07,32.07,1,-60140,63226,123366,3086,0,-4620,401,0,0,,5021,-4219
19,05-12-17,54,13:15,13:30,32.33,26.29,0,32.33,26.29,2,-68892,69936,138828,1044,0,-388,6455,0,0,,6843,6067
19,05-12-17,55,13:30,13:45,32.33,9.11,0,9.11,9.11,-1,-39919,93478,133397,53559,0,-19569,129,0,0,,19698,-19440
19,05-12-17,56,13:45,14:00,,-0.93,0,-0.93,-0.93,-1,-43078,103252,146330,60174,0,-30885,0,0,0,,30885,-30885
19,05-12-17,57,14:00,14:15,,-0.95,0,-0.95,-0.95,-1,-51918,79280,131198,27362,0,-25483,0,0,0,,25483,-25483
19,05-12-17,58,14:15,14:30,,,0,30.3,30.3,0,-46433,65394,111827,18961,0,-459,0,0,0,,459,-459
19,05-12-17,59,14:30,14:45,28.2,,0,28.2,28.2,1,-64156,63486,127642,-670,0,0,21,0,0,,21,21
19,05-12-17,60,14:45,15:00,31.88,,0,31.88,31.88,1,-86808,58954,145762,-27854,0,0,3661,0,0,,3661,3661
19,05-12-17,61,15:00,15:15,32.2,,0,32.2,32.2,1,-67483,29130,96613,-38353,0,0,9157,0,0,,9157,9157
19,05-12-17,62,15:15,15:30,29.6,,0,29.6,29.6,1,-68266,16830,85096,-51436,0,0,2396,0,0,,2396,2396
19,05-12-17,63,15:30,15:45,41.51,,0,41.51,41.51,1,-95712,16693,112405,-79019,0,0,12484,0,0,,12484,12484
19,05-12-17,64,15:45,16:00,115.8,,0,115.8,115.8,1,-119771,20414,140185,-99357,0,0,34602,0,0,,34602,34602
19,05-12-17,65,16:00,16:15,38.2,,0,38.2,38.2,1,-89758,44554,134312,-45204,0,0,29476,0,0,,29476,29476
19,05-12-17,66,16:15,16:30,49.87,,0,49.87,49.87,1,-96443,43480,139923,-52963,0,0,23378,0,0,,23378,23378
19,05-12-17,67,16:30,16:45,118.23,,0,118.23,118.23,1,-130030,41310,171340,-88720,0,0,66143,0,0,,66143,66143
19,05-12-17,68,16:45,17:00,124.23,,0,124.23,124.23,1,-148054,41717,189771,-106337,0,0,73464,0,0,,73464,73464
19,05-12-17,69,17:00,17:15,147.08,,0,147.08,147.08,1,-204202,79821,284023,-124381,0,0,82531,0,0,,82531,82531
19,05-12-17,70,17:15,17:30,350.23,,0,350.23,350.23,1,-199892,74312,274204,-125580,0,0,88018,6250,0,,94268,94268
19,05-12-17,71,17:30,17:45,186.46,,0,186.46,186.46,1,-177291,85982,263273,-91309,0,0,83082,2500,0,,85582,85582
19,05-12-17,72,17:45,18:00,186.46,,0,186.46,186.46,1,-165661,73688,239349,-91973,0,0,79591,3750,0,,83341,83341
19,05-12-17,73,18:00,18:15,53.15,,0,53.15,53.15,1,-92347,53942,146289,-38405,0,0,32173,0,0,,32173,32173
19,05-12-17,74,18:15,18:30,46.65,,0,46.65,46.65,1,-101475,39856,141331,-61619,0,0,9018,0,0,,9018,9018
19,05-12-17,75,18:30,18:45,125.04,,0,125.04,125.04,1,-110703,32757,143460,-77946,0,0,55461,0,0,,55461,55461
19,05-12-17,76,18:45,19:00,55.23,,0,55.23,55.23,1,-93017,51159,144176,-41858,0,0,52749,0,0,,52749,52749
19,05-12-17,77,19:00,19:15,48,,0,48,48,1,-108110,58677,166787,-49433,0,0,42181,0,0,,42181,42181
19,05-12-17,78,19:15,19:30,37.49,,0,37.49,37.49,1,-95075,56030,151105,-39045,0,0,38379,0,0,,38379,38379
19,05-12-17,79,19:30,19:45,35.23,,0,35.23,35.23,1,-91829,50689,142518,-41140,0,0,25506,0,0,,25506,25506
19,05-12-17,80,19:45,20:00,48,,0,48,48,1,-106853,32637,139490,-74216,0,0,13074,0,0,,13074,13074
19,05-12-17,81,20:00,20:15,165.58,,0,165.58,165.58,1,-206840,15046,221886,-191794,0,0,58339,0,0,,58339,58339
19,05-12-17,82,20:15,20:30,165.58,,0,165.58,165.58,1,-135214,36550,171764,-98664,0,0,59152,0,0,,59152,59152
19,05-12-17,83,20:30,20:45,29.67,27.29,0,37.92,27.29,2,-63195,47930,111125,-15265,0,-5,2506,0,0,,2511,2501
19,05-12-17,84,20:45,21:00,29.79,,0,29.79,29.79,1,-54159,30608,84767,-23551,0,0,2399,0,0,,2399,2399
19,05-12-17,85,21:00,21:15,,,0,37.89,37.89,0,-39592,63369,102961,23777,0,0,0,0,0,,0,0
19,05-12-17,86,21:15,21:30,,28.12,0,28.12,28.12,-1,-36869,74942,111811,38073,0,-80,0,0,0,,80,-80
19,05-12-17,87,21:30,21:45,,27.29,0,27.29,27.29,-1,-48901,93176,142077,44275,0,-1627,0,0,0,,1627,-1627
19,05-12-17,88,21:45,22:00,,21.2,0,21.2,21.2,-1,-41085,90628,131713,49543,0,-12360,0,0,0,,12360,-12360
19,05-12-17,89,22:00,22:15,,25.26,0,25.26,25.26,-1,-44799,54334,99133,9535,0,-13459,0,0,0,,13459,-13459
19,05-12-17,90,22:15,22:30,,20.73,0,20.73,20.73,-1,-31307,59259,90566,27952,0,-1511,0,0,0,,1511,-1511
19,05-12-17,91,22:30,22:45,,18.23,0,18.23,18.23,-1,-29927,64103,94030,34176,0,-4138,0,0,0,,4138,-4138
19,05-12-17,92,22:45,23:00,,,0,37.87,37.87,0,-65258,86693,151951,21435,0,0,0,0,0,,0,0
19,05-12-17,93,23:00,23:15,35.37,,0,35.37,35.37,1,-72173,47187,119360,-24986,0,0,6274,0,0,,6274,6274
19,05-12-17,94,23:15,23:30,29.17,28.31,0,28.31,28.31,-1,-58836,52810,111646,-6026,0,-45,5258,0,0,,5303,5213
19,05-12-17,95,23:30,23:45,,27.41,0,27.41,27.41,-1,-29712,61029,90741,31317,0,-1440,0,0,0,,1440,-1440
19,05-12-17,96,23:45,0:00,,27.41,0,27.41,27.41,-1,-34269,93730,127999,59461,0,-667,0,0,0,,667,-667
20,05/13/2017,1,0:00,0:15,39.79,27.41,0,39.79,39.79,1,-84851,45973,130824,-38878,0,-70,5424,0,0,,5494,5354
20,05/13/2017,2,0:15,0:30,29.79,,0,29.79,29.79,1,-54794,40165,94959,-14629,0,0,8392,0,0,,8392,8392
20,05/13/2017,3,0:30,0:45,29.79,27.29,0,27.29,27.29,-1,-32191,48689,80880,16498,0,-917,244,0,0,,1161,-673
20,05/13/2017,4,0:45,1:00,,10.27,0,10.27,10.27,-1,-12981,66765,79746,53784,0,-20609,0,0,0,,20609,-20609
20,05/13/2017,5,1:00,1:15,30.13,0.73,0,30.13,30.13,1,-50808,57840,108648,7032,0,-23919,767,0,0,,24686,-23152
20,05/13/2017,6,1:15,1:30,30.13,22.29,0,22.29,22.29,-1,-46374,71673,118047,25299,0,-5525,129,0,0,,5654,-5396
20,05/13/2017,7,1:30,1:45,27.79,27.29,0,27.79,27.79,1,-57047,51755,108802,-5292,0,-4962,181,0,0,,5143,-4781
20,05/13/2017,8,1:45,2:00,27.79,27.29,0,27.29,27.29,-1,-50263,80586,130849,30323,0,-389,537,0,0,,926,148
20,05/13/2017,9,2:00,2:15,,26.55,0,26.55,26.55,-1,-14642,35807,50449,21165,0,-568,0,0,0,,568,-568
20,05/13/2017,10,2:15,2:30,,,0,28.37,28.37,0,-18320,21322,39642,3002,0,0,0,0,0,,0,0
20,05/13/2017,11,2:30,2:45,27.79,,0,27.79,27.79,1,-15819,20341,36160,4522,0,0,616,0,0,,616,616
20,05/13/2017,12,2:45,3:00,27.79,20.6,0,20.6,20.6,-1,-8312,46247,54559,37935,0,-10157,19,0,0,,10176,-10138
20,05/13/2017,13,3:00,3:15,29.89,27.03,0,29.89,27.03,2,-37668,29909,67577,-7759,0,-4934,740,0,0,,5674,-4194
20,05/13/2017,14,3:15,3:30,,27.21,0,27.21,27.21,-1,-22043,48126,70169,26083,0,-524,0,0,0,,524,-524
20,05/13/2017,15,3:30,3:45,,,0,28.49,28.49,0,-19438,67607,87045,48169,0,-222,0,0,0,,222,-222
20,05/13/2017,16,3:45,4:00,,25.09,0,25.09,25.09,-1,-21415,67424,88839,46009,0,-1961,0,0,0,,1961,-1961
20,05/13/2017,17,4:00,4:15,,27.29,0,27.29,27.29,-1,-15441,76412,91853,60971,0,-2300,0,0,0,,2300,-2300
20,05/13/2017,18,4:15,4:30,,,0,27.67,27.67,0,-15386,99632,115018,84246,0,-9,0,0,0,,9,-9
20,05/13/2017,19,4:30,4:45,,27.55,0,27.55,27.55,-1,-13452,110946,124398,97494,0,-5,0,0,0,,5,-5
20,05/13/2017,20,4:45,5:00,,27.54,0,27.54,27.54,-1,-12678,84754,97432,72076,0,-56,0,0,0,,56,-56
20,05/13/2017,21,5:00,5:15,,26.29,0,26.29,26.29,-1,-26685,77351,104036,50666,0,-4634,0,0,0,,4634,-4634
20,05/13/2017,22,5:15,5:30,,27.18,0,27.18,27.18,-1,-26305,66055,92360,39750,0,-3560,0,0,0,,3560,-3560
20,05/13/2017,23,5:30,5:45,,,0,27.62,27.62,0,-27053,61904,88957,34851,0,0,0,0,0,,0,0
20,05/13/2017,24,5:45,6:00,,26.29,0,26.29,26.29,-1,-20650,76944,97594,56294,0,-607,0,0,0,,607,-607
20,05/13/2017,25,6:00,6:15,,23.07,0,23.07,23.07,-1,-4984,82039,87023,77055,0,-7838,0,0,0,,7838,-7838
20,05/13/2017,26,6:15,6:30,,22.09,0,22.09,22.09,-1,-5572,59686,65258,54114,0,-16306,0,0,0,,16306,-16306
20,05/13/2017,27,6:30,6:45,,22.09,0,22.09,22.09,-1,-21446,57094,78540,35648,0,-16981,0,0,0,,16981,-16981
20,05/13/2017,28,6:45,7:00,,22.09,0,22.09,22.09,-1,-46507,78496,125003,31989,0,-20657,0,0,0,,20657,-20657
20,05/13/2017,29,7:00,7:15,,23.07,0,23.07,23.07,-1,-28918,105668,134586,76750,0,-14268,0,0,0,,14268,-14268
20,05/13/2017,30,7:15,7:30,,,0,27.57,27.57,0,-25532,101489,127021,75957,0,-2672,0,0,0,,2672,-2672
20,05/13/2017,31,7:30,7:45,,,0,27.55,27.55,0,-45086,103322,148408,58236,0,0,0,0,0,,0,0
20,05/13/2017,32,7:45,8:00,,,0,27.7,27.7,0,-59780,101361,161141,41581,0,0,0,0,0,,0,0
20,05/13/2017,33,8:00,8:15,,27.37,0,27.37,27.37,-1,-34502,87197,121699,52695,0,-182,0,0,0,,182,-182
20,05/13/2017,34,8:15,8:30,,27.37,0,27.37,27.37,-1,-28288,60387,88675,32099,0,-1345,0,0,0,,1345,-1345
20,05/13/2017,35,8:30,8:45,,27.13,0,27.13,27.13,-1,-41393,85021,126414,43628,0,-1397,0,0,0,,1397,-1397
20,05/13/2017,36,8:45,9:00,,,0,31.29,31.29,0,-69442,84053,153495,14611,0,-78,0,0,0,,78,-78
20,05/13/2017,37,9:00,9:15,,32.19,0,32.19,32.19,-1,-18084,109577,127661,91493,0,-35,0,0,0,,35,-35
20,05/13/2017,38,9:15,9:30,,32.39,0,32.39,32.39,-1,-42898,79509,122407,36611,0,-2,0,0,0,,2,-2
20,05/13/2017,39,9:30,9:45,27.59,,0,27.59,27.59,1,-61712,66261,127973,4549,0,0,36,0,0,,36,36
20,05/13/2017,40,9:45,10:00,29.72,,0,29.72,29.72,1,-69732,68254,137986,-1478,0,0,1758,0,0,,1758,1758
20,05/13/2017,41,10:00,10:15,,,0,30.14,30.14,0,-33591,77312,110903,43721,0,0,254,0,0,,254,254
20,05/13/2017,42,10:15,10:30,,,0,31.29,31.29,0,-30451,84773,115224,54322,0,0,0,0,0,,0,0
20,05/13/2017,43,10:30,10:45,,27.09,0,27.09,27.09,-1,-26587,86765,113352,60178,0,-339,0,0,0,,339,-339
20,05/13/2017,44,10:45,11:00,,23.4,0,23.4,23.4,-1,-26743,90547,117290,63804,0,-2730,0,0,0,,2730,-2730
20,05/13/2017,45,11:00,11:15,,23.38,0,23.38,23.38,-1,-21811,107573,129384,85762,0,-4366,0,0,0,,4366,-4366
20,05/13/2017,46,11:15,11:30,,,0,29.54,29.54,0,-24141,109087,133228,84946,0,0,0,0,0,,0,0
20,05/13/2017,47,11:30,11:45,,27.09,0,27.09,27.09,-1,-19507,102922,122429,83415,0,-1119,0,0,0,,1119,-1119
20,05/13/2017,48,11:45,12:00,,26.09,0,26.09,26.09,-1,-15771,88390,104161,72619,0,-9972,0,0,0,,9972,-9972
20,05/13/2017,49,12:00,12:15,28.76,27.08,0,31.29,27.08,2,-52473,49399,101872,-3074,0,-6248,1066,0,0,,7314,-5182
20,05/13/2017,50,12:15,12:30,,26.03,0,26.03,26.03,-1,-50535,57087,107622,6552,0,-7184,0,0,0,,7184,-7184
20,05/13/2017,51,12:30,12:45,,17.16,0,17.16,17.16,-1,-30294,53891,84185,23597,0,-10606,0,0,0,,10606,-10606
20,05/13/2017,52,12:45,13:00,27.59,26.03,0,27.59,27.59,1,-44780,48596,93376,3816,0,-12234,32,0,0,,12266,-12202
20,05/13/2017,53,13:00,13:15,27.59,26.03,0,27.59,27.59,1,-68381,62285,130666,-6096,0,-402,1467,0,0,,1869,1065
20,05/13/2017,54,13:15,13:30,27.9,,0,27.9,27.9,1,-56166,53091,109257,-3075,0,0,2486,0,0,,2486,2486
20,05/13/2017,55,13:30,13:45,26.07,,0,26.07,26.07,1,-53154,52144,105298,-1010,0,0,325,0,0,,325,325
20,05/13/2017,56,13:45,14:00,27.96,,0,27.96,27.96,1,-62214,51212,113426,-11002,0,0,685,0,0,,685,685
20,05/13/2017,57,14:00,14:15,28.74,,0,28.74,28.74,1,-73560,67684,141244,-5876,0,0,4135,0,0,,4135,4135
20,05/13/2017,58,14:15,14:30,28.88,27.13,0,27.13,27.13,-1,-64967,62694,127661,-2273,0,-48,3438,0,0,,3486,3390
20,05/13/2017,59,14:30,14:45,,26.09,0,26.09,26.09,-1,-56220,67188,123408,10968,0,-4765,0,0,0,,4765,-4765
20,05/13/2017,60,14:45,15:00,,22.09,0,22.09,22.09,-1,-43931,65127,109058,21196,0,-13259,0,0,0,,13259,-13259
20,05/13/2017,61,15:00,15:15,,26.03,0,26.03,26.03,-1,-67201,80798,147999,13597,0,-11216,0,0,0,,11216,-11216
20,05/13/2017,62,15:15,15:30,,27.09,0,27.09,27.09,-1,-40552,74816,115368,34264,0,-457,0,0,0,,457,-457
20,05/13/2017,63,15:30,15:45,,27.5,0,27.5,27.5,-1,-32493,72986,105479,40493,0,-878,0,0,0,,878,-878
20,05/13/2017,64,15:45,16:00,,27.09,0,27.09,27.09,-1,-48789,63317,112106,14528,0,-115,0,0,0,,115,-115
20,05/13/2017,65,16:00,16:15,,27.09,0,27.09,27.09,-1,-29345,116803,146148,87458,0,-1410,0,0,0,,1410,-1410
20,05/13/2017,66,16:15,16:30,,27.79,0,27.79,27.79,-1,-41565,94569,136134,53004,0,-292,0,0,0,,292,-292
20,05/13/2017,67,16:30,16:45,,,0,27.41,27.41,0,-49830,80156,129986,30326,0,0,0,0,0,,0,0
20,05/13/2017,68,16:45,17:00,,27.07,0,27.07,27.07,-1,-62110,75639,137749,13529,0,-266,0,0,0,,266,-266
20,05/13/2017,69,17:00,17:15,,27.09,0,27.09,27.09,-1,-49471,85436,134907,35965,0,-584,0,0,0,,584,-584
20,05/13/2017,70,17:15,17:30,,22.09,0,22.09,22.09,-1,-57470,88986,146456,31516,0,-11715,0,0,0,,11715,-11715
20,05/13/2017,71,17:30,17:45,30.81,22.09,0,30.81,30.81,1,-77176,58111,135287,-19065,0,-2102,2221,0,0,,4323,119
20,05/13/2017,72,17:45,18:00,34.57,,0,34.57,34.57,1,-105463,53599,159062,-51864,0,0,15117,0,0,,15117,15117
20,05/13/2017,73,18:00,18:15,130.02,,0,130.02,130.02,1,-156716,43576,200292,-113140,0,0,48074,0,0,,48074,48074
20,05/13/2017,74,18:15,18:30,33.49,,0,33.49,33.49,1,-130258,66286,196544,-63972,0,0,20164,0,0,,20164,20164
20,05/13/2017,75,18:30,18:45,40.79,,0,40.79,40.79,1,-131680,69063,200743,-62617,0,0,19984,0,0,,19984,19984
20,05/13/2017,76,18:45,19:00,32.69,,0,32.69,32.69,1,-96010,67973,163983,-28037,0,0,19786,0,0,,19786,19786
20,05/13/2017,77,19:00,19:15,29.59,,0,29.59,29.59,1,-86228,54278,140506,-31950,0,0,9241,0,0,,9241,9241
20,05/13/2017,78,19:15,19:30,30,,0,30,30,1,-75845,57316,133161,-18529,0,0,1335,0,0,,1335,1335
20,05/13/2017,79,19:30,19:45,29.59,,0,29.59,29.59,1,-68367,62360,130727,-6007,0,0,3818,0,0,,3818,3818
20,05/13/2017,80,19:45,20:00,28.9,,0,28.9,28.9,1,-65298,56773,122071,-8525,0,0,983,0,0,,983,983
20,05/13/2017,81,20:00,20:15,29.59,,0,29.59,29.59,1,-65048,62876,127924,-2172,0,0,2286,0,0,,2286,2286
20,05/13/2017,82,20:15,20:30,28.93,,0,28.93,28.93,1,-43543,53366,96909,9823,0,0,1938,0,0,,1938,1938
20,05/13/2017,83,20:30,20:45,,,0,27.65,27.65,0,-54159,70332,124491,16173,0,0,0,0,0,,0,0
20,05/13/2017,84,20:45,21:00,,13.29,0,13.29,13.29,-1,-42583,79842,122425,37259,0,-16022,0,0,0,,16022,-16022
20,05/13/2017,85,21:00,21:15,,17.09,0,17.09,17.09,-1,-18171,96572,114743,78401,0,-35242,0,0,0,,35242,-35242
20,05/13/2017,86,21:15,21:30,,,0,30.18,30.18,0,-23157,76155,99312,52998,0,-2512,0,0,0,,2512,-2512
20,05/13/2017,87,21:30,21:45,,,0,30.13,30.13,0,-22398,76675,99073,54277,0,0,0,0,0,,0,0
20,05/13/2017,88,21:45,22:00,,,0,30.02,30.02,0,-42882,65999,108881,23117,0,0,0,0,0,,0,0
20,05/13/2017,89,22:00,22:15,30,,0,30,30,1,-54359,62649,117008,8290,0,0,173,0,0,,173,173
20,05/13/2017,90,22:15,22:30,,27.09,0,27.09,27.09,-1,-56169,62580,118749,6411,0,-831,0,0,0,,831,-831
20,05/13/2017,91,22:30,22:45,,27.09,0,27.09,27.09,-1,-30086,73319,103405,43233,0,-942,0,0,0,,942,-942
20,05/13/2017,92,22:45,23:00,,27,0,27,27,-1,-25942,81833,107775,55891,0,-98,0,0,0,,98,-98
20,05/13/2017,93,23:00,23:15,,25.81,0,25.81,25.81,-1,-88143,48777,136920,-39366,0,-575,0,0,0,,575,-575
20,05/13/2017,94,23:15,23:30,,,0,29.79,29.79,0,-66367,45009,111376,-21358,0,0,0,0,0,,0,0
20,05/13/2017,95,23:30,23:45,27.59,,0,27.59,27.59,1,-31244,34927,66171,3683,0,0,187,0,0,,187,187
20,05/13/2017,96,23:45,0:00,27.59,23.87,0,23.87,23.87,-1,-21888,55741,77629,33853,0,-8437,1,0,0,,8438,-8436
20,05/14/2017,1,0:00,0:15,33.61,25.78,0,33.61,33.61,1,-76069,85744,161813,9675,0,-7310,1320,0,0,,8630,-5990
20,05/14/2017,2,0:15,0:30,39.09,27.09,0,39.09,27.09,2,-45143,43394,88537,-1749,0,-59,13232,0,0,,13291,13173
20,05/14/2017,3,0:30,0:45,27.09,26.94,0,27.89,26.94,2,-47257,24352,71609,-22905,0,-443,515,0,0,,958,72
20,05/14/2017,4,0:45,1:00,37.41,,0,37.41,37.41,1,-116535,54376,170911,-62159,0,0,9900,0,0,,9900,9900
20,05/14/2017,5,1:00,1:15,39.09,,0,39.09,39.09,1,-45269,44337,89606,-932,0,0,5453,0,0,,5453,5453
20,05/14/2017,6,1:15,1:30,28.63,9.09,0,9.09,9.09,-1,-37031,59060,96091,22029,0,-3528,5470,0,0,,8998,1942
20,05/14/2017,7,1:30,1:45,,2.97,0,2.97,2.97,-1,-8170,56395,64565,48225,0,-36451,0,0,0,,36451,-36451
20,05/14/2017,8,1:45,2:00,,16.31,0,16.31,16.31,-1,-13110,65739,78849,52629,0,-50010,0,0,0,,50010,-50010
20,05/14/2017,9,2:00,2:15,33.83,18.89,0,33.83,33.83,1,-22697,42456,65153,19759,0,-26017,662,0,0,,26679,-25355
20,05/14/2017,10,2:15,2:30,39.09,23.86,0,39.09,23.86,2,-32657,33093,65750,436,0,-1452,3693,0,0,,5145,2241
20,05/14/2017,11,2:30,2:45,,22.09,0,22.09,22.09,-1,-18738,37198,55936,18460,0,-19583,0,0,0,,19583,-19583
20,05/14/2017,12,2:45,3:00,,23.95,0,23.95,23.95,-1,-20304,45649,65953,25345,0,-26817,0,0,0,,26817,-26817
20,05/14/2017,13,3:00,3:15,,25.78,0,25.78,25.78,-1,-30860,69229,100089,38369,0,-11390,0,0,0,,11390,-11390
20,05/14/2017,14,3:15,3:30,,,0,27.25,27.25,0,-21805,57231,79036,35426,0,-36,0,0,0,,36,-36
20,05/14/2017,15,3:30,3:45,,,0,27.16,27.16,0,-19092,75228,94320,56136,0,0,0,0,0,,0,0
20,05/14/2017,16,3:45,4:00,,23.95,0,23.95,23.95,-1,-18345,95473,113818,77128,0,-2750,0,0,0,,2750,-2750
20,05/14/2017,17,4:00,4:15,,27.09,0,27.09,27.09,-1,-9291,98026,107317,88735,0,-3443,0,0,0,,3443,-3443
20,05/14/2017,18,4:15,4:30,,24.46,0,24.46,24.46,-1,-11551,96850,108401,85299,0,-2985,0,0,0,,2985,-2985
20,05/14/2017,19,4:30,4:45,,18.89,0,18.89,18.89,-1,-7131,97145,104276,90014,0,-20850,0,0,0,,20850,-20850
20,05/14/2017,20,4:45,5:00,,19.67,0,19.67,19.67,-1,-3495,107341,110836,103846,0,-34323,0,0,0,,34323,-34323
20,05/14/2017,21,5:00,5:15,,-15.01,0,-15.01,-15.01,-1,-11673,112896,124569,101223,0,-39871,0,0,0,,39871,-39871
20,05/14/2017,22,5:15,5:30,,-15.01,0,-15.01,-15.01,-1,-7995,103027,111022,95032,0,-53274,0,0,0,,53274,-53274
20,05/14/2017,23,5:30,5:45,,-52.02,0,-52.02,-52.02,-1,-5684,114208,119892,108524,0,-74278,0,0,0,,74278,-74278
20,05/14/2017,24,5:45,6:00,,-52.02,0,-52.02,-52.02,-1,-7502,134086,141588,126584,0,-87912,0,0,0,,87912,-87912
20,05/14/2017,25,6:00,6:15,,-29.01,0,-29.01,-29.01,-1,-19561,93145,112706,73584,0,-89294,0,0,0,,89294,-89294
20,05/14/2017,26,6:15,6:30,,-29.01,0,-29.01,-29.01,-1,-16034,118032,134066,101998,0,-82916,0,0,0,,82916,-82916
20,05/14/2017,27,6:30,6:45,,-29.01,0,-29.01,-29.01,-1,-19995,107277,127272,87282,0,-82680,0,0,0,,82680,-82680
20,05/14/2017,28,6:45,7:00,,-29.01,0,-29.01,-29.01,-1,-26604,136813,163417,110209,0,-75709,0,0,0,,75709,-75709
20,05/14/2017,29,7:00,7:15,,-4.15,0,-4.15,-4.15,-1,-33990,105694,139684,71704,0,-71461,0,0,0,,71461,-71461
20,05/14/2017,30,7:15,7:30,,22.16,0,22.16,22.16,-1,-37662,103014,140676,65352,0,-42893,0,0,0,,42893,-42893
20,05/14/2017,31,7:30,7:45,,26.18,0,26.18,26.18,-1,-51196,91810,143006,40614,0,-9327,0,0,0,,9327,-9327
20,05/14/2017,32,7:45,8:00,27.82,,0,27.82,27.82,1,-54507,78798,133305,24291,0,0,458,0,0,,458,458
20,05/14/2017,33,8:00,8:15,27.18,24.43,0,24.43,24.43,-1,-47354,87699,135053,40345,0,-4944,67,0,0,,5011,-4877
20,05/14/2017,34,8:15,8:30,,24.43,0,24.43,24.43,-1,-37414,99038,136452,61624,0,-10712,0,0,0,,10712,-10712
20,05/14/2017,35,8:30,8:45,,,0,27.24,27.24,0,-38511,96473,134984,57962,0,-704,0,0,0,,704,-704
20,05/14/2017,36,8:45,9:00,,,0,27.29,27.29,0,-53103,101648,154751,48545,0,0,0,0,0,,0,0
20,05/14/2017,37,9:00,9:15,,,0,27.01,27.01,0,-40002,110868,150870,70866,0,0,0,0,0,,0,0
20,05/14/2017,38,9:15,9:30,,,0,27.1,27.1,0,-40169,97322,137491,57153,0,0,0,0,0,,0,0
20,05/14/2017,39,9:30,9:45,,,0,27.1,27.1,0,-50161,84519,134680,34358,0,0,0,0,0,,0,0
20,05/14/2017,40,9:45,10:00,,,0,27.29,27.29,0,-59390,91776,151166,32386,0,0,0,0,0,,0,0
20,05/14/2017,41,10:00,10:15,,,0,27.01,27.01,0,-32929,84342,117271,51413,0,0,0,0,0,,0,0
20,05/14/2017,42,10:15,10:30,,,0,27.01,27.01,0,-29323,83720,113043,54397,0,0,0,0,0,,0,0
20,05/14/2017,43,10:30,10:45,,,0,27.05,27.05,0,-41060,92767,133827,51707,0,0,0,0,0,,0,0
20,05/14/2017,44,10:45,11:00,,25.25,0,25.25,25.25,-1,-31264,101064,132328,69800,0,-227,0,0,0,,227,-227
20,05/14/2017,45,11:00,11:15,,-22.77,0,-22.77,-22.77,-1,-16020,125477,141497,109457,0,-39015,0,0,0,,39015,-39015
20,05/14/2017,46,11:15,11:30,,21.29,0,21.29,21.29,-1,-19692,109214,128906,89522,0,-36915,0,0,0,,36915,-36915
20,05/14/2017,47,11:30,11:45,,-22.77,0,-22.77,-22.77,-1,-22394,109175,131569,86781,0,-28607,0,0,0,,28607,-28607
20,05/14/2017,48,11:45,12:00,,21.39,0,21.39,21.39,-1,-34252,100877,135129,66625,0,-24955,0,0,0,,24955,-24955
20,05/14/2017,49,12:00,12:15,,23.42,0,23.42,23.42,-1,-43493,101216,144709,57723,0,-10059,0,0,0,,10059,-10059
20,05/14/2017,50,12:15,12:30,,23.38,0,23.38,23.38,-1,-63539,111972,175511,48433,0,-15682,0,0,0,,15682,-15682
20,05/14/2017,51,12:30,12:45,,24.91,0,24.91,24.91,-1,-67782,119148,186930,51366,0,-9294,0,0,0,,9294,-9294
20,05/14/2017,52,12:45,13:00,,-21.81,0,-21.81,-21.81,-1,-64049,122679,186728,58630,0,-14513,0,0,0,,14513,-14513
20,05/14/2017,53,13:00,13:15,,20.87,0,20.87,20.87,-1,-36499,93887,130386,57388,0,-13681,0,0,0,,13681,-13681
20,05/14/2017,54,13:15,13:30,,24.75,0,24.75,24.75,-1,-46601,103855,150456,57254,0,-484,0,0,0,,484,-484
20,05/14/2017,55,13:30,13:45,,-22.53,0,-22.53,-22.53,-1,-45996,120793,166789,74797,0,-29593,0,0,0,,29593,-29593
20,05/14/2017,56,13:45,14:00,,-22.53,0,-22.53,-22.53,-1,-49001,112932,161933,63931,0,-57170,0,0,0,,57170,-57170
20,05/14/2017,57,14:00,14:15,,22.18,0,22.18,22.18,-1,-64712,89533,154245,24821,0,-20170,0,0,0,,20170,-20170
20,05/14/2017,58,14:15,14:30,,16.7,0,16.7,16.7,-1,-64914,96274,161188,31360,0,-6768,0,0,0,,6768,-6768
20,05/14/2017,59,14:30,14:45,,16.7,0,16.7,16.7,-1,-54852,82437,137289,27585,0,-29651,0,0,0,,29651,-29651
20,05/14/2017,60,14:45,15:00,,22.18,0,22.18,22.18,-1,-56620,91622,148242,35002,0,-29205,0,0,0,,29205,-29205
20,05/14/2017,61,15:00,15:15,27.18,26.18,0,27.18,26.18,2,-79290,76603,155893,-2687,0,-9324,344,0,0,,9668,-8980
20,05/14/2017,62,15:15,15:30,,26.18,0,26.18,26.18,-1,-67241,82720,149961,15479,0,-835,0,0,0,,835,-835
20,05/14/2017,63,15:30,15:45,,27.18,0,27.18,27.18,-1,-45356,68114,113470,22758,0,-2697,0,0,0,,2697,-2697
20,05/14/2017,64,15:45,16:00,,26.18,0,26.18,26.18,-1,-22873,65919,88792,43046,0,-1493,0,0,0,,1493,-1493
20,05/14/2017,65,16:00,16:15,,27.63,0,27.63,27.63,-1,-34361,62192,96553,27831,0,-757,0,0,0,,757,-757
20,05/14/2017,66,16:15,16:30,,27.18,0,27.18,27.18,-1,-13519,84938,98457,71419,0,-1175,0,0,0,,1175,-1175
20,05/14/2017,67,16:30,16:45,,25,0,25,25,-1,-23315,106867,130182,83552,0,-7537,0,0,0,,7537,-7537
20,05/14/2017,68,16:45,17:00,,26.5,0,26.5,26.5,-1,-50239,74130,124369,23891,0,-4746,0,0,0,,4746,-4746
20,05/14/2017,69,17:00,17:15,,-22.9,0,-22.9,-22.9,-1,-39656,131534,171190,91878,0,-40504,0,0,0,,40504,-40504
20,05/14/2017,70,17:15,17:30,,0.41,0,0.41,0.41,-1,-35238,59425,94663,24187,0,-53995,0,0,0,,53995,-53995
20,05/14/2017,71,17:30,17:45,,25.68,0,25.68,25.68,-1,-45193,44745,89938,-448,0,-5957,0,0,0,,5957,-5957
20,05/14/2017,72,17:45,18:00,,24.7,0,24.7,24.7,-1,-42326,57083,99409,14757,0,-4593,0,0,0,,4593,-4593
20,05/14/2017,73,18:00,18:15,,-21.85,0,-21.85,-21.85,-1,-34015,72903,106918,38888,0,-47027,0,0,0,,47027,-47027
20,05/14/2017,74,18:15,18:30,,-74.34,0,-74.34,-74.34,-1,-52646,79850,132496,27204,-23750,-84519,0,0,0,,108269,-108269
20,05/14/2017,75,18:30,18:45,,24.83,0,24.83,24.83,-1,-67709,52821,120530,-14888,0,-18997,0,0,0,,18997,-18997
20,05/14/2017,76,18:45,19:00,,,0,28.89,28.89,0,-53167,53436,106603,269,0,-1856,0,0,0,,1856,-1856
20,05/14/2017,77,19:00,19:15,,-21.85,0,-21.85,-21.85,-1,-48413,85272,133685,36859,0,-29983,0,0,0,,29983,-29983
20,05/14/2017,78,19:15,19:30,,-74.34,0,-74.34,-74.34,-1,-54770,68291,123061,13521,-23750,-87404,0,0,0,,111154,-111154
20,05/14/2017,79,19:30,19:45,,-25.78,0,-25.78,-25.78,-1,-54467,41300,95767,-13167,-15000,-14542,0,0,0,,29542,-29542
20,05/14/2017,80,19:45,20:00,,,0,28.89,28.89,0,-99383,34052,133435,-65331,0,-24,0,0,0,,24,-24
20,05/14/2017,81,20:00,20:15,28.48,,0,28.48,28.48,1,-116806,33399,150205,-83407,0,0,75,0,0,,75,75
20,05/14/2017,82,20:15,20:30,29.55,,0,29.55,29.55,1,-121452,25748,147200,-95704,0,0,2865,0,0,,2865,2865
20,05/14/2017,83,20:30,20:45,29.49,,0,29.49,29.49,1,-122475,27244,149719,-95231,0,0,4046,0,0,,4046,4046
20,05/14/2017,84,20:45,21:00,,,0,29.64,29.64,0,-110716,32150,142866,-78566,0,0,728,0,0,,728,728
20,05/14/2017,85,21:00,21:15,,,0,37.12,37.12,0,-69753,45259,115012,-24494,0,0,0,0,0,,0,0
20,05/14/2017,86,21:15,21:30,,27.18,0,27.18,27.18,-1,-45311,57265,102576,11954,0,-1755,0,0,0,,1755,-1755
20,05/14/2017,87,21:30,21:45,,27.56,0,27.56,27.56,-1,-56211,50197,106408,-6014,0,-1042,0,0,0,,1042,-1042
20,05/14/2017,88,21:45,22:00,,,0,37.12,37.12,0,-106811,45958,152769,-60853,0,0,0,0,0,,0,0
20,05/14/2017,89,22:00,22:15,,,0,29.91,29.91,0,-92379,46429,138808,-45950,0,0,0,0,0,,0,0
20,05/14/2017,90,22:15,22:30,,,0,29.93,29.93,0,-74188,40493,114681,-33695,0,0,0,0,0,,0,0
20,05/14/2017,91,22:30,22:45,,,0,29.94,29.94,0,-54116,43695,97811,-10421,0,0,0,0,0,,0,0
20,05/14/2017,92,22:45,23:00,,17.18,0,17.18,17.18,-1,-34522,61501,96023,26979,0,-8861,0,0,0,,8861,-8861
20,05/14/2017,93,23:00,23:15,32.4,24.21,0,36.46,24.21,2,-86500,44615,131115,-41885,0,-10485,1553,0,0,,12038,-8932
20,05/14/2017,94,23:15,23:30,30.37,,0,30.37,30.37,1,-64648,32015,96663,-32633,0,0,4586,0,0,,4586,4586
20,05/14/2017,95,23:30,23:45,30.37,22.83,0,22.83,22.83,-1,-32469,38823,71292,6354,0,-6790,1135,0,0,,7925,-5655
20,05/14/2017,96,23:45,0:00,,20.43,0,20.43,20.43,-1,-33054,68495,101549,35441,0,-37130,0,0,0,,37130,-37130
20,05/15/2017,1,0:00,0:15,,23.22,0,23.22,23.22,-1,-63178,72441,135619,9263,0,-18808,0,0,0,,18808,-18808
20,05/15/2017,2,0:15,0:30,,-21.85,0,-21.85,-21.85,-1,-38923,75376,114299,36453,0,-4552,0,0,0,,4552,-4552
20,05/15/2017,3,0:30,0:45,,-200,0,-200,-200,-1,-48847,50128,98975,1281,0,-13714,0,0,0,,13714,-13714
20,05/15/2017,4,0:45,1:00,,22.09,0,22.09,22.09,-1,-93581,59741,153322,-33840,0,-11960,0,0,0,,11960,-11960
20,05/15/2017,5,1:00,1:15,,26.09,0,26.09,26.09,-1,-63924,56181,120105,-7743,0,-7541,0,0,0,,7541,-7541
20,05/15/2017,6,1:15,1:30,,7.69,0,7.69,7.69,-1,-52108,52979,105087,871,0,-12776,0,0,0,,12776,-12776
20,05/15/2017,7,1:30,1:45,,22.09,0,22.09,22.09,-1,-51156,57368,108524,6212,0,-25285,0,0,0,,25285,-25285
20,05/15/2017,8,1:45,2:00,,-200,0,-200,-200,-1,-60063,62880,122943,2817,0,-39861,0,0,0,,39861,-39861
20,05/15/2017,9,2:00,2:15,29.09,17.09,0,29.09,29.09,1,-98386,43239,141625,-55147,0,-18507,189,0,0,,18696,-18318
20,05/15/2017,10,2:15,2:30,29.09,22.09,0,29.54,22.09,2,-93891,39578,133469,-54313,0,-3890,187,0,0,,4077,-3703
20,05/15/2017,11,2:30,2:45,,19.74,0,19.74,19.74,-1,-81092,39797,120889,-41295,0,-17739,0,0,0,,17739,-17739
20,05/15/2017,12,2:45,3:00,,7.69,0,7.69,7.69,-1,-78514,40577,119091,-37937,0,-37511,0,0,0,,37511,-37511
20,05/15/2017,13,3:00,3:15,,16.7,0,16.7,16.7,-1,-78051,55752,133803,-22299,0,-26242,0,0,0,,26242,-26242
20,05/15/2017,14,3:15,3:30,,,0,29.01,29.01,0,-77420,52977,130397,-24443,0,-456,0,0,0,,456,-456
20,05/15/2017,15,3:30,3:45,,-2,0,-2,-2,-1,-60651,55822,116473,-4829,0,-16225,0,0,0,,16225,-16225
20,05/15/2017,16,3:45,4:00,,-13.28,0,-13.28,-13.28,-1,-70799,61185,131984,-9614,0,-43006,0,0,0,,43006,-43006
20,05/15/2017,17,4:00,4:15,,22.09,0,22.09,22.09,-1,-68019,71077,139096,3058,0,-24687,0,0,0,,24687,-24687
20,05/15/2017,18,4:15,4:30,,26.09,0,26.09,26.09,-1,-69113,66431,135544,-2682,0,-12021,0,0,0,,12021,-12021
20,05/15/2017,19,4:30,4:45,,25.19,0,25.19,25.19,-1,-73212,68830,142042,-4382,0,-12748,0,0,0,,12748,-12748
20,05/15/2017,20,4:45,5:00,27.09,27.09,0,29.01,27.09,2,-72942,66060,139002,-6882,0,-4803,27,0,0,,4830,-4776
20,05/15/2017,21,5:00,5:15,,28.19,0,28.19,28.19,-1,-102003,83643,185646,-18360,0,-865,0,0,0,,865,-865
20,05/15/2017,22,5:15,5:30,,31.99,0,31.99,31.99,-1,-84562,85094,169656,532,0,-156,0,0,0,,156,-156
20,05/15/2017,23,5:30,5:45,,26.09,0,26.09,26.09,-1,-57714,89433,147147,31719,0,-4704,0,0,0,,4704,-4704
20,05/15/2017,24,5:45,6:00,,-30,0,-30,-30,-1,-62856,138276,201132,75420,0,-21799,0,0,0,,21799,-21799
20,05/15/2017,25,6:00,6:15,250,26,0,250,26,2,-95794,99834,195628,4040,0,-7294,8535,0,0,,15829,1241
20,05/15/2017,26,6:15,6:30,41.38,,0,41.38,41.38,1,-19633,95614,115247,75981,0,0,10744,0,0,,10744,10744
20,05/15/2017,27,6:30,6:45,250,,0,250,250,1,-19853,86854,106707,67001,0,0,15801,0,0,,15801,15801
20,05/15/2017,28,6:45,7:00,251.23,,0,251.23,251.23,1,-29010,110666,139676,81656,0,0,38923,0,0,,38923,38923
20,05/15/2017,29,7:00,7:15,29.68,25.19,0,33.58,25.19,2,-9826,223056,232882,213230,0,-610,6279,0,0,,6889,5669
20,05/15/2017,30,7:15,7:30,,,0,33.58,33.58,0,-9664,160501,170165,150837,0,0,0,0,0,,0,0
20,05/15/2017,31,7:30,7:45,,,0,33.58,33.58,0,-14158,144683,158841,130525,0,0,0,0,0,,0,0
20,05/15/2017,32,7:45,8:00,96.19,,0,96.19,96.19,1,-50328,124468,174796,74140,0,0,9845,0,0,,9845,9845
20,05/15/2017,33,8:00,8:15,36.1,-200,0,36.1,-200,2,-17449,159988,177437,142539,0,-16307,3959,0,0,,20266,-12348
20,05/15/2017,34,8:15,8:30,,22.18,0,22.18,22.18,-1,-36359,115324,151683,78965,0,-14859,0,0,0,,14859,-14859
20,05/15/2017,35,8:30,8:45,,25.19,0,25.19,25.19,-1,-32769,99906,132675,67137,0,-11937,0,0,0,,11937,-11937
20,05/15/2017,36,8:45,9:00,,26.18,0,26.18,26.18,-1,-37514,110023,147537,72509,0,-5014,0,0,0,,5014,-5014
20,05/15/2017,37,9:00,9:15,,22.18,0,22.18,22.18,-1,-24261,118312,142573,94051,0,-15685,0,0,0,,15685,-15685
20,05/15/2017,38,9:15,9:30,,23.4,0,23.4,23.4,-1,-23184,123085,146269,99901,0,-19116,0,0,0,,19116,-19116
20,05/15/2017,39,9:30,9:45,,22.18,0,22.18,22.18,-1,-27188,130065,157253,102877,0,-11022,0,0,0,,11022,-11022
20,05/15/2017,40,9:45,10:00,,-11.82,0,-11.82,-11.82,-1,-31688,133991,165679,102303,0,-22217,0,0,0,,22217,-22217
20,05/15/2017,41,10:00,10:15,,25.19,0,25.19,25.19,-1,-39466,82653,122119,43187,0,-11908,0,0,0,,11908,-11908
20,05/15/2017,42,10:15,10:30,,22.18,0,22.18,22.18,-1,-39462,103904,143366,64442,0,-9909,0,0,0,,9909,-9909
20,05/15/2017,43,10:30,10:45,,17.18,0,17.18,17.18,-1,-44041,108614,152655,64573,0,-24134,0,0,0,,24134,-24134
20,05/15/2017,44,10:45,11:00,,20.34,0,20.34,20.34,-1,-47075,103059,150134,55984,0,-19051,0,0,0,,19051,-19051
20,05/15/2017,45,11:00,11:15,,-200,0,-200,-200,-1,-42393,88345,130738,45952,0,-37358,0,0,0,,37358,-37358
20,05/15/2017,46,11:15,11:30,,18.3,0,18.3,18.3,-1,-72862,74798,147660,1936,0,-22716,0,0,0,,22716,-22716
20,05/15/2017,47,11:30,11:45,,26.18,0,26.18,26.18,-1,-61366,78003,139369,16637,0,-9734,0,0,0,,9734,-9734
20,05/15/2017,48,11:45,12:00,,27.18,0,27.18,27.18,-1,-55085,66712,121797,11627,0,-7746,0,0,0,,7746,-7746
20,05/15/2017,49,12:00,12:15,,-1.79,0,-1.79,-1.79,-1,-62800,55151,117951,-7649,0,-21045,0,0,0,,21045,-21045
20,05/15/2017,50,12:15,12:30,,22.18,0,22.18,22.18,-1,-82931,59347,142278,-23584,0,-21060,0,0,0,,21060,-21060
20,05/15/2017,51,12:30,12:45,,22.18,0,22.18,22.18,-1,-72208,77830,150038,5622,0,-13032,0,0,0,,13032,-13032
20,05/15/2017,52,12:45,13:00,,-200,0,-200,-200,-1,-69845,79454,149299,9609,0,-13127,0,0,0,,13127,-13127
20,05/15/2017,53,13:00,13:15,123.41,-200,0,123.41,-200,2,-150197,37755,187952,-112442,0,-14095,2154,0,0,,16249,-11941
20,05/15/2017,54,13:15,13:30,29.68,22.18,0,22.18,22.18,-1,-89159,35379,124538,-53780,0,-1656,1278,0,0,,2934,-378
20,05/15/2017,55,13:30,13:45,,17.18,0,17.18,17.18,-1,-76793,58315,135108,-18478,0,-14502,0,0,0,,14502,-14502
20,05/15/2017,56,13:45,14:00,27.68,27.18,0,27.68,27.68,1,-77809,58540,136349,-19269,0,-8092,141,0,0,,8233,-7951
20,05/15/2017,57,14:00,14:15,27.68,27.18,0,27.68,27.68,1,-62926,73137,136063,10211,0,-172,45,0,0,,217,-127
20,05/15/2017,58,14:15,14:30,27.68,,0,27.68,27.68,1,-60924,57913,118837,-3011,0,0,929,0,0,,929,929
20,05/15/2017,59,14:30,14:45,,27.18,0,27.18,27.18,-1,-48427,66682,115109,18255,0,-968,0,0,0,,968,-968
20,05/15/2017,60,14:45,15:00,,26.03,0,26.03,26.03,-1,-48405,73959,122364,25554,0,-11326,0,0,0,,11326,-11326
20,05/15/2017,61,15:00,15:15,,27.22,0,27.22,27.22,-1,-52430,71543,123973,19113,0,-6469,0,0,0,,6469,-6469
20,05/15/2017,62,15:15,15:30,,,0,34.46,34.46,0,-54095,75504,129599,21409,0,-68,0,0,0,,68,-68
20,05/15/2017,63,15:30,15:45,,25.19,0,25.19,25.19,-1,-53162,93933,147095,40771,0,-5975,0,0,0,,5975,-5975
20,05/15/2017,64,15:45,16:00,,26.18,0,26.18,26.18,-1,-59533,85858,145391,26325,0,-13262,0,0,0,,13262,-13262
20,05/15/2017,65,16:00,16:15,,28.19,0,28.19,28.19,-1,-37899,81356,119255,43457,0,-4952,0,0,0,,4952,-4952
20,05/15/2017,66,16:15,16:30,,,0,34.47,34.47,0,-44193,81947,126140,37754,0,0,0,0,0,,0,0
20,05/15/2017,67,16:30,16:45,,,0,34.46,34.46,0,-59699,86784,146483,27085,0,0,0,0,0,,0,0
20,05/15/2017,68,16:45,17:00,28.23,,0,28.23,28.23,1,-94596,82711,177307,-11885,0,0,1660,0,0,,1660,1660
20,05/15/2017,69,17:00,17:15,28.53,,0,28.53,28.53,1,-75238,65513,140751,-9725,0,0,3234,0,0,,3234,3234
20,05/15/2017,70,17:15,17:30,34.02,,0,34.02,34.02,1,-93288,52111,145399,-41177,0,0,12536,0,0,,12536,12536
20,05/15/2017,71,17:30,17:45,67.44,,0,67.44,67.44,1,-110886,47532,158418,-63354,0,0,25344,0,0,,25344,25344
20,05/15/2017,72,17:45,18:00,80.02,,0,80.02,80.02,1,-121856,48315,170171,-73541,0,0,62489,0,0,,62489,62489
20,05/15/2017,73,18:00,18:15,36.29,,0,36.29,36.29,1,-121054,46709,167763,-74345,0,0,24775,0,0,,24775,24775
20,05/15/2017,74,18:15,18:30,,,0,33.6,33.6,0,-85633,42329,127962,-43304,0,0,0,0,0,,0,0
20,05/15/2017,75,18:30,18:45,,,0,33.56,33.56,0,-78298,52803,131101,-25495,0,0,0,0,0,,0,0
20,05/15/2017,76,18:45,19:00,29.68,,0,29.68,29.68,1,-77859,69656,147515,-8203,0,0,981,0,0,,981,981
20,05/15/2017,77,19:00,19:15,29.68,,0,29.68,29.68,1,-100855,55275,156130,-45580,0,0,1413,0,0,,1413,1413
20,05/15/2017,78,19:15,19:30,,,0,33.55,33.55,0,-95475,63553,159028,-31922,0,0,0,0,0,,0,0
20,05/15/2017,79,19:30,19:45,,,0,33.57,33.57,0,-94185,72197,166382,-21988,0,0,0,0,0,,0,0
20,05/15/2017,80,19:45,20:00,,,0,33.55,33.55,0,-98516,74297,172813,-24219,0,0,0,0,0,,0,0
20,05/15/2017,81,20:00,20:15,30.04,,0,30.04,30.04,1,-89470,52472,141942,-36998,0,0,3361,0,0,,3361,3361
20,05/15/2017,82,20:15,20:30,33.26,,0,33.26,33.26,1,-93078,38862,131940,-54216,0,0,6043,0,0,,6043,6043
20,05/15/2017,83,20:30,20:45,27.97,,0,27.97,27.97,1,-63967,32906,96873,-31061,0,0,4282,0,0,,4282,4282
20,05/15/2017,84,20:45,21:00,27.97,28.19,0,28.19,28.19,-1,-36731,34716,71447,-2015,0,-768,153,0,0,,921,-615
20,05/15/2017,85,21:00,21:15,27.79,28.19,0,27.79,27.79,1,-56975,40002,96977,-16973,0,-842,136,0,0,,978,-706
20,05/15/2017,86,21:15,21:30,35.14,,0,35.14,35.14,1,-60033,35965,95998,-24068,0,0,9478,0,0,,9478,9478
20,05/15/2017,87,21:30,21:45,35.14,,0,35.14,35.14,1,-78693,35136,113829,-43557,0,0,17789,0,0,,17789,17789
20,05/15/2017,88,21:45,22:00,32.38,,0,32.38,32.38,1,-84474,35091,119565,-49383,0,0,18428,0,0,,18428,18428
20,05/15/2017,89,22:00,22:15,33.93,,0,33.93,33.93,1,-141314,38624,179938,-102690,0,0,10507,0,0,,10507,10507
20,05/15/2017,90,22:15,22:30,28.69,,0,28.69,28.69,1,-110162,34031,144193,-76131,0,0,6879,0,0,,6879,6879
20,05/15/2017,91,22:30,22:45,30.22,,0,30.22,30.22,1,-72074,39422,111496,-32652,0,0,2070,0,0,,2070,2070
20,05/15/2017,92,22:45,23:00,27.93,22.87,0,22.87,22.87,-1,-32112,67069,99181,34957,0,-1737,540,0,0,,2277,-1197
20,05/15/2017,93,23:00,23:15,74.02,17.18,0,74.02,17.18,2,-115066,42213,157279,-72853,0,-3380,11036,0,0,,14416,7656
20,05/15/2017,94,23:15,23:30,28.69,27.18,0,27.18,27.18,-1,-71240,47611,118851,-23629,0,-106,4891,0,0,,4997,4785
20,05/15/2017,95,23:30,23:45,,22.18,0,22.18,22.18,-1,-19206,59375,78581,40169,0,-11048,0,0,0,,11048,-11048
20,05/15/2017,96,23:45,0:00,,11,0,11,11,-1,-25694,90240,115934,64546,0,-41593,0,0,0,,41593,-41593
20,05/16/2017,1,0:00,0:15,39.18,24.78,0,39.18,24.78,2,-88921,47485,136406,-41436,0,-10931,4102,0,0,,15033,-6829
20,05/16/2017,2,0:15,0:30,28.68,,0,28.68,28.68,1,-69998,47659,117657,-22339,0,0,3835,0,0,,3835,3835
20,05/16/2017,3,0:30,0:45,27.18,,0,27.18,27.18,1,-79545,49478,129023,-30067,0,0,151,0,0,,151,151
20,05/16/2017,4,0:45,1:00,,,0,28.14,28.14,0,-93015,77012,170027,-16003,0,0,5,0,0,,5,5
20,05/16/2017,5,1:00,1:15,32.01,27.06,0,32.01,27.06,2,-52771,39219,91990,-13552,0,-402,2525,0,0,,2927,2123
20,05/16/2017,6,1:15,1:30,27.18,,0,27.18,27.18,1,-59621,42728,102349,-16893,0,0,1622,0,0,,1622,1622
20,05/16/2017,7,1:30,1:45,,27.05,0,27.05,27.05,-1,-38748,43573,82321,4825,0,-638,0,0,0,,638,-638
20,05/16/2017,8,1:45,2:00,,26.9,0,26.9,26.9,-1,-42474,47904,90378,5430,0,-8068,0,0,0,,8068,-8068
20,05/16/2017,9,2:00,2:15,33.18,25.21,0,33.18,33.18,1,-44699,61066,105765,16367,0,-7000,1022,0,0,,8022,-5978
20,05/16/2017,10,2:15,2:30,44.99,25.21,0,44.99,44.99,1,-83269,39717,122986,-43552,0,-157,25734,0,0,,25891,25577
20,05/16/2017,11,2:30,2:45,28.12,,0,28.12,28.12,1,-45489,48821,94310,3332,0,0,7422,0,0,,7422,7422
20,05/16/2017,12,2:45,3:00,,26.18,0,26.18,26.18,-1,-32834,63998,96832,31164,0,-1522,0,0,0,,1522,-1522
20,05/16/2017,13,3:00,3:15,,25.78,0,25.78,25.78,-1,-29348,67912,97260,38564,0,-1746,0,0,0,,1746,-1746
20,05/16/2017,14,3:15,3:30,,,0,27.59,27.59,0,-19783,63945,83728,44162,0,0,0,0,0,,0,0
20,05/16/2017,15,3:30,3:45,,,0,27.59,27.59,0,-20392,62658,83050,42266,0,0,0,0,0,,0,0
20,05/16/2017,16,3:45,4:00,,27.83,0,27.83,27.83,-1,-20089,67444,87533,47355,0,-19,0,0,0,,19,-19
20,05/16/2017,17,4:00,4:15,,26.91,0,26.91,26.91,-1,-14762,83884,98646,69122,0,-1097,0,0,0,,1097,-1097
20,05/16/2017,18,4:15,4:30,,27.18,0,27.18,27.18,-1,-9305,84271,93576,74966,0,-4026,0,0,0,,4026,-4026
20,05/16/2017,19,4:30,4:45,,25.83,0,25.83,25.83,-1,-10202,93252,103454,83050,0,-7992,0,0,0,,7992,-7992
20,05/16/2017,20,4:45,5:00,,16.38,0,16.38,16.38,-1,-21814,102303,124117,80489,0,-8275,0,0,0,,8275,-8275
20,05/16/2017,21,5:00,5:15,,9.49,0,9.49,9.49,-1,-23379,103532,126911,80153,0,-44287,0,0,0,,44287,-44287
20,05/16/2017,22,5:15,5:30,,3.86,0,3.86,3.86,-1,-26036,84646,110682,58610,0,-54767,0,0,0,,54767,-54767
20,05/16/2017,23,5:30,5:45,,20.78,0,20.78,20.78,-1,-18615,84125,102740,65510,0,-36049,0,0,0,,36049,-36049
20,05/16/2017,24,5:45,6:00,,12.54,0,12.54,12.54,-1,-11463,69863,81326,58400,0,-44598,0,0,0,,44598,-44598
20,05/16/2017,25,6:00,6:15,,22.18,0,22.18,22.18,-1,-57824,96715,154539,38891,0,-36238,0,0,0,,36238,-36238
20,05/16/2017,26,6:15,6:30,,23.11,0,23.11,23.11,-1,-39777,72208,111985,32431,0,-23388,0,0,0,,23388,-23388
20,05/16/2017,27,6:30,6:45,,17.15,0,17.15,17.15,-1,-31157,54449,85606,23292,0,-33475,0,0,0,,33475,-33475
20,05/16/2017,28,6:45,7:00,39.68,17.15,0,39.68,39.68,1,-96825,60246,157071,-36579,0,-5789,3450,0,0,,9239,-2339
20,05/16/2017,29,7:00,7:15,39.68,-1.92,0,-1.92,-1.92,-1,-10159,76483,86642,66324,0,-25513,275,0,0,,25788,-25238
20,05/16/2017,30,7:15,7:30,28.06,26.18,0,28.06,28.06,1,-38613,24898,63511,-13715,0,-7500,70,0,0,,7570,-7430
20,05/16/2017,31,7:30,7:45,34.96,,0,34.96,34.96,1,-100035,35058,135093,-64977,0,0,6091,0,0,,6091,6091
20,05/16/2017,32,7:45,8:00,139.46,,0,139.46,139.46,1,-160155,36669,196824,-123486,0,0,28210,0,0,,28210,28210
20,05/16/2017,33,8:00,8:15,47.35,,0,47.35,47.35,1,-66878,44501,111379,-22377,0,0,21178,0,0,,21178,21178
20,05/16/2017,34,8:15,8:30,33.49,,0,33.49,33.49,1,-101351,37697,139048,-63654,0,0,4077,0,0,,4077,4077
20,05/16/2017,35,8:30,8:45,53.85,,0,53.85,53.85,1,-155425,41514,196939,-113911,0,0,17865,0,0,,17865,17865
20,05/16/2017,36,8:45,9:00,126.69,,0,126.69,126.69,1,-182769,39721,222490,-143048,0,0,53622,0,0,,53622,53622
20,05/16/2017,37,9:00,9:15,28.42,,0,28.42,28.42,1,-87903,46802,134705,-41101,0,0,14882,0,0,,14882,14882
20,05/16/2017,38,9:15,9:30,,,0,30.38,30.38,0,-100382,43318,143700,-57064,0,0,0,0,0,,0,0
20,05/16/2017,39,9:30,9:45,,,0,30.26,30.26,0,-84439,54143,138582,-30296,0,0,0,0,0,,0,0
20,05/16/2017,40,9:45,10:00,,,0,30.25,30.25,0,-93387,44573,137960,-48814,0,0,0,0,0,,0,0
20,05/16/2017,41,10:00,10:15,29.68,27.18,0,34.76,27.18,2,-59501,70233,129734,10732,0,-204,162,0,0,,366,-42
20,05/16/2017,42,10:15,10:30,,22.99,0,22.99,22.99,-1,-50973,71911,122884,20938,0,-15802,0,0,0,,15802,-15802
20,05/16/2017,43,10:30,10:45,,41.51,0,41.51,41.51,-1,-59662,66862,126524,7200,0,-2623,0,0,0,,2623,-2623
20,05/16/2017,44,10:45,11:00,,27.18,0,27.18,27.18,-1,-60487,79031,139518,18544,0,-305,0,0,0,,305,-305
20,05/16/2017,45,11:00,11:15,,26.72,0,26.72,26.72,-1,-46939,81522,128461,34583,0,-2997,0,0,0,,2997,-2997
20,05/16/2017,46,11:15,11:30,,26.47,0,26.47,26.47,-1,-50588,78496,129084,27908,0,-6280,0,0,0,,6280,-6280
20,05/16/2017,47,11:30,11:45,,,0,34.75,34.75,0,-63667,75838,139505,12171,0,-478,0,0,0,,478,-478
20,05/16/2017,48,11:45,12:00,29.68,,0,29.68,29.68,1,-68442,73438,141880,4996,0,0,821,0,0,,821,821
20,05/16/2017,49,12:00,12:15,28.06,,0,28.06,28.06,1,-94130,81039,175169,-13091,0,0,1821,0,0,,1821,1821
20,05/16/2017,50,12:15,12:30,27.68,,0,27.68,27.68,1,-89786,79846,169632,-9940,0,0,252,0,0,,252,252
20,05/16/2017,51,12:30,12:45,,40.89,0,40.89,40.89,-1,-74615,83050,157665,8435,0,-158,0,0,0,,158,-158
20,05/16/2017,52,12:45,13:00,,40.91,0,40.91,40.91,-1,-79454,77232,156686,-2222,0,-70,0,0,0,,70,-70
20,05/16/2017,53,13:00,13:15,,,0,30.19,30.19,0,-78593,71156,149749,-7437,0,-25,0,0,0,,25,-25
20,05/16/2017,54,13:15,13:30,,27.18,0,27.18,27.18,-1,-62950,63941,126891,991,0,-843,0,0,0,,843,-843
20,05/16/2017,55,13:30,13:45,,27.18,0,27.18,27.18,-1,-63640,72252,135892,8612,0,-2852,0,0,0,,2852,-2852
20,05/16/2017,56,13:45,14:00,,27.35,0,27.35,27.35,-1,-62240,62904,125144,664,0,-1218,0,0,0,,1218,-1218
20,05/16/2017,57,14:00,14:15,,27.18,0,27.18,27.18,-1,-50016,94723,144739,44707,0,-2639,0,0,0,,2639,-2639
20,05/16/2017,58,14:15,14:30,,,0,29.94,29.94,0,-55087,103903,158990,48816,0,-278,0,0,0,,278,-278
20,05/16/2017,59,14:30,14:45,,,0,29.94,29.94,0,-49528,90645,140173,41117,0,0,0,0,0,,0,0
20,05/16/2017,60,14:45,15:00,,,0,29.94,29.94,0,-49862,71729,121591,21867,0,0,0,0,0,,0,0
20,05/16/2017,61,15:00,15:15,128.12,,0,232.33,232.33,1,-73125,45572,118697,-27553,0,0,711,0,0,,711,711
20,05/16/2017,62,15:15,15:30,128.12,,0,232.33,232.33,1,-209490,34885,244375,-174605,0,0,58076,0,21846,,79922,79922
20,05/16/2017,63,15:30,15:45,85.43,,0,232.33,232.33,1,-162402,64029,226431,-98373,0,0,58175,8750,28749,,95674,95674
20,05/16/2017,64,15:45,16:00,79.04,,0,232.33,232.33,1,-162591,78538,241129,-84053,0,0,25162,10000,28749,,63911,63911
20,05/16/2017,65,16:00,16:15,85.04,,0,234.52,234.52,1,-153809,89905,243714,-63904,0,0,2900,7500,27391,,37791,37791
20,05/16/2017,66,16:15,16:30,61.78,,0,234.52,234.52,1,-147018,72987,220005,-74031,0,0,9560,5000,15900,,30460,30460
20,05/16/2017,67,16:30,16:45,85.44,,0,234.52,234.52,1,-147592,71966,219558,-75626,0,0,27999,8750,15000,,51749,51749
20,05/16/2017,68,16:45,17:00,79.03,,0,79.03,79.03,1,-158784,61680,220464,-97104,0,0,37090,10000,2346,,49436,49436
20,05/16/2017,69,17:00,17:15,79.03,-11.99,0,-11.99,-11.99,-1,-29844,210459,240303,180615,0,-12997,11844,0,0,,24841,-1153
20,05/16/2017,70,17:15,17:30,,27.34,0,27.34,27.34,-1,-65353,136556,201909,71203,0,-2511,0,0,0,,2511,-2511
20,05/16/2017,71,17:30,17:45,,26.18,0,26.18,26.18,-1,-79512,122412,201924,42900,0,-4664,0,0,0,,4664,-4664
20,05/16/2017,72,17:45,18:00,,,0,30.09,30.09,0,-86827,111292,198119,24465,0,-363,0,0,0,,363,-363
20,05/16/2017,73,18:00,18:15,28.12,,0,28.12,28.12,1,-122025,81353,203378,-40672,0,0,265,0,0,,265,265
20,05/16/2017,74,18:15,18:30,29.68,,0,29.68,29.68,1,-90395,86786,177181,-3609,0,0,706,0,0,,706,706
20,05/16/2017,75,18:30,18:45,29.25,,0,29.25,29.25,1,-82641,91663,174304,9022,0,0,539,0,0,,539,539
20,05/16/2017,76,18:45,19:00,,,0,35.98,35.98,0,-64824,91803,156627,26979,0,0,0,0,0,,0,0
20,05/16/2017,77,19:00,19:15,48.94,,0,48.94,48.94,1,-113300,64153,177453,-49147,0,0,5074,0,0,,5074,5074
20,05/16/2017,78,19:15,19:30,48.94,,0,48.94,48.94,1,-86134,86056,172190,-78,0,0,9419,0,0,,9419,9419
20,05/16/2017,79,19:30,19:45,48.94,45.65,0,45.65,45.65,-1,-77385,87655,165040,10270,0,-27,463,0,0,,490,436
20,05/16/2017,80,19:45,20:00,,23.32,0,23.32,23.32,-1,-67584,106689,174273,39105,0,-9580,0,0,0,,9580,-9580
20,05/16/2017,81,20:00,20:15,,27.18,0,27.18,27.18,-1,-79953,120208,200161,40255,0,-6647,0,0,0,,6647,-6647
20,05/16/2017,82,20:15,20:30,30.62,27.18,0,30.62,30.62,1,-68592,92976,161568,24384,0,-12,643,0,0,,655,631
20,05/16/2017,83,20:30,20:45,30.61,,0,30.61,30.61,1,-82257,64571,146828,-17686,0,0,5782,0,0,,5782,5782
20,05/16/2017,84,20:45,21:00,32.19,,0,32.19,32.19,1,-82677,53211,135888,-29466,0,0,13022,0,0,,13022,13022
20,05/16/2017,85,21:00,21:15,35.49,,0,35.49,35.49,1,-137826,38390,176216,-99436,0,0,11056,0,0,,11056,11056
20,05/16/2017,86,21:15,21:30,36.5,,0,36.5,36.5,1,-155636,34568,190204,-121068,0,0,16850,0,0,,16850,16850
20,05/16/2017,87,21:30,21:45,264.49,,0,264.49,264.49,1,-180350,28579,208929,-151771,0,0,52364,0,0,,52364,52364
20,05/16/2017,88,21:45,22:00,264.49,,0,264.49,264.49,1,-145779,26767,172546,-119012,0,0,83571,0,0,,83571,83571
20,05/16/2017,89,22:00,22:15,224.99,,0,224.99,224.99,1,-98048,48025,146073,-50023,0,0,25555,5000,0,,30555,30555
20,05/16/2017,90,22:15,22:30,224.99,40.7,0,40.7,40.7,-1,-77693,73800,151493,-3893,0,-228,4788,0,0,,5016,4560
20,05/16/2017,91,22:30,22:45,43.01,,0,43.01,43.01,1,-91840,60248,152088,-31592,0,0,10406,0,0,,10406,10406
20,05/16/2017,92,22:45,23:00,47.12,,0,47.12,47.12,1,-124218,78794,203012,-45424,0,0,35542,0,0,,35542,35542
20,05/16/2017,93,23:00,23:15,154.45,,0,154.45,154.45,1,-179816,23190,203006,-156626,0,0,53694,0,0,,53694,53694
20,05/16/2017,94,23:15,23:30,154.45,,0,154.45,154.45,1,-125769,28873,154642,-96896,0,0,91089,0,0,,91089,91089
20,05/16/2017,95,23:30,23:45,39.68,,0,39.68,39.68,1,-75934,61867,137801,-14067,0,0,30830,0,0,,30830,30830
20,05/16/2017,96,23:45,0:00,31.74,,0,31.74,31.74,1,-91747,60590,152337,-31157,0,0,4402,0,0,,4402,4402
20,05/17/2017,1,0:00,0:15,46.71,26.02,0,46.71,26.02,2,-77696,71693,149389,-6003,0,-502,5657,0,0,,6159,5155
20,05/17/2017,2,0:15,0:30,60.83,,0,60.83,60.83,1,-112296,73002,185298,-39294,0,0,32198,0,0,,32198,32198
20,05/17/2017,3,0:30,0:45,60.83,40.36,0,40.36,40.36,-1,-87043,75371,162414,-11672,0,-308,1791,0,0,,2099,1483
20,05/17/2017,4,0:45,1:00,,40.65,0,40.65,40.65,-1,-86995,68931,155926,-18064,0,-352,0,0,0,,352,-352
20,05/17/2017,5,1:00,1:15,47.29,40.56,0,47.29,33.29,2,-79859,34271,114130,-45588,0,-23,15759,0,0,,15782,15736
20,05/17/2017,6,1:15,1:30,32.02,,0,32.02,32.02,1,-73035,43907,116942,-29128,0,0,11778,0,0,,11778,11778
20,05/17/2017,7,1:30,1:45,,,0,33.3,33.3,0,-68295,47835,116130,-20460,0,0,6,0,0,,6,6
20,05/17/2017,8,1:45,2:00,,25.69,0,25.69,25.69,-1,-59676,56201,115877,-3475,0,-1446,0,0,0,,1446,-1446
20,05/17/2017,9,2:00,2:15,,25.02,0,25.02,25.02,-1,-61298,91255,152553,29957,0,-4187,0,0,0,,4187,-4187
20,05/17/2017,10,2:15,2:30,,,0,33.28,33.28,0,-60086,43317,103403,-16769,0,0,0,0,0,,0,0
20,05/17/2017,11,2:30,2:45,26.02,,0,26.02,26.02,1,-55552,42328,97880,-13224,0,0,76,0,0,,76,76
20,05/17/2017,12,2:45,3:00,,25.02,0,25.02,25.02,-1,-52218,56031,108249,3813,0,-4168,0,0,0,,4168,-4168
20,05/17/2017,13,3:00,3:15,29.36,25.02,0,29.36,29.36,1,-38216,30344,68560,-7872,0,-6356,1075,0,0,,7431,-5281
20,05/17/2017,14,3:15,3:30,32.02,21.02,0,33.25,21.02,2,-31206,52512,83718,21306,0,-4926,3237,0,0,,8163,-1689
20,05/17/2017,15,3:30,3:45,,21.02,0,21.02,21.02,-1,-47575,61375,108950,13800,0,-10282,0,0,0,,10282,-10282
20,05/17/2017,16,3:45,4:00,,23.71,0,23.71,23.71,-1,-62984,97589,160573,34605,0,-6918,0,0,0,,6918,-6918
20,05/17/2017,17,4:00,4:15,36.43,28.39,0,36.43,36.43,1,-89619,54812,144431,-34807,0,-4849,5150,0,0,,9999,301
20,05/17/2017,18,4:15,4:30,38.02,28.39,0,38.02,38.02,1,-81921,54492,136413,-27429,0,-13,20735,0,0,,20748,20722
20,05/17/2017,19,4:30,4:45,26.02,,0,26.02,26.02,1,-80348,75079,155427,-5269,0,0,3923,0,0,,3923,3923
20,05/17/2017,20,4:45,5:00,28.67,,0,28.67,28.67,1,-87209,90588,177797,3379,0,0,3476,0,0,,3476,3476
20,05/17/2017,21,5:00,5:15,,,0,33.28,33.28,0,-49074,49206,98280,132,0,0,424,0,0,,424,424
20,05/17/2017,22,5:15,5:30,26.02,,0,26.02,26.02,1,-47414,46397,93811,-1017,0,0,43,0,0,,43,43
20,05/17/2017,23,5:30,5:45,28.02,,0,28.02,28.02,1,-62071,52732,114803,-9339,0,0,2340,0,0,,2340,2340
20,05/17/2017,24,5:45,6:00,28.29,,0,28.29,28.29,1,-71752,46403,118155,-25349,0,0,6717,0,0,,6717,6717
20,05/17/2017,25,6:00,6:15,27.98,,0,27.98,27.98,1,-80936,59456,140392,-21480,0,0,4188,0,0,,4188,4188
20,05/17/2017,26,6:15,6:30,27.98,,0,27.98,27.98,1,-48058,48450,96508,392,0,0,297,0,0,,297,297
20,05/17/2017,27,6:30,6:45,64.39,,0,64.39,64.39,1,-74927,41333,116260,-33594,0,0,12008,0,0,,12008,12008
20,05/17/2017,28,6:45,7:00,65,,0,65,65,1,-101587,56214,157801,-45373,0,0,39872,0,0,,39872,39872
20,05/17/2017,29,7:00,7:15,29.34,-26.14,0,33.8,-26.14,2,-29154,140952,170106,111798,0,-14511,9867,0,0,,24378,-4644
20,05/17/2017,30,7:15,7:30,,39.89,0,39.89,39.89,-1,-42398,57854,100252,15456,0,-1990,0,0,0,,1990,-1990
20,05/17/2017,31,7:30,7:45,32.59,,0,32.59,32.59,1,-71177,61109,132286,-10068,0,0,1784,0,0,,1784,1784
20,05/17/2017,32,7:45,8:00,65,,0,65,65,1,-104418,58161,162579,-46257,0,0,27461,0,0,,27461,27461
20,05/17/2017,33,8:00,8:15,30.34,36.52,0,34.33,34.33,2,-26921,87169,114090,60248,0,-526,10553,0,0,,11079,10027
20,05/17/2017,34,8:15,8:30,,40.6,0,40.6,40.6,-1,-50954,81091,132045,30137,0,-48,0,0,0,,48,-48
20,05/17/2017,35,8:30,8:45,,40.56,0,40.56,40.56,-1,-61402,71259,132661,9857,0,-347,0,0,0,,347,-347
20,05/17/2017,36,8:45,9:00,29.72,,0,29.72,29.72,1,-73634,66098,139732,-7536,0,0,1970,0,0,,1970,1970
20,05/17/2017,37,9:00,9:15,32.19,,0,32.19,32.19,1,-63946,52656,116602,-11290,0,0,4940,0,0,,4940,4940
20,05/17/2017,38,9:15,9:30,32.59,,0,32.59,32.59,1,-69900,43333,113233,-26567,0,0,15501,0,0,,15501,15501
20,05/17/2017,39,9:30,9:45,32.79,,0,32.79,32.79,1,-73341,39964,113305,-33377,0,0,19500,0,0,,19500,19500
20,05/17/2017,40,9:45,10:00,61.58,,0,61.58,61.58,1,-75383,36986,112369,-38397,0,0,20283,0,0,,20283,20283
20,05/17/2017,41,10:00,10:15,98.57,,0,98.57,98.57,1,-61379,17279,78658,-44100,0,0,43279,0,0,,43279,43279
20,05/17/2017,42,10:15,10:30,33.54,,0,33.54,33.54,1,-56600,29218,85818,-27382,0,0,28421,0,0,,28421,28421
20,05/17/2017,43,10:30,10:45,47,,0,47,47,1,-62434,26794,89228,-35640,0,0,28442,0,0,,28442,28442
20,05/17/2017,44,10:45,11:00,37.02,,0,37.02,37.02,1,-64732,29878,94610,-34854,0,0,35672,0,0,,35672,35672
20,05/17/2017,45,11:00,11:15,32.59,,0,32.59,32.59,1,-65826,43698,109524,-22128,0,0,24380,0,0,,24380,24380
20,05/17/2017,46,11:15,11:30,32.99,,0,32.99,32.99,1,-64113,40957,105070,-23156,0,0,17199,0,0,,17199,17199
20,05/17/2017,47,11:30,11:45,43.7,,0,43.7,43.7,1,-72885,32763,105648,-40122,0,0,27704,0,0,,27704,27704
20,05/17/2017,48,11:45,12:00,43.7,,0,43.7,43.7,1,-73458,33237,106695,-40221,0,0,33232,0,0,,33232,33232
20,05/17/2017,49,12:00,12:15,33.02,,0,33.02,33.02,1,-81207,48739,129946,-32468,0,0,30997,0,0,,30997,30997
20,05/17/2017,50,12:15,12:30,31.02,,0,31.02,31.02,1,-74741,53700,128441,-21041,0,0,18075,0,0,,18075,18075
20,05/17/2017,51,12:30,12:45,28.99,,0,28.99,28.99,1,-61957,60996,122953,-961,0,0,7923,0,0,,7923,7923
20,05/17/2017,52,12:45,13:00,28.02,,0,28.02,28.02,1,-49286,55515,104801,6229,0,0,2213,0,0,,2213,2213
20,05/17/2017,53,13:00,13:15,29.58,,0,29.58,29.58,1,-49718,53024,102742,3306,0,0,506,0,0,,506,506
20,05/17/2017,54,13:15,13:30,29.76,,0,29.76,29.76,1,-44269,38992,83261,-5277,0,0,2492,0,0,,2492,2492
20,05/17/2017,55,13:30,13:45,29.02,,0,29.02,29.02,1,-32969,47814,80783,14845,0,0,1457,0,0,,1457,1457
20,05/17/2017,56,13:45,14:00,29.02,27.08,0,27.08,27.08,-1,-37293,42887,80180,5594,0,-1817,47,0,0,,1864,-1770
20,05/17/2017,57,14:00,14:15,,40.53,0,40.53,40.53,-1,-40120,67210,107330,27090,0,-5258,0,0,0,,5258,-5258
20,05/17/2017,58,14:15,14:30,27.58,40.53,0,27.58,27.58,1,-54687,56398,111085,1711,0,-616,379,0,0,,995,-237
20,05/17/2017,59,14:30,14:45,29.34,,0,29.34,29.34,1,-58711,50655,109366,-8056,0,0,2158,0,0,,2158,2158
20,05/17/2017,60,14:45,15:00,33.58,,0,33.58,33.58,1,-60217,37849,98066,-22368,0,0,8131,0,0,,8131,8131
20,05/17/2017,61,15:00,15:15,33.58,,0,33.58,33.58,1,-78194,32138,110332,-46056,0,0,22486,0,0,,22486,22486
20,05/17/2017,62,15:15,15:30,70.27,,0,70.27,70.27,1,-74863,25409,100272,-49454,0,0,23410,0,0,,23410,23410
20,05/17/2017,63,15:30,15:45,132.02,,0,132.02,132.02,1,-84017,41579,125596,-42438,0,0,43747,0,0,,43747,43747
20,05/17/2017,64,15:45,16:00,28.02,41.28,0,41.28,41.28,-1,-76780,73006,149786,-3774,0,-591,8277,0,0,,8868,7686
20,05/17/2017,65,16:00,16:15,,41.55,0,41.55,41.55,-1,-70987,67684,138671,-3303,0,-380,0,0,0,,380,-380
20,05/17/2017,66,16:15,16:30,30.34,,0,30.34,30.34,1,-66587,52355,118942,-14232,0,0,2962,0,0,,2962,2962
20,05/17/2017,67,16:30,16:45,33.58,,0,33.58,33.58,1,-64651,46954,111605,-17697,0,0,7467,0,0,,7467,7467
20,05/17/2017,68,16:45,17:00,40.59,,0,40.59,40.59,1,-74150,44467,118617,-29683,0,0,20817,0,0,,20817,20817
20,05/17/2017,69,17:00,17:15,29.58,,0,29.58,29.58,1,-87999,78157,166156,-9842,0,0,11260,0,0,,11260,11260
20,05/17/2017,70,17:15,17:30,32.59,,0,32.59,32.59,1,-70728,54880,125608,-15848,0,0,6225,0,0,,6225,6225
20,05/17/2017,71,17:30,17:45,27.58,,0,27.58,27.58,1,-52362,61035,113397,8673,0,0,1880,0,0,,1880,1880
20,05/17/2017,72,17:45,18:00,29.58,,0,29.58,29.58,1,-41593,52985,94578,11392,0,0,1472,0,0,,1472,1472
20,05/17/2017,73,18:00,18:15,29.58,,0,29.58,29.58,1,-100907,34011,134918,-66896,0,0,4937,0,0,,4937,4937
20,05/17/2017,74,18:15,18:30,31.74,,0,31.74,31.74,1,-74679,37237,111916,-37442,0,0,5215,0,0,,5215,5215
20,05/17/2017,75,18:30,18:45,28.74,,0,28.74,28.74,1,-69598,33698,103296,-35900,0,0,3705,0,0,,3705,3705
20,05/17/2017,76,18:45,19:00,55.02,,0,55.02,55.02,1,-68431,31011,99442,-37420,0,0,5293,0,0,,5293,5293
20,05/17/2017,77,19:00,19:15,261.95,,0,261.95,261.95,1,-127864,10288,138152,-117576,0,0,50027,0,0,,50027,50027
20,05/17/2017,78,19:15,19:30,261.95,,0,261.95,261.95,1,-98022,55999,154021,-42023,0,0,65599,0,0,,65599,65599
20,05/17/2017,79,19:30,19:45,261.95,40.65,0,40.65,40.65,-1,-82083,84343,166426,2260,0,-839,5328,0,0,,6167,4489
20,05/17/2017,80,19:45,20:00,35.98,,0,35.98,35.98,1,-95579,52424,148003,-43155,0,0,10387,0,0,,10387,10387
20,05/17/2017,81,20:00,20:15,246.86,,0,246.86,246.86,1,-207627,54925,262552,-152702,0,0,54712,0,0,,54712,54712
20,05/17/2017,82,20:15,20:30,218.46,,0,218.46,218.46,1,-158235,109473,267708,-48762,0,0,56098,0,0,,56098,56098
20,05/17/2017,83,20:30,20:45,,,0,34.04,34.04,0,-121262,118766,240028,-2496,0,0,3511,0,0,,3511,3511
20,05/17/2017,84,20:45,21:00,27.9,,0,27.9,27.9,1,-101430,77883,179313,-23547,0,0,56,0,0,,56,56
20,05/17/2017,85,21:00,21:15,33.58,,0,33.58,33.58,1,-118205,86163,204368,-32042,0,0,4866,0,0,,4866,4866
20,05/17/2017,86,21:15,21:30,40.02,,0,40.02,40.02,1,-108239,70890,179129,-37349,0,0,18942,0,0,,18942,18942
20,05/17/2017,87,21:30,21:45,29.02,,0,29.02,29.02,1,-89526,63498,153024,-26028,0,0,8633,0,0,,8633,8633
20,05/17/2017,88,21:45,22:00,,,0,34.77,34.77,0,-102165,53205,155370,-48960,0,0,23,0,0,,23,23
20,05/17/2017,89,22:00,22:15,116.92,,0,116.92,116.92,1,-142278,55756,198034,-86522,0,0,30902,0,0,,30902,30902
20,05/17/2017,90,22:15,22:30,47.02,26.08,0,26.08,26.08,-1,-85563,78727,164290,-6836,0,-51,29664,0,0,,29715,29613
20,05/17/2017,91,22:30,22:45,47.02,18.86,0,18.86,18.86,-1,-50373,77984,128357,27611,0,-4167,652,0,0,,4819,-3515
20,05/17/2017,92,22:45,23:00,,26.36,0,26.36,26.36,-1,-74725,84255,158980,9530,0,-782,0,0,0,,782,-782
20,05/17/2017,93,23:00,23:15,117,41.12,0,117,117,1,-124883,39220,164103,-85663,0,-566,16766,0,0,,17332,16200
20,05/17/2017,94,23:15,23:30,42.27,26.19,0,42.27,26.19,2,-67924,50879,118803,-17045,0,-35,35760,0,0,,35795,35725
20,05/17/2017,95,23:30,23:45,42.27,17.24,0,17.24,17.24,-1,-18199,74204,92403,56005,0,-10861,1268,0,0,,12129,-9593
20,05/17/2017,96,23:45,0:00,,-7.57,0,-7.57,-7.57,-1,-14485,104565,119050,90080,0,-39459,0,0,0,,39459,-39459
20,05/18/2017,1,0:00,0:15,100.12,-7.57,0,100.12,100.12,1,-74437,37920,112357,-36517,0,-21243,7338,0,0,,28581,-13905
20,05/18/2017,2,0:15,0:30,121.36,-14.8,0,121.36,-14.8,2,-39790,91956,131746,52166,0,-8404,12466,0,0,,20870,4062
20,05/18/2017,3,0:30,0:45,33.08,25.49,0,33.08,33.08,1,-58503,41952,100455,-16551,0,-5411,3814,0,0,,9225,-1597
20,05/18/2017,4,0:45,1:00,33.08,,0,33.08,33.08,1,-50696,43966,94662,-6730,0,0,9652,0,0,,9652,9652
20,05/18/2017,5,1:00,1:15,33.19,,0,33.19,33.19,1,-56877,46018,102895,-10859,0,0,5824,0,0,,5824,5824
20,05/18/2017,6,1:15,1:30,29.08,,0,29.08,29.08,1,-49789,41730,91519,-8059,0,0,13076,0,0,,13076,13076
20,05/18/2017,7,1:30,1:45,,,0,28.34,28.34,0,-45828,55219,101047,9391,0,0,1770,0,0,,1770,1770
20,05/18/2017,8,1:45,2:00,,26.08,0,26.08,26.08,-1,-52378,84262,136640,31884,0,-2305,0,0,0,,2305,-2305
20,05/18/2017,9,2:00,2:15,29.08,26.08,0,29.08,29.08,1,-51705,65783,117488,14078,0,-2171,506,0,0,,2677,-1665
20,05/18/2017,10,2:15,2:30,47.11,,0,47.11,47.11,1,-72814,18337,91151,-54477,0,0,33031,0,0,,33031,33031
20,05/18/2017,11,2:30,2:45,35.63,,0,35.63,35.63,1,-66383,33330,99713,-33053,0,0,40543,0,0,,40543,40543
20,05/18/2017,12,2:45,3:00,33.13,,0,33.13,33.13,1,-71829,29678,101507,-42151,0,0,30220,0,0,,30220,30220
20,05/18/2017,13,3:00,3:15,42.4,,0,42.4,42.4,1,-77683,26623,104306,-51060,0,0,38620,0,0,,38620,38620
20,05/18/2017,14,3:15,3:30,39.96,,0,39.96,39.96,1,-96186,21805,117991,-74381,0,0,49899,0,0,,49899,49899
20,05/18/2017,15,3:30,3:45,69.12,,0,69.12,69.12,1,-101561,21592,123153,-79969,0,0,61890,0,0,,61890,61890
20,05/18/2017,16,3:45,4:00,46.26,,0,46.26,46.26,1,-112755,29636,142391,-83119,0,0,77054,0,0,,77054,77054
20,05/18/2017,17,4:00,4:15,44.79,,0,44.79,44.79,1,-82456,48726,131182,-33730,0,0,49573,0,0,,49573,49573
20,05/18/2017,18,4:15,4:30,36.12,,0,36.12,36.12,1,-90288,50397,140685,-39891,0,0,32453,0,0,,32453,32453
20,05/18/2017,19,4:30,4:45,33.08,,0,33.08,33.08,1,-76646,55683,132329,-20963,0,0,29063,0,0,,29063,29063
20,05/18/2017,20,4:45,5:00,39.08,,0,39.08,39.08,1,-90042,56983,147025,-33059,0,0,18311,0,0,,18311,18311
20,05/18/2017,21,5:00,5:15,31.19,18.36,0,18.36,18.36,-1,-77190,120544,197734,43354,0,-2330,12579,0,0,,14909,10249
20,05/18/2017,22,5:15,5:30,27.08,12.1,0,27.08,12.1,2,-108887,117672,226559,8785,0,-10120,334,0,0,,10454,-9786
20,05/18/2017,23,5:30,5:45,31.39,12.1,0,31.39,31.39,1,-127963,104925,232888,-23038,0,-34,7587,0,0,,7621,7553
20,05/18/2017,24,5:45,6:00,45.05,,0,45.05,45.05,1,-135892,96203,232095,-39689,0,0,37997,0,0,,37997,37997
20,05/18/2017,25,6:00,6:15,33.08,,0,33.08,33.08,1,-130071,78895,208966,-51176,0,0,17790,0,0,,17790,17790
20,05/18/2017,26,6:15,6:30,29.08,,0,29.08,29.08,1,-115131,63829,178960,-51302,0,0,2320,0,0,,2320,2320
20,05/18/2017,27,6:30,6:45,50.87,,0,50.87,50.87,1,-107582,55237,162819,-52345,0,0,4036,0,0,,4036,4036
20,05/18/2017,28,6:45,7:00,135.72,,0,135.72,135.72,1,-119565,57468,177033,-62097,0,0,48276,0,0,,48276,48276
20,05/18/2017,29,7:00,7:15,135.72,-16.23,0,-16.23,-16.23,-1,-22422,87916,110338,65494,0,-8218,16528,0,0,,24746,8310
20,05/18/2017,30,7:15,7:30,46.4,27.72,0,46.4,27.72,2,-72184,39554,111738,-32630,0,-804,10548,0,0,,11352,9744
20,05/18/2017,31,7:30,7:45,200.12,,0,200.12,200.12,1,-123420,50834,174254,-72586,0,0,46851,0,0,,46851,46851
20,05/18/2017,32,7:45,8:00,200.12,,0,200.12,200.12,1,-136205,91888,228093,-44317,0,0,58546,0,0,,58546,58546
20,05/18/2017,33,8:00,8:15,28.12,31.89,0,34.68,31.89,2,-26576,147005,173581,120429,0,-360,5751,0,0,,6111,5391
20,05/18/2017,34,8:15,8:30,,,0,34.65,34.65,0,-14295,106579,120874,92284,0,0,0,0,0,,0,0
20,05/18/2017,35,8:30,8:45,,,0,34.61,34.61,0,-54404,102159,156563,47755,0,0,0,0,0,,0,0
20,05/18/2017,36,8:45,9:00,29.48,,0,29.48,29.48,1,-87479,88036,175515,557,0,0,335,0,0,,335,335
20,05/18/2017,37,9:00,9:15,32.59,,0,32.59,32.59,1,-58435,50319,108754,-8116,0,0,3459,0,0,,3459,3459
20,05/18/2017,38,9:15,9:30,36.39,,0,36.39,36.39,1,-57625,39562,97187,-18063,0,0,9648,0,0,,9648,9648
20,05/18/2017,39,9:30,9:45,34.39,,0,34.39,34.39,1,-67135,47883,115018,-19252,0,0,14874,0,0,,14874,14874
20,05/18/2017,40,9:45,10:00,39.9,,0,39.9,39.9,1,-64398,44273,108671,-20125,0,0,17327,0,0,,17327,17327
20,05/18/2017,41,10:00,10:15,68.26,,0,68.26,68.26,1,-88769,55549,144318,-33220,0,0,20685,0,0,,20685,20685
20,05/18/2017,42,10:15,10:30,200.12,,0,200.12,200.12,1,-151495,63608,215103,-87887,0,0,55751,0,0,,55751,55751
20,05/18/2017,43,10:30,10:45,121.89,,0,121.89,121.89,1,-140610,92097,232707,-48513,0,0,49656,0,0,,49656,49656
20,05/18/2017,44,10:45,11:00,182.58,,0,182.58,182.58,1,-150518,92448,242966,-58070,0,0,47938,0,0,,47938,47938
20,05/18/2017,45,11:00,11:15,66.66,,0,66.66,66.66,1,-145086,97716,242802,-47370,0,0,32429,0,0,,32429,32429
20,05/18/2017,46,11:15,11:30,200.12,,0,200.12,200.12,1,-160024,92301,252325,-67723,0,0,23267,0,0,,23267,23267
20,05/18/2017,47,11:30,11:45,200.12,,0,200.12,200.12,1,-145299,91129,236428,-54170,0,0,39490,0,0,,39490,39490
20,05/18/2017,48,11:45,12:00,200.12,,0,200.12,200.12,1,-154601,94082,248683,-60519,0,0,41446,0,0,,41446,41446
20,05/18/2017,49,12:00,12:15,57.53,,0,57.53,57.53,1,-123500,112946,236446,-10554,0,0,27644,0,0,,27644,27644
20,05/18/2017,50,12:15,12:30,32.59,,0,32.59,32.59,1,-121160,105852,227012,-15308,0,0,4287,0,0,,4287,4287
20,05/18/2017,51,12:30,12:45,32.81,,0,32.81,32.81,1,-114593,103112,217705,-11481,0,0,11663,0,0,,11663,11663
20,05/18/2017,52,12:45,13:00,57.53,,0,57.53,57.53,1,-114538,85632,200170,-28906,0,0,13305,0,0,,13305,13305
20,05/18/2017,53,13:00,13:15,132.45,,0,132.45,132.45,1,-116382,83019,199401,-33363,0,0,34679,0,0,,34679,34679
20,05/18/2017,54,13:15,13:30,41.12,,0,41.12,41.12,1,-111305,82330,193635,-28975,0,0,26990,0,0,,26990,26990
20,05/18/2017,55,13:30,13:45,34.69,,0,34.69,34.69,1,-105620,87468,193088,-18152,0,0,24211,0,0,,24211,24211
20,05/18/2017,56,13:45,14:00,46.12,,0,46.12,46.12,1,-112096,76682,188778,-35414,0,0,22629,0,0,,22629,22629
20,05/18/2017,57,14:00,14:15,31.77,,0,31.77,31.77,1,-100444,100980,201424,536,0,0,15493,0,0,,15493,15493
20,05/18/2017,58,14:15,14:30,32.59,29.79,0,32.59,29.79,2,-82941,76321,159262,-6620,0,-85,2775,0,0,,2860,2690
20,05/18/2017,59,14:30,14:45,29.74,,0,29.74,29.74,1,-68793,67092,135885,-1701,0,0,1919,0,0,,1919,1919
20,05/18/2017,60,14:45,15:00,75,,0,75,75,1,-88339,49690,138029,-38649,0,0,22019,0,0,,22019,22019
20,05/18/2017,61,15:00,15:15,34.9,27.73,0,27.73,27.73,-1,-69393,77540,146933,8147,0,-35,18570,0,0,,18605,18535
20,05/18/2017,62,15:15,15:30,29.9,27.45,0,30.83,27.45,2,-64256,69809,134065,5553,0,-1019,1300,0,0,,2319,281
20,05/18/2017,63,15:30,15:45,34.39,,0,34.39,34.39,1,-77456,65079,142535,-12377,0,0,10269,0,0,,10269,10269
20,05/18/2017,64,15:45,16:00,33.89,,0,33.89,33.89,1,-76428,59995,136423,-16433,0,0,8343,0,0,,8343,8343
20,05/18/2017,65,16:00,16:15,38.92,,0,38.92,38.92,1,-64934,63421,128355,-1513,0,0,10579,0,0,,10579,10579
20,05/18/2017,66,16:15,16:30,38.92,27.08,0,27.08,27.08,-1,-62582,72108,134690,9526,0,-1616,547,0,0,,2163,-1069
20,05/18/2017,67,16:30,16:45,,26.08,0,26.08,26.08,-1,-66462,66780,133242,318,0,-5357,0,0,0,,5357,-5357
20,05/18/2017,68,16:45,17:00,,22.08,0,22.08,22.08,-1,-67057,63440,130497,-3617,0,-666,0,0,0,,666,-666
20,05/18/2017,69,17:00,17:15,,17.69,0,17.69,17.69,-1,-25068,85386,110454,60318,0,-9777,0,0,0,,9777,-9777
20,05/18/2017,70,17:15,17:30,,41.88,0,41.88,41.88,-1,-19013,66010,85023,46997,0,-2152,0,0,0,,2152,-2152
20,05/18/2017,71,17:30,17:45,,3.53,0,3.53,3.53,-1,-6671,83450,90121,76779,0,-24664,0,0,0,,24664,-24664
20,05/18/2017,72,17:45,18:00,,22.08,0,22.08,22.08,-1,-4944,91110,96054,86166,0,-21358,0,0,0,,21358,-21358
20,05/18/2017,73,18:00,18:15,,20.65,0,20.65,20.65,-1,-18473,71241,89714,52768,0,-33707,0,0,0,,33707,-33707
20,05/18/2017,74,18:15,18:30,,17.69,0,17.69,17.69,-1,-16177,87259,103436,71082,0,-41559,0,0,0,,41559,-41559
20,05/18/2017,75,18:30,18:45,,22.08,0,22.08,22.08,-1,-14411,94270,108681,79859,0,-32029,0,0,0,,32029,-32029
20,05/18/2017,76,18:45,19:00,,42.1,0,42.1,42.1,-1,-11773,100128,111901,88355,0,-4212,0,0,0,,4212,-4212
20,05/18/2017,77,19:00,19:15,,41.65,0,41.65,41.65,-1,-43233,50828,94061,7595,0,-95,0,0,0,,95,-95
20,05/18/2017,78,19:15,19:30,,42.52,0,42.52,42.52,-1,-50188,68663,118851,18475,0,-175,0,0,0,,175,-175
20,05/18/2017,79,19:30,19:45,,22.08,0,22.08,22.08,-1,-46240,79262,125502,33022,0,-10873,0,0,0,,10873,-10873
20,05/18/2017,80,19:45,20:00,,26.08,0,26.08,26.08,-1,-65402,92188,157590,26786,0,-21227,0,0,0,,21227,-21227
20,05/18/2017,81,20:00,20:15,,26.78,0,26.78,26.78,-1,-52821,99343,152164,46522,0,-11688,0,0,0,,11688,-11688
20,05/18/2017,82,20:15,20:30,,17.08,0,17.08,17.08,-1,-47995,99275,147270,51280,0,-14303,0,0,0,,14303,-14303
20,05/18/2017,83,20:30,20:45,,17.08,0,17.08,17.08,-1,-48838,110546,159384,61708,0,-47064,0,0,0,,47064,-47064
20,05/18/2017,84,20:45,21:00,,17.08,0,17.08,17.08,-1,-47499,106817,154316,59318,0,-52053,0,0,0,,52053,-52053
20,05/18/2017,85,21:00,21:15,,-49.5,0,-49.5,-49.5,-1,-58621,103906,162527,45285,0,-97862,0,0,0,,97862,-97862
20,05/18/2017,86,21:15,21:30,,17.69,0,17.69,17.69,-1,-55467,109281,164748,53814,0,-67808,0,0,0,,67808,-67808
20,05/18/2017,87,21:30,21:45,,20.65,0,20.65,20.65,-1,-64712,108980,173692,44268,0,-49153,0,0,0,,49153,-49153
20,05/18/2017,88,21:45,22:00,,10.49,0,10.49,10.49,-1,-66109,123544,189653,57435,0,-41889,0,0,0,,41889,-41889
20,05/18/2017,89,22:00,22:15,,22.08,0,22.08,22.08,-1,-97141,102377,199518,5236,0,-23451,0,0,0,,23451,-23451
20,05/18/2017,90,22:15,22:30,,10.49,0,10.49,10.49,-1,-71527,114305,185832,42778,0,-37640,0,0,0,,37640,-37640
20,05/18/2017,91,22:30,22:45,,17.69,0,17.69,17.69,-1,-71222,135448,206670,64226,0,-38834,0,0,0,,38834,-38834
20,05/18/2017,92,22:45,23:00,,-9.67,0,-9.67,-9.67,-1,-68339,154309,222648,85970,0,-25590,0,0,0,,25590,-25590
20,05/18/2017,93,23:00,23:15,,-22.63,0,-22.63,-22.63,-1,-75202,71087,146289,-4115,0,-28160,0,0,0,,28160,-28160
20,05/18/2017,94,23:15,23:30,,22.08,0,22.08,22.08,-1,-63147,94416,157563,31269,0,-7876,0,0,0,,7876,-7876
20,05/18/2017,95,23:30,23:45,,4.49,0,4.49,4.49,-1,-59527,121905,181432,62378,0,-29242,0,0,0,,29242,-29242
20,05/18/2017,96,23:45,0:00,,-2.34,0,-2.34,-2.34,-1,-70116,130688,200804,60572,0,-61842,0,0,0,,61842,-61842
20,05/19/2017,1,0:00,0:15,29.21,25.39,0,29.21,29.21,1,-80091,75398,155489,-4693,0,-15704,610,0,0,,16314,-15094
20,05/19/2017,2,0:15,0:30,29.21,30.34,0,30.34,30.34,-1,-90356,78866,169222,-11490,0,-795,60,0,0,,855,-735
20,05/19/2017,3,0:30,0:45,,27.08,0,27.08,27.08,-1,-81062,80099,161161,-963,0,-2560,0,0,0,,2560,-2560
20,05/19/2017,4,0:45,1:00,,22.08,0,22.08,22.08,-1,-77520,111078,188598,33558,0,-23666,0,0,0,,23666,-23666
20,05/19/2017,5,1:00,1:15,27.08,22.08,0,27.08,27.08,1,-66563,71926,138489,5363,0,-18267,61,0,0,,18328,-18206
20,05/19/2017,6,1:15,1:30,,-56.1,0,-56.1,-56.1,-1,-24737,90743,115480,66006,0,-14775,0,0,0,,14775,-14775
20,05/19/2017,7,1:30,1:45,,-62.62,0,-62.62,-62.62,-1,-32518,78993,111511,46475,0,-25912,0,0,0,,25912,-25912
20,05/19/2017,8,1:45,2:00,,-31.66,0,-31.66,-31.66,-1,-25970,110790,136760,84820,0,-56434,0,0,0,,56434,-56434
20,05/19/2017,9,2:00,2:15,28.86,1.72,0,28.86,28.86,1,-28077,68364,96441,40287,0,-38281,37,0,0,,38318,-38244
20,05/19/2017,10,2:15,2:30,29.08,1.72,0,29.08,29.08,1,-51994,73168,125162,21174,0,-68,176,0,0,,244,108
20,05/19/2017,11,2:30,2:45,,22.08,0,22.08,22.08,-1,-38201,74257,112458,36056,0,-2865,0,0,0,,2865,-2865
20,05/19/2017,12,2:45,3:00,,4.25,0,4.25,4.25,-1,-40101,81092,121193,40991,0,-28814,0,0,0,,28814,-28814
20,05/19/2017,13,3:00,3:15,33.08,20.98,0,33.08,33.08,1,-52980,46501,99481,-6479,0,-18044,1095,0,0,,19139,-16949
20,05/19/2017,14,3:15,3:30,,,0,33.73,33.73,0,-43871,53273,97144,9402,0,0,17,0,0,,17,17
20,05/19/2017,15,3:30,3:45,,26.08,0,26.08,26.08,-1,-45436,76876,122312,31440,0,-2674,0,0,0,,2674,-2674
20,05/19/2017,16,3:45,4:00,,22.08,0,22.08,22.08,-1,-38957,96790,135747,57833,0,-12760,0,0,0,,12760,-12760
20,05/19/2017,17,4:00,4:15,,26.08,0,26.08,26.08,-1,-30148,89953,120101,59805,0,-10414,0,0,0,,10414,-10414
20,05/19/2017,18,4:15,4:30,,26.08,0,26.08,26.08,-1,-32143,94332,126475,62189,0,-9262,0,0,0,,9262,-9262
20,05/19/2017,19,4:30,4:45,,40.4,0,40.4,40.4,-1,-27043,91037,118080,63994,0,-1564,0,0,0,,1564,-1564
20,05/19/2017,20,4:45,5:00,,15.97,0,15.97,15.97,-1,-33978,122501,156479,88523,0,-10861,0,0,0,,10861,-10861
20,05/19/2017,21,5:00,5:15,,-0.79,0,-0.79,-0.79,-1,-37725,82076,119801,44351,0,-30898,0,0,0,,30898,-30898
20,05/19/2017,22,5:15,5:30,,-12.19,0,-12.19,-12.19,-1,-38559,82070,120629,43511,0,-50276,0,0,0,,50276,-50276
20,05/19/2017,23,5:30,5:45,,27.03,0,27.03,27.03,-1,-45618,93422,139040,47804,0,-14607,0,0,0,,14607,-14607
20,05/19/2017,24,5:45,6:00,,26.08,0,26.08,26.08,-1,-51278,114214,165492,62936,0,-8390,0,0,0,,8390,-8390
20,05/19/2017,25,6:00,6:15,,30.17,0,30.17,30.17,-1,-106903,95187,202090,-11716,0,-4693,0,0,0,,4693,-4693
20,05/19/2017,26,6:15,6:30,,17.28,0,17.28,17.28,-1,-38265,102123,140388,63858,0,-17949,0,0,0,,17949,-17949
20,05/19/2017,27,6:30,6:45,,26.69,0,26.69,26.69,-1,-53128,136153,189281,83025,0,-11937,0,0,0,,11937,-11937
20,05/19/2017,28,6:45,7:00,,,0,33.68,33.68,0,-78563,165526,244089,86963,0,-357,0,0,0,,357,-357
20,05/19/2017,29,7:00,7:15,,-50.38,0,-50.38,-50.38,-1,-11805,134677,146482,122872,0,-26038,0,0,0,,26038,-26038
20,05/19/2017,30,7:15,7:30,,36.91,0,36.91,36.91,-1,-48608,146679,195287,98071,0,-3233,0,0,0,,3233,-3233
20,05/19/2017,31,7:30,7:45,,27.69,0,27.69,27.69,-1,-63973,156883,220856,92910,0,-6032,0,0,0,,6032,-6032
20,05/19/2017,32,7:45,8:00,,39.46,0,39.46,39.46,-1,-68284,143964,212248,75680,0,-4152,0,0,0,,4152,-4152
20,05/19/2017,33,8:00,8:15,,39.51,0,39.51,39.51,-1,-44873,121149,166022,76276,0,-1464,0,0,0,,1464,-1464
20,05/19/2017,34,8:15,8:30,,36.34,0,36.34,36.34,-1,-62816,110056,172872,47240,0,-6368,0,0,0,,6368,-6368
20,05/19/2017,35,8:30,8:45,,38.72,0,38.72,38.72,-1,-91672,102704,194376,11032,0,-5965,0,0,0,,5965,-5965
20,05/19/2017,36,8:45,9:00,27.02,38.72,0,27.02,27.02,1,-103889,102641,206530,-1248,0,-243,61,0,0,,304,-182
20,05/19/2017,37,9:00,9:15,,39.94,0,39.94,39.94,-1,-81251,84783,166034,3532,0,-655,0,0,0,,655,-655
20,05/19/2017,38,9:15,9:30,,39.69,0,39.69,39.69,-1,-89620,75953,165573,-13667,0,-1501,0,0,0,,1501,-1501
20,05/19/2017,39,9:30,9:45,,38.25,0,38.25,38.25,-1,-68078,67896,135974,-182,0,-2506,0,0,0,,2506,-2506
20,05/19/2017,40,9:45,10:00,,39.65,0,39.65,39.65,-1,-88538,52884,141422,-35654,0,-1436,0,0,0,,1436,-1436
20,05/19/2017,41,10:00,10:15,,,0,33.7,33.7,0,-87020,65860,152880,-21160,0,0,0,0,0,,0,0
20,05/19/2017,42,10:15,10:30,28.95,,0,28.95,28.95,1,-86369,51380,137749,-34989,0,0,142,0,0,,142,142
20,05/19/2017,43,10:30,10:45,29.47,,0,29.47,29.47,1,-88062,53314,141376,-34748,0,0,3491,0,0,,3491,3491
20,05/19/2017,44,10:45,11:00,28.95,,0,28.95,28.95,1,-89032,54317,143349,-34715,0,0,988,0,0,,988,988
20,05/19/2017,45,11:00,11:15,27.02,,0,27.02,27.02,1,-92863,38318,131181,-54545,0,0,50,0,0,,50,50
20,05/19/2017,46,11:15,11:30,30.27,,0,30.27,30.27,1,-102869,45133,148002,-57736,0,0,1011,0,0,,1011,1011
20,05/19/2017,47,11:30,11:45,29.69,,0,29.69,29.69,1,-74810,49052,123862,-25758,0,0,792,0,0,,792,792
20,05/19/2017,48,11:45,12:00,29.69,,0,29.69,29.69,1,-62170,36555,98725,-25615,0,0,3685,0,0,,3685,3685
20,05/19/2017,49,12:00,12:15,27.02,37.45,0,37.45,37.45,-1,-50691,59394,110085,8703,0,-282,1367,0,0,,1649,1085
20,05/19/2017,50,12:15,12:30,,31.79,0,31.79,31.79,-1,-55024,55541,110565,517,0,-1811,0,0,0,,1811,-1811
20,05/19/2017,51,12:30,12:45,,33.04,0,33.04,33.04,-1,-53629,57180,110809,3551,0,-3052,0,0,0,,3052,-3052
20,05/19/2017,52,12:45,13:00,,26.69,0,26.69,26.69,-1,-50183,63439,113622,13256,0,-3978,0,0,0,,3978,-3978
20,05/19/2017,53,13:00,13:15,,22.69,0,22.69,22.69,-1,-44539,69165,113704,24626,0,-11371,0,0,0,,11371,-11371
20,05/19/2017,54,13:15,13:30,,22.69,0,22.69,22.69,-1,-36313,65952,102265,29639,0,-10174,0,0,0,,10174,-10174
20,05/19/2017,55,13:30,13:45,,22.69,0,22.69,22.69,-1,-49669,69483,119152,19814,0,-15325,0,0,0,,15325,-15325
20,05/19/2017,56,13:45,14:00,,26.69,0,26.69,26.69,-1,-45731,59135,104866,13404,0,-12877,0,0,0,,12877,-12877
20,05/19/2017,57,14:00,14:15,29.09,26.69,0,29.09,29.09,1,-42278,50087,92365,7809,0,-9353,201,0,0,,9554,-9152
20,05/19/2017,58,14:15,14:30,29.69,26.69,0,29.69,29.69,1,-50518,43256,93774,-7262,0,-254,290,0,0,,544,36
20,05/19/2017,59,14:30,14:45,,,0,34.02,34.02,0,-40624,48888,89512,8264,0,0,0,0,0,,0,0
20,05/19/2017,60,14:45,15:00,,,0,34.01,34.01,0,-38110,46422,84532,8312,0,0,0,0,0,,0,0
20,05/19/2017,61,15:00,15:15,,,0,34.04,34.04,0,-54118,72436,126554,18318,0,0,0,0,0,,0,0
20,05/19/2017,62,15:15,15:30,,27.69,0,27.69,27.69,-1,-47731,83114,130845,35383,0,-436,0,0,0,,436,-436
20,05/19/2017,63,15:30,15:45,,26.69,0,26.69,26.69,-1,-60072,98987,159059,38915,0,-10771,0,0,0,,10771,-10771
20,05/19/2017,64,15:45,16:00,,26.69,0,26.69,26.69,-1,-51028,85987,137015,34959,0,-19866,0,0,0,,19866,-19866
20,05/19/2017,65,16:00,16:15,,-8.83,0,-8.83,-8.83,-1,-49059,133560,182619,84501,0,-38636,0,0,0,,38636,-38636
20,05/19/2017,66,16:15,16:30,,17.8,0,17.8,17.8,-1,-46795,95908,142703,49113,0,-49173,0,0,0,,49173,-49173
20,05/19/2017,67,16:30,16:45,,23.66,0,23.66,23.66,-1,-47623,98443,146066,50820,0,-33084,0,0,0,,33084,-33084
20,05/19/2017,68,16:45,17:00,,26.03,0,26.03,26.03,-1,-65291,97167,162458,31876,0,-29222,0,0,0,,29222,-29222
20,05/19/2017,69,17:00,17:15,,26.69,0,26.69,26.69,-1,-58239,84297,142536,26058,0,-26111,0,0,0,,26111,-26111
20,05/19/2017,70,17:15,17:30,27.69,39.72,0,27.69,27.69,1,-70133,63648,133781,-6485,0,-5099,496,0,0,,5595,-4603
20,05/19/2017,71,17:30,17:45,27.69,,0,27.69,27.69,1,-66075,74415,140490,8340,0,0,799,0,0,,799,799
20,05/19/2017,72,17:45,18:00,29.69,,0,29.69,29.69,1,-75035,67593,142628,-7442,0,0,3169,0,0,,3169,3169
20,05/19/2017,73,18:00,18:15,29.69,,0,29.69,29.69,1,-66032,34068,100100,-31964,0,0,3498,0,0,,3498,3498
20,05/19/2017,74,18:15,18:30,,,0,34.34,34.34,0,-60314,34546,94860,-25768,0,0,0,0,0,,0,0
20,05/19/2017,75,18:30,18:45,,,0,34.34,34.34,0,-47180,36543,83723,-10637,0,0,0,0,0,,0,0
20,05/19/2017,76,18:45,19:00,28.5,,0,28.5,28.5,1,-50617,39589,90206,-11028,0,0,1208,0,0,,1208,1208
20,05/19/2017,77,19:00,19:15,28.79,,0,28.79,28.79,1,-50501,47012,97513,-3489,0,0,1648,0,0,,1648,1648
20,05/19/2017,78,19:15,19:30,28.98,,0,28.98,28.98,1,-67662,30329,97991,-37333,0,0,1362,0,0,,1362,1362
20,05/19/2017,79,19:30,19:45,30.19,,0,30.19,30.19,1,-66553,23497,90050,-43056,0,0,3212,0,0,,3212,3212
20,05/19/2017,80,19:45,20:00,28.97,,0,28.97,28.97,1,-48267,40452,88719,-7815,0,0,2197,0,0,,2197,2197
20,05/19/2017,81,20:00,20:15,34.19,,0,34.19,34.19,1,-73627,49446,123073,-24181,0,0,6215,0,0,,6215,6215
20,05/19/2017,82,20:15,20:30,29.31,,0,29.31,29.31,1,-78981,48765,127746,-30216,0,0,10920,0,0,,10920,10920
20,05/19/2017,83,20:30,20:45,,,0,38.51,38.51,0,-82136,54794,136930,-27342,0,0,1525,0,0,,1525,1525
20,05/19/2017,84,20:45,21:00,28.34,,0,28.34,28.34,1,-107496,57397,164893,-50099,0,0,848,0,0,,848,848
20,05/19/2017,85,21:00,21:15,29.06,,0,29.06,29.06,1,-75399,57108,132507,-18291,0,0,1856,0,0,,1856,1856
20,05/19/2017,86,21:15,21:30,29.83,,0,29.83,29.83,1,-63734,48521,112255,-15213,0,0,6443,0,0,,6443,6443
20,05/19/2017,87,21:30,21:45,28.19,,0,28.19,28.19,1,-72485,50903,123388,-21582,0,0,2303,0,0,,2303,2303
20,05/19/2017,88,21:45,22:00,,,0,38.51,38.51,0,-98216,53289,151505,-44927,0,0,0,0,0,,0,0
20,05/19/2017,89,22:00,22:15,30.19,,0,30.19,30.19,1,-84774,69868,154642,-14906,0,0,3158,0,0,,3158,3158
20,05/19/2017,90,22:15,22:30,30.34,,0,30.34,30.34,1,-81890,58996,140886,-22894,0,0,7402,0,0,,7402,7402
20,05/19/2017,91,22:30,22:45,28.4,,0,28.4,28.4,1,-59050,63215,122265,4165,0,0,3988,0,0,,3988,3988
20,05/19/2017,92,22:45,23:00,28.19,,0,28.19,28.19,1,-51419,65574,116993,14155,0,0,16,0,0,,16,16
20,05/19/2017,93,23:00,23:15,177.02,,0,177.02,177.02,1,-160159,41122,201281,-119037,0,0,37389,0,0,,37389,37389
20,05/19/2017,94,23:15,23:30,111.02,,0,111.02,111.02,1,-101136,67925,169061,-33211,0,0,44816,0,0,,44816,44816
20,05/19/2017,95,23:30,23:45,28.19,,0,28.19,28.19,1,-62738,73021,135759,10283,0,0,2892,0,0,,2892,2892
20,05/19/2017,96,23:45,0:00,,26.69,0,26.69,26.69,-1,-57791,73334,131125,15543,0,-3465,0,0,0,,3465,-3465
21,05/20/2017,1,0:00,0:15,,21.74,0,21.74,21.74,-1,-61015,136933,197948,75918,0,-4076,0,0,0,,4076,-4076
21,05/20/2017,2,0:15,0:30,30.38,,0,30.38,30.38,1,-49553,45094,94647,-4459,0,0,1313,0,0,,1313,1313
21,05/20/2017,3,0:30,0:45,,18.77,0,18.77,18.77,-1,-48255,70809,119064,22554,0,-7188,0,0,0,,7188,-7188
21,05/20/2017,4,0:45,1:00,27.84,18.77,0,34.13,18.77,2,-80471,79342,159813,-1129,0,-23270,18,0,0,,23288,-23252
21,05/20/2017,5,1:00,1:15,29.48,29.21,0,33.73,29.21,2,-65203,83682,148885,18479,0,-1903,753,0,0,,2656,-1150
21,05/20/2017,6,1:15,1:30,,22.84,0,22.84,22.84,-1,-39694,68081,107775,28387,0,-17670,0,0,0,,17670,-17670
21,05/20/2017,7,1:30,1:45,,21.43,0,21.43,21.43,-1,-24860,77720,102580,52860,0,-29007,0,0,0,,29007,-29007
21,05/20/2017,8,1:45,2:00,,18.77,0,18.77,18.77,-1,-33752,73052,106804,39300,0,-43352,0,0,0,,43352,-43352
21,05/20/2017,9,2:00,2:15,37.32,22.78,0,37.32,22.78,2,-16378,24823,41201,8445,0,-25330,510,0,0,,25840,-24820
21,05/20/2017,10,2:15,2:30,47.51,22.78,0,47.51,47.51,1,-51496,25788,77284,-25708,0,-288,15129,0,0,,15417,14841
21,05/20/2017,11,2:30,2:45,47.51,25.53,0,25.53,25.53,-1,-25845,38945,64790,13100,0,-7181,1765,0,0,,8946,-5416
21,05/20/2017,12,2:45,3:00,,26.84,0,26.84,26.84,-1,-47451,43932,91383,-3519,0,-10103,0,0,0,,10103,-10103
21,05/20/2017,13,3:00,3:15,,22.84,0,22.84,22.84,-1,-21524,60001,81525,38477,0,-9810,0,0,0,,9810,-9810
21,05/20/2017,14,3:15,3:30,,,0,36.75,36.75,0,-35902,46257,82159,10355,0,-461,0,0,0,,461,-461
21,05/20/2017,15,3:30,3:45,29.84,,0,29.84,29.84,1,-41526,43060,84586,1534,0,0,1478,0,0,,1478,1478
21,05/20/2017,16,3:45,4:00,27.84,,0,27.84,27.84,1,-42787,43288,86075,501,0,0,863,0,0,,863,863
21,05/20/2017,17,4:00,4:15,27.12,,0,27.12,27.12,1,-41531,67375,108906,25844,0,0,85,0,0,,85,85
21,05/20/2017,18,4:15,4:30,,,0,33.74,33.74,0,-25119,44579,69698,19460,0,0,0,0,0,,0,0
21,05/20/2017,19,4:30,4:45,,,0,33.74,33.74,0,-24615,43403,68018,18788,0,0,0,0,0,,0,0
21,05/20/2017,20,4:45,5:00,,,0,33.25,33.25,0,-31795,44265,76060,12470,0,0,0,0,0,,0,0
21,05/20/2017,21,5:00,5:15,,,0,33.24,33.24,0,-46411,74198,120609,27787,0,0,0,0,0,,0,0
21,05/20/2017,22,5:15,5:30,,34.74,0,34.74,34.74,-1,-26712,95987,122699,69275,0,-43,0,0,0,,43,-43
21,05/20/2017,23,5:30,5:45,,33.78,0,33.78,33.78,-1,-23475,103073,126548,79598,0,-2292,0,0,0,,2292,-2292
21,05/20/2017,24,5:45,6:00,,20.64,0,20.64,20.64,-1,-26449,125417,151866,98968,0,-19138,0,0,0,,19138,-19138
21,05/20/2017,25,6:00,6:15,,26.78,0,26.78,26.78,-1,-86886,77229,164115,-9657,0,-16779,0,0,0,,16779,-16779
21,05/20/2017,26,6:15,6:30,,-26.1,0,-26.1,-26.1,-1,-51088,116182,167270,65094,0,-32393,0,0,0,,32393,-32393
21,05/20/2017,27,6:30,6:45,,21.5,0,21.5,21.5,-1,-82063,113221,195284,31158,0,-39690,0,0,0,,39690,-39690
21,05/20/2017,28,6:45,7:00,,39.94,0,39.94,39.94,-1,-97325,105005,202330,7680,0,-7562,0,0,0,,7562,-7562
21,05/20/2017,29,7:00,7:15,30.02,,0,30.02,30.02,1,-55135,61297,116432,6162,0,0,31,0,0,,31,31
21,05/20/2017,30,7:15,7:30,,25.78,0,25.78,25.78,-1,-36292,77594,113886,41302,0,-1807,0,0,0,,1807,-1807
21,05/20/2017,31,7:30,7:45,,23.02,0,23.02,23.02,-1,-39750,66642,106392,26892,0,-8116,0,0,0,,8116,-8116
21,05/20/2017,32,7:45,8:00,,21.74,0,21.74,21.74,-1,-54480,81629,136109,27149,0,-2810,0,0,0,,2810,-2810
21,05/20/2017,33,8:00,8:15,,13.57,0,13.57,13.57,-1,-48121,55555,103676,7434,0,-25269,0,0,0,,25269,-25269
21,05/20/2017,34,8:15,8:30,,23,0,23,23,-1,-25850,58508,84358,32658,0,-4528,0,0,0,,4528,-4528
21,05/20/2017,35,8:30,8:45,,18.02,0,18.02,18.02,-1,-24643,59234,83877,34591,0,-15289,0,0,0,,15289,-15289
21,05/20/2017,36,8:45,9:00,,,0,38.45,38.45,0,-52574,77959,130533,25385,0,-895,0,0,0,,895,-895
21,05/20/2017,37,9:00,9:15,28.32,,0,28.32,28.32,1,-43139,72764,115903,29625,0,0,555,0,0,,555,555
21,05/20/2017,38,9:15,9:30,,,0,38.55,38.55,0,-39088,84107,123195,45019,0,0,0,0,0,,0,0
21,05/20/2017,39,9:30,9:45,,40.19,0,40.19,40.19,-1,-44868,82024,126892,37156,0,-693,0,0,0,,693,-693
21,05/20/2017,40,9:45,10:00,,27.02,0,27.02,27.02,-1,-46221,88630,134851,42409,0,-3891,0,0,0,,3891,-3891
21,05/20/2017,41,10:00,10:15,,23.44,0,23.44,23.44,-1,-55987,102490,158477,46503,0,-8073,0,0,0,,8073,-8073
21,05/20/2017,42,10:15,10:30,28.32,23.44,0,28.32,28.32,1,-65313,79022,144335,13709,0,-258,121,0,0,,379,-137
21,05/20/2017,43,10:30,10:45,28.32,,0,28.32,28.32,1,-72582,78967,151549,6385,0,0,881,0,0,,881,881
21,05/20/2017,44,10:45,11:00,28.32,,0,28.32,28.32,1,-75355,71594,146949,-3761,0,0,279,0,0,,279,279
21,05/20/2017,45,11:00,11:15,40.02,,0,40.02,40.02,1,-60179,48913,109092,-11266,0,0,8423,0,0,,8423,8423
21,05/20/2017,46,11:15,11:30,40.02,,0,40.02,40.02,1,-66782,38673,105455,-28109,0,0,28336,0,0,,28336,28336
21,05/20/2017,47,11:30,11:45,34.02,,0,34.02,34.02,1,-59147,36185,95332,-22962,0,0,21823,0,0,,21823,21823
21,05/20/2017,48,11:45,12:00,28.47,34.18,0,38.4,34.18,2,-54506,54014,108520,-492,0,-1432,3446,0,0,,4878,2014
21,05/20/2017,49,12:00,12:15,128.54,,0,128.54,128.54,1,-91276,29497,120773,-61779,0,0,27700,0,0,,27700,27700
21,05/20/2017,50,12:15,12:30,40.02,,0,40.02,40.02,1,-68591,35698,104289,-32893,0,0,31525,0,0,,31525,31525
21,05/20/2017,51,12:30,12:45,31.4,,0,31.4,31.4,1,-58341,37175,95516,-21166,0,0,17269,0,0,,17269,17269
21,05/20/2017,52,12:45,13:00,28.5,,0,28.5,28.5,1,-59045,41106,100151,-17939,0,0,5692,0,0,,5692,5692
21,05/20/2017,53,13:00,13:15,34.87,,0,34.87,34.87,1,-62740,43614,106354,-19126,0,0,10856,0,0,,10856,10856
21,05/20/2017,54,13:15,13:30,29.47,33.68,0,33.68,33.68,-1,-53473,55757,109230,2284,0,-45,10623,0,0,,10668,10578
21,05/20/2017,55,13:30,13:45,28.82,28.02,0,34.41,28.02,2,-50021,50335,100356,314,0,-562,1180,0,0,,1742,618
21,05/20/2017,56,13:45,14:00,30.44,,0,30.44,30.44,1,-63577,40699,104276,-22878,0,0,4991,0,0,,4991,4991
21,05/20/2017,57,14:00,14:15,28.81,40.14,0,34.33,34.33,2,-38445,89561,128006,51116,0,-266,723,0,0,,989,457
21,05/20/2017,58,14:15,14:30,30.02,,0,30.02,30.02,1,-55667,72661,128328,16994,0,0,1411,0,0,,1411,1411
21,05/20/2017,59,14:30,14:45,,16.2,0,16.2,16.2,-1,-36016,67759,103775,31743,0,-11010,0,0,0,,11010,-11010
21,05/20/2017,60,14:45,15:00,,23.02,0,23.02,23.02,-1,-27372,60220,87592,32848,0,-26519,0,0,0,,26519,-26519
21,05/20/2017,61,15:00,15:15,,23.02,0,23.02,23.02,-1,-16986,93576,110562,76590,0,-24869,0,0,0,,24869,-24869
21,05/20/2017,62,15:15,15:30,,,0,34.46,34.46,0,-18987,53612,72599,34625,0,-4248,0,0,0,,4248,-4248
21,05/20/2017,63,15:30,15:45,,,0,34.45,34.45,0,-16093,59009,75102,42916,0,0,0,0,0,,0,0
21,05/20/2017,64,15:45,16:00,,,0,34.35,34.35,0,-22735,62370,85105,39635,0,0,0,0,0,,0,0
21,05/20/2017,65,16:00,16:15,,-28.07,0,-28.07,-28.07,-1,-14503,101256,115759,86753,0,-23686,0,0,0,,23686,-23686
21,05/20/2017,66,16:15,16:30,32,-424.8,0,33.87,-424.8,2,-46410,69274,115684,22864,-20000,-42548,75,0,0,,62623,-62473
21,05/20/2017,67,16:30,16:45,40.74,-424.8,0,40.74,40.74,1,-77122,41783,118905,-35339,0,-144,8057,0,0,,8201,7913
21,05/20/2017,68,16:45,17:00,32.85,,0,32.85,32.85,1,-79830,52694,132524,-27136,0,0,9318,0,0,,9318,9318
21,05/20/2017,69,17:00,17:15,37.74,27.02,0,37.74,27.02,2,-60316,50114,110430,-10202,0,-611,10950,0,0,,11561,10339
21,05/20/2017,70,17:15,17:30,37.74,23.02,0,23.02,23.02,-1,-39593,43136,82729,3543,0,-11275,498,0,0,,11773,-10777
21,05/20/2017,71,17:30,17:45,34.02,23.02,0,34.02,34.02,1,-65329,41919,107248,-23410,0,-760,5475,0,0,,6235,4715
21,05/20/2017,72,17:45,18:00,62.66,,0,62.66,62.66,1,-92142,40060,132202,-52082,0,0,20392,0,0,,20392,20392
21,05/20/2017,73,18:00,18:15,118.14,23.02,0,118.14,23.02,2,-67016,43109,110125,-23907,0,-185,43854,0,0,,44039,43669
21,05/20/2017,74,18:15,18:30,118.14,-21.73,0,-21.73,-21.73,-1,-31556,71789,103345,40233,0,-22908,835,0,0,,23743,-22073
21,05/20/2017,75,18:30,18:45,,32.91,0,32.91,32.91,-1,-44075,69780,113855,25705,0,-5541,0,0,0,,5541,-5541
21,05/20/2017,76,18:45,19:00,,33.87,0,33.87,33.87,-1,-44974,84666,129640,39692,0,-2903,0,0,0,,2903,-2903
21,05/20/2017,77,19:00,19:15,,27.02,0,27.02,27.02,-1,-41252,50893,92145,9641,0,-4482,0,0,0,,4482,-4482
21,05/20/2017,78,19:15,19:30,28.35,27.02,0,33.82,27.02,2,-39332,42403,81735,3071,0,-10153,200,0,0,,10353,-9953
21,05/20/2017,79,19:30,19:45,29.61,27.02,0,29.61,29.61,1,-37887,36650,74537,-1237,0,-446,533,0,0,,979,87
21,05/20/2017,80,19:45,20:00,30.02,,0,30.02,30.02,1,-50079,41425,91504,-8654,0,0,4269,0,0,,4269,4269
21,05/20/2017,81,20:00,20:15,34.02,,0,34.02,34.02,1,-86162,54674,140836,-31488,0,0,14185,0,0,,14185,14185
21,05/20/2017,82,20:15,20:30,55.12,,0,55.12,55.12,1,-91735,50929,142664,-40806,0,0,36843,0,0,,36843,36843
21,05/20/2017,83,20:30,20:45,30.12,30.1,0,33.84,30.1,2,-56327,55672,111999,-655,0,-337,14846,0,0,,15183,14509
21,05/20/2017,84,20:45,21:00,,39.28,0,39.28,39.28,-1,-63118,65450,128568,2332,0,-597,0,0,0,,597,-597
21,05/20/2017,85,21:00,21:15,,39.15,0,39.15,39.15,-1,-82375,69593,151968,-12782,0,-1262,0,0,0,,1262,-1262
21,05/20/2017,86,21:15,21:30,32.8,39.15,0,32.8,32.8,1,-79516,63060,142576,-16456,0,-71,6179,0,0,,6250,6108
21,05/20/2017,87,21:30,21:45,30.02,,0,30.02,30.02,1,-80479,62601,143080,-17878,0,0,3681,0,0,,3681,3681
21,05/20/2017,88,21:45,22:00,184.36,,0,184.36,184.36,1,-112166,55061,167227,-57105,0,0,26092,0,0,,26092,26092
21,05/20/2017,89,22:00,22:15,273.07,,0,273.07,273.07,1,-141922,61207,203129,-80715,0,0,71215,0,0,,71215,71215
21,05/20/2017,90,22:15,22:30,55.12,,0,55.12,55.12,1,-114263,92354,206617,-21909,0,0,31379,0,0,,31379,31379
21,05/20/2017,91,22:30,22:45,30.4,,0,30.4,30.4,1,-91832,90446,182278,-1386,0,0,1623,0,0,,1623,1623
21,05/20/2017,92,22:45,23:00,32.18,,0,32.18,32.18,1,-101411,87917,189328,-13494,0,0,6598,0,0,,6598,6598
21,05/20/2017,93,23:00,23:15,29.55,,0,29.55,29.55,1,-76052,74417,150469,-1635,0,0,4392,0,0,,4392,4392
21,05/20/2017,94,23:15,23:30,33.35,,0,33.35,33.35,1,-74195,62039,136234,-12156,0,0,6433,0,0,,6433,6433
21,05/20/2017,95,23:30,23:45,,,0,33.79,33.79,0,-61218,67490,128708,6272,0,0,1853,0,0,,1853,1853
21,05/20/2017,96,23:45,0:00,30.02,,0,30.02,30.02,1,-71877,69996,141873,-1881,0,0,547,0,0,,547,547
21,05/21/2017,1,0:00,0:15,150.02,,0,150.02,150.02,1,-71114,41178,112292,-29936,0,0,12833,0,0,,12833,12833
21,05/21/2017,2,0:15,0:30,42.4,,0,42.4,42.4,1,-83014,41015,124029,-41999,0,0,26592,0,0,,26592,26592
21,05/21/2017,3,0:30,0:45,42.4,,0,42.4,42.4,1,-66673,29672,96345,-37001,0,0,30743,0,0,,30743,30743
21,05/21/2017,4,0:45,1:00,53.4,,0,53.4,53.4,1,-68526,48819,117345,-19707,0,0,16495,0,0,,16495,16495
21,05/21/2017,5,1:00,1:15,146.83,,0,146.83,146.83,1,-142798,47356,190154,-95442,0,0,52399,0,0,,52399,52399
21,05/21/2017,6,1:15,1:30,270.52,,0,270.52,270.52,1,-85091,46202,131293,-38889,0,0,55726,0,0,,55726,55726
21,05/21/2017,7,1:30,1:45,270.52,27.52,0,27.52,27.52,-1,-52107,72773,124880,20666,0,-1106,1837,0,0,,2943,731
21,05/21/2017,8,1:45,2:00,,26.03,0,26.03,26.03,-1,-27037,57623,84660,30586,0,-6687,0,0,0,,6687,-6687
21,05/21/2017,9,2:00,2:15,93.02,27.5,0,93.02,93.02,1,-80501,44996,125497,-35505,0,-5171,4054,0,0,,9225,-1117
21,05/21/2017,10,2:15,2:30,124.67,27.5,0,124.67,124.67,1,-63297,39261,102558,-24036,0,-44,30121,0,0,,30165,30077
21,05/21/2017,11,2:30,2:45,124.67,40.28,0,40.28,40.28,-1,-32835,49913,82748,17078,0,-150,2023,0,0,,2173,1873
21,05/21/2017,12,2:45,3:00,,20.38,0,20.38,20.38,-1,-23646,49265,72911,25619,0,-7257,0,0,0,,7257,-7257
21,05/21/2017,13,3:00,3:15,,16.1,0,16.1,16.1,-1,-14918,65980,80898,51062,0,-19244,0,0,0,,19244,-19244
21,05/21/2017,14,3:15,3:30,,31.94,0,31.94,31.94,-1,-31770,44549,76319,12779,0,-2190,0,0,0,,2190,-2190
21,05/21/2017,15,3:30,3:45,,27.52,0,27.52,27.52,-1,-19465,40032,59497,20567,0,-6802,0,0,0,,6802,-6802
21,05/21/2017,16,3:45,4:00,,27.52,0,27.52,27.52,-1,-25860,47800,73660,21940,0,-11451,0,0,0,,11451,-11451
21,05/21/2017,17,4:00,4:15,,33.55,0,33.55,33.55,-1,-17098,57863,74961,40765,0,-4817,0,0,0,,4817,-4817
21,05/21/2017,18,4:15,4:30,28.52,,0,28.52,28.52,1,-20491,38492,58983,18001,0,0,130,0,0,,130,130
21,05/21/2017,19,4:30,4:45,28.52,,0,28.52,28.52,1,-16627,43529,60156,26902,0,0,250,0,0,,250,250
21,05/21/2017,20,4:45,5:00,28.52,,0,28.52,28.52,1,-17362,47539,64901,30177,0,0,5,0,0,,5,5
21,05/21/2017,21,5:00,5:15,28.52,,0,28.52,28.52,1,-50511,54397,104908,3886,0,0,1113,0,0,,1113,1113
21,05/21/2017,22,5:15,5:30,28.52,,0,28.52,28.52,1,-22301,66704,89005,44403,0,0,1223,0,0,,1223,1223
21,05/21/2017,23,5:30,5:45,28.42,23.52,0,34.17,23.52,2,-20469,63269,83738,42800,0,-3421,89,0,0,,3510,-3332
21,05/21/2017,24,5:45,6:00,,19.74,0,19.74,19.74,-1,-18837,52906,71743,34069,0,-22953,0,0,0,,22953,-22953
21,05/21/2017,25,6:00,6:15,,24.03,0,24.03,24.03,-1,-22333,39032,61365,16699,0,-20991,0,0,0,,20991,-20991
21,05/21/2017,26,6:15,6:30,29.45,33.2,0,33.67,33.2,2,-23201,22280,45481,-921,0,-1198,277,0,0,,1475,-921
21,05/21/2017,27,6:30,6:45,,28.65,0,28.65,28.65,-1,-21291,36285,57576,14994,0,-3719,0,0,0,,3719,-3719
21,05/21/2017,28,6:45,7:00,,27.65,0,27.65,27.65,-1,-24586,39733,64319,15147,0,-2871,0,0,0,,2871,-2871
21,05/21/2017,29,7:00,7:15,,21.74,0,21.74,21.74,-1,-11787,66096,77883,54309,0,-18198,0,0,0,,18198,-18198
21,05/21/2017,30,7:15,7:30,,19.74,0,19.74,19.74,-1,-17499,47110,64609,29611,0,-36425,0,0,0,,36425,-36425
21,05/21/2017,31,7:30,7:45,,24.74,0,24.74,24.74,-1,-30523,55248,85771,24725,0,-23711,0,0,0,,23711,-23711
21,05/21/2017,32,7:45,8:00,,29.74,0,29.74,29.74,-1,-35767,59552,95319,23785,0,-9770,0,0,0,,9770,-9770
21,05/21/2017,33,8:00,8:15,,33.9,0,33.9,33.9,-1,-33160,66220,99380,33060,0,-4467,0,0,0,,4467,-4467
21,05/21/2017,34,8:15,8:30,,33.31,0,33.31,33.31,-1,-15375,51548,66923,36173,0,-2045,0,0,0,,2045,-2045
21,05/21/2017,35,8:30,8:45,,30.34,0,30.34,30.34,-1,-16176,48050,64226,31874,0,-508,0,0,0,,508,-508
21,05/21/2017,36,8:45,9:00,,30.34,0,30.34,30.34,-1,-23153,62770,85923,39617,0,-2652,0,0,0,,2652,-2652
21,05/21/2017,37,9:00,9:15,,27.65,0,27.65,27.65,-1,-17982,41718,59700,23736,0,-2632,0,0,0,,2632,-2632
21,05/21/2017,38,9:15,9:30,,23.65,0,23.65,23.65,-1,-15802,42509,58311,26707,0,-3644,0,0,0,,3644,-3644
21,05/21/2017,39,9:30,9:45,,,0,34.39,34.39,0,-28250,40710,68960,12460,0,-71,0,0,0,,71,-71
21,05/21/2017,40,9:45,10:00,,,0,34.36,34.36,0,-30087,38865,68952,8778,0,0,0,0,0,,0,0
21,05/21/2017,41,10:00,10:15,,40.39,0,40.39,40.39,-1,-16212,28916,45128,12704,0,-243,0,0,0,,243,-243
21,05/21/2017,42,10:15,10:30,28.65,40.38,0,34.39,34.39,2,-27670,23515,51185,-4155,0,-317,106,0,0,,423,-211
21,05/21/2017,43,10:30,10:45,28.39,28.65,0,34.38,28.65,2,-27353,35743,63096,8390,0,-304,115,0,0,,419,-189
21,05/21/2017,44,10:45,11:00,,,0,34.35,34.35,0,-34414,36834,71248,2420,0,0,0,0,0,,0,0
21,05/21/2017,45,11:00,11:15,,,0,29.09,29.09,0,-18427,58266,76693,39839,0,0,0,0,0,,0,0
21,05/21/2017,46,11:15,11:30,,,0,29.08,29.08,0,-13677,55871,69548,42194,0,0,0,0,0,,0,0
21,05/21/2017,47,11:30,11:45,28.4,,0,28.4,28.4,1,-29807,40998,70805,11191,0,0,49,0,0,,49,49
21,05/21/2017,48,11:45,12:00,32.04,,0,32.04,32.04,1,-46535,34580,81115,-11955,0,0,4860,0,0,,4860,4860
21,05/21/2017,49,12:00,12:15,28.65,,0,28.65,28.65,1,-47426,46633,94059,-793,0,0,2719,0,0,,2719,2719
21,05/21/2017,50,12:15,12:30,29.8,,0,29.8,29.8,1,-56435,42789,99224,-13646,0,0,7172,0,0,,7172,7172
21,05/21/2017,51,12:30,12:45,28.97,,0,28.97,28.97,1,-49506,42805,92311,-6701,0,0,10204,0,0,,10204,10204
21,05/21/2017,52,12:45,13:00,28.88,,0,28.88,28.88,1,-50076,41402,91478,-8674,0,0,9557,0,0,,9557,9557
21,05/21/2017,53,13:00,13:15,28.88,39.84,0,39.84,39.84,-1,-40660,43930,84590,3270,0,-493,1386,0,0,,1879,893
21,05/21/2017,54,13:15,13:30,28.39,40.49,0,28.39,28.39,1,-46542,26545,73087,-19997,0,-139,24,0,0,,163,-115
21,05/21/2017,55,13:30,13:45,,,0,34.47,34.47,0,-39758,36224,75982,-3534,0,0,2,0,0,,2,2
21,05/21/2017,56,13:45,14:00,,23.65,0,23.65,23.65,-1,-31086,38693,69779,7607,0,-7859,0,0,0,,7859,-7859
21,05/21/2017,57,14:00,14:15,28.67,28.65,0,34.28,28.65,2,-40312,37863,78175,-2449,0,-9261,263,0,0,,9524,-8998
21,05/21/2017,58,14:15,14:30,30.65,28.65,0,30.65,30.65,1,-50735,23391,74126,-27344,0,-385,4229,0,0,,4614,3844
21,05/21/2017,59,14:30,14:45,28.77,,0,28.77,28.77,1,-44816,26300,71116,-18516,0,0,7585,0,0,,7585,7585
21,05/21/2017,60,14:45,15:00,29.46,,0,29.46,29.46,1,-49081,29161,78242,-19920,0,0,10592,0,0,,10592,10592
21,05/21/2017,61,15:00,15:15,28.65,,0,28.65,28.65,1,-46740,47081,93821,341,0,0,4105,0,0,,4105,4105
21,05/21/2017,62,15:15,15:30,28.76,,0,28.76,28.76,1,-54756,37223,91979,-17533,0,0,2395,0,0,,2395,2395
21,05/21/2017,63,15:30,15:45,30.65,,0,30.65,30.65,1,-52197,35733,87930,-16464,0,0,6028,0,0,,6028,6028
21,05/21/2017,64,15:45,16:00,31.27,,0,31.27,31.27,1,-52283,35851,88134,-16432,0,0,10292,0,0,,10292,10292
21,05/21/2017,65,16:00,16:15,31.27,1.15,0,1.15,1.15,-1,-32232,63030,95262,30798,0,-14154,1556,0,0,,15710,-12598
21,05/21/2017,66,16:15,16:30,,22.63,0,22.63,22.63,-1,-54047,57921,111968,3874,0,-15274,0,0,0,,15274,-15274
21,05/21/2017,67,16:30,16:45,,,0,34.5,34.5,0,-56374,54263,110637,-2111,0,-14,0,0,0,,14,-14
21,05/21/2017,68,16:45,17:00,34.65,,0,34.65,34.65,1,-53094,50870,103964,-2224,0,0,4499,0,0,,4499,4499
21,05/21/2017,69,17:00,17:15,28.93,27.65,0,34.55,27.65,2,-19671,84945,104616,65274,0,-3165,2175,0,0,,5340,-990
21,05/21/2017,70,17:15,17:30,,40.22,0,40.22,40.22,-1,-30805,77793,108598,46988,0,-909,0,0,0,,909,-909
21,05/21/2017,71,17:30,17:45,,36.07,0,36.07,36.07,-1,-24617,78896,103513,54279,0,-807,0,0,0,,807,-807
21,05/21/2017,72,17:45,18:00,34.65,28.65,0,34.65,28.65,2,-33934,57432,91366,23498,0,-3733,103,0,0,,3836,-3630
21,05/21/2017,73,18:00,18:15,50.45,28.65,0,50.45,28.65,2,-64552,46055,110607,-18497,0,-387,10703,0,0,,11090,10316
21,05/21/2017,74,18:15,18:30,50.45,19.74,0,19.74,19.74,-1,-19346,51576,70922,32230,0,-6802,229,0,0,,7031,-6573
21,05/21/2017,75,18:30,18:45,,40.23,0,40.23,40.23,-1,-26518,48237,74755,21719,0,-896,0,0,0,,896,-896
21,05/21/2017,76,18:45,19:00,28.14,40.23,0,28.14,28.14,1,-29683,60564,90247,30881,0,-47,499,0,0,,546,452
21,05/21/2017,77,19:00,19:15,,40.61,0,40.61,40.61,-1,-42806,50812,93618,8006,0,-98,0,0,0,,98,-98
21,05/21/2017,78,19:15,19:30,,33.89,0,33.89,33.89,-1,-10983,47045,58028,36062,0,-2258,0,0,0,,2258,-2258
21,05/21/2017,79,19:30,19:45,,40.61,0,40.61,40.61,-1,-10838,58324,69162,47486,0,-463,0,0,0,,463,-463
21,05/21/2017,80,19:45,20:00,,40.61,0,40.61,40.61,-1,-13328,52261,65589,38933,0,-9,0,0,0,,9,-9
21,05/21/2017,81,20:00,20:15,31.49,,0,31.49,31.49,1,-41516,46404,87920,4888,0,0,1749,0,0,,1749,1749
21,05/21/2017,82,20:15,20:30,30.5,,0,30.5,30.5,1,-47216,37685,84901,-9531,0,0,8761,0,0,,8761,8761
21,05/21/2017,83,20:30,20:45,28.83,,0,28.83,28.83,1,-37713,42413,80126,4700,0,0,5372,0,0,,5372,5372
21,05/21/2017,84,20:45,21:00,28.84,,0,28.84,28.84,1,-26571,45980,72551,19409,0,0,964,0,0,,964,964
21,05/21/2017,85,21:00,21:15,28.84,25.14,0,25.14,25.14,-1,-32977,58759,91736,25782,0,-5095,26,0,0,,5121,-5069
21,05/21/2017,86,21:15,21:30,,25.14,0,25.14,25.14,-1,-32521,56191,88712,23670,0,-3068,0,0,0,,3068,-3068
21,05/21/2017,87,21:30,21:45,,25.14,0,25.14,25.14,-1,-37499,46279,83778,8780,0,-5429,0,0,0,,5429,-5429
21,05/21/2017,88,21:45,22:00,28.14,,0,28.14,28.14,1,-54740,44383,99123,-10357,0,0,110,0,0,,110,110
21,05/21/2017,89,22:00,22:15,28.36,,0,28.36,28.36,1,-60602,53903,114505,-6699,0,0,631,0,0,,631,631
21,05/21/2017,90,22:15,22:30,30.37,,0,30.37,30.37,1,-65897,45479,111376,-20418,0,0,3352,0,0,,3352,3352
21,05/21/2017,91,22:30,22:45,30.37,38.57,0,38.57,38.57,-1,-41405,49183,90588,7778,0,-262,396,0,0,,658,134
21,05/21/2017,92,22:45,23:00,,17.31,0,17.31,17.31,-1,-24436,60646,85082,36210,0,-19596,0,0,0,,19596,-19596
21,05/21/2017,93,23:00,23:15,230.42,17.31,0,230.42,230.42,1,-102284,25424,127708,-76860,0,-8760,17099,0,0,,25859,8339
21,05/21/2017,94,23:15,23:30,35.66,24.52,0,24.52,24.52,-1,-46308,54890,101198,8582,0,-1308,9031,0,0,,10339,7723
21,05/21/2017,95,23:30,23:45,,21.14,0,21.14,21.14,-1,-40403,79638,120041,39235,0,-10321,0,0,0,,10321,-10321
21,05/21/2017,96,23:45,0:00,,4.28,0,4.28,4.28,-1,-81183,116728,197911,35545,0,-52534,0,0,0,,52534,-52534
21,05/22/2017,1,0:00,0:15,,22.74,0,22.74,22.74,-1,-34095,95401,129496,61306,0,-21726,0,0,0,,21726,-21726
21,05/22/2017,2,0:15,0:30,,-16.39,0,-16.39,-16.39,-1,-31315,89724,121039,58409,0,-6336,0,0,0,,6336,-6336
21,05/22/2017,3,0:30,0:45,,-5.12,0,-5.12,-5.12,-1,-19813,70458,90271,50645,0,-36199,0,0,0,,36199,-36199
21,05/22/2017,4,0:45,1:00,,24.83,0,24.83,24.83,-1,-41952,55489,97441,13537,0,-26318,0,0,0,,26318,-26318
21,05/22/2017,5,1:00,1:15,,19.76,0,19.76,19.76,-1,-36710,101547,138257,64837,0,-16813,0,0,0,,16813,-16813
21,05/22/2017,6,1:15,1:30,,26.14,0,26.14,26.14,-1,-37007,67798,104805,30791,0,-3351,0,0,0,,3351,-3351
21,05/22/2017,7,1:30,1:45,,32.48,0,32.48,32.48,-1,-29026,53391,82417,24365,0,-1400,0,0,0,,1400,-1400
21,05/22/2017,8,1:45,2:00,,10.3,0,10.3,10.3,-1,-24622,66606,91228,41984,0,-22287,0,0,0,,22287,-22287
21,05/22/2017,9,2:00,2:15,32.14,26.74,0,32.14,32.14,1,-37110,41695,78805,4585,0,-20610,584,0,0,,21194,-20026
21,05/22/2017,10,2:15,2:30,32.14,,0,32.14,32.14,1,-33371,26673,60044,-6698,0,0,5675,0,0,,5675,5675
21,05/22/2017,11,2:30,2:45,,33.66,0,33.66,33.66,-1,-29405,32776,62181,3371,0,-1425,0,0,0,,1425,-1425
21,05/22/2017,12,2:45,3:00,,25.14,0,25.14,25.14,-1,-27703,40194,67897,12491,0,-7367,0,0,0,,7367,-7367
21,05/22/2017,13,3:00,3:15,28.14,26.74,0,28.14,28.14,1,-23717,29404,53121,5687,0,-7228,198,0,0,,7426,-7030
21,05/22/2017,14,3:15,3:30,28.14,26.74,0,28.14,28.14,1,-19986,37459,57445,17473,0,-127,1796,0,0,,1923,1669
21,05/22/2017,15,3:30,3:45,26.14,,0,26.14,26.14,1,-20099,52505,72604,32406,0,0,671,0,0,,671,671
21,05/22/2017,16,3:45,4:00,,30.45,0,30.45,30.45,-1,-20032,57942,77974,37910,0,-1351,0,0,0,,1351,-1351
21,05/22/2017,17,4:00,4:15,,30.43,0,30.43,30.43,-1,-48105,56788,104893,8683,0,-286,0,0,0,,286,-286
21,05/22/2017,18,4:15,4:30,,13.85,0,13.85,13.85,-1,-6031,64740,70771,58709,0,-16365,0,0,0,,16365,-16365
21,05/22/2017,19,4:30,4:45,,4.11,0,4.11,4.11,-1,-6381,73646,80027,67265,0,-32832,0,0,0,,32832,-32832
21,05/22/2017,20,4:45,5:00,,25.14,0,25.14,25.14,-1,-16466,57096,73562,40630,0,-25518,0,0,0,,25518,-25518
21,05/22/2017,21,5:00,5:15,28.97,34.07,0,33.31,33.31,2,-112092,55034,167126,-57058,0,-8782,1115,0,0,,9897,-7667
21,05/22/2017,22,5:15,5:30,28.97,-12.42,0,-12.42,-12.42,-1,-16904,65432,82336,48528,0,-18348,35,0,0,,18383,-18313
21,05/22/2017,23,5:30,5:45,,-150.78,0,-150.78,-150.78,-1,-23876,73142,97018,49266,0,-59119,0,0,0,,59119,-59119
21,05/22/2017,24,5:45,6:00,,18.78,0,18.78,18.78,-1,-41631,138285,179916,96654,0,-35552,0,0,0,,35552,-35552
21,05/22/2017,25,6:00,6:15,62.79,39.67,0,62.79,33.3,2,-181733,28387,210120,-153346,0,-9573,4885,0,0,,14458,-4688
21,05/22/2017,26,6:15,6:30,62.79,31.83,0,31.83,31.83,-1,-54247,59508,113755,5261,0,-683,167,0,0,,850,-516
21,05/22/2017,27,6:30,6:45,,25.14,0,25.14,25.14,-1,-42172,63046,105218,20874,0,-10225,0,0,0,,10225,-10225
21,05/22/2017,28,6:45,7:00,28.14,25.14,0,28.14,28.14,1,-65364,63577,128941,-1787,0,-1149,788,0,0,,1937,-361
21,05/22/2017,29,7:00,7:15,,1.01,0,1.01,1.01,-1,-36181,101648,137829,65467,0,-22477,0,0,0,,22477,-22477
21,05/22/2017,30,7:15,7:30,,20.03,0,20.03,20.03,-1,-21384,69681,91065,48297,0,-52508,0,0,0,,52508,-52508
21,05/22/2017,31,7:30,7:45,,22.74,0,22.74,22.74,-1,-33085,57742,90827,24657,0,-37246,0,0,0,,37246,-37246
21,05/22/2017,32,7:45,8:00,30,22.74,0,30,30,1,-64370,56057,120427,-8313,0,-4390,915,0,0,,5305,-3475
21,05/22/2017,33,8:00,8:15,28.14,,0,28.14,28.14,1,-45003,65036,110039,20033,0,0,130,0,0,,130,130
21,05/22/2017,34,8:15,8:30,28.14,,0,28.14,28.14,1,-31057,62876,93933,31819,0,0,500,0,0,,500,500
21,05/22/2017,35,8:30,8:45,28.14,,0,28.14,28.14,1,-30507,57904,88411,27397,0,0,208,0,0,,208,208
21,05/22/2017,36,8:45,9:00,28.14,,0,28.14,28.14,1,-46797,54411,101208,7614,0,0,49,0,0,,49,49
21,05/22/2017,37,9:00,9:15,29.16,,0,29.16,29.16,1,-42489,42196,84685,-293,0,0,4600,0,0,,4600,4600
21,05/22/2017,38,9:15,9:30,29.15,,0,29.15,29.15,1,-52804,29888,82692,-22916,0,0,8438,0,0,,8438,8438
21,05/22/2017,39,9:30,9:45,29.55,,0,29.55,29.55,1,-61649,37672,99321,-23977,0,0,7580,0,0,,7580,7580
21,05/22/2017,40,9:45,10:00,33.82,,0,33.82,33.82,1,-70377,37347,107724,-33030,0,0,11953,0,0,,11953,11953
21,05/22/2017,41,10:00,10:15,91.24,,0,91.24,91.24,1,-91969,28860,120829,-63109,0,0,33510,0,0,,33510,33510
21,05/22/2017,42,10:15,10:30,43.02,,0,43.02,43.02,1,-74968,30431,105399,-44537,0,0,35938,0,0,,35938,35938
21,05/22/2017,43,10:30,10:45,33.58,,0,33.58,33.58,1,-73216,24313,97529,-48903,0,0,13897,0,0,,13897,13897
21,05/22/2017,44,10:45,11:00,28.14,,0,28.14,28.14,1,-77112,31277,108389,-45835,0,0,7306,0,0,,7306,7306
21,05/22/2017,45,11:00,11:15,,,0,28.72,28.72,0,-64490,16184,80674,-48306,0,0,138,0,0,,138,138
21,05/22/2017,46,11:15,11:30,,,0,28.72,28.72,0,-50859,14648,65507,-36211,0,0,0,0,0,,0,0
21,05/22/2017,47,11:30,11:45,32.24,,0,32.24,32.24,1,-52959,12680,65639,-40279,0,0,2349,0,0,,2349,2349
21,05/22/2017,48,11:45,12:00,148.67,,0,148.67,148.67,1,-83493,11938,95431,-71555,0,0,23878,0,0,,23878,23878
21,05/22/2017,49,12:00,12:15,30.12,,0,30.12,30.12,1,-45191,23037,68228,-22154,0,0,11139,0,0,,11139,11139
21,05/22/2017,50,12:15,12:30,,,0,34.28,34.28,0,-39892,16746,56638,-23146,0,0,16,0,0,,16,16
21,05/22/2017,51,12:30,12:45,,,0,34.28,34.28,0,-51065,21247,72312,-29818,0,0,0,0,0,,0,0
21,05/22/2017,52,12:45,13:00,,,0,34.28,34.28,0,-52259,22915,75174,-29344,0,0,0,0,0,,0,0
21,05/22/2017,53,13:00,13:15,,,0,38.25,38.25,0,-56749,29586,86335,-27163,0,0,0,0,0,,0,0
21,05/22/2017,54,13:15,13:30,,,0,38.25,38.25,0,-71801,19980,91781,-51821,0,0,0,0,0,,0,0
21,05/22/2017,55,13:30,13:45,,,0,38.25,38.25,0,-68375,19311,87686,-49064,0,0,0,0,0,,0,0
21,05/22/2017,56,13:45,14:00,,,0,38.25,38.25,0,-69669,23283,92952,-46386,0,0,0,0,0,,0,0
21,05/22/2017,57,14:00,14:15,,39.95,0,39.95,39.95,-1,-58218,55230,113448,-2988,0,-597,0,0,0,,597,-597
21,05/22/2017,58,14:15,14:30,,40.97,0,40.97,40.97,-1,-56755,52159,108914,-4596,0,-161,0,0,0,,161,-161
21,05/22/2017,59,14:30,14:45,,,0,34.33,34.33,0,-65996,50246,116242,-15750,0,0,0,0,0,,0,0
21,05/22/2017,60,14:45,15:00,28.24,,0,28.24,28.24,1,-74985,37425,112410,-37560,0,0,2908,0,0,,2908,2908
21,05/22/2017,61,15:00,15:15,32.24,,0,32.24,32.24,1,-68296,47856,116152,-20440,0,0,12051,0,0,,12051,12051
21,05/22/2017,62,15:15,15:30,32.24,,0,32.24,32.24,1,-67477,38359,105836,-29118,0,0,16387,0,0,,16387,16387
21,05/22/2017,63,15:30,15:45,66.12,,0,66.12,66.12,1,-83767,31548,115315,-52219,0,0,39405,0,0,,39405,39405
21,05/22/2017,64,15:45,16:00,42.94,,0,42.94,42.94,1,-79246,29183,108429,-50063,0,0,39366,0,0,,39366,39366
21,05/22/2017,65,16:00,16:15,40.74,25.78,0,40.74,25.78,2,-66164,50372,116536,-15792,0,-534,11213,0,0,,11747,10679
21,05/22/2017,66,16:15,16:30,42.2,,0,42.2,42.2,1,-75218,34073,109291,-41145,0,0,4514,0,0,,4514,4514
21,05/22/2017,67,16:30,16:45,43.74,,0,43.74,43.74,1,-55209,25926,81135,-29283,0,0,18401,0,0,,18401,18401
21,05/22/2017,68,16:45,17:00,42.2,,0,42.2,42.2,1,-81009,32183,113192,-48826,0,0,21513,0,0,,21513,21513
21,05/22/2017,69,17:00,17:15,44.71,,0,44.71,44.71,1,-65095,36275,101370,-28820,0,0,16423,0,0,,16423,16423
21,05/22/2017,70,17:15,17:30,,,0,34.6,34.6,0,-75599,31171,106770,-44428,0,0,425,0,0,,425,425
21,05/22/2017,71,17:30,17:45,,,0,34.59,34.59,0,-78906,23861,102767,-55045,0,0,0,0,0,,0,0
21,05/22/2017,72,17:45,18:00,44.71,,0,44.71,44.71,1,-60306,22693,82999,-37613,0,0,6543,0,0,,6543,6543
21,05/22/2017,73,18:00,18:15,43.74,,0,43.74,43.74,1,-109022,16351,125373,-92671,0,0,15050,0,0,,15050,15050
21,05/22/2017,74,18:15,18:30,38.65,,0,38.65,38.65,1,-88635,25396,114031,-63239,0,0,10127,0,0,,10127,10127
21,05/22/2017,75,18:30,18:45,49.65,,0,49.65,49.65,1,-95379,43208,138587,-52171,0,0,12840,0,0,,12840,12840
21,05/22/2017,76,18:45,19:00,49.65,,0,49.65,49.65,1,-74892,56805,131697,-18087,0,0,17986,0,0,,17986,17986
21,05/22/2017,77,19:00,19:15,59.12,,0,59.12,59.12,1,-100573,23504,124077,-77069,0,0,15147,0,0,,15147,15147
21,05/22/2017,78,19:15,19:30,218.11,,0,218.11,218.11,1,-82911,29261,112172,-53650,0,0,39246,0,0,,39246,39246
21,05/22/2017,79,19:30,19:45,34.36,,0,34.36,34.36,1,-73040,43863,116903,-29177,0,0,23031,0,0,,23031,23031
21,05/22/2017,80,19:45,20:00,34.36,,0,34.36,34.36,1,-77656,31754,109410,-45902,0,0,11545,0,0,,11545,11545
21,05/22/2017,81,20:00,20:15,184.83,,0,184.83,184.83,1,-140773,54400,195173,-86373,0,0,37648,0,0,,37648,37648
21,05/22/2017,82,20:15,20:30,47.95,,0,47.95,47.95,1,-116884,70518,187402,-46366,0,0,43151,0,0,,43151,43151
21,05/22/2017,83,20:30,20:45,42.12,,0,42.12,42.12,1,-100976,60132,161108,-40844,0,0,35291,0,0,,35291,35291
21,05/22/2017,84,20:45,21:00,36.95,,0,36.95,36.95,1,-90864,63199,154063,-27665,0,0,28556,0,0,,28556,28556
21,05/22/2017,85,21:00,21:15,40.74,,0,40.74,40.74,1,-88081,65868,153949,-22213,0,0,8504,0,0,,8504,8504
21,05/22/2017,86,21:15,21:30,47.21,,0,47.21,47.21,1,-96129,58192,154321,-37937,0,0,21998,0,0,,21998,21998
21,05/22/2017,87,21:30,21:45,47.21,,0,47.21,47.21,1,-97717,53958,151675,-43759,0,0,26195,0,0,,26195,26195
21,05/22/2017,88,21:45,22:00,47.21,,0,47.21,47.21,1,-116588,40539,157127,-76049,0,0,28668,0,0,,28668,28668
21,05/22/2017,89,22:00,22:15,261.26,,0,261.26,261.26,1,-180164,37320,217484,-142844,0,0,38553,0,0,,38553,38553
21,05/22/2017,90,22:15,22:30,46.84,,0,46.84,46.84,1,-139223,47045,186268,-92178,0,0,29270,0,0,,29270,29270
21,05/22/2017,91,22:30,22:45,74.12,,0,74.12,74.12,1,-90616,38754,129370,-51862,0,0,14197,0,0,,14197,14197
21,05/22/2017,92,22:45,23:00,34.74,,0,34.74,34.74,1,-49573,42996,92569,-6577,0,0,13742,0,0,,13742,13742
21,05/22/2017,93,23:00,23:15,44.87,,0,44.87,44.87,1,-119575,36269,155844,-83306,0,0,11693,0,0,,11693,11693
21,05/22/2017,94,23:15,23:30,28.24,,0,28.24,28.24,1,-87744,36428,124172,-51316,0,0,4867,0,0,,4867,4867
21,05/22/2017,95,23:30,23:45,,,0,34.3,34.3,0,-49304,33792,83096,-15512,0,0,0,0,0,,0,0
21,05/22/2017,96,23:45,0:00,,23.65,0,23.65,23.65,-1,-46350,41068,87418,-5282,0,-1262,0,0,0,,1262,-1262
21,05/23/2017,1,0:00,0:15,118.94,21.27,0,118.94,21.27,2,-94383,52964,147347,-41419,0,-2160,6950,0,0,,9110,4790
21,05/23/2017,2,0:15,0:30,41.08,,0,41.08,41.08,1,-100746,23763,124509,-76983,0,0,18354,0,0,,18354,18354
21,05/23/2017,3,0:30,0:45,,,0,33.57,33.57,0,-95387,25536,120923,-69851,0,0,5444,0,0,,5444,5444
21,05/23/2017,4,0:45,1:00,,29.14,0,29.14,29.14,-1,-75176,43296,118472,-31880,0,-9,0,0,0,,9,-9
21,05/23/2017,5,1:00,1:15,218.79,26.45,0,218.79,218.79,1,-103978,28906,132884,-75072,0,-216,12622,0,0,,12838,12406
21,05/23/2017,6,1:15,1:30,218.79,40.09,0,218.79,33.48,2,-74379,42059,116438,-32320,0,-16,41876,0,0,,41892,41860
21,05/23/2017,7,1:30,1:45,218.79,26.57,0,26.57,26.57,-1,-50023,55218,105241,5195,0,-1336,547,0,0,,1883,-789
21,05/23/2017,8,1:45,2:00,,25.11,0,25.11,25.11,-1,-41478,45260,86738,3782,0,-7561,0,0,0,,7561,-7561
21,05/23/2017,9,2:00,2:15,38.27,39.53,0,38.27,33.48,2,-70034,20895,90929,-49139,0,-2758,1370,0,0,,4128,-1388
21,05/23/2017,10,2:15,2:30,28.27,,0,28.27,28.27,1,-68753,19393,88146,-49360,0,0,854,0,0,,854,854
21,05/23/2017,11,2:30,2:45,28.27,,0,28.27,28.27,1,-63329,18644,81973,-44685,0,0,995,0,0,,995,995
21,05/23/2017,12,2:45,3:00,26.27,,0,26.27,26.27,1,-45495,23663,69158,-21832,0,0,434,0,0,,434,434
21,05/23/2017,13,3:00,3:15,30.24,,0,30.24,30.24,1,-63605,48151,111756,-15454,0,0,1482,0,0,,1482,1482
21,05/23/2017,14,3:15,3:30,31.38,,0,31.38,31.38,1,-60284,52111,112395,-8173,0,0,6212,0,0,,6212,6212
21,05/23/2017,15,3:30,3:45,31.38,40.74,0,40.74,40.74,-1,-64401,55994,120395,-8407,0,-7,483,0,0,,490,476
21,05/23/2017,16,3:45,4:00,,40.41,0,40.41,40.41,-1,-62960,55726,118686,-7234,0,-286,0,0,0,,286,-286
21,05/23/2017,17,4:00,4:15,,40.3,0,40.3,40.3,-1,-51736,46251,97987,-5485,0,-960,0,0,0,,960,-960
21,05/23/2017,18,4:15,4:30,,25.27,0,25.27,25.27,-1,-35895,43834,79729,7939,0,-2075,0,0,0,,2075,-2075
21,05/23/2017,19,4:30,4:45,,25.03,0,25.03,25.03,-1,-29106,45215,74321,16109,0,-11468,0,0,0,,11468,-11468
21,05/23/2017,20,4:45,5:00,,,0,33.48,33.48,0,-34114,36034,70148,1920,0,-860,0,0,0,,860,-860
21,05/23/2017,21,5:00,5:15,,26.03,0,26.03,26.03,-1,-36325,46326,82651,10001,0,-2337,0,0,0,,2337,-2337
21,05/23/2017,22,5:15,5:30,,24.92,0,24.92,24.92,-1,-25830,42711,68541,16881,0,-13794,0,0,0,,13794,-13794
21,05/23/2017,23,5:30,5:45,,29.93,0,29.93,29.93,-1,-36480,49035,85515,12555,0,-1858,0,0,0,,1858,-1858
21,05/23/2017,24,5:45,6:00,,25.27,0,25.27,25.27,-1,-54204,55804,110008,1600,0,-4375,0,0,0,,4375,-4375
21,05/23/2017,25,6:00,6:15,,10.16,0,10.16,10.16,-1,-65484,108083,173567,42599,0,-33375,0,0,0,,33375,-33375
21,05/23/2017,26,6:15,6:30,,26.03,0,26.03,26.03,-1,-65499,70961,136460,5462,0,-15431,0,0,0,,15431,-15431
21,05/23/2017,27,6:30,6:45,31.99,26.03,0,31.99,31.99,1,-57967,62057,120024,4090,0,-786,703,0,0,,1489,-83
21,05/23/2017,28,6:45,7:00,40.91,,0,40.91,40.91,1,-92723,49342,142065,-43381,0,0,3916,0,0,,3916,3916
21,05/23/2017,29,7:00,7:15,27.7,15.86,0,34.21,15.86,2,-44915,111416,156331,66501,0,-11032,716,0,0,,11748,-10316
21,05/23/2017,30,7:15,7:30,,39.27,0,39.27,39.27,-1,-51672,79364,131036,27692,0,-5213,0,0,0,,5213,-5213
21,05/23/2017,31,7:30,7:45,,40.18,0,40.18,40.18,-1,-29331,52580,81911,23249,0,-1045,0,0,0,,1045,-1045
21,05/23/2017,32,7:45,8:00,,,0,34.07,34.07,0,-48909,64348,113257,15439,0,0,0,0,0,,0,0
21,05/23/2017,33,8:00,8:15,27.86,,0,27.86,27.86,1,-51594,43428,95022,-8166,0,0,12,0,0,,12,12
21,05/23/2017,34,8:15,8:30,53.9,,0,53.9,53.9,1,-81978,34903,116881,-47075,0,0,4215,0,0,,4215,4215
21,05/23/2017,35,8:30,8:45,264,,0,264,264,1,-87404,40288,127692,-47116,0,0,35764,0,0,,35764,35764
21,05/23/2017,36,8:45,9:00,47.4,,0,47.4,47.4,1,-91707,53673,145380,-38034,0,0,21008,0,0,,21008,21008
21,05/23/2017,37,9:00,9:15,54.39,,0,54.39,54.39,1,-87463,33786,121249,-53677,0,0,33293,0,0,,33293,33293
21,05/23/2017,38,9:15,9:30,54.39,,0,54.39,54.39,1,-108079,30901,138980,-77178,0,0,32756,0,0,,32756,32756
21,05/23/2017,39,9:30,9:45,82.02,,0,82.02,82.02,1,-106377,28931,135308,-77446,0,0,37770,0,0,,37770,37770
21,05/23/2017,40,9:45,10:00,47.89,,0,47.89,47.89,1,-95945,27572,123517,-68373,0,0,38194,0,0,,38194,38194
21,05/23/2017,41,10:00,10:15,33.05,,0,33.05,33.05,1,-78916,35025,113941,-43891,0,0,15880,0,0,,15880,15880
21,05/23/2017,42,10:15,10:30,33.05,28.78,0,28.78,28.78,-1,-58800,55189,113989,-3611,0,-675,1898,0,0,,2573,1223
21,05/23/2017,43,10:30,10:45,,,0,29.75,29.75,0,-37818,53171,90989,15353,0,0,0,0,0,,0,0
21,05/23/2017,44,10:45,11:00,,,0,29.78,29.78,0,-31834,67316,99150,35482,0,0,0,0,0,,0,0
21,05/23/2017,45,11:00,11:15,,29.17,0,29.17,29.17,-1,-48396,59875,108271,11479,0,-94,0,0,0,,94,-94
21,05/23/2017,46,11:15,11:30,,27.03,0,27.03,27.03,-1,-40411,66516,106927,26105,0,-5719,0,0,0,,5719,-5719
21,05/23/2017,47,11:30,11:45,,24.86,0,24.86,24.86,-1,-48052,103315,151367,55263,0,-8646,0,0,0,,8646,-8646
21,05/23/2017,48,11:45,12:00,,20.15,0,20.15,20.15,-1,-38792,112119,150911,73327,0,-21180,0,0,0,,21180,-21180
21,05/23/2017,49,12:00,12:15,27.86,25.7,0,27.86,27.86,1,-87444,70576,158020,-16868,0,-15356,469,0,0,,15825,-14887
21,05/23/2017,50,12:15,12:30,28.03,27.37,0,29.25,27.37,2,-82537,88446,170983,5909,0,-1882,506,0,0,,2388,-1376
21,05/23/2017,51,12:30,12:45,,26.98,0,26.98,26.98,-1,-79347,73606,152953,-5741,0,-2630,0,0,0,,2630,-2630
21,05/23/2017,52,12:45,13:00,178.25,,0,178.25,178.25,1,-80416,67048,147464,-13368,0,0,4848,0,0,,4848,4848
21,05/23/2017,53,13:00,13:15,27.62,,0,27.62,27.62,1,-114488,60772,175260,-53716,0,0,1292,0,0,,1292,1292
21,05/23/2017,54,13:15,13:30,31.86,,0,31.86,31.86,1,-144292,43791,188083,-100501,0,0,7598,0,0,,7598,7598
21,05/23/2017,55,13:30,13:45,46.02,,0,46.02,46.02,1,-144771,40567,185338,-104204,0,0,20572,0,0,,20572,20572
21,05/23/2017,56,13:45,14:00,29.6,,0,29.6,29.6,1,-121898,32821,154719,-89077,0,0,12722,0,0,,12722,12722
21,05/23/2017,57,14:00,14:15,213.11,,0,213.11,213.11,1,-164422,36031,200453,-128391,0,0,32238,0,0,,32238,32238
21,05/23/2017,58,14:15,14:30,213.11,,0,213.11,213.11,1,-112999,47682,160681,-65317,0,0,54926,0,0,,54926,54926
21,05/23/2017,59,14:30,14:45,62.78,,0,62.78,62.78,1,-91312,53503,144815,-37809,0,0,12094,0,0,,12094,12094
21,05/23/2017,60,14:45,15:00,29.66,27.78,0,27.78,27.78,-1,-70165,63643,133808,-6522,0,-33,12262,0,0,,12295,12229
21,05/23/2017,61,15:00,15:15,29.66,27.29,0,27.29,27.29,-1,-58864,102607,161471,43743,0,-1728,388,0,0,,2116,-1340
21,05/23/2017,62,15:15,15:30,,28.27,0,28.27,28.27,-1,-61514,74444,135958,12930,0,-465,0,0,0,,465,-465
21,05/23/2017,63,15:30,15:45,27.69,,0,27.69,27.69,1,-64290,66997,131287,2707,0,0,1045,0,0,,1045,1045
21,05/23/2017,64,15:45,16:00,27.64,,0,27.64,27.64,1,-63031,83650,146681,20619,0,0,1417,0,0,,1417,1417
21,05/23/2017,65,16:00,16:15,,,0,28.47,28.47,0,-22837,162926,185763,140089,0,0,0,0,0,,0,0
21,05/23/2017,66,16:15,16:30,,,0,28.43,28.43,0,-34513,152769,187282,118256,0,0,0,0,0,,0,0
21,05/23/2017,67,16:30,16:45,,,0,28.37,28.37,0,-42116,132549,174665,90433,0,0,0,0,0,,0,0
21,05/23/2017,68,16:45,17:00,,,0,34.03,34.03,0,-66279,116242,182521,49963,0,0,0,0,0,,0,0
21,05/23/2017,69,17:00,17:15,,30.58,0,30.58,30.58,-1,-46756,86144,132900,39388,0,-673,0,0,0,,673,-673
21,05/23/2017,70,17:15,17:30,27.23,30.32,0,34.05,30.32,2,-64967,61689,126656,-3278,0,-2369,8,0,0,,2377,-2361
21,05/23/2017,71,17:30,17:45,27.63,30.32,0,27.63,27.63,1,-65133,70249,135382,5116,0,-83,1513,0,0,,1596,1430
21,05/23/2017,72,17:45,18:00,31.86,,0,31.86,31.86,1,-75729,61927,137656,-13802,0,0,6931,0,0,,6931,6931
21,05/23/2017,73,18:00,18:15,27.86,40.42,0,40.42,40.42,-1,-42443,26573,69016,-15870,0,-89,5975,0,0,,6064,5886
21,05/23/2017,74,18:15,18:30,27.86,39.85,0,39.85,39.85,-1,-27581,36159,63740,8578,0,-1075,61,0,0,,1136,-1014
21,05/23/2017,75,18:30,18:45,,,0,34.02,34.02,0,-32483,35960,68443,3477,0,-44,0,0,0,,44,-44
21,05/23/2017,76,18:45,19:00,,,0,34.03,34.03,0,-34642,41627,76269,6985,0,0,0,0,0,,0,0
21,05/23/2017,77,19:00,19:15,,39.52,0,39.52,39.52,-1,-54219,42361,96580,-11858,0,-1007,0,0,0,,1007,-1007
21,05/23/2017,78,19:15,19:30,27.87,40.73,0,27.87,27.87,1,-66880,29548,96428,-37332,0,-68,815,0,0,,883,747
21,05/23/2017,79,19:30,19:45,32.11,,0,32.11,32.11,1,-89742,23489,113231,-66253,0,0,5861,0,0,,5861,5861
21,05/23/2017,80,19:45,20:00,28.31,,0,28.31,28.31,1,-92421,26134,118555,-66287,0,0,7866,0,0,,7866,7866
21,05/23/2017,81,20:00,20:15,43.71,,0,43.71,43.71,1,-83702,37433,121135,-46269,0,0,25505,0,0,,25505,25505
21,05/23/2017,82,20:15,20:30,46.24,,0,46.24,46.24,1,-90935,32469,123404,-58466,0,0,33014,0,0,,33014,33014
21,05/23/2017,83,20:30,20:45,35.72,,0,35.72,35.72,1,-72651,37603,110254,-35048,0,0,16229,0,0,,16229,16229
21,05/23/2017,84,20:45,21:00,36.65,,0,36.65,36.65,1,-77911,38676,116587,-39235,0,0,23056,0,0,,23056,23056
21,05/23/2017,85,21:00,21:15,31.86,,0,31.86,31.86,1,-57266,29926,87192,-27340,0,0,6330,0,0,,6330,6330
21,05/23/2017,86,21:15,21:30,31.86,,0,31.86,31.86,1,-56333,24259,80592,-32074,0,0,13517,0,0,,13517,13517
21,05/23/2017,87,21:30,21:45,31.86,,0,31.86,31.86,1,-63382,16606,79988,-46776,0,0,21904,0,0,,21904,21904
21,05/23/2017,88,21:45,22:00,41,,0,41,41,1,-88554,11071,99625,-77483,0,0,22354,0,0,,22354,22354
21,05/23/2017,89,22:00,22:15,256.66,,0,256.66,256.66,1,-136802,2239,139041,-134563,0,0,41479,0,0,,41479,41479
21,05/23/2017,90,22:15,22:30,256.66,,0,256.66,256.66,1,-97012,18813,115825,-78199,0,0,57937,0,0,,57937,57937
21,05/23/2017,91,22:30,22:45,256.66,36.43,0,36.43,36.43,-1,-39784,40907,80691,1123,0,-1057,4100,0,0,,5157,3043
21,05/23/2017,92,22:45,23:00,,25.86,0,25.86,25.86,-1,-32516,42765,75281,10249,0,-5385,0,0,0,,5385,-5385
21,05/23/2017,93,23:00,23:15,60.53,25.86,0,60.53,60.53,1,-97856,39421,137277,-58435,0,-5961,9292,0,0,,15253,3331
21,05/23/2017,94,23:15,23:30,98.68,,0,98.68,98.68,1,-73363,30655,104018,-42708,0,0,31258,0,0,,31258,31258
21,05/23/2017,95,23:30,23:45,27.86,,0,27.86,27.86,1,-57744,29251,86995,-28493,0,0,4807,0,0,,4807,4807
21,05/23/2017,96,23:45,0:00,28.18,,0,28.18,28.18,1,-81438,39738,121176,-41700,0,0,627,0,0,,627,627
21,05/24/2017,1,0:00,0:15,35.66,,0,35.66,35.66,1,-83244,59537,142781,-23707,0,0,6034,0,0,,6034,6034
21,05/24/2017,2,0:15,0:30,29.64,,0,29.64,29.64,1,-70354,48027,118381,-22327,0,0,14643,0,0,,14643,14643
21,05/24/2017,3,0:30,0:45,28.51,,0,28.51,28.51,1,-74264,35457,109721,-38807,0,0,2197,0,0,,2197,2197
21,05/24/2017,4,0:45,1:00,27.86,,0,27.86,27.86,1,-102481,51874,154355,-50607,0,0,2285,0,0,,2285,2285
21,05/24/2017,5,1:00,1:15,41.17,,0,41.17,41.17,1,-97923,51379,149302,-46544,0,0,19103,0,0,,19103,19103
21,05/24/2017,6,1:15,1:30,31.86,,0,31.86,31.86,1,-63341,45020,108361,-18321,0,0,22283,0,0,,22283,22283
21,05/24/2017,7,1:30,1:45,37.86,,0,37.86,37.86,1,-49757,11370,61127,-38387,0,0,12858,0,0,,12858,12858
21,05/24/2017,8,1:45,2:00,37.86,,0,37.86,37.86,1,-44899,16610,61509,-28289,0,0,22939,0,0,,22939,22939
21,05/24/2017,9,2:00,2:15,102.12,,0,102.12,102.12,1,-101589,15652,117241,-85937,0,0,51090,0,0,,51090,51090
21,05/24/2017,10,2:15,2:30,43.19,,0,43.19,43.19,1,-81400,19530,100930,-61870,0,0,50632,0,0,,50632,50632
21,05/24/2017,11,2:30,2:45,102.12,,0,102.12,102.12,1,-123107,23838,146945,-99269,0,0,74720,0,0,,74720,74720
21,05/24/2017,12,2:45,3:00,37.86,,0,37.86,37.86,1,-80288,34442,114730,-45846,0,0,33940,0,0,,33940,33940
21,05/24/2017,13,3:00,3:15,40.17,,0,40.17,40.17,1,-88521,39451,127972,-49070,0,0,27954,0,0,,27954,27954
21,05/24/2017,14,3:15,3:30,40.41,,0,40.41,40.41,1,-85795,40138,125933,-45657,0,0,43419,0,0,,43419,43419
21,05/24/2017,15,3:30,3:45,31.36,,0,31.36,31.36,1,-77351,44546,121897,-32805,0,0,23914,0,0,,23914,23914
21,05/24/2017,16,3:45,4:00,38.3,,0,38.3,38.3,1,-98445,43048,141493,-55397,0,0,33756,0,0,,33756,33756
21,05/24/2017,17,4:00,4:15,31.86,,0,31.86,31.86,1,-82531,51216,133747,-31315,0,0,23764,0,0,,23764,23764
21,05/24/2017,18,4:15,4:30,31.86,,0,31.86,31.86,1,-99115,46448,145563,-52667,0,0,3915,0,0,,3915,3915
21,05/24/2017,19,4:30,4:45,31.86,,0,31.86,31.86,1,-93130,38248,131378,-54882,0,0,21532,0,0,,21532,21532
21,05/24/2017,20,4:45,5:00,33.06,,0,33.06,33.06,1,-90506,49230,139736,-41276,0,0,30190,0,0,,30190,30190
21,05/24/2017,21,5:00,5:15,37.2,22.81,0,22.81,22.81,-1,-64559,62924,127483,-1635,0,-1133,18989,0,0,,20122,17856
21,05/24/2017,22,5:15,5:30,37.2,20.86,0,20.86,20.86,-1,-38857,52298,91155,13441,0,-5753,98,0,0,,5851,-5655
21,05/24/2017,23,5:30,5:45,25.86,20.86,0,25.86,25.86,1,-47201,48139,95340,938,0,-141,24,0,0,,165,-117
21,05/24/2017,24,5:45,6:00,31.57,,0,31.57,31.57,1,-72866,46872,119738,-25994,0,0,8518,0,0,,8518,8518
21,05/24/2017,25,6:00,6:15,32.4,33,0,33,33,-1,-79693,63773,143466,-15920,0,-597,9012,0,0,,9609,8415
21,05/24/2017,26,6:15,6:30,29.93,33,0,29.93,29.93,1,-66561,54272,120833,-12289,0,-152,582,0,0,,734,430
21,05/24/2017,27,6:30,6:45,37.78,,0,37.78,37.78,1,-82877,41424,124301,-41453,0,0,7579,0,0,,7579,7579
21,05/24/2017,28,6:45,7:00,163.41,,0,163.41,163.41,1,-95261,35457,130718,-59804,0,0,50653,0,0,,50653,50653
21,05/24/2017,29,7:00,7:15,27.78,39.71,0,34.14,34.14,2,-36224,77291,113515,41067,0,-241,14854,0,0,,15095,14613
21,05/24/2017,30,7:15,7:30,,39.12,0,39.12,39.12,-1,-36272,89861,126133,53589,0,-1193,0,0,0,,1193,-1193
21,05/24/2017,31,7:30,7:45,,40.07,0,40.07,40.07,-1,-78054,100453,178507,22399,0,-582,0,0,0,,582,-582
21,05/24/2017,32,7:45,8:00,,40.47,0,40.47,40.47,-1,-124098,104174,228272,-19924,0,-26,0,0,0,,26,-26
21,05/24/2017,33,8:00,8:15,,28.3,0,28.3,28.3,-1,-23762,105088,128850,81326,0,-1306,0,0,0,,1306,-1306
21,05/24/2017,34,8:15,8:30,,40.59,0,40.59,40.59,-1,-58931,89629,148560,30698,0,-646,0,0,0,,646,-646
21,05/24/2017,35,8:30,8:45,28.94,,0,28.94,28.94,1,-76494,79229,155723,2735,0,0,1002,0,0,,1002,1002
21,05/24/2017,36,8:45,9:00,59.12,,0,59.12,59.12,1,-101373,71491,172864,-29882,0,0,16649,0,0,,16649,16649
21,05/24/2017,37,9:00,9:15,59.12,,0,59.12,59.12,1,-99266,43366,142632,-55900,0,0,33453,0,0,,33453,33453
21,05/24/2017,38,9:15,9:30,87.46,,0,87.46,87.46,1,-115536,48946,164482,-66590,0,0,55844,0,0,,55844,55844
21,05/24/2017,39,9:30,9:45,40.97,,0,40.97,40.97,1,-94847,56187,151034,-38660,0,0,37095,0,0,,37095,37095
21,05/24/2017,40,9:45,10:00,48.92,,0,48.92,48.92,1,-110129,51164,161293,-58965,0,0,37134,0,0,,37134,37134
21,05/24/2017,41,10:00,10:15,130.12,,0,130.12,130.12,1,-119248,36731,155979,-82517,0,0,41035,0,0,,41035,41035
21,05/24/2017,42,10:15,10:30,53.92,,0,53.92,53.92,1,-132527,41836,174363,-90691,0,0,53414,0,0,,53414,53414
21,05/24/2017,43,10:30,10:45,131.52,,0,231.98,231.98,1,-218886,44736,263622,-174150,0,0,76208,0,8371,,84579,84579
21,05/24/2017,44,10:45,11:00,131.52,,0,231.98,231.98,1,-190907,77307,268214,-113600,0,0,69078,0,40768,,109846,109846
21,05/24/2017,45,11:00,11:15,94.52,,0,232.35,232.35,1,-212189,89395,301584,-122794,0,0,53615,0,49998,,103613,103613
21,05/24/2017,46,11:15,11:30,47.53,,0,232.35,232.35,1,-193892,91695,285587,-102197,0,0,55543,0,49998,,105541,105541
21,05/24/2017,47,11:30,11:45,47.49,,0,232.35,232.35,1,-183937,92784,276721,-91153,0,0,32474,0,43268,,75742,75742
21,05/24/2017,48,11:45,12:00,94.52,,0,232.35,232.35,1,-177028,91579,268607,-85449,0,0,48839,0,18418,,67257,67257
21,05/24/2017,49,12:00,12:15,47.91,,0,47.91,47.91,1,-114629,65710,180339,-48919,0,0,52972,0,0,,52972,52972
21,05/24/2017,50,12:15,12:30,101.68,,0,101.68,101.68,1,-105644,72459,178103,-33185,0,0,30016,17500,0,,47516,47516
21,05/24/2017,51,12:30,12:45,85.28,31.27,0,85.28,31.27,2,-69375,87725,157100,18350,0,-549,2794,13750,0,,17093,15995
21,05/24/2017,52,12:45,13:00,28.92,,0,28.92,28.92,1,-82237,83836,166073,1599,0,0,985,0,0,,985,985
21,05/24/2017,53,13:00,13:15,134.46,,0,134.46,134.46,1,-140372,47616,187988,-92756,0,0,22302,0,0,,22302,22302
21,05/24/2017,54,13:15,13:30,134.46,,0,134.46,134.46,1,-137606,45561,183167,-92045,0,0,83318,0,0,,83318,83318
21,05/24/2017,55,13:30,13:45,95.69,,0,95.69,95.69,1,-118153,54028,172181,-64125,0,0,70024,6250,0,,76274,76274
21,05/24/2017,56,13:45,14:00,37.03,,0,37.03,37.03,1,-104949,64661,169610,-40288,0,0,32587,0,0,,32587,32587
21,05/24/2017,57,14:00,14:15,34.52,,0,34.52,34.52,1,-95597,73248,168845,-22349,0,0,23193,0,0,,23193,23193
21,05/24/2017,58,14:15,14:30,31.78,,0,31.78,31.78,1,-78961,55090,134051,-23871,0,0,14619,0,0,,14619,14619
21,05/24/2017,59,14:30,14:45,35.96,,0,35.96,35.96,1,-81498,47215,128713,-34283,0,0,20696,0,0,,20696,20696
21,05/24/2017,60,14:45,15:00,31.78,,0,31.78,31.78,1,-73955,43192,117147,-30763,0,0,20307,0,0,,20307,20307
21,05/24/2017,61,15:00,15:15,39.71,40.91,0,39.71,34.29,2,-77478,68266,145744,-9212,0,-2,18083,0,0,,18085,18081
21,05/24/2017,62,15:15,15:30,29.22,30.07,0,34.29,30.07,2,-77129,74087,151216,-3042,0,-523,2151,0,0,,2674,1628
21,05/24/2017,63,15:30,15:45,27.78,,0,27.78,27.78,1,-70402,70654,141056,252,0,0,3382,0,0,,3382,3382
21,05/24/2017,64,15:45,16:00,27.66,,0,27.66,27.66,1,-65910,83404,149314,17494,0,0,1159,0,0,,1159,1159
21,05/24/2017,65,16:00,16:15,,,0,34.33,34.33,0,-49794,152270,202064,102476,0,0,0,0,0,,0,0
21,05/24/2017,66,16:15,16:30,,30,0,30,30,-1,-37153,135421,172574,98268,0,-390,0,0,0,,390,-390
21,05/24/2017,67,16:30,16:45,,30.34,0,30.34,30.34,-1,-34248,133384,167632,99136,0,-2648,0,0,0,,2648,-2648
21,05/24/2017,68,16:45,17:00,,20.78,0,20.78,20.78,-1,-34132,116489,150621,82357,0,-8085,0,0,0,,8085,-8085
21,05/24/2017,69,17:00,17:15,,20.78,0,20.78,20.78,-1,-59145,94447,153592,35302,0,-14295,0,0,0,,14295,-14295
21,05/24/2017,70,17:15,17:30,,24.78,0,24.78,24.78,-1,-55185,74369,129554,19184,0,-15527,0,0,0,,15527,-15527
21,05/24/2017,71,17:30,17:45,,40.56,0,40.56,40.56,-1,-54331,69396,123727,15065,0,-5193,0,0,0,,5193,-5193
21,05/24/2017,72,17:45,18:00,,,0,34.29,34.29,0,-46350,82402,128752,36052,0,0,0,0,0,,0,0
21,05/24/2017,73,18:00,18:15,27.78,,0,27.78,27.78,1,-139637,112266,251903,-27371,0,0,178,0,0,,178,178
21,05/24/2017,74,18:15,18:30,,,0,34.37,34.37,0,-118233,125635,243868,7402,0,0,0,0,0,,0,0
21,05/24/2017,75,18:30,18:45,,40.95,0,40.95,40.95,-1,-110690,132773,243463,22083,0,-83,0,0,0,,83,-83
21,05/24/2017,76,18:45,19:00,,40.95,0,40.95,40.95,-1,-104017,120765,224782,16748,0,-22,0,0,0,,22,-22
21,05/24/2017,77,19:00,19:15,,30.65,0,30.65,30.65,-1,-68156,96861,165017,28705,0,-542,0,0,0,,542,-542
21,05/24/2017,78,19:15,19:30,,29.12,0,29.12,29.12,-1,-77714,107400,185114,29686,0,-1316,0,0,0,,1316,-1316
21,05/24/2017,79,19:30,19:45,,31.63,0,31.63,31.63,-1,-75729,117738,193467,42009,0,-4081,0,0,0,,4081,-4081
21,05/24/2017,80,19:45,20:00,,29.11,0,29.11,29.11,-1,-71715,100661,172376,28946,0,-3979,0,0,0,,3979,-3979
21,05/24/2017,81,20:00,20:15,29.22,29.11,0,29.22,29.22,1,-84317,87819,172136,3502,0,-459,168,0,0,,627,-291
21,05/24/2017,82,20:15,20:30,29.62,,0,29.62,29.62,1,-81368,83331,164699,1963,0,0,1898,0,0,,1898,1898
21,05/24/2017,83,20:30,20:45,32.34,,0,32.34,32.34,1,-80495,70558,151053,-9937,0,0,3541,0,0,,3541,3541
21,05/24/2017,84,20:45,21:00,30.12,32.83,0,32.83,32.83,-1,-63113,78935,142048,15822,0,-104,4488,0,0,,4592,4384
21,05/24/2017,85,21:00,21:15,,33.15,0,33.15,33.15,-1,-72805,92972,165777,20167,0,-2083,0,0,0,,2083,-2083
21,05/24/2017,86,21:15,21:30,,40.73,0,40.73,40.73,-1,-65989,96394,162383,30405,0,-322,0,0,0,,322,-322
21,05/24/2017,87,21:30,21:45,,40.77,0,40.77,40.77,-1,-68049,74573,142622,6524,0,-34,0,0,0,,34,-34
21,05/24/2017,88,21:45,22:00,,,0,34.25,34.25,0,-75596,64116,139712,-11480,0,0,0,0,0,,0,0
21,05/24/2017,89,22:00,22:15,29.61,,0,29.61,29.61,1,-80642,42764,123406,-37878,0,0,1540,0,0,,1540,1540
21,05/24/2017,90,22:15,22:30,30.98,29.05,0,34.23,29.05,2,-41914,44222,86136,2308,0,-737,2346,0,0,,3083,1609
21,05/24/2017,91,22:30,22:45,,28.7,0,28.7,28.7,-1,-53984,54171,108155,187,0,-1887,0,0,0,,1887,-1887
21,05/24/2017,92,22:45,23:00,,20.78,0,20.78,20.78,-1,-29484,53404,82888,23920,0,-6410,0,0,0,,6410,-6410
21,05/24/2017,93,23:00,23:15,91.03,29.89,0,91.03,29.89,2,-105851,61515,167366,-44336,0,-5895,12890,0,0,,18785,6995
21,05/24/2017,94,23:15,23:30,32.37,,0,32.37,32.37,1,-81441,65700,147141,-15741,0,0,17909,0,0,,17909,17909
21,05/24/2017,95,23:30,23:45,27.78,,0,27.78,27.78,1,-55964,37960,93924,-18004,0,0,5023,0,0,,5023,5023
21,05/24/2017,96,23:45,0:00,31.91,,0,31.91,31.91,1,-96309,55974,152283,-40335,0,0,3738,0,0,,3738,3738
21,05/25/2017,1,0:00,0:15,128.02,,0,128.02,128.02,1,-87089,23011,110100,-64078,0,0,14593,0,0,,14593,14593
21,05/25/2017,2,0:15,0:30,128.02,,0,128.02,128.02,1,-52777,25381,78158,-27396,0,0,27982,0,0,,27982,27982
21,05/25/2017,3,0:30,0:45,31.99,,0,31.99,31.99,1,-64524,31996,96520,-32528,0,0,14236,0,0,,14236,14236
21,05/25/2017,4,0:45,1:00,31.99,29.43,0,29.43,29.43,-1,-111077,43329,154406,-67748,0,-112,1840,0,0,,1952,1728
21,05/25/2017,5,1:00,1:15,64.87,28.48,0,64.87,28.48,2,-42514,52006,94520,9492,0,-1271,2294,0,0,,3565,1023
21,05/25/2017,6,1:15,1:30,128.02,,0,128.02,128.02,1,-74103,28309,102412,-45794,0,0,36098,0,0,,36098,36098
21,05/25/2017,7,1:30,1:45,25.99,,0,25.99,25.99,1,-41298,29831,71129,-11467,0,0,1985,0,0,,1985,1985
21,05/25/2017,8,1:45,2:00,25.99,28.99,0,33.68,28.99,2,-28557,27321,55878,-1236,0,-203,682,0,0,,885,479
21,05/25/2017,9,2:00,2:15,69.47,25.99,0,69.47,69.47,1,-65574,39674,105248,-25900,0,-368,3971,0,0,,4339,3603
21,05/25/2017,10,2:15,2:30,127.02,,0,127.02,127.02,1,-77478,25685,103163,-51793,0,0,38929,0,0,,38929,38929
21,05/25/2017,11,2:30,2:45,27.02,,0,27.02,27.02,1,-52300,31070,83370,-21230,0,0,3990,0,0,,3990,3990
21,05/25/2017,12,2:45,3:00,,,0,33.18,33.18,0,-51381,31402,82783,-19979,0,0,0,0,0,,0,0
21,05/25/2017,13,3:00,3:15,125.27,,0,125.27,125.27,1,-118366,37861,156227,-80505,0,0,23893,0,0,,23893,23893
21,05/25/2017,14,3:15,3:30,35.02,,0,35.02,35.02,1,-73145,31720,104865,-41425,0,0,32923,0,0,,32923,32923
21,05/25/2017,15,3:30,3:45,31.99,,0,31.99,31.99,1,-70618,21433,92051,-49185,0,0,20451,0,0,,20451,20451
21,05/25/2017,16,3:45,4:00,31.99,,0,31.99,31.99,1,-81819,23057,104876,-58762,0,0,25781,0,0,,25781,25781
21,05/25/2017,17,4:00,4:15,72.62,,0,72.62,72.62,1,-80605,23856,104461,-56749,0,0,33954,0,0,,33954,33954
21,05/25/2017,18,4:15,4:30,81.89,,0,81.89,81.89,1,-70953,35258,106211,-35695,0,0,47596,0,0,,47596,47596
21,05/25/2017,19,4:30,4:45,37.99,40.36,0,37.99,33.18,2,-66328,31744,98072,-34584,0,-49,6355,0,0,,6404,6306
21,05/25/2017,20,4:45,5:00,55.68,,0,55.68,55.68,1,-59181,27403,86584,-31778,0,0,25987,0,0,,25987,25987
21,05/25/2017,21,5:00,5:15,28.48,,0,28.48,28.48,1,-49469,37553,87022,-11916,0,0,8278,0,0,,8278,8278
21,05/25/2017,22,5:15,5:30,28.48,40.34,0,40.34,40.34,-1,-21873,43000,64873,21127,0,-118,800,0,0,,918,682
21,05/25/2017,23,5:30,5:45,,25.99,0,25.99,25.99,-1,-11601,52416,64017,40815,0,-993,0,0,0,,993,-993
21,05/25/2017,24,5:45,6:00,,26.81,0,26.81,26.81,-1,-38989,46536,85525,7547,0,-4559,0,0,0,,4559,-4559
21,05/25/2017,25,6:00,6:15,,25.24,0,25.24,25.24,-1,-32873,62991,95864,30118,0,-9904,0,0,0,,9904,-9904
21,05/25/2017,26,6:15,6:30,,39.97,0,39.97,39.97,-1,-30851,35905,66756,5054,0,-3175,0,0,0,,3175,-3175
21,05/25/2017,27,6:30,6:45,,26.24,0,26.24,26.24,-1,-25078,56363,81441,31285,0,-2077,0,0,0,,2077,-2077
21,05/25/2017,28,6:45,7:00,,40.28,0,40.28,40.28,-1,-19274,55844,75118,36570,0,-572,0,0,0,,572,-572
21,05/25/2017,29,7:00,7:15,,27.66,0,27.66,27.66,-1,-26780,97311,124091,70531,0,-1486,0,0,0,,1486,-1486
21,05/25/2017,30,7:15,7:30,,40.05,0,40.05,40.05,-1,-30452,74498,104950,44046,0,-1555,0,0,0,,1555,-1555
21,05/25/2017,31,7:30,7:45,,40.33,0,40.33,40.33,-1,-25291,78197,103488,52906,0,-381,0,0,0,,381,-381
21,05/25/2017,32,7:45,8:00,,26.94,0,26.94,26.94,-1,-17714,97543,115257,79829,0,-489,0,0,0,,489,-489
21,05/25/2017,33,8:00,8:15,,27.56,0,27.56,27.56,-1,-16957,79724,96681,62767,0,-2483,0,0,0,,2483,-2483
21,05/25/2017,34,8:15,8:30,,27.59,0,27.59,27.59,-1,-14743,91203,105946,76460,0,-3796,0,0,0,,3796,-3796
21,05/25/2017,35,8:30,8:45,,,0,33.33,33.33,0,-22945,81604,104549,58659,0,-1177,0,0,0,,1177,-1177
21,05/25/2017,36,8:45,9:00,,,0,33.29,33.29,0,-36518,90556,127074,54038,0,0,0,0,0,,0,0
21,05/25/2017,37,9:00,9:15,,21.24,0,21.24,21.24,-1,-8451,118448,126899,109997,0,-7730,0,0,0,,7730,-7730
21,05/25/2017,38,9:15,9:30,,21.24,0,21.24,21.24,-1,-19340,116535,135875,97195,0,-12460,0,0,0,,12460,-12460
21,05/25/2017,39,9:30,9:45,,2.7,0,2.7,2.7,-1,-20949,106297,127246,85348,0,-30782,0,0,0,,30782,-30782
21,05/25/2017,40,9:45,10:00,,8.86,0,8.86,8.86,-1,-29163,93315,122478,64152,0,-42664,0,0,0,,42664,-42664
21,05/25/2017,41,10:00,10:15,,25.79,0,25.79,25.79,-1,-55497,117599,173096,62102,0,-17740,0,0,0,,17740,-17740
21,05/25/2017,42,10:15,10:30,,,0,33.84,33.84,0,-49209,102715,151924,53506,0,0,0,0,0,,0,0
21,05/25/2017,43,10:30,10:45,,,0,33.83,33.83,0,-53155,109780,162935,56625,0,0,0,0,0,,0,0
21,05/25/2017,44,10:45,11:00,,21.24,0,21.24,21.24,-1,-47241,103705,150946,56464,0,-1713,0,0,0,,1713,-1713
21,05/25/2017,45,11:00,11:15,,16.24,0,16.24,16.24,-1,-66868,121759,188627,54891,0,-4781,0,0,0,,4781,-4781
21,05/25/2017,46,11:15,11:30,,25.24,0,25.24,25.24,-1,-63340,116900,180240,53560,0,-7221,0,0,0,,7221,-7221
21,05/25/2017,47,11:30,11:45,,25.24,0,25.24,25.24,-1,-61118,123831,184949,62713,0,-9031,0,0,0,,9031,-9031
21,05/25/2017,48,11:45,12:00,,25.22,0,25.22,25.22,-1,-62778,112009,174787,49231,0,-7655,0,0,0,,7655,-7655
21,05/25/2017,49,12:00,12:15,,24.5,0,24.5,24.5,-1,-51607,79420,131027,27813,0,-7612,0,0,0,,7612,-7612
21,05/25/2017,50,12:15,12:30,,25.24,0,25.24,25.24,-1,-55399,81309,136708,25910,0,-11153,0,0,0,,11153,-11153
21,05/25/2017,51,12:30,12:45,,25.24,0,25.24,25.24,-1,-53357,79388,132745,26031,0,-15678,0,0,0,,15678,-15678
21,05/25/2017,52,12:45,13:00,,25.03,0,25.03,25.03,-1,-57667,81417,139084,23750,0,-20307,0,0,0,,20307,-20307
21,05/25/2017,53,13:00,13:15,,25.24,0,25.24,25.24,-1,-65657,75194,140851,9537,0,-14242,0,0,0,,14242,-14242
21,05/25/2017,54,13:15,13:30,,25.78,0,25.78,25.78,-1,-58455,80767,139222,22312,0,-1701,0,0,0,,1701,-1701
21,05/25/2017,55,13:30,13:45,,26.24,0,26.24,26.24,-1,-54331,81367,135698,27036,0,-2123,0,0,0,,2123,-2123
21,05/25/2017,56,13:45,14:00,,25.24,0,25.24,25.24,-1,-57249,78814,136063,21565,0,-3582,0,0,0,,3582,-3582
21,05/25/2017,57,14:00,14:15,,26.24,0,26.24,26.24,-1,-74151,93044,167195,18893,0,-3925,0,0,0,,3925,-3925
21,05/25/2017,58,14:15,14:30,,,0,34.05,34.05,0,-69510,85132,154642,15622,0,-47,0,0,0,,47,-47
21,05/25/2017,59,14:30,14:45,26.24,,0,26.24,26.24,1,-84393,87878,172271,3485,0,0,631,0,0,,631,631
21,05/25/2017,60,14:45,15:00,26.24,26.24,0,26.24,26.24,-1,-79789,80414,160203,625,0,-1396,33,0,0,,1429,-1363
21,05/25/2017,61,15:00,15:15,,41.93,0,41.93,41.93,-1,-50108,94234,144342,44126,0,-17,0,0,0,,17,-17
21,05/25/2017,62,15:15,15:30,,41.93,0,41.93,41.93,-1,-55263,97248,152511,41985,0,-213,0,0,0,,213,-213
21,05/25/2017,63,15:30,15:45,,41.93,0,41.93,41.93,-1,-57639,96924,154563,39285,0,-96,0,0,0,,96,-96
21,05/25/2017,64,15:45,16:00,,41.93,0,41.93,41.93,-1,-58051,91941,149992,33890,0,-52,0,0,0,,52,-52
21,05/25/2017,65,16:00,16:15,,25.24,0,25.24,25.24,-1,-32122,116959,149081,84837,0,-5824,0,0,0,,5824,-5824
21,05/25/2017,66,16:15,16:30,,28.17,0,28.17,28.17,-1,-25891,108957,134848,83066,0,-1856,0,0,0,,1856,-1856
21,05/25/2017,67,16:30,16:45,,28.17,0,28.17,28.17,-1,-27977,102482,130459,74505,0,-3159,0,0,0,,3159,-3159
21,05/25/2017,68,16:45,17:00,,28.46,0,28.46,28.46,-1,-29230,106185,135415,76955,0,-285,0,0,0,,285,-285
21,05/25/2017,69,17:00,17:15,,-150.03,0,-150.03,-150.03,-1,-105021,160992,266013,55971,0,-23021,0,0,0,,23021,-23021
21,05/25/2017,70,17:15,17:30,26.24,6.84,0,34.8,6.84,2,-79726,110137,189863,30411,0,-35490,3,0,0,,35493,-35487
21,05/25/2017,71,17:30,17:45,28.12,6.84,0,28.12,28.12,1,-64977,91357,156334,26380,0,-1978,302,0,0,,2280,-1676
21,05/25/2017,72,17:45,18:00,26.24,,0,26.24,26.24,1,-71652,90170,161822,18518,0,0,84,0,0,,84,84
21,05/25/2017,73,18:00,18:15,28.02,,0,28.02,28.02,1,-89789,62788,152577,-27001,0,0,1224,0,0,,1224,1224
21,05/25/2017,74,18:15,18:30,,22.61,0,22.61,22.61,-1,-61088,85120,146208,24032,0,-8911,0,0,0,,8911,-8911
21,05/25/2017,75,18:30,18:45,,25.24,0,25.24,25.24,-1,-49750,74914,124664,25164,0,-16404,0,0,0,,16404,-16404
21,05/25/2017,76,18:45,19:00,26.24,43.33,0,26.24,26.24,1,-57409,65755,123164,8346,0,-5825,468,0,0,,6293,-5357
21,05/25/2017,77,19:00,19:15,28.24,24.34,0,34.78,24.34,2,-88114,91496,179610,3382,0,-950,1519,0,0,,2469,569
21,05/25/2017,78,19:15,19:30,,21.24,0,21.24,21.24,-1,-50694,78758,129452,28064,0,-16886,0,0,0,,16886,-16886
21,05/25/2017,79,19:30,19:45,,,0,34.78,34.78,0,-58568,75088,133656,16520,0,-1584,0,0,0,,1584,-1584
21,05/25/2017,80,19:45,20:00,28.24,,0,28.24,28.24,1,-69410,69997,139407,587,0,0,108,0,0,,108,108
21,05/25/2017,81,20:00,20:15,46.77,,0,46.77,46.77,1,-99220,56211,155431,-43009,0,0,15192,0,0,,15192,15192
21,05/25/2017,82,20:15,20:30,29.19,29.55,0,29.55,29.55,-1,-47965,59920,107885,11955,0,-258,8235,0,0,,8493,7977
21,05/25/2017,83,20:30,20:45,29.19,28.17,0,28.17,28.17,-1,-47810,59049,106859,11239,0,-2964,29,0,0,,2993,-2935
21,05/25/2017,84,20:45,21:00,,28.44,0,28.44,28.44,-1,-41962,56541,98503,14579,0,-4779,0,0,0,,4779,-4779
21,05/25/2017,85,21:00,21:15,,25.24,0,25.24,25.24,-1,-25135,67126,92261,41991,0,-11612,0,0,0,,11612,-11612
21,05/25/2017,86,21:15,21:30,,25.24,0,25.24,25.24,-1,-29565,75900,105465,46335,0,-8640,0,0,0,,8640,-8640
21,05/25/2017,87,21:30,21:45,,26.24,0,26.24,26.24,-1,-32243,80897,113140,48654,0,-9002,0,0,0,,9002,-9002
21,05/25/2017,88,21:45,22:00,,29.56,0,29.56,29.56,-1,-43418,74145,117563,30727,0,-3292,0,0,0,,3292,-3292
21,05/25/2017,89,22:00,22:15,,26.24,0,26.24,26.24,-1,-53495,69921,123416,16426,0,-5836,0,0,0,,5836,-5836
21,05/25/2017,90,22:15,22:30,26.98,26.24,0,26.98,26.98,1,-64389,49903,114292,-14486,0,-402,1366,0,0,,1768,964
21,05/25/2017,91,22:30,22:45,,,0,34.38,34.38,0,-53996,55789,109785,1793,0,0,66,0,0,,66,66
21,05/25/2017,92,22:45,23:00,,26.24,0,26.24,26.24,-1,-43551,62854,106405,19303,0,-1779,0,0,0,,1779,-1779
21,05/25/2017,93,23:00,23:15,129.07,41.64,0,129.07,129.07,1,-88845,33433,122278,-55412,0,-437,14262,0,0,,14699,13825
21,05/25/2017,94,23:15,23:30,42.05,41.2,0,42.05,33.96,2,-55332,36358,91690,-18974,0,-28,29473,0,0,,29501,29445
21,05/25/2017,95,23:30,23:45,42.05,26.88,0,26.88,26.88,-1,-35569,45078,80647,9509,0,-957,603,0,0,,1560,-354
21,05/25/2017,96,23:45,0:00,,24.77,0,24.77,24.77,-1,-44118,60750,104868,16632,0,-19015,0,0,0,,19015,-19015
21,05/26/2017,1,0:00,0:15,27.92,25.22,0,33.45,25.22,2,-50972,55454,106426,4482,0,-15348,224,0,0,,15572,-15124
21,05/26/2017,2,0:15,0:30,26.22,25.22,0,26.22,26.22,1,-77665,44635,122300,-33030,0,-244,1118,0,0,,1362,874
21,05/26/2017,3,0:30,0:45,26.22,,0,26.22,26.22,1,-81003,53929,134932,-27074,0,0,67,0,0,,67,67
21,05/26/2017,4,0:45,1:00,,26.22,0,26.22,26.22,-1,-93504,72306,165810,-21198,0,-164,0,0,0,,164,-164
21,05/26/2017,5,1:00,1:15,,25.22,0,25.22,25.22,-1,-29506,63021,92527,33515,0,-5432,0,0,0,,5432,-5432
21,05/26/2017,6,1:15,1:30,,25.22,0,25.22,25.22,-1,-48979,51057,100036,2078,0,-8432,0,0,0,,8432,-8432
21,05/26/2017,7,1:30,1:45,,25.22,0,25.22,25.22,-1,-39009,56407,95416,17398,0,-10289,0,0,0,,10289,-10289
21,05/26/2017,8,1:45,2:00,,21.22,0,21.22,21.22,-1,-40171,59796,99967,19625,0,-21889,0,0,0,,21889,-21889
21,05/26/2017,9,2:00,2:15,28.83,24.37,0,28.83,28.83,1,-47670,61673,109343,14003,0,-14819,488,0,0,,15307,-14331
21,05/26/2017,10,2:15,2:30,29.87,21.22,0,33.45,21.22,2,-43152,53127,96279,9975,0,-3321,1037,0,0,,4358,-2284
21,05/26/2017,11,2:30,2:45,,16.1,0,16.1,16.1,-1,-39445,65695,105140,26250,0,-17337,0,0,0,,17337,-17337
21,05/26/2017,12,2:45,3:00,,6.65,0,6.65,6.65,-1,-39212,67081,106293,27869,0,-30375,0,0,0,,30375,-30375
21,05/26/2017,13,3:00,3:15,26.22,26.22,0,26.22,26.22,1,-55438,52870,108308,-2568,0,-11423,216,0,0,,11639,-11207
21,05/26/2017,14,3:15,3:30,26.22,21.22,0,33.45,21.22,2,-39937,51085,91022,11148,0,-2250,45,0,0,,2295,-2205
21,05/26/2017,15,3:30,3:45,,15.07,0,15.07,15.07,-1,-36990,51825,88815,14835,0,-18419,0,0,0,,18419,-18419
21,05/26/2017,16,3:45,4:00,,15.07,0,15.07,15.07,-1,-38766,62691,101457,23925,0,-21254,0,0,0,,21254,-21254
21,05/26/2017,17,4:00,4:15,,12.6,0,12.6,12.6,-1,-34719,79458,114177,44739,0,-19007,0,0,0,,19007,-19007
21,05/26/2017,18,4:15,4:30,,,0,33.43,33.43,0,-36875,57673,94548,20798,0,-355,0,0,0,,355,-355
21,05/26/2017,19,4:30,4:45,,,0,33.43,33.43,0,-27554,57414,84968,29860,0,0,0,0,0,,0,0
21,05/26/2017,20,4:45,5:00,,40.28,0,40.28,40.28,-1,-27402,56561,83963,29159,0,-7,0,0,0,,7,-7
21,05/26/2017,21,5:00,5:15,,-150.78,0,-150.78,-150.78,-1,-40101,64058,104159,23957,0,-30347,0,0,0,,30347,-30347
21,05/26/2017,22,5:15,5:30,,21.08,0,21.08,21.08,-1,-38079,49026,87105,10947,0,-32356,0,0,0,,32356,-32356
21,05/26/2017,23,5:30,5:45,,-150.78,0,-150.78,-150.78,-1,-19501,60720,80221,41219,0,-41340,0,0,0,,41340,-41340
21,05/26/2017,24,5:45,6:00,,15.78,0,15.78,15.78,-1,-25484,41796,67280,16312,0,-34635,0,0,0,,34635,-34635
21,05/26/2017,25,6:00,6:15,27.83,25.22,0,27.83,27.83,1,-123616,49471,173087,-74145,0,-16776,190,0,0,,16966,-16586
21,05/26/2017,26,6:15,6:30,26.22,22.15,0,33.44,22.15,2,-59224,75861,135085,16637,0,-5356,303,0,0,,5659,-5053
21,05/26/2017,27,6:30,6:45,,20.66,0,20.66,20.66,-1,-53639,79879,133518,26240,0,-25922,0,0,0,,25922,-25922
21,05/26/2017,28,6:45,7:00,,23.03,0,23.03,23.03,-1,-33905,88677,122582,54772,0,-13590,0,0,0,,13590,-13590
21,05/26/2017,29,7:00,7:15,,23.03,0,23.03,23.03,-1,-93686,88506,182192,-5180,0,-12892,0,0,0,,12892,-12892
21,05/26/2017,30,7:15,7:30,,24.48,0,24.48,24.48,-1,-48486,91012,139498,42526,0,-8135,0,0,0,,8135,-8135
21,05/26/2017,31,7:30,7:45,,,0,34.26,34.26,0,-39986,73845,113831,33859,0,-776,0,0,0,,776,-776
21,05/26/2017,32,7:45,8:00,,,0,34.23,34.23,0,-53021,82718,135739,29697,0,0,0,0,0,,0,0
21,05/26/2017,33,8:00,8:15,,,0,34.41,34.41,0,-32477,117985,150462,85508,0,0,0,0,0,,0,0
21,05/26/2017,34,8:15,8:30,,,0,34.39,34.39,0,-36194,108822,145016,72628,0,0,0,0,0,,0,0
21,05/26/2017,35,8:30,8:45,,,0,34.37,34.37,0,-46258,91081,137339,44823,0,0,0,0,0,,0,0
21,05/26/2017,36,8:45,9:00,,,0,34.36,34.36,0,-61554,78775,140329,17221,0,0,0,0,0,,0,0
21,05/26/2017,37,9:00,9:15,,,0,34.27,34.27,0,-32938,96773,129711,63835,0,0,0,0,0,,0,0
21,05/26/2017,38,9:15,9:30,,,0,34.25,34.25,0,-38264,85552,123816,47288,0,0,0,0,0,,0,0
21,05/26/2017,39,9:30,9:45,,,0,34.24,34.24,0,-43156,84933,128089,41777,0,0,0,0,0,,0,0
21,05/26/2017,40,9:45,10:00,,,0,34.24,34.24,0,-44648,85717,130365,41069,0,0,0,0,0,,0,0
21,05/26/2017,41,10:00,10:15,,,0,34.29,34.29,0,-15704,105378,121082,89674,0,0,0,0,0,,0,0
21,05/26/2017,42,10:15,10:30,,31.12,0,31.12,31.12,-1,-22637,109622,132259,86985,0,-697,0,0,0,,697,-697
21,05/26/2017,43,10:30,10:45,,17.06,0,17.06,17.06,-1,-16086,114062,130148,97976,0,-15234,0,0,0,,15234,-15234
21,05/26/2017,44,10:45,11:00,,26.22,0,26.22,26.22,-1,-12598,87491,100089,74893,0,-7728,0,0,0,,7728,-7728
21,05/26/2017,45,11:00,11:15,,26.22,0,26.22,26.22,-1,-62174,79145,141319,16971,0,-358,0,0,0,,358,-358
21,05/26/2017,46,11:15,11:30,,27.55,0,27.55,27.55,-1,-28534,75535,104069,47001,0,-150,0,0,0,,150,-150
21,05/26/2017,47,11:30,11:45,,26.72,0,26.72,26.72,-1,-29706,74968,104674,45262,0,-1854,0,0,0,,1854,-1854
21,05/26/2017,48,11:45,12:00,,,0,34.35,34.35,0,-29656,85254,114910,55598,0,-623,0,0,0,,623,-623
21,05/26/2017,49,12:00,12:15,30.44,27.56,0,34.41,27.56,2,-93872,69954,163826,-23918,0,-266,1153,0,0,,1419,887
21,05/26/2017,50,12:15,12:30,,27.26,0,27.26,27.26,-1,-60302,64879,125181,4577,0,-2966,0,0,0,,2966,-2966
21,05/26/2017,51,12:30,12:45,,27.78,0,27.78,27.78,-1,-46245,72442,118687,26197,0,-6707,0,0,0,,6707,-6707
21,05/26/2017,52,12:45,13:00,,16.89,0,16.89,16.89,-1,-46122,84412,130534,38290,0,-10854,0,0,0,,10854,-10854
21,05/26/2017,53,13:00,13:15,,15.81,0,15.81,15.81,-1,-29847,84773,114620,54926,0,-16080,0,0,0,,16080,-16080
21,05/26/2017,54,13:15,13:30,,25.22,0,25.22,25.22,-1,-31415,81190,112605,49775,0,-9474,0,0,0,,9474,-9474
21,05/26/2017,55,13:30,13:45,,25.22,0,25.22,25.22,-1,-26348,84729,111077,58381,0,-12439,0,0,0,,12439,-12439
21,05/26/2017,56,13:45,14:00,,40.75,0,40.75,40.75,-1,-21521,89496,111017,67975,0,-822,0,0,0,,822,-822
21,05/26/2017,57,14:00,14:15,,42.21,0,42.21,42.21,-1,-23521,71233,94754,47712,0,-289,0,0,0,,289,-289
21,05/26/2017,58,14:15,14:30,,28.78,0,28.78,28.78,-1,-25006,81989,106995,56983,0,-985,0,0,0,,985,-985
21,05/26/2017,59,14:30,14:45,,26.22,0,26.22,26.22,-1,-24578,81982,106560,57404,0,-1979,0,0,0,,1979,-1979
21,05/26/2017,60,14:45,15:00,,41.83,0,41.83,41.83,-1,-23297,83319,106616,60022,0,-1982,0,0,0,,1982,-1982
21,05/26/2017,61,15:00,15:15,,42.3,0,42.3,42.3,-1,-19128,76836,95964,57708,0,-614,0,0,0,,614,-614
21,05/26/2017,62,15:15,15:30,,,0,35.05,35.05,0,-19335,89908,109243,70573,0,0,0,0,0,,0,0
21,05/26/2017,63,15:30,15:45,,,0,35.05,35.05,0,-21182,84321,105503,63139,0,0,0,0,0,,0,0
21,05/26/2017,64,15:45,16:00,,,0,35.06,35.06,0,-29313,84381,113694,55068,0,0,0,0,0,,0,0
21,05/26/2017,65,16:00,16:15,,,0,35.08,35.08,0,-26896,87855,114751,60959,0,0,0,0,0,,0,0
21,05/26/2017,66,16:15,16:30,,,0,35.1,35.1,0,-31279,91170,122449,59891,0,0,0,0,0,,0,0
21,05/26/2017,67,16:30,16:45,,,0,35.09,35.09,0,-39386,87340,126726,47954,0,0,0,0,0,,0,0
21,05/26/2017,68,16:45,17:00,,,0,35.08,35.08,0,-47712,90735,138447,43023,0,0,0,0,0,,0,0
21,05/26/2017,69,17:00,17:15,,24.74,0,24.74,24.74,-1,-20843,118153,138996,97310,0,-1952,0,0,0,,1952,-1952
21,05/26/2017,70,17:15,17:30,,,0,35.09,35.09,0,-22323,95127,117450,72804,0,-527,0,0,0,,527,-527
21,05/26/2017,71,17:30,17:45,,42.03,0,42.03,42.03,-1,-26324,98980,125304,72656,0,-550,0,0,0,,550,-550
21,05/26/2017,72,17:45,18:00,,42.37,0,42.37,42.37,-1,-26853,109594,136447,82741,0,-347,0,0,0,,347,-347
21,05/26/2017,73,18:00,18:15,,27.35,0,27.35,27.35,-1,-50306,82524,132830,32218,0,-592,0,0,0,,592,-592
21,05/26/2017,74,18:15,18:30,,27.78,0,27.78,27.78,-1,-23612,84069,107681,60457,0,-1502,0,0,0,,1502,-1502
21,05/26/2017,75,18:30,18:45,,,0,35.32,35.32,0,-16508,85933,102441,69425,0,-4,0,0,0,,4,-4
21,05/26/2017,76,18:45,19:00,,,0,35.32,35.32,0,-20420,91218,111638,70798,0,0,0,0,0,,0,0
21,05/26/2017,77,19:00,19:15,,,0,35.27,35.27,0,-59167,70472,129639,11305,0,0,0,0,0,,0,0
21,05/26/2017,78,19:15,19:30,31.97,,0,31.97,31.97,1,-75899,66929,142828,-8970,0,0,2763,0,0,,2763,2763
21,05/26/2017,79,19:30,19:45,30.12,,0,30.12,30.12,1,-48364,61128,109492,12764,0,0,5521,0,0,,5521,5521
21,05/26/2017,80,19:45,20:00,,,0,35.26,35.26,0,-47022,78596,125618,31574,0,0,690,0,0,,690,690
21,05/26/2017,81,20:00,20:15,181.22,,0,181.22,181.22,1,-112512,50478,162990,-62034,0,0,20737,0,0,,20737,20737
21,05/26/2017,82,20:15,20:30,40.12,41.75,0,41.75,41.75,-1,-72806,68703,141509,-4103,0,-33,27545,0,0,,27578,27512
21,05/26/2017,83,20:30,20:45,28.56,27.2,0,35.23,27.2,2,-73943,79713,153656,5770,0,-884,1898,0,0,,2782,1014
21,05/26/2017,84,20:45,21:00,28.22,41.75,0,41.75,41.75,-1,-66698,77595,144293,10897,0,-284,318,0,0,,602,34
21,05/26/2017,85,21:00,21:15,,41.14,0,41.14,41.14,-1,-92063,61162,153225,-30901,0,-217,0,0,0,,217,-217
21,05/26/2017,86,21:15,21:30,,40.62,0,40.62,40.62,-1,-75498,78035,153533,2537,0,-236,0,0,0,,236,-236
21,05/26/2017,87,21:30,21:45,,25.22,0,25.22,25.22,-1,-66674,96139,162813,29465,0,-8540,0,0,0,,8540,-8540
21,05/26/2017,88,21:45,22:00,,28.13,0,28.13,28.13,-1,-62917,105468,168385,42551,0,-3468,0,0,0,,3468,-3468
21,05/26/2017,89,22:00,22:15,,26.22,0,26.22,26.22,-1,-76226,66010,142236,-10216,0,-1050,0,0,0,,1050,-1050
21,05/26/2017,90,22:15,22:30,,27.74,0,27.74,27.74,-1,-71212,65403,136615,-5809,0,-172,0,0,0,,172,-172
21,05/26/2017,91,22:30,22:45,,27.26,0,27.26,27.26,-1,-64558,63319,127877,-1239,0,-783,0,0,0,,783,-783
21,05/26/2017,92,22:45,23:00,30.16,,0,30.16,30.16,1,-84965,62780,147745,-22185,0,0,2153,0,0,,2153,2153
21,05/26/2017,93,23:00,23:15,38.43,,0,38.43,38.43,1,-112787,43521,156308,-69266,0,0,5678,0,0,,5678,5678
21,05/26/2017,94,23:15,23:30,26.22,,0,26.22,26.22,1,-88428,59256,147684,-29172,0,0,1429,0,0,,1429,1429
21,05/26/2017,95,23:30,23:45,,,0,33.63,33.63,0,-61323,77995,139318,16672,0,0,0,0,0,,0,0
21,05/26/2017,96,23:45,0:00,,26.22,0,26.22,26.22,-1,-70037,64260,134297,-5777,0,-498,0,0,0,,498,-498
22,05/27/2017,1,0:00,0:15,,22.33,0,22.33,22.33,-1,-87362,45920,133282,-41442,0,-1806,0,0,0,,1806,-1806
22,05/27/2017,2,0:15,0:30,25.91,,0,25.91,25.91,1,-90479,47190,137669,-43289,0,0,12,0,0,,12,12
22,05/27/2017,3,0:30,0:45,25.91,,0,25.91,25.91,1,-104540,41502,146042,-63038,0,0,40,0,0,,40,40
22,05/27/2017,4,0:45,1:00,,,0,33.95,33.95,0,-83614,37958,121572,-45656,0,0,0,0,0,,0,0
22,05/27/2017,5,1:00,1:15,61.66,,0,61.66,61.66,1,-89238,48103,137341,-41135,0,0,9290,0,0,,9290,9290
22,05/27/2017,6,1:15,1:30,37.73,,0,37.73,37.73,1,-68886,36086,104972,-32800,0,0,23707,0,0,,23707,23707
22,05/27/2017,7,1:30,1:45,29.43,,0,29.43,29.43,1,-77725,33570,111295,-44155,0,0,5976,0,0,,5976,5976
22,05/27/2017,8,1:45,2:00,25.73,,0,25.73,25.73,1,-68780,44394,113174,-24386,0,0,1437,0,0,,1437,1437
22,05/27/2017,9,2:00,2:15,40.1,,0,40.1,40.1,1,-73195,43158,116353,-30037,0,0,6861,0,0,,6861,6861
22,05/27/2017,10,2:15,2:30,53.6,25.55,0,25.55,25.55,-1,-56107,47644,103751,-8463,0,-256,13896,0,0,,14152,13640
22,05/27/2017,11,2:30,2:45,25.73,24.84,0,33.84,24.84,2,-47448,36434,83882,-11014,0,-352,753,0,0,,1105,401
22,05/27/2017,12,2:45,3:00,25.73,25.73,0,33.84,25.73,2,-48316,44360,92676,-3956,0,-43,195,0,0,,238,152
22,05/27/2017,13,3:00,3:15,31.97,25.73,0,33.81,25.73,2,-43232,44078,87310,846,0,-859,2180,0,0,,3039,1321
22,05/27/2017,14,3:15,3:30,27.73,,0,27.73,27.73,1,-37871,43319,81190,5448,0,0,4826,0,0,,4826,4826
22,05/27/2017,15,3:30,3:45,,,0,33.82,33.82,0,-34436,42940,77376,8504,0,0,41,0,0,,41,41
22,05/27/2017,16,3:45,4:00,,,0,33.84,33.84,0,-33676,54762,88438,21086,0,0,0,0,0,,0,0
22,05/27/2017,17,4:00,4:15,,,0,33.8,33.8,0,-28012,71496,99508,43484,0,0,0,0,0,,0,0
22,05/27/2017,18,4:15,4:30,,,0,33.82,33.82,0,-23365,80439,103804,57074,0,0,0,0,0,,0,0
22,05/27/2017,19,4:30,4:45,,,0,33.83,33.83,0,-24829,94919,119748,70090,0,0,0,0,0,,0,0
22,05/27/2017,20,4:45,5:00,,,0,33.83,33.83,0,-19054,89439,108493,70385,0,0,0,0,0,,0,0
22,05/27/2017,21,5:00,5:15,,11.39,0,11.39,11.39,-1,-19040,79773,98813,60733,0,-9649,0,0,0,,9649,-9649
22,05/27/2017,22,5:15,5:30,,25.73,0,25.73,25.73,-1,-19128,73678,92806,54550,0,-6461,0,0,0,,6461,-6461
22,05/27/2017,23,5:30,5:45,,20.73,0,20.73,20.73,-1,-18579,80093,98672,61514,0,-11022,0,0,0,,11022,-11022
22,05/27/2017,24,5:45,6:00,,24.73,0,24.73,24.73,-1,-19803,86989,106792,67186,0,-13468,0,0,0,,13468,-13468
22,05/27/2017,25,6:00,6:15,,20.73,0,20.73,20.73,-1,-13981,87059,101040,73078,0,-17778,0,0,0,,17778,-17778
22,05/27/2017,26,6:15,6:30,,24.73,0,24.73,24.73,-1,-11274,81912,93186,70638,0,-18350,0,0,0,,18350,-18350
22,05/27/2017,27,6:30,6:45,,,0,33.79,33.79,0,-19076,63412,82488,44336,0,-5608,0,0,0,,5608,-5608
22,05/27/2017,28,6:45,7:00,27.73,,0,27.73,27.73,1,-47311,58891,106202,11580,0,0,1171,0,0,,1171,1171
22,05/27/2017,29,7:00,7:15,25.73,24.73,0,33.82,24.73,2,-57086,98385,155471,41299,0,-3010,187,0,0,,3197,-2823
22,05/27/2017,30,7:15,7:30,,25.14,0,25.14,25.14,-1,-41447,89337,130784,47890,0,-6652,0,0,0,,6652,-6652
22,05/27/2017,31,7:30,7:45,,,0,33.82,33.82,0,-37100,95613,132713,58513,0,-347,0,0,0,,347,-347
22,05/27/2017,32,7:45,8:00,,25.83,0,25.83,25.83,-1,-49083,105641,154724,56558,0,-50,0,0,0,,50,-50
22,05/27/2017,33,8:00,8:15,,-23.18,0,-23.18,-23.18,-1,-22147,112784,134931,90637,0,-21035,0,0,0,,21035,-21035
22,05/27/2017,34,8:15,8:30,,23.09,0,23.09,23.09,-1,-29897,93209,123106,63312,0,-18911,0,0,0,,18911,-18911
22,05/27/2017,35,8:30,8:45,,24.36,0,24.36,24.36,-1,-41495,76154,117649,34659,0,-21208,0,0,0,,21208,-21208
22,05/27/2017,36,8:45,9:00,,25.03,0,25.03,25.03,-1,-62189,67002,129191,4813,0,-9875,0,0,0,,9875,-9875
22,05/27/2017,37,9:00,9:15,,,0,33.85,33.85,0,-49704,79607,129311,29903,0,-67,0,0,0,,67,-67
22,05/27/2017,38,9:15,9:30,,,0,33.85,33.85,0,-37513,73274,110787,35761,0,0,0,0,0,,0,0
22,05/27/2017,39,9:30,9:45,,23.09,0,23.09,23.09,-1,-34555,66094,100649,31539,0,-3678,0,0,0,,3678,-3678
22,05/27/2017,40,9:45,10:00,,25.02,0,25.02,25.02,-1,-31189,60892,92081,29703,0,-6335,0,0,0,,6335,-6335
22,05/27/2017,41,10:00,10:15,,28.02,0,28.02,28.02,-1,-44675,61745,106420,17070,0,-1349,0,0,0,,1349,-1349
22,05/27/2017,42,10:15,10:30,,28.02,0,28.02,28.02,-1,-40619,52936,93555,12317,0,-123,0,0,0,,123,-123
22,05/27/2017,43,10:30,10:45,,25.73,0,25.73,25.73,-1,-38210,61763,99973,23553,0,-2644,0,0,0,,2644,-2644
22,05/27/2017,44,10:45,11:00,,24.73,0,24.73,24.73,-1,-38331,72668,110999,34337,0,-7593,0,0,0,,7593,-7593
22,05/27/2017,45,11:00,11:15,,11.39,0,11.39,11.39,-1,-66591,85825,152416,19234,0,-6904,0,0,0,,6904,-6904
22,05/27/2017,46,11:15,11:30,,-23.43,0,-23.43,-23.43,-1,-24284,87688,111972,63404,0,-34780,0,0,0,,34780,-34780
22,05/27/2017,47,11:30,11:45,,-23.43,0,-23.43,-23.43,-1,-18611,83047,101658,64436,0,-48070,0,0,0,,48070,-48070
22,05/27/2017,48,11:45,12:00,,-23.43,0,-23.43,-23.43,-1,-30073,66303,96376,36230,0,-54082,0,0,0,,54082,-54082
22,05/27/2017,49,12:00,12:15,25.73,25.09,0,25.73,25.73,1,-55936,55522,111458,-414,0,-9644,137,0,0,,9781,-9507
22,05/27/2017,50,12:15,12:30,27.73,,0,27.73,27.73,1,-80297,53325,133622,-26972,0,0,158,0,0,,158,158
22,05/27/2017,51,12:30,12:45,27.73,,0,27.73,27.73,1,-60033,55307,115340,-4726,0,0,1601,0,0,,1601,1601
22,05/27/2017,52,12:45,13:00,27.73,,0,27.73,27.73,1,-38053,56908,94961,18855,0,0,1216,0,0,,1216,1216
22,05/27/2017,53,13:00,13:15,,25.21,0,25.21,25.21,-1,-54816,69782,124598,14966,0,-1911,0,0,0,,1911,-1911
22,05/27/2017,54,13:15,13:30,,25.73,0,25.73,25.73,-1,-62501,58622,121123,-3879,0,-4329,0,0,0,,4329,-4329
22,05/27/2017,55,13:30,13:45,,25.73,0,25.73,25.73,-1,-58899,45692,104591,-13207,0,-2974,0,0,0,,2974,-2974
22,05/27/2017,56,13:45,14:00,,,0,34.84,34.84,0,-57562,19448,77010,-38114,0,-85,0,0,0,,85,-85
22,05/27/2017,57,14:00,14:15,30.53,,0,30.53,30.53,1,-50465,25940,76405,-24525,0,0,2541,0,0,,2541,2541
22,05/27/2017,58,14:15,14:30,30.31,,0,30.31,30.31,1,-64095,21410,85505,-42685,0,0,11111,0,0,,11111,11111
22,05/27/2017,59,14:30,14:45,30.26,,0,30.26,30.26,1,-77374,29759,107133,-47615,0,0,10150,0,0,,10150,10150
22,05/27/2017,60,14:45,15:00,27.73,,0,27.73,27.73,1,-81436,26699,108135,-54737,0,0,2112,0,0,,2112,2112
22,05/27/2017,61,15:00,15:15,62.94,,0,62.94,62.94,1,-85608,36272,121880,-49336,0,0,23909,0,0,,23909,23909
22,05/27/2017,62,15:15,15:30,37.73,,0,37.73,37.73,1,-81845,26882,108727,-54963,0,0,35544,0,0,,35544,35544
22,05/27/2017,63,15:30,15:45,49.56,,0,49.56,49.56,1,-86549,25716,112265,-60833,0,0,14261,0,0,,14261,14261
22,05/27/2017,64,15:45,16:00,86.5,,0,86.5,86.5,1,-97791,33854,131645,-63937,0,0,33000,0,0,,33000,33000
22,05/27/2017,65,16:00,16:15,28.38,29.08,0,29.08,29.08,-1,-62992,62459,125451,-533,0,-211,8679,0,0,,8890,8468
22,05/27/2017,66,16:15,16:30,28.38,28.63,0,28.63,28.63,-1,-67267,64105,131372,-3162,0,-1498,7,0,0,,1505,-1491
22,05/27/2017,67,16:30,16:45,30.53,42.87,0,34.3,34.3,2,-83109,71578,154687,-11531,0,-16,1162,0,0,,1178,1146
22,05/27/2017,68,16:45,17:00,31.73,,0,31.73,31.73,1,-101812,83628,185440,-18184,0,0,8036,0,0,,8036,8036
22,05/27/2017,69,17:00,17:15,27.73,23.09,0,23.09,23.09,-1,-75365,113831,189196,38466,0,-1205,4699,0,0,,5904,3494
22,05/27/2017,70,17:15,17:30,27.73,20.73,0,20.73,20.73,-1,-37329,130257,167586,92928,0,-15069,17,0,0,,15086,-15052
22,05/27/2017,71,17:30,17:45,,28.6,0,28.6,28.6,-1,-41975,139434,181409,97459,0,-2930,0,0,0,,2930,-2930
22,05/27/2017,72,17:45,18:00,,25.73,0,25.73,25.73,-1,-48220,145325,193545,97105,0,-2549,0,0,0,,2549,-2549
22,05/27/2017,73,18:00,18:15,,29.27,0,29.27,29.27,-1,-83421,118962,202383,35541,0,-1404,0,0,0,,1404,-1404
22,05/27/2017,74,18:15,18:30,,25.73,0,25.73,25.73,-1,-56827,75237,132064,18410,0,-2932,0,0,0,,2932,-2932
22,05/27/2017,75,18:30,18:45,,,0,34.27,34.27,0,-52031,63359,115390,11328,0,-199,0,0,0,,199,-199
22,05/27/2017,76,18:45,19:00,,,0,34.27,34.27,0,-45063,71536,116599,26473,0,0,0,0,0,,0,0
22,05/27/2017,77,19:00,19:15,27.73,,0,27.73,27.73,1,-117498,54478,171976,-63020,0,0,1522,0,0,,1522,1522
22,05/27/2017,78,19:15,19:30,43.13,,0,43.13,43.13,1,-105587,45521,151108,-60066,0,0,4785,0,0,,4785,4785
22,05/27/2017,79,19:30,19:45,55.34,,0,55.34,55.34,1,-93989,40050,134039,-53939,0,0,27668,0,0,,27668,27668
22,05/27/2017,80,19:45,20:00,31.21,,0,31.21,31.21,1,-88305,48016,136321,-40289,0,0,14835,0,0,,14835,14835
22,05/27/2017,81,20:00,20:15,41.97,,0,41.97,41.97,1,-100467,73125,173592,-27342,0,0,11121,0,0,,11121,11121
22,05/27/2017,82,20:15,20:30,41.97,43.86,0,43.86,43.86,-1,-89900,109798,199698,19898,0,-77,1604,0,0,,1681,1527
22,05/27/2017,83,20:30,20:45,,43.86,0,43.86,43.86,-1,-89827,96055,185882,6228,0,-271,0,0,0,,271,-271
22,05/27/2017,84,20:45,21:00,25.97,,0,25.97,25.97,1,-101929,84439,186368,-17490,0,0,885,0,0,,885,885
22,05/27/2017,85,21:00,21:15,128.02,,0,128.02,128.02,1,-191982,66998,258980,-124984,0,0,26601,0,0,,26601,26601
22,05/27/2017,86,21:15,21:30,128.02,,0,128.02,128.02,1,-172104,60803,232907,-111301,0,0,67612,0,0,,67612,67612
22,05/27/2017,87,21:30,21:45,,,0,34.69,34.69,0,-139403,75594,214997,-63809,0,0,5367,0,0,,5367,5367
22,05/27/2017,88,21:45,22:00,128.02,,0,128.02,128.02,1,-208734,69168,277902,-139566,0,0,12136,0,0,,12136,12136
22,05/27/2017,89,22:00,22:15,180.73,,0,180.73,180.73,1,-236797,48768,285565,-188029,0,0,74188,0,0,,74188,74188
22,05/27/2017,90,22:15,22:30,197.36,,0,197.36,197.36,1,-234822,62498,297320,-172324,0,0,85827,0,0,,85827,85827
22,05/27/2017,91,22:30,22:45,216.58,,0,216.58,216.58,1,-222814,144319,367133,-78495,0,0,66529,11250,0,,77779,77779
22,05/27/2017,92,22:45,23:00,29.95,41.64,0,35.62,35.62,2,-194116,165304,359420,-28812,0,-165,5423,0,0,,5588,5258
22,05/27/2017,93,23:00,23:15,139.83,,0,139.83,139.83,1,-210414,84825,295239,-125589,0,0,32735,0,0,,32735,32735
22,05/27/2017,94,23:15,23:30,139.83,,0,139.83,139.83,1,-210664,93948,304612,-116716,0,0,84683,0,0,,84683,84683
22,05/27/2017,95,23:30,23:45,228,,0,228,228,1,-214273,121699,335972,-92574,0,0,81945,16250,0,,98195,98195
22,05/27/2017,96,23:45,0:00,30.07,26.86,0,35.59,26.86,2,-180828,143322,324150,-37506,0,-248,17854,0,0,,18102,17606
22,05/28/2017,1,0:00,0:15,29.45,25.94,0,29.45,29.45,1,-43262,94014,137276,50752,0,-39,340,0,0,,379,301
22,05/28/2017,2,0:15,0:30,30.86,39.97,0,34.46,34.46,2,-43241,41439,84680,-1802,0,-45,2870,0,0,,2915,2825
22,05/28/2017,3,0:30,0:45,30.86,24.94,0,24.94,24.94,-1,-43956,43481,87437,-475,0,-3958,33,0,0,,3991,-3925
22,05/28/2017,4,0:45,1:00,,25.94,0,25.94,25.94,-1,-63812,58823,122635,-4989,0,-5762,0,0,0,,5762,-5762
22,05/28/2017,5,1:00,1:15,63.12,22.9,0,63.12,22.9,2,-54499,41497,95996,-13002,0,-7685,3911,0,0,,11596,-3774
22,05/28/2017,6,1:15,1:30,127.12,22.9,0,127.12,127.12,1,-80669,49955,130624,-30714,0,-290,27370,0,0,,27660,27080
22,05/28/2017,7,1:30,1:45,33.78,,0,33.78,33.78,1,-86503,51643,138146,-34860,0,0,7591,0,0,,7591,7591
22,05/28/2017,8,1:45,2:00,30.23,,0,30.23,30.23,1,-87275,58588,145863,-28687,0,0,12088,0,0,,12088,12088
22,05/28/2017,9,2:00,2:15,80.12,,0,80.12,80.12,1,-91801,51883,143684,-39918,0,0,13177,0,0,,13177,13177
22,05/28/2017,10,2:15,2:30,125.15,,0,125.15,125.15,1,-102554,43104,145658,-59450,0,0,48001,0,0,,48001,48001
22,05/28/2017,11,2:30,2:45,31.94,,0,31.94,31.94,1,-93489,52044,145533,-41445,0,0,25328,0,0,,25328,25328
22,05/28/2017,12,2:45,3:00,37.94,,0,37.94,37.94,1,-95023,42621,137644,-52402,0,0,20044,0,0,,20044,20044
22,05/28/2017,13,3:00,3:15,31.94,40.47,0,33.41,33.41,2,-96375,89178,185553,-7197,0,-121,8154,0,0,,8275,8033
22,05/28/2017,14,3:15,3:30,37.94,,0,37.94,37.94,1,-96074,74378,170452,-21696,0,0,12538,0,0,,12538,12538
22,05/28/2017,15,3:30,3:45,39.12,,0,39.12,39.12,1,-93205,52507,145712,-40698,0,0,15790,0,0,,15790,15790
22,05/28/2017,16,3:45,4:00,31.32,,0,31.32,31.32,1,-85678,55571,141249,-30107,0,0,22374,0,0,,22374,22374
22,05/28/2017,17,4:00,4:15,29.91,,0,29.91,29.91,1,-85388,86610,171998,1222,0,0,11048,0,0,,11048,11048
22,05/28/2017,18,4:15,4:30,29.26,,0,29.26,29.26,1,-81404,61700,143104,-19704,0,0,4357,0,0,,4357,4357
22,05/28/2017,19,4:30,4:45,27.94,,0,27.94,27.94,1,-80348,58196,138544,-22152,0,0,7790,0,0,,7790,7790
22,05/28/2017,20,4:45,5:00,27.12,,0,27.12,27.12,1,-76471,62576,139047,-13895,0,0,3552,0,0,,3552,3552
22,05/28/2017,21,5:00,5:15,37.94,,0,37.94,37.94,1,-96717,59260,155977,-37457,0,0,12996,0,0,,12996,12996
22,05/28/2017,22,5:15,5:30,28.87,,0,28.87,28.87,1,-74068,45672,119740,-28396,0,0,8864,0,0,,8864,8864
22,05/28/2017,23,5:30,5:45,27.12,,0,27.12,27.12,1,-54578,38584,93162,-15994,0,0,2205,0,0,,2205,2205
22,05/28/2017,24,5:45,6:00,33.78,30.67,0,33.78,30.67,2,-63158,36749,99907,-26409,0,-1064,1073,0,0,,2137,9
22,05/28/2017,25,6:00,6:15,34.37,,0,34.37,34.37,1,-75486,55505,130991,-19981,0,0,1760,0,0,,1760,1760
22,05/28/2017,26,6:15,6:30,,,0,33.41,33.41,0,-69890,42694,112584,-27196,0,0,0,0,0,,0,0
22,05/28/2017,27,6:30,6:45,,30.38,0,30.38,30.38,-1,-56885,50714,107599,-6171,0,-601,0,0,0,,601,-601
22,05/28/2017,28,6:45,7:00,,25.94,0,25.94,25.94,-1,-60530,53173,113703,-7357,0,-1917,0,0,0,,1917,-1917
22,05/28/2017,29,7:00,7:15,,25.94,0,25.94,25.94,-1,-58068,79298,137366,21230,0,-3670,0,0,0,,3670,-3670
22,05/28/2017,30,7:15,7:30,,24.94,0,24.94,24.94,-1,-45674,79048,124722,33374,0,-10101,0,0,0,,10101,-10101
22,05/28/2017,31,7:30,7:45,,30.96,0,30.96,30.96,-1,-43076,83661,126737,40585,0,-5489,0,0,0,,5489,-5489
22,05/28/2017,32,7:45,8:00,,,0,33.36,33.36,0,-36710,85975,122685,49265,0,-4,0,0,0,,4,-4
22,05/28/2017,33,8:00,8:15,,,0,33.42,33.42,0,-45178,124298,169476,79120,0,0,0,0,0,,0,0
22,05/28/2017,34,8:15,8:30,,20.14,0,20.14,20.14,-1,-17322,118049,135371,100727,0,-6760,0,0,0,,6760,-6760
22,05/28/2017,35,8:30,8:45,,24.94,0,24.94,24.94,-1,-23621,116400,140021,92779,0,-18196,0,0,0,,18196,-18196
22,05/28/2017,36,8:45,9:00,,28.61,0,28.61,28.61,-1,-28761,121726,150487,92965,0,-6208,0,0,0,,6208,-6208
22,05/28/2017,37,9:00,9:15,,15.94,0,15.94,15.94,-1,-14253,89502,103755,75249,0,-5814,0,0,0,,5814,-5814
22,05/28/2017,38,9:15,9:30,,8.99,0,8.99,8.99,-1,-13742,77497,91239,63755,0,-16052,0,0,0,,16052,-16052
22,05/28/2017,39,9:30,9:45,,-25.91,0,-25.91,-25.91,-1,-23424,71021,94445,47597,0,-7752,0,0,0,,7752,-7752
22,05/28/2017,40,9:45,10:00,,-25.91,0,-25.91,-25.91,-1,-39247,55551,94798,16304,0,-14452,0,0,0,,14452,-14452
22,05/28/2017,41,10:00,10:15,,24.89,0,24.89,24.89,-1,-41332,67539,108871,26207,0,-9497,0,0,0,,9497,-9497
22,05/28/2017,42,10:15,10:30,,20.94,0,20.94,20.94,-1,-35548,55414,90962,19866,0,-10942,0,0,0,,10942,-10942
22,05/28/2017,43,10:30,10:45,,20.94,0,20.94,20.94,-1,-33182,64589,97771,31407,0,-19927,0,0,0,,19927,-19927
22,05/28/2017,44,10:45,11:00,,24.94,0,24.94,24.94,-1,-26301,67681,93982,41380,0,-18416,0,0,0,,18416,-18416
22,05/28/2017,45,11:00,11:15,,15.94,0,15.94,15.94,-1,-41998,78050,120048,36052,0,-11055,0,0,0,,11055,-11055
22,05/28/2017,46,11:15,11:30,,8.99,0,8.99,8.99,-1,-32886,104540,137426,71654,0,-23161,0,0,0,,23161,-23161
22,05/28/2017,47,11:30,11:45,,15.94,0,15.94,15.94,-1,-32016,83130,115146,51114,0,-20602,0,0,0,,20602,-20602
22,05/28/2017,48,11:45,12:00,,15.94,0,15.94,15.94,-1,-27814,77536,105350,49722,0,-24532,0,0,0,,24532,-24532
22,05/28/2017,49,12:00,12:15,,20.94,0,20.94,20.94,-1,-35161,82660,117821,47499,0,-19926,0,0,0,,19926,-19926
22,05/28/2017,50,12:15,12:30,,2.55,0,2.55,2.55,-1,-40206,79413,119619,39207,0,-33284,0,0,0,,33284,-33284
22,05/28/2017,51,12:30,12:45,,25.78,0,25.78,25.78,-1,-42271,70302,112573,28031,0,-16443,0,0,0,,16443,-16443
22,05/28/2017,52,12:45,13:00,,26.75,0,26.75,26.75,-1,-46144,61594,107738,15450,0,-9783,0,0,0,,9783,-9783
22,05/28/2017,53,13:00,13:15,48.51,41.76,0,48.51,48.51,1,-69860,44143,114003,-25717,0,-3990,7772,0,0,,11762,3782
22,05/28/2017,54,13:15,13:30,32.18,,0,32.18,32.18,1,-67070,31651,98721,-35419,0,0,22722,0,0,,22722,22722
22,05/28/2017,55,13:30,13:45,31.32,,0,31.32,31.32,1,-67304,40802,108106,-26502,0,0,22286,0,0,,22286,22286
22,05/28/2017,56,13:45,14:00,31.94,,0,31.94,31.94,1,-56460,33643,90103,-22817,0,0,20457,0,0,,20457,20457
22,05/28/2017,57,14:00,14:15,31.94,24.94,0,24.94,24.94,-1,-38083,63993,102076,25910,0,-1679,4696,0,0,,6375,3017
22,05/28/2017,58,14:15,14:30,31.94,,0,31.94,31.94,1,-55935,42903,98838,-13032,0,0,2131,0,0,,2131,2131
22,05/28/2017,59,14:30,14:45,32.55,,0,32.55,32.55,1,-63138,44434,107572,-18704,0,0,13130,0,0,,13130,13130
22,05/28/2017,60,14:45,15:00,40.64,,0,40.64,40.64,1,-88258,44176,132434,-44082,0,0,20361,0,0,,20361,20361
22,05/28/2017,61,15:00,15:15,31.94,41.87,0,41.87,41.87,-1,-50528,47069,97597,-3459,0,-19,19975,0,0,,19994,19956
22,05/28/2017,62,15:15,15:30,29.9,28.19,0,34.1,28.19,2,-54792,46927,101719,-7865,0,-532,2304,0,0,,2836,1772
22,05/28/2017,63,15:30,15:45,37.94,,0,37.94,37.94,1,-72766,42746,115512,-30020,0,0,17180,0,0,,17180,17180
22,05/28/2017,64,15:45,16:00,37.94,,0,37.94,37.94,1,-80150,37660,117810,-42490,0,0,26255,0,0,,26255,26255
22,05/28/2017,65,16:00,16:15,29.25,41.89,0,41.89,41.89,-1,-61146,58943,120089,-2203,0,-86,12589,0,0,,12675,12503
22,05/28/2017,66,16:15,16:30,31.84,42.27,0,31.84,31.84,1,-88004,66641,154645,-21363,0,-15,4090,0,0,,4105,4075
22,05/28/2017,67,16:30,16:45,38.9,,0,38.9,38.9,1,-116539,72762,189301,-43777,0,0,15982,0,0,,15982,15982
22,05/28/2017,68,16:45,17:00,48.78,,0,48.78,48.78,1,-135292,76387,211679,-58905,0,0,42190,0,0,,42190,42190
22,05/28/2017,69,17:00,17:15,33.78,28.23,0,28.23,28.23,-1,-101155,86364,187519,-14791,0,-42,30693,0,0,,30735,30651
22,05/28/2017,70,17:15,17:30,33.78,15.94,0,15.94,15.94,-1,-83352,105776,189128,22424,0,-5461,1689,0,0,,7150,-3772
22,05/28/2017,71,17:30,17:45,27.94,42.23,0,27.94,27.94,1,-93151,90132,183283,-3019,0,-903,316,0,0,,1219,-587
22,05/28/2017,72,17:45,18:00,30.76,,0,30.76,30.76,1,-105975,87284,193259,-18691,0,0,9343,0,0,,9343,9343
22,05/28/2017,73,18:00,18:15,47.49,,0,47.49,47.49,1,-123113,68660,191773,-54453,0,0,22722,0,0,,22722,22722
22,05/28/2017,74,18:15,18:30,29.29,28.19,0,34.67,28.19,2,-81630,73374,155004,-8256,0,-244,4542,0,0,,4786,4298
22,05/28/2017,75,18:30,18:45,29.78,,0,29.78,29.78,1,-70197,73784,143981,3587,0,0,1732,0,0,,1732,1732
22,05/28/2017,76,18:45,19:00,27.94,,0,27.94,27.94,1,-72955,85623,158578,12668,0,0,1380,0,0,,1380,1380
22,05/28/2017,77,19:00,19:15,55.99,,0,55.99,55.99,1,-139978,90661,230639,-49317,0,0,19690,0,0,,19690,19690
22,05/28/2017,78,19:15,19:30,31.95,,0,31.95,31.95,1,-100219,76228,176447,-23991,0,0,20200,0,0,,20200,20200
22,05/28/2017,79,19:30,19:45,29.49,,0,29.49,29.49,1,-87305,70919,158224,-16386,0,0,9106,0,0,,9106,9106
22,05/28/2017,80,19:45,20:00,72.12,,0,72.12,72.12,1,-95803,50809,146612,-44994,0,0,17882,0,0,,17882,17882
22,05/28/2017,81,20:00,20:15,136.01,,0,136.01,136.01,1,-113590,57126,170716,-56464,0,0,54363,0,0,,54363,54363
22,05/28/2017,82,20:15,20:30,30.09,29.04,0,35.07,29.04,2,-68096,78573,146669,10477,0,-296,11563,0,0,,11859,11267
22,05/28/2017,83,20:30,20:45,,,0,35.08,35.08,0,-71275,81793,153068,10518,0,0,0,0,0,,0,0
22,05/28/2017,84,20:45,21:00,,,0,35.08,35.08,0,-65583,76558,142141,10975,0,0,0,0,0,,0,0
22,05/28/2017,85,21:00,21:15,28.65,,0,28.65,28.65,1,-84826,75207,160033,-9619,0,0,2675,0,0,,2675,2675
22,05/28/2017,86,21:15,21:30,28.65,,0,28.65,28.65,1,-90327,57338,147665,-32989,0,0,4265,0,0,,4265,4265
22,05/28/2017,87,21:30,21:45,28.65,,0,28.65,28.65,1,-103308,54330,157638,-48978,0,0,1389,0,0,,1389,1389
22,05/28/2017,88,21:45,22:00,28.65,,0,28.65,28.65,1,-105475,57755,163230,-47720,0,0,3561,0,0,,3561,3561
22,05/28/2017,89,22:00,22:15,141.32,,0,141.32,141.32,1,-148270,62603,210873,-85667,0,0,25225,0,0,,25225,25225
22,05/28/2017,90,22:15,22:30,43.14,,0,43.14,43.14,1,-134834,65425,200259,-69409,0,0,38629,0,0,,38629,38629
22,05/28/2017,91,22:30,22:45,32.12,,0,32.12,32.12,1,-105818,71014,176832,-34804,0,0,22317,0,0,,22317,22317
22,05/28/2017,92,22:45,23:00,29.54,,0,29.54,29.54,1,-96192,80068,176260,-16124,0,0,15320,0,0,,15320,15320
22,05/28/2017,93,23:00,23:15,44.75,,0,44.75,44.75,1,-112385,63274,175659,-49111,0,0,17930,0,0,,17930,17930
22,05/28/2017,94,23:15,23:30,28.58,28.19,0,28.19,28.19,-1,-59644,58507,118151,-1137,0,-388,10075,0,0,,10463,9687
22,05/28/2017,95,23:30,23:45,28.58,26.59,0,26.59,26.59,-1,-31946,39688,71634,7742,0,-414,17,0,0,,431,-397
22,05/28/2017,96,23:45,0:00,,24.94,0,24.94,24.94,-1,-34286,65304,99590,31018,0,-3026,0,0,0,,3026,-3026
22,05/29/2017,1,0:00,0:15,25.64,25.64,0,25.64,25.64,1,-60229,67979,128208,7750,0,-2584,65,0,0,,2649,-2519
22,05/29/2017,2,0:15,0:30,25.64,24.79,0,28.72,24.79,2,-44765,50240,95005,5475,0,-2530,202,0,0,,2732,-2328
22,05/29/2017,3,0:30,0:45,,27.24,0,27.24,27.24,-1,-29818,31567,61385,1749,0,-6509,0,0,0,,6509,-6509
22,05/29/2017,4,0:45,1:00,,20.64,0,20.64,20.64,-1,-26056,51319,77375,25263,0,-16316,0,0,0,,16316,-16316
22,05/29/2017,5,1:00,1:15,25.64,24.64,0,25.64,25.64,1,-54316,50144,104460,-4172,0,-18374,43,0,0,,18417,-18331
22,05/29/2017,6,1:15,1:30,25.64,20.64,0,33.5,20.64,2,-40665,55029,95694,14364,0,-6806,77,0,0,,6883,-6729
22,05/29/2017,7,1:30,1:45,,20.64,0,20.64,20.64,-1,-40556,55018,95574,14462,0,-18118,0,0,0,,18118,-18118
22,05/29/2017,8,1:45,2:00,,24.79,0,24.79,24.79,-1,-39555,54322,93877,14767,0,-19576,0,0,0,,19576,-19576
22,05/29/2017,9,2:00,2:15,27.64,25.64,0,27.64,27.64,1,-52832,46737,99569,-6095,0,-10226,481,0,0,,10707,-9745
22,05/29/2017,10,2:15,2:30,25.64,25.64,0,28.72,25.64,2,-43666,50981,94647,7315,0,-2018,161,0,0,,2179,-1857
22,05/29/2017,11,2:30,2:45,,24.64,0,24.64,24.64,-1,-38747,43620,82367,4873,0,-4785,0,0,0,,4785,-4785
22,05/29/2017,12,2:45,3:00,,24.79,0,24.79,24.79,-1,-45070,49835,94905,4765,0,-12853,0,0,0,,12853,-12853
22,05/29/2017,13,3:00,3:15,28.1,26.61,0,28.1,28.1,1,-46366,56250,102616,9884,0,-3993,319,0,0,,4312,-3674
22,05/29/2017,14,3:15,3:30,28.64,26.61,0,28.64,28.64,1,-43855,48890,92745,5035,0,-38,1887,0,0,,1925,1849
22,05/29/2017,15,3:30,3:45,,,0,28.72,28.72,0,-43171,66358,109529,23187,0,0,0,0,0,,0,0
22,05/29/2017,16,3:45,4:00,,24.79,0,24.79,24.79,-1,-35438,73167,108605,37729,0,-1468,0,0,0,,1468,-1468
22,05/29/2017,17,4:00,4:15,,27.39,0,27.39,27.39,-1,-40134,41064,81198,930,0,-1006,0,0,0,,1006,-1006
22,05/29/2017,18,4:15,4:30,,,0,28.72,28.72,0,-30675,42705,73380,12030,0,0,0,0,0,,0,0
22,05/29/2017,19,4:30,4:45,,,0,28.72,28.72,0,-31721,42360,74081,10639,0,0,0,0,0,,0,0
22,05/29/2017,20,4:45,5:00,,,0,28.72,28.72,0,-28763,74319,103082,45556,0,0,0,0,0,,0,0
22,05/29/2017,21,5:00,5:15,28.55,,0,28.55,28.55,1,-187145,37024,224169,-150121,0,0,3127,0,0,,3127,3127
22,05/29/2017,22,5:15,5:30,35.66,,0,35.66,35.66,1,-168510,58286,226796,-110224,0,0,12246,0,0,,12246,12246
22,05/29/2017,23,5:30,5:45,33.57,,0,33.57,33.57,1,-163725,66070,229795,-97655,0,0,10855,0,0,,10855,10855
22,05/29/2017,24,5:45,6:00,27.64,,0,27.64,27.64,1,-170409,132593,303002,-37816,0,0,2900,0,0,,2900,2900
22,05/29/2017,25,6:00,6:15,28.59,14.59,0,34.71,14.59,2,-45580,96010,141590,50430,0,-6291,1404,0,0,,7695,-4887
22,05/29/2017,26,6:15,6:30,,24.64,0,24.64,24.64,-1,-24392,79440,103832,55048,0,-9492,0,0,0,,9492,-9492
22,05/29/2017,27,6:30,6:45,28.59,24.64,0,28.59,28.59,1,-50552,57395,107947,6843,0,-347,421,0,0,,768,74
22,05/29/2017,28,6:45,7:00,28.59,,0,28.59,28.59,1,-72523,71789,144312,-734,0,0,3018,0,0,,3018,3018
22,05/29/2017,29,7:00,7:15,28.59,20.64,0,20.64,20.64,-1,-33466,136881,170347,103415,0,-4682,457,0,0,,5139,-4225
22,05/29/2017,30,7:15,7:30,,18.79,0,18.79,18.79,-1,-21106,172485,193591,151379,0,-15088,0,0,0,,15088,-15088
22,05/29/2017,31,7:30,7:45,,24.64,0,24.64,24.64,-1,-35268,130707,165975,95439,0,-14735,0,0,0,,14735,-14735
22,05/29/2017,32,7:45,8:00,,,0,36.87,36.87,0,-54554,127991,182545,73437,0,-434,0,0,0,,434,-434
22,05/29/2017,33,8:00,8:15,,-48.06,0,-48.06,-48.06,-1,-12317,183462,195779,171145,0,-15042,0,0,0,,15042,-15042
22,05/29/2017,34,8:15,8:30,,-51.18,0,-51.18,-51.18,-1,-37699,179301,217000,141602,0,-44600,0,0,0,,44600,-44600
22,05/29/2017,35,8:30,8:45,,15.64,0,15.64,15.64,-1,-53342,186144,239486,132802,0,-36936,0,0,0,,36936,-36936
22,05/29/2017,36,8:45,9:00,,45.72,0,45.72,45.72,-1,-68717,150125,218842,81408,0,-7708,0,0,0,,7708,-7708
22,05/29/2017,37,9:00,9:15,,-22.61,0,-22.61,-22.61,-1,-26044,164132,190176,138088,0,-6027,0,0,0,,6027,-6027
22,05/29/2017,38,9:15,9:30,,-49.99,0,-49.99,-49.99,-1,-46837,119413,166250,72576,0,-22207,0,0,0,,22207,-22207
22,05/29/2017,39,9:30,9:45,,6.41,0,6.41,6.41,-1,-23703,122822,146525,99119,0,-5948,0,0,0,,5948,-5948
22,05/29/2017,40,9:45,10:00,,-1.73,0,-1.73,-1.73,-1,-31670,85389,117059,53719,0,-18077,0,0,0,,18077,-18077
22,05/29/2017,41,10:00,10:15,28.58,26.24,0,37,26.24,2,-64708,64555,129263,-153,0,-4647,143,0,0,,4790,-4504
22,05/29/2017,42,10:15,10:30,32,26.24,0,32,32,1,-54450,56342,110792,1892,0,-53,1546,0,0,,1599,1493
22,05/29/2017,43,10:30,10:45,48,,0,48,48,1,-69118,32172,101290,-36946,0,0,22762,0,0,,22762,22762
22,05/29/2017,44,10:45,11:00,37,,0,37,37,1,-66888,33478,100366,-33410,0,0,28235,0,0,,28235,28235
22,05/29/2017,45,11:00,11:15,49.3,,0,49.3,49.3,1,-87628,30816,118444,-56812,0,0,32397,0,0,,32397,32397
22,05/29/2017,46,11:15,11:30,50.67,,0,50.67,50.67,1,-93513,36206,129719,-57307,0,0,36867,0,0,,36867,36867
22,05/29/2017,47,11:30,11:45,50.67,,0,50.67,50.67,1,-88758,43059,131817,-45699,0,0,36661,0,0,,36661,36661
22,05/29/2017,48,11:45,12:00,73.02,,0,73.02,73.02,1,-94547,42181,136728,-52366,0,0,47900,0,0,,47900,47900
22,05/29/2017,49,12:00,12:15,50.04,,0,50.04,50.04,1,-104744,61339,166083,-43405,0,0,31242,0,0,,31242,31242
22,05/29/2017,50,12:15,12:30,40.09,,0,40.09,40.09,1,-88622,54301,142923,-34321,0,0,35511,0,0,,35511,35511
22,05/29/2017,51,12:30,12:45,39.04,,0,39.04,39.04,1,-79895,58509,138404,-21386,0,0,30491,0,0,,30491,30491
22,05/29/2017,52,12:45,13:00,44.99,,0,44.99,44.99,1,-84794,48110,132904,-36684,0,0,22835,0,0,,22835,22835
22,05/29/2017,53,13:00,13:15,146.61,,0,146.61,146.61,1,-116520,60706,177226,-55814,0,0,36685,0,0,,36685,36685
22,05/29/2017,54,13:15,13:30,146.61,,0,146.61,146.61,1,-148422,52599,201021,-95823,0,0,76072,0,0,,76072,76072
22,05/29/2017,55,13:30,13:45,146.61,,0,242.65,242.65,1,-237219,52370,289589,-184849,0,0,84950,0,5000,,89950,89950
22,05/29/2017,56,13:45,14:00,270.13,,0,297.14,297.14,1,-219643,112260,331903,-107383,0,0,86023,2500,15000,,103523,103523
22,05/29/2017,57,14:00,14:15,192.4,,0,242.4,242.4,1,-196227,153603,349830,-42624,0,0,46341,2500,14706,,63547,63547
22,05/29/2017,58,14:15,14:30,129.16,,0,129.16,129.16,1,-190954,142359,333313,-48595,0,0,31997,0,650,,32647,32647
22,05/29/2017,59,14:30,14:45,129.16,,0,129.16,129.16,1,-189982,146083,336065,-43899,0,0,54354,0,0,,54354,54354
22,05/29/2017,60,14:45,15:00,44.99,,0,44.99,44.99,1,-185310,144983,330293,-40327,0,0,30589,0,0,,30589,30589
22,05/29/2017,61,15:00,15:15,44.99,,0,44.99,44.99,1,-176614,139287,315901,-37327,0,0,34352,0,0,,34352,34352
22,05/29/2017,62,15:15,15:30,81.02,,0,81.02,81.02,1,-176035,121240,297275,-54795,0,0,42119,0,0,,42119,42119
22,05/29/2017,63,15:30,15:45,53.07,,0,53.07,53.07,1,-173240,114776,288016,-58464,0,0,55007,0,0,,55007,55007
22,05/29/2017,64,15:45,16:00,67.77,,0,67.77,67.77,1,-174560,110612,285172,-63948,0,0,57805,0,0,,57805,57805
22,05/29/2017,65,16:00,16:15,67.77,24.84,0,24.84,24.84,-1,-115720,160615,276335,44895,0,-516,23010,0,0,,23526,22494
22,05/29/2017,66,16:15,16:30,,,0,29.95,29.95,0,-127442,141148,268590,13706,0,-24,0,0,0,,24,-24
22,05/29/2017,67,16:30,16:45,34.59,,0,34.59,34.59,1,-114198,112742,226940,-1456,0,0,2885,0,0,,2885,2885
22,05/29/2017,68,16:45,17:00,135.26,,0,238.38,238.38,1,-195339,89218,284557,-106121,0,0,25807,0,0,,25807,25807
22,05/29/2017,69,17:00,17:15,145.36,,0,242.18,242.18,1,-321046,125036,446082,-196010,0,0,75700,0,20109,,95809,95809
22,05/29/2017,70,17:15,17:30,185.61,,0,242.18,242.18,1,-311875,181959,493834,-129916,0,0,83540,1250,49998,,134788,134788
22,05/29/2017,71,17:30,17:45,142.18,,0,242.18,242.18,1,-307432,215790,523222,-91642,0,0,48228,1250,55017,,104495,104495
22,05/29/2017,72,17:45,18:00,142.18,,0,242.18,242.18,1,-301084,203029,504113,-98055,0,0,30527,1250,71408,,103185,103185
22,05/29/2017,73,18:00,18:15,277.13,,0,304.84,304.84,1,-338918,179890,518808,-159028,0,0,59750,0,59782,,119532,119532
22,05/29/2017,74,18:15,18:30,73.02,,0,244.08,244.08,1,-324193,198085,522278,-126108,0,0,66003,0,58749,,124752,124752
22,05/29/2017,75,18:30,18:45,194.08,,0,244.08,244.08,1,-313709,203173,516882,-110536,0,0,50298,2500,55378,,108176,108176
22,05/29/2017,76,18:45,19:00,144.08,,0,244.08,244.08,1,-311488,212367,523855,-99121,0,0,39301,0,41250,,80551,80551
22,05/29/2017,77,19:00,19:15,35.69,26.24,0,246.15,26.24,2,-196408,180399,376807,-16009,0,-320,15429,0,41250,,56999,56359
22,05/29/2017,78,19:15,19:30,176.19,26.24,0,176.19,176.19,1,-216881,149787,366668,-67094,0,-1,17560,0,16452,,34013,34011
22,05/29/2017,79,19:30,19:45,52.15,,0,52.15,52.15,1,-206690,148222,354912,-58468,0,0,43388,0,0,,43388,43388
22,05/29/2017,80,19:45,20:00,49.58,,0,49.58,49.58,1,-182523,146125,328648,-36398,0,0,37088,0,0,,37088,37088
22,05/29/2017,81,20:00,20:15,33.76,27.24,0,27.24,27.24,-1,-142300,146241,288541,3941,0,-170,16611,0,0,,16781,16441
22,05/29/2017,82,20:15,20:30,29.54,27.03,0,37.65,27.03,2,-148996,129326,278322,-19670,0,-517,1956,0,0,,2473,1439
22,05/29/2017,83,20:30,20:45,33.76,,0,33.76,33.76,1,-129154,112106,241260,-17048,0,0,9139,0,0,,9139,9139
22,05/29/2017,84,20:45,21:00,29.54,,0,29.54,29.54,1,-124642,110876,235518,-13766,0,0,9876,0,0,,9876,9876
22,05/29/2017,85,21:00,21:15,48.02,,0,48.02,48.02,1,-162359,70160,232519,-92199,0,0,11884,0,0,,11884,11884
22,05/29/2017,86,21:15,21:30,163.78,,0,163.78,163.78,1,-152763,68248,221011,-84515,0,0,30057,0,0,,30057,30057
22,05/29/2017,87,21:30,21:45,,,0,37.05,37.05,0,-137201,71673,208874,-65528,0,0,5356,0,0,,5356,5356
22,05/29/2017,88,21:45,22:00,,,0,37.05,37.05,0,-146261,67470,213731,-78791,0,0,0,0,0,,0,0
22,05/29/2017,89,22:00,22:15,58.02,,0,58.02,58.02,1,-204508,42385,246893,-162123,0,0,10819,0,0,,10819,10819
22,05/29/2017,90,22:15,22:30,30.59,,0,30.59,30.59,1,-144809,48884,193693,-95925,0,0,5669,0,0,,5669,5669
22,05/29/2017,91,22:30,22:45,29.54,,0,29.54,29.54,1,-110997,51644,162641,-59353,0,0,380,0,0,,380,380
22,05/29/2017,92,22:45,23:00,28.1,27.03,0,27.03,27.03,-1,-82465,45771,128236,-36694,0,-471,85,0,0,,556,-386
22,05/29/2017,93,23:00,23:15,40.59,26.24,0,40.59,26.24,2,-158667,54466,213133,-104201,0,-481,3872,0,0,,4353,3391
22,05/29/2017,94,23:15,23:30,28.58,,0,28.58,28.58,1,-124231,48429,172660,-75802,0,0,2771,0,0,,2771,2771
22,05/29/2017,95,23:30,23:45,28.58,27.03,0,27.03,27.03,-1,-96254,48476,144730,-47778,0,-630,147,0,0,,777,-483
22,05/29/2017,96,23:45,0:00,,13.25,0,13.25,13.25,-1,-62287,37291,99578,-24996,0,-13678,0,0,0,,13678,-13678
22,05/30/2017,1,0:00,0:15,129.12,24.34,0,129.12,129.12,1,-171131,39060,210191,-132071,0,-11540,11985,0,0,,23525,445
22,05/30/2017,2,0:15,0:30,209.4,,0,209.4,209.4,1,-114187,21899,136086,-92288,0,0,63931,0,0,,63931,63931
22,05/30/2017,3,0:30,0:45,209.4,27.88,0,27.88,27.88,-1,-28109,38526,66635,10417,0,-288,8501,0,0,,8789,8213
22,05/30/2017,4,0:45,1:00,,20.48,0,20.48,20.48,-1,-21253,75370,96623,54117,0,-4908,0,0,0,,4908,-4908
22,05/30/2017,5,1:00,1:15,,27.59,0,27.59,27.59,-1,-63454,92085,155539,28631,0,-6323,0,0,0,,6323,-6323
22,05/30/2017,6,1:15,1:30,,,0,28.39,28.39,0,-59845,102715,162560,42870,0,0,0,0,0,,0,0
22,05/30/2017,7,1:30,1:45,,,0,28.4,28.4,0,-57256,61354,118610,4098,0,0,0,0,0,,0,0
22,05/30/2017,8,1:45,2:00,,28.59,0,28.59,28.59,-1,-67246,56177,123423,-11069,0,-166,0,0,0,,166,-166
22,05/30/2017,9,2:00,2:15,,28.59,0,28.59,28.59,-1,-87415,71129,158544,-16286,0,-220,0,0,0,,220,-220
22,05/30/2017,10,2:15,2:30,,,0,28.44,28.44,0,-72519,66589,139108,-5930,0,0,0,0,0,,0,0
22,05/30/2017,11,2:30,2:45,,27.59,0,27.59,27.59,-1,-62610,68144,130754,5534,0,-4277,0,0,0,,4277,-4277
22,05/30/2017,12,2:45,3:00,,18.59,0,18.59,18.59,-1,-41359,72686,114045,31327,0,-13971,0,0,0,,13971,-13971
22,05/30/2017,13,3:00,3:15,,19.86,0,19.86,19.86,-1,-44673,22237,66910,-22436,0,-13075,0,0,0,,13075,-13075
22,05/30/2017,14,3:15,3:30,,,0,28.47,28.47,0,-49751,42614,92365,-7137,0,-184,0,0,0,,184,-184
22,05/30/2017,15,3:30,3:45,,28.89,0,28.89,28.89,-1,-47036,59478,106514,12442,0,-1195,0,0,0,,1195,-1195
22,05/30/2017,16,3:45,4:00,,26.04,0,26.04,26.04,-1,-44541,54958,99499,10417,0,-4316,0,0,0,,4316,-4316
22,05/30/2017,17,4:00,4:15,,28.89,0,28.89,28.89,-1,-26103,53120,79223,27017,0,-2430,0,0,0,,2430,-2430
22,05/30/2017,18,4:15,4:30,,,0,28.53,28.53,0,-24395,60891,85286,36496,0,0,0,0,0,,0,0
22,05/30/2017,19,4:30,4:45,,25.95,0,25.95,25.95,-1,-18947,82145,101092,63198,0,-5443,0,0,0,,5443,-5443
22,05/30/2017,20,4:45,5:00,,18.41,0,18.41,18.41,-1,-16410,81422,97832,65012,0,-18967,0,0,0,,18967,-18967
22,05/30/2017,21,5:00,5:15,,28.89,0,28.89,28.89,-1,-62314,76445,138759,14131,0,-5681,0,0,0,,5681,-5681
22,05/30/2017,22,5:15,5:30,,28.59,0,28.59,28.59,-1,-25757,63157,88914,37400,0,-96,0,0,0,,96,-96
22,05/30/2017,23,5:30,5:45,,28.89,0,28.89,28.89,-1,-25610,56768,82378,31158,0,-362,0,0,0,,362,-362
22,05/30/2017,24,5:45,6:00,,28.89,0,28.89,28.89,-1,-39676,39154,78830,-522,0,-2373,0,0,0,,2373,-2373
22,05/30/2017,25,6:00,6:15,,13.51,0,13.51,13.51,-1,-39782,96490,136272,56708,0,-14317,0,0,0,,14317,-14317
22,05/30/2017,26,6:15,6:30,,28.89,0,28.89,28.89,-1,-26965,67251,94216,40286,0,-3747,0,0,0,,3747,-3747
22,05/30/2017,27,6:30,6:45,,28.89,0,28.89,28.89,-1,-48259,57384,105643,9125,0,-2323,0,0,0,,2323,-2323
22,05/30/2017,28,6:45,7:00,,,0,29.01,29.01,0,-65443,63635,129078,-1808,0,-37,0,0,0,,37,-37
22,05/30/2017,29,7:00,7:15,,1.5,0,1.5,1.5,-1,-39994,116180,156174,76186,0,-19795,0,0,0,,19795,-19795
22,05/30/2017,30,7:15,7:30,,39.24,0,39.24,39.24,-1,-57781,62948,120729,5167,0,-2591,0,0,0,,2591,-2591
22,05/30/2017,31,7:30,7:45,30.59,,0,30.59,30.59,1,-78331,38853,117184,-39478,0,0,1552,0,0,,1552,1552
22,05/30/2017,32,7:45,8:00,146.1,,0,146.1,146.1,1,-113183,52316,165499,-60867,0,0,29140,0,0,,29140,29140
22,05/30/2017,33,8:00,8:15,146.1,29.59,0,29.59,29.59,-1,-57629,84414,142043,26785,0,-609,11188,0,0,,11797,10579
22,05/30/2017,34,8:15,8:30,,41.17,0,41.17,41.17,-1,-55295,72729,128024,17434,0,-233,0,0,0,,233,-233
22,05/30/2017,35,8:30,8:45,32.23,41.15,0,32.23,32.23,1,-74120,54137,128257,-19983,0,-128,1426,0,0,,1554,1298
22,05/30/2017,36,8:45,9:00,34.77,,0,34.77,34.77,1,-100883,51879,152762,-49004,0,0,16272,0,0,,16272,16272
22,05/30/2017,37,9:00,9:15,29.53,,0,29.53,29.53,1,-72509,63637,136146,-8872,0,0,7947,0,0,,7947,7947
22,05/30/2017,38,9:15,9:30,45.1,,0,45.1,45.1,1,-92222,48300,140522,-43922,0,0,14163,0,0,,14163,14163
22,05/30/2017,39,9:30,9:45,61.1,,0,61.1,61.1,1,-75416,37056,112472,-38360,0,0,37067,0,0,,37067,37067
22,05/30/2017,40,9:45,10:00,33.6,,0,33.6,33.6,1,-49647,44643,94290,-5004,0,0,14463,0,0,,14463,14463
22,05/30/2017,41,10:00,10:15,148.44,,0,148.44,148.44,1,-99872,27481,127353,-72391,0,0,28793,0,0,,28793,28793
22,05/30/2017,42,10:15,10:30,64.8,,0,64.8,64.8,1,-86674,34826,121500,-51848,0,0,62208,0,0,,62208,62208
22,05/30/2017,43,10:30,10:45,33.33,,0,33.33,33.33,1,-56390,38210,94600,-18180,0,0,21501,0,0,,21501,21501
22,05/30/2017,44,10:45,11:00,53.8,,0,53.8,53.8,1,-65495,31140,96635,-34355,0,0,22903,0,0,,22903,22903
22,05/30/2017,45,11:00,11:15,33.6,,0,33.6,33.6,1,-65853,38293,104146,-27560,0,0,25659,0,0,,25659,25659
22,05/30/2017,46,11:15,11:30,53,,0,53,53,1,-81801,42776,124577,-39025,0,0,29519,0,0,,29519,29519
22,05/30/2017,47,11:30,11:45,67.12,,0,67.12,67.12,1,-84073,37717,121790,-46356,0,0,50020,0,0,,50020,50020
22,05/30/2017,48,11:45,12:00,34.12,,0,34.12,34.12,1,-79425,45242,124667,-34183,0,0,34327,0,0,,34327,34327
22,05/30/2017,49,12:00,12:15,130.12,,0,130.12,130.12,1,-116675,42770,159445,-73905,0,0,43548,0,0,,43548,43548
22,05/30/2017,50,12:15,12:30,41,,0,41,41,1,-79158,47964,127122,-31194,0,0,38700,0,0,,38700,38700
22,05/30/2017,51,12:30,12:45,28.59,28.59,0,28.59,28.59,-1,-53617,56243,109860,2626,0,-419,12606,0,0,,13025,12187
22,05/30/2017,52,12:45,13:00,28.59,28.59,0,28.59,28.59,-1,-47116,65045,112161,17929,0,-554,58,0,0,,612,-496
22,05/30/2017,53,13:00,13:15,,,0,29.01,29.01,0,-57403,34928,92331,-22475,0,-298,0,0,0,,298,-298
22,05/30/2017,54,13:15,13:30,34.1,,0,34.1,34.1,1,-90076,36294,126370,-53782,0,0,4852,0,0,,4852,4852
22,05/30/2017,55,13:30,13:45,28.87,,0,28.87,28.87,1,-77723,34340,112063,-43383,0,0,2618,0,0,,2618,2618
22,05/30/2017,56,13:45,14:00,28.59,,0,28.59,28.59,1,-77012,35409,112421,-41603,0,0,3525,0,0,,3525,3525
22,05/30/2017,57,14:00,14:15,130.12,,0,130.12,130.12,1,-114945,35894,150839,-79051,0,0,25949,0,0,,25949,25949
22,05/30/2017,58,14:15,14:30,74.12,,0,74.12,74.12,1,-95307,47075,142382,-48232,0,0,56029,0,0,,56029,56029
22,05/30/2017,59,14:30,14:45,33.12,,0,33.12,33.12,1,-73113,54846,127959,-18267,0,0,27400,0,0,,27400,27400
22,05/30/2017,60,14:45,15:00,28.87,,0,28.87,28.87,1,-73577,56722,130299,-16855,0,0,8814,0,0,,8814,8814
22,05/30/2017,61,15:00,15:15,35.56,,0,35.56,35.56,1,-100914,58503,159417,-42411,0,0,21625,0,0,,21625,21625
22,05/30/2017,62,15:15,15:30,37.86,,0,37.86,37.86,1,-102753,63537,166290,-39216,0,0,26438,0,0,,26438,26438
22,05/30/2017,63,15:30,15:45,43.45,,0,43.45,43.45,1,-123386,66762,190148,-56624,0,0,51830,0,0,,51830,51830
22,05/30/2017,64,15:45,16:00,34.1,27.17,0,27.17,27.17,-1,-77495,68864,146359,-8631,0,-128,30495,0,0,,30623,30367
22,05/30/2017,65,16:00,16:15,34.1,26.56,0,26.56,26.56,-1,-85628,93670,179298,8042,0,-598,723,0,0,,1321,125
22,05/30/2017,66,16:15,16:30,,,0,29.01,29.01,0,-72490,101273,173763,28783,0,0,0,0,0,,0,0
22,05/30/2017,67,16:30,16:45,,,0,29.01,29.01,0,-55675,109656,165331,53981,0,0,0,0,0,,0,0
22,05/30/2017,68,16:45,17:00,,,0,29.01,29.01,0,-58667,104723,163390,46056,0,0,0,0,0,,0,0
22,05/30/2017,69,17:00,17:15,,13.19,0,13.19,13.19,-1,-65576,119732,185308,54156,0,-20072,0,0,0,,20072,-20072
22,05/30/2017,70,17:15,17:30,,24.49,0,24.49,24.49,-1,-71737,102658,174395,30921,0,-18095,0,0,0,,18095,-18095
22,05/30/2017,71,17:30,17:45,,3.33,0,3.33,3.33,-1,-42858,107110,149968,64252,0,-32867,0,0,0,,32867,-32867
22,05/30/2017,72,17:45,18:00,,24.49,0,24.49,24.49,-1,-61226,101072,162298,39846,0,-19767,0,0,0,,19767,-19767
22,05/30/2017,73,18:00,18:15,,23.59,0,23.59,23.59,-1,-67612,99605,167217,31993,0,-17346,0,0,0,,17346,-17346
22,05/30/2017,74,18:15,18:30,,23.52,0,23.52,23.52,-1,-51678,97221,148899,45543,0,-25584,0,0,0,,25584,-25584
22,05/30/2017,75,18:30,18:45,,-12.93,0,-12.93,-12.93,-1,-38616,113617,152233,75001,0,-46844,0,0,0,,46844,-46844
22,05/30/2017,76,18:45,19:00,,-12.19,0,-12.19,-12.19,-1,-61007,126637,187644,65630,0,-69173,0,0,0,,69173,-69173
22,05/30/2017,77,19:00,19:15,,20.48,0,20.48,20.48,-1,-48763,100588,149351,51825,0,-30863,0,0,0,,30863,-30863
22,05/30/2017,78,19:15,19:30,,25.57,0,25.57,25.57,-1,-33005,104991,137996,71986,0,-7579,0,0,0,,7579,-7579
22,05/30/2017,79,19:30,19:45,,12.73,0,12.73,12.73,-1,-32164,130289,162453,98125,0,-37956,0,0,0,,37956,-37956
22,05/30/2017,80,19:45,20:00,,23.59,0,23.59,23.59,-1,-36663,119312,155975,82649,0,-32630,0,0,0,,32630,-32630
22,05/30/2017,81,20:00,20:15,,-6.78,0,-6.78,-6.78,-1,-41197,137524,178721,96327,0,-47945,0,0,0,,47945,-47945
22,05/30/2017,82,20:15,20:30,,13.41,0,13.41,13.41,-1,-44226,114240,158466,70014,0,-51001,0,0,0,,51001,-51001
22,05/30/2017,83,20:30,20:45,,18.45,0,18.45,18.45,-1,-41875,118372,160247,76497,0,-48293,0,0,0,,48293,-48293
22,05/30/2017,84,20:45,21:00,,20.48,0,20.48,20.48,-1,-42858,98059,140917,55201,0,-43825,0,0,0,,43825,-43825
22,05/30/2017,85,21:00,21:15,29.25,26.78,0,29.25,29.25,1,-56318,62557,118875,6239,0,-15909,876,0,0,,16785,-15033
22,05/30/2017,86,21:15,21:30,29.25,28.59,0,28.59,28.59,-1,-56443,72497,128940,16054,0,-2038,67,0,0,,2105,-1971
22,05/30/2017,87,21:30,21:45,,23.59,0,23.59,23.59,-1,-53162,81811,134973,28649,0,-13401,0,0,0,,13401,-13401
22,05/30/2017,88,21:45,22:00,,23.59,0,23.59,23.59,-1,-45418,69660,115078,24242,0,-18732,0,0,0,,18732,-18732
22,05/30/2017,89,22:00,22:15,27.43,12.78,0,29.01,12.78,2,-60339,90174,150513,29835,0,-16073,77,0,0,,16150,-15996
22,05/30/2017,90,22:15,22:30,27.43,28.59,0,29.01,28.59,2,-66066,69216,135282,3150,0,-1298,108,0,0,,1406,-1190
22,05/30/2017,91,22:30,22:45,,27.59,0,27.59,27.59,-1,-46886,72415,119301,25529,0,-4740,0,0,0,,4740,-4740
22,05/30/2017,92,22:45,23:00,,8.16,0,8.16,8.16,-1,-35286,100828,136114,65542,0,-19494,0,0,0,,19494,-19494
22,05/30/2017,93,23:00,23:15,116.12,23.59,0,116.12,116.12,1,-75696,29762,105458,-45934,0,-12493,9758,0,0,,22251,-2735
22,05/30/2017,94,23:15,23:30,32.89,,0,32.89,32.89,1,-69822,36518,106340,-33304,0,0,17643,0,0,,17643,17643
22,05/30/2017,95,23:30,23:45,32.89,27.17,0,27.17,27.17,-1,-64415,68987,133402,4572,0,-1976,2519,0,0,,4495,543
22,05/30/2017,96,23:45,0:00,,28.89,0,28.89,28.89,-1,-100801,74914,175715,-25887,0,-1873,0,0,0,,1873,-1873
22,05/31/2017,1,0:00,0:15,30.58,,0,30.58,30.58,1,-62839,66321,129160,3482,0,0,3719,0,0,,3719,3719
22,05/31/2017,2,0:15,0:30,28.58,,0,28.58,28.58,1,-57091,22751,79842,-34340,0,0,2277,0,0,,2277,2277
22,05/31/2017,3,0:30,0:45,,,0,29.55,29.55,0,-71675,19039,90714,-52636,0,0,0,0,0,,0,0
22,05/31/2017,4,0:45,1:00,,,0,29.55,29.55,0,-89137,34545,123682,-54592,0,0,0,0,0,,0,0
22,05/31/2017,5,1:00,1:15,90.02,,0,90.02,90.02,1,-65106,23590,88696,-41516,0,0,13780,0,0,,13780,13780
22,05/31/2017,6,1:15,1:30,34.19,,0,34.19,34.19,1,-36303,30285,66588,-6018,0,0,20578,0,0,,20578,20578
22,05/31/2017,7,1:30,1:45,28.58,28.39,0,29.48,28.39,2,-34457,32788,67245,-1669,0,-473,2015,0,0,,2488,1542
22,05/31/2017,8,1:45,2:00,27.75,,0,27.75,27.75,1,-42170,33188,75358,-8982,0,0,838,0,0,,838,838
22,05/31/2017,9,2:00,2:15,30.58,31.39,0,30.58,29.52,2,-48243,49720,97963,1477,0,-30,1380,0,0,,1410,1350
22,05/31/2017,10,2:15,2:30,28.74,,0,28.74,28.74,1,-48604,19308,67912,-29296,0,0,5142,0,0,,5142,5142
22,05/31/2017,11,2:30,2:45,,,0,29.52,29.52,0,-61173,6634,67807,-54539,0,0,620,0,0,,620,620
22,05/31/2017,12,2:45,3:00,,,0,29.52,29.52,0,-75719,6990,82709,-68729,0,0,0,0,0,,0,0
22,05/31/2017,13,3:00,3:15,50.43,,0,50.43,50.43,1,-85101,25086,110187,-60015,0,0,12223,0,0,,12223,12223
22,05/31/2017,14,3:15,3:30,29.31,,0,29.31,29.31,1,-93051,11465,104516,-81586,0,0,5144,0,0,,5144,5144
22,05/31/2017,15,3:30,3:45,34.58,,0,34.58,34.58,1,-115833,7336,123169,-108497,0,0,6006,0,0,,6006,6006
22,05/31/2017,16,3:45,4:00,30.58,,0,30.58,30.58,1,-121040,6899,127939,-114141,0,0,8328,0,0,,8328,8328
22,05/31/2017,17,4:00,4:15,125.78,,0,125.78,125.78,1,-132341,18513,150854,-113828,0,0,38264,0,0,,38264,38264
22,05/31/2017,18,4:15,4:30,54.99,,0,54.99,54.99,1,-99110,19859,118969,-79251,0,0,59604,0,0,,59604,59604
22,05/31/2017,19,4:30,4:45,34.56,,0,34.56,34.56,1,-69719,29706,99425,-40013,0,0,29787,0,0,,29787,29787
22,05/31/2017,20,4:45,5:00,34.58,,0,34.58,34.58,1,-51689,19850,71539,-31839,0,0,19241,0,0,,19241,19241
22,05/31/2017,21,5:00,5:15,34.58,27.58,0,27.58,27.58,-1,-49492,56962,106454,7470,0,-851,6275,0,0,,7126,5424
22,05/31/2017,22,5:15,5:30,28.58,,0,28.58,28.58,1,-48614,24342,72956,-24272,0,0,756,0,0,,756,756
22,05/31/2017,23,5:30,5:45,34.19,,0,34.19,34.19,1,-52864,21117,73981,-31747,0,0,4989,0,0,,4989,4989
22,05/31/2017,24,5:45,6:00,40.58,,0,40.58,40.58,1,-64317,35404,99721,-28913,0,0,20804,0,0,,20804,20804
22,05/31/2017,25,6:00,6:15,31.29,27.56,0,27.56,27.56,-1,-117452,59813,177265,-57639,0,-384,16159,0,0,,16543,15775
22,05/31/2017,26,6:15,6:30,28.56,27.56,0,29.48,27.56,2,-55478,56726,112204,1248,0,-2177,811,0,0,,2988,-1366
22,05/31/2017,27,6:30,6:45,29.14,,0,29.14,29.14,1,-69338,42387,111725,-26951,0,0,826,0,0,,826,826
22,05/31/2017,28,6:45,7:00,128.02,,0,128.02,128.02,1,-111943,62271,174214,-49672,0,0,28213,0,0,,28213,28213
22,05/31/2017,29,7:00,7:15,128.02,-54.91,0,-54.91,-54.91,-1,-43355,122881,166236,79526,0,-20384,4975,0,0,,25359,-15409
22,05/31/2017,30,7:15,7:30,,28.39,0,28.39,28.39,-1,-53289,50133,103422,-3156,0,-1377,0,0,0,,1377,-1377
22,05/31/2017,31,7:30,7:45,45.07,28.39,0,45.07,45.07,1,-79180,43968,123148,-35212,0,-50,4229,0,0,,4279,4179
22,05/31/2017,32,7:45,8:00,123.66,,0,123.66,123.66,1,-110860,55408,166268,-55452,0,0,43511,0,0,,43511,43511
22,05/31/2017,33,8:00,8:15,30.66,23.56,0,30.66,23.56,2,-30669,52560,83229,21891,0,-773,13307,0,0,,14080,12534
22,05/31/2017,34,8:15,8:30,,,0,29.82,29.82,0,-47642,43615,91257,-4027,0,0,0,0,0,,0,0
22,05/31/2017,35,8:30,8:45,,,0,29.82,29.82,0,-65968,40502,106470,-25466,0,0,0,0,0,,0,0
22,05/31/2017,36,8:45,9:00,28.24,,0,28.24,28.24,1,-97742,43305,141047,-54437,0,0,77,0,0,,77,77
22,05/31/2017,37,9:00,9:15,61.66,,0,61.66,61.66,1,-78511,29298,107809,-49213,0,0,9809,0,0,,9809,9809
22,05/31/2017,38,9:15,9:30,44.17,,0,44.17,44.17,1,-73958,21717,95675,-52241,0,0,32175,0,0,,32175,32175
22,05/31/2017,39,9:30,9:45,41.13,,0,41.13,41.13,1,-66545,25440,91985,-41105,0,0,33389,0,0,,33389,33389
22,05/31/2017,40,9:45,10:00,45.36,,0,45.36,45.36,1,-85724,23811,109535,-61913,0,0,35666,0,0,,35666,35666
22,05/31/2017,41,10:00,10:15,30.66,27.56,0,27.56,27.56,-1,-48184,78647,126831,30463,0,-219,15490,0,0,,15709,15271
22,05/31/2017,42,10:15,10:30,27.57,27.56,0,27.57,27.57,1,-60155,51613,111768,-8542,0,-41,92,0,0,,133,51
22,05/31/2017,43,10:30,10:45,32.93,,0,32.93,32.93,1,-74824,43567,118391,-31257,0,0,8636,0,0,,8636,8636
22,05/31/2017,44,10:45,11:00,31.65,,0,31.65,31.65,1,-81494,38732,120226,-42762,0,0,19593,0,0,,19593,19593
22,05/31/2017,45,11:00,11:15,33.51,,0,33.51,33.51,1,-99539,65182,164721,-34357,0,0,18092,0,0,,18092,18092
22,05/31/2017,46,11:15,11:30,33.51,,0,33.51,33.51,1,-98596,61271,159867,-37325,0,0,17412,0,0,,17412,17412
22,05/31/2017,47,11:30,11:45,33.51,,0,33.51,33.51,1,-98187,55902,154089,-42285,0,0,21495,0,0,,21495,21495
22,05/31/2017,48,11:45,12:00,34.52,,0,34.52,34.52,1,-88173,56283,144456,-31890,0,0,25019,0,0,,25019,25019
22,05/31/2017,49,12:00,12:15,128.81,,0,128.81,128.81,1,-116886,38060,154946,-78826,0,0,41024,0,0,,41024,41024
22,05/31/2017,50,12:15,12:30,34.19,,0,34.19,34.19,1,-81741,48241,129982,-33500,0,0,15338,0,0,,15338,15338
22,05/31/2017,51,12:30,12:45,40.56,,0,40.56,40.56,1,-82308,47481,129789,-34827,0,0,7760,0,0,,7760,7760
22,05/31/2017,52,12:45,13:00,30.56,,0,30.56,30.56,1,-86507,52122,138629,-34385,0,0,10037,0,0,,10037,10037
22,05/31/2017,53,13:00,13:15,40.56,,0,40.56,40.56,1,-98692,38630,137322,-60062,0,0,15454,0,0,,15454,15454
22,05/31/2017,54,13:15,13:30,40.56,,0,40.56,40.56,1,-105639,36731,142370,-68908,0,0,32080,0,0,,32080,32080
22,05/31/2017,55,13:30,13:45,53.66,,0,53.66,53.66,1,-97135,34204,131339,-62931,0,0,47016,0,0,,47016,47016
22,05/31/2017,56,13:45,14:00,40.56,,0,40.56,40.56,1,-113180,36182,149362,-76998,0,0,47044,0,0,,47044,47044
22,05/31/2017,57,14:00,14:15,34.56,,0,34.56,34.56,1,-85479,51647,137126,-33832,0,0,26686,0,0,,26686,26686
22,05/31/2017,58,14:15,14:30,34.56,,0,34.56,34.56,1,-85245,46058,131303,-39187,0,0,26969,0,0,,26969,26969
22,05/31/2017,59,14:30,14:45,29.01,,0,29.01,29.01,1,-88087,46538,134625,-41549,0,0,13953,0,0,,13953,13953
22,05/31/2017,60,14:45,15:00,,,0,34.53,34.53,0,-88747,46918,135665,-41829,0,0,2476,0,0,,2476,2476
22,05/31/2017,61,15:00,15:15,40.56,,0,40.56,40.56,1,-108033,34764,142797,-73269,0,0,8214,0,0,,8214,8214
22,05/31/2017,62,15:15,15:30,40.56,,0,40.56,40.56,1,-95643,35931,131574,-59712,0,0,20326,0,0,,20326,20326
22,05/31/2017,63,15:30,15:45,53.58,,0,53.58,53.58,1,-103611,37878,141489,-65733,0,0,25456,0,0,,25456,25456
22,05/31/2017,64,15:45,16:00,34.19,,0,34.19,34.19,1,-97353,44160,141513,-53193,0,0,20921,0,0,,20921,20921
22,05/31/2017,65,16:00,16:15,30.56,,0,30.56,30.56,1,-73538,36477,110015,-37061,0,0,7178,0,0,,7178,7178
22,05/31/2017,66,16:15,16:30,28.72,,0,28.72,28.72,1,-59664,39560,99224,-20104,0,0,9676,0,0,,9676,9676
22,05/31/2017,67,16:30,16:45,30.56,,0,30.56,30.56,1,-69191,43156,112347,-26035,0,0,11019,0,0,,11019,11019
22,05/31/2017,68,16:45,17:00,34.56,,0,34.56,34.56,1,-83151,43881,127032,-39270,0,0,11139,0,0,,11139,11139
22,05/31/2017,69,17:00,17:15,49,,0,49,49,1,-86349,39073,125422,-47276,0,0,26596,0,0,,26596,26596
22,05/31/2017,70,17:15,17:30,34.19,,0,34.19,34.19,1,-64082,44564,108646,-19518,0,0,24906,0,0,,24906,24906
22,05/31/2017,71,17:30,17:45,33,,0,33,33,1,-71273,53150,124423,-18123,0,0,11064,0,0,,11064,11064
22,05/31/2017,72,17:45,18:00,33.1,,0,33.1,33.1,1,-86414,58244,144658,-28170,0,0,13282,0,0,,13282,13282
22,05/31/2017,73,18:00,18:15,28.42,28.56,0,28.56,28.56,-1,-75561,72903,148464,-2658,0,-470,4872,0,0,,5342,4402
22,05/31/2017,74,18:15,18:30,,28.56,0,28.56,28.56,-1,-47804,73213,121017,25409,0,-1696,0,0,0,,1696,-1696
22,05/31/2017,75,18:30,18:45,,,0,34.78,34.78,0,-40447,70661,111108,30214,0,-141,0,0,0,,141,-141
22,05/31/2017,76,18:45,19:00,,41.31,0,41.31,41.31,-1,-39393,75556,114949,36163,0,-72,0,0,0,,72,-72
22,05/31/2017,77,19:00,19:15,30.56,,0,30.56,30.56,1,-57483,50958,108441,-6525,0,0,580,0,0,,580,580
22,05/31/2017,78,19:15,19:30,30.56,,0,30.56,30.56,1,-45419,31318,76737,-14101,0,0,3752,0,0,,3752,3752
22,05/31/2017,79,19:30,19:45,34.19,,0,34.19,34.19,1,-49319,27966,77285,-21353,0,0,6745,0,0,,6745,6745
22,05/31/2017,80,19:45,20:00,37.11,,0,37.11,37.11,1,-62314,22707,85021,-39607,0,0,16490,0,0,,16490,16490
22,05/31/2017,81,20:00,20:15,78.66,,0,78.66,78.66,1,-74719,20149,94868,-54570,0,0,30168,0,0,,30168,30168
22,05/31/2017,82,20:15,20:30,36.45,41.47,0,41.47,41.47,-1,-41507,29255,70762,-12252,0,-10,22364,0,0,,22374,22354
22,05/31/2017,83,20:30,20:45,36.45,40.87,0,40.87,40.87,-1,-33793,27056,60849,-6737,0,-110,1146,0,0,,1256,1036
22,05/31/2017,84,20:45,21:00,34.56,,0,34.56,34.56,1,-38823,28284,67107,-10539,0,0,5038,0,0,,5038,5038
22,05/31/2017,85,21:00,21:15,30.56,,0,30.56,30.56,1,-48434,37831,86265,-10603,0,0,6039,0,0,,6039,6039
22,05/31/2017,86,21:15,21:30,34.19,,0,34.19,34.19,1,-48828,28920,77748,-19908,0,0,9442,0,0,,9442,9442
22,05/31/2017,87,21:30,21:45,31.75,,0,31.75,31.75,1,-48545,31805,80350,-16740,0,0,8215,0,0,,8215,8215
22,05/31/2017,88,21:45,22:00,31.75,27.56,0,27.56,27.56,-1,-40512,44837,85349,4325,0,-3602,676,0,0,,4278,-2926
22,05/31/2017,89,22:00,22:15,30.56,41.01,0,34.93,34.93,2,-42226,36046,78272,-6180,0,-2818,1561,0,0,,4379,-1257
22,05/31/2017,90,22:15,22:30,39.96,,0,39.96,39.96,1,-57219,28530,85749,-28689,0,0,7938,0,0,,7938,7938
22,05/31/2017,91,22:30,22:45,30.56,41.61,0,34.93,34.93,2,-38390,29321,67711,-9069,0,-1,11664,0,0,,11665,11663
22,05/31/2017,92,22:45,23:00,28.24,28.56,0,28.56,28.56,-1,-43382,36846,80228,-6536,0,-524,1427,0,0,,1951,903
22,05/31/2017,93,23:00,23:15,249.11,28.56,0,249.11,28.56,2,-86204,16719,102923,-69485,0,-535,24569,0,0,,25104,24034
22,05/31/2017,94,23:15,23:30,43.28,25.26,0,25.26,25.26,-1,-49568,37438,87006,-12130,0,-235,21770,0,0,,22005,21535
22,05/31/2017,95,23:30,23:45,43.28,21.26,0,21.26,21.26,-1,-35226,39412,74638,4186,0,-10369,380,0,0,,10749,-9989
22,05/31/2017,96,23:45,0:00,,26.26,0,26.26,26.26,-1,-52472,51785,104257,-687,0,-8585,0,0,0,,8585,-8585
22,06-01-17,1,0:00,0:15,30.76,27.76,0,30.76,27.73,2,-75513,66510,142023,-9003,0,-4579,1462,0,0,,6041,-3117
22,06-01-17,2,0:15,0:30,34.76,,0,34.76,34.76,1,-64557,22934,87491,-41623,0,0,7293,0,0,,7293,7293
22,06-01-17,3,0:30,0:45,27.69,,0,27.69,27.69,1,-38152,19053,57205,-19099,0,0,1671,0,0,,1671,1671
22,06-01-17,4,0:45,1:00,,,0,27.68,27.68,0,-55697,36937,92634,-18760,0,0,0,0,0,,0,0
22,06-01-17,5,1:00,1:15,40.76,,0,40.76,40.76,1,-65023,16738,81761,-48285,0,0,3950,0,0,,3950,3950
22,06-01-17,6,1:15,1:30,29.02,,0,29.02,29.02,1,-69980,12280,82260,-57700,0,0,3483,0,0,,3483,3483
22,06-01-17,7,1:30,1:45,,,0,27.53,27.53,0,-60273,15212,75485,-45061,0,0,0,0,0,,0,0
22,06-01-17,8,1:45,2:00,,,0,27.53,27.53,0,-50459,23798,74257,-26661,0,0,0,0,0,,0,0
22,06-01-17,9,2:00,2:15,49.58,,0,49.58,49.58,1,-58149,21983,80132,-36166,0,0,13045,0,0,,13045,13045
22,06-01-17,10,2:15,2:30,29.33,,0,29.33,29.33,1,-41399,17872,59271,-23527,0,0,9062,0,0,,9062,9062
22,06-01-17,11,2:30,2:45,,,0,27.08,27.08,0,-51356,19345,70701,-32011,0,0,0,0,0,,0,0
22,06-01-17,12,2:45,3:00,,,0,27.08,27.08,0,-52962,20693,73655,-32269,0,0,0,0,0,,0,0
22,06-01-17,13,3:00,3:15,50.02,,0,50.02,50.02,1,-64581,18649,83230,-45932,0,0,11528,0,0,,11528,11528
22,06-01-17,14,3:15,3:30,32.26,,0,32.26,32.26,1,-51153,26330,77483,-24823,0,0,24694,0,0,,24694,24694
22,06-01-17,15,3:30,3:45,28.26,26.85,0,28.26,26.85,2,-44543,22609,67152,-21934,0,-383,3466,0,0,,3849,3083
22,06-01-17,16,3:45,4:00,29.75,,0,29.75,29.75,1,-49705,17769,67474,-31936,0,0,3460,0,0,,3460,3460
22,06-01-17,17,4:00,4:15,28.26,,0,28.26,28.26,1,-38866,21170,60036,-17696,0,0,2399,0,0,,2399,2399
22,06-01-17,18,4:15,4:30,28.26,,0,28.26,28.26,1,-33022,19020,52042,-14002,0,0,3100,0,0,,3100,3100
22,06-01-17,19,4:30,4:45,,,0,27.08,27.08,0,-30276,22626,52902,-7650,0,0,0,0,0,,0,0
22,06-01-17,20,4:45,5:00,,,0,27.08,27.08,0,-27925,28242,56167,317,0,0,0,0,0,,0,0
22,06-01-17,21,5:00,5:15,,23.09,0,23.09,23.09,-1,-35850,37601,73451,1751,0,-2662,0,0,0,,2662,-2662
22,06-01-17,22,5:15,5:30,,18.76,0,18.76,18.76,-1,-25159,32288,57447,7129,0,-17532,0,0,0,,17532,-17532
22,06-01-17,23,5:30,5:45,,,0,27.73,27.73,0,-37810,29657,67467,-8153,0,-2928,0,0,0,,2928,-2928
22,06-01-17,24,5:45,6:00,28.76,,0,28.76,28.76,1,-52744,34716,87460,-18028,0,0,610,0,0,,610,610
22,06-01-17,25,6:00,6:15,28.19,27.96,0,27.96,27.96,-1,-82495,56677,139172,-25818,0,-243,336,0,0,,579,93
22,06-01-17,26,6:15,6:30,,26.61,0,26.61,26.61,-1,-40949,37863,78812,-3086,0,-2280,0,0,0,,2280,-2280
22,06-01-17,27,6:30,6:45,29.33,26.61,0,29.33,29.33,1,-44253,35126,79379,-9127,0,-6,276,0,0,,282,270
22,06-01-17,28,6:45,7:00,29.03,,0,29.03,29.03,1,-50527,47688,98215,-2839,0,0,2876,0,0,,2876,2876
22,06-01-17,29,7:00,7:15,29.03,13.59,0,13.59,13.59,-1,-25606,112908,138514,87302,0,-6541,570,0,0,,7111,-5971
22,06-01-17,30,7:15,7:30,,38.3,0,38.3,38.3,-1,-31650,86044,117694,54394,0,-4588,0,0,0,,4588,-4588
22,06-01-17,31,7:30,7:45,,39.74,0,39.74,39.74,-1,-34727,74859,109586,40132,0,-1768,0,0,0,,1768,-1768
22,06-01-17,32,7:45,8:00,,40.86,0,40.86,40.86,-1,-50558,103304,153862,52746,0,-537,0,0,0,,537,-537
22,06-01-17,33,8:00,8:15,,3.6,0,3.6,3.6,-1,-29407,69461,98868,40054,0,-19961,0,0,0,,19961,-19961
22,06-01-17,34,8:15,8:30,,23.8,0,23.8,23.8,-1,-28482,57745,86227,29263,0,-18028,0,0,0,,18028,-18028
22,06-01-17,35,8:30,8:45,,27.96,0,27.96,27.96,-1,-36371,50961,87332,14590,0,-18132,0,0,0,,18132,-18132
22,06-01-17,36,8:45,9:00,,38.49,0,38.49,38.49,-1,-59834,58137,117971,-1697,0,-6503,0,0,0,,6503,-6503
22,06-01-17,37,9:00,9:15,30.89,41.56,0,35.21,35.21,2,-54255,50214,104469,-4041,0,-20,250,0,0,,270,230
22,06-01-17,38,9:15,9:30,44.67,41.56,0,44.67,44.67,1,-64914,42652,107566,-22262,0,-20,3617,0,0,,3637,3597
22,06-01-17,39,9:30,9:45,44.67,27.96,0,27.96,27.96,-1,-53910,54642,108552,732,0,-850,8242,0,0,,9092,7392
22,06-01-17,40,9:45,10:00,29.33,23.96,0,35.21,23.96,2,-53177,51677,104854,-1500,0,-4680,172,0,0,,4852,-4508
22,06-01-17,41,10:00,10:15,29.03,41.58,0,35.22,35.22,2,-65007,84372,149379,19365,0,-6,1056,0,0,,1062,1050
22,06-01-17,42,10:15,10:30,,27.96,0,27.96,27.96,-1,-60168,66524,126692,6356,0,-1943,0,0,0,,1943,-1943
22,06-01-17,43,10:30,10:45,,30.59,0,30.59,30.59,-1,-58009,66733,124742,8724,0,-361,0,0,0,,361,-361
22,06-01-17,44,10:45,11:00,,30.59,0,30.59,30.59,-1,-59585,65147,124732,5562,0,-374,0,0,0,,374,-374
22,06-01-17,45,11:00,11:15,,27.96,0,27.96,27.96,-1,-59910,91521,151431,31611,0,-1560,0,0,0,,1560,-1560
22,06-01-17,46,11:15,11:30,,,0,29.92,29.92,0,-58794,89418,148212,30624,0,-154,0,0,0,,154,-154
22,06-01-17,47,11:30,11:45,,,0,29.92,29.92,0,-52171,86369,138540,34198,0,0,0,0,0,,0,0
22,06-01-17,48,11:45,12:00,,,0,35.41,35.41,0,-51283,85369,136652,34086,0,0,0,0,0,,0,0
22,06-01-17,49,12:00,12:15,,,0,35.45,35.45,0,-63492,98284,161776,34792,0,0,0,0,0,,0,0
22,06-01-17,50,12:15,12:30,,,0,35.45,35.45,0,-67023,81419,148442,14396,0,0,0,0,0,,0,0
22,06-01-17,51,12:30,12:45,,,0,35.45,35.45,0,-65013,85743,150756,20730,0,0,0,0,0,,0,0
22,06-01-17,52,12:45,13:00,,,0,35.45,35.45,0,-66217,85817,152034,19600,0,0,0,0,0,,0,0
22,06-01-17,53,13:00,13:15,,28.96,0,28.96,28.96,-1,-46511,99912,146423,53401,0,-11,0,0,0,,11,-11
22,06-01-17,54,13:15,13:30,,,0,28.73,28.73,0,-65331,80219,145550,14888,0,0,0,0,0,,0,0
22,06-01-17,55,13:30,13:45,,,0,28.73,28.73,0,-65491,77888,143379,12397,0,0,0,0,0,,0,0
22,06-01-17,56,13:45,14:00,,,0,28.68,28.68,0,-67287,73147,140434,5860,0,0,0,0,0,,0,0
22,06-01-17,57,14:00,14:15,30.96,,0,30.96,30.96,1,-78606,65045,143651,-13561,0,0,3982,0,0,,3982,3982
22,06-01-17,58,14:15,14:30,29.03,,0,29.03,29.03,1,-60033,68964,128997,8931,0,0,3178,0,0,,3178,3178
22,06-01-17,59,14:30,14:45,,,0,29.17,29.17,0,-62903,69818,132721,6915,0,0,0,0,0,,0,0
22,06-01-17,60,14:45,15:00,29.03,,0,29.03,29.03,1,-69053,65540,134593,-3513,0,0,1913,0,0,,1913,1913
22,06-01-17,61,15:00,15:15,40.96,,0,40.96,40.96,1,-95099,64843,159942,-30256,0,0,15843,0,0,,15843,15843
22,06-01-17,62,15:15,15:30,30.29,,0,30.29,30.29,1,-66994,57824,124818,-9170,0,0,12111,0,0,,12111,12111
22,06-01-17,63,15:30,15:45,31.69,,0,31.69,31.69,1,-66086,47101,113187,-18985,0,0,8690,0,0,,8690,8690
22,06-01-17,64,15:45,16:00,31.65,,0,31.65,31.65,1,-76449,39680,116129,-36769,0,0,21163,0,0,,21163,21163
22,06-01-17,65,16:00,16:15,29.75,28.59,0,43.79,28.59,2,-58092,71694,129786,13602,0,-694,10633,0,0,,11327,9939
22,06-01-17,66,16:15,16:30,29.75,30.99,0,30.99,30.99,-1,-43256,71351,114607,28095,0,-495,23,0,0,,518,-472
22,06-01-17,67,16:30,16:45,28.96,30.89,0,28.96,28.96,1,-64029,67785,131814,3756,0,-634,50,0,0,,684,-584
22,06-01-17,68,16:45,17:00,28.96,,0,28.96,28.96,1,-76420,68276,144696,-8144,0,0,1754,0,0,,1754,1754
22,06-01-17,69,17:00,17:15,29.75,,0,29.75,29.75,1,-68997,66956,135953,-2041,0,0,2087,0,0,,2087,2087
22,06-01-17,70,17:15,17:30,29.75,,0,29.75,29.75,1,-46921,56763,103684,9842,0,0,2112,0,0,,2112,2112
22,06-01-17,71,17:30,17:45,,,0,43.78,43.78,0,-39127,52720,91847,13593,0,0,14,0,0,,14,14
22,06-01-17,72,17:45,18:00,,40.91,0,40.91,40.91,-1,-39978,68077,108055,28099,0,-345,0,0,0,,345,-345
22,06-01-17,73,18:00,18:15,45,40.91,0,45,45,1,-55982,29856,85838,-26126,0,-91,10336,0,0,,10427,10245
22,06-01-17,74,18:15,18:30,29.75,,0,29.75,29.75,1,-33966,37644,71610,3678,0,0,4189,0,0,,4189,4189
22,06-01-17,75,18:30,18:45,30.29,,0,30.29,30.29,1,-35070,39553,74623,4483,0,0,1848,0,0,,1848,1848
22,06-01-17,76,18:45,19:00,29.75,,0,29.75,29.75,1,-36245,42118,78363,5873,0,0,1677,0,0,,1677,1677
22,06-01-17,77,19:00,19:15,45,,0,45,45,1,-52645,36909,89554,-15736,0,0,7389,0,0,,7389,7389
22,06-01-17,78,19:15,19:30,31.09,,0,31.09,31.09,1,-43969,28660,72629,-15309,0,0,14191,0,0,,14191,14191
22,06-01-17,79,19:30,19:45,30.96,,0,30.96,30.96,1,-47606,34292,81898,-13314,0,0,14128,0,0,,14128,14128
22,06-01-17,80,19:45,20:00,31.29,,0,31.29,31.29,1,-45389,28565,73954,-16824,0,0,15550,0,0,,15550,15550
22,06-01-17,81,20:00,20:15,44.9,,0,44.9,44.9,1,-61317,23501,84818,-37816,0,0,18855,0,0,,18855,18855
22,06-01-17,82,20:15,20:30,55.9,,0,55.9,55.9,1,-56924,22700,79624,-34224,0,0,27342,0,0,,27342,27342
22,06-01-17,83,20:30,20:45,30.96,,0,30.96,30.96,1,-43840,22033,65873,-21807,0,0,19553,0,0,,19553,19553
22,06-01-17,84,20:45,21:00,39.9,,0,39.9,39.9,1,-49467,25828,75295,-23639,0,0,14503,0,0,,14503,14503
22,06-01-17,85,21:00,21:15,39.91,,0,39.91,39.91,1,-63485,32441,95926,-31044,0,0,12309,0,0,,12309,12309
22,06-01-17,86,21:15,21:30,32.89,,0,32.89,32.89,1,-47891,30236,78127,-17655,0,0,15257,0,0,,15257,15257
22,06-01-17,87,21:30,21:45,30.96,,0,30.96,30.96,1,-40788,33245,74033,-7543,0,0,3107,0,0,,3107,3107
22,06-01-17,88,21:45,22:00,29.03,,0,29.03,29.03,1,-43068,44937,88005,1869,0,0,1066,0,0,,1066,1066
22,06-01-17,89,22:00,22:15,39.95,,0,39.95,39.95,1,-59239,30673,89912,-28566,0,0,4430,0,0,,4430,4430
22,06-01-17,90,22:15,22:30,39.95,,0,39.95,39.95,1,-66945,20980,87925,-45965,0,0,16987,0,0,,16987,16987
22,06-01-17,91,22:30,22:45,65,,0,65,65,1,-62628,28883,91511,-33745,0,0,26800,0,0,,26800,26800
22,06-01-17,92,22:45,23:00,30.96,40.1,0,40.1,40.1,-1,-48080,43986,92066,-4094,0,-37,15496,0,0,,15533,15459
22,06-01-17,93,23:00,23:15,256.85,40.07,0,256.85,34.76,2,-108440,25623,134063,-82817,0,-58,25762,0,0,,25820,25704
22,06-01-17,94,23:15,23:30,43.81,,0,43.81,43.81,1,-56764,35122,91886,-21642,0,0,26150,0,0,,26150,26150
22,06-01-17,95,23:30,23:45,43.81,27.96,0,27.96,27.96,-1,-33544,40811,74355,7267,0,-1857,1810,0,0,,3667,-47
22,06-01-17,96,23:45,0:00,,40.07,0,40.07,40.07,-1,-62774,49317,112091,-13457,0,-470,0,0,0,,470,-470
22,06-02-17,1,0:00,0:15,129.12,,0,129.12,129.12,1,-97864,66654,164518,-31210,0,0,13881,0,0,,13881,13881
22,06-02-17,2,0:15,0:30,129.12,,0,129.12,129.12,1,-64285,42188,106473,-22097,0,0,39329,0,0,,39329,39329
22,06-02-17,3,0:30,0:45,28.48,,0,28.48,28.48,1,-78544,47946,126490,-30598,0,0,5747,0,0,,5747,5747
22,06-02-17,4,0:45,1:00,,,0,34.15,34.15,0,-71676,60003,131679,-11673,0,0,0,0,0,,0,0
22,06-02-17,5,1:00,1:15,28.48,,0,28.48,28.48,1,-75626,62937,138563,-12689,0,0,950,0,0,,950,950
22,06-02-17,6,1:15,1:30,32.15,,0,32.15,32.15,1,-57139,34258,91397,-22881,0,0,6798,0,0,,6798,6798
22,06-02-17,7,1:30,1:45,30.27,,0,30.27,30.27,1,-61698,39346,101044,-22352,0,0,12587,0,0,,12587,12587
22,06-02-17,8,1:45,2:00,26.15,26.19,0,26.19,26.19,-1,-61793,49488,111281,-12305,0,-212,4382,0,0,,4594,4170
22,06-02-17,9,2:00,2:15,27.63,26.19,0,34.13,26.19,2,-39697,46426,86123,6729,0,-2245,47,0,0,,2292,-2198
22,06-02-17,10,2:15,2:30,38.15,26.19,0,38.15,38.15,1,-51204,21520,72724,-29684,0,-1,11488,0,0,,11489,11487
22,06-02-17,11,2:30,2:45,29.74,,0,29.74,29.74,1,-51023,24765,75788,-26258,0,0,13609,0,0,,13609,13609
22,06-02-17,12,2:45,3:00,26.15,,0,26.15,26.15,1,-45358,27335,72693,-18023,0,0,5280,0,0,,5280,5280
22,06-02-17,13,3:00,3:15,38.15,,0,38.15,38.15,1,-52219,22843,75062,-29376,0,0,7822,0,0,,7822,7822
22,06-02-17,14,3:15,3:30,39.29,,0,39.29,39.29,1,-46703,25583,72286,-21120,0,0,25117,0,0,,25117,25117
22,06-02-17,15,3:30,3:45,30.33,,0,30.33,30.33,1,-51010,24948,75958,-26062,0,0,6266,0,0,,6266,6266
22,06-02-17,16,3:45,4:00,32.15,,0,32.15,32.15,1,-46355,23376,69731,-22979,0,0,14529,0,0,,14529,14529
22,06-02-17,17,4:00,4:15,28.48,,0,28.48,28.48,1,-50926,25964,76890,-24962,0,0,10841,0,0,,10841,10841
22,06-02-17,18,4:15,4:30,32.15,,0,32.15,32.15,1,-65776,25164,90940,-40612,0,0,15036,0,0,,15036,15036
22,06-02-17,19,4:30,4:45,29.2,,0,29.2,29.2,1,-64108,26226,90334,-37882,0,0,17021,0,0,,17021,17021
22,06-02-17,20,4:45,5:00,38.15,,0,38.15,38.15,1,-70958,34065,105023,-36893,0,0,21650,0,0,,21650,21650
22,06-02-17,21,5:00,5:15,28.15,,0,28.15,28.15,1,-77800,24418,102218,-53382,0,0,9799,0,0,,9799,9799
22,06-02-17,22,5:15,5:30,,,0,28.77,28.77,0,-59640,25640,85280,-34000,0,0,33,0,0,,33,33
22,06-02-17,23,5:30,5:45,,,0,28.77,28.77,0,-57887,19699,77586,-38188,0,0,0,0,0,,0,0
22,06-02-17,24,5:45,6:00,28.15,,0,28.15,28.15,1,-76508,19962,96470,-56546,0,0,356,0,0,,356,356
22,06-02-17,25,6:00,6:15,,,0,33.81,33.81,0,-101317,61103,162420,-40214,0,0,0,0,0,,0,0
22,06-02-17,26,6:15,6:30,39.29,,0,39.29,39.29,1,-68527,31660,100187,-36867,0,0,2126,0,0,,2126,2126
22,06-02-17,27,6:30,6:45,48.99,,0,48.99,48.99,1,-76806,26451,103257,-50355,0,0,24477,0,0,,24477,24477
22,06-02-17,28,6:45,7:00,41.33,,0,41.33,41.33,1,-77842,31598,109440,-46244,0,0,29604,0,0,,29604,29604
22,06-02-17,29,7:00,7:15,31.09,18.1,0,34.83,18.1,2,-63952,84121,148073,20169,0,-3592,12569,0,0,,16161,8977
22,06-02-17,30,7:15,7:30,29.2,18.1,0,29.2,29.2,1,-48233,60942,109175,12709,0,-68,663,0,0,,731,595
22,06-02-17,31,7:30,7:45,,40.32,0,40.32,40.32,-1,-56253,62781,119034,6528,0,-105,0,0,0,,105,-105
22,06-02-17,32,7:45,8:00,28.3,,0,28.3,28.3,1,-83578,68036,151614,-15542,0,0,454,0,0,,454,454
22,06-02-17,33,8:00,8:15,28.78,,0,28.78,28.78,1,-45663,66888,112551,21225,0,0,1406,0,0,,1406,1406
22,06-02-17,34,8:15,8:30,28.78,,0,28.78,28.78,1,-54891,50309,105200,-4582,0,0,3299,0,0,,3299,3299
22,06-02-17,35,8:30,8:45,36.5,,0,36.5,36.5,1,-72399,43169,115568,-29230,0,0,10874,0,0,,10874,10874
22,06-02-17,36,8:45,9:00,48.99,,0,48.99,48.99,1,-86496,43307,129803,-43189,0,0,13972,0,0,,13972,13972
22,06-02-17,37,9:00,9:15,109.22,38.97,0,109.22,34.87,2,-39422,49440,88862,10018,0,-55,22487,0,0,,22542,22432
22,06-02-17,38,9:15,9:30,109.22,26.19,0,26.19,26.19,-1,-42916,73680,116596,30764,0,-504,831,0,0,,1335,327
22,06-02-17,39,9:30,9:45,,41.97,0,41.97,41.97,-1,-52088,71942,124030,19854,0,-239,0,0,0,,239,-239
22,06-02-17,40,9:45,10:00,,,0,34.87,34.87,0,-48035,61845,109880,13810,0,0,0,0,0,,0,0
22,06-02-17,41,10:00,10:15,,40.89,0,40.89,40.89,-1,-50825,91189,142014,40364,0,-9,0,0,0,,9,-9
22,06-02-17,42,10:15,10:30,,40.89,0,40.89,40.89,-1,-49302,85893,135195,36591,0,-151,0,0,0,,151,-151
22,06-02-17,43,10:30,10:45,,,0,34.33,34.33,0,-64642,73690,138332,9048,0,0,0,0,0,,0,0
22,06-02-17,44,10:45,11:00,28.48,,0,28.48,28.48,1,-71938,64116,136054,-7822,0,0,1170,0,0,,1170,1170
22,06-02-17,45,11:00,11:15,28.78,,0,28.78,28.78,1,-84175,56493,140668,-27682,0,0,6399,0,0,,6399,6399
22,06-02-17,46,11:15,11:30,29.74,,0,29.74,29.74,1,-83002,56223,139225,-26779,0,0,11551,0,0,,11551,11551
22,06-02-17,47,11:30,11:45,29.74,,0,29.74,29.74,1,-89332,52691,142023,-36641,0,0,12476,0,0,,12476,12476
22,06-02-17,48,11:45,12:00,32.89,,0,32.89,32.89,1,-89371,49531,138902,-39840,0,0,12005,0,0,,12005,12005
22,06-02-17,49,12:00,12:15,27.76,,0,27.76,27.76,1,-88671,67528,156199,-21143,0,0,6337,0,0,,6337,6337
22,06-02-17,50,12:15,12:30,149.72,,0,237.34,237.34,1,-314354,78363,392717,-235991,0,0,42391,0,9583,,51974,51974
22,06-02-17,51,12:30,12:45,187.34,26.44,0,26.44,26.44,-1,-308025,210073,518098,-97952,0,-33,55054,15000,82040,,152127,152061
22,06-02-17,52,12:45,13:00,187.34,26.11,0,237.34,26.11,2,-301737,242535,544272,-59202,0,-254,5592,20000,27088,,52934,52426
22,06-02-17,53,13:00,13:15,48.99,,0,48.99,48.99,1,-275118,219222,494340,-55896,0,0,42934,0,0,,42934,42934
22,06-02-17,54,13:15,13:30,131.99,,0,131.99,131.99,1,-280534,196988,477522,-83546,0,0,70053,0,0,,70053,70053
22,06-02-17,55,13:30,13:45,92.99,,0,92.99,92.99,1,-281992,205746,487738,-76246,0,0,73783,0,0,,73783,73783
22,06-02-17,56,13:45,14:00,77.58,,0,77.58,77.58,1,-285417,205319,490736,-80098,0,0,70027,0,0,,70027,70027
22,06-02-17,57,14:00,14:15,77.58,25.77,0,25.77,25.77,-1,-210424,245137,455561,34713,0,-199,23327,0,0,,23526,23128
22,06-02-17,58,14:15,14:30,25.76,,0,25.76,25.76,1,-207849,215484,423333,7635,0,0,34,0,0,,34,34
22,06-02-17,59,14:30,14:45,28.78,,0,28.78,28.78,1,-204538,203747,408285,-791,0,0,934,0,0,,934,934
22,06-02-17,60,14:45,15:00,29.2,,0,29.2,29.2,1,-199910,183922,383832,-15988,0,0,7951,0,0,,7951,7951
22,06-02-17,61,15:00,15:15,27.76,,0,27.76,27.76,1,-175742,170954,346696,-4788,0,0,5593,0,0,,5593,5593
22,06-02-17,62,15:15,15:30,28.48,,0,28.48,28.48,1,-170523,162573,333096,-7950,0,0,5030,0,0,,5030,5030
22,06-02-17,63,15:30,15:45,27.76,,0,27.76,27.76,1,-159662,158374,318036,-1288,0,0,6075,0,0,,6075,6075
22,06-02-17,64,15:45,16:00,27.76,25.77,0,25.77,25.77,-1,-156168,160143,316311,3975,0,-1502,1110,0,0,,2612,-392
22,06-02-17,65,16:00,16:15,,12.83,0,12.83,12.83,-1,-111689,158338,270027,46649,0,-16456,0,0,0,,16456,-16456
22,06-02-17,66,16:15,16:30,,20.76,0,20.76,20.76,-1,-109551,135553,245104,26002,0,-30074,0,0,0,,30074,-30074
22,06-02-17,67,16:30,16:45,,24.39,0,24.39,24.39,-1,-102862,136179,239041,33317,0,-16730,0,0,0,,16730,-16730
22,06-02-17,68,16:45,17:00,,24.39,0,24.39,24.39,-1,-121384,139296,260680,17912,0,-18063,0,0,0,,18063,-18063
22,06-02-17,69,17:00,17:15,,20.76,0,20.76,20.76,-1,-147980,182109,330089,34129,0,-11379,0,0,0,,11379,-11379
22,06-02-17,70,17:15,17:30,,26.19,0,26.19,26.19,-1,-130270,168781,299051,38511,0,-967,0,0,0,,967,-967
22,06-02-17,71,17:30,17:45,,24.71,0,24.71,24.71,-1,-121165,150297,271462,29132,0,-3468,0,0,0,,3468,-3468
22,06-02-17,72,17:45,18:00,29.7,24.71,0,29.7,29.7,1,-124455,152779,277234,28324,0,-132,68,0,0,,200,-64
22,06-02-17,73,18:00,18:15,239.61,,0,239.61,239.61,1,-218258,132068,350326,-86190,0,0,35956,0,0,,35956,35956
22,06-02-17,74,18:15,18:30,27.76,31.39,0,31.39,31.39,-1,-188873,213534,402407,24661,0,-743,13289,0,0,,14032,12546
22,06-02-17,75,18:30,18:45,,20.76,0,20.76,20.76,-1,-185734,214251,399985,28517,0,-10395,0,0,0,,10395,-10395
22,06-02-17,76,18:45,19:00,,,0,34.35,34.35,0,-180208,191986,372194,11778,0,-2063,0,0,0,,2063,-2063
22,06-02-17,77,19:00,19:15,50.9,,0,50.9,50.9,1,-146193,128538,274731,-17655,0,0,6047,0,0,,6047,6047
22,06-02-17,78,19:15,19:30,27.76,,0,27.76,27.76,1,-57951,106169,164120,48218,0,0,1171,0,0,,1171,1171
22,06-02-17,79,19:30,19:45,,40.38,0,40.38,40.38,-1,-49603,101345,150948,51742,0,-31,0,0,0,,31,-31
22,06-02-17,80,19:45,20:00,,39.38,0,39.38,39.38,-1,-30795,95414,126209,64619,0,-1544,0,0,0,,1544,-1544
22,06-02-17,81,20:00,20:15,,39.2,0,39.2,39.2,-1,-78516,96771,175287,18255,0,-955,0,0,0,,955,-955
22,06-02-17,82,20:15,20:30,,,0,34.41,34.41,0,-42758,91831,134589,49073,0,0,0,0,0,,0,0
22,06-02-17,83,20:30,20:45,,,0,34.41,34.41,0,-31741,100656,132397,68915,0,0,0,0,0,,0,0
22,06-02-17,84,20:45,21:00,,,0,34.41,34.41,0,-24093,106916,131009,82823,0,0,0,0,0,,0,0
22,06-02-17,85,21:00,21:15,47.98,,0,47.98,47.98,1,-100583,44496,145079,-56087,0,0,4414,0,0,,4414,4414
22,06-02-17,86,21:15,21:30,47.99,,0,47.99,47.99,1,-83542,42013,125555,-41529,0,0,18723,0,0,,18723,18723
22,06-02-17,87,21:30,21:45,36.98,,0,36.98,36.98,1,-67673,52358,120031,-15315,0,0,16690,0,0,,16690,16690
22,06-02-17,88,21:45,22:00,,,0,34.4,34.4,0,-77442,57250,134692,-20192,0,0,1202,0,0,,1202,1202
22,06-02-17,89,22:00,22:15,28.21,,0,28.21,28.21,1,-127080,62933,190013,-64147,0,0,532,0,0,,532,532
22,06-02-17,90,22:15,22:30,28.9,,0,28.9,28.9,1,-158376,50314,208690,-108062,0,0,2070,0,0,,2070,2070
22,06-02-17,91,22:30,22:45,132.79,,0,132.79,132.79,1,-130879,53930,184809,-76949,0,0,6885,0,0,,6885,6885
22,06-02-17,92,22:45,23:00,29.37,,0,29.37,29.37,1,-130448,73010,203458,-57438,0,0,3469,0,0,,3469,3469
22,06-02-17,93,23:00,23:15,51.47,,0,51.47,51.47,1,-126233,99081,225314,-27152,0,0,13897,0,0,,13897,13897
22,06-02-17,94,23:15,23:30,33.27,,0,33.27,33.27,1,-108834,75753,184587,-33081,0,0,23967,0,0,,23967,23967
22,06-02-17,95,23:30,23:45,42.64,,0,42.64,42.64,1,-86590,56750,143340,-29840,0,0,22059,0,0,,22059,22059
22,06-02-17,96,23:45,0:00,240.69,,0,240.69,240.69,1,-141938,49636,191574,-92302,0,0,40665,0,0,,40665,40665
23,06-03-17,1,0:00,0:15,180.71,,0,180.71,180.71,1,-135301,72629,207930,-62672,0,0,44713,0,0,,44713,44713
23,06-03-17,2,0:15,0:30,180.71,,0,180.71,180.71,1,-111867,49911,161778,-61956,0,0,67676,0,0,,67676,67676
23,06-03-17,3,0:30,0:45,69.43,,0,69.43,69.43,1,-120546,68362,188908,-52184,0,0,41186,0,0,,41186,41186
23,06-03-17,4,0:45,1:00,37.71,27.64,0,27.64,27.64,-1,-111049,78847,189896,-32202,0,-119,19909,0,0,,20028,19790
23,06-03-17,5,1:00,1:15,,27.99,0,27.99,27.99,-1,-68361,140157,208518,71796,0,-328,0,0,0,,328,-328
23,06-03-17,6,1:15,1:30,30.22,,0,30.22,30.22,1,-79508,57387,136895,-22121,0,0,1299,0,0,,1299,1299
23,06-03-17,7,1:30,1:45,130.02,,0,130.02,130.02,1,-99565,51351,150916,-48214,0,0,25083,0,0,,25083,25083
23,06-03-17,8,1:45,2:00,32.12,,0,32.12,32.12,1,-76514,63375,139889,-13139,0,0,13161,0,0,,13161,13161
23,06-03-17,9,2:00,2:15,28.22,29.99,0,29.99,29.99,-1,-49552,75209,124761,25657,0,-181,2579,0,0,,2760,2398
23,06-03-17,10,2:15,2:30,28.22,29.99,0,28.22,28.22,1,-64547,59743,124290,-4804,0,-130,53,0,0,,183,-77
23,06-03-17,11,2:30,2:45,29.02,,0,29.02,29.02,1,-58602,53048,111650,-5554,0,0,747,0,0,,747,747
23,06-03-17,12,2:45,3:00,28.22,25.49,0,25.49,25.49,-1,-48760,60421,109181,11661,0,-1503,191,0,0,,1694,-1312
23,06-03-17,13,3:00,3:15,,24.61,0,24.61,24.61,-1,-42565,69671,112236,27106,0,-2537,0,0,0,,2537,-2537
23,06-03-17,14,3:15,3:30,,,0,34.58,34.58,0,-51962,73524,125486,21562,0,0,0,0,0,,0,0
23,06-03-17,15,3:30,3:45,,,0,34.58,34.58,0,-49977,67698,117675,17721,0,0,0,0,0,,0,0
23,06-03-17,16,3:45,4:00,,,0,34.58,34.58,0,-50776,69211,119987,18435,0,0,0,0,0,,0,0
23,06-03-17,17,4:00,4:15,30.22,31.99,0,34.57,31.99,2,-42372,47131,89503,4759,0,-211,542,0,0,,753,331
23,06-03-17,18,4:15,4:30,30.44,,0,30.44,30.44,1,-61115,47305,108420,-13810,0,0,7562,0,0,,7562,7562
23,06-03-17,19,4:30,4:45,28.22,,0,28.22,28.22,1,-54133,48352,102485,-5781,0,0,2150,0,0,,2150,2150
23,06-03-17,20,4:45,5:00,29.18,,0,29.18,29.18,1,-53856,45479,99335,-8377,0,0,1168,0,0,,1168,1168
23,06-03-17,21,5:00,5:15,40.39,,0,40.39,40.39,1,-68164,32744,100908,-35420,0,0,14363,0,0,,14363,14363
23,06-03-17,22,5:15,5:30,30.22,28.91,0,28.91,28.91,-1,-36477,31543,68020,-4934,0,-75,9047,0,0,,9122,8972
23,06-03-17,23,5:30,5:45,30.22,27.99,0,27.99,27.99,-1,-44435,34741,79176,-9694,0,-1512,223,0,0,,1735,-1289
23,06-03-17,24,5:45,6:00,,,0,34.59,34.59,0,-43198,40111,83309,-3087,0,-25,0,0,0,,25,-25
23,06-03-17,25,6:00,6:15,,28.38,0,28.38,28.38,-1,-44640,48387,93027,3747,0,-354,0,0,0,,354,-354
23,06-03-17,26,6:15,6:30,28.38,28.38,0,28.38,28.38,1,-58048,41541,99589,-16507,0,-1214,59,0,0,,1273,-1155
23,06-03-17,27,6:30,6:45,30.38,,0,30.38,30.38,1,-55230,44396,99626,-10834,0,0,1542,0,0,,1542,1542
23,06-03-17,28,6:45,7:00,34.38,,0,34.38,34.38,1,-67734,50140,117874,-17594,0,0,10482,0,0,,10482,10482
23,06-03-17,29,7:00,7:15,29.86,,0,29.86,29.86,1,-80875,60039,140914,-20836,0,0,5252,0,0,,5252,5252
23,06-03-17,30,7:15,7:30,29.26,,0,29.26,29.26,1,-55463,48899,104362,-6564,0,0,676,0,0,,676,676
23,06-03-17,31,7:30,7:45,54.96,,0,54.96,54.96,1,-88441,37187,125628,-51254,0,0,20947,0,0,,20947,20947
23,06-03-17,32,7:45,8:00,40.38,,0,40.38,40.38,1,-90870,32205,123075,-58665,0,0,41731,0,0,,41731,41731
23,06-03-17,33,8:00,8:15,34.38,,0,34.38,34.38,1,-65535,44359,109894,-21176,0,0,18432,0,0,,18432,18432
23,06-03-17,34,8:15,8:30,54.34,,0,54.34,54.34,1,-71003,21959,92962,-49044,0,0,15472,0,0,,15472,15472
23,06-03-17,35,8:30,8:45,46.45,,0,46.45,46.45,1,-95042,19128,114170,-75914,0,0,25030,0,0,,25030,25030
23,06-03-17,36,8:45,9:00,130.04,,0,130.04,130.04,1,-102548,16189,118737,-86359,0,0,53012,0,0,,53012,53012
23,06-03-17,37,9:00,9:15,130.04,27.99,0,27.99,27.99,-1,-25476,77024,102500,51548,0,-205,15325,0,0,,15530,15120
23,06-03-17,38,9:15,9:30,,,0,29.51,29.51,0,-48789,74768,123557,25979,0,0,0,0,0,,0,0
23,06-03-17,39,9:30,9:45,30.38,,0,30.38,30.38,1,-73681,64205,137886,-9476,0,0,486,0,0,,486,486
23,06-03-17,40,9:45,10:00,34.38,,0,34.38,34.38,1,-101220,65748,166968,-35472,0,0,9851,0,0,,9851,9851
23,06-03-17,41,10:00,10:15,29.86,28.38,0,28.38,28.38,-1,-74338,80238,154576,5900,0,-282,7473,0,0,,7755,7191
23,06-03-17,42,10:15,10:30,29.86,28.38,0,28.38,28.38,-1,-48519,66372,114891,17853,0,-598,247,0,0,,845,-351
23,06-03-17,43,10:30,10:45,,25.49,0,25.49,25.49,-1,-46443,63049,109492,16606,0,-1050,0,0,0,,1050,-1050
23,06-03-17,44,10:45,11:00,,25.49,0,25.49,25.49,-1,-45833,73544,119377,27711,0,-3391,0,0,0,,3391,-3391
23,06-03-17,45,11:00,11:15,30.38,25.49,0,30.38,30.38,1,-63061,33175,96236,-29886,0,-88,1726,0,0,,1814,1638
23,06-03-17,46,11:15,11:30,36.89,,0,36.89,36.89,1,-66843,42400,109243,-24443,0,0,9370,0,0,,9370,9370
23,06-03-17,47,11:30,11:45,30.38,,0,30.38,30.38,1,-51594,42990,94584,-8604,0,0,5455,0,0,,5455,5455
23,06-03-17,48,11:45,12:00,32.26,,0,32.26,32.26,1,-50672,33175,83847,-17497,0,0,8583,0,0,,8583,8583
23,06-03-17,49,12:00,12:15,210.24,,0,210.24,210.24,1,-89871,30046,119917,-59825,0,0,32200,0,0,,32200,32200
23,06-03-17,50,12:15,12:30,37.31,38.14,0,38.14,38.14,-1,-51314,56061,107375,4747,0,-382,19170,0,0,,19552,18788
23,06-03-17,51,12:30,12:45,37.31,38.95,0,38.95,38.95,-1,-55453,70617,126070,15164,0,-371,166,0,0,,537,-205
23,06-03-17,52,12:45,13:00,29.86,,0,29.86,29.86,1,-52503,68352,120855,15849,0,0,13,0,0,,13,13
23,06-03-17,53,13:00,13:15,51.63,,0,51.63,51.63,1,-113796,72581,186377,-41215,0,0,12579,0,0,,12579,12579
23,06-03-17,54,13:15,13:30,34.38,,0,34.38,34.38,1,-112243,100932,213175,-11311,0,0,17817,0,0,,17817,17817
23,06-03-17,55,13:30,13:45,34.38,28.38,0,28.38,28.38,-1,-99575,130843,230418,31268,0,-1177,3969,0,0,,5146,2792
23,06-03-17,56,13:45,14:00,,27.38,0,27.38,27.38,-1,-99179,140228,239407,41049,0,-3023,0,0,0,,3023,-3023
23,06-03-17,57,14:00,14:15,,-23.68,0,-23.68,-23.68,-1,-90497,125914,216411,35417,0,-28645,0,0,0,,28645,-28645
23,06-03-17,58,14:15,14:30,,27.99,0,27.99,27.99,-1,-90021,104002,194023,13981,0,-4322,0,0,0,,4322,-4322
23,06-03-17,59,14:30,14:45,,28.03,0,28.03,28.03,-1,-67351,120045,187396,52694,0,-1797,0,0,0,,1797,-1797
23,06-03-17,60,14:45,15:00,,25.49,0,25.49,25.49,-1,-48304,117337,165641,69033,0,-3064,0,0,0,,3064,-3064
23,06-03-17,61,15:00,15:15,,25.06,0,25.06,25.06,-1,-28081,81619,109700,53538,0,-2979,0,0,0,,2979,-2979
23,06-03-17,62,15:15,15:30,,27.17,0,27.17,27.17,-1,-32599,106198,138797,73599,0,-1455,0,0,0,,1455,-1455
23,06-03-17,63,15:30,15:45,,27.89,0,27.89,27.89,-1,-33659,98888,132547,65229,0,-3103,0,0,0,,3103,-3103
23,06-03-17,64,15:45,16:00,,24.06,0,24.06,24.06,-1,-33686,98568,132254,64882,0,-3335,0,0,0,,3335,-3335
23,06-03-17,65,16:00,16:15,,24.06,0,24.06,24.06,-1,-48008,81325,129333,33317,0,-2022,0,0,0,,2022,-2022
23,06-03-17,66,16:15,16:30,,27.99,0,27.99,27.99,-1,-60657,83175,143832,22518,0,-135,0,0,0,,135,-135
23,06-03-17,67,16:30,16:45,,24.06,0,24.06,24.06,-1,-51751,85640,137391,33889,0,-6658,0,0,0,,6658,-6658
23,06-03-17,68,16:45,17:00,,27.13,0,27.13,27.13,-1,-50807,69894,120701,19087,0,-7013,0,0,0,,7013,-7013
23,06-03-17,69,17:00,17:15,,29.03,0,29.03,29.03,-1,-56885,84481,141366,27596,0,-1231,0,0,0,,1231,-1231
23,06-03-17,70,17:15,17:30,,,0,30.19,30.19,0,-50724,69368,120092,18644,0,0,0,0,0,,0,0
23,06-03-17,71,17:30,17:45,,,0,30.19,30.19,0,-49797,50946,100743,1149,0,0,0,0,0,,0,0
23,06-03-17,72,17:45,18:00,28.38,,0,28.38,28.38,1,-43036,41990,85026,-1046,0,0,47,0,0,,47,47
23,06-03-17,73,18:00,18:15,28.38,,0,28.38,28.38,1,-45692,64300,109992,18608,0,0,444,0,0,,444,444
23,06-03-17,74,18:15,18:30,,,0,30.19,30.19,0,-35063,67395,102458,32332,0,0,0,0,0,,0,0
23,06-03-17,75,18:30,18:45,,,0,30.19,30.19,0,-28803,71842,100645,43039,0,0,0,0,0,,0,0
23,06-03-17,76,18:45,19:00,,,0,30.19,30.19,0,-29558,67615,97173,38057,0,0,0,0,0,,0,0
23,06-03-17,77,19:00,19:15,,,0,34.65,34.65,0,-29608,82743,112351,53135,0,0,0,0,0,,0,0
23,06-03-17,78,19:15,19:30,,,0,34.65,34.65,0,-36608,67435,104043,30827,0,0,0,0,0,,0,0
23,06-03-17,79,19:30,19:45,,,0,34.65,34.65,0,-38605,62614,101219,24009,0,0,0,0,0,,0,0
23,06-03-17,80,19:45,20:00,28.38,,0,28.38,28.38,1,-44761,53456,98217,8695,0,0,104,0,0,,104,104
23,06-03-17,81,20:00,20:15,29.43,,0,29.43,29.43,1,-59877,57282,117159,-2595,0,0,1988,0,0,,1988,1988
23,06-03-17,82,20:15,20:30,29.19,,0,29.19,29.19,1,-46246,54829,101075,8583,0,0,1491,0,0,,1491,1491
23,06-03-17,83,20:30,20:45,30.23,,0,30.23,30.23,1,-59688,53001,112689,-6687,0,0,2368,0,0,,2368,2368
23,06-03-17,84,20:45,21:00,29.19,,0,29.19,29.19,1,-58169,53649,111818,-4520,0,0,3349,0,0,,3349,3349
23,06-03-17,85,21:00,21:15,34.38,,0,34.38,34.38,1,-65507,43302,108809,-22205,0,0,7565,0,0,,7565,7565
23,06-03-17,86,21:15,21:30,31.17,,0,31.17,31.17,1,-59497,42939,102436,-16558,0,0,12055,0,0,,12055,12055
23,06-03-17,87,21:30,21:45,40.39,,0,40.39,40.39,1,-69147,40598,109745,-28549,0,0,13554,0,0,,13554,13554
23,06-03-17,88,21:45,22:00,42.97,,0,42.97,42.97,1,-76510,42670,119180,-33840,0,0,26758,0,0,,26758,26758
23,06-03-17,89,22:00,22:15,29.9,,0,29.9,29.9,1,-75403,47736,123139,-27667,0,0,11203,0,0,,11203,11203
23,06-03-17,90,22:15,22:30,,27.38,0,27.38,27.38,-1,-61733,47495,109228,-14238,0,-130,0,0,0,,130,-130
23,06-03-17,91,22:30,22:45,,39.56,0,39.56,39.56,-1,-61829,66462,128291,4633,0,-1728,0,0,0,,1728,-1728
23,06-03-17,92,22:45,23:00,,27.99,0,27.99,27.99,-1,-43040,62362,105402,19322,0,-6353,0,0,0,,6353,-6353
23,06-03-17,93,23:00,23:15,28.38,28.38,0,28.38,28.38,1,-63085,45174,108259,-17911,0,-5570,161,0,0,,5731,-5409
23,06-03-17,94,23:15,23:30,28.38,28.38,0,35.15,28.38,2,-47209,45791,93000,-1418,0,-370,835,0,0,,1205,465
23,06-03-17,95,23:30,23:45,,27.38,0,27.38,27.38,-1,-46102,55727,101829,9625,0,-3473,0,0,0,,3473,-3473
23,06-03-17,96,23:45,0:00,,23.38,0,23.38,23.38,-1,-49653,54159,103812,4506,0,-9193,0,0,0,,9193,-9193
23,06-04-17,1,0:00,0:15,,-44.78,0,-44.78,-44.78,-1,-30416,139833,170249,109417,0,-27404,0,0,0,,27404,-27404
23,06-04-17,2,0:15,0:30,,23.02,0,23.02,23.02,-1,-41606,55466,97072,13860,0,-5995,0,0,0,,5995,-5995
23,06-04-17,3,0:30,0:45,,23.14,0,23.14,23.14,-1,-59638,62358,121996,2720,0,-8662,0,0,0,,8662,-8662
23,06-04-17,4,0:45,1:00,,23.38,0,23.38,23.38,-1,-65756,81709,147465,15953,0,-6837,0,0,0,,6837,-6837
23,06-04-17,5,1:00,1:15,48.46,26.99,0,48.46,48.46,1,-61282,42077,103359,-19205,0,-5653,4035,0,0,,9688,-1618
23,06-04-17,6,1:15,1:30,55.68,28.38,0,28.38,28.38,-1,-40866,45627,86493,4761,0,-72,7943,0,0,,8015,7871
23,06-04-17,7,1:30,1:45,55.68,27.38,0,27.38,27.38,-1,-35919,55008,90927,19089,0,-2732,27,0,0,,2759,-2705
23,06-04-17,8,1:45,2:00,,27.38,0,27.38,27.38,-1,-38621,57482,96103,18861,0,-4017,0,0,0,,4017,-4017
23,06-04-17,9,2:00,2:15,,28.98,0,28.98,28.98,-1,-22112,45867,67979,23755,0,-794,0,0,0,,794,-794
23,06-04-17,10,2:15,2:30,,,0,28.06,28.06,0,-20561,25040,45601,4479,0,0,0,0,0,,0,0
23,06-04-17,11,2:30,2:45,,24.7,0,24.7,24.7,-1,-16484,38199,54683,21715,0,-2155,0,0,0,,2155,-2155
23,06-04-17,12,2:45,3:00,,8.29,0,8.29,8.29,-1,-19114,61526,80640,42412,0,-27597,0,0,0,,27597,-27597
23,06-04-17,13,3:00,3:15,31.58,23.3,0,31.58,23.3,2,-45228,38435,83663,-6793,0,-17307,783,0,0,,18090,-16524
23,06-04-17,14,3:15,3:30,31.58,27.38,0,27.38,27.38,-1,-35291,34102,69393,-1189,0,-753,78,0,0,,831,-675
23,06-04-17,15,3:30,3:45,,27.38,0,27.38,27.38,-1,-32502,28246,60748,-4256,0,-3940,0,0,0,,3940,-3940
23,06-04-17,16,3:45,4:00,,27.38,0,27.38,27.38,-1,-43616,29516,73132,-14100,0,-4118,0,0,0,,4118,-4118
23,06-04-17,17,4:00,4:15,37.99,27.38,0,37.99,37.99,1,-66756,35724,102480,-31032,0,-200,4790,0,0,,4990,4590
23,06-04-17,18,4:15,4:30,30.38,,0,30.38,30.38,1,-55448,27305,82753,-28143,0,0,10323,0,0,,10323,10323
23,06-04-17,19,4:30,4:45,,,0,27.56,27.56,0,-57618,33246,90864,-24372,0,0,1465,0,0,,1465,1465
23,06-04-17,20,4:45,5:00,,,0,27.56,27.56,0,-48437,35573,84010,-12864,0,0,0,0,0,,0,0
23,06-04-17,21,5:00,5:15,30.56,,0,30.56,30.56,1,-58134,30026,88160,-28108,0,0,3557,0,0,,3557,3557
23,06-04-17,22,5:15,5:30,29.72,,0,29.72,29.72,1,-35804,28900,64704,-6904,0,0,6526,0,0,,6526,6526
23,06-04-17,23,5:30,5:45,29.72,28.38,0,28.38,28.38,-1,-23984,39063,63047,15079,0,-667,112,0,0,,779,-555
23,06-04-17,24,5:45,6:00,,23.87,0,23.87,23.87,-1,-22967,50992,73959,28025,0,-1104,0,0,0,,1104,-1104
23,06-04-17,25,6:00,6:15,,27.5,0,27.5,27.5,-1,-36659,40687,77346,4028,0,-2043,0,0,0,,2043,-2043
23,06-04-17,26,6:15,6:30,,28.5,0,28.5,28.5,-1,-26561,54978,81539,28417,0,-589,0,0,0,,589,-589
23,06-04-17,27,6:30,6:45,,29.03,0,29.03,29.03,-1,-21939,55401,77340,33462,0,-80,0,0,0,,80,-80
23,06-04-17,28,6:45,7:00,,28.5,0,28.5,28.5,-1,-22701,72594,95295,49893,0,-243,0,0,0,,243,-243
23,06-04-17,29,7:00,7:15,,25.49,0,25.49,25.49,-1,-21807,93125,114932,71318,0,-1490,0,0,0,,1490,-1490
23,06-04-17,30,7:15,7:30,,25.36,0,25.36,25.36,-1,-19534,97513,117047,77979,0,-4076,0,0,0,,4076,-4076
23,06-04-17,31,7:30,7:45,,27.5,0,27.5,27.5,-1,-20351,100297,120648,79946,0,-1001,0,0,0,,1001,-1001
23,06-04-17,32,7:45,8:00,,23.5,0,23.5,23.5,-1,-21451,100883,122334,79432,0,-2020,0,0,0,,2020,-2020
23,06-04-17,33,8:00,8:15,,-150.78,0,-150.78,-150.78,-1,-28704,73717,102421,45013,0,-33037,0,0,0,,33037,-33037
23,06-04-17,34,8:15,8:30,,12.78,0,12.78,12.78,-1,-29297,50759,80056,21462,0,-42521,0,0,0,,42521,-42521
23,06-04-17,35,8:30,8:45,,28.5,0,28.5,28.5,-1,-35517,41221,76738,5704,0,-7477,0,0,0,,7477,-7477
23,06-04-17,36,8:45,9:00,,25.22,0,25.22,25.22,-1,-36482,52541,89023,16059,0,-3609,0,0,0,,3609,-3609
23,06-04-17,37,9:00,9:15,,23.99,0,23.99,23.99,-1,-42508,53257,95765,10749,0,-11146,0,0,0,,11146,-11146
23,06-04-17,38,9:15,9:30,,28.5,0,28.5,28.5,-1,-38967,43131,82098,4164,0,-3823,0,0,0,,3823,-3823
23,06-04-17,39,9:30,9:45,,,0,28.08,28.08,0,-44479,45646,90125,1167,0,0,0,0,0,,0,0
23,06-04-17,40,9:45,10:00,28.5,,0,28.5,28.5,1,-52896,46325,99221,-6571,0,0,44,0,0,,44,44
23,06-04-17,41,10:00,10:15,28.5,,0,28.5,28.5,1,-84969,28478,113447,-56491,0,0,666,0,0,,666,666
23,06-04-17,42,10:15,10:30,30.5,,0,30.5,30.5,1,-93574,29126,122700,-64448,0,0,1460,0,0,,1460,1460
23,06-04-17,43,10:30,10:45,53.1,,0,53.1,53.1,1,-91560,32868,124428,-58692,0,0,18577,0,0,,18577,18577
23,06-04-17,44,10:45,11:00,39.49,,0,39.49,39.49,1,-84599,30129,114728,-54470,0,0,20053,0,0,,20053,20053
23,06-04-17,45,11:00,11:15,30.43,,0,30.43,30.43,1,-80509,77230,157739,-3279,0,0,12203,0,0,,12203,12203
23,06-04-17,46,11:15,11:30,29.64,,0,29.64,29.64,1,-69215,41551,110766,-27664,0,0,5376,0,0,,5376,5376
23,06-04-17,47,11:30,11:45,29.66,,0,29.66,29.66,1,-60657,32770,93427,-27887,0,0,3305,0,0,,3305,3305
23,06-04-17,48,11:45,12:00,28.5,,0,28.5,28.5,1,-67915,32374,100289,-35541,0,0,990,0,0,,990,990
23,06-04-17,49,12:00,12:15,31.17,,0,31.17,31.17,1,-84870,54598,139468,-30272,0,0,4560,0,0,,4560,4560
23,06-04-17,50,12:15,12:30,31.18,,0,31.18,31.18,1,-73830,60721,134551,-13109,0,0,8594,0,0,,8594,8594
23,06-04-17,51,12:30,12:45,31.18,27.5,0,27.5,27.5,-1,-66887,76019,142906,9132,0,-2344,958,0,0,,3302,-1386
23,06-04-17,52,12:45,13:00,,27.5,0,27.5,27.5,-1,-71654,79652,151306,7998,0,-864,0,0,0,,864,-864
23,06-04-17,53,13:00,13:15,,17.99,0,17.99,17.99,-1,-45700,70759,116459,25059,0,-9289,0,0,0,,9289,-9289
23,06-04-17,54,13:15,13:30,,24.47,0,24.47,24.47,-1,-58291,81584,139875,23293,0,-2740,0,0,0,,2740,-2740
23,06-04-17,55,13:30,13:45,,8.29,0,8.29,8.29,-1,-48583,108141,156724,59558,0,-10610,0,0,0,,10610,-10610
23,06-04-17,56,13:45,14:00,,-150.78,0,-150.78,-150.78,-1,-53397,99949,153346,46552,0,-43027,0,0,0,,43027,-43027
23,06-04-17,57,14:00,14:15,,18.78,0,18.78,18.78,-1,-52497,86688,139185,34191,0,-29439,0,0,0,,29439,-29439
23,06-04-17,58,14:15,14:30,,-150.78,0,-150.78,-150.78,-1,-36559,96423,132982,59864,0,-32653,0,0,0,,32653,-32653
23,06-04-17,59,14:30,14:45,,-150.78,0,-150.78,-150.78,-1,-49093,99898,148991,50805,0,-54593,0,0,0,,54593,-54593
23,06-04-17,60,14:45,15:00,,-150.78,0,-150.78,-150.78,-1,-48627,116418,165045,67791,0,-47061,0,0,0,,47061,-47061
23,06-04-17,61,15:00,15:15,,-150.78,0,-150.78,-150.78,-1,-67239,117573,184812,50334,0,-45672,0,0,0,,45672,-45672
23,06-04-17,62,15:15,15:30,,-150.78,0,-150.78,-150.78,-1,-48273,128578,176851,80305,0,-16534,0,0,0,,16534,-16534
23,06-04-17,63,15:30,15:45,,-150.78,0,-150.78,-150.78,-1,-32064,120053,152117,87989,0,-47265,0,0,0,,47265,-47265
23,06-04-17,64,15:45,16:00,,-150.78,0,-150.78,-150.78,-1,-54114,130692,184806,76578,0,-44458,0,0,0,,44458,-44458
23,06-04-17,65,16:00,16:15,,28.5,0,28.5,28.5,-1,-105273,161691,266964,56418,0,-11118,0,0,0,,11118,-11118
23,06-04-17,66,16:15,16:30,,23.5,0,23.5,23.5,-1,-70721,157762,228483,87041,0,-3814,0,0,0,,3814,-3814
23,06-04-17,67,16:30,16:45,,17.99,0,17.99,17.99,-1,-65905,116271,182176,50366,0,-8282,0,0,0,,8282,-8282
23,06-04-17,68,16:45,17:00,,28.56,0,28.56,28.56,-1,-62123,116176,178299,54053,0,-2461,0,0,0,,2461,-2461
23,06-04-17,69,17:00,17:15,,-150.78,0,-150.78,-150.78,-1,-72721,226792,299513,154071,0,-26348,0,0,0,,26348,-26348
23,06-04-17,70,17:15,17:30,,1.78,0,1.78,1.78,-1,-53863,174582,228445,120719,0,-49827,0,0,0,,49827,-49827
23,06-04-17,71,17:30,17:45,,23.5,0,23.5,23.5,-1,-47630,137038,184668,89408,0,-30117,0,0,0,,30117,-30117
23,06-04-17,72,17:45,18:00,,-96.5,0,-96.5,-96.5,-1,-40813,129823,170636,89010,0,-35440,0,0,0,,35440,-35440
23,06-04-17,73,18:00,18:15,,15.29,0,15.29,15.29,-1,-60747,133762,194509,73015,0,-20502,0,0,0,,20502,-20502
23,06-04-17,74,18:15,18:30,,-150.78,0,-150.78,-150.78,-1,-42767,116469,159236,73702,0,-53860,0,0,0,,53860,-53860
23,06-04-17,75,18:30,18:45,28.5,6.51,0,28.5,28.5,1,-61053,86307,147360,25254,0,-41677,1,0,0,,41678,-41676
23,06-04-17,76,18:45,19:00,30.27,28.5,0,30.27,28.1,2,-42399,78679,121078,36280,0,-2073,401,0,0,,2474,-1672
23,06-04-17,77,19:00,19:15,,-150.78,0,-150.78,-150.78,-1,-29392,125399,154791,96007,0,-18682,0,0,0,,18682,-18682
23,06-04-17,78,19:15,19:30,,-150.78,0,-150.78,-150.78,-1,-43375,60447,103822,17072,0,-35677,0,0,0,,35677,-35677
23,06-04-17,79,19:30,19:45,28.5,-150.78,0,28.5,28.5,1,-62076,64661,126737,2585,0,-597,133,0,0,,730,-464
23,06-04-17,80,19:45,20:00,28.5,,0,28.5,28.5,1,-59171,57357,116528,-1814,0,0,9,0,0,,9,9
23,06-04-17,81,20:00,20:15,,,0,34.65,34.65,0,-68135,102703,170838,34568,0,0,0,0,0,,0,0
23,06-04-17,82,20:15,20:30,,27.5,0,27.5,27.5,-1,-54569,88267,142836,33698,0,-907,0,0,0,,907,-907
23,06-04-17,83,20:30,20:45,,28.5,0,28.5,28.5,-1,-61763,73501,135264,11738,0,-1577,0,0,0,,1577,-1577
23,06-04-17,84,20:45,21:00,,,0,34.62,34.62,0,-58881,68260,127141,9379,0,-8,0,0,0,,8,-8
23,06-04-17,85,21:00,21:15,,24,0,24,24,-1,-62045,77498,139543,15453,0,-6176,0,0,0,,6176,-6176
23,06-04-17,86,21:15,21:30,,24.48,0,24.48,24.48,-1,-53389,71309,124698,17920,0,-14304,0,0,0,,14304,-14304
23,06-04-17,87,21:30,21:45,29.28,27.5,0,34.64,27.5,2,-68418,60808,129226,-7610,0,-5577,446,0,0,,6023,-5131
23,06-04-17,88,21:45,22:00,28.5,23.5,0,34.64,23.5,2,-51905,63296,115201,11391,0,-289,444,0,0,,733,155
23,06-04-17,89,22:00,22:15,,-4.78,0,-4.78,-4.78,-1,-32086,72952,105038,40866,0,-26013,0,0,0,,26013,-26013
23,06-04-17,90,22:15,22:30,29.91,28.5,0,29.91,29.91,1,-73266,50925,124191,-22341,0,-5495,572,0,0,,6067,-4923
23,06-04-17,91,22:30,22:45,29.91,,0,29.91,29.91,1,-67238,53921,121159,-13317,0,0,2145,0,0,,2145,2145
23,06-04-17,92,22:45,23:00,29.3,,0,29.3,29.3,1,-65064,60965,126029,-4099,0,0,944,0,0,,944,944
23,06-04-17,93,23:00,23:15,127.12,,0,127.12,127.12,1,-128467,46275,174742,-82192,0,0,24026,0,0,,24026,24026
23,06-04-17,94,23:15,23:30,40.9,,0,40.9,40.9,1,-80187,39973,120160,-40214,0,0,29659,0,0,,29659,29659
23,06-04-17,95,23:30,23:45,29.68,,0,29.68,29.68,1,-67245,45528,112773,-21717,0,0,4075,0,0,,4075,4075
23,06-04-17,96,23:45,0:00,,,0,28.08,28.08,0,-52604,48233,100837,-4371,0,0,130,0,0,,130,130
23,06-05-17,1,0:00,0:15,40.5,,0,40.5,40.5,1,-93647,49596,143243,-44051,0,0,5934,0,0,,5934,5934
23,06-05-17,2,0:15,0:30,34.5,,0,34.5,34.5,1,-88458,30737,119195,-57721,0,0,10050,0,0,,10050,10050
23,06-05-17,3,0:30,0:45,,,0,27.95,27.95,0,-82480,32225,114705,-50255,0,0,2578,0,0,,2578,2578
23,06-05-17,4,0:45,1:00,,,0,27.98,27.98,0,-84751,37095,121846,-47656,0,0,0,0,0,,0,0
23,06-05-17,5,1:00,1:15,,25.07,0,25.07,25.07,-1,-51181,61066,112247,9885,0,-2014,0,0,0,,2014,-2014
23,06-05-17,6,1:15,1:30,,25.07,0,25.07,25.07,-1,-28297,44337,72634,16040,0,-3578,0,0,0,,3578,-3578
23,06-05-17,7,1:30,1:45,,23.5,0,23.5,23.5,-1,-21976,52867,74843,30891,0,-7018,0,0,0,,7018,-7018
23,06-05-17,8,1:45,2:00,,-96.5,0,-96.5,-96.5,-1,-27658,62220,89878,34562,0,-31951,0,0,0,,31951,-31951
23,06-05-17,9,2:00,2:15,29.64,23.03,0,29.64,29.64,1,-43932,51567,95499,7635,0,-13635,489,0,0,,14124,-13146
23,06-05-17,10,2:15,2:30,29.78,28.5,0,28.5,28.5,-1,-34048,42018,76066,7970,0,-154,175,0,0,,329,21
23,06-05-17,11,2:30,2:45,,27.5,0,27.5,27.5,-1,-28695,59784,88479,31089,0,-2434,0,0,0,,2434,-2434
23,06-05-17,12,2:45,3:00,,21.96,0,21.96,21.96,-1,-31323,61919,93242,30596,0,-11665,0,0,0,,11665,-11665
23,06-05-17,13,3:00,3:15,30.5,28.3,0,33.19,28.3,2,-46908,43741,90649,-3167,0,-5226,1800,0,0,,7026,-3426
23,06-05-17,14,3:15,3:30,28.5,,0,28.5,28.5,1,-38869,46014,84883,7145,0,0,549,0,0,,549,549
23,06-05-17,15,3:30,3:45,,27.5,0,27.5,27.5,-1,-32056,79459,111515,47403,0,-985,0,0,0,,985,-985
23,06-05-17,16,3:45,4:00,,-150.03,0,-150.03,-150.03,-1,-34658,85305,119963,50647,0,-25520,0,0,0,,25520,-25520
23,06-05-17,17,4:00,4:15,,24.51,0,24.51,24.51,-1,-35489,75307,110796,39818,0,-11172,0,0,0,,11172,-11172
23,06-05-17,18,4:15,4:30,,,0,33.27,33.27,0,-34729,60510,95239,25781,0,-196,0,0,0,,196,-196
23,06-05-17,19,4:30,4:45,,,0,33.27,33.27,0,-28358,72458,100816,44100,0,0,0,0,0,,0,0
23,06-05-17,20,4:45,5:00,,28.5,0,28.5,28.5,-1,-23489,103807,127296,80318,0,-382,0,0,0,,382,-382
23,06-05-17,21,5:00,5:15,,28.5,0,28.5,28.5,-1,-33940,89357,123297,55417,0,-1842,0,0,0,,1842,-1842
23,06-05-17,22,5:15,5:30,,-96.5,0,-96.5,-96.5,-1,-19443,95383,114826,75940,0,-8436,0,0,0,,8436,-8436
23,06-05-17,23,5:30,5:45,,-96.5,0,-96.5,-96.5,-1,-22329,79189,101518,56860,0,-47969,0,0,0,,47969,-47969
23,06-05-17,24,5:45,6:00,,9.79,0,9.79,9.79,-1,-31111,95971,127082,64860,0,-52447,0,0,0,,52447,-52447
23,06-05-17,25,6:00,6:15,,26.99,0,26.99,26.99,-1,-26462,74559,101021,48097,0,-20725,0,0,0,,20725,-20725
23,06-05-17,26,6:15,6:30,,23.5,0,23.5,23.5,-1,-26604,100459,127063,73855,0,-6992,0,0,0,,6992,-6992
23,06-05-17,27,6:30,6:45,,27.5,0,27.5,27.5,-1,-20576,89939,110515,69363,0,-13156,0,0,0,,13156,-13156
23,06-05-17,28,6:45,7:00,,23.5,0,23.5,23.5,-1,-19865,108188,128053,88323,0,-17328,0,0,0,,17328,-17328
23,06-05-17,29,7:00,7:15,,-93.59,0,-93.59,-93.59,-1,-30549,108888,139437,78339,0,-26190,0,0,0,,26190,-26190
23,06-05-17,30,7:15,7:30,,-94.54,0,-94.54,-94.54,-1,-37595,100197,137792,62602,0,-46050,0,0,0,,46050,-46050
23,06-05-17,31,7:30,7:45,,14.62,0,14.62,14.62,-1,-38875,107774,146649,68899,0,-24426,0,0,0,,24426,-24426
23,06-05-17,32,7:45,8:00,,23.5,0,23.5,23.5,-1,-34788,115312,150100,80524,0,-18306,0,0,0,,18306,-18306
23,06-05-17,33,8:00,8:15,,23.5,0,23.5,23.5,-1,-58277,86467,144744,28190,0,-10510,0,0,0,,10510,-10510
23,06-05-17,34,8:15,8:30,,27.29,0,27.29,27.29,-1,-57364,65319,122683,7955,0,-14333,0,0,0,,14333,-14333
23,06-05-17,35,8:30,8:45,,28.5,0,28.5,28.5,-1,-54110,55596,109706,1486,0,-3906,0,0,0,,3906,-3906
23,06-05-17,36,8:45,9:00,,27.5,0,27.5,27.5,-1,-54032,58269,112301,4237,0,-5251,0,0,0,,5251,-5251
23,06-05-17,37,9:00,9:15,46.26,27.5,0,46.26,46.26,1,-82934,67937,150871,-14997,0,-2268,7469,0,0,,9737,5201
23,06-05-17,38,9:15,9:30,46.26,27.5,0,27.5,27.5,-1,-56252,63993,120245,7741,0,-1944,655,0,0,,2599,-1289
23,06-05-17,39,9:30,9:45,,24.03,0,24.03,24.03,-1,-51488,77040,128528,25552,0,-11951,0,0,0,,11951,-11951
23,06-05-17,40,9:45,10:00,,25.23,0,25.23,25.23,-1,-48603,95903,144506,47300,0,-18358,0,0,0,,18358,-18358
23,06-05-17,41,10:00,10:15,29.28,27.5,0,29.28,29.28,1,-75067,59987,135054,-15080,0,-7546,735,0,0,,8281,-6811
23,06-05-17,42,10:15,10:30,29.28,24.48,0,24.48,24.48,-1,-26912,112214,139126,85302,0,-1032,8,0,0,,1040,-1024
23,06-05-17,43,10:30,10:45,,-19.03,0,-19.03,-19.03,-1,-19971,131408,151379,111437,0,-44521,0,0,0,,44521,-44521
23,06-05-17,44,10:45,11:00,,9.79,0,9.79,9.79,-1,-26195,120181,146376,93986,0,-64599,0,0,0,,64599,-64599
23,06-05-17,45,11:00,11:15,,15.29,0,15.29,15.29,-1,-53016,78100,131116,25084,0,-39513,0,0,0,,39513,-39513
23,06-05-17,46,11:15,11:30,,-23.69,0,-23.69,-23.69,-1,-49867,119111,168978,69244,0,-48286,0,0,0,,48286,-48286
23,06-05-17,47,11:30,11:45,,9.79,0,9.79,9.79,-1,-53641,116575,170216,62934,0,-58651,0,0,0,,58651,-58651
23,06-05-17,48,11:45,12:00,,22.03,0,22.03,22.03,-1,-55006,127797,182803,72791,0,-36789,0,0,0,,36789,-36789
23,06-05-17,49,12:00,12:15,,18.5,0,18.5,18.5,-1,-77631,118905,196536,41274,0,-3817,0,0,0,,3817,-3817
23,06-05-17,50,12:15,12:30,,9.79,0,9.79,9.79,-1,-64274,131777,196051,67503,0,-27934,0,0,0,,27934,-27934
23,06-05-17,51,12:30,12:45,,21.59,0,21.59,21.59,-1,-80105,124719,204824,44614,0,-20759,0,0,0,,20759,-20759
23,06-05-17,52,12:45,13:00,,,0,34.63,34.63,0,-65959,123060,189019,57101,0,-5,0,0,0,,5,-5
23,06-05-17,53,13:00,13:15,,23.5,0,23.5,23.5,-1,-40011,153772,193783,113761,0,-7584,0,0,0,,7584,-7584
23,06-05-17,54,13:15,13:30,,27.5,0,27.5,27.5,-1,-48175,140797,188972,92622,0,-9331,0,0,0,,9331,-9331
23,06-05-17,55,13:30,13:45,,25.88,0,25.88,25.88,-1,-58217,143430,201647,85213,0,-3596,0,0,0,,3596,-3596
23,06-05-17,56,13:45,14:00,,-23.69,0,-23.69,-23.69,-1,-64249,149376,213625,85127,0,-38360,0,0,0,,38360,-38360
23,06-05-17,57,14:00,14:15,,18.55,0,18.55,18.55,-1,-60879,124646,185525,63767,0,-27256,0,0,0,,27256,-27256
23,06-05-17,58,14:15,14:30,,27.5,0,27.5,27.5,-1,-72115,105514,177629,33399,0,-621,0,0,0,,621,-621
23,06-05-17,59,14:30,14:45,,24.03,0,24.03,24.03,-1,-65902,106382,172284,40480,0,-6095,0,0,0,,6095,-6095
23,06-05-17,60,14:45,15:00,,23.5,0,23.5,23.5,-1,-70265,92961,163226,22696,0,-19560,0,0,0,,19560,-19560
23,06-05-17,61,15:00,15:15,30.5,23.5,0,30.5,30.5,1,-69078,73248,142326,4170,0,-4116,1370,0,0,,5486,-2746
23,06-05-17,62,15:15,15:30,30.5,,0,30.5,30.5,1,-68321,71250,139571,2929,0,0,2631,0,0,,2631,2631
23,06-05-17,63,15:30,15:45,41.29,,0,41.29,41.29,1,-71015,49617,120632,-21398,0,0,8547,0,0,,8547,8547
23,06-05-17,64,15:45,16:00,44.29,29.04,0,44.29,29.04,2,-65297,47703,113000,-17594,0,-27,18504,0,0,,18531,18477
23,06-05-17,65,16:00,16:15,44.29,-24.07,0,-24.07,-24.07,-1,-25455,173449,198904,147994,0,-23993,934,0,0,,24927,-23059
23,06-05-17,66,16:15,16:30,,21.59,0,21.59,21.59,-1,-37451,92883,130334,55432,0,-21186,0,0,0,,21186,-21186
23,06-05-17,67,16:30,16:45,,28.5,0,28.5,28.5,-1,-40455,72508,112963,32053,0,-632,0,0,0,,632,-632
23,06-05-17,68,16:45,17:00,,23.5,0,23.5,23.5,-1,-42330,78128,120458,35798,0,-6023,0,0,0,,6023,-6023
23,06-05-17,69,17:00,17:15,,27.29,0,27.29,27.29,-1,-84119,151701,235820,67582,0,-5471,0,0,0,,5471,-5471
23,06-05-17,70,17:15,17:30,,24.26,0,24.26,24.26,-1,-35467,134155,169622,98688,0,-11599,0,0,0,,11599,-11599
23,06-05-17,71,17:30,17:45,,22.46,0,22.46,22.46,-1,-45395,123866,169261,78471,0,-22284,0,0,0,,22284,-22284
23,06-05-17,72,17:45,18:00,,21.59,0,21.59,21.59,-1,-55875,106071,161946,50196,0,-31562,0,0,0,,31562,-31562
23,06-05-17,73,18:00,18:15,,-23.69,0,-23.69,-23.69,-1,-96975,170526,267501,73551,0,-39783,0,0,0,,39783,-39783
23,06-05-17,74,18:15,18:30,,-23.69,0,-23.69,-23.69,-1,-73395,120165,193560,46770,0,-56772,0,0,0,,56772,-56772
23,06-05-17,75,18:30,18:45,,23.5,0,23.5,23.5,-1,-61225,98185,159410,36960,0,-20230,0,0,0,,20230,-20230
23,06-05-17,76,18:45,19:00,,25.03,0,25.03,25.03,-1,-62399,86213,148612,23814,0,-19107,0,0,0,,19107,-19107
23,06-05-17,77,19:00,19:15,,-23.69,0,-23.69,-23.69,-1,-67537,134747,202284,67210,0,-16423,0,0,0,,16423,-16423
23,06-05-17,78,19:15,19:30,,23.5,0,23.5,23.5,-1,-68289,86285,154574,17996,0,-24088,0,0,0,,24088,-24088
23,06-05-17,79,19:30,19:45,,28.5,0,28.5,28.5,-1,-66460,78729,145189,12269,0,-11742,0,0,0,,11742,-11742
23,06-05-17,80,19:45,20:00,,41.37,0,41.37,41.37,-1,-67589,64429,132018,-3160,0,-5121,0,0,0,,5121,-5121
23,06-05-17,81,20:00,20:15,,27.5,0,27.5,27.5,-1,-70417,109141,179558,38724,0,-6494,0,0,0,,6494,-6494
23,06-05-17,82,20:15,20:30,,29.29,0,29.29,29.29,-1,-65131,82542,147673,17411,0,-5516,0,0,0,,5516,-5516
23,06-05-17,83,20:30,20:45,,,0,34.63,34.63,0,-61796,85678,147474,23882,0,-921,0,0,0,,921,-921
23,06-05-17,84,20:45,21:00,,42.15,0,42.15,42.15,-1,-52354,87728,140082,35374,0,-39,0,0,0,,39,-39
23,06-05-17,85,21:00,21:15,,42.21,0,42.21,42.21,-1,-47063,87735,134798,40672,0,-29,0,0,0,,29,-29
23,06-05-17,86,21:15,21:30,,28.29,0,28.29,28.29,-1,-42599,61260,103859,18661,0,-2159,0,0,0,,2159,-2159
23,06-05-17,87,21:30,21:45,,28.29,0,28.29,28.29,-1,-45676,57830,103506,12154,0,-2522,0,0,0,,2522,-2522
23,06-05-17,88,21:45,22:00,,28.5,0,28.5,28.5,-1,-39628,53001,92629,13373,0,-112,0,0,0,,112,-112
23,06-05-17,89,22:00,22:15,,25.03,0,25.03,25.03,-1,-52673,61280,113953,8607,0,-5511,0,0,0,,5511,-5511
23,06-05-17,90,22:15,22:30,,41.65,0,41.65,41.65,-1,-73783,59271,133054,-14512,0,-492,0,0,0,,492,-492
23,06-05-17,91,22:30,22:45,,27.5,0,27.5,27.5,-1,-64396,83160,147556,18764,0,-5099,0,0,0,,5099,-5099
23,06-05-17,92,22:45,23:00,,23.5,0,23.5,23.5,-1,-99361,116676,216037,17315,0,-17756,0,0,0,,17756,-17756
23,06-05-17,93,23:00,23:15,,9.03,0,9.03,9.03,-1,-46650,74630,121280,27980,0,-28100,0,0,0,,28100,-28100
23,06-05-17,94,23:15,23:30,,-150.03,0,-150.03,-150.03,-1,-36304,81508,117812,45204,0,-20935,0,0,0,,20935,-20935
23,06-05-17,95,23:30,23:45,,-150.03,0,-150.03,-150.03,-1,-84435,109246,193681,24811,0,-37318,0,0,0,,37318,-37318
23,06-05-17,96,23:45,0:00,,-150.03,0,-150.03,-150.03,-1,-102017,153786,255803,51769,0,-29807,0,0,0,,29807,-29807
23,06-06-17,1,0:00,0:15,,14.22,0,14.22,14.22,-1,-52597,81171,133768,28574,0,-26102,0,0,0,,26102,-26102
23,06-06-17,2,0:15,0:30,,-3.78,0,-3.78,-3.78,-1,-36505,87431,123936,50926,0,-41536,0,0,0,,41536,-41536
23,06-06-17,3,0:30,0:45,,-150.78,0,-150.78,-150.78,-1,-41537,119958,161495,78421,0,-60546,0,0,0,,60546,-60546
23,06-06-17,4,0:45,1:00,,-150.78,0,-150.78,-150.78,-1,-48642,156790,205432,108148,0,-81686,0,0,0,,81686,-81686
23,06-06-17,5,1:00,1:15,34.5,-34.01,0,34.5,34.5,1,-89610,59207,148817,-30403,0,-49478,300,0,0,,49778,-49178
23,06-06-17,6,1:15,1:30,34.5,3.78,0,3.78,3.78,-1,-59204,84164,143368,24960,0,-6807,256,0,0,,7063,-6551
23,06-06-17,7,1:30,1:45,,-93.28,0,-93.28,-93.28,-1,-64701,103133,167834,38432,0,-42361,0,0,0,,42361,-42361
23,06-06-17,8,1:45,2:00,,-150.78,0,-150.78,-150.78,-1,-48510,135082,183592,86572,0,-53876,0,0,0,,53876,-53876
23,06-06-17,9,2:00,2:15,29.44,-11.78,0,29.44,29.44,1,-69620,90441,160061,20821,0,-35489,224,0,0,,35713,-35265
23,06-06-17,10,2:15,2:30,29.52,4.49,0,29.52,4.49,2,-56781,84961,141742,28180,0,-7096,182,0,0,,7278,-6914
23,06-06-17,11,2:30,2:45,,1.72,0,1.72,1.72,-1,-46803,89607,136410,42804,0,-40028,0,0,0,,40028,-40028
23,06-06-17,12,2:45,3:00,,-0.78,0,-0.78,-0.78,-1,-47031,92121,139152,45090,0,-49040,0,0,0,,49040,-49040
23,06-06-17,13,3:00,3:15,32.37,10.54,0,32.37,32.37,1,-72560,61308,133868,-11252,0,-28096,709,0,0,,28805,-27387
23,06-06-17,14,3:15,3:30,,,0,27.79,27.79,0,-87711,62280,149991,-25431,0,-99,598,0,0,,697,499
23,06-06-17,15,3:30,3:45,,,0,27.8,27.8,0,-93277,67571,160848,-25706,0,0,0,0,0,,0,0
23,06-06-17,16,3:45,4:00,,27.3,0,27.3,27.3,-1,-76943,71760,148703,-5183,0,-180,0,0,0,,180,-180
23,06-06-17,17,4:00,4:15,,9.8,0,9.8,9.8,-1,-56439,81540,137979,25101,0,-8564,0,0,0,,8564,-8564
23,06-06-17,18,4:15,4:30,,9.8,0,9.8,9.8,-1,-41022,62024,103046,21002,0,-19128,0,0,0,,19128,-19128
23,06-06-17,19,4:30,4:45,,,0,27.74,27.74,0,-48665,55095,103760,6430,0,-1877,0,0,0,,1877,-1877
23,06-06-17,20,4:45,5:00,28.5,,0,28.5,28.5,1,-59338,64374,123712,5036,0,0,13,0,0,,13,13
23,06-06-17,21,5:00,5:15,28.53,,0,28.53,28.53,1,-88413,57108,145521,-31305,0,0,2148,0,0,,2148,2148
23,06-06-17,22,5:15,5:30,28.53,28.38,0,28.38,28.38,-1,-46568,53519,100087,6951,0,-38,87,0,0,,125,49
23,06-06-17,23,5:30,5:45,,-14.08,0,-14.08,-14.08,-1,-57562,54888,112450,-2674,0,-6346,0,0,0,,6346,-6346
23,06-06-17,24,5:45,6:00,,-150.78,0,-150.78,-150.78,-1,-45834,92813,138647,46979,0,-73145,0,0,0,,73145,-73145
23,06-06-17,25,6:00,6:15,30.5,-150.78,0,30.5,30.5,1,-93403,81109,174512,-12294,0,-33162,131,0,0,,33293,-33031
23,06-06-17,26,6:15,6:30,,26.65,0,26.65,26.65,-1,-32752,85821,118573,53069,0,-2924,0,0,0,,2924,-2924
23,06-06-17,27,6:30,6:45,40.5,28.5,0,40.5,40.5,1,-36583,39061,75644,2478,0,-643,2330,0,0,,2973,1687
23,06-06-17,28,6:45,7:00,40.5,,0,40.5,40.5,1,-44401,52570,96971,8169,0,0,19574,0,0,,19574,19574
23,06-06-17,29,7:00,7:15,28.5,27.53,0,27.53,27.53,-1,-28584,163988,192572,135404,0,-133,6959,0,0,,7092,6826
23,06-06-17,30,7:15,7:30,,,0,27.81,27.81,0,-37568,150775,188343,113207,0,-6,0,0,0,,6,-6
23,06-06-17,31,7:30,7:45,30.5,,0,30.5,30.5,1,-46899,105468,152367,58569,0,0,2136,0,0,,2136,2136
23,06-06-17,32,7:45,8:00,128.75,,0,128.75,128.75,1,-65576,93983,159559,28407,0,0,31161,0,0,,31161,31161
23,06-06-17,33,8:00,8:15,42.08,27.5,0,27.5,27.5,-1,-7239,108750,115989,101511,0,-408,17897,0,0,,18305,17489
23,06-06-17,34,8:15,8:30,,,0,27.81,27.81,0,-20160,85605,105765,65445,0,-130,106,0,0,,236,-24
23,06-06-17,35,8:30,8:45,,,0,27.81,27.81,0,-34640,87259,121899,52619,0,0,0,0,0,,0,0
23,06-06-17,36,8:45,9:00,,28.5,0,28.5,28.5,-1,-44373,79382,123755,35009,0,-14,0,0,0,,14,-14
23,06-06-17,37,9:00,9:15,,18.5,0,18.5,18.5,-1,-22797,127244,150041,104447,0,-13517,0,0,0,,13517,-13517
23,06-06-17,38,9:15,9:30,,27.3,0,27.3,27.3,-1,-29511,122536,152047,93025,0,-19201,0,0,0,,19201,-19201
23,06-06-17,39,9:30,9:45,,23.5,0,23.5,23.5,-1,-24913,122491,147404,97578,0,-20425,0,0,0,,20425,-20425
23,06-06-17,40,9:45,10:00,,18.5,0,18.5,18.5,-1,-38489,129648,168137,91159,0,-21176,0,0,0,,21176,-21176
23,06-06-17,41,10:00,10:15,,-2.04,0,-2.04,-2.04,-1,-20247,116338,136585,96091,0,-37654,0,0,0,,37654,-37654
23,06-06-17,42,10:15,10:30,,23.5,0,23.5,23.5,-1,-39444,128310,167754,88866,0,-18828,0,0,0,,18828,-18828
23,06-06-17,43,10:30,10:45,,20.16,0,20.16,20.16,-1,-51777,141980,193757,90203,0,-26946,0,0,0,,26946,-26946
23,06-06-17,44,10:45,11:00,,23.2,0,23.2,23.2,-1,-46387,142724,189111,96337,0,-26472,0,0,0,,26472,-26472
23,06-06-17,45,11:00,11:15,40.5,26.96,0,40.5,40.5,1,-62410,92351,154761,29941,0,-12722,2100,0,0,,14822,-10622
23,06-06-17,46,11:15,11:30,40.5,26.96,0,40.5,40.5,1,-60409,113207,173616,52798,0,-102,5005,0,0,,5107,4903
23,06-06-17,47,11:30,11:45,,,0,28.5,28.5,0,-47413,122372,169785,74959,0,0,14,0,0,,14,14
23,06-06-17,48,11:45,12:00,,,0,28.5,28.5,0,-39325,129060,168385,89735,0,0,0,0,0,,0,0
23,06-06-17,49,12:00,12:15,48.92,,0,48.92,48.92,1,-85723,102999,188722,17276,0,0,10335,0,0,,10335,10335
23,06-06-17,50,12:15,12:30,29.12,18.1,0,18.1,18.1,-1,-67278,123227,190505,55949,0,-3923,3414,0,0,,7337,-509
23,06-06-17,51,12:30,12:45,,8.02,0,8.02,8.02,-1,-56132,149761,205893,93629,0,-14447,0,0,0,,14447,-14447
23,06-06-17,52,12:45,13:00,,-25.78,0,-25.78,-25.78,-1,-45638,148557,194195,102919,0,-5033,0,0,0,,5033,-5033
23,06-06-17,53,13:00,13:15,,-25.78,0,-25.78,-25.78,-1,-18757,129647,148404,110890,0,-30187,0,0,0,,30187,-30187
23,06-06-17,54,13:15,13:30,,-25.78,0,-25.78,-25.78,-1,-50636,156481,207117,105845,0,-26310,0,0,0,,26310,-26310
23,06-06-17,55,13:30,13:45,,-25.78,0,-25.78,-25.78,-1,-85867,115956,201823,30089,0,-24131,0,0,0,,24131,-24131
23,06-06-17,56,13:45,14:00,,18.12,0,18.12,18.12,-1,-54756,90622,145378,35866,0,-10291,0,0,0,,10291,-10291
23,06-06-17,57,14:00,14:15,,25.74,0,25.74,25.74,-1,-64858,138022,202880,73164,0,-12998,0,0,0,,12998,-12998
23,06-06-17,58,14:15,14:30,,,0,28.5,28.5,0,-66564,111543,178107,44979,0,-427,0,0,0,,427,-427
23,06-06-17,59,14:30,14:45,,28.07,0,28.07,28.07,-1,-46580,125130,171710,78550,0,-90,0,0,0,,90,-90
23,06-06-17,60,14:45,15:00,,27.5,0,27.5,27.5,-1,-57057,124852,181909,67795,0,-2706,0,0,0,,2706,-2706
23,06-06-17,61,15:00,15:15,,23.5,0,23.5,23.5,-1,-136263,119344,255607,-16919,0,-424,0,0,0,,424,-424
23,06-06-17,62,15:15,15:30,,12.85,0,12.85,12.85,-1,-96093,112811,208904,16718,0,-12192,0,0,0,,12192,-12192
23,06-06-17,63,15:30,15:45,,22.96,0,22.96,22.96,-1,-96169,112007,208176,15838,0,-1921,0,0,0,,1921,-1921
23,06-06-17,64,15:45,16:00,,22.96,0,22.96,22.96,-1,-88033,112574,200607,24541,0,-11628,0,0,0,,11628,-11628
23,06-06-17,65,16:00,16:15,,28.15,0,28.15,28.15,-1,-128042,136915,264957,8873,0,-5903,0,0,0,,5903,-5903
23,06-06-17,66,16:15,16:30,,28.5,0,28.5,28.5,-1,-116667,159341,276008,42674,0,-1166,0,0,0,,1166,-1166
23,06-06-17,67,16:30,16:45,28.5,28.5,0,28.5,28.5,1,-115439,130938,246377,15499,0,-12,11,0,0,,23,-1
23,06-06-17,68,16:45,17:00,28.87,,0,28.87,28.87,1,-136713,118692,255405,-18021,0,0,1696,0,0,,1696,1696
23,06-06-17,69,17:00,17:15,34.5,,0,34.5,34.5,1,-58419,157232,215651,98813,0,0,6336,0,0,,6336,6336
23,06-06-17,70,17:15,17:30,30.5,,0,30.5,30.5,1,-70340,131826,202166,61486,0,0,5934,0,0,,5934,5934
23,06-06-17,71,17:30,17:45,43.13,,0,43.13,43.13,1,-82906,122315,205221,39409,0,0,21829,0,0,,21829,21829
23,06-06-17,72,17:45,18:00,34.5,,0,34.5,34.5,1,-86782,145176,231958,58394,0,0,25406,0,0,,25406,25406
23,06-06-17,73,18:00,18:15,,,0,28.5,28.5,0,-44444,137118,181562,92674,0,0,6003,0,0,,6003,6003
23,06-06-17,74,18:15,18:30,,,0,28.5,28.5,0,-51987,147467,199454,95480,0,0,0,0,0,,0,0
23,06-06-17,75,18:30,18:45,,27.5,0,27.5,27.5,-1,-36139,171573,207712,135434,0,-10,0,0,0,,10,-10
23,06-06-17,76,18:45,19:00,,31.74,0,31.74,31.74,-1,-29486,191945,221431,162459,0,-2,0,0,0,,2,-2
23,06-06-17,77,19:00,19:15,,28.51,0,28.51,28.51,-1,-62858,102614,165472,39756,0,-1771,0,0,0,,1771,-1771
23,06-06-17,78,19:15,19:30,,28.74,0,28.74,28.74,-1,-77187,95897,173084,18710,0,-2362,0,0,0,,2362,-2362
23,06-06-17,79,19:30,19:45,,28.74,0,28.74,28.74,-1,-84246,109997,194243,25751,0,-1007,0,0,0,,1007,-1007
23,06-06-17,80,19:45,20:00,,28.5,0,28.5,28.5,-1,-87011,106514,193525,19503,0,-4789,0,0,0,,4789,-4789
23,06-06-17,81,20:00,20:15,28.55,30.74,0,28.55,28.55,1,-114599,110277,224876,-4322,0,-2229,702,0,0,,2931,-1527
23,06-06-17,82,20:15,20:30,33.35,,0,33.35,33.35,1,-121397,106561,227958,-14836,0,0,4533,0,0,,4533,4533
23,06-06-17,83,20:30,20:45,33.35,28.5,0,28.5,28.5,-1,-112782,115471,228253,2689,0,-1076,1131,0,0,,2207,55
23,06-06-17,84,20:45,21:00,,28.5,0,28.5,28.5,-1,-106671,118303,224974,11632,0,-4852,0,0,0,,4852,-4852
23,06-06-17,85,21:00,21:15,,29.74,0,29.74,29.74,-1,-115333,127387,242720,12054,0,-1624,0,0,0,,1624,-1624
23,06-06-17,86,21:15,21:30,,28.74,0,28.74,28.74,-1,-101075,138690,239765,37615,0,-74,0,0,0,,74,-74
23,06-06-17,87,21:30,21:45,,28.74,0,28.74,28.74,-1,-92366,140969,233335,48603,0,-1727,0,0,0,,1727,-1727
23,06-06-17,88,21:45,22:00,,27.5,0,27.5,27.5,-1,-69862,134318,204180,64456,0,-374,0,0,0,,374,-374
23,06-06-17,89,22:00,22:15,,23.5,0,23.5,23.5,-1,-69885,88163,158048,18278,0,-6124,0,0,0,,6124,-6124
23,06-06-17,90,22:15,22:30,,27.5,0,27.5,27.5,-1,-69192,94990,164182,25798,0,-7848,0,0,0,,7848,-7848
23,06-06-17,91,22:30,22:45,,30.74,0,30.74,30.74,-1,-59016,106100,165116,47084,0,-2776,0,0,0,,2776,-2776
23,06-06-17,92,22:45,23:00,,7.59,0,7.59,7.59,-1,-59498,114802,174300,55304,0,-4610,0,0,0,,4610,-4610
23,06-06-17,93,23:00,23:15,30.12,11.1,0,30.12,11.1,2,-83603,65029,148632,-18574,0,-7951,670,0,0,,8621,-7281
23,06-06-17,94,23:15,23:30,28.5,28.74,0,30.12,28.74,2,-70470,60913,131383,-9557,0,-132,215,0,0,,347,83
23,06-06-17,95,23:30,23:45,,28.74,0,28.74,28.74,-1,-69942,71956,141898,2014,0,-2058,0,0,0,,2058,-2058
23,06-06-17,96,23:45,0:00,30.5,30.74,0,30.5,30.5,1,-118009,99265,217274,-18744,0,-260,764,0,0,,1024,504
23,06-07-17,1,0:00,0:15,28.95,,0,28.95,28.95,1,-77985,56835,134820,-21150,0,0,3999,0,0,,3999,3999
23,06-07-17,2,0:15,0:30,28.82,18.5,0,18.5,18.5,-1,-60286,43863,104149,-16423,0,-2524,2705,0,0,,5229,181
23,06-07-17,3,0:30,0:45,,3.78,0,3.78,3.78,-1,-71766,67618,139384,-4148,0,-21464,0,0,0,,21464,-21464
23,06-07-17,4,0:45,1:00,,23.49,0,23.49,23.49,-1,-71405,83224,154629,11819,0,-19836,0,0,0,,19836,-19836
23,06-07-17,5,1:00,1:15,78.02,8.8,0,78.02,8.8,2,-84183,28331,112514,-55852,0,-14897,4691,0,0,,19588,-10206
23,06-07-17,6,1:15,1:30,31.95,8.8,0,31.95,31.95,1,-81975,19625,101600,-62350,0,-190,7911,0,0,,8101,7721
23,06-07-17,7,1:30,1:45,,,0,27.84,27.84,0,-95629,28153,123782,-67476,0,0,27,0,0,,27,27
23,06-07-17,8,1:45,2:00,,,0,27.34,27.34,0,-84849,36872,121721,-47977,0,0,0,0,0,,0,0
23,06-07-17,9,2:00,2:15,34.5,,0,34.5,34.5,1,-100780,41337,142117,-59443,0,0,1973,0,0,,1973,1973
23,06-07-17,10,2:15,2:30,34.5,,0,34.5,34.5,1,-93434,34164,127598,-59270,0,0,4868,0,0,,4868,4868
23,06-07-17,11,2:30,2:45,,,0,27.34,27.34,0,-90543,38283,128826,-52260,0,0,6,0,0,,6,6
23,06-07-17,12,2:45,3:00,,,0,27.34,27.34,0,-71816,42150,113966,-29666,0,0,0,0,0,,0,0
23,06-07-17,13,3:00,3:15,,,0,27.33,27.33,0,-69831,35363,105194,-34468,0,0,0,0,0,,0,0
23,06-07-17,14,3:15,3:30,,,0,27.33,27.33,0,-74010,41073,115083,-32937,0,0,0,0,0,,0,0
23,06-07-17,15,3:30,3:45,,,0,27.33,27.33,0,-73546,41417,114963,-32129,0,0,0,0,0,,0,0
23,06-07-17,16,3:45,4:00,,,0,27.33,27.33,0,-69457,45486,114943,-23971,0,0,0,0,0,,0,0
23,06-07-17,17,4:00,4:15,,,0,27.33,27.33,0,-61375,40392,101767,-20983,0,0,0,0,0,,0,0
23,06-07-17,18,4:15,4:30,,,0,27.33,27.33,0,-51823,31143,82966,-20680,0,0,0,0,0,,0,0
23,06-07-17,19,4:30,4:45,,,0,27.33,27.33,0,-47506,37698,85204,-9808,0,0,0,0,0,,0,0
23,06-07-17,20,4:45,5:00,,23.07,0,23.07,23.07,-1,-49284,50040,99324,756,0,-196,0,0,0,,196,-196
23,06-07-17,21,5:00,5:15,,20.26,0,20.26,20.26,-1,-41131,61784,102915,20653,0,-6341,0,0,0,,6341,-6341
23,06-07-17,22,5:15,5:30,,-15.03,0,-15.03,-15.03,-1,-31893,69214,101107,37321,0,-26303,0,0,0,,26303,-26303
23,06-07-17,23,5:30,5:45,28.5,20.26,0,28.5,28.5,1,-52756,53724,106480,968,0,-14665,97,0,0,,14762,-14568
23,06-07-17,24,5:45,6:00,28.77,20.26,0,28.77,28.77,1,-64431,54346,118777,-10085,0,-466,2222,0,0,,2688,1756
23,06-07-17,25,6:00,6:15,28.77,2.33,0,2.33,2.33,-1,-49168,96352,145520,47184,0,-9601,79,0,0,,9680,-9522
23,06-07-17,26,6:15,6:30,,23.03,0,23.03,23.03,-1,-52891,85454,138345,32563,0,-11974,0,0,0,,11974,-11974
23,06-07-17,27,6:30,6:45,,27.33,0,27.33,27.33,-1,-70236,79891,150127,9655,0,-3079,0,0,0,,3079,-3079
23,06-07-17,28,6:45,7:00,,24.58,0,24.58,24.58,-1,-72382,94965,167347,22583,0,-780,0,0,0,,780,-780
23,06-07-17,29,7:00,7:15,28.5,25.15,0,28.5,25.15,2,-72197,131277,203474,59080,0,-962,27,0,0,,989,-935
23,06-07-17,30,7:15,7:30,,27.5,0,27.5,27.5,-1,-36234,115350,151584,79116,0,-2716,0,0,0,,2716,-2716
23,06-07-17,31,7:30,7:45,,,0,27.84,27.84,0,-57837,99772,157609,41935,0,-111,0,0,0,,111,-111
23,06-07-17,32,7:45,8:00,28.95,,0,28.95,28.95,1,-72404,98529,170933,26125,0,0,556,0,0,,556,556
23,06-07-17,33,8:00,8:15,47.01,,0,47.01,47.01,1,-130855,95482,226337,-35373,0,0,6325,0,0,,6325,6325
23,06-07-17,34,8:15,8:30,47.01,23.5,0,23.5,23.5,-1,-32883,89719,122602,56836,0,-5428,253,0,0,,5681,-5175
23,06-07-17,35,8:30,8:45,,23.5,0,23.5,23.5,-1,-42680,61440,104120,18760,0,-12359,0,0,0,,12359,-12359
23,06-07-17,36,8:45,9:00,30.5,28.5,0,34.46,28.5,2,-61543,49884,111427,-11659,0,-4048,435,0,0,,4483,-3613
23,06-07-17,37,9:00,9:15,28.91,28.5,0,28.91,28.91,1,-73639,79007,152646,5368,0,-99,30,0,0,,129,-69
23,06-07-17,38,9:15,9:30,28.91,,0,28.91,28.91,1,-72083,69781,141864,-2302,0,0,90,0,0,,90,90
23,06-07-17,39,9:30,9:45,,28.5,0,28.5,28.5,-1,-53946,69554,123500,15608,0,-1951,0,0,0,,1951,-1951
23,06-07-17,40,9:45,10:00,,27.5,0,27.5,27.5,-1,-58728,69832,128560,11104,0,-1187,0,0,0,,1187,-1187
23,06-07-17,41,10:00,10:15,,27.5,0,27.5,27.5,-1,-44356,68147,112503,23791,0,-1244,0,0,0,,1244,-1244
23,06-07-17,42,10:15,10:30,,28.5,0,28.5,28.5,-1,-44697,59531,104228,14834,0,-1650,0,0,0,,1650,-1650
23,06-07-17,43,10:30,10:45,,24.9,0,24.9,24.9,-1,-59731,61244,120975,1513,0,-1209,0,0,0,,1209,-1209
23,06-07-17,44,10:45,11:00,,24.9,0,24.9,24.9,-1,-58161,59190,117351,1029,0,-7827,0,0,0,,7827,-7827
23,06-07-17,45,11:00,11:15,29.1,41.95,0,29.1,29.1,1,-77663,54500,132163,-23163,0,-3438,518,0,0,,3956,-2920
23,06-07-17,46,11:15,11:30,28.86,,0,28.86,28.86,1,-58135,52785,110920,-5350,0,0,457,0,0,,457,457
23,06-07-17,47,11:30,11:45,,41.64,0,41.64,41.64,-1,-58860,52070,110930,-6790,0,-144,0,0,0,,144,-144
23,06-07-17,48,11:45,12:00,,28.5,0,28.5,28.5,-1,-54064,45700,99764,-8364,0,-1246,0,0,0,,1246,-1246
23,06-07-17,49,12:00,12:15,45.75,28.5,0,45.75,45.75,1,-82254,36946,119200,-45308,0,-96,12286,0,0,,12382,12190
23,06-07-17,50,12:15,12:30,40.5,,0,40.5,40.5,1,-80456,61488,141944,-18968,0,0,13553,0,0,,13553,13553
23,06-07-17,51,12:30,12:45,30.5,,0,30.5,30.5,1,-73109,65154,138263,-7955,0,0,1639,0,0,,1639,1639
23,06-07-17,52,12:45,13:00,30.5,,0,30.5,30.5,1,-75991,63393,139384,-12598,0,0,822,0,0,,822,822
23,06-07-17,53,13:00,13:15,132.66,,0,132.66,132.66,1,-130570,37346,167916,-93224,0,0,33764,0,0,,33764,33764
23,06-07-17,54,13:15,13:30,53.48,,0,53.48,53.48,1,-114487,55706,170193,-58781,0,0,53647,0,0,,53647,53647
23,06-07-17,55,13:30,13:45,43.4,,0,43.4,43.4,1,-117567,57304,174871,-60263,0,0,30678,0,0,,30678,30678
23,06-07-17,56,13:45,14:00,37.05,,0,37.05,37.05,1,-105518,61435,166953,-44083,0,0,20706,0,0,,20706,20706
23,06-07-17,57,14:00,14:15,40.5,,0,40.5,40.5,1,-128612,88379,216991,-40233,0,0,19361,0,0,,19361,19361
23,06-07-17,58,14:15,14:30,45.74,,0,45.74,45.74,1,-129298,84491,213789,-44807,0,0,22154,0,0,,22154,22154
23,06-07-17,59,14:30,14:45,40.5,,0,40.5,40.5,1,-125206,89615,214821,-35591,0,0,29331,0,0,,29331,29331
23,06-07-17,60,14:45,15:00,34.5,,0,34.5,34.5,1,-125256,84440,209696,-40816,0,0,17985,0,0,,17985,17985
23,06-07-17,61,15:00,15:15,40.5,,0,40.5,40.5,1,-119981,78020,198001,-41961,0,0,28262,0,0,,28262,28262
23,06-07-17,62,15:15,15:30,45.74,,0,45.74,45.74,1,-137634,88118,225752,-49516,0,0,35500,0,0,,35500,35500
23,06-07-17,63,15:30,15:45,40.5,,0,40.5,40.5,1,-129435,111406,240841,-18029,0,0,25615,0,0,,25615,25615
23,06-07-17,64,15:45,16:00,,,0,28.58,28.58,0,-123571,124945,248516,1374,0,0,1034,0,0,,1034,1034
23,06-07-17,65,16:00,16:15,40.5,,0,40.5,40.5,1,-161538,135858,297396,-25680,0,0,5763,0,0,,5763,5763
23,06-07-17,66,16:15,16:30,27.67,28.5,0,28.5,28.5,-1,-146051,149795,295846,3744,0,-24,2626,0,0,,2650,2602
23,06-07-17,67,16:30,16:45,26.25,27.5,0,26.82,26.82,2,-143689,135549,279238,-8140,0,-2203,17,0,0,,2220,-2186
23,06-07-17,68,16:45,17:00,40.5,27.5,0,40.5,40.5,1,-156560,130635,287195,-25925,0,-8,10834,0,0,,10842,10826
23,06-07-17,69,17:00,17:15,31.97,,0,31.97,31.97,1,-139519,134169,273688,-5350,0,0,8608,0,0,,8608,8608
23,06-07-17,70,17:15,17:30,29.72,,0,29.72,29.72,1,-133153,128213,261366,-4940,0,0,7532,0,0,,7532,7532
23,06-07-17,71,17:30,17:45,28.81,28.5,0,28.5,28.5,-1,-110705,135843,246548,25138,0,-48,3876,0,0,,3924,3828
23,06-07-17,72,17:45,18:00,28.81,27.5,0,27.5,27.5,-1,-113480,135381,248861,21901,0,-533,1,0,0,,534,-532
23,06-07-17,73,18:00,18:15,,18.5,0,18.5,18.5,-1,-76122,97884,174006,21762,0,-12603,0,0,0,,12603,-12603
23,06-07-17,74,18:15,18:30,,23.5,0,23.5,23.5,-1,-68001,94152,162153,26151,0,-16817,0,0,0,,16817,-16817
23,06-07-17,75,18:30,18:45,,27.5,0,27.5,27.5,-1,-48553,90421,138974,41868,0,-8051,0,0,0,,8051,-8051
23,06-07-17,76,18:45,19:00,,,0,35.35,35.35,0,-42184,84431,126615,42247,0,-1161,0,0,0,,1161,-1161
23,06-07-17,77,19:00,19:15,,27.5,0,27.5,27.5,-1,-27480,100464,127944,72984,0,-423,0,0,0,,423,-423
23,06-07-17,78,19:15,19:30,,28.6,0,28.6,28.6,-1,-31994,92647,124641,60653,0,-321,0,0,0,,321,-321
23,06-07-17,79,19:30,19:45,,,0,35.35,35.35,0,-41050,83277,124327,42227,0,-44,0,0,0,,44,-44
23,06-07-17,80,19:45,20:00,,,0,35.35,35.35,0,-48556,76704,125260,28148,0,0,0,0,0,,0,0
23,06-07-17,81,20:00,20:15,,25.74,0,25.74,25.74,-1,-25796,93442,119238,67646,0,-2106,0,0,0,,2106,-2106
23,06-07-17,82,20:15,20:30,,27.5,0,27.5,27.5,-1,-32347,93653,126000,61306,0,-2768,0,0,0,,2768,-2768
23,06-07-17,83,20:30,20:45,,23.5,0,23.5,23.5,-1,-38796,87844,126640,49048,0,-6296,0,0,0,,6296,-6296
23,06-07-17,84,20:45,21:00,,24.66,0,24.66,24.66,-1,-44518,91570,136088,47052,0,-1001,0,0,0,,1001,-1001
23,06-07-17,85,21:00,21:15,,24.47,0,24.47,24.47,-1,-70642,91517,162159,20875,0,-803,0,0,0,,803,-803
23,06-07-17,86,21:15,21:30,,28.65,0,28.65,28.65,-1,-49652,95058,144710,45406,0,-50,0,0,0,,50,-50
23,06-07-17,87,21:30,21:45,,28.65,0,28.65,28.65,-1,-44969,105073,150042,60104,0,-258,0,0,0,,258,-258
23,06-07-17,88,21:45,22:00,,,0,28.71,28.71,0,-96289,117112,213401,20823,0,0,0,0,0,,0,0
23,06-07-17,89,22:00,22:15,52.4,,0,52.4,52.4,1,-157116,69477,226593,-87639,0,0,2902,0,0,,2902,2902
23,06-07-17,90,22:15,22:30,33.51,,0,33.51,33.51,1,-169629,68118,237747,-101511,0,0,9065,0,0,,9065,9065
23,06-07-17,91,22:30,22:45,342.37,,0,342.37,342.37,1,-159898,58832,218730,-101066,0,0,21128,0,0,,21128,21128
23,06-07-17,92,22:45,23:00,342.37,27.5,0,27.5,27.5,-1,-143333,111568,254901,-31765,0,-72,37446,0,0,,37518,37374
23,06-07-17,93,23:00,23:15,342.37,18.5,0,18.5,18.5,-1,-111565,127202,238767,15637,0,-7430,1353,0,0,,8783,-6077
23,06-07-17,94,23:15,23:30,,13.41,0,13.41,13.41,-1,-95735,120023,215758,24288,0,-17023,0,0,0,,17023,-17023
23,06-07-17,95,23:30,23:45,,10.03,0,10.03,10.03,-1,-86653,127632,214285,40979,0,-44632,0,0,0,,44632,-44632
23,06-07-17,96,23:45,0:00,,18.5,0,18.5,18.5,-1,-92830,119558,212388,26728,0,-38535,0,0,0,,38535,-38535
23,06-08-17,1,0:00,0:15,,-102.35,0,-102.35,-102.35,-1,-37610,133291,170901,95681,0,-34670,0,0,0,,34670,-34670
23,06-08-17,2,0:15,0:30,,-95.24,0,-95.24,-95.24,-1,-27546,109834,137380,82288,0,-23580,0,0,0,,23580,-23580
23,06-08-17,3,0:30,0:45,,-95.24,0,-95.24,-95.24,-1,-67763,83083,150846,15320,0,-36559,0,0,0,,36559,-36559
23,06-08-17,4,0:45,1:00,,20.75,0,20.75,20.75,-1,-60923,94949,155872,34026,0,-25119,0,0,0,,25119,-25119
23,06-08-17,5,1:00,1:15,33.12,24.66,0,33.12,24.66,2,-59429,27341,86770,-32088,0,-11420,2565,0,0,,13985,-8855
23,06-08-17,6,1:15,1:30,27.75,25.17,0,27.75,25.17,2,-36046,31848,67894,-4198,0,-251,2424,0,0,,2675,2173
23,06-08-17,7,1:30,1:45,,24.78,0,24.78,24.78,-1,-44701,45039,89740,338,0,-1399,0,0,0,,1399,-1399
23,06-08-17,8,1:45,2:00,,22.74,0,22.74,22.74,-1,-49675,53641,103316,3966,0,-13616,0,0,0,,13616,-13616
23,06-08-17,9,2:00,2:15,31.75,24.59,0,31.75,31.75,1,-35750,44061,79811,8311,0,-13405,988,0,0,,14393,-12417
23,06-08-17,10,2:15,2:30,32.86,24.59,0,32.86,32.86,1,-42310,37584,79894,-4726,0,-278,2363,0,0,,2641,2085
23,06-08-17,11,2:30,2:45,31.75,,0,31.75,31.75,1,-46766,27202,73968,-19564,0,0,6190,0,0,,6190,6190
23,06-08-17,12,2:45,3:00,29.12,28.17,0,29.12,26.96,2,-59507,30721,90228,-28786,0,-3,11059,0,0,,11062,11056
23,06-08-17,13,3:00,3:15,29.12,25.74,0,25.74,25.74,-1,-13110,69023,82133,55913,0,-1722,1187,0,0,,2909,-535
23,06-08-17,14,3:15,3:30,,27.74,0,27.74,27.74,-1,-28940,49022,77962,20082,0,-884,0,0,0,,884,-884
23,06-08-17,15,3:30,3:45,27.75,,0,27.75,27.75,1,-47781,41834,89615,-5947,0,0,1128,0,0,,1128,1128
23,06-08-17,16,3:45,4:00,37.12,,0,37.12,37.12,1,-78262,30661,108923,-47601,0,0,15059,0,0,,15059,15059
23,06-08-17,17,4:00,4:15,37.12,,0,37.12,37.12,1,-63460,35553,99013,-27907,0,0,13862,0,0,,13862,13862
23,06-08-17,18,4:15,4:30,37.75,,0,37.75,37.75,1,-65192,36043,101235,-29149,0,0,9076,0,0,,9076,9076
23,06-08-17,19,4:30,4:45,38.34,,0,38.34,38.34,1,-60722,30242,90964,-30480,0,0,23385,0,0,,23385,23385
23,06-08-17,20,4:45,5:00,31.82,,0,31.82,31.82,1,-55498,28831,84329,-26667,0,0,23074,0,0,,23074,23074
23,06-08-17,21,5:00,5:15,27.75,25.37,0,25.37,25.37,-1,-51429,64822,116251,13393,0,-485,11428,0,0,,11913,10943
23,06-08-17,22,5:15,5:30,,,0,26.68,26.68,0,-35447,47513,82960,12066,0,-156,57,0,0,,213,-99
23,06-08-17,23,5:30,5:45,31.75,,0,31.75,31.75,1,-59947,29544,89491,-30403,0,0,1415,0,0,,1415,1415
23,06-08-17,24,5:45,6:00,27.75,,0,27.75,27.75,1,-81390,25049,106439,-56341,0,0,7393,0,0,,7393,7393
23,06-08-17,25,6:00,6:15,25.49,,0,25.49,25.49,1,-134015,70713,204728,-63302,0,0,2408,0,0,,2408,2408
23,06-08-17,26,6:15,6:30,31.49,,0,31.49,31.49,1,-101607,41288,142895,-60319,0,0,284,0,0,,284,284
23,06-08-17,27,6:30,6:45,221.73,,0,221.73,221.73,1,-105398,42063,147461,-63335,0,0,21983,0,0,,21983,21983
23,06-08-17,28,6:45,7:00,27.49,19.74,0,27.49,19.74,2,-62175,89583,151758,27408,0,-858,5855,0,0,,6713,4997
23,06-08-17,29,7:00,7:15,27.49,-150.78,0,-150.78,-150.78,-1,-25484,81205,106689,55721,0,-42627,40,0,0,,42667,-42587
23,06-08-17,30,7:15,7:30,,23.78,0,23.78,23.78,-1,-21827,58423,80250,36596,0,-15448,0,0,0,,15448,-15448
23,06-08-17,31,7:30,7:45,,25.49,0,25.49,25.49,-1,-32647,51550,84197,18903,0,-4856,0,0,0,,4856,-4856
23,06-08-17,32,7:45,8:00,,,0,26.8,26.8,0,-58263,43204,101467,-15059,0,-688,0,0,0,,688,-688
23,06-08-17,33,8:00,8:15,,,0,26.87,26.87,0,-49809,68742,118551,18933,0,0,0,0,0,,0,0
23,06-08-17,34,8:15,8:30,,,0,26.85,26.85,0,-66678,49498,116176,-17180,0,0,0,0,0,,0,0
23,06-08-17,35,8:30,8:45,28.43,,0,28.43,28.43,1,-60641,31478,92119,-29163,0,0,330,0,0,,330,330
23,06-08-17,36,8:45,9:00,25.51,,0,25.51,25.51,1,-74796,29661,104457,-45135,0,0,972,0,0,,972,972
23,06-08-17,37,9:00,9:15,27.49,,0,27.49,27.49,1,-57500,32764,90264,-24736,0,0,3303,0,0,,3303,3303
23,06-08-17,38,9:15,9:30,27.49,,0,27.49,27.49,1,-65790,32009,97799,-33781,0,0,3815,0,0,,3815,3815
23,06-08-17,39,9:30,9:45,25.49,,0,25.49,25.49,1,-83642,30748,114390,-52894,0,0,1312,0,0,,1312,1312
23,06-08-17,40,9:45,10:00,,,0,26.84,26.84,0,-83012,14182,97194,-68830,0,0,0,0,0,,0,0
23,06-08-17,41,10:00,10:15,25.49,,0,25.49,25.49,1,-82231,40282,122513,-41949,0,0,892,0,0,,892,892
23,06-08-17,42,10:15,10:30,27.49,,0,27.49,27.49,1,-96888,30369,127257,-66519,0,0,3836,0,0,,3836,3836
23,06-08-17,43,10:30,10:45,27.49,26.27,0,26.27,26.27,-1,-64353,44627,108980,-19726,0,-16,673,0,0,,689,657
23,06-08-17,44,10:45,11:00,,23.42,0,23.42,23.42,-1,-51938,56539,108477,4601,0,-7536,0,0,0,,7536,-7536
23,06-08-17,45,11:00,11:15,25.49,24.75,0,25.49,25.49,1,-48907,42188,91095,-6719,0,-5724,246,0,0,,5970,-5478
23,06-08-17,46,11:15,11:30,25.49,20.49,0,20.49,20.49,-1,-34811,53453,88264,18642,0,-8322,17,0,0,,8339,-8305
23,06-08-17,47,11:30,11:45,,24.11,0,24.11,24.11,-1,-37787,48764,86551,10977,0,-14874,0,0,0,,14874,-14874
23,06-08-17,48,11:45,12:00,,24.49,0,24.49,24.49,-1,-43391,52955,96346,9564,0,-11536,0,0,0,,11536,-11536
23,06-08-17,49,12:00,12:15,,23.83,0,23.83,23.83,-1,-43239,59602,102841,16363,0,-13248,0,0,0,,13248,-13248
23,06-08-17,50,12:15,12:30,25.49,24.49,0,26.8,24.49,2,-64360,54536,118896,-9824,0,-8096,127,0,0,,8223,-7969
23,06-08-17,51,12:30,12:45,27.49,24.49,0,27.49,27.49,1,-75759,49264,125023,-26495,0,-244,3604,0,0,,3848,3360
23,06-08-17,52,12:45,13:00,25.49,,0,25.49,25.49,1,-70051,52233,122284,-17818,0,0,1092,0,0,,1092,1092
23,06-08-17,53,13:00,13:15,25.49,,0,25.49,25.49,1,-66839,47147,113986,-19692,0,0,575,0,0,,575,575
23,06-08-17,54,13:15,13:30,25.49,,0,25.49,25.49,1,-57602,49147,106749,-8455,0,0,486,0,0,,486,486
23,06-08-17,55,13:30,13:45,,24.49,0,24.49,24.49,-1,-48455,70172,118627,21717,0,-2133,0,0,0,,2133,-2133
23,06-08-17,56,13:45,14:00,,1.24,0,1.24,1.24,-1,-43292,92736,136028,49444,0,-27820,0,0,0,,27820,-27820
23,06-08-17,57,14:00,14:15,,20.49,0,20.49,20.49,-1,-58052,113261,171313,55209,0,-35877,0,0,0,,35877,-35877
23,06-08-17,58,14:15,14:30,,12.91,0,12.91,12.91,-1,-38617,119460,158077,80843,0,-25964,0,0,0,,25964,-25964
23,06-08-17,59,14:30,14:45,,15.49,0,15.49,15.49,-1,-42393,122378,164771,79985,0,-38382,0,0,0,,38382,-38382
23,06-08-17,60,14:45,15:00,,15.49,0,15.49,15.49,-1,-61632,126350,187982,64718,0,-45308,0,0,0,,45308,-45308
23,06-08-17,61,15:00,15:15,,24.49,0,24.49,24.49,-1,-43816,119650,163466,75834,0,-19466,0,0,0,,19466,-19466
23,06-08-17,62,15:15,15:30,,,0,26.86,26.86,0,-62554,96778,159332,34224,0,0,0,0,0,,0,0
23,06-08-17,63,15:30,15:45,,,0,26.84,26.84,0,-32374,78688,111062,46314,0,0,0,0,0,,0,0
23,06-08-17,64,15:45,16:00,,,0,26.83,26.83,0,-39408,64742,104150,25334,0,0,0,0,0,,0,0
23,06-08-17,65,16:00,16:15,25.49,,0,25.49,25.49,1,-71046,69307,140353,-1739,0,0,3,0,0,,3,3
23,06-08-17,66,16:15,16:30,,,0,26.84,26.84,0,-58789,67347,126136,8558,0,0,0,0,0,,0,0
23,06-08-17,67,16:30,16:45,31.54,,0,31.54,31.54,1,-81500,63844,145344,-17656,0,0,2478,0,0,,2478,2478
23,06-08-17,68,16:45,17:00,42.74,,0,42.74,42.74,1,-92777,54670,147447,-38107,0,0,16903,0,0,,16903,16903
23,06-08-17,69,17:00,17:15,42.74,25.49,0,25.49,25.49,-1,-92156,116417,208573,24261,0,-2227,1534,0,0,,3761,-693
23,06-08-17,70,17:15,17:30,27.49,27.74,0,27.49,27.49,1,-86973,85701,172674,-1272,0,-647,128,0,0,,775,-519
23,06-08-17,71,17:30,17:45,31.49,,0,31.49,31.49,1,-84027,76531,160558,-7496,0,0,4249,0,0,,4249,4249
23,06-08-17,72,17:45,18:00,31.49,,0,31.49,31.49,1,-85545,69964,155509,-15581,0,0,10910,0,0,,10910,10910
23,06-08-17,73,18:00,18:15,28.46,25.74,0,25.74,25.74,-1,-108097,93290,201387,-14807,0,-90,9140,0,0,,9230,9050
23,06-08-17,74,18:15,18:30,28.46,25.74,0,25.74,25.74,-1,-92638,127562,220200,34924,0,-503,423,0,0,,926,-80
23,06-08-17,75,18:30,18:45,,,0,27.15,27.15,0,-83702,115096,198798,31394,0,0,0,0,0,,0,0
23,06-08-17,76,18:45,19:00,,,0,27.16,27.16,0,-86077,95660,181737,9583,0,0,0,0,0,,0,0
23,06-08-17,77,19:00,19:15,,,0,27.14,27.14,0,-51746,91325,143071,39579,0,0,0,0,0,,0,0
23,06-08-17,78,19:15,19:30,33.91,,0,33.91,33.91,1,-54387,48958,103345,-5429,0,0,2246,0,0,,2246,2246
23,06-08-17,79,19:30,19:45,29.09,,0,29.09,29.09,1,-52152,46780,98932,-5372,0,0,6488,0,0,,6488,6488
23,06-08-17,80,19:45,20:00,33.91,,0,33.91,33.91,1,-65196,53283,118479,-11913,0,0,4483,0,0,,4483,4483
23,06-08-17,81,20:00,20:15,29.09,,0,29.09,29.09,1,-75573,72725,148298,-2848,0,0,6140,0,0,,6140,6140
23,06-08-17,82,20:15,20:30,47.87,,0,47.87,47.87,1,-87806,56119,143925,-31687,0,0,12528,0,0,,12528,12528
23,06-08-17,83,20:30,20:45,36.87,,0,36.87,36.87,1,-91264,61882,153146,-29382,0,0,26452,0,0,,26452,26452
23,06-08-17,84,20:45,21:00,30.12,25.55,0,25.55,25.55,-1,-75529,86897,162426,11368,0,-557,12377,0,0,,12934,11820
23,06-08-17,85,21:00,21:15,,,0,27.17,27.17,0,-63597,74612,138209,11015,0,-133,113,0,0,,246,-20
23,06-08-17,86,21:15,21:30,,,0,27.14,27.14,0,-54821,61723,116544,6902,0,0,0,0,0,,0,0
23,06-08-17,87,21:30,21:45,,,0,27.15,27.15,0,-64536,66155,130691,1619,0,0,0,0,0,,0,0
23,06-08-17,88,21:45,22:00,27.6,,0,27.6,27.6,1,-71271,57417,128688,-13854,0,0,3471,0,0,,3471,3471
23,06-08-17,89,22:00,22:15,27.6,24.49,0,24.49,24.49,-1,-62296,74605,136901,12309,0,-314,486,0,0,,800,172
23,06-08-17,90,22:15,22:30,,,0,27.13,27.13,0,-87527,51303,138830,-36224,0,0,0,0,0,,0,0
23,06-08-17,91,22:30,22:45,29.51,,0,29.51,29.51,1,-84539,55772,140311,-28767,0,0,1832,0,0,,1832,1832
23,06-08-17,92,22:45,23:00,26.13,24.49,0,27.15,24.49,2,-72967,80122,153089,7155,0,-1382,265,0,0,,1647,-1117
23,06-08-17,93,23:00,23:15,,25.49,0,25.49,25.49,-1,-120564,68431,188995,-52133,0,-2483,0,0,0,,2483,-2483
23,06-08-17,94,23:15,23:30,,,0,26.79,26.79,0,-98129,40412,138541,-57717,0,0,0,0,0,,0,0
23,06-08-17,95,23:30,23:45,,,0,26.83,26.83,0,-91246,47933,139179,-43313,0,0,0,0,0,,0,0
23,06-08-17,96,23:45,0:00,25.49,,0,25.49,25.49,1,-89474,29452,118926,-60022,0,0,35,0,0,,35,35
23,06-09-17,1,0:00,0:15,37.67,,0,37.67,37.67,1,-113866,68992,182858,-44874,0,0,6939,0,0,,6939,6939
23,06-09-17,2,0:15,0:30,37.67,,0,37.67,37.67,1,-121365,27893,149258,-93472,0,0,20797,0,0,,20797,20797
23,06-09-17,3,0:30,0:45,,,0,27.28,27.28,0,-84412,34316,118728,-50096,0,0,4283,0,0,,4283,4283
23,06-09-17,4,0:45,1:00,,,0,27.28,27.28,0,-85146,42660,127806,-42486,0,0,0,0,0,,0,0
23,06-09-17,5,1:00,1:15,180.67,,0,180.67,180.67,1,-107014,16775,123789,-90239,0,0,17201,0,0,,17201,17201
23,06-09-17,6,1:15,1:30,37.67,,0,37.67,37.67,1,-83737,21415,105152,-62322,0,0,16783,0,0,,16783,16783
23,06-09-17,7,1:30,1:45,,,0,35.07,35.07,0,-103235,29005,132240,-74230,0,0,17,0,0,,17,17
23,06-09-17,8,1:45,2:00,,,0,35.07,35.07,0,-79046,37150,116196,-41896,0,0,0,0,0,,0,0
23,06-09-17,9,2:00,2:15,28.69,,0,28.69,28.69,1,-57381,45985,103366,-11396,0,0,1486,0,0,,1486,1486
23,06-09-17,10,2:15,2:30,27.67,40.03,0,32.85,32.85,2,-52859,53938,106797,1079,0,-3,1518,0,0,,1521,1515
23,06-09-17,11,2:30,2:45,27.67,20.67,0,20.67,20.67,-1,-49022,73094,122116,24072,0,-12512,45,0,0,,12557,-12467
23,06-09-17,12,2:45,3:00,,-7.89,0,-7.89,-7.89,-1,-52208,107507,159715,55299,0,-21711,0,0,0,,21711,-21711
23,06-09-17,13,3:00,3:15,,-20.03,0,-20.03,-20.03,-1,-37797,128131,165928,90334,0,-18924,0,0,0,,18924,-18924
23,06-09-17,14,3:15,3:30,,-150.03,0,-150.03,-150.03,-1,-23982,162788,186770,138806,0,-27055,0,0,0,,27055,-27055
23,06-09-17,15,3:30,3:45,,-150.03,0,-150.03,-150.03,-1,-27342,189844,217186,162502,0,-68105,0,0,0,,68105,-68105
23,06-09-17,16,3:45,4:00,,-14.03,0,-14.03,-14.03,-1,-39026,147302,186328,108276,0,-70126,0,0,0,,70126,-70126
23,06-09-17,17,4:00,4:15,,,0,27.28,27.28,0,-76057,132422,208479,56365,0,-16775,0,0,0,,16775,-16775
23,06-09-17,18,4:15,4:30,,-150.03,0,-150.03,-150.03,-1,-40322,201490,241812,161168,0,-24754,0,0,0,,24754,-24754
23,06-09-17,19,4:30,4:45,,-150.03,0,-150.03,-150.03,-1,-65197,235786,300983,170589,0,-70298,0,0,0,,70298,-70298
23,06-09-17,20,4:45,5:00,,-8.66,0,-8.66,-8.66,-1,-79357,236504,315861,157147,0,-71948,0,0,0,,71948,-71948
23,06-09-17,21,5:00,5:15,,,0,27.28,27.28,0,-131710,140525,272235,8815,0,-17063,0,0,0,,17063,-17063
23,06-09-17,22,5:15,5:30,,,0,27.28,27.28,0,-78462,120252,198714,41790,0,0,0,0,0,,0,0
23,06-09-17,23,5:30,5:45,,,0,27.28,27.28,0,-104166,155822,259988,51656,0,0,0,0,0,,0,0
23,06-09-17,24,5:45,6:00,31.67,,0,31.67,31.67,1,-112902,159226,272128,46324,0,0,834,0,0,,834,834
23,06-09-17,25,6:00,6:15,98.02,,0,98.02,98.02,1,-169597,55375,224972,-114222,0,0,27201,0,0,,27201,27201
23,06-09-17,26,6:15,6:30,25.69,,0,25.69,25.69,1,-66644,64106,130750,-2538,0,0,3167,0,0,,3167,3167
23,06-09-17,27,6:30,6:45,137.56,,0,137.56,137.56,1,-96842,25264,122106,-71578,0,0,22846,0,0,,22846,22846
23,06-09-17,28,6:45,7:00,45.79,,0,45.79,45.79,1,-71573,60014,131587,-11559,0,0,42419,0,0,,42419,42419
23,06-09-17,29,7:00,7:15,45.79,8.79,0,8.79,8.79,-1,-36557,101134,137691,64577,0,-8062,4285,0,0,,12347,-3777
23,06-09-17,30,7:15,7:30,51.88,28.49,0,51.88,51.88,1,-97136,52982,150118,-44154,0,-1104,5510,0,0,,6614,4406
23,06-09-17,31,7:30,7:45,254.11,,0,254.11,254.11,1,-172099,57504,229603,-114595,0,0,48145,0,0,,48145,48145
23,06-09-17,32,7:45,8:00,254.11,,0,254.11,254.11,1,-180049,72160,252209,-107889,0,0,86090,0,0,,86090,86090
23,06-09-17,33,8:00,8:15,72.02,,0,72.02,72.02,1,-123816,99000,222816,-24816,0,0,35085,0,0,,35085,35085
23,06-09-17,34,8:15,8:30,48.59,,0,48.59,48.59,1,-118379,64155,182534,-54224,0,0,23573,0,0,,23573,23573
23,06-09-17,35,8:30,8:45,269.83,,0,269.83,269.83,1,-120634,57245,177879,-63389,0,0,59984,0,0,,59984,59984
23,06-09-17,36,8:45,9:00,89.82,,0,89.82,89.82,1,-136937,58152,195089,-78785,0,0,41177,0,0,,41177,41177
23,06-09-17,37,9:00,9:15,86.56,,0,86.56,86.56,1,-137626,114754,252380,-22872,0,0,24347,0,0,,24347,24347
23,06-09-17,38,9:15,9:30,129.02,,0,129.02,129.02,1,-169903,68943,238846,-100960,0,0,21951,0,0,,21951,21951
23,06-09-17,39,9:30,9:45,129.02,,0,129.02,129.02,1,-166995,65344,232339,-101651,0,0,82190,0,0,,82190,82190
23,06-09-17,40,9:45,10:00,129.02,,0,129.02,129.02,1,-159710,72243,231953,-87467,0,0,80203,0,0,,80203,80203
23,06-09-17,41,10:00,10:15,158.37,,0,158.37,158.37,1,-199978,54808,254786,-145170,0,0,55285,0,0,,55285,55285
23,06-09-17,42,10:15,10:30,50.61,,0,50.61,50.61,1,-164342,52675,217017,-111667,0,0,52028,0,0,,52028,52028
23,06-09-17,43,10:30,10:45,46.22,,0,46.22,46.22,1,-155886,51762,207648,-104124,0,0,27100,0,0,,27100,27100
23,06-09-17,44,10:45,11:00,30.35,,0,30.35,30.35,1,-124872,55916,180788,-68956,0,0,17837,0,0,,17837,17837
23,06-09-17,45,11:00,11:15,127.02,,0,127.02,127.02,1,-168159,64169,232328,-103990,0,0,22656,0,0,,22656,22656
23,06-09-17,46,11:15,11:30,38.02,,0,38.02,38.02,1,-175900,100563,276463,-75337,0,0,28301,0,0,,28301,28301
23,06-09-17,47,11:30,11:45,31.39,,0,31.39,31.39,1,-161242,122534,283776,-38708,0,0,17334,0,0,,17334,17334
23,06-09-17,48,11:45,12:00,31.39,28.49,0,28.49,28.49,-1,-139789,151095,290884,11306,0,-608,1607,0,0,,2215,999
23,06-09-17,49,12:00,12:15,42.38,28.62,0,42.38,27.96,2,-186711,117039,303750,-69672,0,-110,7483,0,0,,7593,7373
23,06-09-17,50,12:15,12:30,28.99,,0,28.99,28.99,1,-158954,128376,287330,-30578,0,0,5845,0,0,,5845,5845
23,06-09-17,51,12:30,12:45,,,0,27.96,27.96,0,-104768,109709,214477,4941,0,0,45,0,0,,45,45
23,06-09-17,52,12:45,13:00,,28.49,0,28.49,28.49,-1,-64547,77675,142222,13128,0,-220,0,0,0,,220,-220
23,06-09-17,53,13:00,13:15,,28.35,0,28.35,28.35,-1,-49977,32058,82035,-17919,0,-750,0,0,0,,750,-750
23,06-09-17,54,13:15,13:30,,,0,27.27,27.27,0,-55241,36325,91566,-18916,0,0,0,0,0,,0,0
23,06-09-17,55,13:30,13:45,,27.35,0,27.35,27.35,-1,-63231,69940,133171,6709,0,-3052,0,0,0,,3052,-3052
23,06-09-17,56,13:45,14:00,,23.35,0,23.35,23.35,-1,-84820,104781,189601,19961,0,-20025,0,0,0,,20025,-20025
23,06-09-17,57,14:00,14:15,28.99,27.35,0,28.99,28.99,1,-96148,92202,188350,-3946,0,-8408,458,0,0,,8866,-7950
23,06-09-17,58,14:15,14:30,29.02,27.35,0,29.02,29.02,1,-135988,95819,231807,-40169,0,-12,3394,0,0,,3406,3382
23,06-09-17,59,14:30,14:45,28.99,,0,28.99,28.99,1,-152086,93610,245696,-58476,0,0,2327,0,0,,2327,2327
23,06-09-17,60,14:45,15:00,,,0,27.22,27.22,0,-151383,133283,284666,-18100,0,0,312,0,0,,312,312
23,06-09-17,61,15:00,15:15,34.35,,0,34.35,34.35,1,-156689,116900,273589,-39789,0,0,5720,0,0,,5720,5720
23,06-09-17,62,15:15,15:30,28.99,,0,28.99,28.99,1,-158919,123299,282218,-35620,0,0,7717,0,0,,7717,7717
23,06-09-17,63,15:30,15:45,28.35,,0,28.35,28.35,1,-138875,113420,252295,-25455,0,0,2830,0,0,,2830,2830
23,06-09-17,64,15:45,16:00,,,0,27.18,27.18,0,-134700,129264,263964,-5436,0,0,253,0,0,,253,253
23,06-09-17,65,16:00,16:15,30.35,,0,30.35,30.35,1,-181556,162201,343757,-19355,0,0,1222,0,0,,1222,1222
23,06-09-17,66,16:15,16:30,30.35,28.35,0,28.35,28.35,-1,-140529,195574,336103,55045,0,-300,27,0,0,,327,-273
23,06-09-17,67,16:30,16:45,,28.49,0,28.49,28.49,-1,-138223,173044,311267,34821,0,-1073,0,0,0,,1073,-1073
23,06-09-17,68,16:45,17:00,,,0,27.14,27.14,0,-139454,146793,286247,7339,0,-43,0,0,0,,43,-43
23,06-09-17,69,17:00,17:15,,,0,27.15,27.15,0,-139722,164432,304154,24710,0,0,0,0,0,,0,0
23,06-09-17,70,17:15,17:30,,,0,27.15,27.15,0,-116929,149692,266621,32763,0,0,0,0,0,,0,0
23,06-09-17,71,17:30,17:45,,,0,27.15,27.15,0,-118824,132507,251331,13683,0,0,0,0,0,,0,0
23,06-09-17,72,17:45,18:00,,,0,27.14,27.14,0,-117658,138107,255765,20449,0,0,0,0,0,,0,0
23,06-09-17,73,18:00,18:15,,23.35,0,23.35,23.35,-1,-73277,113962,187239,40685,0,-5545,0,0,0,,5545,-5545
23,06-09-17,74,18:15,18:30,,23.35,0,23.35,23.35,-1,-58690,101482,160172,42792,0,-20250,0,0,0,,20250,-20250
23,06-09-17,75,18:30,18:45,,27.35,0,27.35,27.35,-1,-60733,106306,167039,45573,0,-10651,0,0,0,,10651,-10651
23,06-09-17,76,18:45,19:00,,,0,27.96,27.96,0,-62562,110709,173271,48147,0,-1129,0,0,0,,1129,-1129
23,06-09-17,77,19:00,19:15,,25.09,0,25.09,25.09,-1,-57262,114154,171416,56892,0,-2980,0,0,0,,2980,-2980
23,06-09-17,78,19:15,19:30,,25.17,0,25.17,25.17,-1,-55156,127078,182234,71922,0,-8856,0,0,0,,8856,-8856
23,06-09-17,79,19:30,19:45,,27.35,0,27.35,27.35,-1,-57842,112535,170377,54693,0,-7775,0,0,0,,7775,-7775
23,06-09-17,80,19:45,20:00,28.96,27.35,0,28.96,28.96,1,-69121,80592,149713,11471,0,-365,112,0,0,,477,-253
23,06-09-17,81,20:00,20:15,28.35,27.35,0,28.62,27.35,2,-39298,66144,105442,26846,0,-836,5,0,0,,841,-831
23,06-09-17,82,20:15,20:30,,25.09,0,25.09,25.09,-1,-47288,41318,88606,-5970,0,-4185,0,0,0,,4185,-4185
23,06-09-17,83,20:30,20:45,30.35,25.09,0,30.35,30.35,1,-61967,31194,93161,-30773,0,-11,2461,0,0,,2472,2450
23,06-09-17,84,20:45,21:00,28.69,,0,28.69,28.69,1,-73189,30320,103509,-42869,0,0,1650,0,0,,1650,1650
23,06-09-17,85,21:00,21:15,31.39,,0,31.39,31.39,1,-67566,19863,87429,-47703,0,0,1773,0,0,,1773,1773
23,06-09-17,86,21:15,21:30,31.76,,0,31.76,31.76,1,-44753,22498,67251,-22255,0,0,5953,0,0,,5953,5953
23,06-09-17,87,21:30,21:45,,,0,34.24,34.24,0,-39591,26202,65793,-13389,0,0,226,0,0,,226,226
23,06-09-17,88,21:45,22:00,,,0,34.24,34.24,0,-48680,27497,76177,-21183,0,0,0,0,0,,0,0
23,06-09-17,89,22:00,22:15,,28.35,0,28.35,28.35,-1,-27555,35026,62581,7471,0,-1992,0,0,0,,1992,-1992
23,06-09-17,90,22:15,22:30,,28.49,0,28.49,28.49,-1,-71049,25104,96153,-45945,0,-1004,0,0,0,,1004,-1004
23,06-09-17,91,22:30,22:45,44.99,,0,44.99,44.99,1,-88949,32583,121532,-56366,0,0,1995,0,0,,1995,1995
23,06-09-17,92,22:45,23:00,218.29,,0,218.29,218.29,1,-113904,42566,156470,-71338,0,0,29713,0,0,,29713,29713
23,06-09-17,93,23:00,23:15,42.01,,0,42.01,42.01,1,-87535,19606,107141,-67929,0,0,13357,0,0,,13357,13357
23,06-09-17,94,23:15,23:30,29.71,,0,29.71,29.71,1,-85960,16828,102788,-69132,0,0,11236,0,0,,11236,11236
23,06-09-17,95,23:30,23:45,,,0,34.38,34.38,0,-84573,18189,102762,-66384,0,0,480,0,0,,480,480
23,06-09-17,96,23:45,0:00,,28.35,0,28.35,28.35,-1,-98386,34929,133315,-63457,0,-31,0,0,0,,31,-31
24,06-10-17,1,0:00,0:15,127.12,27.9,0,127.12,27.9,2,-75639,46613,122252,-29026,0,-889,5740,0,0,,6629,4851
24,06-10-17,2,0:15,0:30,127.12,,0,127.12,127.12,1,-64786,29712,94498,-35074,0,0,39650,0,0,,39650,39650
24,06-10-17,3,0:30,0:45,127.12,28.77,0,28.77,28.77,-1,-41296,49632,90928,8336,0,-992,786,0,0,,1778,-206
24,06-10-17,4,0:45,1:00,,28.79,0,28.79,28.79,-1,-62154,30752,92906,-31402,0,-1582,0,0,0,,1582,-1582
24,06-10-17,5,1:00,1:15,28.9,28.9,0,28.9,27.2,2,-78551,140367,218918,61816,0,-958,13,0,0,,971,-945
24,06-10-17,6,1:15,1:30,127.12,,0,127.12,127.12,1,-83997,13608,97605,-70389,0,0,26434,0,0,,26434,26434
24,06-10-17,7,1:30,1:45,35.9,,0,35.9,35.9,1,-48180,36917,85097,-11263,0,0,16448,0,0,,16448,16448
24,06-10-17,8,1:45,2:00,35.9,24.99,0,24.99,24.99,-1,-41240,55321,96561,14081,0,-2831,150,0,0,,2981,-2681
24,06-10-17,9,2:00,2:15,30.9,23.9,0,30.9,30.9,1,-42128,61743,103871,19615,0,-3849,365,0,0,,4214,-3484
24,06-10-17,10,2:15,2:30,40.9,,0,40.9,40.9,1,-71812,14564,86376,-57248,0,0,7837,0,0,,7837,7837
24,06-10-17,11,2:30,2:45,33.79,,0,33.79,33.79,1,-55195,27683,82878,-27512,0,0,6639,0,0,,6639,6639
24,06-10-17,12,2:45,3:00,29.38,28.69,0,28.69,28.69,-1,-38446,32361,70807,-6085,0,-185,6877,0,0,,7062,6692
24,06-10-17,13,3:00,3:15,29.37,28.69,0,29.37,27.29,2,-30688,14672,45360,-16016,0,-535,777,0,0,,1312,242
24,06-10-17,14,3:15,3:30,27.12,27.9,0,27.29,27.29,2,-17060,18420,35480,1360,0,-313,269,0,0,,582,-44
24,06-10-17,15,3:30,3:45,,27.9,0,27.9,27.9,-1,-16474,28266,44740,11792,0,-3457,0,0,0,,3457,-3457
24,06-10-17,16,3:45,4:00,,26.6,0,26.6,26.6,-1,-17207,31657,48864,14450,0,-4490,0,0,0,,4490,-4490
24,06-10-17,17,4:00,4:15,,28.36,0,28.36,28.36,-1,-17106,21921,39027,4815,0,-3706,0,0,0,,3706,-3706
24,06-10-17,18,4:15,4:30,28.9,28.36,0,28.9,28.9,1,-31621,14347,45968,-17274,0,-3,2315,0,0,,2318,2312
24,06-10-17,19,4:30,4:45,27.12,,0,27.12,27.12,1,-22594,14225,36819,-8369,0,0,467,0,0,,467,467
24,06-10-17,20,4:45,5:00,,28.72,0,28.72,28.72,-1,-25438,26988,52426,1550,0,-449,0,0,0,,449,-449
24,06-10-17,21,5:00,5:15,,28.75,0,28.75,28.75,-1,-23405,17469,40874,-5936,0,-697,0,0,0,,697,-697
24,06-10-17,22,5:15,5:30,,,0,27.46,27.46,0,-14216,20030,34246,5814,0,0,0,0,0,,0,0
24,06-10-17,23,5:30,5:45,28.9,,0,28.9,28.9,1,-21970,16099,38069,-5871,0,0,137,0,0,,137,137
24,06-10-17,24,5:45,6:00,28.9,,0,28.9,28.9,1,-30726,24801,55527,-5925,0,0,1198,0,0,,1198,1198
24,06-10-17,25,6:00,6:15,29.01,,0,29.01,29.01,1,-40617,18719,59336,-21898,0,0,1111,0,0,,1111,1111
24,06-10-17,26,6:15,6:30,30.15,,0,30.15,30.15,1,-43552,14817,58369,-28735,0,0,5930,0,0,,5930,5930
24,06-10-17,27,6:30,6:45,50.85,,0,50.85,50.85,1,-63763,12096,75859,-51667,0,0,27611,0,0,,27611,27611
24,06-10-17,28,6:45,7:00,36.54,,0,36.54,36.54,1,-70678,28346,99024,-42332,0,0,41889,0,0,,41889,41889
24,06-10-17,29,7:00,7:15,36.54,-11.89,0,-11.89,-11.89,-1,-13861,68043,81904,54182,0,-9644,12451,0,0,,22095,2807
24,06-10-17,30,7:15,7:30,,27.95,0,27.95,27.95,-1,-37253,57257,94510,20004,0,-2629,0,0,0,,2629,-2629
24,06-10-17,31,7:30,7:45,,28.95,0,28.95,28.95,-1,-44644,60578,105222,15934,0,-46,0,0,0,,46,-46
24,06-10-17,32,7:45,8:00,,28.95,0,28.95,28.95,-1,-54006,80350,134356,26344,0,-58,0,0,0,,58,-58
24,06-10-17,33,8:00,8:15,,27.95,0,27.95,27.95,-1,-51573,85138,136711,33565,0,-2616,0,0,0,,2616,-2616
24,06-10-17,34,8:15,8:30,,26.59,0,26.59,26.59,-1,-46198,75689,121887,29491,0,-6938,0,0,0,,6938,-6938
24,06-10-17,35,8:30,8:45,,24.98,0,24.98,24.98,-1,-49754,72802,122556,23048,0,-5876,0,0,0,,5876,-5876
24,06-10-17,36,8:45,9:00,,27.95,0,27.95,27.95,-1,-58868,77132,136000,18264,0,-5084,0,0,0,,5084,-5084
24,06-10-17,37,9:00,9:15,,27.95,0,27.95,27.95,-1,-39211,90388,129599,51177,0,-2557,0,0,0,,2557,-2557
24,06-10-17,38,9:15,9:30,,28.95,0,28.95,28.95,-1,-37706,62618,100324,24912,0,-820,0,0,0,,820,-820
24,06-10-17,39,9:30,9:45,25.69,,0,25.69,25.69,1,-48774,45707,94481,-3067,0,0,65,0,0,,65,65
24,06-10-17,40,9:45,10:00,26.12,,0,26.12,26.12,1,-53386,48483,101869,-4903,0,0,285,0,0,,285,285
24,06-10-17,41,10:00,10:15,29.39,,0,29.39,29.39,1,-48660,23033,71693,-25627,0,0,3883,0,0,,3883,3883
24,06-10-17,42,10:15,10:30,47.9,,0,47.9,47.9,1,-61762,25138,86900,-36624,0,0,19141,0,0,,19141,19141
24,06-10-17,43,10:30,10:45,29,28.95,0,29,27.22,2,-54652,45181,99833,-9471,0,-260,5033,0,0,,5293,4773
24,06-10-17,44,10:45,11:00,29,,0,29,29,1,-60690,50918,111608,-9772,0,0,3332,0,0,,3332,3332
24,06-10-17,45,11:00,11:15,26.12,,0,26.12,26.12,1,-74470,77151,151621,2681,0,0,583,0,0,,583,583
24,06-10-17,46,11:15,11:30,,,0,27.54,27.54,0,-69525,107020,176545,37495,0,0,0,0,0,,0,0
24,06-10-17,47,11:30,11:45,,,0,27.54,27.54,0,-67235,107363,174598,40128,0,0,0,0,0,,0,0
24,06-10-17,48,11:45,12:00,,28.95,0,28.95,28.95,-1,-61779,112706,174485,50927,0,-9,0,0,0,,9,-9
24,06-10-17,49,12:00,12:15,,19.96,0,19.96,19.96,-1,-36208,107707,143915,71499,0,-9587,0,0,0,,9587,-9587
24,06-10-17,50,12:15,12:30,,13.42,0,13.42,13.42,-1,-55265,114057,169322,58792,0,-42003,0,0,0,,42003,-42003
24,06-10-17,51,12:30,12:45,,19.96,0,19.96,19.96,-1,-61423,112399,173822,50976,0,-25006,0,0,0,,25006,-25006
24,06-10-17,52,12:45,13:00,,,0,27.54,27.54,0,-61333,113978,175311,52645,0,-32,0,0,0,,32,-32
24,06-10-17,53,13:00,13:15,28.91,,0,28.91,28.91,1,-116305,118384,234689,2079,0,0,62,0,0,,62,62
24,06-10-17,54,13:15,13:30,47.62,,0,47.62,47.62,1,-167492,92478,259970,-75014,0,0,6269,0,0,,6269,6269
24,06-10-17,55,13:30,13:45,50.37,,0,50.37,50.37,1,-183211,108083,291294,-75128,0,0,24279,0,0,,24279,24279
24,06-10-17,56,13:45,14:00,29.09,,0,29.09,29.09,1,-179799,114910,294709,-64889,0,0,8656,0,0,,8656,8656
24,06-10-17,57,14:00,14:15,30.95,,0,30.95,30.95,1,-136556,104450,241006,-32106,0,0,3402,0,0,,3402,3402
24,06-10-17,58,14:15,14:30,34.95,,0,34.95,34.95,1,-122820,83938,206758,-38882,0,0,23542,0,0,,23542,23542
24,06-10-17,59,14:30,14:45,30.35,,0,30.35,30.35,1,-126658,108738,235396,-17920,0,0,16645,0,0,,16645,16645
24,06-10-17,60,14:45,15:00,30.35,27.95,0,27.95,27.95,-1,-126420,122218,248638,-4202,0,-1308,1332,0,0,,2640,24
24,06-10-17,61,15:00,15:15,,,0,27.24,27.24,0,-148791,113863,262654,-34928,0,0,0,0,0,,0,0
24,06-10-17,62,15:15,15:30,,,0,27.24,27.24,0,-127387,91429,218816,-35958,0,0,0,0,0,,0,0
24,06-10-17,63,15:30,15:45,,,0,27.24,27.24,0,-125838,91348,217186,-34490,0,0,0,0,0,,0,0
24,06-10-17,64,15:45,16:00,,,0,27.24,27.24,0,-126422,109413,235835,-17009,0,0,0,0,0,,0,0
24,06-10-17,65,16:00,16:15,,,0,27.15,27.15,0,-123218,84167,207385,-39051,0,0,0,0,0,,0,0
24,06-10-17,66,16:15,16:30,28.95,,0,28.95,28.95,1,-114244,92008,206252,-22236,0,0,1292,0,0,,1292,1292
24,06-10-17,67,16:30,16:45,28.95,,0,28.95,28.95,1,-115746,102381,218127,-13365,0,0,4014,0,0,,4014,4014
24,06-10-17,68,16:45,17:00,28.95,,0,28.95,28.95,1,-117931,116562,234493,-1369,0,0,3039,0,0,,3039,3039
24,06-10-17,69,17:00,17:15,32.09,,0,32.09,32.09,1,-178898,96534,275432,-82364,0,0,5133,0,0,,5133,5133
24,06-10-17,70,17:15,17:30,30.95,,0,30.95,30.95,1,-133259,86657,219916,-46602,0,0,2192,0,0,,2192,2192
24,06-10-17,71,17:30,17:45,126.12,,0,126.12,126.12,1,-128704,35686,164390,-93018,0,0,11793,0,0,,11793,11793
24,06-10-17,72,17:45,18:00,126.12,,0,126.12,126.12,1,-122866,45857,168723,-77009,0,0,37245,0,0,,37245,37245
24,06-10-17,73,18:00,18:15,30.95,18.3,0,18.3,18.3,-1,-106947,86949,193896,-19998,0,-2104,15079,0,0,,17183,12975
24,06-10-17,74,18:15,18:30,30.95,3.2,0,3.2,3.2,-1,-67903,80032,147935,12129,0,-14398,12,0,0,,14410,-14386
24,06-10-17,75,18:30,18:45,,,0,36.58,36.58,0,-70265,59585,129850,-10680,0,-507,0,0,0,,507,-507
24,06-10-17,76,18:45,19:00,29.36,,0,29.36,29.36,1,-62062,56325,118387,-5737,0,0,2707,0,0,,2707,2707
24,06-10-17,77,19:00,19:15,29.23,,0,29.23,29.23,1,-66537,76493,143030,9956,0,0,4767,0,0,,4767,4767
24,06-10-17,78,19:15,19:30,,,0,28.04,28.04,0,-39098,61109,100207,22011,0,0,70,0,0,,70,70
24,06-10-17,79,19:30,19:45,,,0,27.92,27.92,0,-37712,66278,103990,28566,0,0,0,0,0,,0,0
24,06-10-17,80,19:45,20:00,,,0,27.92,27.92,0,-47061,54950,102011,7889,0,0,0,0,0,,0,0
24,06-10-17,81,20:00,20:15,,,0,27.91,27.91,0,-56422,63762,120184,7340,0,0,0,0,0,,0,0
24,06-10-17,82,20:15,20:30,,,0,27.92,27.92,0,-58602,69490,128092,10888,0,0,0,0,0,,0,0
24,06-10-17,83,20:30,20:45,,,0,27.93,27.93,0,-63050,60975,124025,-2075,0,0,0,0,0,,0,0
24,06-10-17,84,20:45,21:00,28.78,,0,28.78,28.78,1,-48952,48698,97650,-254,0,0,213,0,0,,213,213
24,06-10-17,85,21:00,21:15,33.79,,0,33.79,33.79,1,-94166,47944,142110,-46222,0,0,8110,0,0,,8110,8110
24,06-10-17,86,21:15,21:30,29.36,,0,29.36,29.36,1,-73162,58114,131276,-15048,0,0,9835,0,0,,9835,9835
24,06-10-17,87,21:30,21:45,29.36,28.38,0,28.38,28.38,-1,-62813,60500,123313,-2313,0,-799,981,0,0,,1780,182
24,06-10-17,88,21:45,22:00,,,0,28.18,28.18,0,-51938,61281,113219,9343,0,-157,0,0,0,,157,-157
24,06-10-17,89,22:00,22:15,,,0,28.16,28.16,0,-81286,68483,149769,-12803,0,0,0,0,0,,0,0
24,06-10-17,90,22:15,22:30,,,0,28.16,28.16,0,-88094,71899,159993,-16195,0,0,0,0,0,,0,0
24,06-10-17,91,22:30,22:45,,,0,28.17,28.17,0,-88442,90065,178507,1623,0,0,0,0,0,,0,0
24,06-10-17,92,22:45,23:00,,,0,28.18,28.18,0,-78290,96127,174417,17837,0,0,0,0,0,,0,0
24,06-10-17,93,23:00,23:15,31.94,,0,31.94,31.94,1,-102402,61423,163825,-40979,0,0,3430,0,0,,3430,3430
24,06-10-17,94,23:15,23:30,26.94,,0,26.94,26.94,1,-84590,69372,153962,-15218,0,0,945,0,0,,945,945
24,06-10-17,95,23:30,23:45,,28.34,0,28.34,28.34,-1,-72766,81788,154554,9022,0,-910,0,0,0,,910,-910
24,06-10-17,96,23:45,0:00,,25.61,0,25.61,25.61,-1,-69514,64094,133608,-5420,0,-1775,0,0,0,,1775,-1775
24,06-11-17,1,0:00,0:15,,23.69,0,23.69,23.69,-1,-77052,109312,186364,32260,0,-2391,0,0,0,,2391,-2391
24,06-11-17,2,0:15,0:30,,,0,27.35,27.35,0,-71983,39163,111146,-32820,0,0,0,0,0,,0,0
24,06-11-17,3,0:30,0:45,,,0,27.35,27.35,0,-59990,22606,82596,-37384,0,0,0,0,0,,0,0
24,06-11-17,4,0:45,1:00,26.13,,0,26.13,26.13,1,-110082,17250,127332,-92832,0,0,88,0,0,,88,88
24,06-11-17,5,1:00,1:15,28.98,25.86,0,28.98,25.86,2,-59888,87768,147656,27880,0,-334,83,0,0,,417,-251
24,06-11-17,6,1:15,1:30,69.02,,0,69.02,69.02,1,-73956,17400,91356,-56556,0,0,24258,0,0,,24258,24258
24,06-11-17,7,1:30,1:45,30.02,28.69,0,28.69,28.69,-1,-39686,38808,78494,-878,0,-43,13499,0,0,,13542,13456
24,06-11-17,8,1:45,2:00,30.02,27.69,0,27.69,27.69,-1,-47921,23810,71731,-24111,0,-507,295,0,0,,802,-212
24,06-11-17,9,2:00,2:15,26.13,26.99,0,26.86,26.86,2,-44571,61499,106070,16928,0,-1394,42,0,0,,1436,-1352
24,06-11-17,10,2:15,2:30,31.89,,0,31.89,31.89,1,-39999,16658,56657,-23341,0,0,7677,0,0,,7677,7677
24,06-11-17,11,2:30,2:45,28.13,,0,28.13,28.13,1,-39427,27907,67334,-11520,0,0,6669,0,0,,6669,6669
24,06-11-17,12,2:45,3:00,,,0,26.86,26.86,0,-38502,30696,69198,-7806,0,0,482,0,0,,482,482
24,06-11-17,13,3:00,3:15,28.13,,0,28.13,28.13,1,-52137,53363,105500,1226,0,0,460,0,0,,460,460
24,06-11-17,14,3:15,3:30,28.13,,0,28.13,28.13,1,-47637,39326,86963,-8311,0,0,3016,0,0,,3016,3016
24,06-11-17,15,3:30,3:45,,,0,26.86,26.86,0,-42632,44072,86704,1440,0,0,98,0,0,,98,98
24,06-11-17,16,3:45,4:00,26.13,26.99,0,26.86,26.86,2,-44379,37394,81773,-6985,0,-191,221,0,0,,412,30
24,06-11-17,17,4:00,4:15,,26.99,0,26.99,26.99,-1,-45148,55580,100728,10432,0,-794,0,0,0,,794,-794
24,06-11-17,18,4:15,4:30,,,0,26.86,26.86,0,-52587,43635,96222,-8952,0,0,0,0,0,,0,0
24,06-11-17,19,4:30,4:45,,26.99,0,26.99,26.99,-1,-39952,37792,77744,-2160,0,-2519,0,0,0,,2519,-2519
24,06-11-17,20,4:45,5:00,26.13,26.99,0,26.86,26.86,2,-31843,30768,62611,-1075,0,-3376,7,0,0,,3383,-3369
24,06-11-17,21,5:00,5:15,28.13,26.99,0,28.13,28.13,1,-35413,20042,55455,-15371,0,-143,1117,0,0,,1260,974
24,06-11-17,22,5:15,5:30,,27.69,0,27.69,27.69,-1,-24702,29563,54265,4861,0,-34,0,0,0,,34,-34
24,06-11-17,23,5:30,5:45,,2.6,0,2.6,2.6,-1,-14610,41254,55864,26644,0,-18640,0,0,0,,18640,-18640
24,06-11-17,24,5:45,6:00,,23.26,0,23.26,23.26,-1,-15118,35603,50721,20485,0,-24701,0,0,0,,24701,-24701
24,06-11-17,25,6:00,6:15,,23.24,0,23.24,23.24,-1,-20860,28434,49294,7574,0,-19887,0,0,0,,19887,-19887
24,06-11-17,26,6:15,6:30,27.94,23.24,0,27.94,27.94,1,-29813,22331,52144,-7482,0,-1648,211,0,0,,1859,-1437
24,06-11-17,27,6:30,6:45,,,0,26.86,26.86,0,-36266,19138,55404,-17128,0,0,0,0,0,,0,0
24,06-11-17,28,6:45,7:00,30.93,,0,30.93,30.93,1,-50275,20858,71133,-29417,0,0,4442,0,0,,4442,4442
24,06-11-17,29,7:00,7:15,29.37,,0,29.37,29.37,1,-57050,30817,87867,-26233,0,0,9551,0,0,,9551,9551
24,06-11-17,30,7:15,7:30,38.02,,0,38.02,38.02,1,-66245,29316,95561,-36929,0,0,23583,0,0,,23583,23583
24,06-11-17,31,7:30,7:45,30.93,,0,30.93,30.93,1,-61413,41159,102572,-20254,0,0,14582,0,0,,14582,14582
24,06-11-17,32,7:45,8:00,32.1,,0,32.1,32.1,1,-84392,37389,121781,-47003,0,0,5737,0,0,,5737,5737
24,06-11-17,33,8:00,8:15,25.94,,0,25.94,25.94,1,-28821,66623,95444,37802,0,0,1470,0,0,,1470,1470
24,06-11-17,34,8:15,8:30,,,0,27.32,27.32,0,-38397,76053,114450,37656,0,0,0,0,0,,0,0
24,06-11-17,35,8:30,8:45,,,0,27.32,27.32,0,-43763,73990,117753,30227,0,0,0,0,0,,0,0
24,06-11-17,36,8:45,9:00,,26.99,0,26.99,26.99,-1,-64647,78152,142799,13505,0,-39,0,0,0,,39,-39
24,06-11-17,37,9:00,9:15,,-99.06,0,-99.06,-99.06,-1,-40820,85096,125916,44276,0,-9014,0,0,0,,9014,-9014
24,06-11-17,38,9:15,9:30,,26.99,0,26.99,26.99,-1,-57396,67387,124783,9991,0,-1982,0,0,0,,1982,-1982
24,06-11-17,39,9:30,9:45,,27.89,0,27.89,27.89,-1,-66933,78792,145725,11859,0,-2706,0,0,0,,2706,-2706
24,06-11-17,40,9:45,10:00,,27.89,0,27.89,27.89,-1,-68654,82171,150825,13517,0,-1699,0,0,0,,1699,-1699
24,06-11-17,41,10:00,10:15,,28.69,0,28.69,28.69,-1,-60157,68010,128167,7853,0,-30,0,0,0,,30,-30
24,06-11-17,42,10:15,10:30,,28.69,0,28.69,28.69,-1,-54107,51792,105899,-2315,0,-530,0,0,0,,530,-530
24,06-11-17,43,10:30,10:45,,28.69,0,28.69,28.69,-1,-56876,47464,104340,-9412,0,-20,0,0,0,,20,-20
24,06-11-17,44,10:45,11:00,,27.69,0,27.69,27.69,-1,-58477,54706,113183,-3771,0,-948,0,0,0,,948,-948
24,06-11-17,45,11:00,11:15,31.94,27.69,0,31.94,26.99,2,-83343,45872,129215,-37471,0,-488,4670,0,0,,5158,4182
24,06-11-17,46,11:15,11:30,25.24,27.69,0,27.69,27.69,-1,-70058,49661,119719,-20397,0,-370,919,0,0,,1289,549
24,06-11-17,47,11:30,11:45,25.94,27.69,0,25.94,25.94,1,-78813,51998,130811,-26815,0,-89,34,0,0,,123,-55
24,06-11-17,48,11:45,12:00,25.94,,0,25.94,25.94,1,-68948,50825,119773,-18123,0,0,1367,0,0,,1367,1367
24,06-11-17,49,12:00,12:15,127.02,,0,127.02,127.02,1,-119551,31595,151146,-87956,0,0,27545,0,0,,27545,27545
24,06-11-17,50,12:15,12:30,31.94,,0,31.94,31.94,1,-75947,54468,130415,-21479,0,0,17212,0,0,,17212,17212
24,06-11-17,51,12:30,12:45,27.94,,0,27.94,27.94,1,-59106,67395,126501,8289,0,0,3035,0,0,,3035,3035
24,06-11-17,52,12:45,13:00,27.94,27.69,0,27.69,27.69,-1,-52077,66265,118342,14188,0,-677,407,0,0,,1084,-270
24,06-11-17,53,13:00,13:15,,26.99,0,26.99,26.99,-1,-60964,96110,157074,35146,0,-2721,0,0,0,,2721,-2721
24,06-11-17,54,13:15,13:30,,22.59,0,22.59,22.59,-1,-55026,85988,141014,30962,0,-6129,0,0,0,,6129,-6129
24,06-11-17,55,13:30,13:45,,26.99,0,26.99,26.99,-1,-43429,91636,135065,48207,0,-8054,0,0,0,,8054,-8054
24,06-11-17,56,13:45,14:00,,25.94,0,25.94,25.94,-1,-35031,99600,134631,64569,0,-3165,0,0,0,,3165,-3165
24,06-11-17,57,14:00,14:15,,22.32,0,22.32,22.32,-1,-45298,97892,143190,52594,0,-7622,0,0,0,,7622,-7622
24,06-11-17,58,14:15,14:30,,25.94,0,25.94,25.94,-1,-52301,94084,146385,41783,0,-3027,0,0,0,,3027,-3027
24,06-11-17,59,14:30,14:45,,28.69,0,28.69,28.69,-1,-65346,88406,153752,23060,0,-638,0,0,0,,638,-638
24,06-11-17,60,14:45,15:00,,23.49,0,23.49,23.49,-1,-56536,77356,133892,20820,0,-5788,0,0,0,,5788,-5788
24,06-11-17,61,15:00,15:15,,26.99,0,26.99,26.99,-1,-48036,109958,157994,61922,0,-5153,0,0,0,,5153,-5153
24,06-11-17,62,15:15,15:30,,,0,27.16,27.16,0,-58722,93160,151882,34438,0,-30,0,0,0,,30,-30
24,06-11-17,63,15:30,15:45,,,0,27.16,27.16,0,-61515,85480,146995,23965,0,0,0,0,0,,0,0
24,06-11-17,64,15:45,16:00,29.37,,0,29.37,29.37,1,-63806,73085,136891,9279,0,0,588,0,0,,588,588
24,06-11-17,65,16:00,16:15,25.63,,0,25.63,25.63,1,-55556,56296,111852,740,0,0,296,0,0,,296,296
24,06-11-17,66,16:15,16:30,29.37,,0,29.37,29.37,1,-68023,46912,114935,-21111,0,0,759,0,0,,759,759
24,06-11-17,67,16:30,16:45,52.7,,0,52.7,52.7,1,-112069,41205,153274,-70864,0,0,12868,0,0,,12868,12868
24,06-11-17,68,16:45,17:00,109.79,,0,109.79,109.79,1,-137756,65842,203598,-71914,0,0,42904,0,0,,42904,42904
24,06-11-17,69,17:00,17:15,27.94,,0,27.94,27.94,1,-106049,59016,165065,-47033,0,0,8866,0,0,,8866,8866
24,06-11-17,70,17:15,17:30,25.94,,0,25.94,25.94,1,-88983,40408,129391,-48575,0,0,43,0,0,,43,43
24,06-11-17,71,17:30,17:45,37.94,,0,37.94,37.94,1,-78276,35103,113379,-43173,0,0,5558,0,0,,5558,5558
24,06-11-17,72,17:45,18:00,25.94,,0,25.94,25.94,1,-91580,81503,173083,-10077,0,0,1319,0,0,,1319,1319
24,06-11-17,73,18:00,18:15,25.94,,0,25.94,25.94,1,-124050,45627,169677,-78423,0,0,2747,0,0,,2747,2747
24,06-11-17,74,18:15,18:30,,,0,35.87,35.87,0,-93149,91562,184711,-1587,0,0,277,0,0,,277,277
24,06-11-17,75,18:30,18:45,,,0,35.87,35.87,0,-73077,115454,188531,42377,0,0,0,0,0,,0,0
24,06-11-17,76,18:45,19:00,,,0,27.14,27.14,0,-58722,107484,166206,48762,0,0,0,0,0,,0,0
24,06-11-17,77,19:00,19:15,32.1,,0,32.1,32.1,1,-85644,54592,140236,-31052,0,0,2379,0,0,,2379,2379
24,06-11-17,78,19:15,19:30,33.07,,0,33.07,33.07,1,-99897,56842,156739,-43055,0,0,20064,0,0,,20064,20064
24,06-11-17,79,19:30,19:45,30.89,,0,30.89,30.89,1,-100396,45412,145808,-54984,0,0,13875,0,0,,13875,13875
24,06-11-17,80,19:45,20:00,,,0,27.27,27.27,0,-81450,43712,125162,-37738,0,0,332,0,0,,332,332
24,06-11-17,81,20:00,20:15,39.62,,0,39.62,39.62,1,-101325,43566,144891,-57759,0,0,8795,0,0,,8795,8795
24,06-11-17,82,20:15,20:30,31.29,27.69,0,27.69,27.69,-1,-56374,56107,112481,-267,0,-68,12329,0,0,,12397,12261
24,06-11-17,83,20:30,20:45,31.29,25.94,0,25.94,25.94,-1,-52509,66116,118625,13607,0,-863,394,0,0,,1257,-469
24,06-11-17,84,20:45,21:00,,,0,27.32,27.32,0,-56547,57785,114332,1238,0,0,0,0,0,,0,0
24,06-11-17,85,21:00,21:15,130.02,,0,130.02,130.02,1,-131557,27500,159057,-104057,0,0,11187,0,0,,11187,11187
24,06-11-17,86,21:15,21:30,130.02,,0,130.02,130.02,1,-136971,30428,167399,-106543,0,0,64929,0,0,,64929,64929
24,06-11-17,87,21:30,21:45,30.93,24.94,0,30.93,24.94,2,-82543,76659,159202,-5884,0,-248,17671,0,0,,17919,17423
24,06-11-17,88,21:45,22:00,,,0,27.32,27.32,0,-82335,66759,149094,-15576,0,-4,0,0,0,,4,-4
24,06-11-17,89,22:00,22:15,,,0,27.32,27.32,0,-74245,58329,132574,-15916,0,0,0,0,0,,0,0
24,06-11-17,90,22:15,22:30,27.94,,0,27.94,27.94,1,-86433,42452,128885,-43981,0,0,418,0,0,,418,418
24,06-11-17,91,22:30,22:45,28.98,,0,28.98,28.98,1,-71665,70485,142150,-1180,0,0,1521,0,0,,1521,1521
24,06-11-17,92,22:45,23:00,,,0,27.32,27.32,0,-85967,70785,156752,-15182,0,0,0,0,0,,0,0
24,06-11-17,93,23:00,23:15,126.02,,0,126.02,126.02,1,-141421,42075,183496,-99346,0,0,23841,0,0,,23841,23841
24,06-11-17,94,23:15,23:30,30.93,,0,30.93,30.93,1,-104909,49633,154542,-55276,0,0,12237,0,0,,12237,12237
24,06-11-17,95,23:30,23:45,30.93,20.94,0,20.94,20.94,-1,-87946,104342,192288,16396,0,-4962,1050,0,0,,6012,-3912
24,06-11-17,96,23:45,0:00,,15.94,0,15.94,15.94,-1,-89126,146880,236006,57754,0,-34374,0,0,0,,34374,-34374
24,06-12-17,1,0:00,0:15,28.98,24.94,0,28.98,28.98,1,-70584,98912,169496,28328,0,-14474,202,0,0,,14676,-14272
24,06-12-17,2,0:15,0:30,37.94,,0,37.94,37.94,1,-74621,40473,115094,-34148,0,0,10431,0,0,,10431,10431
24,06-12-17,3,0:30,0:45,32.1,,0,32.1,32.1,1,-69452,42698,112150,-26754,0,0,24762,0,0,,24762,24762
24,06-12-17,4,0:45,1:00,32.1,25.78,0,25.78,25.78,-1,-53382,56618,110000,3236,0,-1023,6115,0,0,,7138,5092
24,06-12-17,5,1:00,1:15,30.02,28.69,0,30.02,27.32,2,-52102,52465,104567,363,0,-36,1155,0,0,,1191,1119
24,06-12-17,6,1:15,1:30,30.93,,0,30.93,30.93,1,-57284,34353,91637,-22931,0,0,3703,0,0,,3703,3703
24,06-12-17,7,1:30,1:45,25.94,,0,25.94,25.94,1,-45492,38641,84133,-6851,0,0,225,0,0,,225,225
24,06-12-17,8,1:45,2:00,25.94,,0,25.94,25.94,1,-44235,35623,79858,-8612,0,0,147,0,0,,147,147
24,06-12-17,9,2:00,2:15,31.94,,0,31.94,31.94,1,-72420,65446,137866,-6974,0,0,5200,0,0,,5200,5200
24,06-12-17,10,2:15,2:30,27.94,,0,27.94,27.94,1,-65570,41312,106882,-24258,0,0,3050,0,0,,3050,3050
24,06-12-17,11,2:30,2:45,,,0,27.32,27.32,0,-64848,31122,95970,-33726,0,0,0,0,0,,0,0
24,06-12-17,12,2:45,3:00,,,0,27.32,27.32,0,-41466,26378,67844,-15088,0,0,0,0,0,,0,0
24,06-12-17,13,3:00,3:15,37.94,,0,37.94,37.94,1,-74069,13084,87153,-60985,0,0,4987,0,0,,4987,4987
24,06-12-17,14,3:15,3:30,33.12,,0,33.12,33.12,1,-63707,10483,74190,-53224,0,0,13777,0,0,,13777,13777
24,06-12-17,15,3:30,3:45,,,0,27.32,27.32,0,-57764,15049,72813,-42715,0,0,410,0,0,,410,410
24,06-12-17,16,3:45,4:00,,,0,27.32,27.32,0,-33939,17117,51056,-16822,0,0,0,0,0,,0,0
24,06-12-17,17,4:00,4:15,,,0,27.32,27.32,0,-52422,23204,75626,-29218,0,0,0,0,0,,0,0
24,06-12-17,18,4:15,4:30,,,0,27.32,27.32,0,-55828,19214,75042,-36614,0,0,0,0,0,,0,0
24,06-12-17,19,4:30,4:45,28.98,,0,28.98,28.98,1,-56241,21778,78019,-34463,0,0,2060,0,0,,2060,2060
24,06-12-17,20,4:45,5:00,32.1,,0,32.1,32.1,1,-58724,33482,92206,-25242,0,0,3074,0,0,,3074,3074
24,06-12-17,21,5:00,5:15,34.09,,0,34.09,34.09,1,-76288,26656,102944,-49632,0,0,15050,0,0,,15050,15050
24,06-12-17,22,5:15,5:30,,,0,27.32,27.32,0,-52864,32158,85022,-20706,0,0,1680,0,0,,1680,1680
24,06-12-17,23,5:30,5:45,,,0,27.32,27.32,0,-69172,37457,106629,-31715,0,0,0,0,0,,0,0
24,06-12-17,24,5:45,6:00,,26.59,0,26.59,26.59,-1,-65643,52617,118260,-13026,0,-369,0,0,0,,369,-369
24,06-12-17,25,6:00,6:15,127.91,,0,127.91,127.91,1,-150464,13959,164423,-136505,0,0,30604,0,0,,30604,30604
24,06-12-17,26,6:15,6:30,55.12,,0,55.12,55.12,1,-54326,42255,96581,-12071,0,0,50829,0,0,,50829,50829
24,06-12-17,27,6:30,6:45,30.2,,0,30.2,30.2,1,-57605,67386,124991,9781,0,0,3269,0,0,,3269,3269
24,06-12-17,28,6:45,7:00,29.55,,0,29.55,29.55,1,-56037,81439,137476,25402,0,0,1520,0,0,,1520,1520
24,06-12-17,29,7:00,7:15,48.04,,0,48.04,48.04,1,-141185,33624,174809,-107561,0,0,14465,0,0,,14465,14465
24,06-12-17,30,7:15,7:30,27.94,,0,27.94,27.94,1,-53901,60016,113917,6115,0,0,6161,0,0,,6161,6161
24,06-12-17,31,7:30,7:45,29.55,,0,29.55,29.55,1,-52531,52317,104848,-214,0,0,848,0,0,,848,848
24,06-12-17,32,7:45,8:00,26.04,,0,26.04,26.04,1,-60003,91148,151151,31145,0,0,1092,0,0,,1092,1092
24,06-12-17,33,8:00,8:15,27.69,,0,27.69,27.69,1,-96121,63397,159518,-32724,0,0,1365,0,0,,1365,1365
24,06-12-17,34,8:15,8:30,26.45,21.37,0,21.37,21.37,-1,-52063,89685,141748,37622,0,-5612,238,0,0,,5850,-5374
24,06-12-17,35,8:30,8:45,,20.94,0,20.94,20.94,-1,-49841,91712,141553,41871,0,-20025,0,0,0,,20025,-20025
24,06-12-17,36,8:45,9:00,26.45,27.39,0,26.45,26.45,1,-52851,83178,136029,30327,0,-7823,12,0,0,,7835,-7811
24,06-12-17,37,9:00,9:15,25.94,23.47,0,27.41,23.47,2,-37153,102600,139753,65447,0,-5763,213,0,0,,5976,-5550
24,06-12-17,38,9:15,9:30,,25.78,0,25.78,25.78,-1,-40644,84941,125585,44297,0,-17178,0,0,0,,17178,-17178
24,06-12-17,39,9:30,9:45,,25.55,0,25.55,25.55,-1,-45337,82066,127403,36729,0,-19024,0,0,0,,19024,-19024
24,06-12-17,40,9:45,10:00,,,0,27.41,27.41,0,-46872,70740,117612,23868,0,-5353,0,0,0,,5353,-5353
24,06-12-17,41,10:00,10:15,32.28,,0,32.28,32.28,1,-48572,31396,79968,-17176,0,0,3452,0,0,,3452,3452
24,06-12-17,42,10:15,10:30,32.28,,0,32.28,32.28,1,-58275,30766,89041,-27509,0,0,2272,0,0,,2272,2272
24,06-12-17,43,10:30,10:45,34.09,,0,34.09,34.09,1,-75489,27179,102668,-48310,0,0,13909,0,0,,13909,13909
24,06-12-17,44,10:45,11:00,60.52,,0,60.52,60.52,1,-80221,25791,106012,-54430,0,0,25873,0,0,,25873,25873
24,06-12-17,45,11:00,11:15,60.3,,0,60.3,60.3,1,-90979,42611,133590,-48368,0,0,39711,0,0,,39711,39711
24,06-12-17,46,11:15,11:30,32.12,,0,32.12,32.12,1,-66006,44039,110045,-21967,0,0,17385,0,0,,17385,17385
24,06-12-17,47,11:30,11:45,31.11,,0,31.11,31.11,1,-66108,49048,115156,-17060,0,0,10516,0,0,,10516,10516
24,06-12-17,48,11:45,12:00,31.11,,0,31.11,31.11,1,-64644,34937,99581,-29707,0,0,10755,0,0,,10755,10755
24,06-12-17,49,12:00,12:15,31.94,,0,31.94,31.94,1,-63869,49386,113255,-14483,0,0,10254,0,0,,10254,10254
24,06-12-17,50,12:15,12:30,,,0,33.15,33.15,0,-64963,50841,115804,-14122,0,0,441,0,0,,441,441
24,06-12-17,51,12:30,12:45,,27.04,0,27.04,27.04,-1,-47669,59478,107147,11809,0,-1361,0,0,0,,1361,-1361
24,06-12-17,52,12:45,13:00,31.94,27.04,0,33.15,27.04,2,-70498,58842,129340,-11656,0,-2428,410,0,0,,2838,-2018
24,06-12-17,53,13:00,13:15,77.61,27.04,0,77.61,77.61,1,-91684,49110,140794,-42574,0,-137,29352,0,0,,29489,29215
24,06-12-17,54,13:15,13:30,34.09,,0,34.09,34.09,1,-76529,48379,124908,-28150,0,0,31188,0,0,,31188,31188
24,06-12-17,55,13:30,13:45,114.12,,0,114.12,114.12,1,-119501,48343,167844,-71158,0,0,35410,0,0,,35410,35410
24,06-12-17,56,13:45,14:00,128.12,,0,128.12,128.12,1,-136776,58558,195334,-78218,0,0,76549,0,0,,76549,76549
24,06-12-17,57,14:00,14:15,28.12,24.31,0,24.31,24.31,-1,-85996,94976,180972,8980,0,-1430,18661,0,0,,20091,17231
24,06-12-17,58,14:15,14:30,29.55,20.44,0,33.2,20.44,2,-76528,78536,155064,2008,0,-18412,80,0,0,,18492,-18332
24,06-12-17,59,14:30,14:45,32.28,24.94,0,33.2,24.94,2,-65993,72312,138305,6319,0,-2456,1155,0,0,,3611,-1301
24,06-12-17,60,14:45,15:00,,-10.01,0,-10.01,-10.01,-1,-28955,88845,117800,59890,0,-49375,0,0,0,,49375,-49375
24,06-12-17,61,15:00,15:15,,15.94,0,15.94,15.94,-1,-84075,105652,189727,21577,0,-34072,0,0,0,,34072,-34072
24,06-12-17,62,15:15,15:30,27.94,15.94,0,27.94,27.94,1,-87609,85188,172797,-2421,0,-974,1317,0,0,,2291,343
24,06-12-17,63,15:30,15:45,28.08,,0,28.08,28.08,1,-104683,98639,203322,-6044,0,0,4422,0,0,,4422,4422
24,06-12-17,64,15:45,16:00,37.94,,0,37.94,37.94,1,-126230,98177,224407,-28053,0,0,15575,0,0,,15575,15575
24,06-12-17,65,16:00,16:15,38.4,,0,38.4,38.4,1,-130670,59738,190408,-70932,0,0,30433,0,0,,30433,30433
24,06-12-17,66,16:15,16:30,38.4,,0,38.4,38.4,1,-119236,62601,181837,-56635,0,0,36696,0,0,,36696,36696
24,06-12-17,67,16:30,16:45,34.09,,0,34.09,34.09,1,-111514,66630,178144,-44884,0,0,34877,0,0,,34877,34877
24,06-12-17,68,16:45,17:00,56.48,,0,56.48,56.48,1,-122880,59550,182430,-63330,0,0,42018,0,0,,42018,42018
24,06-12-17,69,17:00,17:15,38.29,,0,38.29,38.29,1,-115921,80862,196783,-35059,0,0,25693,0,0,,25693,25693
24,06-12-17,70,17:15,17:30,49.29,,0,49.29,49.29,1,-116032,63531,179563,-52501,0,0,11988,0,0,,11988,11988
24,06-12-17,71,17:30,17:45,52.12,,0,52.12,52.12,1,-111188,60248,171436,-50940,0,0,28631,0,0,,28631,28631
24,06-12-17,72,17:45,18:00,41.12,,0,41.12,41.12,1,-110845,67504,178349,-43341,0,0,36808,0,0,,36808,36808
24,06-12-17,73,18:00,18:15,30.2,1.78,0,1.78,1.78,-1,-57961,96284,154245,38323,0,-8636,12772,0,0,,21408,4136
24,06-12-17,74,18:15,18:30,,20.94,0,20.94,20.94,-1,-49033,79668,128701,30635,0,-21565,0,0,0,,21565,-21565
24,06-12-17,75,18:30,18:45,,27.86,0,27.86,27.86,-1,-67139,85097,152236,17958,0,-3672,0,0,0,,3672,-3672
24,06-12-17,76,18:45,19:00,,28.09,0,28.09,28.09,-1,-72898,101179,174077,28281,0,-3467,0,0,0,,3467,-3467
24,06-12-17,77,19:00,19:15,,-8.26,0,-8.26,-8.26,-1,-51344,125112,176456,73768,0,-15299,0,0,0,,15299,-15299
24,06-12-17,78,19:15,19:30,,20.9,0,20.9,20.9,-1,-66306,114128,180434,47822,0,-42836,0,0,0,,42836,-42836
24,06-12-17,79,19:30,19:45,30.2,25.6,0,30.2,30.2,1,-81582,94014,175596,12432,0,-23695,165,0,0,,23860,-23530
24,06-12-17,80,19:45,20:00,45.12,25.6,0,45.12,45.12,1,-126108,88060,214168,-38048,0,-820,17337,0,0,,18157,16517
24,06-12-17,81,20:00,20:15,29.12,,0,29.12,29.12,1,-87598,84683,172281,-2915,0,0,9543,0,0,,9543,9543
24,06-12-17,82,20:15,20:30,29.16,,0,29.16,29.16,1,-87722,72086,159808,-15636,0,0,4953,0,0,,4953,4953
24,06-12-17,83,20:30,20:45,27.94,,0,27.94,27.94,1,-82156,78205,160361,-3951,0,0,5417,0,0,,5417,5417
24,06-12-17,84,20:45,21:00,27.94,26.59,0,26.59,26.59,-1,-73778,85652,159430,11874,0,-1935,195,0,0,,2130,-1740
24,06-12-17,85,21:00,21:15,,25.94,0,25.94,25.94,-1,-59339,102581,161920,43242,0,-3887,0,0,0,,3887,-3887
24,06-12-17,86,21:15,21:30,,,0,33.14,33.14,0,-48987,82572,131559,33585,0,-434,0,0,0,,434,-434
24,06-12-17,87,21:30,21:45,,,0,33.14,33.14,0,-60503,72542,133045,12039,0,0,0,0,0,,0,0
24,06-12-17,88,21:45,22:00,,27.94,0,27.94,27.94,-1,-58601,57001,115602,-1600,0,-100,0,0,0,,100,-100
24,06-12-17,89,22:00,22:15,,27.39,0,27.39,27.39,-1,-52840,67983,120823,15143,0,-1747,0,0,0,,1747,-1747
24,06-12-17,90,22:15,22:30,,27.89,0,27.89,27.89,-1,-69472,59867,129339,-9605,0,-2624,0,0,0,,2624,-2624
24,06-12-17,91,22:30,22:45,,40.02,0,40.02,40.02,-1,-70021,68649,138670,-1372,0,-849,0,0,0,,849,-849
24,06-12-17,92,22:45,23:00,,26.84,0,26.84,26.84,-1,-71842,67057,138899,-4785,0,-713,0,0,0,,713,-713
24,06-12-17,93,23:00,23:15,129.12,25.69,0,232.4,25.69,2,-205962,77610,283572,-128352,0,-2280,12023,0,2959,,17262,12702
24,06-12-17,94,23:15,23:30,280.49,26.39,0,308.54,26.39,2,-320403,185947,506350,-134456,0,-8,67095,26250,50718,,144071,144055
24,06-12-17,95,23:30,23:45,32.28,-48.18,0,232.4,-48.18,2,-238348,220541,458889,-17807,0,-20424,5457,0,45058,,70939,30091
24,06-12-17,96,23:45,0:00,129.12,-48.18,0,129.12,129.12,1,-225458,141487,366945,-83971,0,-86,46782,0,1997,,48865,48693
24,06/13/2017,1,0:00,0:15,129.92,,0,129.92,129.92,1,-187744,99265,287009,-88479,0,0,72376,0,0,,72376,72376
24,06/13/2017,2,0:15,0:30,46.48,,0,46.48,46.48,1,-150244,92902,243146,-57342,0,0,46248,0,0,,46248,46248
24,06/13/2017,3,0:30,0:45,33.48,,0,33.48,33.48,1,-132095,98402,230497,-33693,0,0,29928,0,0,,29928,29928
24,06/13/2017,4,0:45,1:00,34.44,,0,34.44,34.44,1,-139707,91047,230754,-48660,0,0,8433,0,0,,8433,8433
24,06/13/2017,5,1:00,1:15,27.46,,0,27.46,27.46,1,-59230,104462,163692,45232,0,0,2634,0,0,,2634,2634
24,06/13/2017,6,1:15,1:30,,26.82,0,26.82,26.82,-1,-65431,95693,161124,30262,0,-16,0,0,0,,16,-16
24,06/13/2017,7,1:30,1:45,,25.89,0,25.89,25.89,-1,-53926,72311,126237,18385,0,-1489,0,0,0,,1489,-1489
24,06/13/2017,8,1:45,2:00,,26.17,0,26.17,26.17,-1,-60262,60170,120432,-92,0,-1726,0,0,0,,1726,-1726
24,06/13/2017,9,2:00,2:15,54.82,26.17,0,54.82,26.17,2,-76459,38646,115105,-37813,0,-1028,12966,0,0,,13994,11938
24,06/13/2017,10,2:15,2:30,32.05,,0,32.05,32.05,1,-61549,42606,104155,-18943,0,0,25264,0,0,,25264,25264
24,06/13/2017,11,2:30,2:45,29.32,,0,29.32,29.32,1,-57040,39812,96852,-17228,0,0,10803,0,0,,10803,10803
24,06/13/2017,12,2:45,3:00,,,0,26.34,26.34,0,-49943,35489,85432,-14454,0,0,2995,0,0,,2995,2995
24,06/13/2017,13,3:00,3:15,70.94,,0,70.94,70.94,1,-51594,10351,61945,-41243,0,0,14491,0,0,,14491,14491
24,06/13/2017,14,3:15,3:30,34.24,,0,34.24,34.24,1,-46412,17094,63506,-29318,0,0,25648,0,0,,25648,25648
24,06/13/2017,15,3:30,3:45,47.9,,0,47.9,47.9,1,-69720,12320,82040,-57400,0,0,32348,0,0,,32348,32348
24,06/13/2017,16,3:45,4:00,114.11,,0,114.11,114.11,1,-62123,11675,73798,-50448,0,0,44674,0,0,,44674,44674
24,06/13/2017,17,4:00,4:15,115.11,,0,226.9,226.9,1,-34319,50083,84402,15764,0,0,91522,0,18247,,109769,109769
24,06/13/2017,18,4:15,4:30,115.11,25.15,0,25.15,25.15,-1,-22779,178319,201098,155540,0,-351,28843,0,63747,,92941,92239
24,06/13/2017,19,4:30,4:45,,,0,226.9,226.9,1,-17660,162145,179805,144485,0,0,0,0,63747,,63747,63747
24,06/13/2017,20,4:45,5:00,31.46,26.09,0,226.9,26.09,2,-10585,194002,204587,183417,0,-580,201,0,41722,,42503,41343
24,06/13/2017,21,5:00,5:15,36.3,,0,36.3,36.3,1,-66774,148276,215050,81502,0,0,3902,0,2025,,5927,5927
24,06/13/2017,22,5:15,5:30,44.83,,0,44.83,44.83,1,-18861,125165,144026,106304,0,0,12160,0,0,,12160,12160
24,06/13/2017,23,5:30,5:45,115.11,,0,115.11,115.11,1,-15924,78738,94662,62814,0,0,53690,0,0,,53690,53690
24,06/13/2017,24,5:45,6:00,114.66,,0,114.66,114.66,1,-21310,96908,118218,75598,0,0,88988,0,0,,88988,88988
24,06/13/2017,25,6:00,6:15,,,0,26.38,26.38,0,-31210,149777,180987,118567,0,0,35742,0,0,,35742,35742
24,06/13/2017,26,6:15,6:30,,22.04,0,22.04,22.04,-1,-36840,139234,176074,102394,0,-332,0,0,0,,332,-332
24,06/13/2017,27,6:30,6:45,39.14,,0,39.14,39.14,1,-50909,99359,150268,48450,0,0,1114,0,0,,1114,1114
24,06/13/2017,28,6:45,7:00,129.11,,0,129.11,129.11,1,-27050,116517,143567,89467,0,0,33060,0,0,,33060,33060
24,06/13/2017,29,7:00,7:15,27.46,13.28,0,33.88,13.28,2,-46195,204860,251055,158665,0,-9921,1521,0,0,,11442,-8400
24,06/13/2017,30,7:15,7:30,34.64,40.39,0,34.64,33.88,2,-58956,142061,201017,83105,0,-1497,4083,0,0,,5580,2586
24,06/13/2017,31,7:30,7:45,48.66,,0,48.66,48.66,1,-75552,119484,195036,43932,0,0,17027,0,0,,17027,17027
24,06/13/2017,32,7:45,8:00,199.35,,0,199.35,199.35,1,-84779,123565,208344,38786,0,0,34987,0,0,,34987,34987
24,06/13/2017,33,8:00,8:15,30,28.64,0,33.94,28.64,2,-83428,119735,203163,36307,0,-510,9954,0,0,,10464,9444
24,06/13/2017,34,8:15,8:30,,25.46,0,25.46,25.46,-1,-67825,119228,187053,51403,0,-378,0,0,0,,378,-378
24,06/13/2017,35,8:30,8:45,,25.46,0,25.46,25.46,-1,-75285,92607,167892,17322,0,-1524,0,0,0,,1524,-1524
24,06/13/2017,36,8:45,9:00,46,25.46,0,46,46,1,-103104,76287,179391,-26817,0,-23,4291,0,0,,4314,4268
24,06/13/2017,37,9:00,9:15,132.8,,0,132.8,132.8,1,-147951,95969,243920,-51982,0,0,52929,0,0,,52929,52929
24,06/13/2017,38,9:15,9:30,72.08,20.46,0,20.46,20.46,-1,-98381,119488,217869,21107,0,-390,35298,0,0,,35688,34908
24,06/13/2017,39,9:30,9:45,,19.43,0,19.43,19.43,-1,-74624,110043,184667,35419,0,-4497,0,0,0,,4497,-4497
24,06/13/2017,40,9:45,10:00,,28.64,0,28.64,28.64,-1,-79601,112628,192229,33027,0,-2226,0,0,0,,2226,-2226
24,06/13/2017,41,10:00,10:15,48,40.38,0,48,48,1,-94921,60726,155647,-34195,0,-325,4784,0,0,,5109,4459
24,06/13/2017,42,10:15,10:30,115.02,,0,115.02,115.02,1,-129779,59722,189501,-70057,0,0,39929,0,0,,39929,39929
24,06/13/2017,43,10:30,10:45,48,,0,48,48,1,-106456,67645,174101,-38811,0,0,35304,0,0,,35304,35304
24,06/13/2017,44,10:45,11:00,39.14,,0,39.14,39.14,1,-100609,66794,167403,-33815,0,0,6723,0,0,,6723,6723
24,06/13/2017,45,11:00,11:15,65.02,,0,65.02,65.02,1,-128674,72519,201193,-56155,0,0,24995,0,0,,24995,24995
24,06/13/2017,46,11:15,11:30,50.08,,0,50.08,50.08,1,-107448,66645,174093,-40803,0,0,39609,0,0,,39609,39609
24,06/13/2017,47,11:30,11:45,41.5,,0,41.5,41.5,1,-94130,56732,150862,-37398,0,0,44707,0,0,,44707,44707
24,06/13/2017,48,11:45,12:00,52.45,,0,52.45,52.45,1,-110464,57951,168415,-52513,0,0,42131,0,0,,42131,42131
24,06/13/2017,49,12:00,12:15,55.04,,0,55.04,55.04,1,-182819,95123,277942,-87696,0,0,54566,100000,0,,154566,154566
24,06/13/2017,50,12:15,12:30,33.02,,0,33.02,33.02,1,-127358,94738,222096,-32620,0,0,25081,100000,0,,125081,125081
24,06/13/2017,51,12:30,12:45,57.93,,0,57.93,57.93,1,-140674,88172,228846,-52502,0,0,14097,100000,0,,114097,114097
24,06/13/2017,52,12:45,13:00,37.46,,0,37.46,37.46,1,-157494,100471,257965,-57023,0,0,38810,100000,0,,138810,138810
24,06/13/2017,53,13:00,13:15,129.02,,0,129.02,129.02,1,-168311,41468,209779,-126843,0,0,61922,0,0,,61922,61922
24,06/13/2017,54,13:15,13:30,144.89,,0,144.89,144.89,1,-161308,52196,213504,-109112,0,0,85021,0,0,,85021,85021
24,06/13/2017,55,13:30,13:45,266.94,,0,266.94,266.94,1,-180565,86323,266888,-94242,0,0,89217,2500,0,,91717,91717
24,06/13/2017,56,13:45,14:00,236.23,,0,236.23,236.23,1,-182572,117812,300384,-64760,0,0,84212,2500,0,,86712,86712
24,06/13/2017,57,14:00,14:15,126.17,,0,126.17,126.17,1,-175950,142871,318821,-33079,0,0,46676,0,0,,46676,46676
24,06/13/2017,58,14:15,14:30,126.17,,0,126.17,126.17,1,-176450,137021,313471,-39429,0,0,65525,0,0,,65525,65525
24,06/13/2017,59,14:30,14:45,49.98,,0,49.98,49.98,1,-166265,137082,303347,-29183,0,0,50938,0,0,,50938,50938
24,06/13/2017,60,14:45,15:00,52.35,,0,52.35,52.35,1,-168643,134304,302947,-34339,0,0,55653,0,0,,55653,55653
24,06/13/2017,61,15:00,15:15,42.14,,0,42.14,42.14,1,-160980,136943,297923,-24037,0,0,48833,0,0,,48833,48833
24,06/13/2017,62,15:15,15:30,62.65,,0,62.65,62.65,1,-174367,130499,304866,-43868,0,0,56607,0,0,,56607,56607
24,06/13/2017,63,15:30,15:45,55.38,,0,55.38,55.38,1,-171641,118486,290127,-53155,0,0,55842,0,0,,55842,55842
24,06/13/2017,64,15:45,16:00,57.59,,0,57.59,57.59,1,-166818,110501,277319,-56317,0,0,60515,0,0,,60515,60515
24,06/13/2017,65,16:00,16:15,42.14,,0,233.98,233.98,1,-206905,190339,397244,-16566,0,0,30387,0,0,,30387,30387
24,06/13/2017,66,16:15,16:30,42.14,,0,233.98,233.98,1,-310102,207754,517856,-102348,0,0,6736,0,33235,,39971,39971
24,06/13/2017,67,16:30,16:45,25.46,,0,233.98,233.98,1,-303932,225269,529201,-78663,0,0,401,0,73749,,74150,74150
24,06/13/2017,68,16:45,17:00,39.98,,0,233.98,233.98,1,-299894,211979,511873,-87915,0,0,9429,0,62748,,72177,72177
24,06/13/2017,69,17:00,17:15,27.46,25.46,0,236.9,25.46,2,-271261,250666,521927,-20595,0,-1097,1967,0,53380,,56444,54250
24,06/13/2017,70,17:15,17:30,131.33,,0,131.33,131.33,1,-268080,195048,463128,-73032,0,0,26151,0,0,,26151,26151
24,06/13/2017,71,17:30,17:45,131.33,,0,131.33,131.33,1,-256937,200405,457342,-56532,0,0,70378,0,0,,70378,70378
24,06/13/2017,72,17:45,18:00,92.02,,0,92.02,92.02,1,-250728,203370,454098,-47358,0,0,33000,0,0,,33000,33000
24,06/13/2017,73,18:00,18:15,42.14,,0,42.14,42.14,1,-239745,118464,358209,-121281,0,0,31221,75000,0,,106221,106221
24,06/13/2017,74,18:15,18:30,135.63,,0,135.63,135.63,1,-218430,119893,338323,-98537,0,0,36422,75000,0,,111422,111422
24,06/13/2017,75,18:30,18:45,135.63,,0,135.63,135.63,1,-213421,132418,345839,-81003,0,0,34532,75000,0,,109532,109532
24,06/13/2017,76,18:45,19:00,135.63,,0,135.63,135.63,1,-221398,119626,341024,-101772,0,0,30200,75000,0,,105200,105200
24,06/13/2017,77,19:00,19:15,32.92,26.92,0,36.09,26.92,2,-152367,193577,345944,41210,0,-861,13767,60000,0,,74628,72906
24,06/13/2017,78,19:15,19:30,29.32,44.72,0,29.32,29.32,1,-160737,142162,302899,-18575,0,-31,1044,60000,0,,61075,61013
24,06/13/2017,79,19:30,19:45,53.38,,0,53.38,53.38,1,-165132,125318,290450,-39814,0,0,21231,60000,0,,81231,81231
24,06/13/2017,80,19:45,20:00,52.02,,0,52.02,52.02,1,-156027,125695,281722,-30332,0,0,31729,60000,0,,91729,91729
24,06/13/2017,81,20:00,20:15,32.05,,0,32.05,32.05,1,-156285,133062,289347,-23223,0,0,18141,0,0,,18141,18141
24,06/13/2017,82,20:15,20:30,31.95,,0,31.95,31.95,1,-137694,108131,245825,-29563,0,0,8332,0,0,,8332,8332
24,06/13/2017,83,20:30,20:45,47.95,,0,47.95,47.95,1,-129049,98762,227811,-30287,0,0,8396,0,0,,8396,8396
24,06/13/2017,84,20:45,21:00,47.95,,0,47.95,47.95,1,-130917,101592,232509,-29325,0,0,15060,0,0,,15060,15060
24,06/13/2017,85,21:00,21:15,261.85,,0,261.85,261.85,1,-197903,94484,292387,-103419,0,0,39619,0,0,,39619,39619
24,06/13/2017,86,21:15,21:30,261.85,,0,261.85,261.85,1,-173761,126687,300448,-47074,0,0,56476,0,0,,56476,56476
24,06/13/2017,87,21:30,21:45,,,0,33.84,33.84,0,-171002,154426,325428,-16576,0,0,1083,0,0,,1083,1083
24,06/13/2017,88,21:45,22:00,,,0,33.84,33.84,0,-174030,146185,320215,-27845,0,0,0,0,0,,0,0
24,06/13/2017,89,22:00,22:15,,,0,33.88,33.88,0,-173502,95521,269023,-77981,0,0,0,0,0,,0,0
24,06/13/2017,90,22:15,22:30,47.12,,0,47.12,47.12,1,-184751,67233,251984,-117518,0,0,5204,0,0,,5204,5204
24,06/13/2017,91,22:30,22:45,262.63,,0,262.63,262.63,1,-177259,60645,237904,-116614,0,0,58699,0,0,,58699,58699
24,06/13/2017,92,22:45,23:00,205.68,,0,205.68,205.68,1,-156485,106523,263008,-49962,0,0,47227,0,0,,47227,47227
24,06/13/2017,93,23:00,23:15,214.13,,0,214.13,214.13,1,-183221,72057,255278,-111164,0,0,28800,0,0,,28800,28800
24,06/13/2017,94,23:15,23:30,72.02,,0,72.02,72.02,1,-157577,87229,244806,-70348,0,0,21594,0,0,,21594,21594
24,06/13/2017,95,23:30,23:45,31.9,,0,31.9,31.9,1,-139465,82949,222414,-56516,0,0,9514,0,0,,9514,9514
24,06/13/2017,96,23:45,0:00,29.09,,0,29.09,29.09,1,-136835,97596,234431,-39239,0,0,6421,0,0,,6421,6421
24,06/14/2017,1,0:00,0:15,180.82,,0,180.82,180.82,1,-147966,26642,174608,-121324,0,0,26847,0,0,,26847,26847
24,06/14/2017,2,0:15,0:30,91.12,,0,91.12,91.12,1,-130647,41791,172438,-88856,0,0,24392,0,0,,24392,24392
24,06/14/2017,3,0:30,0:45,28.88,,0,28.88,28.88,1,-116181,52205,168386,-63976,0,0,4378,0,0,,4378,4378
24,06/14/2017,4,0:45,1:00,,27.84,0,27.84,27.84,-1,-129992,72016,202008,-57976,0,-34,0,0,0,,34,-34
24,06/14/2017,5,1:00,1:15,64.13,24.86,0,64.13,24.86,2,-73179,48109,121288,-25070,0,-771,6191,0,0,,6962,5420
24,06/14/2017,6,1:15,1:30,64.13,,0,64.13,64.13,1,-98804,54444,153248,-44360,0,0,21420,0,0,,21420,21420
24,06/14/2017,7,1:30,1:45,31.61,,0,31.61,31.61,1,-75073,50202,125275,-24871,0,0,7882,0,0,,7882,7882
24,06/14/2017,8,1:45,2:00,31.61,24.44,0,24.44,24.44,-1,-67549,61533,129082,-6016,0,-3582,332,0,0,,3914,-3250
24,06/14/2017,9,2:00,2:15,37.82,25.82,0,37.82,37.82,1,-72835,43218,116053,-29617,0,-2970,8856,0,0,,11826,5886
24,06/14/2017,10,2:15,2:30,37.82,,0,37.82,37.82,1,-69039,38336,107375,-30703,0,0,26688,0,0,,26688,26688
24,06/14/2017,11,2:30,2:45,27.82,,0,27.82,27.82,1,-65804,35393,101197,-30411,0,0,4278,0,0,,4278,4278
24,06/14/2017,12,2:45,3:00,,,0,26.8,26.8,0,-58005,33296,91301,-24709,0,0,0,0,0,,0,0
24,06/14/2017,13,3:00,3:15,34.44,,0,34.44,34.44,1,-58384,28207,86591,-30177,0,0,6555,0,0,,6555,6555
24,06/14/2017,14,3:15,3:30,37.82,,0,37.82,37.82,1,-57092,27192,84284,-29900,0,0,31037,0,0,,31037,31037
24,06/14/2017,15,3:30,3:45,27.82,,0,27.82,27.82,1,-40534,35423,75957,-5111,0,0,5883,0,0,,5883,5883
24,06/14/2017,16,3:45,4:00,,25.82,0,25.82,25.82,-1,-26447,58889,85336,32442,0,-483,0,0,0,,483,-483
24,06/14/2017,17,4:00,4:15,,25.82,0,25.82,25.82,-1,-27630,54227,81857,26597,0,-2109,0,0,0,,2109,-2109
24,06/14/2017,18,4:15,4:30,,,0,26.19,26.19,0,-36325,44624,80949,8299,0,-92,0,0,0,,92,-92
24,06/14/2017,19,4:30,4:45,,25.82,0,25.82,25.82,-1,-34189,41734,75923,7545,0,-201,0,0,0,,201,-201
24,06/14/2017,20,4:45,5:00,,24.82,0,24.82,24.82,-1,-28256,47057,75313,18801,0,-5460,0,0,0,,5460,-5460
24,06/14/2017,21,5:00,5:15,,24.82,0,24.82,24.82,-1,-48793,55403,104196,6610,0,-10659,0,0,0,,10659,-10659
24,06/14/2017,22,5:15,5:30,,20.82,0,20.82,20.82,-1,-29911,55769,85680,25858,0,-22029,0,0,0,,22029,-22029
24,06/14/2017,23,5:30,5:45,,24.82,0,24.82,24.82,-1,-34102,47190,81292,13088,0,-21817,0,0,0,,21817,-21817
24,06/14/2017,24,5:45,6:00,27.82,24.82,0,27.82,27.82,1,-48366,38289,86655,-10077,0,-4944,1236,0,0,,6180,-3708
24,06/14/2017,25,6:00,6:15,27.88,20.88,0,27.88,20.88,2,-67604,85633,153237,18029,0,-4949,1210,0,0,,6159,-3739
24,06/14/2017,26,6:15,6:30,,20.88,0,20.88,20.88,-1,-34708,73080,107788,38372,0,-22994,0,0,0,,22994,-22994
24,06/14/2017,27,6:30,6:45,32.89,27.78,0,32.89,32.89,1,-53646,47158,100804,-6488,0,-7821,2641,0,0,,10462,-5180
24,06/14/2017,28,6:45,7:00,36.07,,0,36.07,36.07,1,-80676,44100,124776,-36576,0,0,23963,0,0,,23963,23963
24,06/14/2017,29,7:00,7:15,31.26,17.52,0,36.1,17.52,2,-32290,120604,152894,88314,0,-1729,9209,0,0,,10938,7480
24,06/14/2017,30,7:15,7:30,,,0,36.1,36.1,0,-55271,77664,132935,22393,0,0,0,0,0,,0,0
24,06/14/2017,31,7:30,7:45,31.26,,0,31.26,31.26,1,-79431,59047,138478,-20384,0,0,2599,0,0,,2599,2599
24,06/14/2017,32,7:45,8:00,37.54,,0,37.54,37.54,1,-96946,58932,155878,-38014,0,0,15651,0,0,,15651,15651
24,06/14/2017,33,8:00,8:15,28.88,43.95,0,43.95,43.95,-1,-30806,62868,93674,32062,0,-236,5128,0,0,,5364,4892
24,06/14/2017,34,8:15,8:30,27.88,44.34,0,27.88,27.88,1,-48753,54013,102766,5260,0,-205,16,0,0,,221,-189
24,06/14/2017,35,8:30,8:45,29.12,,0,29.12,29.12,1,-54135,41862,95997,-12273,0,0,2506,0,0,,2506,2506
24,06/14/2017,36,8:45,9:00,30.44,,0,30.44,30.44,1,-54163,45284,99447,-8879,0,0,1403,0,0,,1403,1403
24,06/14/2017,37,9:00,9:15,30.44,,0,30.44,30.44,1,-58299,64438,122737,6139,0,0,2328,0,0,,2328,2328
24,06/14/2017,38,9:15,9:30,27.88,44.31,0,36.1,36.1,2,-61637,48609,110246,-13028,0,-49,151,0,0,,200,102
24,06/14/2017,39,9:30,9:45,27.88,30.54,0,30.54,30.54,-1,-62986,64905,127891,1919,0,-376,222,0,0,,598,-154
24,06/14/2017,40,9:45,10:00,,30.54,0,30.54,30.54,-1,-64091,67851,131942,3760,0,-3879,0,0,0,,3879,-3879
24,06/14/2017,41,10:00,10:15,31.12,32.04,0,31.12,31.12,1,-73007,43198,116205,-29809,0,-1694,2826,0,0,,4520,1132
24,06/14/2017,42,10:15,10:30,31.61,,0,31.61,31.61,1,-81163,48544,129707,-32619,0,0,11009,0,0,,11009,11009
24,06/14/2017,43,10:30,10:45,27.88,,0,27.88,27.88,1,-87142,49006,136148,-38136,0,0,2658,0,0,,2658,2658
24,06/14/2017,44,10:45,11:00,28.88,,0,28.88,28.88,1,-90004,48440,138444,-41564,0,0,1456,0,0,,1456,1456
24,06/14/2017,45,11:00,11:15,29.12,,0,29.12,29.12,1,-95604,72127,167731,-23477,0,0,1049,0,0,,1049,1049
24,06/14/2017,46,11:15,11:30,,,0,30.64,30.64,0,-85248,67563,152811,-17685,0,0,0,0,0,,0,0
24,06/14/2017,47,11:30,11:45,,27.54,0,27.54,27.54,-1,-80214,76101,156315,-4113,0,-1448,0,0,0,,1448,-1448
24,06/14/2017,48,11:45,12:00,,25.88,0,25.88,25.88,-1,-79677,81892,161569,2215,0,-7397,0,0,0,,7397,-7397
24,06/14/2017,49,12:00,12:15,27.88,30.54,0,27.88,27.88,1,-111841,74387,186228,-37454,0,-3357,1167,0,0,,4524,-2190
24,06/14/2017,50,12:15,12:30,26.96,,0,26.96,26.96,1,-119823,81453,201276,-38370,0,0,1395,0,0,,1395,1395
24,06/14/2017,51,12:30,12:45,27.88,,0,27.88,27.88,1,-115727,84518,200245,-31209,0,0,1997,0,0,,1997,1997
24,06/14/2017,52,12:45,13:00,26.94,,0,26.94,26.94,1,-117145,80583,197728,-36562,0,0,1326,0,0,,1326,1326
24,06/14/2017,53,13:00,13:15,,,0,29.39,29.39,0,-137018,109657,246675,-27361,0,0,0,0,0,,0,0
24,06/14/2017,54,13:15,13:30,27.88,,0,27.88,27.88,1,-145704,92950,238654,-52754,0,0,1114,0,0,,1114,1114
24,06/14/2017,55,13:30,13:45,29.53,,0,29.53,29.53,1,-158495,89264,247759,-69231,0,0,5734,0,0,,5734,5734
24,06/14/2017,56,13:45,14:00,30.44,,0,30.44,30.44,1,-147977,93276,241253,-54701,0,0,9927,0,0,,9927,9927
24,06/14/2017,57,14:00,14:15,42.04,,0,42.04,42.04,1,-164837,102045,266882,-62792,0,0,18236,0,0,,18236,18236
24,06/14/2017,58,14:15,14:30,42.04,,0,42.04,42.04,1,-164081,103677,267758,-60404,0,0,42135,0,0,,42135,42135
24,06/14/2017,59,14:30,14:45,39.04,,0,39.04,39.04,1,-165657,109492,275149,-56165,0,0,39866,0,0,,39866,39866
24,06/14/2017,60,14:45,15:00,31.88,,0,31.88,31.88,1,-163028,108071,271099,-54957,0,0,21581,0,0,,21581,21581
24,06/14/2017,61,15:00,15:15,31.61,,0,31.61,31.61,1,-167553,114269,281822,-53284,0,0,12333,0,0,,12333,12333
24,06/14/2017,62,15:15,15:30,31.88,,0,31.88,31.88,1,-165922,106237,272159,-59685,0,0,12564,0,0,,12564,12564
24,06/14/2017,63,15:30,15:45,59.89,,0,59.89,59.89,1,-166589,106856,273445,-59733,0,0,31565,0,0,,31565,31565
24,06/14/2017,64,15:45,16:00,55.68,,0,55.68,55.68,1,-162077,110645,272722,-51432,0,0,27008,0,0,,27008,27008
24,06/14/2017,65,16:00,16:15,34.37,,0,34.37,34.37,1,-144309,120399,264708,-23910,0,0,8277,0,0,,8277,8277
24,06/14/2017,66,16:15,16:30,41.85,,0,41.85,41.85,1,-146379,105881,252260,-40498,0,0,29017,0,0,,29017,29017
24,06/14/2017,67,16:30,16:45,41.85,,0,41.85,41.85,1,-140574,99947,240521,-40627,0,0,38111,0,0,,38111,38111
24,06/14/2017,68,16:45,17:00,59.95,,0,59.95,59.95,1,-145878,85346,231224,-60532,0,0,39320,0,0,,39320,39320
24,06/14/2017,69,17:00,17:15,46.53,,0,46.53,46.53,1,-198918,142141,341059,-56777,0,0,46943,0,0,,46943,46943
24,06/14/2017,70,17:15,17:30,110.41,,0,110.41,110.41,1,-198247,121859,320106,-76388,0,0,59299,0,0,,59299,59299
24,06/14/2017,71,17:30,17:45,97.7,,0,97.7,97.7,1,-174030,141069,315099,-32961,0,0,53812,0,0,,53812,53812
24,06/14/2017,72,17:45,18:00,28.88,28.23,0,28.23,28.23,-1,-168447,155463,323910,-12984,0,-57,12448,0,0,,12505,12391
24,06/14/2017,73,18:00,18:15,27.88,,0,27.88,27.88,1,-141620,90347,231967,-51273,0,0,933,0,0,,933,933
24,06/14/2017,74,18:15,18:30,,27.54,0,27.54,27.54,-1,-84528,97153,181681,12625,0,-979,0,0,0,,979,-979
24,06/14/2017,75,18:30,18:45,,32.04,0,32.04,32.04,-1,-81867,100348,182215,18481,0,-489,0,0,0,,489,-489
24,06/14/2017,76,18:45,19:00,,,0,37.52,37.52,0,-74250,94398,168648,20148,0,0,0,0,0,,0,0
24,06/14/2017,77,19:00,19:15,,,0,37.75,37.75,0,-60202,47934,108136,-12268,0,0,0,0,0,,0,0
24,06/14/2017,78,19:15,19:30,39.04,,0,39.04,39.04,1,-57063,30272,87335,-26791,0,0,4118,0,0,,4118,4118
24,06/14/2017,79,19:30,19:45,39.95,,0,39.95,39.95,1,-51930,32669,84599,-19261,0,0,15347,0,0,,15347,15347
24,06/14/2017,80,19:45,20:00,55.95,,0,55.95,55.95,1,-69696,32687,102383,-37009,0,0,20525,0,0,,20525,20525
24,06/14/2017,81,20:00,20:15,52.12,,0,52.12,52.12,1,-87659,45853,133512,-41806,0,0,27309,0,0,,27309,27309
24,06/14/2017,82,20:15,20:30,29.53,,0,29.53,29.53,1,-88900,41118,130018,-47782,0,0,7486,0,0,,7486,7486
24,06/14/2017,83,20:30,20:45,29.53,27.64,0,27.64,27.64,-1,-67632,44943,112575,-22689,0,-122,5,0,0,,127,-117
24,06/14/2017,84,20:45,21:00,,27.54,0,27.54,27.54,-1,-63853,46705,110558,-17148,0,-1440,0,0,0,,1440,-1440
24,06/14/2017,85,21:00,21:15,28.88,28.11,0,28.88,28.88,1,-88638,39766,128404,-48872,0,-488,1043,0,0,,1531,555
24,06/14/2017,86,21:15,21:30,28.88,,0,28.88,28.88,1,-54140,26856,80996,-27284,0,0,2423,0,0,,2423,2423
24,06/14/2017,87,21:30,21:45,,25.26,0,25.26,25.26,-1,-41889,34201,76090,-7688,0,-5159,0,0,0,,5159,-5159
24,06/14/2017,88,21:45,22:00,,24.88,0,24.88,24.88,-1,-41903,48425,90328,6522,0,-15028,0,0,0,,15028,-15028
24,06/14/2017,89,22:00,22:15,,27.78,0,27.78,27.78,-1,-66011,51013,117024,-14998,0,-11165,0,0,0,,11165,-11165
24,06/14/2017,90,22:15,22:30,27.88,27.78,0,27.88,27.88,1,-71404,47402,118806,-24002,0,-1595,675,0,0,,2270,-920
24,06/14/2017,91,22:30,22:45,27.88,,0,27.88,27.88,1,-60769,52252,113021,-8517,0,0,343,0,0,,343,343
24,06/14/2017,92,22:45,23:00,,24.88,0,24.88,24.88,-1,-52472,69962,122434,17490,0,-5130,0,0,0,,5130,-5130
24,06/14/2017,93,23:00,23:15,144.01,26.78,0,144.01,26.78,2,-120968,49971,170939,-70997,0,-3670,20326,0,0,,23996,16656
24,06/14/2017,94,23:15,23:30,62.95,,0,62.95,62.95,1,-73232,55268,128500,-17964,0,0,16307,0,0,,16307,16307
24,06/14/2017,95,23:30,23:45,62.95,8.53,0,8.53,8.53,-1,-45657,72894,118551,27237,0,-20438,86,0,0,,20524,-20352
24,06/14/2017,96,23:45,0:00,,15.88,0,15.88,15.88,-1,-83932,98496,182428,14564,0,-16551,0,0,0,,16551,-16551
24,06/15/2017,1,0:00,0:15,174.53,15.49,0,174.53,174.53,1,-86966,18444,105410,-68522,0,-10808,12704,0,0,,23512,1896
24,06/15/2017,2,0:15,0:30,174.53,,0,174.53,174.53,1,-79419,34069,113488,-45350,0,0,22569,0,0,,22569,22569
24,06/15/2017,3,0:30,0:45,30.38,24.25,0,24.25,24.25,-1,-35220,63865,99085,28645,0,-1881,3896,0,0,,5777,2015
24,06/15/2017,4,0:45,1:00,,19.17,0,19.17,19.17,-1,-62452,86427,148879,23975,0,-15650,0,0,0,,15650,-15650
24,06/15/2017,5,1:00,1:15,52.98,15.49,0,52.98,52.98,1,-57723,49572,107295,-8151,0,-14898,2097,0,0,,16995,-12801
24,06/15/2017,6,1:15,1:30,62.82,15.49,0,62.82,62.82,1,-64020,45569,109589,-18451,0,-239,18254,0,0,,18493,18015
24,06/15/2017,7,1:30,1:45,31.49,,0,31.49,31.49,1,-77944,50552,128496,-27392,0,0,14829,0,0,,14829,14829
24,06/15/2017,8,1:45,2:00,29.47,25.49,0,29.47,25.49,2,-42383,53968,96351,11585,0,-558,9290,0,0,,9848,8732
24,06/15/2017,9,2:00,2:15,,,0,26.83,26.83,0,-35167,45114,80281,9947,0,-12,78,0,0,,90,66
24,06/15/2017,10,2:15,2:30,,,0,26.83,26.83,0,-44837,48436,93273,3599,0,0,0,0,0,,0,0
24,06/15/2017,11,2:30,2:45,,,0,26.83,26.83,0,-36723,60995,97718,24272,0,0,0,0,0,,0,0
24,06/15/2017,12,2:45,3:00,,25.49,0,25.49,25.49,-1,-34428,53221,87649,18793,0,-1004,0,0,0,,1004,-1004
24,06/15/2017,13,3:00,3:15,29.47,25.49,0,29.47,25.49,2,-47287,53617,100904,6330,0,-2149,740,0,0,,2889,-1409
24,06/15/2017,14,3:15,3:30,36.01,25.49,0,36.01,36.01,1,-55254,44471,99725,-10783,0,-5,16391,0,0,,16396,16386
24,06/15/2017,15,3:30,3:45,27.49,,0,27.49,27.49,1,-52588,56769,109357,4181,0,0,4461,0,0,,4461,4461
24,06/15/2017,16,3:45,4:00,,24.49,0,24.49,24.49,-1,-52928,50740,103668,-2188,0,-165,0,0,0,,165,-165
24,06/15/2017,17,4:00,4:15,,27.78,0,27.78,27.78,-1,-28264,67174,95438,38910,0,-205,0,0,0,,205,-205
24,06/15/2017,18,4:15,4:30,,25.49,0,25.49,25.49,-1,-33238,50724,83962,17486,0,-2286,0,0,0,,2286,-2286
24,06/15/2017,19,4:30,4:45,,25.2,0,25.2,25.2,-1,-31225,50677,81902,19452,0,-5007,0,0,0,,5007,-5007
24,06/15/2017,20,4:45,5:00,,15.49,0,15.49,15.49,-1,-25103,63534,88637,38431,0,-12843,0,0,0,,12843,-12843
24,06/15/2017,21,5:00,5:15,,19.76,0,19.76,19.76,-1,-29371,78305,107676,48934,0,-27031,0,0,0,,27031,-27031
24,06/15/2017,22,5:15,5:30,,14.39,0,14.39,14.39,-1,-29501,57191,86692,27690,0,-37329,0,0,0,,37329,-37329
24,06/15/2017,23,5:30,5:45,27.49,24.8,0,27.49,27.49,1,-34944,26852,61796,-8092,0,-14525,99,0,0,,14624,-14426
24,06/15/2017,24,5:45,6:00,28.24,24.8,0,28.24,28.24,1,-40047,27663,67710,-12384,0,-263,3912,0,0,,4175,3649
24,06/15/2017,25,6:00,6:15,28.24,18.94,0,18.94,18.94,-1,-58462,87224,145686,28762,0,-9169,234,0,0,,9403,-8935
24,06/15/2017,26,6:15,6:30,,18.97,0,18.97,18.97,-1,-37764,65515,103279,27751,0,-29597,0,0,0,,29597,-29597
24,06/15/2017,27,6:30,6:45,31.58,26.27,0,31.58,31.58,1,-50108,37361,87469,-12747,0,-10730,1164,0,0,,11894,-9566
24,06/15/2017,28,6:45,7:00,218.06,26.27,0,218.06,218.06,1,-84703,31819,116522,-52884,0,-16,35743,0,0,,35759,35727
24,06/15/2017,29,7:00,7:15,218.06,3.1,0,3.1,3.1,-1,-66469,135915,202384,69446,0,-12070,7269,0,0,,19339,-4801
24,06/15/2017,30,7:15,7:30,,25.03,0,25.03,25.03,-1,-70060,89966,160026,19906,0,-8942,0,0,0,,8942,-8942
24,06/15/2017,31,7:30,7:45,27.58,25.03,0,27.58,27.58,1,-90912,54501,145413,-36411,0,-64,70,0,0,,134,6
24,06/15/2017,32,7:45,8:00,246.42,,0,246.42,246.42,1,-117577,54807,172384,-62770,0,0,17577,0,0,,17577,17577
24,06/15/2017,33,8:00,8:15,72.87,,0,72.87,72.87,1,-42940,90516,133456,47576,0,0,17931,0,0,,17931,17931
24,06/15/2017,34,8:15,8:30,28.43,,0,28.43,28.43,1,-61318,72663,133981,11345,0,0,4187,0,0,,4187,4187
24,06/15/2017,35,8:30,8:45,33,,0,33,33,1,-76478,55369,131847,-21109,0,0,1214,0,0,,1214,1214
24,06/15/2017,36,8:45,9:00,102.02,,0,102.02,102.02,1,-104567,49585,154152,-54982,0,0,33314,0,0,,33314,33314
24,06/15/2017,37,9:00,9:15,44.08,,0,44.08,44.08,1,-93510,77104,170614,-16406,0,0,24067,0,0,,24067,24067
24,06/15/2017,38,9:15,9:30,28.08,29.64,0,29.74,29.64,2,-91925,80084,172009,-11841,0,-155,1113,0,0,,1268,958
24,06/15/2017,39,9:30,9:45,28.43,,0,28.43,28.43,1,-120336,79627,199963,-40709,0,0,3437,0,0,,3437,3437
24,06/15/2017,40,9:45,10:00,72.98,,0,72.98,72.98,1,-138507,47939,186446,-90568,0,0,8249,0,0,,8249,8249
24,06/15/2017,41,10:00,10:15,81.02,,0,81.02,81.02,1,-142681,71343,214024,-71338,0,0,46263,0,0,,46263,46263
24,06/15/2017,42,10:15,10:30,42.45,,0,42.45,42.45,1,-128930,74505,203435,-54425,0,0,16698,0,0,,16698,16698
24,06/15/2017,43,10:30,10:45,37.58,,0,37.58,37.58,1,-144405,70959,215364,-73446,0,0,23484,0,0,,23484,23484
24,06/15/2017,44,10:45,11:00,56.78,,0,56.78,56.78,1,-160690,82174,242864,-78516,0,0,40644,0,0,,40644,40644
24,06/15/2017,45,11:00,11:15,116.67,,0,116.67,116.67,1,-151515,126542,278057,-24973,0,0,41896,0,0,,41896,41896
24,06/15/2017,46,11:15,11:30,32.02,,0,32.02,32.02,1,-143309,122091,265400,-21218,0,0,11149,0,0,,11149,11149
24,06/15/2017,47,11:30,11:45,43.09,,0,43.09,43.09,1,-135872,107379,243251,-28493,0,0,19774,0,0,,19774,19774
24,06/15/2017,48,11:45,12:00,36.02,,0,36.02,36.02,1,-129775,105649,235424,-24126,0,0,24586,0,0,,24586,24586
24,06/15/2017,49,12:00,12:15,28.02,,0,28.02,28.02,1,-162272,123991,286263,-38281,0,0,13046,0,0,,13046,13046
24,06/15/2017,50,12:15,12:30,25.58,,0,25.58,25.58,1,-180130,120675,300805,-59455,0,0,2211,0,0,,2211,2211
24,06/15/2017,51,12:30,12:45,128.02,,0,128.02,128.02,1,-181504,123221,304725,-58283,0,0,19622,0,0,,19622,19622
24,06/15/2017,52,12:45,13:00,114.02,30.54,0,30.54,30.54,-1,-148930,138066,286996,-10864,0,-1,28621,0,0,,28622,28620
24,06/15/2017,53,13:00,13:15,30.93,26.52,0,30.93,26.52,2,-178182,153216,331398,-24966,0,-316,2422,0,0,,2738,2106
24,06/15/2017,54,13:15,13:30,30.93,,0,30.93,30.93,1,-192832,149535,342367,-43297,0,0,8132,0,0,,8132,8132
24,06/15/2017,55,13:30,13:45,27.01,,0,27.01,27.01,1,-180505,164231,344736,-16274,0,0,1746,0,0,,1746,1746
24,06/15/2017,56,13:45,14:00,27.01,4.91,0,4.91,4.91,-1,-164216,193886,358102,29670,0,-11009,147,0,0,,11156,-10862
24,06/15/2017,57,14:00,14:15,128.02,5.03,0,128.02,5.03,2,-208698,146458,355156,-62240,0,-14468,13692,0,0,,28160,-776
24,06/15/2017,58,14:15,14:30,72.02,,0,72.02,72.02,1,-184364,174876,359240,-9488,0,0,16363,0,0,,16363,16363
24,06/15/2017,59,14:30,14:45,32.89,8.32,0,8.32,8.32,-1,-157418,205087,362505,47669,0,-9700,1178,0,0,,10878,-8522
24,06/15/2017,60,14:45,15:00,,-21.79,0,-21.79,-21.79,-1,-160813,203369,364182,42556,0,-55595,0,0,0,,55595,-55595
24,06/15/2017,61,15:00,15:15,25.58,24.58,0,25.58,25.58,1,-168849,181415,350264,12566,0,-16513,92,0,0,,16605,-16421
24,06/15/2017,62,15:15,15:30,25.58,24.58,0,25.58,25.58,1,-142902,188841,331743,45939,0,-9,250,0,0,,259,241
24,06/15/2017,63,15:30,15:45,25.58,,0,25.58,25.58,1,-135512,174336,309848,38824,0,0,250,0,0,,250,250
24,06/15/2017,64,15:45,16:00,25.58,,0,25.58,25.58,1,-116710,177373,294083,60663,0,0,250,0,0,,250,250
24,06/15/2017,65,16:00,16:15,25.58,-8.51,0,-8.51,-8.51,-1,-83460,179383,262843,95923,0,-16116,30,0,0,,16146,-16086
24,06/15/2017,66,16:15,16:30,,-8.51,0,-8.51,-8.51,-1,-73896,210954,284850,137058,0,-68984,0,0,0,,68984,-68984
24,06/15/2017,67,16:30,16:45,,14.9,0,14.9,14.9,-1,-70848,190889,261737,120041,0,-57419,0,0,0,,57419,-57419
24,06/15/2017,68,16:45,17:00,,8.47,0,8.47,8.47,-1,-75337,186246,261583,110909,0,-39928,0,0,0,,39928,-39928
24,06/15/2017,69,17:00,17:15,,-11.77,0,-11.77,-11.77,-1,-108171,155693,263864,47522,0,-49462,0,0,0,,49462,-49462
24,06/15/2017,70,17:15,17:30,,,0,29.19,29.19,0,-83683,190674,274357,106991,0,-4079,0,0,0,,4079,-4079
24,06/15/2017,71,17:30,17:45,,11.15,0,11.15,11.15,-1,-73465,190084,263549,116619,0,-5314,0,0,0,,5314,-5314
24,06/15/2017,72,17:45,18:00,,-2.37,0,-2.37,-2.37,-1,-83892,176643,260535,92751,0,-22261,0,0,0,,22261,-22261
24,06/15/2017,73,18:00,18:15,,-1.73,0,-1.73,-1.73,-1,-73469,118352,191821,44883,0,-49452,0,0,0,,49452,-49452
24,06/15/2017,74,18:15,18:30,,18.56,0,18.56,18.56,-1,-69372,126090,195462,56718,0,-47340,0,0,0,,47340,-47340
24,06/15/2017,75,18:30,18:45,,20.58,0,20.58,20.58,-1,-74057,110639,184696,36582,0,-40323,0,0,0,,40323,-40323
24,06/15/2017,76,18:45,19:00,28.05,20.58,0,28.05,20.58,2,-65150,102910,168060,37760,0,-6145,418,0,0,,6563,-5727
24,06/15/2017,77,19:00,19:15,,15.58,0,15.58,15.58,-1,-35012,171388,206400,136376,0,-25525,0,0,0,,25525,-25525
24,06/15/2017,78,19:15,19:30,,15.58,0,15.58,15.58,-1,-38175,147070,185245,108895,0,-23987,0,0,0,,23987,-23987
24,06/15/2017,79,19:30,19:45,,15.15,0,15.15,15.15,-1,-33615,159761,193376,126146,0,-39033,0,0,0,,39033,-39033
24,06/15/2017,80,19:45,20:00,,21.39,0,21.39,21.39,-1,-30037,140978,171015,110941,0,-32207,0,0,0,,32207,-32207
24,06/15/2017,81,20:00,20:15,,25.58,0,25.58,25.58,-1,-53902,158167,212069,104265,0,-11497,0,0,0,,11497,-11497
24,06/15/2017,82,20:15,20:30,,20.58,0,20.58,20.58,-1,-41544,156400,197944,114856,0,-3289,0,0,0,,3289,-3289
24,06/15/2017,83,20:30,20:45,,11.15,0,11.15,11.15,-1,-47811,152969,200780,105158,0,-34369,0,0,0,,34369,-34369
24,06/15/2017,84,20:45,21:00,,8.41,0,8.41,8.41,-1,-50042,166204,216246,116162,0,-38855,0,0,0,,38855,-38855
24,06/15/2017,85,21:00,21:15,,3.45,0,3.45,3.45,-1,-61939,147523,209462,85584,0,-42912,0,0,0,,42912,-42912
24,06/15/2017,86,21:15,21:30,,21.22,0,21.22,21.22,-1,-51139,181754,232893,130615,0,-25836,0,0,0,,25836,-25836
24,06/15/2017,87,21:30,21:45,,20.58,0,20.58,20.58,-1,-56675,143580,200255,86905,0,-18976,0,0,0,,18976,-18976
24,06/15/2017,88,21:45,22:00,,20.58,0,20.58,20.58,-1,-50970,83399,134369,32429,0,-21218,0,0,0,,21218,-21218
24,06/15/2017,89,22:00,22:15,,20.58,0,20.58,20.58,-1,-66841,113251,180092,46410,0,-25814,0,0,0,,25814,-25814
24,06/15/2017,90,22:15,22:30,,24.58,0,24.58,24.58,-1,-77828,75994,153822,-1834,0,-16899,0,0,0,,16899,-16899
24,06/15/2017,91,22:30,22:45,27.4,39.5,0,32.62,32.62,2,-76629,53422,130051,-23207,0,-4320,895,0,0,,5215,-3425
24,06/15/2017,92,22:45,23:00,,20.58,0,20.58,20.58,-1,-69278,75960,145238,6682,0,-2702,0,0,0,,2702,-2702
24,06/15/2017,93,23:00,23:15,,15.58,0,15.58,15.58,-1,-55167,134660,189827,79493,0,-4773,0,0,0,,4773,-4773
24,06/15/2017,94,23:15,23:30,,25.58,0,25.58,25.58,-1,-59280,62769,122049,3489,0,-102,0,0,0,,102,-102
24,06/15/2017,95,23:30,23:45,,24.58,0,24.58,24.58,-1,-75807,67452,143259,-8355,0,-1086,0,0,0,,1086,-1086
24,06/15/2017,96,23:45,0:00,,,0,32.6,32.6,0,-141614,65574,207188,-76040,0,0,0,0,0,,0,0
24,06/16/2017,1,0:00,0:15,35.19,,0,35.19,35.19,1,-115523,41897,157420,-73626,0,0,1159,0,0,,1159,1159
24,06/16/2017,2,0:15,0:30,115.12,,0,115.12,115.12,1,-108891,21804,130695,-87087,0,0,17811,0,0,,17811,17811
24,06/16/2017,3,0:30,0:45,,,0,27.95,27.95,0,-80752,25447,106199,-55305,0,0,1315,0,0,,1315,1315
24,06/16/2017,4,0:45,1:00,,26.86,0,26.86,26.86,-1,-51414,25249,76663,-26165,0,-136,0,0,0,,136,-136
24,06/16/2017,5,1:00,1:15,205.62,26.86,0,205.62,205.62,1,-93683,14903,108586,-78780,0,-136,13909,0,0,,14045,13773
24,06/16/2017,6,1:15,1:30,40.54,,0,40.54,40.54,1,-66584,12491,79075,-54093,0,0,18394,0,0,,18394,18394
24,06/16/2017,7,1:30,1:45,205.62,,0,205.62,205.62,1,-122542,13660,136202,-108882,0,0,23786,0,0,,23786,23786
24,06/16/2017,8,1:45,2:00,40,,0,40,40,1,-89799,31978,121777,-57821,0,0,19349,0,0,,19349,19349
24,06/16/2017,9,2:00,2:15,38.15,26.86,0,38.15,26.86,2,-103828,75029,178857,-28799,0,-71,6115,0,0,,6186,6044
24,06/16/2017,10,2:15,2:30,40.38,,0,40.38,40.38,1,-88386,54011,142397,-34375,0,0,23539,0,0,,23539,23539
24,06/16/2017,11,2:30,2:45,28.15,,0,28.15,28.15,1,-74493,60248,134741,-14245,0,0,11081,0,0,,11081,11081
24,06/16/2017,12,2:45,3:00,28.15,26.79,0,26.79,26.79,-1,-69673,69511,139184,-162,0,-751,331,0,0,,1082,-420
24,06/16/2017,13,3:00,3:15,32.15,26.79,0,32.15,26.79,2,-71111,61716,132827,-9395,0,-620,2711,0,0,,3331,2091
24,06/16/2017,14,3:15,3:30,29.46,,0,29.46,29.46,1,-68213,56376,124589,-11837,0,0,7914,0,0,,7914,7914
24,06/16/2017,15,3:30,3:45,,,0,26.9,26.9,0,-61651,60380,122031,-1271,0,0,234,0,0,,234,234
24,06/16/2017,16,3:45,4:00,,,0,26.9,26.9,0,-49109,65453,114562,16344,0,0,0,0,0,,0,0
24,06/16/2017,17,4:00,4:15,28.15,,0,28.15,28.15,1,-64709,51189,115898,-13520,0,0,1613,0,0,,1613,1613
24,06/16/2017,18,4:15,4:30,,27.99,0,27.99,27.99,-1,-58255,48935,107190,-9320,0,-32,0,0,0,,32,-32
24,06/16/2017,19,4:30,4:45,28.15,,0,28.15,28.15,1,-64846,47958,112804,-16888,0,0,682,0,0,,682,682
24,06/16/2017,20,4:45,5:00,28.15,,0,28.15,28.15,1,-73139,55691,128830,-17448,0,0,4098,0,0,,4098,4098
24,06/16/2017,21,5:00,5:15,39.36,,0,39.36,39.36,1,-110617,47724,158341,-62893,0,0,18552,0,0,,18552,18552
24,06/16/2017,22,5:15,5:30,29.12,,0,29.12,29.12,1,-77958,48742,126700,-29216,0,0,10536,0,0,,10536,10536
24,06/16/2017,23,5:30,5:45,34.31,,0,34.31,34.31,1,-85363,44994,130357,-40369,0,0,8692,0,0,,8692,8692
24,06/16/2017,24,5:45,6:00,32.15,,0,32.15,32.15,1,-93159,71316,164475,-21843,0,0,5944,0,0,,5944,5944
24,06/16/2017,25,6:00,6:15,32.23,,0,32.23,32.23,1,-119368,35185,154553,-84183,0,0,2388,0,0,,2388,2388
24,06/16/2017,26,6:15,6:30,,,0,27.31,27.31,0,-85267,36453,121720,-48814,0,0,0,0,0,,0,0
24,06/16/2017,27,6:30,6:45,33.39,,0,33.39,33.39,1,-69157,37402,106559,-31755,0,0,5295,0,0,,5295,5295
24,06/16/2017,28,6:45,7:00,27.51,,0,27.51,27.51,1,-48063,90339,138402,42276,0,0,1778,0,0,,1778,1778
24,06/16/2017,29,7:00,7:15,28.23,,0,28.23,28.23,1,-102590,83740,186330,-18850,0,0,267,0,0,,267,267
24,06/16/2017,30,7:15,7:30,,,0,27.31,27.31,0,-74982,103199,178181,28217,0,0,0,0,0,,0,0
24,06/16/2017,31,7:30,7:45,,,0,27.31,27.31,0,-76669,117350,194019,40681,0,0,0,0,0,,0,0
24,06/16/2017,32,7:45,8:00,,,0,27.31,27.31,0,-80169,132609,212778,52440,0,0,0,0,0,,0,0
24,06/16/2017,33,8:00,8:15,26.23,,0,26.23,26.23,1,-97911,115567,213478,17656,0,0,293,0,0,,293,293
24,06/16/2017,34,8:15,8:30,26.23,,0,26.23,26.23,1,-68686,110624,179310,41938,0,0,500,0,0,,500,500
24,06/16/2017,35,8:30,8:45,26.23,25.95,0,25.95,25.95,-1,-51650,77544,129194,25894,0,-1442,156,0,0,,1598,-1286
24,06/16/2017,36,8:45,9:00,,25.95,0,25.95,25.95,-1,-58254,61963,120217,3709,0,-2520,0,0,0,,2520,-2520
24,06/16/2017,37,9:00,9:15,35.19,27.51,0,35.19,27.31,2,-77493,59719,137212,-17774,0,-469,2165,0,0,,2634,1696
24,06/16/2017,38,9:15,9:30,130.2,,0,130.2,130.2,1,-78742,40179,118921,-38563,0,0,35333,0,0,,35333,35333
24,06/16/2017,39,9:30,9:45,29.2,24.78,0,24.78,24.78,-1,-65051,72214,137265,7163,0,-2586,11761,0,0,,14347,9175
24,06/16/2017,40,9:45,10:00,27.51,26.23,0,27.51,26.23,2,-67899,72657,140556,4758,0,-4182,230,0,0,,4412,-3952
24,06/16/2017,41,10:00,10:15,32.23,,0,32.23,32.23,1,-75692,58075,133767,-17617,0,0,6959,0,0,,6959,6959
24,06/16/2017,42,10:15,10:30,26.23,23.45,0,27.31,23.45,2,-78348,76161,154509,-2187,0,-4908,1602,0,0,,6510,-3306
24,06/16/2017,43,10:30,10:45,55.32,23.45,0,55.32,55.32,1,-89723,51898,141621,-37825,0,-129,19973,0,0,,20102,19844
24,06/16/2017,44,10:45,11:00,43.19,,0,43.19,43.19,1,-102573,63718,166291,-38855,0,0,34992,0,0,,34992,34992
24,06/16/2017,45,11:00,11:15,136.92,,0,136.92,136.92,1,-108303,47004,155307,-61299,0,0,55439,0,0,,55439,55439
24,06/16/2017,46,11:15,11:30,33.1,,0,33.1,33.1,1,-91667,73470,165137,-18197,0,0,19823,0,0,,19823,19823
24,06/16/2017,47,11:30,11:45,34.49,,0,34.49,34.49,1,-110842,84037,194879,-26805,0,0,16067,0,0,,16067,16067
24,06/16/2017,48,11:45,12:00,39.08,,0,39.08,39.08,1,-107908,73417,181325,-34491,0,0,25199,0,0,,25199,25199
24,06/16/2017,49,12:00,12:15,229.42,,0,229.42,229.42,1,-159492,80329,239821,-79163,0,0,42124,0,0,,42124,42124
24,06/16/2017,50,12:15,12:30,40.34,,0,40.34,40.34,1,-136971,118621,255592,-18350,0,0,21248,0,0,,21248,21248
24,06/16/2017,51,12:30,12:45,28.16,,0,28.16,28.16,1,-150519,129949,280468,-20570,0,0,439,0,0,,439,439
24,06/16/2017,52,12:45,13:00,28.55,,0,28.55,28.55,1,-156254,124105,280359,-32149,0,0,5832,0,0,,5832,5832
24,06/16/2017,53,13:00,13:15,35.19,,0,35.19,35.19,1,-180066,101165,281231,-78901,0,0,10062,0,0,,10062,10062
24,06/16/2017,54,13:15,13:30,34.49,,0,34.49,34.49,1,-191103,93337,284440,-97766,0,0,14737,0,0,,14737,14737
24,06/16/2017,55,13:30,13:45,32.23,,0,32.23,32.23,1,-182890,88950,271840,-93940,0,0,14546,0,0,,14546,14546
24,06/16/2017,56,13:45,14:00,29.2,,0,29.2,29.2,1,-192107,99515,291622,-92592,0,0,12524,0,0,,12524,12524
24,06/16/2017,57,14:00,14:15,219.92,,0,219.92,219.92,1,-178376,107288,285664,-71088,0,0,33269,0,0,,33269,33269
24,06/16/2017,58,14:15,14:30,43.12,25.23,0,25.23,25.23,-1,-156915,159053,315968,2138,0,-621,25269,0,0,,25890,24648
24,06/16/2017,59,14:30,14:45,35.19,25.23,0,35.19,35.19,1,-152003,134139,286142,-17864,0,-1084,8326,0,0,,9410,7242
24,06/16/2017,60,14:45,15:00,38.4,,0,38.4,38.4,1,-164631,128358,292989,-36273,0,0,27638,0,0,,27638,27638
24,06/16/2017,61,15:00,15:15,101.82,,0,101.82,101.82,1,-162376,103714,266090,-58662,0,0,45410,0,0,,45410,45410
24,06/16/2017,62,15:15,15:30,43.16,,0,43.16,43.16,1,-153378,110284,263662,-43094,0,0,47374,0,0,,47374,47374
24,06/16/2017,63,15:30,15:45,33.1,,0,33.1,33.1,1,-142370,108160,250530,-34210,0,0,29785,0,0,,29785,29785
24,06/16/2017,64,15:45,16:00,55.26,,0,55.26,55.26,1,-154401,101049,255450,-53352,0,0,31010,0,0,,31010,31010
24,06/16/2017,65,16:00,16:15,55.26,21.23,0,21.23,21.23,-1,-153395,166233,319628,12838,0,-2915,12376,0,0,,15291,9461
24,06/16/2017,66,16:15,16:30,,27.25,0,27.25,27.25,-1,-148640,142283,290923,-6357,0,-968,0,0,0,,968,-968
24,06/16/2017,67,16:30,16:45,27.51,,0,27.51,27.51,1,-142870,128140,271010,-14730,0,0,215,0,0,,215,215
24,06/16/2017,68,16:45,17:00,38.23,,0,38.23,38.23,1,-151839,119840,271679,-31999,0,0,10003,0,0,,10003,10003
24,06/16/2017,69,17:00,17:15,28.23,26.23,0,26.23,26.23,-1,-172243,169856,342099,-2387,0,-125,7797,0,0,,7922,7672
24,06/16/2017,70,17:15,17:30,28.23,21.23,0,21.23,21.23,-1,-138704,148114,286818,9410,0,-13452,187,0,0,,13639,-13265
24,06/16/2017,71,17:30,17:45,,27.9,0,27.9,27.9,-1,-138349,129125,267474,-9224,0,-2609,0,0,0,,2609,-2609
24,06/16/2017,72,17:45,18:00,,25.99,0,25.99,25.99,-1,-145451,136394,281845,-9057,0,-505,0,0,0,,505,-505
24,06/16/2017,73,18:00,18:15,,0.8,0,0.8,0.8,-1,-102288,147785,250073,45497,0,-32245,0,0,0,,32245,-32245
24,06/16/2017,74,18:15,18:30,,21.23,0,21.23,21.23,-1,-72828,118784,191612,45956,0,-42972,0,0,0,,42972,-42972
24,06/16/2017,75,18:30,18:45,,25.78,0,25.78,25.78,-1,-73465,127111,200576,53646,0,-24336,0,0,0,,24336,-24336
24,06/16/2017,76,18:45,19:00,,11.07,0,11.07,11.07,-1,-66436,121708,188144,55272,0,-36100,0,0,0,,36100,-36100
24,06/16/2017,77,19:00,19:15,,-11.98,0,-11.98,-11.98,-1,-33139,121023,154162,87884,0,-64740,0,0,0,,64740,-64740
24,06/16/2017,78,19:15,19:30,,11.07,0,11.07,11.07,-1,-33785,68800,102585,35015,0,-55558,0,0,0,,55558,-55558
24,06/16/2017,79,19:30,19:45,,26.79,0,26.79,26.79,-1,-37821,61142,98963,23321,0,-5065,0,0,0,,5065,-5065
24,06/16/2017,80,19:45,20:00,,21.23,0,21.23,21.23,-1,-50097,88840,138937,38743,0,-7409,0,0,0,,7409,-7409
24,06/16/2017,81,20:00,20:15,,25.23,0,25.23,25.23,-1,-41881,100440,142321,58559,0,-3110,0,0,0,,3110,-3110
24,06/16/2017,82,20:15,20:30,,19.5,0,19.5,19.5,-1,-46803,84759,131562,37956,0,-11142,0,0,0,,11142,-11142
24,06/16/2017,83,20:30,20:45,,27.51,0,27.51,27.51,-1,-49952,78308,128260,28356,0,-4143,0,0,0,,4143,-4143
24,06/16/2017,84,20:45,21:00,,26.86,0,26.86,26.86,-1,-50423,64977,115400,14554,0,-506,0,0,0,,506,-506
24,06/16/2017,85,21:00,21:15,,26.86,0,26.86,26.86,-1,-68549,63172,131721,-5377,0,-1592,0,0,0,,1592,-1592
24,06/16/2017,86,21:15,21:30,,26.23,0,26.23,26.23,-1,-46474,67967,114441,21493,0,-1714,0,0,0,,1714,-1714
24,06/16/2017,87,21:30,21:45,,25.99,0,25.99,25.99,-1,-48130,77886,126016,29756,0,-7747,0,0,0,,7747,-7747
24,06/16/2017,88,21:45,22:00,,26.23,0,26.23,26.23,-1,-49078,50088,99166,1010,0,-6566,0,0,0,,6566,-6566
24,06/16/2017,89,22:00,22:15,,26.86,0,26.86,26.86,-1,-45681,40892,86573,-4789,0,-2153,0,0,0,,2153,-2153
24,06/16/2017,90,22:15,22:30,,27.51,0,27.51,27.51,-1,-57326,30767,88093,-26559,0,-1402,0,0,0,,1402,-1402
24,06/16/2017,91,22:30,22:45,28.16,,0,28.16,28.16,1,-60492,23405,83897,-37087,0,0,485,0,0,,485,485
24,06/16/2017,92,22:45,23:00,28.16,,0,28.16,28.16,1,-54091,23691,77782,-30400,0,0,1484,0,0,,1484,1484
24,06/16/2017,93,23:00,23:15,350.12,,0,350.12,350.12,1,-88104,27882,115986,-60222,0,0,20944,0,0,,20944,20944
24,06/16/2017,94,23:15,23:30,350.12,11.07,0,11.07,11.07,-1,-44644,62586,107230,17942,0,-1313,31907,0,0,,33220,30594
24,06/16/2017,95,23:30,23:45,350.12,-4.66,0,-4.66,-4.66,-1,-50154,61855,112009,11701,0,-16606,26,0,0,,16632,-16580
24,06/16/2017,96,23:45,0:00,38.51,21.23,0,38.51,21.23,2,-97675,73521,171196,-24154,0,-420,7563,0,0,,7983,7143
25,06/17/2017,1,0:00,0:15,38.51,-22.03,0,-22.03,-22.03,-1,-31461,98052,129513,66591,0,-7974,618,0,0,,8592,-7356
25,06/17/2017,2,0:15,0:30,,23.61,0,23.61,23.61,-1,-30108,77387,107495,47279,0,-13261,0,0,0,,13261,-13261
25,06/17/2017,3,0:30,0:45,27.63,23.61,0,33.04,23.61,2,-69047,58567,127614,-10480,0,-16075,10,0,0,,16085,-16065
25,06/17/2017,4,0:45,1:00,28.61,27.61,0,33.04,27.61,2,-75591,60135,135726,-15456,0,-1925,704,0,0,,2629,-1221
25,06/17/2017,5,1:00,1:15,,-4.42,0,-4.42,-4.42,-1,-63590,123048,186638,59458,0,-24889,0,0,0,,24889,-24889
25,06/17/2017,6,1:15,1:30,,25.42,0,25.42,25.42,-1,-53870,111586,165456,57716,0,-20448,0,0,0,,20448,-20448
25,06/17/2017,7,1:30,1:45,,28.61,0,28.61,28.61,-1,-41362,89845,131207,48483,0,-8863,0,0,0,,8863,-8863
25,06/17/2017,8,1:45,2:00,,23.61,0,23.61,23.61,-1,-38937,85632,124569,46695,0,-3385,0,0,0,,3385,-3385
25,06/17/2017,9,2:00,2:15,34.61,29.8,0,34.61,34.61,1,-51039,55189,106228,4150,0,-1034,961,0,0,,1995,-73
25,06/17/2017,10,2:15,2:30,47.92,,0,47.92,47.92,1,-56325,38998,95323,-17327,0,0,20048,0,0,,20048,20048
25,06/17/2017,11,2:30,2:45,47.92,28.61,0,28.61,28.61,-1,-31885,58322,90207,26437,0,-483,2696,0,0,,3179,2213
25,06/17/2017,12,2:45,3:00,29.58,,0,29.58,29.58,1,-70038,39813,109851,-30225,0,0,970,0,0,,970,970
25,06/17/2017,13,3:00,3:15,29.58,29.39,0,29.39,29.39,-1,-33624,108691,142315,75067,0,-395,111,0,0,,506,-284
25,06/17/2017,14,3:15,3:30,,29.8,0,29.8,29.8,-1,-42134,54984,97118,12850,0,-595,0,0,0,,595,-595
25,06/17/2017,15,3:30,3:45,125.02,,0,125.02,125.02,1,-73576,29796,103372,-43780,0,0,18708,0,0,,18708,18708
25,06/17/2017,16,3:45,4:00,33.16,29.39,0,29.39,29.39,-1,-43642,59413,103055,15771,0,-132,13008,0,0,,13140,12876
25,06/17/2017,17,4:00,4:15,33.16,28.61,0,28.61,28.61,-1,-15286,116402,131688,101116,0,-4166,49,0,0,,4215,-4117
25,06/17/2017,18,4:15,4:30,,29.78,0,29.78,29.78,-1,-12063,87143,99206,75080,0,-1461,0,0,0,,1461,-1461
25,06/17/2017,19,4:30,4:45,,,0,28.9,28.9,0,-14438,63180,77618,48742,0,-88,0,0,0,,88,-88
25,06/17/2017,20,4:45,5:00,,,0,28.9,28.9,0,-20858,45855,66713,24997,0,0,0,0,0,,0,0
25,06/17/2017,21,5:00,5:15,30.75,,0,30.75,30.75,1,-56081,56101,112182,20,0,0,3917,0,0,,3917,3917
25,06/17/2017,22,5:15,5:30,32.5,29.82,0,32.5,28.92,2,-26576,51007,77583,24431,0,-23,9821,0,0,,9844,9798
25,06/17/2017,23,5:30,5:45,32.5,29.82,0,29.82,29.82,-1,-26384,36383,62767,9999,0,-764,142,0,0,,906,-622
25,06/17/2017,24,5:45,6:00,,,0,28.92,28.92,0,-28772,33818,62590,5046,0,0,0,0,0,,0,0
25,06/17/2017,25,6:00,6:15,,,0,28.92,28.92,0,-23316,62046,85362,38730,0,0,0,0,0,,0,0
25,06/17/2017,26,6:15,6:30,,,0,28.92,28.92,0,-44902,60779,105681,15877,0,0,0,0,0,,0,0
25,06/17/2017,27,6:30,6:45,,,0,28.92,28.92,0,-38900,56891,95791,17991,0,0,0,0,0,,0,0
25,06/17/2017,28,6:45,7:00,31.58,,0,31.58,31.58,1,-63625,56053,119678,-7572,0,0,4398,0,0,,4398,4398
25,06/17/2017,29,7:00,7:15,27.63,28.93,0,28.93,28.93,-1,-66866,74204,141070,7338,0,-165,1226,0,0,,1391,1061
25,06/17/2017,30,7:15,7:30,,28.93,0,28.93,28.93,-1,-56273,55686,111959,-587,0,-3096,0,0,0,,3096,-3096
25,06/17/2017,31,7:30,7:45,,,0,28.89,28.89,0,-70964,52849,123813,-18115,0,-244,0,0,0,,244,-244
25,06/17/2017,32,7:45,8:00,,,0,28.89,28.89,0,-95018,70922,165940,-24096,0,0,0,0,0,,0,0
25,06/17/2017,33,8:00,8:15,73.02,,0,73.02,73.02,1,-89336,43593,132929,-45743,0,0,18610,0,0,,18610,18610
25,06/17/2017,34,8:15,8:30,34.93,,0,34.93,34.93,1,-79351,48933,128284,-30418,0,0,20081,0,0,,20081,20081
25,06/17/2017,35,8:30,8:45,46.7,,0,46.7,46.7,1,-112221,60840,173061,-51381,0,0,26520,0,0,,26520,26520
25,06/17/2017,36,8:45,9:00,44.94,,0,44.94,44.94,1,-127221,76024,203245,-51197,0,0,41423,0,0,,41423,41423
25,06/17/2017,37,9:00,9:15,82.02,,0,82.02,82.02,1,-102181,42985,145166,-59196,0,0,51719,0,0,,51719,51719
25,06/17/2017,38,9:15,9:30,47.55,,0,47.55,47.55,1,-88862,55579,144441,-33283,0,0,53198,0,0,,53198,53198
25,06/17/2017,39,9:30,9:45,42.02,,0,42.02,42.02,1,-94346,57931,152277,-36415,0,0,19002,0,0,,19002,19002
25,06/17/2017,40,9:45,10:00,111.51,,0,111.51,111.51,1,-112310,59160,171470,-53150,0,0,40814,0,0,,40814,40814
25,06/17/2017,41,10:00,10:15,30.75,27.93,0,33.08,27.93,2,-54900,63630,118530,8730,0,-838,11997,0,0,,12835,11159
25,06/17/2017,42,10:15,10:30,34.9,27.93,0,34.9,34.9,1,-77633,60779,138412,-16854,0,-38,3345,0,0,,3383,3307
25,06/17/2017,43,10:30,10:45,30.02,,0,30.02,30.02,1,-79434,65483,144917,-13951,0,0,5191,0,0,,5191,5191
25,06/17/2017,44,10:45,11:00,29.58,,0,29.58,29.58,1,-75253,63462,138715,-11791,0,0,1218,0,0,,1218,1218
25,06/17/2017,45,11:00,11:15,30,,0,30,30,1,-82465,74038,156503,-8427,0,0,3588,0,0,,3588,3588
25,06/17/2017,46,11:15,11:30,30.93,,0,30.93,30.93,1,-97845,75464,173309,-22381,0,0,11787,0,0,,11787,11787
25,06/17/2017,47,11:30,11:45,30.93,,0,30.93,30.93,1,-97509,75938,173447,-21571,0,0,12759,0,0,,12759,12759
25,06/17/2017,48,11:45,12:00,30,,0,30,30,1,-93791,77487,171278,-16304,0,0,12255,0,0,,12255,12255
25,06/17/2017,49,12:00,12:15,30.93,,0,30.93,30.93,1,-75870,56200,132070,-19670,0,0,12693,0,0,,12693,12693
25,06/17/2017,50,12:15,12:30,29.58,,0,29.58,29.58,1,-75815,55522,131337,-20293,0,0,11469,0,0,,11469,11469
25,06/17/2017,51,12:30,12:45,28.93,,0,28.93,28.93,1,-70474,57432,127906,-13042,0,0,9374,0,0,,9374,9374
25,06/17/2017,52,12:45,13:00,34.93,,0,34.93,34.93,1,-65827,51385,117212,-14442,0,0,7352,0,0,,7352,7352
25,06/17/2017,53,13:00,13:15,34.93,,0,34.93,34.93,1,-107319,45950,153269,-61369,0,0,8616,0,0,,8616,8616
25,06/17/2017,54,13:15,13:30,27.63,,0,27.63,27.63,1,-89321,43291,132612,-46030,0,0,3076,0,0,,3076,3076
25,06/17/2017,55,13:30,13:45,,,0,28.51,28.51,0,-80148,42063,122211,-38085,0,0,0,0,0,,0,0
25,06/17/2017,56,13:45,14:00,,28.93,0,28.93,28.93,-1,-69473,46662,116135,-22811,0,-15,0,0,0,,15,-15
25,06/17/2017,57,14:00,14:15,30.93,28.78,0,30.93,28.51,2,-83597,57983,141580,-25614,0,-431,690,0,0,,1121,259
25,06/17/2017,58,14:15,14:30,35.09,,0,35.09,35.09,1,-76185,43849,120034,-32336,0,0,7369,0,0,,7369,7369
25,06/17/2017,59,14:30,14:45,28.93,,0,28.93,28.93,1,-63777,43836,107613,-19941,0,0,1893,0,0,,1893,1893
25,06/17/2017,60,14:45,15:00,28.67,26.79,0,26.79,26.79,-1,-49252,48595,97847,-657,0,-1484,1018,0,0,,2502,-466
25,06/17/2017,61,15:00,15:15,,28.89,0,28.89,28.89,-1,-44254,66638,110892,22384,0,-694,0,0,0,,694,-694
25,06/17/2017,62,15:15,15:30,,26.79,0,26.79,26.79,-1,-36687,67727,104414,31040,0,-696,0,0,0,,696,-696
25,06/17/2017,63,15:30,15:45,,26.33,0,26.33,26.33,-1,-38032,58022,96054,19990,0,-2806,0,0,0,,2806,-2806
25,06/17/2017,64,15:45,16:00,,25.05,0,25.05,25.05,-1,-40190,55822,96012,15632,0,-1789,0,0,0,,1789,-1789
25,06/17/2017,65,16:00,16:15,,29.39,0,29.39,29.39,-1,-58090,100120,158210,42030,0,-576,0,0,0,,576,-576
25,06/17/2017,66,16:15,16:30,,28.89,0,28.89,28.89,-1,-40104,87000,127104,46896,0,-9,0,0,0,,9,-9
25,06/17/2017,67,16:30,16:45,,28.89,0,28.89,28.89,-1,-40852,72180,113032,31328,0,-199,0,0,0,,199,-199
25,06/17/2017,68,16:45,17:00,,29.39,0,29.39,29.39,-1,-42677,66960,109637,24283,0,-77,0,0,0,,77,-77
25,06/17/2017,69,17:00,17:15,,26.98,0,26.98,26.98,-1,-55889,107629,163518,51740,0,-1350,0,0,0,,1350,-1350
25,06/17/2017,70,17:15,17:30,,27.29,0,27.29,27.29,-1,-45033,99505,144538,54472,0,-1378,0,0,0,,1378,-1378
25,06/17/2017,71,17:30,17:45,,28.89,0,28.89,28.89,-1,-39729,69466,109195,29737,0,-186,0,0,0,,186,-186
25,06/17/2017,72,17:45,18:00,,28.89,0,28.89,28.89,-1,-45090,64364,109454,19274,0,-196,0,0,0,,196,-196
25,06/17/2017,73,18:00,18:15,,27.93,0,27.93,27.93,-1,-60135,61183,121318,1048,0,-1403,0,0,0,,1403,-1403
25,06/17/2017,74,18:15,18:30,,28.89,0,28.89,28.89,-1,-49649,73059,122708,23410,0,-1442,0,0,0,,1442,-1442
25,06/17/2017,75,18:30,18:45,,26.98,0,26.98,26.98,-1,-53365,65703,119068,12338,0,-1401,0,0,0,,1401,-1401
25,06/17/2017,76,18:45,19:00,30.93,,0,30.93,30.93,1,-62374,59724,122098,-2650,0,0,3572,0,0,,3572,3572
25,06/17/2017,77,19:00,19:15,49.88,,0,49.88,49.88,1,-93388,40100,133488,-53288,0,0,20092,0,0,,20092,20092
25,06/17/2017,78,19:15,19:30,41.1,,0,41.1,41.1,1,-72821,36868,109689,-35953,0,0,10892,0,0,,10892,10892
25,06/17/2017,79,19:30,19:45,41.1,,0,41.1,41.1,1,-75786,38135,113921,-37651,0,0,20081,0,0,,20081,20081
25,06/17/2017,80,19:45,20:00,49.88,,0,49.88,49.88,1,-82322,32927,115249,-49395,0,0,28357,0,0,,28357,28357
25,06/17/2017,81,20:00,20:15,34.19,,0,34.19,34.19,1,-65316,48393,113709,-16923,0,0,21755,0,0,,21755,21755
25,06/17/2017,82,20:15,20:30,,,0,33.24,33.24,0,-74132,46159,120291,-27973,0,0,1406,0,0,,1406,1406
25,06/17/2017,83,20:30,20:45,,,0,33.24,33.24,0,-82048,36497,118545,-45551,0,0,0,0,0,,0,0
25,06/17/2017,84,20:45,21:00,,,0,33.24,33.24,0,-81951,32647,114598,-49304,0,0,0,0,0,,0,0
25,06/17/2017,85,21:00,21:15,,,0,33.18,33.18,0,-64073,45779,109852,-18294,0,0,0,0,0,,0,0
25,06/17/2017,86,21:15,21:30,,,0,33.18,33.18,0,-72497,45390,117887,-27107,0,0,0,0,0,,0,0
25,06/17/2017,87,21:30,21:45,,,0,33.18,33.18,0,-80182,49016,129198,-31166,0,0,0,0,0,,0,0
25,06/17/2017,88,21:45,22:00,,,0,33.18,33.18,0,-79660,51339,130999,-28321,0,0,0,0,0,,0,0
25,06/17/2017,89,22:00,22:15,,28.93,0,28.93,28.93,-1,-56415,62839,119254,6424,0,-1338,0,0,0,,1338,-1338
25,06/17/2017,90,22:15,22:30,,28.93,0,28.93,28.93,-1,-71802,56421,128223,-15381,0,-1601,0,0,0,,1601,-1601
25,06/17/2017,91,22:30,22:45,29.58,29.11,0,33.15,29.11,2,-76767,44450,121217,-32317,0,-878,397,0,0,,1275,-481
25,06/17/2017,92,22:45,23:00,28.67,,0,28.67,28.67,1,-74240,48547,122787,-25693,0,0,1562,0,0,,1562,1562
25,06/17/2017,93,23:00,23:15,35.09,,0,35.09,35.09,1,-117133,31640,148773,-85493,0,0,10198,0,0,,10198,10198
25,06/17/2017,94,23:15,23:30,31.43,,0,31.43,31.43,1,-136798,29291,166089,-107507,0,0,15471,0,0,,15471,15471
25,06/17/2017,95,23:30,23:45,129.01,,0,129.01,129.01,1,-130820,24490,155310,-106330,0,0,37826,0,0,,37826,37826
25,06/17/2017,96,23:45,0:00,28.02,,0,28.02,28.02,1,-101555,32122,133677,-69433,0,0,17583,0,0,,17583,17583
25,06/18/2017,1,0:00,0:15,186,,0,186,186,1,-131683,81155,212838,-50528,0,0,14939,0,0,,14939,14939
25,06/18/2017,2,0:15,0:30,186,,0,186,186,1,-123855,37775,161630,-86080,0,0,47648,0,0,,47648,47648
25,06/18/2017,3,0:30,0:45,30.75,27.93,0,27.93,27.93,-1,-91525,54574,146099,-36951,0,-231,15124,0,0,,15355,14893
25,06/18/2017,4,0:45,1:00,30.75,20.33,0,20.33,20.33,-1,-65488,72176,137664,6688,0,-10788,155,0,0,,10943,-10633
25,06/18/2017,5,1:00,1:15,28.93,18.19,0,28.93,28.93,1,-56387,75005,131392,18618,0,-18962,58,0,0,,19020,-18904
25,06/18/2017,6,1:15,1:30,28.93,27.93,0,28.93,27.93,2,-68150,67099,135249,-1051,0,-1067,799,0,0,,1866,-268
25,06/18/2017,7,1:30,1:45,,24.58,0,24.58,24.58,-1,-38274,67603,105877,29329,0,-10592,0,0,0,,10592,-10592
25,06/18/2017,8,1:45,2:00,,4.63,0,4.63,4.63,-1,-35858,81245,117103,45387,0,-33379,0,0,0,,33379,-33379
25,06/18/2017,9,2:00,2:15,,0.77,0,0.77,0.77,-1,-39964,180638,220602,140674,0,-59872,0,0,0,,59872,-59872
25,06/18/2017,10,2:15,2:30,,-23.72,0,-23.72,-23.72,-1,-38539,173593,212132,135054,0,-57516,0,0,0,,57516,-57516
25,06/18/2017,11,2:30,2:45,,-23.72,0,-23.72,-23.72,-1,-39224,155940,195164,116716,0,-80314,0,0,0,,80314,-80314
25,06/18/2017,12,2:45,3:00,,-20.05,0,-20.05,-20.05,-1,-47389,142838,190227,95449,0,-86912,0,0,0,,86912,-86912
25,06/18/2017,13,3:00,3:15,32.93,-20.05,0,32.93,32.93,1,-58032,85422,143454,27390,0,-39810,3,0,0,,39813,-39807
25,06/18/2017,14,3:15,3:30,,,0,27.98,27.98,0,-47086,73341,120427,26255,0,0,0,0,0,,0,0
25,06/18/2017,15,3:30,3:45,,,0,27.98,27.98,0,-39671,82434,122105,42763,0,0,0,0,0,,0,0
25,06/18/2017,16,3:45,4:00,,-27.35,0,-27.35,-27.35,-1,-33226,89490,122716,56264,0,-12932,0,0,0,,12932,-12932
25,06/18/2017,17,4:00,4:15,114.27,23.93,0,114.27,114.27,1,-84090,37839,121929,-46251,0,-9553,5890,0,0,,15443,-3663
25,06/18/2017,18,4:15,4:30,114.27,,0,114.27,114.27,1,-116464,40135,156599,-76329,0,0,59233,0,0,,59233,59233
25,06/18/2017,19,4:30,4:45,31.27,,0,31.27,31.27,1,-97994,57756,155750,-40238,0,0,13940,0,0,,13940,13940
25,06/18/2017,20,4:45,5:00,28.93,26.98,0,28.93,26.98,2,-85743,56287,142030,-29456,0,-139,5056,0,0,,5195,4917
25,06/18/2017,21,5:00,5:15,28.93,24.93,0,24.93,24.93,-1,-34679,69265,103944,34586,0,-1643,394,0,0,,2037,-1249
25,06/18/2017,22,5:15,5:30,,23.93,0,23.93,23.93,-1,-35838,61040,96878,25202,0,-1099,0,0,0,,1099,-1099
25,06/18/2017,23,5:30,5:45,,23.93,0,23.93,23.93,-1,-32647,80686,113333,48039,0,-10539,0,0,0,,10539,-10539
25,06/18/2017,24,5:45,6:00,,15.3,0,15.3,15.3,-1,-35441,103154,138595,67713,0,-21918,0,0,0,,21918,-21918
25,06/18/2017,25,6:00,6:15,,24.92,0,24.92,24.92,-1,-35488,60340,95828,24852,0,-12664,0,0,0,,12664,-12664
25,06/18/2017,26,6:15,6:30,,26.41,0,26.41,26.41,-1,-33137,70604,103741,37467,0,-2584,0,0,0,,2584,-2584
25,06/18/2017,27,6:30,6:45,,22.96,0,22.96,22.96,-1,-32312,70837,103149,38525,0,-10687,0,0,0,,10687,-10687
25,06/18/2017,28,6:45,7:00,,22.01,0,22.01,22.01,-1,-26379,75337,101716,48958,0,-17523,0,0,0,,17523,-17523
25,06/18/2017,29,7:00,7:15,,-27.35,0,-27.35,-27.35,-1,-35736,68190,103926,32454,0,-16157,0,0,0,,16157,-16157
25,06/18/2017,30,7:15,7:30,,20.72,0,20.72,20.72,-1,-34829,85651,120480,50822,0,-34387,0,0,0,,34387,-34387
25,06/18/2017,31,7:30,7:45,,,0,28.26,28.26,0,-39042,76674,115716,37632,0,-3699,0,0,0,,3699,-3699
25,06/18/2017,32,7:45,8:00,,,0,28.26,28.26,0,-40227,81274,121501,41047,0,0,0,0,0,,0,0
25,06/18/2017,33,8:00,8:15,,,0,27.93,27.93,0,-48145,122556,170701,74411,0,0,0,0,0,,0,0
25,06/18/2017,34,8:15,8:30,,,0,27.93,27.93,0,-40843,90474,131317,49631,0,0,0,0,0,,0,0
25,06/18/2017,35,8:30,8:45,,,0,27.93,27.93,0,-53930,87366,141296,33436,0,0,0,0,0,,0,0
25,06/18/2017,36,8:45,9:00,,,0,27.93,27.93,0,-68936,94128,163064,25192,0,0,0,0,0,,0,0
25,06/18/2017,37,9:00,9:15,,20.72,0,20.72,20.72,-1,-45889,155317,201206,109428,0,-7535,0,0,0,,7535,-7535
25,06/18/2017,38,9:15,9:30,,23.88,0,23.88,23.88,-1,-39436,136347,175783,96911,0,-18949,0,0,0,,18949,-18949
25,06/18/2017,39,9:30,9:45,,23.88,0,23.88,23.88,-1,-35860,124770,160630,88910,0,-15970,0,0,0,,15970,-15970
25,06/18/2017,40,9:45,10:00,,25.64,0,25.64,25.64,-1,-42328,117686,160014,75358,0,-13536,0,0,0,,13536,-13536
25,06/18/2017,41,10:00,10:15,,-7.87,0,-7.87,-7.87,-1,-26647,133288,159935,106641,0,-24113,0,0,0,,24113,-24113
25,06/18/2017,42,10:15,10:30,,24.05,0,24.05,24.05,-1,-30279,116090,146369,85811,0,-21144,0,0,0,,21144,-21144
25,06/18/2017,43,10:30,10:45,,23.06,0,23.06,23.06,-1,-30683,126199,156882,95516,0,-18371,0,0,0,,18371,-18371
25,06/18/2017,44,10:45,11:00,,15.5,0,15.5,15.5,-1,-30668,122268,152936,91600,0,-28514,0,0,0,,28514,-28514
25,06/18/2017,45,11:00,11:15,,10.58,0,10.58,10.58,-1,-47931,130419,178350,82488,0,-31058,0,0,0,,31058,-31058
25,06/18/2017,46,11:15,11:30,,-150.72,0,-150.72,-150.72,-1,-53059,114612,167671,61553,0,-39901,0,0,0,,39901,-39901
25,06/18/2017,47,11:30,11:45,,23.2,0,23.2,23.2,-1,-58527,96245,154772,37718,0,-31879,0,0,0,,31879,-31879
25,06/18/2017,48,11:45,12:00,,16.8,0,16.8,16.8,-1,-59647,92568,152215,32921,0,-38961,0,0,0,,38961,-38961
25,06/18/2017,49,12:00,12:15,,23.78,0,23.78,23.78,-1,-63773,97883,161656,34110,0,-27959,0,0,0,,27959,-27959
25,06/18/2017,50,12:15,12:30,,14.78,0,14.78,14.78,-1,-72838,122247,195085,49409,0,-35033,0,0,0,,35033,-35033
25,06/18/2017,51,12:30,12:45,,23.13,0,23.13,23.13,-1,-69230,118476,187706,49246,0,-23661,0,0,0,,23661,-23661
25,06/18/2017,52,12:45,13:00,,23.88,0,23.88,23.88,-1,-70173,114464,184637,44291,0,-1957,0,0,0,,1957,-1957
25,06/18/2017,53,13:00,13:15,,27.37,0,27.37,27.37,-1,-60881,115570,176451,54689,0,-1797,0,0,0,,1797,-1797
25,06/18/2017,54,13:15,13:30,,4.78,0,4.78,4.78,-1,-58782,106962,165744,48180,0,-4398,0,0,0,,4398,-4398
25,06/18/2017,55,13:30,13:45,,-150.78,0,-150.78,-150.78,-1,-66859,104654,171513,37795,0,-39825,0,0,0,,39825,-39825
25,06/18/2017,56,13:45,14:00,,23.22,0,23.22,23.22,-1,-66144,102708,168852,36564,0,-39506,0,0,0,,39506,-39506
25,06/18/2017,57,14:00,14:15,,23.78,0,23.78,23.78,-1,-65671,81345,147016,15674,0,-25079,0,0,0,,25079,-25079
25,06/18/2017,58,14:15,14:30,,,0,27.5,27.5,0,-73082,99757,172839,26675,0,-304,0,0,0,,304,-304
25,06/18/2017,59,14:30,14:45,,23.88,0,23.88,23.88,-1,-78576,132172,210748,53596,0,-656,0,0,0,,656,-656
25,06/18/2017,60,14:45,15:00,,14.78,0,14.78,14.78,-1,-81017,126618,207635,45601,0,-21538,0,0,0,,21538,-21538
25,06/18/2017,61,15:00,15:15,28.88,14.78,0,28.88,28.88,1,-93315,94673,187988,1358,0,-5466,403,0,0,,5869,-5063
25,06/18/2017,62,15:15,15:30,,,0,27.5,27.5,0,-80881,105675,186556,24794,0,0,0,0,0,,0,0
25,06/18/2017,63,15:30,15:45,,,0,27.5,27.5,0,-68522,89050,157572,20528,0,0,0,0,0,,0,0
25,06/18/2017,64,15:45,16:00,,26.89,0,26.89,26.89,-1,-65355,79640,144995,14285,0,-564,0,0,0,,564,-564
25,06/18/2017,65,16:00,16:15,,28.88,0,28.88,28.88,-1,-55516,94499,150015,38983,0,-67,0,0,0,,67,-67
25,06/18/2017,66,16:15,16:30,,28.88,0,28.88,28.88,-1,-35997,105218,141215,69221,0,-260,0,0,0,,260,-260
25,06/18/2017,67,16:30,16:45,,28.1,0,28.1,28.1,-1,-41761,115614,157375,73853,0,-1570,0,0,0,,1570,-1570
25,06/18/2017,68,16:45,17:00,,,0,27.5,27.5,0,-51711,94058,145769,42347,0,0,0,0,0,,0,0
25,06/18/2017,69,17:00,17:15,,27.88,0,27.88,27.88,-1,-86238,145235,231473,58997,0,-990,0,0,0,,990,-990
25,06/18/2017,70,17:15,17:30,,26.25,0,26.25,26.25,-1,-45372,129107,174479,83735,0,-6624,0,0,0,,6624,-6624
25,06/18/2017,71,17:30,17:45,,26.25,0,26.25,26.25,-1,-36730,118429,155159,81699,0,-4663,0,0,0,,4663,-4663
25,06/18/2017,72,17:45,18:00,,27.88,0,27.88,27.88,-1,-31702,102908,134610,71206,0,-4061,0,0,0,,4061,-4061
25,06/18/2017,73,18:00,18:15,28.04,27.88,0,28.04,28.04,1,-98753,81614,180367,-17139,0,-208,658,0,0,,866,450
25,06/18/2017,74,18:15,18:30,,27.37,0,27.37,27.37,-1,-13583,97184,110767,83601,0,-689,0,0,0,,689,-689
25,06/18/2017,75,18:30,18:45,,,0,28.02,28.02,0,-12182,98406,110588,86224,0,0,0,0,0,,0,0
25,06/18/2017,76,18:45,19:00,,,0,28.02,28.02,0,-10576,101915,112491,91339,0,0,0,0,0,,0,0
25,06/18/2017,77,19:00,19:15,,23.88,0,23.88,23.88,-1,-47723,81932,129655,34209,0,-4666,0,0,0,,4666,-4666
25,06/18/2017,78,19:15,19:30,,28.88,0,28.88,28.88,-1,-37752,83291,121043,45539,0,-1587,0,0,0,,1587,-1587
25,06/18/2017,79,19:30,19:45,,,0,28.89,28.89,0,-44621,80631,125252,36010,0,0,0,0,0,,0,0
25,06/18/2017,80,19:45,20:00,28.88,,0,28.88,28.88,1,-60851,70328,131179,9477,0,0,201,0,0,,201,201
25,06/18/2017,81,20:00,20:15,28.98,,0,28.98,28.98,1,-72320,69421,141741,-2899,0,0,2106,0,0,,2106,2106
25,06/18/2017,82,20:15,20:30,28.98,,0,28.98,28.98,1,-80712,100802,181514,20090,0,0,2039,0,0,,2039,2039
25,06/18/2017,83,20:30,20:45,28.98,,0,28.98,28.98,1,-83391,94394,177785,11003,0,0,755,0,0,,755,755
25,06/18/2017,84,20:45,21:00,29.58,,0,29.58,29.58,1,-81382,71968,153350,-9414,0,0,3331,0,0,,3331,3331
25,06/18/2017,85,21:00,21:15,28.02,,0,28.02,28.02,1,-92428,69277,161705,-23151,0,0,133,0,0,,133,133
25,06/18/2017,86,21:15,21:30,29.09,,0,29.09,29.09,1,-89804,78437,168241,-11367,0,0,966,0,0,,966,966
25,06/18/2017,87,21:30,21:45,,,0,29.3,29.3,0,-68854,78276,147130,9422,0,0,0,0,0,,0,0
25,06/18/2017,88,21:45,22:00,27.63,,0,27.63,27.63,1,-69496,84172,153668,14676,0,0,207,0,0,,207,207
25,06/18/2017,89,22:00,22:15,,,0,29.46,29.46,0,-56713,81643,138356,24930,0,0,0,0,0,,0,0
25,06/18/2017,90,22:15,22:30,,27.78,0,27.78,27.78,-1,-58695,87549,146244,28854,0,-1967,0,0,0,,1967,-1967
25,06/18/2017,91,22:30,22:45,,27.78,0,27.78,27.78,-1,-70129,99476,169605,29347,0,-2961,0,0,0,,2961,-2961
25,06/18/2017,92,22:45,23:00,,27.88,0,27.88,27.88,-1,-56546,105447,161993,48901,0,-705,0,0,0,,705,-705
25,06/18/2017,93,23:00,23:15,28.88,27.61,0,28.88,27.61,2,-118155,131965,250120,13810,0,-897,580,0,0,,1477,-317
25,06/18/2017,94,23:15,23:30,28.67,18.88,0,18.88,18.88,-1,-79133,133046,212179,53913,0,-2414,540,0,0,,2954,-1874
25,06/18/2017,95,23:30,23:45,,-6.41,0,-6.41,-6.41,-1,-59637,138699,198336,79062,0,-18266,0,0,0,,18266,-18266
25,06/18/2017,96,23:45,0:00,,-20.06,0,-20.06,-20.06,-1,-73041,126617,199658,53576,0,-52229,0,0,0,,52229,-52229
25,06/19/2017,1,0:00,0:15,227.17,-20.06,0,227.17,227.17,1,-108768,32364,141132,-76404,0,-17294,10033,0,0,,27327,-7261
25,06/19/2017,2,0:15,0:30,227.17,18.45,0,227.17,18.45,2,-70735,70097,140832,-638,0,-1482,18404,0,0,,19886,16922
25,06/19/2017,3,0:30,0:45,227.17,-39.76,0,-39.76,-39.76,-1,-63679,135245,198924,71566,0,-42198,55,0,0,,42253,-42143
25,06/19/2017,4,0:45,1:00,,-19.08,0,-19.08,-19.08,-1,-88597,167507,256104,78910,0,-79202,0,0,0,,79202,-79202
25,06/19/2017,5,1:00,1:15,,27.68,0,27.68,27.68,-1,-72557,87462,160019,14905,0,-24495,0,0,0,,24495,-24495
25,06/19/2017,6,1:15,1:30,,24.62,0,24.62,24.62,-1,-50899,90978,141877,40079,0,-1870,0,0,0,,1870,-1870
25,06/19/2017,7,1:30,1:45,,27.24,0,27.24,27.24,-1,-46933,84099,131032,37166,0,-887,0,0,0,,887,-887
25,06/19/2017,8,1:45,2:00,,14.38,0,14.38,14.38,-1,-47758,87868,135626,40110,0,-20445,0,0,0,,20445,-20445
25,06/19/2017,9,2:00,2:15,99.63,25.62,0,99.63,99.63,1,-63405,30306,93711,-33099,0,-8101,8306,0,0,,16407,205
25,06/19/2017,10,2:15,2:30,31.62,,0,31.62,31.62,1,-41036,35509,76545,-5527,0,0,14826,0,0,,14826,14826
25,06/19/2017,11,2:30,2:45,,,0,35.56,35.56,0,-48190,45751,93941,-2439,0,0,498,0,0,,498,498
25,06/19/2017,12,2:45,3:00,,26.11,0,26.11,26.11,-1,-43613,33119,76732,-10494,0,-373,0,0,0,,373,-373
25,06/19/2017,13,3:00,3:15,,26.24,0,26.24,26.24,-1,-61634,101888,163522,40254,0,-413,0,0,0,,413,-413
25,06/19/2017,14,3:15,3:30,,,0,35.54,35.54,0,-38808,88439,127247,49631,0,0,0,0,0,,0,0
25,06/19/2017,15,3:30,3:45,,,0,35.54,35.54,0,-37436,76689,114125,39253,0,0,0,0,0,,0,0
25,06/19/2017,16,3:45,4:00,,45.46,0,45.46,45.46,-1,-32084,77360,109444,45276,0,-75,0,0,0,,75,-75
25,06/19/2017,17,4:00,4:15,28.67,,0,28.67,28.67,1,-72084,37245,109329,-34839,0,0,1736,0,0,,1736,1736
25,06/19/2017,18,4:15,4:30,25.62,,0,25.62,25.62,1,-48349,45957,94306,-2392,0,0,437,0,0,,437,437
25,06/19/2017,19,4:30,4:45,25.62,,0,25.62,25.62,1,-38742,55878,94620,17136,0,0,114,0,0,,114,114
25,06/19/2017,20,4:45,5:00,25.62,,0,25.62,25.62,1,-27631,79754,107385,52123,0,0,20,0,0,,20,20
25,06/19/2017,21,5:00,5:15,27.62,45.02,0,35.52,35.52,2,-98580,52908,151488,-45672,0,-39,999,0,0,,1038,960
25,06/19/2017,22,5:15,5:30,,26.42,0,26.42,26.42,-1,-41194,59969,101163,18775,0,-4176,0,0,0,,4176,-4176
25,06/19/2017,23,5:30,5:45,,26.57,0,26.57,26.57,-1,-45689,58393,104082,12704,0,-5185,0,0,0,,5185,-5185
25,06/19/2017,24,5:45,6:00,27.2,26.57,0,27.2,27.2,1,-60070,57036,117106,-3034,0,-138,246,0,0,,384,108
25,06/19/2017,25,6:00,6:15,28.04,,0,28.04,28.04,1,-134165,44362,178527,-89803,0,0,2190,0,0,,2190,2190
25,06/19/2017,26,6:15,6:30,30.75,,0,30.75,30.75,1,-126059,65286,191345,-60773,0,0,1211,0,0,,1211,1211
25,06/19/2017,27,6:30,6:45,33.91,,0,33.91,33.91,1,-138354,64605,202959,-73749,0,0,9905,0,0,,9905,9905
25,06/19/2017,28,6:45,7:00,248.82,,0,248.82,248.82,1,-156475,64466,220941,-92009,0,0,27004,0,0,,27004,27004
25,06/19/2017,29,7:00,7:15,248.82,4.9,0,4.9,4.9,-1,-49389,91678,141067,42289,0,-7869,12202,0,0,,20071,4333
25,06/19/2017,30,7:15,7:30,28.02,26.67,0,28.02,28.02,1,-79582,84736,164318,5154,0,-5643,295,0,0,,5938,-5348
25,06/19/2017,31,7:30,7:45,28.67,,0,28.67,28.67,1,-86400,73731,160131,-12669,0,0,5115,0,0,,5115,5115
25,06/19/2017,32,7:45,8:00,166.63,,0,166.63,166.63,1,-114152,69597,183749,-44555,0,0,22519,0,0,,22519,22519
25,06/19/2017,33,8:00,8:15,30.02,-54.38,0,36.56,-54.38,2,-8296,151550,159846,143254,0,-19215,7443,0,0,,26658,-11772
25,06/19/2017,34,8:15,8:30,,32.46,0,32.46,32.46,-1,-40163,123720,163883,83557,0,-1503,0,0,0,,1503,-1503
25,06/19/2017,35,8:30,8:45,,,0,36.56,36.56,0,-53572,113841,167413,60269,0,0,0,0,0,,0,0
25,06/19/2017,36,8:45,9:00,,45.48,0,45.48,45.48,-1,-76008,93546,169554,17538,0,-2,0,0,0,,2,-2
25,06/19/2017,37,9:00,9:15,,24.35,0,24.35,24.35,-1,-40741,103693,144434,62952,0,-6946,0,0,0,,6946,-6946
25,06/19/2017,38,9:15,9:30,,30.08,0,30.08,30.08,-1,-47948,104035,151983,56087,0,-3408,0,0,0,,3408,-3408
25,06/19/2017,39,9:30,9:45,,30.13,0,30.13,30.13,-1,-46887,122749,169636,75862,0,-366,0,0,0,,366,-366
25,06/19/2017,40,9:45,10:00,,,0,45.62,45.62,0,-49693,117935,167628,68242,0,0,0,0,0,,0,0
25,06/19/2017,41,10:00,10:15,28.24,46.78,0,45.59,45.59,2,-51655,50891,102546,-764,0,-132,943,0,0,,1075,811
25,06/19/2017,42,10:15,10:30,28.24,,0,28.24,28.24,1,-52749,50853,103602,-1896,0,0,2801,0,0,,2801,2801
25,06/19/2017,43,10:30,10:45,28.24,,0,28.24,28.24,1,-49609,51918,101527,2309,0,0,7345,0,0,,7345,7345
25,06/19/2017,44,10:45,11:00,,,0,37.16,37.16,0,-59788,61238,121026,1450,0,0,1590,0,0,,1590,1590
25,06/19/2017,45,11:00,11:15,,,0,37.28,37.28,0,-36904,100210,137114,63306,0,0,0,0,0,,0,0
25,06/19/2017,46,11:15,11:30,,,0,37.28,37.28,0,-70540,100443,170983,29903,0,0,0,0,0,,0,0
25,06/19/2017,47,11:30,11:45,,,0,37.23,37.23,0,-65263,85542,150805,20279,0,0,0,0,0,,0,0
25,06/19/2017,48,11:45,12:00,,,0,37.23,37.23,0,-59526,78762,138288,19236,0,0,0,0,0,,0,0
25,06/19/2017,49,12:00,12:15,,,0,36.46,36.46,0,-88207,128577,216784,40370,0,0,0,0,0,,0,0
25,06/19/2017,50,12:15,12:30,,24.79,0,24.79,24.79,-1,-84237,138916,223153,54679,0,-7652,0,0,0,,7652,-7652
25,06/19/2017,51,12:30,12:45,,24.87,0,24.87,24.87,-1,-69846,136121,205967,66275,0,-10727,0,0,0,,10727,-10727
25,06/19/2017,52,12:45,13:00,,24.87,0,24.87,24.87,-1,-54998,139165,194163,84167,0,-9590,0,0,0,,9590,-9590
25,06/19/2017,53,13:00,13:15,,24.87,0,24.87,24.87,-1,-18915,131287,150202,112372,0,-7103,0,0,0,,7103,-7103
25,06/19/2017,54,13:15,13:30,,20.87,0,20.87,20.87,-1,-20821,134920,155741,114099,0,-2144,0,0,0,,2144,-2144
25,06/19/2017,55,13:30,13:45,,16.57,0,16.57,16.57,-1,-17739,114644,132383,96905,0,-11380,0,0,0,,11380,-11380
25,06/19/2017,56,13:45,14:00,,15.87,0,15.87,15.87,-1,-24787,98200,122987,73413,0,-13231,0,0,0,,13231,-13231
25,06/19/2017,57,14:00,14:15,,15.87,0,15.87,15.87,-1,-67144,119974,187118,52830,0,-21272,0,0,0,,21272,-21272
25,06/19/2017,58,14:15,14:30,,29.96,0,29.96,29.96,-1,-65281,123379,188660,58098,0,-9148,0,0,0,,9148,-9148
25,06/19/2017,59,14:30,14:45,,47.03,0,47.03,47.03,-1,-53651,121210,174861,67559,0,-1720,0,0,0,,1720,-1720
25,06/19/2017,60,14:45,15:00,,24.87,0,24.87,24.87,-1,-37834,132939,170773,95105,0,-1812,0,0,0,,1812,-1812
25,06/19/2017,61,15:00,15:15,,20.87,0,20.87,20.87,-1,-32171,153731,185902,121560,0,-3773,0,0,0,,3773,-3773
25,06/19/2017,62,15:15,15:30,,48.39,0,48.39,48.39,-1,-29900,151932,181832,122032,0,-172,0,0,0,,172,-172
25,06/19/2017,63,15:30,15:45,,-22.03,0,-22.03,-22.03,-1,-52287,142983,195270,90696,-12500,-63,0,0,0,,12563,-12563
25,06/19/2017,64,15:45,16:00,28.33,-22.03,0,28.33,28.33,1,-68398,91025,159423,22627,-12500,0,213,0,0,,12713,-12287
25,06/19/2017,65,16:00,16:15,29.51,,0,29.51,29.51,1,-74261,43316,117577,-30945,0,0,5723,0,0,,5723,5723
25,06/19/2017,66,16:15,16:30,28.67,,0,28.67,28.67,1,-66273,38317,104590,-27956,0,0,8079,0,0,,8079,8079
25,06/19/2017,67,16:30,16:45,28.02,,0,28.02,28.02,1,-47130,43180,90310,-3950,0,0,6622,0,0,,6622,6622
25,06/19/2017,68,16:45,17:00,28.67,,0,28.67,28.67,1,-50692,42211,92903,-8481,0,0,5212,0,0,,5212,5212
25,06/19/2017,69,17:00,17:15,28.02,,0,28.02,28.02,1,-82502,60089,142591,-22413,0,0,2713,0,0,,2713,2713
25,06/19/2017,70,17:15,17:30,29.58,,0,29.58,29.58,1,-74569,62135,136704,-12434,0,0,4029,0,0,,4029,4029
25,06/19/2017,71,17:30,17:45,32.1,,0,32.1,32.1,1,-81997,67054,149051,-14943,0,0,5496,0,0,,5496,5496
25,06/19/2017,72,17:45,18:00,37.05,,0,37.05,37.05,1,-83627,78274,161901,-5353,0,0,12774,0,0,,12774,12774
25,06/19/2017,73,18:00,18:15,35.6,,0,35.6,35.6,1,-111800,66606,178406,-45194,0,0,13118,0,0,,13118,13118
25,06/19/2017,74,18:15,18:30,30.75,,0,30.75,30.75,1,-85193,68755,153948,-16438,0,0,6166,0,0,,6166,6166
25,06/19/2017,75,18:30,18:45,28.02,,0,28.02,28.02,1,-66528,59945,126473,-6583,0,0,4999,0,0,,4999,4999
25,06/19/2017,76,18:45,19:00,35.6,,0,35.6,35.6,1,-57621,63046,120667,5425,0,0,852,0,0,,852,852
25,06/19/2017,77,19:00,19:15,270.86,,0,270.86,270.86,1,-117594,33050,150644,-84544,0,0,32507,0,0,,32507,32507
25,06/19/2017,78,19:15,19:30,52.02,48.33,0,48.33,48.33,-1,-74937,80840,155777,5903,0,-32,24465,0,0,,24497,24433
25,06/19/2017,79,19:30,19:45,52.02,29.89,0,29.89,29.89,-1,-83763,110300,194063,26537,0,-2034,194,0,0,,2228,-1840
25,06/19/2017,80,19:45,20:00,,48.33,0,48.33,48.33,-1,-80056,90116,170172,10060,0,-350,0,0,0,,350,-350
25,06/19/2017,81,20:00,20:15,40.4,,0,40.4,40.4,1,-121143,87679,208822,-33464,0,0,8472,0,0,,8472,8472
25,06/19/2017,82,20:15,20:30,35.4,,0,35.4,35.4,1,-108018,77874,185892,-30144,0,0,6365,0,0,,6365,6365
25,06/19/2017,83,20:30,20:45,35.4,,0,35.4,35.4,1,-102976,74697,177673,-28279,0,0,12967,0,0,,12967,12967
25,06/19/2017,84,20:45,21:00,29.58,,0,29.58,29.58,1,-104026,74252,178278,-29774,0,0,6059,0,0,,6059,6059
25,06/19/2017,85,21:00,21:15,277.37,,0,277.37,277.37,1,-150141,71334,221475,-78807,0,0,37929,0,0,,37929,37929
25,06/19/2017,86,21:15,21:30,63.99,30.99,0,30.99,30.99,-1,-103945,109068,213013,5123,0,-55,27419,0,0,,27474,27364
25,06/19/2017,87,21:30,21:45,63.99,30.88,0,30.88,30.88,-1,-83589,114827,198416,31238,0,-1797,11,0,0,,1808,-1786
25,06/19/2017,88,21:45,22:00,,,0,37.31,37.31,0,-82636,109602,192238,26966,0,-108,0,0,0,,108,-108
25,06/19/2017,89,22:00,22:15,30.75,,0,30.75,30.75,1,-96777,85996,182773,-10781,0,0,939,0,0,,939,939
25,06/19/2017,90,22:15,22:30,33.68,,0,33.68,33.68,1,-99119,50326,149445,-48793,0,0,10445,0,0,,10445,10445
25,06/19/2017,91,22:30,22:45,275.17,,0,275.17,275.17,1,-111839,41669,153508,-70170,0,0,26353,0,0,,26353,26353
25,06/19/2017,92,22:45,23:00,71.74,,0,71.74,71.74,1,-91937,56320,148257,-35617,0,0,39006,0,0,,39006,39006
25,06/19/2017,93,23:00,23:15,240.79,,0,240.79,240.79,1,-138598,56586,195184,-82012,0,0,26546,0,0,,26546,26546
25,06/19/2017,94,23:15,23:30,62.77,,0,62.77,62.77,1,-118653,62293,180946,-56360,0,0,30722,0,0,,30722,30722
25,06/19/2017,95,23:30,23:45,36.67,,0,36.67,36.67,1,-102907,76179,179086,-26728,0,0,7259,0,0,,7259,7259
25,06/19/2017,96,23:45,0:00,27.87,29.72,0,29.72,29.72,-1,-109605,104584,214189,-5021,0,-302,3860,0,0,,4162,3558
25,06/20/2017,1,0:00,0:15,219.87,26.79,0,219.87,26.79,2,-121125,23436,144561,-97689,0,-312,20592,0,0,,20904,20280
25,06/20/2017,2,0:15,0:30,40.19,,0,40.19,40.19,1,-128639,54211,182850,-74428,0,0,37290,0,0,,37290,37290
25,06/20/2017,3,0:30,0:45,31.87,,0,31.87,31.87,1,-124285,79489,203774,-44796,0,0,22960,0,0,,22960,22960
25,06/20/2017,4,0:45,1:00,,,0,36.3,36.3,0,-144075,107929,252004,-36146,0,0,3049,0,0,,3049,3049
25,06/20/2017,5,1:00,1:15,218.45,,0,218.45,218.45,1,-105057,55320,160377,-49737,0,0,9798,0,0,,9798,9798
25,06/20/2017,6,1:15,1:30,218.45,,0,218.45,218.45,1,-101675,44080,145755,-57595,0,0,51235,0,0,,51235,51235
25,06/20/2017,7,1:30,1:45,31.16,,0,31.16,31.16,1,-87471,66216,153687,-21255,0,0,15941,0,0,,15941,15941
25,06/20/2017,8,1:45,2:00,28.43,,0,28.43,28.43,1,-86559,77061,163620,-9498,0,0,4633,0,0,,4633,4633
25,06/20/2017,9,2:00,2:15,27.87,,0,27.87,27.87,1,-55346,62333,117679,6987,0,0,415,0,0,,415,415
25,06/20/2017,10,2:15,2:30,28.04,,0,28.04,28.04,1,-69170,48922,118092,-20248,0,0,4719,0,0,,4719,4719
25,06/20/2017,11,2:30,2:45,29.99,,0,29.99,29.99,1,-72283,47077,119360,-25206,0,0,7464,0,0,,7464,7464
25,06/20/2017,12,2:45,3:00,28.43,,0,28.43,28.43,1,-75827,46257,122084,-29570,0,0,10360,0,0,,10360,10360
25,06/20/2017,13,3:00,3:15,42.49,,0,42.49,42.49,1,-87171,45113,132284,-42058,0,0,20513,0,0,,20513,20513
25,06/20/2017,14,3:15,3:30,37.87,,0,37.87,37.87,1,-84441,41051,125492,-43390,0,0,30447,0,0,,30447,30447
25,06/20/2017,15,3:30,3:45,29.08,,0,29.08,29.08,1,-74081,47705,121786,-26376,0,0,17415,0,0,,17415,17415
25,06/20/2017,16,3:45,4:00,27.87,26.79,0,26.79,26.79,-1,-65259,60851,126110,-4408,0,-399,5476,0,0,,5875,5077
25,06/20/2017,17,4:00,4:15,25.87,26.79,0,25.87,25.87,1,-65324,52980,118304,-12344,0,-286,265,0,0,,551,-21
25,06/20/2017,18,4:15,4:30,25.87,31.89,0,35.68,31.89,2,-66227,65631,131858,-596,0,-109,511,0,0,,620,402
25,06/20/2017,19,4:30,4:45,,26.79,0,26.79,26.79,-1,-71077,102817,173894,31740,0,-3551,0,0,0,,3551,-3551
25,06/20/2017,20,4:45,5:00,,26.79,0,26.79,26.79,-1,-66298,115913,182211,49615,0,-5557,0,0,0,,5557,-5557
25,06/20/2017,21,5:00,5:15,,28.78,0,28.78,28.78,-1,-67973,100050,168023,32077,0,-3999,0,0,0,,3999,-3999
25,06/20/2017,22,5:15,5:30,,25.87,0,25.87,25.87,-1,-64880,90915,155795,26035,0,-686,0,0,0,,686,-686
25,06/20/2017,23,5:30,5:45,,25.87,0,25.87,25.87,-1,-65751,85260,151011,19509,0,-5666,0,0,0,,5666,-5666
25,06/20/2017,24,5:45,6:00,,26.6,0,26.6,26.6,-1,-74013,85514,159527,11501,0,-7824,0,0,0,,7824,-7824
25,06/20/2017,25,6:00,6:15,,5.29,0,5.29,5.29,-1,-61129,124493,185622,63364,0,-26825,0,0,0,,26825,-26825
25,06/20/2017,26,6:15,6:30,,26.79,0,26.79,26.79,-1,-73091,84302,157393,11211,0,-8684,0,0,0,,8684,-8684
25,06/20/2017,27,6:30,6:45,42.49,26.79,0,42.49,42.49,1,-89640,47938,137578,-41702,0,-687,4154,0,0,,4841,3467
25,06/20/2017,28,6:45,7:00,241.52,,0,241.52,241.52,1,-115229,35475,150704,-79754,0,0,43119,0,0,,43119,43119
25,06/20/2017,29,7:00,7:15,241.52,-53.99,0,-53.99,-53.99,-1,-40185,158491,198676,118306,0,-10385,12234,0,0,,22619,1849
25,06/20/2017,30,7:15,7:30,,26.79,0,26.79,26.79,-1,-68520,127801,196321,59281,0,-3515,0,0,0,,3515,-3515
25,06/20/2017,31,7:30,7:45,31.16,26.79,0,31.16,31.16,1,-93484,89349,182833,-4135,0,-692,474,0,0,,1166,-218
25,06/20/2017,32,7:45,8:00,59.12,,0,59.12,59.12,1,-125817,81189,207006,-44628,0,0,20299,0,0,,20299,20299
25,06/20/2017,33,8:00,8:15,29.08,31.89,0,31.89,31.89,-1,-45351,93361,138712,48010,0,-595,8403,0,0,,8998,7808
25,06/20/2017,34,8:15,8:30,,,0,36.75,36.75,0,-74688,89682,164370,14994,0,-33,0,0,0,,33,-33
25,06/20/2017,35,8:30,8:45,34.02,,0,34.02,34.02,1,-97664,87186,184850,-10478,0,0,1965,0,0,,1965,1965
25,06/20/2017,36,8:45,9:00,50.02,,0,50.02,50.02,1,-108060,84726,192786,-23334,0,0,13478,0,0,,13478,13478
25,06/20/2017,37,9:00,9:15,268.41,,0,268.41,268.41,1,-76248,64400,140648,-11848,0,0,32712,0,0,,32712,32712
25,06/20/2017,38,9:15,9:30,28.43,26.79,0,37.34,26.79,2,-56038,75082,131120,19044,0,-672,8513,0,0,,9185,7841
25,06/20/2017,39,9:30,9:45,,,0,37.34,37.34,0,-70459,84062,154521,13603,0,0,0,0,0,,0,0
25,06/20/2017,40,9:45,10:00,,,0,37.34,37.34,0,-76524,83179,159703,6655,0,0,0,0,0,,0,0
25,06/20/2017,41,10:00,10:15,29.66,,0,29.66,29.66,1,-71182,72220,143402,1038,0,0,1687,0,0,,1687,1687
25,06/20/2017,42,10:15,10:30,45.66,,0,45.66,45.66,1,-81500,63689,145189,-17811,0,0,5919,0,0,,5919,5919
25,06/20/2017,43,10:30,10:45,53.51,,0,53.51,53.51,1,-91291,67712,159003,-23579,0,0,25191,0,0,,25191,25191
25,06/20/2017,44,10:45,11:00,45.66,,0,45.66,45.66,1,-98893,69852,168745,-29041,0,0,11434,0,0,,11434,11434
25,06/20/2017,45,11:00,11:15,274.39,,0,274.39,274.39,1,-252370,84294,336664,-168076,0,0,58859,0,0,,58859,58859
25,06/20/2017,46,11:15,11:30,274.39,,0,274.39,274.39,1,-183495,112417,295912,-71078,0,0,76491,0,0,,76491,76491
25,06/20/2017,47,11:30,11:45,116.63,,0,116.63,116.63,1,-170687,106912,277599,-63775,0,0,44165,0,0,,44165,44165
25,06/20/2017,48,11:45,12:00,49.52,,0,49.52,49.52,1,-176566,126942,303508,-49624,0,0,42447,0,0,,42447,42447
25,06/20/2017,49,12:00,12:15,49.52,25,0,25,25,-1,-75896,122279,198175,46383,0,-1263,8564,0,0,,9827,7301
25,06/20/2017,50,12:15,12:30,,26.09,0,26.09,26.09,-1,-96511,109400,205911,12889,0,-1966,0,0,0,,1966,-1966
25,06/20/2017,51,12:30,12:45,,27.39,0,27.39,27.39,-1,-103424,124843,228267,21419,0,-2341,0,0,0,,2341,-2341
25,06/20/2017,52,12:45,13:00,,47.03,0,47.03,47.03,-1,-106870,116750,223620,9880,0,-161,0,0,0,,161,-161
25,06/20/2017,53,13:00,13:15,,,0,36.53,36.53,0,-90636,72942,163578,-17694,0,0,0,0,0,,0,0
25,06/20/2017,54,13:15,13:30,,,0,36.53,36.53,0,-103849,66871,170720,-36978,0,0,0,0,0,,0,0
25,06/20/2017,55,13:30,13:45,,,0,36.53,36.53,0,-120407,68990,189397,-51417,0,0,0,0,0,,0,0
25,06/20/2017,56,13:45,14:00,26,,0,26,26,1,-132928,69687,202615,-63241,0,0,2,0,0,,2,2
25,06/20/2017,57,14:00,14:15,192.19,,0,192.19,192.19,1,-131763,47239,179002,-84524,0,0,23327,0,0,,23327,23327
25,06/20/2017,58,14:15,14:30,36.09,,0,36.09,36.09,1,-110761,66722,177483,-44039,0,0,18244,0,0,,18244,18244
25,06/20/2017,59,14:30,14:45,29.99,,0,29.99,29.99,1,-109857,75830,185687,-34027,0,0,7812,0,0,,7812,7812
25,06/20/2017,60,14:45,15:00,28,,0,28,28,1,-111212,83582,194794,-27630,0,0,3361,0,0,,3361,3361
25,06/20/2017,61,15:00,15:15,117.93,,0,117.93,117.93,1,-131380,82435,213815,-48945,0,0,16052,0,0,,16052,16052
25,06/20/2017,62,15:15,15:30,32,,0,32,32,1,-112541,97874,210415,-14667,0,0,17056,0,0,,17056,17056
25,06/20/2017,63,15:30,15:45,42.49,,0,42.49,42.49,1,-117985,77828,195813,-40157,0,0,27295,0,0,,27295,27295
25,06/20/2017,64,15:45,16:00,104.51,,0,104.51,104.51,1,-125387,70799,196186,-54588,0,0,44606,0,0,,44606,44606
25,06/20/2017,65,16:00,16:15,44.49,,0,44.49,44.49,1,-110343,85861,196204,-24482,0,0,33762,0,0,,33762,33762
25,06/20/2017,66,16:15,16:30,31.16,,0,31.16,31.16,1,-122238,97087,219325,-25151,0,0,13309,0,0,,13309,13309
25,06/20/2017,67,16:30,16:45,38,,0,38,38,1,-124679,94738,219417,-29941,0,0,20675,0,0,,20675,20675
25,06/20/2017,68,16:45,17:00,38,,0,38,38,1,-131470,93144,224614,-38326,0,0,28021,0,0,,28021,28021
25,06/20/2017,69,17:00,17:15,43.34,,0,43.34,43.34,1,-139418,83666,223084,-55752,0,0,34556,0,0,,34556,34556
25,06/20/2017,70,17:15,17:30,43.34,,0,43.34,43.34,1,-134182,93611,227793,-40571,0,0,35144,0,0,,35144,35144
25,06/20/2017,71,17:30,17:45,29.08,,0,29.08,29.08,1,-122859,107624,230483,-15235,0,0,17068,0,0,,17068,17068
25,06/20/2017,72,17:45,18:00,27.34,31.99,0,31.99,31.99,-1,-120682,125104,245786,4422,0,-22,4605,0,0,,4627,4583
25,06/20/2017,73,18:00,18:15,,21,0,21,21,-1,-86970,87569,174539,599,0,-5018,0,0,0,,5018,-5018
25,06/20/2017,74,18:15,18:30,,25,0,25,25,-1,-64293,93658,157951,29365,0,-15103,0,0,0,,15103,-15103
25,06/20/2017,75,18:30,18:45,,24.58,0,24.58,24.58,-1,-65670,92573,158243,26903,0,-11735,0,0,0,,11735,-11735
25,06/20/2017,76,18:45,19:00,,,0,29.79,29.79,0,-67027,102938,169965,35911,0,-2450,0,0,0,,2450,-2450
25,06/20/2017,77,19:00,19:15,34.71,,0,34.71,34.71,1,-82349,51878,134227,-30471,0,0,5405,0,0,,5405,5405
25,06/20/2017,78,19:15,19:30,29.71,,0,29.71,29.71,1,-81255,60012,141267,-21243,0,0,8942,0,0,,8942,8942
25,06/20/2017,79,19:30,19:45,29.71,,0,29.71,29.71,1,-79352,72153,151505,-7199,0,0,5469,0,0,,5469,5469
25,06/20/2017,80,19:45,20:00,29.71,,0,29.71,29.71,1,-84918,74256,159174,-10662,0,0,8073,0,0,,8073,8073
25,06/20/2017,81,20:00,20:15,34.95,,0,34.95,34.95,1,-93700,64726,158426,-28974,0,0,7199,0,0,,7199,7199
25,06/20/2017,82,20:15,20:30,34.95,,0,34.95,34.95,1,-93441,60204,153645,-33237,0,0,11581,0,0,,11581,11581
25,06/20/2017,83,20:30,20:45,34.95,,0,34.95,34.95,1,-89380,64780,154160,-24600,0,0,14857,0,0,,14857,14857
25,06/20/2017,84,20:45,21:00,29.08,27.78,0,29.79,27.78,2,-60753,71360,132113,10607,0,-172,6914,0,0,,7086,6742
25,06/20/2017,85,21:00,21:15,197.16,,0,197.16,197.16,1,-134476,49875,184351,-84601,0,0,29776,0,0,,29776,29776
25,06/20/2017,86,21:15,21:30,33.9,,0,33.9,33.9,1,-60339,55103,115442,-5236,0,0,13150,0,0,,13150,13150
25,06/20/2017,87,21:30,21:45,33.9,24.01,0,24.01,24.01,-1,-47817,63357,111174,15540,0,-6868,218,0,0,,7086,-6650
25,06/20/2017,88,21:45,22:00,,24.69,0,24.69,24.69,-1,-57874,61228,119102,3354,0,-11810,0,0,0,,11810,-11810
25,06/20/2017,89,22:00,22:15,,16.73,0,16.73,16.73,-1,-45682,89075,134757,43393,0,-20591,0,0,0,,20591,-20591
25,06/20/2017,90,22:15,22:30,,25.58,0,25.58,25.58,-1,-53185,81429,134614,28244,0,-10663,0,0,0,,10663,-10663
25,06/20/2017,91,22:30,22:45,,24.69,0,24.69,24.69,-1,-43986,84316,128302,40330,0,-6413,0,0,0,,6413,-6413
25,06/20/2017,92,22:45,23:00,,5.29,0,5.29,5.29,-1,-39299,103030,142329,63731,0,-17042,0,0,0,,17042,-17042
25,06/20/2017,93,23:00,23:15,,5.96,0,5.96,5.96,-1,-69696,133089,202785,63393,0,-18976,0,0,0,,18976,-18976
25,06/20/2017,94,23:15,23:30,,15.58,0,15.58,15.58,-1,-50288,91072,141360,40784,0,-11613,0,0,0,,11613,-11613
25,06/20/2017,95,23:30,23:45,,15.58,0,15.58,15.58,-1,-54354,102636,156990,48282,0,-21057,0,0,0,,21057,-21057
25,06/20/2017,96,23:45,0:00,,-27.91,0,-27.91,-27.91,-1,-40400,120231,160631,79831,0,-47199,0,0,0,,47199,-47199
25,06/21/2017,1,0:00,0:15,,6.77,0,6.77,6.77,-1,-62340,49049,111389,-13291,0,-32934,0,0,0,,32934,-32934
25,06/21/2017,2,0:15,0:30,25.58,15.58,0,27.84,15.58,2,-53239,96966,150205,43727,0,-6245,27,0,0,,6272,-6218
25,06/21/2017,3,0:30,0:45,,15.58,0,15.58,15.58,-1,-48003,96096,144099,48093,0,-22857,0,0,0,,22857,-22857
25,06/21/2017,4,0:45,1:00,,25.58,0,25.58,25.58,-1,-55165,109226,164391,54061,0,-11921,0,0,0,,11921,-11921
25,06/21/2017,5,1:00,1:15,,20.58,0,20.58,20.58,-1,-61510,62345,123855,835,0,-7016,0,0,0,,7016,-7016
25,06/21/2017,6,1:15,1:30,,17.34,0,17.34,17.34,-1,-50639,78634,129273,27995,0,-8799,0,0,0,,8799,-8799
25,06/21/2017,7,1:30,1:45,,17.34,0,17.34,17.34,-1,-50495,92502,142997,42007,0,-32345,0,0,0,,32345,-32345
25,06/21/2017,8,1:45,2:00,,5.9,0,5.9,5.9,-1,-45551,111174,156725,65623,0,-44359,0,0,0,,44359,-44359
25,06/21/2017,9,2:00,2:15,27.14,18.03,0,27.14,27.14,1,-52174,65432,117606,13258,0,-22803,370,0,0,,23173,-22433
25,06/21/2017,10,2:15,2:30,27.14,13.22,0,13.22,13.22,-1,-30285,72768,103053,42483,0,-4594,41,0,0,,4635,-4553
25,06/21/2017,11,2:30,2:45,,5.9,0,5.9,5.9,-1,-31722,65482,97204,33760,0,-22751,0,0,0,,22751,-22751
25,06/21/2017,12,2:45,3:00,,21,0,21,21,-1,-31951,68442,100393,36491,0,-18470,0,0,0,,18470,-18470
25,06/21/2017,13,3:00,3:15,,25.59,0,25.59,25.59,-1,-42396,61215,103611,18819,0,-10734,0,0,0,,10734,-10734
25,06/21/2017,14,3:15,3:30,,,0,28.05,28.05,0,-43231,57355,100586,14124,0,-143,0,0,0,,143,-143
25,06/21/2017,15,3:30,3:45,,27.13,0,27.13,27.13,-1,-36934,65320,102254,28386,0,-991,0,0,0,,991,-991
25,06/21/2017,16,3:45,4:00,,27.13,0,27.13,27.13,-1,-42923,64674,107597,21751,0,-2196,0,0,0,,2196,-2196
25,06/21/2017,17,4:00,4:15,,27.13,0,27.13,27.13,-1,-42745,77863,120608,35118,0,-1232,0,0,0,,1232,-1232
25,06/21/2017,18,4:15,4:30,,28.03,0,28.03,28.03,-1,-44942,81460,126402,36518,0,-1979,0,0,0,,1979,-1979
25,06/21/2017,19,4:30,4:45,,,0,28.05,28.05,0,-50132,78933,129065,28801,0,-270,0,0,0,,270,-270
25,06/21/2017,20,4:45,5:00,,,0,28.05,28.05,0,-48344,90804,139148,42460,0,0,0,0,0,,0,0
25,06/21/2017,21,5:00,5:15,,-64.03,0,-64.03,-64.03,-1,-67648,188453,256101,120805,0,-38930,0,0,0,,38930,-38930
25,06/21/2017,22,5:15,5:30,,3.54,0,3.54,3.54,-1,-50854,121455,172309,70601,0,-55573,0,0,0,,55573,-55573
25,06/21/2017,23,5:30,5:45,26,25,0,26,26,1,-56511,76397,132908,19886,0,-20790,52,0,0,,20842,-20738
25,06/21/2017,24,5:45,6:00,26.87,25,0,26.87,26.87,1,-66837,65848,132685,-989,0,-195,267,0,0,,462,72
25,06/21/2017,25,6:00,6:15,26.87,-53.38,0,-53.38,-53.38,-1,-69199,182104,251303,112905,0,-30459,58,0,0,,30517,-30401
25,06/21/2017,26,6:15,6:30,,16.27,0,16.27,16.27,-1,-66875,147377,214252,80502,0,-21179,0,0,0,,21179,-21179
25,06/21/2017,27,6:30,6:45,,26.59,0,26.59,26.59,-1,-74896,118093,192989,43197,0,-9215,0,0,0,,9215,-9215
25,06/21/2017,28,6:45,7:00,29.55,26.59,0,29.55,29.55,1,-75858,101578,177436,25720,0,-21,737,0,0,,758,716
25,06/21/2017,29,7:00,7:15,,-11.83,0,-11.83,-11.83,-1,-51402,145946,197348,94544,0,-19298,0,0,0,,19298,-19298
25,06/21/2017,30,7:15,7:30,,27.03,0,27.03,27.03,-1,-42815,107851,150666,65036,0,-2662,0,0,0,,2662,-2662
25,06/21/2017,31,7:30,7:45,,,0,28.52,28.52,0,-60550,89836,150386,29286,0,0,0,0,0,,0,0
25,06/21/2017,32,7:45,8:00,50.02,,0,50.02,50.02,1,-105529,79091,184620,-26438,0,0,15011,0,0,,15011,15011
25,06/21/2017,33,8:00,8:15,28.27,28.03,0,28.03,28.03,-1,-36958,147708,184666,110750,0,-741,4733,0,0,,5474,3992
25,06/21/2017,34,8:15,8:30,,28.42,0,28.42,28.42,-1,-41555,129186,170741,87631,0,-1111,0,0,0,,1111,-1111
25,06/21/2017,35,8:30,8:45,,30.09,0,30.09,30.09,-1,-56403,118679,175082,62276,0,-37,0,0,0,,37,-37
25,06/21/2017,36,8:45,9:00,,26.59,0,26.59,26.59,-1,-75229,124358,199587,49129,0,-605,0,0,0,,605,-605
25,06/21/2017,37,9:00,9:15,,20.24,0,20.24,20.24,-1,-27417,159377,186794,131960,0,-10345,0,0,0,,10345,-10345
25,06/21/2017,38,9:15,9:30,,25.27,0,25.27,25.27,-1,-39000,145943,184943,106943,0,-10549,0,0,0,,10549,-10549
25,06/21/2017,39,9:30,9:45,,-1.83,0,-1.83,-1.83,-1,-41442,129525,170967,88083,0,-33125,0,0,0,,33125,-33125
25,06/21/2017,40,9:45,10:00,,21.27,0,21.27,21.27,-1,-49964,109368,159332,59404,0,-31038,0,0,0,,31038,-31038
25,06/21/2017,41,10:00,10:15,,5.9,0,5.9,5.9,-1,-38136,114161,152297,76025,0,-47935,0,0,0,,47935,-47935
25,06/21/2017,42,10:15,10:30,,18.15,0,18.15,18.15,-1,-50891,100758,151649,49867,0,-42541,0,0,0,,42541,-42541
25,06/21/2017,43,10:30,10:45,,26.27,0,26.27,26.27,-1,-54786,110288,165074,55502,0,-12610,0,0,0,,12610,-12610
25,06/21/2017,44,10:45,11:00,,28.89,0,28.89,28.89,-1,-55068,106022,161090,50954,0,-461,0,0,0,,461,-461
25,06/21/2017,45,11:00,11:15,,-53.38,0,-53.38,-53.38,-1,-35777,107250,143027,71473,0,-32192,0,0,0,,32192,-32192
25,06/21/2017,46,11:15,11:30,,21.27,0,21.27,21.27,-1,-43100,85919,129019,42819,0,-34420,0,0,0,,34420,-34420
25,06/21/2017,47,11:30,11:45,,21.27,0,21.27,21.27,-1,-44040,76795,120835,32755,0,-31762,0,0,0,,31762,-31762
25,06/21/2017,48,11:45,12:00,,25.27,0,25.27,25.27,-1,-53500,92679,146179,39179,0,-22412,0,0,0,,22412,-22412
25,06/21/2017,49,12:00,12:15,,21.27,0,21.27,21.27,-1,-82266,124480,206746,42214,0,-26284,0,0,0,,26284,-26284
25,06/21/2017,50,12:15,12:30,,25.27,0,25.27,25.27,-1,-87670,121812,209482,34142,0,-26167,0,0,0,,26167,-26167
25,06/21/2017,51,12:30,12:45,,21.27,0,21.27,21.27,-1,-85664,125642,211306,39978,0,-32610,0,0,0,,32610,-32610
25,06/21/2017,52,12:45,13:00,,20.14,0,20.14,20.14,-1,-85649,110855,196504,25206,0,-38855,0,0,0,,38855,-38855
25,06/21/2017,53,13:00,13:15,,21.27,0,21.27,21.27,-1,-62126,96759,158885,34633,0,-25289,0,0,0,,25289,-25289
25,06/21/2017,54,13:15,13:30,,25.27,0,25.27,25.27,-1,-67458,91993,159451,24535,0,-23690,0,0,0,,23690,-23690
25,06/21/2017,55,13:30,13:45,,24.62,0,24.62,24.62,-1,-63554,85309,148863,21755,0,-24897,0,0,0,,24897,-24897
25,06/21/2017,56,13:45,14:00,39.9,21.27,0,39.9,21.27,2,-61338,84518,145856,23180,0,-7810,2051,0,0,,9861,-5759
25,06/21/2017,57,14:00,14:15,,16.27,0,16.27,16.27,-1,-39781,77816,117597,38035,0,-28101,0,0,0,,28101,-28101
25,06/21/2017,58,14:15,14:30,31.8,25.79,0,31.8,25.79,2,-47273,59169,106442,11896,0,-12909,753,0,0,,13662,-12156
25,06/21/2017,59,14:30,14:45,31.8,21.27,0,21.27,21.27,-1,-47136,75637,122773,28501,0,-13058,34,0,0,,13092,-13024
25,06/21/2017,60,14:45,15:00,,25.79,0,25.79,25.79,-1,-45275,67330,112605,22055,0,-15031,0,0,0,,15031,-15031
25,06/21/2017,61,15:00,15:15,,26.27,0,26.27,26.27,-1,-44460,58973,103433,14513,0,-7852,0,0,0,,7852,-7852
25,06/21/2017,62,15:15,15:30,31.52,26.27,0,31.52,31.52,1,-51573,43893,95466,-7680,0,-12,2442,0,0,,2454,2430
25,06/21/2017,63,15:30,15:45,30.23,,0,30.23,30.23,1,-46448,47233,93681,785,0,0,2079,0,0,,2079,2079
25,06/21/2017,64,15:45,16:00,44.89,,0,44.89,44.89,1,-60082,33843,93925,-26239,0,0,9627,0,0,,9627,9627
25,06/21/2017,65,16:00,16:15,34.18,,0,34.18,34.18,1,-62730,48581,111311,-14149,0,0,10472,0,0,,10472,10472
25,06/21/2017,66,16:15,16:30,32.77,,0,32.77,32.77,1,-59752,42240,101992,-17512,0,0,9715,0,0,,9715,9715
25,06/21/2017,67,16:30,16:45,34.18,,0,34.18,34.18,1,-60251,46051,106302,-14200,0,0,4908,0,0,,4908,4908
25,06/21/2017,68,16:45,17:00,38.19,,0,38.19,38.19,1,-60707,40983,101690,-19724,0,0,6268,0,0,,6268,6268
25,06/21/2017,69,17:00,17:15,27.73,,0,27.73,27.73,1,-58781,85849,144630,27068,0,0,2803,0,0,,2803,2803
25,06/21/2017,70,17:15,17:30,28.27,,0,28.27,28.27,1,-62397,67235,129632,4838,0,0,389,0,0,,389,389
25,06/21/2017,71,17:30,17:45,28.27,,0,28.27,28.27,1,-55855,62918,118773,7063,0,0,3045,0,0,,3045,3045
25,06/21/2017,72,17:45,18:00,28.27,,0,28.27,28.27,1,-47018,58058,105076,11040,0,0,3622,0,0,,3622,3622
25,06/21/2017,73,18:00,18:15,31.3,,0,31.3,31.3,1,-82877,45490,128367,-37387,0,0,3814,0,0,,3814,3814
25,06/21/2017,74,18:15,18:30,,,0,28.57,28.57,0,-57777,65333,123110,7556,0,0,226,0,0,,226,226
25,06/21/2017,75,18:30,18:45,,,0,28.57,28.57,0,-52604,66471,119075,13867,0,0,0,0,0,,0,0
25,06/21/2017,76,18:45,19:00,30.94,,0,30.94,30.94,1,-44023,75045,119068,31022,0,0,80,0,0,,80,80
25,06/21/2017,77,19:00,19:15,68.52,,0,68.52,68.52,1,-84316,28071,112387,-56245,0,0,14871,0,0,,14871,14871
25,06/21/2017,78,19:15,19:30,44.89,,0,44.89,44.89,1,-63185,34837,98022,-28348,0,0,19684,0,0,,19684,19684
25,06/21/2017,79,19:30,19:45,36.95,,0,36.95,36.95,1,-65856,44979,110835,-20877,0,0,17758,0,0,,17758,17758
25,06/21/2017,80,19:45,20:00,,,0,28.67,28.67,0,-69481,48161,117642,-21320,0,0,5055,0,0,,5055,5055
25,06/21/2017,81,20:00,20:15,149.46,,0,149.46,149.46,1,-108952,40174,149126,-68778,0,0,24533,0,0,,24533,24533
25,06/21/2017,82,20:15,20:30,54.43,,0,54.43,54.43,1,-84007,53348,137355,-30659,0,0,34631,0,0,,34631,34631
25,06/21/2017,83,20:30,20:45,28.3,27.35,0,28.79,27.35,2,-79645,67690,147335,-11955,0,-471,1231,0,0,,1702,760
25,06/21/2017,84,20:45,21:00,31.03,,0,31.03,31.03,1,-70238,61841,132079,-8397,0,0,1126,0,0,,1126,1126
25,06/21/2017,85,21:00,21:15,58.22,,0,58.22,58.22,1,-103580,60689,164269,-42891,0,0,14873,0,0,,14873,14873
25,06/21/2017,86,21:15,21:30,35.44,,0,35.44,35.44,1,-81696,58509,140205,-23187,0,0,13185,0,0,,13185,13185
25,06/21/2017,87,21:30,21:45,35.44,26.27,0,26.27,26.27,-1,-62659,69824,132483,7165,0,-987,237,0,0,,1224,-750
25,06/21/2017,88,21:45,22:00,,26.27,0,26.27,26.27,-1,-63671,68029,131700,4358,0,-2217,0,0,0,,2217,-2217
25,06/21/2017,89,22:00,22:15,,26.7,0,26.7,26.7,-1,-100442,79978,180420,-20464,0,-2566,0,0,0,,2566,-2566
25,06/21/2017,90,22:15,22:30,,,0,28.65,28.65,0,-110455,80228,190683,-30227,0,-105,0,0,0,,105,-105
25,06/21/2017,91,22:30,22:45,28.27,,0,28.27,28.27,1,-90665,72074,162739,-18591,0,0,49,0,0,,49,49
25,06/21/2017,92,22:45,23:00,28.27,28.03,0,28.65,28.03,2,-70285,67132,137417,-3153,0,-55,1511,0,0,,1566,1456
25,06/21/2017,93,23:00,23:15,126.28,28.52,0,126.28,28.18,2,-136522,71269,207791,-65253,0,-106,18310,0,0,,18416,18204
25,06/21/2017,94,23:15,23:30,32.27,26.7,0,26.7,26.7,-1,-86805,69674,156479,-17131,0,-94,8235,0,0,,8329,8141
25,06/21/2017,95,23:30,23:45,,7.23,0,7.23,7.23,-1,-37629,76118,113747,38489,0,-21422,0,0,0,,21422,-21422
25,06/21/2017,96,23:45,0:00,,-11.93,0,-11.93,-11.93,-1,-27074,106960,134034,79886,0,-39715,0,0,0,,39715,-39715
25,06/22/2017,1,0:00,0:15,25.94,-11.66,0,25.94,25.94,1,-55485,67319,122804,11834,0,-26746,20,0,0,,26766,-26726
25,06/22/2017,2,0:15,0:30,25.94,27.99,0,27.99,27.99,-1,-42634,104793,147427,62159,0,-15,215,0,0,,230,200
25,06/22/2017,3,0:30,0:45,,17.19,0,17.19,17.19,-1,-23392,136066,159458,112674,0,-2653,0,0,0,,2653,-2653
25,06/22/2017,4,0:45,1:00,,-9.85,0,-9.85,-9.85,-1,-14506,144793,159299,130287,0,-57635,0,0,0,,57635,-57635
25,06/22/2017,5,1:00,1:15,,,0,28.75,28.75,0,-88652,141664,230316,53012,0,-35341,0,0,0,,35341,-35341
25,06/22/2017,6,1:15,1:30,,,0,28.75,28.75,0,-67958,90031,157989,22073,0,0,0,0,0,,0,0
25,06/22/2017,7,1:30,1:45,,27.88,0,27.88,27.88,-1,-46447,52490,98937,6043,0,-1415,0,0,0,,1415,-1415
25,06/22/2017,8,1:45,2:00,,28.27,0,28.27,28.27,-1,-80124,62453,142577,-17671,0,-1092,0,0,0,,1092,-1092
25,06/22/2017,9,2:00,2:15,218.16,28.27,0,218.16,218.16,1,-102442,43574,146016,-58868,0,-33,13638,0,0,,13671,13605
25,06/22/2017,10,2:15,2:30,218.16,,0,218.16,218.16,1,-73159,33574,106733,-39585,0,0,40123,0,0,,40123,40123
25,06/22/2017,11,2:30,2:45,27.9,,0,27.9,27.9,1,-60560,51425,111985,-9135,0,0,7968,0,0,,7968,7968
25,06/22/2017,12,2:45,3:00,25.9,,0,25.9,25.9,1,-59763,55221,114984,-4542,0,0,1088,0,0,,1088,1088
25,06/22/2017,13,3:00,3:15,27.9,,0,27.9,27.9,1,-65360,79547,144907,14187,0,0,661,0,0,,661,661
25,06/22/2017,14,3:15,3:30,28.92,,0,28.92,28.92,1,-65101,71479,136580,6378,0,0,1604,0,0,,1604,1604
25,06/22/2017,15,3:30,3:45,,,0,28.75,28.75,0,-49397,82323,131720,32926,0,0,0,0,0,,0,0
25,06/22/2017,16,3:45,4:00,,,0,28.75,28.75,0,-32501,80161,112662,47660,0,0,0,0,0,,0,0
25,06/22/2017,17,4:00,4:15,,,0,28.75,28.75,0,-69598,85835,155433,16237,0,0,0,0,0,,0,0
25,06/22/2017,18,4:15,4:30,,,0,28.75,28.75,0,-49067,99604,148671,50537,0,0,0,0,0,,0,0
25,06/22/2017,19,4:30,4:45,,,0,28.75,28.75,0,-58387,96088,154475,37701,0,0,0,0,0,,0,0
25,06/22/2017,20,4:45,5:00,25.9,,0,25.9,25.9,1,-68629,97855,166484,29226,0,0,4,0,0,,4,4
25,06/22/2017,21,5:00,5:15,42.49,,0,42.49,42.49,1,-150855,99887,250742,-50968,0,0,10686,0,0,,10686,10686
25,06/22/2017,22,5:15,5:30,28.92,27.59,0,27.59,27.59,-1,-98680,103966,202646,5286,0,-232,6829,0,0,,7061,6597
25,06/22/2017,23,5:30,5:45,28.92,27.2,0,27.2,27.2,-1,-110722,100026,210748,-10696,0,-647,46,0,0,,693,-601
25,06/22/2017,24,5:45,6:00,25.85,,0,25.85,25.85,1,-81247,85817,167064,4570,0,0,112,0,0,,112,112
25,06/22/2017,25,6:00,6:15,,-9.85,0,-9.85,-9.85,-1,-81097,140217,221314,59120,0,-22989,0,0,0,,22989,-22989
25,06/22/2017,26,6:15,6:30,,25.64,0,25.64,25.64,-1,-101559,117768,219327,16209,0,-19370,0,0,0,,19370,-19370
25,06/22/2017,27,6:30,6:45,42.34,25.64,0,42.34,42.34,1,-112117,95485,207602,-16632,0,-3873,4302,0,0,,8175,429
25,06/22/2017,28,6:45,7:00,146.72,,0,146.72,146.72,1,-146842,81276,228118,-65566,0,0,42671,0,0,,42671,42671
25,06/22/2017,29,7:00,7:15,146.72,-53.53,0,-53.53,-53.53,-1,-52877,124144,177021,71267,0,-19588,10489,0,0,,30077,-9099
25,06/22/2017,30,7:15,7:30,,20.91,0,20.91,20.91,-1,-46285,81044,127329,34759,0,-10819,0,0,0,,10819,-10819
25,06/22/2017,31,7:30,7:45,,25.91,0,25.91,25.91,-1,-67640,80830,148470,13190,0,-14079,0,0,0,,14079,-14079
25,06/22/2017,32,7:45,8:00,32.39,25.91,0,32.39,32.39,1,-102112,71172,173284,-30940,0,-1957,4309,0,0,,6266,2352
25,06/22/2017,33,8:00,8:15,32.39,-53.53,0,-53.53,-53.53,-1,-39968,134792,174760,94824,0,-37573,965,0,0,,38538,-36608
25,06/22/2017,34,8:15,8:30,,20.91,0,20.91,20.91,-1,-58304,107119,165423,48815,0,-16400,0,0,0,,16400,-16400
25,06/22/2017,35,8:30,8:45,,25.91,0,25.91,25.91,-1,-71863,93110,164973,21247,0,-14387,0,0,0,,14387,-14387
25,06/22/2017,36,8:45,9:00,27.91,25.91,0,27.91,27.91,1,-79011,86145,165156,7134,0,-1179,117,0,0,,1296,-1062
25,06/22/2017,37,9:00,9:15,,25.91,0,25.91,25.91,-1,-71025,90519,161544,19494,0,-3164,0,0,0,,3164,-3164
25,06/22/2017,38,9:15,9:30,58.12,48.41,0,58.12,58.12,1,-80599,44968,125567,-35631,0,-956,8079,0,0,,9035,7123
25,06/22/2017,39,9:30,9:45,60.8,,0,60.8,60.8,1,-101010,43744,144754,-57266,0,0,31418,0,0,,31418,31418
25,06/22/2017,40,9:45,10:00,103.12,,0,103.12,103.12,1,-114482,49135,163617,-65347,0,0,48099,0,0,,48099,48099
25,06/22/2017,41,10:00,10:15,129.12,,0,129.12,129.12,1,-128701,73595,202296,-55106,0,0,57436,0,0,,57436,57436
25,06/22/2017,42,10:15,10:30,40.37,,0,40.37,40.37,1,-117917,90772,208689,-27145,0,0,22477,0,0,,22477,22477
25,06/22/2017,43,10:30,10:45,42.49,,0,42.49,42.49,1,-106894,80781,187675,-26113,0,0,17140,0,0,,17140,17140
25,06/22/2017,44,10:45,11:00,80.28,,0,80.28,80.28,1,-114513,67525,182038,-46988,0,0,22074,0,0,,22074,22074
25,06/22/2017,45,11:00,11:15,43.41,,0,43.41,43.41,1,-101792,71872,173664,-29920,0,0,29031,0,0,,29031,29031
25,06/22/2017,46,11:15,11:30,33.12,,0,33.12,33.12,1,-123967,75160,199127,-48807,0,0,10056,0,0,,10056,10056
25,06/22/2017,47,11:30,11:45,285.69,,0,285.69,285.69,1,-132055,76136,208191,-55919,0,0,26918,0,0,,26918,26918
25,06/22/2017,48,11:45,12:00,59.41,,0,59.41,59.41,1,-129237,68687,197924,-60550,0,0,43015,0,0,,43015,43015
25,06/22/2017,49,12:00,12:15,28.53,,0,28.53,28.53,1,-122435,101742,224177,-20693,0,0,10209,0,0,,10209,10209
25,06/22/2017,50,12:15,12:30,,,0,38.24,38.24,0,-114882,79948,194830,-34934,0,0,0,0,0,,0,0
25,06/22/2017,51,12:30,12:45,,,0,38.24,38.24,0,-101819,76188,178007,-25631,0,0,0,0,0,,0,0
25,06/22/2017,52,12:45,13:00,,,0,38.24,38.24,0,-105127,79014,184141,-26113,0,0,0,0,0,,0,0
25,06/22/2017,53,13:00,13:15,,23.4,0,23.4,23.4,-1,-51030,89493,140523,38463,0,-12150,0,0,0,,12150,-12150
25,06/22/2017,54,13:15,13:30,,26.43,0,26.43,26.43,-1,-80580,80495,161075,-85,0,-11723,0,0,0,,11723,-11723
25,06/22/2017,55,13:30,13:45,,27.78,0,27.78,27.78,-1,-89668,98585,188253,8917,0,-9487,0,0,0,,9487,-9487
25,06/22/2017,56,13:45,14:00,,25.91,0,25.91,25.91,-1,-85875,103596,189471,17721,0,-10294,0,0,0,,10294,-10294
25,06/22/2017,57,14:00,14:15,,27.78,0,27.78,27.78,-1,-62694,119860,182554,57166,0,-5946,0,0,0,,5946,-5946
25,06/22/2017,58,14:15,14:30,,,0,29.75,29.75,0,-58809,152228,211037,93419,0,-46,0,0,0,,46,-46
25,06/22/2017,59,14:30,14:45,,17.19,0,17.19,17.19,-1,-57856,187873,245729,130017,0,-710,0,0,0,,710,-710
25,06/22/2017,60,14:45,15:00,,5.75,0,5.75,5.75,-1,-52114,212312,264426,160198,0,-20533,0,0,0,,20533,-20533
25,06/22/2017,61,15:00,15:15,,26.78,0,26.78,26.78,-1,-52182,123256,175438,71074,0,-5476,0,0,0,,5476,-5476
25,06/22/2017,62,15:15,15:30,,,0,28.75,28.75,0,-52214,112438,164652,60224,0,-15,0,0,0,,15,-15
25,06/22/2017,63,15:30,15:45,,,0,28.75,28.75,0,-63237,148338,211575,85101,0,0,0,0,0,,0,0
25,06/22/2017,64,15:45,16:00,,17.19,0,17.19,17.19,-1,-65507,209050,274557,143543,0,-4072,0,0,0,,4072,-4072
25,06/22/2017,65,16:00,16:15,,-53.53,0,-53.53,-53.53,-1,-105361,141538,246899,36177,0,-45058,0,0,0,,45058,-45058
25,06/22/2017,66,16:15,16:30,159.15,-53.53,0,159.15,159.15,1,-181654,104390,286044,-77264,0,-2821,26636,0,0,,29457,23815
25,06/22/2017,67,16:30,16:45,159.15,,0,159.15,159.15,1,-160557,64054,224611,-96503,0,0,80881,0,0,,80881,80881
25,06/22/2017,68,16:45,17:00,140.48,-53.53,0,-53.53,-53.53,-1,-150634,187275,337909,36641,0,-7299,30130,22500,0,,59929,45331
25,06/22/2017,69,17:00,17:15,,-53.53,0,-53.53,-53.53,-1,-118404,149565,267969,31161,0,-24304,0,0,0,,24304,-24304
25,06/22/2017,70,17:15,17:30,,,0,29.67,29.67,0,-123579,146621,270200,23042,0,-147,0,0,0,,147,-147
25,06/22/2017,71,17:30,17:45,,,0,29.68,29.68,0,-117295,141094,258389,23799,0,0,0,0,0,,0,0
25,06/22/2017,72,17:45,18:00,,,0,29.68,29.68,0,-100300,144075,244375,43775,0,0,0,0,0,,0,0
25,06/22/2017,73,18:00,18:15,,17.19,0,17.19,17.19,-1,-105088,158890,263978,53802,0,-10400,0,0,0,,10400,-10400
25,06/22/2017,74,18:15,18:30,,-9.85,0,-9.85,-9.85,-1,-66747,183848,250595,117101,0,-63220,0,0,0,,63220,-63220
25,06/22/2017,75,18:30,18:45,,-53.53,0,-53.53,-53.53,-1,-44146,140549,184695,96403,0,-86000,0,0,0,,86000,-86000
25,06/22/2017,76,18:45,19:00,,5.75,0,5.75,5.75,-1,-54634,170560,225194,115926,0,-68488,0,0,0,,68488,-68488
25,06/22/2017,77,19:00,19:15,,11.78,0,11.78,11.78,-1,-76487,171916,248403,95429,0,-37140,0,0,0,,37140,-37140
25,06/22/2017,78,19:15,19:30,,17.19,0,17.19,17.19,-1,-29005,177327,206332,148322,0,-8306,0,0,0,,8306,-8306
25,06/22/2017,79,19:30,19:45,,15.91,0,15.91,15.91,-1,-23485,183637,207122,160152,0,-43035,0,0,0,,43035,-43035
25,06/22/2017,80,19:45,20:00,,17.19,0,17.19,17.19,-1,-26654,173615,200269,146961,0,-44159,0,0,0,,44159,-44159
25,06/22/2017,81,20:00,20:15,,-1.74,0,-1.74,-1.74,-1,-51085,185313,236398,134228,0,-42730,0,0,0,,42730,-42730
25,06/22/2017,82,20:15,20:30,,-29.61,0,-29.61,-29.61,-1,-54212,202819,257031,148607,0,-71040,0,0,0,,71040,-71040
25,06/22/2017,83,20:30,20:45,,-53.53,0,-53.53,-53.53,-1,-51992,168149,220141,116157,0,-81061,0,0,0,,81061,-81061
25,06/22/2017,84,20:45,21:00,,-53.53,0,-53.53,-53.53,-1,-48542,193531,242073,144989,0,-90310,0,0,0,,90310,-90310
25,06/22/2017,85,21:00,21:15,,-53.53,0,-53.53,-53.53,-1,-68028,180941,248969,112913,0,-90398,0,0,0,,90398,-90398
25,06/22/2017,86,21:15,21:30,,-11.76,0,-11.76,-11.76,-1,-54938,232790,287728,177852,0,-86975,0,0,0,,86975,-86975
25,06/22/2017,87,21:30,21:45,,-44.07,0,-44.07,-44.07,-1,-30635,221269,251904,190634,0,-95232,0,0,0,,95232,-95232
25,06/22/2017,88,21:45,22:00,,-44.07,0,-44.07,-44.07,-1,-43054,191347,234401,148293,0,-118077,0,0,0,,118077,-118077
25,06/22/2017,89,22:00,22:15,,-47.16,0,-47.16,-47.16,-1,-70696,202157,272853,131461,0,-67092,0,0,0,,67092,-67092
25,06/22/2017,90,22:15,22:30,,-4.73,0,-4.73,-4.73,-1,-48645,211674,260319,163029,0,-61791,0,0,0,,61791,-61791
25,06/22/2017,91,22:30,22:45,,-47.16,0,-47.16,-47.16,-1,-39428,205567,244995,166139,0,-89190,0,0,0,,89190,-89190
25,06/22/2017,92,22:45,23:00,,-44.07,0,-44.07,-44.07,-1,-45331,174454,219785,129123,0,-122134,0,0,0,,122134,-122134
25,06/22/2017,93,23:00,23:15,,-61.94,0,-61.94,-61.94,-1,-84403,181772,266175,97369,0,-92109,0,0,0,,92109,-92109
25,06/22/2017,94,23:15,23:30,,-61.94,0,-61.94,-61.94,-1,-81017,170688,251705,89671,0,-67406,0,0,0,,67406,-67406
25,06/22/2017,95,23:30,23:45,,-62.62,0,-62.62,-62.62,-1,-69940,178340,248280,108400,0,-40870,0,0,0,,40870,-40870
25,06/22/2017,96,23:45,0:00,,-62.62,0,-62.62,-62.62,-1,-105972,119610,225582,13638,0,-58086,0,0,0,,58086,-58086
25,06/23/2017,1,0:00,0:15,38.37,26.6,0,38.37,38.37,1,-159049,152594,311643,-6455,0,-3279,2681,0,0,,5960,-598
25,06/23/2017,2,0:15,0:30,63.86,,0,63.86,63.86,1,-146460,139289,285749,-7171,0,0,14980,0,0,,14980,14980
25,06/23/2017,3,0:30,0:45,,,0,27.86,27.86,0,-155915,138912,294827,-17003,0,0,188,0,0,,188,188
25,06/23/2017,4,0:45,1:00,,,0,27.82,27.82,0,-175618,124259,299877,-51359,0,0,0,0,0,,0,0
25,06/23/2017,5,1:00,1:15,,,0,26.68,26.68,0,-42906,95696,138602,52790,0,0,0,0,0,,0,0
25,06/23/2017,6,1:15,1:30,28.37,,0,28.37,28.37,1,-50015,40173,90188,-9842,0,0,841,0,0,,841,841
25,06/23/2017,7,1:30,1:45,29.87,,0,29.87,29.87,1,-74310,50964,125274,-23346,0,0,7863,0,0,,7863,7863
25,06/23/2017,8,1:45,2:00,26.37,,0,26.37,26.37,1,-103783,56373,160156,-47410,0,0,2984,0,0,,2984,2984
25,06/23/2017,9,2:00,2:15,38.37,26.72,0,38.37,38.37,1,-38905,22105,61010,-16800,0,-29,6576,0,0,,6605,6547
25,06/23/2017,10,2:15,2:30,38.37,24.74,0,24.74,24.74,-1,-34116,37192,71308,3076,0,-309,14742,0,0,,15051,14433
25,06/23/2017,11,2:30,2:45,38.37,21.37,0,21.37,21.37,-1,-31072,42483,73555,11411,0,-6905,257,0,0,,7162,-6648
25,06/23/2017,12,2:45,3:00,,26.37,0,26.37,26.37,-1,-34409,33097,67506,-1312,0,-5105,0,0,0,,5105,-5105
25,06/23/2017,13,3:00,3:15,28.37,26.37,0,28.37,28.37,1,-46824,44446,91270,-2378,0,-683,510,0,0,,1193,-173
25,06/23/2017,14,3:15,3:30,32.37,,0,32.37,32.37,1,-73568,47482,121050,-26086,0,0,11391,0,0,,11391,11391
25,06/23/2017,15,3:30,3:45,71.02,,0,71.02,71.02,1,-102673,43671,146344,-59002,0,0,24350,0,0,,24350,24350
25,06/23/2017,16,3:45,4:00,30.81,,0,30.81,30.81,1,-63099,39984,103083,-23115,0,0,14745,0,0,,14745,14745
25,06/23/2017,17,4:00,4:15,,,0,27.27,27.27,0,-55924,35934,91858,-19990,0,0,812,0,0,,812,812
25,06/23/2017,18,4:15,4:30,26.37,,0,26.37,26.37,1,-31169,41545,72714,10376,0,0,121,0,0,,121,121
25,06/23/2017,19,4:30,4:45,,,0,27.22,27.22,0,-34536,65812,100348,31276,0,0,0,0,0,,0,0
25,06/23/2017,20,4:45,5:00,,,0,27.23,27.23,0,-35004,59033,94037,24029,0,0,0,0,0,,0,0
25,06/23/2017,21,5:00,5:15,,,0,27.34,27.34,0,-54606,122066,176672,67460,0,0,0,0,0,,0,0
25,06/23/2017,22,5:15,5:30,,,0,27.29,27.29,0,-44821,89655,134476,44834,0,0,0,0,0,,0,0
25,06/23/2017,23,5:30,5:45,,,0,27.39,27.39,0,-41153,106137,147290,64984,0,0,0,0,0,,0,0
25,06/23/2017,24,5:45,6:00,28.37,,0,28.37,28.37,1,-54051,101218,155269,47167,0,0,2383,0,0,,2383,2383
25,06/23/2017,25,6:00,6:15,28.37,-33.58,0,-33.58,-33.58,-1,-53943,137651,191594,83708,0,-20487,203,0,0,,20690,-20284
25,06/23/2017,26,6:15,6:30,,25.23,0,25.23,25.23,-1,-61267,110425,171692,49158,0,-10297,0,0,0,,10297,-10297
25,06/23/2017,27,6:30,6:45,28.81,25.23,0,28.81,28.81,1,-81037,96126,177163,15089,0,-15,562,0,0,,577,547
25,06/23/2017,28,6:45,7:00,38.64,,0,38.64,38.64,1,-106004,116806,222810,10802,0,0,16161,0,0,,16161,16161
25,06/23/2017,29,7:00,7:15,38.64,27.9,0,27.9,27.9,-1,-86071,129355,215426,43284,0,-1128,2168,0,0,,3296,1040
25,06/23/2017,30,7:15,7:30,,29.15,0,29.15,29.15,-1,-61355,111973,173328,50618,0,-1231,0,0,0,,1231,-1231
25,06/23/2017,31,7:30,7:45,,,0,29.02,29.02,0,-74162,84645,158807,10483,0,-5,0,0,0,,5,-5
25,06/23/2017,32,7:45,8:00,26.26,,0,26.26,26.26,1,-94449,73804,168253,-20645,0,0,232,0,0,,232,232
25,06/23/2017,33,8:00,8:15,33.28,,0,33.28,33.28,1,-110428,112598,223026,2170,0,0,1634,0,0,,1634,1634
25,06/23/2017,34,8:15,8:30,44.28,,0,44.28,44.28,1,-128083,120933,249016,-7150,0,0,10317,0,0,,10317,10317
25,06/23/2017,35,8:30,8:45,28.83,,0,28.83,28.83,1,-131501,118995,250496,-12506,0,0,1918,0,0,,1918,1918
25,06/23/2017,36,8:45,9:00,28.28,,0,28.28,28.28,1,-140007,134767,274774,-5240,0,0,3764,0,0,,3764,3764
25,06/23/2017,37,9:00,9:15,32.4,,0,32.4,32.4,1,-119907,105614,225521,-14293,0,0,4821,0,0,,4821,4821
25,06/23/2017,38,9:15,9:30,28.14,,0,28.14,28.14,1,-122446,103756,226202,-18690,0,0,1997,0,0,,1997,1997
25,06/23/2017,39,9:30,9:45,,27.51,0,27.51,27.51,-1,-119481,118681,238162,-800,0,-652,0,0,0,,652,-652
25,06/23/2017,40,9:45,10:00,,26.47,0,26.47,26.47,-1,-129456,137178,266634,7722,0,-4386,0,0,0,,4386,-4386
25,06/23/2017,41,10:00,10:15,,-53.61,0,-53.61,-53.61,-1,-38072,139833,177905,101761,0,-36050,0,0,0,,36050,-36050
25,06/23/2017,42,10:15,10:30,,-29.69,0,-29.69,-29.69,-1,-51132,135074,186206,83942,0,-58083,0,0,0,,58083,-58083
25,06/23/2017,43,10:30,10:45,,-53.61,0,-53.61,-53.61,-1,-61911,129061,190972,67150,0,-68193,0,0,0,,68193,-68193
25,06/23/2017,44,10:45,11:00,,-53.61,0,-53.61,-53.61,-1,-64334,169994,234328,105660,0,-72010,0,0,0,,72010,-72010
25,06/23/2017,45,11:00,11:15,,16.14,0,16.14,16.14,-1,-66596,129920,196516,63324,0,-60557,0,0,0,,60557,-60557
25,06/23/2017,46,11:15,11:30,,-9.93,0,-9.93,-9.93,-1,-65114,154816,219930,89702,0,-78326,0,0,0,,78326,-78326
25,06/23/2017,47,11:30,11:45,,5.67,0,5.67,5.67,-1,-71822,153274,225096,81452,0,-73829,0,0,0,,73829,-73829
25,06/23/2017,48,11:45,12:00,,11.03,0,11.03,11.03,-1,-70320,160778,231098,90458,0,-76083,0,0,0,,76083,-76083
25,06/23/2017,49,12:00,12:15,50.98,17.03,0,50.98,50.98,1,-114408,81387,195795,-33021,0,-34810,1652,0,0,,36462,-33158
25,06/23/2017,50,12:15,12:30,50.98,5.67,0,5.67,5.67,-1,-85889,133477,219366,47588,0,-15870,473,0,0,,16343,-15397
25,06/23/2017,51,12:30,12:45,,-2.22,0,-2.22,-2.22,-1,-90499,155020,245519,64521,0,-56020,0,0,0,,56020,-56020
25,06/23/2017,52,12:45,13:00,,-9.93,0,-9.93,-9.93,-1,-79505,176673,256178,97168,0,-73121,0,0,0,,73121,-73121
25,06/23/2017,53,13:00,13:15,,17.11,0,17.11,17.11,-1,-89079,121059,210138,31980,0,-49725,0,0,0,,49725,-49725
25,06/23/2017,54,13:15,13:30,,17.11,0,17.11,17.11,-1,-93474,133525,226999,40051,0,-31606,0,0,0,,31606,-31606
25,06/23/2017,55,13:30,13:45,,-9.93,0,-9.93,-9.93,-1,-95021,163093,258114,68072,0,-59894,0,0,0,,59894,-59894
25,06/23/2017,56,13:45,14:00,,5.67,0,5.67,5.67,-1,-95549,179999,275548,84450,0,-68448,0,0,0,,68448,-68448
25,06/23/2017,57,14:00,14:15,32.53,31.5,0,32.53,28.82,2,-91990,69820,161810,-22170,0,-24964,1691,0,0,,26655,-23273
25,06/23/2017,58,14:15,14:30,32.53,26.14,0,26.14,26.14,-1,-82683,108972,191655,26289,0,-4917,47,0,0,,4964,-4870
25,06/23/2017,59,14:30,14:45,,25.99,0,25.99,25.99,-1,-79951,86050,166001,6099,0,-5913,0,0,0,,5913,-5913
25,06/23/2017,60,14:45,15:00,,24.39,0,24.39,24.39,-1,-81783,100380,182163,18597,0,-7751,0,0,0,,7751,-7751
25,06/23/2017,61,15:00,15:15,,16.14,0,16.14,16.14,-1,-70218,114885,185103,44667,0,-25843,0,0,0,,25843,-25843
25,06/23/2017,62,15:15,15:30,,21.14,0,21.14,21.14,-1,-70514,113384,183898,42870,0,-25253,0,0,0,,25253,-25253
25,06/23/2017,63,15:30,15:45,,2.78,0,2.78,2.78,-1,-60476,134376,194852,73900,0,-45629,0,0,0,,45629,-45629
25,06/23/2017,64,15:45,16:00,,18.03,0,18.03,18.03,-1,-71231,135285,206516,64054,0,-52060,0,0,0,,52060,-52060
25,06/23/2017,65,16:00,16:15,,21.14,0,21.14,21.14,-1,-102378,120093,222471,17715,0,-33822,0,0,0,,33822,-33822
25,06/23/2017,66,16:15,16:30,,25.14,0,25.14,25.14,-1,-96020,139180,235200,43160,0,-24521,0,0,0,,24521,-24521
25,06/23/2017,67,16:30,16:45,,26.03,0,26.03,26.03,-1,-90109,142673,232782,52564,0,-13490,0,0,0,,13490,-13490
25,06/23/2017,68,16:45,17:00,,7.33,0,7.33,7.33,-1,-77317,158154,235471,80837,0,-11676,0,0,0,,11676,-11676
25,06/23/2017,69,17:00,17:15,,-57.22,0,-57.22,-57.22,-1,-44985,126463,171448,81478,0,-49113,0,0,0,,49113,-49113
25,06/23/2017,70,17:15,17:30,,2.76,0,2.76,2.76,-1,-52181,141342,193523,89161,0,-38810,0,0,0,,38810,-38810
25,06/23/2017,71,17:30,17:45,,25.14,0,25.14,25.14,-1,-62396,132657,195053,70261,0,-30216,0,0,0,,30216,-30216
25,06/23/2017,72,17:45,18:00,26.14,27.87,0,26.14,26.14,1,-75445,122761,198206,47316,0,-9413,4,0,0,,9417,-9409
25,06/23/2017,73,18:00,18:15,,26.14,0,26.14,26.14,-1,-104850,85467,190317,-19383,0,-744,0,0,0,,744,-744
25,06/23/2017,74,18:15,18:30,,26.03,0,26.03,26.03,-1,-95785,116340,212125,20555,0,-10481,0,0,0,,10481,-10481
25,06/23/2017,75,18:30,18:45,,26.03,0,26.03,26.03,-1,-100465,107173,207638,6708,0,-12601,0,0,0,,12601,-12601
25,06/23/2017,76,18:45,19:00,,29.02,0,29.02,29.02,-1,-100494,116194,216688,15700,0,-2332,0,0,0,,2332,-2332
25,06/23/2017,77,19:00,19:15,,27.51,0,27.51,27.51,-1,-104955,87365,192320,-17590,0,-2529,0,0,0,,2529,-2529
25,06/23/2017,78,19:15,19:30,,27.51,0,27.51,27.51,-1,-92012,79912,171924,-12100,0,-1734,0,0,0,,1734,-1734
25,06/23/2017,79,19:30,19:45,,27.12,0,27.12,27.12,-1,-76914,85761,162675,8847,0,-1946,0,0,0,,1946,-1946
25,06/23/2017,80,19:45,20:00,,26.14,0,26.14,26.14,-1,-84007,94830,178837,10823,0,-1091,0,0,0,,1091,-1091
25,06/23/2017,81,20:00,20:15,,21.14,0,21.14,21.14,-1,-58184,69506,127690,11322,0,-10248,0,0,0,,10248,-10248
25,06/23/2017,82,20:15,20:30,,21.14,0,21.14,21.14,-1,-53688,79925,133613,26237,0,-13087,0,0,0,,13087,-13087
25,06/23/2017,83,20:30,20:45,,21.14,0,21.14,21.14,-1,-61557,103369,164926,41812,0,-27867,0,0,0,,27867,-27867
25,06/23/2017,84,20:45,21:00,,25.14,0,25.14,25.14,-1,-75666,98177,173843,22511,0,-25852,0,0,0,,25852,-25852
25,06/23/2017,85,21:00,21:15,32.98,26.14,0,32.98,32.98,1,-84112,52491,136603,-31621,0,-12410,1250,0,0,,13660,-11160
25,06/23/2017,86,21:15,21:30,31.2,26.04,0,31.2,26.04,2,-58964,63219,122183,4255,0,-726,5572,0,0,,6298,4846
25,06/23/2017,87,21:30,21:45,31.2,24.39,0,24.39,24.39,-1,-46534,95547,142081,49013,0,-8944,323,0,0,,9267,-8621
25,06/23/2017,88,21:45,22:00,,21.14,0,21.14,21.14,-1,-53951,84436,138387,30485,0,-20026,0,0,0,,20026,-20026
25,06/23/2017,89,22:00,22:15,,26.03,0,26.03,26.03,-1,-72882,82427,155309,9545,0,-20157,0,0,0,,20157,-20157
25,06/23/2017,90,22:15,22:30,29.23,26.03,0,29.23,29.23,1,-77998,80164,158162,2166,0,-3408,952,0,0,,4360,-2456
25,06/23/2017,91,22:30,22:45,29.23,26.14,0,26.14,26.14,-1,-55481,88033,143514,32552,0,-2721,9,0,0,,2730,-2712
25,06/23/2017,92,22:45,23:00,,27.51,0,27.51,27.51,-1,-98420,83525,181945,-14895,0,-1039,0,0,0,,1039,-1039
25,06/23/2017,93,23:00,23:15,28.14,27.12,0,28.98,27.12,2,-49233,39259,88492,-9974,0,-338,1044,0,0,,1382,706
25,06/23/2017,94,23:15,23:30,29.72,,0,29.72,29.72,1,-91171,59741,150912,-31430,0,0,4018,0,0,,4018,4018
25,06/23/2017,95,23:30,23:45,29.72,27.12,0,27.12,27.12,-1,-67589,86548,154137,18959,0,-1158,74,0,0,,1232,-1084
25,06/23/2017,96,23:45,0:00,,13.58,0,13.58,13.58,-1,-59428,79624,139052,20196,0,-14409,0,0,0,,14409,-14409
26,06/24/2017,1,0:00,0:15,,-15.2,0,-15.2,-15.2,-1,-33265,150327,183592,117062,0,-20152,0,0,0,,20152,-20152
26,06/24/2017,2,0:15,0:30,,,0,27.71,27.71,0,-52269,76796,129065,24527,0,-1251,0,0,0,,1251,-1251
26,06/24/2017,3,0:30,0:45,27.91,,0,27.91,27.91,1,-68150,55758,123908,-12392,0,0,1111,0,0,,1111,1111
26,06/24/2017,4,0:45,1:00,27.05,,0,27.05,27.05,1,-125498,65822,191320,-59676,0,0,1763,0,0,,1763,1763
26,06/24/2017,5,1:00,1:15,25.91,,0,25.91,25.91,1,-78995,74510,153505,-4485,0,0,2,0,0,,2,2
26,06/24/2017,6,1:15,1:30,25.91,,0,25.91,25.91,1,-78505,50434,128939,-28071,0,0,8,0,0,,8,8
26,06/24/2017,7,1:30,1:45,25.91,,0,25.91,25.91,1,-72969,33807,106776,-39162,0,0,182,0,0,,182,182
26,06/24/2017,8,1:45,2:00,25.91,,0,25.91,25.91,1,-96125,36103,132228,-60022,0,0,27,0,0,,27,27
26,06/24/2017,9,2:00,2:15,33.47,,0,33.47,33.47,1,-61285,15790,77075,-45495,0,0,2584,0,0,,2584,2584
26,06/24/2017,10,2:15,2:30,35.66,,0,35.66,35.66,1,-84441,24443,108884,-59998,0,0,8617,0,0,,8617,8617
26,06/24/2017,11,2:30,2:45,,,0,26.96,26.96,0,-75182,26729,101911,-48453,0,0,113,0,0,,113,113
26,06/24/2017,12,2:45,3:00,,,0,26.95,26.95,0,-77695,32330,110025,-45365,0,0,0,0,0,,0,0
26,06/24/2017,13,3:00,3:15,35.66,,0,35.66,35.66,1,-70268,37327,107595,-32941,0,0,10833,0,0,,10833,10833
26,06/24/2017,14,3:15,3:30,30.17,,0,30.17,30.17,1,-64164,48990,113154,-15174,0,0,18258,0,0,,18258,18258
26,06/24/2017,15,3:30,3:45,30.17,26.84,0,26.84,26.84,-1,-54251,59842,114093,5591,0,-77,3405,0,0,,3482,3328
26,06/24/2017,16,3:45,4:00,,26.84,0,26.84,26.84,-1,-54879,54754,109633,-125,0,-185,0,0,0,,185,-185
26,06/24/2017,17,4:00,4:15,,,0,26.38,26.38,0,-54024,64615,118639,10591,0,0,0,0,0,,0,0
26,06/24/2017,18,4:15,4:30,,,0,26.38,26.38,0,-56861,63425,120286,6564,0,0,0,0,0,,0,0
26,06/24/2017,19,4:30,4:45,,,0,26.38,26.38,0,-49783,66644,116427,16861,0,0,0,0,0,,0,0
26,06/24/2017,20,4:45,5:00,,,0,26.38,26.38,0,-40739,69339,110078,28600,0,0,0,0,0,,0,0
26,06/24/2017,21,5:00,5:15,,,0,26.38,26.38,0,-32578,54804,87382,22226,0,0,0,0,0,,0,0
26,06/24/2017,22,5:15,5:30,,,0,26.38,26.38,0,-26506,57809,84315,31303,0,0,0,0,0,,0,0
26,06/24/2017,23,5:30,5:45,,,0,26.38,26.38,0,-25183,57964,83147,32781,0,0,0,0,0,,0,0
26,06/24/2017,24,5:45,6:00,,,0,26.38,26.38,0,-24719,74970,99689,50251,0,0,0,0,0,,0,0
26,06/24/2017,25,6:00,6:15,,23.48,0,23.48,23.48,-1,-23954,82329,106283,58375,0,-3036,0,0,0,,3036,-3036
26,06/24/2017,26,6:15,6:30,,26.84,0,26.84,26.84,-1,-20770,76475,97245,55705,0,-499,0,0,0,,499,-499
26,06/24/2017,27,6:30,6:45,,,0,26.25,26.25,0,-23546,66980,90526,43434,0,0,0,0,0,,0,0
26,06/24/2017,28,6:45,7:00,,,0,26.25,26.25,0,-30281,67678,97959,37397,0,0,0,0,0,,0,0
26,06/24/2017,29,7:00,7:15,,12.65,0,12.65,12.65,-1,-33548,92542,126090,58994,0,-12670,0,0,0,,12670,-12670
26,06/24/2017,30,7:15,7:30,,24.66,0,24.66,24.66,-1,-19746,74396,94142,54650,0,-10456,0,0,0,,10456,-10456
26,06/24/2017,31,7:30,7:45,,,0,27.01,27.01,0,-36254,60644,96898,24390,0,-75,0,0,0,,75,-75
26,06/24/2017,32,7:45,8:00,26.74,,0,26.74,26.74,1,-54470,61853,116323,7383,0,0,692,0,0,,692,692
26,06/24/2017,33,8:00,8:15,25.66,25.66,0,27.04,25.66,2,-38033,52563,90596,14530,0,-2099,201,0,0,,2300,-1898
26,06/24/2017,34,8:15,8:30,,26.09,0,26.09,26.09,-1,-50967,52499,103466,1532,0,-3169,0,0,0,,3169,-3169
26,06/24/2017,35,8:30,8:45,,25.74,0,25.74,25.74,-1,-64201,75630,139831,11429,0,-4690,0,0,0,,4690,-4690
26,06/24/2017,36,8:45,9:00,,26.09,0,26.09,26.09,-1,-90088,88016,178104,-2072,0,-3627,0,0,0,,3627,-3627
26,06/24/2017,37,9:00,9:15,,26.08,0,26.08,26.08,-1,-47814,45500,93314,-2314,0,-821,0,0,0,,821,-821
26,06/24/2017,38,9:15,9:30,26.79,26.84,0,27.49,26.84,2,-63271,39602,102873,-23669,0,-742,243,0,0,,985,-499
26,06/24/2017,39,9:30,9:45,51.32,,0,51.32,51.32,1,-78365,26742,105107,-51623,0,0,21673,0,0,,21673,21673
26,06/24/2017,40,9:45,10:00,37.66,,0,37.66,37.66,1,-100377,29636,130013,-70741,0,0,43565,0,0,,43565,43565
26,06/24/2017,41,10:00,10:15,37.66,,0,37.66,37.66,1,-76368,23499,99867,-52869,0,0,46505,0,0,,46505,46505
26,06/24/2017,42,10:15,10:30,42.08,,0,42.08,42.08,1,-85499,23546,109045,-61953,0,0,53530,0,0,,53530,53530
26,06/24/2017,43,10:30,10:45,37.66,,0,37.66,37.66,1,-83033,33409,116442,-49624,0,0,47816,0,0,,47816,47816
26,06/24/2017,44,10:45,11:00,31.66,,0,31.66,31.66,1,-87969,37126,125095,-50843,0,0,25624,0,0,,25624,25624
26,06/24/2017,45,11:00,11:15,45.33,,0,45.33,45.33,1,-85945,28987,114932,-56958,0,0,25020,0,0,,25020,25020
26,06/24/2017,46,11:15,11:30,45.33,,0,45.33,45.33,1,-84521,27458,111979,-57063,0,0,43623,0,0,,43623,43623
26,06/24/2017,47,11:30,11:45,37.66,,0,37.66,37.66,1,-73054,29700,102754,-43354,0,0,40606,0,0,,40606,40606
26,06/24/2017,48,11:45,12:00,37.66,,0,37.66,37.66,1,-83951,33670,117621,-50281,0,0,42953,0,0,,42953,42953
26,06/24/2017,49,12:00,12:15,72.35,,0,72.35,72.35,1,-128028,41054,169082,-86974,0,0,48732,0,0,,48732,48732
26,06/24/2017,50,12:15,12:30,35.31,,0,35.31,35.31,1,-87777,49857,137634,-37920,0,0,26802,0,0,,26802,26802
26,06/24/2017,51,12:30,12:45,28.47,,0,28.47,28.47,1,-78067,53203,131270,-24864,0,0,9314,0,0,,9314,9314
26,06/24/2017,52,12:45,13:00,55.24,,0,55.24,55.24,1,-91811,42080,133891,-49731,0,0,16318,0,0,,16318,16318
26,06/24/2017,53,13:00,13:15,53.82,,0,53.82,53.82,1,-93991,25331,119322,-68660,0,0,39962,0,0,,39962,39962
26,06/24/2017,54,13:15,13:30,95.89,,0,95.89,95.89,1,-117628,45199,162827,-72429,0,0,58591,0,0,,58591,58591
26,06/24/2017,55,13:30,13:45,52.05,,0,52.05,52.05,1,-109572,51074,160646,-58498,0,0,52660,0,0,,52660,52660
26,06/24/2017,56,13:45,14:00,60.21,,0,60.21,60.21,1,-109188,53969,163157,-55219,0,0,50855,0,0,,50855,50855
26,06/24/2017,57,14:00,14:15,82.21,,0,82.21,82.21,1,-135973,68639,204612,-67334,0,0,40878,0,0,,40878,40878
26,06/24/2017,58,14:15,14:30,146,,0,146,146,1,-128740,53665,182405,-75075,0,0,45782,0,0,,45782,45782
26,06/24/2017,59,14:30,14:45,52.21,,0,52.21,52.21,1,-128052,56372,184424,-71680,0,0,34437,0,0,,34437,34437
26,06/24/2017,60,14:45,15:00,31.66,,0,31.66,31.66,1,-119246,67019,186265,-52227,0,0,17934,0,0,,17934,17934
26,06/24/2017,61,15:00,15:15,37.66,,0,37.66,37.66,1,-112787,89718,202505,-23069,0,0,9176,0,0,,9176,9176
26,06/24/2017,62,15:15,15:30,33.32,,0,33.32,33.32,1,-118140,88693,206833,-29447,0,0,24744,0,0,,24744,24744
26,06/24/2017,63,15:30,15:45,37.66,,0,37.66,37.66,1,-119181,86766,205947,-32415,0,0,31398,0,0,,31398,31398
26,06/24/2017,64,15:45,16:00,37.66,,0,37.66,37.66,1,-111664,72599,184263,-39065,0,0,32135,0,0,,32135,32135
26,06/24/2017,65,16:00,16:15,29.89,,0,29.89,29.89,1,-86893,90796,177689,3903,0,0,12723,0,0,,12723,12723
26,06/24/2017,66,16:15,16:30,59.02,,0,59.02,59.02,1,-106592,63775,170367,-42817,0,0,17336,0,0,,17336,17336
26,06/24/2017,67,16:30,16:45,116.21,,0,116.21,116.21,1,-121264,52972,174236,-68292,0,0,52698,0,0,,52698,52698
26,06/24/2017,68,16:45,17:00,39.12,,0,39.12,39.12,1,-137518,73326,210844,-64192,0,0,54471,0,0,,54471,54471
26,06/24/2017,69,17:00,17:15,37.66,,0,37.66,37.66,1,-98761,54026,152787,-44735,0,0,40239,0,0,,40239,40239
26,06/24/2017,70,17:15,17:30,56.12,,0,56.12,56.12,1,-96623,42053,138676,-54570,0,0,18418,0,0,,18418,18418
26,06/24/2017,71,17:30,17:45,70.55,,0,70.55,70.55,1,-95981,57423,153404,-38558,0,0,35045,0,0,,35045,35045
26,06/24/2017,72,17:45,18:00,37.66,,0,37.66,37.66,1,-89464,51753,141217,-37711,0,0,19686,0,0,,19686,19686
26,06/24/2017,73,18:00,18:15,30.42,-1.94,0,-1.94,-1.94,-1,-80529,111230,191759,30701,0,-7935,11607,0,0,,19542,3672
26,06/24/2017,74,18:15,18:30,30.42,24.78,0,24.78,24.78,-1,-72154,87946,160100,15792,0,-10648,63,0,0,,10711,-10585
26,06/24/2017,75,18:30,18:45,,,0,27.9,27.9,0,-65697,94408,160105,28711,0,-74,0,0,0,,74,-74
26,06/24/2017,76,18:45,19:00,,27.1,0,27.1,27.1,-1,-59071,106235,165306,47164,0,-629,0,0,0,,629,-629
26,06/24/2017,77,19:00,19:15,,29.25,0,29.25,29.25,-1,-80200,97640,177840,17440,0,-729,0,0,0,,729,-729
26,06/24/2017,78,19:15,19:30,,,0,28.41,28.41,0,-65564,72081,137645,6517,0,0,0,0,0,,0,0
26,06/24/2017,79,19:30,19:45,25.66,,0,25.66,25.66,1,-57733,61677,119410,3944,0,0,132,0,0,,132,132
26,06/24/2017,80,19:45,20:00,25.66,,0,25.66,25.66,1,-62269,55925,118194,-6344,0,0,170,0,0,,170,170
26,06/24/2017,81,20:00,20:15,80.12,,0,80.12,80.12,1,-100299,35394,135693,-64905,0,0,15336,0,0,,15336,15336
26,06/24/2017,82,20:15,20:30,34.71,,0,34.71,34.71,1,-91343,34105,125448,-57238,0,0,27737,0,0,,27737,27737
26,06/24/2017,83,20:30,20:45,29.51,,0,29.51,29.51,1,-69499,36418,105917,-33081,0,0,15409,0,0,,15409,15409
26,06/24/2017,84,20:45,21:00,,,0,28.72,28.72,0,-60251,38324,98575,-21927,0,0,349,0,0,,349,349
26,06/24/2017,85,21:00,21:15,,,0,37.78,37.78,0,-70701,14994,85695,-55707,0,0,0,0,0,,0,0
26,06/24/2017,86,21:15,21:30,,,0,37.77,37.77,0,-56563,20689,77252,-35874,0,0,0,0,0,,0,0
26,06/24/2017,87,21:30,21:45,,,0,37.77,37.77,0,-66886,27669,94555,-39217,0,0,0,0,0,,0,0
26,06/24/2017,88,21:45,22:00,,,0,37.77,37.77,0,-65529,23294,88823,-42235,0,0,0,0,0,,0,0
26,06/24/2017,89,22:00,22:15,,25.66,0,25.66,25.66,-1,-42794,65980,108774,23186,0,-2596,0,0,0,,2596,-2596
26,06/24/2017,90,22:15,22:30,,26.79,0,26.79,26.79,-1,-53557,49222,102779,-4335,0,-2875,0,0,0,,2875,-2875
26,06/24/2017,91,22:30,22:45,37.94,26.79,0,37.94,37.94,1,-78106,41796,119902,-36310,0,-355,7628,0,0,,7983,7273
26,06/24/2017,92,22:45,23:00,31.66,,0,31.66,31.66,1,-105877,53084,158961,-52793,0,0,17654,0,0,,17654,17654
26,06/24/2017,93,23:00,23:15,31.66,26.99,0,26.99,26.99,-1,-26959,77848,104807,50889,0,-1789,2356,0,0,,4145,567
26,06/24/2017,94,23:15,23:30,,20.66,0,20.66,20.66,-1,-21873,80652,102525,58779,0,-3652,0,0,0,,3652,-3652
26,06/24/2017,95,23:30,23:45,,20.66,0,20.66,20.66,-1,-15482,110241,125723,94759,0,-7483,0,0,0,,7483,-7483
26,06/24/2017,96,23:45,0:00,,-2.78,0,-2.78,-2.78,-1,-17854,125635,143489,107781,0,-20740,0,0,0,,20740,-20740
26,06/25/2017,1,0:00,0:15,27.57,25.7,0,27.57,27.57,1,-61768,74217,135985,12449,0,-11653,832,0,0,,12485,-10821
26,06/25/2017,2,0:15,0:30,27.57,24.97,0,24.97,24.97,-1,-40723,76864,117587,36141,0,-1860,36,0,0,,1896,-1824
26,06/25/2017,3,0:30,0:45,,25.7,0,25.7,25.7,-1,-41906,60755,102661,18849,0,-3682,0,0,0,,3682,-3682
26,06/25/2017,4,0:45,1:00,,15.7,0,15.7,15.7,-1,-31015,66476,97491,35461,0,-8230,0,0,0,,8230,-8230
26,06/25/2017,5,1:00,1:15,,15.34,0,15.34,15.34,-1,-26983,76922,103905,49939,0,-11110,0,0,0,,11110,-11110
26,06/25/2017,6,1:15,1:30,,,0,27.35,27.35,0,-17114,57547,74661,40433,0,-405,0,0,0,,405,-405
26,06/25/2017,7,1:30,1:45,,,0,27.35,27.35,0,-14290,71470,85760,57180,0,0,0,0,0,,0,0
26,06/25/2017,8,1:45,2:00,,27.99,0,27.99,27.99,-1,-18267,69692,87959,51425,0,-421,0,0,0,,421,-421
26,06/25/2017,9,2:00,2:15,,27.99,0,27.99,27.99,-1,-38449,91563,130012,53114,0,-1055,0,0,0,,1055,-1055
26,06/25/2017,10,2:15,2:30,,28.99,0,28.99,28.99,-1,-38823,100681,139504,61858,0,-90,0,0,0,,90,-90
26,06/25/2017,11,2:30,2:45,,,0,27.35,27.35,0,-28966,94808,123774,65842,0,0,0,0,0,,0,0
26,06/25/2017,12,2:45,3:00,,27.59,0,27.59,27.59,-1,-22656,92064,114720,69408,0,-430,0,0,0,,430,-430
26,06/25/2017,13,3:00,3:15,,27.59,0,27.59,27.59,-1,-36004,90355,126359,54351,0,-2102,0,0,0,,2102,-2102
26,06/25/2017,14,3:15,3:30,,28.99,0,28.99,28.99,-1,-33776,75759,109535,41983,0,-120,0,0,0,,120,-120
26,06/25/2017,15,3:30,3:45,,,0,27.35,27.35,0,-31262,74509,105771,43247,0,0,0,0,0,,0,0
26,06/25/2017,16,3:45,4:00,,,0,27.35,27.35,0,-27215,44804,72019,17589,0,0,0,0,0,,0,0
26,06/25/2017,17,4:00,4:15,,,0,27.35,27.35,0,-26302,72677,98979,46375,0,0,0,0,0,,0,0
26,06/25/2017,18,4:15,4:30,,,0,27.35,27.35,0,-40069,44973,85042,4904,0,0,0,0,0,,0,0
26,06/25/2017,19,4:30,4:45,,,0,27.35,27.35,0,-40052,51031,91083,10979,0,0,0,0,0,,0,0
26,06/25/2017,20,4:45,5:00,25.7,,0,25.7,25.7,1,-59724,47167,106891,-12557,0,0,535,0,0,,535,535
26,06/25/2017,21,5:00,5:15,25.7,,0,25.7,25.7,1,-54982,95415,150397,40433,0,0,371,0,0,,371,371
26,06/25/2017,22,5:15,5:30,,27.59,0,27.59,27.59,-1,-48925,73686,122611,24761,0,-1903,0,0,0,,1903,-1903
26,06/25/2017,23,5:30,5:45,,27.59,0,27.59,27.59,-1,-46587,76557,123144,29970,0,-208,0,0,0,,208,-208
26,06/25/2017,24,5:45,6:00,,25.7,0,25.7,25.7,-1,-39328,66401,105729,27073,0,-6212,0,0,0,,6212,-6212
26,06/25/2017,25,6:00,6:15,,27.59,0,27.59,27.59,-1,-38299,72206,110505,33907,0,-4433,0,0,0,,4433,-4433
26,06/25/2017,26,6:15,6:30,27.15,27.59,0,27.15,27.15,1,-43809,51515,95324,7706,0,-15,284,0,0,,299,269
26,06/25/2017,27,6:30,6:45,27.54,,0,27.54,27.54,1,-53116,49355,102471,-3761,0,0,2748,0,0,,2748,2748
26,06/25/2017,28,6:45,7:00,25.7,,0,25.7,25.7,1,-44115,42759,86874,-1356,0,0,1118,0,0,,1118,1118
26,06/25/2017,29,7:00,7:15,27.16,,0,27.16,27.16,1,-62569,57381,119950,-5188,0,0,1691,0,0,,1691,1691
26,06/25/2017,30,7:15,7:30,25.7,,0,25.7,25.7,1,-37466,49369,86835,11903,0,0,986,0,0,,986,986
26,06/25/2017,31,7:30,7:45,29.11,,0,29.11,29.11,1,-50350,36500,86850,-13850,0,0,4346,0,0,,4346,4346
26,06/25/2017,32,7:45,8:00,27.55,,0,27.55,27.55,1,-48770,38712,87482,-10058,0,0,6763,0,0,,6763,6763
26,06/25/2017,33,8:00,8:15,27.55,26.71,0,26.71,26.71,-1,-65989,72798,138787,6809,0,-689,1374,0,0,,2063,685
26,06/25/2017,34,8:15,8:30,,25.7,0,25.7,25.7,-1,-36022,47449,83471,11427,0,-2607,0,0,0,,2607,-2607
26,06/25/2017,35,8:30,8:45,,23.8,0,23.8,23.8,-1,-45845,69846,115691,24001,0,-16710,0,0,0,,16710,-16710
26,06/25/2017,36,8:45,9:00,,23.8,0,23.8,23.8,-1,-47845,83440,131285,35595,0,-21156,0,0,0,,21156,-21156
26,06/25/2017,37,9:00,9:15,31.7,27.59,0,31.7,27.35,2,-111129,57897,169026,-53232,0,-8255,1221,0,0,,9476,-7034
26,06/25/2017,38,9:15,9:30,,3.74,0,3.74,3.74,-1,-64344,76883,141227,12539,0,-9236,0,0,0,,9236,-9236
26,06/25/2017,39,9:30,9:45,,-3.99,0,-3.99,-3.99,-1,-59687,83641,143328,23954,0,-32538,0,0,0,,32538,-32538
26,06/25/2017,40,9:45,10:00,,24.7,0,24.7,24.7,-1,-72053,99993,172046,27940,0,-22767,0,0,0,,22767,-22767
26,06/25/2017,41,10:00,10:15,114.15,25.7,0,114.15,114.15,1,-134092,68436,202528,-65656,0,-10161,15412,0,0,,25573,5251
26,06/25/2017,42,10:15,10:30,33.56,,0,33.56,33.56,1,-102057,82875,184932,-19182,0,0,22676,0,0,,22676,22676
26,06/25/2017,43,10:30,10:45,33.56,26.79,0,26.79,26.79,-1,-106844,105969,212813,-875,0,-1075,1132,0,0,,2207,57
26,06/25/2017,44,10:45,11:00,,-27.4,0,-27.4,-27.4,-1,-81816,148958,230774,67142,0,-28099,0,0,0,,28099,-28099
26,06/25/2017,45,11:00,11:15,33.56,25.7,0,33.56,25.7,2,-47901,36257,84158,-11644,0,-6937,4646,0,0,,11583,-2291
26,06/25/2017,46,11:15,11:30,52.11,,0,52.11,52.11,1,-52599,34026,86625,-18573,0,0,26777,0,0,,26777,26777
26,06/25/2017,47,11:30,11:45,30.15,,0,30.15,30.15,1,-50233,64831,115064,14598,0,0,13389,0,0,,13389,13389
26,06/25/2017,48,11:45,12:00,49.27,,0,49.27,49.27,1,-78396,69717,148113,-8679,0,0,19036,0,0,,19036,19036
26,06/25/2017,49,12:00,12:15,180.7,,0,180.7,180.7,1,-89713,63720,153433,-25993,0,0,58315,0,0,,58315,58315
26,06/25/2017,50,12:15,12:30,116.11,,0,116.11,116.11,1,-82160,64449,146609,-17711,0,0,50109,0,0,,50109,50109
26,06/25/2017,51,12:30,12:45,180.7,,0,180.7,180.7,1,-106950,72348,179298,-34602,0,0,69228,0,0,,69228,69228
26,06/25/2017,52,12:45,13:00,42.11,,0,42.11,42.11,1,-92594,77043,169637,-15551,0,0,55980,0,0,,55980,55980
26,06/25/2017,53,13:00,13:15,166.86,,0,166.86,166.86,1,-103597,55795,159392,-47802,0,0,62129,0,0,,62129,62129
26,06/25/2017,54,13:15,13:30,35.79,,0,35.79,35.79,1,-92302,76701,169003,-15601,0,0,40318,0,0,,40318,40318
26,06/25/2017,55,13:30,13:45,31.7,,0,31.7,31.7,1,-76787,66908,143695,-9879,0,0,22046,0,0,,22046,22046
26,06/25/2017,56,13:45,14:00,37.7,,0,37.7,37.7,1,-81180,53692,134872,-27488,0,0,23218,0,0,,23218,23218
26,06/25/2017,57,14:00,14:15,232.17,,0,232.17,232.17,1,-85603,20843,106446,-64760,0,0,59957,0,0,,59957,59957
26,06/25/2017,58,14:15,14:30,98.68,,0,98.68,98.68,1,-91364,57899,149263,-33465,0,0,60774,0,0,,60774,60774
26,06/25/2017,59,14:30,14:45,60.53,,0,60.53,60.53,1,-116465,75069,191534,-41396,0,0,46211,0,0,,46211,46211
26,06/25/2017,60,14:45,15:00,74.11,,0,74.11,74.11,1,-125511,88699,214210,-36812,0,0,50017,0,0,,50017,50017
26,06/25/2017,61,15:00,15:15,52.7,,0,52.7,52.7,1,-116850,99340,216190,-17510,0,0,43150,0,0,,43150,43150
26,06/25/2017,62,15:15,15:30,228.44,,0,228.44,228.44,1,-127675,75725,203400,-51950,0,0,42340,0,0,,42340,42340
26,06/25/2017,63,15:30,15:45,60.14,,0,60.14,60.14,1,-105173,90741,195914,-14432,0,0,41728,0,0,,41728,41728
26,06/25/2017,64,15:45,16:00,31.32,27.94,0,31.32,27.94,2,-82213,74733,156946,-7480,0,-90,4002,0,0,,4092,3912
26,06/25/2017,65,16:00,16:15,,,0,28.13,28.13,0,-59535,123776,183311,64241,0,0,0,0,0,,0,0
26,06/25/2017,66,16:15,16:30,31.32,,0,31.32,31.32,1,-59358,86466,145824,27108,0,0,673,0,0,,673,673
26,06/25/2017,67,16:30,16:45,27.66,27.59,0,28.13,27.59,2,-64250,91465,155715,27215,0,-1081,320,0,0,,1401,-761
26,06/25/2017,68,16:45,17:00,37.11,27.59,0,37.11,27.59,2,-67613,73595,141208,5982,0,-574,3062,0,0,,3636,2488
26,06/25/2017,69,17:00,17:15,37.11,23.89,0,23.89,23.89,-1,-62948,150083,213031,87135,0,-6485,409,0,0,,6894,-6076
26,06/25/2017,70,17:15,17:30,,25.7,0,25.7,25.7,-1,-67333,142138,209471,74805,0,-12463,0,0,0,,12463,-12463
26,06/25/2017,71,17:30,17:45,,,0,27.35,27.35,0,-67983,121348,189331,53365,0,-835,0,0,0,,835,-835
26,06/25/2017,72,17:45,18:00,,,0,27.35,27.35,0,-72012,121787,193799,49775,0,0,0,0,0,,0,0
26,06/25/2017,73,18:00,18:15,,24.7,0,24.7,24.7,-1,-81843,93688,175531,11845,0,-5931,0,0,0,,5931,-5931
26,06/25/2017,74,18:15,18:30,,27.55,0,27.55,27.55,-1,-62342,98229,160571,35887,0,-6581,0,0,0,,6581,-6581
26,06/25/2017,75,18:30,18:45,,,0,27.35,27.35,0,-60508,101621,162129,41113,0,-1189,0,0,0,,1189,-1189
26,06/25/2017,76,18:45,19:00,,,0,27.35,27.35,0,-81668,113161,194829,31493,0,0,0,0,0,,0,0
26,06/25/2017,77,19:00,19:15,,28.02,0,28.02,28.02,-1,-82070,88622,170692,6552,0,-176,0,0,0,,176,-176
26,06/25/2017,78,19:15,19:30,,27.59,0,27.59,27.59,-1,-60113,96612,156725,36499,0,-2339,0,0,0,,2339,-2339
26,06/25/2017,79,19:30,19:45,,,0,27.35,27.35,0,-54415,107193,161608,52778,0,-301,0,0,0,,301,-301
26,06/25/2017,80,19:45,20:00,,27.59,0,27.59,27.59,-1,-50154,115047,165201,64893,0,-744,0,0,0,,744,-744
26,06/25/2017,81,20:00,20:15,,20.7,0,20.7,20.7,-1,-43110,108199,151309,65089,0,-3560,0,0,0,,3560,-3560
26,06/25/2017,82,20:15,20:30,,20,0,20,20,-1,-41680,114736,156416,73056,0,-14543,0,0,0,,14543,-14543
26,06/25/2017,83,20:30,20:45,,15.7,0,15.7,15.7,-1,-53993,114299,168292,60306,0,-23835,0,0,0,,23835,-23835
26,06/25/2017,84,20:45,21:00,,23.87,0,23.87,23.87,-1,-47459,100347,147806,52888,0,-28726,0,0,0,,28726,-28726
26,06/25/2017,85,21:00,21:15,,22.58,0,22.58,22.58,-1,-52796,63606,116402,10810,0,-24448,0,0,0,,24448,-24448
26,06/25/2017,86,21:15,21:30,27.7,27.94,0,27.7,27.7,1,-73295,68589,141884,-4706,0,-7214,747,0,0,,7961,-6467
26,06/25/2017,87,21:30,21:45,27.7,,0,27.7,27.7,1,-69514,68779,138293,-735,0,0,1230,0,0,,1230,1230
26,06/25/2017,88,21:45,22:00,,,0,27.35,27.35,0,-78074,73965,152039,-4109,0,0,0,0,0,,0,0
26,06/25/2017,89,22:00,22:15,,27.59,0,27.59,27.59,-1,-102973,94874,197847,-8099,0,-928,0,0,0,,928,-928
26,06/25/2017,90,22:15,22:30,,27.99,0,27.99,27.99,-1,-120380,70102,190482,-50278,0,-817,0,0,0,,817,-817
26,06/25/2017,91,22:30,22:45,29.24,,0,29.24,29.24,1,-127425,79219,206644,-48206,0,0,1396,0,0,,1396,1396
26,06/25/2017,92,22:45,23:00,28.2,,0,28.2,28.2,1,-108479,86949,195428,-21530,0,0,1941,0,0,,1941,1941
26,06/25/2017,93,23:00,23:15,253.72,,0,253.72,253.72,1,-118568,60678,179246,-57890,0,0,16026,0,0,,16026,16026
26,06/25/2017,94,23:15,23:30,31.32,,0,31.32,31.32,1,-80627,55733,136360,-24894,0,0,9026,0,0,,9026,9026
26,06/25/2017,95,23:30,23:45,,,0,28.35,28.35,0,-76214,65876,142090,-10338,0,0,32,0,0,,32,32
26,06/25/2017,96,23:45,0:00,,24.7,0,24.7,24.7,-1,-82844,92102,174946,9258,0,-5012,0,0,0,,5012,-5012
26,06/26/2017,1,0:00,0:15,350,24.7,0,350,350,1,-119947,31036,150983,-88911,0,-3346,17554,0,0,,20900,14208
26,06/26/2017,2,0:15,0:30,74.66,,0,74.66,74.66,1,-112287,21209,133496,-91078,0,0,23039,0,0,,23039,23039
26,06/26/2017,3,0:30,0:45,350,,0,350,350,1,-181060,29796,210856,-151264,0,0,21394,0,0,,21394,21394
26,06/26/2017,4,0:45,1:00,45.79,,0,45.79,45.79,1,-143330,34424,177754,-108906,0,0,23204,0,0,,23204,23204
26,06/26/2017,5,1:00,1:15,31.7,29.74,0,31.7,27.72,2,-95420,83782,179202,-11638,0,-5,2046,0,0,,2051,2041
26,06/26/2017,6,1:15,1:30,37.74,,0,37.74,37.74,1,-65913,32431,98344,-33482,0,0,7573,0,0,,7573,7573
26,06/26/2017,7,1:30,1:45,31.7,,0,31.7,31.7,1,-73381,28859,102240,-44522,0,0,8795,0,0,,8795,8795
26,06/26/2017,8,1:45,2:00,31.7,25.7,0,25.7,25.7,-1,-57842,25103,82945,-32739,0,-6,1448,0,0,,1454,1442
26,06/26/2017,9,2:00,2:15,31.7,25.7,0,31.7,25.7,2,-43578,39397,82975,-4181,0,-433,695,0,0,,1128,262
26,06/26/2017,10,2:15,2:30,27.7,,0,27.7,27.7,1,-42392,41929,84321,-463,0,0,3408,0,0,,3408,3408
26,06/26/2017,11,2:30,2:45,27.7,16.74,0,16.74,16.74,-1,-35282,77938,113220,42656,0,-9246,539,0,0,,9785,-8707
26,06/26/2017,12,2:45,3:00,,20.7,0,20.7,20.7,-1,-45382,69413,114795,24031,0,-16948,0,0,0,,16948,-16948
26,06/26/2017,13,3:00,3:15,25.7,20.78,0,25.7,25.7,1,-43065,42032,85097,-1033,0,-8921,31,0,0,,8952,-8890
26,06/26/2017,14,3:15,3:30,31.7,20.78,0,31.7,31.7,1,-45361,31313,76674,-14048,0,-71,154,0,0,,225,83
26,06/26/2017,15,3:30,3:45,,,0,27.72,27.72,0,-52242,33614,85856,-18628,0,0,0,0,0,,0,0
26,06/26/2017,16,3:45,4:00,,,0,27.72,27.72,0,-55601,45456,101057,-10145,0,0,0,0,0,,0,0
26,06/26/2017,17,4:00,4:15,70.45,,0,70.45,70.45,1,-86126,35930,122056,-50196,0,0,10629,0,0,,10629,10629
26,06/26/2017,18,4:15,4:30,25.7,,0,25.7,25.7,1,-81874,54333,136207,-27541,0,0,3111,0,0,,3111,3111
26,06/26/2017,19,4:30,4:45,31.7,,0,31.7,31.7,1,-72188,39878,112066,-32310,0,0,4474,0,0,,4474,4474
26,06/26/2017,20,4:45,5:00,27.7,,0,27.7,27.7,1,-52226,46501,98727,-5725,0,0,2345,0,0,,2345,2345
26,06/26/2017,21,5:00,5:15,27.7,,0,27.7,27.7,1,-85992,20212,106204,-65780,0,0,2176,0,0,,2176,2176
26,06/26/2017,22,5:15,5:30,25.7,25.7,0,27.72,25.7,2,-46868,20837,67705,-26031,0,-2,265,0,0,,267,263
26,06/26/2017,23,5:30,5:45,,13.48,0,13.48,13.48,-1,-36190,63495,99685,27305,0,-10541,0,0,0,,10541,-10541
26,06/26/2017,24,5:45,6:00,,24.7,0,24.7,24.7,-1,-44056,92727,136783,48671,0,-5351,0,0,0,,5351,-5351
26,06/26/2017,25,6:00,6:15,43.12,24.7,0,43.12,43.12,1,-154793,41198,195991,-113595,0,-144,2252,0,0,,2396,2108
26,06/26/2017,26,6:15,6:30,27.12,,0,27.12,27.12,1,-103620,69921,173541,-33699,0,0,895,0,0,,895,895
26,06/26/2017,27,6:30,6:45,27.85,,0,27.85,27.85,1,-80266,56622,136888,-23644,0,0,809,0,0,,809,809
26,06/26/2017,28,6:45,7:00,27.85,,0,27.85,27.85,1,-55950,65095,121045,9145,0,0,2023,0,0,,2023,2023
26,06/26/2017,29,7:00,7:15,27.85,25.74,0,25.74,25.74,-1,-98362,88047,186409,-10315,0,-1491,41,0,0,,1532,-1450
26,06/26/2017,30,7:15,7:30,29.43,25.85,0,29.43,25.85,2,-92829,79979,172808,-12850,0,-1339,25,0,0,,1364,-1314
26,06/26/2017,31,7:30,7:45,45.43,,0,45.43,45.43,1,-110290,34405,144695,-75885,0,0,8447,0,0,,8447,8447
26,06/26/2017,32,7:45,8:00,350,,0,350,350,1,-131393,50126,181519,-81267,0,0,37439,0,0,,37439,37439
26,06/26/2017,33,8:00,8:15,37.74,23.46,0,23.46,23.46,-1,-50707,134501,185208,83794,0,-319,14613,0,0,,14932,14294
26,06/26/2017,34,8:15,8:30,,25.85,0,25.85,25.85,-1,-46064,85675,131739,39611,0,-738,0,0,0,,738,-738
26,06/26/2017,35,8:30,8:45,,25.85,0,25.85,25.85,-1,-54150,67789,121939,13639,0,-787,0,0,0,,787,-787
26,06/26/2017,36,8:45,9:00,,25.85,0,25.85,25.85,-1,-55594,57412,113006,1818,0,-2815,0,0,0,,2815,-2815
26,06/26/2017,37,9:00,9:15,,18.35,0,18.35,18.35,-1,-47107,87342,134449,40235,0,-6981,0,0,0,,6981,-6981
26,06/26/2017,38,9:15,9:30,,20.85,0,20.85,20.85,-1,-42943,75946,118889,33003,0,-9980,0,0,0,,9980,-9980
26,06/26/2017,39,9:30,9:45,,10.56,0,10.56,10.56,-1,-41927,89779,131706,47852,0,-22240,0,0,0,,22240,-22240
26,06/26/2017,40,9:45,10:00,,17.91,0,17.91,17.91,-1,-48642,67180,115822,18538,0,-19528,0,0,0,,19528,-19528
26,06/26/2017,41,10:00,10:15,,24.85,0,24.85,24.85,-1,-42012,85201,127213,43189,0,-2475,0,0,0,,2475,-2475
26,06/26/2017,42,10:15,10:30,,24.85,0,24.85,24.85,-1,-56007,98237,154244,42230,0,-3324,0,0,0,,3324,-3324
26,06/26/2017,43,10:30,10:45,,24.85,0,24.85,24.85,-1,-54343,88056,142399,33713,0,-1291,0,0,0,,1291,-1291
26,06/26/2017,44,10:45,11:00,,21.74,0,21.74,21.74,-1,-44806,92491,137297,47685,0,-711,0,0,0,,711,-711
26,06/26/2017,45,11:00,11:15,,24.85,0,24.85,24.85,-1,-58422,99240,157662,40818,0,-2659,0,0,0,,2659,-2659
26,06/26/2017,46,11:15,11:30,,26.55,0,26.55,26.55,-1,-57860,94843,152703,36983,0,-738,0,0,0,,738,-738
26,06/26/2017,47,11:30,11:45,,,0,27.8,27.8,0,-55024,97608,152632,42584,0,0,0,0,0,,0,0
26,06/26/2017,48,11:45,12:00,,20.85,0,20.85,20.85,-1,-56179,97781,153960,41602,0,-1215,0,0,0,,1215,-1215
26,06/26/2017,49,12:00,12:15,,3.26,0,3.26,3.26,-1,-69472,99430,168902,29958,0,-16965,0,0,0,,16965,-16965
26,06/26/2017,50,12:15,12:30,,20.85,0,20.85,20.85,-1,-77066,104311,181377,27245,0,-17438,0,0,0,,17438,-17438
26,06/26/2017,51,12:30,12:45,,17.18,0,17.18,17.18,-1,-81304,124743,206047,43439,0,-32037,0,0,0,,32037,-32037
26,06/26/2017,52,12:45,13:00,,21.74,0,21.74,21.74,-1,-95784,117823,213607,22039,0,-28640,0,0,0,,28640,-28640
26,06/26/2017,53,13:00,13:15,37.85,21.74,0,37.85,21.74,2,-96869,83873,180742,-12996,0,-15024,1739,0,0,,16763,-13285
26,06/26/2017,54,13:15,13:30,40.74,21.74,0,40.74,40.74,1,-95152,82151,177303,-13001,0,-340,6411,0,0,,6751,6071
26,06/26/2017,55,13:30,13:45,40.74,25.85,0,25.85,25.85,-1,-93299,85614,178913,-7685,0,-708,67,0,0,,775,-641
26,06/26/2017,56,13:45,14:00,,26.66,0,26.66,26.66,-1,-88930,86215,175145,-2715,0,-189,0,0,0,,189,-189
26,06/26/2017,57,14:00,14:15,112.01,,0,112.01,112.01,1,-106300,49614,155914,-56686,0,0,13345,0,0,,13345,13345
26,06/26/2017,58,14:15,14:30,31.3,,0,31.3,31.3,1,-77174,58549,135723,-18625,0,0,13051,0,0,,13051,13051
26,06/26/2017,59,14:30,14:45,31.3,,0,31.3,31.3,1,-84296,69020,153316,-15276,0,0,1457,0,0,,1457,1457
26,06/26/2017,60,14:45,15:00,28.72,,0,28.72,28.72,1,-84825,58621,143446,-26204,0,0,1145,0,0,,1145,1145
26,06/26/2017,61,15:00,15:15,28.72,18.88,0,18.88,18.88,-1,-68086,147210,215296,79124,0,-6922,220,0,0,,7142,-6702
26,06/26/2017,62,15:15,15:30,,16.74,0,16.74,16.74,-1,-63933,112695,176628,48762,0,-18463,0,0,0,,18463,-18463
26,06/26/2017,63,15:30,15:45,,24.85,0,24.85,24.85,-1,-68216,99225,167441,31009,0,-11941,0,0,0,,11941,-11941
26,06/26/2017,64,15:45,16:00,27.85,24.85,0,27.85,27.85,1,-91617,98071,189688,6454,0,-243,75,0,0,,318,-168
26,06/26/2017,65,16:00,16:15,,16.74,0,16.74,16.74,-1,-65101,101893,166994,36792,0,-5630,0,0,0,,5630,-5630
26,06/26/2017,66,16:15,16:30,,17.4,0,17.4,17.4,-1,-49384,108508,157892,59124,0,-17422,0,0,0,,17422,-17422
26,06/26/2017,67,16:30,16:45,,17.4,0,17.4,17.4,-1,-35689,110791,146480,75102,0,-22746,0,0,0,,22746,-22746
26,06/26/2017,68,16:45,17:00,,20.85,0,20.85,20.85,-1,-45431,121331,166762,75900,0,-26424,0,0,0,,26424,-26424
26,06/26/2017,69,17:00,17:15,,23.39,0,23.39,23.39,-1,-43571,58493,102064,14922,0,-20526,0,0,0,,20526,-20526
26,06/26/2017,70,17:15,17:30,,16.74,0,16.74,16.74,-1,-35429,65773,101202,30344,0,-24970,0,0,0,,24970,-24970
26,06/26/2017,71,17:30,17:45,,24.85,0,24.85,24.85,-1,-44908,60130,105038,15222,0,-20084,0,0,0,,20084,-20084
26,06/26/2017,72,17:45,18:00,27.4,25.85,0,27.4,27.4,1,-54622,64307,118929,9685,0,-9250,14,0,0,,9264,-9236
26,06/26/2017,73,18:00,18:15,29.9,27.68,0,29.9,27.68,2,-67359,34139,101498,-33220,0,-1249,512,0,0,,1761,-737
26,06/26/2017,74,18:15,18:30,,24.85,0,24.85,24.85,-1,-49957,59001,108958,9044,0,-3906,0,0,0,,3906,-3906
26,06/26/2017,75,18:30,18:45,,25.85,0,25.85,25.85,-1,-48947,59938,108885,10991,0,-6030,0,0,0,,6030,-6030
26,06/26/2017,76,18:45,19:00,27.85,25.85,0,27.85,27.85,1,-55569,64725,120294,9156,0,-486,287,0,0,,773,-199
26,06/26/2017,77,19:00,19:15,27.01,,0,27.01,27.01,1,-45027,42177,87204,-2850,0,0,58,0,0,,58,58
26,06/26/2017,78,19:15,19:30,27.85,,0,27.85,27.85,1,-51921,37598,89519,-14323,0,0,553,0,0,,553,553
26,06/26/2017,79,19:30,19:45,27.85,,0,27.85,27.85,1,-55555,44341,99896,-11214,0,0,1192,0,0,,1192,1192
26,06/26/2017,80,19:45,20:00,27.85,,0,27.85,27.85,1,-64662,39880,104542,-24782,0,0,1816,0,0,,1816,1816
26,06/26/2017,81,20:00,20:15,29.37,,0,29.37,29.37,1,-68298,22838,91136,-45460,0,0,1776,0,0,,1776,1776
26,06/26/2017,82,20:15,20:30,27.85,,0,27.85,27.85,1,-66616,19979,86595,-46637,0,0,1635,0,0,,1635,1635
26,06/26/2017,83,20:30,20:45,26.92,,0,26.92,26.92,1,-64465,30890,95355,-33575,0,0,144,0,0,,144,144
26,06/26/2017,84,20:45,21:00,26.92,,0,26.92,26.92,1,-58504,47796,106300,-10708,0,0,49,0,0,,49,49
26,06/26/2017,85,21:00,21:15,30.55,,0,30.55,30.55,1,-62867,42172,105039,-20695,0,0,2140,0,0,,2140,2140
26,06/26/2017,86,21:15,21:30,27.85,28.07,0,28.33,28.07,2,-48397,51958,100355,3561,0,-1,3046,0,0,,3047,3045
26,06/26/2017,87,21:30,21:45,27.85,24.85,0,24.85,24.85,-1,-46224,68300,114524,22076,0,-6035,73,0,0,,6108,-5962
26,06/26/2017,88,21:45,22:00,,16.46,0,16.46,16.46,-1,-38868,78616,117484,39748,0,-32461,0,0,0,,32461,-32461
26,06/26/2017,89,22:00,22:15,,16.16,0,16.16,16.16,-1,-36608,58325,94933,21717,0,-35000,0,0,0,,35000,-35000
26,06/26/2017,90,22:15,22:30,27.85,16.16,0,27.85,27.85,1,-40378,31726,72104,-8652,0,-2970,1118,0,0,,4088,-1852
26,06/26/2017,91,22:30,22:45,,,0,28.33,28.33,0,-48048,45586,93634,-2462,0,0,27,0,0,,27,27
26,06/26/2017,92,22:45,23:00,,27.68,0,27.68,27.68,-1,-41803,55461,97264,13658,0,-388,0,0,0,,388,-388
26,06/26/2017,93,23:00,23:15,249.06,27.68,0,249.06,27.68,2,-81735,32636,114371,-49099,0,-478,15163,0,0,,15641,14685
26,06/26/2017,94,23:15,23:30,38.12,27.68,0,27.68,27.68,-1,-66134,52786,118920,-13348,0,-16,18796,0,0,,18812,18780
26,06/26/2017,95,23:30,23:45,38.12,24.85,0,24.85,24.85,-1,-47310,66840,114150,19530,0,-5767,444,0,0,,6211,-5323
26,06/26/2017,96,23:45,0:00,,16.38,0,16.38,16.38,-1,-40009,82027,122036,42018,0,-17863,0,0,0,,17863,-17863
26,06/27/2017,1,0:00,0:15,33.39,24.85,0,33.39,24.85,2,-105473,93662,199135,-11811,0,-11608,1825,0,0,,13433,-9783
26,06/27/2017,2,0:15,0:30,33.39,24.85,0,24.85,24.85,-1,-63425,78645,142070,15220,0,-2160,96,0,0,,2256,-2064
26,06/27/2017,3,0:30,0:45,,16.44,0,16.44,16.44,-1,-42930,88371,131301,45441,0,-28718,0,0,0,,28718,-28718
26,06/27/2017,4,0:45,1:00,,20.85,0,20.85,20.85,-1,-71601,118350,189951,46749,0,-38735,0,0,0,,38735,-38735
26,06/27/2017,5,1:00,1:15,103.02,23.72,0,103.02,23.72,2,-68622,46728,115350,-21894,0,-19577,5154,0,0,,24731,-14423
26,06/27/2017,6,1:15,1:30,26.96,25.85,0,25.85,25.85,-1,-54627,54990,109617,363,0,-172,2316,0,0,,2488,2144
26,06/27/2017,7,1:30,1:45,,22.74,0,22.74,22.74,-1,-39945,54042,93987,14097,0,-9723,0,0,0,,9723,-9723
26,06/27/2017,8,1:45,2:00,,22.74,0,22.74,22.74,-1,-37891,68399,106290,30508,0,-23688,0,0,0,,23688,-23688
26,06/27/2017,9,2:00,2:15,129.02,26.03,0,129.02,26.03,2,-63361,16628,79989,-46733,0,-10379,8436,0,0,,18815,-1943
26,06/27/2017,10,2:15,2:30,27.85,26.03,0,27.85,27.85,1,-39787,29681,69468,-10106,0,-1,8584,0,0,,8585,8583
26,06/27/2017,11,2:30,2:45,25.85,,0,25.85,25.85,1,-50634,39294,89928,-11340,0,0,746,0,0,,746,746
26,06/27/2017,12,2:45,3:00,26.93,,0,26.93,26.93,1,-41974,47694,89668,5720,0,0,1086,0,0,,1086,1086
26,06/27/2017,13,3:00,3:15,31.85,,0,31.85,31.85,1,-41359,30916,72275,-10443,0,0,5950,0,0,,5950,5950
26,06/27/2017,14,3:15,3:30,26.92,,0,26.92,26.92,1,-18561,32599,51160,14038,0,0,3140,0,0,,3140,3140
26,06/27/2017,15,3:30,3:45,,,0,27.8,27.8,0,-8892,48810,57702,39918,0,0,0,0,0,,0,0
26,06/27/2017,16,3:45,4:00,,28.26,0,28.26,28.26,-1,-11057,46621,57678,35564,0,-543,0,0,0,,543,-543
26,06/27/2017,17,4:00,4:15,,25.85,0,25.85,25.85,-1,-18712,35234,53946,16522,0,-1733,0,0,0,,1733,-1733
26,06/27/2017,18,4:15,4:30,,26.74,0,26.74,26.74,-1,-13899,36610,50509,22711,0,-3361,0,0,0,,3361,-3361
26,06/27/2017,19,4:30,4:45,,25.85,0,25.85,25.85,-1,-10841,30456,41297,19615,0,-1784,0,0,0,,1784,-1784
26,06/27/2017,20,4:45,5:00,,25.85,0,25.85,25.85,-1,-12038,35698,47736,23660,0,-5308,0,0,0,,5308,-5308
26,06/27/2017,21,5:00,5:15,,25.85,0,25.85,25.85,-1,-58308,52863,111171,-5445,0,-3517,0,0,0,,3517,-3517
26,06/27/2017,22,5:15,5:30,,22.74,0,22.74,22.74,-1,-29841,49415,79256,19574,0,-12498,0,0,0,,12498,-12498
26,06/27/2017,23,5:30,5:45,,20.85,0,20.85,20.85,-1,-12167,40408,52575,28241,0,-24194,0,0,0,,24194,-24194
26,06/27/2017,24,5:45,6:00,25.85,25.8,0,25.85,25.85,1,-23954,27401,51355,3447,0,-16322,70,0,0,,16392,-16252
26,06/27/2017,25,6:00,6:15,27.31,15.31,0,27.65,15.31,2,-59123,84360,143483,25237,0,-9095,800,0,0,,9895,-8295
26,06/27/2017,26,6:15,6:30,,-2.7,0,-2.7,-2.7,-1,-20952,80019,100971,59067,0,-59479,0,0,0,,59479,-59479
26,06/27/2017,27,6:30,6:45,,20.67,0,20.67,20.67,-1,-25502,35013,60515,9511,0,-22364,0,0,0,,22364,-22364
26,06/27/2017,28,6:45,7:00,27.49,20.67,0,27.49,27.49,1,-34666,39605,74271,4939,0,-441,1060,0,0,,1501,619
26,06/27/2017,29,7:00,7:15,27.49,-54.28,0,-54.28,-54.28,-1,-4358,132546,136904,128188,0,-46945,52,0,0,,46997,-46893
26,06/27/2017,30,7:15,7:30,,19.74,0,19.74,19.74,-1,-15371,74709,90080,59338,0,-39787,0,0,0,,39787,-39787
26,06/27/2017,31,7:30,7:45,27.1,19.74,0,28.42,19.74,2,-26740,44936,71676,18196,0,-31099,3,0,0,,31102,-31096
26,06/27/2017,32,7:45,8:00,36.19,19.74,0,36.19,36.19,1,-58666,48747,107413,-9919,0,-1910,4226,0,0,,6136,2316
26,06/27/2017,33,8:00,8:15,36.19,19.74,0,19.74,19.74,-1,-34260,103376,137636,69116,0,-7832,1348,0,0,,9180,-6484
26,06/27/2017,34,8:15,8:30,,26.45,0,26.45,26.45,-1,-40145,77553,117698,37408,0,-4933,0,0,0,,4933,-4933
26,06/27/2017,35,8:30,8:45,,26.84,0,26.84,26.84,-1,-27086,64890,91976,37804,0,-80,0,0,0,,80,-80
26,06/27/2017,36,8:45,9:00,,19.74,0,19.74,19.74,-1,-31794,61973,93767,30179,0,-5042,0,0,0,,5042,-5042
26,06/27/2017,37,9:00,9:15,,15.67,0,15.67,15.67,-1,-33274,101206,134480,67932,0,-24920,0,0,0,,24920,-24920
26,06/27/2017,38,9:15,9:30,,24.67,0,24.67,24.67,-1,-33324,90466,123790,57142,0,-20446,0,0,0,,20446,-20446
26,06/27/2017,39,9:30,9:45,,27.03,0,27.03,27.03,-1,-24678,75616,100294,50938,0,-6341,0,0,0,,6341,-6341
26,06/27/2017,40,9:45,10:00,,15.67,0,15.67,15.67,-1,-16723,72042,88765,55319,0,-7489,0,0,0,,7489,-7489
26,06/27/2017,41,10:00,10:15,,15.67,0,15.67,15.67,-1,-41948,94745,136693,52797,0,-13684,0,0,0,,13684,-13684
26,06/27/2017,42,10:15,10:30,,25.67,0,25.67,25.67,-1,-30517,80023,110540,49506,0,-3087,0,0,0,,3087,-3087
26,06/27/2017,43,10:30,10:45,,25.67,0,25.67,25.67,-1,-34307,63091,97398,28784,0,-1762,0,0,0,,1762,-1762
26,06/27/2017,44,10:45,11:00,,,0,28.42,28.42,0,-31933,53254,85187,21321,0,-1,0,0,0,,1,-1
26,06/27/2017,45,11:00,11:15,,,0,28.42,28.42,0,-14943,60429,75372,45486,0,0,0,0,0,,0,0
26,06/27/2017,46,11:15,11:30,,,0,28.42,28.42,0,-14224,74882,89106,60658,0,0,0,0,0,,0,0
26,06/27/2017,47,11:30,11:45,,29.74,0,29.74,29.74,-1,-15394,82341,97735,66947,0,-71,0,0,0,,71,-71
26,06/27/2017,48,11:45,12:00,,29.74,0,29.74,29.74,-1,-12979,83419,96398,70440,0,-95,0,0,0,,95,-95
26,06/27/2017,49,12:00,12:15,,,0,28.42,28.42,0,-22115,63858,85973,41743,0,0,0,0,0,,0,0
26,06/27/2017,50,12:15,12:30,,27,0,27,27,-1,-27021,83582,110603,56561,0,-442,0,0,0,,442,-442
26,06/27/2017,51,12:30,12:45,,27.03,0,27.03,27.03,-1,-26218,85453,111671,59235,0,-465,0,0,0,,465,-465
26,06/27/2017,52,12:45,13:00,,,0,28.42,28.42,0,-30847,74554,105401,43707,0,0,0,0,0,,0,0
26,06/27/2017,53,13:00,13:15,29.05,,0,29.05,29.05,1,-71255,72250,143505,995,0,0,289,0,0,,289,289
26,06/27/2017,54,13:15,13:30,34.67,,0,34.67,34.67,1,-93865,61437,155302,-32428,0,0,5513,0,0,,5513,5513
26,06/27/2017,55,13:30,13:45,247.8,,0,247.8,247.8,1,-105486,42214,147700,-63272,0,0,23804,0,0,,23804,23804
26,06/27/2017,56,13:45,14:00,39.67,24.67,0,24.67,24.67,-1,-97223,87795,185018,-9428,0,-217,19958,0,0,,20175,19741
26,06/27/2017,57,14:00,14:15,39.67,-54.28,0,-54.28,-54.28,-1,-30485,115211,145696,84726,0,-52943,524,0,0,,53467,-52419
26,06/27/2017,58,14:15,14:30,,16.62,0,16.62,16.62,-1,-34509,85947,120456,51438,0,-46950,0,0,0,,46950,-46950
26,06/27/2017,59,14:30,14:45,,19.74,0,19.74,19.74,-1,-45854,76111,121965,30257,0,-44592,0,0,0,,44592,-44592
26,06/27/2017,60,14:45,15:00,,20.67,0,20.67,20.67,-1,-44590,80348,124938,35758,0,-27634,0,0,0,,27634,-27634
26,06/27/2017,61,15:00,15:15,,24.67,0,24.67,24.67,-1,-28466,106224,134690,77758,0,-14953,0,0,0,,14953,-14953
26,06/27/2017,62,15:15,15:30,,,0,28.42,28.42,0,-30507,115449,145956,84942,0,-133,0,0,0,,133,-133
26,06/27/2017,63,15:30,15:45,,,0,28.42,28.42,0,-54208,120408,174616,66200,0,0,0,0,0,,0,0
26,06/27/2017,64,15:45,16:00,,,0,28.42,28.42,0,-50774,118158,168932,67384,0,0,0,0,0,,0,0
26,06/27/2017,65,16:00,16:15,,,0,28.42,28.42,0,-55141,101929,157070,46788,0,0,0,0,0,,0,0
26,06/27/2017,66,16:15,16:30,,,0,28.42,28.42,0,-48898,60219,109117,11321,0,0,0,0,0,,0,0
26,06/27/2017,67,16:30,16:45,27.67,26.66,0,26.66,26.66,-1,-57702,68336,126038,10634,0,-428,2,0,0,,430,-426
26,06/27/2017,68,16:45,17:00,28.14,26.66,0,28.14,28.14,1,-75930,48710,124640,-27220,0,-1541,69,0,0,,1610,-1472
26,06/27/2017,69,17:00,17:15,82.02,,0,82.02,82.02,1,-120011,48808,168819,-71203,0,0,6231,0,0,,6231,6231
26,06/27/2017,70,17:15,17:30,269.88,,0,269.88,269.88,1,-187051,62487,249538,-124564,0,0,63719,0,0,,63719,63719
26,06/27/2017,71,17:30,17:45,269.88,26,0,26,26,-1,-153686,136217,289903,-17469,0,-71,44762,0,0,,44833,44691
26,06/27/2017,72,17:45,18:00,27.67,26,0,27.67,27.67,1,-142486,141115,283601,-1371,0,-83,379,0,0,,462,296
26,06/27/2017,73,18:00,18:15,117.59,,0,117.59,117.59,1,-217343,80363,297706,-136980,0,0,15958,0,0,,15958,15958
26,06/27/2017,74,18:15,18:30,32.47,,0,32.47,32.47,1,-181341,89188,270529,-92153,0,0,10565,0,0,,10565,10565
26,06/27/2017,75,18:30,18:45,29.02,,0,29.02,29.02,1,-165610,83525,249135,-82085,0,0,2798,0,0,,2798,2798
26,06/27/2017,76,18:45,19:00,129.02,,0,129.02,129.02,1,-154759,82101,236860,-72658,0,0,14816,0,0,,14816,14816
26,06/27/2017,77,19:00,19:15,32.18,,0,32.18,32.18,1,-159388,114485,273873,-44903,0,0,13436,0,0,,13436,13436
26,06/27/2017,78,19:15,19:30,31.64,,0,31.64,31.64,1,-152486,102880,255366,-49606,0,0,10060,0,0,,10060,10060
26,06/27/2017,79,19:30,19:45,28.91,,0,28.91,28.91,1,-136407,94694,231101,-41713,0,0,1287,0,0,,1287,1287
26,06/27/2017,80,19:45,20:00,31.64,,0,31.64,31.64,1,-149869,80953,230822,-68916,0,0,4077,0,0,,4077,4077
26,06/27/2017,81,20:00,20:15,258.32,,0,258.32,258.32,1,-199584,77801,277385,-121783,0,0,34805,0,0,,34805,34805
26,06/27/2017,82,20:15,20:30,29.56,,0,29.56,29.56,1,-149841,100056,249897,-49785,0,0,17655,0,0,,17655,17655
26,06/27/2017,83,20:30,20:45,,,0,28.37,28.37,0,-121508,102268,223776,-19240,0,0,0,0,0,,0,0
26,06/27/2017,84,20:45,21:00,,,0,28.37,28.37,0,-113162,109271,222433,-3891,0,0,0,0,0,,0,0
26,06/27/2017,85,21:00,21:15,247.25,,0,247.25,247.25,1,-174138,65370,239508,-108768,0,0,22454,0,0,,22454,22454
26,06/27/2017,86,21:15,21:30,247.25,,0,247.25,247.25,1,-154340,88915,243255,-65425,0,0,46763,0,0,,46763,46763
26,06/27/2017,87,21:30,21:45,247.25,27,0,27,27,-1,-153302,131107,284409,-22195,0,-47,1723,0,0,,1770,1676
26,06/27/2017,88,21:45,22:00,,27,0,27,27,-1,-139394,122043,261437,-17351,0,-621,0,0,0,,621,-621
26,06/27/2017,89,22:00,22:15,,27.87,0,27.87,27.87,-1,-154073,83702,237775,-70371,0,-317,0,0,0,,317,-317
26,06/27/2017,90,22:15,22:30,27.67,,0,27.67,27.67,1,-148517,68700,217217,-79817,0,0,386,0,0,,386,386
26,06/27/2017,91,22:30,22:45,25.67,,0,25.67,25.67,1,-133676,70972,204648,-62704,0,0,26,0,0,,26,26
26,06/27/2017,92,22:45,23:00,25.67,,0,25.67,25.67,1,-157396,81984,239380,-75412,0,0,449,0,0,,449,449
26,06/27/2017,93,23:00,23:15,,25.89,0,25.89,25.89,-1,-123773,106189,229962,-17584,0,-896,0,0,0,,896,-896
26,06/27/2017,94,23:15,23:30,,26.93,0,26.93,26.93,-1,-142664,59987,202651,-82677,0,-93,0,0,0,,93,-93
26,06/27/2017,95,23:30,23:45,,,0,27.71,27.71,0,-142166,69866,212032,-72300,0,0,0,0,0,,0,0
26,06/27/2017,96,23:45,0:00,,,0,27.71,27.71,0,-131941,44966,176907,-86975,0,0,0,0,0,,0,0
26,06/28/2017,1,0:00,0:15,32.58,,0,32.58,32.58,1,-154544,87907,242451,-66637,0,0,3123,0,0,,3123,3123
26,06/28/2017,2,0:15,0:30,38.26,,0,38.26,38.26,1,-142740,63179,205919,-79561,0,0,17618,0,0,,17618,17618
26,06/28/2017,3,0:30,0:45,28.04,,0,28.04,28.04,1,-144296,53803,198099,-90493,0,0,3948,0,0,,3948,3948
26,06/28/2017,4,0:45,1:00,27.08,,0,27.08,27.08,1,-156974,65819,222793,-91155,0,0,2841,0,0,,2841,2841
26,06/28/2017,5,1:00,1:15,187.38,,0,187.38,187.38,1,-134729,63476,198205,-71253,0,0,23092,0,0,,23092,23092
26,06/28/2017,6,1:15,1:30,52.12,,0,52.12,52.12,1,-107199,83467,190666,-23732,0,0,40988,0,0,,40988,40988
26,06/28/2017,7,1:30,1:45,,,0,27.42,27.42,0,-112427,98090,210517,-14337,0,0,2331,0,0,,2331,2331
26,06/28/2017,8,1:45,2:00,,,0,27.42,27.42,0,-118040,94404,212444,-23636,0,0,0,0,0,,0,0
26,06/28/2017,9,2:00,2:15,50.6,27.13,0,50.6,27.13,2,-111337,88839,200176,-22498,0,-145,5575,0,0,,5720,5430
26,06/28/2017,10,2:15,2:30,54.97,,0,54.97,54.97,1,-117437,98749,216186,-18688,0,0,30039,0,0,,30039,30039
26,06/28/2017,11,2:30,2:45,28.04,,0,28.04,28.04,1,-115130,103812,218942,-11318,0,0,3358,0,0,,3358,3358
26,06/28/2017,12,2:45,3:00,,,0,27.42,27.42,0,-119764,110498,230262,-9266,0,0,0,0,0,,0,0
26,06/28/2017,13,3:00,3:15,,,0,27.42,27.42,0,-117512,92182,209694,-25330,0,0,0,0,0,,0,0
26,06/28/2017,14,3:15,3:30,,,0,27.42,27.42,0,-124249,82265,206514,-41984,0,0,0,0,0,,0,0
26,06/28/2017,15,3:30,3:45,28.1,,0,28.1,28.1,1,-120782,69498,190280,-51284,0,0,887,0,0,,887,887
26,06/28/2017,16,3:45,4:00,,,0,27.42,27.42,0,-124565,81381,205946,-43184,0,0,0,0,0,,0,0
26,06/28/2017,17,4:00,4:15,,,0,27.42,27.42,0,-116854,78527,195381,-38327,0,0,0,0,0,,0,0
26,06/28/2017,18,4:15,4:30,,,0,27.42,27.42,0,-121719,62495,184214,-59224,0,0,0,0,0,,0,0
26,06/28/2017,19,4:30,4:45,,,0,27.42,27.42,0,-125191,49927,175118,-75264,0,0,0,0,0,,0,0
26,06/28/2017,20,4:45,5:00,26.04,,0,26.04,26.04,1,-115918,42144,158062,-73774,0,0,86,0,0,,86,86
26,06/28/2017,21,5:00,5:15,,,0,27.42,27.42,0,-158941,73463,232404,-85478,0,0,19,0,0,,19,19
26,06/28/2017,22,5:15,5:30,26.04,,0,26.04,26.04,1,-145142,51495,196637,-93647,0,0,203,0,0,,203,203
26,06/28/2017,23,5:30,5:45,32.58,,0,32.58,32.58,1,-140595,30700,171295,-109895,0,0,1092,0,0,,1092,1092
26,06/28/2017,24,5:45,6:00,115.12,,0,115.12,115.12,1,-142951,24806,167757,-118145,0,0,32245,0,0,,32245,32245
26,06/28/2017,25,6:00,6:15,27.08,,0,27.08,27.08,1,-158816,75219,234035,-83597,0,0,4651,0,0,,4651,4651
26,06/28/2017,26,6:15,6:30,,,0,27.31,27.31,0,-129952,52447,182399,-77505,0,0,0,0,0,,0,0
26,06/28/2017,27,6:30,6:45,27.05,,0,27.05,27.05,1,-126918,48034,174952,-78884,0,0,26,0,0,,26,26
26,06/28/2017,28,6:45,7:00,34.2,,0,34.2,34.2,1,-138925,98424,237349,-40501,0,0,3533,0,0,,3533,3533
26,06/28/2017,29,7:00,7:15,44.64,,0,44.64,44.64,1,-179771,92548,272319,-87223,0,0,3052,0,0,,3052,3052
26,06/28/2017,30,7:15,7:30,44.64,,0,44.64,44.64,1,-164480,65724,230204,-98756,0,0,12237,0,0,,12237,12237
26,06/28/2017,31,7:30,7:45,57.12,,0,57.12,57.12,1,-162902,52794,215696,-110108,0,0,18042,0,0,,18042,18042
26,06/28/2017,32,7:45,8:00,250.48,,0,250.48,250.48,1,-189559,75270,264829,-114289,0,0,55701,0,0,,55701,55701
26,06/28/2017,33,8:00,8:15,250.48,18.59,0,18.59,18.59,-1,-109179,150920,260099,41741,0,-2020,25258,0,0,,27278,23238
26,06/28/2017,34,8:15,8:30,36.51,18.59,0,36.51,36.51,1,-116321,95961,212282,-20360,0,-50,5122,0,0,,5172,5072
26,06/28/2017,35,8:30,8:45,31.51,,0,31.51,31.51,1,-133429,81108,214537,-52321,0,0,12529,0,0,,12529,12529
26,06/28/2017,36,8:45,9:00,47.51,,0,47.51,47.51,1,-156128,49049,205177,-107079,0,0,13509,0,0,,13509,13509
26,06/28/2017,37,9:00,9:15,61.57,,0,61.57,61.57,1,-123280,77840,201120,-45440,0,0,18259,0,0,,18259,18259
26,06/28/2017,38,9:15,9:30,100.39,,0,100.39,100.39,1,-137091,66890,203981,-70201,0,0,26000,0,0,,26000,26000
26,06/28/2017,39,9:30,9:45,47.99,,0,47.99,47.99,1,-155047,64158,219205,-90889,0,0,29917,0,0,,29917,29917
26,06/28/2017,40,9:45,10:00,92.12,,0,92.12,92.12,1,-186121,59963,246084,-126158,0,0,21236,0,0,,21236,21236
26,06/28/2017,41,10:00,10:15,128.1,,0,128.1,128.1,1,-161138,91762,252900,-69376,0,0,39883,0,0,,39883,39883
26,06/28/2017,42,10:15,10:30,31.95,,0,31.95,31.95,1,-146201,89869,236070,-56332,0,0,12469,0,0,,12469,12469
26,06/28/2017,43,10:30,10:45,54.45,,0,54.45,54.45,1,-154481,92697,247178,-61784,0,0,15846,0,0,,15846,15846
26,06/28/2017,44,10:45,11:00,47.95,,0,47.95,47.95,1,-150851,91673,242524,-59178,0,0,29941,0,0,,29941,29941
26,06/28/2017,45,11:00,11:15,37.49,,0,37.49,37.49,1,-139421,122095,261516,-17326,0,0,18294,0,0,,18294,18294
26,06/28/2017,46,11:15,11:30,32.7,,0,32.7,32.7,1,-139983,121419,261402,-18564,0,0,2958,0,0,,2958,2958
26,06/28/2017,47,11:30,11:45,54.39,,0,54.39,54.39,1,-143034,109245,252279,-33789,0,0,10206,0,0,,10206,10206
26,06/28/2017,48,11:45,12:00,79.65,,0,79.65,79.65,1,-148946,116328,265274,-32618,0,0,34772,0,0,,34772,34772
26,06/28/2017,49,12:00,12:15,264.25,,0,264.25,264.25,1,-158769,92895,251664,-65874,0,0,41141,0,0,,41141,41141
26,06/28/2017,50,12:15,12:30,264.25,,0,264.25,264.25,1,-148606,106323,254929,-42283,0,0,62155,0,0,,62155,62155
26,06/28/2017,51,12:30,12:45,77.84,,0,77.84,77.84,1,-136448,118414,254862,-18034,0,0,9257,0,0,,9257,9257
26,06/28/2017,52,12:45,13:00,264.25,,0,264.25,264.25,1,-138324,104120,242444,-34204,0,0,42238,0,0,,42238,42238
26,06/28/2017,53,13:00,13:15,31.2,26.55,0,31.2,26.55,2,-125090,141795,266885,16705,0,-200,7913,0,0,,8113,7713
26,06/28/2017,54,13:15,13:30,47.2,,0,47.2,47.2,1,-132028,108632,240660,-23396,0,0,19200,0,0,,19200,19200
26,06/28/2017,55,13:30,13:45,47.2,,0,47.2,47.2,1,-144626,108942,253568,-35684,0,0,30504,0,0,,30504,30504
26,06/28/2017,56,13:45,14:00,64.12,,0,64.12,64.12,1,-147936,105857,253793,-42079,0,0,36938,0,0,,36938,36938
26,06/28/2017,57,14:00,14:15,64.12,16.73,0,16.73,16.73,-1,-130910,172588,303498,41678,0,-7175,12783,0,0,,19958,5608
26,06/28/2017,58,14:15,14:30,,26.09,0,26.09,26.09,-1,-135404,147772,283176,12368,0,-2754,0,0,0,,2754,-2754
26,06/28/2017,59,14:30,14:45,,28.79,0,28.79,28.79,-1,-138925,142185,281110,3260,0,-190,0,0,0,,190,-190
26,06/28/2017,60,14:45,15:00,27.82,,0,27.82,27.82,1,-149178,126504,275682,-22674,0,0,169,0,0,,169,169
26,06/28/2017,61,15:00,15:15,37.49,,0,37.49,37.49,1,-167471,104411,271882,-63060,0,0,10465,0,0,,10465,10465
26,06/28/2017,62,15:15,15:30,27.82,,0,27.82,27.82,1,-166092,107517,273609,-58575,0,0,6057,0,0,,6057,6057
26,06/28/2017,63,15:30,15:45,31.96,,0,31.96,31.96,1,-166878,99926,266804,-66952,0,0,5806,0,0,,5806,5806
26,06/28/2017,64,15:45,16:00,26.97,,0,26.97,26.97,1,-167970,98568,266538,-69402,0,0,2488,0,0,,2488,2488
26,06/28/2017,65,16:00,16:15,31.96,,0,31.96,31.96,1,-170498,89517,260015,-80981,0,0,5348,0,0,,5348,5348
26,06/28/2017,66,16:15,16:30,27.82,,0,27.82,27.82,1,-165666,94088,259754,-71578,0,0,3596,0,0,,3596,3596
26,06/28/2017,67,16:30,16:45,27.82,,0,27.82,27.82,1,-153170,98339,251509,-54831,0,0,3671,0,0,,3671,3671
26,06/28/2017,68,16:45,17:00,26.97,,0,26.97,26.97,1,-151754,96409,248163,-55345,0,0,440,0,0,,440,440
26,06/28/2017,69,17:00,17:15,82.99,,0,82.99,82.99,1,-163442,91996,255438,-71446,0,0,14148,0,0,,14148,14148
26,06/28/2017,70,17:15,17:30,44.4,,0,44.4,44.4,1,-159512,94230,253742,-65282,0,0,26107,0,0,,26107,26107
26,06/28/2017,71,17:30,17:45,29.23,,0,29.23,29.23,1,-142569,105084,247653,-37485,0,0,7445,0,0,,7445,7445
26,06/28/2017,72,17:45,18:00,28.4,,0,28.4,28.4,1,-131098,119808,250906,-11290,0,0,9086,0,0,,9086,9086
26,06/28/2017,73,18:00,18:15,28.12,,0,28.12,28.12,1,-146029,104274,250303,-41755,0,0,3777,0,0,,3777,3777
26,06/28/2017,74,18:15,18:30,,28.19,0,28.19,28.19,-1,-129093,119548,248641,-9545,0,-636,0,0,0,,636,-636
26,06/28/2017,75,18:30,18:45,,26.09,0,26.09,26.09,-1,-118223,133900,252123,15677,0,-2680,0,0,0,,2680,-2680
26,06/28/2017,76,18:45,19:00,,28.8,0,28.8,28.8,-1,-114555,136758,251313,22203,0,-292,0,0,0,,292,-292
26,06/28/2017,77,19:00,19:15,35,,0,35,35,1,-143848,119687,263535,-24161,0,0,4447,0,0,,4447,4447
26,06/28/2017,78,19:15,19:30,30.79,,0,30.79,30.79,1,-134396,88654,223050,-45742,0,0,12591,0,0,,12591,12591
26,06/28/2017,79,19:30,19:45,29.88,,0,29.88,29.88,1,-126678,89659,216337,-37019,0,0,10994,0,0,,10994,10994
26,06/28/2017,80,19:45,20:00,,,0,28.31,28.31,0,-131836,98250,230086,-33586,0,0,3010,0,0,,3010,3010
26,06/28/2017,81,20:00,20:15,29.88,,0,29.88,29.88,1,-151829,107372,259201,-44457,0,0,1159,0,0,,1159,1159
26,06/28/2017,82,20:15,20:30,28.95,,0,28.95,28.95,1,-132484,115554,248038,-16930,0,0,528,0,0,,528,528
26,06/28/2017,83,20:30,20:45,,24.82,0,24.82,24.82,-1,-121556,128253,249809,6697,0,-2261,0,0,0,,2261,-2261
26,06/28/2017,84,20:45,21:00,,24.82,0,24.82,24.82,-1,-119602,148645,268247,29043,0,-9241,0,0,0,,9241,-9241
26,06/28/2017,85,21:00,21:15,,25.78,0,25.78,25.78,-1,-138203,166327,304530,28124,0,-6733,0,0,0,,6733,-6733
26,06/28/2017,86,21:15,21:30,,,0,27.89,27.89,0,-132205,168965,301170,36760,0,-79,0,0,0,,79,-79
26,06/28/2017,87,21:30,21:45,,,0,27.88,27.88,0,-125535,187507,313042,61972,0,0,0,0,0,,0,0
26,06/28/2017,88,21:45,22:00,,28.79,0,28.79,28.79,-1,-120636,186466,307102,65830,0,-129,0,0,0,,129,-129
26,06/28/2017,89,22:00,22:15,,16.73,0,16.73,16.73,-1,-86449,115749,202198,29300,0,-11349,0,0,0,,11349,-11349
26,06/28/2017,90,22:15,22:30,26.97,28.58,0,26.97,26.97,1,-119419,99893,219312,-19526,0,-1685,116,0,0,,1801,-1569
26,06/28/2017,91,22:30,22:45,37.49,,0,37.49,37.49,1,-139087,96912,235999,-42175,0,0,9167,0,0,,9167,9167
26,06/28/2017,92,22:45,23:00,27.82,28.19,0,28.19,28.19,-1,-143737,115420,259157,-28317,0,-58,4027,0,0,,4085,3969
26,06/28/2017,93,23:00,23:15,36.02,28.65,0,36.02,27.88,2,-121658,128431,250089,6773,0,-119,4135,0,0,,4254,4016
26,06/28/2017,94,23:15,23:30,27.04,,0,27.04,27.04,1,-115567,112989,228556,-2578,0,0,4033,0,0,,4033,4033
26,06/28/2017,95,23:30,23:45,27.04,26.09,0,26.09,26.09,-1,-116643,131125,247768,14482,0,-2543,44,0,0,,2587,-2499
26,06/28/2017,96,23:45,0:00,,23.82,0,23.82,23.82,-1,-142353,164068,306421,21715,0,-4941,0,0,0,,4941,-4941
26,06/29/2017,1,0:00,0:15,,26.05,0,26.05,26.05,-1,-65548,47678,113226,-17870,0,-3419,0,0,0,,3419,-3419
26,06/29/2017,2,0:15,0:30,,24.64,0,24.64,24.64,-1,-41147,81303,122450,40156,0,-1892,0,0,0,,1892,-1892
26,06/29/2017,3,0:30,0:45,,24.39,0,24.39,24.39,-1,-71263,87250,158513,15987,0,-9980,0,0,0,,9980,-9980
26,06/29/2017,4,0:45,1:00,,16.93,0,16.93,16.93,-1,-72564,99430,171994,26866,0,-19423,0,0,0,,19423,-19423
26,06/29/2017,5,1:00,1:15,,16.93,0,16.93,16.93,-1,-35649,46443,82092,10794,0,-19386,0,0,0,,19386,-19386
26,06/29/2017,6,1:15,1:30,,20.64,0,20.64,20.64,-1,-16592,48585,65177,31993,0,-4677,0,0,0,,4677,-4677
26,06/29/2017,7,1:30,1:45,,16.93,0,16.93,16.93,-1,-20904,50989,71893,30085,0,-22016,0,0,0,,22016,-22016
26,06/29/2017,8,1:45,2:00,,20.64,0,20.64,20.64,-1,-37450,67403,104853,29953,0,-24646,0,0,0,,24646,-24646
26,06/29/2017,9,2:00,2:15,,24.64,0,24.64,24.64,-1,-30570,30534,61104,-36,0,-15663,0,0,0,,15663,-15663
26,06/29/2017,10,2:15,2:30,,,0,26.64,26.64,0,-30773,37584,68357,6811,0,-216,0,0,0,,216,-216
26,06/29/2017,11,2:30,2:45,,,0,26.64,26.64,0,-11143,51909,63052,40766,0,0,0,0,0,,0,0
26,06/29/2017,12,2:45,3:00,,20.64,0,20.64,20.64,-1,-15287,52626,67913,37339,0,-4124,0,0,0,,4124,-4124
26,06/29/2017,13,3:00,3:15,31.79,26.29,0,31.79,26.29,2,-81110,42409,123519,-38701,0,-2789,4700,0,0,,7489,1911
26,06/29/2017,14,3:15,3:30,27.79,,0,27.79,27.79,1,-50554,43754,94308,-6800,0,0,6440,0,0,,6440,6440
26,06/29/2017,15,3:30,3:45,,,0,26.64,26.64,0,-29969,43433,73402,13464,0,0,214,0,0,,214,214
26,06/29/2017,16,3:45,4:00,,26.29,0,26.29,26.29,-1,-36039,47793,83832,11754,0,-1558,0,0,0,,1558,-1558
26,06/29/2017,17,4:00,4:15,,,0,26.64,26.64,0,-75320,52363,127683,-22957,0,-271,0,0,0,,271,-271
26,06/29/2017,18,4:15,4:30,,27.03,0,27.03,27.03,-1,-49898,49907,99805,9,0,-742,0,0,0,,742,-742
26,06/29/2017,19,4:30,4:45,,26.29,0,26.29,26.29,-1,-25989,50596,76585,24607,0,-2912,0,0,0,,2912,-2912
26,06/29/2017,20,4:45,5:00,,,0,26.64,26.64,0,-15897,46498,62395,30601,0,-21,0,0,0,,21,-21
26,06/29/2017,21,5:00,5:15,,,0,26.64,26.64,0,-26918,59294,86212,32376,0,0,0,0,0,,0,0
26,06/29/2017,22,5:15,5:30,,,0,26.64,26.64,0,-13325,50041,63366,36716,0,0,0,0,0,,0,0
26,06/29/2017,23,5:30,5:45,,,0,26.26,26.26,0,-22055,38519,60574,16464,0,0,0,0,0,,0,0
26,06/29/2017,24,5:45,6:00,27.79,,0,27.79,27.79,1,-33363,35548,68911,2185,0,0,825,0,0,,825,825
26,06/29/2017,25,6:00,6:15,,,0,26.87,26.87,0,-51608,61738,113346,10130,0,0,249,0,0,,249,249
26,06/29/2017,26,6:15,6:30,,,0,26.87,26.87,0,-42087,48320,90407,6233,0,0,0,0,0,,0,0
26,06/29/2017,27,6:30,6:45,26.24,,0,26.24,26.24,1,-48561,50895,99456,2334,0,0,26,0,0,,26,26
26,06/29/2017,28,6:45,7:00,35.47,,0,35.47,35.47,1,-73878,63928,137806,-9950,0,0,9442,0,0,,9442,9442
26,06/29/2017,29,7:00,7:15,35.47,-53.79,0,-53.79,-53.79,-1,-31180,119876,151056,88696,0,-24260,2301,0,0,,26561,-21959
26,06/29/2017,30,7:15,7:30,,24.83,0,24.83,24.83,-1,-45127,79656,124783,34529,0,-7997,0,0,0,,7997,-7997
26,06/29/2017,31,7:30,7:45,31.9,24.83,0,31.9,31.9,1,-63858,78084,141942,14226,0,-321,326,0,0,,647,5
26,06/29/2017,32,7:45,8:00,36.9,,0,36.9,36.9,1,-100813,84935,185748,-15878,0,0,10157,0,0,,10157,10157
26,06/29/2017,33,8:00,8:15,36.9,-10.11,0,-10.11,-10.11,-1,-31466,95097,126563,63631,0,-19292,1050,0,0,,20342,-18242
26,06/29/2017,34,8:15,8:30,,27.19,0,27.19,27.19,-1,-66275,70829,137104,4554,0,-3423,0,0,0,,3423,-3423
26,06/29/2017,35,8:30,8:45,,25.41,0,25.41,25.41,-1,-58420,67385,125805,8965,0,-3861,0,0,0,,3861,-3861
26,06/29/2017,36,8:45,9:00,,25.41,0,25.41,25.41,-1,-95329,61682,157011,-33647,0,-420,0,0,0,,420,-420
26,06/29/2017,37,9:00,9:15,,5.49,0,5.49,5.49,-1,-31568,81257,112825,49689,0,-21103,0,0,0,,21103,-21103
26,06/29/2017,38,9:15,9:30,,24.41,0,24.41,24.41,-1,-47996,75437,123433,27441,0,-18703,0,0,0,,18703,-18703
26,06/29/2017,39,9:30,9:45,,24.21,0,24.21,24.21,-1,-53426,93308,146734,39882,0,-15519,0,0,0,,15519,-15519
26,06/29/2017,40,9:45,10:00,,24.21,0,24.21,24.21,-1,-51615,73430,125045,21815,0,-20029,0,0,0,,20029,-20029
26,06/29/2017,41,10:00,10:15,,25.41,0,25.41,25.41,-1,-47007,64506,111513,17499,0,-8644,0,0,0,,8644,-8644
26,06/29/2017,42,10:15,10:30,,25.41,0,25.41,25.41,-1,-50435,54275,104710,3840,0,-2904,0,0,0,,2904,-2904
26,06/29/2017,43,10:30,10:45,,27.19,0,27.19,27.19,-1,-51265,40302,91567,-10963,0,-2115,0,0,0,,2115,-2115
26,06/29/2017,44,10:45,11:00,,26.29,0,26.29,26.29,-1,-48168,36233,84401,-11935,0,-2814,0,0,0,,2814,-2814
26,06/29/2017,45,11:00,11:15,,,0,28.19,28.19,0,-68240,42550,110790,-25690,0,-320,0,0,0,,320,-320
26,06/29/2017,46,11:15,11:30,,,0,28.19,28.19,0,-63387,31655,95042,-31732,0,0,0,0,0,,0,0
26,06/29/2017,47,11:30,11:45,,,0,28.19,28.19,0,-62345,26590,88935,-35755,0,0,0,0,0,,0,0
26,06/29/2017,48,11:45,12:00,,,0,28.19,28.19,0,-74208,26260,100468,-47948,0,0,0,0,0,,0,0
26,06/29/2017,49,12:00,12:15,,,0,28.1,28.1,0,-78965,29062,108027,-49903,0,0,0,0,0,,0,0
26,06/29/2017,50,12:15,12:30,,,0,28.1,28.1,0,-66831,36035,102866,-30796,0,0,0,0,0,,0,0
26,06/29/2017,51,12:30,12:45,,20.41,0,20.41,20.41,-1,-37305,60087,97392,22782,0,-5379,0,0,0,,5379,-5379
26,06/29/2017,52,12:45,13:00,,17.16,0,17.16,17.16,-1,-40409,60786,101195,20377,0,-24939,0,0,0,,24939,-24939
26,06/29/2017,53,13:00,13:15,,24.39,0,24.39,24.39,-1,-47838,66796,114634,18958,0,-19149,0,0,0,,19149,-19149
26,06/29/2017,54,13:15,13:30,27.59,24.39,0,27.59,27.59,1,-58141,55892,114033,-2249,0,-2740,555,0,0,,3295,-2185
26,06/29/2017,55,13:30,13:45,27.59,15.41,0,15.41,15.41,-1,-41470,68776,110246,27306,0,-12207,93,0,0,,12300,-12114
26,06/29/2017,56,13:45,14:00,,24.41,0,24.41,24.41,-1,-68584,69647,138231,1063,0,-9484,0,0,0,,9484,-9484
26,06/29/2017,57,14:00,14:15,,28.79,0,28.79,28.79,-1,-63242,91909,155151,28667,0,-175,0,0,0,,175,-175
26,06/29/2017,58,14:15,14:30,,27.19,0,27.19,27.19,-1,-58499,88885,147384,30386,0,-134,0,0,0,,134,-134
26,06/29/2017,59,14:30,14:45,,24.41,0,24.41,24.41,-1,-69471,92477,161948,23006,0,-3352,0,0,0,,3352,-3352
26,06/29/2017,60,14:45,15:00,,25.38,0,25.38,25.38,-1,-73322,94457,167779,21135,0,-5757,0,0,0,,5757,-5757
26,06/29/2017,61,15:00,15:15,,24.41,0,24.41,24.41,-1,-80496,107249,187745,26753,0,-9170,0,0,0,,9170,-9170
26,06/29/2017,62,15:15,15:30,,,0,28.09,28.09,0,-72312,105408,177720,33096,0,-1605,0,0,0,,1605,-1605
26,06/29/2017,63,15:30,15:45,,,0,28.09,28.09,0,-77213,101220,178433,24007,0,0,0,0,0,,0,0
26,06/29/2017,64,15:45,16:00,,,0,28.09,28.09,0,-75236,81009,156245,5773,0,0,0,0,0,,0,0
26,06/29/2017,65,16:00,16:15,29.17,,0,29.17,29.17,1,-59578,87967,147545,28389,0,0,426,0,0,,426,426
26,06/29/2017,66,16:15,16:30,,28.4,0,28.4,28.4,-1,-63402,77609,141011,14207,0,-219,0,0,0,,219,-219
26,06/29/2017,67,16:30,16:45,,25.41,0,25.41,25.41,-1,-56434,76934,133368,20500,0,-1598,0,0,0,,1598,-1598
26,06/29/2017,68,16:45,17:00,,24.41,0,24.41,24.41,-1,-58537,80322,138859,21785,0,-6848,0,0,0,,6848,-6848
26,06/29/2017,69,17:00,17:15,,24.39,0,24.39,24.39,-1,-58813,94244,153057,35431,0,-5278,0,0,0,,5278,-5278
26,06/29/2017,70,17:15,17:30,,27.19,0,27.19,27.19,-1,-56021,84349,140370,28328,0,-2563,0,0,0,,2563,-2563
26,06/29/2017,71,17:30,17:45,,,0,28.07,28.07,0,-56956,59236,116192,2280,0,0,0,0,0,,0,0
26,06/29/2017,72,17:45,18:00,28.23,,0,28.23,28.23,1,-60139,64770,124909,4631,0,0,678,0,0,,678,678
26,06/29/2017,73,18:00,18:15,28.94,,0,28.94,28.94,1,-70659,53669,124328,-16990,0,0,1952,0,0,,1952,1952
26,06/29/2017,74,18:15,18:30,,,0,28.1,28.1,0,-38088,69287,107375,31199,0,0,0,0,0,,0,0
26,06/29/2017,75,18:30,18:45,,28.79,0,28.79,28.79,-1,-40775,79670,120445,38895,0,-75,0,0,0,,75,-75
26,06/29/2017,76,18:45,19:00,29.21,,0,29.21,29.21,1,-83176,72449,155625,-10727,0,0,1357,0,0,,1357,1357
26,06/29/2017,77,19:00,19:15,29.01,,0,29.01,29.01,1,-74602,60714,135316,-13888,0,0,1970,0,0,,1970,1970
26,06/29/2017,78,19:15,19:30,27.41,,0,27.41,27.41,1,-83658,59681,143339,-23977,0,0,1364,0,0,,1364,1364
26,06/29/2017,79,19:30,19:45,,,0,28.1,28.1,0,-78620,59340,137960,-19280,0,0,0,0,0,,0,0
26,06/29/2017,80,19:45,20:00,27.41,,0,27.41,27.41,1,-70781,57022,127803,-13759,0,0,2,0,0,,2,2
26,06/29/2017,81,20:00,20:15,,,0,27.52,27.52,0,-49385,63483,112868,14098,0,0,0,0,0,,0,0
26,06/29/2017,82,20:15,20:30,,,0,27.52,27.52,0,-59165,61052,120217,1887,0,0,0,0,0,,0,0
26,06/29/2017,83,20:30,20:45,,28.11,0,28.11,28.11,-1,-49685,75950,125635,26265,0,-741,0,0,0,,741,-741
26,06/29/2017,84,20:45,21:00,,24.39,0,24.39,24.39,-1,-44122,83437,127559,39315,0,-7526,0,0,0,,7526,-7526
26,06/29/2017,85,21:00,21:15,40.99,28.04,0,40.99,27.52,2,-86528,45364,131892,-41164,0,-3702,3551,0,0,,7253,-151
26,06/29/2017,86,21:15,21:30,27.41,,0,27.41,27.41,1,-54552,50152,104704,-4400,0,0,3298,0,0,,3298,3298
26,06/29/2017,87,21:30,21:45,26.24,,0,26.24,26.24,1,-49907,57748,107655,7841,0,0,568,0,0,,568,568
26,06/29/2017,88,21:45,22:00,,,0,27.52,27.52,0,-61038,56443,117481,-4595,0,0,0,0,0,,0,0
26,06/29/2017,89,22:00,22:15,,27.97,0,27.97,27.97,-1,-50376,47190,97566,-3186,0,-623,0,0,0,,623,-623
26,06/29/2017,90,22:15,22:30,,28.79,0,28.79,28.79,-1,-62659,31349,94008,-31310,0,-493,0,0,0,,493,-493
26,06/29/2017,91,22:30,22:45,,28.79,0,28.79,28.79,-1,-45411,32058,77469,-13353,0,-19,0,0,0,,19,-19
26,06/29/2017,92,22:45,23:00,,24.41,0,24.41,24.41,-1,-39618,45118,84736,5500,0,-2127,0,0,0,,2127,-2127
26,06/29/2017,93,23:00,23:15,32.17,20.41,0,32.17,20.41,2,-42625,35642,78267,-6983,0,-3606,2238,0,0,,5844,-1368
26,06/29/2017,94,23:15,23:30,27.24,20.41,0,27.24,27.24,1,-41740,20188,61928,-21552,0,-13,283,0,0,,296,270
26,06/29/2017,95,23:30,23:45,,24.39,0,24.39,24.39,-1,-45051,35264,80315,-9787,0,-3502,0,0,0,,3502,-3502
26,06/29/2017,96,23:45,0:00,,25.41,0,25.41,25.41,-1,-153908,64093,218001,-89815,0,-98,0,0,0,,98,-98
26,06/30/2017,1,0:00,0:15,31.51,-53.23,0,31.51,-53.23,2,-18448,78320,96768,59872,0,-14284,191,0,0,,14475,-14093
26,06/30/2017,2,0:15,0:30,31.51,6.05,0,6.05,6.05,-1,-10367,56519,66886,46152,0,-7529,154,0,0,,7683,-7375
26,06/30/2017,3,0:30,0:45,,-9.55,0,-9.55,-9.55,-1,-37803,53286,91089,15483,0,-39235,0,0,0,,39235,-39235
26,06/30/2017,4,0:45,1:00,27,27.5,0,27.5,27.5,2,-98992,60409,159401,-38583,0,-3629,1217,0,0,,4846,-2412
26,06/30/2017,5,1:00,1:15,27,15.51,0,15.51,15.51,-1,-26429,106500,132929,80071,0,-5676,85,0,0,,5761,-5591
26,06/30/2017,6,1:15,1:30,,24.51,0,24.51,24.51,-1,-37173,41892,79065,4719,0,-4495,0,0,0,,4495,-4495
26,06/30/2017,7,1:30,1:45,,24.51,0,24.51,24.51,-1,-62554,53006,115560,-9548,0,-8212,0,0,0,,8212,-8212
26,06/30/2017,8,1:45,2:00,,26.29,0,26.29,26.29,-1,-71491,64222,135713,-7269,0,-1736,0,0,0,,1736,-1736
26,06/30/2017,9,2:00,2:15,,26.85,0,26.85,26.85,-1,-52239,57196,109435,4957,0,-3224,0,0,0,,3224,-3224
26,06/30/2017,10,2:15,2:30,,26.29,0,26.29,26.29,-1,-39246,43146,82392,3900,0,-2417,0,0,0,,2417,-2417
26,06/30/2017,11,2:30,2:45,,15.51,0,15.51,15.51,-1,-17340,47621,64961,30281,0,-16913,0,0,0,,16913,-16913
26,06/30/2017,12,2:45,3:00,,20.51,0,20.51,20.51,-1,-13836,56176,70012,42340,0,-40199,0,0,0,,40199,-40199
26,06/30/2017,13,3:00,3:15,31.27,25.78,0,31.27,31.27,1,-47120,45929,93049,-1191,0,-21238,702,0,0,,21940,-20536
26,06/30/2017,14,3:15,3:30,31.27,26.29,0,31.27,26.29,2,-22733,46335,69068,23602,0,-898,628,0,0,,1526,-270
26,06/30/2017,15,3:30,3:45,,26.29,0,26.29,26.29,-1,-18290,60765,79055,42475,0,-2998,0,0,0,,2998,-2998
26,06/30/2017,16,3:45,4:00,,20.51,0,20.51,20.51,-1,-15978,57538,73516,41560,0,-7676,0,0,0,,7676,-7676
26,06/30/2017,17,4:00,4:15,,20.11,0,20.11,20.11,-1,-24336,53361,77697,29025,0,-20059,0,0,0,,20059,-20059
26,06/30/2017,18,4:15,4:30,,15.51,0,15.51,15.51,-1,-15913,54986,70899,39073,0,-34516,0,0,0,,34516,-34516
26,06/30/2017,19,4:30,4:45,,21.78,0,21.78,21.78,-1,-18052,48408,66460,30356,0,-33947,0,0,0,,33947,-33947
26,06/30/2017,20,4:45,5:00,,26.19,0,26.19,26.19,-1,-18132,48130,66262,29998,0,-12002,0,0,0,,12002,-12002
26,06/30/2017,21,5:00,5:15,25.51,26.85,0,27.5,26.85,2,-40453,46368,86821,5915,0,-485,2,0,0,,487,-483
26,06/30/2017,22,5:15,5:30,,25.51,0,25.51,25.51,-1,-14433,56525,70958,42092,0,-7139,0,0,0,,7139,-7139
26,06/30/2017,23,5:30,5:45,,20.51,0,20.51,20.51,-1,-11639,59157,70796,47518,0,-10827,0,0,0,,10827,-10827
26,06/30/2017,24,5:45,6:00,25.51,24.51,0,27.5,24.51,2,-6157,79683,85840,73526,0,-6386,4,0,0,,6390,-6382
26,06/30/2017,25,6:00,6:15,81.91,24.51,0,81.91,81.91,1,-193612,49523,243135,-144089,0,-803,10214,0,0,,11017,9411
26,06/30/2017,26,6:15,6:30,81.91,20.92,0,20.92,20.92,-1,-22371,53470,75841,31099,0,-6118,880,0,0,,6998,-5238
26,06/30/2017,27,6:30,6:45,,27.69,0,27.69,27.69,-1,-15101,38352,53453,23251,0,-719,0,0,0,,719,-719
26,06/30/2017,28,6:45,7:00,28.15,,0,28.15,28.15,1,-45680,65443,111123,19763,0,0,555,0,0,,555,555
26,06/30/2017,29,7:00,7:15,,15.92,0,15.92,15.92,-1,-56991,88247,145238,31256,0,-11843,0,0,0,,11843,-11843
26,06/30/2017,30,7:15,7:30,,24.92,0,24.92,24.92,-1,-28286,48414,76700,20128,0,-20780,0,0,0,,20780,-20780
26,06/30/2017,31,7:30,7:45,,29.29,0,29.29,29.29,-1,-38257,45488,83745,7231,0,-4156,0,0,0,,4156,-4156
26,06/30/2017,32,7:45,8:00,,27.09,0,27.09,27.09,-1,-62811,56363,119174,-6448,0,-467,0,0,0,,467,-467
26,06/30/2017,33,8:00,8:15,,15.92,0,15.92,15.92,-1,-44969,79467,124436,34498,0,-12749,0,0,0,,12749,-12749
26,06/30/2017,34,8:15,8:30,,20.92,0,20.92,20.92,-1,-39742,58579,98321,18837,0,-22457,0,0,0,,22457,-22457
26,06/30/2017,35,8:30,8:45,28.91,29.02,0,28.91,28.91,1,-42783,32291,75074,-10492,0,-10407,216,0,0,,10623,-10191
26,06/30/2017,36,8:45,9:00,28.15,29.02,0,28.15,28.15,1,-56721,22652,79373,-34069,0,-14,1849,0,0,,1863,1835
26,06/30/2017,37,9:00,9:15,28.15,24.92,0,24.92,24.92,-1,-46218,60030,106248,13812,0,-4847,65,0,0,,4912,-4782
26,06/30/2017,38,9:15,9:30,29.19,24.92,0,29.19,29.19,1,-56109,50688,106797,-5421,0,-9708,566,0,0,,10274,-9142
26,06/30/2017,39,9:30,9:45,32,24.92,0,32,32,1,-45546,40229,85775,-5317,0,-261,2923,0,0,,3184,2662
26,06/30/2017,40,9:45,10:00,32,,0,32,32,1,-48133,35931,84064,-12202,0,0,3229,0,0,,3229,3229
26,06/30/2017,41,10:00,10:15,28.54,,0,28.54,28.54,1,-61282,52493,113775,-8789,0,0,7712,0,0,,7712,7712
26,06/30/2017,42,10:15,10:30,32.09,,0,32.09,32.09,1,-60419,43445,103864,-16974,0,0,9725,0,0,,9725,9725
26,06/30/2017,43,10:30,10:45,29.19,,0,29.19,29.19,1,-59250,41610,100860,-17640,0,0,13214,0,0,,13214,13214
26,06/30/2017,44,10:45,11:00,28.54,,0,28.54,28.54,1,-49668,34177,83845,-15491,0,0,12511,0,0,,12511,12511
26,06/30/2017,45,11:00,11:15,45.87,,0,45.87,45.87,1,-62811,27978,90789,-34833,0,0,21748,0,0,,21748,21748
26,06/30/2017,46,11:15,11:30,30.77,,0,30.77,30.77,1,-47568,36088,83656,-11480,0,0,16583,0,0,,16583,16583
26,06/30/2017,47,11:30,11:45,27.92,,0,27.92,27.92,1,-32268,40401,72669,8133,0,0,4460,0,0,,4460,4460
26,06/30/2017,48,11:45,12:00,27.92,,0,27.92,27.92,1,-30041,42181,72222,12140,0,0,220,0,0,,220,220
26,06/30/2017,49,12:00,12:15,35.99,,0,35.99,35.99,1,-63065,45750,108815,-17315,0,0,8964,0,0,,8964,8964
26,06/30/2017,50,12:15,12:30,28.8,,0,28.8,28.8,1,-75891,64297,140188,-11594,0,0,10969,0,0,,10969,10969
26,06/30/2017,51,12:30,12:45,27.92,,0,27.92,27.92,1,-84399,85419,169818,1020,0,0,3258,0,0,,3258,3258
26,06/30/2017,52,12:45,13:00,,30.19,0,30.19,30.19,-1,-80271,87198,167469,6927,0,-192,0,0,0,,192,-192
26,06/30/2017,53,13:00,13:15,29.52,27.82,0,29.52,27.82,2,-67553,72609,140162,5056,0,-1825,1197,0,0,,3022,-628
26,06/30/2017,54,13:15,13:30,31.92,,0,31.92,31.92,1,-70974,46013,116987,-24961,0,0,9416,0,0,,9416,9416
26,06/30/2017,55,13:30,13:45,39.54,,0,39.54,39.54,1,-70692,47456,118148,-23236,0,0,21109,0,0,,21109,21109
26,06/30/2017,56,13:45,14:00,27.92,,0,27.92,27.92,1,-69879,50618,120497,-19261,0,0,4461,0,0,,4461,4461
26,06/30/2017,57,14:00,14:15,58.23,,0,58.23,58.23,1,-64198,38842,103040,-25356,0,0,18998,0,0,,18998,18998
26,06/30/2017,58,14:15,14:30,39.1,,0,39.1,39.1,1,-69128,37249,106377,-31879,0,0,27735,0,0,,27735,27735
26,06/30/2017,59,14:30,14:45,48.33,,0,48.33,48.33,1,-64135,37112,101247,-27023,0,0,34186,0,0,,34186,34186
26,06/30/2017,60,14:45,15:00,25.92,26.64,0,29.46,26.64,2,-47570,46047,93617,-1523,0,-1013,9458,0,0,,10471,8445
26,06/30/2017,61,15:00,15:15,,25.75,0,25.75,25.75,-1,-63546,83667,147213,20121,0,-6571,0,0,0,,6571,-6571
26,06/30/2017,62,15:15,15:30,27.92,25.75,0,27.92,27.92,1,-55891,53977,109868,-1914,0,-2064,590,0,0,,2654,-1474
26,06/30/2017,63,15:30,15:45,25.92,30.19,0,29.46,29.46,2,-46815,53897,100712,7082,0,-18,105,0,0,,123,87
26,06/30/2017,64,15:45,16:00,,24.92,0,24.92,24.92,-1,-32511,43608,76119,11097,0,-7731,0,0,0,,7731,-7731
26,06/30/2017,65,16:00,16:15,,25.89,0,25.89,25.89,-1,-49948,62249,112197,12301,0,-14784,0,0,0,,14784,-14784
26,06/30/2017,66,16:15,16:30,,25.92,0,25.92,25.92,-1,-48110,56818,104928,8708,0,-15848,0,0,0,,15848,-15848
26,06/30/2017,67,16:30,16:45,,26.86,0,26.86,26.86,-1,-29953,54607,84560,24654,0,-7903,0,0,0,,7903,-7903
26,06/30/2017,68,16:45,17:00,,27.49,0,27.49,27.49,-1,-38122,53944,92066,15822,0,-1008,0,0,0,,1008,-1008
26,06/30/2017,69,17:00,17:15,,21.61,0,21.61,21.61,-1,-52274,84692,136966,32418,0,-7682,0,0,0,,7682,-7682
26,06/30/2017,70,17:15,17:30,,30.19,0,30.19,30.19,-1,-46285,80731,127016,34446,0,-1581,0,0,0,,1581,-1581
26,06/30/2017,71,17:30,17:45,,31.99,0,31.99,31.99,-1,-46102,67796,113898,21694,0,-981,0,0,0,,981,-981
26,06/30/2017,72,17:45,18:00,,,0,29.46,29.46,0,-54389,71429,125818,17040,0,-35,0,0,0,,35,-35
26,06/30/2017,73,18:00,18:15,,30.19,0,30.19,30.19,-1,-82842,45700,128542,-37142,0,-98,0,0,0,,98,-98
26,06/30/2017,74,18:15,18:30,27.92,30.19,0,27.92,27.92,1,-56548,40432,96980,-16116,0,-318,979,0,0,,1297,661
26,06/30/2017,75,18:30,18:45,27.92,31.29,0,29.68,29.68,2,-49162,48836,97998,-326,0,-178,650,0,0,,828,472
26,06/30/2017,76,18:45,19:00,,29.45,0,29.45,29.45,-1,-83656,76461,160117,-7195,0,-2824,0,0,0,,2824,-2824
26,06/30/2017,77,19:00,19:15,30.14,31.29,0,30.46,30.46,2,-65413,54957,120370,-10456,0,-797,1589,0,0,,2386,792
26,06/30/2017,78,19:15,19:30,28.92,,0,28.92,28.92,1,-57551,37700,95251,-19851,0,0,1918,0,0,,1918,1918
26,06/30/2017,79,19:30,19:45,28.92,,0,28.92,28.92,1,-62289,37854,100143,-24435,0,0,2600,0,0,,2600,2600
26,06/30/2017,80,19:45,20:00,28.92,,0,28.92,28.92,1,-76905,53561,130466,-23344,0,0,2307,0,0,,2307,2307
26,06/30/2017,81,20:00,20:15,44.71,,0,44.71,44.71,1,-87004,56872,143876,-30132,0,0,11739,0,0,,11739,11739
26,06/30/2017,82,20:15,20:30,32.61,,0,32.61,32.61,1,-78732,64102,142834,-14630,0,0,19669,0,0,,19669,19669
26,06/30/2017,83,20:30,20:45,29.67,29.41,0,30.46,29.41,2,-62985,78082,141067,15097,0,-668,8271,0,0,,8939,7603
26,06/30/2017,84,20:45,21:00,29.67,30.19,0,30.19,30.19,-1,-53921,91382,145303,37461,0,-100,5,0,0,,105,-95
26,06/30/2017,85,21:00,21:15,,29.34,0,29.34,29.34,-1,-32369,74538,106907,42169,0,-205,0,0,0,,205,-205
26,06/30/2017,86,21:15,21:30,,,0,29.8,29.8,0,-26362,57389,83751,31027,0,0,0,0,0,,0,0
26,06/30/2017,87,21:30,21:45,,,0,29.8,29.8,0,-22333,60934,83267,38601,0,0,0,0,0,,0,0
26,06/30/2017,88,21:45,22:00,,,0,29.8,29.8,0,-61928,60834,122762,-1094,0,0,0,0,0,,0,0
26,06/30/2017,89,22:00,22:15,,28.95,0,28.95,28.95,-1,-21539,125128,146667,103589,0,-1346,0,0,0,,1346,-1346
26,06/30/2017,90,22:15,22:30,,30.19,0,30.19,30.19,-1,-19502,52450,71952,32948,0,-1136,0,0,0,,1136,-1136
26,06/30/2017,91,22:30,22:45,,29.39,0,29.39,29.39,-1,-10695,74011,84706,63316,0,-3133,0,0,0,,3133,-3133
26,06/30/2017,92,22:45,23:00,,-29.31,0,-29.31,-29.31,-1,-12947,96995,109942,84048,0,-4731,0,0,0,,4731,-4731
26,06/30/2017,93,23:00,23:15,,-60.18,0,-60.18,-60.18,-1,-27472,144435,171907,116963,0,-15090,0,0,0,,15090,-15090
26,06/30/2017,94,23:15,23:30,,-41.41,0,-41.41,-41.41,-1,-11979,128787,140766,116808,0,-9924,0,0,0,,9924,-9924
26,06/30/2017,95,23:30,23:45,,-53.11,0,-53.11,-53.11,-1,-25101,125891,150992,100790,0,-48842,0,0,0,,48842,-48842
26,06/30/2017,96,23:45,0:00,,-15.3,0,-15.3,-15.3,-1,-52841,108846,161687,56005,0,-74619,0,0,0,,74619,-74619
27,07-01-17,1,0:00,0:15,379.08,19.03,0,379.08,379.08,1,-104502,19404,123906,-85098,0,-21412,8607,0,0,,30019,-12805
27,07-01-17,2,0:15,0:30,379.08,,0,379.08,379.08,1,-74193,24974,99167,-49219,0,0,42593,0,0,,42593,42593
27,07-01-17,3,0:30,0:45,379.08,22.74,0,22.74,22.74,-1,-53227,66844,120071,13617,0,-5861,3398,0,0,,9259,-2463
27,07-01-17,4,0:45,1:00,36.55,25.23,0,36.6,25.23,2,-79662,62619,142281,-17043,0,-10221,936,0,0,,11157,-9285
27,07-01-17,5,1:00,1:15,36.55,25.23,0,36.55,36.55,1,-73535,64421,137956,-9114,0,-553,2854,0,0,,3407,2301
27,07-01-17,6,1:15,1:30,29.82,,0,29.82,29.82,1,-77872,57961,135833,-19911,0,0,4756,0,0,,4756,4756
27,07-01-17,7,1:30,1:45,29.82,28.58,0,28.58,28.58,-1,-53326,70026,123352,16700,0,-1300,439,0,0,,1739,-861
27,07-01-17,8,1:45,2:00,,24.58,0,24.58,24.58,-1,-47302,71647,118949,24345,0,-8748,0,0,0,,8748,-8748
27,07-01-17,9,2:00,2:15,31.03,26.63,0,31.03,26.63,2,-57551,57012,114563,-539,0,-5786,936,0,0,,6722,-4850
27,07-01-17,10,2:15,2:30,,25.23,0,25.23,25.23,-1,-36844,51772,88616,14928,0,-420,0,0,0,,420,-420
27,07-01-17,11,2:30,2:45,,24.58,0,24.58,24.58,-1,-34731,54749,89480,20018,0,-10006,0,0,0,,10006,-10006
27,07-01-17,12,2:45,3:00,,18.91,0,18.91,18.91,-1,-33493,72249,105742,38756,0,-20265,0,0,0,,20265,-20265
27,07-01-17,13,3:00,3:15,,24.58,0,24.58,24.58,-1,-22898,29422,52320,6524,0,-12357,0,0,0,,12357,-12357
27,07-01-17,14,3:15,3:30,,,0,28.23,28.23,0,-21067,39258,60325,18191,0,-126,0,0,0,,126,-126
27,07-01-17,15,3:30,3:45,29.82,26.3,0,29.82,26.3,2,-39661,44868,84529,5207,0,-817,115,0,0,,932,-702
27,07-01-17,16,3:45,4:00,162.1,,0,162.1,162.1,1,-99764,37080,136844,-62684,0,0,27695,0,0,,27695,27695
27,07-01-17,17,4:00,4:15,45.02,,0,45.02,45.02,1,-57351,41281,98632,-16070,0,0,29753,0,0,,29753,29753
27,07-01-17,18,4:15,4:30,31.58,,0,31.58,31.58,1,-37062,40532,77594,3470,0,0,8182,0,0,,8182,8182
27,07-01-17,19,4:30,4:45,31.58,45.13,0,45.13,45.13,-1,-40943,47275,88218,6332,0,-7,251,0,0,,258,244
27,07-01-17,20,4:45,5:00,35.58,,0,35.58,35.58,1,-67364,37022,104386,-30342,0,0,3064,0,0,,3064,3064
27,07-01-17,21,5:00,5:15,39.56,,0,39.56,39.56,1,-68109,51174,119283,-16935,0,0,6335,0,0,,6335,6335
27,07-01-17,22,5:15,5:30,41.58,29.58,0,41.58,28.35,2,-55663,45031,100694,-10632,0,-8,10353,0,0,,10361,10345
27,07-01-17,23,5:30,5:45,41.58,29.58,0,29.58,29.58,-1,-40201,40139,80340,-62,0,-1093,327,0,0,,1420,-766
27,07-01-17,24,5:45,6:00,,25.32,0,25.32,25.32,-1,-46356,45828,92184,-528,0,-5034,0,0,0,,5034,-5034
27,07-01-17,25,6:00,6:15,,28.29,0,28.29,28.29,-1,-48245,63777,112022,15532,0,-4867,0,0,0,,4867,-4867
27,07-01-17,26,6:15,6:30,,24.89,0,24.89,24.89,-1,-35956,63888,99844,27932,0,-563,0,0,0,,563,-563
27,07-01-17,27,6:30,6:45,,24.29,0,24.29,24.29,-1,-38982,62673,101655,23691,0,-7456,0,0,0,,7456,-7456
27,07-01-17,28,6:45,7:00,,28.29,0,28.29,28.29,-1,-43562,67224,110786,23662,0,-4720,0,0,0,,4720,-4720
27,07-01-17,29,7:00,7:15,,29.29,0,29.29,29.29,-1,-52691,56437,109128,3746,0,-393,0,0,0,,393,-393
27,07-01-17,30,7:15,7:30,,,0,27.5,27.5,0,-27753,57688,85441,29935,0,0,0,0,0,,0,0
27,07-01-17,31,7:30,7:45,,,0,27.48,27.48,0,-33382,54836,88218,21454,0,0,0,0,0,,0,0
27,07-01-17,32,7:45,8:00,,,0,27.48,27.48,0,-43389,49149,92538,5760,0,0,0,0,0,,0,0
27,07-01-17,33,8:00,8:15,,28.29,0,28.29,28.29,-1,-67032,61883,128915,-5149,0,-16,0,0,0,,16,-16
27,07-01-17,34,8:15,8:30,,24.31,0,24.31,24.31,-1,-38594,52677,91271,14083,0,-4717,0,0,0,,4717,-4717
27,07-01-17,35,8:30,8:45,,,0,27.5,27.5,0,-74169,44437,118606,-29732,0,-455,0,0,0,,455,-455
27,07-01-17,36,8:45,9:00,30.66,,0,30.66,30.66,1,-108111,55615,163726,-52496,0,0,1336,0,0,,1336,1336
27,07-01-17,37,9:00,9:15,29.2,,0,29.2,29.2,1,-105252,51515,156767,-53737,0,0,2444,0,0,,2444,2444
27,07-01-17,38,9:15,9:30,35.29,,0,35.29,35.29,1,-109750,47276,157026,-62474,0,0,7649,0,0,,7649,7649
27,07-01-17,39,9:30,9:45,41.29,,0,41.29,41.29,1,-118211,49857,168068,-68354,0,0,18252,0,0,,18252,18252
27,07-01-17,40,9:45,10:00,41.29,,0,41.29,41.29,1,-126028,55113,181141,-70915,0,0,19482,0,0,,19482,19482
27,07-01-17,41,10:00,10:15,175.87,,0,175.87,175.87,1,-124327,43739,168066,-80588,0,0,48803,0,0,,48803,48803
27,07-01-17,42,10:15,10:30,31.02,,0,31.02,31.02,1,-84994,82458,167452,-2536,0,0,17914,0,0,,17914,17914
27,07-01-17,43,10:30,10:45,31.02,,0,31.02,31.02,1,-90133,62167,152300,-27966,0,0,6010,0,0,,6010,6010
27,07-01-17,44,10:45,11:00,27.02,,0,27.02,27.02,1,-78251,56831,135082,-21420,0,0,5968,0,0,,5968,5968
27,07-01-17,45,11:00,11:15,31.02,,0,31.02,31.02,1,-72565,56016,128581,-16549,0,0,9109,0,0,,9109,9109
27,07-01-17,46,11:15,11:30,27.02,29.29,0,29.29,29.29,-1,-54827,68449,123276,13622,0,-44,4771,0,0,,4815,4727
27,07-01-17,47,11:30,11:45,27.02,29.29,0,29.29,29.29,-1,-49074,59098,108172,10024,0,-45,58,0,0,,103,13
27,07-01-17,48,11:45,12:00,27.02,,0,27.02,27.02,1,-55065,59391,114456,4326,0,0,1003,0,0,,1003,1003
27,07-01-17,49,12:00,12:15,60.02,,0,60.02,60.02,1,-76974,36380,113354,-40594,0,0,16551,0,0,,16551,16551
27,07-01-17,50,12:15,12:30,30.35,,0,30.35,30.35,1,-68260,47913,116173,-20347,0,0,9781,0,0,,9781,9781
27,07-01-17,51,12:30,12:45,28.75,,0,28.75,28.75,1,-62232,49382,111614,-12850,0,0,4164,0,0,,4164,4164
27,07-01-17,52,12:45,13:00,33,,0,33,33,1,-67854,47929,115783,-19925,0,0,13059,0,0,,13059,13059
27,07-01-17,53,13:00,13:15,38.4,,0,38.4,38.4,1,-85812,35178,120990,-50634,0,0,22794,0,0,,22794,22794
27,07-01-17,54,13:15,13:30,29.54,,0,29.54,29.54,1,-85336,49937,135273,-35399,0,0,10886,0,0,,10886,10886
27,07-01-17,55,13:30,13:45,66.02,,0,66.02,66.02,1,-92259,37047,129306,-55212,0,0,20811,0,0,,20811,20811
27,07-01-17,56,13:45,14:00,38.4,,0,38.4,38.4,1,-99303,32100,131403,-67203,0,0,26193,0,0,,26193,26193
27,07-01-17,57,14:00,14:15,27.02,,0,27.02,27.02,1,-54082,58490,112572,4408,0,0,3773,0,0,,3773,3773
27,07-01-17,58,14:15,14:30,,26.68,0,26.68,26.68,-1,-48116,41838,89954,-6278,0,-821,0,0,0,,821,-821
27,07-01-17,59,14:30,14:45,,25.42,0,25.42,25.42,-1,-58586,49656,108242,-8930,0,-2803,0,0,0,,2803,-2803
27,07-01-17,60,14:45,15:00,,28.29,0,28.29,28.29,-1,-46865,67351,114216,20486,0,-1309,0,0,0,,1309,-1309
27,07-01-17,61,15:00,15:15,,25.39,0,25.39,25.39,-1,-51371,72212,123583,20841,0,-6516,0,0,0,,6516,-6516
27,07-01-17,62,15:15,15:30,,4.03,0,4.03,4.03,-1,-43935,86668,130603,42733,0,-29053,0,0,0,,29053,-29053
27,07-01-17,63,15:30,15:45,,22.73,0,22.73,22.73,-1,-35748,77640,113388,41892,0,-29855,0,0,0,,29855,-29855
27,07-01-17,64,15:45,16:00,,-12.69,0,-12.69,-12.69,-1,-29264,94143,123407,64879,0,-42070,0,0,0,,42070,-42070
27,07-01-17,65,16:00,16:15,,21.53,0,21.53,21.53,-1,-47840,97263,145103,49423,0,-34656,0,0,0,,34656,-34656
27,07-01-17,66,16:15,16:30,,9.9,0,9.9,9.9,-1,-39257,75988,115245,36731,0,-40396,0,0,0,,40396,-40396
27,07-01-17,67,16:30,16:45,,24.29,0,24.29,24.29,-1,-53197,85168,138365,31971,0,-26370,0,0,0,,26370,-26370
27,07-01-17,68,16:45,17:00,27.94,28.29,0,27.94,27.16,2,-49055,57039,106094,7984,0,-7539,337,0,0,,7876,-7202
27,07-01-17,69,17:00,17:15,26.41,,0,26.41,26.41,1,-101386,81494,182880,-19892,0,0,148,0,0,,148,148
27,07-01-17,70,17:15,17:30,,,0,27.16,27.16,0,-69793,64969,134762,-4824,0,0,0,0,0,,0,0
27,07-01-17,71,17:30,17:45,30.75,,0,30.75,30.75,1,-72478,48711,121189,-23767,0,0,2921,0,0,,2921,2921
27,07-01-17,72,17:45,18:00,44.76,,0,44.76,44.76,1,-97279,40551,137830,-56728,0,0,27446,0,0,,27446,27446
27,07-01-17,73,18:00,18:15,72.25,,0,72.25,72.25,1,-104509,38986,143495,-65523,0,0,37246,0,0,,37246,37246
27,07-01-17,74,18:15,18:30,164.71,,0,164.71,164.71,1,-99255,20111,119366,-79144,0,0,62637,0,0,,62637,62637
27,07-01-17,75,18:30,18:45,128.02,,0,128.02,128.02,1,-78949,50541,129490,-28408,0,0,56276,0,0,,56276,56276
27,07-01-17,76,18:45,19:00,29.53,,0,29.53,29.53,1,-70066,61194,131260,-8872,0,0,14887,0,0,,14887,14887
27,07-01-17,77,19:00,19:15,31.02,,0,31.02,31.02,1,-51044,46813,97857,-4231,0,0,5553,0,0,,5553,5553
27,07-01-17,78,19:15,19:30,31.02,,0,31.02,31.02,1,-55687,36033,91720,-19654,0,0,10073,0,0,,10073,10073
27,07-01-17,79,19:30,19:45,36.84,,0,36.84,36.84,1,-60920,33647,94567,-27273,0,0,12655,0,0,,12655,12655
27,07-01-17,80,19:45,20:00,55.02,,0,55.02,55.02,1,-85209,28804,114013,-56405,0,0,25525,0,0,,25525,25525
27,07-01-17,81,20:00,20:15,27.15,25.67,0,25.67,25.67,-1,-31885,86438,118323,54553,0,-731,7694,0,0,,8425,6963
27,07-01-17,82,20:15,20:30,,,0,26.56,26.56,0,-30233,84703,114936,54470,0,-94,0,0,0,,94,-94
27,07-01-17,83,20:30,20:45,,26.29,0,26.29,26.29,-1,-31293,101445,132738,70152,0,-140,0,0,0,,140,-140
27,07-01-17,84,20:45,21:00,,21.29,0,21.29,21.29,-1,-28525,100397,128922,71872,0,-5866,0,0,0,,5866,-5866
27,07-01-17,85,21:00,21:15,,24.73,0,24.73,24.73,-1,-23852,144840,168692,120988,0,-10977,0,0,0,,10977,-10977
27,07-01-17,86,21:15,21:30,,-55.55,0,-55.55,-55.55,-1,-18678,95708,114386,77030,0,-44052,0,0,0,,44052,-44052
27,07-01-17,87,21:30,21:45,,15.79,0,15.79,15.79,-1,-31885,59399,91284,27514,0,-30066,0,0,0,,30066,-30066
27,07-01-17,88,21:45,22:00,,-6.98,0,-6.98,-6.98,-1,-28247,87936,116183,59689,0,-20977,0,0,0,,20977,-20977
27,07-01-17,89,22:00,22:15,,-6.89,0,-6.89,-6.89,-1,-36178,65779,101957,29601,0,-32320,0,0,0,,32320,-32320
27,07-01-17,90,22:15,22:30,31.17,26.29,0,36.03,26.29,2,-51892,37622,89514,-14270,0,-6524,1369,0,0,,7893,-5155
27,07-01-17,91,22:30,22:45,66.02,,0,66.02,66.02,1,-68775,29903,98678,-38872,0,0,24276,0,0,,24276,24276
27,07-01-17,92,22:45,23:00,35.62,44.66,0,44.66,44.66,-1,-57001,52394,109395,-4607,0,-18,17390,0,0,,17408,17372
27,07-01-17,93,23:00,23:15,33.09,43.55,0,36.02,36.02,2,-51532,33045,84577,-18487,0,-605,2284,0,0,,2889,1679
27,07-01-17,94,23:15,23:30,32.62,25.29,0,36.06,25.29,2,-39116,41111,80227,1995,0,-272,4667,0,0,,4939,4395
27,07-01-17,95,23:30,23:45,32.62,25.29,0,25.29,25.29,-1,-42876,68118,110994,25242,0,-3084,294,0,0,,3378,-2790
27,07-01-17,96,23:45,0:00,,18.43,0,18.43,18.43,-1,-56216,73168,129384,16952,0,-9056,0,0,0,,9056,-9056
27,07-02-17,1,0:00,0:15,,8.78,0,8.78,8.78,-1,-46675,88436,135111,41761,0,-10332,0,0,0,,10332,-10332
27,07-02-17,2,0:15,0:30,,-14.18,0,-14.18,-14.18,-1,-26961,73660,100621,46699,0,-20440,0,0,0,,20440,-20440
27,07-02-17,3,0:30,0:45,,20.78,0,20.78,20.78,-1,-31137,50553,81690,19416,0,-19164,0,0,0,,19164,-19164
27,07-02-17,4,0:45,1:00,,11.07,0,11.07,11.07,-1,-58952,87555,146507,28603,0,-19331,0,0,0,,19331,-19331
27,07-02-17,5,1:00,1:15,,20.78,0,20.78,20.78,-1,-27606,32376,59982,4770,0,-17069,0,0,0,,17069,-17069
27,07-02-17,6,1:15,1:30,,-7.91,0,-7.91,-7.91,-1,-7390,49431,56821,42041,0,-15792,0,0,0,,15792,-15792
27,07-02-17,7,1:30,1:45,,22.98,0,22.98,22.98,-1,-20373,65117,85490,44744,0,-25307,0,0,0,,25307,-25307
27,07-02-17,8,1:45,2:00,,19.69,0,19.69,19.69,-1,-48094,85987,134081,37893,0,-29105,0,0,0,,29105,-29105
27,07-02-17,9,2:00,2:15,,-0.1,0,-0.1,-0.1,-1,-10535,105874,116409,95339,0,-24895,0,0,0,,24895,-24895
27,07-02-17,10,2:15,2:30,,,0,27.65,27.65,0,-9683,101617,111300,91934,0,-491,0,0,0,,491,-491
27,07-02-17,11,2:30,2:45,,-38.34,0,-38.34,-38.34,-1,-8516,133139,141655,124623,0,-13931,0,0,0,,13931,-13931
27,07-02-17,12,2:45,3:00,,-38.34,0,-38.34,-38.34,-1,-16251,120370,136621,104119,0,-90944,0,0,0,,90944,-90944
27,07-02-17,13,3:00,3:15,,-41.08,0,-41.08,-41.08,-1,-6629,137979,144608,131350,0,-90090,0,0,0,,90090,-90090
27,07-02-17,14,3:15,3:30,,-41.08,0,-41.08,-41.08,-1,-7945,110029,117974,102084,0,-82899,0,0,0,,82899,-82899
27,07-02-17,15,3:30,3:45,,-41.08,0,-41.08,-41.08,-1,-19805,114861,134666,95056,0,-85130,0,0,0,,85130,-85130
27,07-02-17,16,3:45,4:00,,-150.78,0,-150.78,-150.78,-1,-35438,120634,156072,85196,0,-77886,0,0,0,,77886,-77886
27,07-02-17,17,4:00,4:15,,16.78,0,16.78,16.78,-1,-11047,91836,102883,80789,0,-38584,0,0,0,,38584,-38584
27,07-02-17,18,4:15,4:30,,-38.34,0,-38.34,-38.34,-1,-19380,130515,149895,111135,0,-57314,0,0,0,,57314,-57314
27,07-02-17,19,4:30,4:45,,-38.34,0,-38.34,-38.34,-1,-22049,128288,150337,106239,0,-69893,0,0,0,,69893,-69893
27,07-02-17,20,4:45,5:00,,16.78,0,16.78,16.78,-1,-23680,152172,175852,128492,0,-55619,0,0,0,,55619,-55619
27,07-02-17,21,5:00,5:15,,-39.71,0,-39.71,-39.71,-1,-26240,144226,170466,117986,0,-48824,0,0,0,,48824,-48824
27,07-02-17,22,5:15,5:30,,-39.71,0,-39.71,-39.71,-1,-57187,123767,180954,66580,0,-69145,0,0,0,,69145,-69145
27,07-02-17,23,5:30,5:45,,-39.71,0,-39.71,-39.71,-1,-44823,121090,165913,76267,0,-59854,0,0,0,,59854,-59854
27,07-02-17,24,5:45,6:00,,-39.71,0,-39.71,-39.71,-1,-82245,111901,194146,29656,0,-46723,0,0,0,,46723,-46723
27,07-02-17,25,6:00,6:15,,24.78,0,24.78,24.78,-1,-47224,130538,177762,83314,0,-17421,0,0,0,,17421,-17421
27,07-02-17,26,6:15,6:30,,25.46,0,25.46,25.46,-1,-51483,116856,168339,65373,0,-8748,0,0,0,,8748,-8748
27,07-02-17,27,6:30,6:45,,26.69,0,26.69,26.69,-1,-49489,112053,161542,62564,0,-4840,0,0,0,,4840,-4840
27,07-02-17,28,6:45,7:00,,28.19,0,28.19,28.19,-1,-49259,103981,153240,54722,0,-1406,0,0,0,,1406,-1406
27,07-02-17,29,7:00,7:15,,22.55,0,22.55,22.55,-1,-64549,89391,153940,24842,0,-11424,0,0,0,,11424,-11424
27,07-02-17,30,7:15,7:30,,24.78,0,24.78,24.78,-1,-52445,70493,122938,18048,0,-20149,0,0,0,,20149,-20149
27,07-02-17,31,7:30,7:45,,25.78,0,25.78,25.78,-1,-35782,59802,95584,24020,0,-16872,0,0,0,,16872,-16872
27,07-02-17,32,7:45,8:00,,,0,27.63,27.63,0,-39226,64129,103355,24903,0,-2546,0,0,0,,2546,-2546
27,07-02-17,33,8:00,8:15,,16.78,0,16.78,16.78,-1,-19746,112233,131979,92487,0,-6987,0,0,0,,6987,-6987
27,07-02-17,34,8:15,8:30,,29.19,0,29.19,29.19,-1,-32330,90584,122914,58254,0,-847,0,0,0,,847,-847
27,07-02-17,35,8:30,8:45,,,0,27.66,27.66,0,-31314,79394,110708,48080,0,0,0,0,0,,0,0
27,07-02-17,36,8:45,9:00,,,0,27.66,27.66,0,-34571,55024,89595,20453,0,0,0,0,0,,0,0
27,07-02-17,37,9:00,9:15,28.87,,0,28.87,28.87,1,-65073,45678,110751,-19395,0,0,551,0,0,,551,551
27,07-02-17,38,9:15,9:30,27.23,,0,27.23,27.23,1,-50798,47690,98488,-3108,0,0,1098,0,0,,1098,1098
27,07-02-17,39,9:30,9:45,28.87,,0,28.87,28.87,1,-49055,44744,93799,-4311,0,0,3378,0,0,,3378,3378
27,07-02-17,40,9:45,10:00,,,0,27.21,27.21,0,-46349,75685,122034,29336,0,0,172,0,0,,172,172
27,07-02-17,41,10:00,10:15,85.08,,0,85.08,85.08,1,-80209,12991,93200,-67218,0,0,20066,0,0,,20066,20066
27,07-02-17,42,10:15,10:30,31.82,,0,31.82,31.82,1,-34091,32226,66317,-1865,0,0,12888,0,0,,12888,12888
27,07-02-17,43,10:30,10:45,31.23,,0,31.23,31.23,1,-45624,51143,96767,5519,0,0,9294,0,0,,9294,9294
27,07-02-17,44,10:45,11:00,31.23,28.19,0,28.19,28.19,-1,-51025,85991,137016,34966,0,-953,1536,0,0,,2489,583
27,07-02-17,45,11:00,11:15,,29.19,0,29.19,29.19,-1,-30953,91868,122821,60915,0,-781,0,0,0,,781,-781
27,07-02-17,46,11:15,11:30,,29.19,0,29.19,29.19,-1,-21928,102034,123962,80106,0,-92,0,0,0,,92,-92
27,07-02-17,47,11:30,11:45,,28.19,0,28.19,28.19,-1,-21123,108045,129168,86922,0,-3588,0,0,0,,3588,-3588
27,07-02-17,48,11:45,12:00,,24.19,0,24.19,24.19,-1,-18958,126484,145442,107526,0,-7882,0,0,0,,7882,-7882
27,07-02-17,49,12:00,12:15,,28.19,0,28.19,28.19,-1,-30768,69966,100734,39198,0,-4661,0,0,0,,4661,-4661
27,07-02-17,50,12:15,12:30,,18.01,0,18.01,18.01,-1,-9233,94751,103984,85518,0,-5677,0,0,0,,5677,-5677
27,07-02-17,51,12:30,12:45,,25.36,0,25.36,25.36,-1,-6795,102873,109668,96078,0,-5247,0,0,0,,5247,-5247
27,07-02-17,52,12:45,13:00,,20.36,0,20.36,20.36,-1,-6688,109139,115827,102451,0,-3050,0,0,0,,3050,-3050
27,07-02-17,53,13:00,13:15,,25.36,0,25.36,25.36,-1,-11964,114711,126675,102747,0,-6396,0,0,0,,6396,-6396
27,07-02-17,54,13:15,13:30,,13.56,0,13.56,13.56,-1,-6202,97955,104157,91753,0,-5338,0,0,0,,5338,-5338
27,07-02-17,55,13:30,13:45,,-12.71,0,-12.71,-12.71,-1,-22087,87113,109200,65026,0,-26707,0,0,0,,26707,-26707
27,07-02-17,56,13:45,14:00,,-7.81,0,-7.81,-7.81,-1,-28249,116627,144876,88378,0,-19868,0,0,0,,19868,-19868
27,07-02-17,57,14:00,14:15,,-11.4,0,-11.4,-11.4,-1,-34386,75430,109816,41044,0,-20644,0,0,0,,20644,-20644
27,07-02-17,58,14:15,14:30,,,0,26.03,26.03,0,-50345,123082,173427,72737,0,-182,0,0,0,,182,-182
27,07-02-17,59,14:30,14:45,,,0,26.03,26.03,0,-51502,131379,182881,79877,0,0,0,0,0,,0,0
27,07-02-17,60,14:45,15:00,,,0,26.04,26.04,0,-73672,132937,206609,59265,0,0,0,0,0,,0,0
27,07-02-17,61,15:00,15:15,,,0,26.06,26.06,0,-29967,125200,155167,95233,0,0,0,0,0,,0,0
27,07-02-17,62,15:15,15:30,,25.32,0,25.32,25.32,-1,-31436,126973,158409,95537,0,-4626,0,0,0,,4626,-4626
27,07-02-17,63,15:30,15:45,,-38.34,0,-38.34,-38.34,-1,-32354,129213,161567,96859,0,-25858,0,0,0,,25858,-25858
27,07-02-17,64,15:45,16:00,,20.36,0,20.36,20.36,-1,-31550,109696,141246,78146,0,-22335,0,0,0,,22335,-22335
27,07-02-17,65,16:00,16:15,,-38.34,0,-38.34,-38.34,-1,-26806,151182,177988,124376,0,-56220,0,0,0,,56220,-56220
27,07-02-17,66,16:15,16:30,,-38.34,0,-38.34,-38.34,-1,-34625,96698,131323,62073,0,-72616,0,0,0,,72616,-72616
27,07-02-17,67,16:30,16:45,,20.9,0,20.9,20.9,-1,-39043,91744,130787,52701,0,-36814,0,0,0,,36814,-36814
27,07-02-17,68,16:45,17:00,,24.36,0,24.36,24.36,-1,-27225,89254,116479,62029,0,-16210,0,0,0,,16210,-16210
27,07-02-17,69,17:00,17:15,,5.78,0,5.78,5.78,-1,-54699,129758,184457,75059,0,-24198,0,0,0,,24198,-24198
27,07-02-17,70,17:15,17:30,,25.32,0,25.32,25.32,-1,-65472,112482,177954,47010,0,-14102,0,0,0,,14102,-14102
27,07-02-17,71,17:30,17:45,,25.78,0,25.78,25.78,-1,-66919,96505,163424,29586,0,-5427,0,0,0,,5427,-5427
27,07-02-17,72,17:45,18:00,,26.5,0,26.5,26.5,-1,-57440,71676,129116,14236,0,-527,0,0,0,,527,-527
27,07-02-17,73,18:00,18:15,,24.29,0,24.29,24.29,-1,-78523,104135,182658,25612,0,-7148,0,0,0,,7148,-7148
27,07-02-17,74,18:15,18:30,,24.36,0,24.36,24.36,-1,-63276,91837,155113,28561,0,-18299,0,0,0,,18299,-18299
27,07-02-17,75,18:30,18:45,,24.78,0,24.78,24.78,-1,-59211,76271,135482,17060,0,-15892,0,0,0,,15892,-15892
27,07-02-17,76,18:45,19:00,,24.36,0,24.36,24.36,-1,-53046,74344,127390,21298,0,-9353,0,0,0,,9353,-9353
27,07-02-17,77,19:00,19:15,,14.31,0,14.31,14.31,-1,-42761,94288,137049,51527,0,-14614,0,0,0,,14614,-14614
27,07-02-17,78,19:15,19:30,29.49,24.36,0,29.49,29.49,1,-72602,80165,152767,7563,0,-12589,380,0,0,,12969,-12209
27,07-02-17,79,19:30,19:45,29.4,24.36,0,29.4,29.4,1,-79075,74110,153185,-4965,0,-262,628,0,0,,890,366
27,07-02-17,80,19:45,20:00,38.32,,0,38.32,38.32,1,-83450,53546,136996,-29904,0,0,3450,0,0,,3450,3450
27,07-02-17,81,20:00,20:15,27.48,25.36,0,27.48,25.36,2,-36871,77877,114748,41006,0,-462,4780,0,0,,5242,4318
27,07-02-17,82,20:15,20:30,27.48,25.83,0,25.83,25.83,-1,-35323,48502,83825,13179,0,-1993,31,0,0,,2024,-1962
27,07-02-17,83,20:30,20:45,,26.35,0,26.35,26.35,-1,-39727,46115,85842,6388,0,-1797,0,0,0,,1797,-1797
27,07-02-17,84,20:45,21:00,,25.35,0,25.35,25.35,-1,-36560,49642,86202,13082,0,-3827,0,0,0,,3827,-3827
27,07-02-17,85,21:00,21:15,,-29.51,0,-29.51,-29.51,-1,-11226,90957,102183,79731,0,-29099,0,0,0,,29099,-29099
27,07-02-17,86,21:15,21:30,,-1.87,0,-1.87,-1.87,-1,-17312,90619,107931,73307,0,-57154,0,0,0,,57154,-57154
27,07-02-17,87,21:30,21:45,,5.78,0,5.78,5.78,-1,-23593,90464,114057,66871,0,-67360,0,0,0,,67360,-67360
27,07-02-17,88,21:45,22:00,,7.2,0,7.2,7.2,-1,-21378,79798,101176,58420,0,-63888,0,0,0,,63888,-63888
27,07-02-17,89,22:00,22:15,27.02,21.78,0,27.02,27.02,1,-60381,60757,121138,376,0,-28591,6,0,0,,28597,-28585
27,07-02-17,90,22:15,22:30,29.76,21.78,0,29.76,29.76,1,-73113,44385,117498,-28728,0,-304,825,0,0,,1129,521
27,07-02-17,91,22:30,22:45,56,,0,56,56,1,-77451,40627,118078,-36824,0,0,9755,0,0,,9755,9755
27,07-02-17,92,22:45,23:00,30,26.78,0,36.11,26.78,2,-64354,50095,114449,-14259,0,-83,6015,0,0,,6098,5932
27,07-02-17,93,23:00,23:15,30,25.36,0,25.36,25.36,-1,-38731,41693,80424,2962,0,-599,239,0,0,,838,-360
27,07-02-17,94,23:15,23:30,,12.8,0,12.8,12.8,-1,-27823,52611,80434,24788,0,-17733,0,0,0,,17733,-17733
27,07-02-17,95,23:30,23:45,,10.29,0,10.29,10.29,-1,-27181,67226,94407,40045,0,-22449,0,0,0,,22449,-22449
27,07-02-17,96,23:45,0:00,,-9.72,0,-9.72,-9.72,-1,-21121,86316,107437,65195,0,-60764,0,0,0,,60764,-60764
27,07-03-17,1,0:00,0:15,345.26,-9.72,0,345.26,345.26,1,-81994,10583,92577,-71411,0,-19790,11390,0,0,,31180,-8400
27,07-03-17,2,0:15,0:30,35.02,,0,35.02,35.02,1,-51117,12802,63919,-38315,0,0,20870,0,0,,20870,20870
27,07-03-17,3,0:30,0:45,35.02,25.36,0,25.36,25.36,-1,-48040,34640,82680,-13400,0,-321,3463,0,0,,3784,3142
27,07-03-17,4,0:45,1:00,,26.58,0,26.58,26.58,-1,-66198,48020,114218,-18178,0,-70,0,0,0,,70,-70
27,07-03-17,5,1:00,1:15,48.46,20.36,0,48.46,20.36,2,-39525,32798,72323,-6727,0,-1648,2485,0,0,,4133,837
27,07-03-17,6,1:15,1:30,29.52,,0,29.52,29.52,1,-35155,16382,51537,-18773,0,0,5735,0,0,,5735,5735
27,07-03-17,7,1:30,1:45,29.52,25.36,0,25.36,25.36,-1,-18820,28263,47083,9443,0,-259,131,0,0,,390,-128
27,07-03-17,8,1:45,2:00,,19.43,0,19.43,19.43,-1,-21313,39966,61279,18653,0,-18740,0,0,0,,18740,-18740
27,07-03-17,9,2:00,2:15,32.47,25.36,0,32.47,25.36,2,-41068,18192,59260,-22876,0,-6954,1390,0,0,,8344,-5564
27,07-03-17,10,2:15,2:30,27.34,,0,27.34,27.34,1,-40149,15101,55250,-25048,0,0,1098,0,0,,1098,1098
27,07-03-17,11,2:30,2:45,,,0,26.2,26.2,0,-37928,18873,56801,-19055,0,0,47,0,0,,47,47
27,07-03-17,12,2:45,3:00,41.44,,0,41.44,41.44,1,-60361,22885,83246,-37476,0,0,3324,0,0,,3324,3324
27,07-03-17,13,3:00,3:15,113.04,,0,113.04,113.04,1,-82914,24213,107127,-58701,0,0,44289,0,0,,44289,44289
27,07-03-17,14,3:15,3:30,38.75,26.69,0,26.69,26.69,-1,-56463,42245,98708,-14218,0,-5,25685,0,0,,25690,25680
27,07-03-17,15,3:30,3:45,38.75,25.36,0,25.36,25.36,-1,-50669,44183,94852,-6486,0,-369,24,0,0,,393,-345
27,07-03-17,16,3:45,4:00,,23.67,0,23.67,23.67,-1,-30415,37868,68283,7453,0,-8921,0,0,0,,8921,-8921
27,07-03-17,17,4:00,4:15,,22.14,0,22.14,22.14,-1,-42773,61338,104111,18565,0,-12851,0,0,0,,12851,-12851
27,07-03-17,18,4:15,4:30,,20.36,0,20.36,20.36,-1,-39037,57329,96366,18292,0,-4712,0,0,0,,4712,-4712
27,07-03-17,19,4:30,4:45,,-0.03,0,-0.03,-0.03,-1,-23910,71174,95084,47264,0,-35456,0,0,0,,35456,-35456
27,07-03-17,20,4:45,5:00,,20.36,0,20.36,20.36,-1,-13336,78987,92323,65651,0,-32392,0,0,0,,32392,-32392
27,07-03-17,21,5:00,5:15,,20.36,0,20.36,20.36,-1,-69731,75087,144818,5356,0,-23079,0,0,0,,23079,-23079
27,07-03-17,22,5:15,5:30,,27.03,0,27.03,27.03,-1,-22966,82743,105709,59777,0,-6011,0,0,0,,6011,-6011
27,07-03-17,23,5:30,5:45,,16.44,0,16.44,16.44,-1,-12569,126480,139049,113911,0,-8604,0,0,0,,8604,-8604
27,07-03-17,24,5:45,6:00,,24.36,0,24.36,24.36,-1,-23519,150763,174282,127244,0,-14057,0,0,0,,14057,-14057
27,07-03-17,25,6:00,6:15,,25.43,0,25.43,25.43,-1,-45090,63733,108823,18643,0,-7883,0,0,0,,7883,-7883
27,07-03-17,26,6:15,6:30,,20.43,0,20.43,20.43,-1,-25595,64250,89845,38655,0,-9343,0,0,0,,9343,-9343
27,07-03-17,27,6:30,6:45,,25.23,0,25.23,25.23,-1,-24179,41444,65623,17265,0,-10593,0,0,0,,10593,-10593
27,07-03-17,28,6:45,7:00,27.43,25.23,0,27.43,27.43,1,-31750,46466,78216,14716,0,-1406,553,0,0,,1959,-853
27,07-03-17,29,7:00,7:15,27.43,-38.31,0,-38.31,-38.31,-1,-19761,107963,127724,88202,0,-18698,34,0,0,,18732,-18664
27,07-03-17,30,7:15,7:30,,24.43,0,24.43,24.43,-1,-16787,70433,87220,53646,0,-9314,0,0,0,,9314,-9314
27,07-03-17,31,7:30,7:45,,24.43,0,24.43,24.43,-1,-23728,45279,69007,21551,0,-9425,0,0,0,,9425,-9425
27,07-03-17,32,7:45,8:00,29,24.43,0,29,29,1,-48998,47539,96537,-1459,0,-2162,1142,0,0,,3304,-1020
27,07-03-17,33,8:00,8:15,27.62,26.58,0,26.58,26.58,-1,-67047,87371,154418,20324,0,-347,742,0,0,,1089,395
27,07-03-17,34,8:15,8:30,,26.03,0,26.03,26.03,-1,-50648,58754,109402,8106,0,-3140,0,0,0,,3140,-3140
27,07-03-17,35,8:30,8:45,,25.43,0,25.43,25.43,-1,-35537,42693,78230,7156,0,-6274,0,0,0,,6274,-6274
27,07-03-17,36,8:45,9:00,,25.67,0,25.67,25.67,-1,-22497,29584,52081,7087,0,-6596,0,0,0,,6596,-6596
27,07-03-17,37,9:00,9:15,,6.75,0,6.75,6.75,-1,-24450,62562,87012,38112,0,-17646,0,0,0,,17646,-17646
27,07-03-17,38,9:15,9:30,,20.43,0,20.43,20.43,-1,-28428,69809,98237,41381,0,-37434,0,0,0,,37434,-37434
27,07-03-17,39,9:30,9:45,,5.03,0,5.03,5.03,-1,-43183,95978,139161,52795,0,-51172,0,0,0,,51172,-51172
27,07-03-17,40,9:45,10:00,,-0.28,0,-0.28,-0.28,-1,-44713,110713,155426,66000,0,-55911,0,0,0,,55911,-55911
27,07-03-17,41,10:00,10:15,,14.03,0,14.03,14.03,-1,-66735,94627,161362,27892,0,-36987,0,0,0,,36987,-36987
27,07-03-17,42,10:15,10:30,,-37.62,0,-37.62,-37.62,-1,-59676,114884,174560,55208,0,-48653,0,0,0,,48653,-48653
27,07-03-17,43,10:30,10:45,,-20.34,0,-20.34,-20.34,-1,-53614,120962,174576,67348,0,-40694,0,0,0,,40694,-40694
27,07-03-17,44,10:45,11:00,,-15.22,0,-15.22,-15.22,-1,-77730,100816,178546,23086,0,-43850,0,0,0,,43850,-43850
27,07-03-17,45,11:00,11:15,,20.43,0,20.43,20.43,-1,-59335,87917,147252,28582,0,-23517,0,0,0,,23517,-23517
27,07-03-17,46,11:15,11:30,,7.41,0,7.41,7.41,-1,-39939,83580,123519,43641,0,-25639,0,0,0,,25639,-25639
27,07-03-17,47,11:30,11:45,,3.87,0,3.87,3.87,-1,-45433,79856,125289,34423,0,-41375,0,0,0,,41375,-41375
27,07-03-17,48,11:45,12:00,,24.43,0,24.43,24.43,-1,-48045,65462,113507,17417,0,-25824,0,0,0,,25824,-25824
27,07-03-17,49,12:00,12:15,27.48,24.43,0,27.48,27.48,1,-108887,61313,170200,-47574,0,-3766,632,0,0,,4398,-3134
27,07-03-17,50,12:15,12:30,,,0,26.77,26.77,0,-90666,55853,146519,-34813,0,0,0,0,0,,0,0
27,07-03-17,51,12:30,12:45,31.45,,0,31.45,31.45,1,-93403,61620,155023,-31783,0,0,2145,0,0,,2145,2145
27,07-03-17,52,12:45,13:00,33.99,,0,33.99,33.99,1,-103628,56144,159772,-47484,0,0,4749,0,0,,4749,4749
27,07-03-17,53,13:00,13:15,37.64,,0,37.64,37.64,1,-128329,54799,183128,-73530,0,0,1928,0,0,,1928,1928
27,07-03-17,54,13:15,13:30,64.21,,0,64.21,64.21,1,-124926,67746,192672,-57180,0,0,17257,0,0,,17257,17257
27,07-03-17,55,13:30,13:45,31.43,,0,31.43,31.43,1,-93598,52820,146418,-40778,0,0,7012,0,0,,7012,7012
27,07-03-17,56,13:45,14:00,,,0,26.74,26.74,0,-90910,63565,154475,-27345,0,0,1616,0,0,,1616,1616
27,07-03-17,57,14:00,14:15,,23.19,0,23.19,23.19,-1,-79703,108724,188427,29021,0,-5888,0,0,0,,5888,-5888
27,07-03-17,58,14:15,14:30,,25.43,0,25.43,25.43,-1,-73101,79218,152319,6117,0,-4060,0,0,0,,4060,-4060
27,07-03-17,59,14:30,14:45,,24.43,0,24.43,24.43,-1,-52016,80776,132792,28760,0,-9887,0,0,0,,9887,-9887
27,07-03-17,60,14:45,15:00,,12.39,0,12.39,12.39,-1,-36650,89191,125841,52541,0,-24308,0,0,0,,24308,-24308
27,07-03-17,61,15:00,15:15,,23.03,0,23.03,23.03,-1,-35013,54872,89885,19859,0,-30220,0,0,0,,30220,-30220
27,07-03-17,62,15:15,15:30,,25.6,0,25.6,25.6,-1,-33229,48589,81818,15360,0,-7748,0,0,0,,7748,-7748
27,07-03-17,63,15:30,15:45,,24.43,0,24.43,24.43,-1,-35593,43355,78948,7762,0,-4041,0,0,0,,4041,-4041
27,07-03-17,64,15:45,16:00,,22.35,0,22.35,22.35,-1,-27600,52244,79844,24644,0,-9035,0,0,0,,9035,-9035
27,07-03-17,65,16:00,16:15,,-18.35,0,-18.35,-18.35,-1,-55271,115315,170586,60044,0,-38916,0,0,0,,38916,-38916
27,07-03-17,66,16:15,16:30,,17.35,0,17.35,17.35,-1,-59703,103127,162830,43424,0,-31260,0,0,0,,31260,-31260
27,07-03-17,67,16:30,16:45,,19.04,0,19.04,19.04,-1,-52796,86948,139744,34152,0,-34709,0,0,0,,34709,-34709
27,07-03-17,68,16:45,17:00,,24.43,0,24.43,24.43,-1,-53862,69999,123861,16137,0,-18781,0,0,0,,18781,-18781
27,07-03-17,69,17:00,17:15,,9.69,0,9.69,9.69,-1,-74746,114657,189403,39911,0,-19623,0,0,0,,19623,-19623
27,07-03-17,70,17:15,17:30,,25.43,0,25.43,25.43,-1,-68458,67011,135469,-1447,0,-9680,0,0,0,,9680,-9680
27,07-03-17,71,17:30,17:45,177.6,25.43,0,177.6,177.6,1,-78964,16830,95794,-62134,0,-1280,21969,0,0,,23249,20689
27,07-03-17,72,17:45,18:00,45.82,26.4,0,45.82,26.4,2,-29998,22357,52355,-7641,0,-14,34609,0,0,,34623,34595
27,07-03-17,73,18:00,18:15,45.82,-27.29,0,-27.29,-27.29,-1,-50617,74054,124671,23437,0,-14729,2702,0,0,,17431,-12027
27,07-03-17,74,18:15,18:30,,25.43,0,25.43,25.43,-1,-57938,55039,112977,-2899,0,-7196,0,0,0,,7196,-7196
27,07-03-17,75,18:30,18:45,33.94,25.43,0,33.94,33.94,1,-71689,39970,111659,-31719,0,-793,3054,0,0,,3847,2261
27,07-03-17,76,18:45,19:00,37.73,,0,37.73,37.73,1,-84460,43131,127591,-41329,0,0,9417,0,0,,9417,9417
27,07-03-17,77,19:00,19:15,30.97,,0,30.97,30.97,1,-60792,45999,106791,-14793,0,0,9595,0,0,,9595,9595
27,07-03-17,78,19:15,19:30,50.25,,0,50.25,50.25,1,-68209,39138,107347,-29071,0,0,11506,0,0,,11506,11506
27,07-03-17,79,19:30,19:45,39.25,,0,39.25,39.25,1,-74243,39843,114086,-34400,0,0,23939,0,0,,23939,23939
27,07-03-17,80,19:45,20:00,107.02,,0,107.02,107.02,1,-89145,33600,122745,-55545,0,0,42054,0,0,,42054,42054
27,07-03-17,81,20:00,20:15,29.57,25.8,0,29.57,25.8,2,-37916,83379,121295,45463,0,-199,14548,0,0,,14747,14349
27,07-03-17,82,20:15,20:30,,,0,26.76,26.76,0,-39586,80546,120132,40960,0,0,0,0,0,,0,0
27,07-03-17,83,20:30,20:45,,,0,26.76,26.76,0,-39330,79945,119275,40615,0,0,0,0,0,,0,0
27,07-03-17,84,20:45,21:00,,24.43,0,24.43,24.43,-1,-44080,70970,115050,26890,0,-1130,0,0,0,,1130,-1130
27,07-03-17,85,21:00,21:15,,25.43,0,25.43,25.43,-1,-48308,126281,174589,77973,0,-2164,0,0,0,,2164,-2164
27,07-03-17,86,21:15,21:30,,25.43,0,25.43,25.43,-1,-35351,117158,152509,81807,0,-1552,0,0,0,,1552,-1552
27,07-03-17,87,21:30,21:45,,-34,0,-34,-34,-1,-41580,102604,144184,61024,0,-26361,0,0,0,,26361,-26361
27,07-03-17,88,21:45,22:00,,24.43,0,24.43,24.43,-1,-53454,106125,159579,52671,0,-20808,0,0,0,,20808,-20808
27,07-03-17,89,22:00,22:15,344.65,26.54,0,344.65,344.65,1,-135817,60353,196170,-75464,0,-7162,13941,0,0,,21103,6779
27,07-03-17,90,22:15,22:30,344.65,,0,344.65,344.65,1,-111549,83358,194907,-28191,0,0,48967,0,0,,48967,48967
27,07-03-17,91,22:30,22:45,344.65,16.3,0,16.3,16.3,-1,-99193,114775,213968,15582,0,-9265,3477,0,0,,12742,-5788
27,07-03-17,92,22:45,23:00,,5.11,0,5.11,5.11,-1,-77903,106321,184224,28418,0,-24696,0,0,0,,24696,-24696
27,07-03-17,93,23:00,23:15,,-3.89,0,-3.89,-3.89,-1,-66239,84074,150313,17835,0,-23451,0,0,0,,23451,-23451
27,07-03-17,94,23:15,23:30,27.37,24.98,0,27.37,24.98,2,-62193,60840,123033,-1353,0,-2303,128,0,0,,2431,-2175
27,07-03-17,95,23:30,23:45,,20.61,0,20.61,20.61,-1,-49792,64877,114669,15085,0,-8344,0,0,0,,8344,-8344
27,07-03-17,96,23:45,0:00,,16.89,0,16.89,16.89,-1,-45767,88651,134418,42884,0,-36151,0,0,0,,36151,-36151
27,07-04-17,1,0:00,0:15,,16.78,0,16.78,16.78,-1,-41878,64838,106716,22960,0,-24962,0,0,0,,24962,-24962
27,07-04-17,2,0:15,0:30,,-31.07,0,-31.07,-31.07,-1,-16670,80522,97192,63852,0,-9408,0,0,0,,9408,-9408
27,07-04-17,3,0:30,0:45,,-9.3,0,-9.3,-9.3,-1,-44698,78979,123677,34281,0,-17503,0,0,0,,17503,-17503
27,07-04-17,4,0:45,1:00,,20.53,0,20.53,20.53,-1,-76808,101268,178076,24460,0,-14420,0,0,0,,14420,-14420
27,07-04-17,5,1:00,1:15,,25.51,0,25.51,25.51,-1,-31936,32983,64919,1047,0,-8435,0,0,0,,8435,-8435
27,07-04-17,6,1:15,1:30,,22.97,0,22.97,22.97,-1,-31908,46113,78021,14205,0,-5389,0,0,0,,5389,-5389
27,07-04-17,7,1:30,1:45,27.53,25.53,0,27.53,27.53,1,-36913,42238,79151,5325,0,-5040,106,0,0,,5146,-4934
27,07-04-17,8,1:45,2:00,25.5,19.7,0,26.64,19.7,2,-33746,65790,99536,32044,0,-8759,16,0,0,,8775,-8743
27,07-04-17,9,2:00,2:15,31.99,25.53,0,31.99,25.53,2,-54079,33654,87733,-20425,0,-4771,1484,0,0,,6255,-3287
27,07-04-17,10,2:15,2:30,31.53,,0,31.53,31.53,1,-42285,34039,76324,-8246,0,0,4019,0,0,,4019,4019
27,07-04-17,11,2:30,2:45,31.53,25.53,0,25.53,25.53,-1,-32390,48201,80591,15811,0,-413,197,0,0,,610,-216
27,07-04-17,12,2:45,3:00,,22.95,0,22.95,22.95,-1,-28646,43214,71860,14568,0,-9332,0,0,0,,9332,-9332
27,07-04-17,13,3:00,3:15,,25.68,0,25.68,25.68,-1,-18514,34189,52703,15675,0,-4520,0,0,0,,4520,-4520
27,07-04-17,14,3:15,3:30,,24.53,0,24.53,24.53,-1,-21140,39343,60483,18203,0,-5606,0,0,0,,5606,-5606
27,07-04-17,15,3:30,3:45,,25.53,0,25.53,25.53,-1,-24413,39662,64075,15249,0,-9547,0,0,0,,9547,-9547
27,07-04-17,16,3:45,4:00,,,0,26.91,26.91,0,-25884,43701,69585,17817,0,-2776,0,0,0,,2776,-2776
27,07-04-17,17,4:00,4:15,,,0,26.66,26.66,0,-31311,15195,46506,-16116,0,0,0,0,0,,0,0
27,07-04-17,18,4:15,4:30,,,0,26.66,26.66,0,-34917,17980,52897,-16937,0,0,0,0,0,,0,0
27,07-04-17,19,4:30,4:45,,25.78,0,25.78,25.78,-1,-27370,22259,49629,-5111,0,-440,0,0,0,,440,-440
27,07-04-17,20,4:45,5:00,,25.18,0,25.18,25.18,-1,-32261,44458,76719,12197,0,-4303,0,0,0,,4303,-4303
27,07-04-17,21,5:00,5:15,,24.53,0,24.53,24.53,-1,-29814,45318,75132,15504,0,-12615,0,0,0,,12615,-12615
27,07-04-17,22,5:15,5:30,,25.7,0,25.7,25.7,-1,-25618,31190,56808,5572,0,-6845,0,0,0,,6845,-6845
27,07-04-17,23,5:30,5:45,,,0,26.16,26.16,0,-30445,23388,53833,-7057,0,-1947,0,0,0,,1947,-1947
27,07-04-17,24,5:45,6:00,,24.98,0,24.98,24.98,-1,-53625,55839,109464,2214,0,-2504,0,0,0,,2504,-2504
27,07-04-17,25,6:00,6:15,,25.5,0,25.5,25.5,-1,-64816,55538,120354,-9278,0,-1745,0,0,0,,1745,-1745
27,07-04-17,26,6:15,6:30,,26.67,0,26.67,26.67,-1,-44352,48515,92867,4163,0,-3854,0,0,0,,3854,-3854
27,07-04-17,27,6:30,6:45,41.81,26.67,0,41.81,41.81,1,-71320,20842,92162,-50478,0,-495,2404,0,0,,2899,1909
27,07-04-17,28,6:45,7:00,61.69,,0,61.69,61.69,1,-62016,29792,91808,-32224,0,0,15924,0,0,,15924,15924
27,07-04-17,29,7:00,7:15,61.69,0.64,0,0.64,0.64,-1,-36892,63145,100037,26253,0,-11893,4122,0,0,,16015,-7771
27,07-04-17,30,7:15,7:30,27.6,28.16,0,27.6,27.49,2,-31217,16750,47967,-14467,0,-754,737,0,0,,1491,-17
27,07-04-17,31,7:30,7:45,27.5,,0,27.5,27.5,1,-52253,34736,86989,-17517,0,0,2752,0,0,,2752,2752
27,07-04-17,32,7:45,8:00,53.37,,0,53.37,53.37,1,-89657,40181,129838,-49476,0,0,17748,0,0,,17748,17748
27,07-04-17,33,8:00,8:15,300.48,,0,300.48,300.48,1,-165503,62332,227835,-103171,0,0,61980,0,0,,61980,61980
27,07-04-17,34,8:15,8:30,107.12,28.51,0,28.51,28.51,-1,-90022,82302,172324,-7720,0,-18,39952,0,0,,39970,39934
27,07-04-17,35,8:30,8:45,69.32,28.51,0,69.32,69.32,1,-110892,76623,187515,-34269,0,-1,7989,0,0,,7990,7988
27,07-04-17,36,8:45,9:00,107.12,,0,107.12,107.12,1,-133667,74756,208423,-58911,0,0,48707,0,0,,48707,48707
27,07-04-17,37,9:00,9:15,33.4,,0,33.4,33.4,1,-97048,70379,167427,-26669,0,0,27419,0,0,,27419,27419
27,07-04-17,38,9:15,9:30,67.12,,0,67.12,67.12,1,-108052,61742,169794,-46310,0,0,28221,0,0,,28221,28221
27,07-04-17,39,9:30,9:45,67.12,,0,67.12,67.12,1,-102184,57619,159803,-44565,0,0,42261,0,0,,42261,42261
27,07-04-17,40,9:45,10:00,32.4,,0,32.4,32.4,1,-105615,59046,164661,-46569,0,0,33334,0,0,,33334,33334
27,07-04-17,41,10:00,10:15,32.38,23.9,0,23.9,23.9,-1,-68120,98963,167083,30843,0,-960,17267,0,0,,18227,16307
27,07-04-17,42,10:15,10:30,,21.9,0,21.9,21.9,-1,-67189,80204,147393,13015,0,-5323,0,0,0,,5323,-5323
27,07-04-17,43,10:30,10:45,,28.16,0,28.16,28.16,-1,-63452,68925,132377,5473,0,-1749,0,0,0,,1749,-1749
27,07-04-17,44,10:45,11:00,67.12,28.16,0,67.12,67.12,1,-85084,50226,135310,-34858,0,-16,14451,0,0,,14467,14435
27,07-04-17,45,11:00,11:15,31.16,,0,31.16,31.16,1,-82655,49555,132210,-33100,0,0,19045,0,0,,19045,19045
27,07-04-17,46,11:15,11:30,147.41,,0,147.41,147.41,1,-97747,43530,141277,-54217,0,0,35529,0,0,,35529,35529
27,07-04-17,47,11:30,11:45,33.16,,0,33.16,33.16,1,-83478,55116,138594,-28362,0,0,28845,0,0,,28845,28845
27,07-04-17,48,11:45,12:00,30.42,,0,30.42,30.42,1,-76556,51894,128450,-24662,0,0,6821,0,0,,6821,6821
27,07-04-17,49,12:00,12:15,188.4,,0,188.4,188.4,1,-129505,62629,192134,-66876,0,0,35191,0,0,,35191,35191
27,07-04-17,50,12:15,12:30,35.12,,0,35.12,35.12,1,-105840,80528,186368,-25312,0,0,33420,0,0,,33420,33420
27,07-04-17,51,12:30,12:45,32.47,,0,32.47,32.47,1,-106994,84614,191608,-22380,0,0,11339,0,0,,11339,11339
27,07-04-17,52,12:45,13:00,57.08,,0,57.08,57.08,1,-111114,84253,195367,-26861,0,0,24877,0,0,,24877,24877
27,07-04-17,53,13:00,13:15,46.12,48.05,0,46.12,37.61,2,-111661,80113,191774,-31548,0,-48,8374,0,0,,8422,8326
27,07-04-17,54,13:15,13:30,345.92,,0,345.92,345.92,1,-121224,76586,197810,-44638,0,0,39394,0,0,,39394,39394
27,07-04-17,55,13:30,13:45,33,,0,33,33,1,-120203,96468,216671,-23735,0,0,16703,0,0,,16703,16703
27,07-04-17,56,13:45,14:00,239.74,,0,239.74,239.74,1,-120217,70869,191086,-49348,0,0,36429,0,0,,36429,36429
27,07-04-17,57,14:00,14:15,27.5,26.3,0,27.63,26.3,2,-134321,134521,268842,200,0,-199,12548,0,0,,12747,12349
27,07-04-17,58,14:15,14:30,190.44,,0,190.44,190.44,1,-130509,84302,214811,-46207,0,0,20039,0,0,,20039,20039
27,07-04-17,59,14:30,14:45,190.44,,0,190.44,190.44,1,-133471,94401,227872,-39070,0,0,40448,0,0,,40448,40448
27,07-04-17,60,14:45,15:00,116.8,,0,116.8,116.8,1,-146814,85589,232403,-61225,0,0,42584,0,0,,42584,42584
27,07-04-17,61,15:00,15:15,40.12,,0,40.12,40.12,1,-114721,91854,206575,-22867,0,0,34194,0,0,,34194,34194
27,07-04-17,62,15:15,15:30,54.5,,0,54.5,54.5,1,-129716,92734,222450,-36982,0,0,15462,0,0,,15462,15462
27,07-04-17,63,15:30,15:45,201,,0,201,201,1,-136769,74080,210849,-62689,0,0,54715,0,0,,54715,54715
27,07-04-17,64,15:45,16:00,43.11,,0,43.11,43.11,1,-128490,81607,210097,-46883,0,0,45918,0,0,,45918,45918
27,07-04-17,65,16:00,16:15,43.11,-54.4,0,-54.4,-54.4,-1,-59465,126638,186103,67173,0,-14866,13438,0,0,,28304,-1428
27,07-04-17,66,16:15,16:30,,24.89,0,24.89,24.89,-1,-83354,102364,185718,19010,0,-7636,0,0,0,,7636,-7636
27,07-04-17,67,16:30,16:45,27.9,24.16,0,27.9,24.16,2,-66399,66005,132404,-394,0,-9640,109,0,0,,9749,-9531
27,07-04-17,68,16:45,17:00,65.55,24.16,0,65.55,65.55,1,-114734,75154,189888,-39580,0,-665,20946,0,0,,21611,20281
27,07-04-17,69,17:00,17:15,39.11,,0,39.11,39.11,1,-126531,72194,198725,-54337,0,0,37854,0,0,,37854,37854
27,07-04-17,70,17:15,17:30,216.29,,0,216.29,216.29,1,-138151,66812,204963,-71339,0,0,52687,0,0,,52687,52687
27,07-04-17,71,17:30,17:45,90.11,,0,90.11,90.11,1,-133768,58812,192580,-74956,0,0,65646,0,0,,65646,65646
27,07-04-17,72,17:45,18:00,98.11,,0,98.11,98.11,1,-135733,63423,199156,-72310,0,0,67295,0,0,,67295,67295
27,07-04-17,73,18:00,18:15,201.38,,0,201.38,201.38,1,-127178,53975,181153,-73203,0,0,67128,0,0,,67128,67128
27,07-04-17,74,18:15,18:30,37.4,,0,37.4,37.4,1,-103808,69775,173583,-34033,0,0,40091,0,0,,40091,40091
27,07-04-17,75,18:30,18:45,30.5,,0,30.5,30.5,1,-101090,77815,178905,-23275,0,0,23506,0,0,,23506,23506
27,07-04-17,76,18:45,19:00,30.5,,0,30.5,30.5,1,-98019,79871,177890,-18148,0,0,19481,0,0,,19481,19481
27,07-04-17,77,19:00,19:15,276.93,,0,276.93,276.93,1,-146687,45459,192146,-101228,0,0,39134,0,0,,39134,39134
27,07-04-17,78,19:15,19:30,276.93,,0,276.93,276.93,1,-143395,37181,180576,-106214,0,0,83344,0,0,,83344,83344
27,07-04-17,79,19:30,19:45,359.12,,0,359.12,359.12,1,-152250,42323,194573,-109927,0,0,85960,0,0,,85960,85960
27,07-04-17,80,19:45,20:00,191.93,,0,191.93,191.93,1,-138054,65341,203395,-72713,0,0,46825,0,0,,46825,46825
27,07-04-17,81,20:00,20:15,75.12,,0,75.12,75.12,1,-121997,38286,160283,-83711,0,0,18092,0,0,,18092,18092
27,07-04-17,82,20:15,20:30,81.12,,0,81.12,81.12,1,-108055,38361,146416,-69694,0,0,34768,0,0,,34768,34768
27,07-04-17,83,20:30,20:45,39.09,,0,39.09,39.09,1,-83991,37338,121329,-46653,0,0,36864,0,0,,36864,36864
27,07-04-17,84,20:45,21:00,32.5,25.96,0,25.96,25.96,-1,-72668,57772,130440,-14896,0,-58,23211,0,0,,23269,23153
27,07-04-17,85,21:00,21:15,118.12,25.62,0,118.12,25.62,2,-84055,46443,130498,-37612,0,-337,12554,0,0,,12891,12217
27,07-04-17,86,21:15,21:30,33.32,,0,33.32,33.32,1,-70686,57484,128170,-13202,0,0,25371,0,0,,25371,25371
27,07-04-17,87,21:30,21:45,33.32,28.16,0,28.16,28.16,-1,-45091,73191,118282,28100,0,-307,4499,0,0,,4806,4192
27,07-04-17,88,21:45,22:00,,,0,27.64,27.64,0,-53378,72780,126158,19402,0,0,0,0,0,,0,0
27,07-04-17,89,22:00,22:15,,,0,27.66,27.66,0,-91526,53471,144997,-38055,0,0,0,0,0,,0,0
27,07-04-17,90,22:15,22:30,61.19,,0,61.19,61.19,1,-111024,25747,136771,-85277,0,0,5118,0,0,,5118,5118
27,07-04-17,91,22:30,22:45,293.56,,0,293.56,293.56,1,-107804,29149,136953,-78655,0,0,53608,0,0,,53608,53608
27,07-04-17,92,22:45,23:00,28.5,24.16,0,24.16,24.16,-1,-29438,59712,89150,30274,0,-643,20780,0,0,,21423,20137
27,07-04-17,93,23:00,23:15,31.83,22.1,0,31.83,22.1,2,-64475,48029,112504,-16446,0,-1260,3721,0,0,,4981,2461
27,07-04-17,94,23:15,23:30,28.5,26.39,0,26.39,26.39,-1,-53118,51540,104658,-1578,0,-291,4285,0,0,,4576,3994
27,07-04-17,95,23:30,23:45,,26.01,0,26.01,26.01,-1,-36979,49871,86850,12892,0,-994,0,0,0,,994,-994
27,07-04-17,96,23:45,0:00,,9.76,0,9.76,9.76,-1,-26318,83967,110285,57649,0,-12147,0,0,0,,12147,-12147
27,07-05-17,1,0:00,0:15,223.94,25.03,0,223.94,25.03,2,-97192,15834,113026,-81358,0,-6970,12986,0,0,,19956,6016
27,07-05-17,2,0:15,0:30,38.02,25.03,0,38.02,38.02,1,-53830,35447,89277,-18383,0,-31,15126,0,0,,15157,15095
27,07-05-17,3,0:30,0:45,38.02,25.84,0,25.84,25.84,-1,-33492,39760,73252,6268,0,-2188,694,0,0,,2882,-1494
27,07-05-17,4,0:45,1:00,,17.78,0,17.78,17.78,-1,-21497,59752,81249,38255,0,-13189,0,0,0,,13189,-13189
27,07-05-17,5,1:00,1:15,189.68,25.03,0,189.68,25.03,2,-63875,8519,72394,-55356,0,-8196,8647,0,0,,16843,451
27,07-05-17,6,1:15,1:30,28.66,29.22,0,29.22,29.22,-1,-38052,31587,69639,-6465,0,-94,3768,0,0,,3862,3674
27,07-05-17,7,1:30,1:45,,26.7,0,26.7,26.7,-1,-33591,34536,68127,945,0,-777,0,0,0,,777,-777
27,07-05-17,8,1:45,2:00,,23.29,0,23.29,23.29,-1,-27657,50736,78393,23079,0,-4680,0,0,0,,4680,-4680
27,07-05-17,9,2:00,2:15,90.61,29.22,0,90.61,27.91,2,-55200,6544,61744,-48656,0,-1603,13856,0,0,,15459,12253
27,07-05-17,10,2:15,2:30,38.6,,0,38.6,38.6,1,-38367,19266,57633,-19101,0,0,27362,0,0,,27362,27362
27,07-05-17,11,2:30,2:45,38.6,25.6,0,25.6,25.6,-1,-31169,42886,74055,11717,0,-678,4613,0,0,,5291,3935
27,07-05-17,12,2:45,3:00,,25.6,0,25.6,25.6,-1,-32507,48582,81089,16075,0,-4491,0,0,0,,4491,-4491
27,07-05-17,13,3:00,3:15,28.6,26.6,0,28.6,28.6,1,-28537,33121,61658,4584,0,-3084,358,0,0,,3442,-2726
27,07-05-17,14,3:15,3:30,31.37,,0,31.37,31.37,1,-29444,29673,59117,229,0,0,3016,0,0,,3016,3016
27,07-05-17,15,3:30,3:45,,,0,27.95,27.95,0,-26949,39696,66645,12747,0,0,41,0,0,,41,41
27,07-05-17,16,3:45,4:00,,,0,27.95,27.95,0,-25687,32334,58021,6647,0,0,0,0,0,,0,0
27,07-05-17,17,4:00,4:15,,,0,27.95,27.95,0,-16871,38958,55829,22087,0,0,0,0,0,,0,0
27,07-05-17,18,4:15,4:30,,,0,27.95,27.95,0,-21963,34961,56924,12998,0,0,0,0,0,,0,0
27,07-05-17,19,4:30,4:45,,,0,27.95,27.95,0,-22131,40212,62343,18081,0,0,0,0,0,,0,0
27,07-05-17,20,4:45,5:00,31.45,,0,31.45,31.45,1,-25414,26949,52363,1535,0,0,2066,0,0,,2066,2066
27,07-05-17,21,5:00,5:15,33.8,,0,33.8,33.8,1,-48117,37822,85939,-10295,0,0,8322,0,0,,8322,8322
27,07-05-17,22,5:15,5:30,33.8,25.96,0,25.96,25.96,-1,-20397,34223,54620,13826,0,-1442,630,0,0,,2072,-812
27,07-05-17,23,5:30,5:45,,26.6,0,26.6,26.6,-1,-27294,22089,49383,-5205,0,-1710,0,0,0,,1710,-1710
27,07-05-17,24,5:45,6:00,,26.6,0,26.6,26.6,-1,-35814,20840,56654,-14974,0,-433,0,0,0,,433,-433
27,07-05-17,25,6:00,6:15,,9.03,0,9.03,9.03,-1,-34604,81429,116033,46825,0,-16961,0,0,0,,16961,-16961
27,07-05-17,26,6:15,6:30,,25.57,0,25.57,25.57,-1,-35436,33251,68687,-2185,0,-9846,0,0,0,,9846,-9846
27,07-05-17,27,6:30,6:45,28.57,25.57,0,28.57,28.57,1,-50054,11400,61454,-38654,0,-391,1521,0,0,,1912,1130
27,07-05-17,28,6:45,7:00,43.72,,0,43.72,43.72,1,-79836,22316,102152,-57520,0,0,8171,0,0,,8171,8171
27,07-05-17,29,7:00,7:15,43.72,17.78,0,17.78,17.78,-1,-31746,79759,111505,48013,0,-4596,3095,0,0,,7691,-1501
27,07-05-17,30,7:15,7:30,,29.3,0,29.3,29.3,-1,-37498,29626,67124,-7872,0,-682,0,0,0,,682,-682
27,07-05-17,31,7:30,7:45,,,0,28.6,28.6,0,-57709,14764,72473,-42945,0,0,0,0,0,,0,0
27,07-05-17,32,7:45,8:00,312.27,,0,312.27,312.27,1,-98805,27396,126201,-71409,0,0,14804,0,0,,14804,14804
27,07-05-17,33,8:00,8:15,32.8,-25.61,0,32.8,-25.61,2,-8026,88777,96803,80751,0,-17936,3946,0,0,,21882,-13990
27,07-05-17,34,8:15,8:30,,16.03,0,16.03,16.03,-1,-15929,60012,75941,44083,0,-35596,0,0,0,,35596,-35596
27,07-05-17,35,8:30,8:45,,22.97,0,22.97,22.97,-1,-34677,56776,91453,22099,0,-24953,0,0,0,,24953,-24953
27,07-05-17,36,8:45,9:00,27.98,26.12,0,27.98,27.98,1,-46115,44293,90408,-1822,0,-7503,62,0,0,,7565,-7441
27,07-05-17,37,9:00,9:15,,17.74,0,17.74,17.74,-1,-14098,53586,67684,39488,0,-10042,0,0,0,,10042,-10042
27,07-05-17,38,9:15,9:30,,25.47,0,25.47,25.47,-1,-28382,34139,62521,5757,0,-13236,0,0,0,,13236,-13236
27,07-05-17,39,9:30,9:45,28.47,25.47,0,28.47,28.47,1,-34633,30692,65325,-3941,0,-1644,1304,0,0,,2948,-340
27,07-05-17,40,9:45,10:00,28.47,26.47,0,26.47,26.47,-1,-30660,37551,68211,6891,0,-1477,90,0,0,,1567,-1387
27,07-05-17,41,10:00,10:15,,26.47,0,26.47,26.47,-1,-35459,44192,79651,8733,0,-4716,0,0,0,,4716,-4716
27,07-05-17,42,10:15,10:30,,25.47,0,25.47,25.47,-1,-32223,42415,74638,10192,0,-6817,0,0,0,,6817,-6817
27,07-05-17,43,10:30,10:45,,21.47,0,21.47,21.47,-1,-74025,52055,126080,-21970,0,-10183,0,0,0,,10183,-10183
27,07-05-17,44,10:45,11:00,28.47,21.47,0,28.47,28.47,1,-110267,40299,150566,-69968,0,-924,789,0,0,,1713,-135
27,07-05-17,45,11:00,11:15,64.34,,0,64.34,64.34,1,-122575,45118,167693,-77457,0,0,12373,0,0,,12373,12373
27,07-05-17,46,11:15,11:30,171.05,,0,171.05,171.05,1,-102281,41286,143567,-60995,0,0,40963,0,0,,40963,40963
27,07-05-17,47,11:30,11:45,50.44,,0,50.44,50.44,1,-86029,54018,140047,-32011,0,0,13789,0,0,,13789,13789
27,07-05-17,48,11:45,12:00,59.02,,0,59.02,59.02,1,-85874,62922,148796,-22952,0,0,22523,0,0,,22523,22523
27,07-05-17,49,12:00,12:15,59.02,24.94,0,24.94,24.94,-1,-46973,57468,104441,10495,0,-3265,4851,0,0,,8116,1586
27,07-05-17,50,12:15,12:30,,30.11,0,30.11,30.11,-1,-65719,56394,122113,-9325,0,-22,0,0,0,,22,-22
27,07-05-17,51,12:30,12:45,,28.11,0,28.11,28.11,-1,-58134,55684,113818,-2450,0,-19,0,0,0,,19,-19
27,07-05-17,52,12:45,13:00,,6.86,0,6.86,6.86,-1,-55728,83671,139399,27943,0,-14468,0,0,0,,14468,-14468
27,07-05-17,53,13:00,13:15,,-7.76,0,-7.76,-7.76,-1,-47309,101224,148533,53915,0,-39038,0,0,0,,39038,-39038
27,07-05-17,54,13:15,13:30,,24.7,0,24.7,24.7,-1,-69580,89642,159222,20062,0,-20273,0,0,0,,20273,-20273
27,07-05-17,55,13:30,13:45,28.18,26.47,0,28.18,28.18,1,-79475,81774,161249,2299,0,-10359,155,0,0,,10514,-10204
27,07-05-17,56,13:45,14:00,28.46,27.6,0,28.92,27.6,2,-67888,73496,141384,5608,0,-574,941,0,0,,1515,367
27,07-05-17,57,14:00,14:15,28.47,27.59,0,28.88,27.59,2,-50791,43355,94146,-7436,0,-550,449,0,0,,999,-101
27,07-05-17,58,14:15,14:30,29.11,,0,29.11,29.11,1,-53432,46116,99548,-7316,0,0,2925,0,0,,2925,2925
27,07-05-17,59,14:30,14:45,29.11,28.11,0,28.11,28.11,-1,-46705,47402,94107,697,0,-517,12,0,0,,529,-505
27,07-05-17,60,14:45,15:00,28.47,,0,28.47,28.47,1,-46608,43428,90036,-3180,0,0,553,0,0,,553,553
27,07-05-17,61,15:00,15:15,36.86,,0,36.86,36.86,1,-46192,20850,67042,-25342,0,0,6075,0,0,,6075,6075
27,07-05-17,62,15:15,15:30,40.72,,0,40.72,40.72,1,-53963,27407,81370,-26556,0,0,16751,0,0,,16751,16751
27,07-05-17,63,15:30,15:45,43.38,,0,43.38,43.38,1,-63289,28053,91342,-35236,0,0,26494,0,0,,26494,26494
27,07-05-17,64,15:45,16:00,34.96,,0,34.96,34.96,1,-48824,29567,78391,-19257,0,0,25074,0,0,,25074,25074
27,07-05-17,65,16:00,16:15,33.9,,0,33.9,33.9,1,-63553,34296,97849,-29257,0,0,17142,0,0,,17142,17142
27,07-05-17,66,16:15,16:30,44.9,,0,44.9,44.9,1,-72922,34872,107794,-38050,0,0,23198,0,0,,23198,23198
27,07-05-17,67,16:30,16:45,44.9,,0,44.9,44.9,1,-73856,34343,108199,-39513,0,0,29992,0,0,,29992,29992
27,07-05-17,68,16:45,17:00,65.63,,0,65.63,65.63,1,-86079,33418,119497,-52661,0,0,37800,0,0,,37800,37800
27,07-05-17,69,17:00,17:15,65.63,-7.03,0,-7.03,-7.03,-1,-36700,78626,115326,41926,0,-10164,15415,0,0,,25579,5251
27,07-05-17,70,17:15,17:30,31.65,24.74,0,31.65,24.74,2,-42410,33609,76019,-8801,0,-7682,1158,0,0,,8840,-6524
27,07-05-17,71,17:30,17:45,28.47,27.59,0,30.08,27.59,2,-29969,35364,65333,5395,0,-355,1783,0,0,,2138,1428
27,07-05-17,72,17:45,18:00,,25.47,0,25.47,25.47,-1,-30351,52118,82469,21767,0,-6322,0,0,0,,6322,-6322
27,07-05-17,73,18:00,18:15,30.75,25.47,0,30.75,30.75,1,-85675,21951,107626,-63724,0,-1835,914,0,0,,2749,-921
27,07-05-17,74,18:15,18:30,,,0,38.29,38.29,0,-36984,35480,72464,-1504,0,0,0,0,0,,0,0
27,07-05-17,75,18:30,18:45,,26.47,0,26.47,26.47,-1,-24247,48538,72785,24291,0,-3065,0,0,0,,3065,-3065
27,07-05-17,76,18:45,19:00,,27.42,0,27.42,27.42,-1,-23007,54012,77019,31005,0,-2051,0,0,0,,2051,-2051
27,07-05-17,77,19:00,19:15,,26.47,0,26.47,26.47,-1,-39005,50134,89139,11129,0,-2684,0,0,0,,2684,-2684
27,07-05-17,78,19:15,19:30,,27.34,0,27.34,27.34,-1,-33880,50928,84808,17048,0,-4654,0,0,0,,4654,-4654
27,07-05-17,79,19:30,19:45,,,0,30.08,30.08,0,-30675,53200,83875,22525,0,-642,0,0,0,,642,-642
27,07-05-17,80,19:45,20:00,,,0,30.08,30.08,0,-31749,35251,67000,3502,0,0,0,0,0,,0,0
27,07-05-17,81,20:00,20:15,50.15,,0,50.15,50.15,1,-51454,24244,75698,-27210,0,0,10271,0,0,,10271,10271
27,07-05-17,82,20:15,20:30,28.47,,0,28.47,28.47,1,-42638,26698,69336,-15940,0,0,7911,0,0,,7911,7911
27,07-05-17,83,20:30,20:45,31.75,,0,31.75,31.75,1,-38978,20495,59473,-18483,0,0,1957,0,0,,1957,1957
27,07-05-17,84,20:45,21:00,31.75,30.11,0,30.11,30.11,-1,-39002,29074,68076,-9928,0,-113,21,0,0,,134,-92
27,07-05-17,85,21:00,21:15,312.33,32.11,0,312.33,312.33,1,-113474,16509,129983,-96965,0,-40,8691,0,0,,8731,8651
27,07-05-17,86,21:15,21:30,312.33,,0,312.33,312.33,1,-84325,15316,99641,-69009,0,0,29849,0,0,,29849,29849
27,07-05-17,87,21:30,21:45,312.33,26.47,0,26.47,26.47,-1,-35640,34195,69835,-1445,0,-1631,700,0,0,,2331,-931
27,07-05-17,88,21:45,22:00,,29.16,0,29.16,29.16,-1,-50846,35695,86541,-15151,0,-471,0,0,0,,471,-471
27,07-05-17,89,22:00,22:15,,29.17,0,29.17,29.17,-1,-70070,58596,128666,-11474,0,-419,0,0,0,,419,-419
27,07-05-17,90,22:15,22:30,,,0,28.99,28.99,0,-82276,41274,123550,-41002,0,0,0,0,0,,0,0
27,07-05-17,91,22:30,22:45,31.83,,0,31.83,31.83,1,-73161,39867,113028,-33294,0,0,2328,0,0,,2328,2328
27,07-05-17,92,22:45,23:00,28.4,30.11,0,30.11,30.11,-1,-42664,46058,88722,3394,0,-131,1061,0,0,,1192,930
27,07-05-17,93,23:00,23:15,54.88,30.11,0,54.88,29.03,2,-87454,49357,136811,-38097,0,-151,8109,0,0,,8260,7958
27,07-05-17,94,23:15,23:30,30.07,,0,30.07,30.07,1,-66632,49728,116360,-16904,0,0,6117,0,0,,6117,6117
27,07-05-17,95,23:30,23:45,,25.47,0,25.47,25.47,-1,-45137,57231,102368,12094,0,-1750,0,0,0,,1750,-1750
27,07-05-17,96,23:45,0:00,,7.1,0,7.1,7.1,-1,-33626,78441,112067,44815,0,-31450,0,0,0,,31450,-31450
27,07-06-17,1,0:00,0:15,240.43,7.1,0,240.43,240.43,1,-105726,5861,111587,-99865,0,-12222,18739,0,0,,30961,6517
27,07-06-17,2,0:15,0:30,240.43,,0,240.43,240.43,1,-83214,33269,116483,-49945,0,0,50542,0,0,,50542,50542
27,07-06-17,3,0:30,0:45,,,0,28.09,28.09,0,-73184,45812,118996,-27372,0,0,1113,0,0,,1113,1113
27,07-06-17,4,0:45,1:00,,28.7,0,28.7,28.7,-1,-67315,61535,128850,-5780,0,-189,0,0,0,,189,-189
27,07-06-17,5,1:00,1:15,37.71,29.7,0,37.71,28.09,2,-92784,25141,117925,-67643,0,-106,5250,0,0,,5356,5144
27,07-06-17,6,1:15,1:30,28.47,,0,28.47,28.47,1,-65679,23539,89218,-42140,0,0,1824,0,0,,1824,1824
27,07-06-17,7,1:30,1:45,27.83,,0,27.83,27.83,1,-65230,24354,89584,-40876,0,0,13,0,0,,13,13
27,07-06-17,8,1:45,2:00,26.47,,0,26.47,26.47,1,-53966,33225,87191,-20741,0,0,67,0,0,,67,67
27,07-06-17,9,2:00,2:15,49.14,28.7,0,49.14,27.54,2,-46360,22695,69055,-23665,0,-164,3862,0,0,,4026,3698
27,07-06-17,10,2:15,2:30,130.12,,0,130.12,130.12,1,-52027,29984,82011,-22043,0,0,26247,0,0,,26247,26247
27,07-06-17,11,2:30,2:45,130.12,24.7,0,24.7,24.7,-1,-44862,42031,86893,-2831,0,-826,2465,0,0,,3291,1639
27,07-06-17,12,2:45,3:00,,28.7,0,28.7,28.7,-1,-52342,51877,104219,-465,0,-994,0,0,0,,994,-994
27,07-06-17,13,3:00,3:15,33.86,28.7,0,33.86,27.56,2,-53124,36924,90048,-16200,0,-1863,1278,0,0,,3141,-585
27,07-06-17,14,3:15,3:30,40.12,,0,40.12,40.12,1,-68405,27782,96187,-40623,0,0,15107,0,0,,15107,15107
27,07-06-17,15,3:30,3:45,32.43,,0,32.43,32.43,1,-55703,26231,81934,-29472,0,0,5477,0,0,,5477,5477
27,07-06-17,16,3:45,4:00,,,0,27.56,27.56,0,-51087,27712,78799,-23375,0,0,1514,0,0,,1514,1514
27,07-06-17,17,4:00,4:15,40.12,,0,40.12,40.12,1,-75906,10033,85939,-65873,0,0,11053,0,0,,11053,11053
27,07-06-17,18,4:15,4:30,34.02,,0,34.02,34.02,1,-61064,16806,77870,-44258,0,0,15551,0,0,,15551,15551
27,07-06-17,19,4:30,4:45,,,0,27.58,27.58,0,-80493,12644,93137,-67849,0,0,837,0,0,,837,837
27,07-06-17,20,4:45,5:00,,,0,27.58,27.58,0,-82145,13681,95826,-68464,0,0,0,0,0,,0,0
27,07-06-17,21,5:00,5:15,,,0,28.09,28.09,0,-86745,27121,113866,-59624,0,0,0,0,0,,0,0
27,07-06-17,22,5:15,5:30,,,0,28.09,28.09,0,-60655,22766,83421,-37889,0,0,0,0,0,,0,0
27,07-06-17,23,5:30,5:45,,,0,28.09,28.09,0,-69635,15004,84639,-54631,0,0,0,0,0,,0,0
27,07-06-17,24,5:45,6:00,,26.53,0,26.53,26.53,-1,-77624,16588,94212,-61036,0,-406,0,0,0,,406,-406
27,07-06-17,25,6:00,6:15,,-29.63,0,-29.63,-29.63,-1,-50674,88502,139176,37828,0,-22964,0,0,0,,22964,-22964
27,07-06-17,26,6:15,6:30,42.94,29.93,0,42.94,28.88,2,-77222,38676,115898,-38546,0,-2027,5797,0,0,,7824,3770
27,07-06-17,27,6:30,6:45,30.12,,0,30.12,30.12,1,-73987,30128,104115,-43859,0,0,3549,0,0,,3549,3549
27,07-06-17,28,6:45,7:00,189.64,,0,189.64,189.64,1,-104076,31228,135304,-72848,0,0,12824,0,0,,12824,12824
27,07-06-17,29,7:00,7:15,32.29,5.73,0,32.29,5.73,2,-32055,107684,139739,75629,0,-6158,5512,0,0,,11670,-646
27,07-06-17,30,7:15,7:30,,29.93,0,29.93,29.93,-1,-36477,64099,100576,27622,0,-888,0,0,0,,888,-888
27,07-06-17,31,7:30,7:45,48.29,29.93,0,48.29,28.88,2,-64179,40625,104804,-23554,0,-130,4396,0,0,,4526,4266
27,07-06-17,32,7:45,8:00,237.49,,0,237.49,237.49,1,-94500,49532,144032,-44968,0,0,35643,0,0,,35643,35643
27,07-06-17,33,8:00,8:15,31.93,24.93,0,37.31,24.93,2,-17600,94357,111957,76757,0,-1148,8866,0,0,,10014,7718
27,07-06-17,34,8:15,8:30,,,0,37.31,37.31,0,-24457,79487,103944,55030,0,0,0,0,0,,0,0
27,07-06-17,35,8:30,8:45,,,0,37.31,37.31,0,-31864,69430,101294,37566,0,0,0,0,0,,0,0
27,07-06-17,36,8:45,9:00,,,0,37.31,37.31,0,-45486,65516,111002,20030,0,0,0,0,0,,0,0
27,07-06-17,37,9:00,9:15,,28.93,0,28.93,28.93,-1,-14320,113915,128235,99595,0,-62,0,0,0,,62,-62
27,07-06-17,38,9:15,9:30,,28.93,0,28.93,28.93,-1,-21219,92190,113409,70971,0,-248,0,0,0,,248,-248
27,07-06-17,39,9:30,9:45,,29.93,0,29.93,29.93,-1,-30125,96618,126743,66493,0,-47,0,0,0,,47,-47
27,07-06-17,40,9:45,10:00,,29.1,0,29.1,29.1,-1,-33121,95063,128184,61942,0,-1019,0,0,0,,1019,-1019
27,07-06-17,41,10:00,10:15,,,0,28.88,28.88,0,-30453,76518,106971,46065,0,0,0,0,0,,0,0
27,07-06-17,42,10:15,10:30,,,0,28.88,28.88,0,-33068,83266,116334,50198,0,0,0,0,0,,0,0
27,07-06-17,43,10:30,10:45,,,0,28.88,28.88,0,-35068,83970,119038,48902,0,0,0,0,0,,0,0
27,07-06-17,44,10:45,11:00,,24.45,0,24.45,24.45,-1,-34322,82973,117295,48651,0,-2359,0,0,0,,2359,-2359
27,07-06-17,45,11:00,11:15,,21.33,0,21.33,21.33,-1,-42144,89499,131643,47355,0,-15510,0,0,0,,15510,-15510
27,07-06-17,46,11:15,11:30,,28.93,0,28.93,28.93,-1,-45217,83749,128966,38532,0,-5657,0,0,0,,5657,-5657
27,07-06-17,47,11:30,11:45,,,0,28.88,28.88,0,-37455,88201,125656,50746,0,0,0,0,0,,0,0
27,07-06-17,48,11:45,12:00,,27.41,0,27.41,27.41,-1,-41654,69976,111630,28322,0,-240,0,0,0,,240,-240
27,07-06-17,49,12:00,12:15,,19.38,0,19.38,19.38,-1,-28063,78692,106755,50629,0,-15683,0,0,0,,15683,-15683
27,07-06-17,50,12:15,12:30,,24.93,0,24.93,24.93,-1,-42205,62038,104243,19833,0,-22248,0,0,0,,22248,-22248
27,07-06-17,51,12:30,12:45,,27.13,0,27.13,27.13,-1,-34282,63701,97983,29419,0,-11747,0,0,0,,11747,-11747
27,07-06-17,52,12:45,13:00,,21.33,0,21.33,21.33,-1,-44163,59705,103868,15542,0,-10136,0,0,0,,10136,-10136
27,07-06-17,53,13:00,13:15,,21.33,0,21.33,21.33,-1,-39854,68073,107927,28219,0,-17885,0,0,0,,17885,-17885
27,07-06-17,54,13:15,13:30,27.83,26.53,0,27.83,27.83,1,-52566,49811,102377,-2755,0,-11442,5,0,0,,11447,-11437
27,07-06-17,55,13:30,13:45,31.93,26.53,0,31.93,31.93,1,-58310,44409,102719,-13901,0,-229,3639,0,0,,3868,3410
27,07-06-17,56,13:45,14:00,39.3,,0,39.3,39.3,1,-69938,45392,115330,-24546,0,0,11784,0,0,,11784,11784
27,07-06-17,57,14:00,14:15,73.22,,0,73.22,73.22,1,-78988,42198,121186,-36790,0,0,35332,0,0,,35332,35332
27,07-06-17,58,14:15,14:30,42.71,,0,42.71,42.71,1,-73950,63012,136962,-10938,0,0,24416,0,0,,24416,24416
27,07-06-17,59,14:30,14:45,44.15,,0,44.15,44.15,1,-81818,69075,150893,-12743,0,0,7887,0,0,,7887,7887
27,07-06-17,60,14:45,15:00,44.15,,0,44.15,44.15,1,-96629,70562,167191,-26067,0,0,15742,0,0,,15742,15742
27,07-06-17,61,15:00,15:15,77.22,,0,77.22,77.22,1,-103704,49733,153437,-53971,0,0,32963,0,0,,32963,32963
27,07-06-17,62,15:15,15:30,65.22,,0,65.22,65.22,1,-103815,48561,152376,-55254,0,0,40550,0,0,,40550,40550
27,07-06-17,63,15:30,15:45,54.22,,0,54.22,54.22,1,-111242,66925,178167,-44317,0,0,47358,0,0,,47358,47358
27,07-06-17,64,15:45,16:00,43.22,,0,43.22,43.22,1,-110450,65632,176082,-44818,0,0,31406,0,0,,31406,31406
27,07-06-17,65,16:00,16:15,39.03,,0,39.03,39.03,1,-79227,68739,147966,-10488,0,0,15615,0,0,,15615,15615
27,07-06-17,66,16:15,16:30,44.34,,0,44.34,44.34,1,-82166,41928,124094,-40238,0,0,7497,0,0,,7497,7497
27,07-06-17,67,16:30,16:45,55.03,,0,55.03,55.03,1,-81704,48902,130606,-32802,0,0,31067,0,0,,31067,31067
27,07-06-17,68,16:45,17:00,44.03,,0,44.03,44.03,1,-98170,55231,153401,-42939,0,0,29710,0,0,,29710,29710
27,07-06-17,69,17:00,17:15,81.63,,0,81.63,81.63,1,-81599,50924,132523,-30675,0,0,29690,0,0,,29690,29690
27,07-06-17,70,17:15,17:30,35.55,29.93,0,39.07,29.93,2,-62014,49329,111343,-12685,0,-183,7629,0,0,,7812,7446
27,07-06-17,71,17:30,17:45,65.74,,0,65.74,65.74,1,-83518,53846,137364,-29672,0,0,14563,0,0,,14563,14563
27,07-06-17,72,17:45,18:00,72.24,,0,72.24,72.24,1,-96074,67727,163801,-28347,0,0,28782,0,0,,28782,28782
27,07-06-17,73,18:00,18:15,31.22,26.39,0,39.07,26.39,2,-82181,105440,187621,23259,0,-1069,9099,0,0,,10168,8030
27,07-06-17,74,18:15,18:30,,,0,39.07,39.07,0,-83707,105391,189098,21684,0,0,0,0,0,,0,0
27,07-06-17,75,18:30,18:45,,26.53,0,26.53,26.53,-1,-70915,114966,185881,44051,0,-2274,0,0,0,,2274,-2274
27,07-06-17,76,18:45,19:00,,,0,39.07,39.07,0,-67684,99204,166888,31520,0,-22,0,0,0,,22,-22
27,07-06-17,77,19:00,19:15,31.47,,0,31.47,31.47,1,-98699,57721,156420,-40978,0,0,548,0,0,,548,548
27,07-06-17,78,19:15,19:30,31.22,,0,31.22,31.22,1,-82980,47639,130619,-35341,0,0,2734,0,0,,2734,2734
27,07-06-17,79,19:30,19:45,31.47,,0,31.47,31.47,1,-85891,38171,124062,-47720,0,0,802,0,0,,802,802
27,07-06-17,80,19:45,20:00,31.47,,0,31.47,31.47,1,-92459,35484,127943,-56975,0,0,2543,0,0,,2543,2543
27,07-06-17,81,20:00,20:15,55.56,,0,55.56,55.56,1,-134151,44580,178731,-89571,0,0,7975,0,0,,7975,7975
27,07-06-17,82,20:15,20:30,32.43,,0,32.43,32.43,1,-125042,41521,166563,-83521,0,0,9865,0,0,,9865,9865
27,07-06-17,83,20:30,20:45,,,0,39.04,39.04,0,-120608,36301,156909,-84307,0,0,931,0,0,,931,931
27,07-06-17,84,20:45,21:00,,,0,39.04,39.04,0,-112438,36185,148623,-76253,0,0,0,0,0,,0,0
27,07-06-17,85,21:00,21:15,323.95,,0,323.95,323.95,1,-127914,34447,162361,-93467,0,0,21384,0,0,,21384,21384
27,07-06-17,86,21:15,21:30,52.03,26.05,0,52.03,26.05,2,-72011,72518,144529,507,0,-83,25600,0,0,,25683,25517
27,07-06-17,87,21:30,21:45,52.03,23.46,0,23.46,23.46,-1,-43585,69775,113360,26190,0,-4217,735,0,0,,4952,-3482
27,07-06-17,88,21:45,22:00,,26.63,0,26.63,26.63,-1,-47379,63189,110568,15810,0,-7504,0,0,0,,7504,-7504
27,07-06-17,89,22:00,22:15,,26.64,0,26.64,26.64,-1,-60724,68498,129222,7774,0,-10402,0,0,0,,10402,-10402
27,07-06-17,90,22:15,22:30,,-5.44,0,-5.44,-5.44,-1,-59780,99451,159231,39671,0,-26349,0,0,0,,26349,-26349
27,07-06-17,91,22:30,22:45,,-6.3,0,-6.3,-6.3,-1,-52827,109777,162604,56950,0,-48410,0,0,0,,48410,-48410
27,07-06-17,92,22:45,23:00,,1.24,0,1.24,1.24,-1,-43516,119280,162796,75764,0,-67009,0,0,0,,67009,-67009
27,07-06-17,93,23:00,23:15,32.33,1.24,0,32.33,32.33,1,-116927,95155,212082,-21772,0,-25152,478,0,0,,25630,-24674
27,07-06-17,94,23:15,23:30,,-14.8,0,-14.8,-14.8,-1,-99386,126480,225866,27094,0,-4676,0,0,0,,4676,-4676
27,07-06-17,95,23:30,23:45,,-54.39,0,-54.39,-54.39,-1,-68005,148111,216116,80106,0,-64404,0,0,0,,64404,-64404
27,07-06-17,96,23:45,0:00,,-54.39,0,-54.39,-54.39,-1,-44509,170473,214982,125964,0,-89265,0,0,0,,89265,-89265
27,07-07-17,1,0:00,0:15,,-22.28,0,-22.28,-22.28,-1,-54060,167519,221579,113459,0,-77550,0,0,0,,77550,-77550
27,07-07-17,2,0:15,0:30,,-8.91,0,-8.91,-8.91,-1,-47518,151087,198605,103569,0,-72591,0,0,0,,72591,-72591
27,07-07-17,3,0:30,0:45,,-54.75,0,-54.75,-54.75,-1,-40611,162073,202684,121462,0,-101544,0,0,0,,101544,-101544
27,07-07-17,4,0:45,1:00,,-55.19,0,-55.19,-55.19,-1,-52789,192141,244930,139352,0,-103687,0,0,0,,103687,-103687
27,07-07-17,5,1:00,1:15,,-65.83,0,-65.83,-65.83,-1,-65046,123654,188700,58608,0,-57169,0,0,0,,57169,-57169
27,07-07-17,6,1:15,1:30,,,0,27.88,27.88,0,-78689,96341,175030,17652,0,0,0,0,0,,0,0
27,07-07-17,7,1:30,1:45,,,0,27.9,27.9,0,-79387,98359,177746,18972,0,0,0,0,0,,0,0
27,07-07-17,8,1:45,2:00,,,0,28.3,28.3,0,-96802,82944,179746,-13858,0,0,0,0,0,,0,0
27,07-07-17,9,2:00,2:15,41.93,,0,41.93,41.93,1,-106820,53546,160366,-53274,0,0,7757,0,0,,7757,7757
27,07-07-17,10,2:15,2:30,62.48,,0,62.48,62.48,1,-110688,50818,161506,-59870,0,0,27568,0,0,,27568,27568
27,07-07-17,11,2:30,2:45,33.4,,0,33.4,33.4,1,-76483,57182,133665,-19301,0,0,9873,0,0,,9873,9873
27,07-07-17,12,2:45,3:00,30.39,27.45,0,27.45,27.45,-1,-49447,70476,119923,21029,0,-499,4308,0,0,,4807,3809
27,07-07-17,13,3:00,3:15,30.39,27.24,0,27.24,27.24,-1,-25454,90220,115674,64766,0,-717,5,0,0,,722,-712
27,07-07-17,14,3:15,3:30,,,0,28.32,28.32,0,-30131,80037,110168,49906,0,0,0,0,0,,0,0
27,07-07-17,15,3:30,3:45,29.75,,0,29.75,29.75,1,-45359,55815,101174,10456,0,0,32,0,0,,32,32
27,07-07-17,16,3:45,4:00,36.46,,0,36.46,36.46,1,-65509,49223,114732,-16286,0,0,7668,0,0,,7668,7668
27,07-07-17,17,4:00,4:15,41.93,,0,41.93,41.93,1,-76232,30270,106502,-45962,0,0,21073,0,0,,21073,21073
27,07-07-17,18,4:15,4:30,41.93,,0,41.93,41.93,1,-80179,34696,114875,-45483,0,0,30268,0,0,,30268,30268
27,07-07-17,19,4:30,4:45,33.02,,0,33.02,33.02,1,-78079,45892,123971,-32187,0,0,20397,0,0,,20397,20397
27,07-07-17,20,4:45,5:00,35.93,,0,35.93,35.93,1,-75582,41618,117200,-33964,0,0,14876,0,0,,14876,14876
27,07-07-17,21,5:00,5:15,38.16,,0,38.16,38.16,1,-101343,24600,125943,-76743,0,0,11451,0,0,,11451,11451
27,07-07-17,22,5:15,5:30,38.16,28.93,0,28.93,28.93,-1,-31977,25372,57349,-6605,0,-204,569,0,0,,773,365
27,07-07-17,23,5:30,5:45,,28.93,0,28.93,28.93,-1,-28057,19825,47882,-8232,0,-3530,0,0,0,,3530,-3530
27,07-07-17,24,5:45,6:00,31.93,29.93,0,31.93,27.9,2,-60111,18830,78941,-41281,0,-234,225,0,0,,459,-9
27,07-07-17,25,6:00,6:15,,26.1,0,26.1,26.1,-1,-42123,65284,107407,23161,0,-5868,0,0,0,,5868,-5868
27,07-07-17,26,6:15,6:30,,30.39,0,30.39,30.39,-1,-40463,33055,73518,-7408,0,-866,0,0,0,,866,-866
27,07-07-17,27,6:30,6:45,,,0,29.09,29.09,0,-65095,32249,97344,-32846,0,0,0,0,0,,0,0
27,07-07-17,28,6:45,7:00,267.72,,0,267.72,267.72,1,-119097,43072,162169,-76025,0,0,18363,0,0,,18363,18363
27,07-07-17,29,7:00,7:15,267.72,22.74,0,22.74,22.74,-1,-34334,74970,109304,40636,0,-5613,6134,0,0,,11747,521
27,07-07-17,30,7:15,7:30,28.4,29.39,0,29.08,29.08,2,-51087,46683,97770,-4404,0,-1124,116,0,0,,1240,-1008
27,07-07-17,31,7:30,7:45,47.88,,0,47.88,47.88,1,-86459,41421,127880,-45038,0,0,9857,0,0,,9857,9857
27,07-07-17,32,7:45,8:00,300.98,,0,300.98,300.98,1,-132360,42713,175073,-89647,0,0,35051,0,0,,35051,35051
27,07-07-17,33,8:00,8:15,51.54,,0,51.54,51.54,1,-78742,39574,118316,-39168,0,0,30621,0,0,,30621,30621
27,07-07-17,34,8:15,8:30,51.54,,0,51.54,51.54,1,-79631,47447,127078,-32184,0,0,24084,0,0,,24084,24084
27,07-07-17,35,8:30,8:45,321.24,,0,321.24,321.24,1,-113092,51898,164990,-61194,0,0,36543,0,0,,36543,36543
27,07-07-17,36,8:45,9:00,321.24,,0,321.24,321.24,1,-130308,51413,181721,-78895,0,0,78948,0,0,,78948,78948
27,07-07-17,37,9:00,9:15,28.31,,0,28.31,28.31,1,-77686,76068,153754,-1618,0,0,24422,0,0,,24422,24422
27,07-07-17,38,9:15,9:30,31.94,,0,31.94,31.94,1,-81356,64425,145781,-16931,0,0,3430,0,0,,3430,3430
27,07-07-17,39,9:30,9:45,35.33,,0,35.33,35.33,1,-86643,52279,138922,-34364,0,0,9143,0,0,,9143,9143
27,07-07-17,40,9:45,10:00,51.58,,0,51.58,51.58,1,-91188,48077,139265,-43111,0,0,15211,0,0,,15211,15211
27,07-07-17,41,10:00,10:15,55.11,,0,55.11,55.11,1,-87354,33849,121203,-53505,0,0,25169,0,0,,25169,25169
27,07-07-17,42,10:15,10:30,50.61,,0,50.61,50.61,1,-100527,42120,142647,-58407,0,0,35418,0,0,,35418,35418
27,07-07-17,43,10:30,10:45,34.61,,0,34.61,34.61,1,-106699,45878,152577,-60821,0,0,17158,0,0,,17158,17158
27,07-07-17,44,10:45,11:00,39.61,,0,39.61,39.61,1,-129524,45977,175501,-83547,0,0,4977,0,0,,4977,4977
27,07-07-17,45,11:00,11:15,380.12,,0,380.12,380.12,1,-141234,52781,194015,-88453,0,0,26268,0,0,,26268,26268
27,07-07-17,46,11:15,11:30,38.12,,0,38.12,38.12,1,-120770,72168,192938,-48602,0,0,15136,0,0,,15136,15136
27,07-07-17,47,11:30,11:45,63.07,,0,63.07,63.07,1,-136874,63471,200345,-73403,0,0,14071,0,0,,14071,14071
27,07-07-17,48,11:45,12:00,49.31,,0,49.31,49.31,1,-134931,63394,198325,-71537,0,0,24236,0,0,,24236,24236
27,07-07-17,49,12:00,12:15,36.08,,0,36.08,36.08,1,-158430,54662,213092,-103768,0,0,13192,0,0,,13192,13192
27,07-07-17,50,12:15,12:30,33.59,,0,33.59,33.59,1,-153970,47320,201290,-106650,0,0,18813,0,0,,18813,18813
27,07-07-17,51,12:30,12:45,66.59,,0,66.59,66.59,1,-117569,49135,166704,-68434,0,0,20650,0,0,,20650,20650
27,07-07-17,52,12:45,13:00,36.39,,0,36.39,36.39,1,-119764,57685,177449,-62079,0,0,19941,0,0,,19941,19941
27,07-07-17,53,13:00,13:15,36.39,,0,36.39,36.39,1,-99235,80767,180002,-18468,0,0,6229,0,0,,6229,6229
27,07-07-17,54,13:15,13:30,33.4,,0,33.4,33.4,1,-122287,56414,178701,-65873,0,0,8377,0,0,,8377,8377
27,07-07-17,55,13:30,13:45,374.12,,0,374.12,374.12,1,-115043,55334,170377,-59709,0,0,29130,0,0,,29130,29130
27,07-07-17,56,13:45,14:00,42.39,29.39,0,29.39,29.39,-1,-86766,69901,156667,-16865,0,-38,21013,0,0,,21051,20975
27,07-07-17,57,14:00,14:15,30.82,27.31,0,30.82,27.31,2,-80497,56744,137241,-23753,0,-199,1360,0,0,,1559,1161
27,07-07-17,58,14:15,14:30,30.39,,0,30.39,30.39,1,-79540,49679,129219,-29861,0,0,2683,0,0,,2683,2683
27,07-07-17,59,14:30,14:45,28.38,,0,28.38,28.38,1,-68502,51158,119660,-17344,0,0,3262,0,0,,3262,3262
27,07-07-17,60,14:45,15:00,,,0,28.67,28.67,0,-63088,54154,117242,-8934,0,0,870,0,0,,870,870
27,07-07-17,61,15:00,15:15,36.39,30.39,0,36.39,36.39,1,-110628,86748,197376,-23880,0,-24,2920,0,0,,2944,2896
27,07-07-17,62,15:15,15:30,36.39,,0,36.39,36.39,1,-102982,89710,192692,-13272,0,0,8138,0,0,,8138,8138
27,07-07-17,63,15:30,15:45,,,0,28.65,28.65,0,-112338,91817,204155,-20521,0,0,202,0,0,,202,202
27,07-07-17,64,15:45,16:00,31.52,,0,31.52,31.52,1,-104689,94157,198846,-10532,0,0,495,0,0,,495,495
27,07-07-17,65,16:00,16:15,134.88,,0,134.88,134.88,1,-96275,46800,143075,-49475,0,0,24980,0,0,,24980,24980
27,07-07-17,66,16:15,16:30,37.12,,0,37.12,37.12,1,-67867,44355,112222,-23512,0,0,26769,0,0,,26769,26769
27,07-07-17,67,16:30,16:45,42.39,,0,42.39,42.39,1,-65649,36816,102465,-28833,0,0,10000,0,0,,10000,10000
27,07-07-17,68,16:45,17:00,57.33,,0,57.33,57.33,1,-76898,40130,117028,-36768,0,0,23893,0,0,,23893,23893
27,07-07-17,69,17:00,17:15,,,0,28.67,28.67,0,-84149,58426,142575,-25723,0,0,4247,0,0,,4247,4247
27,07-07-17,70,17:15,17:30,33.91,,0,33.91,33.91,1,-109135,64507,173642,-44628,0,0,3609,0,0,,3609,3609
27,07-07-17,71,17:30,17:45,36.39,,0,36.39,36.39,1,-110808,75192,186000,-35616,0,0,21187,0,0,,21187,21187
27,07-07-17,72,17:45,18:00,43.87,,0,43.87,43.87,1,-101566,60971,162537,-40595,0,0,29567,0,0,,29567,29567
27,07-07-17,73,18:00,18:15,33.51,27.31,0,33.51,27.31,2,-77217,84676,161893,7459,0,-379,13656,0,0,,14035,13277
27,07-07-17,74,18:15,18:30,33.51,29.39,0,29.39,29.39,-1,-71887,91324,163211,19437,0,-1167,6,0,0,,1173,-1161
27,07-07-17,75,18:30,18:45,,29.39,0,29.39,29.39,-1,-56708,103127,159835,46419,0,-2205,0,0,0,,2205,-2205
27,07-07-17,76,18:45,19:00,,,0,28.63,28.63,0,-56040,109383,165423,53343,0,-282,0,0,0,,282,-282
27,07-07-17,77,19:00,19:15,,30.39,0,30.39,30.39,-1,-56418,90093,146511,33675,0,-430,0,0,0,,430,-430
27,07-07-17,78,19:15,19:30,,29.39,0,29.39,29.39,-1,-54602,96762,151364,42160,0,-1907,0,0,0,,1907,-1907
27,07-07-17,79,19:30,19:45,,24.22,0,24.22,24.22,-1,-60807,102196,163003,41389,0,-8469,0,0,0,,8469,-8469
27,07-07-17,80,19:45,20:00,30.98,24.22,0,30.98,30.98,1,-119066,113526,232592,-5540,0,-2482,292,0,0,,2774,-2190
27,07-07-17,81,20:00,20:15,92.12,,0,92.12,92.12,1,-79503,39380,118883,-40123,0,0,17597,0,0,,17597,17597
27,07-07-17,82,20:15,20:30,47.8,,0,47.8,47.8,1,-75628,34746,110374,-40882,0,0,33770,0,0,,33770,33770
27,07-07-17,83,20:30,20:45,32.74,,0,32.74,32.74,1,-49529,28687,78216,-20842,0,0,5394,0,0,,5394,5394
27,07-07-17,84,20:45,21:00,33.01,,0,33.01,33.01,1,-50817,15028,65845,-35789,0,0,4349,0,0,,4349,4349
27,07-07-17,85,21:00,21:15,97.58,,0,97.58,97.58,1,-70137,33615,103752,-36522,0,0,19595,0,0,,19595,19595
27,07-07-17,86,21:15,21:30,39.48,,0,39.48,39.48,1,-48975,43074,92049,-5901,0,0,25295,0,0,,25295,25295
27,07-07-17,87,21:30,21:45,39.48,29.39,0,29.39,29.39,-1,-25464,50199,75663,24735,0,-658,2755,0,0,,3413,2097
27,07-07-17,88,21:45,22:00,,29.39,0,29.39,29.39,-1,-28885,65365,94250,36480,0,-480,0,0,0,,480,-480
27,07-07-17,89,22:00,22:15,,29.39,0,29.39,29.39,-1,-48149,79169,127318,31020,0,-1392,0,0,0,,1392,-1392
27,07-07-17,90,22:15,22:30,,,0,29.27,29.27,0,-59303,54509,113812,-4794,0,0,0,0,0,,0,0
27,07-07-17,91,22:30,22:45,27.79,,0,27.79,27.79,1,-45294,49521,94815,4227,0,0,19,0,0,,19,19
27,07-07-17,92,22:45,23:00,27.8,26.49,0,29.27,26.49,2,-30984,58520,89504,27536,0,-1356,126,0,0,,1482,-1230
27,07-07-17,93,23:00,23:15,380.12,30.74,0,380.12,28.29,2,-181715,107511,289226,-74204,0,-206,23319,0,0,,23525,23113
27,07-07-17,94,23:15,23:30,100.79,,0,100.79,100.79,1,-173185,115261,288446,-57924,0,0,50709,0,0,,50709,50709
27,07-07-17,95,23:30,23:45,42.39,,0,42.39,42.39,1,-167762,134464,302226,-33298,0,0,21246,0,0,,21246,21246
27,07-07-17,96,23:45,0:00,36.39,10.26,0,10.26,10.26,-1,-127441,146671,274112,19230,0,-2329,13354,0,0,,15683,11025
28,07-08-17,1,0:00,0:15,185.39,-6.2,0,185.39,185.39,1,-93639,60708,154347,-32931,0,-3322,8131,0,0,,11453,4809
28,07-08-17,2,0:15,0:30,185.39,25.39,0,185.39,25.39,2,-60822,67436,128258,6614,0,-199,25368,0,0,,25567,25169
28,07-08-17,3,0:30,0:45,185.39,25.39,0,25.39,25.39,-1,-48306,57165,105471,8859,0,-1637,132,0,0,,1769,-1505
28,07-08-17,4,0:45,1:00,,29.01,0,29.01,29.01,-1,-51829,58288,110117,6459,0,-3739,0,0,0,,3739,-3739
28,07-08-17,5,1:00,1:15,,30.39,0,30.39,30.39,-1,-86206,76809,163015,-9397,0,-262,0,0,0,,262,-262
28,07-08-17,6,1:15,1:30,30.44,,0,30.44,30.44,1,-91128,31112,122240,-60016,0,0,2444,0,0,,2444,2444
28,07-08-17,7,1:30,1:45,,,0,28.22,28.22,0,-73506,29702,103208,-43804,0,0,172,0,0,,172,172
28,07-08-17,8,1:45,2:00,,27.21,0,27.21,27.21,-1,-49377,51519,100896,2142,0,-969,0,0,0,,969,-969
28,07-08-17,9,2:00,2:15,170.89,30.39,0,170.89,28.23,2,-97484,26362,123846,-71122,0,-211,18403,0,0,,18614,18192
28,07-08-17,10,2:15,2:30,42.39,,0,42.39,42.39,1,-72887,45554,118441,-27333,0,0,23469,0,0,,23469,23469
28,07-08-17,11,2:30,2:45,,,0,28.23,28.23,0,-55558,30933,86491,-24625,0,0,996,0,0,,996,996
28,07-08-17,12,2:45,3:00,,,0,28.23,28.23,0,-49239,29689,78928,-19550,0,0,0,0,0,,0,0
28,07-08-17,13,3:00,3:15,42.39,,0,42.39,42.39,1,-106290,31684,137974,-74606,0,0,4230,0,0,,4230,4230
28,07-08-17,14,3:15,3:30,165.63,,0,165.63,165.63,1,-106784,39418,146202,-67366,0,0,40384,0,0,,40384,40384
28,07-08-17,15,3:30,3:45,39.28,,0,39.28,39.28,1,-79440,38982,118422,-40458,0,0,34114,0,0,,34114,34114
28,07-08-17,16,3:45,4:00,28.85,,0,28.85,28.85,1,-59077,39485,98562,-19592,0,0,8525,0,0,,8525,8525
28,07-08-17,17,4:00,4:15,49.12,,0,49.12,49.12,1,-73233,37733,110966,-35500,0,0,8225,0,0,,8225,8225
28,07-08-17,18,4:15,4:30,33.72,,0,33.72,33.72,1,-67676,44615,112291,-23061,0,0,17190,0,0,,17190,17190
28,07-08-17,19,4:30,4:45,28.85,,0,28.85,28.85,1,-59240,52297,111537,-6943,0,0,7443,0,0,,7443,7443
28,07-08-17,20,4:45,5:00,28.85,30.39,0,28.85,28.24,2,-59602,60333,119935,731,0,-70,224,0,0,,294,154
28,07-08-17,21,5:00,5:15,165.36,,0,165.36,165.36,1,-86292,33174,119466,-53118,0,0,26708,0,0,,26708,26708
28,07-08-17,22,5:15,5:30,34.12,,0,34.12,34.12,1,-64609,39864,104473,-24745,0,0,17975,0,0,,17975,17975
28,07-08-17,23,5:30,5:45,28.75,,0,28.75,28.75,1,-59439,35070,94509,-24369,0,0,4659,0,0,,4659,4659
28,07-08-17,24,5:45,6:00,28.74,,0,28.74,28.74,1,-52295,32536,84831,-19759,0,0,570,0,0,,570,570
28,07-08-17,25,6:00,6:15,29.62,,0,29.62,29.62,1,-46320,57725,104045,11405,0,0,2294,0,0,,2294,2294
28,07-08-17,26,6:15,6:30,36.83,,0,36.83,36.83,1,-53373,36881,90254,-16492,0,0,1969,0,0,,1969,1969
28,07-08-17,27,6:30,6:45,40.98,,0,40.98,40.98,1,-66844,42650,109494,-24194,0,0,18108,0,0,,18108,18108
28,07-08-17,28,6:45,7:00,42.83,,0,42.83,42.83,1,-89716,35303,125019,-54413,0,0,20065,0,0,,20065,20065
28,07-08-17,29,7:00,7:15,44.52,,0,44.52,44.52,1,-51720,44384,96104,-7336,0,0,22092,0,0,,22092,22092
28,07-08-17,30,7:15,7:30,28.73,29.83,0,28.73,28.5,2,-51847,51926,103773,79,0,-1245,2186,0,0,,3431,941
28,07-08-17,31,7:30,7:45,36.83,,0,36.83,36.83,1,-74728,51766,126494,-22962,0,0,6022,0,0,,6022,6022
28,07-08-17,32,7:45,8:00,49.12,,0,49.12,49.12,1,-106228,61472,167700,-44756,0,0,31132,0,0,,31132,31132
28,07-08-17,33,8:00,8:15,42.21,29.83,0,29.83,29.83,-1,-64595,40268,104863,-24327,0,-6,25479,0,0,,25485,25473
28,07-08-17,34,8:15,8:30,60.12,29.83,0,60.12,28.5,2,-74311,39405,113716,-34906,0,-75,4594,0,0,,4669,4519
28,07-08-17,35,8:30,8:45,185.83,,0,185.83,185.83,1,-97609,52857,150466,-44752,0,0,37566,0,0,,37566,37566
28,07-08-17,36,8:45,9:00,42.83,,0,42.83,42.83,1,-107895,79966,187861,-27929,0,0,21711,0,0,,21711,21711
28,07-08-17,37,9:00,9:15,32.83,29.83,0,29.83,29.83,-1,-40925,103704,144629,62779,0,-734,8849,0,0,,9583,8115
28,07-08-17,38,9:15,9:30,32.83,29.83,0,29.83,29.83,-1,-53348,82032,135380,28684,0,-2668,27,0,0,,2695,-2641
28,07-08-17,39,9:30,9:45,,,0,28.49,28.49,0,-61215,64748,125963,3533,0,0,0,0,0,,0,0
28,07-08-17,40,9:45,10:00,31.14,,0,31.14,31.14,1,-75073,46606,121679,-28467,0,0,3280,0,0,,3280,3280
28,07-08-17,41,10:00,10:15,28.68,,0,28.68,28.68,1,-81673,57814,139487,-23859,0,0,2941,0,0,,2941,2941
28,07-08-17,42,10:15,10:30,32.09,,0,32.09,32.09,1,-78683,55601,134284,-23082,0,0,3032,0,0,,3032,3032
28,07-08-17,43,10:30,10:45,32.83,,0,32.83,32.83,1,-81812,58266,140078,-23546,0,0,3167,0,0,,3167,3167
28,07-08-17,44,10:45,11:00,36.83,,0,36.83,36.83,1,-89755,52449,142204,-37306,0,0,6015,0,0,,6015,6015
28,07-08-17,45,11:00,11:15,33.88,,0,33.88,33.88,1,-87873,33177,121050,-54696,0,0,8664,0,0,,8664,8664
28,07-08-17,46,11:15,11:30,27.79,,0,27.79,27.79,1,-76298,34157,110455,-42141,0,0,1383,0,0,,1383,1383
28,07-08-17,47,11:30,11:45,31,,0,31,31,1,-64264,44161,108425,-20103,0,0,1605,0,0,,1605,1605
28,07-08-17,48,11:45,12:00,30.83,,0,30.83,30.83,1,-61836,38241,100077,-23595,0,0,2713,0,0,,2713,2713
28,07-08-17,49,12:00,12:15,,,0,28.45,28.45,0,-87832,56002,143834,-31830,0,0,141,0,0,,141,141
28,07-08-17,50,12:15,12:30,27.65,,0,27.65,27.65,1,-87502,41944,129446,-45558,0,0,701,0,0,,701,701
28,07-08-17,51,12:30,12:45,32.94,,0,32.94,32.94,1,-67380,43500,110880,-23880,0,0,3869,0,0,,3869,3869
28,07-08-17,52,12:45,13:00,32.23,,0,32.23,32.23,1,-70665,42246,112911,-28419,0,0,7140,0,0,,7140,7140
28,07-08-17,53,13:00,13:15,84.88,,0,84.88,84.88,1,-98675,40416,139091,-58259,0,0,19792,0,0,,19792,19792
28,07-08-17,54,13:15,13:30,42.83,,0,42.83,42.83,1,-91847,48020,139867,-43827,0,0,34344,0,0,,34344,34344
28,07-08-17,55,13:30,13:45,34.63,,0,34.63,34.63,1,-91157,39839,130996,-51318,0,0,15136,0,0,,15136,15136
28,07-08-17,56,13:45,14:00,,,0,28.43,28.43,0,-89044,36560,125604,-52484,0,0,2175,0,0,,2175,2175
28,07-08-17,57,14:00,14:15,27.66,,0,27.66,27.66,1,-126496,35106,161602,-91390,0,0,21,0,0,,21,21
28,07-08-17,58,14:15,14:30,27.89,,0,27.89,27.89,1,-105452,33489,138941,-71963,0,0,805,0,0,,805,805
28,07-08-17,59,14:30,14:45,30.83,,0,30.83,30.83,1,-104827,31616,136443,-73211,0,0,1864,0,0,,1864,1864
28,07-08-17,60,14:45,15:00,30.72,,0,30.72,30.72,1,-108543,34319,142862,-74224,0,0,2994,0,0,,2994,2994
28,07-08-17,61,15:00,15:15,185.26,,0,185.26,185.26,1,-103723,37336,141059,-66387,0,0,21562,0,0,,21562,21562
28,07-08-17,62,15:15,15:30,36.83,,0,36.83,36.83,1,-70200,40843,111043,-29357,0,0,21716,0,0,,21716,21716
28,07-08-17,63,15:30,15:45,36.83,,0,36.83,36.83,1,-78282,39645,117927,-38637,0,0,17455,0,0,,17455,17455
28,07-08-17,64,15:45,16:00,48.08,,0,48.08,48.08,1,-84941,36675,121616,-48266,0,0,28385,0,0,,28385,28385
28,07-08-17,65,16:00,16:15,32.82,27.4,0,32.82,27.4,2,-60856,58266,119122,-2590,0,-279,10546,0,0,,10825,10267
28,07-08-17,66,16:15,16:30,38.17,,0,38.17,38.17,1,-68819,48307,117126,-20512,0,0,6503,0,0,,6503,6503
28,07-08-17,67,16:30,16:45,31.07,,0,31.07,31.07,1,-59187,50018,109205,-9169,0,0,6829,0,0,,6829,6829
28,07-08-17,68,16:45,17:00,30.83,,0,30.83,30.83,1,-56478,48445,104923,-8033,0,0,6699,0,0,,6699,6699
28,07-08-17,69,17:00,17:15,30.83,29.83,0,29.83,29.83,-1,-29989,67436,97425,37447,0,-417,2474,0,0,,2891,2057
28,07-08-17,70,17:15,17:30,,30.83,0,30.83,30.83,-1,-42787,61032,103819,18245,0,-432,0,0,0,,432,-432
28,07-08-17,71,17:30,17:45,,,0,28.32,28.32,0,-39808,53308,93116,13500,0,0,0,0,0,,0,0
28,07-08-17,72,17:45,18:00,30.72,,0,30.72,30.72,1,-40940,47042,87982,6102,0,0,277,0,0,,277,277
28,07-08-17,73,18:00,18:15,29.13,29.83,0,29.13,28.34,2,-38319,63310,101629,24991,0,-27,789,0,0,,816,762
28,07-08-17,74,18:15,18:30,,29.83,0,29.83,29.83,-1,-34119,51915,86034,17796,0,-241,0,0,0,,241,-241
28,07-08-17,75,18:30,18:45,,29.83,0,29.83,29.83,-1,-33305,39824,73129,6519,0,-332,0,0,0,,332,-332
28,07-08-17,76,18:45,19:00,32.83,30.83,0,32.83,28.33,2,-54008,35083,89091,-18925,0,-218,1451,0,0,,1669,1233
28,07-08-17,77,19:00,19:15,28.56,,0,28.56,28.56,1,-72046,21708,93754,-50338,0,0,2275,0,0,,2275,2275
28,07-08-17,78,19:15,19:30,32.83,,0,32.83,32.83,1,-84785,13041,97826,-71744,0,0,1739,0,0,,1739,1739
28,07-08-17,79,19:30,19:45,32.61,,0,32.61,32.61,1,-87341,12633,99974,-74708,0,0,3568,0,0,,3568,3568
28,07-08-17,80,19:45,20:00,40.75,,0,40.75,40.75,1,-107960,12631,120591,-95329,0,0,10370,0,0,,10370,10370
28,07-08-17,81,20:00,20:15,36.83,,0,36.83,36.83,1,-79861,39096,118957,-40765,0,0,11286,0,0,,11286,11286
28,07-08-17,82,20:15,20:30,32.83,,0,32.83,32.83,1,-97486,30291,127777,-67195,0,0,3182,0,0,,3182,3182
28,07-08-17,83,20:30,20:45,36.83,,0,36.83,36.83,1,-90652,35820,126472,-54832,0,0,3341,0,0,,3341,3341
28,07-08-17,84,20:45,21:00,,,0,28.41,28.41,0,-88368,36790,125158,-51578,0,0,295,0,0,,295,295
28,07-08-17,85,21:00,21:15,,25.83,0,25.83,25.83,-1,-108724,154125,262849,45401,0,-2596,0,0,0,,2596,-2596
28,07-08-17,86,21:15,21:30,,21.8,0,21.8,21.8,-1,-102954,150798,253752,47844,0,-22978,0,0,0,,22978,-22978
28,07-08-17,87,21:30,21:45,,25.52,0,25.52,25.52,-1,-94332,136813,231145,42481,0,-33183,0,0,0,,33183,-33183
28,07-08-17,88,21:45,22:00,,22.78,0,22.78,22.78,-1,-105436,128255,233691,22819,0,-32740,0,0,0,,32740,-32740
28,07-08-17,89,22:00,22:15,,26.78,0,26.78,26.78,-1,-86650,123724,210374,37074,0,-20995,0,0,0,,20995,-20995
28,07-08-17,90,22:15,22:30,,29.83,0,29.83,29.83,-1,-101304,117333,218637,16029,0,-5649,0,0,0,,5649,-5649
28,07-08-17,91,22:30,22:45,,29.83,0,29.83,29.83,-1,-93309,118838,212147,25529,0,-724,0,0,0,,724,-724
28,07-08-17,92,22:45,23:00,,29.83,0,29.83,29.83,-1,-87234,124441,211675,37207,0,-1050,0,0,0,,1050,-1050
28,07-08-17,93,23:00,23:15,,29.83,0,29.83,29.83,-1,-92823,118409,211232,25586,0,-2885,0,0,0,,2885,-2885
28,07-08-17,94,23:15,23:30,,24.7,0,24.7,24.7,-1,-88765,110565,199330,21800,0,-6323,0,0,0,,6323,-6323
28,07-08-17,95,23:30,23:45,,26.32,0,26.32,26.32,-1,-65476,113755,179231,48279,0,-10088,0,0,0,,10088,-10088
28,07-08-17,96,23:45,0:00,,19.02,0,19.02,19.02,-1,-48799,123321,172120,74522,0,-14886,0,0,0,,14886,-14886
28,07-09-17,1,0:00,0:15,31.52,17.43,0,31.52,17.43,2,-54780,35360,90140,-19420,0,-13435,385,0,0,,13820,-13050
28,07-09-17,2,0:15,0:30,36.83,30.83,0,36.83,29.23,2,-56786,31091,87877,-25695,0,-197,2599,0,0,,2796,2402
28,07-09-17,3,0:30,0:45,,30.83,0,30.83,30.83,-1,-34830,24363,59193,-10467,0,-262,0,0,0,,262,-262
28,07-09-17,4,0:45,1:00,,28.74,0,28.74,28.74,-1,-72895,40522,113417,-32373,0,-1470,0,0,0,,1470,-1470
28,07-09-17,5,1:00,1:15,128.02,,0,128.02,128.02,1,-77926,37771,115697,-40155,0,0,13573,0,0,,13573,13573
28,07-09-17,6,1:15,1:30,37.26,30.83,0,30.83,30.83,-1,-52848,50517,103365,-2331,0,-5,15859,0,0,,15864,15854
28,07-09-17,7,1:30,1:45,37.26,30.83,0,30.83,30.83,-1,-52396,43821,96217,-8575,0,-97,252,0,0,,349,155
28,07-09-17,8,1:45,2:00,32.83,,0,32.83,32.83,1,-84792,48217,133009,-36575,0,0,2781,0,0,,2781,2781
28,07-09-17,9,2:00,2:15,32.74,,0,32.74,32.74,1,-55798,51774,107572,-4024,0,0,3220,0,0,,3220,3220
28,07-09-17,10,2:15,2:30,63.01,,0,63.01,63.01,1,-80627,41665,122292,-38962,0,0,16728,0,0,,16728,16728
28,07-09-17,11,2:30,2:45,29.62,,0,29.62,29.62,1,-75990,45375,121365,-30615,0,0,2263,0,0,,2263,2263
28,07-09-17,12,2:45,3:00,31.17,,0,31.17,31.17,1,-62932,43948,106880,-18984,0,0,846,0,0,,846,846
28,07-09-17,13,3:00,3:15,42.83,,0,42.83,42.83,1,-82925,57295,140220,-25630,0,0,3228,0,0,,3228,3228
28,07-09-17,14,3:15,3:30,42.83,,0,42.83,42.83,1,-72144,46233,118377,-25911,0,0,11629,0,0,,11629,11629
28,07-09-17,15,3:30,3:45,,,0,28.27,28.27,0,-69481,47029,116510,-22452,0,0,899,0,0,,899,899
28,07-09-17,16,3:45,4:00,,29.83,0,29.83,29.83,-1,-60502,46421,106923,-14081,0,-55,0,0,0,,55,-55
28,07-09-17,17,4:00,4:15,,29.83,0,29.83,29.83,-1,-86463,74815,161278,-11648,0,-1509,0,0,0,,1509,-1509
28,07-09-17,18,4:15,4:30,,,0,28.26,28.26,0,-82706,45886,128592,-36820,0,-37,0,0,0,,37,-37
28,07-09-17,19,4:30,4:45,,,0,28.26,28.26,0,-72592,45408,118000,-27184,0,0,0,0,0,,0,0
28,07-09-17,20,4:45,5:00,,,0,28.26,28.26,0,-69679,44262,113941,-25417,0,0,0,0,0,,0,0
28,07-09-17,21,5:00,5:15,72.02,,0,72.02,72.02,1,-93130,58701,151831,-34429,0,0,14700,0,0,,14700,14700
28,07-09-17,22,5:15,5:30,28.03,,0,28.03,28.03,1,-44337,59566,103903,15229,0,0,2501,0,0,,2501,2501
28,07-09-17,23,5:30,5:45,,,0,28.26,28.26,0,-39385,63820,103205,24435,0,0,0,0,0,,0,0
28,07-09-17,24,5:45,6:00,,,0,28.27,28.27,0,-41073,77049,118122,35976,0,0,0,0,0,,0,0
28,07-09-17,25,6:00,6:15,,30.82,0,30.82,30.82,-1,-40761,91117,131878,50356,0,-131,0,0,0,,131,-131
28,07-09-17,26,6:15,6:30,,30.82,0,30.82,30.82,-1,-35574,67880,103454,32306,0,-42,0,0,0,,42,-42
28,07-09-17,27,6:30,6:45,,,0,28.27,28.27,0,-39988,77685,117673,37697,0,0,0,0,0,,0,0
28,07-09-17,28,6:45,7:00,,,0,28.27,28.27,0,-36556,82156,118712,45600,0,0,0,0,0,,0,0
28,07-09-17,29,7:00,7:15,,29.82,0,29.82,29.82,-1,-24941,56284,81225,31343,0,-365,0,0,0,,365,-365
28,07-09-17,30,7:15,7:30,,29.82,0,29.82,29.82,-1,-24695,65494,90189,40799,0,-1187,0,0,0,,1187,-1187
28,07-09-17,31,7:30,7:45,,30.82,0,30.82,30.82,-1,-30757,80659,111416,49902,0,-223,0,0,0,,223,-223
28,07-09-17,32,7:45,8:00,,30.82,0,30.82,30.82,-1,-46769,96248,143017,49479,0,-9,0,0,0,,9,-9
28,07-09-17,33,8:00,8:15,,27.4,0,27.4,27.4,-1,-31638,59462,91100,27824,0,-1516,0,0,0,,1516,-1516
28,07-09-17,34,8:15,8:30,,29.82,0,29.82,29.82,-1,-35114,78745,113859,43631,0,-664,0,0,0,,664,-664
28,07-09-17,35,8:30,8:45,,30.82,0,30.82,30.82,-1,-41476,87297,128773,45821,0,-25,0,0,0,,25,-25
28,07-09-17,36,8:45,9:00,,,0,28.15,28.15,0,-46795,92961,139756,46166,0,0,0,0,0,,0,0
28,07-09-17,37,9:00,9:15,,27.38,0,27.38,27.38,-1,-43710,70687,114397,26977,0,-397,0,0,0,,397,-397
28,07-09-17,38,9:15,9:30,,30.82,0,30.82,30.82,-1,-25551,65464,91015,39913,0,-133,0,0,0,,133,-133
28,07-09-17,39,9:30,9:45,,29.82,0,29.82,29.82,-1,-24273,67045,91318,42772,0,-1026,0,0,0,,1026,-1026
28,07-09-17,40,9:45,10:00,,30.82,0,30.82,30.82,-1,-28843,81568,110411,52725,0,-14,0,0,0,,14,-14
28,07-09-17,41,10:00,10:15,,30.82,0,30.82,30.82,-1,-26043,76476,102519,50433,0,-9,0,0,0,,9,-9
28,07-09-17,42,10:15,10:30,,30.82,0,30.82,30.82,-1,-29132,88250,117382,59118,0,-62,0,0,0,,62,-62
28,07-09-17,43,10:30,10:45,,18.51,0,18.51,18.51,-1,-30941,90649,121590,59708,0,-4512,0,0,0,,4512,-4512
28,07-09-17,44,10:45,11:00,,25.82,0,25.82,25.82,-1,-32650,86304,118954,53654,0,-3439,0,0,0,,3439,-3439
28,07-09-17,45,11:00,11:15,,25.82,0,25.82,25.82,-1,-30116,70957,101073,40841,0,-4036,0,0,0,,4036,-4036
28,07-09-17,46,11:15,11:30,,27.34,0,27.34,27.34,-1,-35358,71265,106623,35907,0,-140,0,0,0,,140,-140
28,07-09-17,47,11:30,11:45,,25.82,0,25.82,25.82,-1,-29709,67938,97647,38229,0,-7003,0,0,0,,7003,-7003
28,07-09-17,48,11:45,12:00,,24.22,0,24.22,24.22,-1,-27992,59932,87924,31940,0,-13990,0,0,0,,13990,-13990
28,07-09-17,49,12:00,12:15,,22.98,0,22.98,22.98,-1,-29497,56805,86302,27308,0,-18995,0,0,0,,18995,-18995
28,07-09-17,50,12:15,12:30,,25.82,0,25.82,25.82,-1,-34626,48572,83198,13946,0,-17245,0,0,0,,17245,-17245
28,07-09-17,51,12:30,12:45,,25.55,0,25.55,25.55,-1,-34427,53581,88008,19154,0,-13390,0,0,0,,13390,-13390
28,07-09-17,52,12:45,13:00,,24.36,0,24.36,24.36,-1,-42477,49120,91597,6643,0,-18445,0,0,0,,18445,-18445
28,07-09-17,53,13:00,13:15,30.11,24.36,0,30.11,30.11,1,-32277,44055,76332,11778,0,-5320,470,0,0,,5790,-4850
28,07-09-17,54,13:15,13:30,,25.82,0,25.82,25.82,-1,-32981,52861,85842,19880,0,-3923,0,0,0,,3923,-3923
28,07-09-17,55,13:30,13:45,,28.81,0,28.81,28.81,-1,-40634,47426,88060,6792,0,-5440,0,0,0,,5440,-5440
28,07-09-17,56,13:45,14:00,,24.7,0,24.7,24.7,-1,-41318,52008,93326,10690,0,-10717,0,0,0,,10717,-10717
28,07-09-17,57,14:00,14:15,,24.25,0,24.25,24.25,-1,-33519,47798,81317,14279,0,-11444,0,0,0,,11444,-11444
28,07-09-17,58,14:15,14:30,30.2,24.25,0,30.2,30.2,1,-35133,49438,84571,14305,0,-514,125,0,0,,639,-389
28,07-09-17,59,14:30,14:45,,29.82,0,29.82,29.82,-1,-33459,51704,85163,18245,0,-762,0,0,0,,762,-762
28,07-09-17,60,14:45,15:00,,25.82,0,25.82,25.82,-1,-30539,69059,99598,38520,0,-6445,0,0,0,,6445,-6445
28,07-09-17,61,15:00,15:15,,26.32,0,26.32,26.32,-1,-25342,46340,71682,20998,0,-7142,0,0,0,,7142,-7142
28,07-09-17,62,15:15,15:30,,,0,28.81,28.81,0,-23004,49027,72031,26023,0,-144,0,0,0,,144,-144
28,07-09-17,63,15:30,15:45,29.95,,0,29.95,29.95,1,-29885,47691,77576,17806,0,0,210,0,0,,210,210
28,07-09-17,64,15:45,16:00,28.84,,0,28.84,28.84,1,-32737,49937,82674,17200,0,0,732,0,0,,732,732
28,07-09-17,65,16:00,16:15,28.14,,0,28.14,28.14,1,-26323,73506,99829,47183,0,0,396,0,0,,396,396
28,07-09-17,66,16:15,16:30,26.77,,0,26.77,26.77,1,-25442,57677,83119,32235,0,0,250,0,0,,250,250
28,07-09-17,67,16:30,16:45,29.78,,0,29.78,29.78,1,-30849,34528,65377,3679,0,0,419,0,0,,419,419
28,07-09-17,68,16:45,17:00,32.82,,0,32.82,32.82,1,-32758,26064,58822,-6694,0,0,4697,0,0,,4697,4697
28,07-09-17,69,17:00,17:15,28.28,,0,28.28,28.28,1,-44533,69470,114003,24937,0,0,1821,0,0,,1821,1821
28,07-09-17,70,17:15,17:30,,,0,28.78,28.78,0,-40557,41695,82252,1138,0,0,0,0,0,,0,0
28,07-09-17,71,17:30,17:45,64.4,,0,64.4,64.4,1,-61757,35128,96885,-26629,0,0,13097,0,0,,13097,13097
28,07-09-17,72,17:45,18:00,42.32,,0,42.32,42.32,1,-57662,41356,99018,-16306,0,0,21922,0,0,,21922,21922
28,07-09-17,73,18:00,18:15,42.75,29.82,0,42.75,28.79,2,-102630,44335,146965,-58295,0,-142,14232,0,0,,14374,14090
28,07-09-17,74,18:15,18:30,42.75,27.35,0,27.35,27.35,-1,-56118,65543,121661,9425,0,-416,385,0,0,,801,-31
28,07-09-17,75,18:30,18:45,,,0,28.79,28.79,0,-53781,55174,108955,1393,0,0,0,0,0,,0,0
28,07-09-17,76,18:45,19:00,28.01,,0,28.01,28.01,1,-53155,44554,97709,-8601,0,0,64,0,0,,64,64
28,07-09-17,77,19:00,19:15,,,0,38.04,38.04,0,-50412,43127,93539,-7285,0,0,0,0,0,,0,0
28,07-09-17,78,19:15,19:30,,,0,38.04,38.04,0,-53937,41737,95674,-12200,0,0,0,0,0,,0,0
28,07-09-17,79,19:30,19:45,,,0,38.04,38.04,0,-49457,43096,92553,-6361,0,0,0,0,0,,0,0
28,07-09-17,80,19:45,20:00,,,0,38.04,38.04,0,-49747,43640,93387,-6107,0,0,0,0,0,,0,0
28,07-09-17,81,20:00,20:15,,,0,38,38,0,-40087,48094,88181,8007,0,0,0,0,0,,0,0
28,07-09-17,82,20:15,20:30,,,0,38,38,0,-48361,47506,95867,-855,0,0,0,0,0,,0,0
28,07-09-17,83,20:30,20:45,,30.82,0,30.82,30.82,-1,-47491,41090,88581,-6401,0,-62,0,0,0,,62,-62
28,07-09-17,84,20:45,21:00,,29.82,0,29.82,29.82,-1,-44569,42529,87098,-2040,0,-576,0,0,0,,576,-576
28,07-09-17,85,21:00,21:15,28.02,30.82,0,28.02,28.02,1,-54251,34958,89209,-19293,0,-331,338,0,0,,669,7
28,07-09-17,86,21:15,21:30,34.06,,0,34.06,34.06,1,-49718,34587,84305,-15131,0,0,6551,0,0,,6551,6551
28,07-09-17,87,21:30,21:45,27.83,,0,27.83,27.83,1,-46980,36750,83730,-10230,0,0,5165,0,0,,5165,5165
28,07-09-17,88,21:45,22:00,31.34,,0,31.34,31.34,1,-47121,36011,83132,-11110,0,0,1154,0,0,,1154,1154
28,07-09-17,89,22:00,22:15,32.43,,0,32.43,32.43,1,-77659,34560,112219,-43099,0,0,4772,0,0,,4772,4772
28,07-09-17,90,22:15,22:30,33.63,,0,33.63,33.63,1,-101078,38394,139472,-62684,0,0,2765,0,0,,2765,2765
28,07-09-17,91,22:30,22:45,37.28,,0,37.28,37.28,1,-99488,39814,139302,-59674,0,0,5776,0,0,,5776,5776
28,07-09-17,92,22:45,23:00,27.46,,0,27.46,27.46,1,-89524,42585,132109,-46939,0,0,1815,0,0,,1815,1815
28,07-09-17,93,23:00,23:15,,,0,27.36,27.36,0,-92034,39570,131604,-52464,0,0,0,0,0,,0,0
28,07-09-17,94,23:15,23:30,,,0,27.38,27.38,0,-74000,32471,106471,-41529,0,0,0,0,0,,0,0
28,07-09-17,95,23:30,23:45,33.05,,0,33.05,33.05,1,-57012,23380,80392,-33632,0,0,373,0,0,,373,373
28,07-09-17,96,23:45,0:00,,,0,27.42,27.42,0,-40631,31109,71740,-9522,0,0,0,0,0,,0,0
28,07-10-17,1,0:00,0:15,41.46,,0,41.46,41.46,1,-70161,41232,111393,-28929,0,0,6395,0,0,,6395,6395
28,07-10-17,2,0:15,0:30,29.12,26,0,26,26,-1,-37807,33382,71189,-4425,0,-282,3681,0,0,,3963,3399
28,07-10-17,3,0:30,0:45,,23.07,0,23.07,23.07,-1,-27727,41300,69027,13573,0,-4523,0,0,0,,4523,-4523
28,07-10-17,4,0:45,1:00,,17.34,0,17.34,17.34,-1,-42981,58493,101474,15512,0,-26068,0,0,0,,26068,-26068
28,07-10-17,5,1:00,1:15,,25.32,0,25.32,25.32,-1,-28920,35830,64750,6910,0,-16124,0,0,0,,16124,-16124
28,07-10-17,6,1:15,1:30,,25.46,0,25.46,25.46,-1,-23329,39591,62920,16262,0,-2666,0,0,0,,2666,-2666
28,07-10-17,7,1:30,1:45,,25.04,0,25.04,25.04,-1,-25537,39762,65299,14225,0,-12618,0,0,0,,12618,-12618
28,07-10-17,8,1:45,2:00,,25.04,0,25.04,25.04,-1,-26077,46774,72851,20697,0,-18579,0,0,0,,18579,-18579
28,07-10-17,9,2:00,2:15,28.73,25.46,0,28.73,28.73,1,-25119,34165,59284,9046,0,-8739,320,0,0,,9059,-8419
28,07-10-17,10,2:15,2:30,28.74,25.04,0,28.74,25.04,2,-22360,39837,62197,17477,0,-1156,109,0,0,,1265,-1047
28,07-10-17,11,2:30,2:45,,18.98,0,18.98,18.98,-1,-21827,52147,73974,30320,0,-19049,0,0,0,,19049,-19049
28,07-10-17,12,2:45,3:00,,25.46,0,25.46,25.46,-1,-24149,37427,61576,13278,0,-16379,0,0,0,,16379,-16379
28,07-10-17,13,3:00,3:15,,25.04,0,25.04,25.04,-1,-21551,54487,76038,32936,0,-12972,0,0,0,,12972,-12972
28,07-10-17,14,3:15,3:30,,26.64,0,26.64,26.64,-1,-17404,58151,75555,40747,0,-5214,0,0,0,,5214,-5214
28,07-10-17,15,3:30,3:45,,26.81,0,26.81,26.81,-1,-14947,66671,81618,51724,0,-2321,0,0,0,,2321,-2321
28,07-10-17,16,3:45,4:00,,27.17,0,27.17,27.17,-1,-15230,71319,86549,56089,0,-1656,0,0,0,,1656,-1656
28,07-10-17,17,4:00,4:15,,26.94,0,26.94,26.94,-1,-12144,67525,79669,55381,0,-1187,0,0,0,,1187,-1187
28,07-10-17,18,4:15,4:30,,27.23,0,27.23,27.23,-1,-16513,59968,76481,43455,0,-1553,0,0,0,,1553,-1553
28,07-10-17,19,4:30,4:45,,,0,27.48,27.48,0,-23194,60232,83426,37038,0,-272,0,0,0,,272,-272
28,07-10-17,20,4:45,5:00,,,0,27.47,27.47,0,-25986,90362,116348,64376,0,0,0,0,0,,0,0
28,07-10-17,21,5:00,5:15,,27.24,0,27.24,27.24,-1,-50847,60312,111159,9465,0,-789,0,0,0,,789,-789
28,07-10-17,22,5:15,5:30,,26.37,0,26.37,26.37,-1,-24232,71477,95709,47245,0,-742,0,0,0,,742,-742
28,07-10-17,23,5:30,5:45,,24.46,0,24.46,24.46,-1,-32873,57568,90441,24695,0,-4875,0,0,0,,4875,-4875
28,07-10-17,24,5:45,6:00,,25.46,0,25.46,25.46,-1,-49156,52564,101720,3408,0,-1196,0,0,0,,1196,-1196
28,07-10-17,25,6:00,6:15,,10.16,0,10.16,10.16,-1,-53739,100802,154541,47063,0,-21792,0,0,0,,21792,-21792
28,07-10-17,26,6:15,6:30,,25.82,0,25.82,25.82,-1,-30129,70210,100339,40081,0,-20068,0,0,0,,20068,-20068
28,07-10-17,27,6:30,6:45,,26.37,0,26.37,26.37,-1,-44121,71577,115698,27456,0,-16457,0,0,0,,16457,-16457
28,07-10-17,28,6:45,7:00,,,0,27.99,27.99,0,-67716,79817,147533,12101,0,-794,0,0,0,,794,-794
28,07-10-17,29,7:00,7:15,,-10,0,-10,-10,-1,-16388,90546,106934,74158,0,-20069,0,0,0,,20069,-20069
28,07-10-17,30,7:15,7:30,,28.44,0,28.44,28.44,-1,-28360,64796,93156,36436,0,-2730,0,0,0,,2730,-2730
28,07-10-17,31,7:30,7:45,,,0,28.73,28.73,0,-43607,62085,105692,18478,0,0,0,0,0,,0,0
28,07-10-17,32,7:45,8:00,31.43,,0,31.43,31.43,1,-87556,69673,157229,-17883,0,0,1033,0,0,,1033,1033
28,07-10-17,33,8:00,8:15,,,0,37.93,37.93,0,-42434,49249,91683,6815,0,0,18,0,0,,18,18
28,07-10-17,34,8:15,8:30,28.6,,0,28.6,28.6,1,-43818,31264,75082,-12554,0,0,118,0,0,,118,118
28,07-10-17,35,8:30,8:45,31.12,,0,31.12,31.12,1,-67830,21843,89673,-45987,0,0,2505,0,0,,2505,2505
28,07-10-17,36,8:45,9:00,27.59,,0,27.59,27.59,1,-88598,15281,103879,-73317,0,0,397,0,0,,397,397
28,07-10-17,37,9:00,9:15,,,0,37.91,37.91,0,-77437,27329,104766,-50108,0,0,0,0,0,,0,0
28,07-10-17,38,9:15,9:30,,,0,37.88,37.88,0,-63812,19298,83110,-44514,0,0,0,0,0,,0,0
28,07-10-17,39,9:30,9:45,,,0,37.89,37.89,0,-45505,25058,70563,-20447,0,0,0,0,0,,0,0
28,07-10-17,40,9:45,10:00,27.63,,0,27.63,27.63,1,-44650,38446,83096,-6204,0,0,257,0,0,,257,257
28,07-10-17,41,10:00,10:15,,,0,28.73,28.73,0,-45733,66233,111966,20500,0,0,43,0,0,,43,43
28,07-10-17,42,10:15,10:30,28.05,,0,28.05,28.05,1,-41601,51301,92902,9700,0,0,114,0,0,,114,114
28,07-10-17,43,10:30,10:45,31.57,,0,31.57,31.57,1,-47419,37428,84847,-9991,0,0,3379,0,0,,3379,3379
28,07-10-17,44,10:45,11:00,32.82,,0,32.82,32.82,1,-57110,43593,100703,-13517,0,0,8198,0,0,,8198,8198
28,07-10-17,45,11:00,11:15,127.46,,0,127.46,127.46,1,-85868,28402,114270,-57466,0,0,23444,0,0,,23444,23444
28,07-10-17,46,11:15,11:30,39.35,,0,39.35,39.35,1,-68998,46328,115326,-22670,0,0,23925,0,0,,23925,23925
28,07-10-17,47,11:30,11:45,31.74,,0,31.74,31.74,1,-73876,56886,130762,-16990,0,0,12232,0,0,,12232,12232
28,07-10-17,48,11:45,12:00,30.57,,0,30.57,30.57,1,-59882,40275,100157,-19607,0,0,5148,0,0,,5148,5148
28,07-10-17,49,12:00,12:15,31.43,29.82,0,31.43,29.26,2,-61671,70406,132077,8735,0,-5,4865,0,0,,4870,4860
28,07-10-17,50,12:15,12:30,31.43,21.81,0,21.81,21.81,-1,-49430,78684,128114,29254,0,-11260,364,0,0,,11624,-10896
28,07-10-17,51,12:30,12:45,,27.1,0,27.1,27.1,-1,-37336,60936,98272,23600,0,-9357,0,0,0,,9357,-9357
28,07-10-17,52,12:45,13:00,,,0,29.23,29.23,0,-39224,61684,100908,22460,0,-54,0,0,0,,54,-54
28,07-10-17,53,13:00,13:15,,,0,29.18,29.18,0,-43508,91338,134846,47830,0,0,0,0,0,,0,0
28,07-10-17,54,13:15,13:30,27.53,,0,27.53,27.53,1,-47959,68477,116436,20518,0,0,53,0,0,,53,53
28,07-10-17,55,13:30,13:45,27.53,,0,27.53,27.53,1,-57510,69478,126988,11968,0,0,250,0,0,,250,250
28,07-10-17,56,13:45,14:00,27.64,,0,27.64,27.64,1,-57864,66519,124383,8655,0,0,441,0,0,,441,441
28,07-10-17,57,14:00,14:15,63.38,,0,63.38,63.38,1,-115110,85579,200689,-29531,0,0,13652,0,0,,13652,13652
28,07-10-17,58,14:15,14:30,33.65,,0,33.65,33.65,1,-99458,85161,184619,-14297,0,0,11633,0,0,,11633,11633
28,07-10-17,59,14:30,14:45,33.65,29.82,0,29.82,29.82,-1,-57442,82701,140143,25259,0,-461,2116,0,0,,2577,1655
28,07-10-17,60,14:45,15:00,,30.82,0,30.82,30.82,-1,-48118,76638,124756,28520,0,-857,0,0,0,,857,-857
28,07-10-17,61,15:00,15:15,31.75,,0,31.75,31.75,1,-63006,41838,104844,-21168,0,0,1856,0,0,,1856,1856
28,07-10-17,62,15:15,15:30,33.83,,0,33.83,33.83,1,-73465,37541,111006,-35924,0,0,9161,0,0,,9161,9161
28,07-10-17,63,15:30,15:45,29.21,,0,29.21,29.21,1,-85837,35673,121510,-50164,0,0,9985,0,0,,9985,9985
28,07-10-17,64,15:45,16:00,,,0,29.18,29.18,0,-79665,30331,109996,-49334,0,0,1087,0,0,,1087,1087
28,07-10-17,65,16:00,16:15,27.53,,0,27.53,27.53,1,-88796,44121,132917,-44675,0,0,232,0,0,,232,232
28,07-10-17,66,16:15,16:30,27.53,,0,27.53,27.53,1,-83139,34772,117911,-48367,0,0,303,0,0,,303,303
28,07-10-17,67,16:30,16:45,27.53,,0,27.53,27.53,1,-74297,40650,114947,-33647,0,0,29,0,0,,29,29
28,07-10-17,68,16:45,17:00,27.53,,0,27.53,27.53,1,-89203,48309,137512,-40894,0,0,31,0,0,,31,31
28,07-10-17,69,17:00,17:15,,,0,28.97,28.97,0,-76951,61614,138565,-15337,0,0,0,0,0,,0,0
28,07-10-17,70,17:15,17:30,,,0,28.97,28.97,0,-63948,45762,109710,-18186,0,0,0,0,0,,0,0
28,07-10-17,71,17:30,17:45,27.53,,0,27.53,27.53,1,-58130,38660,96790,-19470,0,0,577,0,0,,577,577
28,07-10-17,72,17:45,18:00,28.6,,0,28.6,28.6,1,-40483,33898,74381,-6585,0,0,3651,0,0,,3651,3651
28,07-10-17,73,18:00,18:15,27.63,,0,27.63,27.63,1,-90239,25963,116202,-64276,0,0,2222,0,0,,2222,2222
28,07-10-17,74,18:15,18:30,,,0,28.97,28.97,0,-66437,42387,108824,-24050,0,0,43,0,0,,43,43
28,07-10-17,75,18:30,18:45,,,0,28.97,28.97,0,-59606,63311,122917,3705,0,0,0,0,0,,0,0
28,07-10-17,76,18:45,19:00,,29.82,0,29.82,29.82,-1,-48939,70943,119882,22004,0,-826,0,0,0,,826,-826
28,07-10-17,77,19:00,19:15,,30.82,0,30.82,30.82,-1,-75985,60408,136393,-15577,0,-1484,0,0,0,,1484,-1484
28,07-10-17,78,19:15,19:30,,29.82,0,29.82,29.82,-1,-67845,57847,125692,-9998,0,-2271,0,0,0,,2271,-2271
28,07-10-17,79,19:30,19:45,,30.82,0,30.82,30.82,-1,-59323,50661,109984,-8662,0,-26,0,0,0,,26,-26
28,07-10-17,80,19:45,20:00,,,0,29.18,29.18,0,-53298,41376,94674,-11922,0,0,0,0,0,,0,0
28,07-10-17,81,20:00,20:15,59.56,,0,59.56,59.56,1,-86698,17571,104269,-69127,0,0,8050,0,0,,8050,8050
28,07-10-17,82,20:15,20:30,33.04,,0,33.04,33.04,1,-81430,18548,99978,-62882,0,0,8464,0,0,,8464,8464
28,07-10-17,83,20:30,20:45,28.17,,0,28.17,28.17,1,-58969,27891,86860,-31078,0,0,5136,0,0,,5136,5136
28,07-10-17,84,20:45,21:00,28.17,29.82,0,29.82,29.82,-1,-48495,46642,95137,-1853,0,-1134,9,0,0,,1143,-1125
28,07-10-17,85,21:00,21:15,284.26,29.82,0,284.26,28.23,2,-69529,27679,97208,-41850,0,-933,14828,0,0,,15761,13895
28,07-10-17,86,21:15,21:30,35.12,,0,35.12,35.12,1,-50599,55916,106515,5317,0,0,14351,0,0,,14351,14351
28,07-10-17,87,21:30,21:45,35.12,30.82,0,30.82,30.82,-1,-40939,74416,115355,33477,0,-397,578,0,0,,975,181
28,07-10-17,88,21:45,22:00,,29.82,0,29.82,29.82,-1,-36759,91864,128623,55105,0,-209,0,0,0,,209,-209
28,07-10-17,89,22:00,22:15,,28.91,0,28.91,28.91,-1,-53354,96083,149437,42729,0,-767,0,0,0,,767,-767
28,07-10-17,90,22:15,22:30,,30.82,0,30.82,30.82,-1,-56473,64533,121006,8060,0,-199,0,0,0,,199,-199
28,07-10-17,91,22:30,22:45,,28.92,0,28.92,28.92,-1,-46165,78700,124865,32535,0,-1195,0,0,0,,1195,-1195
28,07-10-17,92,22:45,23:00,,-56.44,0,-56.44,-56.44,-1,-34431,105641,140072,71210,0,-15155,0,0,0,,15155,-15155
28,07-10-17,93,23:00,23:15,,-60.7,0,-60.7,-60.7,-1,-85139,96699,181838,11560,0,-27737,0,0,0,,27737,-27737
28,07-10-17,94,23:15,23:30,,20.63,0,20.63,20.63,-1,-68584,78853,147437,10269,0,-2174,0,0,0,,2174,-2174
28,07-10-17,95,23:30,23:45,,0.71,0,0.71,0.71,-1,-62738,105867,168605,43129,0,-30920,0,0,0,,30920,-30920
28,07-10-17,96,23:45,0:00,,-22.96,0,-22.96,-22.96,-1,-52892,143690,196582,90798,0,-51932,0,0,0,,51932,-51932
28,07-11-17,1,0:00,0:15,188.25,3.54,0,188.25,188.25,1,-100872,13677,114549,-87195,0,-27720,7450,0,0,,35170,-20270
28,07-11-17,2,0:15,0:30,36.32,,0,36.32,36.32,1,-68739,26818,95557,-41921,0,0,15954,0,0,,15954,15954
28,07-11-17,3,0:30,0:45,,,0,28.2,28.2,0,-60019,42314,102333,-17705,0,0,906,0,0,,906,906
28,07-11-17,4,0:45,1:00,,,0,28.2,28.2,0,-105316,64510,169826,-40806,0,0,0,0,0,,0,0
28,07-11-17,5,1:00,1:15,,,0,28.1,28.1,0,-75286,51136,126422,-24150,0,0,0,0,0,,0,0
28,07-11-17,6,1:15,1:30,,,0,28.15,28.15,0,-69017,35759,104776,-33258,0,0,0,0,0,,0,0
28,07-11-17,7,1:30,1:45,,,0,26.66,26.66,0,-60674,46647,107321,-14027,0,0,0,0,0,,0,0
28,07-11-17,8,1:45,2:00,,27.14,0,27.14,27.14,-1,-56293,45478,101771,-10815,0,-1121,0,0,0,,1121,-1121
28,07-11-17,9,2:00,2:15,,26.72,0,26.72,26.72,-1,-61664,39676,101340,-21988,0,-1314,0,0,0,,1314,-1314
28,07-11-17,10,2:15,2:30,32.93,,0,32.93,32.93,1,-60192,42892,103084,-17300,0,0,2403,0,0,,2403,2403
28,07-11-17,11,2:30,2:45,32.93,26.32,0,26.32,26.32,-1,-49612,54253,103865,4641,0,-1147,85,0,0,,1232,-1062
28,07-11-17,12,2:45,3:00,,25.31,0,25.31,25.31,-1,-48972,66218,115190,17246,0,-12959,0,0,0,,12959,-12959
28,07-11-17,13,3:00,3:15,,26.32,0,26.32,26.32,-1,-42882,54086,96968,11204,0,-8545,0,0,0,,8545,-8545
28,07-11-17,14,3:15,3:30,,,0,26.65,26.65,0,-43876,54061,97937,10185,0,-110,0,0,0,,110,-110
28,07-11-17,15,3:30,3:45,,26.32,0,26.32,26.32,-1,-38877,65298,104175,26421,0,-325,0,0,0,,325,-325
28,07-11-17,16,3:45,4:00,,27.32,0,27.32,27.32,-1,-45580,56355,101935,10775,0,-430,0,0,0,,430,-430
28,07-11-17,17,4:00,4:15,,26.23,0,26.23,26.23,-1,-36831,48175,85006,11344,0,-7060,0,0,0,,7060,-7060
28,07-11-17,18,4:15,4:30,,27.03,0,27.03,27.03,-1,-47680,47379,95059,-301,0,-4833,0,0,0,,4833,-4833
28,07-11-17,19,4:30,4:45,,27.32,0,27.32,27.32,-1,-49324,48677,98001,-647,0,-426,0,0,0,,426,-426
28,07-11-17,20,4:45,5:00,33.51,,0,33.51,33.51,1,-63922,54023,117945,-9899,0,0,1478,0,0,,1478,1478
28,07-11-17,21,5:00,5:15,33.86,,0,33.86,33.86,1,-68607,49279,117886,-19328,0,0,6576,0,0,,6576,6576
28,07-11-17,22,5:15,5:30,41.66,,0,41.66,41.66,1,-70706,43536,114242,-27170,0,0,8445,0,0,,8445,8445
28,07-11-17,23,5:30,5:45,35.32,,0,35.32,35.32,1,-67089,53845,120934,-13244,0,0,13883,0,0,,13883,13883
28,07-11-17,24,5:45,6:00,49.02,,0,49.02,49.02,1,-73693,40643,114336,-33050,0,0,14966,0,0,,14966,14966
28,07-11-17,25,6:00,6:15,35.31,27.31,0,27.31,27.31,-1,-65001,63436,128437,-1565,0,-62,8466,0,0,,8528,8404
28,07-11-17,26,6:15,6:30,35.31,27.31,0,27.31,27.31,-1,-39493,52391,91884,12898,0,-1185,109,0,0,,1294,-1076
28,07-11-17,27,6:30,6:45,39.31,27.31,0,39.31,26.63,2,-57869,37175,95044,-20694,0,-471,1991,0,0,,2462,1520
28,07-11-17,28,6:45,7:00,66.02,,0,66.02,66.02,1,-83347,12725,96072,-70622,0,0,13982,0,0,,13982,13982
28,07-11-17,29,7:00,7:15,35.31,7.79,0,35.31,7.79,2,-41501,82660,124161,41159,0,-9556,6844,0,0,,16400,-2712
28,07-11-17,30,7:15,7:30,39.31,27.31,0,39.31,39.31,1,-62843,27659,90502,-35184,0,-1279,1280,0,0,,2559,1
28,07-11-17,31,7:30,7:45,96.02,,0,96.02,96.02,1,-77742,22894,100636,-54848,0,0,33416,0,0,,33416,33416
28,07-11-17,32,7:45,8:00,53.64,,0,53.64,53.64,1,-84933,66923,151856,-18010,0,0,35134,0,0,,35134,35134
28,07-11-17,33,8:00,8:15,30.55,26.31,0,30.55,26.31,2,-41933,67663,109596,25730,0,-475,2746,0,0,,3221,2271
28,07-11-17,34,8:15,8:30,30.2,,0,30.2,30.2,1,-43961,46415,90376,2454,0,0,2237,0,0,,2237,2237
28,07-11-17,35,8:30,8:45,30.92,,0,30.92,30.92,1,-44903,40974,85877,-3929,0,0,2496,0,0,,2496,2496
28,07-11-17,36,8:45,9:00,30.56,,0,30.56,30.56,1,-63577,50856,114433,-12721,0,0,6468,0,0,,6468,6468
28,07-11-17,37,9:00,9:15,30.92,,0,30.92,30.92,1,-53513,53927,107440,414,0,0,5874,0,0,,5874,5874
28,07-11-17,38,9:15,9:30,34.65,,0,34.65,34.65,1,-64146,46595,110741,-17551,0,0,1762,0,0,,1762,1762
28,07-11-17,39,9:30,9:45,34.58,,0,34.58,34.58,1,-65697,46447,112144,-19250,0,0,6946,0,0,,6946,6946
28,07-11-17,40,9:45,10:00,35.31,,0,35.31,35.31,1,-70126,48665,118791,-21461,0,0,5660,0,0,,5660,5660
28,07-11-17,41,10:00,10:15,29.82,,0,29.82,29.82,1,-54047,59208,113255,5161,0,0,5236,0,0,,5236,5236
28,07-11-17,42,10:15,10:30,,,0,28.19,28.19,0,-44710,59934,104644,15224,0,0,98,0,0,,98,98
28,07-11-17,43,10:30,10:45,,,0,28.24,28.24,0,-44172,60749,104921,16577,0,0,0,0,0,,0,0
28,07-11-17,44,10:45,11:00,,27.31,0,27.31,27.31,-1,-36325,76594,112919,40269,0,-1006,0,0,0,,1006,-1006
28,07-11-17,45,11:00,11:15,,27.31,0,27.31,27.31,-1,-37170,96989,134159,59819,0,-843,0,0,0,,843,-843
28,07-11-17,46,11:15,11:30,,,0,28.14,28.14,0,-39801,94844,134645,55043,0,0,0,0,0,,0,0
28,07-11-17,47,11:30,11:45,,,0,28.16,28.16,0,-36482,87738,124220,51256,0,0,0,0,0,,0,0
28,07-11-17,48,11:45,12:00,,27.31,0,27.31,27.31,-1,-32879,100314,133193,67435,0,-903,0,0,0,,903,-903
28,07-11-17,49,12:00,12:15,,23.24,0,23.24,23.24,-1,-51089,51068,102157,-21,0,-10215,0,0,0,,10215,-10215
28,07-11-17,50,12:15,12:30,,26.59,0,26.59,26.59,-1,-53391,48956,102347,-4435,0,-4735,0,0,0,,4735,-4735
28,07-11-17,51,12:30,12:45,,23.04,0,23.04,23.04,-1,-40867,56609,97476,15742,0,-17613,0,0,0,,17613,-17613
28,07-11-17,52,12:45,13:00,,26.09,0,26.09,26.09,-1,-42843,50697,93540,7854,0,-21695,0,0,0,,21695,-21695
28,07-11-17,53,13:00,13:15,,27.03,0,27.03,27.03,-1,-51248,28223,79471,-23025,0,-9173,0,0,0,,9173,-9173
28,07-11-17,54,13:15,13:30,45.31,27.03,0,45.31,45.31,1,-57698,12916,70614,-44782,0,-7,99,0,0,,106,92
28,07-11-17,55,13:30,13:45,260.85,,0,260.85,260.85,1,-60861,13533,74394,-47328,0,0,3199,0,0,,3199,3199
28,07-11-17,56,13:45,14:00,37.7,25.2,0,37.7,25.2,2,-56748,37180,93928,-19568,0,-3018,3258,0,0,,6276,240
28,07-11-17,57,14:00,14:15,30.22,26.98,0,30.22,30.22,1,-83554,14265,97819,-69289,0,-3774,581,0,0,,4355,-3193
28,07-11-17,58,14:15,14:30,32.26,,0,32.26,32.26,1,-100968,6937,107905,-94031,0,0,3356,0,0,,3356,3356
28,07-11-17,59,14:30,14:45,45.31,,0,45.31,45.31,1,-95515,13650,109165,-81865,0,0,12882,0,0,,12882,12882
28,07-11-17,60,14:45,15:00,34.63,,0,34.63,34.63,1,-103076,20546,123622,-82530,0,0,13542,0,0,,13542,13542
28,07-11-17,61,15:00,15:15,59.8,,0,59.8,59.8,1,-87234,33177,120411,-54057,0,0,16755,0,0,,16755,16755
28,07-11-17,62,15:15,15:30,33.31,,0,33.31,33.31,1,-85433,35873,121306,-49560,0,0,13950,0,0,,13950,13950
28,07-11-17,63,15:30,15:45,39.31,,0,39.31,39.31,1,-82576,20361,102937,-62215,0,0,3948,0,0,,3948,3948
28,07-11-17,64,15:45,16:00,30.02,,0,30.02,30.02,1,-91216,12278,103494,-78938,0,0,3344,0,0,,3344,3344
28,07-11-17,65,16:00,16:15,38.05,,0,38.05,38.05,1,-64588,25845,90433,-38743,0,0,6343,0,0,,6343,6343
28,07-11-17,66,16:15,16:30,30.21,,0,30.21,30.21,1,-53230,30581,83811,-22649,0,0,3550,0,0,,3550,3550
28,07-11-17,67,16:30,16:45,,,0,27.37,27.37,0,-50578,28443,79021,-22135,0,0,46,0,0,,46,46
28,07-11-17,68,16:45,17:00,116.02,,0,116.02,116.02,1,-82686,24866,107552,-57820,0,0,14141,0,0,,14141,14141
28,07-11-17,69,17:00,17:15,34.31,,0,34.31,34.31,1,-46877,43540,90417,-3337,0,0,8926,0,0,,8926,8926
28,07-11-17,70,17:15,17:30,,28.87,0,28.87,28.87,-1,-40142,30463,70605,-9679,0,-11,0,0,0,,11,-11
28,07-11-17,71,17:30,17:45,,28.77,0,28.77,28.77,-1,-34511,24468,58979,-10043,0,-123,0,0,0,,123,-123
28,07-11-17,72,17:45,18:00,27.49,,0,27.49,27.49,1,-37326,21641,58967,-15685,0,0,11,0,0,,11,11
28,07-11-17,73,18:00,18:15,29.4,,0,29.4,29.4,1,-129478,6329,135807,-123149,0,0,1510,0,0,,1510,1510
28,07-11-17,74,18:15,18:30,33.72,,0,33.72,33.72,1,-90977,8933,99910,-82044,0,0,4989,0,0,,4989,4989
28,07-11-17,75,18:30,18:45,33.72,,0,33.72,33.72,1,-78548,10164,88712,-68384,0,0,10051,0,0,,10051,10051
28,07-11-17,76,18:45,19:00,39.31,,0,39.31,39.31,1,-88727,18642,107369,-70085,0,0,16024,0,0,,16024,16024
28,07-11-17,77,19:00,19:15,31.8,,0,31.8,31.8,1,-91309,26366,117675,-64943,0,0,11821,0,0,,11821,11821
28,07-11-17,78,19:15,19:30,30.46,,0,30.46,30.46,1,-91732,15609,107341,-76123,0,0,9524,0,0,,9524,9524
28,07-11-17,79,19:30,19:45,31.68,,0,31.68,31.68,1,-85579,20619,106198,-64960,0,0,8531,0,0,,8531,8531
28,07-11-17,80,19:45,20:00,31.93,,0,31.93,31.93,1,-97567,19277,116844,-78290,0,0,9002,0,0,,9002,9002
28,07-11-17,81,20:00,20:15,294.45,,0,294.45,294.45,1,-141583,18835,160418,-122748,0,0,33527,0,0,,33527,33527
28,07-11-17,82,20:15,20:30,53.2,,0,53.2,53.2,1,-116788,36639,153427,-80149,0,0,36539,0,0,,36539,36539
28,07-11-17,83,20:30,20:45,30.05,27.27,0,30.05,27.27,2,-100257,48471,148728,-51786,0,-294,3936,0,0,,4230,3642
28,07-11-17,84,20:45,21:00,35.94,,0,35.94,35.94,1,-93414,42078,135492,-51336,0,0,3391,0,0,,3391,3391
28,07-11-17,85,21:00,21:15,284.71,,0,284.71,284.71,1,-98908,34004,132912,-64904,0,0,16134,0,0,,16134,16134
28,07-11-17,86,21:15,21:30,39.39,,0,39.39,39.39,1,-93939,53996,147935,-39943,0,0,29723,0,0,,29723,29723
28,07-11-17,87,21:30,21:45,28.02,27.29,0,27.29,27.29,-1,-80605,73045,153650,-7560,0,-978,6448,0,0,,7426,5470
28,07-11-17,88,21:45,22:00,,27.31,0,27.31,27.31,-1,-71653,64599,136252,-7054,0,-1914,0,0,0,,1914,-1914
28,07-11-17,89,22:00,22:15,35.31,27.31,0,35.31,35.31,1,-92278,39715,131993,-52563,0,-21,1554,0,0,,1575,1533
28,07-11-17,90,22:15,22:30,33.52,,0,33.52,33.52,1,-81769,36133,117902,-45636,0,0,1701,0,0,,1701,1701
28,07-11-17,91,22:30,22:45,35.79,,0,35.79,35.79,1,-61462,39484,100946,-21978,0,0,8117,0,0,,8117,8117
28,07-11-17,92,22:45,23:00,30.46,,0,30.46,30.46,1,-47956,41941,89897,-6015,0,0,4524,0,0,,4524,4524
28,07-11-17,93,23:00,23:15,61.02,,0,61.02,61.02,1,-116741,25477,142218,-91264,0,0,8070,0,0,,8070,8070
28,07-11-17,94,23:15,23:30,124.28,,0,124.28,124.28,1,-85849,33620,119469,-52229,0,0,21406,0,0,,21406,21406
28,07-11-17,95,23:30,23:45,,,0,27.3,27.3,0,-61271,37922,99193,-23349,0,0,1003,0,0,,1003,1003
28,07-11-17,96,23:45,0:00,,27.16,0,27.16,27.16,-1,-41204,43211,84415,2007,0,-457,0,0,0,,457,-457
28,07-12-17,1,0:00,0:15,247.9,29.31,0,247.9,28.27,2,-77607,35803,113410,-41804,0,-366,9080,0,0,,9446,8714
28,07-12-17,2,0:15,0:30,31.86,29.31,0,29.31,29.31,-1,-62265,72013,134278,9748,0,-298,4830,0,0,,5128,4532
28,07-12-17,3,0:30,0:45,,27.1,0,27.1,27.1,-1,-55622,41017,96639,-14605,0,-363,0,0,0,,363,-363
28,07-12-17,4,0:45,1:00,,,0,28.35,28.35,0,-93471,46467,139938,-47004,0,0,0,0,0,,0,0
28,07-12-17,5,1:00,1:15,26.28,,0,26.28,26.28,1,-50945,43588,94533,-7357,0,0,163,0,0,,163,163
28,07-12-17,6,1:15,1:30,26.38,21.31,0,21.31,21.31,-1,-31456,39900,71356,8444,0,-1453,363,0,0,,1816,-1090
28,07-12-17,7,1:30,1:45,,20.18,0,20.18,20.18,-1,-26408,49782,76190,23374,0,-17851,0,0,0,,17851,-17851
28,07-12-17,8,1:45,2:00,,24.98,0,24.98,24.98,-1,-36121,50150,86271,14029,0,-14790,0,0,0,,14790,-14790
28,07-12-17,9,2:00,2:15,30.22,24.1,0,30.22,24.1,2,-46240,52291,98531,6051,0,-10279,424,0,0,,10703,-9855
28,07-12-17,10,2:15,2:30,30.22,26.31,0,30.22,26.31,2,-37106,54688,91794,17582,0,-305,210,0,0,,515,-95
28,07-12-17,11,2:30,2:45,,25.31,0,25.31,25.31,-1,-36758,71588,108346,34830,0,-3118,0,0,0,,3118,-3118
28,07-12-17,12,2:45,3:00,,14.83,0,14.83,14.83,-1,-37622,81159,118781,43537,0,-14225,0,0,0,,14225,-14225
28,07-12-17,13,3:00,3:15,,14.52,0,14.52,14.52,-1,-19764,113602,133366,93838,0,-21864,0,0,0,,21864,-21864
28,07-12-17,14,3:15,3:30,,,0,27.23,27.23,0,-32027,108726,140753,76699,0,-1882,0,0,0,,1882,-1882
28,07-12-17,15,3:30,3:45,,,0,27.23,27.23,0,-29783,84587,114370,54804,0,0,0,0,0,,0,0
28,07-12-17,16,3:45,4:00,,27.23,0,27.23,27.23,-1,-38119,63183,101302,25064,0,-29,0,0,0,,29,-29
28,07-12-17,17,4:00,4:15,,26.42,0,26.42,26.42,-1,-58544,52087,110631,-6457,0,-1120,0,0,0,,1120,-1120
28,07-12-17,18,4:15,4:30,,26.31,0,26.31,26.31,-1,-57741,47484,105225,-10257,0,-2729,0,0,0,,2729,-2729
28,07-12-17,19,4:30,4:45,36.31,,0,36.31,36.31,1,-61462,39667,101129,-21795,0,0,816,0,0,,816,816
28,07-12-17,20,4:45,5:00,40.31,,0,40.31,40.31,1,-75312,44304,119616,-31008,0,0,9776,0,0,,9776,9776
28,07-12-17,21,5:00,5:15,36.31,,0,36.31,36.31,1,-104660,59544,164204,-45116,0,0,10276,0,0,,10276,10276
28,07-12-17,22,5:15,5:30,40.31,,0,40.31,40.31,1,-86007,41067,127074,-44940,0,0,14796,0,0,,14796,14796
28,07-12-17,23,5:30,5:45,40.31,27.19,0,27.19,27.19,-1,-77975,60140,138115,-17835,0,-118,4785,0,0,,4903,4667
28,07-12-17,24,5:45,6:00,33.7,,0,33.7,33.7,1,-89952,53787,143739,-36165,0,0,1292,0,0,,1292,1292
28,07-12-17,25,6:00,6:15,26.33,26.42,0,27.06,26.42,2,-75870,70526,146396,-5344,0,-964,854,0,0,,1818,-110
28,07-12-17,26,6:15,6:30,36.25,26.42,0,36.25,36.25,1,-101679,57754,159433,-43925,0,-26,238,0,0,,264,212
28,07-12-17,27,6:30,6:45,251.39,,0,251.39,251.39,1,-99664,43296,142960,-56368,0,0,29408,0,0,,29408,29408
28,07-12-17,28,6:45,7:00,251.39,,0,251.39,251.39,1,-130995,55760,186755,-75235,0,0,62622,0,0,,62622,62622
28,07-12-17,29,7:00,7:15,251.39,-53.81,0,-53.81,-53.81,-1,-50748,167560,218308,116812,0,-20952,15566,0,0,,36518,-5386
28,07-12-17,30,7:15,7:30,,26.42,0,26.42,26.42,-1,-81744,95568,177312,13824,0,-4275,0,0,0,,4275,-4275
28,07-12-17,31,7:30,7:45,33.98,26.42,0,33.98,33.98,1,-132050,88889,220939,-43161,0,-32,495,0,0,,527,463
28,07-12-17,32,7:45,8:00,49.59,,0,49.59,49.59,1,-163441,82804,246245,-80637,0,0,11511,0,0,,11511,11511
28,07-12-17,33,8:00,8:15,34.89,25.25,0,34.89,25.25,2,-62594,83656,146250,21062,0,-1169,6984,0,0,,8153,5815
28,07-12-17,34,8:15,8:30,35.11,,0,35.11,35.11,1,-72669,69489,142158,-3180,0,0,3443,0,0,,3443,3443
28,07-12-17,35,8:30,8:45,36.25,,0,36.25,36.25,1,-73013,68804,141817,-4209,0,0,1999,0,0,,1999,1999
28,07-12-17,36,8:45,9:00,29.12,,0,29.12,29.12,1,-85427,67563,152990,-17864,0,0,3089,0,0,,3089,3089
28,07-12-17,37,9:00,9:15,,,0,27.99,27.99,0,-74078,61278,135356,-12800,0,0,252,0,0,,252,252
28,07-12-17,38,9:15,9:30,,,0,27.85,27.85,0,-72436,60662,133098,-11774,0,0,0,0,0,,0,0
28,07-12-17,39,9:30,9:45,27.89,,0,27.89,27.89,1,-75590,59895,135485,-15695,0,0,187,0,0,,187,187
28,07-12-17,40,9:45,10:00,27.89,,0,27.89,27.89,1,-78305,70005,148310,-8300,0,0,578,0,0,,578,578
28,07-12-17,41,10:00,10:15,38.12,,0,38.12,38.12,1,-138201,34317,172518,-103884,0,0,6418,0,0,,6418,6418
28,07-12-17,42,10:15,10:30,33.84,,0,33.84,33.84,1,-117631,35897,153528,-81734,0,0,4535,0,0,,4535,4535
28,07-12-17,43,10:30,10:45,56.66,,0,56.66,56.66,1,-106578,41884,148462,-64694,0,0,20527,0,0,,20527,20527
28,07-12-17,44,10:45,11:00,41.64,,0,41.64,41.64,1,-72554,55510,128064,-17044,0,0,21302,0,0,,21302,21302
28,07-12-17,45,11:00,11:15,276.25,,0,276.25,276.25,1,-111168,41208,152376,-69960,0,0,32289,0,0,,32289,32289
28,07-12-17,46,11:15,11:30,35.28,26.95,0,26.95,26.95,-1,-79759,101163,180922,21404,0,-145,14755,0,0,,14900,14610
28,07-12-17,47,11:30,11:45,35.28,27.14,0,27.14,27.14,-1,-78027,136695,214722,58668,0,-1807,6,0,0,,1813,-1801
28,07-12-17,48,11:45,12:00,,27.78,0,27.78,27.78,-1,-61737,172695,234432,110958,0,-770,0,0,0,,770,-770
28,07-12-17,49,12:00,12:15,,,0,28.27,28.27,0,-95739,117366,213105,21627,0,-1,0,0,0,,1,-1
28,07-12-17,50,12:15,12:30,,17.24,0,17.24,17.24,-1,-67795,159752,227547,91957,0,-6797,0,0,0,,6797,-6797
28,07-12-17,51,12:30,12:45,,-10.12,0,-10.12,-10.12,-1,-82914,143615,226529,60701,0,-34778,0,0,0,,34778,-34778
28,07-12-17,52,12:45,13:00,,-37.96,0,-37.96,-37.96,-1,-76350,158473,234823,82123,0,-41650,0,0,0,,41650,-41650
28,07-12-17,53,13:00,13:15,,25.75,0,25.75,25.75,-1,-82645,82960,165605,315,0,-12277,0,0,0,,12277,-12277
28,07-12-17,54,13:15,13:30,,17.24,0,17.24,17.24,-1,-65604,100849,166453,35245,0,-14462,0,0,0,,14462,-14462
28,07-12-17,55,13:30,13:45,256.66,17.24,0,282.33,17.24,2,-160547,119686,280233,-40861,0,-38160,11464,0,0,,49624,-26696
28,07-12-17,56,13:45,14:00,134.12,-37.96,0,239.9,-37.96,2,-194434,171535,365969,-22899,0,-7535,24330,0,57917,,89782,74712
28,07-12-17,57,14:00,14:15,275.46,-47.81,0,275.46,-47.81,2,-194084,122873,316957,-71211,0,-34586,3117,0,23763,,61466,-7706
28,07-12-17,58,14:15,14:30,275.46,12.78,0,275.46,12.78,2,-145105,156553,301658,11448,0,-2933,13262,0,0,,16195,10329
28,07-12-17,59,14:30,14:45,,9.92,0,9.92,9.92,-1,-153331,159408,312739,6077,0,-9467,0,0,0,,9467,-9467
28,07-12-17,60,14:45,15:00,,18.15,0,18.15,18.15,-1,-165122,170391,335513,5269,0,-2591,0,0,0,,2591,-2591
28,07-12-17,61,15:00,15:15,,-24.62,0,-24.62,-24.62,-1,-24170,132625,156795,108455,0,-35948,0,0,0,,35948,-35948
28,07-12-17,62,15:15,15:30,,-37.78,0,-37.78,-37.78,-1,-20071,113842,133913,93771,0,-62483,0,0,0,,62483,-62483
28,07-12-17,63,15:30,15:45,,-12.56,0,-12.56,-12.56,-1,-24685,136175,160860,111490,0,-56317,0,0,0,,56317,-56317
28,07-12-17,64,15:45,16:00,,8.78,0,8.78,8.78,-1,-26289,110209,136498,83920,0,-67427,0,0,0,,67427,-67427
28,07-12-17,65,16:00,16:15,,-47,0,-47,-47,-1,-46938,161570,208508,114632,0,-68938,0,0,0,,68938,-68938
28,07-12-17,66,16:15,16:30,,-14.74,0,-14.74,-14.74,-1,-51019,137531,188550,86512,0,-66120,0,0,0,,66120,-66120
28,07-12-17,67,16:30,16:45,,15.96,0,15.96,15.96,-1,-59483,148441,207924,88958,0,-59923,0,0,0,,59923,-59923
28,07-12-17,68,16:45,17:00,,23.74,0,23.74,23.74,-1,-64812,148761,213573,83949,0,-41515,0,0,0,,41515,-41515
28,07-12-17,69,17:00,17:15,,26.84,0,26.84,26.84,-1,-61746,151987,213733,90241,0,-17720,0,0,0,,17720,-17720
28,07-12-17,70,17:15,17:30,,-3.27,0,-3.27,-3.27,-1,-42298,141996,184294,99698,0,-22877,0,0,0,,22877,-22877
28,07-12-17,71,17:30,17:45,,11.17,0,11.17,11.17,-1,-51763,112314,164077,60551,0,-34727,0,0,0,,34727,-34727
28,07-12-17,72,17:45,18:00,,,0,28.28,28.28,0,-52634,77530,130164,24896,0,-297,0,0,0,,297,-297
28,07-12-17,73,18:00,18:15,,29.25,0,29.25,29.25,-1,-36528,150522,187050,113994,0,-108,0,0,0,,108,-108
28,07-12-17,74,18:15,18:30,,27.29,0,27.29,27.29,-1,-34055,160489,194544,126434,0,-1755,0,0,0,,1755,-1755
28,07-12-17,75,18:30,18:45,,27.25,0,27.25,27.25,-1,-33838,149379,183217,115541,0,-3769,0,0,0,,3769,-3769
28,07-12-17,76,18:45,19:00,,20.41,0,20.41,20.41,-1,-26013,128411,154424,102398,0,-8360,0,0,0,,8360,-8360
28,07-12-17,77,19:00,19:15,,-30.37,0,-30.37,-30.37,-1,-57400,119151,176551,61751,0,-49291,0,0,0,,49291,-49291
28,07-12-17,78,19:15,19:30,,25.25,0,25.25,25.25,-1,-69953,101318,171271,31365,0,-29127,0,0,0,,29127,-29127
28,07-12-17,79,19:30,19:45,,25.25,0,25.25,25.25,-1,-63560,91148,154708,27588,0,-25208,0,0,0,,25208,-25208
28,07-12-17,80,19:45,20:00,,25.78,0,25.78,25.78,-1,-79979,79282,159261,-697,0,-21534,0,0,0,,21534,-21534
28,07-12-17,81,20:00,20:15,,24.87,0,24.87,24.87,-1,-56609,104210,160819,47601,0,-15800,0,0,0,,15800,-15800
28,07-12-17,82,20:15,20:30,,29.25,0,29.25,29.25,-1,-76583,74929,151512,-1654,0,-3833,0,0,0,,3833,-3833
28,07-12-17,83,20:30,20:45,26.5,,0,26.5,26.5,1,-65081,55593,120674,-9488,0,0,185,0,0,,185,185
28,07-12-17,84,20:45,21:00,26.53,,0,26.53,26.53,1,-84367,53671,138038,-30696,0,0,288,0,0,,288,288
28,07-12-17,85,21:00,21:15,28.61,,0,28.61,28.61,1,-66357,66838,133195,481,0,0,2159,0,0,,2159,2159
28,07-12-17,86,21:15,21:30,28.61,25.78,0,25.78,25.78,-1,-35965,58565,94530,22600,0,-2386,269,0,0,,2655,-2117
28,07-12-17,87,21:30,21:45,,25.78,0,25.78,25.78,-1,-31013,52466,83479,21453,0,-9720,0,0,0,,9720,-9720
28,07-12-17,88,21:45,22:00,,26.08,0,26.08,26.08,-1,-47100,53422,100522,6322,0,-8587,0,0,0,,8587,-8587
28,07-12-17,89,22:00,22:15,26.83,22.66,0,28.54,22.66,2,-54796,93118,147914,38322,0,-9201,4,0,0,,9205,-9197
28,07-12-17,90,22:15,22:30,30.25,22.66,0,30.25,30.25,1,-74140,30768,104908,-43372,0,-525,1767,0,0,,2292,1242
28,07-12-17,91,22:30,22:45,54.38,,0,54.38,54.38,1,-65403,24325,89728,-41078,0,0,16706,0,0,,16706,16706
28,07-12-17,92,22:45,23:00,33.76,27.19,0,27.19,27.19,-1,-52817,34982,87799,-17835,0,-109,10408,0,0,,10517,10299
28,07-12-17,93,23:00,23:15,235.34,29.25,0,235.34,235.34,1,-115694,48750,164444,-66944,0,-141,15598,0,0,,15739,15457
28,07-12-17,94,23:15,23:30,208.26,,0,208.26,208.26,1,-77912,32004,109916,-45908,0,0,25614,0,0,,25614,25614
28,07-12-17,95,23:30,23:45,32.25,,0,32.25,32.25,1,-50494,34043,84537,-16451,0,0,1472,0,0,,1472,1472
28,07-12-17,96,23:45,0:00,29.3,29.25,0,29.25,29.25,-1,-63330,37408,100738,-25922,0,-14,2886,0,0,,2900,2872
28,07/13/2017,1,0:00,0:15,28.28,25.25,0,28.28,25.25,2,-46192,66320,112512,20128,0,-464,135,0,0,,599,-329
28,07/13/2017,2,0:15,0:30,36.25,2.07,0,36.25,2.07,2,-28062,50456,78518,22394,0,-3568,2846,0,0,,6414,-722
28,07/13/2017,3,0:30,0:45,,-38.44,0,-38.44,-38.44,-1,-26316,51031,77347,24715,0,-37916,0,0,0,,37916,-37916
28,07/13/2017,4,0:45,1:00,,25.25,0,25.25,25.25,-1,-51445,55889,107334,4444,0,-7885,0,0,0,,7885,-7885
28,07/13/2017,5,1:00,1:15,32.43,20.74,0,32.43,32.43,1,-43775,65895,109670,22120,0,-7481,525,0,0,,8006,-6956
28,07/13/2017,6,1:15,1:30,36.25,20.74,0,36.25,20.74,2,-44807,57348,102155,12541,0,-1190,4851,0,0,,6041,3661
28,07/13/2017,7,1:30,1:45,,-3.58,0,-3.58,-3.58,-1,-29436,108043,137479,78607,0,-14343,0,0,0,,14343,-14343
28,07/13/2017,8,1:45,2:00,,-60.88,0,-60.88,-60.88,-1,-46549,113256,159805,66707,0,-62355,0,0,0,,62355,-62355
28,07/13/2017,9,2:00,2:15,144.68,-60.88,0,144.68,144.68,1,-69551,20152,89703,-49399,0,-16753,7459,0,0,,24212,-9294
28,07/13/2017,10,2:15,2:30,144.68,24.73,0,144.68,24.73,2,-54412,47303,101715,-7109,0,-250,19942,0,0,,20192,19692
28,07/13/2017,11,2:30,2:45,144.68,9.92,0,9.92,9.92,-1,-49855,54433,104288,4578,0,-11758,205,0,0,,11963,-11553
28,07/13/2017,12,2:45,3:00,,24.03,0,24.03,24.03,-1,-40370,59727,100097,19357,0,-1885,0,0,0,,1885,-1885
28,07/13/2017,13,3:00,3:15,,18.03,0,18.03,18.03,-1,-30084,55901,85985,25817,0,-6617,0,0,0,,6617,-6617
28,07/13/2017,14,3:15,3:30,26.35,14.5,0,26.55,14.5,2,-25679,48869,74548,23190,0,-3431,16,0,0,,3447,-3415
28,07/13/2017,15,3:30,3:45,,14.63,0,14.63,14.63,-1,-39236,52851,92087,13615,0,-7168,0,0,0,,7168,-7168
28,07/13/2017,16,3:45,4:00,,,0,26.55,26.55,0,-39619,52573,92192,12954,0,-15,0,0,0,,15,-15
28,07/13/2017,17,4:00,4:15,,20.74,0,20.74,20.74,-1,-29368,51976,81344,22608,0,-7762,0,0,0,,7762,-7762
28,07/13/2017,18,4:15,4:30,,25.74,0,25.74,25.74,-1,-41128,41461,82589,333,0,-3698,0,0,0,,3698,-3698
28,07/13/2017,19,4:30,4:45,,25.52,0,25.52,25.52,-1,-31043,49299,80342,18256,0,-2907,0,0,0,,2907,-2907
28,07/13/2017,20,4:45,5:00,,25.74,0,25.74,25.74,-1,-33397,78639,112036,45242,0,-454,0,0,0,,454,-454
28,07/13/2017,21,5:00,5:15,,25.74,0,25.74,25.74,-1,-86700,81556,168256,-5144,0,-1468,0,0,0,,1468,-1468
28,07/13/2017,22,5:15,5:30,,24.74,0,24.74,24.74,-1,-33166,105840,139006,72674,0,-5892,0,0,0,,5892,-5892
28,07/13/2017,23,5:30,5:45,,,0,26.56,26.56,0,-26082,100958,127040,74876,0,-667,0,0,0,,667,-667
28,07/13/2017,24,5:45,6:00,,24.74,0,24.74,24.74,-1,-26160,72370,98530,46210,0,-2196,0,0,0,,2196,-2196
28,07/13/2017,25,6:00,6:15,,30.02,0,30.02,30.02,-1,-157524,103266,260790,-54258,0,-1002,0,0,0,,1002,-1002
28,07/13/2017,26,6:15,6:30,,30.02,0,30.02,30.02,-1,-89326,92184,181510,2858,0,-569,0,0,0,,569,-569
28,07/13/2017,27,6:30,6:45,,30.02,0,30.02,30.02,-1,-74818,112789,187607,37971,0,-757,0,0,0,,757,-757
28,07/13/2017,28,6:45,7:00,,29.02,0,29.02,29.02,-1,-106546,156829,263375,50283,0,-967,0,0,0,,967,-967
28,07/13/2017,29,7:00,7:15,,24.74,0,24.74,24.74,-1,-73989,80159,154148,6170,0,-14426,0,0,0,,14426,-14426
28,07/13/2017,30,7:15,7:30,,26.03,0,26.03,26.03,-1,-56012,59220,115232,3208,0,-13170,0,0,0,,13170,-13170
28,07/13/2017,31,7:30,7:45,,29.02,0,29.02,29.02,-1,-58995,74075,133070,15080,0,-2041,0,0,0,,2041,-2041
28,07/13/2017,32,7:45,8:00,27.34,29.02,0,27.34,27.34,1,-67216,68478,135694,1262,0,-3,671,0,0,,674,668
28,07/13/2017,33,8:00,8:15,27.34,9.56,0,9.56,9.56,-1,-50652,95652,146304,45000,0,-14481,9,0,0,,14490,-14472
28,07/13/2017,34,8:15,8:30,,26.78,0,26.78,26.78,-1,-54682,63407,118089,8725,0,-8541,0,0,0,,8541,-8541
28,07/13/2017,35,8:30,8:45,,29.02,0,29.02,29.02,-1,-41156,48115,89271,6959,0,-2356,0,0,0,,2356,-2356
28,07/13/2017,36,8:45,9:00,,26.7,0,26.7,26.7,-1,-52981,53733,106714,752,0,-5641,0,0,0,,5641,-5641
28,07/13/2017,37,9:00,9:15,,26.43,0,26.43,26.43,-1,-35474,119382,154856,83908,0,-3288,0,0,0,,3288,-3288
28,07/13/2017,38,9:15,9:30,,25.02,0,25.02,25.02,-1,-33122,99733,132855,66611,0,-9503,0,0,0,,9503,-9503
28,07/13/2017,39,9:30,9:45,,,0,28.13,28.13,0,-31743,103196,134939,71453,0,-892,0,0,0,,892,-892
28,07/13/2017,40,9:45,10:00,,30.02,0,30.02,30.02,-1,-31202,90649,121851,59447,0,-29,0,0,0,,29,-29
28,07/13/2017,41,10:00,10:15,,29.02,0,29.02,29.02,-1,-36825,115256,152081,78431,0,-747,0,0,0,,747,-747
28,07/13/2017,42,10:15,10:30,,29.02,0,29.02,29.02,-1,-29863,91596,121459,61733,0,-1128,0,0,0,,1128,-1128
28,07/13/2017,43,10:30,10:45,,30.02,0,30.02,30.02,-1,-36724,94938,131662,58214,0,-220,0,0,0,,220,-220
28,07/13/2017,44,10:45,11:00,,,0,28.09,28.09,0,-39297,82308,121605,43011,0,0,0,0,0,,0,0
28,07/13/2017,45,11:00,11:15,,24.82,0,24.82,24.82,-1,-38281,64921,103202,26640,0,-5803,0,0,0,,5803,-5803
28,07/13/2017,46,11:15,11:30,,29.02,0,29.02,29.02,-1,-44092,68919,113011,24827,0,-1537,0,0,0,,1537,-1537
28,07/13/2017,47,11:30,11:45,,29.02,0,29.02,29.02,-1,-46301,78385,124686,32084,0,-61,0,0,0,,61,-61
28,07/13/2017,48,11:45,12:00,,25.02,0,25.02,25.02,-1,-44048,79938,123986,35890,0,-4131,0,0,0,,4131,-4131
28,07/13/2017,49,12:00,12:15,,13.02,0,13.02,13.02,-1,-37268,64124,101392,26856,0,-22468,0,0,0,,22468,-22468
28,07/13/2017,50,12:15,12:30,,22.22,0,22.22,22.22,-1,-45144,75871,121015,30727,0,-20309,0,0,0,,20309,-20309
28,07/13/2017,51,12:30,12:45,,6.45,0,6.45,6.45,-1,-42282,87771,130053,45489,0,-42771,0,0,0,,42771,-42771
28,07/13/2017,52,12:45,13:00,,10.46,0,10.46,10.46,-1,-47249,80274,127523,33025,0,-30242,0,0,0,,30242,-30242
28,07/13/2017,53,13:00,13:15,,0.18,0,0.18,0.18,-1,-46418,72580,118998,26162,0,-43403,0,0,0,,43403,-43403
28,07/13/2017,54,13:15,13:30,,7.9,0,7.9,7.9,-1,-45138,78565,123703,33427,0,-14408,0,0,0,,14408,-14408
28,07/13/2017,55,13:30,13:45,,8.42,0,8.42,8.42,-1,-59456,58879,118335,-577,0,-20842,0,0,0,,20842,-20842
28,07/13/2017,56,13:45,14:00,26.1,8.33,0,28.06,8.33,2,-42664,75716,118380,33052,0,-11986,53,0,0,,12039,-11933
28,07/13/2017,57,14:00,14:15,,10.45,0,10.45,10.45,-1,-45850,64163,110013,18313,0,-20574,0,0,0,,20574,-20574
28,07/13/2017,58,14:15,14:30,,22.31,0,22.31,22.31,-1,-44038,65998,110036,21960,0,-18940,0,0,0,,18940,-18940
28,07/13/2017,59,14:30,14:45,,18.78,0,18.78,18.78,-1,-46218,83040,129258,36822,0,-25909,0,0,0,,25909,-25909
28,07/13/2017,60,14:45,15:00,,23.45,0,23.45,23.45,-1,-49520,82495,132015,32975,0,-31442,0,0,0,,31442,-31442
28,07/13/2017,61,15:00,15:15,,22.33,0,22.33,22.33,-1,-57245,88788,146033,31543,0,-31530,0,0,0,,31530,-31530
28,07/13/2017,62,15:15,15:30,,24.85,0,24.85,24.85,-1,-53751,81288,135039,27537,0,-30995,0,0,0,,30995,-30995
28,07/13/2017,63,15:30,15:45,,25.78,0,25.78,25.78,-1,-58838,74260,133098,15422,0,-17730,0,0,0,,17730,-17730
28,07/13/2017,64,15:45,16:00,,22.13,0,22.13,22.13,-1,-56040,81676,137716,25636,0,-11957,0,0,0,,11957,-11957
28,07/13/2017,65,16:00,16:15,,6.71,0,6.71,6.71,-1,-41552,83401,124953,41849,0,-24033,0,0,0,,24033,-24033
28,07/13/2017,66,16:15,16:30,,22.31,0,22.31,22.31,-1,-51599,65152,116751,13553,0,-24267,0,0,0,,24267,-24267
28,07/13/2017,67,16:30,16:45,,19.33,0,19.33,19.33,-1,-38464,71564,110028,33100,0,-18758,0,0,0,,18758,-18758
28,07/13/2017,68,16:45,17:00,,25.02,0,25.02,25.02,-1,-56734,76070,132804,19336,0,-22308,0,0,0,,22308,-22308
28,07/13/2017,69,17:00,17:15,,26.61,0,26.61,26.61,-1,-54556,63039,117595,8483,0,-14078,0,0,0,,14078,-14078
28,07/13/2017,70,17:15,17:30,,29.02,0,29.02,29.02,-1,-42332,42000,84332,-332,0,-6831,0,0,0,,6831,-6831
28,07/13/2017,71,17:30,17:45,,26.76,0,26.76,26.76,-1,-34389,40002,74391,5613,0,-5620,0,0,0,,5620,-5620
28,07/13/2017,72,17:45,18:00,,30.02,0,30.02,30.02,-1,-33390,47983,81373,14593,0,-1328,0,0,0,,1328,-1328
28,07/13/2017,73,18:00,18:15,,,0,28.53,28.53,0,-95838,38603,134441,-57235,0,-91,0,0,0,,91,-91
28,07/13/2017,74,18:15,18:30,,,0,28.61,28.61,0,-86471,49679,136150,-36792,0,0,0,0,0,,0,0
28,07/13/2017,75,18:30,18:45,,,0,28.56,28.56,0,-86852,62636,149488,-24216,0,0,0,0,0,,0,0
28,07/13/2017,76,18:45,19:00,,,0,28.62,28.62,0,-82455,64065,146520,-18390,0,0,0,0,0,,0,0
28,07/13/2017,77,19:00,19:15,,,0,28.58,28.58,0,-80992,42029,123021,-38963,0,0,0,0,0,,0,0
28,07/13/2017,78,19:15,19:30,,,0,28.61,28.61,0,-83445,29699,113144,-53746,0,0,0,0,0,,0,0
28,07/13/2017,79,19:30,19:45,,,0,28.62,28.62,0,-74074,36725,110799,-37349,0,0,0,0,0,,0,0
28,07/13/2017,80,19:45,20:00,,,0,28.62,28.62,0,-78220,36398,114618,-41822,0,0,0,0,0,,0,0
28,07/13/2017,81,20:00,20:15,,,0,28.56,28.56,0,-84510,42593,127103,-41917,0,0,0,0,0,,0,0
28,07/13/2017,82,20:15,20:30,,,0,28.57,28.57,0,-68498,35605,104103,-32893,0,0,0,0,0,,0,0
28,07/13/2017,83,20:30,20:45,,,0,28.59,28.59,0,-65830,41433,107263,-24397,0,0,0,0,0,,0,0
28,07/13/2017,84,20:45,21:00,,29.02,0,29.02,29.02,-1,-62791,59234,122025,-3557,0,-617,0,0,0,,617,-617
28,07/13/2017,85,21:00,21:15,,29.02,0,29.02,29.02,-1,-71467,65688,137155,-5779,0,-4285,0,0,0,,4285,-4285
28,07/13/2017,86,21:15,21:30,,25.02,0,25.02,25.02,-1,-59414,76322,135736,16908,0,-11617,0,0,0,,11617,-11617
28,07/13/2017,87,21:30,21:45,,24.87,0,24.87,24.87,-1,-60926,90069,150995,29143,0,-14253,0,0,0,,14253,-14253
28,07/13/2017,88,21:45,22:00,,29.02,0,29.02,29.02,-1,-56435,89415,145850,32980,0,-4502,0,0,0,,4502,-4502
28,07/13/2017,89,22:00,22:15,,29.02,0,29.02,29.02,-1,-93289,43534,136823,-49755,0,-1782,0,0,0,,1782,-1782
28,07/13/2017,90,22:15,22:30,32.54,,0,32.54,32.54,1,-107640,15731,123371,-91909,0,0,3995,0,0,,3995,3995
28,07/13/2017,91,22:30,22:45,302.36,,0,302.36,302.36,1,-92089,28986,121075,-63103,0,0,24132,0,0,,24132,24132
28,07/13/2017,92,22:45,23:00,32.02,19.36,0,32.02,19.36,2,-55328,90899,146227,35571,0,-5522,7805,0,0,,13327,2283
28,07/13/2017,93,23:00,23:15,31.26,26.81,0,31.26,26.81,2,-76842,60853,137695,-15989,0,-3703,1237,0,0,,4940,-2466
28,07/13/2017,94,23:15,23:30,28.02,26.26,0,28.02,26.26,2,-55937,58456,114393,2519,0,-703,1855,0,0,,2558,1152
28,07/13/2017,95,23:30,23:45,,25.02,0,25.02,25.02,-1,-42952,75513,118465,32561,0,-9244,0,0,0,,9244,-9244
28,07/13/2017,96,23:45,0:00,,-23.56,0,-23.56,-23.56,-1,-30533,110706,141239,80173,0,-44620,0,0,0,,44620,-44620
28,07/14/2017,1,0:00,0:15,42.52,-6.9,0,42.52,42.52,1,-55138,24509,79647,-30629,0,-38207,1864,0,0,,40071,-36343
28,07/14/2017,2,0:15,0:30,42.52,23.09,0,23.09,23.09,-1,-29625,34683,64308,5058,0,-1795,343,0,0,,2138,-1452
28,07/14/2017,3,0:30,0:45,,9.54,0,9.54,9.54,-1,-17310,56137,73447,38827,0,-37849,0,0,0,,37849,-37849
28,07/14/2017,4,0:45,1:00,,16.76,0,16.76,16.76,-1,-35960,76950,112910,40990,0,-53081,0,0,0,,53081,-53081
28,07/14/2017,5,1:00,1:15,26.33,13.13,0,27.71,13.13,2,-24828,36915,61743,12087,0,-32187,30,0,0,,32217,-32157
28,07/14/2017,6,1:15,1:30,32.02,-12.19,0,32.02,-12.19,2,-9769,47428,57197,37659,0,-12198,95,0,0,,12293,-12103
28,07/14/2017,7,1:30,1:45,,-12.02,0,-12.02,-12.02,-1,-13142,65317,78459,52175,0,-59551,0,0,0,,59551,-59551
28,07/14/2017,8,1:45,2:00,,16.76,0,16.76,16.76,-1,-25686,73894,99580,48208,0,-41894,0,0,0,,41894,-41894
28,07/14/2017,9,2:00,2:15,31.73,14.65,0,31.73,31.73,1,-18522,26123,44645,7601,0,-26771,140,0,0,,26911,-26631
28,07/14/2017,10,2:15,2:30,32.23,16.32,0,32.23,16.32,2,-21816,31769,53585,9953,0,-5614,540,0,0,,6154,-5074
28,07/14/2017,11,2:30,2:45,,13.11,0,13.11,13.11,-1,-24377,33073,57450,8696,0,-18229,0,0,0,,18229,-18229
28,07/14/2017,12,2:45,3:00,,26.24,0,26.24,26.24,-1,-28285,43350,71635,15065,0,-7450,0,0,0,,7450,-7450
28,07/14/2017,13,3:00,3:15,26.85,24.16,0,26.85,26.85,1,-33315,22811,56126,-10504,0,-6034,24,0,0,,6058,-6010
28,07/14/2017,14,3:15,3:30,32.02,24.16,0,32.02,32.02,1,-36273,35069,71342,-1204,0,-219,2013,0,0,,2232,1794
28,07/14/2017,15,3:30,3:45,32.02,22.74,0,22.74,22.74,-1,-26946,38362,65308,11416,0,-6629,7,0,0,,6636,-6622
28,07/14/2017,16,3:45,4:00,,26,0,26,26,-1,-24006,27380,51386,3374,0,-776,0,0,0,,776,-776
28,07/14/2017,17,4:00,4:15,,25.8,0,25.8,25.8,-1,-45717,29103,74820,-16614,0,-1014,0,0,0,,1014,-1014
28,07/14/2017,18,4:15,4:30,32.02,,0,32.02,32.02,1,-44158,22017,66175,-22141,0,0,711,0,0,,711,711
28,07/14/2017,19,4:30,4:45,34.31,,0,34.31,34.31,1,-44429,24448,68877,-19981,0,0,2729,0,0,,2729,2729
28,07/14/2017,20,4:45,5:00,28.67,,0,28.67,28.67,1,-44723,32324,77047,-12399,0,0,2236,0,0,,2236,2236
28,07/14/2017,21,5:00,5:15,26.48,24.16,0,26.65,24.16,2,-40291,47538,87829,7247,0,-714,25,0,0,,739,-689
28,07/14/2017,22,5:15,5:30,,20.16,0,20.16,20.16,-1,-27204,38190,65394,10986,0,-12419,0,0,0,,12419,-12419
28,07/14/2017,23,5:30,5:45,,25.16,0,25.16,25.16,-1,-29277,35266,64543,5989,0,-3267,0,0,0,,3267,-3267
28,07/14/2017,24,5:45,6:00,28.56,25.65,0,28.56,25.65,2,-38146,24304,62450,-13842,0,-2522,495,0,0,,3017,-2027
28,07/14/2017,25,6:00,6:15,28.56,20.16,0,20.16,20.16,-1,-12506,73542,86048,61036,0,-7242,43,0,0,,7285,-7199
28,07/14/2017,26,6:15,6:30,,25.16,0,25.16,25.16,-1,-19954,66226,86180,46272,0,-4261,0,0,0,,4261,-4261
28,07/14/2017,27,6:30,6:45,,22.29,0,22.29,22.29,-1,-21225,55854,77079,34629,0,-8479,0,0,0,,8479,-8479
28,07/14/2017,28,6:45,7:00,,25.16,0,25.16,25.16,-1,-42031,54303,96334,12272,0,-2392,0,0,0,,2392,-2392
28,07/14/2017,29,7:00,7:15,,24.16,0,24.16,24.16,-1,-28987,104242,133229,75255,0,-3827,0,0,0,,3827,-3827
28,07/14/2017,30,7:15,7:30,,26.87,0,26.87,26.87,-1,-28434,67906,96340,39472,0,-86,0,0,0,,86,-86
28,07/14/2017,31,7:30,7:45,,26.42,0,26.42,26.42,-1,-44270,62231,106501,17961,0,-538,0,0,0,,538,-538
28,07/14/2017,32,7:45,8:00,,,0,26.51,26.51,0,-67326,62785,130111,-4541,0,-31,0,0,0,,31,-31
28,07/14/2017,33,8:00,8:15,28.87,,0,28.87,28.87,1,-44132,73363,117495,29231,0,0,75,0,0,,75,75
28,07/14/2017,34,8:15,8:30,32.02,,0,32.02,32.02,1,-43873,42391,86264,-1482,0,0,3068,0,0,,3068,3068
28,07/14/2017,35,8:30,8:45,32.02,,0,32.02,32.02,1,-48836,37889,86725,-10947,0,0,4785,0,0,,4785,4785
28,07/14/2017,36,8:45,9:00,,,0,27.65,27.65,0,-40779,39529,80308,-1250,0,0,316,0,0,,316,316
28,07/14/2017,37,9:00,9:15,,,0,27.65,27.65,0,-41003,83345,124348,42342,0,0,0,0,0,,0,0
28,07/14/2017,38,9:15,9:30,,,0,27.65,27.65,0,-36120,61318,97438,25198,0,0,0,0,0,,0,0
28,07/14/2017,39,9:30,9:45,,,0,27.64,27.64,0,-44888,53133,98021,8245,0,0,0,0,0,,0,0
28,07/14/2017,40,9:45,10:00,,,0,27.64,27.64,0,-45965,50924,96889,4959,0,0,0,0,0,,0,0
28,07/14/2017,41,10:00,10:15,30.53,,0,30.53,30.53,1,-67824,46146,113970,-21678,0,0,1454,0,0,,1454,1454
28,07/14/2017,42,10:15,10:30,27.94,,0,27.94,27.94,1,-59960,39287,99247,-20673,0,0,1845,0,0,,1845,1845
28,07/14/2017,43,10:30,10:45,26.07,,0,26.07,26.07,1,-45988,40967,86955,-5021,0,0,324,0,0,,324,324
28,07/14/2017,44,10:45,11:00,,,0,27.59,27.59,0,-43959,54448,98407,10489,0,0,0,0,0,,0,0
28,07/14/2017,45,11:00,11:15,27.53,,0,27.53,27.53,1,-54892,49164,104056,-5728,0,0,671,0,0,,671,671
28,07/14/2017,46,11:15,11:30,27.76,,0,27.76,27.76,1,-56718,61318,118036,4600,0,0,838,0,0,,838,838
28,07/14/2017,47,11:30,11:45,28.18,,0,28.18,28.18,1,-58544,54448,112992,-4096,0,0,2150,0,0,,2150,2150
28,07/14/2017,48,11:45,12:00,28.4,,0,28.4,28.4,1,-49189,46543,95732,-2646,0,0,1448,0,0,,1448,1448
28,07/14/2017,49,12:00,12:15,27.19,,0,27.19,27.19,1,-89662,29327,118989,-60335,0,0,2079,0,0,,2079,2079
28,07/14/2017,50,12:15,12:30,,,0,27.53,27.53,0,-71649,27973,99622,-43676,0,0,367,0,0,,367,367
28,07/14/2017,51,12:30,12:45,,,0,27.54,27.54,0,-52380,44207,96587,-8173,0,0,0,0,0,,0,0
28,07/14/2017,52,12:45,13:00,,24.16,0,24.16,24.16,-1,-40284,62372,102656,22088,0,-2553,0,0,0,,2553,-2553
28,07/14/2017,53,13:00,13:15,114.03,24.16,0,114.03,114.03,1,-65875,21695,87570,-44180,0,-3475,7103,0,0,,10578,3628
28,07/14/2017,54,13:15,13:30,36.02,,0,36.02,36.02,1,-64599,21404,86003,-43195,0,0,13954,0,0,,13954,13954
28,07/14/2017,55,13:30,13:45,36.02,,0,36.02,36.02,1,-77504,9374,86878,-68130,0,0,4702,0,0,,4702,4702
28,07/14/2017,56,13:45,14:00,,,0,27.57,27.57,0,-69253,41969,111222,-27284,0,0,502,0,0,,502,502
28,07/14/2017,57,14:00,14:15,92.46,,0,92.46,92.46,1,-86035,48196,134231,-37839,0,0,12434,0,0,,12434,12434
28,07/14/2017,58,14:15,14:30,36.02,,0,36.02,36.02,1,-65603,51345,116948,-14258,0,0,21689,0,0,,21689,21689
28,07/14/2017,59,14:30,14:45,36.02,25.88,0,25.88,25.88,-1,-44296,97736,142032,53440,0,-1035,4023,0,0,,5058,2988
28,07/14/2017,60,14:45,15:00,,13.17,0,13.17,13.17,-1,-55837,147528,203365,91691,0,-2958,0,0,0,,2958,-2958
28,07/14/2017,61,15:00,15:15,,5.21,0,5.21,5.21,-1,-39951,111789,151740,71838,0,-8025,0,0,0,,8025,-8025
28,07/14/2017,62,15:15,15:30,,,0,28.93,28.93,0,-45452,136333,181785,90881,0,-9,0,0,0,,9,-9
28,07/14/2017,63,15:30,15:45,,-43.56,0,-43.56,-43.56,-1,-49988,165545,215533,115557,0,-15365,0,0,0,,15365,-15365
28,07/14/2017,64,15:45,16:00,,-39.45,0,-39.45,-39.45,-1,-101019,130029,231048,29010,0,-36403,0,0,0,,36403,-36403
28,07/14/2017,65,16:00,16:15,,9.95,0,9.95,9.95,-1,-70873,112935,183808,42062,0,-23353,0,0,0,,23353,-23353
28,07/14/2017,66,16:15,16:30,,2.97,0,2.97,2.97,-1,-78135,114130,192265,35995,0,-46741,0,0,0,,46741,-46741
28,07/14/2017,67,16:30,16:45,,6.74,0,6.74,6.74,-1,-70992,126296,197288,55304,0,-27671,0,0,0,,27671,-27671
28,07/14/2017,68,16:45,17:00,,20.16,0,20.16,20.16,-1,-88859,115261,204120,26402,0,-29861,0,0,0,,29861,-29861
28,07/14/2017,69,17:00,17:15,,-2.4,0,-2.4,-2.4,-1,-44141,120284,164425,76143,0,-34357,0,0,0,,34357,-34357
28,07/14/2017,70,17:15,17:30,,-2.06,0,-2.06,-2.06,-1,-44359,103957,148316,59598,0,-46593,0,0,0,,46593,-46593
28,07/14/2017,71,17:30,17:45,,-2.06,0,-2.06,-2.06,-1,-38925,87537,126462,48612,0,-57376,0,0,0,,57376,-57376
28,07/14/2017,72,17:45,18:00,,15.78,0,15.78,15.78,-1,-44388,74766,119154,30378,0,-38591,0,0,0,,38591,-38591
28,07/14/2017,73,18:00,18:15,36.02,24.78,0,36.02,24.78,2,-98802,46404,145206,-52398,0,-8896,319,0,0,,9215,-8577
28,07/14/2017,74,18:15,18:30,,25.16,0,25.16,25.16,-1,-62948,55377,118325,-7571,0,-201,0,0,0,,201,-201
28,07/14/2017,75,18:30,18:45,,24.16,0,24.16,24.16,-1,-60889,71837,132726,10948,0,-1658,0,0,0,,1658,-1658
28,07/14/2017,76,18:45,19:00,,24.16,0,24.16,24.16,-1,-70269,93683,163952,23414,0,-6872,0,0,0,,6872,-6872
28,07/14/2017,77,19:00,19:15,350,24.16,0,350,350,1,-175808,81869,257677,-93939,0,-1660,12831,0,0,,14491,11171
28,07/14/2017,78,19:15,19:30,32.02,,0,32.02,32.02,1,-116068,101778,217846,-14290,0,0,2119,0,0,,2119,2119
28,07/14/2017,79,19:30,19:45,36.02,,0,36.02,36.02,1,-147168,94238,241406,-52930,0,0,1507,0,0,,1507,1507
28,07/14/2017,80,19:45,20:00,42.2,,0,42.2,42.2,1,-156130,84060,240190,-72070,0,0,10557,0,0,,10557,10557
28,07/14/2017,81,20:00,20:15,36.02,,0,36.02,36.02,1,-121819,101170,222989,-20649,0,0,4733,0,0,,4733,4733
28,07/14/2017,82,20:15,20:30,36.02,,0,36.02,36.02,1,-117849,74176,192025,-43673,0,0,7961,0,0,,7961,7961
28,07/14/2017,83,20:30,20:45,32.12,,0,32.12,32.12,1,-118225,80948,199173,-37277,0,0,3945,0,0,,3945,3945
28,07/14/2017,84,20:45,21:00,32.02,,0,32.02,32.02,1,-113318,91246,204564,-22072,0,0,3086,0,0,,3086,3086
28,07/14/2017,85,21:00,21:15,,,0,27.95,27.95,0,-154267,129084,283351,-25183,0,0,334,0,0,,334,334
28,07/14/2017,86,21:15,21:30,,25.16,0,25.16,25.16,-1,-130280,126141,256421,-4139,0,-1448,0,0,0,,1448,-1448
28,07/14/2017,87,21:30,21:45,,24.16,0,24.16,24.16,-1,-119621,121944,241565,2323,0,-3832,0,0,0,,3832,-3832
28,07/14/2017,88,21:45,22:00,,24.16,0,24.16,24.16,-1,-135384,119649,255033,-15735,0,-1085,0,0,0,,1085,-1085
28,07/14/2017,89,22:00,22:15,,8.07,0,8.07,8.07,-1,-114974,163922,278896,48948,0,-11842,0,0,0,,11842,-11842
28,07/14/2017,90,22:15,22:30,32.02,24.16,0,32.02,32.02,1,-108340,94811,203151,-13529,0,-6458,144,0,0,,6602,-6314
28,07/14/2017,91,22:30,22:45,32.02,20.16,0,20.16,20.16,-1,-75120,100467,175587,25347,0,-4665,2,0,0,,4667,-4663
28,07/14/2017,92,22:45,23:00,,2.39,0,2.39,2.39,-1,-69246,103684,172930,34438,0,-18880,0,0,0,,18880,-18880
28,07/14/2017,93,23:00,23:15,36.02,20.16,0,36.02,36.02,1,-106399,63111,169510,-43288,0,-14910,234,0,0,,15144,-14676
28,07/14/2017,94,23:15,23:30,36.02,20.16,0,36.02,36.02,1,-126597,62203,188800,-64394,0,-172,374,0,0,,546,202
28,07/14/2017,95,23:30,23:45,,20.16,0,20.16,20.16,-1,-84254,88338,172592,4084,0,-1697,0,0,0,,1697,-1697
28,07/14/2017,96,23:45,0:00,,-200,0,-200,-200,-1,-81475,118630,200105,37155,0,-33316,0,0,0,,33316,-33316
29,07/15/2017,1,0:00,0:15,,-200,0,-200,-200,-1,-47259,124950,172209,77691,0,-37529,0,0,0,,37529,-37529
29,07/15/2017,2,0:15,0:30,,5.66,0,5.66,5.66,-1,-41790,71679,113469,29889,0,-22528,0,0,0,,22528,-22528
29,07/15/2017,3,0:30,0:45,,25,0,25,25,-1,-53137,53857,106994,720,0,-16933,0,0,0,,16933,-16933
29,07/15/2017,4,0:45,1:00,,25,0,25,25,-1,-95209,81071,176280,-14138,0,-6504,0,0,0,,6504,-6504
29,07/15/2017,5,1:00,1:15,,-200,0,-200,-200,-1,-75332,92830,168162,17498,0,-16814,0,0,0,,16814,-16814
29,07/15/2017,6,1:15,1:30,36,14.03,0,36,14.03,2,-65571,71189,136760,5618,0,-3527,443,0,0,,3970,-3084
29,07/15/2017,7,1:30,1:45,,-13.9,0,-13.9,-13.9,-1,-71990,77293,149283,5303,0,-10923,0,0,0,,10923,-10923
29,07/15/2017,8,1:45,2:00,,,0,29.51,29.51,0,-94762,63907,158669,-30855,0,-700,0,0,0,,700,-700
29,07/15/2017,9,2:00,2:15,32,,0,32,32,1,-64192,61344,125536,-2848,0,0,424,0,0,,424,424
29,07/15/2017,10,2:15,2:30,32,1.96,0,1.96,1.96,-1,-51120,73226,124346,22106,0,-3660,172,0,0,,3832,-3488
29,07/15/2017,11,2:30,2:45,,0.64,0,0.64,0.64,-1,-65287,62701,127988,-2586,0,-7098,0,0,0,,7098,-7098
29,07/15/2017,12,2:45,3:00,,25,0,25,25,-1,-75763,87117,162880,11354,0,-8120,0,0,0,,8120,-8120
29,07/15/2017,13,3:00,3:15,,25.03,0,25.03,25.03,-1,-68363,78192,146555,9829,0,-9792,0,0,0,,9792,-9792
29,07/15/2017,14,3:15,3:30,,24.03,0,24.03,24.03,-1,-69610,87327,156937,17717,0,-18454,0,0,0,,18454,-18454
29,07/15/2017,15,3:30,3:45,,25.03,0,25.03,25.03,-1,-70400,80764,151164,10364,0,-16406,0,0,0,,16406,-16406
29,07/15/2017,16,3:45,4:00,,29,0,29,29,-1,-80332,76254,156586,-4078,0,-4211,0,0,0,,4211,-4211
29,07/15/2017,17,4:00,4:15,,24.2,0,24.2,24.2,-1,-61008,74937,135945,13929,0,-2124,0,0,0,,2124,-2124
29,07/15/2017,18,4:15,4:30,,25.03,0,25.03,25.03,-1,-59160,66549,125709,7389,0,-832,0,0,0,,832,-832
29,07/15/2017,19,4:30,4:45,,25.03,0,25.03,25.03,-1,-69917,54494,124411,-15423,0,-1524,0,0,0,,1524,-1524
29,07/15/2017,20,4:45,5:00,,26.03,0,26.03,26.03,-1,-83438,51421,134859,-32017,0,-19,0,0,0,,19,-19
29,07/15/2017,21,5:00,5:15,32,,0,32,32,1,-78892,58364,137256,-20528,0,0,763,0,0,,763,763
29,07/15/2017,22,5:15,5:30,32,,0,32,32,1,-70866,61005,131871,-9861,0,0,1467,0,0,,1467,1467
29,07/15/2017,23,5:30,5:45,30,,0,30,30,1,-76794,52249,129043,-24545,0,0,312,0,0,,312,312
29,07/15/2017,24,5:45,6:00,32,,0,32,32,1,-64509,54166,118675,-10343,0,0,2030,0,0,,2030,2030
29,07/15/2017,25,6:00,6:15,,,0,29.42,29.42,0,-37713,55071,92784,17358,0,0,224,0,0,,224,224
29,07/15/2017,26,6:15,6:30,,,0,29.42,29.42,0,-33377,53138,86515,19761,0,0,0,0,0,,0,0
29,07/15/2017,27,6:30,6:45,,,0,29.42,29.42,0,-46860,54220,101080,7360,0,0,0,0,0,,0,0
29,07/15/2017,28,6:45,7:00,,,0,29.42,29.42,0,-57217,66387,123604,9170,0,0,0,0,0,,0,0
29,07/15/2017,29,7:00,7:15,,,0,29.42,29.42,0,-40986,62218,103204,21232,0,0,0,0,0,,0,0
29,07/15/2017,30,7:15,7:30,,,0,29.42,29.42,0,-32741,68648,101389,35907,0,0,0,0,0,,0,0
29,07/15/2017,31,7:30,7:45,,,0,29.42,29.42,0,-45008,70752,115760,25744,0,0,0,0,0,,0,0
29,07/15/2017,32,7:45,8:00,,,0,29.42,29.42,0,-53981,93542,147523,39561,0,0,0,0,0,,0,0
29,07/15/2017,33,8:00,8:15,,-200,0,-200,-200,-1,-17718,77098,94816,59380,0,-24795,0,0,0,,24795,-24795
29,07/15/2017,34,8:15,8:30,,24.82,0,24.82,24.82,-1,-24355,46060,70415,21705,0,-19485,0,0,0,,19485,-19485
29,07/15/2017,35,8:30,8:45,35.82,29.82,0,35.82,29.42,2,-41466,38002,79468,-3464,0,-5951,585,0,0,,6536,-5366
29,07/15/2017,36,8:45,9:00,,,0,29.42,29.42,0,-63712,39468,103180,-24244,0,0,0,0,0,,0,0
29,07/15/2017,37,9:00,9:15,,0.99,0,0.99,0.99,-1,-33140,90396,123536,57256,0,-7426,0,0,0,,7426,-7426
29,07/15/2017,38,9:15,9:30,,29.82,0,29.82,29.82,-1,-54649,52936,107585,-1713,0,-1483,0,0,0,,1483,-1483
29,07/15/2017,39,9:30,9:45,,29.82,0,29.82,29.82,-1,-51589,44356,95945,-7233,0,-612,0,0,0,,612,-612
29,07/15/2017,40,9:45,10:00,,29.82,0,29.82,29.82,-1,-61320,34227,95547,-27093,0,-60,0,0,0,,60,-60
29,07/15/2017,41,10:00,10:15,,24.82,0,24.82,24.82,-1,-36376,70254,106630,33878,0,-6089,0,0,0,,6089,-6089
29,07/15/2017,42,10:15,10:30,,28.82,0,28.82,28.82,-1,-44179,68392,112571,24213,0,-2962,0,0,0,,2962,-2962
29,07/15/2017,43,10:30,10:45,,28.82,0,28.82,28.82,-1,-43857,72084,115941,28227,0,-1473,0,0,0,,1473,-1473
29,07/15/2017,44,10:45,11:00,,26.03,0,26.03,26.03,-1,-45466,74180,119646,28714,0,-6123,0,0,0,,6123,-6123
29,07/15/2017,45,11:00,11:15,,28.82,0,28.82,28.82,-1,-49360,92661,142021,43301,0,-7636,0,0,0,,7636,-7636
29,07/15/2017,46,11:15,11:30,,28.82,0,28.82,28.82,-1,-48343,92363,140706,44020,0,-3680,0,0,0,,3680,-3680
29,07/15/2017,47,11:30,11:45,,4.03,0,4.03,4.03,-1,-50141,98588,148729,48447,0,-14474,0,0,0,,14474,-14474
29,07/15/2017,48,11:45,12:00,,-0.84,0,-0.84,-0.84,-1,-56020,84899,140919,28879,0,-23606,0,0,0,,23606,-23606
29,07/15/2017,49,12:00,12:15,,24.82,0,24.82,24.82,-1,-63689,90226,153915,26537,0,-11264,0,0,0,,11264,-11264
29,07/15/2017,50,12:15,12:30,,25.03,0,25.03,25.03,-1,-68822,96294,165116,27472,0,-12333,0,0,0,,12333,-12333
29,07/15/2017,51,12:30,12:45,,26.54,0,26.54,26.54,-1,-66659,112779,179438,46120,0,-5579,0,0,0,,5579,-5579
29,07/15/2017,52,12:45,13:00,,24.82,0,24.82,24.82,-1,-64161,129542,193703,65381,0,-763,0,0,0,,763,-763
29,07/15/2017,53,13:00,13:15,,24.03,0,24.03,24.03,-1,-75536,110359,185895,34823,0,-5745,0,0,0,,5745,-5745
29,07/15/2017,54,13:15,13:30,,-200,0,-200,-200,-1,-67267,125631,192898,58364,0,-24067,0,0,0,,24067,-24067
29,07/15/2017,55,13:30,13:45,,-200,0,-200,-200,-1,-75135,66646,141781,-8489,0,-39719,0,0,0,,39719,-39719
29,07/15/2017,56,13:45,14:00,31.82,-200,0,31.82,-200,2,-44247,84952,129199,40705,0,-6925,282,0,0,,7207,-6643
29,07/15/2017,57,14:00,14:15,,-200,0,-200,-200,-1,-46534,92989,139523,46455,0,-19692,0,0,0,,19692,-19692
29,07/15/2017,58,14:15,14:30,,24.07,0,24.07,24.07,-1,-72957,73569,146526,612,0,-1524,0,0,0,,1524,-1524
29,07/15/2017,59,14:30,14:45,,22.03,0,22.03,22.03,-1,-75562,80558,156120,4996,0,-5638,0,0,0,,5638,-5638
29,07/15/2017,60,14:45,15:00,,-200,0,-200,-200,-1,-58231,98375,156606,40144,0,-21914,0,0,0,,21914,-21914
29,07/15/2017,61,15:00,15:15,35.82,16.43,0,35.82,35.82,1,-85750,51828,137578,-33922,0,-15486,277,0,0,,15763,-15209
29,07/15/2017,62,15:15,15:30,35.82,19.03,0,19.03,19.03,-1,-73775,75245,149020,1470,0,-2182,119,0,0,,2301,-2063
29,07/15/2017,63,15:30,15:45,,3.51,0,3.51,3.51,-1,-67591,66114,133705,-1477,0,-11830,0,0,0,,11830,-11830
29,07/15/2017,64,15:45,16:00,29.02,3.51,0,29.02,29.02,1,-74840,45012,119852,-29828,0,-523,165,0,0,,688,-358
29,07/15/2017,65,16:00,16:15,31.82,,0,31.82,31.82,1,-84082,54759,138841,-29323,0,0,2418,0,0,,2418,2418
29,07/15/2017,66,16:15,16:30,35.82,,0,35.82,35.82,1,-81646,67305,148951,-14341,0,0,6418,0,0,,6418,6418
29,07/15/2017,67,16:30,16:45,35.82,,0,35.82,35.82,1,-80463,65936,146399,-14527,0,0,6930,0,0,,6930,6930
29,07/15/2017,68,16:45,17:00,41.82,,0,41.82,41.82,1,-76800,68154,144954,-8646,0,0,8270,0,0,,8270,8270
29,07/15/2017,69,17:00,17:15,41.82,28.82,0,28.82,28.82,-1,-67547,93153,160700,25606,0,-1471,1035,0,0,,2506,-436
29,07/15/2017,70,17:15,17:30,,28.82,0,28.82,28.82,-1,-54493,82682,137175,28189,0,-2802,0,0,0,,2802,-2802
29,07/15/2017,71,17:30,17:45,,,0,29.42,29.42,0,-52314,79108,131422,26794,0,-1,0,0,0,,1,-1
29,07/15/2017,72,17:45,18:00,31.82,,0,31.82,31.82,1,-63080,63376,126456,296,0,0,326,0,0,,326,326
29,07/15/2017,73,18:00,18:15,31.82,24.82,0,31.82,24.82,2,-52697,59242,111939,6545,0,-2297,576,0,0,,2873,-1721
29,07/15/2017,74,18:15,18:30,,24.82,0,24.82,24.82,-1,-29334,59281,88615,29947,0,-5886,0,0,0,,5886,-5886
29,07/15/2017,75,18:30,18:45,,,0,29.42,29.42,0,-27506,79003,106509,51497,0,-66,0,0,0,,66,-66
29,07/15/2017,76,18:45,19:00,,28.82,0,28.82,28.82,-1,-28389,84871,113260,56482,0,-62,0,0,0,,62,-62
29,07/15/2017,77,19:00,19:15,,-200,0,-200,-200,-1,-44263,66814,111077,22551,0,-9922,0,0,0,,9922,-9922
29,07/15/2017,78,19:15,19:30,35.82,-200,0,35.82,35.82,1,-62418,44230,106648,-18188,0,-290,2646,0,0,,2936,2356
29,07/15/2017,79,19:30,19:45,31.82,,0,31.82,31.82,1,-48930,58246,107176,9316,0,0,2334,0,0,,2334,2334
29,07/15/2017,80,19:45,20:00,31.82,,0,31.82,31.82,1,-49771,53820,103591,4049,0,0,396,0,0,,396,396
29,07/15/2017,81,20:00,20:15,29.82,,0,29.82,29.82,1,-63188,53592,116780,-9596,0,0,184,0,0,,184,184
29,07/15/2017,82,20:15,20:30,,,0,29.42,29.42,0,-60986,51155,112141,-9831,0,0,0,0,0,,0,0
29,07/15/2017,83,20:30,20:45,35.82,,0,35.82,35.82,1,-52544,47949,100493,-4595,0,0,1266,0,0,,1266,1266
29,07/15/2017,84,20:45,21:00,43,,0,43,43,1,-61310,54920,116230,-6390,0,0,3741,0,0,,3741,3741
29,07/15/2017,85,21:00,21:15,43,28.82,0,28.82,28.82,-1,-43702,51301,95003,7599,0,-702,176,0,0,,878,-526
29,07/15/2017,86,21:15,21:30,,28.82,0,28.82,28.82,-1,-47852,58032,105884,10180,0,-875,0,0,0,,875,-875
29,07/15/2017,87,21:30,21:45,,24.82,0,24.82,24.82,-1,-44455,63380,107835,18925,0,-6341,0,0,0,,6341,-6341
29,07/15/2017,88,21:45,22:00,,28.82,0,28.82,28.82,-1,-41228,67553,108781,26325,0,-4530,0,0,0,,4530,-4530
29,07/15/2017,89,22:00,22:15,,-5.03,0,-5.03,-5.03,-1,-24218,69438,93656,45220,0,-13924,0,0,0,,13924,-13924
29,07/15/2017,90,22:15,22:30,,-200,0,-200,-200,-1,-21378,66032,87410,44654,0,-33271,0,0,0,,33271,-33271
29,07/15/2017,91,22:30,22:45,,9.94,0,9.94,9.94,-1,-34230,74845,109075,40615,0,-22023,0,0,0,,22023,-22023
29,07/15/2017,92,22:45,23:00,,-200,0,-200,-200,-1,-25103,90424,115527,65321,0,-4849,0,0,0,,4849,-4849
29,07/15/2017,93,23:00,23:15,128.96,-200,0,128.96,-200,2,-79163,40498,119661,-38665,0,-7970,1099,0,0,,9069,-6871
29,07/15/2017,94,23:15,23:30,29.02,24.82,0,29.42,24.82,2,-62601,68383,130984,5782,0,-3059,42,0,0,,3101,-3017
29,07/15/2017,95,23:30,23:45,,26.54,0,26.54,26.54,-1,-59779,73133,132912,13354,0,-4303,0,0,0,,4303,-4303
29,07/15/2017,96,23:45,0:00,,,0,29.42,29.42,0,-122728,75782,198510,-46946,0,-4,0,0,0,,4,-4
29,07/16/2017,1,0:00,0:15,35.82,,0,35.82,35.82,1,-82443,44335,126778,-38108,0,0,888,0,0,,888,888
29,07/16/2017,2,0:15,0:30,35.82,,0,35.82,35.82,1,-50910,41741,92651,-9169,0,0,1717,0,0,,1717,1717
29,07/16/2017,3,0:30,0:45,,15.44,0,15.44,15.44,-1,-45590,60313,105903,14723,0,-4964,0,0,0,,4964,-4964
29,07/16/2017,4,0:45,1:00,,0.99,0,0.99,0.99,-1,-61282,70352,131634,9070,0,-26980,0,0,0,,26980,-26980
29,07/16/2017,5,1:00,1:15,350,26.78,0,350,26.78,2,-85710,45143,130853,-40567,0,-10937,1962,0,0,,12899,-8975
29,07/16/2017,6,1:15,1:30,35.12,,0,35.12,35.12,1,-72679,35161,107840,-37518,0,0,1972,0,0,,1972,1972
29,07/16/2017,7,1:30,1:45,31.82,,0,31.82,31.82,1,-86606,38362,124968,-48244,0,0,1731,0,0,,1731,1731
29,07/16/2017,8,1:45,2:00,31.82,29.82,0,29.82,29.82,-1,-84734,37678,122412,-47056,0,-8,417,0,0,,425,409
29,07/16/2017,9,2:00,2:15,,28.82,0,28.82,28.82,-1,-35121,96352,131473,61231,0,-1605,0,0,0,,1605,-1605
29,07/16/2017,10,2:15,2:30,,24.82,0,24.82,24.82,-1,-40953,58488,99441,17535,0,-499,0,0,0,,499,-499
29,07/16/2017,11,2:30,2:45,,13.22,0,13.22,13.22,-1,-38464,52487,90951,14023,0,-11701,0,0,0,,11701,-11701
29,07/16/2017,12,2:45,3:00,,19.78,0,19.78,19.78,-1,-50405,68234,118639,17829,0,-19190,0,0,0,,19190,-19190
29,07/16/2017,13,3:00,3:15,,24.78,0,24.78,24.78,-1,-44873,61281,106154,16408,0,-13883,0,0,0,,13883,-13883
29,07/16/2017,14,3:15,3:30,35.82,24.82,0,35.82,24.82,2,-54504,51960,106464,-2544,0,-1382,45,0,0,,1427,-1337
29,07/16/2017,15,3:30,3:45,,17.78,0,17.78,17.78,-1,-44136,62475,106611,18339,0,-9041,0,0,0,,9041,-9041
29,07/16/2017,16,3:45,4:00,,-16.78,0,-16.78,-16.78,-1,-36395,59115,95510,22720,0,-21779,0,0,0,,21779,-21779
29,07/16/2017,17,4:00,4:15,,24.82,0,24.82,24.82,-1,-44972,66151,111123,21179,0,-15144,0,0,0,,15144,-15144
29,07/16/2017,18,4:15,4:30,,28.82,0,28.82,28.82,-1,-43067,49495,92562,6428,0,-6380,0,0,0,,6380,-6380
29,07/16/2017,19,4:30,4:45,,,0,29.47,29.47,0,-45882,47294,93176,1412,0,-534,0,0,0,,534,-534
29,07/16/2017,20,4:45,5:00,,28.82,0,28.82,28.82,-1,-45919,51405,97324,5486,0,-193,0,0,0,,193,-193
29,07/16/2017,21,5:00,5:15,55.12,28.82,0,55.12,55.12,1,-73790,45450,119240,-28340,0,-692,2399,0,0,,3091,1707
29,07/16/2017,22,5:15,5:30,80.12,,0,80.12,80.12,1,-68905,47502,116407,-21403,0,0,15895,0,0,,15895,15895
29,07/16/2017,23,5:30,5:45,80.12,28.82,0,28.82,28.82,-1,-58148,66574,124722,8426,0,-564,3085,0,0,,3649,2521
29,07/16/2017,24,5:45,6:00,,28.82,0,28.82,28.82,-1,-64265,71300,135565,7035,0,-972,0,0,0,,972,-972
29,07/16/2017,25,6:00,6:15,,,0,29.46,29.46,0,-52697,61292,113989,8595,0,0,0,0,0,,0,0
29,07/16/2017,26,6:15,6:30,,,0,29.46,29.46,0,-47880,70329,118209,22449,0,0,0,0,0,,0,0
29,07/16/2017,27,6:30,6:45,,28.8,0,28.8,28.8,-1,-42596,72892,115488,30296,0,-1873,0,0,0,,1873,-1873
29,07/16/2017,28,6:45,7:00,,29.8,0,29.8,29.8,-1,-49261,85874,135135,36613,0,-735,0,0,0,,735,-735
29,07/16/2017,29,7:00,7:15,,,0,29.46,29.46,0,-34930,65880,100810,30950,0,0,0,0,0,,0,0
29,07/16/2017,30,7:15,7:30,,29.8,0,29.8,29.8,-1,-43154,68383,111537,25229,0,-13,0,0,0,,13,-13
29,07/16/2017,31,7:30,7:45,,29.8,0,29.8,29.8,-1,-52397,58121,110518,5724,0,-204,0,0,0,,204,-204
29,07/16/2017,32,7:45,8:00,,29.8,0,29.8,29.8,-1,-63822,57190,121012,-6632,0,-63,0,0,0,,63,-63
29,07/16/2017,33,8:00,8:15,,24.8,0,24.8,24.8,-1,-66208,76464,142672,10256,0,-3559,0,0,0,,3559,-3559
29,07/16/2017,34,8:15,8:30,,28.8,0,28.8,28.8,-1,-54626,61845,116471,7219,0,-2401,0,0,0,,2401,-2401
29,07/16/2017,35,8:30,8:45,,,0,29.46,29.46,0,-63451,49354,112805,-14097,0,0,0,0,0,,0,0
29,07/16/2017,36,8:45,9:00,31.8,,0,31.8,31.8,1,-76017,43083,119100,-32934,0,0,740,0,0,,740,740
29,07/16/2017,37,9:00,9:15,31.8,28.8,0,31.8,28.8,2,-71143,70960,142103,-183,0,-1102,925,0,0,,2027,-177
29,07/16/2017,38,9:15,9:30,31.8,28.8,0,31.8,31.8,1,-58359,51246,109605,-7113,0,-1817,93,0,0,,1910,-1724
29,07/16/2017,39,9:30,9:45,41.8,,0,41.8,41.8,1,-72888,57839,130727,-15049,0,0,5697,0,0,,5697,5697
29,07/16/2017,40,9:45,10:00,35.8,29.8,0,29.8,29.8,-1,-69837,73939,143776,4102,0,-10,4849,0,0,,4859,4839
29,07/16/2017,41,10:00,10:15,35.8,28.8,0,28.8,28.8,-1,-57136,83981,141117,26845,0,-1875,21,0,0,,1896,-1854
29,07/16/2017,42,10:15,10:30,31.12,28.8,0,31.12,31.12,1,-71232,80085,151317,8853,0,-60,651,0,0,,711,591
29,07/16/2017,43,10:30,10:45,35.8,,0,35.8,35.8,1,-81065,79807,160872,-1258,0,0,1267,0,0,,1267,1267
29,07/16/2017,44,10:45,11:00,35.8,,0,35.8,35.8,1,-83392,72594,155986,-10798,0,0,3776,0,0,,3776,3776
29,07/16/2017,45,11:00,11:15,97.12,29.8,0,97.12,29.46,2,-61635,52751,114386,-8884,0,-6,5105,0,0,,5111,5099
29,07/16/2017,46,11:15,11:30,350,24.8,0,350,24.8,2,-69461,76395,145856,6934,0,-59,16419,0,0,,16478,16360
29,07/16/2017,47,11:30,11:45,38.12,-200,0,38.12,-200,2,-75681,85867,161548,10186,0,-11791,604,0,0,,12395,-11187
29,07/16/2017,48,11:45,12:00,350,-200,0,350,350,1,-106539,52793,159332,-53746,0,-133,30199,0,0,,30332,30066
29,07/16/2017,49,12:00,12:15,41.8,11.19,0,11.19,11.19,-1,-72172,109014,181186,36842,0,-821,11261,0,0,,12082,10440
29,07/16/2017,50,12:15,12:30,350,-12.78,0,350,-12.78,2,-88605,58535,147140,-30070,0,-6467,2650,0,0,,9117,-3817
29,07/16/2017,51,12:30,12:45,350,28.8,0,350,28.8,2,-85997,73918,159915,-12079,0,-17,29263,0,0,,29280,29246
29,07/16/2017,52,12:45,13:00,68.9,-11.78,0,68.9,-11.78,2,-92610,88116,180726,-4494,0,-6080,971,0,0,,7051,-5109
29,07/16/2017,53,13:00,13:15,350,-11.78,0,350,350,1,-99577,64357,163934,-35220,0,-3,32978,0,0,,32981,32975
29,07/16/2017,54,13:15,13:30,350,13.12,0,13.12,13.12,-1,-97317,105035,202352,7718,0,-396,12710,0,0,,13106,12314
29,07/16/2017,55,13:30,13:45,46.12,24.3,0,46.12,24.3,2,-92176,81071,173247,-11105,0,-11,5412,0,0,,5423,5401
29,07/16/2017,56,13:45,14:00,64.32,1.76,0,64.32,1.76,2,-107279,88707,195986,-18572,0,-4107,1249,0,0,,5356,-2858
29,07/16/2017,57,14:00,14:15,67.12,24.3,0,67.12,24.3,2,-97089,133950,231039,36861,0,-301,1876,0,0,,2177,1575
29,07/16/2017,58,14:15,14:30,,24.3,0,24.3,24.3,-1,-97424,115786,213210,18362,0,-504,0,0,0,,504,-504
29,07/16/2017,59,14:30,14:45,,24.3,0,24.3,24.3,-1,-113726,113371,227097,-355,0,-1116,0,0,0,,1116,-1116
29,07/16/2017,60,14:45,15:00,41.94,,0,41.94,41.94,1,-117943,98850,216793,-19093,0,0,2812,0,0,,2812,2812
29,07/16/2017,61,15:00,15:15,80.12,,0,80.12,80.12,1,-111656,91558,203214,-20098,0,0,13119,0,0,,13119,13119
29,07/16/2017,62,15:15,15:30,50.12,,0,50.12,50.12,1,-111879,89377,201256,-22502,0,0,11554,0,0,,11554,11554
29,07/16/2017,63,15:30,15:45,41.94,,0,41.94,41.94,1,-111361,91242,202603,-20119,0,0,14280,0,0,,14280,14280
29,07/16/2017,64,15:45,16:00,41.94,,0,41.94,41.94,1,-93923,97341,191264,3418,0,0,12031,0,0,,12031,12031
29,07/16/2017,65,16:00,16:15,41.94,20.3,0,20.3,20.3,-1,-100966,128798,229764,27832,0,-1406,1379,0,0,,2785,-27
29,07/16/2017,66,16:15,16:30,,24.3,0,24.3,24.3,-1,-105874,103579,209453,-2295,0,-2322,0,0,0,,2322,-2322
29,07/16/2017,67,16:30,16:45,41.94,,0,41.94,41.94,1,-112446,88539,200985,-23907,0,0,6351,0,0,,6351,6351
29,07/16/2017,68,16:45,17:00,35.8,,0,35.8,35.8,1,-113165,102214,215379,-10951,0,0,7685,0,0,,7685,7685
29,07/16/2017,69,17:00,17:15,35.8,25.78,0,25.78,25.78,-1,-110130,105096,215226,-5034,0,-757,708,0,0,,1465,-49
29,07/16/2017,70,17:15,17:30,,24.8,0,24.8,24.8,-1,-90135,88707,178842,-1428,0,-6730,0,0,0,,6730,-6730
29,07/16/2017,71,17:30,17:45,31.8,24.8,0,31.8,31.8,1,-101108,72585,173693,-28523,0,-537,1147,0,0,,1684,610
29,07/16/2017,72,17:45,18:00,46.41,,0,46.41,46.41,1,-90814,66194,157008,-24620,0,0,6113,0,0,,6113,6113
29,07/16/2017,73,18:00,18:15,67.12,,0,67.12,67.12,1,-156035,44088,200123,-111947,0,0,17648,0,0,,17648,17648
29,07/16/2017,74,18:15,18:30,,,0,29.46,29.46,0,-127744,89058,216802,-38686,0,0,4722,0,0,,4722,4722
29,07/16/2017,75,18:30,18:45,350,,0,385,385,1,-215353,68878,284231,-146475,0,0,27533,0,0,,27533,27533
29,07/16/2017,76,18:45,19:00,129.12,,0,231.79,231.79,1,-155665,129328,284993,-26337,0,0,28939,0,0,,28939,28939
29,07/16/2017,77,19:00,19:15,41.94,,0,41.94,41.94,1,-216121,113320,329441,-102801,0,0,5988,0,0,,5988,5988
29,07/16/2017,78,19:15,19:30,41.94,,0,41.94,41.94,1,-196298,116970,313268,-79328,0,0,1268,0,0,,1268,1268
29,07/16/2017,79,19:30,19:45,350,,0,350,350,1,-202365,106443,308808,-95922,0,0,28340,0,0,,28340,28340
29,07/16/2017,80,19:45,20:00,35.12,29.8,0,29.8,29.8,-1,-192193,125607,317800,-66586,0,-12,5492,0,0,,5504,5480
29,07/16/2017,81,20:00,20:15,,0.78,0,0.78,0.78,-1,-56348,170533,226881,114185,0,-7360,0,0,0,,7360,-7360
29,07/16/2017,82,20:15,20:30,,24.8,0,24.8,24.8,-1,-55574,104958,160532,49384,0,-7972,0,0,0,,7972,-7972
29,07/16/2017,83,20:30,20:45,,,0,29.46,29.46,0,-58813,97481,156294,38668,0,-340,0,0,0,,340,-340
29,07/16/2017,84,20:45,21:00,,,0,29.46,29.46,0,-59024,76036,135060,17012,0,0,0,0,0,,0,0
29,07/16/2017,85,21:00,21:15,,28.8,0,28.8,28.8,-1,-61894,120650,182544,58756,0,-742,0,0,0,,742,-742
29,07/16/2017,86,21:15,21:30,,24.8,0,24.8,24.8,-1,-60408,105343,165751,44935,0,-5746,0,0,0,,5746,-5746
29,07/16/2017,87,21:30,21:45,,24.8,0,24.8,24.8,-1,-66450,88188,154638,21738,0,-6688,0,0,0,,6688,-6688
29,07/16/2017,88,21:45,22:00,35.8,24.8,0,35.8,35.8,1,-79389,80184,159573,795,0,-166,260,0,0,,426,94
29,07/16/2017,89,22:00,22:15,36.02,,0,36.02,36.02,1,-108763,38976,147739,-69787,0,0,1393,0,0,,1393,1393
29,07/16/2017,90,22:15,22:30,36.02,,0,36.02,36.02,1,-106242,34259,140501,-71983,0,0,4890,0,0,,4890,4890
29,07/16/2017,91,22:30,22:45,77.22,,0,77.22,77.22,1,-89137,40296,129433,-48841,0,0,9964,0,0,,9964,9964
29,07/16/2017,92,22:45,23:00,47.02,,0,47.02,47.02,1,-74927,59903,134830,-15024,0,0,17282,0,0,,17282,17282
29,07/16/2017,93,23:00,23:15,174.11,,0,174.11,174.11,1,-97534,54521,152055,-43013,0,0,12279,0,0,,12279,12279
29,07/16/2017,94,23:15,23:30,31.8,24.8,0,24.8,24.8,-1,-74549,76947,151496,2398,0,-1401,3901,0,0,,5302,2500
29,07/16/2017,95,23:30,23:45,,24.78,0,24.78,24.78,-1,-70190,56980,127170,-13210,0,-2786,0,0,0,,2786,-2786
29,07/16/2017,96,23:45,0:00,,4.78,0,4.78,4.78,-1,-66230,77219,143449,10989,0,-3025,0,0,0,,3025,-3025
29,07/17/2017,1,0:00,0:15,350,2.3,0,350,350,1,-68390,26827,95217,-41563,0,-5189,9445,0,0,,14634,4256
29,07/17/2017,2,0:15,0:30,61.02,28.8,0,28.8,28.8,-1,-34826,39012,73838,4186,0,-156,11127,0,0,,11283,10971
29,07/17/2017,3,0:30,0:45,61.02,24.8,0,24.8,24.8,-1,-25516,54411,79927,28895,0,-2079,40,0,0,,2119,-2039
29,07/17/2017,4,0:45,1:00,,7.03,0,7.03,7.03,-1,-34750,64453,99203,29703,0,-13396,0,0,0,,13396,-13396
29,07/17/2017,5,1:00,1:15,129.56,24.8,0,129.56,129.56,1,-66704,17442,84146,-49262,0,-8365,2241,0,0,,10606,-6124
29,07/17/2017,6,1:15,1:30,129.56,24.8,0,129.56,129.56,1,-41495,22369,63864,-19126,0,-40,3713,0,0,,3753,3673
29,07/17/2017,7,1:30,1:45,129.56,17.48,0,17.48,17.48,-1,-19559,38739,58298,19180,0,-5837,54,0,0,,5891,-5783
29,07/17/2017,8,1:45,2:00,,24.8,0,24.8,24.8,-1,-23185,36222,59407,13037,0,-14358,0,0,0,,14358,-14358
29,07/17/2017,9,2:00,2:15,29.8,25.3,0,29.8,29.8,1,-35637,33757,69394,-1880,0,-2639,222,0,0,,2861,-2417
29,07/17/2017,10,2:15,2:30,29.8,,0,29.8,29.8,1,-32296,37009,69305,4713,0,0,472,0,0,,472,472
29,07/17/2017,11,2:30,2:45,350,,0,350,350,1,-157786,29039,186825,-128747,0,0,25176,0,0,,25176,25176
29,07/17/2017,12,2:45,3:00,73.02,,0,73.02,73.02,1,-120890,52266,173156,-68624,0,0,16180,0,0,,16180,16180
29,07/17/2017,13,3:00,3:15,,25.3,0,25.3,25.3,-1,-78085,94303,172388,16218,0,-351,0,0,0,,351,-351
29,07/17/2017,14,3:15,3:30,,,0,26.66,26.66,0,-99877,74509,174386,-25368,0,0,0,0,0,,0,0
29,07/17/2017,15,3:30,3:45,29.8,,0,29.8,29.8,1,-110131,74332,184463,-35799,0,0,163,0,0,,163,163
29,07/17/2017,16,3:45,4:00,31.8,20.3,0,31.8,20.3,2,-85790,55738,141528,-30052,0,-63,1237,0,0,,1300,1174
29,07/17/2017,17,4:00,4:15,31.8,-200,0,-200,-200,-1,-31634,99262,130896,67628,0,-17876,27,0,0,,17903,-17849
29,07/17/2017,18,4:15,4:30,,23.03,0,23.03,23.03,-1,-45956,78253,124209,32297,0,-3724,0,0,0,,3724,-3724
29,07/17/2017,19,4:30,4:45,,24.3,0,24.3,24.3,-1,-42351,79324,121675,36973,0,-250,0,0,0,,250,-250
29,07/17/2017,20,4:45,5:00,,24.3,0,24.3,24.3,-1,-41543,106645,148188,65102,0,-1980,0,0,0,,1980,-1980
29,07/17/2017,21,5:00,5:15,,24.3,0,24.3,24.3,-1,-63137,26709,89846,-36428,0,-2364,0,0,0,,2364,-2364
29,07/17/2017,22,5:15,5:30,,24.3,0,24.3,24.3,-1,-49930,53158,103088,3228,0,-1191,0,0,0,,1191,-1191
29,07/17/2017,23,5:30,5:45,,24.3,0,24.3,24.3,-1,-55579,53125,108704,-2454,0,-253,0,0,0,,253,-253
29,07/17/2017,24,5:45,6:00,,8.32,0,8.32,8.32,-1,-60282,95407,155689,35125,0,-6175,0,0,0,,6175,-6175
29,07/17/2017,25,6:00,6:15,,28.79,0,28.79,28.79,-1,-51995,31165,83160,-20830,0,-2304,0,0,0,,2304,-2304
29,07/17/2017,26,6:15,6:30,,-0.03,0,-0.03,-0.03,-1,-47586,84536,132122,36950,0,-8636,0,0,0,,8636,-8636
29,07/17/2017,27,6:30,6:45,,24.79,0,24.79,24.79,-1,-52496,96147,148643,43651,0,-12096,0,0,0,,12096,-12096
29,07/17/2017,28,6:45,7:00,,24.79,0,24.79,24.79,-1,-78795,109535,188330,30740,0,-3054,0,0,0,,3054,-3054
29,07/17/2017,29,7:00,7:15,,-200,0,-200,-200,-1,-27703,81242,108945,53539,0,-28424,0,0,0,,28424,-28424
29,07/17/2017,30,7:15,7:30,,26.03,0,26.03,26.03,-1,-52046,41384,93430,-10662,0,-4787,0,0,0,,4787,-4787
29,07/17/2017,31,7:30,7:45,,24.79,0,24.79,24.79,-1,-46971,61153,108124,14182,0,-7253,0,0,0,,7253,-7253
29,07/17/2017,32,7:45,8:00,,29.79,0,29.79,29.79,-1,-70706,70090,140796,-616,0,-2729,0,0,0,,2729,-2729
29,07/17/2017,33,8:00,8:15,,,0,29.41,29.41,0,-92938,54000,146938,-38938,0,0,0,0,0,,0,0
29,07/17/2017,34,8:15,8:30,32.02,,0,32.02,32.02,1,-79994,28384,108378,-51610,0,0,856,0,0,,856,856
29,07/17/2017,35,8:30,8:45,32.02,,0,32.02,32.02,1,-68456,15760,84216,-52696,0,0,2049,0,0,,2049,2049
29,07/17/2017,36,8:45,9:00,31.79,,0,31.79,31.79,1,-67819,11693,79512,-56126,0,0,1431,0,0,,1431,1431
29,07/17/2017,37,9:00,9:15,,,0,29.41,29.41,0,-76799,41899,118698,-34900,0,0,143,0,0,,143,143
29,07/17/2017,38,9:15,9:30,,29.79,0,29.79,29.79,-1,-63137,43434,106571,-19703,0,-9,0,0,0,,9,-9
29,07/17/2017,39,9:30,9:45,,11.12,0,11.12,11.12,-1,-49516,82680,132196,33164,0,-5592,0,0,0,,5592,-5592
29,07/17/2017,40,9:45,10:00,,5.99,0,5.99,5.99,-1,-62064,96508,158572,34444,0,-12645,0,0,0,,12645,-12645
29,07/17/2017,41,10:00,10:15,,28.79,0,28.79,28.79,-1,-64274,91553,155827,27279,0,-5986,0,0,0,,5986,-5986
29,07/17/2017,42,10:15,10:30,,24.79,0,24.79,24.79,-1,-55526,101656,157182,46130,0,-1335,0,0,0,,1335,-1335
29,07/17/2017,43,10:30,10:45,,28.79,0,28.79,28.79,-1,-57486,96527,154013,39041,0,-3773,0,0,0,,3773,-3773
29,07/17/2017,44,10:45,11:00,,28.79,0,28.79,28.79,-1,-54971,92902,147873,37931,0,-1850,0,0,0,,1850,-1850
29,07/17/2017,45,11:00,11:15,37.74,28.79,0,37.74,28.79,2,-103715,69275,172990,-34440,0,-2503,95,0,0,,2598,-2408
29,07/17/2017,46,11:15,11:30,37.74,,0,37.74,37.74,1,-78879,79081,157960,202,0,0,765,0,0,,765,765
29,07/17/2017,47,11:30,11:45,,,0,29.41,29.41,0,-74593,89180,163773,14587,0,0,0,0,0,,0,0
29,07/17/2017,48,11:45,12:00,,18.67,0,18.67,18.67,-1,-72783,87064,159847,14281,0,-1095,0,0,0,,1095,-1095
29,07/17/2017,49,12:00,12:15,,-200,0,-200,-200,-1,-94255,92289,186544,-1966,0,-19244,0,0,0,,19244,-19244
29,07/17/2017,50,12:15,12:30,,,0,29.41,29.41,0,-107507,82320,189827,-25187,0,-1157,0,0,0,,1157,-1157
29,07/17/2017,51,12:30,12:45,,28.79,0,28.79,28.79,-1,-96834,101523,198357,4689,0,-773,0,0,0,,773,-773
29,07/17/2017,52,12:45,13:00,,24.79,0,24.79,24.79,-1,-88542,98753,187295,10211,0,-9868,0,0,0,,9868,-9868
29,07/17/2017,53,13:00,13:15,,24.79,0,24.79,24.79,-1,-63356,103522,166878,40166,0,-9705,0,0,0,,9705,-9705
29,07/17/2017,54,13:15,13:30,,15.44,0,15.44,15.44,-1,-64547,95565,160112,31018,0,-24162,0,0,0,,24162,-24162
29,07/17/2017,55,13:30,13:45,,24.79,0,24.79,24.79,-1,-66455,73380,139835,6925,0,-16061,0,0,0,,16061,-16061
29,07/17/2017,56,13:45,14:00,35.79,22.67,0,35.79,22.67,2,-70340,79071,149411,8731,0,-2928,734,0,0,,3662,-2194
29,07/17/2017,57,14:00,14:15,,22.67,0,22.67,22.67,-1,-68075,80422,148497,12347,0,-7308,0,0,0,,7308,-7308
29,07/17/2017,58,14:15,14:30,,24.79,0,24.79,24.79,-1,-65593,71530,137123,5937,0,-11143,0,0,0,,11143,-11143
29,07/17/2017,59,14:30,14:45,,29.79,0,29.79,29.79,-1,-78927,78837,157764,-90,0,-2791,0,0,0,,2791,-2791
29,07/17/2017,60,14:45,15:00,,28.79,0,28.79,28.79,-1,-77946,81165,159111,3219,0,-1944,0,0,0,,1944,-1944
29,07/17/2017,61,15:00,15:15,350,28.79,0,350,350,1,-133193,79046,212239,-54147,0,-14,10163,0,0,,10177,10149
29,07/17/2017,62,15:15,15:30,350,-200,0,-200,-200,-1,-86464,116741,203205,30277,0,-11697,1449,0,0,,13146,-10248
29,07/17/2017,63,15:30,15:45,35.79,29.79,0,35.79,29.41,2,-96912,69253,166165,-27659,0,-1002,547,0,0,,1549,-455
29,07/17/2017,64,15:45,16:00,31.79,,0,31.79,31.79,1,-80684,75604,156288,-5080,0,0,347,0,0,,347,347
29,07/17/2017,65,16:00,16:15,35.79,,0,35.79,35.79,1,-89446,82609,172055,-6837,0,0,3393,0,0,,3393,3393
29,07/17/2017,66,16:15,16:30,35.79,,0,35.79,35.79,1,-80617,63123,143740,-17494,0,0,5454,0,0,,5454,5454
29,07/17/2017,67,16:30,16:45,35.79,,0,35.79,35.79,1,-72800,62887,135687,-9913,0,0,6558,0,0,,6558,6558
29,07/17/2017,68,16:45,17:00,128.51,,0,128.51,128.51,1,-84915,50387,135302,-34528,0,0,15654,0,0,,15654,15654
29,07/17/2017,69,17:00,17:15,38.02,,0,38.02,38.02,1,-62845,63639,126484,794,0,0,9010,0,0,,9010,9010
29,07/17/2017,70,17:15,17:30,350,,0,350,350,1,-61065,28107,89172,-32958,0,0,11713,0,0,,11713,11713
29,07/17/2017,71,17:30,17:45,61.02,,0,61.02,61.02,1,-56443,45484,101927,-10959,0,0,20521,0,0,,20521,20521
29,07/17/2017,72,17:45,18:00,35.79,,0,35.79,35.79,1,-46329,55769,102098,9440,0,0,8463,0,0,,8463,8463
29,07/17/2017,73,18:00,18:15,35.79,29.79,0,29.79,29.79,-1,-43040,38805,81845,-4235,0,-224,365,0,0,,589,141
29,07/17/2017,74,18:15,18:30,,29.79,0,29.79,29.79,-1,-23775,38182,61957,14407,0,-716,0,0,0,,716,-716
29,07/17/2017,75,18:30,18:45,37.05,,0,37.05,37.05,1,-22886,31358,54244,8472,0,0,430,0,0,,430,430
29,07/17/2017,76,18:45,19:00,37.05,,0,37.05,37.05,1,-25974,18602,44576,-7372,0,0,4876,0,0,,4876,4876
29,07/17/2017,77,19:00,19:15,50.95,,0,50.95,50.95,1,-52210,21865,74075,-30345,0,0,8922,0,0,,8922,8922
29,07/17/2017,78,19:15,19:30,51.02,,0,51.02,51.02,1,-47003,22398,69401,-24605,0,0,9662,0,0,,9662,9662
29,07/17/2017,79,19:30,19:45,57.45,,0,57.45,57.45,1,-36187,32738,68925,-3449,0,0,9637,0,0,,9637,9637
29,07/17/2017,80,19:45,20:00,57.45,28.79,0,28.79,28.79,-1,-43557,37269,80826,-6288,0,-920,154,0,0,,1074,-766
29,07/17/2017,81,20:00,20:15,350,29.79,0,350,29.41,2,-71929,33161,105090,-38768,0,-131,12903,0,0,,13034,12772
29,07/17/2017,82,20:15,20:30,56.29,,0,56.29,56.29,1,-64581,45155,109736,-19426,0,0,24498,0,0,,24498,24498
29,07/17/2017,83,20:30,20:45,,,0,29.41,29.41,0,-58734,48380,107114,-10354,0,0,4601,0,0,,4601,4601
29,07/17/2017,84,20:45,21:00,,28.79,0,28.79,28.79,-1,-48876,43734,92610,-5142,0,-203,0,0,0,,203,-203
29,07/17/2017,85,21:00,21:15,35.98,28.79,0,35.98,28.79,2,-53598,36812,90410,-16786,0,-481,548,0,0,,1029,67
29,07/17/2017,86,21:15,21:30,,,0,29.41,29.41,0,-41775,25332,67107,-16443,0,0,0,0,0,,0,0
29,07/17/2017,87,21:30,21:45,46.98,,0,46.98,46.98,1,-57385,18745,76130,-38640,0,0,171,0,0,,171,171
29,07/17/2017,88,21:45,22:00,350,,0,350,350,1,-135866,15140,151006,-120726,0,0,18937,0,0,,18937,18937
29,07/17/2017,89,22:00,22:15,77.12,,0,77.12,77.12,1,-124249,17410,141659,-106839,0,0,14071,0,0,,14071,14071
29,07/17/2017,90,22:15,22:30,350,,0,350,350,1,-138289,9561,147850,-128728,0,0,36505,0,0,,36505,36505
29,07/17/2017,91,22:30,22:45,51.02,,0,51.02,51.02,1,-102704,24019,126723,-78685,0,0,20639,0,0,,20639,20639
29,07/17/2017,92,22:45,23:00,,,0,29.41,29.41,0,-97675,50362,148037,-47313,0,0,996,0,0,,996,996
29,07/17/2017,93,23:00,23:15,350,,0,350,350,1,-110867,23342,134209,-87525,0,0,5827,0,0,,5827,5827
29,07/17/2017,94,23:15,23:30,31.79,,0,31.79,31.79,1,-93889,26486,120375,-67403,0,0,1989,0,0,,1989,1989
29,07/17/2017,95,23:30,23:45,,,0,29.41,29.41,0,-85662,38372,124034,-47290,0,0,25,0,0,,25,25
29,07/17/2017,96,23:45,0:00,,28.79,0,28.79,28.79,-1,-82665,60809,143474,-21856,0,-197,0,0,0,,197,-197
29,07/18/2017,1,0:00,0:15,,21.78,0,21.78,21.78,-1,-34524,89270,123794,54746,0,-9909,0,0,0,,9909,-9909
29,07/18/2017,2,0:15,0:30,,-200,0,-200,-200,-1,-29603,68579,98182,38976,0,-19833,0,0,0,,19833,-19833
29,07/18/2017,3,0:30,0:45,,-200,0,-200,-200,-1,-68716,83711,152427,14995,0,-39294,0,0,0,,39294,-39294
29,07/18/2017,4,0:45,1:00,,-200,0,-200,-200,-1,-54134,86295,140429,32161,0,-10472,0,0,0,,10472,-10472
29,07/18/2017,5,1:00,1:15,46.12,24.79,0,46.12,24.79,2,-63225,36207,99432,-27018,0,-7576,1222,0,0,,8798,-6354
29,07/18/2017,6,1:15,1:30,29.12,24.79,0,24.79,24.79,-1,-36135,77183,113318,41048,0,-689,76,0,0,,765,-613
29,07/18/2017,7,1:30,1:45,,-200,0,-200,-200,-1,-42787,104600,147387,61813,0,-4890,0,0,0,,4890,-4890
29,07/18/2017,8,1:45,2:00,,-200,0,-200,-200,-1,-52170,99252,151422,47082,0,-36183,0,0,0,,36183,-36183
29,07/18/2017,9,2:00,2:15,,6.57,0,6.57,6.57,-1,-53285,83239,136524,29954,0,-24878,0,0,0,,24878,-24878
29,07/18/2017,10,2:15,2:30,,6.78,0,6.78,6.78,-1,-47874,85306,133180,37432,0,-2322,0,0,0,,2322,-2322
29,07/18/2017,11,2:30,2:45,,-200,0,-200,-200,-1,-43666,71038,114704,27372,0,-24989,0,0,0,,24989,-24989
29,07/18/2017,12,2:45,3:00,,17.25,0,17.25,17.25,-1,-53881,76138,130019,22257,0,-20332,0,0,0,,20332,-20332
29,07/18/2017,13,3:00,3:15,29.79,9.78,0,30.19,9.78,2,-57595,65546,123141,7951,0,-17046,70,0,0,,17116,-16976
29,07/18/2017,14,3:15,3:30,35.12,-200,0,35.12,-200,2,-50732,79259,129991,28527,0,-7488,249,0,0,,7737,-7239
29,07/18/2017,15,3:30,3:45,,-200,0,-200,-200,-1,-44147,50155,94302,6008,0,-28656,0,0,0,,28656,-28656
29,07/18/2017,16,3:45,4:00,,1.31,0,1.31,1.31,-1,-45771,77525,123296,31754,0,-5433,0,0,0,,5433,-5433
29,07/18/2017,17,4:00,4:15,,0.38,0,0.38,0.38,-1,-57151,68611,125762,11460,0,-11798,0,0,0,,11798,-11798
29,07/18/2017,18,4:15,4:30,,28.79,0,28.79,28.79,-1,-52210,62215,114425,10005,0,-990,0,0,0,,990,-990
29,07/18/2017,19,4:30,4:45,,27.26,0,27.26,27.26,-1,-52500,65350,117850,12850,0,-6244,0,0,0,,6244,-6244
29,07/18/2017,20,4:45,5:00,,28.79,0,28.79,28.79,-1,-56943,59215,116158,2272,0,-3801,0,0,0,,3801,-3801
29,07/18/2017,21,5:00,5:15,,28.79,0,28.79,28.79,-1,-61668,73615,135283,11947,0,-7198,0,0,0,,7198,-7198
29,07/18/2017,22,5:15,5:30,,-2.78,0,-2.78,-2.78,-1,-57656,87940,145596,30284,0,-21421,0,0,0,,21421,-21421
29,07/18/2017,23,5:30,5:45,,24.79,0,24.79,24.79,-1,-53556,60184,113740,6628,0,-20021,0,0,0,,20021,-20021
29,07/18/2017,24,5:45,6:00,,24.79,0,24.79,24.79,-1,-60854,54870,115724,-5984,0,-1899,0,0,0,,1899,-1899
29,07/18/2017,25,6:00,6:15,,-200,0,-200,-200,-1,-50929,148369,199298,97440,0,-44660,0,0,0,,44660,-44660
29,07/18/2017,26,6:15,6:30,,-14.78,0,-14.78,-14.78,-1,-89316,106412,195728,17096,0,-37881,0,0,0,,37881,-37881
29,07/18/2017,27,6:30,6:45,,29.26,0,29.26,29.26,-1,-76437,72465,148902,-3972,0,-4381,0,0,0,,4381,-4381
29,07/18/2017,28,6:45,7:00,,28.79,0,28.79,28.79,-1,-63772,70167,133939,6395,0,-690,0,0,0,,690,-690
29,07/18/2017,29,7:00,7:15,,1.78,0,1.78,1.78,-1,-86940,125798,212738,38858,0,-16972,0,0,0,,16972,-16972
29,07/18/2017,30,7:15,7:30,31.79,31.26,0,31.79,31.79,1,-69996,75164,145160,5168,0,-4607,306,0,0,,4913,-4301
29,07/18/2017,31,7:30,7:45,31.79,,0,31.79,31.79,1,-70661,47235,117896,-23426,0,0,1041,0,0,,1041,1041
29,07/18/2017,32,7:45,8:00,350,,0,350,350,1,-88489,55756,144245,-32733,0,0,11358,0,0,,11358,11358
29,07/18/2017,33,8:00,8:15,48.88,27.26,0,48.88,27.26,2,-46943,94944,141887,48001,0,-243,6423,0,0,,6666,6180
29,07/18/2017,34,8:15,8:30,,,0,30.19,30.19,0,-34936,66628,101564,31692,0,0,0,0,0,,0,0
29,07/18/2017,35,8:30,8:45,,,0,30.19,30.19,0,-39217,39857,79074,640,0,0,0,0,0,,0,0
29,07/18/2017,36,8:45,9:00,,,0,30.19,30.19,0,-53748,38327,92075,-15421,0,0,0,0,0,,0,0
29,07/18/2017,37,9:00,9:15,,28.79,0,28.79,28.79,-1,-60655,68293,128948,7638,0,-712,0,0,0,,712,-712
29,07/18/2017,38,9:15,9:30,,28.79,0,28.79,28.79,-1,-60727,71308,132035,10581,0,-3490,0,0,0,,3490,-3490
29,07/18/2017,39,9:30,9:45,,24.79,0,24.79,24.79,-1,-56211,83477,139688,27266,0,-8461,0,0,0,,8461,-8461
29,07/18/2017,40,9:45,10:00,,24.79,0,24.79,24.79,-1,-65064,83829,148893,18765,0,-13219,0,0,0,,13219,-13219
29,07/18/2017,41,10:00,10:15,,27.26,0,27.26,27.26,-1,-44697,77536,122233,32839,0,-9200,0,0,0,,9200,-9200
29,07/18/2017,42,10:15,10:30,,27.26,0,27.26,27.26,-1,-44219,72166,116385,27947,0,-9397,0,0,0,,9397,-9397
29,07/18/2017,43,10:30,10:45,,,0,30.19,30.19,0,-34619,54409,89028,19790,0,-1758,0,0,0,,1758,-1758
29,07/18/2017,44,10:45,11:00,,29.79,0,29.79,29.79,-1,-52025,52778,104803,753,0,-16,0,0,0,,16,-16
29,07/18/2017,45,11:00,11:15,,27.26,0,27.26,27.26,-1,-44207,52890,97097,8683,0,-3561,0,0,0,,3561,-3561
29,07/18/2017,46,11:15,11:30,,18.13,0,18.13,18.13,-1,-34602,59072,93674,24470,0,-16478,0,0,0,,16478,-16478
29,07/18/2017,47,11:30,11:45,,28.79,0,28.79,28.79,-1,-35817,57154,92971,21337,0,-5649,0,0,0,,5649,-5649
29,07/18/2017,48,11:45,12:00,,8.06,0,8.06,8.06,-1,-31776,69827,101603,38051,0,-4647,0,0,0,,4647,-4647
29,07/18/2017,49,12:00,12:15,,-2.08,0,-2.08,-2.08,-1,-18801,75478,94279,56677,0,-27855,0,0,0,,27855,-27855
29,07/18/2017,50,12:15,12:30,,-12.11,0,-12.11,-12.11,-1,-32153,91629,123782,59476,0,-40326,0,0,0,,40326,-40326
29,07/18/2017,51,12:30,12:45,,13.78,0,13.78,13.78,-1,-45739,82882,128621,37143,0,-21471,0,0,0,,21471,-21471
29,07/18/2017,52,12:45,13:00,,-200,0,-200,-200,-1,-30540,94675,125215,64135,0,-10094,0,0,0,,10094,-10094
29,07/18/2017,53,13:00,13:15,,-200,0,-200,-200,-1,-77356,65397,142753,-11959,0,-19941,0,0,0,,19941,-19941
29,07/18/2017,54,13:15,13:30,35.79,-200,0,35.79,35.79,1,-55708,61708,117416,6000,0,-368,1762,0,0,,2130,1394
29,07/18/2017,55,13:30,13:45,35.79,28.79,0,28.79,28.79,-1,-46147,65021,111168,18874,0,-2985,11,0,0,,2996,-2974
29,07/18/2017,56,13:45,14:00,,24.79,0,24.79,24.79,-1,-40696,62606,103302,21910,0,-5405,0,0,0,,5405,-5405
29,07/18/2017,57,14:00,14:15,31.87,24.79,0,31.87,24.79,2,-69235,53875,123110,-15360,0,-5598,1636,0,0,,7234,-3962
29,07/18/2017,58,14:15,14:30,,,0,28.62,28.62,0,-46608,60892,107500,14284,0,-3,209,0,0,,212,206
29,07/18/2017,59,14:30,14:45,,28.79,0,28.79,28.79,-1,-45821,63204,109025,17383,0,-321,0,0,0,,321,-321
29,07/18/2017,60,14:45,15:00,,28.79,0,28.79,28.79,-1,-48283,57339,105622,9056,0,-4719,0,0,0,,4719,-4719
29,07/18/2017,61,15:00,15:15,33.51,29.79,0,33.51,28.55,2,-49866,36025,85891,-13841,0,-905,4571,0,0,,5476,3666
29,07/18/2017,62,15:15,15:30,29.79,,0,29.79,29.79,1,-42484,46185,88669,3701,0,0,2845,0,0,,2845,2845
29,07/18/2017,63,15:30,15:45,26.87,,0,26.87,26.87,1,-43380,43208,86588,-172,0,0,2739,0,0,,2739,2739
29,07/18/2017,64,15:45,16:00,35.97,,0,35.97,35.97,1,-51554,49560,101114,-1994,0,0,5432,0,0,,5432,5432
29,07/18/2017,65,16:00,16:15,58.04,28.79,0,58.04,28.53,2,-58172,58279,116451,107,0,-44,10946,0,0,,10990,10902
29,07/18/2017,66,16:15,16:30,58.04,19.95,0,19.95,19.95,-1,-54381,83935,138316,29554,0,-11739,831,0,0,,12570,-10908
29,07/18/2017,67,16:30,16:45,,25.01,0,25.01,25.01,-1,-46429,82266,128695,35837,0,-18705,0,0,0,,18705,-18705
29,07/18/2017,68,16:45,17:00,,24.79,0,24.79,24.79,-1,-57405,74077,131482,16672,0,-20555,0,0,0,,20555,-20555
29,07/18/2017,69,17:00,17:15,,27.26,0,27.26,27.26,-1,-52420,100569,152989,48149,0,-6244,0,0,0,,6244,-6244
29,07/18/2017,70,17:15,17:30,,22.21,0,22.21,22.21,-1,-38092,98054,136146,59962,0,-14720,0,0,0,,14720,-14720
29,07/18/2017,71,17:30,17:45,,29.26,0,29.26,29.26,-1,-44647,95666,140313,51019,0,-5018,0,0,0,,5018,-5018
29,07/18/2017,72,17:45,18:00,,,0,28.51,28.51,0,-43559,94143,137702,50584,0,0,0,0,0,,0,0
29,07/18/2017,73,18:00,18:15,29.22,,0,29.22,29.22,1,-73513,67082,140595,-6431,0,0,31,0,0,,31,31
29,07/18/2017,74,18:15,18:30,,29.79,0,29.79,29.79,-1,-55508,79329,134837,23821,0,-780,0,0,0,,780,-780
29,07/18/2017,75,18:30,18:45,,29.79,0,29.79,29.79,-1,-44788,77767,122555,32979,0,-245,0,0,0,,245,-245
29,07/18/2017,76,18:45,19:00,,29.79,0,29.79,29.79,-1,-45349,82556,127905,37207,0,-6,0,0,0,,6,-6
29,07/18/2017,77,19:00,19:15,96.18,,0,96.18,96.18,1,-77022,46182,123204,-30840,0,0,8515,0,0,,8515,8515
29,07/18/2017,78,19:15,19:30,41.49,,0,41.49,41.49,1,-61476,42428,103904,-19048,0,0,19713,0,0,,19713,19713
29,07/18/2017,79,19:30,19:45,31.79,28.79,0,28.79,28.79,-1,-42333,53686,96019,11353,0,-489,9754,0,0,,10243,9265
29,07/18/2017,80,19:45,20:00,31.79,28.79,0,28.79,28.79,-1,-47319,56529,103848,9210,0,-2977,105,0,0,,3082,-2872
29,07/18/2017,81,20:00,20:15,49.61,29.79,0,49.61,28.5,2,-78454,56076,134530,-22378,0,-339,6152,0,0,,6491,5813
29,07/18/2017,82,20:15,20:30,31.79,,0,31.79,31.79,1,-69241,60067,129308,-9174,0,0,8163,0,0,,8163,8163
29,07/18/2017,83,20:30,20:45,26.17,28.79,0,28.79,28.79,-1,-59869,63995,123864,4126,0,-106,2604,0,0,,2710,2498
29,07/18/2017,84,20:45,21:00,26.17,25.1,0,25.1,25.1,-1,-45299,70676,115975,25377,0,-9415,69,0,0,,9484,-9346
29,07/18/2017,85,21:00,21:15,,25.37,0,25.37,25.37,-1,-63450,69233,132683,5783,0,-9973,0,0,0,,9973,-9973
29,07/18/2017,86,21:15,21:30,,26.09,0,26.09,26.09,-1,-40244,72017,112261,31773,0,-5409,0,0,0,,5409,-5409
29,07/18/2017,87,21:30,21:45,,17.98,0,17.98,17.98,-1,-33684,97405,131089,63721,0,-28487,0,0,0,,28487,-28487
29,07/18/2017,88,21:45,22:00,,1.78,0,1.78,1.78,-1,-34512,115705,150217,81193,0,-51831,0,0,0,,51831,-51831
29,07/18/2017,89,22:00,22:15,,16.86,0,16.86,16.86,-1,-47285,59649,106934,12364,0,-38045,0,0,0,,38045,-38045
29,07/18/2017,90,22:15,22:30,,26.49,0,26.49,26.49,-1,-47691,45110,92801,-2581,0,-3122,0,0,0,,3122,-3122
29,07/18/2017,91,22:30,22:45,,22.48,0,22.48,22.48,-1,-35452,66982,102434,31530,0,-14836,0,0,0,,14836,-14836
29,07/18/2017,92,22:45,23:00,,20.05,0,20.05,20.05,-1,-60702,84440,145142,23738,0,-30772,0,0,0,,30772,-30772
29,07/18/2017,93,23:00,23:15,,17.37,0,17.37,17.37,-1,-52038,77912,129950,25874,0,-19882,0,0,0,,19882,-19882
29,07/18/2017,94,23:15,23:30,,-33.74,0,-33.74,-33.74,-1,-40513,80639,121152,40126,0,-9149,0,0,0,,9149,-9149
29,07/18/2017,95,23:30,23:45,,-35.71,0,-35.71,-35.71,-1,-50598,80216,130814,29618,0,-25780,0,0,0,,25780,-25780
29,07/18/2017,96,23:45,0:00,,24.79,0,24.79,24.79,-1,-54583,78237,132820,23654,0,-20934,0,0,0,,20934,-20934
29,07/19/2017,1,0:00,0:15,29.62,24.79,0,29.62,29.62,1,-38861,65848,104709,26987,0,-14643,191,0,0,,14834,-14452
29,07/19/2017,2,0:15,0:30,30.31,23.19,0,30.31,23.19,2,-32959,51390,84349,18431,0,-4499,517,0,0,,5016,-3982
29,07/19/2017,3,0:30,0:45,,25.63,0,25.63,25.63,-1,-54130,66920,121050,12790,0,-15587,0,0,0,,15587,-15587
29,07/19/2017,4,0:45,1:00,,24.79,0,24.79,24.79,-1,-60435,79216,139651,18781,0,-13747,0,0,0,,13747,-13747
29,07/19/2017,5,1:00,1:15,34.02,25.37,0,34.02,34.02,1,-65945,58067,124012,-7878,0,-11939,1020,0,0,,12959,-10919
29,07/19/2017,6,1:15,1:30,38.97,25.37,0,38.97,38.97,1,-38943,42332,81275,3389,0,-450,2805,0,0,,3255,2355
29,07/19/2017,7,1:30,1:45,38.97,29.79,0,29.79,29.79,-1,-45330,50772,96102,5442,0,-111,5,0,0,,116,-106
29,07/19/2017,8,1:45,2:00,,27.26,0,27.26,27.26,-1,-46983,55786,102769,8803,0,-4766,0,0,0,,4766,-4766
29,07/19/2017,9,2:00,2:15,35.79,29.79,0,35.79,28.11,2,-42955,35241,78196,-7714,0,-2128,2495,0,0,,4623,367
29,07/19/2017,10,2:15,2:30,35.79,24.79,0,24.79,24.79,-1,-40050,45582,85632,5532,0,-2902,181,0,0,,3083,-2721
29,07/19/2017,11,2:30,2:45,,24.79,0,24.79,24.79,-1,-40050,53162,93212,13112,0,-12123,0,0,0,,12123,-12123
29,07/19/2017,12,2:45,3:00,,28.48,0,28.48,28.48,-1,-43667,53926,97593,10259,0,-6776,0,0,0,,6776,-6776
29,07/19/2017,13,3:00,3:15,,24.79,0,24.79,24.79,-1,-33599,55029,88628,21430,0,-6278,0,0,0,,6278,-6278
29,07/19/2017,14,3:15,3:30,30.68,24.79,0,30.68,30.68,1,-44396,44990,89386,594,0,-301,702,0,0,,1003,401
29,07/19/2017,15,3:30,3:45,29.79,,0,29.79,29.79,1,-41035,35223,76258,-5812,0,0,3751,0,0,,3751,3751
29,07/19/2017,16,3:45,4:00,26.21,,0,26.21,26.21,1,-47062,34516,81578,-12546,0,0,709,0,0,,709,709
29,07/19/2017,17,4:00,4:15,,26.59,0,26.59,26.59,-1,-26747,46485,73232,19738,0,-2319,0,0,0,,2319,-2319
29,07/19/2017,18,4:15,4:30,,28.79,0,28.79,28.79,-1,-30227,50952,81179,20725,0,-1871,0,0,0,,1871,-1871
29,07/19/2017,19,4:30,4:45,,29.79,0,29.79,29.79,-1,-29578,43482,73060,13904,0,-1423,0,0,0,,1423,-1423
29,07/19/2017,20,4:45,5:00,31.64,29.79,0,31.64,31.64,1,-35574,34661,70235,-913,0,-16,914,0,0,,930,898
29,07/19/2017,21,5:00,5:15,31.78,,0,31.78,31.78,1,-56187,31716,87903,-24471,0,0,553,0,0,,553,553
29,07/19/2017,22,5:15,5:30,31.79,,0,31.79,31.79,1,-46898,36929,83827,-9969,0,0,2833,0,0,,2833,2833
29,07/19/2017,23,5:30,5:45,34.03,,0,34.03,34.03,1,-50980,29177,80157,-21803,0,0,4451,0,0,,4451,4451
29,07/19/2017,24,5:45,6:00,34.61,,0,34.61,34.61,1,-48274,35730,84004,-12544,0,0,11758,0,0,,11758,11758
29,07/19/2017,25,6:00,6:15,,,0,28.17,28.17,0,-88246,60990,149236,-27256,0,0,2209,0,0,,2209,2209
29,07/19/2017,26,6:15,6:30,,29.84,0,29.84,29.84,-1,-44224,51385,95609,7161,0,-37,0,0,0,,37,-37
29,07/19/2017,27,6:30,6:45,41.84,29.84,0,41.84,41.84,1,-53533,33444,86977,-20089,0,-58,3522,0,0,,3580,3464
29,07/19/2017,28,6:45,7:00,49.02,,0,49.02,49.02,1,-67857,60009,127866,-7848,0,0,26443,0,0,,26443,26443
29,07/19/2017,29,7:00,7:15,49.02,7.85,0,7.85,7.85,-1,-61687,97596,159283,35909,0,-12223,6346,0,0,,18569,-5877
29,07/19/2017,30,7:15,7:30,,28.84,0,28.84,28.84,-1,-50373,60235,110608,9862,0,-3411,0,0,0,,3411,-3411
29,07/19/2017,31,7:30,7:45,41.84,29.84,0,41.84,41.84,1,-57962,20155,78117,-37807,0,-1084,1024,0,0,,2108,-60
29,07/19/2017,32,7:45,8:00,248.51,,0,248.51,248.51,1,-99913,30144,130057,-69769,0,0,48391,0,0,,48391,48391
29,07/19/2017,33,8:00,8:15,248.51,28.46,0,28.46,28.46,-1,-29266,140906,170172,111640,0,-131,14065,0,0,,14196,13934
29,07/19/2017,34,8:15,8:30,,,0,27.85,27.85,0,-34078,89223,123301,55145,0,0,0,0,0,,0,0
29,07/19/2017,35,8:30,8:45,,28.84,0,28.84,28.84,-1,-32938,58046,90984,25108,0,-1015,0,0,0,,1015,-1015
29,07/19/2017,36,8:45,9:00,31.89,28.84,0,31.89,27.82,2,-55513,53745,109258,-1768,0,-959,2324,0,0,,3283,1365
29,07/19/2017,37,9:00,9:15,26.38,,0,26.38,26.38,1,-55096,86847,141943,31751,0,0,523,0,0,,523,523
29,07/19/2017,38,9:15,9:30,30.59,,0,30.59,30.59,1,-73328,69222,142550,-4106,0,0,843,0,0,,843,843
29,07/19/2017,39,9:30,9:45,30.03,,0,30.03,30.03,1,-94375,61945,156320,-32430,0,0,2130,0,0,,2130,2130
29,07/19/2017,40,9:45,10:00,31.05,,0,31.05,31.05,1,-88183,56625,144808,-31558,0,0,6621,0,0,,6621,6621
29,07/19/2017,41,10:00,10:15,35.84,,0,35.84,35.84,1,-71540,66803,138343,-4737,0,0,11626,0,0,,11626,11626
29,07/19/2017,42,10:15,10:30,35.84,29.84,0,29.84,29.84,-1,-71675,61114,132789,-10561,0,-445,2120,0,0,,2565,1675
29,07/19/2017,43,10:30,10:45,35.84,,0,35.84,35.84,1,-92141,68266,160407,-23875,0,0,3640,0,0,,3640,3640
29,07/19/2017,44,10:45,11:00,27.36,,0,27.36,27.36,1,-86510,84654,171164,-1856,0,0,2235,0,0,,2235,2235
29,07/19/2017,45,11:00,11:15,27.36,28.84,0,28.84,28.84,-1,-56360,86878,143238,30518,0,-1282,43,0,0,,1325,-1239
29,07/19/2017,46,11:15,11:30,,29.84,0,29.84,29.84,-1,-59621,82505,142126,22884,0,-1022,0,0,0,,1022,-1022
29,07/19/2017,47,11:30,11:45,,28.84,0,28.84,28.84,-1,-52201,89293,141494,37092,0,-2476,0,0,0,,2476,-2476
29,07/19/2017,48,11:45,12:00,,28.84,0,28.84,28.84,-1,-57248,92622,149870,35374,0,-5367,0,0,0,,5367,-5367
29,07/19/2017,49,12:00,12:15,,27.03,0,27.03,27.03,-1,-42999,83825,126824,40826,0,-6712,0,0,0,,6712,-6712
29,07/19/2017,50,12:15,12:30,,27.03,0,27.03,27.03,-1,-61111,62781,123892,1670,0,-5774,0,0,0,,5774,-5774
29,07/19/2017,51,12:30,12:45,35.84,27.03,0,35.84,35.84,1,-79457,60264,139721,-19193,0,-394,2859,0,0,,3253,2465
29,07/19/2017,52,12:45,13:00,35.84,,0,35.84,35.84,1,-94044,49488,143532,-44556,0,0,10542,0,0,,10542,10542
29,07/19/2017,53,13:00,13:15,27.34,,0,27.34,27.34,1,-87930,102264,190194,14334,0,0,1969,0,0,,1969,1969
29,07/19/2017,54,13:15,13:30,26.67,29.84,0,29.84,29.84,-1,-73860,109658,183518,35798,0,-5,163,0,0,,168,158
29,07/19/2017,55,13:30,13:45,,27.26,0,27.26,27.26,-1,-88008,117270,205278,29262,0,-367,0,0,0,,367,-367
29,07/19/2017,56,13:45,14:00,26.85,28.84,0,28.47,28.47,2,-92357,95991,188348,3634,0,-647,11,0,0,,658,-636
29,07/19/2017,57,14:00,14:15,129.02,,0,129.02,129.02,1,-160925,100492,261417,-60433,0,0,29197,0,0,,29197,29197
29,07/19/2017,58,14:15,14:30,41.84,,0,41.84,41.84,1,-121643,103565,225208,-18078,0,0,33233,0,0,,33233,33233
29,07/19/2017,59,14:30,14:45,57.23,,0,57.23,57.23,1,-126103,99629,225732,-26474,0,0,18216,0,0,,18216,18216
29,07/19/2017,60,14:45,15:00,67.02,,0,67.02,67.02,1,-124603,97857,222460,-26746,0,0,39272,0,0,,39272,39272
29,07/19/2017,61,15:00,15:15,31.84,,0,31.84,31.84,1,-116242,112057,228299,-4185,0,0,11615,0,0,,11615,11615
29,07/19/2017,62,15:15,15:30,33.78,,0,33.78,33.78,1,-116632,104672,221304,-11960,0,0,3285,0,0,,3285,3285
29,07/19/2017,63,15:30,15:45,97.02,,0,97.02,97.02,1,-135081,108831,243912,-26250,0,0,29072,0,0,,29072,29072
29,07/19/2017,64,15:45,16:00,34.27,28.84,0,28.84,28.84,-1,-112627,110368,222995,-2259,0,-19,20242,0,0,,20261,20223
29,07/19/2017,65,16:00,16:15,34.27,2.87,0,2.87,2.87,-1,-56780,180373,237153,123593,0,-10746,2436,0,0,,13182,-8310
29,07/19/2017,66,16:15,16:30,,28.84,0,28.84,28.84,-1,-58213,157939,216152,99726,0,-1665,0,0,0,,1665,-1665
29,07/19/2017,67,16:30,16:45,,29.84,0,29.84,29.84,-1,-55086,161958,217044,106872,0,-1295,0,0,0,,1295,-1295
29,07/19/2017,68,16:45,17:00,,27.26,0,27.26,27.26,-1,-55213,166883,222096,111670,0,-617,0,0,0,,617,-617
29,07/19/2017,69,17:00,17:15,,16.14,0,16.14,16.14,-1,-34029,184006,218035,149977,0,-19461,0,0,0,,19461,-19461
29,07/19/2017,70,17:15,17:30,,24.84,0,24.84,24.84,-1,-24385,165215,189600,140830,0,-7156,0,0,0,,7156,-7156
29,07/19/2017,71,17:30,17:45,,17.27,0,17.27,17.27,-1,-26153,161506,187659,135353,0,-14620,0,0,0,,14620,-14620
29,07/19/2017,72,17:45,18:00,,26.45,0,26.45,26.45,-1,-30454,186605,217059,156151,0,-8083,0,0,0,,8083,-8083
29,07/19/2017,73,18:00,18:15,,13.85,0,13.85,13.85,-1,-41474,176526,218000,135052,0,-11393,0,0,0,,11393,-11393
29,07/19/2017,74,18:15,18:30,,15.36,0,15.36,15.36,-1,-30573,164401,194974,133828,0,-24521,0,0,0,,24521,-24521
29,07/19/2017,75,18:30,18:45,,7.13,0,7.13,7.13,-1,-34043,162523,196566,128480,0,-22403,0,0,0,,22403,-22403
29,07/19/2017,76,18:45,19:00,,26.91,0,26.91,26.91,-1,-31868,134151,166019,102283,0,-11725,0,0,0,,11725,-11725
29,07/19/2017,77,19:00,19:15,,28.84,0,28.84,28.84,-1,-46934,121274,168208,74340,0,-2947,0,0,0,,2947,-2947
29,07/19/2017,78,19:15,19:30,,24.84,0,24.84,24.84,-1,-39959,100406,140365,60447,0,-6049,0,0,0,,6049,-6049
29,07/19/2017,79,19:30,19:45,,24.84,0,24.84,24.84,-1,-42188,106316,148504,64128,0,-9949,0,0,0,,9949,-9949
29,07/19/2017,80,19:45,20:00,,26.53,0,26.53,26.53,-1,-39166,95732,134898,56566,0,-10242,0,0,0,,10242,-10242
29,07/19/2017,81,20:00,20:15,,27.26,0,27.26,27.26,-1,-40243,72976,113219,32733,0,-4233,0,0,0,,4233,-4233
29,07/19/2017,82,20:15,20:30,,25.41,0,25.41,25.41,-1,-35455,66477,101932,31022,0,-1394,0,0,0,,1394,-1394
29,07/19/2017,83,20:30,20:45,,22.26,0,22.26,22.26,-1,-42609,75742,118351,33133,0,-21771,0,0,0,,21771,-21771
29,07/19/2017,84,20:45,21:00,,7.46,0,7.46,7.46,-1,-40760,101190,141950,60430,0,-29712,0,0,0,,29712,-29712
29,07/19/2017,85,21:00,21:15,,23.23,0,23.23,23.23,-1,-42483,89684,132167,47201,0,-31352,0,0,0,,31352,-31352
29,07/19/2017,86,21:15,21:30,,,0,28.13,28.13,0,-29384,106340,135724,76956,0,-6705,0,0,0,,6705,-6705
29,07/19/2017,87,21:30,21:45,,,0,28.13,28.13,0,-43882,107213,151095,63331,0,0,0,0,0,,0,0
29,07/19/2017,88,21:45,22:00,,,0,28.13,28.13,0,-49369,90066,139435,40697,0,0,0,0,0,,0,0
29,07/19/2017,89,22:00,22:15,,,0,28.21,28.21,0,-60115,67360,127475,7245,0,0,0,0,0,,0,0
29,07/19/2017,90,22:15,22:30,,,0,28.21,28.21,0,-58596,71864,130460,13268,0,0,0,0,0,,0,0
29,07/19/2017,91,22:30,22:45,,,0,28.21,28.21,0,-48126,62991,111117,14865,0,0,0,0,0,,0,0
29,07/19/2017,92,22:45,23:00,,27.03,0,27.03,27.03,-1,-48415,57363,105778,8948,0,-1927,0,0,0,,1927,-1927
29,07/19/2017,93,23:00,23:15,,27.03,0,27.03,27.03,-1,-71844,85403,157247,13559,0,-1665,0,0,0,,1665,-1665
29,07/19/2017,94,23:15,23:30,,22.4,0,22.4,22.4,-1,-44176,65839,110015,21663,0,-3195,0,0,0,,3195,-3195
29,07/19/2017,95,23:30,23:45,,14.63,0,14.63,14.63,-1,-31748,76480,108228,44732,0,-32103,0,0,0,,32103,-32103
29,07/19/2017,96,23:45,0:00,,20.07,0,20.07,20.07,-1,-35406,92035,127441,56629,0,-34339,0,0,0,,34339,-34339
29,07/20/2017,1,0:00,0:15,89.61,28.49,0,89.61,26.98,2,-86132,56833,142965,-29299,0,-9053,6473,0,0,,15526,-2580
29,07/20/2017,2,0:15,0:30,25.9,,0,25.9,25.9,1,-49427,69499,118926,20072,0,0,884,0,0,,884,884
29,07/20/2017,3,0:30,0:45,,28.47,0,28.47,28.47,-1,-53760,77956,131716,24196,0,-473,0,0,0,,473,-473
29,07/20/2017,4,0:45,1:00,,28.09,0,28.09,28.09,-1,-51499,94034,145533,42535,0,-1958,0,0,0,,1958,-1958
29,07/20/2017,5,1:00,1:15,,27.79,0,27.79,27.79,-1,-70411,93150,163561,22739,0,-1357,0,0,0,,1357,-1357
29,07/20/2017,6,1:15,1:30,,24.47,0,24.47,24.47,-1,-56512,100030,156542,43518,0,-2321,0,0,0,,2321,-2321
29,07/20/2017,7,1:30,1:45,,27.78,0,27.78,27.78,-1,-51610,96205,147815,44595,0,-3162,0,0,0,,3162,-3162
29,07/20/2017,8,1:45,2:00,,26.83,0,26.83,26.83,-1,-77581,96811,174392,19230,0,-684,0,0,0,,684,-684
29,07/20/2017,9,2:00,2:15,,26.5,0,26.5,26.5,-1,-56753,114156,170909,57403,0,-1774,0,0,0,,1774,-1774
29,07/20/2017,10,2:15,2:30,,20.47,0,20.47,20.47,-1,-46139,110312,156451,64173,0,-3328,0,0,0,,3328,-3328
29,07/20/2017,11,2:30,2:45,,1.78,0,1.78,1.78,-1,-36690,112329,149019,75639,0,-34951,0,0,0,,34951,-34951
29,07/20/2017,12,2:45,3:00,,-1.99,0,-1.99,-1.99,-1,-37068,117774,154842,80706,0,-45877,0,0,0,,45877,-45877
29,07/20/2017,13,3:00,3:15,,-12.39,0,-12.39,-12.39,-1,-42710,77786,120496,35076,0,-48131,0,0,0,,48131,-48131
29,07/20/2017,14,3:15,3:30,,-9.12,0,-9.12,-9.12,-1,-39404,108509,147913,69105,0,-54914,0,0,0,,54914,-54914
29,07/20/2017,15,3:30,3:45,,11.96,0,11.96,11.96,-1,-50001,95762,145763,45761,0,-54676,0,0,0,,54676,-54676
29,07/20/2017,16,3:45,4:00,,23.01,0,23.01,23.01,-1,-52416,66261,118677,13845,0,-30525,0,0,0,,30525,-30525
29,07/20/2017,17,4:00,4:15,26.99,23.01,0,26.99,26.99,1,-59521,28882,88403,-30639,0,-2758,1000,0,0,,3758,-1758
29,07/20/2017,18,4:15,4:30,27.02,28.43,0,27.21,27.21,2,-66818,75826,142644,9008,0,-3,1794,0,0,,1797,1791
29,07/20/2017,19,4:30,4:45,27.02,24.47,0,24.47,24.47,-1,-65597,100633,166230,35036,0,-1641,9,0,0,,1650,-1632
29,07/20/2017,20,4:45,5:00,35.84,,0,35.84,35.84,1,-72777,33413,106190,-39364,0,0,1910,0,0,,1910,1910
29,07/20/2017,21,5:00,5:15,235.73,,0,235.73,235.73,1,-152624,24572,177196,-128052,0,0,26341,0,0,,26341,26341
29,07/20/2017,22,5:15,5:30,235.73,,0,235.73,235.73,1,-91565,35721,127286,-55844,0,0,53657,0,0,,53657,53657
29,07/20/2017,23,5:30,5:45,46.12,,0,46.12,46.12,1,-87801,33915,121716,-53886,0,0,40551,0,0,,40551,40551
29,07/20/2017,24,5:45,6:00,235.73,,0,235.73,235.73,1,-104362,65317,169679,-39045,0,0,56281,0,0,,56281,56281
29,07/20/2017,25,6:00,6:15,235.73,-28.11,0,-28.11,-28.11,-1,-48045,103740,151785,55695,0,-25429,6822,0,0,,32251,-18607
29,07/20/2017,26,6:15,6:30,,-35.67,0,-35.67,-35.67,-1,-66776,60906,127682,-5870,0,-33100,0,0,0,,33100,-33100
29,07/20/2017,27,6:30,6:45,,,0,26.36,26.36,0,-80544,41760,122304,-38784,0,-825,0,0,0,,825,-825
29,07/20/2017,28,6:45,7:00,184.62,,0,184.62,184.62,1,-97250,32311,129561,-64939,0,0,8153,0,0,,8153,8153
29,07/20/2017,29,7:00,7:15,28.12,16.85,0,28.12,16.85,2,-55445,83557,139002,28112,0,-7256,2057,0,0,,9313,-5199
29,07/20/2017,30,7:15,7:30,,28.39,0,28.39,28.39,-1,-114851,69673,184524,-45178,0,-250,0,0,0,,250,-250
29,07/20/2017,31,7:30,7:45,,,0,27.15,27.15,0,-88136,39339,127475,-48797,0,0,0,0,0,,0,0
29,07/20/2017,32,7:45,8:00,26.08,,0,26.08,26.08,1,-107472,40903,148375,-66569,0,0,151,0,0,,151,151
29,07/20/2017,33,8:00,8:15,40.28,,0,40.28,40.28,1,-113726,25265,138991,-88461,0,0,3250,0,0,,3250,3250
29,07/20/2017,34,8:15,8:30,48.95,,0,48.95,48.95,1,-121836,9867,131703,-111969,0,0,22579,0,0,,22579,22579
29,07/20/2017,35,8:30,8:45,70.8,,0,70.8,70.8,1,-138121,3908,142029,-134213,0,0,32124,0,0,,32124,32124
29,07/20/2017,36,8:45,9:00,117.12,,0,117.12,117.12,1,-154448,16865,171313,-137583,0,0,50556,0,0,,50556,50556
29,07/20/2017,37,9:00,9:15,102.72,,0,102.72,102.72,1,-105035,46151,151186,-58884,0,0,33956,0,0,,33956,33956
29,07/20/2017,38,9:15,9:30,,,0,27.21,27.21,0,-118321,35891,154212,-82430,0,0,191,0,0,,191,191
29,07/20/2017,39,9:30,9:45,31.62,,0,31.62,31.62,1,-132411,23552,155963,-108859,0,0,36,0,0,,36,36
29,07/20/2017,40,9:45,10:00,61.12,,0,61.12,61.12,1,-141335,13511,154846,-127824,0,0,18885,0,0,,18885,18885
29,07/20/2017,41,10:00,10:15,47.73,,0,47.73,47.73,1,-102205,52929,155134,-49276,0,0,16663,0,0,,16663,16663
29,07/20/2017,42,10:15,10:30,265.62,,0,265.62,265.62,1,-116743,23056,139799,-93687,0,0,51613,0,0,,51613,51613
29,07/20/2017,43,10:30,10:45,107.12,,0,107.12,107.12,1,-91584,48699,140283,-42885,0,0,58281,0,0,,58281,58281
29,07/20/2017,44,10:45,11:00,33.35,,0,33.35,33.35,1,-90646,63917,154563,-26729,0,0,14806,0,0,,14806,14806
29,07/20/2017,45,11:00,11:15,31.62,27.19,0,31.62,27.19,2,-71378,66238,137616,-5140,0,-196,253,0,0,,449,57
29,07/20/2017,46,11:15,11:30,31.62,,0,31.62,31.62,1,-73778,59025,132803,-14753,0,0,2789,0,0,,2789,2789
29,07/20/2017,47,11:30,11:45,40.66,,0,40.66,40.66,1,-77637,57608,135245,-20029,0,0,14918,0,0,,14918,14918
29,07/20/2017,48,11:45,12:00,40.66,28.49,0,28.49,28.49,-1,-67871,65768,133639,-2103,0,-35,3442,0,0,,3477,3407
29,07/20/2017,49,12:00,12:15,257.15,,0,257.15,257.15,1,-84760,36593,121353,-48167,0,0,14665,0,0,,14665,14665
29,07/20/2017,50,12:15,12:30,31.62,,0,31.62,31.62,1,-76761,63938,140699,-12823,0,0,6786,0,0,,6786,6786
29,07/20/2017,51,12:30,12:45,46,,0,46,46,1,-92639,57263,149902,-35376,0,0,15789,0,0,,15789,15789
29,07/20/2017,52,12:45,13:00,38.01,,0,38.01,38.01,1,-96914,59444,156358,-37470,0,0,22587,0,0,,22587,22587
29,07/20/2017,53,13:00,13:15,249.11,,0,249.11,249.11,1,-117898,30698,148596,-87200,0,0,47237,0,0,,47237,47237
29,07/20/2017,54,13:15,13:30,39.09,26.78,0,26.78,26.78,-1,-81032,61612,142644,-19420,0,-118,19797,0,0,,19915,19679
29,07/20/2017,55,13:30,13:45,31.62,,0,31.62,31.62,1,-74884,43804,118688,-31080,0,0,882,0,0,,882,882
29,07/20/2017,56,13:45,14:00,38.04,,0,38.04,38.04,1,-76790,42092,118882,-34698,0,0,9168,0,0,,9168,9168
29,07/20/2017,57,14:00,14:15,30.96,,0,30.96,30.96,1,-89869,60640,150509,-29229,0,0,1630,0,0,,1630,1630
29,07/20/2017,58,14:15,14:30,33.88,,0,33.88,33.88,1,-76308,64642,140950,-11666,0,0,4444,0,0,,4444,4444
29,07/20/2017,59,14:30,14:45,33.88,26.49,0,26.49,26.49,-1,-60908,103593,164501,42685,0,-160,831,0,0,,991,671
29,07/20/2017,60,14:45,15:00,,25.92,0,25.92,25.92,-1,-58966,108877,167843,49911,0,-1081,0,0,0,,1081,-1081
29,07/20/2017,61,15:00,15:15,,25.83,0,25.83,25.83,-1,-79189,100951,180140,21762,0,-1246,0,0,0,,1246,-1246
29,07/20/2017,62,15:15,15:30,,26.81,0,26.81,26.81,-1,-71727,86503,158230,14776,0,-1179,0,0,0,,1179,-1179
29,07/20/2017,63,15:30,15:45,,26.82,0,26.82,26.82,-1,-70064,68075,138139,-1989,0,-1252,0,0,0,,1252,-1252
29,07/20/2017,64,15:45,16:00,28.7,,0,28.7,28.7,1,-64384,57658,122042,-6726,0,0,765,0,0,,765,765
29,07/20/2017,65,16:00,16:15,203.64,,0,203.64,203.64,1,-93679,20326,114005,-73353,0,0,24172,0,0,,24172,24172
29,07/20/2017,66,16:15,16:30,203.64,,0,203.64,203.64,1,-68127,59807,127934,-8320,0,0,36322,0,0,,36322,36322
29,07/20/2017,67,16:30,16:45,,,0,26.95,26.95,0,-61360,69962,131322,8602,0,0,1556,0,0,,1556,1556
29,07/20/2017,68,16:45,17:00,27.01,,0,27.01,27.01,1,-56584,63253,119837,6669,0,0,17,0,0,,17,17
29,07/20/2017,69,17:00,17:15,42.97,,0,42.97,42.97,1,-91071,49636,140707,-41435,0,0,1903,0,0,,1903,1903
29,07/20/2017,70,17:15,17:30,,,0,27.27,27.27,0,-79519,50833,130352,-28686,0,0,0,0,0,,0,0
29,07/20/2017,71,17:30,17:45,,,0,27.27,27.27,0,-77167,70886,148053,-6281,0,0,0,0,0,,0,0
29,07/20/2017,72,17:45,18:00,,,0,27.27,27.27,0,-86130,81397,167527,-4733,0,0,0,0,0,,0,0
29,07/20/2017,73,18:00,18:15,,,0,27.74,27.74,0,-108489,89092,197581,-19397,0,0,0,0,0,,0,0
29,07/20/2017,74,18:15,18:30,,-2.7,0,-2.7,-2.7,-1,-55225,113033,168258,57808,0,-18284,0,0,0,,18284,-18284
29,07/20/2017,75,18:30,18:45,,20.45,0,20.45,20.45,-1,-87605,119383,206988,31778,0,-27723,0,0,0,,27723,-27723
29,07/20/2017,76,18:45,19:00,,24.45,0,24.45,24.45,-1,-81024,147745,228769,66721,0,-8174,0,0,0,,8174,-8174
29,07/20/2017,77,19:00,19:15,,20.45,0,20.45,20.45,-1,-52629,105217,157846,52588,0,-11749,0,0,0,,11749,-11749
29,07/20/2017,78,19:15,19:30,,-3.81,0,-3.81,-3.81,-1,-44755,119184,163939,74429,0,-49399,0,0,0,,49399,-49399
29,07/20/2017,79,19:30,19:45,,22.13,0,22.13,22.13,-1,-48119,112073,160192,63954,0,-35654,0,0,0,,35654,-35654
29,07/20/2017,80,19:45,20:00,,23.15,0,23.15,23.15,-1,-46207,96894,143101,50687,0,-17285,0,0,0,,17285,-17285
29,07/20/2017,81,20:00,20:15,31.62,26.75,0,31.62,26.75,2,-54079,40673,94752,-13406,0,-5108,640,0,0,,5748,-4468
29,07/20/2017,82,20:15,20:30,,28.39,0,28.39,28.39,-1,-52494,60551,113045,8057,0,-6,0,0,0,,6,-6
29,07/20/2017,83,20:30,20:45,,25.78,0,25.78,25.78,-1,-71379,84260,155639,12881,0,-2338,0,0,0,,2338,-2338
29,07/20/2017,84,20:45,21:00,,28.36,0,28.36,28.36,-1,-95496,93600,189096,-1896,0,-266,0,0,0,,266,-266
29,07/20/2017,85,21:00,21:15,,25.45,0,25.45,25.45,-1,-75898,89359,165257,13461,0,-997,0,0,0,,997,-997
29,07/20/2017,86,21:15,21:30,,23.87,0,23.87,23.87,-1,-63136,94525,157661,31389,0,-13012,0,0,0,,13012,-13012
29,07/20/2017,87,21:30,21:45,,25.45,0,25.45,25.45,-1,-76563,97969,174532,21406,0,-13071,0,0,0,,13071,-13071
29,07/20/2017,88,21:45,22:00,,25.85,0,25.85,25.85,-1,-86141,95362,181503,9221,0,-4083,0,0,0,,4083,-4083
29,07/20/2017,89,22:00,22:15,,24.83,0,24.83,24.83,-1,-76389,98208,174597,21819,0,-2960,0,0,0,,2960,-2960
29,07/20/2017,90,22:15,22:30,,24.45,0,24.45,24.45,-1,-95597,96918,192515,1321,0,-4448,0,0,0,,4448,-4448
29,07/20/2017,91,22:30,22:45,,26.78,0,26.78,26.78,-1,-97780,106545,204325,8765,0,-2454,0,0,0,,2454,-2454
29,07/20/2017,92,22:45,23:00,,19.6,0,19.6,19.6,-1,-94384,137617,232001,43233,0,-8921,0,0,0,,8921,-8921
29,07/20/2017,93,23:00,23:15,,7.66,0,7.66,7.66,-1,-84752,124677,209429,39925,0,-30072,0,0,0,,30072,-30072
29,07/20/2017,94,23:15,23:30,,24.45,0,24.45,24.45,-1,-103053,118247,221300,15194,0,-7276,0,0,0,,7276,-7276
29,07/20/2017,95,23:30,23:45,,20.86,0,20.86,20.86,-1,-118227,118881,237108,654,0,-7055,0,0,0,,7055,-7055
29,07/20/2017,96,23:45,0:00,,28.36,0,28.36,28.36,-1,-124239,87218,211457,-37021,0,-218,0,0,0,,218,-218
29,07/21/2017,1,0:00,0:15,32.52,29.62,0,32.52,27.47,2,-117652,59148,176800,-58504,0,-17,442,0,0,,459,425
29,07/21/2017,2,0:15,0:30,51.02,,0,51.02,51.02,1,-125549,13934,139483,-111615,0,0,13325,0,0,,13325,13325
29,07/21/2017,3,0:30,0:45,37.49,,0,37.49,37.49,1,-128057,11791,139848,-116266,0,0,12370,0,0,,12370,12370
29,07/21/2017,4,0:45,1:00,164.6,,0,164.6,164.6,1,-193681,23599,217280,-170082,0,0,35467,0,0,,35467,35467
29,07/21/2017,5,1:00,1:15,164.71,,0,164.71,164.71,1,-139669,42299,181968,-97370,0,0,51402,0,0,,51402,51402
29,07/21/2017,6,1:15,1:30,164.71,,0,164.71,164.71,1,-102936,58300,161236,-44636,0,0,53679,0,0,,53679,53679
29,07/21/2017,7,1:30,1:45,,,0,27.53,27.53,0,-98629,46456,145085,-52173,0,0,753,0,0,,753,753
29,07/21/2017,8,1:45,2:00,,,0,27.53,27.53,0,-106391,54777,161168,-51614,0,0,0,0,0,,0,0
29,07/21/2017,9,2:00,2:15,41.62,,0,41.62,41.62,1,-76265,46677,122942,-29588,0,0,11147,0,0,,11147,11147
29,07/21/2017,10,2:15,2:30,31.62,,0,31.62,31.62,1,-61270,48665,109935,-12605,0,0,9407,0,0,,9407,9407
29,07/21/2017,11,2:30,2:45,31.62,29.62,0,29.62,29.62,-1,-45650,49884,95534,4234,0,-317,57,0,0,,374,-260
29,07/21/2017,12,2:45,3:00,,28.62,0,28.62,28.62,-1,-41016,44801,85817,3785,0,-1204,0,0,0,,1204,-1204
29,07/21/2017,13,3:00,3:15,,28.62,0,28.62,28.62,-1,-22579,67037,89616,44458,0,-523,0,0,0,,523,-523
29,07/21/2017,14,3:15,3:30,,29.62,0,29.62,29.62,-1,-16253,80421,96674,64168,0,-9,0,0,0,,9,-9
29,07/21/2017,15,3:30,3:45,,28.62,0,28.62,28.62,-1,-16693,77776,94469,61083,0,-824,0,0,0,,824,-824
29,07/21/2017,16,3:45,4:00,,26.72,0,26.72,26.72,-1,-13561,66304,79865,52743,0,-1486,0,0,0,,1486,-1486
29,07/21/2017,17,4:00,4:15,,21.2,0,21.2,21.2,-1,-9983,68718,78701,58735,0,-2183,0,0,0,,2183,-2183
29,07/21/2017,18,4:15,4:30,,11.75,0,11.75,11.75,-1,-13578,54874,68452,41296,0,-21463,0,0,0,,21463,-21463
29,07/21/2017,19,4:30,4:45,,,0,27.59,27.59,0,-26412,47779,74191,21367,0,-1944,0,0,0,,1944,-1944
29,07/21/2017,20,4:45,5:00,,,0,27.59,27.59,0,-33613,45022,78635,11409,0,0,0,0,0,,0,0
29,07/21/2017,21,5:00,5:15,,24.62,0,24.62,24.62,-1,-29025,49145,78170,20120,0,-7080,0,0,0,,7080,-7080
29,07/21/2017,22,5:15,5:30,,26.07,0,26.07,26.07,-1,-35970,57588,93558,21618,0,-10150,0,0,0,,10150,-10150
29,07/21/2017,23,5:30,5:45,,24.62,0,24.62,24.62,-1,-40260,55374,95634,15114,0,-17118,0,0,0,,17118,-17118
29,07/21/2017,24,5:45,6:00,25.77,27.04,0,27.59,27.04,2,-40579,55200,95779,14621,0,-3361,105,0,0,,3466,-3256
29,07/21/2017,25,6:00,6:15,,26.62,0,26.62,26.62,-1,-57584,68781,126365,11197,0,-3055,0,0,0,,3055,-3055
29,07/21/2017,26,6:15,6:30,,24.61,0,24.61,24.61,-1,-48437,56585,105022,8148,0,-8393,0,0,0,,8393,-8393
29,07/21/2017,27,6:30,6:45,,24.61,0,24.61,24.61,-1,-30615,40260,70875,9645,0,-20847,0,0,0,,20847,-20847
29,07/21/2017,28,6:45,7:00,,-4.52,0,-4.52,-4.52,-1,-41796,99850,141646,58054,0,-13095,0,0,0,,13095,-13095
29,07/21/2017,29,7:00,7:15,31.79,-0.96,0,31.79,-0.96,2,-102938,80103,183041,-22835,0,-26837,161,0,0,,26998,-26676
29,07/21/2017,30,7:15,7:30,46.06,-0.96,0,46.06,46.06,1,-56217,52317,108534,-3900,0,-884,5843,0,0,,6727,4959
29,07/21/2017,31,7:30,7:45,46.06,24.61,0,24.61,24.61,-1,-31591,47786,79377,16195,0,-8397,216,0,0,,8613,-8181
29,07/21/2017,32,7:45,8:00,,28.61,0,28.61,28.61,-1,-54497,56762,111259,2265,0,-2260,0,0,0,,2260,-2260
29,07/21/2017,33,8:00,8:15,,,0,27.62,27.62,0,-54244,58748,112992,4504,0,0,0,0,0,,0,0
29,07/21/2017,34,8:15,8:30,31.61,,0,31.61,31.61,1,-50152,35485,85637,-14667,0,0,1025,0,0,,1025,1025
29,07/21/2017,35,8:30,8:45,30.04,,0,30.04,30.04,1,-34594,22618,57212,-11976,0,0,1698,0,0,,1698,1698
29,07/21/2017,36,8:45,9:00,30.18,,0,30.18,30.18,1,-44143,32189,76332,-11954,0,0,2867,0,0,,2867,2867
29,07/21/2017,37,9:00,9:15,31.61,,0,31.61,31.61,1,-57448,36594,94042,-20854,0,0,4681,0,0,,4681,4681
29,07/21/2017,38,9:15,9:30,46.87,,0,46.87,46.87,1,-68727,31657,100384,-37070,0,0,16483,0,0,,16483,16483
29,07/21/2017,39,9:30,9:45,31.91,,0,31.91,31.91,1,-62584,43765,106349,-18819,0,0,15291,0,0,,15291,15291
29,07/21/2017,40,9:45,10:00,30.21,,0,30.21,30.21,1,-69295,43228,112523,-26067,0,0,7088,0,0,,7088,7088
29,07/21/2017,41,10:00,10:15,30.21,28.61,0,28.61,28.61,-1,-33651,153426,187077,119775,0,-564,1005,0,0,,1569,441
29,07/21/2017,42,10:15,10:30,,28.61,0,28.61,28.61,-1,-54362,79792,134154,25430,0,-1181,0,0,0,,1181,-1181
29,07/21/2017,43,10:30,10:45,,28.61,0,28.61,28.61,-1,-32662,87080,119742,54418,0,-976,0,0,0,,976,-976
29,07/21/2017,44,10:45,11:00,,29.61,0,29.61,29.61,-1,-29523,73850,103373,44327,0,-869,0,0,0,,869,-869
29,07/21/2017,45,11:00,11:15,,24.61,0,24.61,24.61,-1,-32489,57186,89675,24697,0,-8603,0,0,0,,8603,-8603
29,07/21/2017,46,11:15,11:30,,29.61,0,29.61,29.61,-1,-29738,54360,84098,24622,0,-2594,0,0,0,,2594,-2594
29,07/21/2017,47,11:30,11:45,,29.61,0,29.61,29.61,-1,-33512,49213,82725,15701,0,-1122,0,0,0,,1122,-1122
29,07/21/2017,48,11:45,12:00,,29.61,0,29.61,29.61,-1,-41870,50322,92192,8452,0,-1511,0,0,0,,1511,-1511
29,07/21/2017,49,12:00,12:15,,29.61,0,29.61,29.61,-1,-37623,89819,127442,52196,0,-738,0,0,0,,738,-738
29,07/21/2017,50,12:15,12:30,,28.61,0,28.61,28.61,-1,-40024,101794,141818,61770,0,-1582,0,0,0,,1582,-1582
29,07/21/2017,51,12:30,12:45,,23.14,0,23.14,23.14,-1,-44087,107325,151412,63238,0,-16043,0,0,0,,16043,-16043
29,07/21/2017,52,12:45,13:00,,24.61,0,24.61,24.61,-1,-47586,89410,136996,41824,0,-19633,0,0,0,,19633,-19633
29,07/21/2017,53,13:00,13:15,,24.45,0,24.45,24.45,-1,-53413,69599,123012,16186,0,-16593,0,0,0,,16593,-16593
29,07/21/2017,54,13:15,13:30,36.58,27.09,0,36.58,27.09,2,-50341,46757,97098,-3584,0,-2944,2449,0,0,,5393,-495
29,07/21/2017,55,13:30,13:45,,26.22,0,26.22,26.22,-1,-42318,72270,114588,29952,0,-2890,0,0,0,,2890,-2890
29,07/21/2017,56,13:45,14:00,,12.26,0,12.26,12.26,-1,-42322,93643,135965,51321,0,-10131,0,0,0,,10131,-10131
29,07/21/2017,57,14:00,14:15,,5.98,0,5.98,5.98,-1,-49187,80053,129240,30866,0,-37174,0,0,0,,37174,-37174
29,07/21/2017,58,14:15,14:30,,27.09,0,27.09,27.09,-1,-52247,59193,111440,6946,0,-11818,0,0,0,,11818,-11818
29,07/21/2017,59,14:30,14:45,,26.71,0,26.71,26.71,-1,-50940,53958,104898,3018,0,-2042,0,0,0,,2042,-2042
29,07/21/2017,60,14:45,15:00,,24.61,0,24.61,24.61,-1,-49318,57758,107076,8440,0,-7539,0,0,0,,7539,-7539
29,07/21/2017,61,15:00,15:15,,18.04,0,18.04,18.04,-1,-45427,87805,133232,42378,0,-20177,0,0,0,,20177,-20177
29,07/21/2017,62,15:15,15:30,,14.43,0,14.43,14.43,-1,-43795,73036,116831,29241,0,-32901,0,0,0,,32901,-32901
29,07/21/2017,63,15:30,15:45,,24.61,0,24.61,24.61,-1,-46064,76863,122927,30799,0,-23191,0,0,0,,23191,-23191
29,07/21/2017,64,15:45,16:00,,24.61,0,24.61,24.61,-1,-44809,95601,140410,50792,0,-29312,0,0,0,,29312,-29312
29,07/21/2017,65,16:00,16:15,87.72,26.1,0,87.72,26.1,2,-85080,53367,138447,-31713,0,-14043,5126,0,0,,19169,-8917
29,07/21/2017,66,16:15,16:30,30.27,,0,30.27,30.27,1,-75471,83503,158974,8032,0,0,3708,0,0,,3708,3708
29,07/21/2017,67,16:30,16:45,26.01,,0,26.01,26.01,1,-67872,87565,155437,19693,0,0,1288,0,0,,1288,1288
29,07/21/2017,68,16:45,17:00,,,0,27.6,27.6,0,-77747,88393,166140,10646,0,0,118,0,0,,118,118
29,07/21/2017,69,17:00,17:15,,12.72,0,12.72,12.72,-1,-42382,88270,130652,45888,0,-14955,0,0,0,,14955,-14955
29,07/21/2017,70,17:15,17:30,,27.03,0,27.03,27.03,-1,-50274,67529,117803,17255,0,-8529,0,0,0,,8529,-8529
29,07/21/2017,71,17:30,17:45,,,0,27.62,27.62,0,-57866,68814,126680,10948,0,-3,0,0,0,,3,-3
29,07/21/2017,72,17:45,18:00,29.02,,0,29.02,29.02,1,-60529,67057,127586,6528,0,0,576,0,0,,576,576
29,07/21/2017,73,18:00,18:15,25.61,,0,25.61,25.61,1,-52830,55345,108175,2515,0,0,1384,0,0,,1384,1384
29,07/21/2017,74,18:15,18:30,,,0,27.63,27.63,0,-53162,66103,119265,12941,0,0,71,0,0,,71,71
29,07/21/2017,75,18:30,18:45,,,0,27.65,27.65,0,-53538,85333,138871,31795,0,0,0,0,0,,0,0
29,07/21/2017,76,18:45,19:00,,,0,27.69,27.69,0,-45266,103146,148412,57880,0,0,0,0,0,,0,0
29,07/21/2017,77,19:00,19:15,,,0,27.64,27.64,0,-61941,74939,136880,12998,0,0,0,0,0,,0,0
29,07/21/2017,78,19:15,19:30,31.61,,0,31.61,31.61,1,-65319,67614,132933,2295,0,0,495,0,0,,495,495
29,07/21/2017,79,19:30,19:45,31.61,,0,31.61,31.61,1,-60792,63707,124499,2915,0,0,1246,0,0,,1246,1246
29,07/21/2017,80,19:45,20:00,,,0,27.7,27.7,0,-57896,64805,122701,6909,0,0,176,0,0,,176,176
29,07/21/2017,81,20:00,20:15,31.8,,0,31.8,31.8,1,-77159,85205,162364,8046,0,0,378,0,0,,378,378
29,07/21/2017,82,20:15,20:30,37.91,,0,37.91,37.91,1,-76687,57129,133816,-19558,0,0,8135,0,0,,8135,8135
29,07/21/2017,83,20:30,20:45,37.91,26.07,0,26.07,26.07,-1,-58858,84857,143715,25999,0,-3333,334,0,0,,3667,-2999
29,07/21/2017,84,20:45,21:00,,25.35,0,25.35,25.35,-1,-57807,85586,143393,27779,0,-2930,0,0,0,,2930,-2930
29,07/21/2017,85,21:00,21:15,,28.61,0,28.61,28.61,-1,-96772,99363,196135,2591,0,-2652,0,0,0,,2652,-2652
29,07/21/2017,86,21:15,21:30,,29.61,0,29.61,29.61,-1,-55493,64715,120208,9222,0,-23,0,0,0,,23,-23
29,07/21/2017,87,21:30,21:45,,28.61,0,28.61,28.61,-1,-60863,76209,137072,15346,0,-783,0,0,0,,783,-783
29,07/21/2017,88,21:45,22:00,,25.35,0,25.35,25.35,-1,-60062,97729,157791,37667,0,-9456,0,0,0,,9456,-9456
29,07/21/2017,89,22:00,22:15,,28.61,0,28.61,28.61,-1,-75281,44226,119507,-31055,0,-4238,0,0,0,,4238,-4238
29,07/21/2017,90,22:15,22:30,,,0,27.75,27.75,0,-68793,43836,112629,-24957,0,0,0,0,0,,0,0
29,07/21/2017,91,22:30,22:45,,28.63,0,28.63,28.63,-1,-47895,54649,102544,6754,0,-380,0,0,0,,380,-380
29,07/21/2017,92,22:45,23:00,,10.7,0,10.7,10.7,-1,-51774,71955,123729,20181,0,-17560,0,0,0,,17560,-17560
29,07/21/2017,93,23:00,23:15,,-4.52,0,-4.52,-4.52,-1,-67983,101322,169305,33339,0,-36725,0,0,0,,36725,-36725
29,07/21/2017,94,23:15,23:30,,26.03,0,26.03,26.03,-1,-58423,65827,124250,7404,0,-15262,0,0,0,,15262,-15262
29,07/21/2017,95,23:30,23:45,,,0,27.73,27.73,0,-75836,68264,144100,-7572,0,-784,0,0,0,,784,-784
29,07/21/2017,96,23:45,0:00,,23.09,0,23.09,23.09,-1,-82691,95227,177918,12536,0,-8278,0,0,0,,8278,-8278
30,07/22/2017,1,0:00,0:15,,29.61,0,29.61,29.61,-1,-99817,34006,133823,-65811,0,-1977,0,0,0,,1977,-1977
30,07/22/2017,2,0:15,0:30,,,0,28.58,28.58,0,-66911,37391,104302,-29520,0,0,0,0,0,,0,0
30,07/22/2017,3,0:30,0:45,,,0,28.62,28.62,0,-79349,56523,135872,-22826,0,0,0,0,0,,0,0
30,07/22/2017,4,0:45,1:00,,,0,28.63,28.63,0,-128317,58938,187255,-69379,0,0,0,0,0,,0,0
30,07/22/2017,5,1:00,1:15,36.26,25.05,0,36.26,25.05,2,-40893,42211,83104,1318,0,-1561,800,0,0,,2361,-761
30,07/22/2017,6,1:15,1:30,41.61,,0,41.61,41.61,1,-75410,30838,106248,-44572,0,0,1968,0,0,,1968,1968
30,07/22/2017,7,1:30,1:45,31.95,,0,31.95,31.95,1,-119582,43733,163315,-75849,0,0,1959,0,0,,1959,1959
30,07/22/2017,8,1:45,2:00,31.61,,0,31.61,31.61,1,-159615,61184,220799,-98431,0,0,2605,0,0,,2605,2605
30,07/22/2017,9,2:00,2:15,,,0,28.55,28.55,0,-41126,69644,110770,28518,0,0,82,0,0,,82,82
30,07/22/2017,10,2:15,2:30,,27.06,0,27.06,27.06,-1,-36665,75851,112516,39186,0,-838,0,0,0,,838,-838
30,07/22/2017,11,2:30,2:45,,27.11,0,27.11,27.11,-1,-56460,74208,130668,17748,0,-3085,0,0,0,,3085,-3085
30,07/22/2017,12,2:45,3:00,,29.61,0,29.61,29.61,-1,-125760,73924,199684,-51836,0,-696,0,0,0,,696,-696
30,07/22/2017,13,3:00,3:15,,,0,28.58,28.58,0,-37847,64164,102011,26317,0,0,0,0,0,,0,0
30,07/22/2017,14,3:15,3:30,,,0,28.58,28.58,0,-38858,60563,99421,21705,0,0,0,0,0,,0,0
30,07/22/2017,15,3:30,3:45,,28.61,0,28.61,28.61,-1,-37979,47445,85424,9466,0,-1566,0,0,0,,1566,-1566
30,07/22/2017,16,3:45,4:00,,29.61,0,29.61,29.61,-1,-29920,35824,65744,5904,0,-2987,0,0,0,,2987,-2987
30,07/22/2017,17,4:00,4:15,,28.61,0,28.61,28.61,-1,-34671,40547,75218,5876,0,-1308,0,0,0,,1308,-1308
30,07/22/2017,18,4:15,4:30,,27.29,0,27.29,27.29,-1,-36547,38685,75232,2138,0,-2051,0,0,0,,2051,-2051
30,07/22/2017,19,4:30,4:45,,28.61,0,28.61,28.61,-1,-37565,32388,69953,-5177,0,-1987,0,0,0,,1987,-1987
30,07/22/2017,20,4:45,5:00,,29.61,0,29.61,29.61,-1,-41897,32695,74592,-9202,0,-546,0,0,0,,546,-546
30,07/22/2017,21,5:00,5:15,,,0,27.9,27.9,0,-47281,50179,97460,2898,0,0,0,0,0,,0,0
30,07/22/2017,22,5:15,5:30,,,0,27.88,27.88,0,-53807,56645,110452,2838,0,0,0,0,0,,0,0
30,07/22/2017,23,5:30,5:45,,,0,27.87,27.87,0,-43830,55571,99401,11741,0,0,0,0,0,,0,0
30,07/22/2017,24,5:45,6:00,,,0,27.87,27.87,0,-28998,74641,103639,45643,0,0,0,0,0,,0,0
30,07/22/2017,25,6:00,6:15,,,0,28.56,28.56,0,-38013,50287,88300,12274,0,0,0,0,0,,0,0
30,07/22/2017,26,6:15,6:30,,,0,28.53,28.53,0,-31804,43631,75435,11827,0,0,0,0,0,,0,0
30,07/22/2017,27,6:30,6:45,,,0,28.52,28.52,0,-46670,57011,103681,10341,0,0,0,0,0,,0,0
30,07/22/2017,28,6:45,7:00,31.57,,0,31.57,31.57,1,-56662,60785,117447,4123,0,0,2919,0,0,,2919,2919
30,07/22/2017,29,7:00,7:15,31.57,,0,31.57,31.57,1,-52707,53091,105798,384,0,0,1020,0,0,,1020,1020
30,07/22/2017,30,7:15,7:30,35.57,,0,35.57,35.57,1,-47087,35495,82582,-11592,0,0,9603,0,0,,9603,9603
30,07/22/2017,31,7:30,7:45,,,0,28.51,28.51,0,-49672,48736,98408,-936,0,0,2700,0,0,,2700,2700
30,07/22/2017,32,7:45,8:00,31.83,,0,31.83,31.83,1,-55983,48084,104067,-7899,0,0,3376,0,0,,3376,3376
30,07/22/2017,33,8:00,8:15,31.57,,0,31.57,31.57,1,-39718,39110,78828,-608,0,0,787,0,0,,787,787
30,07/22/2017,34,8:15,8:30,,,0,28.53,28.53,0,-34050,62041,96091,27991,0,0,75,0,0,,75,75
30,07/22/2017,35,8:30,8:45,27.42,,0,27.42,27.42,1,-42501,47589,90090,5088,0,0,13,0,0,,13,13
30,07/22/2017,36,8:45,9:00,47.46,,0,47.46,47.46,1,-68101,23776,91877,-44325,0,0,14191,0,0,,14191,14191
30,07/22/2017,37,9:00,9:15,31.77,,0,31.77,31.77,1,-56677,35365,92042,-21312,0,0,10582,0,0,,10582,10582
30,07/22/2017,38,9:15,9:30,98.12,,0,98.12,98.12,1,-78494,9302,87796,-69192,0,0,21532,0,0,,21532,21532
30,07/22/2017,39,9:30,9:45,42.47,,0,42.47,42.47,1,-88855,15349,104204,-73506,0,0,31621,0,0,,31621,31621
30,07/22/2017,40,9:45,10:00,35.57,,0,35.57,35.57,1,-97731,21343,119074,-76388,0,0,15252,0,0,,15252,15252
30,07/22/2017,41,10:00,10:15,31.57,,0,31.57,31.57,1,-68390,36723,105113,-31667,0,0,6348,0,0,,6348,6348
30,07/22/2017,42,10:15,10:30,,,0,28.53,28.53,0,-75328,42447,117775,-32881,0,0,320,0,0,,320,320
30,07/22/2017,43,10:30,10:45,,,0,28.53,28.53,0,-87670,43296,130966,-44374,0,0,0,0,0,,0,0
30,07/22/2017,44,10:45,11:00,27.48,,0,27.48,27.48,1,-88674,55350,144024,-33324,0,0,59,0,0,,59,59
30,07/22/2017,45,11:00,11:15,,28.57,0,28.57,28.57,-1,-57208,78995,136203,21787,0,-30,0,0,0,,30,-30
30,07/22/2017,46,11:15,11:30,,26.84,0,26.84,26.84,-1,-60628,92789,153417,32161,0,-548,0,0,0,,548,-548
30,07/22/2017,47,11:30,11:45,,24.57,0,24.57,24.57,-1,-62653,123888,186541,61235,0,-2464,0,0,0,,2464,-2464
30,07/22/2017,48,11:45,12:00,,12.94,0,12.94,12.94,-1,-58098,126354,184452,68256,0,-21265,0,0,0,,21265,-21265
30,07/22/2017,49,12:00,12:15,,7.44,0,7.44,7.44,-1,-50565,135288,185853,84723,0,-36567,0,0,0,,36567,-36567
30,07/22/2017,50,12:15,12:30,,8.86,0,8.86,8.86,-1,-58608,135720,194328,77112,0,-54961,0,0,0,,54961,-54961
30,07/22/2017,51,12:30,12:45,,3.11,0,3.11,3.11,-1,-65538,147517,213055,81979,0,-69135,0,0,0,,69135,-69135
30,07/22/2017,52,12:45,13:00,,-1,0,-1,-1,-1,-72616,140870,213486,68254,0,-66169,0,0,0,,66169,-66169
30,07/22/2017,53,13:00,13:15,30.86,24.57,0,30.86,24.57,2,-74305,80903,155208,6598,0,-17296,262,0,0,,17558,-17034
30,07/22/2017,54,13:15,13:30,,26.81,0,26.81,26.81,-1,-63701,77546,141247,13845,0,-468,0,0,0,,468,-468
30,07/22/2017,55,13:30,13:45,,26.78,0,26.78,26.78,-1,-68553,83118,151671,14565,0,-5493,0,0,0,,5493,-5493
30,07/22/2017,56,13:45,14:00,,26.81,0,26.81,26.81,-1,-70829,74553,145382,3724,0,-4824,0,0,0,,4824,-4824
30,07/22/2017,57,14:00,14:15,,26.81,0,26.81,26.81,-1,-46590,66312,112902,19722,0,-4131,0,0,0,,4131,-4131
30,07/22/2017,58,14:15,14:30,,15.42,0,15.42,15.42,-1,-37107,68338,105445,31231,0,-14159,0,0,0,,14159,-14159
30,07/22/2017,59,14:30,14:45,,7.46,0,7.46,7.46,-1,-52003,63171,115174,11168,0,-36266,0,0,0,,36266,-36266
30,07/22/2017,60,14:45,15:00,31.57,29.57,0,31.57,28.56,2,-50985,26013,76998,-24972,0,-3868,369,0,0,,4237,-3499
30,07/22/2017,61,15:00,15:15,,29.57,0,29.57,29.57,-1,-56365,50100,106465,-6265,0,-689,0,0,0,,689,-689
30,07/22/2017,62,15:15,15:30,,29.57,0,29.57,29.57,-1,-68437,52367,120804,-16070,0,-398,0,0,0,,398,-398
30,07/22/2017,63,15:30,15:45,,,0,28.56,28.56,0,-66848,37711,104559,-29137,0,0,0,0,0,,0,0
30,07/22/2017,64,15:45,16:00,,,0,28.55,28.55,0,-80308,27270,107578,-53038,0,0,0,0,0,,0,0
30,07/22/2017,65,16:00,16:15,89.12,,0,89.12,89.12,1,-88475,49048,137523,-39427,0,0,10027,0,0,,10027,10027
30,07/22/2017,66,16:15,16:30,38.06,,0,38.06,38.06,1,-72357,66711,139068,-5646,0,0,16567,0,0,,16567,16567
30,07/22/2017,67,16:30,16:45,38.06,29.57,0,29.57,29.57,-1,-45107,72751,117858,27644,0,-674,652,0,0,,1326,-22
30,07/22/2017,68,16:45,17:00,,29.57,0,29.57,29.57,-1,-49339,80050,129389,30711,0,-65,0,0,0,,65,-65
30,07/22/2017,69,17:00,17:15,,26.81,0,26.81,26.81,-1,-33815,125821,159636,92006,0,-1015,0,0,0,,1015,-1015
30,07/22/2017,70,17:15,17:30,,29.57,0,29.57,29.57,-1,-23929,108511,132440,84582,0,-539,0,0,0,,539,-539
30,07/22/2017,71,17:30,17:45,,28.57,0,28.57,28.57,-1,-19143,86760,105903,67617,0,-1483,0,0,0,,1483,-1483
30,07/22/2017,72,17:45,18:00,,29.57,0,29.57,29.57,-1,-29976,51111,81087,21135,0,-780,0,0,0,,780,-780
30,07/22/2017,73,18:00,18:15,,7.91,0,7.91,7.91,-1,-29159,94454,123613,65295,0,-10592,0,0,0,,10592,-10592
30,07/22/2017,74,18:15,18:30,,7.39,0,7.39,7.39,-1,-26935,84573,111508,57638,0,-24936,0,0,0,,24936,-24936
30,07/22/2017,75,18:30,18:45,,25.34,0,25.34,25.34,-1,-39731,60605,100336,20874,0,-20750,0,0,0,,20750,-20750
30,07/22/2017,76,18:45,19:00,,22.77,0,22.77,22.77,-1,-32286,54662,86948,22376,0,-8749,0,0,0,,8749,-8749
30,07/22/2017,77,19:00,19:15,,22.68,0,22.68,22.68,-1,-45814,57944,103758,12130,0,-12680,0,0,0,,12680,-12680
30,07/22/2017,78,19:15,19:30,,29.57,0,29.57,29.57,-1,-47666,33429,81095,-14237,0,-4022,0,0,0,,4022,-4022
30,07/22/2017,79,19:30,19:45,31.57,,0,31.57,31.57,1,-55571,28359,83930,-27212,0,0,1256,0,0,,1256,1256
30,07/22/2017,80,19:45,20:00,30.89,,0,30.89,30.89,1,-70607,27123,97730,-43484,0,0,1690,0,0,,1690,1690
30,07/22/2017,81,20:00,20:15,36.9,,0,36.9,36.9,1,-57376,35210,92586,-22166,0,0,7661,0,0,,7661,7661
30,07/22/2017,82,20:15,20:30,32.07,,0,32.07,32.07,1,-59733,24097,83830,-35636,0,0,13901,0,0,,13901,13901
30,07/22/2017,83,20:30,20:45,34.55,28.57,0,34.55,28.54,2,-50848,43739,94587,-7109,0,-92,10573,0,0,,10665,10481
30,07/22/2017,84,20:45,21:00,34.55,24.57,0,24.57,24.57,-1,-32107,44628,76735,12521,0,-8125,765,0,0,,8890,-7360
30,07/22/2017,85,21:00,21:15,,,0,28.61,28.61,0,-37373,41977,79350,4604,0,-917,0,0,0,,917,-917
30,07/22/2017,86,21:15,21:30,27.64,,0,27.64,27.64,1,-49420,41743,91163,-7677,0,0,27,0,0,,27,27
30,07/22/2017,87,21:30,21:45,41.61,,0,41.61,41.61,1,-64139,38083,102222,-26056,0,0,5352,0,0,,5352,5352
30,07/22/2017,88,21:45,22:00,39.71,,0,39.71,39.71,1,-76182,37611,113793,-38571,0,0,14378,0,0,,14378,14378
30,07/22/2017,89,22:00,22:15,46,,0,46,46,1,-69182,18655,87837,-50527,0,0,13065,0,0,,13065,13065
30,07/22/2017,90,22:15,22:30,32.08,,0,32.08,32.08,1,-64665,22619,87284,-42046,0,0,9134,0,0,,9134,9134
30,07/22/2017,91,22:30,22:45,29.12,,0,29.12,29.12,1,-42956,29198,72154,-13758,0,0,646,0,0,,646,646
30,07/22/2017,92,22:45,23:00,29.12,29.57,0,29.57,29.57,-1,-38283,45700,83983,7417,0,-14,348,0,0,,362,334
30,07/22/2017,93,23:00,23:15,,28.57,0,28.57,28.57,-1,-46654,30412,77066,-16242,0,-203,0,0,0,,203,-203
30,07/22/2017,94,23:15,23:30,,24.57,0,24.57,24.57,-1,-31553,37522,69075,5969,0,-9709,0,0,0,,9709,-9709
30,07/22/2017,95,23:30,23:45,,26.78,0,26.78,26.78,-1,-29490,35432,64922,5942,0,-11140,0,0,0,,11140,-11140
30,07/22/2017,96,23:45,0:00,,23.51,0,23.51,23.51,-1,-37205,56407,93612,19202,0,-16680,0,0,0,,16680,-16680
30,07/23/2017,1,0:00,0:15,154.42,23.51,0,154.42,154.42,1,-69742,11509,81251,-58233,0,-4566,13403,0,0,,17969,8837
30,07/23/2017,2,0:15,0:30,33.66,28.57,0,28.57,28.57,-1,-39612,22950,62562,-16662,0,-51,11832,0,0,,11883,11781
30,07/23/2017,3,0:30,0:45,33.66,12.06,0,12.06,12.06,-1,-26185,59073,85258,32888,0,-18270,343,0,0,,18613,-17927
30,07/23/2017,4,0:45,1:00,,12.16,0,12.16,12.16,-1,-66177,75139,141316,8962,0,-33641,0,0,0,,33641,-33641
30,07/23/2017,5,1:00,1:15,127.94,12.16,0,127.94,127.94,1,-70643,41541,112184,-29102,0,-5492,13363,0,0,,18855,7871
30,07/23/2017,6,1:15,1:30,33.1,29.57,0,29.57,29.57,-1,-39297,36643,75940,-2654,0,-47,7020,0,0,,7067,6973
30,07/23/2017,7,1:30,1:45,41.57,29.57,0,41.57,41.57,1,-55503,16151,71654,-39352,0,-12,3398,0,0,,3410,3386
30,07/23/2017,8,1:45,2:00,29.01,,0,29.01,29.01,1,-70232,22293,92525,-47939,0,0,2215,0,0,,2215,2215
30,07/23/2017,9,2:00,2:15,41.57,,0,41.57,41.57,1,-66340,28958,95298,-37382,0,0,5701,0,0,,5701,5701
30,07/23/2017,10,2:15,2:30,56.55,,0,56.55,56.55,1,-57288,29367,86655,-27921,0,0,27296,0,0,,27296,27296
30,07/23/2017,11,2:30,2:45,,,0,26.52,26.52,0,-52717,30122,82839,-22595,0,0,2816,0,0,,2816,2816
30,07/23/2017,12,2:45,3:00,,,0,26.54,26.54,0,-49309,32762,82071,-16547,0,0,0,0,0,,0,0
30,07/23/2017,13,3:00,3:15,,27.21,0,27.21,27.21,-1,-55533,55669,111202,136,0,-521,0,0,0,,521,-521
30,07/23/2017,14,3:15,3:30,,24.57,0,24.57,24.57,-1,-47111,45713,92824,-1398,0,-2310,0,0,0,,2310,-2310
30,07/23/2017,15,3:30,3:45,,22.9,0,22.9,22.9,-1,-45071,54208,99279,9137,0,-15596,0,0,0,,15596,-15596
30,07/23/2017,16,3:45,4:00,,24.71,0,24.71,24.71,-1,-37415,34678,72093,-2737,0,-13127,0,0,0,,13127,-13127
30,07/23/2017,17,4:00,4:15,66.87,26.83,0,66.87,66.87,1,-82765,26663,109428,-56102,0,-2084,7369,0,0,,9453,5285
30,07/23/2017,18,4:15,4:30,35.57,,0,35.57,35.57,1,-62871,33403,96274,-29468,0,0,17733,0,0,,17733,17733
30,07/23/2017,19,4:30,4:45,31.57,,0,31.57,31.57,1,-53606,34832,88438,-18774,0,0,5131,0,0,,5131,5131
30,07/23/2017,20,4:45,5:00,,,0,26.59,26.59,0,-34097,36333,70430,2236,0,0,526,0,0,,526,526
30,07/23/2017,21,5:00,5:15,28.69,,0,28.69,28.69,1,-68944,40679,109623,-28265,0,0,424,0,0,,424,424
30,07/23/2017,22,5:15,5:30,31.57,,0,31.57,31.57,1,-57153,34119,91272,-23034,0,0,2148,0,0,,2148,2148
30,07/23/2017,23,5:30,5:45,,,0,26.65,26.65,0,-36512,36212,72724,-300,0,0,19,0,0,,19,19
30,07/23/2017,24,5:45,6:00,,,0,26.65,26.65,0,-36710,56102,92812,19392,0,0,0,0,0,,0,0
30,07/23/2017,25,6:00,6:15,,,0,26.63,26.63,0,-41190,37315,78505,-3875,0,0,0,0,0,,0,0
30,07/23/2017,26,6:15,6:30,,,0,26.61,26.61,0,-20390,50469,70859,30079,0,0,0,0,0,,0,0
30,07/23/2017,27,6:30,6:45,,,0,26.61,26.61,0,-11711,54772,66483,43061,0,0,0,0,0,,0,0
30,07/23/2017,28,6:45,7:00,,,0,26.6,26.6,0,-11949,74986,86935,63037,0,0,0,0,0,,0,0
30,07/23/2017,29,7:00,7:15,30.44,,0,30.44,30.44,1,-52175,40669,92844,-11506,0,0,223,0,0,,223,223
30,07/23/2017,30,7:15,7:30,,,0,27.29,27.29,0,-22780,63080,85860,40300,0,0,0,0,0,,0,0
30,07/23/2017,31,7:30,7:45,,26.78,0,26.78,26.78,-1,-31373,77904,109277,46531,0,-7,0,0,0,,7,-7
30,07/23/2017,32,7:45,8:00,,-54.78,0,-54.78,-54.78,-1,-25003,112113,137116,87110,0,-30393,0,0,0,,30393,-30393
30,07/23/2017,33,8:00,8:15,,15.83,0,15.83,15.83,-1,-38259,71206,109465,32947,0,-42181,0,0,0,,42181,-42181
30,07/23/2017,34,8:15,8:30,,23.37,0,23.37,23.37,-1,-38468,73181,111649,34713,0,-21331,0,0,0,,21331,-21331
30,07/23/2017,35,8:30,8:45,,19.37,0,19.37,19.37,-1,-37262,92314,129576,55052,0,-27987,0,0,0,,27987,-27987
30,07/23/2017,36,8:45,9:00,,19.32,0,19.32,19.32,-1,-38851,101060,139911,62209,0,-31284,0,0,0,,31284,-31284
30,07/23/2017,37,9:00,9:15,,24.99,0,24.99,24.99,-1,-38592,105429,144021,66837,0,-14212,0,0,0,,14212,-14212
30,07/23/2017,38,9:15,9:30,,19.37,0,19.37,19.37,-1,-28877,109188,138065,80311,0,-2338,0,0,0,,2338,-2338
30,07/23/2017,39,9:30,9:45,,4.03,0,4.03,4.03,-1,-37185,108919,146104,71734,0,-34756,0,0,0,,34756,-34756
30,07/23/2017,40,9:45,10:00,,19.37,0,19.37,19.37,-1,-46387,115324,161711,68937,0,-33279,0,0,0,,33279,-33279
30,07/23/2017,41,10:00,10:15,,-22.44,0,-22.44,-22.44,-1,-42046,113931,155977,71885,0,-53342,0,0,0,,53342,-53342
30,07/23/2017,42,10:15,10:30,,19.37,0,19.37,19.37,-1,-49451,94857,144308,45406,0,-24617,0,0,0,,24617,-24617
30,07/23/2017,43,10:30,10:45,,21.46,0,21.46,21.46,-1,-35249,92908,128157,57659,0,-18633,0,0,0,,18633,-18633
30,07/23/2017,44,10:45,11:00,,19.37,0,19.37,19.37,-1,-55475,83479,138954,28004,0,-20197,0,0,0,,20197,-20197
30,07/23/2017,45,11:00,11:15,,19.37,0,19.37,19.37,-1,-27622,120092,147714,92470,0,-13476,0,0,0,,13476,-13476
30,07/23/2017,46,11:15,11:30,,25.18,0,25.18,25.18,-1,-24935,105235,130170,80300,0,-575,0,0,0,,575,-575
30,07/23/2017,47,11:30,11:45,,-25.53,0,-25.53,-25.53,-1,-24695,109138,133833,84443,0,-9409,0,0,0,,9409,-9409
30,07/23/2017,48,11:45,12:00,,-25.53,0,-25.53,-25.53,-1,-43052,91422,134474,48370,0,-39249,0,0,0,,39249,-39249
30,07/23/2017,49,12:00,12:15,,-29.42,0,-29.42,-29.42,-1,-16782,137754,154536,120972,0,-55959,0,0,0,,55959,-55959
30,07/23/2017,50,12:15,12:30,,0.01,0,0.01,0.01,-1,-52702,118802,171504,66100,0,-52947,0,0,0,,52947,-52947
30,07/23/2017,51,12:30,12:45,,12.1,0,12.1,12.1,-1,-65091,117639,182730,52548,0,-57640,0,0,0,,57640,-57640
30,07/23/2017,52,12:45,13:00,,19.88,0,19.88,19.88,-1,-92134,107794,199928,15660,0,-34715,0,0,0,,34715,-34715
30,07/23/2017,53,13:00,13:15,28.48,19.88,0,28.48,28.48,1,-58299,62200,120499,3901,0,-4644,410,0,0,,5054,-4234
30,07/23/2017,54,13:15,13:30,28.48,21.45,0,21.45,21.45,-1,-41536,57011,98547,15475,0,-5187,3,0,0,,5190,-5184
30,07/23/2017,55,13:30,13:45,,24.37,0,24.37,24.37,-1,-52004,53717,105721,1713,0,-4982,0,0,0,,4982,-4982
30,07/23/2017,56,13:45,14:00,,15.07,0,15.07,15.07,-1,-42927,64381,107308,21454,0,-13722,0,0,0,,13722,-13722
30,07/23/2017,57,14:00,14:15,41.37,23.37,0,41.37,23.37,2,-56034,43360,99394,-12674,0,-10694,3698,0,0,,14392,-6996
30,07/23/2017,58,14:15,14:30,29.02,19.37,0,19.37,19.37,-1,-33934,63413,97347,29479,0,-7143,1707,0,0,,8850,-5436
30,07/23/2017,59,14:30,14:45,,17.03,0,17.03,17.03,-1,-35790,88262,124052,52472,0,-41331,0,0,0,,41331,-41331
30,07/23/2017,60,14:45,15:00,,12.72,0,12.72,12.72,-1,-41983,105259,147242,63276,0,-52859,0,0,0,,52859,-52859
30,07/23/2017,61,15:00,15:15,,-29.14,0,-29.14,-29.14,-1,-33212,112897,146109,79685,0,-61751,0,0,0,,61751,-61751
30,07/23/2017,62,15:15,15:30,,-37.88,0,-37.88,-37.88,-1,-45683,88152,133835,42469,0,-62439,0,0,0,,62439,-62439
30,07/23/2017,63,15:30,15:45,32.22,24.91,0,32.22,24.91,2,-52877,53000,105877,123,0,-14685,557,0,0,,15242,-14128
30,07/23/2017,64,15:45,16:00,41.37,,0,41.37,41.37,1,-61864,43672,105536,-18192,0,0,5919,0,0,,5919,5919
30,07/23/2017,65,16:00,16:15,127.67,,0,127.67,127.67,1,-112696,32341,145037,-80355,0,0,50485,0,0,,50485,50485
30,07/23/2017,66,16:15,16:30,54.66,10.79,0,10.79,10.79,-1,-49732,77154,126886,27422,0,-1904,29760,0,0,,31664,27856
30,07/23/2017,67,16:30,16:45,,1.87,0,1.87,1.87,-1,-44338,71543,115881,27205,0,-13508,0,0,0,,13508,-13508
30,07/23/2017,68,16:45,17:00,28.02,1.87,0,28.02,28.02,1,-48314,49350,97664,1036,0,-454,86,0,0,,540,-368
30,07/23/2017,69,17:00,17:15,,-37.88,0,-37.88,-37.88,-1,-32543,113018,145561,80475,0,-23818,0,0,0,,23818,-23818
30,07/23/2017,70,17:15,17:30,,19.37,0,19.37,19.37,-1,-36757,96796,133553,60039,0,-41191,0,0,0,,41191,-41191
30,07/23/2017,71,17:30,17:45,,23.37,0,23.37,23.37,-1,-36683,101544,138227,64861,0,-22542,0,0,0,,22542,-22542
30,07/23/2017,72,17:45,18:00,,17.99,0,17.99,17.99,-1,-42896,126125,169021,83229,0,-21031,0,0,0,,21031,-21031
30,07/23/2017,73,18:00,18:15,,17.06,0,17.06,17.06,-1,-33592,134927,168519,101335,0,-32824,0,0,0,,32824,-32824
30,07/23/2017,74,18:15,18:30,,25.72,0,25.72,25.72,-1,-36431,148595,185026,112164,0,-14011,0,0,0,,14011,-14011
30,07/23/2017,75,18:30,18:45,,,0,26.35,26.35,0,-25889,140808,166697,114919,0,-262,0,0,0,,262,-262
30,07/23/2017,76,18:45,19:00,,26.68,0,26.68,26.68,-1,-29247,159749,188996,130502,0,-364,0,0,0,,364,-364
30,07/23/2017,77,19:00,19:15,,26.68,0,26.68,26.68,-1,-34509,77808,112317,43299,0,-1243,0,0,0,,1243,-1243
30,07/23/2017,78,19:15,19:30,,24.28,0,24.28,24.28,-1,-23497,71752,95249,48255,0,-2741,0,0,0,,2741,-2741
30,07/23/2017,79,19:30,19:45,,,0,27.29,27.29,0,-30231,59004,89235,28773,0,-18,0,0,0,,18,-18
30,07/23/2017,80,19:45,20:00,,,0,27.29,27.29,0,-25677,57539,83216,31862,0,0,0,0,0,,0,0
30,07/23/2017,81,20:00,20:15,29.02,,0,29.02,29.02,1,-38154,32141,70295,-6013,0,0,252,0,0,,252,252
30,07/23/2017,82,20:15,20:30,29.02,,0,29.02,29.02,1,-45351,26559,71910,-18792,0,0,1469,0,0,,1469,1469
30,07/23/2017,83,20:30,20:45,28.02,,0,28.02,28.02,1,-47111,43761,90872,-3350,0,0,202,0,0,,202,202
30,07/23/2017,84,20:45,21:00,31.87,,0,31.87,31.87,1,-54284,45648,99932,-8636,0,0,1255,0,0,,1255,1255
30,07/23/2017,85,21:00,21:15,,26.26,0,26.26,26.26,-1,-39758,62086,101844,22328,0,-196,0,0,0,,196,-196
30,07/23/2017,86,21:15,21:30,,26.03,0,26.03,26.03,-1,-35498,44708,80206,9210,0,-927,0,0,0,,927,-927
30,07/23/2017,87,21:30,21:45,,26.98,0,26.98,26.98,-1,-39640,58580,98220,18940,0,-1309,0,0,0,,1309,-1309
30,07/23/2017,88,21:45,22:00,,27.16,0,27.16,27.16,-1,-49501,94819,144320,45318,0,-59,0,0,0,,59,-59
30,07/23/2017,89,22:00,22:15,,23.37,0,23.37,23.37,-1,-44807,74382,119189,29575,0,-5350,0,0,0,,5350,-5350
30,07/23/2017,90,22:15,22:30,,,0,27.29,27.29,0,-47065,30527,77592,-16538,0,-601,0,0,0,,601,-601
30,07/23/2017,91,22:30,22:45,,26.05,0,26.05,26.05,-1,-33937,32106,66043,-1831,0,-332,0,0,0,,332,-332
30,07/23/2017,92,22:45,23:00,,25.06,0,25.06,25.06,-1,-37773,57726,95499,19953,0,-493,0,0,0,,493,-493
30,07/23/2017,93,23:00,23:15,74.02,,0,74.02,74.02,1,-65305,29189,94494,-36116,0,0,9587,0,0,,9587,9587
30,07/23/2017,94,23:15,23:30,31.37,23.37,0,23.37,23.37,-1,-32072,51473,83545,19401,0,-1491,4493,0,0,,5984,3002
30,07/23/2017,95,23:30,23:45,,22.36,0,22.36,22.36,-1,-25540,73861,99401,48321,0,-2955,0,0,0,,2955,-2955
30,07/23/2017,96,23:45,0:00,,19.37,0,19.37,19.37,-1,-33201,87276,120477,54075,0,-5127,0,0,0,,5127,-5127
30,07/24/2017,1,0:00,0:15,,17.78,0,17.78,17.78,-1,-37091,93305,130396,56214,0,-5596,0,0,0,,5596,-5596
30,07/24/2017,2,0:15,0:30,,7.51,0,7.51,7.51,-1,-34367,83230,117597,48863,0,-3674,0,0,0,,3674,-3674
30,07/24/2017,3,0:30,0:45,,8.63,0,8.63,8.63,-1,-31561,63600,95161,32039,0,-22922,0,0,0,,22922,-22922
30,07/24/2017,4,0:45,1:00,,25.34,0,25.34,25.34,-1,-37158,46121,83279,8963,0,-19432,0,0,0,,19432,-19432
30,07/24/2017,5,1:00,1:15,27.6,25.34,0,27.6,27.6,1,-51777,50305,102082,-1472,0,-4821,224,0,0,,5045,-4597
30,07/24/2017,6,1:15,1:30,,25.91,0,25.91,25.91,-1,-42320,52689,95009,10369,0,-132,0,0,0,,132,-132
30,07/24/2017,7,1:30,1:45,,24.91,0,24.91,24.91,-1,-33000,60675,93675,27675,0,-1288,0,0,0,,1288,-1288
30,07/24/2017,8,1:45,2:00,,23.63,0,23.63,23.63,-1,-36925,79162,116087,42237,0,-9899,0,0,0,,9899,-9899
30,07/24/2017,9,2:00,2:15,31.91,25.91,0,31.91,31.91,1,-37922,27439,65361,-10483,0,-6790,1236,0,0,,8026,-5554
30,07/24/2017,10,2:15,2:30,,,0,26.85,26.85,0,-47144,37080,84224,-10064,0,-101,572,0,0,,673,471
30,07/24/2017,11,2:30,2:45,,,0,26.85,26.85,0,-52963,44580,97543,-8383,0,0,0,0,0,,0,0
30,07/24/2017,12,2:45,3:00,,24.91,0,24.91,24.91,-1,-50916,54015,104931,3099,0,-635,0,0,0,,635,-635
30,07/24/2017,13,3:00,3:15,37.11,24.91,0,37.11,24.91,2,-60004,46065,106069,-13939,0,-1087,3429,0,0,,4516,2342
30,07/24/2017,14,3:15,3:30,31.19,,0,31.19,31.19,1,-61855,43043,104898,-18812,0,0,6364,0,0,,6364,6364
30,07/24/2017,15,3:30,3:45,31.91,,0,31.91,31.91,1,-55924,42316,98240,-13608,0,0,2549,0,0,,2549,2549
30,07/24/2017,16,3:45,4:00,27.91,25.88,0,27.91,25.88,2,-40483,49609,90092,9126,0,-322,2261,0,0,,2583,1939
30,07/24/2017,17,4:00,4:15,31.91,25.88,0,31.91,31.91,1,-80174,35860,116034,-44314,0,-5,1052,0,0,,1057,1047
30,07/24/2017,18,4:15,4:30,27.91,,0,27.91,27.91,1,-71008,33195,104203,-37813,0,0,73,0,0,,73,73
30,07/24/2017,19,4:30,4:45,,,0,26.85,26.85,0,-47976,32827,80803,-15149,0,0,0,0,0,,0,0
30,07/24/2017,20,4:45,5:00,,,0,26.85,26.85,0,-54892,58374,113266,3482,0,0,0,0,0,,0,0
30,07/24/2017,21,5:00,5:15,,,0,26.85,26.85,0,-113807,46696,160503,-67111,0,0,0,0,0,,0,0
30,07/24/2017,22,5:15,5:30,,,0,26.85,26.85,0,-83755,45455,129210,-38300,0,0,0,0,0,,0,0
30,07/24/2017,23,5:30,5:45,,,0,26.85,26.85,0,-45870,41023,86893,-4847,0,0,0,0,0,,0,0
30,07/24/2017,24,5:45,6:00,,5.38,0,5.38,5.38,-1,-75257,99984,175241,24727,0,-5454,0,0,0,,5454,-5454
30,07/24/2017,25,6:00,6:15,,1.73,0,1.73,1.73,-1,-106621,56437,163058,-50184,0,-17010,0,0,0,,17010,-17010
30,07/24/2017,26,6:15,6:30,,26,0,26,26,-1,-49629,49467,99096,-162,0,-585,0,0,0,,585,-585
30,07/24/2017,27,6:30,6:45,,25.86,0,25.86,25.86,-1,-53592,48179,101771,-5413,0,-1400,0,0,0,,1400,-1400
30,07/24/2017,28,6:45,7:00,,15.23,0,15.23,15.23,-1,-54670,63752,118422,9082,0,-1771,0,0,0,,1771,-1771
30,07/24/2017,29,7:00,7:15,,0.73,0,0.73,0.73,-1,-40303,80479,120782,40176,0,-26660,0,0,0,,26660,-26660
30,07/24/2017,30,7:15,7:30,,25,0,25,25,-1,-40273,63781,104054,23508,0,-23219,0,0,0,,23219,-23219
30,07/24/2017,31,7:30,7:45,,26.05,0,26.05,26.05,-1,-44340,56955,101295,12615,0,-8719,0,0,0,,8719,-8719
30,07/24/2017,32,7:45,8:00,,20.92,0,20.92,20.92,-1,-73930,76257,150187,2327,0,-4276,0,0,0,,4276,-4276
30,07/24/2017,33,8:00,8:15,,-1.58,0,-1.58,-1.58,-1,-58687,58506,117193,-181,0,-21554,0,0,0,,21554,-21554
30,07/24/2017,34,8:15,8:30,,,0,35.37,35.37,0,-53059,42504,95563,-10555,0,-1156,0,0,0,,1156,-1156
30,07/24/2017,35,8:30,8:45,,,0,35.35,35.35,0,-55945,32678,88623,-23267,0,0,0,0,0,,0,0
30,07/24/2017,36,8:45,9:00,,43.07,0,43.07,43.07,-1,-64934,49068,114002,-15866,0,-32,0,0,0,,32,-32
30,07/24/2017,37,9:00,9:15,,23.99,0,23.99,23.99,-1,-43211,66347,109558,23136,0,-6993,0,0,0,,6993,-6993
30,07/24/2017,38,9:15,9:30,,24.96,0,24.96,24.96,-1,-48581,70845,119426,22264,0,-21498,0,0,0,,21498,-21498
30,07/24/2017,39,9:30,9:45,,23.99,0,23.99,23.99,-1,-51130,79132,130262,28002,0,-20180,0,0,0,,20180,-20180
30,07/24/2017,40,9:45,10:00,,24.08,0,24.08,24.08,-1,-49750,69874,119624,20124,0,-26321,0,0,0,,26321,-26321
30,07/24/2017,41,10:00,10:15,,24.96,0,24.96,24.96,-1,-57850,76105,133955,18255,0,-19144,0,0,0,,19144,-19144
30,07/24/2017,42,10:15,10:30,,25,0,25,25,-1,-60383,82189,142572,21806,0,-18611,0,0,0,,18611,-18611
30,07/24/2017,43,10:30,10:45,,26,0,26,26,-1,-66509,73913,140422,7404,0,-12462,0,0,0,,12462,-12462
30,07/24/2017,44,10:45,11:00,,,0,35.36,35.36,0,-60830,64387,125217,3557,0,-741,0,0,0,,741,-741
30,07/24/2017,45,11:00,11:15,,,0,35.92,35.92,0,-100838,80618,181456,-20220,0,0,0,0,0,,0,0
30,07/24/2017,46,11:15,11:30,,,0,35.91,35.91,0,-105846,64061,169907,-41785,0,0,0,0,0,,0,0
30,07/24/2017,47,11:30,11:45,,,0,35.91,35.91,0,-90136,49095,139231,-41041,0,0,0,0,0,,0,0
30,07/24/2017,48,11:45,12:00,,,0,35.91,35.91,0,-89743,45628,135371,-44115,0,0,0,0,0,,0,0
30,07/24/2017,49,12:00,12:15,,,0,35.92,35.92,0,-87103,27850,114953,-59253,0,0,0,0,0,,0,0
30,07/24/2017,50,12:15,12:30,,,0,35.92,35.92,0,-70601,26987,97588,-43614,0,0,0,0,0,,0,0
30,07/24/2017,51,12:30,12:45,,,0,35.93,35.93,0,-61888,33576,95464,-28312,0,0,0,0,0,,0,0
30,07/24/2017,52,12:45,13:00,,44.41,0,44.41,44.41,-1,-54633,30774,85407,-23859,0,-33,0,0,0,,33,-33
30,07/24/2017,53,13:00,13:15,27.7,44.54,0,27.7,27.7,1,-70152,46033,116185,-24119,0,-115,172,0,0,,287,57
30,07/24/2017,54,13:15,13:30,27.68,,0,27.68,27.68,1,-57218,44360,101578,-12858,0,0,439,0,0,,439,439
30,07/24/2017,55,13:30,13:45,,25.86,0,25.86,25.86,-1,-56382,54457,110839,-1925,0,-2118,0,0,0,,2118,-2118
30,07/24/2017,56,13:45,14:00,,25.94,0,25.94,25.94,-1,-55020,51624,106644,-3396,0,-6696,0,0,0,,6696,-6696
30,07/24/2017,57,14:00,14:15,31.17,25.94,0,31.17,31.17,1,-66916,61025,127941,-5891,0,-404,944,0,0,,1348,540
30,07/24/2017,58,14:15,14:30,,25,0,25,25,-1,-49708,65766,115474,16058,0,-2252,0,0,0,,2252,-2252
30,07/24/2017,59,14:30,14:45,,23.37,0,23.37,23.37,-1,-50942,69227,120169,18285,0,-7305,0,0,0,,7305,-7305
30,07/24/2017,60,14:45,15:00,,21,0,21,21,-1,-40304,76314,116618,36010,0,-21850,0,0,0,,21850,-21850
30,07/24/2017,61,15:00,15:15,39.16,26.67,0,39.16,26.67,2,-109207,58353,167560,-50854,0,-7019,1914,0,0,,8933,-5105
30,07/24/2017,62,15:15,15:30,,23.55,0,23.55,23.55,-1,-44146,68334,112480,24188,0,-3639,0,0,0,,3639,-3639
30,07/24/2017,63,15:30,15:45,,21,0,21,21,-1,-39510,76166,115676,36656,0,-20490,0,0,0,,20490,-20490
30,07/24/2017,64,15:45,16:00,,21,0,21,21,-1,-39747,73031,112778,33284,0,-28147,0,0,0,,28147,-28147
30,07/24/2017,65,16:00,16:15,,17.05,0,17.05,17.05,-1,-45732,64845,110577,19113,0,-27384,0,0,0,,27384,-27384
30,07/24/2017,66,16:15,16:30,,9.85,0,9.85,9.85,-1,-38770,81364,120134,42594,0,-21376,0,0,0,,21376,-21376
30,07/24/2017,67,16:30,16:45,,9.85,0,9.85,9.85,-1,-39972,75061,115033,35089,0,-41148,0,0,0,,41148,-41148
30,07/24/2017,68,16:45,17:00,,25.87,0,25.87,25.87,-1,-45513,75255,120768,29742,0,-10642,0,0,0,,10642,-10642
30,07/24/2017,69,17:00,17:15,,21,0,21,21,-1,-18622,64606,83228,45984,0,-12974,0,0,0,,12974,-12974
30,07/24/2017,70,17:15,17:30,,26.02,0,26.02,26.02,-1,-18947,52007,70954,33060,0,-5950,0,0,0,,5950,-5950
30,07/24/2017,71,17:30,17:45,,,0,34.88,34.88,0,-23171,67643,90814,44472,0,0,0,0,0,,0,0
30,07/24/2017,72,17:45,18:00,,,0,35.35,35.35,0,-24403,72706,97109,48303,0,0,0,0,0,,0,0
30,07/24/2017,73,18:00,18:15,,26.83,0,26.83,26.83,-1,-39635,36089,75724,-3546,0,-173,0,0,0,,173,-173
30,07/24/2017,74,18:15,18:30,,22.35,0,22.35,22.35,-1,-19685,56675,76360,36990,0,-8280,0,0,0,,8280,-8280
30,07/24/2017,75,18:30,18:45,,21,0,21,21,-1,-20129,84416,104545,64287,0,-16612,0,0,0,,16612,-16612
30,07/24/2017,76,18:45,19:00,,,0,34.96,34.96,0,-15464,80935,96399,65471,0,-2719,0,0,0,,2719,-2719
30,07/24/2017,77,19:00,19:15,28,,0,28,28,1,-44620,48573,93193,3953,0,0,5,0,0,,5,5
30,07/24/2017,78,19:15,19:30,33.66,,0,33.66,33.66,1,-47322,41396,88718,-5926,0,0,1760,0,0,,1760,1760
30,07/24/2017,79,19:30,19:45,30.03,,0,30.03,30.03,1,-44983,53386,98369,8403,0,0,2463,0,0,,2463,2463
30,07/24/2017,80,19:45,20:00,,26.06,0,26.06,26.06,-1,-44491,44548,89039,57,0,-1015,0,0,0,,1015,-1015
30,07/24/2017,81,20:00,20:15,29.55,26.86,0,29.55,26.86,2,-58892,36223,95115,-22669,0,-104,184,0,0,,288,80
30,07/24/2017,82,20:15,20:30,,,0,27.52,27.52,0,-55680,30363,86043,-25317,0,0,0,0,0,,0,0
30,07/24/2017,83,20:30,20:45,,,0,27.52,27.52,0,-73753,26406,100159,-47347,0,0,0,0,0,,0,0
30,07/24/2017,84,20:45,21:00,27.45,,0,27.45,27.45,1,-106846,39586,146432,-67260,0,0,164,0,0,,164,164
30,07/24/2017,85,21:00,21:15,27.68,,0,27.68,27.68,1,-77806,28318,106124,-49488,0,0,629,0,0,,629,629
30,07/24/2017,86,21:15,21:30,26,,0,26,26,1,-70727,24899,95626,-45828,0,0,762,0,0,,762,762
30,07/24/2017,87,21:30,21:45,27.71,,0,27.71,27.71,1,-72496,18082,90578,-54414,0,0,428,0,0,,428,428
30,07/24/2017,88,21:45,22:00,27.59,,0,27.59,27.59,1,-86312,16973,103285,-69339,0,0,1149,0,0,,1149,1149
30,07/24/2017,89,22:00,22:15,,,0,27.87,27.87,0,-74527,22213,96740,-52314,0,0,115,0,0,,115,115
30,07/24/2017,90,22:15,22:30,,,0,27.87,27.87,0,-63872,24142,88014,-39730,0,0,0,0,0,,0,0
30,07/24/2017,91,22:30,22:45,,,0,27.87,27.87,0,-32752,26914,59666,-5838,0,0,0,0,0,,0,0
30,07/24/2017,92,22:45,23:00,,,0,27.87,27.87,0,-29661,33876,63537,4215,0,0,0,0,0,,0,0
30,07/24/2017,93,23:00,23:15,,26.99,0,26.99,26.99,-1,-78907,38311,117218,-40596,0,-71,0,0,0,,71,-71
30,07/24/2017,94,23:15,23:30,,,0,27.87,27.87,0,-75565,24013,99578,-51552,0,0,0,0,0,,0,0
30,07/24/2017,95,23:30,23:45,,,0,27.87,27.87,0,-70646,34109,104755,-36537,0,0,0,0,0,,0,0
30,07/24/2017,96,23:45,0:00,,,0,27.87,27.87,0,-79158,36557,115715,-42601,0,0,0,0,0,,0,0
30,07/25/2017,1,0:00,0:15,,,0,27.62,27.62,0,-89250,83589,172839,-5661,0,0,0,0,0,,0,0
30,07/25/2017,2,0:15,0:30,,27.06,0,27.06,27.06,-1,-52923,28475,81398,-24448,0,-122,0,0,0,,122,-122
30,07/25/2017,3,0:30,0:45,,25,0,25,25,-1,-44591,34612,79203,-9979,0,-588,0,0,0,,588,-588
30,07/25/2017,4,0:45,1:00,,17.26,0,17.26,17.26,-1,-35043,68774,103817,33731,0,-25065,0,0,0,,25065,-25065
30,07/25/2017,5,1:00,1:15,44.74,21,0,44.74,44.74,1,-64099,22197,86296,-41902,0,-18042,1687,0,0,,19729,-16355
30,07/25/2017,6,1:15,1:30,47.02,21,0,47.02,47.02,1,-44586,27565,72151,-17021,0,-32,4182,0,0,,4214,4150
30,07/25/2017,7,1:30,1:45,32,,0,32,32,1,-74169,28459,102628,-45710,0,0,1408,0,0,,1408,1408
30,07/25/2017,8,1:45,2:00,,,0,27.62,27.62,0,-78694,58731,137425,-19963,0,0,57,0,0,,57,57
30,07/25/2017,9,2:00,2:15,32,,0,32,32,1,-32647,33297,65944,650,0,0,2314,0,0,,2314,2314
30,07/25/2017,10,2:15,2:30,28.98,,0,28.98,28.98,1,-34656,29372,64028,-5284,0,0,6924,0,0,,6924,6924
30,07/25/2017,11,2:30,2:45,28.98,25,0,25,25,-1,-29038,35564,64602,6526,0,-530,313,0,0,,843,-217
30,07/25/2017,12,2:45,3:00,,21.01,0,21.01,21.01,-1,-29299,54235,83534,24936,0,-16596,0,0,0,,16596,-16596
30,07/25/2017,13,3:00,3:15,32,25,0,32,25,2,-52085,33982,86067,-18103,0,-10566,890,0,0,,11456,-9676
30,07/25/2017,14,3:15,3:30,,,0,27.87,27.87,0,-55217,39142,94359,-16075,0,-24,80,0,0,,104,56
30,07/25/2017,15,3:30,3:45,,,0,27.87,27.87,0,-24472,35572,60044,11100,0,0,0,0,0,,0,0
30,07/25/2017,16,3:45,4:00,,26,0,26,26,-1,-21250,56785,78035,35535,0,-759,0,0,0,,759,-759
30,07/25/2017,17,4:00,4:15,,26.66,0,26.66,26.66,-1,-19773,49356,69129,29583,0,-1319,0,0,0,,1319,-1319
30,07/25/2017,18,4:15,4:30,,,0,27.74,27.74,0,-25903,39630,65533,13727,0,0,0,0,0,,0,0
30,07/25/2017,19,4:30,4:45,,,0,27.74,27.74,0,-26365,49082,75447,22717,0,0,0,0,0,,0,0
30,07/25/2017,20,4:45,5:00,,,0,27.74,27.74,0,-37374,50283,87657,12909,0,0,0,0,0,,0,0
30,07/25/2017,21,5:00,5:15,,27.11,0,27.11,27.11,-1,-35904,53402,89306,17498,0,-26,0,0,0,,26,-26
30,07/25/2017,22,5:15,5:30,,25,0,25,25,-1,-32400,45815,78215,13415,0,-5496,0,0,0,,5496,-5496
30,07/25/2017,23,5:30,5:45,,24.03,0,24.03,24.03,-1,-25466,51107,76573,25641,0,-7193,0,0,0,,7193,-7193
30,07/25/2017,24,5:45,6:00,,29.74,0,29.74,29.74,-1,-27343,70445,97788,43102,0,-1301,0,0,0,,1301,-1301
30,07/25/2017,25,6:00,6:15,,11.49,0,11.49,11.49,-1,-46429,88755,135184,42326,0,-19700,0,0,0,,19700,-19700
30,07/25/2017,26,6:15,6:30,,5.61,0,5.61,5.61,-1,-29501,63700,93201,34199,0,-43378,0,0,0,,43378,-43378
30,07/25/2017,27,6:30,6:45,,-58.46,0,-58.46,-58.46,-1,-25662,81180,106842,55518,0,-47601,0,0,0,,47601,-47601
30,07/25/2017,28,6:45,7:00,,20.74,0,20.74,20.74,-1,-35312,130860,166172,95548,0,-12744,0,0,0,,12744,-12744
30,07/25/2017,29,7:00,7:15,,17.1,0,17.1,17.1,-1,-78949,97026,175975,18077,0,-18043,0,0,0,,18043,-18043
30,07/25/2017,30,7:15,7:30,,-26.81,0,-26.81,-26.81,-1,-48860,118536,167396,69676,0,-55588,0,0,0,,55588,-55588
30,07/25/2017,31,7:30,7:45,,20.74,0,20.74,20.74,-1,-32711,79227,111938,46516,0,-32830,0,0,0,,32830,-32830
30,07/25/2017,32,7:45,8:00,,20.74,0,20.74,20.74,-1,-39855,85970,125825,46115,0,-34639,0,0,0,,34639,-34639
30,07/25/2017,33,8:00,8:15,,19.74,0,19.74,19.74,-1,-73031,102320,175351,29289,0,-37447,0,0,0,,37447,-37447
30,07/25/2017,34,8:15,8:30,27.77,24.74,0,27.77,27.77,1,-70973,66960,137933,-4013,0,-18789,118,0,0,,18907,-18671
30,07/25/2017,35,8:30,8:45,28.02,24.74,0,36.46,24.74,2,-47294,56031,103325,8737,0,-3297,288,0,0,,3585,-3009
30,07/25/2017,36,8:45,9:00,30.19,24.74,0,36.43,24.74,2,-42996,39354,82350,-3642,0,-4752,129,0,0,,4881,-4623
30,07/25/2017,37,9:00,9:15,39.48,18.34,0,39.48,18.34,2,-44999,57279,102278,12280,0,-3433,1631,0,0,,5064,-1802
30,07/25/2017,38,9:15,9:30,,5.26,0,5.26,5.26,-1,-48300,71384,119684,23084,0,-20868,0,0,0,,20868,-20868
30,07/25/2017,39,9:30,9:45,,18.32,0,18.32,18.32,-1,-41575,90474,132049,48899,0,-10156,0,0,0,,10156,-10156
30,07/25/2017,40,9:45,10:00,,16.02,0,16.02,16.02,-1,-41196,87870,129066,46674,0,-29558,0,0,0,,29558,-29558
30,07/25/2017,41,10:00,10:15,,23.41,0,23.41,23.41,-1,-35039,87826,122865,52787,0,-13174,0,0,0,,13174,-13174
30,07/25/2017,42,10:15,10:30,,-14.28,0,-14.28,-14.28,-1,-39187,92524,131711,53337,0,-34886,0,0,0,,34886,-34886
30,07/25/2017,43,10:30,10:45,,-12.03,0,-12.03,-12.03,-1,-46401,102414,148815,56013,0,-32145,0,0,0,,32145,-32145
30,07/25/2017,44,10:45,11:00,,16.33,0,16.33,16.33,-1,-43832,88050,131882,44218,0,-48568,0,0,0,,48568,-48568
30,07/25/2017,45,11:00,11:15,,21.79,0,21.79,21.79,-1,-46493,57189,103682,10696,0,-21069,0,0,0,,21069,-21069
30,07/25/2017,46,11:15,11:30,,5.16,0,5.16,5.16,-1,-39765,76249,116014,36484,0,-20915,0,0,0,,20915,-20915
30,07/25/2017,47,11:30,11:45,,24.74,0,24.74,24.74,-1,-53301,80988,134289,27687,0,-23491,0,0,0,,23491,-23491
30,07/25/2017,48,11:45,12:00,,23.4,0,23.4,23.4,-1,-52724,85760,138484,33036,0,-26928,0,0,0,,26928,-26928
30,07/25/2017,49,12:00,12:15,,20.74,0,20.74,20.74,-1,-45134,75728,120862,30594,0,-32430,0,0,0,,32430,-32430
30,07/25/2017,50,12:15,12:30,,20.74,0,20.74,20.74,-1,-47465,83485,130950,36020,0,-33135,0,0,0,,33135,-33135
30,07/25/2017,51,12:30,12:45,,22.38,0,22.38,22.38,-1,-46222,82773,128995,36551,0,-32629,0,0,0,,32629,-32629
30,07/25/2017,52,12:45,13:00,,22.38,0,22.38,22.38,-1,-53714,81205,134919,27491,0,-34168,0,0,0,,34168,-34168
30,07/25/2017,53,13:00,13:15,,20.34,0,20.34,20.34,-1,-49070,58738,107808,9668,0,-29922,0,0,0,,29922,-29922
30,07/25/2017,54,13:15,13:30,27.37,18.3,0,36.37,18.3,2,-51256,77873,129129,26617,0,-5751,69,0,0,,5820,-5682
30,07/25/2017,55,13:30,13:45,,13.26,0,13.26,13.26,-1,-47530,79216,126746,31686,0,-26428,0,0,0,,26428,-26428
30,07/25/2017,56,13:45,14:00,,17.28,0,17.28,17.28,-1,-51648,83655,135303,32007,0,-26342,0,0,0,,26342,-26342
30,07/25/2017,57,14:00,14:15,,8.2,0,8.2,8.2,-1,-43041,75725,118766,32684,0,-34281,0,0,0,,34281,-34281
30,07/25/2017,58,14:15,14:30,,22.56,0,22.56,22.56,-1,-45104,87335,132439,42231,0,-19505,0,0,0,,19505,-19505
30,07/25/2017,59,14:30,14:45,,8.23,0,8.23,8.23,-1,-45234,95175,140409,49941,0,-35238,0,0,0,,35238,-35238
30,07/25/2017,60,14:45,15:00,,21.79,0,21.79,21.79,-1,-53159,75452,128611,22293,0,-29795,0,0,0,,29795,-29795
30,07/25/2017,61,15:00,15:15,,22.72,0,22.72,22.72,-1,-60759,93830,154589,33071,0,-27016,0,0,0,,27016,-27016
30,07/25/2017,62,15:15,15:30,,20.32,0,20.32,20.32,-1,-68666,96182,164848,27516,0,-28542,0,0,0,,28542,-28542
30,07/25/2017,63,15:30,15:45,,24.31,0,24.31,24.31,-1,-74965,89785,164750,14820,0,-24064,0,0,0,,24064,-24064
30,07/25/2017,64,15:45,16:00,,24.74,0,24.74,24.74,-1,-70379,77449,147828,7070,0,-7913,0,0,0,,7913,-7913
30,07/25/2017,65,16:00,16:15,,21.69,0,21.69,21.69,-1,-80003,86462,166465,6459,0,-6329,0,0,0,,6329,-6329
30,07/25/2017,66,16:15,16:30,,27.12,0,27.12,27.12,-1,-75800,68363,144163,-7437,0,-1280,0,0,0,,1280,-1280
30,07/25/2017,67,16:30,16:45,,29.74,0,29.74,29.74,-1,-70452,56062,126514,-14390,0,-44,0,0,0,,44,-44
30,07/25/2017,68,16:45,17:00,,,0,27.74,27.74,0,-77039,42265,119304,-34774,0,0,0,0,0,,0,0
30,07/25/2017,69,17:00,17:15,28.04,,0,28.04,28.04,1,-98831,28439,127270,-70392,0,0,136,0,0,,136,136
30,07/25/2017,70,17:15,17:30,,,0,27.74,27.74,0,-97126,23104,120230,-74022,0,0,0,0,0,,0,0
30,07/25/2017,71,17:30,17:45,37.9,,0,37.9,37.9,1,-82269,22237,104506,-60032,0,0,2944,0,0,,2944,2944
30,07/25/2017,72,17:45,18:00,40.99,,0,40.99,40.99,1,-73349,39814,113163,-33535,0,0,18056,0,0,,18056,18056
30,07/25/2017,73,18:00,18:15,27.74,,0,27.74,27.74,1,-96497,31886,128383,-64611,0,0,6447,0,0,,6447,6447
30,07/25/2017,74,18:15,18:30,27.74,26.19,0,26.19,26.19,-1,-48210,32450,80660,-15760,0,-72,21,0,0,,93,-51
30,07/25/2017,75,18:30,18:45,37.33,25.74,0,37.33,25.74,2,-40867,23562,64429,-17305,0,-340,1838,0,0,,2178,1498
30,07/25/2017,76,18:45,19:00,41,,0,41,41,1,-44376,20789,65165,-23587,0,0,18441,0,0,,18441,18441
30,07/25/2017,77,19:00,19:15,26.1,,0,26.1,26.1,1,-48540,48999,97539,459,0,0,4440,0,0,,4440,4440
30,07/25/2017,78,19:15,19:30,,29.74,0,29.74,29.74,-1,-50616,42860,93476,-7756,0,-36,0,0,0,,36,-36
30,07/25/2017,79,19:30,19:45,,25.74,0,25.74,25.74,-1,-45493,54300,99793,8807,0,-976,0,0,0,,976,-976
30,07/25/2017,80,19:45,20:00,,26.07,0,26.07,26.07,-1,-44750,33701,78451,-11049,0,-2095,0,0,0,,2095,-2095
30,07/25/2017,81,20:00,20:15,,27.03,0,27.03,27.03,-1,-43593,67488,111081,23895,0,-1473,0,0,0,,1473,-1473
30,07/25/2017,82,20:15,20:30,,,0,27.74,27.74,0,-35796,38758,74554,2962,0,-152,0,0,0,,152,-152
30,07/25/2017,83,20:30,20:45,,,0,27.74,27.74,0,-44239,40990,85229,-3249,0,0,0,0,0,,0,0
30,07/25/2017,84,20:45,21:00,,25.74,0,25.74,25.74,-1,-55946,37417,93363,-18529,0,-233,0,0,0,,233,-233
30,07/25/2017,85,21:00,21:15,,24.74,0,24.74,24.74,-1,-33658,108462,142120,74804,0,-3647,0,0,0,,3647,-3647
30,07/25/2017,86,21:15,21:30,,20.74,0,20.74,20.74,-1,-30820,94243,125063,63423,0,-1818,0,0,0,,1818,-1818
30,07/25/2017,87,21:30,21:45,,16.79,0,16.79,16.79,-1,-39245,82204,121449,42959,0,-6923,0,0,0,,6923,-6923
30,07/25/2017,88,21:45,22:00,,24.74,0,24.74,24.74,-1,-67787,64219,132006,-3568,0,-281,0,0,0,,281,-281
30,07/25/2017,89,22:00,22:15,,-12.67,0,-12.67,-12.67,-1,-65560,135772,201332,70212,0,-24795,0,0,0,,24795,-24795
30,07/25/2017,90,22:15,22:30,,15.89,0,15.89,15.89,-1,-50471,96347,146818,45876,0,-24913,0,0,0,,24913,-24913
30,07/25/2017,91,22:30,22:45,,12.03,0,12.03,12.03,-1,-50833,100273,151106,49440,0,-31611,0,0,0,,31611,-31611
30,07/25/2017,92,22:45,23:00,,6.83,0,6.83,6.83,-1,-78335,111831,190166,33496,0,-34225,0,0,0,,34225,-34225
30,07/25/2017,93,23:00,23:15,,20.04,0,20.04,20.04,-1,-56676,96364,153040,39688,0,-22603,0,0,0,,22603,-22603
30,07/25/2017,94,23:15,23:30,,16.81,0,16.81,16.81,-1,-51551,75465,127016,23914,0,-4325,0,0,0,,4325,-4325
30,07/25/2017,95,23:30,23:45,,6.02,0,6.02,6.02,-1,-50158,84064,134222,33906,0,-38419,0,0,0,,38419,-38419
30,07/25/2017,96,23:45,0:00,,19.82,0,19.82,19.82,-1,-70224,76665,146889,6441,0,-34614,0,0,0,,34614,-34614
30,07/26/2017,1,0:00,0:15,,27.04,0,27.04,27.04,-1,-31183,88192,119375,57009,0,-3511,0,0,0,,3511,-3511
30,07/26/2017,2,0:15,0:30,,-21.73,0,-21.73,-21.73,-1,-32204,95623,127827,63419,0,-8542,0,0,0,,8542,-8542
30,07/26/2017,3,0:30,0:45,,-39.61,0,-39.61,-39.61,-1,-46623,95800,142423,49177,0,-39478,0,0,0,,39478,-39478
30,07/26/2017,4,0:45,1:00,,-20.56,0,-20.56,-20.56,-1,-45783,127912,173695,82129,0,-56386,0,0,0,,56386,-56386
30,07/26/2017,5,1:00,1:15,,19.18,0,19.18,19.18,-1,-49901,85473,135374,35572,0,-26178,0,0,0,,26178,-26178
30,07/26/2017,6,1:15,1:30,,19.74,0,19.74,19.74,-1,-45677,82372,128049,36695,0,-22387,0,0,0,,22387,-22387
30,07/26/2017,7,1:30,1:45,,20.75,0,20.75,20.75,-1,-46533,93688,140221,47155,0,-20772,0,0,0,,20772,-20772
30,07/26/2017,8,1:45,2:00,,12.97,0,12.97,12.97,-1,-61172,105378,166550,44206,0,-36258,0,0,0,,36258,-36258
30,07/26/2017,9,2:00,2:15,25.64,24.75,0,25.64,25.64,1,-65000,75823,140823,10823,0,-14151,98,0,0,,14249,-14053
30,07/26/2017,10,2:15,2:30,,12.03,0,12.03,12.03,-1,-45682,81000,126682,35318,0,-14918,0,0,0,,14918,-14918
30,07/26/2017,11,2:30,2:45,,24.26,0,24.26,24.26,-1,-62136,95015,157151,32879,0,-26996,0,0,0,,26996,-26996
30,07/26/2017,12,2:45,3:00,,24.75,0,24.75,24.75,-1,-64068,97545,161613,33477,0,-22281,0,0,0,,22281,-22281
30,07/26/2017,13,3:00,3:15,,27.09,0,27.09,27.09,-1,-42916,80568,123484,37652,0,-6217,0,0,0,,6217,-6217
30,07/26/2017,14,3:15,3:30,,24.75,0,24.75,24.75,-1,-34129,110517,144646,76388,0,-485,0,0,0,,485,-485
30,07/26/2017,15,3:30,3:45,,24.75,0,24.75,24.75,-1,-35485,102934,138419,67449,0,-1695,0,0,0,,1695,-1695
30,07/26/2017,16,3:45,4:00,,24.75,0,24.75,24.75,-1,-34295,94376,128671,60081,0,-1096,0,0,0,,1096,-1096
30,07/26/2017,17,4:00,4:15,,21.52,0,21.52,21.52,-1,-35782,89125,124907,53343,0,-10850,0,0,0,,10850,-10850
30,07/26/2017,18,4:15,4:30,,,0,27.7,27.7,0,-36932,75302,112234,38370,0,-1774,0,0,0,,1774,-1774
30,07/26/2017,19,4:30,4:45,,,0,27.7,27.7,0,-42957,71492,114449,28535,0,0,0,0,0,,0,0
30,07/26/2017,20,4:45,5:00,,,0,27.69,27.69,0,-41487,71621,113108,30134,0,0,0,0,0,,0,0
30,07/26/2017,21,5:00,5:15,,,0,27.75,27.75,0,-48334,84487,132821,36153,0,0,0,0,0,,0,0
30,07/26/2017,22,5:15,5:30,33.6,,0,33.6,33.6,1,-58835,53972,112807,-4863,0,0,1375,0,0,,1375,1375
30,07/26/2017,23,5:30,5:45,27.69,,0,27.69,27.69,1,-46589,53081,99670,6492,0,0,942,0,0,,942,942
30,07/26/2017,24,5:45,6:00,31.36,,0,31.36,31.36,1,-48519,54552,103071,6033,0,0,4450,0,0,,4450,4450
30,07/26/2017,25,6:00,6:15,28,,0,28,28,1,-69273,54568,123841,-14705,0,0,367,0,0,,367,367
30,07/26/2017,26,6:15,6:30,27.86,,0,27.86,27.86,1,-41247,57355,98602,16108,0,0,606,0,0,,606,606
30,07/26/2017,27,6:30,6:45,,,0,27.69,27.69,0,-29670,70945,100615,41275,0,0,0,0,0,,0,0
30,07/26/2017,28,6:45,7:00,,26.4,0,26.4,26.4,-1,-32734,110216,142950,77482,0,-958,0,0,0,,958,-958
30,07/26/2017,29,7:00,7:15,,26.66,0,26.66,26.66,-1,-119757,68593,188350,-51164,0,-285,0,0,0,,285,-285
30,07/26/2017,30,7:15,7:30,,17.78,0,17.78,17.78,-1,-48676,59051,107727,10375,0,-12844,0,0,0,,12844,-12844
30,07/26/2017,31,7:30,7:45,35.15,17.78,0,35.15,35.15,1,-45447,17975,63422,-27472,0,-504,5967,0,0,,6471,5463
30,07/26/2017,32,7:45,8:00,32.49,,0,32.49,32.49,1,-48628,29957,78585,-18671,0,0,10286,0,0,,10286,10286
30,07/26/2017,33,8:00,8:15,29.15,,0,29.15,29.15,1,-98279,78541,176820,-19738,0,0,3517,0,0,,3517,3517
30,07/26/2017,34,8:15,8:30,,,0,28.43,28.43,0,-73846,75204,149050,1358,0,0,211,0,0,,211,211
30,07/26/2017,35,8:30,8:45,39.02,,0,39.02,39.02,1,-67477,41809,109286,-25668,0,0,1648,0,0,,1648,1648
30,07/26/2017,36,8:45,9:00,52.53,,0,52.53,52.53,1,-75835,25208,101043,-50627,0,0,27107,0,0,,27107,27107
30,07/26/2017,37,9:00,9:15,27.78,19.78,0,28.54,19.78,2,-49924,69541,119465,19617,0,-5057,8249,0,0,,13306,3192
30,07/26/2017,38,9:15,9:30,,27.07,0,27.07,27.07,-1,-63956,49391,113347,-14565,0,-2477,0,0,0,,2477,-2477
30,07/26/2017,39,9:30,9:45,,,0,28.54,28.54,0,-58308,49545,107853,-8763,0,0,0,0,0,,0,0
30,07/26/2017,40,9:45,10:00,,,0,28.54,28.54,0,-68270,47021,115291,-21249,0,0,0,0,0,,0,0
30,07/26/2017,41,10:00,10:15,,26.78,0,26.78,26.78,-1,-52201,66309,118510,14108,0,-2023,0,0,0,,2023,-2023
30,07/26/2017,42,10:15,10:30,,24.15,0,24.15,24.15,-1,-58922,86775,145697,27853,0,-14289,0,0,0,,14289,-14289
30,07/26/2017,43,10:30,10:45,,25.3,0,25.3,25.3,-1,-54677,90611,145288,35934,0,-21222,0,0,0,,21222,-21222
30,07/26/2017,44,10:45,11:00,,26.72,0,26.72,26.72,-1,-56109,64500,120609,8391,0,-14457,0,0,0,,14457,-14457
30,07/26/2017,45,11:00,11:15,,22.67,0,22.67,22.67,-1,-50947,78832,129779,27885,0,-7951,0,0,0,,7951,-7951
30,07/26/2017,46,11:15,11:30,,22.92,0,22.92,22.92,-1,-59232,80070,139302,20838,0,-28405,0,0,0,,28405,-28405
30,07/26/2017,47,11:30,11:45,,26.21,0,26.21,26.21,-1,-56072,79829,135901,23757,0,-13403,0,0,0,,13403,-13403
30,07/26/2017,48,11:45,12:00,,24.15,0,24.15,24.15,-1,-54813,86181,140994,31368,0,-18588,0,0,0,,18588,-18588
30,07/26/2017,49,12:00,12:15,,25.16,0,25.16,25.16,-1,-42138,79495,121633,37357,0,-16222,0,0,0,,16222,-16222
30,07/26/2017,50,12:15,12:30,,8.07,0,8.07,8.07,-1,-46714,92360,139074,45646,0,-30920,0,0,0,,30920,-30920
30,07/26/2017,51,12:30,12:45,,18.7,0,18.7,18.7,-1,-52425,101237,153662,48812,0,-42041,0,0,0,,42041,-42041
30,07/26/2017,52,12:45,13:00,,19.74,0,19.74,19.74,-1,-60339,93643,153982,33304,0,-37594,0,0,0,,37594,-37594
30,07/26/2017,53,13:00,13:15,,10.05,0,10.05,10.05,-1,-69680,88455,158135,18775,0,-33555,0,0,0,,33555,-33555
30,07/26/2017,54,13:15,13:30,29.52,26.24,0,29.52,26.24,2,-79045,81566,160611,2521,0,-3026,240,0,0,,3266,-2786
30,07/26/2017,55,13:30,13:45,,26.04,0,26.04,26.04,-1,-69310,79999,149309,10689,0,-5135,0,0,0,,5135,-5135
30,07/26/2017,56,13:45,14:00,,23.96,0,23.96,23.96,-1,-69825,85102,154927,15277,0,-13561,0,0,0,,13561,-13561
30,07/26/2017,57,14:00,14:15,,23.16,0,23.16,23.16,-1,-71832,77315,149147,5483,0,-13639,0,0,0,,13639,-13639
30,07/26/2017,58,14:15,14:30,,24.15,0,24.15,24.15,-1,-76044,90512,166556,14468,0,-2487,0,0,0,,2487,-2487
30,07/26/2017,59,14:30,14:45,,24.15,0,24.15,24.15,-1,-82143,104031,186174,21888,0,-13739,0,0,0,,13739,-13739
30,07/26/2017,60,14:45,15:00,,24.74,0,24.74,24.74,-1,-85153,106704,191857,21551,0,-20542,0,0,0,,20542,-20542
30,07/26/2017,61,15:00,15:15,,24.15,0,24.15,24.15,-1,-70097,92212,162309,22115,0,-19003,0,0,0,,19003,-19003
30,07/26/2017,62,15:15,15:30,,24.15,0,24.15,24.15,-1,-68223,88401,156624,20178,0,-25625,0,0,0,,25625,-25625
30,07/26/2017,63,15:30,15:45,,25.78,0,25.78,25.78,-1,-72048,79137,151185,7089,0,-17410,0,0,0,,17410,-17410
30,07/26/2017,64,15:45,16:00,,29.15,0,29.15,29.15,-1,-80018,70022,150040,-9996,0,-2453,0,0,0,,2453,-2453
30,07/26/2017,65,16:00,16:15,,26.12,0,26.12,26.12,-1,-78593,90319,168912,11726,0,-3048,0,0,0,,3048,-3048
30,07/26/2017,66,16:15,16:30,,28.15,0,28.15,28.15,-1,-82086,80374,162460,-1712,0,-3464,0,0,0,,3464,-3464
30,07/26/2017,67,16:30,16:45,,29.15,0,29.15,29.15,-1,-77100,61899,138999,-15201,0,-753,0,0,0,,753,-753
30,07/26/2017,68,16:45,17:00,30.4,,0,30.4,30.4,1,-78340,44767,123107,-33573,0,0,387,0,0,,387,387
30,07/26/2017,69,17:00,17:15,32.83,,0,32.83,32.83,1,-95980,54564,150544,-41416,0,0,914,0,0,,914,914
30,07/26/2017,70,17:15,17:30,86.12,,0,86.12,86.12,1,-102780,41790,144570,-60990,0,0,18226,0,0,,18226,18226
30,07/26/2017,71,17:30,17:45,105.12,,0,105.12,105.12,1,-88399,38739,127138,-49660,0,0,31604,0,0,,31604,31604
30,07/26/2017,72,17:45,18:00,34.65,,0,34.65,34.65,1,-65331,44186,109517,-21145,0,0,20512,0,0,,20512,20512
30,07/26/2017,73,18:00,18:15,34.65,28.15,0,28.15,28.15,-1,-74956,44308,119264,-30648,0,-2,2221,0,0,,2223,2219
30,07/26/2017,74,18:15,18:30,27.46,,0,27.46,27.46,1,-59771,50177,109948,-9594,0,0,163,0,0,,163,163
30,07/26/2017,75,18:30,18:45,27.5,,0,27.5,27.5,1,-59584,61799,121383,2215,0,0,932,0,0,,932,932
30,07/26/2017,76,18:45,19:00,27.58,,0,27.58,27.58,1,-60077,72621,132698,12544,0,0,385,0,0,,385,385
30,07/26/2017,77,19:00,19:15,,27.07,0,27.07,27.07,-1,-69363,79905,149268,10542,0,-117,0,0,0,,117,-117
30,07/26/2017,78,19:15,19:30,,19.74,0,19.74,19.74,-1,-61232,97554,158786,36322,0,-14208,0,0,0,,14208,-14208
30,07/26/2017,79,19:30,19:45,,19.74,0,19.74,19.74,-1,-61882,98671,160553,36789,0,-20848,0,0,0,,20848,-20848
30,07/26/2017,80,19:45,20:00,,22.34,0,22.34,22.34,-1,-61744,116888,178632,55144,0,-8424,0,0,0,,8424,-8424
30,07/26/2017,81,20:00,20:15,,26.26,0,26.26,26.26,-1,-44593,46331,90924,1738,0,-8640,0,0,0,,8640,-8640
30,07/26/2017,82,20:15,20:30,,28.15,0,28.15,28.15,-1,-59063,78410,137473,19347,0,-182,0,0,0,,182,-182
30,07/26/2017,83,20:30,20:45,,28.15,0,28.15,28.15,-1,-63549,91244,154793,27695,0,-2568,0,0,0,,2568,-2568
30,07/26/2017,84,20:45,21:00,,27.14,0,27.14,27.14,-1,-59035,105540,164575,46505,0,-7733,0,0,0,,7733,-7733
30,07/26/2017,85,21:00,21:15,,28.15,0,28.15,28.15,-1,-50353,51593,101946,1240,0,-3848,0,0,0,,3848,-3848
30,07/26/2017,86,21:15,21:30,,24.15,0,24.15,24.15,-1,-42284,62178,104462,19894,0,-4350,0,0,0,,4350,-4350
30,07/26/2017,87,21:30,21:45,,23.75,0,23.75,23.75,-1,-51454,61722,113176,10268,0,-12232,0,0,0,,12232,-12232
30,07/26/2017,88,21:45,22:00,,27.78,0,27.78,27.78,-1,-62706,59436,122142,-3270,0,-6375,0,0,0,,6375,-6375
30,07/26/2017,89,22:00,22:15,,25.78,0,25.78,25.78,-1,-48655,47223,95878,-1432,0,-3751,0,0,0,,3751,-3751
30,07/26/2017,90,22:15,22:30,,-2.74,0,-2.74,-2.74,-1,-27474,72557,100031,45083,0,-14728,0,0,0,,14728,-14728
30,07/26/2017,91,22:30,22:45,,-2.74,0,-2.74,-2.74,-1,-32803,66607,99410,33804,0,-42126,0,0,0,,42126,-42126
30,07/26/2017,92,22:45,23:00,,-3.49,0,-3.49,-3.49,-1,-46332,90420,136752,44088,0,-31885,0,0,0,,31885,-31885
30,07/26/2017,93,23:00,23:15,,-56.03,0,-56.03,-56.03,-1,-66692,75868,142560,9176,0,-43081,0,0,0,,43081,-43081
30,07/26/2017,94,23:15,23:30,,19.49,0,19.49,19.49,-1,-71460,76620,148080,5160,0,-2629,0,0,0,,2629,-2629
30,07/26/2017,95,23:30,23:45,,0.92,0,0.92,0.92,-1,-68058,120083,188141,52025,0,-32058,0,0,0,,32058,-32058
30,07/26/2017,96,23:45,0:00,,8.19,0,8.19,8.19,-1,-71230,112629,183859,41399,0,-40641,0,0,0,,40641,-40641
30,07/27/2017,1,0:00,0:15,44.74,25.03,0,44.74,25.03,2,-97845,86180,184025,-11665,0,-10914,3374,0,0,,14288,-7540
30,07/27/2017,2,0:15,0:30,28.4,24.85,0,24.85,24.85,-1,-73389,69276,142665,-4113,0,-545,1641,0,0,,2186,1096
30,07/27/2017,3,0:30,0:45,,1.84,0,1.84,1.84,-1,-56123,96349,152472,40226,0,-35464,0,0,0,,35464,-35464
30,07/27/2017,4,0:45,1:00,,16.03,0,16.03,16.03,-1,-79140,137321,216461,58181,0,-67071,0,0,0,,67071,-67071
30,07/27/2017,5,1:00,1:15,40.05,16.03,0,40.05,40.05,1,-71144,65711,136855,-5433,0,-32579,1350,0,0,,33929,-31229
30,07/27/2017,6,1:15,1:30,40.05,24.09,0,24.09,24.09,-1,-49679,81547,131226,31868,0,-1203,62,0,0,,1265,-1141
30,07/27/2017,7,1:30,1:45,,18.32,0,18.32,18.32,-1,-54365,93302,147667,38937,0,-837,0,0,0,,837,-837
30,07/27/2017,8,1:45,2:00,,7.22,0,7.22,7.22,-1,-54368,103777,158145,49409,0,-30646,0,0,0,,30646,-30646
30,07/27/2017,9,2:00,2:15,34.02,19.74,0,34.02,34.02,1,-60982,70175,131157,9193,0,-19805,971,0,0,,20776,-18834
30,07/27/2017,10,2:15,2:30,26.05,-2.7,0,-2.7,-2.7,-1,-52496,82540,135036,30044,0,-3680,1005,0,0,,4685,-2675
30,07/27/2017,11,2:30,2:45,,-47.98,0,-47.98,-47.98,-1,-63781,85834,149615,22053,0,-34568,0,0,0,,34568,-34568
30,07/27/2017,12,2:45,3:00,,10.6,0,10.6,10.6,-1,-83783,110611,194394,26828,0,-16716,0,0,0,,16716,-16716
30,07/27/2017,13,3:00,3:15,,7.16,0,7.16,7.16,-1,-64696,121966,186662,57270,0,-15543,0,0,0,,15543,-15543
30,07/27/2017,14,3:15,3:30,,,0,27.89,27.89,0,-57459,117481,174940,60022,0,-49,0,0,0,,49,-49
30,07/27/2017,15,3:30,3:45,,18.05,0,18.05,18.05,-1,-38945,123353,162298,84408,0,-3281,0,0,0,,3281,-3281
30,07/27/2017,16,3:45,4:00,,13.61,0,13.61,13.61,-1,-52188,116402,168590,64214,0,-12946,0,0,0,,12946,-12946
30,07/27/2017,17,4:00,4:15,,25.14,0,25.14,25.14,-1,-35764,141034,176798,105270,0,-15336,0,0,0,,15336,-15336
30,07/27/2017,18,4:15,4:30,,26.33,0,26.33,26.33,-1,-31850,133412,165262,101562,0,-10688,0,0,0,,10688,-10688
30,07/27/2017,19,4:30,4:45,,,0,27.87,27.87,0,-33406,143105,176511,109699,0,-224,0,0,0,,224,-224
30,07/27/2017,20,4:45,5:00,,,0,27.86,27.86,0,-35870,144489,180359,108619,0,0,0,0,0,,0,0
30,07/27/2017,21,5:00,5:15,,24.37,0,24.37,24.37,-1,-64248,136409,200657,72161,0,-1284,0,0,0,,1284,-1284
30,07/27/2017,22,5:15,5:30,,17.56,0,17.56,17.56,-1,-52747,108576,161323,55829,0,-14152,0,0,0,,14152,-14152
30,07/27/2017,23,5:30,5:45,31.15,17.56,0,31.15,31.15,1,-63257,42090,105347,-21167,0,-628,939,0,0,,1567,311
30,07/27/2017,24,5:45,6:00,41.15,,0,41.15,41.15,1,-86544,47849,134393,-38695,0,0,16412,0,0,,16412,16412
30,07/27/2017,25,6:00,6:15,41.15,26.77,0,26.77,26.77,-1,-51797,62971,114768,11174,0,-1053,2562,0,0,,3615,1509
30,07/27/2017,26,6:15,6:30,,28.24,0,28.24,28.24,-1,-64479,65246,129725,767,0,-2510,0,0,0,,2510,-2510
30,07/27/2017,27,6:30,6:45,,28.24,0,28.24,28.24,-1,-66166,66490,132656,324,0,-1770,0,0,0,,1770,-1770
30,07/27/2017,28,6:45,7:00,30.08,28.24,0,30.08,30.08,1,-59786,99120,158906,39334,0,-164,1570,0,0,,1734,1406
30,07/27/2017,29,7:00,7:15,29.76,,0,29.76,29.76,1,-116863,60694,177557,-56169,0,0,813,0,0,,813,813
30,07/27/2017,30,7:15,7:30,29.76,0.85,0,0.85,0.85,-1,-47905,93810,141715,45905,0,-16332,214,0,0,,16546,-16118
30,07/27/2017,31,7:30,7:45,,-14.39,0,-14.39,-14.39,-1,-42961,79122,122083,36161,0,-38336,0,0,0,,38336,-38336
30,07/27/2017,32,7:45,8:00,,27.11,0,27.11,27.11,-1,-46753,97992,144745,51239,0,-7224,0,0,0,,7224,-7224
30,07/27/2017,33,8:00,8:15,,,0,28.67,28.67,0,-91181,57036,148217,-34145,0,-22,0,0,0,,22,-22
30,07/27/2017,34,8:15,8:30,,,0,28.67,28.67,0,-97143,47561,144704,-49582,0,0,0,0,0,,0,0
30,07/27/2017,35,8:30,8:45,40.27,,0,40.27,40.27,1,-106009,26196,132205,-79813,0,0,5367,0,0,,5367,5367
30,07/27/2017,36,8:45,9:00,279.01,,0,279.01,279.01,1,-106786,20858,127644,-85928,0,0,44946,0,0,,44946,44946
30,07/27/2017,37,9:00,9:15,30.56,27.07,0,30.56,27.07,2,-47819,80536,128355,32717,0,-38,10396,0,0,,10434,10358
30,07/27/2017,38,9:15,9:30,27.6,29.24,0,28.67,28.67,2,-52575,59429,112004,6854,0,-329,12,0,0,,341,-317
30,07/27/2017,39,9:30,9:45,35.22,,0,35.22,35.22,1,-73783,38700,112483,-35083,0,0,2746,0,0,,2746,2746
30,07/27/2017,40,9:45,10:00,38.48,,0,38.48,38.48,1,-95049,32636,127685,-62413,0,0,16226,0,0,,16226,16226
30,07/27/2017,41,10:00,10:15,31.43,24.24,0,24.24,24.24,-1,-70794,87160,157954,16366,0,-1297,9745,0,0,,11042,8448
30,07/27/2017,42,10:15,10:30,31.43,24.24,0,24.24,24.24,-1,-63275,88515,151790,25240,0,-15777,27,0,0,,15804,-15750
30,07/27/2017,43,10:30,10:45,,28.24,0,28.24,28.24,-1,-57789,93134,150923,35345,0,-6556,0,0,0,,6556,-6556
30,07/27/2017,44,10:45,11:00,,,0,28.67,28.67,0,-76080,79590,155670,3510,0,-104,0,0,0,,104,-104
30,07/27/2017,45,11:00,11:15,35.24,,0,35.24,35.24,1,-127016,77557,204573,-49459,0,0,2654,0,0,,2654,2654
30,07/27/2017,46,11:15,11:30,39.16,,0,39.16,39.16,1,-125850,79394,205244,-46456,0,0,3031,0,0,,3031,3031
30,07/27/2017,47,11:30,11:45,35.47,,0,35.47,35.47,1,-131772,77712,209484,-54060,0,0,7839,0,0,,7839,7839
30,07/27/2017,48,11:45,12:00,29.76,,0,29.76,29.76,1,-116307,80483,196790,-35824,0,0,6516,0,0,,6516,6516
30,07/27/2017,49,12:00,12:15,29.24,,0,29.24,29.24,1,-96139,69751,165890,-26388,0,0,1741,0,0,,1741,1741
30,07/27/2017,50,12:15,12:30,29.24,27.21,0,27.21,27.21,-1,-87711,90279,177990,2568,0,-983,154,0,0,,1137,-829
30,07/27/2017,51,12:30,12:45,,19.74,0,19.74,19.74,-1,-84368,117521,201889,33153,0,-21074,0,0,0,,21074,-21074
30,07/27/2017,52,12:45,13:00,,23.53,0,23.53,23.53,-1,-90866,118967,209833,28101,0,-38409,0,0,0,,38409,-38409
30,07/27/2017,53,13:00,13:15,29.3,24.24,0,29.3,29.3,1,-104000,114739,218739,10739,0,-20612,155,0,0,,20767,-20457
30,07/27/2017,54,13:15,13:30,29.76,26.4,0,29.76,26.4,2,-116548,131309,247857,14761,0,-2374,285,0,0,,2659,-2089
30,07/27/2017,55,13:30,13:45,,24.31,0,24.31,24.31,-1,-108990,123820,232810,14830,0,-10638,0,0,0,,10638,-10638
30,07/27/2017,56,13:45,14:00,,26.62,0,26.62,26.62,-1,-120345,124331,244676,3986,0,-8872,0,0,0,,8872,-8872
30,07/27/2017,57,14:00,14:15,54.8,26.62,0,54.8,54.8,1,-129917,73860,203777,-56057,0,-1403,6540,0,0,,7943,5137
30,07/27/2017,58,14:15,14:30,30.32,,0,30.32,30.32,1,-125612,82972,208584,-42640,0,0,4497,0,0,,4497,4497
30,07/27/2017,59,14:30,14:45,,,0,28.62,28.62,0,-118178,80794,198972,-37384,0,0,0,0,0,,0,0
30,07/27/2017,60,14:45,15:00,,,0,28.62,28.62,0,-120851,84542,205393,-36309,0,0,0,0,0,,0,0
30,07/27/2017,61,15:00,15:15,29,,0,29,29,1,-110342,91003,201345,-19339,0,0,714,0,0,,714,714
30,07/27/2017,62,15:15,15:30,27.4,,0,27.4,27.4,1,-98522,107563,206085,9041,0,0,174,0,0,,174,174
30,07/27/2017,63,15:30,15:45,,,0,28.57,28.57,0,-90700,96785,187485,6085,0,0,0,0,0,,0,0
30,07/27/2017,64,15:45,16:00,,,0,28.57,28.57,0,-89064,85652,174716,-3412,0,0,0,0,0,,0,0
30,07/27/2017,65,16:00,16:15,,27.03,0,27.03,27.03,-1,-46947,72538,119485,25591,0,-1117,0,0,0,,1117,-1117
30,07/27/2017,66,16:15,16:30,,25.7,0,25.7,25.7,-1,-49606,107635,157241,58029,0,-9725,0,0,0,,9725,-9725
30,07/27/2017,67,16:30,16:45,,19.74,0,19.74,19.74,-1,-59055,140408,199463,81353,0,-20853,0,0,0,,20853,-20853
30,07/27/2017,68,16:45,17:00,,5.23,0,5.23,5.23,-1,-48073,138503,186576,90430,0,-32256,0,0,0,,32256,-32256
30,07/27/2017,69,17:00,17:15,,5.23,0,5.23,5.23,-1,-93159,127296,220455,34137,0,-40792,0,0,0,,40792,-40792
30,07/27/2017,70,17:15,17:30,,19.74,0,19.74,19.74,-1,-80705,132745,213450,52040,0,-28972,0,0,0,,28972,-28972
30,07/27/2017,71,17:30,17:45,29.31,24.24,0,29.31,29.31,1,-84116,95040,179156,10924,0,-18939,70,0,0,,19009,-18869
30,07/27/2017,72,17:45,18:00,29.76,24.24,0,29.76,29.76,1,-82730,85293,168023,2563,0,-367,371,0,0,,738,4
30,07/27/2017,73,18:00,18:15,,,0,28.58,28.58,0,-81390,48732,130122,-32658,0,0,0,0,0,,0,0
30,07/27/2017,74,18:15,18:30,,28.24,0,28.24,28.24,-1,-58636,64794,123430,6158,0,-520,0,0,0,,520,-520
30,07/27/2017,75,18:30,18:45,,28.24,0,28.24,28.24,-1,-51058,57347,108405,6289,0,-3279,0,0,0,,3279,-3279
30,07/27/2017,76,18:45,19:00,,29.74,0,29.74,29.74,-1,-59467,57347,116814,-2120,0,-522,0,0,0,,522,-522
30,07/27/2017,77,19:00,19:15,29.02,,0,29.02,29.02,1,-60003,30667,90670,-29336,0,0,819,0,0,,819,819
30,07/27/2017,78,19:15,19:30,27.51,,0,27.51,27.51,1,-67586,32947,100533,-34639,0,0,1623,0,0,,1623,1623
30,07/27/2017,79,19:30,19:45,32.02,,0,32.02,32.02,1,-76094,30366,106460,-45728,0,0,3891,0,0,,3891,3891
30,07/27/2017,80,19:45,20:00,33.1,,0,33.1,33.1,1,-81692,23617,105309,-58075,0,0,11528,0,0,,11528,11528
30,07/27/2017,81,20:00,20:15,41.24,,0,41.24,41.24,1,-74902,30128,105030,-44774,0,0,17989,0,0,,17989,17989
30,07/27/2017,82,20:15,20:30,35.24,,0,35.24,35.24,1,-79218,39875,119093,-39343,0,0,12794,0,0,,12794,12794
30,07/27/2017,83,20:30,20:45,25.94,26.43,0,26.43,26.43,-1,-51822,51587,103409,-235,0,-731,4048,0,0,,4779,3317
30,07/27/2017,84,20:45,21:00,,26.77,0,26.77,26.77,-1,-59435,52982,112417,-6453,0,-1106,0,0,0,,1106,-1106
30,07/27/2017,85,21:00,21:15,33.59,,0,33.59,33.59,1,-73529,31368,104897,-42161,0,0,1433,0,0,,1433,1433
30,07/27/2017,86,21:15,21:30,29.76,,0,29.76,29.76,1,-59554,31615,91169,-27939,0,0,1183,0,0,,1183,1183
30,07/27/2017,87,21:30,21:45,29.02,,0,29.02,29.02,1,-71298,48738,120036,-22560,0,0,2068,0,0,,2068,2068
30,07/27/2017,88,21:45,22:00,31.29,,0,31.29,31.29,1,-77820,34591,112411,-43229,0,0,2922,0,0,,2922,2922
30,07/27/2017,89,22:00,22:15,32.07,,0,32.07,32.07,1,-98483,12477,110960,-86006,0,0,788,0,0,,788,788
30,07/27/2017,90,22:15,22:30,29.76,,0,29.76,29.76,1,-79973,20579,100552,-59394,0,0,1541,0,0,,1541,1541
30,07/27/2017,91,22:30,22:45,29.09,,0,29.09,29.09,1,-61738,41480,103218,-20258,0,0,1768,0,0,,1768,1768
30,07/27/2017,92,22:45,23:00,28.7,27.19,0,28.7,27.19,2,-89063,55683,144746,-33380,0,-49,2715,0,0,,2764,2666
30,07/27/2017,93,23:00,23:15,28.7,-6.49,0,-6.49,-6.49,-1,-66125,108692,174817,42567,0,-11851,485,0,0,,12336,-11366
30,07/27/2017,94,23:15,23:30,,,0,27.77,27.77,0,-73149,47584,120733,-25565,0,-77,0,0,0,,77,-77
30,07/27/2017,95,23:30,23:45,,,0,27.82,27.82,0,-85628,43392,129020,-42236,0,0,0,0,0,,0,0
30,07/27/2017,96,23:45,0:00,25.91,,0,25.91,25.91,1,-138080,38485,176565,-99595,0,0,51,0,0,,51,51
30,07/28/2017,1,0:00,0:15,,,0,35.15,35.15,0,-20038,84993,105031,64955,0,0,6,0,0,,6,6
30,07/28/2017,2,0:15,0:30,,14.9,0,14.9,14.9,-1,-44194,84622,128816,40428,0,-1412,0,0,0,,1412,-1412
30,07/28/2017,3,0:30,0:45,,-37.96,0,-37.96,-37.96,-1,-43795,73916,117711,30121,0,-36266,0,0,0,,36266,-36266
30,07/28/2017,4,0:45,1:00,,-9.68,0,-9.68,-9.68,-1,-85301,104629,189930,19328,0,-21240,0,0,0,,21240,-21240
30,07/28/2017,5,1:00,1:15,,-37.96,0,-37.96,-37.96,-1,-50746,108036,158782,57290,0,-24030,0,0,0,,24030,-24030
30,07/28/2017,6,1:15,1:30,27.82,14.15,0,27.82,14.15,2,-33691,37059,70750,3368,0,-2067,92,0,0,,2159,-1975
30,07/28/2017,7,1:30,1:45,,-11.78,0,-11.78,-11.78,-1,-46458,65150,111608,18692,0,-27422,0,0,0,,27422,-27422
30,07/28/2017,8,1:45,2:00,,24.04,0,24.04,24.04,-1,-92672,80885,173557,-11787,0,-23421,0,0,0,,23421,-23421
30,07/28/2017,9,2:00,2:15,31.24,24.04,0,31.24,31.24,1,-79178,40030,119208,-39148,0,-3637,797,0,0,,4434,-2840
30,07/28/2017,10,2:15,2:30,,,0,26.78,26.78,0,-81633,38200,119833,-43433,0,0,110,0,0,,110,110
30,07/28/2017,11,2:30,2:45,,,0,26.78,26.78,0,-93268,43042,136310,-50226,0,0,0,0,0,,0,0
30,07/28/2017,12,2:45,3:00,,,0,26.77,26.77,0,-130865,49648,180513,-81217,0,0,0,0,0,,0,0
30,07/28/2017,13,3:00,3:15,27.93,24.67,0,27.93,24.67,2,-46738,59703,106441,12965,0,-419,28,0,0,,447,-391
30,07/28/2017,14,3:15,3:30,28.86,,0,28.86,28.86,1,-47843,56182,104025,8339,0,0,884,0,0,,884,884
30,07/28/2017,15,3:30,3:45,,12.7,0,12.7,12.7,-1,-38275,71133,109408,32858,0,-15558,0,0,0,,15558,-15558
30,07/28/2017,16,3:45,4:00,,15.14,0,15.14,15.14,-1,-56695,92741,149436,36046,0,-33689,0,0,0,,33689,-33689
30,07/28/2017,17,4:00,4:15,,19.2,0,19.2,19.2,-1,-41173,102213,143386,61040,0,-32310,0,0,0,,32310,-32310
30,07/28/2017,18,4:15,4:30,,21.2,0,21.2,21.2,-1,-31555,87728,119283,56173,0,-5858,0,0,0,,5858,-5858
30,07/28/2017,19,4:30,4:45,,26.44,0,26.44,26.44,-1,-50741,98147,148888,47406,0,-2202,0,0,0,,2202,-2202
30,07/28/2017,20,4:45,5:00,,,0,26.79,26.79,0,-70854,101823,172677,30969,0,-55,0,0,0,,55,-55
30,07/28/2017,21,5:00,5:15,,,0,26.84,26.84,0,-108318,74950,183268,-33368,0,0,0,0,0,,0,0
30,07/28/2017,22,5:15,5:30,,,0,26.84,26.84,0,-74096,60819,134915,-13277,0,0,0,0,0,,0,0
30,07/28/2017,23,5:30,5:45,,,0,26.81,26.81,0,-78397,56817,135214,-21580,0,0,0,0,0,,0,0
30,07/28/2017,24,5:45,6:00,41.24,,0,41.24,41.24,1,-83134,70513,153647,-12621,0,0,1191,0,0,,1191,1191
30,07/28/2017,25,6:00,6:15,247.02,,0,247.02,247.02,1,-61503,55539,117042,-5964,0,0,54772,0,0,,54772,54772
30,07/28/2017,26,6:15,6:30,332.13,,0,332.13,332.13,1,-44144,164425,208569,120281,0,0,45579,22500,0,,68079,68079
30,07/28/2017,27,6:30,6:45,232.13,28.41,0,232.13,27.73,2,-28778,212403,241181,183625,0,-800,74,3750,0,,4624,3024
30,07/28/2017,28,6:45,7:00,182.13,29.41,0,182.13,27.73,2,-35898,222190,258088,186292,0,-16,474,2500,0,,2990,2958
30,07/28/2017,29,7:00,7:15,138,24.41,0,138,24.41,2,-18639,213341,231980,194702,0,-2991,0,1250,0,,4241,-1741
30,07/28/2017,30,7:15,7:30,188,,0,188,188,1,-25136,192961,218097,167825,0,0,218,2500,0,,2718,2718
30,07/28/2017,31,7:30,7:45,188,,0,188,188,1,-23443,185655,209098,162212,0,0,3948,2500,0,,6448,6448
30,07/28/2017,32,7:45,8:00,188,,0,188,188,1,-30930,227700,258630,196770,0,0,2101,2500,0,,4601,4601
30,07/28/2017,33,8:00,8:15,188.8,6.04,0,188.8,6.04,2,-6148,291352,297500,285204,0,-12804,33,2500,0,,15337,-10271
30,07/28/2017,34,8:15,8:30,188.8,27.18,0,188.8,188.8,1,-6110,229332,235442,223222,0,-4716,0,2500,0,,7216,-2216
30,07/28/2017,35,8:30,8:45,188.8,,0,188.8,188.8,1,-7032,229635,236667,222603,0,0,0,2500,0,,2500,2500
30,07/28/2017,36,8:45,9:00,188.8,15.58,0,15.58,15.58,-1,-11503,209914,221417,198411,0,-1455,0,2500,0,,3955,1045
30,07/28/2017,37,9:00,9:15,,-21.58,0,-21.58,-21.58,-1,-31501,157682,189183,126181,0,-47605,0,0,0,,47605,-47605
30,07/28/2017,38,9:15,9:30,,-21.58,0,-21.58,-21.58,-1,-72381,158235,230616,85854,0,-52116,0,0,0,,52116,-52116
30,07/28/2017,39,9:30,9:45,,14.94,0,14.94,14.94,-1,-87950,157663,245613,69713,0,-47805,0,0,0,,47805,-47805
30,07/28/2017,40,9:45,10:00,,22.72,0,22.72,22.72,-1,-98578,141910,240488,43332,0,-26727,0,0,0,,26727,-26727
30,07/28/2017,41,10:00,10:15,,,0,35.22,35.22,0,-89052,116111,205163,27059,0,-1909,0,0,0,,1909,-1909
30,07/28/2017,42,10:15,10:30,,,0,35.23,35.23,0,-91758,123049,214807,31291,0,0,0,0,0,,0,0
30,07/28/2017,43,10:30,10:45,,28.41,0,28.41,28.41,-1,-94511,144031,238542,49520,0,-1105,0,0,0,,1105,-1105
30,07/28/2017,44,10:45,11:00,,-21.58,0,-21.58,-21.58,-1,-87669,165309,252978,77640,0,-16440,0,0,0,,16440,-16440
30,07/28/2017,45,11:00,11:15,,18.78,0,18.78,18.78,-1,-98545,74964,173509,-23581,0,-16205,0,0,0,,16205,-16205
30,07/28/2017,46,11:15,11:30,,27.19,0,27.19,27.19,-1,-80110,79412,159522,-698,0,-505,0,0,0,,505,-505
30,07/28/2017,47,11:30,11:45,,24.41,0,24.41,24.41,-1,-73332,96761,170093,23429,0,-16785,0,0,0,,16785,-16785
30,07/28/2017,48,11:45,12:00,,26.78,0,26.78,26.78,-1,-87586,104640,192226,17054,0,-17710,0,0,0,,17710,-17710
30,07/28/2017,49,12:00,12:15,,21.49,0,21.49,21.49,-1,-58393,80133,138526,21740,0,-22288,0,0,0,,22288,-22288
30,07/28/2017,50,12:15,12:30,,26.02,0,26.02,26.02,-1,-64673,76282,140955,11609,0,-10304,0,0,0,,10304,-10304
30,07/28/2017,51,12:30,12:45,,-18.78,0,-18.78,-18.78,-1,-51716,89909,141625,38193,0,-30869,0,0,0,,30869,-30869
30,07/28/2017,52,12:45,13:00,41.41,27.78,0,41.41,27.78,2,-89917,73802,163719,-16115,0,-9761,1209,0,0,,10970,-8552
30,07/28/2017,53,13:00,13:15,,26.29,0,26.29,26.29,-1,-60967,74337,135304,13370,0,-2160,0,0,0,,2160,-2160
30,07/28/2017,54,13:15,13:30,,26.2,0,26.2,26.2,-1,-72358,80767,153125,8409,0,-5513,0,0,0,,5513,-5513
30,07/28/2017,55,13:30,13:45,117.12,26.49,0,117.12,26.49,2,-88561,42064,130625,-46497,0,-3805,25254,0,0,,29059,21449
30,07/28/2017,56,13:45,14:00,34.82,21.49,0,21.49,21.49,-1,-59986,67576,127562,7590,0,-1054,9106,0,0,,10160,8052
30,07/28/2017,57,14:00,14:15,,21.49,0,21.49,21.49,-1,-57100,62354,119454,5254,0,-5211,0,0,0,,5211,-5211
30,07/28/2017,58,14:15,14:30,,25.24,0,25.24,25.24,-1,-60440,65012,125452,4572,0,-5383,0,0,0,,5383,-5383
30,07/28/2017,59,14:30,14:45,,25.49,0,25.49,25.49,-1,-54986,65393,120379,10407,0,-4887,0,0,0,,4887,-4887
30,07/28/2017,60,14:45,15:00,41.41,27.23,0,41.41,41.41,1,-72886,53761,126647,-19125,0,-2699,3602,0,0,,6301,903
30,07/28/2017,61,15:00,15:15,46.09,25.49,0,46.09,25.49,2,-86755,85115,171870,-1640,0,-83,18052,0,0,,18135,17969
30,07/28/2017,62,15:15,15:30,46.09,16.63,0,16.63,16.63,-1,-78407,85803,164210,7396,0,-7037,639,0,0,,7676,-6398
30,07/28/2017,63,15:30,15:45,,22.29,0,22.29,22.29,-1,-81380,109628,191008,28248,0,-4487,0,0,0,,4487,-4487
30,07/28/2017,64,15:45,16:00,,21.49,0,21.49,21.49,-1,-93200,113876,207076,20676,0,-10266,0,0,0,,10266,-10266
30,07/28/2017,65,16:00,16:15,,19.48,0,19.48,19.48,-1,-69694,94147,163841,24453,0,-12503,0,0,0,,12503,-12503
30,07/28/2017,66,16:15,16:30,,7.76,0,7.76,7.76,-1,-66811,108372,175183,41561,0,-45299,0,0,0,,45299,-45299
30,07/28/2017,67,16:30,16:45,,21.49,0,21.49,21.49,-1,-72221,107150,179371,34929,0,-34990,0,0,0,,34990,-34990
30,07/28/2017,68,16:45,17:00,,17.64,0,17.64,17.64,-1,-84258,110157,194415,25899,0,-29310,0,0,0,,29310,-29310
30,07/28/2017,69,17:00,17:15,30.89,-98.51,0,30.89,-98.51,2,-84151,111993,196144,27842,0,-33151,96,0,0,,33247,-33055
30,07/28/2017,70,17:15,17:30,30.37,-98.51,0,30.37,30.37,1,-81895,110990,192885,29095,0,-2499,718,0,0,,3217,-1781
30,07/28/2017,71,17:30,17:45,,,0,27.02,27.02,0,-74296,118288,192584,43992,0,0,0,0,0,,0,0
30,07/28/2017,72,17:45,18:00,,,0,27.01,27.01,0,-75677,102837,178514,27160,0,0,0,0,0,,0,0
30,07/28/2017,73,18:00,18:15,,21.49,0,21.49,21.49,-1,-91626,109374,201000,17748,0,-6122,0,0,0,,6122,-6122
30,07/28/2017,74,18:15,18:30,,25.78,0,25.78,25.78,-1,-79712,91302,171014,11590,0,-9457,0,0,0,,9457,-9457
30,07/28/2017,75,18:30,18:45,,,0,34.63,34.63,0,-91051,90543,181594,-508,0,-1679,0,0,0,,1679,-1679
30,07/28/2017,76,18:45,19:00,36.26,,0,36.26,36.26,1,-90723,65909,156632,-24814,0,0,5896,0,0,,5896,5896
30,07/28/2017,77,19:00,19:15,36.26,3.68,0,3.68,3.68,-1,-46286,95935,142221,49649,0,-13742,722,0,0,,14464,-13020
30,07/28/2017,78,19:15,19:30,,0.78,0,0.78,0.78,-1,-65375,96363,161738,30988,0,-44245,0,0,0,,44245,-44245
30,07/28/2017,79,19:30,19:45,,,0,34.84,34.84,0,-63486,81194,144680,17708,0,-5942,0,0,0,,5942,-5942
30,07/28/2017,80,19:45,20:00,,,0,34.42,34.42,0,-58065,71309,129374,13244,0,0,0,0,0,,0,0
30,07/28/2017,81,20:00,20:15,,,0,34.32,34.32,0,-43359,106899,150258,63540,0,0,0,0,0,,0,0
30,07/28/2017,82,20:15,20:30,,,0,34.37,34.37,0,-40125,91722,131847,51597,0,0,0,0,0,,0,0
30,07/28/2017,83,20:30,20:45,,23.22,0,23.22,23.22,-1,-48165,100187,148352,52022,0,-2200,0,0,0,,2200,-2200
30,07/28/2017,84,20:45,21:00,,21.49,0,21.49,21.49,-1,-63718,101690,165408,37972,0,-8216,0,0,0,,8216,-8216
30,07/28/2017,85,21:00,21:15,,25.78,0,25.78,25.78,-1,-75284,97718,173002,22434,0,-9096,0,0,0,,9096,-9096
30,07/28/2017,86,21:15,21:30,,25.78,0,25.78,25.78,-1,-67631,92536,160167,24905,0,-4294,0,0,0,,4294,-4294
30,07/28/2017,87,21:30,21:45,,,0,34.39,34.39,0,-74445,80836,155281,6391,0,-967,0,0,0,,967,-967
30,07/28/2017,88,21:45,22:00,,27.39,0,27.39,27.39,-1,-86981,82187,169168,-4794,0,-29,0,0,0,,29,-29
30,07/28/2017,89,22:00,22:15,,26.22,0,26.22,26.22,-1,-59369,82646,142015,23277,0,-1361,0,0,0,,1361,-1361
30,07/28/2017,90,22:15,22:30,,18.82,0,18.82,18.82,-1,-54641,74516,129157,19875,0,-12413,0,0,0,,12413,-12413
30,07/28/2017,91,22:30,22:45,,24.18,0,24.18,24.18,-1,-55756,75192,130948,19436,0,-24183,0,0,0,,24183,-24183
30,07/28/2017,92,22:45,23:00,,25.49,0,25.49,25.49,-1,-64980,68853,133833,3873,0,-16996,0,0,0,,16996,-16996
30,07/28/2017,93,23:00,23:15,28.16,25.49,0,28.16,28.16,1,-87531,63333,150864,-24198,0,-8526,101,0,0,,8627,-8425
30,07/28/2017,94,23:15,23:30,28.21,25.49,0,28.21,28.21,1,-87383,52891,140274,-34492,0,-106,1747,0,0,,1853,1641
30,07/28/2017,95,23:30,23:45,26.49,,0,26.49,26.49,1,-68441,54815,123256,-13626,0,0,284,0,0,,284,284
30,07/28/2017,96,23:45,0:00,,,0,34.39,34.39,0,-103625,88049,191674,-15576,0,0,0,0,0,,0,0
31,07/29/2017,1,0:00,0:15,28.26,,0,28.26,28.26,1,-137510,108619,246129,-28891,0,0,456,0,0,,456,456
31,07/29/2017,2,0:15,0:30,,,0,26.06,26.06,0,-92807,74674,167481,-18133,0,0,2,0,0,,2,2
31,07/29/2017,3,0:30,0:45,,,0,26.06,26.06,0,-73124,46964,120088,-26160,0,0,0,0,0,,0,0
31,07/29/2017,4,0:45,1:00,,25.78,0,25.78,25.78,-1,-75467,46518,121985,-28949,0,-70,0,0,0,,70,-70
31,07/29/2017,5,1:00,1:15,,24.78,0,24.78,24.78,-1,-90662,86998,177660,-3664,0,-635,0,0,0,,635,-635
31,07/29/2017,6,1:15,1:30,,,0,34.87,34.87,0,-44770,26096,70866,-18674,0,0,0,0,0,,0,0
31,07/29/2017,7,1:30,1:45,,,0,34.87,34.87,0,-43585,18705,62290,-24880,0,0,0,0,0,,0,0
31,07/29/2017,8,1:45,2:00,,26.57,0,26.57,26.57,-1,-58938,39930,98868,-19008,0,-262,0,0,0,,262,-262
31,07/29/2017,9,2:00,2:15,27.78,25.78,0,34.84,25.78,2,-68189,65214,133403,-2975,0,-493,456,0,0,,949,-37
31,07/29/2017,10,2:15,2:30,25.78,21.15,0,21.15,21.15,-1,-36073,49753,85826,13680,0,-1629,272,0,0,,1901,-1357
31,07/29/2017,11,2:30,2:45,,-20.67,0,-20.67,-20.67,-1,-24672,59321,83993,34649,0,-33764,0,0,0,,33764,-33764
31,07/29/2017,12,2:45,3:00,,15.69,0,15.69,15.69,-1,-28843,51517,80360,22674,0,-36975,0,0,0,,36975,-36975
31,07/29/2017,13,3:00,3:15,31.78,15.69,0,31.78,31.78,1,-71280,59569,130849,-11711,0,-6083,334,0,0,,6417,-5749
31,07/29/2017,14,3:15,3:30,,,0,34.83,34.83,0,-48261,57960,106221,9699,0,0,0,0,0,,0,0
31,07/29/2017,15,3:30,3:45,,17.75,0,17.75,17.75,-1,-28652,62233,90885,33581,0,-9100,0,0,0,,9100,-9100
31,07/29/2017,16,3:45,4:00,,17.75,0,17.75,17.75,-1,-29698,66830,96528,37132,0,-23884,0,0,0,,23884,-23884
31,07/29/2017,17,4:00,4:15,,23.03,0,23.03,23.03,-1,-45975,50167,96142,4192,0,-12089,0,0,0,,12089,-12089
31,07/29/2017,18,4:15,4:30,,,0,35.69,35.69,0,-38725,60736,99461,22011,0,-19,0,0,0,,19,-19
31,07/29/2017,19,4:30,4:45,,,0,35.69,35.69,0,-28185,60028,88213,31843,0,0,0,0,0,,0,0
31,07/29/2017,20,4:45,5:00,,,0,35.69,35.69,0,-28461,66698,95159,38237,0,0,0,0,0,,0,0
31,07/29/2017,21,5:00,5:15,26.09,,0,26.09,26.09,1,-38242,58822,97064,20580,0,0,1,0,0,,1,1
31,07/29/2017,22,5:15,5:30,,,0,35.68,35.68,0,-37486,63327,100813,25841,0,0,0,0,0,,0,0
31,07/29/2017,23,5:30,5:45,,,0,35.68,35.68,0,-32356,44950,77306,12594,0,0,0,0,0,,0,0
31,07/29/2017,24,5:45,6:00,,,0,35.68,35.68,0,-20054,47354,67408,27300,0,0,0,0,0,,0,0
31,07/29/2017,25,6:00,6:15,,,0,34.81,34.81,0,-23711,55002,78713,31291,0,0,0,0,0,,0,0
31,07/29/2017,26,6:15,6:30,,,0,34.81,34.81,0,-46966,55123,102089,8157,0,0,0,0,0,,0,0
31,07/29/2017,27,6:30,6:45,,,0,34.81,34.81,0,-58319,42617,100936,-15702,0,0,0,0,0,,0,0
31,07/29/2017,28,6:45,7:00,25.51,,0,25.51,25.51,1,-87931,51139,139070,-36792,0,0,351,0,0,,351,351
31,07/29/2017,29,7:00,7:15,27.51,,0,27.51,27.51,1,-43799,57295,101094,13496,0,0,596,0,0,,596,596
31,07/29/2017,30,7:15,7:30,27.51,,0,27.51,27.51,1,-52124,59505,111629,7381,0,0,608,0,0,,608,608
31,07/29/2017,31,7:30,7:45,25.57,,0,25.57,25.57,1,-49388,60039,109427,10651,0,0,722,0,0,,722,722
31,07/29/2017,32,7:45,8:00,27.51,,0,27.51,27.51,1,-60572,64622,125194,4050,0,0,1063,0,0,,1063,1063
31,07/29/2017,33,8:00,8:15,,24.51,0,24.51,24.51,-1,-50328,98573,148901,48245,0,-463,0,0,0,,463,-463
31,07/29/2017,34,8:15,8:30,,,0,26.24,26.24,0,-54340,70514,124854,16174,0,0,0,0,0,,0,0
31,07/29/2017,35,8:30,8:45,27.51,,0,27.51,27.51,1,-57521,57135,114656,-386,0,0,23,0,0,,23,23
31,07/29/2017,36,8:45,9:00,30.34,,0,30.34,30.34,1,-72937,75448,148385,2511,0,0,1022,0,0,,1022,1022
31,07/29/2017,37,9:00,9:15,,,0,26.24,26.24,0,-92069,74000,166069,-18069,0,0,0,0,0,,0,0
31,07/29/2017,38,9:15,9:30,33.46,,0,33.46,33.46,1,-100519,45284,145803,-55235,0,0,5316,0,0,,5316,5316
31,07/29/2017,39,9:30,9:45,51.85,,0,51.85,51.85,1,-95888,23915,119803,-71973,0,0,16903,0,0,,16903,16903
31,07/29/2017,40,9:45,10:00,61.21,,0,61.21,61.21,1,-115688,42771,158459,-72917,0,0,47227,0,0,,47227,47227
31,07/29/2017,41,10:00,10:15,51.85,,0,51.85,51.85,1,-95500,65117,160617,-30383,0,0,33044,0,0,,33044,33044
31,07/29/2017,42,10:15,10:30,37.51,,0,37.51,37.51,1,-103001,77055,180056,-25946,0,0,7914,0,0,,7914,7914
31,07/29/2017,43,10:30,10:45,38.85,,0,38.85,38.85,1,-109147,88175,197322,-20972,0,0,10186,0,0,,10186,10186
31,07/29/2017,44,10:45,11:00,33.09,,0,33.09,33.09,1,-120155,91085,211240,-29070,0,0,6834,0,0,,6834,6834
31,07/29/2017,45,11:00,11:15,117.02,,0,117.02,117.02,1,-96479,43399,139878,-53080,0,0,37294,0,0,,37294,37294
31,07/29/2017,46,11:15,11:30,31.5,,0,31.5,31.5,1,-93118,70251,163369,-22867,0,0,21082,0,0,,21082,21082
31,07/29/2017,47,11:30,11:45,31.51,,0,31.51,31.51,1,-87528,56505,144033,-31023,0,0,16388,0,0,,16388,16388
31,07/29/2017,48,11:45,12:00,62.35,,0,62.35,62.35,1,-105572,64217,169789,-41355,0,0,33001,0,0,,33001,33001
31,07/29/2017,49,12:00,12:15,31.51,14.1,0,14.1,14.1,-1,-76294,85916,162210,9622,0,-2700,15245,0,0,,17945,12545
31,07/29/2017,50,12:15,12:30,31.51,5.18,0,5.18,5.18,-1,-74317,77755,152072,3438,0,-12542,355,0,0,,12897,-12187
31,07/29/2017,51,12:30,12:45,27.17,25.15,0,27.17,25.15,2,-69256,76099,145355,6843,0,-321,133,0,0,,454,-188
31,07/29/2017,52,12:45,13:00,,25.29,0,25.29,25.29,-1,-72934,72865,145799,-69,0,-1065,0,0,0,,1065,-1065
31,07/29/2017,53,13:00,13:15,,16.03,0,16.03,16.03,-1,-50566,76419,126985,25853,0,-13007,0,0,0,,13007,-13007
31,07/29/2017,54,13:15,13:30,,19.89,0,19.89,19.89,-1,-40234,76052,116286,35818,0,-28391,0,0,0,,28391,-28391
31,07/29/2017,55,13:30,13:45,,17.29,0,17.29,17.29,-1,-45752,60449,106201,14697,0,-30163,0,0,0,,30163,-30163
31,07/29/2017,56,13:45,14:00,28.59,24.51,0,28.59,24.51,2,-49740,53139,102879,3399,0,-6340,1085,0,0,,7425,-5255
31,07/29/2017,57,14:00,14:15,38.4,24.51,0,38.4,38.4,1,-61310,39991,101301,-21319,0,-282,4131,0,0,,4413,3849
31,07/29/2017,58,14:15,14:30,38.4,,0,38.4,38.4,1,-65606,36757,102363,-28849,0,0,21495,0,0,,21495,21495
31,07/29/2017,59,14:30,14:45,28.59,,0,28.59,28.59,1,-77800,58656,136456,-19144,0,0,9651,0,0,,9651,9651
31,07/29/2017,60,14:45,15:00,31.51,,0,31.51,31.51,1,-84340,67447,151787,-16893,0,0,13200,0,0,,13200,13200
31,07/29/2017,61,15:00,15:15,31.51,20.51,0,20.51,20.51,-1,-37765,91821,129586,54056,0,-4489,2847,0,0,,7336,-1642
31,07/29/2017,62,15:15,15:30,,,0,26.23,26.23,0,-50810,60218,111028,9408,0,-330,0,0,0,,330,-330
31,07/29/2017,63,15:30,15:45,45.35,,0,45.35,45.35,1,-65635,40644,106279,-24991,0,0,7712,0,0,,7712,7712
31,07/29/2017,64,15:45,16:00,72.22,,0,72.22,72.22,1,-85012,49745,134757,-35267,0,0,37890,0,0,,37890,37890
31,07/29/2017,65,16:00,16:15,72.22,-38.06,0,-38.06,-38.06,-1,-28694,100856,129550,72162,0,-14255,7950,0,0,,22205,-6305
31,07/29/2017,66,16:15,16:30,,20.51,0,20.51,20.51,-1,-32690,90428,123118,57738,0,-13996,0,0,0,,13996,-13996
31,07/29/2017,67,16:30,16:45,31.51,20.51,0,31.51,31.51,1,-46299,46268,92567,-31,0,-440,901,0,0,,1341,461
31,07/29/2017,68,16:45,17:00,48.39,,0,48.39,48.39,1,-82212,30704,112916,-51508,0,0,31942,0,0,,31942,31942
31,07/29/2017,69,17:00,17:15,39.9,-1.03,0,-1.03,-1.03,-1,-56280,67556,123836,11276,0,-3772,20751,0,0,,24523,16979
31,07/29/2017,70,17:15,17:30,41.29,-6.03,0,41.29,41.29,1,-89949,33161,123110,-56788,0,-7700,1664,0,0,,9364,-6036
31,07/29/2017,71,17:30,17:45,47.79,,0,47.79,47.79,1,-93523,34414,127937,-59109,0,0,11619,0,0,,11619,11619
31,07/29/2017,72,17:45,18:00,117.02,,0,117.02,117.02,1,-116381,37990,154371,-78391,0,0,33437,0,0,,33437,33437
31,07/29/2017,73,18:00,18:15,54.7,,0,54.7,54.7,1,-94217,37226,131443,-56991,0,0,27213,0,0,,27213,27213
31,07/29/2017,74,18:15,18:30,37.51,,0,37.51,37.51,1,-81173,33979,115152,-47194,0,0,1024,0,0,,1024,1024
31,07/29/2017,75,18:30,18:45,145.42,,0,145.42,145.42,1,-91468,28937,120405,-62531,0,0,18590,0,0,,18590,18590
31,07/29/2017,76,18:45,19:00,37.51,,0,37.51,37.51,1,-83880,40552,124432,-43328,0,0,37728,0,0,,37728,37728
31,07/29/2017,77,19:00,19:15,146.9,,0,146.9,146.9,1,-127614,25971,153585,-101643,0,0,47307,0,0,,47307,47307
31,07/29/2017,78,19:15,19:30,64.42,,0,64.42,64.42,1,-94361,40927,135288,-53434,0,0,50504,0,0,,50504,50504
31,07/29/2017,79,19:30,19:45,42.4,,0,42.4,42.4,1,-82334,43590,125924,-38744,0,0,41109,0,0,,41109,41109
31,07/29/2017,80,19:45,20:00,33.64,,0,33.64,33.64,1,-76023,53164,129187,-22859,0,0,26774,0,0,,26774,26774
31,07/29/2017,81,20:00,20:15,196.65,,0,196.65,196.65,1,-111374,40571,151945,-70803,0,0,38764,0,0,,38764,38764
31,07/29/2017,82,20:15,20:30,67.02,,0,67.02,67.02,1,-112808,54902,167710,-57906,0,0,47141,0,0,,47141,47141
31,07/29/2017,83,20:30,20:45,51.43,,0,51.43,51.43,1,-107537,57229,164766,-50308,0,0,45748,0,0,,45748,45748
31,07/29/2017,84,20:45,21:00,58.19,,0,58.19,58.19,1,-114709,62338,177047,-52371,0,0,45034,0,0,,45034,45034
31,07/29/2017,85,21:00,21:15,54.2,,0,54.2,54.2,1,-106391,73001,179392,-33390,0,0,31399,0,0,,31399,31399
31,07/29/2017,86,21:15,21:30,263.11,,0,263.11,263.11,1,-113976,52075,166051,-61901,0,0,21677,0,0,,21677,21677
31,07/29/2017,87,21:30,21:45,263.11,,0,263.11,263.11,1,-134932,51412,186344,-83520,0,0,74304,0,0,,74304,74304
31,07/29/2017,88,21:45,22:00,129.02,,0,129.02,129.02,1,-144147,67592,211739,-76555,0,0,60913,0,0,,60913,60913
31,07/29/2017,89,22:00,22:15,27.15,26.29,0,27.15,26.2,2,-104183,96016,200199,-8167,0,-99,5440,0,0,,5539,5341
31,07/29/2017,90,22:15,22:30,27.16,,0,27.16,27.16,1,-96682,67055,163737,-29627,0,0,911,0,0,,911,911
31,07/29/2017,91,22:30,22:45,27.22,,0,27.22,27.22,1,-92694,50046,142740,-42648,0,0,406,0,0,,406,406
31,07/29/2017,92,22:45,23:00,25.51,,0,25.51,25.51,1,-97341,42120,139461,-55221,0,0,171,0,0,,171,171
31,07/29/2017,93,23:00,23:15,37.51,,0,37.51,37.51,1,-148012,53559,201571,-94453,0,0,3705,0,0,,3705,3705
31,07/29/2017,94,23:15,23:30,40.02,,0,40.02,40.02,1,-127858,26918,154776,-100940,0,0,14969,0,0,,14969,14969
31,07/29/2017,95,23:30,23:45,59.02,,0,59.02,59.02,1,-157431,29115,186546,-128316,0,0,17783,0,0,,17783,17783
31,07/29/2017,96,23:45,0:00,37.51,,0,37.51,37.51,1,-113887,31127,145014,-82760,0,0,20512,0,0,,20512,20512
31,07/30/2017,1,0:00,0:15,116.12,,0,116.12,116.12,1,-183072,72272,255344,-110800,0,0,16983,0,0,,16983,16983
31,07/30/2017,2,0:15,0:30,116.12,,0,116.12,116.12,1,-168113,58211,226324,-109902,0,0,50123,0,0,,50123,50123
31,07/30/2017,3,0:30,0:45,116.12,,0,116.12,116.12,1,-193429,54266,247695,-139163,0,0,22669,0,0,,22669,22669
31,07/30/2017,4,0:45,1:00,116.12,,0,116.12,116.12,1,-201427,53536,254963,-147891,0,0,67486,0,0,,67486,67486
31,07/30/2017,5,1:00,1:15,115.12,,0,115.12,115.12,1,-249146,89751,338897,-159395,0,0,79660,0,0,,79660,79660
31,07/30/2017,6,1:15,1:30,176.48,,0,176.48,176.48,1,-205482,114157,319639,-91325,0,0,89199,2500,0,,91699,91699
31,07/30/2017,7,1:30,1:45,126.48,24.03,0,126.48,24.03,2,-122694,145838,268532,23144,0,-243,24025,1250,0,,25518,25032
31,07/30/2017,8,1:45,2:00,83.97,26.98,0,83.97,83.97,1,-115890,79391,195281,-36499,0,-86,5260,0,0,,5346,5174
31,07/30/2017,9,2:00,2:15,115.12,,0,115.12,115.12,1,-191385,62053,253438,-129332,0,0,68293,0,0,,68293,68293
31,07/30/2017,10,2:15,2:30,115.12,,0,115.12,115.12,1,-163494,66941,230435,-96553,0,0,86994,0,0,,86994,86994
31,07/30/2017,11,2:30,2:45,53.12,,0,53.12,53.12,1,-162474,89729,252203,-72745,0,0,66959,0,0,,66959,66959
31,07/30/2017,12,2:45,3:00,162.87,,0,162.87,162.87,1,-150386,64762,215148,-85624,0,0,54648,0,0,,54648,54648
31,07/30/2017,13,3:00,3:15,162.87,,0,162.87,162.87,1,-173454,103574,277028,-69880,0,0,67702,0,0,,67702,67702
31,07/30/2017,14,3:15,3:30,70.12,,0,70.12,70.12,1,-152686,95951,248637,-56735,0,0,57163,0,0,,57163,57163
31,07/30/2017,15,3:30,3:45,52.12,,0,52.12,52.12,1,-147495,88469,235964,-59026,0,0,36533,0,0,,36533,36533
31,07/30/2017,16,3:45,4:00,235.01,,0,235.01,235.01,1,-151341,79959,231300,-71382,0,0,55007,0,0,,55007,55007
31,07/30/2017,17,4:00,4:15,30.93,23.73,0,30.93,23.73,2,-130718,104308,235026,-26410,0,-324,11359,0,0,,11683,11035
31,07/30/2017,18,4:15,4:30,235.01,,0,235.01,235.01,1,-149818,53128,202946,-96690,0,0,39445,0,0,,39445,39445
31,07/30/2017,19,4:30,4:45,30.04,26.91,0,26.91,26.91,-1,-89670,65777,155447,-23893,0,-2,19715,0,0,,19717,19713
31,07/30/2017,20,4:45,5:00,32.03,26.96,0,32.03,26.04,2,-77423,49264,126687,-28159,0,-196,534,0,0,,730,338
31,07/30/2017,21,5:00,5:15,235.01,,0,235.01,235.01,1,-159051,73634,232685,-85417,0,0,39205,0,0,,39205,39205
31,07/30/2017,22,5:15,5:30,41.03,,0,41.03,41.03,1,-120747,96223,216970,-24524,0,0,24024,0,0,,24024,24024
31,07/30/2017,23,5:30,5:45,28.27,,0,28.27,28.27,1,-113005,78732,191737,-34273,0,0,801,0,0,,801,801
31,07/30/2017,24,5:45,6:00,,,0,26.07,26.07,0,-83488,70275,153763,-13213,0,0,0,0,0,,0,0
31,07/30/2017,25,6:00,6:15,181.03,,0,181.03,181.03,1,-127421,62175,189596,-65246,0,0,11045,0,0,,11045,11045
31,07/30/2017,26,6:15,6:30,41.03,,0,41.03,41.03,1,-76191,77616,153807,1425,0,0,17309,0,0,,17309,17309
31,07/30/2017,27,6:30,6:45,41.03,27.24,0,27.24,27.24,-1,-75325,77436,152761,2111,0,-129,193,0,0,,322,64
31,07/30/2017,28,6:45,7:00,27.89,,0,27.89,27.89,1,-74032,82338,156370,8306,0,0,29,0,0,,29,29
31,07/30/2017,29,7:00,7:15,30.61,,0,30.61,30.61,1,-121577,58660,180237,-62917,0,0,323,0,0,,323,323
31,07/30/2017,30,7:15,7:30,31.96,,0,31.96,31.96,1,-125008,64573,189581,-60435,0,0,677,0,0,,677,677
31,07/30/2017,31,7:30,7:45,27.9,,0,27.9,27.9,1,-91802,69450,161252,-22352,0,0,1519,0,0,,1519,1519
31,07/30/2017,32,7:45,8:00,,,0,27.37,27.37,0,-86261,92239,178500,5978,0,0,101,0,0,,101,101
31,07/30/2017,33,8:00,8:15,,,0,27.44,27.44,0,-62538,72678,135216,10140,0,0,0,0,0,,0,0
31,07/30/2017,34,8:15,8:30,,,0,27.44,27.44,0,-62112,81928,144040,19816,0,0,0,0,0,,0,0
31,07/30/2017,35,8:30,8:45,,,0,27.44,27.44,0,-77480,76227,153707,-1253,0,0,0,0,0,,0,0
31,07/30/2017,36,8:45,9:00,,,0,27.44,27.44,0,-82031,80789,162820,-1242,0,0,0,0,0,,0,0
31,07/30/2017,37,9:00,9:15,234.34,,0,234.34,234.34,1,-112847,20945,133792,-91902,0,0,12056,0,0,,12056,12056
31,07/30/2017,38,9:15,9:30,234.34,,0,234.34,234.34,1,-77630,50669,128299,-26961,0,0,43875,0,0,,43875,43875
31,07/30/2017,39,9:30,9:45,234.34,25.78,0,25.78,25.78,-1,-61486,88986,150472,27500,0,-726,4970,0,0,,5696,4244
31,07/30/2017,40,9:45,10:00,,25.48,0,25.48,25.48,-1,-81617,84867,166484,3250,0,-1163,0,0,0,,1163,-1163
31,07/30/2017,41,10:00,10:15,41.03,25.48,0,41.03,41.03,1,-74300,50650,124950,-23650,0,-31,3971,0,0,,4002,3940
31,07/30/2017,42,10:15,10:30,27.53,21.03,0,27.53,21.03,2,-63455,55102,118557,-8353,0,-1879,493,0,0,,2372,-1386
31,07/30/2017,43,10:30,10:45,32.03,,0,32.03,32.03,1,-54985,46098,101083,-8887,0,0,3051,0,0,,3051,3051
31,07/30/2017,44,10:45,11:00,32.03,,0,32.03,32.03,1,-65370,61749,127119,-3621,0,0,4960,0,0,,4960,4960
31,07/30/2017,45,11:00,11:15,32.03,-19.78,0,-19.78,-19.78,-1,-51080,81524,132604,30444,0,-14495,1382,0,0,,15877,-13113
31,07/30/2017,46,11:15,11:30,,26.26,0,26.26,26.26,-1,-49129,63050,112179,13921,0,-3768,0,0,0,,3768,-3768
31,07/30/2017,47,11:30,11:45,41.03,21.03,0,41.03,21.03,2,-76143,50763,126906,-25380,0,-2675,2029,0,0,,4704,-646
31,07/30/2017,48,11:45,12:00,47.03,25.21,0,47.03,25.21,2,-79317,52797,132114,-26520,0,-302,12537,0,0,,12839,12235
31,07/30/2017,49,12:00,12:15,41.03,17.03,0,41.03,17.03,2,-60182,70161,130343,9979,0,-2544,1776,0,0,,4320,-768
31,07/30/2017,50,12:15,12:30,112.48,12.66,0,112.48,12.66,2,-77293,49198,126491,-28095,0,-5806,6062,0,0,,11868,256
31,07/30/2017,51,12:30,12:45,234.18,,0,234.18,234.18,1,-74790,60796,135586,-13994,0,0,37807,0,0,,37807,37807
31,07/30/2017,52,12:45,13:00,234.18,17.03,0,17.03,17.03,-1,-64525,75099,139624,10574,0,-7544,2101,0,0,,9645,-5443
31,07/30/2017,53,13:00,13:15,,19.78,0,19.78,19.78,-1,-48584,56312,104896,7728,0,-12859,0,0,0,,12859,-12859
31,07/30/2017,54,13:15,13:30,47.03,19.78,0,47.03,47.03,1,-65333,41238,106571,-24095,0,-3272,7822,0,0,,11094,4550
31,07/30/2017,55,13:30,13:45,28.17,-200,0,-200,-200,-1,-38529,72012,110541,33483,0,-12802,3000,0,0,,15802,-9802
31,07/30/2017,56,13:45,14:00,183.35,-200,0,183.35,-200,2,-101257,53773,155030,-47484,0,-22826,6079,0,0,,28905,-16747
31,07/30/2017,57,14:00,14:15,32.37,,0,32.37,32.37,1,-75177,61241,136418,-13936,0,0,5467,0,0,,5467,5467
31,07/30/2017,58,14:15,14:30,181.03,,0,181.03,181.03,1,-82752,37203,119955,-45549,0,0,18736,0,0,,18736,18736
31,07/30/2017,59,14:30,14:45,41.03,-200,0,-200,-200,-1,-37748,66660,104408,28912,0,-6496,11441,0,0,,17937,4945
31,07/30/2017,60,14:45,15:00,47.03,-200,0,47.03,-200,2,-85580,76306,161886,-9274,0,-22140,1434,0,0,,23574,-20706
31,07/30/2017,61,15:00,15:15,47.03,-200,0,-200,-200,-1,-61093,118549,179642,57456,0,-25161,51,0,0,,25212,-25110
31,07/30/2017,62,15:15,15:30,,5.07,0,5.07,5.07,-1,-77276,120130,197406,42854,0,-30882,0,0,0,,30882,-30882
31,07/30/2017,63,15:30,15:45,,17.03,0,17.03,17.03,-1,-88718,114755,203473,26037,0,-34286,0,0,0,,34286,-34286
31,07/30/2017,64,15:45,16:00,47.03,21.03,0,47.03,21.03,2,-99815,83427,183242,-16388,0,-16637,1434,0,0,,18071,-15203
31,07/30/2017,65,16:00,16:15,47.03,-200,0,-200,-200,-1,-27208,262543,289751,235335,0,-49478,6,0,0,,49484,-49472
31,07/30/2017,66,16:15,16:30,,-200,0,-300,-300,-1,-78148,213646,291794,135498,0,-82355,0,0,0,-11670,94025,-94025
31,07/30/2017,67,16:30,16:45,,-13.14,0,-230.1,-230.1,-1,-99187,196398,295585,97211,0,-61672,0,0,0,-19230,80902,-80902
31,07/30/2017,68,16:45,17:00,,-20.78,0,-230.1,-230.1,-1,-74629,177364,251993,102735,0,-54513,0,0,0,-24349,78862,-78862
31,07/30/2017,69,17:00,17:15,32.03,22.03,0,32.03,-226.29,2,-67109,114328,181437,47219,0,-16391,345,0,0,-37689,54425,-53735
31,07/30/2017,70,17:15,17:30,78.06,-200,0,78.06,-300,2,-63081,94672,157753,31591,0,-15049,929,0,0,-31019,46997,-45139
31,07/30/2017,71,17:30,17:45,78.06,22.03,0,78.06,-226.29,2,-46111,91542,137653,45431,0,-1236,1146,0,0,-19290,21672,-19380
31,07/30/2017,72,17:45,18:00,,-25.78,0,-25.78,-25.78,-1,-32245,64591,96836,32346,0,-10611,0,0,0,,10611,-10611
31,07/30/2017,73,18:00,18:15,74.12,-29.67,0,74.12,-29.67,2,-117318,109657,226975,-7661,0,-11057,2817,0,0,,13874,-8240
31,07/30/2017,74,18:15,18:30,,-98.97,0,-98.97,-98.97,-1,-70238,118901,189139,48663,0,-24420,0,0,0,,24420,-24420
31,07/30/2017,75,18:30,18:45,,22.03,0,22.03,22.03,-1,-63194,103169,166363,39975,0,-12558,0,0,0,,12558,-12558
31,07/30/2017,76,18:45,19:00,32.03,22.03,0,32.03,32.03,1,-48816,90565,139381,41749,0,-198,131,0,0,,329,-67
31,07/30/2017,77,19:00,19:15,41.03,,0,41.03,41.03,1,-151222,96482,247704,-54740,0,0,3431,0,0,,3431,3431
31,07/30/2017,78,19:15,19:30,27.57,,0,27.57,27.57,1,-103515,102329,205844,-1186,0,0,331,0,0,,331,331
31,07/30/2017,79,19:30,19:45,27.57,,0,27.57,27.57,1,-59905,75046,134951,15141,0,0,273,0,0,,273,273
31,07/30/2017,80,19:45,20:00,47.03,,0,47.03,47.03,1,-70328,56418,126746,-13910,0,0,2816,0,0,,2816,2816
31,07/30/2017,81,20:00,20:15,110.62,,0,110.62,110.62,1,-97483,60916,158399,-36567,0,0,27239,0,0,,27239,27239
31,07/30/2017,82,20:15,20:30,110.62,25.87,0,25.87,25.87,-1,-42647,83633,126280,40986,0,-663,6284,0,0,,6947,5621
31,07/30/2017,83,20:30,20:45,,26.41,0,26.41,26.41,-1,-41324,123603,164927,82279,0,-491,0,0,0,,491,-491
31,07/30/2017,84,20:45,21:00,,26.41,0,26.41,26.41,-1,-34659,117981,152640,83322,0,-1426,0,0,0,,1426,-1426
31,07/30/2017,85,21:00,21:15,,27.13,0,27.13,27.13,-1,-33643,82542,116185,48899,0,-923,0,0,0,,923,-923
31,07/30/2017,86,21:15,21:30,,,0,27.44,27.44,0,-41073,73952,115025,32879,0,0,0,0,0,,0,0
31,07/30/2017,87,21:30,21:45,,,0,27.44,27.44,0,-53198,60375,113573,7177,0,0,0,0,0,,0,0
31,07/30/2017,88,21:45,22:00,50.93,,0,50.93,50.93,1,-83564,45696,129260,-37868,0,0,10453,0,0,,10453,10453
31,07/30/2017,89,22:00,22:15,81.8,,0,81.8,81.8,1,-87540,18393,105933,-69147,0,0,28148,0,0,,28148,28148
31,07/30/2017,90,22:15,22:30,41.67,,0,41.67,41.67,1,-98713,22900,121613,-75813,0,0,25334,0,0,,25334,25334
31,07/30/2017,91,22:30,22:45,92.43,,0,92.43,92.43,1,-103588,42456,146044,-61132,0,0,28651,0,0,,28651,28651
31,07/30/2017,92,22:45,23:00,48.12,,0,48.12,48.12,1,-91693,56479,148172,-35214,0,0,32135,0,0,,32135,32135
31,07/30/2017,93,23:00,23:15,267.72,,0,267.72,267.72,1,-119681,46786,166467,-72895,0,0,25746,0,0,,25746,25746
31,07/30/2017,94,23:15,23:30,53.12,,0,53.12,53.12,1,-92157,54632,146789,-37525,0,0,27874,0,0,,27874,27874
31,07/30/2017,95,23:30,23:45,53.12,26.41,0,26.41,26.41,-1,-58045,57909,115954,-136,0,-30,427,0,0,,457,397
31,07/30/2017,96,23:45,0:00,,22.03,0,22.03,22.03,-1,-43642,54210,97852,10568,0,-1505,0,0,0,,1505,-1505
31,07/31/2017,1,0:00,0:15,106.02,22.03,0,106.02,106.02,1,-68300,24617,92917,-43683,0,-9,14265,0,0,,14274,14256
31,07/31/2017,2,0:15,0:30,32.04,25.57,0,25.57,25.57,-1,-45686,39458,85144,-6228,0,-94,16859,0,0,,16953,16765
31,07/31/2017,3,0:30,0:45,32.04,24.82,0,24.82,24.82,-1,-25260,60830,86090,35570,0,-3589,211,0,0,,3800,-3378
31,07/31/2017,4,0:45,1:00,,14.61,0,14.61,14.61,-1,-22744,86861,109605,64117,0,-21896,0,0,0,,21896,-21896
31,07/31/2017,5,1:00,1:15,,21.04,0,21.04,21.04,-1,-31292,64524,95816,33232,0,-15259,0,0,0,,15259,-15259
31,07/31/2017,6,1:15,1:30,,24.17,0,24.17,24.17,-1,-19476,48505,67981,29029,0,-298,0,0,0,,298,-298
31,07/31/2017,7,1:30,1:45,,21.04,0,21.04,21.04,-1,-29898,66237,96135,36339,0,-11384,0,0,0,,11384,-11384
31,07/31/2017,8,1:45,2:00,,-150.03,0,-150.03,-150.03,-1,-38059,78678,116737,40619,0,-41845,0,0,0,,41845,-41845
31,07/31/2017,9,2:00,2:15,38.04,21.04,0,38.04,38.04,1,-58958,53387,112345,-5571,0,-14328,1584,0,0,,15912,-12744
31,07/31/2017,10,2:15,2:30,48.02,,0,48.02,48.02,1,-59679,26952,86631,-32727,0,0,11133,0,0,,11133,11133
31,07/31/2017,11,2:30,2:45,48.02,27.22,0,27.22,27.22,-1,-43688,34203,77891,-9485,0,-3,204,0,0,,207,201
31,07/31/2017,12,2:45,3:00,,21.03,0,21.03,21.03,-1,-22173,47070,69243,24897,0,-12697,0,0,0,,12697,-12697
31,07/31/2017,13,3:00,3:15,,17.72,0,17.72,17.72,-1,-44315,38883,83198,-5432,0,-15187,0,0,0,,15187,-15187
31,07/31/2017,14,3:15,3:30,28.04,17.72,0,28.04,28.04,1,-50995,22101,73096,-28894,0,-2270,1167,0,0,,3437,-1103
31,07/31/2017,15,3:30,3:45,28.38,,0,28.38,28.38,1,-62171,21447,83618,-40724,0,0,1911,0,0,,1911,1911
31,07/31/2017,16,3:45,4:00,26.04,27.2,0,27.2,27.2,-1,-59891,37640,97531,-22251,0,-2,791,0,0,,793,789
31,07/31/2017,17,4:00,4:15,38.04,27.19,0,38.04,38.04,1,-77687,27032,104719,-50655,0,-73,3000,0,0,,3073,2927
31,07/31/2017,18,4:15,4:30,38.04,,0,38.04,38.04,1,-55675,33763,89438,-21912,0,0,7522,0,0,,7522,7522
31,07/31/2017,19,4:30,4:45,,,0,26.61,26.61,0,-44461,65442,109903,20981,0,0,16,0,0,,16,16
31,07/31/2017,20,4:45,5:00,28.33,,0,28.33,28.33,1,-50574,38290,88864,-12284,0,0,207,0,0,,207,207
31,07/31/2017,21,5:00,5:15,38.04,,0,38.04,38.04,1,-66510,50831,117341,-15679,0,0,8466,0,0,,8466,8466
31,07/31/2017,22,5:15,5:30,,,0,26.63,26.63,0,-30877,78343,109220,47466,0,0,107,0,0,,107,107
31,07/31/2017,23,5:30,5:45,,,0,26.61,26.61,0,-37519,79555,117074,42036,0,0,0,0,0,,0,0
31,07/31/2017,24,5:45,6:00,,,0,26.61,26.61,0,-44238,93504,137742,49266,0,0,0,0,0,,0,0
31,07/31/2017,25,6:00,6:15,,28.02,0,28.02,28.02,-1,-19386,67373,86759,47987,0,-2,0,0,0,,2,-2
31,07/31/2017,26,6:15,6:30,,-7.18,0,-7.18,-7.18,-1,-27482,73984,101466,46502,0,-23978,0,0,0,,23978,-23978
31,07/31/2017,27,6:30,6:45,,21.12,0,21.12,21.12,-1,-36690,42789,79479,6099,0,-22253,0,0,0,,22253,-22253
31,07/31/2017,28,6:45,7:00,38.15,27.9,0,38.15,27.01,2,-82560,54116,136676,-28444,0,-3244,4900,0,0,,8144,1656
31,07/31/2017,29,7:00,7:15,38.15,21.12,0,21.12,21.12,-1,-59873,67588,127461,7715,0,-6320,412,0,0,,6732,-5908
31,07/31/2017,30,7:15,7:30,,26.01,0,26.01,26.01,-1,-45634,38169,83803,-7465,0,-2860,0,0,0,,2860,-2860
31,07/31/2017,31,7:30,7:45,42.59,26.01,0,42.59,42.59,1,-60047,20949,80996,-39098,0,-17,4996,0,0,,5013,4979
31,07/31/2017,32,7:45,8:00,271.7,,0,271.7,271.7,1,-97760,40447,138207,-57313,0,0,31023,0,0,,31023,31023
31,07/31/2017,33,8:00,8:15,273.53,27.97,0,27.97,27.97,-1,-110991,105651,216642,-5340,0,-5,30224,0,0,,30229,30219
31,07/31/2017,34,8:15,8:30,32.12,26.81,0,32.12,26.81,2,-94138,93189,187327,-949,0,-243,866,0,0,,1109,623
31,07/31/2017,35,8:30,8:45,33.65,,0,33.65,33.65,1,-66469,70119,136588,3650,0,0,4620,0,0,,4620,4620
31,07/31/2017,36,8:45,9:00,28.02,,0,28.02,28.02,1,-84705,93699,178404,8994,0,0,606,0,0,,606,606
31,07/31/2017,37,9:00,9:15,,17.6,0,17.6,17.6,-1,-44863,146537,191400,101674,0,-5556,0,0,0,,5556,-5556
31,07/31/2017,38,9:15,9:30,,26.01,0,26.01,26.01,-1,-45791,143871,189662,98080,0,-3775,0,0,0,,3775,-3775
31,07/31/2017,39,9:30,9:45,,26.12,0,26.12,26.12,-1,-41103,136943,178046,95840,0,-161,0,0,0,,161,-161
31,07/31/2017,40,9:45,10:00,,19.77,0,19.77,19.77,-1,-32180,131036,163216,98856,0,-593,0,0,0,,593,-593
31,07/31/2017,41,10:00,10:15,,9.68,0,9.68,9.68,-1,-33756,124588,158344,90832,0,-2319,0,0,0,,2319,-2319
31,07/31/2017,42,10:15,10:30,,-7.63,0,-7.63,-7.63,-1,-18650,136008,154658,117358,0,-5997,0,0,0,,5997,-5997
31,07/31/2017,43,10:30,10:45,,25.12,0,25.12,25.12,-1,-19891,133724,153615,113833,0,-7683,0,0,0,,7683,-7683
31,07/31/2017,44,10:45,11:00,,25.03,0,25.03,25.03,-1,-25106,136255,161361,111149,0,-4219,0,0,0,,4219,-4219
31,07/31/2017,45,11:00,11:15,,-33.68,0,-33.68,-33.68,-1,-18024,113150,131174,95126,0,-35344,0,0,0,,35344,-35344
31,07/31/2017,46,11:15,11:30,,17.69,0,17.69,17.69,-1,-44706,100879,145585,56173,0,-40667,0,0,0,,40667,-40667
31,07/31/2017,47,11:30,11:45,,21.88,0,21.88,21.88,-1,-33472,98089,131561,64617,0,-32762,0,0,0,,32762,-32762
31,07/31/2017,48,11:45,12:00,,,0,27.05,27.05,0,-31402,105494,136896,74092,0,-7363,0,0,0,,7363,-7363
31,07/31/2017,49,12:00,12:15,32.12,,0,32.12,32.12,1,-53590,75608,129198,22018,0,0,432,0,0,,432,432
31,07/31/2017,50,12:15,12:30,28.12,,0,28.12,28.12,1,-61324,80287,141611,18963,0,0,177,0,0,,177,177
31,07/31/2017,51,12:30,12:45,28.12,,0,28.12,28.12,1,-48477,85684,134161,37207,0,0,640,0,0,,640,640
31,07/31/2017,52,12:45,13:00,26.02,,0,26.02,26.02,1,-62438,90885,153323,28447,0,0,65,0,0,,65,65
31,07/31/2017,53,13:00,13:15,,,0,27,27,0,-70409,96884,167293,26475,0,0,0,0,0,,0,0
31,07/31/2017,54,13:15,13:30,,,0,27,27,0,-43536,100228,143764,56692,0,0,0,0,0,,0,0
31,07/31/2017,55,13:30,13:45,,,0,27,27,0,-49565,99520,149085,49955,0,0,0,0,0,,0,0
31,07/31/2017,56,13:45,14:00,,,0,27,27,0,-64602,89736,154338,25134,0,0,0,0,0,,0,0
31,07/31/2017,57,14:00,14:15,,,0,27,27,0,-61912,87008,148920,25096,0,0,0,0,0,,0,0
31,07/31/2017,58,14:15,14:30,31.74,,0,31.74,31.74,1,-88039,87432,175471,-607,0,0,3242,0,0,,3242,3242
31,07/31/2017,59,14:30,14:45,28.02,,0,28.02,28.02,1,-73868,93364,167232,19496,0,0,908,0,0,,908,908
31,07/31/2017,60,14:45,15:00,,27.97,0,27.97,27.97,-1,-53937,91569,145506,37632,0,-2,0,0,0,,2,-2
31,07/31/2017,61,15:00,15:15,,28,0,28,28,-1,-34989,75674,110663,40685,0,-265,0,0,0,,265,-265
31,07/31/2017,62,15:15,15:30,,27.98,0,27.98,27.98,-1,-47983,65446,113429,17463,0,-299,0,0,0,,299,-299
31,07/31/2017,63,15:30,15:45,30.51,,0,30.51,30.51,1,-60202,41038,101240,-19164,0,0,974,0,0,,974,974
31,07/31/2017,64,15:45,16:00,29.41,,0,29.41,29.41,1,-69360,42535,111895,-26825,0,0,2410,0,0,,2410,2410
31,07/31/2017,65,16:00,16:15,26.12,,0,26.12,26.12,1,-99846,114128,213974,14282,0,0,1131,0,0,,1131,1131
31,07/31/2017,66,16:15,16:30,28.12,,0,28.12,28.12,1,-99684,106043,205727,6359,0,0,1041,0,0,,1041,1041
31,07/31/2017,67,16:30,16:45,26.12,,0,26.12,26.12,1,-99343,118130,217473,18787,0,0,162,0,0,,162,162
31,07/31/2017,68,16:45,17:00,,,0,26.97,26.97,0,-113405,104452,217857,-8953,0,0,0,0,0,,0,0
31,07/31/2017,69,17:00,17:15,,27.56,0,27.56,27.56,-1,-76446,178269,254715,101823,0,-484,0,0,0,,484,-484
31,07/31/2017,70,17:15,17:30,,27.1,0,27.1,27.1,-1,-66420,181101,247521,114681,0,-2418,0,0,0,,2418,-2418
31,07/31/2017,71,17:30,17:45,,27.58,0,27.58,27.58,-1,-75150,166947,242097,91797,0,-1505,0,0,0,,1505,-1505
31,07/31/2017,72,17:45,18:00,,,0,26.99,26.99,0,-88891,172005,260896,83114,0,-2,0,0,0,,2,-2
31,07/31/2017,73,18:00,18:15,,6.99,0,6.99,6.99,-1,-96520,162391,258911,65871,0,-16504,0,0,0,,16504,-16504
31,07/31/2017,74,18:15,18:30,,23.84,0,23.84,23.84,-1,-96370,161328,257698,64958,0,-16789,0,0,0,,16789,-16789
31,07/31/2017,75,18:30,18:45,,,0,27,27,0,-77293,145840,223133,68547,0,-2738,0,0,0,,2738,-2738
31,07/31/2017,76,18:45,19:00,,,0,27,27,0,-83441,146671,230112,63230,0,0,0,0,0,,0,0
31,07/31/2017,77,19:00,19:15,,,0,27,27,0,-86932,131233,218165,44301,0,0,0,0,0,,0,0
31,07/31/2017,78,19:15,19:30,,,0,27,27,0,-95678,118973,214651,23295,0,0,0,0,0,,0,0
31,07/31/2017,79,19:30,19:45,,,0,27.01,27.01,0,-97829,121236,219065,23407,0,0,0,0,0,,0,0
31,07/31/2017,80,19:45,20:00,28.65,,0,28.65,28.65,1,-106091,101765,207856,-4326,0,0,747,0,0,,747,747
31,07/31/2017,81,20:00,20:15,,,0,28.04,28.04,0,-56815,62004,118819,5189,0,0,438,0,0,,438,438
31,07/31/2017,82,20:15,20:30,,27.97,0,27.97,27.97,-1,-56434,60136,116570,3702,0,-7,0,0,0,,7,-7
31,07/31/2017,83,20:30,20:45,,27.59,0,27.59,27.59,-1,-62368,68161,130529,5793,0,-797,0,0,0,,797,-797
31,07/31/2017,84,20:45,21:00,,26.12,0,26.12,26.12,-1,-71598,79341,150939,7743,0,-1687,0,0,0,,1687,-1687
31,07/31/2017,85,21:00,21:15,,26.12,0,26.12,26.12,-1,-66930,83780,150710,16850,0,-1154,0,0,0,,1154,-1154
31,07/31/2017,86,21:15,21:30,,27.97,0,27.97,27.97,-1,-62869,83146,146015,20277,0,-211,0,0,0,,211,-211
31,07/31/2017,87,21:30,21:45,,27.57,0,27.57,27.57,-1,-78569,82647,161216,4078,0,-938,0,0,0,,938,-938
31,07/31/2017,88,21:45,22:00,33.63,,0,33.63,33.63,1,-105962,72171,178133,-33791,0,0,6494,0,0,,6494,6494
31,07/31/2017,89,22:00,22:15,28.02,,0,28.02,28.02,1,-82167,57809,139976,-24358,0,0,2351,0,0,,2351,2351
31,07/31/2017,90,22:15,22:30,,,0,27.88,27.88,0,-71997,54941,126938,-17056,0,0,0,0,0,,0,0
31,07/31/2017,91,22:30,22:45,,,0,27.91,27.91,0,-53166,64606,117772,11440,0,0,0,0,0,,0,0
31,07/31/2017,92,22:45,23:00,,1.59,0,1.59,1.59,-1,-54561,95466,150027,40905,0,-6942,0,0,0,,6942,-6942
31,07/31/2017,93,23:00,23:15,32.12,25.03,0,32.12,25.03,2,-59024,40551,99575,-18473,0,-6684,1220,0,0,,7904,-5464
31,07/31/2017,94,23:15,23:30,30.96,25.12,0,30.96,25.12,2,-61675,47685,109360,-13990,0,-844,839,0,0,,1683,-5
31,07/31/2017,95,23:30,23:45,,24.89,0,24.89,24.89,-1,-46756,70310,117066,23554,0,-3589,0,0,0,,3589,-3589
31,07/31/2017,96,23:45,0:00,,7.34,0,7.34,7.34,-1,-53855,94781,148636,40926,0,-31486,0,0,0,,31486,-31486
31,08-01-17,1,0:00,0:15,,,0,28.01,28.01,0,-60883,69382,130265,8499,0,-13691,0,0,0,,13691,-13691
31,08-01-17,2,0:15,0:30,,21.12,0,21.12,21.12,-1,-31774,64747,96521,32973,0,-749,0,0,0,,749,-749
31,08-01-17,3,0:30,0:45,,17.88,0,17.88,17.88,-1,-25824,32238,58062,6414,0,-7483,0,0,0,,7483,-7483
31,08-01-17,4,0:45,1:00,,-11.03,0,-11.03,-11.03,-1,-25497,47976,73473,22479,0,-16424,0,0,0,,16424,-16424
31,08-01-17,5,1:00,1:15,,20.59,0,20.59,20.59,-1,-35312,54299,89611,18987,0,-16080,0,0,0,,16080,-16080
31,08-01-17,6,1:15,1:30,,25.12,0,25.12,25.12,-1,-30747,36578,67325,5831,0,-240,0,0,0,,240,-240
31,08-01-17,7,1:30,1:45,,21.12,0,21.12,21.12,-1,-30157,43640,73797,13483,0,-283,0,0,0,,283,-283
31,08-01-17,8,1:45,2:00,,19.69,0,19.69,19.69,-1,-50593,49110,99703,-1483,0,-5752,0,0,0,,5752,-5752
31,08-01-17,9,2:00,2:15,32.12,26.12,0,32.12,26.12,2,-44418,41858,86276,-2560,0,-337,731,0,0,,1068,394
31,08-01-17,10,2:15,2:30,,,0,26.76,26.76,0,-40151,47881,88032,7730,0,0,65,0,0,,65,65
31,08-01-17,11,2:30,2:45,,,0,26.76,26.76,0,-37317,45766,83083,8449,0,0,0,0,0,,0,0
31,08-01-17,12,2:45,3:00,,25.12,0,25.12,25.12,-1,-36037,51527,87564,15490,0,-2147,0,0,0,,2147,-2147
31,08-01-17,13,3:00,3:15,,26.12,0,26.12,26.12,-1,-48288,92530,140818,44242,0,-995,0,0,0,,995,-995
31,08-01-17,14,3:15,3:30,,,0,27.01,27.01,0,-37715,60774,98489,23059,0,0,0,0,0,,0,0
31,08-01-17,15,3:30,3:45,,,0,27.01,27.01,0,-25891,51588,77479,25697,0,0,0,0,0,,0,0
31,08-01-17,16,3:45,4:00,,21.03,0,21.03,21.03,-1,-22161,58889,81050,36728,0,-2414,0,0,0,,2414,-2414
31,08-01-17,17,4:00,4:15,,26.12,0,26.12,26.12,-1,-33828,67999,101827,34171,0,-349,0,0,0,,349,-349
31,08-01-17,18,4:15,4:30,,26.12,0,26.12,26.12,-1,-16563,93215,109778,76652,0,-678,0,0,0,,678,-678
31,08-01-17,19,4:30,4:45,,26.12,0,26.12,26.12,-1,-18574,96791,115365,78217,0,-931,0,0,0,,931,-931
31,08-01-17,20,4:45,5:00,,12.64,0,12.64,12.64,-1,-21521,127183,148704,105662,0,-3539,0,0,0,,3539,-3539
31,08-01-17,21,5:00,5:15,,-200,0,-200,-200,-1,-32718,76602,109320,43884,0,-29902,0,0,0,,29902,-29902
31,08-01-17,22,5:15,5:30,,10.42,0,10.42,10.42,-1,-35674,69600,105274,33926,0,-30937,0,0,0,,30937,-30937
31,08-01-17,23,5:30,5:45,,20.03,0,20.03,20.03,-1,-36723,94271,130994,57548,0,-19006,0,0,0,,19006,-19006
31,08-01-17,24,5:45,6:00,,21.12,0,21.12,21.12,-1,-28568,103267,131835,74699,0,-12282,0,0,0,,12282,-12282
31,08-01-17,25,6:00,6:15,,26.12,0,26.12,26.12,-1,-89659,45007,134666,-44652,0,-1500,0,0,0,,1500,-1500
31,08-01-17,26,6:15,6:30,,26.12,0,26.12,26.12,-1,-54637,47032,101669,-7605,0,-577,0,0,0,,577,-577
31,08-01-17,27,6:30,6:45,,28.29,0,28.29,28.29,-1,-67140,57096,124236,-10044,0,-23,0,0,0,,23,-23
31,08-01-17,28,6:45,7:00,,28.29,0,28.29,28.29,-1,-69581,68134,137715,-1447,0,-31,0,0,0,,31,-31
31,08-01-17,29,7:00,7:15,,-3.03,0,-3.03,-3.03,-1,-43258,60295,103553,17037,0,-4758,0,0,0,,4758,-4758
31,08-01-17,30,7:15,7:30,,-20.03,0,-20.03,-20.03,-1,-44072,55996,100068,11924,0,-11251,0,0,0,,11251,-11251
31,08-01-17,31,7:30,7:45,,,0,28.76,28.76,0,-37962,80912,118874,42950,0,-55,0,0,0,,55,-55
31,08-01-17,32,7:45,8:00,,,0,28.66,28.66,0,-44586,100475,145061,55889,0,0,0,0,0,,0,0
31,08-01-17,33,8:00,8:15,,12.01,0,12.01,12.01,-1,-49894,87267,137161,37373,0,-7416,0,0,0,,7416,-7416
31,08-01-17,34,8:15,8:30,,26.69,0,26.69,26.69,-1,-61414,70846,132260,9432,0,-5056,0,0,0,,5056,-5056
31,08-01-17,35,8:30,8:45,,,0,29.31,29.31,0,-74176,57040,131216,-17136,0,-595,0,0,0,,595,-595
31,08-01-17,36,8:45,9:00,33.94,,0,33.94,33.94,1,-80879,50018,130897,-30861,0,0,141,0,0,,141,141
31,08-01-17,37,9:00,9:15,,,0,29.21,29.21,0,-78660,72050,150710,-6610,0,0,0,0,0,,0,0
31,08-01-17,38,9:15,9:30,350,,0,350,350,1,-89253,51119,140372,-38134,0,0,14706,0,0,,14706,14706
31,08-01-17,39,9:30,9:45,350,,0,350,350,1,-51201,53889,105090,2688,0,0,30839,0,0,,30839,30839
31,08-01-17,40,9:45,10:00,350,27.79,0,27.79,27.79,-1,-39395,57390,96785,17995,0,-350,1063,0,0,,1413,713
31,08-01-17,41,10:00,10:15,,,0,29.26,29.26,0,-36350,37200,73550,850,0,0,0,0,0,,0,0
31,08-01-17,42,10:15,10:30,28.12,,0,28.12,28.12,1,-38157,40021,78178,1864,0,0,19,0,0,,19,19
31,08-01-17,43,10:30,10:45,33.02,,0,33.02,33.02,1,-45381,23943,69324,-21438,0,0,2157,0,0,,2157,2157
31,08-01-17,44,10:45,11:00,43.9,,0,43.9,43.9,1,-38213,24025,62238,-14188,0,0,8875,0,0,,8875,8875
31,08-01-17,45,11:00,11:15,43.9,21.12,0,21.12,21.12,-1,-29662,64417,94079,34755,0,-5789,817,0,0,,6606,-4972
31,08-01-17,46,11:15,11:30,,29.09,0,29.09,29.09,-1,-27369,80599,107968,53230,0,-1692,0,0,0,,1692,-1692
31,08-01-17,47,11:30,11:45,,,0,29.36,29.36,0,-25285,95244,120529,69959,0,0,0,0,0,,0,0
31,08-01-17,48,11:45,12:00,,26.12,0,26.12,26.12,-1,-30569,105811,136380,75242,0,-1663,0,0,0,,1663,-1663
31,08-01-17,49,12:00,12:15,,27.59,0,27.59,27.59,-1,-44780,78823,123603,34043,0,-1746,0,0,0,,1746,-1746
31,08-01-17,50,12:15,12:30,,27.29,0,27.29,27.29,-1,-52026,70783,122809,18757,0,-309,0,0,0,,309,-309
31,08-01-17,51,12:30,12:45,32.12,28.69,0,32.12,28.69,2,-60274,56772,117046,-3502,0,-326,620,0,0,,946,294
31,08-01-17,52,12:45,13:00,,,0,29.11,29.11,0,-57135,58247,115382,1112,0,0,214,0,0,,214,214
31,08-01-17,53,13:00,13:15,,25.12,0,25.12,25.12,-1,-50300,60152,110452,9852,0,-1739,0,0,0,,1739,-1739
31,08-01-17,54,13:15,13:30,,27.59,0,27.59,27.59,-1,-52151,38130,90281,-14021,0,-1092,0,0,0,,1092,-1092
31,08-01-17,55,13:30,13:45,32.12,28.79,0,32.12,28.79,2,-84478,39852,124330,-44626,0,-157,69,0,0,,226,-88
31,08-01-17,56,13:45,14:00,35.02,,0,35.02,35.02,1,-110180,59758,169938,-50422,0,0,1453,0,0,,1453,1453
31,08-01-17,57,14:00,14:15,,-11.03,0,-11.03,-11.03,-1,-46886,97392,144278,50506,0,-12899,0,0,0,,12899,-12899
31,08-01-17,58,14:15,14:30,62.02,21.12,0,62.02,62.02,1,-97681,84192,181873,-13489,0,-15772,434,0,0,,16206,-15338
31,08-01-17,59,14:30,14:45,67.02,24.03,0,24.03,24.03,-1,-81905,114417,196322,32512,0,-1462,1006,0,0,,2468,-456
31,08-01-17,60,14:45,15:00,,21.12,0,21.12,21.12,-1,-81995,106264,188259,24269,0,-9249,0,0,0,,9249,-9249
31,08-01-17,61,15:00,15:15,,-200,0,-200,-200,-1,-31273,124812,156085,93539,0,-16662,0,0,0,,16662,-16662
31,08-01-17,62,15:15,15:30,,19.03,0,19.03,19.03,-1,-31021,103427,134448,72406,0,-25367,0,0,0,,25367,-25367
31,08-01-17,63,15:30,15:45,,,0,29.21,29.21,0,-32254,89405,121659,57151,0,-3581,0,0,0,,3581,-3581
31,08-01-17,64,15:45,16:00,,,0,29.21,29.21,0,-24005,79041,103046,55036,0,0,0,0,0,,0,0
31,08-01-17,65,16:00,16:15,32.12,,0,32.12,32.12,1,-76113,97844,173957,21731,0,0,101,0,0,,101,101
31,08-01-17,66,16:15,16:30,,,0,29.26,29.26,0,-28906,93222,122128,64316,0,0,0,0,0,,0,0
31,08-01-17,67,16:30,16:45,,28.89,0,28.89,28.89,-1,-28735,96403,125138,67668,0,-145,0,0,0,,145,-145
31,08-01-17,68,16:45,17:00,,30.49,0,30.49,30.49,-1,-26163,73556,99719,47393,0,-75,0,0,0,,75,-75
31,08-01-17,69,17:00,17:15,,,0,29.11,29.11,0,-43705,92116,135821,48411,0,0,0,0,0,,0,0
31,08-01-17,70,17:15,17:30,,,0,29.36,29.36,0,-37346,76122,113468,38776,0,0,0,0,0,,0,0
31,08-01-17,71,17:30,17:45,,,0,29.11,29.11,0,-42136,58192,100328,16056,0,0,0,0,0,,0,0
31,08-01-17,72,17:45,18:00,,,0,29.06,29.06,0,-48396,73052,121448,24656,0,0,0,0,0,,0,0
31,08-01-17,73,18:00,18:15,,26.12,0,26.12,26.12,-1,-51848,77053,128901,25205,0,-127,0,0,0,,127,-127
31,08-01-17,74,18:15,18:30,,21.12,0,21.12,21.12,-1,-45204,113249,158453,68045,0,-2339,0,0,0,,2339,-2339
31,08-01-17,75,18:30,18:45,,19.03,0,19.03,19.03,-1,-43380,117978,161358,74598,0,-5352,0,0,0,,5352,-5352
31,08-01-17,76,18:45,19:00,,,0,29.21,29.21,0,-42863,108211,151074,65348,0,-373,0,0,0,,373,-373
31,08-01-17,77,19:00,19:15,,,0,29.31,29.31,0,-64537,82282,146819,17745,0,0,0,0,0,,0,0
31,08-01-17,78,19:15,19:30,,25.12,0,25.12,25.12,-1,-65720,81099,146819,15379,0,-1048,0,0,0,,1048,-1048
31,08-01-17,79,19:30,19:45,,25.12,0,25.12,25.12,-1,-54821,78710,133531,23889,0,-5769,0,0,0,,5769,-5769
31,08-01-17,80,19:45,20:00,,25.12,0,25.12,25.12,-1,-56458,69771,126229,13313,0,-5972,0,0,0,,5972,-5972
31,08-01-17,81,20:00,20:15,36.02,25.12,0,36.02,36.02,1,-54396,50757,105153,-3639,0,-595,818,0,0,,1413,223
31,08-01-17,82,20:15,20:30,33.96,,0,33.96,33.96,1,-51123,49786,100909,-1337,0,0,1107,0,0,,1107,1107
31,08-01-17,83,20:30,20:45,39.02,,0,39.02,39.02,1,-56302,50233,106535,-6069,0,0,5078,0,0,,5078,5078
31,08-01-17,84,20:45,21:00,28.12,25.12,0,28.56,25.12,2,-50911,89921,140832,39010,0,-515,1483,0,0,,1998,968
31,08-01-17,85,21:00,21:15,,,0,29.16,29.16,0,-57587,97951,155538,40364,0,-61,0,0,0,,61,-61
31,08-01-17,86,21:15,21:30,,,0,29.16,29.16,0,-48154,84029,132183,35875,0,0,0,0,0,,0,0
31,08-01-17,87,21:30,21:45,32.12,,0,32.12,32.12,1,-57294,65805,123099,8511,0,0,139,0,0,,139,139
31,08-01-17,88,21:45,22:00,38.29,,0,38.29,38.29,1,-62881,54047,116928,-8834,0,0,2160,0,0,,2160,2160
31,08-01-17,89,22:00,22:15,28.12,,0,28.12,28.12,1,-82127,39910,122037,-42217,0,0,1220,0,0,,1220,1220
31,08-01-17,90,22:15,22:30,28.02,,0,28.02,28.02,1,-67376,31981,99357,-35395,0,0,242,0,0,,242,242
31,08-01-17,91,22:30,22:45,41.94,,0,41.94,41.94,1,-47106,44561,91667,-2545,0,0,1923,0,0,,1923,1923
31,08-01-17,92,22:45,23:00,,,0,28.86,28.86,0,-43399,52191,95590,8792,0,0,0,0,0,,0,0
31,08-01-17,93,23:00,23:15,350.02,,0,350.02,350.02,1,-105245,17843,123088,-87402,0,0,19133,0,0,,19133,19133
31,08-01-17,94,23:15,23:30,350,,0,350,350,1,-110512,50386,160898,-60126,0,0,44583,0,0,,44583,44583
31,08-01-17,95,23:30,23:45,350,-200,0,-200,-200,-1,-40614,63422,104036,22808,0,-11576,600,0,0,,12176,-10976
31,08-01-17,96,23:45,0:00,,7.03,0,7.03,7.03,-1,-71143,70041,141184,-1102,0,-3729,0,0,0,,3729,-3729
31,08-02-17,1,0:00,0:15,46.49,-3.78,0,46.49,46.49,1,-81528,121680,203208,40152,0,-5577,1652,0,0,,7229,-3925
31,08-02-17,2,0:15,0:30,123.12,,0,123.12,123.12,1,-88554,51923,140477,-36631,0,0,23398,0,0,,23398,23398
31,08-02-17,3,0:30,0:45,,,0,26.3,26.3,0,-90376,57402,147778,-32974,0,0,575,0,0,,575,575
31,08-02-17,4,0:45,1:00,,,0,26.33,26.33,0,-121351,38459,159810,-82892,0,0,0,0,0,,0,0
31,08-02-17,5,1:00,1:15,63.74,,0,63.74,63.74,1,-139310,119008,258318,-20302,0,0,5103,0,0,,5103,5103
31,08-02-17,6,1:15,1:30,120.12,,0,120.12,120.12,1,-128174,46454,174628,-81720,0,0,21615,0,0,,21615,21615
31,08-02-17,7,1:30,1:45,,,0,26.76,26.76,0,-103897,36950,140847,-66947,0,0,423,0,0,,423,423
31,08-02-17,8,1:45,2:00,,,0,26.77,26.77,0,-101675,25256,126931,-76419,0,0,0,0,0,,0,0
31,08-02-17,9,2:00,2:15,36.44,,0,36.44,36.44,1,-60598,47767,108365,-12831,0,0,8301,0,0,,8301,8301
31,08-02-17,10,2:15,2:30,30.53,26.86,0,30.53,26.63,2,-65374,51254,116628,-14120,0,-10,18833,0,0,,18843,18823
31,08-02-17,11,2:30,2:45,27.76,25.2,0,27.76,25.2,2,-47383,44748,92131,-2635,0,-1064,1799,0,0,,2863,735
31,08-02-17,12,2:45,3:00,27.78,21.2,0,27.78,21.2,2,-33473,49120,82593,15647,0,-1042,416,0,0,,1458,-626
31,08-02-17,13,3:00,3:15,,20.78,0,20.78,20.78,-1,-31602,31156,62758,-446,0,-2128,0,0,0,,2128,-2128
31,08-02-17,14,3:15,3:30,,,0,26.55,26.55,0,-54920,30094,85014,-24826,0,0,0,0,0,,0,0
31,08-02-17,15,3:30,3:45,,,0,26.56,26.56,0,-39421,26556,65977,-12865,0,0,0,0,0,,0,0
31,08-02-17,16,3:45,4:00,,25.2,0,25.2,25.2,-1,-40985,37229,78214,-3756,0,-3273,0,0,0,,3273,-3273
31,08-02-17,17,4:00,4:15,28.81,26.47,0,28.81,26.47,2,-44992,14953,59945,-30039,0,-1611,983,0,0,,2594,-628
31,08-02-17,18,4:15,4:30,28.8,,0,28.8,28.8,1,-37480,18217,55697,-19263,0,0,3116,0,0,,3116,3116
31,08-02-17,19,4:30,4:45,27.09,,0,27.09,27.09,1,-23393,22620,46013,-773,0,0,1121,0,0,,1121,1121
31,08-02-17,20,4:45,5:00,28.59,,0,28.59,28.59,1,-25214,36047,61261,10833,0,0,170,0,0,,170,170
31,08-02-17,21,5:00,5:15,52.89,,0,52.89,52.89,1,-88940,55917,144857,-33023,0,0,14610,0,0,,14610,14610
31,08-02-17,22,5:15,5:30,30.62,,0,30.62,30.62,1,-56566,69820,126386,13254,0,0,1312,0,0,,1312,1312
31,08-02-17,23,5:30,5:45,146.88,,0,146.88,146.88,1,-91495,47583,139078,-43912,0,0,26386,0,0,,26386,26386
31,08-02-17,24,5:45,6:00,32.01,27.46,0,27.46,27.46,-1,-60218,85965,146183,25747,0,-28,13984,0,0,,14012,13956
31,08-02-17,25,6:00,6:15,28.46,27.6,0,28.46,27.6,2,-115744,67006,182750,-48738,0,-126,197,0,0,,323,71
31,08-02-17,26,6:15,6:30,46.71,,0,46.71,46.71,1,-122875,54596,177471,-68279,0,0,9662,0,0,,9662,9662
31,08-02-17,27,6:30,6:45,42.76,,0,42.76,42.76,1,-75162,37843,113005,-37319,0,0,20704,0,0,,20704,20704
31,08-02-17,28,6:45,7:00,29.82,24.69,0,24.69,24.69,-1,-49674,62366,112040,12692,0,-150,13505,0,0,,13655,13355
31,08-02-17,29,7:00,7:15,29.82,24.39,0,24.39,24.39,-1,-100258,72607,172865,-27651,0,-723,668,0,0,,1391,-55
31,08-02-17,30,7:15,7:30,,21.06,0,21.06,21.06,-1,-63297,86398,149695,23101,0,-6787,0,0,0,,6787,-6787
31,08-02-17,31,7:30,7:45,,28.41,0,28.41,28.41,-1,-54612,68778,123390,14166,0,-3230,0,0,0,,3230,-3230
31,08-02-17,32,7:45,8:00,30.65,28.41,0,30.65,30.65,1,-76759,73829,150588,-2930,0,-255,940,0,0,,1195,685
31,08-02-17,33,8:00,8:15,,,0,28.58,28.58,0,-68461,84152,152613,15691,0,0,0,0,0,,0,0
31,08-02-17,34,8:15,8:30,32.52,,0,32.52,32.52,1,-80486,67340,147826,-13146,0,0,941,0,0,,941,941
31,08-02-17,35,8:30,8:45,46.12,,0,46.12,46.12,1,-91387,60360,151747,-31027,0,0,20473,0,0,,20473,20473
31,08-02-17,36,8:45,9:00,32.06,,0,32.06,32.06,1,-75180,57323,132503,-17857,0,0,17684,0,0,,17684,17684
31,08-02-17,37,9:00,9:15,32.06,29.02,0,29.02,29.02,-1,-58952,75011,133963,16059,0,-185,3513,0,0,,3698,3328
31,08-02-17,38,9:15,9:30,,29.01,0,29.01,29.01,-1,-70050,72827,142877,2777,0,-344,0,0,0,,344,-344
31,08-02-17,39,9:30,9:45,,,0,28.83,28.83,0,-58977,84133,143110,25156,0,0,0,0,0,,0,0
31,08-02-17,40,9:45,10:00,,,0,28.83,28.83,0,-39837,101157,140994,61320,0,0,0,0,0,,0,0
31,08-02-17,41,10:00,10:15,,26.06,0,26.06,26.06,-1,-47410,97557,144967,50147,0,-1145,0,0,0,,1145,-1145
31,08-02-17,42,10:15,10:30,,13.32,0,13.32,13.32,-1,-42505,87561,130066,45056,0,-6553,0,0,0,,6553,-6553
31,08-02-17,43,10:30,10:45,,11.46,0,11.46,11.46,-1,-47073,70371,117444,23298,0,-16852,0,0,0,,16852,-16852
31,08-02-17,44,10:45,11:00,,26.06,0,26.06,26.06,-1,-45642,60509,106151,14867,0,-6652,0,0,0,,6652,-6652
31,08-02-17,45,11:00,11:15,,28.98,0,28.98,28.98,-1,-56079,52268,108347,-3811,0,-1680,0,0,0,,1680,-1680
31,08-02-17,46,11:15,11:30,,28.43,0,28.43,28.43,-1,-36805,56635,93440,19830,0,-2203,0,0,0,,2203,-2203
31,08-02-17,47,11:30,11:45,,29,0,29,29,-1,-39860,69387,109247,29527,0,-1113,0,0,0,,1113,-1113
31,08-02-17,48,11:45,12:00,,,0,28.83,28.83,0,-41024,66024,107048,25000,0,-11,0,0,0,,11,-11
31,08-02-17,49,12:00,12:15,,,0,28.83,28.83,0,-36779,56030,92809,19251,0,0,0,0,0,,0,0
31,08-02-17,50,12:15,12:30,,-0.14,0,-0.14,-0.14,-1,-39530,87459,126989,47929,0,-14674,0,0,0,,14674,-14674
31,08-02-17,51,12:30,12:45,,-10.31,0,-10.31,-10.31,-1,-49198,83382,132580,34184,0,-41595,0,0,0,,41595,-41595
31,08-02-17,52,12:45,13:00,29.28,26.78,0,29.28,29.28,1,-46882,51475,98357,4593,0,-16984,35,0,0,,17019,-16949
31,08-02-17,53,13:00,13:15,30.07,26.78,0,30.07,30.07,1,-34338,79840,114178,45502,0,-116,328,0,0,,444,212
31,08-02-17,54,13:15,13:30,28.18,,0,28.18,28.18,1,-48580,49801,98381,1221,0,0,289,0,0,,289,289
31,08-02-17,55,13:30,13:45,,27.53,0,27.53,27.53,-1,-47505,61968,109473,14463,0,-5,0,0,0,,5,-5
31,08-02-17,56,13:45,14:00,,26.06,0,26.06,26.06,-1,-58441,69564,128005,11123,0,-1613,0,0,0,,1613,-1613
31,08-02-17,57,14:00,14:15,28.75,27.1,0,28.75,27.1,2,-42201,30648,72849,-11553,0,-928,310,0,0,,1238,-618
31,08-02-17,58,14:15,14:30,,,0,27.56,27.56,0,-56074,33788,89862,-22286,0,0,292,0,0,,292,292
31,08-02-17,59,14:30,14:45,28.06,,0,28.06,28.06,1,-57752,33403,91155,-24349,0,0,850,0,0,,850,850
31,08-02-17,60,14:45,15:00,28.06,,0,28.06,28.06,1,-57405,38550,95955,-18855,0,0,771,0,0,,771,771
31,08-02-17,61,15:00,15:15,28.06,,0,28.06,28.06,1,-82203,37055,119258,-45148,0,0,823,0,0,,823,823
31,08-02-17,62,15:15,15:30,32.06,,0,32.06,32.06,1,-82187,30312,112499,-51875,0,0,3763,0,0,,3763,3763
31,08-02-17,63,15:30,15:45,39.09,,0,39.09,39.09,1,-96461,29114,125575,-67347,0,0,12496,0,0,,12496,12496
31,08-02-17,64,15:45,16:00,53.12,,0,53.12,53.12,1,-75716,40016,115732,-35700,0,0,16818,0,0,,16818,16818
31,08-02-17,65,16:00,16:15,28.06,,0,28.06,28.06,1,-56548,68180,124728,11632,0,0,4605,0,0,,4605,4605
31,08-02-17,66,16:15,16:30,,,0,28.61,28.61,0,-58517,71514,130031,12997,0,0,0,0,0,,0,0
31,08-02-17,67,16:30,16:45,28.06,,0,28.06,28.06,1,-64448,72102,136550,7654,0,0,20,0,0,,20,20
31,08-02-17,68,16:45,17:00,29.9,,0,29.9,29.9,1,-85777,76015,161792,-9762,0,0,944,0,0,,944,944
31,08-02-17,69,17:00,17:15,28.06,,0,28.06,28.06,1,-56880,69307,126187,12427,0,0,238,0,0,,238,238
31,08-02-17,70,17:15,17:30,,29.09,0,29.09,29.09,-1,-48806,62926,111732,14120,0,-540,0,0,0,,540,-540
31,08-02-17,71,17:30,17:45,,30.09,0,30.09,30.09,-1,-51627,69576,121203,17949,0,-296,0,0,0,,296,-296
31,08-02-17,72,17:45,18:00,32.2,,0,32.2,32.2,1,-63682,66023,129705,2341,0,0,415,0,0,,415,415
31,08-02-17,73,18:00,18:15,149.12,,0,149.12,149.12,1,-126921,27891,154812,-99030,0,0,38830,0,0,,38830,38830
31,08-02-17,74,18:15,18:30,34.23,28.95,0,28.95,28.95,-1,-59098,83109,142207,24011,0,-22,20834,0,0,,20856,20812
31,08-02-17,75,18:30,18:45,34.23,28.61,0,28.61,28.61,-1,-46418,120564,166982,74146,0,-1167,11,0,0,,1178,-1156
31,08-02-17,76,18:45,19:00,,28.67,0,28.67,28.67,-1,-50011,130263,180274,80252,0,-1368,0,0,0,,1368,-1368
31,08-02-17,77,19:00,19:15,,-2.78,0,-2.78,-2.78,-1,-68633,126438,195071,57805,0,-23565,0,0,0,,23565,-23565
31,08-02-17,78,19:15,19:30,,26.06,0,26.06,26.06,-1,-91526,122660,214186,31134,0,-20749,0,0,0,,20749,-20749
31,08-02-17,79,19:30,19:45,,-14.54,0,-14.54,-14.54,-1,-59440,145540,204980,86100,0,-36332,0,0,0,,36332,-36332
31,08-02-17,80,19:45,20:00,,19.78,0,19.78,19.78,-1,-65520,115111,180631,49591,0,-51785,0,0,0,,51785,-51785
31,08-02-17,81,20:00,20:15,,25.56,0,25.56,25.56,-1,-54700,91439,146139,36739,0,-21650,0,0,0,,21650,-21650
31,08-02-17,82,20:15,20:30,,26.06,0,26.06,26.06,-1,-59940,75774,135714,15834,0,-3968,0,0,0,,3968,-3968
31,08-02-17,83,20:30,20:45,,28.99,0,28.99,28.99,-1,-65174,72569,137743,7395,0,-1409,0,0,0,,1409,-1409
31,08-02-17,84,20:45,21:00,,26.78,0,26.78,26.78,-1,-75095,77175,152270,2080,0,-2279,0,0,0,,2279,-2279
31,08-02-17,85,21:00,21:15,29.68,26.78,0,29.68,29.68,1,-96527,64517,161044,-32010,0,-25,686,0,0,,711,661
31,08-02-17,86,21:15,21:30,50.33,,0,50.33,50.33,1,-94917,65537,160454,-29380,0,0,11658,0,0,,11658,11658
31,08-02-17,87,21:30,21:45,50.33,,0,50.33,50.33,1,-106214,77531,183745,-28683,0,0,25370,0,0,,25370,25370
31,08-02-17,88,21:45,22:00,32.83,24.53,0,24.53,24.53,-1,-88307,111191,199498,22884,0,-1685,15435,0,0,,17120,13750
31,08-02-17,89,22:00,22:15,28.06,24.53,0,28.06,28.06,1,-138731,76972,215703,-61759,0,-354,973,0,0,,1327,619
31,08-02-17,90,22:15,22:30,,28.62,0,28.62,28.62,-1,-104738,109542,214280,4804,0,-11,0,0,0,,11,-11
31,08-02-17,91,22:30,22:45,,26.78,0,26.78,26.78,-1,-79876,143083,222959,63207,0,-555,0,0,0,,555,-555
31,08-02-17,92,22:45,23:00,,-54.48,0,-54.48,-54.48,-1,-65782,159465,225247,93683,0,-18352,0,0,0,,18352,-18352
31,08-02-17,93,23:00,23:15,,19.78,0,19.78,19.78,-1,-96222,114448,210670,18226,0,-12752,0,0,0,,12752,-12752
31,08-02-17,94,23:15,23:30,,21.06,0,21.06,21.06,-1,-85447,137473,222920,52026,0,-1488,0,0,0,,1488,-1488
31,08-02-17,95,23:30,23:45,,13.13,0,13.13,13.13,-1,-70800,154490,225290,83690,0,-12548,0,0,0,,12548,-12548
31,08-02-17,96,23:45,0:00,,-9.78,0,-9.78,-9.78,-1,-78069,131950,210019,53881,0,-58072,0,0,0,,58072,-58072
31,08-03-17,1,0:00,0:15,,-15.53,0,-15.53,-15.53,-1,-35582,213715,249297,178133,0,-46142,0,0,0,,46142,-46142
31,08-03-17,2,0:15,0:30,28.6,-15.53,0,28.6,28.6,1,-74106,34281,108387,-39825,0,-4135,535,0,0,,4670,-3600
31,08-03-17,3,0:30,0:45,128.02,,0,128.02,128.02,1,-169659,21059,190718,-148600,0,0,36230,0,0,,36230,36230
31,08-03-17,4,0:45,1:00,128.02,,0,128.02,128.02,1,-235053,46711,281764,-188342,0,0,75386,0,0,,75386,75386
31,08-03-17,5,1:00,1:15,31.96,,0,31.96,31.96,1,-135981,137296,273277,1315,0,0,26461,0,0,,26461,26461
31,08-03-17,6,1:15,1:30,44.02,,0,44.02,44.02,1,-101245,50674,151919,-50571,0,0,32805,0,0,,32805,32805
31,08-03-17,7,1:30,1:45,30.34,26.58,0,26.58,26.58,-1,-70374,56749,127123,-13625,0,-63,15422,0,0,,15485,15359
31,08-03-17,8,1:45,2:00,30.34,20.96,0,20.96,20.96,-1,-67011,69838,136849,2827,0,-4194,43,0,0,,4237,-4151
31,08-03-17,9,2:00,2:15,,24.96,0,24.96,24.96,-1,-73516,122254,195770,48738,0,-4365,0,0,0,,4365,-4365
31,08-03-17,10,2:15,2:30,,,0,26.25,26.25,0,-45262,56417,101679,11155,0,0,0,0,0,,0,0
31,08-03-17,11,2:30,2:45,,25.96,0,25.96,25.96,-1,-36138,64191,100329,28053,0,-72,0,0,0,,72,-72
31,08-03-17,12,2:45,3:00,,20.96,0,20.96,20.96,-1,-30211,79614,109825,49403,0,-3370,0,0,0,,3370,-3370
31,08-03-17,13,3:00,3:15,,26.38,0,26.38,26.38,-1,-60259,64569,124828,4310,0,-2478,0,0,0,,2478,-2478
31,08-03-17,14,3:15,3:30,28.89,,0,28.89,28.89,1,-99261,54561,153822,-44700,0,0,1577,0,0,,1577,1577
31,08-03-17,15,3:30,3:45,127.58,,0,127.58,127.58,1,-150802,57858,208660,-92944,0,0,33370,0,0,,33370,33370
31,08-03-17,16,3:45,4:00,30.46,20.96,0,20.96,20.96,-1,-103242,65116,168358,-38126,0,-1186,10055,0,0,,11241,8869
31,08-03-17,17,4:00,4:15,,16.39,0,16.39,16.39,-1,-101313,60621,161934,-40692,0,-9994,0,0,0,,9994,-9994
31,08-03-17,18,4:15,4:30,,,0,26.18,26.18,0,-102253,63530,165783,-38723,0,-14,0,0,0,,14,-14
31,08-03-17,19,4:30,4:45,,,0,26.18,26.18,0,-95296,66160,161456,-29136,0,0,0,0,0,,0,0
31,08-03-17,20,4:45,5:00,,,0,26.18,26.18,0,-102427,34491,136918,-67936,0,0,0,0,0,,0,0
31,08-03-17,21,5:00,5:15,28.46,,0,28.46,28.46,1,-101159,55543,156702,-45616,0,0,543,0,0,,543,543
31,08-03-17,22,5:15,5:30,,,0,26.28,26.28,0,-91466,50216,141682,-41250,0,0,0,0,0,,0,0
31,08-03-17,23,5:30,5:45,34.24,,0,34.24,34.24,1,-108541,40667,149208,-67874,0,0,2447,0,0,,2447,2447
31,08-03-17,24,5:45,6:00,127.57,,0,127.57,127.57,1,-130608,35200,165808,-95408,0,0,45638,0,0,,45638,45638
31,08-03-17,25,6:00,6:15,58.85,,0,58.85,58.85,1,-122764,70660,193424,-52104,0,0,33663,0,0,,33663,33663
31,08-03-17,26,6:15,6:30,30.38,,0,30.38,30.38,1,-96018,75783,171801,-20235,0,0,743,0,0,,743,743
31,08-03-17,27,6:30,6:45,33.59,,0,33.59,33.59,1,-102274,58333,160607,-43941,0,0,3328,0,0,,3328,3328
31,08-03-17,28,6:45,7:00,145.42,,0,145.42,145.42,1,-109586,50902,160488,-58684,0,0,42899,0,0,,42899,42899
31,08-03-17,29,7:00,7:15,350.02,,0,350.02,350.02,1,-209635,45410,255045,-164225,0,0,53255,0,0,,53255,53255
31,08-03-17,30,7:15,7:30,186.35,,0,186.35,186.35,1,-140067,51931,191998,-88136,0,0,88686,0,0,,88686,88686
31,08-03-17,31,7:30,7:45,141.02,,0,141.02,141.02,1,-100608,58109,158717,-42499,0,0,56483,0,0,,56483,56483
31,08-03-17,32,7:45,8:00,141.02,,0,141.02,141.02,1,-106387,62170,168557,-44217,0,0,40343,0,0,,40343,40343
31,08-03-17,33,8:00,8:15,128.02,,0,128.02,128.02,1,-162443,103033,265476,-59410,0,0,51756,0,0,,51756,51756
31,08-03-17,34,8:15,8:30,185.96,,0,185.96,185.96,1,-161288,81034,242322,-80254,0,0,60163,0,0,,60163,60163
31,08-03-17,35,8:30,8:45,185.96,,0,185.96,185.96,1,-153868,65780,219648,-88088,0,0,77462,0,0,,77462,77462
31,08-03-17,36,8:45,9:00,185.96,,0,185.96,185.96,1,-137791,49887,187678,-87904,0,0,81761,0,0,,81761,81761
31,08-03-17,37,9:00,9:15,185.96,25.02,0,25.02,25.02,-1,-62594,172902,235496,110308,0,-528,20613,0,0,,21141,20085
31,08-03-17,38,9:15,9:30,,,0,28.86,28.86,0,-67740,120644,188384,52904,0,0,0,0,0,,0,0
31,08-03-17,39,9:30,9:45,,,0,28.91,28.91,0,-75916,96824,172740,20908,0,0,0,0,0,,0,0
31,08-03-17,40,9:45,10:00,41.98,,0,41.98,41.98,1,-98209,81029,179238,-17180,0,0,543,0,0,,543,543
31,08-03-17,41,10:00,10:15,145.37,,0,145.37,145.37,1,-162073,45527,207600,-116546,0,0,45625,0,0,,45625,45625
31,08-03-17,42,10:15,10:30,118.02,,0,118.02,118.02,1,-134080,83403,217483,-50677,0,0,61510,0,0,,61510,61510
31,08-03-17,43,10:30,10:45,118.02,25.03,0,25.03,25.03,-1,-80597,87991,168588,7394,0,-1012,11580,0,0,,12592,10568
31,08-03-17,44,10:45,11:00,,26.9,0,26.9,26.9,-1,-60123,80321,140444,20198,0,-1109,0,0,0,,1109,-1109
31,08-03-17,45,11:00,11:15,109.02,28.99,0,109.02,28.86,2,-140838,72960,213798,-67878,0,-386,11500,0,0,,11886,11114
31,08-03-17,46,11:15,11:30,31.98,,0,31.98,31.98,1,-57154,97369,154523,40215,0,0,7116,0,0,,7116,7116
31,08-03-17,47,11:30,11:45,,27.02,0,27.02,27.02,-1,-55504,86993,142497,31489,0,-692,0,0,0,,692,-692
31,08-03-17,48,11:45,12:00,,27.04,0,27.04,27.04,-1,-51367,67290,118657,15923,0,-1913,0,0,0,,1913,-1913
31,08-03-17,49,12:00,12:15,,,0,27.58,27.58,0,-57650,102070,159720,44420,0,-153,0,0,0,,153,-153
31,08-03-17,50,12:15,12:30,,,0,27.41,27.41,0,-46292,101110,147402,54818,0,0,0,0,0,,0,0
31,08-03-17,51,12:30,12:45,,15.42,0,15.42,15.42,-1,-37778,108046,145824,70268,0,-5841,0,0,0,,5841,-5841
31,08-03-17,52,12:45,13:00,,-0.08,0,-0.08,-0.08,-1,-39280,122149,161429,82869,0,-40689,0,0,0,,40689,-40689
31,08-03-17,53,13:00,13:15,39.95,-61.03,0,39.95,-61.03,2,-90903,92465,183368,1562,0,-40419,813,0,0,,41232,-39606
31,08-03-17,54,13:15,13:30,40.73,-61.03,0,40.73,-61.03,2,-59320,116061,175381,56741,0,-16748,1403,0,0,,18151,-15345
31,08-03-17,55,13:30,13:45,,-61.03,0,-61.03,-61.03,-1,-67071,101815,168886,34744,0,-52738,0,0,0,,52738,-52738
31,08-03-17,56,13:45,14:00,,-120.03,0,-120.03,-120.03,-1,-34992,98846,133838,63854,0,-52194,0,0,0,,52194,-52194
31,08-03-17,57,14:00,14:15,31.7,-61.03,0,31.7,-61.03,2,-60109,98135,158244,38026,0,-32621,39,0,0,,32660,-32582
31,08-03-17,58,14:15,14:30,46.55,-61.03,0,46.55,-61.03,2,-36211,109331,145542,73120,0,-11955,1159,0,0,,13114,-10796
31,08-03-17,59,14:30,14:45,,-61.03,0,-61.03,-61.03,-1,-70383,77917,148300,7534,0,-18092,0,0,0,,18092,-18092
31,08-03-17,60,14:45,15:00,,-61.03,0,-61.03,-61.03,-1,-50426,105932,156358,55506,0,-19427,0,0,0,,19427,-19427
31,08-03-17,61,15:00,15:15,,-0.37,0,-0.37,-0.37,-1,-37271,67911,105182,30640,0,-12923,0,0,0,,12923,-12923
31,08-03-17,62,15:15,15:30,35.62,-8.03,0,35.62,-8.03,2,-46492,46343,92835,-149,0,-29949,579,0,0,,30528,-29370
31,08-03-17,63,15:30,15:45,35.62,-61.03,0,-61.03,-61.03,-1,-37302,73925,111227,36623,0,-19127,420,0,0,,19547,-18707
31,08-03-17,64,15:45,16:00,27.23,25.98,0,27.23,25.98,2,-36307,42656,78963,6349,0,-4378,61,0,0,,4439,-4317
31,08-03-17,65,16:00,16:15,,25.35,0,25.35,25.35,-1,-37967,32944,70911,-5023,0,-2121,0,0,0,,2121,-2121
31,08-03-17,66,16:15,16:30,27.98,25.35,0,27.98,27.98,1,-44894,29912,74806,-14982,0,-17,663,0,0,,680,646
31,08-03-17,67,16:30,16:45,29.18,,0,29.18,29.18,1,-52540,39248,91788,-13292,0,0,3119,0,0,,3119,3119
31,08-03-17,68,16:45,17:00,31.98,,0,31.98,31.98,1,-63176,36341,99517,-26835,0,0,12164,0,0,,12164,12164
31,08-03-17,69,17:00,17:15,29.09,,0,29.09,29.09,1,-53400,47503,100903,-5897,0,0,8780,0,0,,8780,8780
31,08-03-17,70,17:15,17:30,27.63,,0,27.63,27.63,1,-44151,59754,103905,15603,0,0,1359,0,0,,1359,1359
31,08-03-17,71,17:30,17:45,26.09,,0,26.09,26.09,1,-52697,68189,120886,15492,0,0,323,0,0,,323,323
31,08-03-17,72,17:45,18:00,27.98,,0,27.98,27.98,1,-64549,64975,129524,426,0,0,912,0,0,,912,912
31,08-03-17,73,18:00,18:15,,17.19,0,17.19,17.19,-1,-37426,56308,93734,18882,0,-6291,0,0,0,,6291,-6291
31,08-03-17,74,18:15,18:30,,17.09,0,17.09,17.09,-1,-47272,64793,112065,17521,0,-14991,0,0,0,,14991,-14991
31,08-03-17,75,18:30,18:45,,,0,26.55,26.55,0,-34300,55740,90040,21440,0,-332,0,0,0,,332,-332
31,08-03-17,76,18:45,19:00,,,0,26.55,26.55,0,-47462,72102,119564,24640,0,0,0,0,0,,0,0
31,08-03-17,77,19:00,19:15,163.94,,0,163.94,163.94,1,-64628,32899,97527,-31729,0,0,21144,0,0,,21144,21144
31,08-03-17,78,19:15,19:30,33.02,,0,33.02,33.02,1,-14988,59091,74079,44103,0,0,15414,0,0,,15414,15414
31,08-03-17,79,19:30,19:45,33.02,27.02,0,27.02,27.02,-1,-23706,69401,93107,45695,0,-565,79,0,0,,644,-486
31,08-03-17,80,19:45,20:00,,,0,26.71,26.71,0,-40076,61067,101143,20991,0,-35,0,0,0,,35,-35
31,08-03-17,81,20:00,20:15,27.98,,0,27.98,27.98,1,-83478,38738,122216,-44740,0,0,824,0,0,,824,824
31,08-03-17,82,20:15,20:30,,,0,27.16,27.16,0,-82045,51927,133972,-30118,0,0,46,0,0,,46,46
31,08-03-17,83,20:30,20:45,27.98,,0,27.98,27.98,1,-96261,52943,149204,-43318,0,0,75,0,0,,75,75
31,08-03-17,84,20:45,21:00,33.69,,0,33.69,33.69,1,-83771,40580,124351,-43191,0,0,5518,0,0,,5518,5518
31,08-03-17,85,21:00,21:15,28.34,,0,28.34,28.34,1,-83919,68788,152707,-15131,0,0,1077,0,0,,1077,1077
31,08-03-17,86,21:15,21:30,27.23,,0,27.23,27.23,1,-71693,63716,135409,-7977,0,0,409,0,0,,409,409
31,08-03-17,87,21:30,21:45,81.71,,0,81.71,81.71,1,-73295,44568,117863,-28727,0,0,12605,0,0,,12605,12605
31,08-03-17,88,21:45,22:00,41.02,,0,41.02,41.02,1,-67146,33363,100509,-33783,0,0,33237,0,0,,33237,33237
31,08-03-17,89,22:00,22:15,41.02,25.52,0,25.52,25.52,-1,-49012,71997,121009,22985,0,-823,7696,0,0,,8519,6873
31,08-03-17,90,22:15,22:30,,,0,27.5,27.5,0,-41269,51299,92568,10030,0,0,0,0,0,,0,0
31,08-03-17,91,22:30,22:45,,27.49,0,27.49,27.49,-1,-34473,57876,92349,23403,0,-37,0,0,0,,37,-37
31,08-03-17,92,22:45,23:00,,27.01,0,27.01,27.01,-1,-53947,56475,110422,2528,0,-151,0,0,0,,151,-151
31,08-03-17,93,23:00,23:15,138.02,26.9,0,138.02,26.55,2,-81404,43769,125173,-37635,0,-153,13600,0,0,,13753,13447
31,08-03-17,94,23:15,23:30,35.02,,0,35.02,35.02,1,-57176,46910,104086,-10266,0,0,19134,0,0,,19134,19134
31,08-03-17,95,23:30,23:45,35.02,25.98,0,25.98,25.98,-1,-52002,49120,101122,-2882,0,-54,181,0,0,,235,127
31,08-03-17,96,23:45,0:00,,18.49,0,18.49,18.49,-1,-50552,61409,111961,10857,0,-12749,0,0,0,,12749,-12749
31,08-04-17,1,0:00,0:15,33.78,18.49,0,33.78,33.78,1,-65675,60729,126404,-4946,0,-1062,2308,0,0,,3370,1246
31,08-04-17,2,0:15,0:30,40.19,20.93,0,40.19,20.93,2,-40311,42482,82793,2171,0,-1393,10520,0,0,,11913,9127
31,08-04-17,3,0:30,0:45,40.19,20.93,0,20.93,20.93,-1,-28431,33715,62146,5284,0,-5679,39,0,0,,5718,-5640
31,08-04-17,4,0:45,1:00,,4.07,0,4.07,4.07,-1,-34674,54074,88748,19400,0,-28394,0,0,0,,28394,-28394
31,08-04-17,5,1:00,1:15,146.12,20.78,0,146.12,146.12,1,-77155,38634,115789,-38521,0,-15128,7772,0,0,,22900,-7356
31,08-04-17,6,1:15,1:30,164.12,,0,164.12,164.12,1,-70942,40821,111763,-30121,0,0,18572,0,0,,18572,18572
31,08-04-17,7,1:30,1:45,27.93,,0,27.93,27.93,1,-50681,39097,89778,-11584,0,0,5944,0,0,,5944,5944
31,08-04-17,8,1:45,2:00,27.93,20.78,0,20.78,20.78,-1,-31606,35662,67268,4056,0,-12359,416,0,0,,12775,-11943
31,08-04-17,9,2:00,2:15,,20.93,0,20.93,20.93,-1,-39863,70690,110553,30827,0,-17025,0,0,0,,17025,-17025
31,08-04-17,10,2:15,2:30,31.93,20.93,0,31.93,31.93,1,-36113,31260,67373,-4853,0,-557,615,0,0,,1172,58
31,08-04-17,11,2:30,2:45,,26.57,0,26.57,26.57,-1,-36244,31961,68205,-4283,0,-82,0,0,0,,82,-82
31,08-04-17,12,2:45,3:00,,24.93,0,24.93,24.93,-1,-43322,27400,70722,-15922,0,-2891,0,0,0,,2891,-2891
31,08-04-17,13,3:00,3:15,,22.96,0,22.96,22.96,-1,-46244,63110,109354,16866,0,-2898,0,0,0,,2898,-2898
31,08-04-17,14,3:15,3:30,,,0,27.07,27.07,0,-59818,49937,109755,-9881,0,-4,0,0,0,,4,-4
31,08-04-17,15,3:30,3:45,164.12,,0,219.65,219.65,1,-61394,48398,109792,-12996,0,0,18238,0,16666,,34904,34904
31,08-04-17,16,3:45,4:00,164.12,-150.78,0,219.65,-150.78,2,-18142,156399,174541,138257,0,-3332,33605,0,87639,,124576,117912
31,08-04-17,17,4:00,4:15,,-150.78,0,-150.78,-150.78,-1,-26318,166271,192589,139953,0,-13188,0,0,87639,,100827,74451
31,08-04-17,18,4:15,4:30,,23.85,0,23.85,23.85,-1,-9694,173087,182781,163393,0,-735,0,0,87639,,88374,86904
31,08-04-17,19,4:30,4:45,,19.58,0,19.58,19.58,-1,-9142,168958,178100,159816,0,-4429,0,0,87639,,92068,83210
31,08-04-17,20,4:45,5:00,,26.57,0,26.57,26.57,-1,-12945,167081,180026,154136,0,-1274,0,0,79305,,80579,78031
31,08-04-17,21,5:00,5:15,,-39.78,0,-39.78,-39.78,-1,-33039,200165,233204,167126,0,-15280,0,0,75138,,90418,59858
31,08-04-17,22,5:15,5:30,,-150.78,0,-150.78,-150.78,-1,-26446,95783,122229,69337,0,-36803,0,0,36712,,73515,-91
31,08-04-17,23,5:30,5:45,,,0,27.03,27.03,0,-21622,92959,114581,71337,0,-3294,0,0,0,,3294,-3294
31,08-04-17,24,5:45,6:00,,,0,27.03,27.03,0,-35237,107761,142998,72524,0,0,0,0,0,,0,0
31,08-04-17,25,6:00,6:15,28.05,,0,28.05,28.05,1,-55300,45698,100998,-9602,0,0,4,0,0,,4,4
31,08-04-17,26,6:15,6:30,32.05,,0,32.05,32.05,1,-51475,25893,77368,-25582,0,0,659,0,0,,659,659
31,08-04-17,27,6:30,6:45,,,0,27.08,27.08,0,-51145,26043,77188,-25102,0,0,252,0,0,,252,252
31,08-04-17,28,6:45,7:00,32.05,,0,32.05,32.05,1,-69215,47685,116900,-21530,0,0,3918,0,0,,3918,3918
31,08-04-17,29,7:00,7:15,,,0,27.16,27.16,0,-32639,71392,104031,38753,0,0,231,0,0,,231,231
31,08-04-17,30,7:15,7:30,27.25,,0,27.25,27.25,1,-25673,45124,70797,19451,0,0,9,0,0,,9,9
31,08-04-17,31,7:30,7:45,71.12,,0,71.12,71.12,1,-55553,31015,86568,-24538,0,0,12229,0,0,,12229,12229
31,08-04-17,32,7:45,8:00,32.05,,0,32.05,32.05,1,-78698,77702,156400,-996,0,0,13978,0,0,,13978,13978
31,08-04-17,33,8:00,8:15,28.05,27.03,0,28.05,27.03,2,-41812,39679,81491,-2133,0,-70,1409,0,0,,1479,1339
31,08-04-17,34,8:15,8:30,41.02,,0,41.02,41.02,1,-54263,26902,81165,-27361,0,0,7498,0,0,,7498,7498
31,08-04-17,35,8:30,8:45,41.02,,0,41.02,41.02,1,-64253,38786,103039,-25467,0,0,11072,0,0,,11072,11072
31,08-04-17,36,8:45,9:00,62.12,,0,62.12,62.12,1,-83830,39622,123452,-44208,0,0,20132,0,0,,20132,20132
31,08-04-17,37,9:00,9:15,38.12,,0,38.12,38.12,1,-79056,47292,126348,-31764,0,0,19995,0,0,,19995,19995
31,08-04-17,38,9:15,9:30,28.05,,0,28.05,28.05,1,-93341,37904,131245,-55437,0,0,1817,0,0,,1817,1817
31,08-04-17,39,9:30,9:45,32.05,,0,32.05,32.05,1,-102224,27533,129757,-74691,0,0,2286,0,0,,2286,2286
31,08-04-17,40,9:45,10:00,27.39,,0,27.39,27.39,1,-88844,42335,131179,-46509,0,0,1402,0,0,,1402,1402
31,08-04-17,41,10:00,10:15,287.12,,0,287.12,287.12,1,-124568,68295,192863,-56273,0,0,21969,0,0,,21969,21969
31,08-04-17,42,10:15,10:30,84.43,,0,84.43,84.43,1,-77303,70916,148219,-6387,0,0,29661,0,0,,29661,29661
31,08-04-17,43,10:30,10:45,84.43,26.9,0,26.9,26.9,-1,-56348,70445,126793,14097,0,-288,2427,0,0,,2715,2139
31,08-04-17,44,10:45,11:00,45.28,26.9,0,45.28,45.28,1,-68180,56781,124961,-11399,0,-96,2910,0,0,,3006,2814
31,08-04-17,45,11:00,11:15,293.12,,0,293.12,293.12,1,-91415,49918,141333,-41497,0,0,35365,0,0,,35365,35365
31,08-04-17,46,11:15,11:30,92.12,26.4,0,92.12,26.4,2,-88511,61377,149888,-27134,0,-233,9466,0,0,,9699,9233
31,08-04-17,47,11:30,11:45,350.12,14.18,0,350.12,14.18,2,-61078,73250,134328,12172,0,-829,16865,0,0,,17694,16036
31,08-04-17,48,11:45,12:00,305.12,-49.78,0,305.12,-49.78,2,-73862,62889,136751,-10973,0,-14388,3759,0,0,,18147,-10629
31,08-04-17,49,12:00,12:15,32.05,26.94,0,26.94,26.94,-1,-75886,99028,174914,23142,0,-2,4467,0,0,,4469,4465
31,08-04-17,50,12:15,12:30,,25.05,0,25.05,25.05,-1,-60145,90598,150743,30453,0,-1757,0,0,0,,1757,-1757
31,08-04-17,51,12:30,12:45,,18.71,0,18.71,18.71,-1,-53690,87534,141224,33844,0,-5762,0,0,0,,5762,-5762
31,08-04-17,52,12:45,13:00,,15.36,0,15.36,15.36,-1,-48818,92874,141692,44056,0,-25799,0,0,0,,25799,-25799
31,08-04-17,53,13:00,13:15,30.34,15.36,0,30.34,30.34,1,-43685,56986,100671,13301,0,-10500,643,0,0,,11143,-9857
31,08-04-17,54,13:15,13:30,34.9,,0,34.9,34.9,1,-43020,45298,88318,2278,0,0,4047,0,0,,4047,4047
31,08-04-17,55,13:30,13:45,34.9,21.05,0,21.05,21.05,-1,-35471,59275,94746,23804,0,-1934,597,0,0,,2531,-1337
31,08-04-17,56,13:45,14:00,34.9,19.88,0,34.9,19.88,2,-50175,40518,90693,-9657,0,-8546,615,0,0,,9161,-7931
31,08-04-17,57,14:00,14:15,34.9,24.93,0,24.93,24.93,-1,-43076,63648,106724,20572,0,-2280,128,0,0,,2408,-2152
31,08-04-17,58,14:15,14:30,28.17,24.93,0,28.17,28.17,1,-43037,46402,89439,3365,0,-339,546,0,0,,885,207
31,08-04-17,59,14:30,14:45,28.17,21.05,0,21.05,21.05,-1,-38344,51066,89410,12722,0,-2491,8,0,0,,2499,-2483
31,08-04-17,60,14:45,15:00,,21.05,0,21.05,21.05,-1,-32219,51446,83665,19227,0,-19149,0,0,0,,19149,-19149
31,08-04-17,61,15:00,15:15,,21.05,0,21.05,21.05,-1,-36514,75758,112272,39244,0,-16138,0,0,0,,16138,-16138
31,08-04-17,62,15:15,15:30,,26.05,0,26.05,26.05,-1,-42589,53876,96465,11287,0,-7201,0,0,0,,7201,-7201
31,08-04-17,63,15:30,15:45,32.05,25.88,0,32.05,25.88,2,-52196,45835,98031,-6361,0,-471,239,0,0,,710,-232
31,08-04-17,64,15:45,16:00,38.05,,0,38.05,38.05,1,-65293,50134,115427,-15159,0,0,12254,0,0,,12254,12254
31,08-04-17,65,16:00,16:15,38.05,21.05,0,21.05,21.05,-1,-34716,60870,95586,26154,0,-6965,3123,0,0,,10088,-3842
31,08-04-17,66,16:15,16:30,,25.05,0,25.05,25.05,-1,-49110,65734,114844,16624,0,-10811,0,0,0,,10811,-10811
31,08-04-17,67,16:30,16:45,27.22,26.96,0,27.22,26.96,2,-61687,66131,127818,4444,0,-1704,48,0,0,,1752,-1656
31,08-04-17,68,16:45,17:00,29.57,,0,29.57,29.57,1,-64407,63068,127475,-1339,0,0,2388,0,0,,2388,2388
31,08-04-17,69,17:00,17:15,32.05,25.05,0,32.05,25.05,2,-32689,41577,74266,8888,0,-2803,418,0,0,,3221,-2385
31,08-04-17,70,17:15,17:30,57.33,,0,57.33,57.33,1,-60477,47974,108451,-12503,0,0,15728,0,0,,15728,15728
31,08-04-17,71,17:30,17:45,28.28,,0,28.28,28.28,1,-56554,54106,110660,-2448,0,0,3152,0,0,,3152,3152
31,08-04-17,72,17:45,18:00,38.4,,0,38.4,38.4,1,-66724,57750,124474,-8974,0,0,5892,0,0,,5892,5892
31,08-04-17,73,18:00,18:15,31.57,26.77,0,31.57,26.77,2,-51394,43878,95272,-7516,0,-128,1827,0,0,,1955,1699
31,08-04-17,74,18:15,18:30,38.05,,0,38.05,38.05,1,-45764,38256,84020,-7508,0,0,4311,0,0,,4311,4311
31,08-04-17,75,18:30,18:45,32.05,,0,32.05,32.05,1,-44526,38269,82795,-6257,0,0,10081,0,0,,10081,10081
31,08-04-17,76,18:45,19:00,29.31,,0,29.31,29.31,1,-50494,42131,92625,-8363,0,0,8284,0,0,,8284,8284
31,08-04-17,77,19:00,19:15,30.29,26.05,0,30.29,26.05,2,-73057,63997,137054,-9060,0,-473,1535,0,0,,2008,1062
31,08-04-17,78,19:15,19:30,106.7,,0,106.7,106.7,1,-65031,25272,90303,-39759,0,0,23954,0,0,,23954,23954
31,08-04-17,79,19:30,19:45,57.91,,0,57.91,57.91,1,-58516,35034,93550,-23482,0,0,36170,0,0,,36170,36170
31,08-04-17,80,19:45,20:00,27.8,,0,27.8,27.8,1,-63305,43448,106753,-19857,0,0,6465,0,0,,6465,6465
31,08-04-17,81,20:00,20:15,27.29,,0,27.29,27.29,1,-39270,90624,129894,51354,0,0,250,0,0,,250,250
31,08-04-17,82,20:15,20:30,27.89,,0,27.89,27.89,1,-50707,62145,112852,11438,0,0,337,0,0,,337,337
31,08-04-17,83,20:30,20:45,27.27,,0,27.27,27.27,1,-52939,48023,100962,-4916,0,0,959,0,0,,959,959
31,08-04-17,84,20:45,21:00,32.05,,0,32.05,32.05,1,-61764,36071,97835,-25693,0,0,4431,0,0,,4431,4431
31,08-04-17,85,21:00,21:15,27.22,26.05,0,27.22,26.05,2,-34287,66034,100321,31747,0,-178,1217,0,0,,1395,1039
31,08-04-17,86,21:15,21:30,,,0,27.09,27.09,0,-29476,48257,77733,18781,0,0,0,0,0,,0,0
31,08-04-17,87,21:30,21:45,,,0,27.08,27.08,0,-42381,28702,71083,-13679,0,0,0,0,0,,0,0
31,08-04-17,88,21:45,22:00,40.93,,0,40.93,40.93,1,-79789,27029,106818,-52760,0,0,8752,0,0,,8752,8752
31,08-04-17,89,22:00,22:15,32.05,,0,32.05,32.05,1,-63014,16990,80004,-46024,0,0,12862,0,0,,12862,12862
31,08-04-17,90,22:15,22:30,,,0,27.07,27.07,0,-64279,14551,78830,-49728,0,0,455,0,0,,455,455
31,08-04-17,91,22:30,22:45,28.25,,0,28.25,28.25,1,-39200,19732,58932,-19468,0,0,397,0,0,,397,397
31,08-04-17,92,22:45,23:00,,,0,27.09,27.09,0,-36458,27529,63987,-8929,0,0,5,0,0,,5,5
31,08-04-17,93,23:00,23:15,303.12,,0,303.12,303.12,1,-59725,21987,81712,-37738,0,0,23012,0,0,,23012,23012
31,08-04-17,94,23:15,23:30,58.12,24.88,0,24.88,24.88,-1,-33791,51033,84824,17242,0,-336,22792,0,0,,23128,22456
31,08-04-17,95,23:30,23:45,58.12,21.05,0,21.05,21.05,-1,-28710,37081,65791,8371,0,-7007,91,0,0,,7098,-6916
31,08-04-17,96,23:45,0:00,,18.45,0,18.45,18.45,-1,-23644,56708,80352,33064,0,-8942,0,0,0,,8942,-8942
32,08-05-17,1,0:00,0:15,,25.03,0,25.03,25.03,-1,-18470,73708,92178,55238,0,-7000,0,0,0,,7000,-7000
32,08-05-17,2,0:15,0:30,,26.05,0,26.05,26.05,-1,-12180,83111,95291,70931,0,-631,0,0,0,,631,-631
32,08-05-17,3,0:30,0:45,,26.79,0,26.79,26.79,-1,-7769,79817,87586,72048,0,-1451,0,0,0,,1451,-1451
32,08-05-17,4,0:45,1:00,,5.14,0,5.14,5.14,-1,-33445,69876,103321,36431,0,-18791,0,0,0,,18791,-18791
32,08-05-17,5,1:00,1:15,,20.92,0,20.92,20.92,-1,-31017,115672,146689,84655,0,-17670,0,0,0,,17670,-17670
32,08-05-17,6,1:15,1:30,,,0,27.12,27.12,0,-28949,40858,69807,11909,0,-53,0,0,0,,53,-53
32,08-05-17,7,1:30,1:45,,26.05,0,26.05,26.05,-1,-31725,49451,81176,17726,0,-376,0,0,0,,376,-376
32,08-05-17,8,1:45,2:00,,25.03,0,25.03,25.03,-1,-53782,44876,98658,-8906,0,-1539,0,0,0,,1539,-1539
32,08-05-17,9,2:00,2:15,33.82,21.05,0,33.82,33.82,1,-57684,59203,116887,1519,0,-3200,1671,0,0,,4871,-1529
32,08-05-17,10,2:15,2:30,38.05,,0,38.05,38.05,1,-46232,23276,69508,-22956,0,0,9776,0,0,,9776,9776
32,08-05-17,11,2:30,2:45,,,0,27.12,27.12,0,-48406,26708,75114,-21698,0,0,58,0,0,,58,58
32,08-05-17,12,2:45,3:00,,,0,27.13,27.13,0,-51169,28459,79628,-22710,0,0,0,0,0,,0,0
32,08-05-17,13,3:00,3:15,38.05,,0,38.05,38.05,1,-60850,26465,87315,-34385,0,0,6531,0,0,,6531,6531
32,08-05-17,14,3:15,3:30,29.02,,0,29.02,29.02,1,-63256,22763,86019,-40493,0,0,6281,0,0,,6281,6281
32,08-05-17,15,3:30,3:45,38.05,,0,38.05,38.05,1,-67167,22060,89227,-45107,0,0,9460,0,0,,9460,9460
32,08-05-17,16,3:45,4:00,29.4,,0,29.4,29.4,1,-75276,28772,104048,-46504,0,0,7018,0,0,,7018,7018
32,08-05-17,17,4:00,4:15,27.46,,0,27.46,27.46,1,-32392,40166,72558,7774,0,0,2185,0,0,,2185,2185
32,08-05-17,18,4:15,4:30,,,0,27.11,27.11,0,-35349,32266,67615,-3083,0,0,35,0,0,,35,35
32,08-05-17,19,4:30,4:45,,,0,27.1,27.1,0,-34771,33194,67965,-1577,0,0,0,0,0,,0,0
32,08-05-17,20,4:45,5:00,,,0,27.08,27.08,0,-35511,26685,62196,-8826,0,0,0,0,0,,0,0
32,08-05-17,21,5:00,5:15,,24.57,0,24.57,24.57,-1,-32298,51583,83881,19285,0,-1709,0,0,0,,1709,-1709
32,08-05-17,22,5:15,5:30,,24.03,0,24.03,24.03,-1,-34905,41497,76402,6592,0,-7161,0,0,0,,7161,-7161
32,08-05-17,23,5:30,5:45,,26.05,0,26.05,26.05,-1,-38693,40223,78916,1530,0,-3342,0,0,0,,3342,-3342
32,08-05-17,24,5:45,6:00,,27.16,0,27.16,27.16,-1,-36666,42247,78913,5581,0,-400,0,0,0,,400,-400
32,08-05-17,25,6:00,6:15,,26.13,0,26.13,26.13,-1,-38995,43662,82657,4667,0,-494,0,0,0,,494,-494
32,08-05-17,26,6:15,6:30,,25.22,0,25.22,25.22,-1,-39692,43661,83353,3969,0,-4607,0,0,0,,4607,-4607
32,08-05-17,27,6:30,6:45,,26.63,0,26.63,26.63,-1,-51182,32568,83750,-18614,0,-1397,0,0,0,,1397,-1397
32,08-05-17,28,6:45,7:00,,21.22,0,21.22,21.22,-1,-41744,60108,101852,18364,0,-3187,0,0,0,,3187,-3187
32,08-05-17,29,7:00,7:15,,21.22,0,21.22,21.22,-1,-78278,76718,154996,-1560,0,-9139,0,0,0,,9139,-9139
32,08-05-17,30,7:15,7:30,,26.22,0,26.22,26.22,-1,-71766,62778,134544,-8988,0,-1530,0,0,0,,1530,-1530
32,08-05-17,31,7:30,7:45,27.64,26.6,0,27.64,27.64,1,-78321,49774,128095,-28547,0,-682,20,0,0,,702,-662
32,08-05-17,32,7:45,8:00,28.83,,0,28.83,28.83,1,-86308,77855,164163,-8453,0,0,1268,0,0,,1268,1268
32,08-05-17,33,8:00,8:15,29.02,,0,29.02,29.02,1,-114371,35244,149615,-79127,0,0,1740,0,0,,1740,1740
32,08-05-17,34,8:15,8:30,38.22,,0,38.22,38.22,1,-91703,28895,120598,-62808,0,0,4809,0,0,,4809,4809
32,08-05-17,35,8:30,8:45,102.34,,0,102.34,102.34,1,-116317,24046,140363,-92271,0,0,9849,0,0,,9849,9849
32,08-05-17,36,8:45,9:00,73.02,,0,73.02,73.02,1,-121184,38242,159426,-82942,0,0,11992,0,0,,11992,11992
32,08-05-17,37,9:00,9:15,32.22,,0,32.22,32.22,1,-101005,25927,126932,-75078,0,0,12869,0,0,,12869,12869
32,08-05-17,38,9:15,9:30,,,0,27.33,27.33,0,-85252,34519,119771,-50733,0,0,510,0,0,,510,510
32,08-05-17,39,9:30,9:45,,27.19,0,27.19,27.19,-1,-51195,37679,88874,-13516,0,-53,0,0,0,,53,-53
32,08-05-17,40,9:45,10:00,28.22,,0,28.22,28.22,1,-58700,29184,87884,-29516,0,0,45,0,0,,45,45
32,08-05-17,41,10:00,10:15,118.02,,0,118.02,118.02,1,-59894,27062,86956,-32832,0,0,20507,0,0,,20507,20507
32,08-05-17,42,10:15,10:30,38.22,,0,38.22,38.22,1,-57486,33467,90953,-24019,0,0,25581,0,0,,25581,25581
32,08-05-17,43,10:30,10:45,32.22,,0,32.22,32.22,1,-59766,34889,94655,-24877,0,0,17696,0,0,,17696,17696
32,08-05-17,44,10:45,11:00,38.22,,0,38.22,38.22,1,-58390,33643,92033,-24747,0,0,10051,0,0,,10051,10051
32,08-05-17,45,11:00,11:15,69.26,,0,69.26,69.26,1,-88445,21765,110210,-66680,0,0,22038,0,0,,22038,22038
32,08-05-17,46,11:15,11:30,41.5,,0,41.5,41.5,1,-55136,22537,77673,-32599,0,0,24285,0,0,,24285,24285
32,08-05-17,47,11:30,11:45,,,0,27.32,27.32,0,-47605,29199,76804,-18406,0,0,7591,0,0,,7591,7591
32,08-05-17,48,11:45,12:00,,25.22,0,25.22,25.22,-1,-39513,32739,72252,-6774,0,-18,0,0,0,,18,-18
32,08-05-17,49,12:00,12:15,,,0,27.26,27.26,0,-54739,47634,102373,-7105,0,0,0,0,0,,0,0
32,08-05-17,50,12:15,12:30,,,0,27.26,27.26,0,-48560,44913,93473,-3647,0,0,0,0,0,,0,0
32,08-05-17,51,12:30,12:45,,,0,27.26,27.26,0,-46026,63346,109372,17320,0,0,0,0,0,,0,0
32,08-05-17,52,12:45,13:00,,27.17,0,27.17,27.17,-1,-50734,68377,119111,17643,0,-47,0,0,0,,47,-47
32,08-05-17,53,13:00,13:15,,26.22,0,26.22,26.22,-1,-50615,65994,116609,15379,0,-719,0,0,0,,719,-719
32,08-05-17,54,13:15,13:30,32.22,,0,32.22,32.22,1,-55037,41143,96180,-13894,0,0,5811,0,0,,5811,5811
32,08-05-17,55,13:30,13:45,32.19,,0,32.19,32.19,1,-60472,50323,110795,-10149,0,0,15778,0,0,,15778,15778
32,08-05-17,56,13:45,14:00,28.02,25.22,0,25.22,25.22,-1,-55824,56343,112167,519,0,-1112,5552,0,0,,6664,4440
32,08-05-17,57,14:00,14:15,,24.03,0,24.03,24.03,-1,-39747,74196,113943,34449,0,-2143,0,0,0,,2143,-2143
32,08-05-17,58,14:15,14:30,,-1.47,0,-1.47,-1.47,-1,-36661,71046,107707,34385,0,-6776,0,0,0,,6776,-6776
32,08-05-17,59,14:30,14:45,,-15.51,0,-15.51,-15.51,-1,-41808,69052,110860,27244,0,-28078,0,0,0,,28078,-28078
32,08-05-17,60,14:45,15:00,,-7.03,0,-7.03,-7.03,-1,-49343,93078,142421,43735,0,-29622,0,0,0,,29622,-29622
32,08-05-17,61,15:00,15:15,,-150.03,0,-150.03,-150.03,-1,-24631,132297,156928,107666,0,-53490,0,0,0,,53490,-53490
32,08-05-17,62,15:15,15:30,,25.22,0,25.22,25.22,-1,-49681,100065,149746,50384,0,-5907,0,0,0,,5907,-5907
32,08-05-17,63,15:30,15:45,,-150.03,0,-150.03,-150.03,-1,-47240,122716,169956,75476,0,-14425,0,0,0,,14425,-14425
32,08-05-17,64,15:45,16:00,,23.61,0,23.61,23.61,-1,-49906,142095,192001,92189,0,-7714,0,0,0,,7714,-7714
32,08-05-17,65,16:00,16:15,,25.03,0,25.03,25.03,-1,-62017,123060,185077,61043,0,-10054,0,0,0,,10054,-10054
32,08-05-17,66,16:15,16:30,,24.35,0,24.35,24.35,-1,-60002,126929,186931,66927,0,-5713,0,0,0,,5713,-5713
32,08-05-17,67,16:30,16:45,,21.22,0,21.22,21.22,-1,-60410,120158,180568,59748,0,-11194,0,0,0,,11194,-11194
32,08-05-17,68,16:45,17:00,,-48.03,0,-48.03,-48.03,-1,-47673,119137,166810,71464,0,-15992,0,0,0,,15992,-15992
32,08-05-17,69,17:00,17:15,,25.22,0,25.22,25.22,-1,-105622,107696,213318,2074,0,-7690,0,0,0,,7690,-7690
32,08-05-17,70,17:15,17:30,,-57.03,0,-57.03,-57.03,-1,-59626,114865,174491,55239,0,-16368,0,0,0,,16368,-16368
32,08-05-17,71,17:30,17:45,,-73.78,0,-73.78,-73.78,-1,-46186,140012,186198,93826,0,-25975,0,0,0,,25975,-25975
32,08-05-17,72,17:45,18:00,,12.03,0,12.03,12.03,-1,-46401,134542,180943,88141,0,-32139,0,0,0,,32139,-32139
32,08-05-17,73,18:00,18:15,27.88,25.22,0,27.88,25.22,2,-76549,49769,126318,-26780,0,-8698,281,0,0,,8979,-8417
32,08-05-17,74,18:15,18:30,,11.13,0,11.13,11.13,-1,-39562,94811,134373,55249,0,-18192,0,0,0,,18192,-18192
32,08-05-17,75,18:30,18:45,,20.38,0,20.38,20.38,-1,-29037,104828,133865,75791,0,-14857,0,0,0,,14857,-14857
32,08-05-17,76,18:45,19:00,,27.13,0,27.13,27.13,-1,-34209,119041,153250,84832,0,-5263,0,0,0,,5263,-5263
32,08-05-17,77,19:00,19:15,,-11.03,0,-11.03,-11.03,-1,-51127,116093,167220,64966,0,-15418,0,0,0,,15418,-15418
32,08-05-17,78,19:15,19:30,,25.53,0,25.53,25.53,-1,-36734,84059,120793,47325,0,-4604,0,0,0,,4604,-4604
32,08-05-17,79,19:30,19:45,,,0,27.26,27.26,0,-48241,72158,120399,23917,0,-16,0,0,0,,16,-16
32,08-05-17,80,19:45,20:00,,,0,27.26,27.26,0,-46149,74078,120227,27929,0,0,0,0,0,,0,0
32,08-05-17,81,20:00,20:15,39.63,,0,39.63,39.63,1,-76168,71597,147765,-4571,0,0,1342,0,0,,1342,1342
32,08-05-17,82,20:15,20:30,75.21,,0,75.21,75.21,1,-78377,41023,119400,-37354,0,0,26728,0,0,,26728,26728
32,08-05-17,83,20:30,20:45,66.56,,0,66.56,66.56,1,-63511,41440,104951,-22071,0,0,34088,0,0,,34088,34088
32,08-05-17,84,20:45,21:00,32.22,26.53,0,26.53,26.53,-1,-44253,53150,97403,8897,0,-109,17318,0,0,,17427,17209
32,08-05-17,85,21:00,21:15,32.22,3.13,0,3.13,3.13,-1,-14033,108235,122268,94202,0,-14649,697,0,0,,15346,-13952
32,08-05-17,86,21:15,21:30,,25.22,0,25.22,25.22,-1,-30350,57009,87359,26659,0,-6753,0,0,0,,6753,-6753
32,08-05-17,87,21:30,21:45,28.29,25.22,0,28.29,28.29,1,-55231,38811,94042,-16420,0,-73,1440,0,0,,1513,1367
32,08-05-17,88,21:45,22:00,32.22,,0,32.22,32.22,1,-60858,37659,98517,-23199,0,0,4681,0,0,,4681,4681
32,08-05-17,89,22:00,22:15,27.57,27.13,0,27.13,27.13,-1,-29813,54188,84001,24375,0,-2,1659,0,0,,1661,1657
32,08-05-17,90,22:15,22:30,,7.33,0,7.33,7.33,-1,-18980,75281,94261,56301,0,-14886,0,0,0,,14886,-14886
32,08-05-17,91,22:30,22:45,,25.03,0,25.03,25.03,-1,-23281,66213,89494,42932,0,-17291,0,0,0,,17291,-17291
32,08-05-17,92,22:45,23:00,,-61.03,0,-61.03,-61.03,-1,-35478,95972,131450,60494,0,-21529,0,0,0,,21529,-21529
32,08-05-17,93,23:00,23:15,28.22,-61.03,0,28.22,28.22,1,-36473,46598,83071,10125,0,-22915,447,0,0,,23362,-22468
32,08-05-17,94,23:15,23:30,28.22,14.53,0,14.53,14.53,-1,-38959,89706,128665,50747,0,-5728,5,0,0,,5733,-5723
32,08-05-17,95,23:30,23:45,,-61.03,0,-61.03,-61.03,-1,-33578,124376,157954,90798,0,-29193,0,0,0,,29193,-29193
32,08-05-17,96,23:45,0:00,,-60.03,0,-60.03,-60.03,-1,-67270,105326,172596,38056,0,-50973,0,0,0,,50973,-50973
32,08-06-17,1,0:00,0:15,,-150.78,0,-150.78,-150.78,-1,-12356,93771,106127,81415,0,-34532,0,0,0,,34532,-34532
32,08-06-17,2,0:15,0:30,,-150.78,0,-150.78,-150.78,-1,-14592,96321,110913,81729,0,-36698,0,0,0,,36698,-36698
32,08-06-17,3,0:30,0:45,,-150.78,0,-150.78,-150.78,-1,-57063,72487,129550,15424,0,-50999,0,0,0,,50999,-50999
32,08-06-17,4,0:45,1:00,,4.52,0,4.52,4.52,-1,-46336,68455,114791,22119,0,-27307,0,0,0,,27307,-27307
32,08-06-17,5,1:00,1:15,,-150.78,0,-150.78,-150.78,-1,-38975,102638,141613,63663,0,-46435,0,0,0,,46435,-46435
32,08-06-17,6,1:15,1:30,,-150.78,0,-150.78,-150.78,-1,-18702,87604,106306,68902,0,-48707,0,0,0,,48707,-48707
32,08-06-17,7,1:30,1:45,,-150.78,0,-150.78,-150.78,-1,-13075,101302,114377,88227,0,-55764,0,0,0,,55764,-55764
32,08-06-17,8,1:45,2:00,,-150.78,0,-150.78,-150.78,-1,-8485,130642,139127,122157,0,-64459,0,0,0,,64459,-64459
32,08-06-17,9,2:00,2:15,,-150.78,0,-150.78,-150.78,-1,-27422,158434,185856,131012,0,-57656,0,0,0,,57656,-57656
32,08-06-17,10,2:15,2:30,,-150.78,0,-150.78,-150.78,-1,-25383,148822,174205,123439,0,-49607,0,0,0,,49607,-49607
32,08-06-17,11,2:30,2:45,,-150.78,0,-150.78,-150.78,-1,-72282,129932,202214,57650,0,-68032,0,0,0,,68032,-68032
32,08-06-17,12,2:45,3:00,,-150.78,0,-150.78,-150.78,-1,-45475,152103,197578,106628,0,-62026,0,0,0,,62026,-62026
32,08-06-17,13,3:00,3:15,,-150.78,0,-150.78,-150.78,-1,-98105,142860,240965,44755,0,-58900,0,0,0,,58900,-58900
32,08-06-17,14,3:15,3:30,,-38.78,0,-38.78,-38.78,-1,-46530,96187,142717,49657,0,-22926,0,0,0,,22926,-22926
32,08-06-17,15,3:30,3:45,,3.78,0,3.78,3.78,-1,-48534,78806,127340,30272,0,-29854,0,0,0,,29854,-29854
32,08-06-17,16,3:45,4:00,,10,0,10,10,-1,-60491,70215,130706,9724,0,-26596,0,0,0,,26596,-26596
32,08-06-17,17,4:00,4:15,28.22,10,0,28.22,28.22,1,-53991,53774,107765,-217,0,-4644,463,0,0,,5107,-4181
32,08-06-17,18,4:15,4:30,,27.2,0,27.2,27.2,-1,-50564,49319,99883,-1245,0,-174,0,0,0,,174,-174
32,08-06-17,19,4:30,4:45,,26.16,0,26.16,26.16,-1,-53908,54848,108756,940,0,-538,0,0,0,,538,-538
32,08-06-17,20,4:45,5:00,,26.16,0,26.16,26.16,-1,-52942,71222,124164,18280,0,-1668,0,0,0,,1668,-1668
32,08-06-17,21,5:00,5:15,,,0,27.16,27.16,0,-26090,62466,88556,36376,0,-141,0,0,0,,141,-141
32,08-06-17,22,5:15,5:30,,,0,27.16,27.16,0,-22323,61659,83982,39336,0,0,0,0,0,,0,0
32,08-06-17,23,5:30,5:45,,10,0,10,10,-1,-28733,59072,87805,30339,0,-1626,0,0,0,,1626,-1626
32,08-06-17,24,5:45,6:00,,-34.78,0,-34.78,-34.78,-1,-33174,60528,93702,27354,0,-19820,0,0,0,,19820,-19820
32,08-06-17,25,6:00,6:15,,-87.12,0,-87.12,-87.12,-1,-13353,113853,127206,100500,0,-20695,0,0,0,,20695,-20695
32,08-06-17,26,6:15,6:30,,-65,0,-65,-65,-1,-14748,91844,106592,77096,0,-24123,0,0,0,,24123,-24123
32,08-06-17,27,6:30,6:45,,-65,0,-65,-65,-1,-39708,76079,115787,36371,0,-31691,0,0,0,,31691,-31691
32,08-06-17,28,6:45,7:00,,0.98,0,0.98,0.98,-1,-25913,82459,108372,56546,0,-27991,0,0,0,,27991,-27991
32,08-06-17,29,7:00,7:15,,13.78,0,13.78,13.78,-1,-20923,70303,91226,49380,0,-20715,0,0,0,,20715,-20715
32,08-06-17,30,7:15,7:30,,25.25,0,25.25,25.25,-1,-23438,65016,88454,41578,0,-9912,0,0,0,,9912,-9912
32,08-06-17,31,7:30,7:45,,25.78,0,25.78,25.78,-1,-26703,56674,83377,29971,0,-6044,0,0,0,,6044,-6044
32,08-06-17,32,7:45,8:00,,27.2,0,27.2,27.2,-1,-38493,70274,108767,31781,0,-69,0,0,0,,69,-69
32,08-06-17,33,8:00,8:15,,25.25,0,25.25,25.25,-1,-38408,48669,87077,10261,0,-1938,0,0,0,,1938,-1938
32,08-06-17,34,8:15,8:30,,26.2,0,26.2,26.2,-1,-58286,53690,111976,-4596,0,-1803,0,0,0,,1803,-1803
32,08-06-17,35,8:30,8:45,,,0,27.16,27.16,0,-67689,60319,128008,-7370,0,-68,0,0,0,,68,-68
32,08-06-17,36,8:45,9:00,,,0,27.16,27.16,0,-72683,71651,144334,-1032,0,0,0,0,0,,0,0
32,08-06-17,37,9:00,9:15,,,0,27.16,27.16,0,-55277,81141,136418,25864,0,0,0,0,0,,0,0
32,08-06-17,38,9:15,9:30,,,0,27.16,27.16,0,-45565,87648,133213,42083,0,0,0,0,0,,0,0
32,08-06-17,39,9:30,9:45,,26.2,0,26.2,26.2,-1,-36931,97355,134286,60424,0,-18,0,0,0,,18,-18
32,08-06-17,40,9:45,10:00,,-77.87,0,-77.87,-77.87,-1,-37277,103038,140315,65761,0,-12137,0,0,0,,12137,-12137
32,08-06-17,41,10:00,10:15,,-74.57,0,-74.57,-74.57,-1,-63506,72095,135601,8589,0,-14075,0,0,0,,14075,-14075
32,08-06-17,42,10:15,10:30,,13.78,0,13.78,13.78,-1,-65373,87574,152947,22201,0,-5367,0,0,0,,5367,-5367
32,08-06-17,43,10:30,10:45,,15.05,0,15.05,15.05,-1,-72252,92387,164639,20135,0,-20954,0,0,0,,20954,-20954
32,08-06-17,44,10:45,11:00,,24.78,0,24.78,24.78,-1,-76013,89100,165113,13087,0,-14860,0,0,0,,14860,-14860
32,08-06-17,45,11:00,11:15,,24.08,0,24.08,24.08,-1,-72488,112670,185158,40182,0,-12125,0,0,0,,12125,-12125
32,08-06-17,46,11:15,11:30,,0.1,0,0.1,0.1,-1,-68945,107480,176425,38535,0,-23519,0,0,0,,23519,-23519
32,08-06-17,47,11:30,11:45,,17.78,0,17.78,17.78,-1,-76349,103816,180165,27467,0,-23219,0,0,0,,23219,-23219
32,08-06-17,48,11:45,12:00,,,0,27.16,27.16,0,-70915,106395,177310,35480,0,-3656,0,0,0,,3656,-3656
32,08-06-17,49,12:00,12:15,,,0,27.16,27.16,0,-46593,69080,115673,22487,0,0,0,0,0,,0,0
32,08-06-17,50,12:15,12:30,,25.25,0,25.25,25.25,-1,-41960,77075,119035,35115,0,-749,0,0,0,,749,-749
32,08-06-17,51,12:30,12:45,,26.81,0,26.81,26.81,-1,-52853,83353,136206,30500,0,-1273,0,0,0,,1273,-1273
32,08-06-17,52,12:45,13:00,,24.78,0,24.78,24.78,-1,-41043,74996,116039,33953,0,-2172,0,0,0,,2172,-2172
32,08-06-17,53,13:00,13:15,,-77.9,0,-77.9,-77.9,-1,-33246,71122,104368,37876,0,-21898,0,0,0,,21898,-21898
32,08-06-17,54,13:15,13:30,,-91.78,0,-91.78,-91.78,-1,-30651,76001,106652,45350,0,-31360,0,0,0,,31360,-31360
32,08-06-17,55,13:30,13:45,,-12.78,0,-12.78,-12.78,-1,-30248,53671,83919,23423,0,-30025,0,0,0,,30025,-30025
32,08-06-17,56,13:45,14:00,,-77.9,0,-77.9,-77.9,-1,-32725,63102,95827,30377,0,-39826,0,0,0,,39826,-39826
32,08-06-17,57,14:00,14:15,,-65,0,-65,-65,-1,-29498,81481,110979,51983,0,-33406,0,0,0,,33406,-33406
32,08-06-17,58,14:15,14:30,,-150.78,0,-150.78,-150.78,-1,-31715,93847,125562,62132,0,-36779,0,0,0,,36779,-36779
32,08-06-17,59,14:30,14:45,,-65,0,-65,-65,-1,-29930,68613,98543,38683,0,-44432,0,0,0,,44432,-44432
32,08-06-17,60,14:45,15:00,,-78.1,0,-78.1,-78.1,-1,-31565,96404,127969,64839,0,-40928,0,0,0,,40928,-40928
32,08-06-17,61,15:00,15:15,,-1.62,0,-1.62,-1.62,-1,-41647,76762,118409,35115,0,-34236,0,0,0,,34236,-34236
32,08-06-17,62,15:15,15:30,,24.78,0,24.78,24.78,-1,-34973,71337,106310,36364,0,-19830,0,0,0,,19830,-19830
32,08-06-17,63,15:30,15:45,,24.78,0,24.78,24.78,-1,-43268,72759,116027,29491,0,-18412,0,0,0,,18412,-18412
32,08-06-17,64,15:45,16:00,28.2,25.78,0,28.2,28.2,1,-42021,46729,88750,4708,0,-9502,292,0,0,,9794,-9210
32,08-06-17,65,16:00,16:15,28.2,13.9,0,28.2,13.9,2,-55403,84298,139701,28895,0,-3232,481,0,0,,3713,-2751
32,08-06-17,66,16:15,16:30,,24.78,0,24.78,24.78,-1,-45563,52017,97580,6454,0,-2820,0,0,0,,2820,-2820
32,08-06-17,67,16:30,16:45,28.5,,0,28.5,28.5,1,-60929,28006,88935,-32923,0,0,124,0,0,,124,124
32,08-06-17,68,16:45,17:00,32.2,,0,32.2,32.2,1,-91141,14761,105902,-76380,0,0,812,0,0,,812,812
32,08-06-17,69,17:00,17:15,,,0,27.16,27.16,0,-110165,75111,185276,-35054,0,0,0,0,0,,0,0
32,08-06-17,70,17:15,17:30,,,0,27.16,27.16,0,-94663,76577,171240,-18086,0,0,0,0,0,,0,0
32,08-06-17,71,17:30,17:45,32.2,,0,32.2,32.2,1,-105537,75718,181255,-29819,0,0,528,0,0,,528,528
32,08-06-17,72,17:45,18:00,117.12,,0,117.12,117.12,1,-128007,42463,170470,-85544,0,0,9369,0,0,,9369,9369
32,08-06-17,73,18:00,18:15,138.12,21.2,0,138.12,21.2,2,-83307,38162,121469,-45145,0,-117,31843,0,0,,31960,31726
32,08-06-17,74,18:15,18:30,138.12,-56.78,0,-56.78,-56.78,-1,-24555,66679,91234,42124,0,-22018,410,0,0,,22428,-21608
32,08-06-17,75,18:30,18:45,,25.78,0,25.78,25.78,-1,-40098,83886,123984,43788,0,-8062,0,0,0,,8062,-8062
32,08-06-17,76,18:45,19:00,,24.08,0,24.08,24.08,-1,-29950,117606,147556,87656,0,-4417,0,0,0,,4417,-4417
32,08-06-17,77,19:00,19:15,,16.8,0,16.8,16.8,-1,-43042,66751,109793,23709,0,-17071,0,0,0,,17071,-17071
32,08-06-17,78,19:15,19:30,27.85,25.2,0,27.85,27.85,1,-53505,56890,110395,3385,0,-13516,54,0,0,,13570,-13462
32,08-06-17,79,19:30,19:45,32.2,25.2,0,32.2,32.2,1,-67619,51266,118885,-16353,0,-390,738,0,0,,1128,348
32,08-06-17,80,19:45,20:00,79.12,,0,79.12,79.12,1,-74791,33481,108272,-41310,0,0,8751,0,0,,8751,8751
32,08-06-17,81,20:00,20:15,40.95,,0,40.95,40.95,1,-57285,30076,87361,-27209,0,0,12237,0,0,,12237,12237
32,08-06-17,82,20:15,20:30,53.62,,0,53.62,53.62,1,-61736,24897,86633,-36839,0,0,20895,0,0,,20895,20895
32,08-06-17,83,20:30,20:45,40.95,,0,40.95,40.95,1,-57923,35124,93047,-22799,0,0,24518,0,0,,24518,24518
32,08-06-17,84,20:45,21:00,73.12,,0,73.12,73.12,1,-63765,36549,100314,-27216,0,0,33896,0,0,,33896,33896
32,08-06-17,85,21:00,21:15,28.2,25.78,0,28.2,25.78,2,-38750,63437,102187,24687,0,-785,10637,0,0,,11422,9852
32,08-06-17,86,21:15,21:30,,,0,27.33,27.33,0,-43694,47630,91324,3936,0,-5,0,0,0,,5,-5
32,08-06-17,87,21:30,21:45,58.12,,0,58.12,58.12,1,-64190,28335,92525,-35855,0,0,9569,0,0,,9569,9569
32,08-06-17,88,21:45,22:00,118.12,,0,118.12,118.12,1,-73319,30784,104103,-42535,0,0,40175,0,0,,40175,40175
32,08-06-17,89,22:00,22:15,32.2,25.2,0,25.2,25.2,-1,-47210,62038,109248,14828,0,-1109,14547,0,0,,15656,13438
32,08-06-17,90,22:15,22:30,,21.2,0,21.2,21.2,-1,-25685,49169,74854,23484,0,-7645,0,0,0,,7645,-7645
32,08-06-17,91,22:30,22:45,,21.2,0,21.2,21.2,-1,-17533,48400,65933,30867,0,-12720,0,0,0,,12720,-12720
32,08-06-17,92,22:45,23:00,,-41.78,0,-41.78,-41.78,-1,-22800,74569,97369,51769,0,-12515,0,0,0,,12515,-12515
32,08-06-17,93,23:00,23:15,27.85,22.65,0,27.85,27.85,1,-67093,26677,93770,-40416,0,-8521,272,0,0,,8793,-8249
32,08-06-17,94,23:15,23:30,27.85,,0,27.85,27.85,1,-47212,35486,82698,-11726,0,0,964,0,0,,964,964
32,08-06-17,95,23:30,23:45,,25.2,0,25.2,25.2,-1,-25436,47771,73207,22335,0,-3037,0,0,0,,3037,-3037
32,08-06-17,96,23:45,0:00,,3.41,0,3.41,3.41,-1,-26935,76518,103453,49583,0,-23877,0,0,0,,23877,-23877
32,08-07-17,1,0:00,0:15,249.02,15,0,249.02,15,2,-83809,28465,112274,-55344,0,-13460,6032,0,0,,19492,-7428
32,08-07-17,2,0:15,0:30,32.03,,0,32.03,32.03,1,-63698,27843,91541,-35855,0,0,5502,0,0,,5502,5502
32,08-07-17,3,0:30,0:45,32.03,26.81,0,26.81,26.81,-1,-44660,25043,69703,-19617,0,-57,436,0,0,,493,379
32,08-07-17,4,0:45,1:00,,26.81,0,26.81,26.81,-1,-64902,32350,97252,-32552,0,-500,0,0,0,,500,-500
32,08-07-17,5,1:00,1:15,32.03,24.08,0,32.03,24.08,2,-85005,66648,151653,-18357,0,-746,638,0,0,,1384,-108
32,08-07-17,6,1:15,1:30,32.03,,0,32.03,32.03,1,-60186,30040,90226,-30146,0,0,1692,0,0,,1692,1692
32,08-07-17,7,1:30,1:45,,,0,27.11,27.11,0,-54809,36313,91122,-18496,0,0,114,0,0,,114,114
32,08-07-17,8,1:45,2:00,,18.03,0,18.03,18.03,-1,-51492,44012,95504,-7480,0,-2210,0,0,0,,2210,-2210
32,08-07-17,9,2:00,2:15,28.03,10,0,28.03,28.03,1,-51866,59417,111283,7551,0,-3895,65,0,0,,3960,-3830
32,08-07-17,10,2:15,2:30,32.03,27.2,0,32.03,27.11,2,-44645,41128,85773,-3517,0,-7,2567,0,0,,2574,2560
32,08-07-17,11,2:30,2:45,,10,0,10,10,-1,-25139,46046,71185,20907,0,-3054,0,0,0,,3054,-3054
32,08-07-17,12,2:45,3:00,,-0.03,0,-0.03,-0.03,-1,-28192,44014,72206,15822,0,-22175,0,0,0,,22175,-22175
32,08-07-17,13,3:00,3:15,,,0,27.11,27.11,0,-50001,37316,87317,-12685,0,-2465,0,0,0,,2465,-2465
32,08-07-17,14,3:15,3:30,,,0,27.11,27.11,0,-34890,27482,62372,-7408,0,0,0,0,0,,0,0
32,08-07-17,15,3:30,3:45,,,0,27.11,27.11,0,-21521,40865,62386,19344,0,0,0,0,0,,0,0
32,08-07-17,16,3:45,4:00,,,0,27.11,27.11,0,-27023,67496,94519,40473,0,0,0,0,0,,0,0
32,08-07-17,17,4:00,4:15,,25.25,0,25.25,25.25,-1,-20717,46546,67263,25829,0,-320,0,0,0,,320,-320
32,08-07-17,18,4:15,4:30,,25.03,0,25.03,25.03,-1,-21557,52855,74412,31298,0,-2899,0,0,0,,2899,-2899
32,08-07-17,19,4:30,4:45,,9.84,0,9.84,9.84,-1,-22873,56848,79721,33975,0,-5457,0,0,0,,5457,-5457
32,08-07-17,20,4:45,5:00,,-100,0,-100,-100,-1,-22980,65744,88724,42764,0,-16802,0,0,0,,16802,-16802
32,08-07-17,21,5:00,5:15,,18.37,0,18.37,18.37,-1,-31920,32386,64306,466,0,-12181,0,0,0,,12181,-12181
32,08-07-17,22,5:15,5:30,,15,0,15,15,-1,-31984,45080,77064,13096,0,-9311,0,0,0,,9311,-9311
32,08-07-17,23,5:30,5:45,,-10.03,0,-10.03,-10.03,-1,-31828,76220,108048,44392,0,-11316,0,0,0,,11316,-11316
32,08-07-17,24,5:45,6:00,,-15.51,0,-15.51,-15.51,-1,-27310,83880,111190,56570,0,-34976,0,0,0,,34976,-34976
32,08-07-17,25,6:00,6:15,,23.03,0,23.03,23.03,-1,-32730,90923,123653,58193,0,-8981,0,0,0,,8981,-8981
32,08-07-17,26,6:15,6:30,,15,0,15,15,-1,-22455,89900,112355,67445,0,-3057,0,0,0,,3057,-3057
32,08-07-17,27,6:30,6:45,,21.04,0,21.04,21.04,-1,-17787,74808,92595,57021,0,-2257,0,0,0,,2257,-2257
32,08-07-17,28,6:45,7:00,,28.35,0,28.35,28.35,-1,-26249,103266,129515,77017,0,-83,0,0,0,,83,-83
32,08-07-17,29,7:00,7:15,,-19.52,0,-19.52,-19.52,-1,-24814,122739,147553,97925,0,-20511,0,0,0,,20511,-20511
32,08-07-17,30,7:15,7:30,,17.99,0,17.99,17.99,-1,-16479,92250,108729,75771,0,-12922,0,0,0,,12922,-12922
32,08-07-17,31,7:30,7:45,,,0,28.18,28.18,0,-18311,70711,89022,52400,0,-97,0,0,0,,97,-97
32,08-07-17,32,7:45,8:00,,,0,28.18,28.18,0,-37627,98100,135727,60473,0,0,0,0,0,,0,0
32,08-07-17,33,8:00,8:15,,15,0,15,15,-1,-49899,98874,148773,48975,0,-1637,0,0,0,,1637,-1637
32,08-07-17,34,8:15,8:30,,11.68,0,11.68,11.68,-1,-45604,70397,116001,24793,0,-7649,0,0,0,,7649,-7649
32,08-07-17,35,8:30,8:45,,24.03,0,24.03,24.03,-1,-38658,62656,101314,23998,0,-2357,0,0,0,,2357,-2357
32,08-07-17,36,8:45,9:00,,,0,28.18,28.18,0,-46884,61236,108120,14352,0,-158,0,0,0,,158,-158
32,08-07-17,37,9:00,9:15,,15,0,15,15,-1,-48298,80398,128696,32100,0,-2948,0,0,0,,2948,-2948
32,08-07-17,38,9:15,9:30,,11.68,0,11.68,11.68,-1,-42204,68627,110831,26423,0,-6251,0,0,0,,6251,-6251
32,08-07-17,39,9:30,9:45,,5.44,0,5.44,5.44,-1,-41916,79848,121764,37932,0,-21267,0,0,0,,21267,-21267
32,08-07-17,40,9:45,10:00,,16.88,0,16.88,16.88,-1,-44670,77538,122208,32868,0,-22965,0,0,0,,22965,-22965
32,08-07-17,41,10:00,10:15,,21.22,0,21.22,21.22,-1,-60329,72914,133243,12585,0,-13850,0,0,0,,13850,-13850
32,08-07-17,42,10:15,10:30,,10,0,10,10,-1,-53323,79437,132760,26114,0,-16785,0,0,0,,16785,-16785
32,08-07-17,43,10:30,10:45,,20.03,0,20.03,20.03,-1,-58824,67011,125835,8187,0,-14233,0,0,0,,14233,-14233
32,08-07-17,44,10:45,11:00,,,0,28.18,28.18,0,-59910,79122,139032,19212,0,-205,0,0,0,,205,-205
32,08-07-17,45,11:00,11:15,,24.01,0,24.01,24.01,-1,-62328,83750,146078,21422,0,-470,0,0,0,,470,-470
32,08-07-17,46,11:15,11:30,,21.13,0,21.13,21.13,-1,-61360,67654,129014,6294,0,-4003,0,0,0,,4003,-4003
32,08-07-17,47,11:30,11:45,,26.26,0,26.26,26.26,-1,-58276,82237,140513,23961,0,-3842,0,0,0,,3842,-3842
32,08-07-17,48,11:45,12:00,,,0,28.15,28.15,0,-56657,85276,141933,28619,0,-389,0,0,0,,389,-389
32,08-07-17,49,12:00,12:15,,12.53,0,12.53,12.53,-1,-48980,105621,154601,56641,0,-8309,0,0,0,,8309,-8309
32,08-07-17,50,12:15,12:30,,0,0,0,0,-1,-47229,108745,155974,61516,0,-20424,0,0,0,,20424,-20424
32,08-07-17,51,12:30,12:45,,0,0,0,0,-1,-55206,104706,159912,49500,0,-30398,0,0,0,,30398,-30398
32,08-07-17,52,12:45,13:00,,10,0,10,10,-1,-52399,90231,142630,37832,0,-14561,0,0,0,,14561,-14561
32,08-07-17,53,13:00,13:15,,22.39,0,22.39,22.39,-1,-81059,81747,162806,688,0,-9377,0,0,0,,9377,-9377
32,08-07-17,54,13:15,13:30,,,0,28.19,28.19,0,-61042,62475,123517,1433,0,-22,0,0,0,,22,-22
32,08-07-17,55,13:30,13:45,,25.58,0,25.58,25.58,-1,-61398,61013,122411,-385,0,-1397,0,0,0,,1397,-1397
32,08-07-17,56,13:45,14:00,,25.59,0,25.59,25.59,-1,-64515,60638,125153,-3877,0,-455,0,0,0,,455,-455
32,08-07-17,57,14:00,14:15,,24.69,0,24.69,24.69,-1,-51821,106666,158487,54845,0,-383,0,0,0,,383,-383
32,08-07-17,58,14:15,14:30,,,0,28.16,28.16,0,-44074,97148,141222,53074,0,0,0,0,0,,0,0
32,08-07-17,59,14:30,14:45,,,0,28.17,28.17,0,-51205,82450,133655,31245,0,0,0,0,0,,0,0
32,08-07-17,60,14:45,15:00,,24.29,0,24.29,24.29,-1,-50391,88316,138707,37925,0,-1374,0,0,0,,1374,-1374
32,08-07-17,61,15:00,15:15,,26.11,0,26.11,26.11,-1,-69366,139297,208663,69931,0,-2464,0,0,0,,2464,-2464
32,08-07-17,62,15:15,15:30,,25.64,0,25.64,25.64,-1,-57414,116671,174085,59257,0,-1072,0,0,0,,1072,-1072
32,08-07-17,63,15:30,15:45,,27.29,0,27.29,27.29,-1,-29617,106076,135693,76459,0,-508,0,0,0,,508,-508
32,08-07-17,64,15:45,16:00,,27.28,0,27.28,27.28,-1,-33803,99313,133116,65510,0,-825,0,0,0,,825,-825
32,08-07-17,65,16:00,16:15,,28.78,0,28.78,28.78,-1,-70725,73166,143891,2441,0,-205,0,0,0,,205,-205
32,08-07-17,66,16:15,16:30,,21.61,0,21.61,21.61,-1,-48094,67600,115694,19506,0,-3821,0,0,0,,3821,-3821
32,08-07-17,67,16:30,16:45,,28.74,0,28.74,28.74,-1,-54021,55510,109531,1489,0,-770,0,0,0,,770,-770
32,08-07-17,68,16:45,17:00,,,0,28.16,28.16,0,-54286,59772,114058,5486,0,0,0,0,0,,0,0
32,08-07-17,69,17:00,17:15,,,0,28.19,28.19,0,-49699,80351,130050,30652,0,0,0,0,0,,0,0
32,08-07-17,70,17:15,17:30,,,0,28.18,28.18,0,-44685,53043,97728,8358,0,0,0,0,0,,0,0
32,08-07-17,71,17:30,17:45,37.62,,0,37.62,37.62,1,-61511,46421,107932,-15090,0,0,4097,0,0,,4097,4097
32,08-07-17,72,17:45,18:00,61.02,,0,61.02,61.02,1,-75186,37950,113136,-37236,0,0,26604,0,0,,26604,26604
32,08-07-17,73,18:00,18:15,30.55,9.66,0,9.66,9.66,-1,-45374,31752,77126,-13622,0,-1976,13101,0,0,,15077,11125
32,08-07-17,74,18:15,18:30,,1.89,0,1.89,1.89,-1,-34368,52922,87290,18554,0,-16384,0,0,0,,16384,-16384
32,08-07-17,75,18:30,18:45,,,0,28.19,28.19,0,-38286,47209,85495,8923,0,-918,0,0,0,,918,-918
32,08-07-17,76,18:45,19:00,,,0,28.19,28.19,0,-39548,41036,80584,1488,0,0,0,0,0,,0,0
32,08-07-17,77,19:00,19:15,,,0,28.17,28.17,0,-27000,32259,59259,5259,0,0,0,0,0,,0,0
32,08-07-17,78,19:15,19:30,29,,0,29,29,1,-28980,20406,49386,-8574,0,0,1203,0,0,,1203,1203
32,08-07-17,79,19:30,19:45,29.46,,0,29.46,29.46,1,-29845,27873,57718,-1972,0,0,1259,0,0,,1259,1259
32,08-07-17,80,19:45,20:00,27.62,,0,27.62,27.62,1,-36946,33009,69955,-3937,0,0,1145,0,0,,1145,1145
32,08-07-17,81,20:00,20:15,31.43,,0,31.43,31.43,1,-37566,19660,57226,-17906,0,0,2939,0,0,,2939,2939
32,08-07-17,82,20:15,20:30,37.62,,0,37.62,37.62,1,-41235,14626,55861,-26609,0,0,12927,0,0,,12927,12927
32,08-07-17,83,20:30,20:45,27.62,,0,27.62,27.62,1,-31867,18956,50823,-12911,0,0,2868,0,0,,2868,2868
32,08-07-17,84,20:45,21:00,,,0,28.19,28.19,0,-27109,23338,50447,-3771,0,0,35,0,0,,35,35
32,08-07-17,85,21:00,21:15,,,0,28.18,28.18,0,-37508,30103,67611,-7405,0,0,0,0,0,,0,0
32,08-07-17,86,21:15,21:30,30.04,,0,30.04,30.04,1,-39204,19254,58458,-19950,0,0,965,0,0,,965,965
32,08-07-17,87,21:30,21:45,31.62,,0,31.62,31.62,1,-64028,11738,75766,-52290,0,0,1184,0,0,,1184,1184
32,08-07-17,88,21:45,22:00,31.9,,0,31.9,31.9,1,-63247,14425,77672,-48822,0,0,4037,0,0,,4037,4037
32,08-07-17,89,22:00,22:15,27.62,,0,27.62,27.62,1,-83510,32004,115514,-51506,0,0,621,0,0,,621,621
32,08-07-17,90,22:15,22:30,27.62,,0,27.62,27.62,1,-49858,30133,79991,-19725,0,0,54,0,0,,54,54
32,08-07-17,91,22:30,22:45,,21.24,0,21.24,21.24,-1,-33368,50437,83805,17069,0,-5068,0,0,0,,5068,-5068
32,08-07-17,92,22:45,23:00,,19.75,0,19.75,19.75,-1,-50560,64681,115241,14121,0,-9413,0,0,0,,9413,-9413
32,08-07-17,93,23:00,23:15,30.37,15,0,30.37,15,2,-39530,30765,70295,-8765,0,-7898,850,0,0,,8748,-7048
32,08-07-17,94,23:15,23:30,,,0,27.34,27.34,0,-57206,36794,94000,-20412,0,-3,0,0,0,,3,-3
32,08-07-17,95,23:30,23:45,,,0,27.41,27.41,0,-64112,33053,97165,-31059,0,0,0,0,0,,0,0
32,08-07-17,96,23:45,0:00,,,0,27.46,27.46,0,-83182,41204,124386,-41978,0,0,0,0,0,,0,0
32,08-08-17,1,0:00,0:15,,25.28,0,25.28,25.28,-1,-52462,65143,117605,12681,0,-320,0,0,0,,320,-320
32,08-08-17,2,0:15,0:30,,,0,27.66,27.66,0,-50957,27945,78902,-23012,0,0,0,0,0,,0,0
32,08-08-17,3,0:30,0:45,32.28,,0,32.28,32.28,1,-49408,30058,79466,-19350,0,0,861,0,0,,861,861
32,08-08-17,4,0:45,1:00,,21.28,0,21.28,21.28,-1,-41207,51865,93072,10658,0,-7733,0,0,0,,7733,-7733
32,08-08-17,5,1:00,1:15,54.86,-1.76,0,54.86,54.86,1,-58130,48140,106270,-9990,0,-11729,5834,0,0,,17563,-5895
32,08-08-17,6,1:15,1:30,33.74,,0,33.74,33.74,1,-43434,44798,88232,1364,0,0,7110,0,0,,7110,7110
32,08-08-17,7,1:30,1:45,,,0,27.7,27.7,0,-39585,62452,102037,22867,0,0,6,0,0,,6,6
32,08-08-17,8,1:45,2:00,,26.28,0,26.28,26.28,-1,-50221,56740,106961,6519,0,-675,0,0,0,,675,-675
32,08-08-17,9,2:00,2:15,,25.24,0,25.24,25.24,-1,-21338,52880,74218,31542,0,-812,0,0,0,,812,-812
32,08-08-17,10,2:15,2:30,27.8,,0,27.8,27.8,1,-38271,34707,72978,-3564,0,0,69,0,0,,69,69
32,08-08-17,11,2:30,2:45,,,0,27.67,27.67,0,-30507,47480,77987,16973,0,0,0,0,0,,0,0
32,08-08-17,12,2:45,3:00,,20.34,0,20.34,20.34,-1,-26829,64683,91512,37854,0,-5740,0,0,0,,5740,-5740
32,08-08-17,13,3:00,3:15,,15.94,0,15.94,15.94,-1,-27562,53776,81338,26214,0,-13272,0,0,0,,13272,-13272
32,08-08-17,14,3:15,3:30,,,0,27.67,27.67,0,-27637,65775,93412,38138,0,-925,0,0,0,,925,-925
32,08-08-17,15,3:30,3:45,,-21.76,0,-21.76,-21.76,-1,-28202,72935,101137,44733,0,-7679,0,0,0,,7679,-7679
32,08-08-17,16,3:45,4:00,,-29.76,0,-29.76,-29.76,-1,-36506,62147,98653,25641,0,-29679,0,0,0,,29679,-29679
32,08-08-17,17,4:00,4:15,,27.56,0,27.56,27.56,-1,-35201,50934,86135,15733,0,-8029,0,0,0,,8029,-8029
32,08-08-17,18,4:15,4:30,,,0,27.68,27.68,0,-30778,45326,76104,14548,0,0,0,0,0,,0,0
32,08-08-17,19,4:30,4:45,,,0,27.69,27.69,0,-30754,39882,70636,9128,0,0,0,0,0,,0,0
32,08-08-17,20,4:45,5:00,28.28,,0,28.28,28.28,1,-24912,31395,56307,6483,0,0,468,0,0,,468,468
32,08-08-17,21,5:00,5:15,32.28,26.28,0,32.28,26.28,2,-59709,42875,102584,-16834,0,-349,547,0,0,,896,198
32,08-08-17,22,5:15,5:30,,26.71,0,26.71,26.71,-1,-48654,28622,77276,-20032,0,-766,0,0,0,,766,-766
32,08-08-17,23,5:30,5:45,,27.16,0,27.16,27.16,-1,-52251,20046,72297,-32205,0,-474,0,0,0,,474,-474
32,08-08-17,24,5:45,6:00,,,0,28.77,28.77,0,-48724,31325,80049,-17399,0,0,0,0,0,,0,0
32,08-08-17,25,6:00,6:15,,,0,28.81,28.81,0,-113044,54150,167194,-58894,0,0,0,0,0,,0,0
32,08-08-17,26,6:15,6:30,,26.28,0,26.28,26.28,-1,-49395,50506,99901,1111,0,-1331,0,0,0,,1331,-1331
32,08-08-17,27,6:30,6:45,,24.2,0,24.2,24.2,-1,-47271,60506,107777,13235,0,-4611,0,0,0,,4611,-4611
32,08-08-17,28,6:45,7:00,,11.47,0,11.47,11.47,-1,-58747,102337,161084,43590,0,-10313,0,0,0,,10313,-10313
32,08-08-17,29,7:00,7:15,,3.91,0,3.91,3.91,-1,-63515,87638,151153,24123,0,-32231,0,0,0,,32231,-32231
32,08-08-17,30,7:15,7:30,,3.45,0,3.45,3.45,-1,-28210,90973,119183,62763,0,-39684,0,0,0,,39684,-39684
32,08-08-17,31,7:30,7:45,,19.74,0,19.74,19.74,-1,-31236,55593,86829,24357,0,-24315,0,0,0,,24315,-24315
32,08-08-17,32,7:45,8:00,,,0,29.01,29.01,0,-46294,76293,122587,29999,0,-705,0,0,0,,705,-705
32,08-08-17,33,8:00,8:15,,,0,29.01,29.01,0,-65259,77700,142959,12441,0,0,0,0,0,,0,0
32,08-08-17,34,8:15,8:30,28.28,,0,28.28,28.28,1,-45293,63538,108831,18245,0,0,50,0,0,,50,50
32,08-08-17,35,8:30,8:45,28.28,,0,28.28,28.28,1,-36914,42383,79297,5469,0,0,144,0,0,,144,144
32,08-08-17,36,8:45,9:00,111.74,,0,111.74,111.74,1,-62478,29612,92090,-32866,0,0,10928,0,0,,10928,10928
32,08-08-17,37,9:00,9:15,35.74,,0,35.74,35.74,1,-46778,64049,110827,17271,0,0,12113,0,0,,12113,12113
32,08-08-17,38,9:15,9:30,35.74,29.04,0,29.04,29.04,-1,-43720,51901,95621,8181,0,-281,109,0,0,,390,-172
32,08-08-17,39,9:30,9:45,32.91,,0,32.91,32.91,1,-64548,44625,109173,-19923,0,0,2947,0,0,,2947,2947
32,08-08-17,40,9:45,10:00,60.74,,0,60.74,60.74,1,-72435,28216,100651,-44219,0,0,24297,0,0,,24297,24297
32,08-08-17,41,10:00,10:15,32.28,26.53,0,26.53,26.53,-1,-34391,104693,139084,70302,0,-667,11872,0,0,,12539,11205
32,08-08-17,42,10:15,10:30,,,0,29.01,29.01,0,-39168,109517,148685,70349,0,-46,0,0,0,,46,-46
32,08-08-17,43,10:30,10:45,,,0,29.01,29.01,0,-46185,109233,155418,63048,0,0,0,0,0,,0,0
32,08-08-17,44,10:45,11:00,,28.63,0,28.63,28.63,-1,-53542,103215,156757,49673,0,-47,0,0,0,,47,-47
32,08-08-17,45,11:00,11:15,,28.63,0,28.63,28.63,-1,-45737,125715,171452,79978,0,-990,0,0,0,,990,-990
32,08-08-17,46,11:15,11:30,,29.74,0,29.74,29.74,-1,-57727,123661,181388,65934,0,-397,0,0,0,,397,-397
32,08-08-17,47,11:30,11:45,,,0,29.01,29.01,0,-63867,105656,169523,41789,0,0,0,0,0,,0,0
32,08-08-17,48,11:45,12:00,,,0,29.01,29.01,0,-75687,108481,184168,32794,0,0,0,0,0,,0,0
32,08-08-17,49,12:00,12:15,76.74,,0,76.74,76.74,1,-93178,56655,149833,-36523,0,0,9606,0,0,,9606,9606
32,08-08-17,50,12:15,12:30,130.74,,0,130.74,130.74,1,-100465,46990,147455,-53475,0,0,40562,0,0,,40562,40562
32,08-08-17,51,12:30,12:45,49.29,,0,49.29,49.29,1,-75663,62512,138175,-13151,0,0,31819,0,0,,31819,31819
32,08-08-17,52,12:45,13:00,49.29,26.28,0,26.28,26.28,-1,-65392,87285,152677,21893,0,-649,2412,0,0,,3061,1763
32,08-08-17,53,13:00,13:15,51,,0,51,51,1,-100757,80866,181623,-19891,0,0,5235,0,0,,5235,5235
32,08-08-17,54,13:15,13:30,56.74,,0,56.74,56.74,1,-91985,60840,152825,-31145,0,0,20169,0,0,,20169,20169
32,08-08-17,55,13:30,13:45,51,,0,51,51,1,-87826,55587,143413,-32239,0,0,28661,0,0,,28661,28661
32,08-08-17,56,13:45,14:00,40,29.02,0,29.02,29.02,-1,-86600,68692,155292,-17908,0,-5,20311,0,0,,20316,20306
32,08-08-17,57,14:00,14:15,40,26.5,0,26.5,26.5,-1,-62542,78649,141191,16107,0,-671,1284,0,0,,1955,613
32,08-08-17,58,14:15,14:30,,,0,29.01,29.01,0,-62756,81332,144088,18576,0,0,0,0,0,,0,0
32,08-08-17,59,14:30,14:45,,,0,29.01,29.01,0,-73455,71744,145199,-1711,0,0,0,0,0,,0,0
32,08-08-17,60,14:45,15:00,,,0,29.01,29.01,0,-81979,68872,150851,-13107,0,0,0,0,0,,0,0
32,08-08-17,61,15:00,15:15,,,0,29.01,29.01,0,-59168,71340,130508,12172,0,0,0,0,0,,0,0
32,08-08-17,62,15:15,15:30,,,0,29.01,29.01,0,-71805,66715,138520,-5090,0,0,0,0,0,,0,0
32,08-08-17,63,15:30,15:45,32.28,,0,32.28,32.28,1,-63482,50670,114152,-12812,0,0,1914,0,0,,1914,1914
32,08-08-17,64,15:45,16:00,31.85,,0,31.85,31.85,1,-65486,51623,117109,-13863,0,0,6764,0,0,,6764,6764
32,08-08-17,65,16:00,16:15,31.85,17.6,0,17.6,17.6,-1,-54255,81577,135832,27322,0,-9925,652,0,0,,10577,-9273
32,08-08-17,66,16:15,16:30,,26.17,0,26.17,26.17,-1,-53383,58085,111468,4702,0,-2982,0,0,0,,2982,-2982
32,08-08-17,67,16:30,16:45,,25.6,0,25.6,25.6,-1,-42009,57115,99124,15106,0,-10797,0,0,0,,10797,-10797
32,08-08-17,68,16:45,17:00,,25.28,0,25.28,25.28,-1,-46955,67533,114488,20578,0,-13530,0,0,0,,13530,-13530
32,08-08-17,69,17:00,17:15,,25.28,0,25.28,25.28,-1,-43342,70602,113944,27260,0,-12118,0,0,0,,12118,-12118
32,08-08-17,70,17:15,17:30,,25.28,0,25.28,25.28,-1,-30644,54967,85611,24323,0,-16152,0,0,0,,16152,-16152
32,08-08-17,71,17:30,17:45,34.12,27.54,0,34.12,34.12,1,-46292,27989,74281,-18303,0,-5964,2042,0,0,,8006,-3922
32,08-08-17,72,17:45,18:00,38.36,,0,38.36,38.36,1,-43238,52858,96096,9620,0,0,7316,0,0,,7316,7316
32,08-08-17,73,18:00,18:15,,23.61,0,23.61,23.61,-1,-54326,62663,116989,8337,0,-3068,0,0,0,,3068,-3068
32,08-08-17,74,18:15,18:30,,21.48,0,21.48,21.48,-1,-46990,95197,142187,48207,0,-13131,0,0,0,,13131,-13131
32,08-08-17,75,18:30,18:45,,26.78,0,26.78,26.78,-1,-40044,86446,126490,46402,0,-6394,0,0,0,,6394,-6394
32,08-08-17,76,18:45,19:00,,,0,29.01,29.01,0,-34522,65974,100496,31452,0,-52,0,0,0,,52,-52
32,08-08-17,77,19:00,19:15,,,0,29.01,29.01,0,-54413,40543,94956,-13870,0,0,0,0,0,,0,0
32,08-08-17,78,19:15,19:30,,,0,29.01,29.01,0,-42770,53572,96342,10802,0,0,0,0,0,,0,0
32,08-08-17,79,19:30,19:45,,,0,29.01,29.01,0,-44557,85708,130265,41151,0,0,0,0,0,,0,0
32,08-08-17,80,19:45,20:00,,,0,29.01,29.01,0,-58308,104436,162744,46128,0,0,0,0,0,,0,0
32,08-08-17,81,20:00,20:15,,,0,29.01,29.01,0,-49482,79188,128670,29706,0,0,0,0,0,,0,0
32,08-08-17,82,20:15,20:30,,,0,29.01,29.01,0,-49210,86548,135758,37338,0,0,0,0,0,,0,0
32,08-08-17,83,20:30,20:45,,22.81,0,22.81,22.81,-1,-46583,108038,154621,61455,0,-1185,0,0,0,,1185,-1185
32,08-08-17,84,20:45,21:00,,21.28,0,21.28,21.28,-1,-57455,114195,171650,56740,0,-13114,0,0,0,,13114,-13114
32,08-08-17,85,21:00,21:15,,25.78,0,25.78,25.78,-1,-50333,100303,150636,49970,0,-8760,0,0,0,,8760,-8760
32,08-08-17,86,21:15,21:30,,,0,29.01,29.01,0,-60232,107993,168225,47761,0,-214,0,0,0,,214,-214
32,08-08-17,87,21:30,21:45,,28.78,0,28.78,28.78,-1,-68582,127973,196555,59391,0,-1499,0,0,0,,1499,-1499
32,08-08-17,88,21:45,22:00,,-22.78,0,-22.78,-22.78,-1,-56766,148669,205435,91903,0,-15340,0,0,0,,15340,-15340
32,08-08-17,89,22:00,22:15,,-54.78,0,-54.78,-54.78,-1,-56041,123699,179740,67658,0,-50582,0,0,0,,50582,-50582
32,08-08-17,90,22:15,22:30,,-0.98,0,-0.98,-0.98,-1,-54715,113522,168237,58807,0,-28537,0,0,0,,28537,-28537
32,08-08-17,91,22:30,22:45,,-1.89,0,-1.89,-1.89,-1,-44309,130359,174668,86050,0,-28560,0,0,0,,28560,-28560
32,08-08-17,92,22:45,23:00,,-62.78,0,-62.78,-62.78,-1,-25644,152928,178572,127284,0,-20346,0,0,0,,20346,-20346
32,08-08-17,93,23:00,23:15,,21.78,0,21.78,21.78,-1,-30449,86650,117099,56201,0,-12780,0,0,0,,12780,-12780
32,08-08-17,94,23:15,23:30,,-150.78,0,-150.78,-150.78,-1,-22482,104518,127000,82036,0,-13290,0,0,0,,13290,-13290
32,08-08-17,95,23:30,23:45,,-150.78,0,-150.78,-150.78,-1,-35560,91813,127373,56253,0,-18894,0,0,0,,18894,-18894
32,08-08-17,96,23:45,0:00,,-150.78,0,-150.78,-150.78,-1,-39837,121370,161207,81533,0,-42132,0,0,0,,42132,-42132
32,08-09-17,1,0:00,0:15,,10.03,0,10.03,10.03,-1,-71745,65706,137451,-6039,0,-30576,0,0,0,,30576,-30576
32,08-09-17,2,0:15,0:30,32.78,26.76,0,32.78,26.76,2,-42034,31594,73628,-10440,0,-2818,614,0,0,,3432,-2204
32,08-09-17,3,0:30,0:45,,26.78,0,26.78,26.78,-1,-36391,28383,64774,-8008,0,-956,0,0,0,,956,-956
32,08-09-17,4,0:45,1:00,,25.78,0,25.78,25.78,-1,-40420,42790,83210,2370,0,-7881,0,0,0,,7881,-7881
32,08-09-17,5,1:00,1:15,37.94,26.16,0,37.94,26.16,2,-66663,36224,102887,-30439,0,-2671,2993,0,0,,5664,322
32,08-09-17,6,1:15,1:30,47.4,26.16,0,47.4,47.4,1,-81870,34254,116124,-47616,0,-7,16676,0,0,,16683,16669
32,08-09-17,7,1:30,1:45,28.09,,0,28.09,28.09,1,-69277,37047,106324,-32230,0,0,638,0,0,,638,638
32,08-09-17,8,1:45,2:00,,26.41,0,26.41,26.41,-1,-50331,53455,103786,3124,0,-968,0,0,0,,968,-968
32,08-09-17,9,2:00,2:15,32.78,26.3,0,32.78,26.3,2,-57103,45645,102748,-11458,0,-326,1398,0,0,,1724,1072
32,08-09-17,10,2:15,2:30,,,0,29.98,29.98,0,-60002,48700,108702,-11302,0,0,184,0,0,,184,184
32,08-09-17,11,2:30,2:45,,21.13,0,21.13,21.13,-1,-45777,59666,105443,13889,0,-3847,0,0,0,,3847,-3847
32,08-09-17,12,2:45,3:00,,21.13,0,21.13,21.13,-1,-28464,49964,78428,21500,0,-17241,0,0,0,,17241,-17241
32,08-09-17,13,3:00,3:15,38.78,26.67,0,38.78,26.67,2,-62492,40319,102811,-22173,0,-9126,5110,0,0,,14236,-4016
32,08-09-17,14,3:15,3:30,29.06,26.67,0,29.06,29.06,1,-68292,45852,114144,-22440,0,-7,6520,0,0,,6527,6513
32,08-09-17,15,3:30,3:45,29.1,,0,29.1,29.1,1,-73038,36623,109661,-36415,0,0,3392,0,0,,3392,3392
32,08-09-17,16,3:45,4:00,,,0,29.99,29.99,0,-64276,26191,90467,-38085,0,0,173,0,0,,173,173
32,08-09-17,17,4:00,4:15,29.81,,0,29.81,29.81,1,-83267,34328,117595,-48939,0,0,360,0,0,,360,360
32,08-09-17,18,4:15,4:30,28.78,,0,28.78,28.78,1,-70275,34314,104589,-35961,0,0,279,0,0,,279,279
32,08-09-17,19,4:30,4:45,37.67,,0,37.67,37.67,1,-62181,27328,89509,-34853,0,0,9768,0,0,,9768,9768
32,08-09-17,20,4:45,5:00,33.5,,0,33.5,33.5,1,-53764,41369,95133,-12395,0,0,7291,0,0,,7291,7291
32,08-09-17,21,5:00,5:15,34.32,,0,34.32,34.32,1,-65314,40817,106131,-24497,0,0,3862,0,0,,3862,3862
32,08-09-17,22,5:15,5:30,,,0,29.98,29.98,0,-73624,40391,114015,-33233,0,0,116,0,0,,116,116
32,08-09-17,23,5:30,5:45,28.02,,0,28.02,28.02,1,-83537,28210,111747,-55327,0,0,47,0,0,,47,47
32,08-09-17,24,5:45,6:00,32.78,,0,32.78,32.78,1,-87156,22801,109957,-64355,0,0,2337,0,0,,2337,2337
32,08-09-17,25,6:00,6:15,30.22,,0,30.22,30.22,1,-121089,47795,168884,-73294,0,0,968,0,0,,968,968
32,08-09-17,26,6:15,6:30,,,0,29.97,29.97,0,-95718,38634,134352,-57084,0,0,0,0,0,,0,0
32,08-09-17,27,6:30,6:45,,,0,29.96,29.96,0,-81749,36159,117908,-45590,0,0,0,0,0,,0,0
32,08-09-17,28,6:45,7:00,38.1,,0,38.1,38.1,1,-85178,49680,134858,-35498,0,0,8424,0,0,,8424,8424
32,08-09-17,29,7:00,7:15,30.02,,0,30.02,30.02,1,-148233,87848,236081,-60385,0,0,6406,0,0,,6406,6406
32,08-09-17,30,7:15,7:30,30.02,27.8,0,27.8,27.8,-1,-72422,95013,167435,22591,0,-402,41,0,0,,443,-361
32,08-09-17,31,7:30,7:45,,27.76,0,27.76,27.76,-1,-50375,79459,129834,29084,0,-1297,0,0,0,,1297,-1297
32,08-09-17,32,7:45,8:00,,,0,29.96,29.96,0,-85408,112993,198401,27585,0,-46,0,0,0,,46,-46
32,08-09-17,33,8:00,8:15,,25.78,0,25.78,25.78,-1,-122757,135670,258427,12913,0,-1776,0,0,0,,1776,-1776
32,08-09-17,34,8:15,8:30,,28.94,0,28.94,28.94,-1,-99081,126761,225842,27680,0,-1640,0,0,0,,1640,-1640
32,08-09-17,35,8:30,8:45,,26.78,0,26.78,26.78,-1,-79592,105242,184834,25650,0,-459,0,0,0,,459,-459
32,08-09-17,36,8:45,9:00,,,0,30.34,30.34,0,-61424,109753,171177,48329,0,0,0,0,0,,0,0
32,08-09-17,37,9:00,9:15,,13.84,0,13.84,13.84,-1,-79631,131082,210713,51451,0,-12182,0,0,0,,12182,-12182
32,08-09-17,38,9:15,9:30,,25.78,0,25.78,25.78,-1,-87126,124085,211211,36959,0,-18930,0,0,0,,18930,-18930
32,08-09-17,39,9:30,9:45,,25.78,0,25.78,25.78,-1,-81672,117051,198723,35379,0,-17231,0,0,0,,17231,-17231
32,08-09-17,40,9:45,10:00,,25.5,0,25.5,25.5,-1,-78367,101107,179474,22740,0,-16891,0,0,0,,16891,-16891
32,08-09-17,41,10:00,10:15,,26.73,0,26.73,26.73,-1,-79088,116718,195806,37630,0,-8043,0,0,0,,8043,-8043
32,08-09-17,42,10:15,10:30,,28.79,0,28.79,28.79,-1,-77493,109983,187476,32490,0,-345,0,0,0,,345,-345
32,08-09-17,43,10:30,10:45,,28.79,0,28.79,28.79,-1,-81164,100351,181515,19187,0,-546,0,0,0,,546,-546
32,08-09-17,44,10:45,11:00,,27.44,0,27.44,27.44,-1,-76909,84747,161656,7838,0,-270,0,0,0,,270,-270
32,08-09-17,45,11:00,11:15,,20.75,0,20.75,20.75,-1,-68968,99734,168702,30766,0,-9652,0,0,0,,9652,-9652
32,08-09-17,46,11:15,11:30,,24.83,0,24.83,24.83,-1,-73389,98198,171587,24809,0,-19564,0,0,0,,19564,-19564
32,08-09-17,47,11:30,11:45,,21.78,0,21.78,21.78,-1,-64485,112232,176717,47747,0,-20010,0,0,0,,20010,-20010
32,08-09-17,48,11:45,12:00,,24.7,0,24.7,24.7,-1,-72275,99551,171826,27276,0,-14414,0,0,0,,14414,-14414
32,08-09-17,49,12:00,12:15,,25.78,0,25.78,25.78,-1,-57584,97047,154631,39463,0,-3033,0,0,0,,3033,-3033
32,08-09-17,50,12:15,12:30,,26.77,0,26.77,26.77,-1,-59767,75783,135550,16016,0,-1420,0,0,0,,1420,-1420
32,08-09-17,51,12:30,12:45,,27.82,0,27.82,27.82,-1,-55572,68691,124263,13119,0,-337,0,0,0,,337,-337
32,08-09-17,52,12:45,13:00,,23.74,0,23.74,23.74,-1,-50112,61470,111582,11358,0,-5813,0,0,0,,5813,-5813
32,08-09-17,53,13:00,13:15,167.44,28.79,0,167.44,28.79,2,-96882,47800,144682,-49082,0,-832,14511,0,0,,15343,13679
32,08-09-17,54,13:15,13:30,38.78,,0,38.78,38.78,1,-88916,48657,137573,-40259,0,0,24062,0,0,,24062,24062
32,08-09-17,55,13:30,13:45,152.22,,0,152.22,152.22,1,-99752,42410,142162,-57342,0,0,26258,0,0,,26258,26258
32,08-09-17,56,13:45,14:00,167.44,,0,167.44,167.44,1,-88194,52019,140213,-36175,0,0,44478,0,0,,44478,44478
32,08-09-17,57,14:00,14:15,167.44,25.97,0,25.97,25.97,-1,-38608,91341,129949,52733,0,-1285,9581,0,0,,10866,8296
32,08-09-17,58,14:15,14:30,,,0,30.34,30.34,0,-25793,90845,116638,65052,0,0,0,0,0,,0,0
32,08-09-17,59,14:30,14:45,,,0,30.34,30.34,0,-27218,85376,112594,58158,0,0,0,0,0,,0,0
32,08-09-17,60,14:45,15:00,,27.76,0,27.76,27.76,-1,-30889,68779,99668,37890,0,-845,0,0,0,,845,-845
32,08-09-17,61,15:00,15:15,,25.78,0,25.78,25.78,-1,-45884,138785,184669,92901,0,-1816,0,0,0,,1816,-1816
32,08-09-17,62,15:15,15:30,,24.63,0,24.63,24.63,-1,-52827,128973,181800,76146,0,-5912,0,0,0,,5912,-5912
32,08-09-17,63,15:30,15:45,,23.99,0,23.99,23.99,-1,-61693,107968,169661,46275,0,-12892,0,0,0,,12892,-12892
32,08-09-17,64,15:45,16:00,,25.78,0,25.78,25.78,-1,-68045,87108,155153,19063,0,-4113,0,0,0,,4113,-4113
32,08-09-17,65,16:00,16:15,,13.32,0,13.32,13.32,-1,-43106,142866,185972,99760,0,-14800,0,0,0,,14800,-14800
32,08-09-17,66,16:15,16:30,,24.72,0,24.72,24.72,-1,-54450,134634,189084,80184,0,-17611,0,0,0,,17611,-17611
32,08-09-17,67,16:30,16:45,,25.56,0,25.56,25.56,-1,-56500,120120,176620,63620,0,-12014,0,0,0,,12014,-12014
32,08-09-17,68,16:45,17:00,,,0,30.34,30.34,0,-62528,93914,156442,31386,0,-1835,0,0,0,,1835,-1835
32,08-09-17,69,17:00,17:15,,14.82,0,14.82,14.82,-1,-69960,111346,181306,41386,0,-10250,0,0,0,,10250,-10250
32,08-09-17,70,17:15,17:30,,26.16,0,26.16,26.16,-1,-76820,91265,168085,14445,0,-11347,0,0,0,,11347,-11347
32,08-09-17,71,17:30,17:45,,,0,29.96,29.96,0,-88071,81601,169672,-6470,0,-1627,0,0,0,,1627,-1627
32,08-09-17,72,17:45,18:00,30.43,,0,30.43,30.43,1,-101568,65326,166894,-36242,0,0,457,0,0,,457,457
32,08-09-17,73,18:00,18:15,28.02,,0,28.02,28.02,1,-91648,35753,127401,-55895,0,0,741,0,0,,741,741
32,08-09-17,74,18:15,18:30,,,0,29.96,29.96,0,-78572,36528,115100,-42044,0,0,15,0,0,,15,15
32,08-09-17,75,18:30,18:45,28.09,,0,28.09,28.09,1,-84417,33861,118278,-50556,0,0,91,0,0,,91,91
32,08-09-17,76,18:45,19:00,140.22,,0,140.22,140.22,1,-98922,25321,124243,-73601,0,0,9383,0,0,,9383,9383
32,08-09-17,77,19:00,19:15,152.22,,0,152.22,152.22,1,-72309,37728,110037,-34581,0,0,42099,0,0,,42099,42099
32,08-09-17,78,19:15,19:30,28.09,,0,28.09,28.09,1,-49819,54717,104536,4898,0,0,4955,0,0,,4955,4955
32,08-09-17,79,19:30,19:45,,,0,30,30,0,-38746,43645,82391,4899,0,0,0,0,0,,0,0
32,08-09-17,80,19:45,20:00,30.65,,0,30.65,30.65,1,-46534,31571,78105,-14963,0,0,1072,0,0,,1072,1072
32,08-09-17,81,20:00,20:15,56.22,,0,56.22,56.22,1,-59645,36842,96487,-22803,0,0,9561,0,0,,9561,9561
32,08-09-17,82,20:15,20:30,39.79,,0,39.79,39.79,1,-57659,40437,98096,-17222,0,0,19787,0,0,,19787,19787
32,08-09-17,83,20:30,20:45,39.79,28.97,0,28.97,28.97,-1,-50271,41112,91383,-9159,0,-412,1889,0,0,,2301,1477
32,08-09-17,84,20:45,21:00,,29,0,29,29,-1,-63507,48375,111882,-15132,0,-623,0,0,0,,623,-623
32,08-09-17,85,21:00,21:15,,29.08,0,29.08,29.08,-1,-45590,62111,107701,16521,0,-990,0,0,0,,990,-990
32,08-09-17,86,21:15,21:30,28.78,29.08,0,28.78,28.78,1,-48849,33851,82700,-14998,0,-97,50,0,0,,147,-47
32,08-09-17,87,21:30,21:45,48.39,,0,48.39,48.39,1,-71628,15475,87103,-56153,0,0,7846,0,0,,7846,7846
32,08-09-17,88,21:45,22:00,28.78,,0,28.78,28.78,1,-56587,16130,72717,-40457,0,0,2081,0,0,,2081,2081
32,08-09-17,89,22:00,22:15,,,0,30.34,30.34,0,-60183,29392,89575,-30791,0,0,0,0,0,,0,0
32,08-09-17,90,22:15,22:30,,,0,30.34,30.34,0,-52520,21915,74435,-30605,0,0,0,0,0,,0,0
32,08-09-17,91,22:30,22:45,,25.78,0,25.78,25.78,-1,-29934,44873,74807,14939,0,-1451,0,0,0,,1451,-1451
32,08-09-17,92,22:45,23:00,,21.78,0,21.78,21.78,-1,-31041,67261,98302,36220,0,-14418,0,0,0,,14418,-14418
32,08-09-17,93,23:00,23:15,96.22,25.78,0,96.22,25.78,2,-81160,25940,107100,-55220,0,-8149,3937,0,0,,12086,-4212
32,08-09-17,94,23:15,23:30,29.59,,0,29.59,29.59,1,-58727,35542,94269,-23185,0,0,1862,0,0,,1862,1862
32,08-09-17,95,23:30,23:45,28.78,,0,28.78,28.78,1,-53593,47865,101458,-5728,0,0,1465,0,0,,1465,1465
32,08-09-17,96,23:45,0:00,,16.2,0,16.2,16.2,-1,-57278,86875,144153,29597,0,-17585,0,0,0,,17585,-17585
32,08-10-17,1,0:00,0:15,32.58,25.78,0,32.58,25.78,2,-27424,77832,105256,50408,0,-14821,293,0,0,,15114,-14528
32,08-10-17,2,0:15,0:30,28.81,25.78,0,28.81,28.81,1,-35507,38739,74246,3232,0,-18,124,0,0,,142,106
32,08-10-17,3,0:30,0:45,28.81,,0,28.81,28.81,1,-52475,28090,80565,-24385,0,0,1287,0,0,,1287,1287
32,08-10-17,4,0:45,1:00,28.81,26.81,0,26.81,26.81,-1,-59189,46640,105829,-12549,0,-335,198,0,0,,533,-137
32,08-10-17,5,1:00,1:15,30.19,25.29,0,30.19,25.29,2,-48026,43034,91060,-4992,0,-446,268,0,0,,714,-178
32,08-10-17,6,1:15,1:30,,,0,28.74,28.74,0,-29772,29310,59082,-462,0,0,0,0,0,,0,0
32,08-10-17,7,1:30,1:45,,26.81,0,26.81,26.81,-1,-32298,41228,73526,8930,0,-1653,0,0,0,,1653,-1653
32,08-10-17,8,1:45,2:00,,24.78,0,24.78,24.78,-1,-38200,56325,94525,18125,0,-12129,0,0,0,,12129,-12129
32,08-10-17,9,2:00,2:15,28.98,27.59,0,28.98,28.98,1,-16490,18419,34909,1929,0,-3509,477,0,0,,3986,-3032
32,08-10-17,10,2:15,2:30,,,0,27.87,27.87,0,-19089,15425,34514,-3664,0,-5,127,0,0,,132,122
32,08-10-17,11,2:30,2:45,,26.81,0,26.81,26.81,-1,-14457,27521,41978,13064,0,-137,0,0,0,,137,-137
32,08-10-17,12,2:45,3:00,,19.78,0,19.78,19.78,-1,-16294,45353,61647,29059,0,-17720,0,0,0,,17720,-17720
32,08-10-17,13,3:00,3:15,,23.78,0,23.78,23.78,-1,-18441,26048,44489,7607,0,-13196,0,0,0,,13196,-13196
32,08-10-17,14,3:15,3:30,,,0,27.87,27.87,0,-33620,39814,73434,6194,0,-56,0,0,0,,56,-56
32,08-10-17,15,3:30,3:45,,,0,27.88,27.88,0,-29783,52935,82718,23152,0,0,0,0,0,,0,0
32,08-10-17,16,3:45,4:00,,,0,27.88,27.88,0,-30154,53888,84042,23734,0,0,0,0,0,,0,0
32,08-10-17,17,4:00,4:15,,,0,27.87,27.87,0,-18354,47247,65601,28893,0,0,0,0,0,,0,0
32,08-10-17,18,4:15,4:30,,,0,27.87,27.87,0,-21154,44231,65385,23077,0,0,0,0,0,,0,0
32,08-10-17,19,4:30,4:45,,,0,27.87,27.87,0,-24315,40641,64956,16326,0,0,0,0,0,,0,0
32,08-10-17,20,4:45,5:00,28.81,,0,28.81,28.81,1,-20501,51175,71676,30674,0,0,196,0,0,,196,196
32,08-10-17,21,5:00,5:15,31.19,,0,31.19,31.19,1,-106534,55057,161591,-51477,0,0,594,0,0,,594,594
32,08-10-17,22,5:15,5:30,28.01,,0,28.01,28.01,1,-27819,76552,104371,48733,0,0,68,0,0,,68,68
32,08-10-17,23,5:30,5:45,,,0,27.86,27.86,0,-23915,85600,109515,61685,0,0,0,0,0,,0,0
32,08-10-17,24,5:45,6:00,,,0,27.81,27.81,0,-32707,114227,146934,81520,0,0,0,0,0,,0,0
32,08-10-17,25,6:00,6:15,32.81,,0,32.81,32.81,1,-110408,52355,162763,-58053,0,0,1979,0,0,,1979,1979
32,08-10-17,26,6:15,6:30,28.81,24.78,0,24.78,24.78,-1,-25919,49650,75569,23731,0,-454,1237,0,0,,1691,783
32,08-10-17,27,6:30,6:45,,18.61,0,18.61,18.61,-1,-35142,51766,86908,16624,0,-14534,0,0,0,,14534,-14534
32,08-10-17,28,6:45,7:00,,,0,29,29,0,-30651,63784,94435,33133,0,-2391,0,0,0,,2391,-2391
32,08-10-17,29,7:00,7:15,,,0,28.7,28.7,0,-53664,70349,124013,16685,0,0,0,0,0,,0,0
32,08-10-17,30,7:15,7:30,,,0,28.68,28.68,0,-40998,62203,103201,21205,0,0,0,0,0,,0,0
32,08-10-17,31,7:30,7:45,,,0,28.94,28.94,0,-30804,46049,76853,15245,0,0,0,0,0,,0,0
32,08-10-17,32,7:45,8:00,,,0,28.9,28.9,0,-39374,63028,102402,23654,0,0,0,0,0,,0,0
32,08-10-17,33,8:00,8:15,,,0,30.31,30.31,0,-88996,54177,143173,-34819,0,0,0,0,0,,0,0
32,08-10-17,34,8:15,8:30,43.89,,0,43.89,43.89,1,-76255,41814,118069,-34441,0,0,3884,0,0,,3884,3884
32,08-10-17,35,8:30,8:45,53.35,,0,53.35,53.35,1,-63796,27206,91002,-36590,0,0,23816,0,0,,23816,23816
32,08-10-17,36,8:45,9:00,46.88,,0,46.88,46.88,1,-71493,33708,105201,-37785,0,0,32253,0,0,,32253,32253
32,08-10-17,37,9:00,9:15,40.35,28.88,0,28.88,28.88,-1,-63067,59718,122785,-3349,0,-63,21501,0,0,,21564,21438
32,08-10-17,38,9:15,9:30,28.62,26.62,0,31.81,26.62,2,-51904,56347,108251,4443,0,-621,832,0,0,,1453,211
32,08-10-17,39,9:30,9:45,31.46,,0,31.46,31.46,1,-56686,46332,103018,-10354,0,0,1389,0,0,,1389,1389
32,08-10-17,40,9:45,10:00,49.35,,0,49.35,49.35,1,-73974,34707,108681,-39267,0,0,10626,0,0,,10626,10626
32,08-10-17,41,10:00,10:15,41.49,,0,41.49,41.49,1,-58209,45730,103939,-12479,0,0,10953,0,0,,10953,10953
32,08-10-17,42,10:15,10:30,61.53,,0,61.53,61.53,1,-66581,39879,106460,-26702,0,0,13930,0,0,,13930,13930
32,08-10-17,43,10:30,10:45,72.35,,0,72.35,72.35,1,-58757,39216,97973,-19541,0,0,23668,0,0,,23668,23668
32,08-10-17,44,10:45,11:00,47.95,,0,47.95,47.95,1,-58402,35091,93493,-23311,0,0,19419,0,0,,19419,19419
32,08-10-17,45,11:00,11:15,61.51,,0,61.51,61.51,1,-69336,22893,92229,-46443,0,0,31698,0,0,,31698,31698
32,08-10-17,46,11:15,11:30,248.35,,0,248.35,248.35,1,-69818,16717,86535,-53101,0,0,48885,0,0,,48885,48885
32,08-10-17,47,11:30,11:45,36.93,,0,36.93,36.93,1,-46613,42729,89342,-3884,0,0,16695,0,0,,16695,16695
32,08-10-17,48,11:45,12:00,59.35,,0,59.35,59.35,1,-58526,35560,94086,-22966,0,0,9226,0,0,,9226,9226
32,08-10-17,49,12:00,12:15,63.35,,0,63.35,63.35,1,-65342,17690,83032,-47652,0,0,23332,0,0,,23332,23332
32,08-10-17,50,12:15,12:30,,,0,31.81,31.81,0,-62591,16798,79389,-45793,0,0,1551,0,0,,1551,1551
32,08-10-17,51,12:30,12:45,298.35,,0,298.35,298.35,1,-79559,10846,90405,-68713,0,0,19436,0,0,,19436,19436
32,08-10-17,52,12:45,13:00,78.1,,0,78.1,78.1,1,-70924,30252,101176,-40672,0,0,30593,0,0,,30593,30593
32,08-10-17,53,13:00,13:15,113.35,,0,113.35,113.35,1,-72360,32751,105111,-39609,0,0,8586,0,0,,8586,8586
32,08-10-17,54,13:15,13:30,184.35,,0,184.35,184.35,1,-72425,39140,111565,-33285,0,0,31006,0,0,,31006,31006
32,08-10-17,55,13:30,13:45,236.35,,0,259.99,259.99,1,-149351,32707,182058,-116644,0,0,27663,0,5000,,32663,32663
32,08-10-17,56,13:45,14:00,45.35,,0,240.95,240.95,1,-121602,74522,196124,-47080,0,0,17458,0,27501,,44959,44959
32,08-10-17,57,14:00,14:15,206.35,,0,206.35,206.35,1,-181115,113650,294765,-67465,0,0,20025,0,5000,,25025,25025
32,08-10-17,58,14:15,14:30,206.35,,0,206.35,206.35,1,-150018,121096,271114,-28922,0,0,46480,0,0,,46480,46480
32,08-10-17,59,14:30,14:45,28.62,,0,28.62,28.62,1,-130345,120424,250769,-9921,0,0,5887,0,0,,5887,5887
32,08-10-17,60,14:45,15:00,,28.86,0,28.86,28.86,-1,-145558,101528,247086,-44030,0,-64,0,0,0,,64,-64
32,08-10-17,61,15:00,15:15,,26.62,0,26.62,26.62,-1,-32254,143529,175783,111275,0,-711,0,0,0,,711,-711
32,08-10-17,62,15:15,15:30,,26.62,0,26.62,26.62,-1,-58033,115489,173522,57456,0,-243,0,0,0,,243,-243
32,08-10-17,63,15:30,15:45,,26.62,0,26.62,26.62,-1,-76377,102872,179249,26495,0,-764,0,0,0,,764,-764
32,08-10-17,64,15:45,16:00,,33.09,0,33.09,33.09,-1,-86416,102988,189404,16572,0,-143,0,0,0,,143,-143
32,08-10-17,65,16:00,16:15,,26.62,0,26.62,26.62,-1,-56498,71477,127975,14979,0,-1674,0,0,0,,1674,-1674
32,08-10-17,66,16:15,16:30,,25.55,0,25.55,25.55,-1,-59315,73652,132967,14337,0,-9748,0,0,0,,9748,-9748
32,08-10-17,67,16:30,16:45,,25.62,0,25.62,25.62,-1,-65733,77419,143152,11686,0,-10501,0,0,0,,10501,-10501
32,08-10-17,68,16:45,17:00,,26.62,0,26.62,26.62,-1,-68216,79288,147504,11072,0,-6515,0,0,0,,6515,-6515
32,08-10-17,69,17:00,17:15,,28.74,0,28.74,28.74,-1,-58977,50958,109935,-8019,0,-2911,0,0,0,,2911,-2911
32,08-10-17,70,17:15,17:30,30.34,28.74,0,30.34,30.34,1,-56797,36087,92884,-20710,0,-112,1244,0,0,,1356,1132
32,08-10-17,71,17:30,17:45,30.14,,0,30.14,30.14,1,-56273,48914,105187,-7359,0,0,1543,0,0,,1543,1543
32,08-10-17,72,17:45,18:00,43.05,,0,43.05,43.05,1,-60782,34028,94810,-26754,0,0,11521,0,0,,11521,11521
32,08-10-17,73,18:00,18:15,30.34,,0,30.34,30.34,1,-62903,23856,86759,-39047,0,0,7557,0,0,,7557,7557
32,08-10-17,74,18:15,18:30,,,0,31.81,31.81,0,-36587,46631,83218,10044,0,0,73,0,0,,73,73
32,08-10-17,75,18:30,18:45,,,0,31.81,31.81,0,-35824,46080,81904,10256,0,0,0,0,0,,0,0
32,08-10-17,76,18:45,19:00,,,0,31.81,31.81,0,-36732,53586,90318,16854,0,0,0,0,0,,0,0
32,08-10-17,77,19:00,19:15,,,0,31.81,31.81,0,-60080,58585,118665,-1495,0,0,0,0,0,,0,0
32,08-10-17,78,19:15,19:30,,,0,31.81,31.81,0,-58944,44394,103338,-14550,0,0,0,0,0,,0,0
32,08-10-17,79,19:30,19:45,,,0,31.81,31.81,0,-55619,46403,102022,-9216,0,0,0,0,0,,0,0
32,08-10-17,80,19:45,20:00,28.62,,0,28.62,28.62,1,-62061,40722,102783,-21339,0,0,141,0,0,,141,141
32,08-10-17,81,20:00,20:15,31.06,,0,31.06,31.06,1,-55533,50799,106332,-4734,0,0,2387,0,0,,2387,2387
32,08-10-17,82,20:15,20:30,32.62,,0,32.62,32.62,1,-60062,44680,104742,-15382,0,0,5574,0,0,,5574,5574
32,08-10-17,83,20:30,20:45,30.46,,0,30.46,30.46,1,-56441,28903,85344,-27538,0,0,3701,0,0,,3701,3701
32,08-10-17,84,20:45,21:00,28.62,,0,28.62,28.62,1,-56821,34909,91730,-21912,0,0,1035,0,0,,1035,1035
32,08-10-17,85,21:00,21:15,28.62,,0,28.62,28.62,1,-64194,28638,92832,-35556,0,0,391,0,0,,391,391
32,08-10-17,86,21:15,21:30,41.56,,0,41.56,41.56,1,-65337,31816,97153,-33521,0,0,3938,0,0,,3938,3938
32,08-10-17,87,21:30,21:45,32.62,,0,32.62,32.62,1,-70653,23823,94476,-46830,0,0,3177,0,0,,3177,3177
32,08-10-17,88,21:45,22:00,28.62,,0,28.62,28.62,1,-67196,38599,105795,-28597,0,0,166,0,0,,166,166
32,08-10-17,89,22:00,22:15,,,0,30.31,30.31,0,-72205,36402,108607,-35803,0,0,0,0,0,,0,0
32,08-10-17,90,22:15,22:30,,25.62,0,25.62,25.62,-1,-47654,38085,85739,-9569,0,-275,0,0,0,,275,-275
32,08-10-17,91,22:30,22:45,,25.24,0,25.24,25.24,-1,-36474,59124,95598,22650,0,-3348,0,0,0,,3348,-3348
32,08-10-17,92,22:45,23:00,,17.73,0,17.73,17.73,-1,-44047,57972,102019,13925,0,-9781,0,0,0,,9781,-9781
32,08-10-17,93,23:00,23:15,,-2.35,0,-2.35,-2.35,-1,-66636,107440,174076,40804,0,-14331,0,0,0,,14331,-14331
32,08-10-17,94,23:15,23:30,,,0,29.99,29.99,0,-50108,31454,81562,-18654,0,-133,0,0,0,,133,-133
32,08-10-17,95,23:30,23:45,28.62,,0,28.62,28.62,1,-46465,36548,83013,-9917,0,0,658,0,0,,658,658
32,08-10-17,96,23:45,0:00,28.07,25.62,0,30.03,25.62,2,-52922,65441,118363,12519,0,-1243,235,0,0,,1478,-1008
32,08-11-17,1,0:00,0:15,56.07,,0,56.07,56.07,1,-56966,24490,81456,-32476,0,0,11532,0,0,,11532,11532
32,08-11-17,2,0:15,0:30,34.01,,0,34.01,34.01,1,-32681,20309,52990,-12372,0,0,12951,0,0,,12951,12951
32,08-11-17,3,0:30,0:45,,,0,31.07,31.07,0,-60610,38103,98713,-22507,0,0,134,0,0,,134,134
32,08-11-17,4,0:45,1:00,,28.93,0,28.93,28.93,-1,-104239,58709,162948,-45530,0,-30,0,0,0,,30,-30
32,08-11-17,5,1:00,1:15,,25.5,0,25.5,25.5,-1,-44627,80491,125118,35864,0,-665,0,0,0,,665,-665
32,08-11-17,6,1:15,1:30,,18.41,0,18.41,18.41,-1,-22926,42650,65576,19724,0,-8364,0,0,0,,8364,-8364
32,08-11-17,7,1:30,1:45,,17.99,0,17.99,17.99,-1,-31781,37666,69447,5885,0,-18578,0,0,0,,18578,-18578
32,08-11-17,8,1:45,2:00,,22.76,0,22.76,22.76,-1,-36696,42427,79123,5731,0,-2295,0,0,0,,2295,-2295
32,08-11-17,9,2:00,2:15,,11.27,0,11.27,11.27,-1,-30946,50844,81790,19898,0,-6655,0,0,0,,6655,-6655
32,08-11-17,10,2:15,2:30,31.06,28.86,0,31.06,28.18,2,-36488,33920,70408,-2568,0,-5,1306,0,0,,1311,1301
32,08-11-17,11,2:30,2:45,,25.64,0,25.64,25.64,-1,-21246,53402,74648,32156,0,-2504,0,0,0,,2504,-2504
32,08-11-17,12,2:45,3:00,,24.5,0,24.5,24.5,-1,-22280,42440,64720,20160,0,-6468,0,0,0,,6468,-6468
32,08-11-17,13,3:00,3:15,,26.64,0,26.64,26.64,-1,-37243,40056,77299,2813,0,-3536,0,0,0,,3536,-3536
32,08-11-17,14,3:15,3:30,,,0,28.18,28.18,0,-35286,49143,84429,13857,0,-39,0,0,0,,39,-39
32,08-11-17,15,3:30,3:45,,,0,28.18,28.18,0,-31820,43794,75614,11974,0,0,0,0,0,,0,0
32,08-11-17,16,3:45,4:00,,26.64,0,26.64,26.64,-1,-32395,49101,81496,16706,0,-370,0,0,0,,370,-370
32,08-11-17,17,4:00,4:15,,25.64,0,25.64,25.64,-1,-34873,44713,79586,9840,0,-1182,0,0,0,,1182,-1182
32,08-11-17,18,4:15,4:30,,24.5,0,24.5,24.5,-1,-37085,39746,76831,2661,0,-5262,0,0,0,,5262,-5262
32,08-11-17,19,4:30,4:45,,28.86,0,28.86,28.86,-1,-42054,37720,79774,-4334,0,-911,0,0,0,,911,-911
32,08-11-17,20,4:45,5:00,28.64,,0,28.64,28.64,1,-42008,40640,82648,-1368,0,0,23,0,0,,23,23
32,08-11-17,21,5:00,5:15,29.51,,0,29.51,29.51,1,-92222,2946,95168,-89276,0,0,126,0,0,,126,126
32,08-11-17,22,5:15,5:30,29.5,,0,29.5,29.5,1,-48517,7444,55961,-41073,0,0,569,0,0,,569,569
32,08-11-17,23,5:30,5:45,,,0,28.18,28.18,0,-44555,30353,74908,-14202,0,0,0,0,0,,0,0
32,08-11-17,24,5:45,6:00,38.64,,0,38.64,38.64,1,-61533,33786,95319,-27747,0,0,5206,0,0,,5206,5206
32,08-11-17,25,6:00,6:15,62.01,,0,62.01,62.01,1,-110178,44759,154937,-65419,0,0,24658,0,0,,24658,24658
32,08-11-17,26,6:15,6:30,35.1,,0,35.1,35.1,1,-58509,43055,101564,-15454,0,0,19962,0,0,,19962,19962
32,08-11-17,27,6:30,6:45,,,0,28.16,28.16,0,-43429,38517,81946,-4912,0,0,586,0,0,,586,586
32,08-11-17,28,6:45,7:00,28.71,,0,28.71,28.71,1,-59758,63691,123449,3933,0,0,236,0,0,,236,236
32,08-11-17,29,7:00,7:15,28.71,25.71,0,31.11,25.71,2,-88742,65367,154109,-23375,0,-848,749,0,0,,1597,-99
32,08-11-17,30,7:15,7:30,,25.71,0,25.71,25.71,-1,-56289,54969,111258,-1320,0,-8155,0,0,0,,8155,-8155
32,08-11-17,31,7:30,7:45,32.71,25.71,0,32.71,32.71,1,-60052,37029,97081,-23023,0,-155,965,0,0,,1120,810
32,08-11-17,32,7:45,8:00,37.01,,0,37.01,37.01,1,-56941,48330,105271,-8611,0,0,9131,0,0,,9131,9131
32,08-11-17,33,8:00,8:15,37.01,27.49,0,27.49,27.49,-1,-29165,65590,94755,36425,0,-480,938,0,0,,1418,458
32,08-11-17,34,8:15,8:30,33.87,,0,33.87,33.87,1,-41218,34287,75505,-6931,0,0,536,0,0,,536,536
32,08-11-17,35,8:30,8:45,51.09,,0,51.09,51.09,1,-59029,30121,89150,-28908,0,0,9439,0,0,,9439,9439
32,08-11-17,36,8:45,9:00,106.11,,0,106.11,106.11,1,-84709,39883,124592,-44826,0,0,24958,0,0,,24958,24958
32,08-11-17,37,9:00,9:15,32.7,30.07,0,30.07,30.07,-1,-10033,65321,75354,55288,0,-441,10570,0,0,,11011,10129
32,08-11-17,38,9:15,9:30,,,0,31.26,31.26,0,-27309,56291,83600,28982,0,-8,0,0,0,,8,-8
32,08-11-17,39,9:30,9:45,,,0,31.26,31.26,0,-24193,62104,86297,37911,0,0,0,0,0,,0,0
32,08-11-17,40,9:45,10:00,,,0,31.26,31.26,0,-30002,62512,92514,32510,0,0,0,0,0,,0,0
32,08-11-17,41,10:00,10:15,,,0,31.76,31.76,0,-27575,74167,101742,46592,0,0,0,0,0,,0,0
32,08-11-17,42,10:15,10:30,,,0,31.76,31.76,0,-25276,85219,110495,59943,0,0,0,0,0,,0,0
32,08-11-17,43,10:30,10:45,,,0,31.76,31.76,0,-23144,89651,112795,66507,0,0,0,0,0,,0,0
32,08-11-17,44,10:45,11:00,,,0,31.76,31.76,0,-24671,83147,107818,58476,0,0,0,0,0,,0,0
32,08-11-17,45,11:00,11:15,,30.03,0,30.03,30.03,-1,-33070,77546,110616,44476,0,-174,0,0,0,,174,-174
32,08-11-17,46,11:15,11:30,,,0,31.76,31.76,0,-30117,75577,105694,45460,0,0,0,0,0,,0,0
32,08-11-17,47,11:30,11:45,,,0,31.76,31.76,0,-30297,82226,112523,51929,0,0,0,0,0,,0,0
32,08-11-17,48,11:45,12:00,,,0,31.76,31.76,0,-25949,71048,96997,45099,0,0,0,0,0,,0,0
32,08-11-17,49,12:00,12:15,,,0,31.76,31.76,0,-63718,70995,134713,7277,0,0,0,0,0,,0,0
32,08-11-17,50,12:15,12:30,,,0,31.76,31.76,0,-59286,77317,136603,18031,0,0,0,0,0,,0,0
32,08-11-17,51,12:30,12:45,,,0,31.76,31.76,0,-52704,78484,131188,25780,0,0,0,0,0,,0,0
32,08-11-17,52,12:45,13:00,,,0,31.76,31.76,0,-51686,90315,142001,38629,0,0,0,0,0,,0,0
32,08-11-17,53,13:00,13:15,,,0,31.11,31.11,0,-58460,80527,138987,22067,0,0,0,0,0,,0,0
32,08-11-17,54,13:15,13:30,,,0,31.11,31.11,0,-51991,63811,115802,11820,0,0,0,0,0,,0,0
32,08-11-17,55,13:30,13:45,,27.82,0,27.82,27.82,-1,-54771,71614,126385,16843,0,-236,0,0,0,,236,-236
32,08-11-17,56,13:45,14:00,,20.54,0,20.54,20.54,-1,-51646,83404,135050,31758,0,-9993,0,0,0,,9993,-9993
32,08-11-17,57,14:00,14:15,,26.71,0,26.71,26.71,-1,-51882,73413,125295,21531,0,-10932,0,0,0,,10932,-10932
32,08-11-17,58,14:15,14:30,,31.5,0,31.5,31.5,-1,-41701,89349,131050,47648,0,-89,0,0,0,,89,-89
32,08-11-17,59,14:30,14:45,,21.71,0,21.71,21.71,-1,-30826,93184,124010,62358,0,-5435,0,0,0,,5435,-5435
32,08-11-17,60,14:45,15:00,,-8.3,0,-8.3,-8.3,-1,-34815,99008,133823,64193,0,-45186,0,0,0,,45186,-45186
32,08-11-17,61,15:00,15:15,,25.71,0,25.71,25.71,-1,-58655,70490,129145,11835,0,-15768,0,0,0,,15768,-15768
32,08-11-17,62,15:15,15:30,,,0,31.11,31.11,0,-46777,80112,126889,33335,0,0,0,0,0,,0,0
32,08-11-17,63,15:30,15:45,,,0,31.11,31.11,0,-45263,83748,129011,38485,0,0,0,0,0,,0,0
32,08-11-17,64,15:45,16:00,,,0,31.11,31.11,0,-39480,83882,123362,44402,0,0,0,0,0,,0,0
32,08-11-17,65,16:00,16:15,,,0,31.11,31.11,0,-46717,76947,123664,30230,0,0,0,0,0,,0,0
32,08-11-17,66,16:15,16:30,,,0,31.11,31.11,0,-41241,81477,122718,40236,0,0,0,0,0,,0,0
32,08-11-17,67,16:30,16:45,,25.71,0,25.71,25.71,-1,-43392,67002,110394,23610,0,-6477,0,0,0,,6477,-6477
32,08-11-17,68,16:45,17:00,,30.06,0,30.06,30.06,-1,-49588,54416,104004,4828,0,-3465,0,0,0,,3465,-3465
32,08-11-17,69,17:00,17:15,,26.71,0,26.71,26.71,-1,-43170,70166,113336,26996,0,-5369,0,0,0,,5369,-5369
32,08-11-17,70,17:15,17:30,,,0,31.11,31.11,0,-52318,40410,92728,-11908,0,-821,0,0,0,,821,-821
32,08-11-17,71,17:30,17:45,28.71,,0,28.71,28.71,1,-64073,44802,108875,-19271,0,0,43,0,0,,43,43
32,08-11-17,72,17:45,18:00,31.79,,0,31.79,31.79,1,-74983,60129,135112,-14854,0,0,855,0,0,,855,855
32,08-11-17,73,18:00,18:15,44.08,,0,44.08,44.08,1,-130360,14091,144451,-116269,0,0,5224,0,0,,5224,5224
32,08-11-17,74,18:15,18:30,,,0,31.11,31.11,0,-79473,24069,103542,-55404,0,0,649,0,0,,649,649
32,08-11-17,75,18:30,18:45,,,0,31.11,31.11,0,-65518,36437,101955,-29081,0,0,0,0,0,,0,0
32,08-11-17,76,18:45,19:00,33.08,,0,33.08,33.08,1,-57995,20338,78333,-37657,0,0,2754,0,0,,2754,2754
32,08-11-17,77,19:00,19:15,32.71,,0,32.71,32.71,1,-106577,33667,140244,-72910,0,0,2551,0,0,,2551,2551
32,08-11-17,78,19:15,19:30,30.87,,0,30.87,30.87,1,-98112,32518,130630,-65594,0,0,1143,0,0,,1143,1143
32,08-11-17,79,19:30,19:45,32.71,,0,32.71,32.71,1,-67402,17822,85224,-49580,0,0,2923,0,0,,2923,2923
32,08-11-17,80,19:45,20:00,52.83,,0,52.83,52.83,1,-92435,31246,123681,-61189,0,0,13070,0,0,,13070,13070
32,08-11-17,81,20:00,20:15,28.71,,0,28.71,28.71,1,-40710,69150,109860,28440,0,0,4964,0,0,,4964,4964
32,08-11-17,82,20:15,20:30,,26.71,0,26.71,26.71,-1,-31139,47854,78993,16715,0,-495,0,0,0,,495,-495
32,08-11-17,83,20:30,20:45,,26.71,0,26.71,26.71,-1,-34377,74386,108763,40009,0,-1321,0,0,0,,1321,-1321
32,08-11-17,84,20:45,21:00,,,0,29.6,29.6,0,-46747,67984,114731,21237,0,-245,0,0,0,,245,-245
32,08-11-17,85,21:00,21:15,,14.13,0,14.13,14.13,-1,-26925,153516,180441,126591,0,-7637,0,0,0,,7637,-7637
32,08-11-17,86,21:15,21:30,,,0,29.59,29.59,0,-54749,93380,148129,38631,0,-55,0,0,0,,55,-55
32,08-11-17,87,21:30,21:45,,26.18,0,26.18,26.18,-1,-25965,111044,137009,85079,0,-678,0,0,0,,678,-678
32,08-11-17,88,21:45,22:00,,2.95,0,2.95,2.95,-1,-19717,121653,141370,101936,0,-13816,0,0,0,,13816,-13816
32,08-11-17,89,22:00,22:15,,-26.52,0,-26.52,-26.52,-1,-58092,113642,171734,55550,0,-47374,0,0,0,,47374,-47374
32,08-11-17,90,22:15,22:30,,-58.03,0,-58.03,-58.03,-1,-48697,120918,169615,72221,0,-42136,0,0,0,,42136,-42136
32,08-11-17,91,22:30,22:45,,-58.03,0,-58.03,-58.03,-1,-84659,111119,195778,26460,0,-36787,0,0,0,,36787,-36787
32,08-11-17,92,22:45,23:00,31.38,-58.03,0,31.38,31.38,1,-139694,103685,243379,-36009,0,-195,21,0,0,,216,-174
32,08-11-17,93,23:00,23:15,,26.71,0,26.71,26.71,-1,-66464,106778,173242,40314,0,-1037,0,0,0,,1037,-1037
32,08-11-17,94,23:15,23:30,,-58.03,0,-58.03,-58.03,-1,-48957,103536,152493,54579,0,-27345,0,0,0,,27345,-27345
32,08-11-17,95,23:30,23:45,,21.71,0,21.71,21.71,-1,-64146,126006,190152,61860,0,-29569,0,0,0,,29569,-29569
32,08-11-17,96,23:45,0:00,,14.76,0,14.76,14.76,-1,-68753,139413,208166,70660,0,-24703,0,0,0,,24703,-24703
33,08-12-17,1,0:00,0:15,,26.8,0,26.8,26.8,-1,-17815,121106,138921,103291,0,-12052,0,0,0,,12052,-12052
33,08-12-17,2,0:15,0:30,,28.89,0,28.89,28.89,-1,-48962,60368,109330,11406,0,-423,0,0,0,,423,-423
33,08-12-17,3,0:30,0:45,,26.8,0,26.8,26.8,-1,-68018,60910,128928,-7108,0,-1547,0,0,0,,1547,-1547
33,08-12-17,4,0:45,1:00,,24.23,0,24.23,24.23,-1,-73803,70838,144641,-2965,0,-10939,0,0,0,,10939,-10939
33,08-12-17,5,1:00,1:15,110.23,24.23,0,110.23,110.23,1,-71759,16823,88582,-54936,0,-2149,17365,0,0,,19514,15216
33,08-12-17,6,1:15,1:30,39.8,,0,39.8,39.8,1,-39138,25959,65097,-13179,0,0,13014,0,0,,13014,13014
33,08-12-17,7,1:30,1:45,,28.75,0,28.75,28.75,-1,-35316,26679,61995,-8637,0,-150,0,0,0,,150,-150
33,08-12-17,8,1:45,2:00,,27.8,0,27.8,27.8,-1,-43153,33322,76475,-9831,0,-1520,0,0,0,,1520,-1520
33,08-12-17,9,2:00,2:15,39.8,28.47,0,39.8,28.47,2,-53964,39803,93767,-14161,0,-432,6849,0,0,,7281,6417
33,08-12-17,10,2:15,2:30,32.26,,0,32.26,32.26,1,-47182,37653,84835,-9529,0,0,12475,0,0,,12475,12475
33,08-12-17,11,2:30,2:45,32.26,27.8,0,27.8,27.8,-1,-40249,47645,87894,7396,0,-478,1551,0,0,,2029,1073
33,08-12-17,12,2:45,3:00,,26.8,0,26.8,26.8,-1,-33986,42075,76061,8089,0,-5196,0,0,0,,5196,-5196
33,08-12-17,13,3:00,3:15,,28.54,0,28.54,28.54,-1,-24530,34460,58990,9930,0,-1996,0,0,0,,1996,-1996
33,08-12-17,14,3:15,3:30,,,0,29.02,29.02,0,-17767,30785,48552,13018,0,0,0,0,0,,0,0
33,08-12-17,15,3:30,3:45,,,0,29,29,0,-18355,34747,53102,16392,0,0,0,0,0,,0,0
33,08-12-17,16,3:45,4:00,29.8,,0,29.8,29.8,1,-31291,29839,61130,-1452,0,0,547,0,0,,547,547
33,08-12-17,17,4:00,4:15,44.76,,0,44.76,44.76,1,-42411,20178,62589,-22233,0,0,11847,0,0,,11847,11847
33,08-12-17,18,4:15,4:30,32.23,,0,32.23,32.23,1,-26037,23855,49892,-2182,0,0,7238,0,0,,7238,7238
33,08-12-17,19,4:30,4:45,,,0,28.99,28.99,0,-20225,29719,49944,9494,0,0,14,0,0,,14,14
33,08-12-17,20,4:45,5:00,,,0,28.99,28.99,0,-22863,35144,58007,12281,0,0,0,0,0,,0,0
33,08-12-17,21,5:00,5:15,,28.86,0,28.86,28.86,-1,-19945,60174,80119,40229,0,-8,0,0,0,,8,-8
33,08-12-17,22,5:15,5:30,,28.86,0,28.86,28.86,-1,-16598,50921,67519,34323,0,-100,0,0,0,,100,-100
33,08-12-17,23,5:30,5:45,,,0,28.99,28.99,0,-20437,39976,60413,19539,0,0,0,0,0,,0,0
33,08-12-17,24,5:45,6:00,,,0,29,29,0,-20963,32197,53160,11234,0,0,0,0,0,,0,0
33,08-12-17,25,6:00,6:15,33.47,,0,33.47,33.47,1,-46631,35493,82124,-11138,0,0,513,0,0,,513,513
33,08-12-17,26,6:15,6:30,33.47,,0,33.47,33.47,1,-48104,36215,84319,-11889,0,0,2439,0,0,,2439,2439
33,08-12-17,27,6:30,6:45,60.48,,0,60.48,60.48,1,-67145,33262,100407,-33883,0,0,12017,0,0,,12017,12017
33,08-12-17,28,6:45,7:00,35.15,,0,35.15,35.15,1,-73727,34435,108162,-39292,0,0,25188,0,0,,25188,25188
33,08-12-17,29,7:00,7:15,33.99,,0,33.99,33.99,1,-35148,38445,73593,3297,0,0,10230,0,0,,10230,10230
33,08-12-17,30,7:15,7:30,33.99,22.47,0,22.47,22.47,-1,-28453,51601,80054,23148,0,-4518,1366,0,0,,5884,-3152
33,08-12-17,31,7:30,7:45,,27.47,0,27.47,27.47,-1,-28574,46746,75320,18172,0,-4909,0,0,0,,4909,-4909
33,08-12-17,32,7:45,8:00,,,0,29,29,0,-39461,45307,84768,5846,0,-536,0,0,0,,536,-536
33,08-12-17,33,8:00,8:15,,26.47,0,26.47,26.47,-1,-21947,100902,122849,78955,0,-1036,0,0,0,,1036,-1036
33,08-12-17,34,8:15,8:30,,,0,28.03,28.03,0,-18651,57112,75763,38461,0,-436,0,0,0,,436,-436
33,08-12-17,35,8:30,8:45,33.47,,0,33.47,33.47,1,-36552,35217,71769,-1335,0,0,533,0,0,,533,533
33,08-12-17,36,8:45,9:00,60.24,,0,60.24,60.24,1,-77531,29390,106921,-48141,0,0,28260,0,0,,28260,28260
33,08-12-17,37,9:00,9:15,29.19,19.78,0,29.19,19.78,2,-12878,62128,75006,49250,0,-1437,10007,0,0,,11444,8570
33,08-12-17,38,9:15,9:30,,,0,28.03,28.03,0,-34645,51147,85792,16502,0,0,0,0,0,,0,0
33,08-12-17,39,9:30,9:45,30.52,,0,30.52,30.52,1,-63667,51450,115117,-12217,0,0,142,0,0,,142,142
33,08-12-17,40,9:45,10:00,33.47,,0,33.47,33.47,1,-84715,49189,133904,-35526,0,0,6514,0,0,,6514,6514
33,08-12-17,41,10:00,10:15,,,0,28.03,28.03,0,-64683,58053,122736,-6630,0,0,327,0,0,,327,327
33,08-12-17,42,10:15,10:30,,,0,28.03,28.03,0,-73651,52078,125729,-21573,0,0,0,0,0,,0,0
33,08-12-17,43,10:30,10:45,29.47,,0,29.47,29.47,1,-86983,51805,138788,-35178,0,0,2028,0,0,,2028,2028
33,08-12-17,44,10:45,11:00,29.19,,0,29.19,29.19,1,-68460,55524,123984,-12936,0,0,741,0,0,,741,741
33,08-12-17,45,11:00,11:15,113,,0,113,113,1,-83937,42254,126191,-41683,0,0,13695,0,0,,13695,13695
33,08-12-17,46,11:15,11:30,43.98,27.49,0,27.49,27.49,-1,-47116,51972,99088,4856,0,-310,17543,0,0,,17853,17233
33,08-12-17,47,11:30,11:45,43.98,27.47,0,27.47,27.47,-1,-44628,52400,97028,7772,0,-736,14,0,0,,750,-722
33,08-12-17,48,11:45,12:00,,26.47,0,26.47,26.47,-1,-43433,66260,109693,22827,0,-2119,0,0,0,,2119,-2119
33,08-12-17,49,12:00,12:15,30.79,26.47,0,30.79,26.47,2,-66854,44505,111359,-22349,0,-3063,1050,0,0,,4113,-2013
33,08-12-17,50,12:15,12:30,30.79,8.78,0,8.78,8.78,-1,-50540,67793,118333,17253,0,-5166,164,0,0,,5330,-5002
33,08-12-17,51,12:30,12:45,,1.78,0,1.78,1.78,-1,-47141,58737,105878,11596,0,-12560,0,0,0,,12560,-12560
33,08-12-17,52,12:45,13:00,,-52.78,0,-52.78,-52.78,-1,-34518,66036,100554,31518,0,-8571,0,0,0,,8571,-8571
33,08-12-17,53,13:00,13:15,117.12,-52.78,0,117.12,117.12,1,-78345,35552,113897,-42793,0,-3499,11639,0,0,,15138,8140
33,08-12-17,54,13:15,13:30,117.12,-16.78,0,-16.78,-16.78,-1,-47389,80788,128177,33399,0,-14235,456,0,0,,14691,-13779
33,08-12-17,55,13:30,13:45,,-150.78,0,-150.78,-150.78,-1,-45028,91699,136727,46671,0,-27617,0,0,0,,27617,-27617
33,08-12-17,56,13:45,14:00,84.37,-150.78,0,84.37,84.37,1,-53165,40745,93910,-12420,0,-34284,1196,0,0,,35480,-33088
33,08-12-17,57,14:00,14:15,118.12,27.31,0,118.12,27.31,2,-74094,49325,123419,-24769,0,-521,20479,0,0,,21000,19958
33,08-12-17,58,14:15,14:30,31.51,22.47,0,31.51,22.47,2,-65639,58526,124165,-7113,0,-3401,776,0,0,,4177,-2625
33,08-12-17,59,14:30,14:45,31.51,28.59,0,28.59,28.59,-1,-72200,69653,141853,-2547,0,-200,5,0,0,,205,-195
33,08-12-17,60,14:45,15:00,,27.47,0,27.47,27.47,-1,-78142,90296,168438,12154,0,-1796,0,0,0,,1796,-1796
33,08-12-17,61,15:00,15:15,33.47,26.47,0,33.47,26.47,2,-70163,62068,132231,-8095,0,-3531,1363,0,0,,4894,-2168
33,08-12-17,62,15:15,15:30,39.47,,0,39.47,39.47,1,-65050,49858,114908,-15192,0,0,8369,0,0,,8369,8369
33,08-12-17,63,15:30,15:45,40.87,,0,40.87,40.87,1,-70648,61189,131837,-9459,0,0,19745,0,0,,19745,19745
33,08-12-17,64,15:45,16:00,40.87,25.78,0,25.78,25.78,-1,-73244,66645,139889,-6599,0,-3108,1904,0,0,,5012,-1204
33,08-12-17,65,16:00,16:15,,27.47,0,27.47,27.47,-1,-61564,69126,130690,7562,0,-3791,0,0,0,,3791,-3791
33,08-12-17,66,16:15,16:30,,28.3,0,28.3,28.3,-1,-63417,62809,126226,-608,0,-2996,0,0,0,,2996,-2996
33,08-12-17,67,16:30,16:45,60.92,28.3,0,60.92,60.92,1,-69056,33077,102133,-35979,0,-461,13793,0,0,,14254,13332
33,08-12-17,68,16:45,17:00,57.12,,0,57.12,57.12,1,-91129,32355,123484,-58774,0,0,45349,0,0,,45349,45349
33,08-12-17,69,17:00,17:15,40.08,-47.78,0,-47.78,-47.78,-1,-56284,77079,133363,20795,0,-3374,23011,0,0,,26385,19637
33,08-12-17,70,17:15,17:30,,25.75,0,25.75,25.75,-1,-56410,53315,109725,-3095,0,-6216,0,0,0,,6216,-6216
33,08-12-17,71,17:30,17:45,29.1,25.75,0,29.1,29.1,1,-54539,31635,86174,-22904,0,-8,23,0,0,,31,15
33,08-12-17,72,17:45,18:00,39.47,,0,39.47,39.47,1,-82771,36117,118888,-46654,0,0,12011,0,0,,12011,12011
33,08-12-17,73,18:00,18:15,31.97,,0,31.97,31.97,1,-71657,41840,113497,-29817,0,0,9894,0,0,,9894,9894
33,08-12-17,74,18:15,18:30,33.47,,0,33.47,33.47,1,-64620,30233,94853,-34387,0,0,11007,0,0,,11007,11007
33,08-12-17,75,18:30,18:45,49.69,,0,49.69,49.69,1,-77914,20022,97936,-57892,0,0,25711,0,0,,25711,25711
33,08-12-17,76,18:45,19:00,101.12,,0,101.12,101.12,1,-89494,46030,135524,-43464,0,0,45600,0,0,,45600,45600
33,08-12-17,77,19:00,19:15,118.12,,0,118.12,118.12,1,-105915,32622,138537,-73293,0,0,43299,0,0,,43299,43299
33,08-12-17,78,19:15,19:30,39.12,,0,39.12,39.12,1,-59520,31998,91518,-27522,0,0,22939,0,0,,22939,22939
33,08-12-17,79,19:30,19:45,39.47,,0,39.47,39.47,1,-45169,28888,74057,-16281,0,0,20113,0,0,,20113,20113
33,08-12-17,80,19:45,20:00,58.12,,0,58.12,58.12,1,-67411,30364,97775,-37047,0,0,25496,0,0,,25496,25496
33,08-12-17,81,20:00,20:15,28.12,27.47,0,28.49,27.47,2,-42415,85840,128255,43425,0,-569,6939,0,0,,7508,6370
33,08-12-17,82,20:15,20:30,,,0,28.49,28.49,0,-46730,78822,125552,32092,0,0,0,0,0,,0,0
33,08-12-17,83,20:30,20:45,128.12,,0,128.12,128.12,1,-190066,78528,268594,-111538,0,0,30031,0,0,,30031,30031
33,08-12-17,84,20:45,21:00,100.68,27.73,0,27.73,27.73,-1,-200022,165265,365287,-34757,0,-47,33573,20000,0,,53620,53526
33,08-12-17,85,21:00,21:15,168.66,26.78,0,168.66,26.78,2,-220476,180372,400848,-40104,0,-533,5167,0,0,,5700,4634
33,08-12-17,86,21:15,21:30,283.12,,0,283.12,283.12,1,-289473,151336,440809,-138137,0,0,70090,16250,0,,86340,86340
33,08-12-17,87,21:30,21:45,262.12,,0,262.12,262.12,1,-299078,190454,489532,-108624,0,0,91258,20000,0,,111258,111258
33,08-12-17,88,21:45,22:00,180,,0,180,180,1,-279934,253197,533131,-26737,0,0,31681,12500,0,,44181,44181
33,08-12-17,89,22:00,22:15,220.12,,0,220.12,220.12,1,-273755,173831,447586,-99924,0,0,43230,0,0,,43230,43230
33,08-12-17,90,22:15,22:30,254.12,,0,254.12,254.12,1,-264438,179229,443667,-85209,0,0,78474,0,0,,78474,78474
33,08-12-17,91,22:30,22:45,63.88,,0,63.88,63.88,1,-252840,205144,457984,-47696,0,0,44060,0,0,,44060,44060
33,08-12-17,92,22:45,23:00,43.53,,0,43.53,43.53,1,-245486,197297,442783,-48189,0,0,28661,0,0,,28661,28661
33,08-12-17,93,23:00,23:15,350.12,,0,350.12,350.12,1,-262642,111550,374192,-151092,0,0,55954,0,0,,55954,55954
33,08-12-17,94,23:15,23:30,350.12,,0,350.12,350.12,1,-239493,141380,380873,-98113,0,0,84383,0,0,,84383,84383
33,08-12-17,95,23:30,23:45,150.12,,0,150.12,150.12,1,-227678,169905,397583,-57773,0,0,59316,0,0,,59316,59316
33,08-12-17,96,23:45,0:00,79.12,,0,79.12,79.12,1,-219016,144945,363961,-74071,0,0,37962,0,0,,37962,37962
33,08/13/2017,1,0:00,0:15,79.12,3.07,0,3.07,3.07,-1,-162615,262292,424907,99677,0,-2879,11609,0,0,,14488,8730
33,08/13/2017,2,0:15,0:30,,22.8,0,22.8,22.8,-1,-154166,151474,305640,-2692,0,-4421,0,0,0,,4421,-4421
33,08/13/2017,3,0:30,0:45,,26.8,0,26.8,26.8,-1,-149497,147915,297412,-1582,0,-1601,0,0,0,,1601,-1601
33,08/13/2017,4,0:45,1:00,,12.58,0,12.58,12.58,-1,-151373,144143,295516,-7230,0,-18629,0,0,0,,18629,-18629
33,08/13/2017,5,1:00,1:15,39.8,12.58,0,39.8,39.8,1,-113844,89626,203470,-24218,0,-2739,8909,0,0,,11648,6170
33,08/13/2017,6,1:15,1:30,29.49,3.56,0,3.56,3.56,-1,-69671,90727,160398,21056,0,-4045,2615,0,0,,6660,-1430
33,08/13/2017,7,1:30,1:45,,2.51,0,2.51,2.51,-1,-59153,91479,150632,32326,0,-7739,0,0,0,,7739,-7739
33,08/13/2017,8,1:45,2:00,,-17.51,0,-17.51,-17.51,-1,-49794,91854,141648,42060,0,-10491,0,0,0,,10491,-10491
33,08/13/2017,9,2:00,2:15,38.97,21.1,0,38.97,38.97,1,-54808,47252,102060,-7556,0,-9754,2107,0,0,,11861,-7647
33,08/13/2017,10,2:15,2:30,38.19,21.1,0,21.1,21.1,-1,-36475,50227,86702,13752,0,-612,4583,0,0,,5195,3971
33,08/13/2017,11,2:30,2:45,38.19,-11.51,0,-11.51,-11.51,-1,-28788,61887,90675,33099,0,-17321,15,0,0,,17336,-17306
33,08/13/2017,12,2:45,3:00,,8.51,0,8.51,8.51,-1,-21437,55249,76686,33812,0,-27178,0,0,0,,27178,-27178
33,08/13/2017,13,3:00,3:15,,10.45,0,10.45,10.45,-1,-32047,54100,86147,22053,0,-21018,0,0,0,,21018,-21018
33,08/13/2017,14,3:15,3:30,,25.47,0,25.47,25.47,-1,-29357,53276,82633,23919,0,-2047,0,0,0,,2047,-2047
33,08/13/2017,15,3:30,3:45,,22.51,0,22.51,22.51,-1,-35695,46269,81964,10574,0,-10027,0,0,0,,10027,-10027
33,08/13/2017,16,3:45,4:00,,18.69,0,18.69,18.69,-1,-27790,45818,73608,18028,0,-18262,0,0,0,,18262,-18262
33,08/13/2017,17,4:00,4:15,,19.51,0,19.51,19.51,-1,-23112,33367,56479,10255,0,-16961,0,0,0,,16961,-16961
33,08/13/2017,18,4:15,4:30,,19.51,0,19.51,19.51,-1,-22448,36802,59250,14354,0,-9937,0,0,0,,9937,-9937
33,08/13/2017,19,4:30,4:45,,23.34,0,23.34,23.34,-1,-23945,41900,65845,17955,0,-18563,0,0,0,,18563,-18563
33,08/13/2017,20,4:45,5:00,,23.34,0,23.34,23.34,-1,-23610,44427,68037,20817,0,-14980,0,0,0,,14980,-14980
33,08/13/2017,21,5:00,5:15,,6.95,0,6.95,6.95,-1,-20386,67678,88064,47292,0,-20168,0,0,0,,20168,-20168
33,08/13/2017,22,5:15,5:30,,21.95,0,21.95,21.95,-1,-20606,72396,93002,51790,0,-16099,0,0,0,,16099,-16099
33,08/13/2017,23,5:30,5:45,,,0,28.99,28.99,0,-19351,66234,85585,46883,0,-3827,0,0,0,,3827,-3827
33,08/13/2017,24,5:45,6:00,,,0,28.99,28.99,0,-20486,62604,83090,42118,0,0,0,0,0,,0,0
33,08/13/2017,25,6:00,6:15,,,0,28.99,28.99,0,-18296,86380,104676,68084,0,0,0,0,0,,0,0
33,08/13/2017,26,6:15,6:30,,21.77,0,21.77,21.77,-1,-12999,104280,117279,91281,0,-1646,0,0,0,,1646,-1646
33,08/13/2017,27,6:30,6:45,,25.74,0,25.74,25.74,-1,-15021,99776,114797,84755,0,-5377,0,0,0,,5377,-5377
33,08/13/2017,28,6:45,7:00,,11.77,0,11.77,11.77,-1,-15100,87766,102866,72666,0,-8255,0,0,0,,8255,-8255
33,08/13/2017,29,7:00,7:15,,28.93,0,28.93,28.93,-1,-26020,66500,92520,40480,0,-1773,0,0,0,,1773,-1773
33,08/13/2017,30,7:15,7:30,,,0,29.04,29.04,0,-24083,62839,86922,38756,0,0,0,0,0,,0,0
33,08/13/2017,31,7:30,7:45,,,0,28.99,28.99,0,-28019,64062,92081,36043,0,0,0,0,0,,0,0
33,08/13/2017,32,7:45,8:00,,,0,28.98,28.98,0,-29966,66208,96174,36242,0,0,0,0,0,,0,0
33,08/13/2017,33,8:00,8:15,,-48.51,0,-48.51,-48.51,-1,-18743,65870,84613,47127,0,-20136,0,0,0,,20136,-20136
33,08/13/2017,34,8:15,8:30,,16.51,0,16.51,16.51,-1,-26568,53961,80529,27393,0,-29549,0,0,0,,29549,-29549
33,08/13/2017,35,8:30,8:45,,27.81,0,27.81,27.81,-1,-34419,44629,79048,10210,0,-10089,0,0,0,,10089,-10089
33,08/13/2017,36,8:45,9:00,,25.74,0,25.74,25.74,-1,-37829,51095,88924,13266,0,-6411,0,0,0,,6411,-6411
33,08/13/2017,37,9:00,9:15,,21.79,0,21.79,21.79,-1,-34101,116660,150761,82559,0,-13604,0,0,0,,13604,-13604
33,08/13/2017,38,9:15,9:30,,27.81,0,27.81,27.81,-1,-36486,101376,137862,64890,0,-5817,0,0,0,,5817,-5817
33,08/13/2017,39,9:30,9:45,,,0,27.96,27.96,0,-42210,90005,132215,47795,0,-22,0,0,0,,22,-22
33,08/13/2017,40,9:45,10:00,,,0,27.94,27.94,0,-45340,88313,133653,42973,0,0,0,0,0,,0,0
33,08/13/2017,41,10:00,10:15,,26.03,0,26.03,26.03,-1,-45933,68938,114871,23005,0,-4832,0,0,0,,4832,-4832
33,08/13/2017,42,10:15,10:30,,27.93,0,27.93,27.93,-1,-46306,61213,107519,14907,0,-5623,0,0,0,,5623,-5623
33,08/13/2017,43,10:30,10:45,,26.81,0,26.81,26.81,-1,-44572,66323,110895,21751,0,-7443,0,0,0,,7443,-7443
33,08/13/2017,44,10:45,11:00,,26.81,0,26.81,26.81,-1,-46414,76399,122813,29985,0,-9656,0,0,0,,9656,-9656
33,08/13/2017,45,11:00,11:15,,16.03,0,16.03,16.03,-1,-50417,86384,136801,35967,0,-13856,0,0,0,,13856,-13856
33,08/13/2017,46,11:15,11:30,,26.81,0,26.81,26.81,-1,-47696,85976,133672,38280,0,-11780,0,0,0,,11780,-11780
33,08/13/2017,47,11:30,11:45,,22.59,0,22.59,22.59,-1,-45488,77822,123310,32334,0,-4960,0,0,0,,4960,-4960
33,08/13/2017,48,11:45,12:00,,22.59,0,22.59,22.59,-1,-52497,71207,123704,18710,0,-6155,0,0,0,,6155,-6155
33,08/13/2017,49,12:00,12:15,,28.93,0,28.93,28.93,-1,-35970,60720,96690,24750,0,-432,0,0,0,,432,-432
33,08/13/2017,50,12:15,12:30,,27.81,0,27.81,27.81,-1,-40954,68011,108965,27057,0,-1705,0,0,0,,1705,-1705
33,08/13/2017,51,12:30,12:45,,28.68,0,28.68,28.68,-1,-41729,76804,118533,35075,0,-1500,0,0,0,,1500,-1500
33,08/13/2017,52,12:45,13:00,,22.81,0,22.81,22.81,-1,-40914,80310,121224,39396,0,-3965,0,0,0,,3965,-3965
33,08/13/2017,53,13:00,13:15,,22.81,0,22.81,22.81,-1,-48058,76877,124935,28819,0,-10961,0,0,0,,10961,-10961
33,08/13/2017,54,13:15,13:30,,22.81,0,22.81,22.81,-1,-47804,77706,125510,29902,0,-16293,0,0,0,,16293,-16293
33,08/13/2017,55,13:30,13:45,,26.03,0,26.03,26.03,-1,-50630,75106,125736,24476,0,-22851,0,0,0,,22851,-22851
33,08/13/2017,56,13:45,14:00,,4.03,0,4.03,4.03,-1,-44946,72507,117453,27561,0,-34483,0,0,0,,34483,-34483
33,08/13/2017,57,14:00,14:15,,22.4,0,22.4,22.4,-1,-63113,71221,134334,8108,0,-19662,0,0,0,,19662,-19662
33,08/13/2017,58,14:15,14:30,33.81,26.81,0,33.81,26.81,2,-63124,81263,144387,18139,0,-676,22,0,0,,698,-654
33,08/13/2017,59,14:30,14:45,,26.81,0,26.81,26.81,-1,-71455,88361,159816,16906,0,-3012,0,0,0,,3012,-3012
33,08/13/2017,60,14:45,15:00,,13.9,0,13.9,13.9,-1,-62762,98981,161743,36219,0,-8496,0,0,0,,8496,-8496
33,08/13/2017,61,15:00,15:15,29.81,28.45,0,29.81,29.81,1,-85523,84938,170461,-585,0,-3180,419,0,0,,3599,-2761
33,08/13/2017,62,15:15,15:30,29.79,,0,29.79,29.79,1,-66598,90541,157139,23943,0,0,790,0,0,,790,790
33,08/13/2017,63,15:30,15:45,29.02,,0,29.02,29.02,1,-67624,98971,166595,31347,0,0,352,0,0,,352,352
33,08/13/2017,64,15:45,16:00,,26.81,0,26.81,26.81,-1,-55095,97912,153007,42817,0,-381,0,0,0,,381,-381
33,08/13/2017,65,16:00,16:15,,-150.03,0,-150.03,-150.03,-1,-31273,107711,138984,76438,0,-38439,0,0,0,,38439,-38439
33,08/13/2017,66,16:15,16:30,,-6.56,0,-6.56,-6.56,-1,-34413,68707,103120,34294,0,-44325,0,0,0,,44325,-44325
33,08/13/2017,67,16:30,16:45,,27.81,0,27.81,27.81,-1,-39237,60560,99797,21323,0,-6124,0,0,0,,6124,-6124
33,08/13/2017,68,16:45,17:00,30.17,27.81,0,30.17,30.17,1,-38473,38218,76691,-255,0,-457,897,0,0,,1354,440
33,08/13/2017,69,17:00,17:15,,-150.03,0,-150.03,-150.03,-1,-34047,115476,149523,81429,0,-17207,0,0,0,,17207,-17207
33,08/13/2017,70,17:15,17:30,29.79,-150.03,0,29.79,-150.03,2,-35017,55085,90102,20068,0,-41500,11,0,0,,41511,-41489
33,08/13/2017,71,17:30,17:45,35.98,-150.03,0,35.98,35.98,1,-28937,33083,62020,4146,0,-770,910,0,0,,1680,140
33,08/13/2017,72,17:45,18:00,31.07,,0,31.07,31.07,1,-29426,31647,61073,2221,0,0,1281,0,0,,1281,1281
33,08/13/2017,73,18:00,18:15,40.34,,0,40.34,40.34,1,-86420,45984,132404,-40436,0,0,9719,0,0,,9719,9719
33,08/13/2017,74,18:15,18:30,,,0,28.45,28.45,0,-51828,34282,86110,-17546,0,0,1375,0,0,,1375,1375
33,08/13/2017,75,18:30,18:45,29.81,,0,29.81,29.81,1,-52363,40560,92923,-11803,0,0,272,0,0,,272,272
33,08/13/2017,76,18:45,19:00,39.81,,0,39.81,39.81,1,-44611,50000,94611,5389,0,0,5840,0,0,,5840,5840
33,08/13/2017,77,19:00,19:15,30.07,,0,30.07,30.07,1,-103615,23160,126775,-80455,0,0,4599,0,0,,4599,4599
33,08/13/2017,78,19:15,19:30,,,0,29.25,29.25,0,-54833,27416,82249,-27417,0,0,710,0,0,,710,710
33,08/13/2017,79,19:30,19:45,,,0,29.24,29.24,0,-53038,20491,73529,-32547,0,0,0,0,0,,0,0
33,08/13/2017,80,19:45,20:00,39.81,,0,39.81,39.81,1,-84998,18076,103074,-66922,0,0,1727,0,0,,1727,1727
33,08/13/2017,81,20:00,20:15,58.02,,0,58.02,58.02,1,-76503,32657,109160,-43846,0,0,9682,0,0,,9682,9682
33,08/13/2017,82,20:15,20:30,68.51,,0,68.51,68.51,1,-66979,32402,99381,-34577,0,0,31035,0,0,,31035,31035
33,08/13/2017,83,20:30,20:45,33.81,29.82,0,29.82,29.82,-1,-44148,35076,79224,-9072,0,-124,18216,0,0,,18340,18092
33,08/13/2017,84,20:45,21:00,30.71,27.81,0,30.71,27.81,2,-47198,35453,82651,-11745,0,-407,1643,0,0,,2050,1236
33,08/13/2017,85,21:00,21:15,29.81,,0,29.81,29.81,1,-26279,43354,69633,17075,0,0,763,0,0,,763,763
33,08/13/2017,86,21:15,21:30,90.22,,0,90.22,90.22,1,-52909,26132,79041,-26777,0,0,6906,0,0,,6906,6906
33,08/13/2017,87,21:30,21:45,33.84,,0,33.84,33.84,1,-61393,23533,84926,-37860,0,0,19841,0,0,,19841,19841
33,08/13/2017,88,21:45,22:00,32.66,30.45,0,30.45,30.45,-1,-46618,29105,75723,-17513,0,-7,11401,0,0,,11408,11394
33,08/13/2017,89,22:00,22:15,32.66,27.81,0,27.81,27.81,-1,-42674,29244,71918,-13430,0,-256,200,0,0,,456,-56
33,08/13/2017,90,22:15,22:30,,26.79,0,26.79,26.79,-1,-33558,33024,66582,-534,0,-2077,0,0,0,,2077,-2077
33,08/13/2017,91,22:30,22:45,,26.03,0,26.03,26.03,-1,-21605,51387,72992,29782,0,-4208,0,0,0,,4208,-4208
33,08/13/2017,92,22:45,23:00,,26.81,0,26.81,26.81,-1,-23900,64772,88672,40872,0,-1704,0,0,0,,1704,-1704
33,08/13/2017,93,23:00,23:15,32.08,27.81,0,32.08,27.81,2,-64910,29308,94218,-35602,0,-688,1646,0,0,,2334,958
33,08/13/2017,94,23:15,23:30,29.81,26.81,0,29.81,26.81,2,-34033,30269,64302,-3764,0,-954,1190,0,0,,2144,236
33,08/13/2017,95,23:30,23:45,,22.81,0,22.81,22.81,-1,-17865,52577,70442,34712,0,-2813,0,0,0,,2813,-2813
33,08/13/2017,96,23:45,0:00,,-59.03,0,-59.03,-59.03,-1,-47666,72448,120114,24782,0,-35351,0,0,0,,35351,-35351
33,08/14/2017,1,0:00,0:15,31.04,26.81,0,31.04,26.81,2,-42523,49404,91927,6881,0,-7944,277,0,0,,8221,-7667
33,08/14/2017,2,0:15,0:30,,22.81,0,22.81,22.81,-1,-42673,56309,98982,13636,0,-747,0,0,0,,747,-747
33,08/14/2017,3,0:30,0:45,,-150.78,0,-150.78,-150.78,-1,-31744,69187,100931,37443,0,-37153,0,0,0,,37153,-37153
33,08/14/2017,4,0:45,1:00,,0.85,0,0.85,0.85,-1,-51327,74489,125816,23162,0,-48233,0,0,0,,48233,-48233
33,08/14/2017,5,1:00,1:15,29.81,0.85,0,29.81,29.81,1,-45272,55882,101154,10610,0,-4446,2,0,0,,4448,-4444
33,08/14/2017,6,1:15,1:30,,,0,29.01,29.01,0,-34090,52581,86671,18491,0,0,0,0,0,,0,0
33,08/14/2017,7,1:30,1:45,,27.81,0,27.81,27.81,-1,-34545,78399,112944,43854,0,-994,0,0,0,,994,-994
33,08/14/2017,8,1:45,2:00,,-150.78,0,-150.78,-150.78,-1,-38814,77117,115931,38303,0,-22024,0,0,0,,22024,-22024
33,08/14/2017,9,2:00,2:15,,22.81,0,22.81,22.81,-1,-47453,80956,128409,33503,0,-17968,0,0,0,,17968,-17968
33,08/14/2017,10,2:15,2:30,,-150.78,0,-150.78,-150.78,-1,-38495,90938,129433,52443,0,-23559,0,0,0,,23559,-23559
33,08/14/2017,11,2:30,2:45,,5.09,0,5.09,5.09,-1,-41288,70617,111905,29329,0,-41981,0,0,0,,41981,-41981
33,08/14/2017,12,2:45,3:00,,11.78,0,11.78,11.78,-1,-44007,80475,124482,36468,0,-38172,0,0,0,,38172,-38172
33,08/14/2017,13,3:00,3:15,,6.78,0,6.78,6.78,-1,-64694,92261,156955,27567,0,-22353,0,0,0,,22353,-22353
33,08/14/2017,14,3:15,3:30,29.81,6.78,0,29.81,29.81,1,-60269,41237,101506,-19032,0,-27,532,0,0,,559,505
33,08/14/2017,15,3:30,3:45,29.68,,0,29.68,29.68,1,-63024,50168,113192,-12856,0,0,1059,0,0,,1059,1059
33,08/14/2017,16,3:45,4:00,29.68,22.81,0,22.81,22.81,-1,-46729,61397,108126,14668,0,-2779,109,0,0,,2888,-2670
33,08/14/2017,17,4:00,4:15,,9.78,0,9.78,9.78,-1,-49695,94181,143876,44486,0,-25471,0,0,0,,25471,-25471
33,08/14/2017,18,4:15,4:30,,15.91,0,15.91,15.91,-1,-43831,90027,133858,46196,0,-40092,0,0,0,,40092,-40092
33,08/14/2017,19,4:30,4:45,,-0.07,0,-0.07,-0.07,-1,-44059,96271,140330,52212,0,-47105,0,0,0,,47105,-47105
33,08/14/2017,20,4:45,5:00,,-28.78,0,-28.78,-28.78,-1,-46420,102059,148479,55639,0,-52597,0,0,0,,52597,-52597
33,08/14/2017,21,5:00,5:15,,-3.78,0,-3.78,-3.78,-1,-60907,131989,192896,71082,0,-40432,0,0,0,,40432,-40432
33,08/14/2017,22,5:15,5:30,,-72.36,0,-72.36,-72.36,-1,-36853,134547,171400,97694,0,-61667,0,0,0,,61667,-61667
33,08/14/2017,23,5:30,5:45,,-38.78,0,-38.78,-38.78,-1,-48743,98868,147611,50125,0,-56157,0,0,0,,56157,-56157
33,08/14/2017,24,5:45,6:00,,2.78,0,2.78,2.78,-1,-56669,113850,170519,57181,0,-39118,0,0,0,,39118,-39118
33,08/14/2017,25,6:00,6:15,,27.9,0,27.9,27.9,-1,-66010,81901,147911,15891,0,-9678,0,0,0,,9678,-9678
33,08/14/2017,26,6:15,6:30,,22.9,0,22.9,22.9,-1,-40029,84055,124084,44026,0,-1282,0,0,0,,1282,-1282
33,08/14/2017,27,6:30,6:45,,22.9,0,22.9,22.9,-1,-33067,64140,97207,31073,0,-1760,0,0,0,,1760,-1760
33,08/14/2017,28,6:45,7:00,,28.82,0,28.82,28.82,-1,-35740,54599,90339,18859,0,-994,0,0,0,,994,-994
33,08/14/2017,29,7:00,7:15,,-26.78,0,-26.78,-26.78,-1,-61362,110967,172329,49605,0,-20276,0,0,0,,20276,-20276
33,08/14/2017,30,7:15,7:30,,11.65,0,11.65,11.65,-1,-35621,80299,115920,44678,0,-44958,0,0,0,,44958,-44958
33,08/14/2017,31,7:30,7:45,,17.9,0,17.9,17.9,-1,-27956,31741,59697,3785,0,-24694,0,0,0,,24694,-24694
33,08/14/2017,32,7:45,8:00,31.54,17.9,0,31.54,31.54,1,-56802,69366,126168,12564,0,-3522,977,0,0,,4499,-2545
33,08/14/2017,33,8:00,8:15,,18.85,0,18.85,18.85,-1,-72521,82283,154804,9762,0,-3227,0,0,0,,3227,-3227
33,08/14/2017,34,8:15,8:30,33.9,30.34,0,33.9,33.9,1,-72471,52239,124710,-20232,0,-796,594,0,0,,1390,-202
33,08/14/2017,35,8:30,8:45,60.12,,0,60.12,60.12,1,-73529,39832,113361,-33697,0,0,9581,0,0,,9581,9581
33,08/14/2017,36,8:45,9:00,33.77,,0,33.77,33.77,1,-84810,59320,144130,-25490,0,0,10147,0,0,,10147,10147
33,08/14/2017,37,9:00,9:15,33.77,16.9,0,16.9,16.9,-1,-52927,86701,139628,33774,0,-4662,751,0,0,,5413,-3911
33,08/14/2017,38,9:15,9:30,,24.13,0,24.13,24.13,-1,-62433,75799,138232,13366,0,-7981,0,0,0,,7981,-7981
33,08/14/2017,39,9:30,9:45,,20.1,0,20.1,20.1,-1,-58148,76175,134323,18027,0,-5108,0,0,0,,5108,-5108
33,08/14/2017,40,9:45,10:00,,18.95,0,18.95,18.95,-1,-58840,79966,138806,21126,0,-7746,0,0,0,,7746,-7746
33,08/14/2017,41,10:00,10:15,,9.78,0,9.78,9.78,-1,-60586,96093,156679,35507,0,-23512,0,0,0,,23512,-23512
33,08/14/2017,42,10:15,10:30,,23.78,0,23.78,23.78,-1,-70564,100226,170790,29662,0,-22023,0,0,0,,22023,-22023
33,08/14/2017,43,10:30,10:45,,16.64,0,16.64,16.64,-1,-58858,100491,159349,41633,0,-27136,0,0,0,,27136,-27136
33,08/14/2017,44,10:45,11:00,,9.52,0,9.52,9.52,-1,-78529,103989,182518,25460,0,-37992,0,0,0,,37992,-37992
33,08/14/2017,45,11:00,11:15,,21.06,0,21.06,21.06,-1,-81930,94726,176656,12796,0,-11571,0,0,0,,11571,-11571
33,08/14/2017,46,11:15,11:30,,17.9,0,17.9,17.9,-1,-73101,97712,170813,24611,0,-13581,0,0,0,,13581,-13581
33,08/14/2017,47,11:30,11:45,,22.84,0,22.84,22.84,-1,-75247,98955,174202,23708,0,-21884,0,0,0,,21884,-21884
33,08/14/2017,48,11:45,12:00,,19.51,0,19.51,19.51,-1,-73779,89950,163729,16171,0,-13489,0,0,0,,13489,-13489
33,08/14/2017,49,12:00,12:15,,27.9,0,27.9,27.9,-1,-59722,71444,131166,11722,0,-560,0,0,0,,560,-560
33,08/14/2017,50,12:15,12:30,,27.42,0,27.42,27.42,-1,-59025,84245,143270,25220,0,-4293,0,0,0,,4293,-4293
33,08/14/2017,51,12:30,12:45,,27.9,0,27.9,27.9,-1,-59774,86182,145956,26408,0,-3419,0,0,0,,3419,-3419
33,08/14/2017,52,12:45,13:00,,24.1,0,24.1,24.1,-1,-74447,86783,161230,12336,0,-3262,0,0,0,,3262,-3262
33,08/14/2017,53,13:00,13:15,,22.9,0,22.9,22.9,-1,-56044,91287,147331,35243,0,-4562,0,0,0,,4562,-4562
33,08/14/2017,54,13:15,13:30,,,0,29.03,29.03,0,-69634,70285,139919,651,0,0,0,0,0,,0,0
33,08/14/2017,55,13:30,13:45,,28.44,0,28.44,28.44,-1,-70993,68464,139457,-2529,0,-738,0,0,0,,738,-738
33,08/14/2017,56,13:45,14:00,,28.45,0,28.45,28.45,-1,-78030,64649,142679,-13381,0,-1444,0,0,0,,1444,-1444
33,08/14/2017,57,14:00,14:15,37.14,28.47,0,37.14,28.47,2,-87325,60070,147395,-27255,0,-346,3485,0,0,,3831,3139
33,08/14/2017,58,14:15,14:30,29.9,,0,29.9,29.9,1,-66743,66752,133495,9,0,0,1172,0,0,,1172,1172
33,08/14/2017,59,14:30,14:45,,,0,29.41,29.41,0,-89519,73983,163502,-15536,0,0,0,0,0,,0,0
33,08/14/2017,60,14:45,15:00,,,0,29.42,29.42,0,-88620,75589,164209,-13031,0,0,0,0,0,,0,0
33,08/14/2017,61,15:00,15:15,,,0,30.2,30.2,0,-96103,103140,199243,7037,0,0,0,0,0,,0,0
33,08/14/2017,62,15:15,15:30,,30.51,0,30.51,30.51,-1,-94304,98030,192334,3726,0,-13,0,0,0,,13,-13
33,08/14/2017,63,15:30,15:45,,27.9,0,27.9,27.9,-1,-94146,93781,187927,-365,0,-1462,0,0,0,,1462,-1462
33,08/14/2017,64,15:45,16:00,,30.5,0,30.5,30.5,-1,-78444,79754,158198,1310,0,-1028,0,0,0,,1028,-1028
33,08/14/2017,65,16:00,16:15,,30.52,0,30.52,30.52,-1,-81079,96235,177314,15156,0,-648,0,0,0,,648,-648
33,08/14/2017,66,16:15,16:30,,30.52,0,30.52,30.52,-1,-65738,117525,183263,51787,0,-146,0,0,0,,146,-146
33,08/14/2017,67,16:30,16:45,,30.5,0,30.5,30.5,-1,-57088,113751,170839,56663,0,-274,0,0,0,,274,-274
33,08/14/2017,68,16:45,17:00,,,0,30.18,30.18,0,-63810,101211,165021,37401,0,0,0,0,0,,0,0
33,08/14/2017,69,17:00,17:15,,27.9,0,27.9,27.9,-1,-38569,126376,164945,87807,0,-1332,0,0,0,,1332,-1332
33,08/14/2017,70,17:15,17:30,,28.11,0,28.11,28.11,-1,-45232,116243,161475,71011,0,-1915,0,0,0,,1915,-1915
33,08/14/2017,71,17:30,17:45,,,0,30.19,30.19,0,-51142,106929,158071,55787,0,-23,0,0,0,,23,-23
33,08/14/2017,72,17:45,18:00,,,0,30.18,30.18,0,-53888,98668,152556,44780,0,0,0,0,0,,0,0
33,08/14/2017,73,18:00,18:15,29.9,,0,29.9,29.9,1,-91853,83728,175581,-8125,0,0,691,0,0,,691,691
33,08/14/2017,74,18:15,18:30,29.9,,0,29.9,29.9,1,-75686,96104,171790,20418,0,0,181,0,0,,181,181
33,08/14/2017,75,18:30,18:45,29.9,,0,29.9,29.9,1,-76057,95131,171188,19074,0,0,9,0,0,,9,9
33,08/14/2017,76,18:45,19:00,,,0,30.21,30.21,0,-84470,93985,178455,9515,0,0,0,0,0,,0,0
33,08/14/2017,77,19:00,19:15,34.07,,0,34.07,34.07,1,-100620,73576,174196,-27044,0,0,1464,0,0,,1464,1464
33,08/14/2017,78,19:15,19:30,36.96,,0,36.96,36.96,1,-100427,72349,172776,-28078,0,0,5051,0,0,,5051,5051
33,08/14/2017,79,19:30,19:45,47.96,,0,47.96,47.96,1,-95933,75613,171546,-20320,0,0,14614,0,0,,14614,14614
33,08/14/2017,80,19:45,20:00,63.12,,0,63.12,63.12,1,-111788,81231,193019,-30557,0,0,25449,0,0,,25449,25449
33,08/14/2017,81,20:00,20:15,32.05,27.44,0,32.05,27.44,2,-47754,110445,158199,62691,0,-632,9625,0,0,,10257,8993
33,08/14/2017,82,20:15,20:30,,,0,30.21,30.21,0,-50823,103820,154643,52997,0,-14,0,0,0,,14,-14
33,08/14/2017,83,20:30,20:45,,,0,30.21,30.21,0,-55178,93740,148918,38562,0,0,0,0,0,,0,0
33,08/14/2017,84,20:45,21:00,,,0,30.21,30.21,0,-59480,99349,158829,39869,0,0,0,0,0,,0,0
33,08/14/2017,85,21:00,21:15,,,0,30.21,30.21,0,-46045,94381,140426,48336,0,0,0,0,0,,0,0
33,08/14/2017,86,21:15,21:30,32.21,,0,32.21,32.21,1,-60570,72610,133180,12040,0,0,187,0,0,,187,187
33,08/14/2017,87,21:30,21:45,29.9,,0,29.9,29.9,1,-69196,73136,142332,3940,0,0,447,0,0,,447,447
33,08/14/2017,88,21:45,22:00,29.9,26.9,0,30.18,26.9,2,-34704,69822,104526,35118,0,-294,273,0,0,,567,-21
33,08/14/2017,89,22:00,22:15,350.12,,0,350.12,350.12,1,-145631,37956,183587,-107675,0,0,32846,0,0,,32846,32846
33,08/14/2017,90,22:15,22:30,350.12,-52.07,0,-52.07,-52.07,-1,-59183,71817,131000,12634,0,-1905,42353,0,0,,44258,40448
33,08/14/2017,91,22:30,22:45,350.12,-38.47,0,-38.47,-38.47,-1,-51086,78728,129814,27642,0,-7605,138,0,0,,7743,-7467
33,08/14/2017,92,22:45,23:00,,11.65,0,11.65,11.65,-1,-59081,118878,177959,59797,0,-6560,0,0,0,,6560,-6560
33,08/14/2017,93,23:00,23:15,350.12,25.56,0,350.12,350.12,1,-116528,68281,184809,-48247,0,-5315,12956,0,0,,18271,7641
33,08/14/2017,94,23:15,23:30,76.12,,0,76.12,76.12,1,-93035,74108,167143,-18927,0,0,29394,0,0,,29394,29394
33,08/14/2017,95,23:30,23:45,53.5,,0,53.5,53.5,1,-122786,101845,224631,-20941,0,0,12697,0,0,,12697,12697
33,08/14/2017,96,23:45,0:00,36,26.9,0,26.9,26.9,-1,-142573,130848,273421,-11725,0,-206,17400,0,0,,17606,17194
33,08/15/2017,1,0:00,0:15,36,22.9,0,22.9,22.9,-1,-43035,113289,156324,70254,0,-927,1611,0,0,,2538,684
33,08/15/2017,2,0:15,0:30,,8.54,0,8.54,8.54,-1,-23359,70891,94250,47532,0,-3103,0,0,0,,3103,-3103
33,08/15/2017,3,0:30,0:45,,8.34,0,8.34,8.34,-1,-35399,73279,108678,37880,0,-9691,0,0,0,,9691,-9691
33,08/15/2017,4,0:45,1:00,,22.9,0,22.9,22.9,-1,-48960,78847,127807,29887,0,-1344,0,0,0,,1344,-1344
33,08/15/2017,5,1:00,1:15,,16.18,0,16.18,16.18,-1,-25592,38535,64127,12943,0,-1648,0,0,0,,1648,-1648
33,08/15/2017,6,1:15,1:30,,,0,29.34,29.34,0,-32766,39182,71948,6416,0,0,0,0,0,,0,0
33,08/15/2017,7,1:30,1:45,29.9,,0,29.9,29.9,1,-46920,40073,86993,-6847,0,0,143,0,0,,143,143
33,08/15/2017,8,1:45,2:00,30.22,,0,30.22,30.22,1,-58466,37358,95824,-21108,0,0,747,0,0,,747,747
33,08/15/2017,9,2:00,2:15,31.52,,0,31.52,31.52,1,-58600,59710,118310,1110,0,0,1387,0,0,,1387,1387
33,08/15/2017,10,2:15,2:30,,,0,27.08,27.08,0,-56859,35230,92089,-21629,0,0,191,0,0,,191,191
33,08/15/2017,11,2:30,2:45,31.9,,0,31.9,31.9,1,-71168,33538,104706,-37630,0,0,1392,0,0,,1392,1392
33,08/15/2017,12,2:45,3:00,30.99,,0,30.99,30.99,1,-67193,34055,101248,-33138,0,0,1584,0,0,,1584,1584
33,08/15/2017,13,3:00,3:15,36.95,,0,36.95,36.95,1,-52076,34498,86574,-17578,0,0,2387,0,0,,2387,2387
33,08/15/2017,14,3:15,3:30,39.9,,0,39.9,39.9,1,-56047,40214,96261,-15833,0,0,7300,0,0,,7300,7300
33,08/15/2017,15,3:30,3:45,51.96,,0,51.96,51.96,1,-77053,40964,118017,-36089,0,0,7876,0,0,,7876,7876
33,08/15/2017,16,3:45,4:00,32.37,,0,32.37,32.37,1,-78943,48001,126944,-30942,0,0,9600,0,0,,9600,9600
33,08/15/2017,17,4:00,4:15,32.26,,0,32.26,32.26,1,-50069,40636,90705,-9433,0,0,5691,0,0,,5691,5691
33,08/15/2017,18,4:15,4:30,33.9,,0,33.9,33.9,1,-64664,42643,107307,-22021,0,0,8520,0,0,,8520,8520
33,08/15/2017,19,4:30,4:45,29.93,,0,29.93,29.93,1,-55960,51118,107078,-4842,0,0,2745,0,0,,2745,2745
33,08/15/2017,20,4:45,5:00,33.04,,0,33.04,33.04,1,-54720,47644,102364,-7076,0,0,3913,0,0,,3913,3913
33,08/15/2017,21,5:00,5:15,,,0,27.09,27.09,0,-18392,70312,88704,51920,0,0,399,0,0,,399,399
33,08/15/2017,22,5:15,5:30,,,0,27.08,27.08,0,-25135,44333,69468,19198,0,0,0,0,0,,0,0
33,08/15/2017,23,5:30,5:45,,,0,27.05,27.05,0,-35733,32135,67868,-3598,0,0,0,0,0,,0,0
33,08/15/2017,24,5:45,6:00,32.9,,0,32.9,32.9,1,-55129,34731,89860,-20398,0,0,3872,0,0,,3872,3872
33,08/15/2017,25,6:00,6:15,32.9,25.88,0,25.88,25.88,-1,-30991,88189,119180,57198,0,-2760,386,0,0,,3146,-2374
33,08/15/2017,26,6:15,6:30,,22.79,0,22.79,22.79,-1,-38182,52492,90674,14310,0,-5847,0,0,0,,5847,-5847
33,08/15/2017,27,6:30,6:45,,,0,29.36,29.36,0,-36579,28056,64635,-8523,0,-520,0,0,0,,520,-520
33,08/15/2017,28,6:45,7:00,,,0,29.3,29.3,0,-49264,27622,76886,-21642,0,0,0,0,0,,0,0
33,08/15/2017,29,7:00,7:15,,,0,30.32,30.32,0,-69188,81491,150679,12303,0,0,0,0,0,,0,0
33,08/15/2017,30,7:15,7:30,,,0,30.26,30.26,0,-44796,47282,92078,2486,0,0,0,0,0,,0,0
33,08/15/2017,31,7:30,7:45,350.96,,0,350.96,350.96,1,-51307,7462,58769,-43845,0,0,17200,0,0,,17200,17200
33,08/15/2017,32,7:45,8:00,350.96,,0,350.96,350.96,1,-49843,50786,100629,943,0,0,39722,0,0,,39722,39722
33,08/15/2017,33,8:00,8:15,31.2,27.99,0,31.2,27.99,2,-62995,117329,180324,54334,0,-222,1499,0,0,,1721,1277
33,08/15/2017,34,8:15,8:30,178.93,,0,178.93,178.93,1,-87332,47602,134934,-39730,0,0,21092,0,0,,21092,21092
33,08/15/2017,35,8:30,8:45,46.21,,0,46.21,46.21,1,-81219,60488,141707,-20731,0,0,20793,0,0,,20793,20793
33,08/15/2017,36,8:45,9:00,202.19,,0,202.19,202.19,1,-103193,32645,135838,-70548,0,0,24464,0,0,,24464,24464
33,08/15/2017,37,9:00,9:15,41.96,,0,41.96,41.96,1,-87388,62688,150076,-24700,0,0,26531,0,0,,26531,26531
33,08/15/2017,38,9:15,9:30,73.21,,0,73.21,73.21,1,-89960,57476,147436,-32484,0,0,12939,0,0,,12939,12939
33,08/15/2017,39,9:30,9:45,73.21,,0,73.21,73.21,1,-96514,59646,156160,-36868,0,0,35715,0,0,,35715,35715
33,08/15/2017,40,9:45,10:00,35.2,,0,35.2,35.2,1,-88271,66088,154359,-22183,0,0,24249,0,0,,24249,24249
33,08/15/2017,41,10:00,10:15,29.79,30.27,0,30.27,30.27,-1,-85817,103823,189640,18006,0,-122,7475,0,0,,7597,7353
33,08/15/2017,42,10:15,10:30,192.96,30.27,0,192.96,192.96,1,-127068,77647,204715,-49421,0,-123,9242,0,0,,9365,9119
33,08/15/2017,43,10:30,10:45,350.96,,0,350.96,350.96,1,-121449,77154,198603,-44295,0,0,41436,0,0,,41436,41436
33,08/15/2017,44,10:45,11:00,109.4,,0,109.4,109.4,1,-128812,78622,207434,-50190,0,0,19157,0,0,,19157,19157
33,08/15/2017,45,11:00,11:15,214.96,,0,214.96,214.96,1,-163678,85377,249055,-78301,0,0,60010,0,0,,60010,60010
33,08/15/2017,46,11:15,11:30,100.96,,0,100.96,100.96,1,-128819,92958,221777,-35861,0,0,46956,0,0,,46956,46956
33,08/15/2017,47,11:30,11:45,32.03,26.79,0,32.03,26.79,2,-123470,109066,232536,-14404,0,-542,4349,0,0,,4891,3807
33,08/15/2017,48,11:45,12:00,98.89,,0,98.89,98.89,1,-120658,106308,226966,-14350,0,0,15494,0,0,,15494,15494
33,08/15/2017,49,12:00,12:15,32.15,,0,32.15,32.15,1,-116492,83924,200416,-32568,0,0,6222,0,0,,6222,6222
33,08/15/2017,50,12:15,12:30,,,0,30.36,30.36,0,-108216,98621,206837,-9595,0,0,0,0,0,,0,0
33,08/15/2017,51,12:30,12:45,33.79,,0,33.79,33.79,1,-121432,96583,218015,-24849,0,0,460,0,0,,460,460
33,08/15/2017,52,12:45,13:00,40,,0,40,40,1,-134110,79067,213177,-55043,0,0,9173,0,0,,9173,9173
33,08/15/2017,53,13:00,13:15,221.96,,0,221.96,221.96,1,-123380,78220,201600,-45160,0,0,27252,0,0,,27252,27252
33,08/15/2017,54,13:15,13:30,350.96,,0,350.96,350.96,1,-132080,79233,211313,-52847,0,0,51778,0,0,,51778,51778
33,08/15/2017,55,13:30,13:45,45.96,,0,45.96,45.96,1,-117261,98082,215343,-19179,0,0,25690,0,0,,25690,25690
33,08/15/2017,56,13:45,14:00,66.74,,0,66.74,66.74,1,-122227,88577,210804,-33650,0,0,17758,0,0,,17758,17758
33,08/15/2017,57,14:00,14:15,142.96,,0,142.96,142.96,1,-139919,91049,230968,-48870,0,0,31176,0,0,,31176,31176
33,08/15/2017,58,14:15,14:30,222.96,,0,222.96,222.96,1,-140899,103026,243925,-37873,0,0,47618,0,0,,47618,47618
33,08/15/2017,59,14:30,14:45,52.96,,0,52.96,52.96,1,-124852,98873,223725,-25979,0,0,19346,0,0,,19346,19346
33,08/15/2017,60,14:45,15:00,143.96,,0,143.96,143.96,1,-129241,94025,223266,-35216,0,0,36481,0,0,,36481,36481
33,08/15/2017,61,15:00,15:15,63.72,,0,63.72,63.72,1,-148013,120390,268403,-27623,0,0,35602,0,0,,35602,35602
33,08/15/2017,62,15:15,15:30,41.96,,0,41.96,41.96,1,-152886,108788,261674,-44098,0,0,34428,0,0,,34428,34428
33,08/15/2017,63,15:30,15:45,52.96,,0,52.96,52.96,1,-148885,115816,264701,-33069,0,0,39702,0,0,,39702,39702
33,08/15/2017,64,15:45,16:00,39.79,,0,39.79,39.79,1,-139071,123647,262718,-15424,0,0,18322,0,0,,18322,18322
33,08/15/2017,65,16:00,16:15,276.96,,0,276.96,276.96,1,-193610,137462,331072,-56148,0,0,41017,0,0,,41017,41017
33,08/15/2017,66,16:15,16:30,33.79,,0,33.79,33.79,1,-133922,147785,281707,13863,0,0,9713,0,0,,9713,9713
33,08/15/2017,67,16:30,16:45,,,0,29.99,29.99,0,-136948,144389,281337,7441,0,0,0,0,0,,0,0
33,08/15/2017,68,16:45,17:00,164.84,,0,164.84,164.84,1,-154401,123791,278192,-30610,0,0,12483,0,0,,12483,12483
33,08/15/2017,69,17:00,17:15,71.36,,0,71.36,71.36,1,-120633,168510,289143,47877,0,0,18970,0,0,,18970,18970
33,08/15/2017,70,17:15,17:30,,,0,29.18,29.18,0,-111225,155217,266442,43992,0,0,256,0,0,,256,256
33,08/15/2017,71,17:30,17:45,,,0,29.18,29.18,0,-120592,145763,266355,25171,0,0,0,0,0,,0,0
33,08/15/2017,72,17:45,18:00,,,0,29.18,29.18,0,-96311,144117,240428,47806,0,0,0,0,0,,0,0
33,08/15/2017,73,18:00,18:15,,,0,29.96,29.96,0,-165706,82774,248480,-82932,0,0,0,0,0,,0,0
33,08/15/2017,74,18:15,18:30,,,0,30,30,0,-128883,84530,213413,-44353,0,0,0,0,0,,0,0
33,08/15/2017,75,18:30,18:45,41.24,,0,41.24,41.24,1,-128334,88623,216957,-39711,0,0,2094,0,0,,2094,2094
33,08/15/2017,76,18:45,19:00,87.96,,0,87.96,87.96,1,-116486,94562,211048,-21924,0,0,19595,0,0,,19595,19595
33,08/15/2017,77,19:00,19:15,34.24,,0,34.24,34.24,1,-134090,72412,206502,-61678,0,0,12827,0,0,,12827,12827
33,08/15/2017,78,19:15,19:30,47.8,,0,47.8,47.8,1,-115327,76351,191678,-38976,0,0,19884,0,0,,19884,19884
33,08/15/2017,79,19:30,19:45,40.02,,0,40.02,40.02,1,-105785,84303,190088,-21482,0,0,22528,0,0,,22528,22528
33,08/15/2017,80,19:45,20:00,35.54,,0,35.54,35.54,1,-111153,89538,200691,-21615,0,0,17518,0,0,,17518,17518
33,08/15/2017,81,20:00,20:15,41.36,,0,41.36,41.36,1,-82696,60311,143007,-22385,0,0,15328,0,0,,15328,15328
33,08/15/2017,82,20:15,20:30,30.02,,0,30.02,30.02,1,-91845,69717,161562,-22128,0,0,2991,0,0,,2991,2991
33,08/15/2017,83,20:30,20:45,29.05,,0,29.05,29.05,1,-83370,82298,165668,-1072,0,0,783,0,0,,783,783
33,08/15/2017,84,20:45,21:00,29.05,,0,29.05,29.05,1,-80927,88633,169560,7706,0,0,29,0,0,,29,29
33,08/15/2017,85,21:00,21:15,34.47,,0,34.47,34.47,1,-61760,51178,112938,-10582,0,0,3489,0,0,,3489,3489
33,08/15/2017,86,21:15,21:30,182.79,,0,182.79,182.79,1,-77498,33465,110963,-44033,0,0,20597,0,0,,20597,20597
33,08/15/2017,87,21:30,21:45,222.02,,0,222.02,222.02,1,-72061,50165,122226,-21896,0,0,37799,0,0,,37799,37799
33,08/15/2017,88,21:45,22:00,222.02,5.73,0,5.73,5.73,-1,-36345,91241,127586,54896,0,-8850,3992,0,0,,12842,-4858
33,08/15/2017,89,22:00,22:15,34.9,27.79,0,34.9,27.79,2,-71545,58988,130533,-12557,0,-4140,1612,0,0,,5752,-2528
33,08/15/2017,90,22:15,22:30,34.9,26.79,0,26.79,26.79,-1,-46974,62490,109464,15516,0,-629,53,0,0,,682,-576
33,08/15/2017,91,22:30,22:45,,27.36,0,27.36,27.36,-1,-41384,74230,115614,32846,0,-648,0,0,0,,648,-648
33,08/15/2017,92,22:45,23:00,,23.65,0,23.65,23.65,-1,-31890,85958,117848,54068,0,-1643,0,0,0,,1643,-1643
33,08/15/2017,93,23:00,23:15,52.02,30.87,0,52.02,29.96,2,-82777,53018,135795,-29759,0,-313,5195,0,0,,5508,4882
33,08/15/2017,94,23:15,23:30,32.69,,0,32.69,32.69,1,-58126,59706,117832,1580,0,0,5406,0,0,,5406,5406
33,08/15/2017,95,23:30,23:45,32.69,29.87,0,29.87,29.87,-1,-42177,58336,100513,16159,0,-173,352,0,0,,525,179
33,08/15/2017,96,23:45,0:00,,12.71,0,12.71,12.71,-1,-39548,72315,111863,32767,0,-8816,0,0,0,,8816,-8816
33,08/16/2017,1,0:00,0:15,30.4,-28.36,0,30.4,-28.36,2,-59495,38922,98417,-20573,0,-16227,290,0,0,,16517,-15937
33,08/16/2017,2,0:15,0:30,32.46,-28.36,0,32.46,32.46,1,-77752,18257,96009,-59495,0,-158,1253,0,0,,1411,1095
33,08/16/2017,3,0:30,0:45,,,0,29.35,29.35,0,-107809,17879,125688,-89930,0,0,0,0,0,,0,0
33,08/16/2017,4,0:45,1:00,,,0,29.4,29.4,0,-114318,22965,137283,-91353,0,0,0,0,0,,0,0
33,08/16/2017,5,1:00,1:15,130.12,,0,130.12,130.12,1,-108067,8077,116144,-99990,0,0,21402,0,0,,21402,21402
33,08/16/2017,6,1:15,1:30,44.42,,0,44.42,44.42,1,-59861,29331,89192,-30530,0,0,26358,0,0,,26358,26358
33,08/16/2017,7,1:30,1:45,,,0,29.33,29.33,0,-51499,27940,79439,-23559,0,0,57,0,0,,57,57
33,08/16/2017,8,1:45,2:00,,,0,29.34,29.34,0,-64461,36009,100470,-28452,0,0,0,0,0,,0,0
33,08/16/2017,9,2:00,2:15,39.85,,0,39.85,39.85,1,-56861,16191,73052,-40670,0,0,12173,0,0,,12173,12173
33,08/16/2017,10,2:15,2:30,32.56,,0,32.56,32.56,1,-48531,24603,73134,-23928,0,0,13237,0,0,,13237,13237
33,08/16/2017,11,2:30,2:45,,,0,29.3,29.3,0,-43382,29330,72712,-14052,0,0,333,0,0,,333,333
33,08/16/2017,12,2:45,3:00,,27.85,0,27.85,27.85,-1,-46242,19920,66162,-26322,0,-39,0,0,0,,39,-39
33,08/16/2017,13,3:00,3:15,,27.78,0,27.78,27.78,-1,-37938,31972,69910,-5966,0,-596,0,0,0,,596,-596
33,08/16/2017,14,3:15,3:30,,28.81,0,28.81,28.81,-1,-32971,16360,49331,-16611,0,-18,0,0,0,,18,-18
33,08/16/2017,15,3:30,3:45,,27.32,0,27.32,27.32,-1,-36371,22853,59224,-13518,0,-815,0,0,0,,815,-815
33,08/16/2017,16,3:45,4:00,,,0,29.28,29.28,0,-43108,17838,60946,-25270,0,0,0,0,0,,0,0
33,08/16/2017,17,4:00,4:15,,,0,29.22,29.22,0,-49825,20156,69981,-29669,0,0,0,0,0,,0,0
33,08/16/2017,18,4:15,4:30,33.85,,0,33.85,33.85,1,-55681,22718,78399,-32963,0,0,1407,0,0,,1407,1407
33,08/16/2017,19,4:30,4:45,29.25,,0,29.25,29.25,1,-38228,38926,77154,698,0,0,1221,0,0,,1221,1221
33,08/16/2017,20,4:45,5:00,31.74,,0,31.74,31.74,1,-42271,32195,74466,-10076,0,0,1495,0,0,,1495,1495
33,08/16/2017,21,5:00,5:15,,,0,29.34,29.34,0,-39079,48933,88012,9854,0,0,46,0,0,,46,46
33,08/16/2017,22,5:15,5:30,,29.31,0,29.31,29.31,-1,-38864,50655,89519,11791,0,-195,0,0,0,,195,-195
33,08/16/2017,23,5:30,5:45,,29.31,0,29.31,29.31,-1,-26552,51072,77624,24520,0,-617,0,0,0,,617,-617
33,08/16/2017,24,5:45,6:00,,,0,29.2,29.2,0,-36333,57544,93877,21211,0,0,0,0,0,,0,0
33,08/16/2017,25,6:00,6:15,65.58,,0,65.58,65.58,1,-96417,33963,130380,-62454,0,0,12126,0,0,,12126,12126
33,08/16/2017,26,6:15,6:30,29.52,,0,29.52,29.52,1,-26305,56883,83188,30578,0,0,2097,0,0,,2097,2097
33,08/16/2017,27,6:30,6:45,,27.52,0,27.52,27.52,-1,-24357,53904,78261,29547,0,-418,0,0,0,,418,-418
33,08/16/2017,28,6:45,7:00,,-14.39,0,-14.39,-14.39,-1,-34355,140490,174845,106135,0,-15880,0,0,0,,15880,-15880
33,08/16/2017,29,7:00,7:15,,26.52,0,26.52,26.52,-1,-32785,55795,88580,23010,0,-16926,0,0,0,,16926,-16926
33,08/16/2017,30,7:15,7:30,,26.52,0,26.52,26.52,-1,-35802,68680,104482,32878,0,-5326,0,0,0,,5326,-5326
33,08/16/2017,31,7:30,7:45,,27.52,0,27.52,27.52,-1,-42244,54688,96932,12444,0,-1914,0,0,0,,1914,-1914
33,08/16/2017,32,7:45,8:00,32.1,,0,32.1,32.1,1,-72981,60276,133257,-12705,0,0,830,0,0,,830,830
33,08/16/2017,33,8:00,8:15,65.12,,0,65.12,65.12,1,-148369,46060,194429,-102309,0,0,7195,0,0,,7195,7195
33,08/16/2017,34,8:15,8:30,286.12,,0,286.12,286.12,1,-148219,35143,183362,-113076,0,0,42810,0,0,,42810,42810
33,08/16/2017,35,8:30,8:45,286.12,,0,286.12,286.12,1,-135111,43222,178333,-91889,0,0,59667,0,0,,59667,59667
33,08/16/2017,36,8:45,9:00,128.22,,0,128.22,128.22,1,-134323,60607,194930,-73716,0,0,56197,0,0,,56197,56197
33,08/16/2017,37,9:00,9:15,78.51,,0,78.51,78.51,1,-122225,84624,206849,-37601,0,0,27589,0,0,,27589,27589
33,08/16/2017,38,9:15,9:30,47.91,,0,47.91,47.91,1,-129361,75214,204575,-54147,0,0,1214,0,0,,1214,1214
33,08/16/2017,39,9:30,9:45,29.52,,0,29.52,29.52,1,-131070,61570,192640,-69500,0,0,2469,0,0,,2469,2469
33,08/16/2017,40,9:45,10:00,32.17,,0,32.17,32.17,1,-148195,62038,210233,-86157,0,0,2539,0,0,,2539,2539
33,08/16/2017,41,10:00,10:15,32.17,5.13,0,5.13,5.13,-1,-76012,145560,221572,69548,0,-7935,124,0,0,,8059,-7811
33,08/16/2017,42,10:15,10:30,,25.35,0,25.35,25.35,-1,-89560,123456,213016,33896,0,-22757,0,0,0,,22757,-22757
33,08/16/2017,43,10:30,10:45,,26.79,0,26.79,26.79,-1,-86587,109890,196477,23303,0,-14036,0,0,0,,14036,-14036
33,08/16/2017,44,10:45,11:00,,25.35,0,25.35,25.35,-1,-77763,114185,191948,36422,0,-10210,0,0,0,,10210,-10210
33,08/16/2017,45,11:00,11:15,,30.97,0,30.97,30.97,-1,-117760,91277,209037,-26483,0,-2748,0,0,0,,2748,-2748
33,08/16/2017,46,11:15,11:30,,,0,30.26,30.26,0,-108317,91699,200016,-16618,0,0,0,0,0,,0,0
33,08/16/2017,47,11:30,11:45,,,0,30.27,30.27,0,-125846,84576,210422,-41270,0,0,0,0,0,,0,0
33,08/16/2017,48,11:45,12:00,31.69,,0,31.69,31.69,1,-120667,89657,210324,-31010,0,0,645,0,0,,645,645
33,08/16/2017,49,12:00,12:15,50.94,,0,50.94,50.94,1,-146923,44384,191307,-102539,0,0,13150,0,0,,13150,13150
33,08/16/2017,50,12:15,12:30,33.12,,0,33.12,33.12,1,-139215,49816,189031,-89399,0,0,10015,0,0,,10015,10015
33,08/16/2017,51,12:30,12:45,271.12,,0,271.12,271.12,1,-126246,53285,179531,-72961,0,0,27984,0,0,,27984,27984
33,08/16/2017,52,12:45,13:00,96.12,,0,96.12,96.12,1,-104487,78317,182804,-26170,0,0,33371,0,0,,33371,33371
33,08/16/2017,53,13:00,13:15,96.12,28.78,0,28.78,28.78,-1,-76718,98109,174827,21391,0,-1274,392,0,0,,1666,-882
33,08/16/2017,54,13:15,13:30,,31.03,0,31.03,31.03,-1,-83780,86416,170196,2636,0,-287,0,0,0,,287,-287
33,08/16/2017,55,13:30,13:45,,,0,30.28,30.28,0,-81930,72846,154776,-9084,0,0,0,0,0,,0,0
33,08/16/2017,56,13:45,14:00,,,0,30.27,30.27,0,-92753,58539,151292,-34214,0,0,0,0,0,,0,0
33,08/16/2017,57,14:00,14:15,,,0,30.27,30.27,0,-94377,101236,195613,6859,0,0,0,0,0,,0,0
33,08/16/2017,58,14:15,14:30,41.56,,0,41.56,41.56,1,-121240,97259,218499,-23981,0,0,5843,0,0,,5843,5843
33,08/16/2017,59,14:30,14:45,48.06,,0,48.06,48.06,1,-140098,103101,243199,-36997,0,0,26017,0,0,,26017,26017
33,08/16/2017,60,14:45,15:00,32.44,,0,32.44,32.44,1,-139490,107876,247366,-31614,0,0,12156,0,0,,12156,12156
33,08/16/2017,61,15:00,15:15,120.12,,0,120.12,120.12,1,-134350,68131,202481,-66219,0,0,12809,0,0,,12809,12809
33,08/16/2017,62,15:15,15:30,82.12,,0,82.12,82.12,1,-119678,70589,190267,-49089,0,0,34493,0,0,,34493,34493
33,08/16/2017,63,15:30,15:45,40.31,,0,40.31,40.31,1,-107858,67002,174860,-40856,0,0,13248,0,0,,13248,13248
33,08/16/2017,64,15:45,16:00,33.07,,0,33.07,33.07,1,-114351,58136,172487,-56215,0,0,10756,0,0,,10756,10756
33,08/16/2017,65,16:00,16:15,42.27,,0,42.27,42.27,1,-111317,51996,163313,-59321,0,0,6458,0,0,,6458,6458
33,08/16/2017,66,16:15,16:30,177.12,,0,177.12,177.12,1,-114015,61674,175689,-52341,0,0,25641,0,0,,25641,25641
33,08/16/2017,67,16:30,16:45,55.11,,0,55.11,55.11,1,-101609,73271,174880,-28338,0,0,11076,0,0,,11076,11076
33,08/16/2017,68,16:45,17:00,101.54,,0,101.54,101.54,1,-114793,71193,185986,-43600,0,0,26578,0,0,,26578,26578
33,08/16/2017,69,17:00,17:15,32.12,,0,32.12,32.12,1,-86491,49730,136221,-36761,0,0,8807,0,0,,8807,8807
33,08/16/2017,70,17:15,17:30,31.7,,0,31.7,31.7,1,-108534,50822,159356,-57712,0,0,72,0,0,,72,72
33,08/16/2017,71,17:30,17:45,75.67,,0,75.67,75.67,1,-132296,54477,186773,-77819,0,0,3423,0,0,,3423,3423
33,08/16/2017,72,17:45,18:00,96.62,,0,96.62,96.62,1,-136867,64528,201395,-72339,0,0,21278,0,0,,21278,21278
33,08/16/2017,73,18:00,18:15,35.12,,0,35.12,35.12,1,-91941,50527,142468,-41414,0,0,12295,0,0,,12295,12295
33,08/16/2017,74,18:15,18:30,35.12,30.63,0,30.63,30.63,-1,-72505,65520,138025,-6985,0,-60,30,0,0,,90,-30
33,08/16/2017,75,18:30,18:45,29.52,30.66,0,30.27,30.27,2,-73837,79118,152955,5281,0,-406,6,0,0,,412,-400
33,08/16/2017,76,18:45,19:00,29.52,,0,29.52,29.52,1,-75935,86473,162408,10538,0,0,493,0,0,,493,493
33,08/16/2017,77,19:00,19:15,31.22,,0,31.22,31.22,1,-81058,69197,150255,-11861,0,0,1306,0,0,,1306,1306
33,08/16/2017,78,19:15,19:30,32.05,,0,32.05,32.05,1,-101137,69023,170160,-32114,0,0,3178,0,0,,3178,3178
33,08/16/2017,79,19:30,19:45,32.1,,0,32.1,32.1,1,-88281,77119,165400,-11162,0,0,1064,0,0,,1064,1064
33,08/16/2017,80,19:45,20:00,,,0,30.27,30.27,0,-99604,85632,185236,-13972,0,0,0,0,0,,0,0
33,08/16/2017,81,20:00,20:15,,,0,30.23,30.23,0,-50729,53171,103900,2442,0,0,0,0,0,,0,0
33,08/16/2017,82,20:15,20:30,,,0,30.24,30.24,0,-62919,57574,120493,-5345,0,0,0,0,0,,0,0
33,08/16/2017,83,20:30,20:45,,,0,30.26,30.26,0,-78613,71329,149942,-7284,0,0,0,0,0,,0,0
33,08/16/2017,84,20:45,21:00,,31,0,31,31,-1,-84430,86515,170945,2085,0,-187,0,0,0,,187,-187
33,08/16/2017,85,21:00,21:15,,31.02,0,31.02,31.02,-1,-67447,97466,164913,30019,0,-525,0,0,0,,525,-525
33,08/16/2017,86,21:15,21:30,,,0,30.27,30.27,0,-91719,97960,189679,6241,0,0,0,0,0,,0,0
33,08/16/2017,87,21:30,21:45,,,0,30.27,30.27,0,-92452,109739,202191,17287,0,0,0,0,0,,0,0
33,08/16/2017,88,21:45,22:00,,20.11,0,20.11,20.11,-1,-61267,87164,148431,25897,0,-2510,0,0,0,,2510,-2510
33,08/16/2017,89,22:00,22:15,,26.79,0,26.79,26.79,-1,-107322,82401,189723,-24921,0,-3304,0,0,0,,3304,-3304
33,08/16/2017,90,22:15,22:30,,30.94,0,30.94,30.94,-1,-72312,48819,121131,-23493,0,-19,0,0,0,,19,-19
33,08/16/2017,91,22:30,22:45,,21.79,0,21.79,21.79,-1,-47551,60182,107733,12631,0,-4526,0,0,0,,4526,-4526
33,08/16/2017,92,22:45,23:00,,25.79,0,25.79,25.79,-1,-35401,52653,88054,17252,0,-7965,0,0,0,,7965,-7965
33,08/16/2017,93,23:00,23:15,,26.31,0,26.31,26.31,-1,-78774,63674,142448,-15100,0,-4704,0,0,0,,4704,-4704
33,08/16/2017,94,23:15,23:30,,,0,29.55,29.55,0,-69467,56001,125468,-13466,0,0,0,0,0,,0,0
33,08/16/2017,95,23:30,23:45,29.52,,0,29.52,29.52,1,-68442,53645,122087,-14797,0,0,202,0,0,,202,202
33,08/16/2017,96,23:45,0:00,29.52,,0,29.52,29.52,1,-80182,62179,142361,-18003,0,0,403,0,0,,403,403
33,08/17/2017,1,0:00,0:15,,,0,28.13,28.13,0,-58611,61903,120514,3292,0,0,0,0,0,,0,0
33,08/17/2017,2,0:15,0:30,,,0,28.13,28.13,0,-70094,23481,93575,-46613,0,0,0,0,0,,0,0
33,08/17/2017,3,0:30,0:45,,,0,28.14,28.14,0,-73735,14759,88494,-58976,0,0,0,0,0,,0,0
33,08/17/2017,4,0:45,1:00,,,0,28.14,28.14,0,-145578,50090,195668,-95488,0,0,0,0,0,,0,0
33,08/17/2017,5,1:00,1:15,80.37,,0,80.37,80.37,1,-51953,17845,69798,-34108,0,0,17049,0,0,,17049,17049
33,08/17/2017,6,1:15,1:30,34.53,27.97,0,27.97,27.97,-1,-25199,18054,43253,-7145,0,-32,18106,0,0,,18138,18074
33,08/17/2017,7,1:30,1:45,34.53,26.56,0,26.56,26.56,-1,-16668,23163,39831,6495,0,-530,392,0,0,,922,-138
33,08/17/2017,8,1:45,2:00,,22.56,0,22.56,22.56,-1,-27062,41301,68363,14239,0,-13525,0,0,0,,13525,-13525
33,08/17/2017,9,2:00,2:15,29.31,22.56,0,29.31,29.31,1,-28182,46862,75044,18680,0,-8674,368,0,0,,9042,-8306
33,08/17/2017,10,2:15,2:30,29.31,22.56,0,29.31,29.31,1,-21773,35533,57306,13760,0,-69,78,0,0,,147,9
33,08/17/2017,11,2:30,2:45,,28.48,0,28.48,28.48,-1,-25002,42083,67085,17081,0,-24,0,0,0,,24,-24
33,08/17/2017,12,2:45,3:00,,14.76,0,14.76,14.76,-1,-22984,49703,72687,26719,0,-14322,0,0,0,,14322,-14322
33,08/17/2017,13,3:00,3:15,32.06,25.03,0,32.06,25.03,2,-45877,7218,53095,-38659,0,-9773,973,0,0,,10746,-8800
33,08/17/2017,14,3:15,3:30,,,0,28.62,28.62,0,-42859,14738,57597,-28121,0,-18,0,0,0,,18,-18
33,08/17/2017,15,3:30,3:45,,,0,28.62,28.62,0,-37867,25006,62873,-12861,0,0,0,0,0,,0,0
33,08/17/2017,16,3:45,4:00,,22.56,0,22.56,22.56,-1,-26563,34829,61392,8266,0,-1631,0,0,0,,1631,-1631
33,08/17/2017,17,4:00,4:15,,27.35,0,27.35,27.35,-1,-37615,24445,62060,-13170,0,-1739,0,0,0,,1739,-1739
33,08/17/2017,18,4:15,4:30,,27.56,0,27.56,27.56,-1,-39971,41062,81033,1091,0,-285,0,0,0,,285,-285
33,08/17/2017,19,4:30,4:45,,17.63,0,17.63,17.63,-1,-30116,49031,79147,18915,0,-12642,0,0,0,,12642,-12642
33,08/17/2017,20,4:45,5:00,,28.25,0,28.25,28.25,-1,-47839,39516,87355,-8323,0,-4460,0,0,0,,4460,-4460
33,08/17/2017,21,5:00,5:15,,,0,29.06,29.06,0,-71202,45968,117170,-25234,0,0,0,0,0,,0,0
33,08/17/2017,22,5:15,5:30,,26.56,0,26.56,26.56,-1,-44656,44223,88879,-433,0,-1197,0,0,0,,1197,-1197
33,08/17/2017,23,5:30,5:45,,27.1,0,27.1,27.1,-1,-34761,45285,80046,10524,0,-973,0,0,0,,973,-973
33,08/17/2017,24,5:45,6:00,,28.38,0,28.38,28.38,-1,-50166,46056,96222,-4110,0,-327,0,0,0,,327,-327
33,08/17/2017,25,6:00,6:15,,29.04,0,29.04,29.04,-1,-72258,59964,132222,-12294,0,-321,0,0,0,,321,-321
33,08/17/2017,26,6:15,6:30,,26.13,0,26.13,26.13,-1,-32013,52183,84196,20170,0,-4847,0,0,0,,4847,-4847
33,08/17/2017,27,6:30,6:45,,27.42,0,27.42,27.42,-1,-31031,33516,64547,2485,0,-4106,0,0,0,,4106,-4106
33,08/17/2017,28,6:45,7:00,,27.42,0,27.42,27.42,-1,-31977,38786,70763,6809,0,-57,0,0,0,,57,-57
33,08/17/2017,29,7:00,7:15,,-11.95,0,-11.95,-11.95,-1,-46225,97343,143568,51118,0,-29458,0,0,0,,29458,-29458
33,08/17/2017,30,7:15,7:30,,25.48,0,25.48,25.48,-1,-37883,64378,102261,26495,0,-23367,0,0,0,,23367,-23367
33,08/17/2017,31,7:30,7:45,31.58,27.03,0,31.58,31.58,1,-65302,27236,92538,-38066,0,-12014,692,0,0,,12706,-11322
33,08/17/2017,32,7:45,8:00,189.49,27.03,0,189.49,189.49,1,-93544,17296,110840,-76248,0,-7,11516,0,0,,11523,11509
33,08/17/2017,33,8:00,8:15,201.92,28.22,0,201.92,28.22,2,-82695,94329,177024,11634,0,-72,34650,0,0,,34722,34578
33,08/17/2017,34,8:15,8:30,35.14,27.42,0,35.14,27.42,2,-80235,92537,172772,12302,0,-187,383,0,0,,570,196
33,08/17/2017,35,8:30,8:45,85.83,,0,85.83,85.83,1,-90670,63751,154421,-26919,0,0,16084,0,0,,16084,16084
33,08/17/2017,36,8:45,9:00,280.02,,0,280.02,280.02,1,-109910,30133,140043,-79777,0,0,31200,0,0,,31200,31200
33,08/17/2017,37,9:00,9:15,95.33,,0,95.33,95.33,1,-115055,81732,196787,-33323,0,0,33552,0,0,,33552,33552
33,08/17/2017,38,9:15,9:30,283.02,,0,283.02,283.02,1,-120077,55838,175915,-64239,0,0,24566,0,0,,24566,24566
33,08/17/2017,39,9:30,9:45,45.24,,0,45.24,45.24,1,-111964,77935,189899,-34029,0,0,30246,0,0,,30246,30246
33,08/17/2017,40,9:45,10:00,198.47,,0,198.47,198.47,1,-133774,48686,182460,-85088,0,0,44479,0,0,,44479,44479
33,08/17/2017,41,10:00,10:15,280.02,,0,280.02,280.02,1,-111378,94236,205614,-17142,0,0,32334,0,0,,32334,32334
33,08/17/2017,42,10:15,10:30,280.02,,0,308.02,308.02,1,-250327,88909,339236,-161418,0,0,59146,0,18334,,77480,77480
33,08/17/2017,43,10:30,10:45,340.61,,0,374.67,374.67,1,-212838,89410,302248,-123428,0,0,41409,15000,27501,,83910,83910
33,08/17/2017,44,10:45,11:00,42.47,,0,236.47,236.47,1,-210752,93283,304035,-117469,0,0,1759,0,17501,,19260,19260
33,08/17/2017,45,11:00,11:15,79.11,,0,79.11,79.11,1,-178401,80724,259125,-97677,0,0,11888,0,0,,11888,11888
33,08/17/2017,46,11:15,11:30,,,0,29.12,29.12,0,-161122,86465,247587,-74657,0,0,127,0,0,,127,127
33,08/17/2017,47,11:30,11:45,31.8,,0,31.8,31.8,1,-165192,100998,266190,-64194,0,0,493,0,0,,493,493
33,08/17/2017,48,11:45,12:00,42.02,,0,42.02,42.02,1,-179049,122729,301778,-56320,0,0,4038,0,0,,4038,4038
33,08/17/2017,49,12:00,12:15,,,0,29.12,29.12,0,-89789,146388,236177,56599,0,0,106,0,0,,106,106
33,08/17/2017,50,12:15,12:30,,,0,29.43,29.43,0,-96022,131933,227955,35911,0,0,0,0,0,,0,0
33,08/17/2017,51,12:30,12:45,,,0,29.46,29.46,0,-96489,116439,212928,19950,0,0,0,0,0,,0,0
33,08/17/2017,52,12:45,13:00,,,0,29.47,29.47,0,-73847,132286,206133,58439,0,0,0,0,0,,0,0
33,08/17/2017,53,13:00,13:15,59.39,,0,59.39,59.39,1,-85154,50728,135882,-34426,0,0,7939,0,0,,7939,7939
33,08/17/2017,54,13:15,13:30,57.85,,0,57.85,57.85,1,-88636,31915,120551,-56721,0,0,29097,0,0,,29097,29097
33,08/17/2017,55,13:30,13:45,130.02,,0,130.02,130.02,1,-121752,34048,155800,-87704,0,0,46857,0,0,,46857,46857
33,08/17/2017,56,13:45,14:00,63.69,,0,63.69,63.69,1,-117494,43350,160844,-74144,0,0,65317,0,0,,65317,65317
33,08/17/2017,57,14:00,14:15,52.12,,0,52.12,52.12,1,-112301,51260,163561,-61041,0,0,43239,0,0,,43239,43239
33,08/17/2017,58,14:15,14:30,40.64,,0,40.64,40.64,1,-106253,51071,157324,-55182,0,0,43942,0,0,,43942,43942
33,08/17/2017,59,14:30,14:45,38.7,,0,38.7,38.7,1,-111390,64941,176331,-46449,0,0,32663,0,0,,32663,32663
33,08/17/2017,60,14:45,15:00,45.39,,0,45.39,45.39,1,-115846,55609,171455,-60237,0,0,36828,0,0,,36828,36828
33,08/17/2017,61,15:00,15:15,36.02,,0,36.02,36.02,1,-124911,108867,233778,-16044,0,0,24483,0,0,,24483,24483
33,08/17/2017,62,15:15,15:30,35.8,,0,35.8,35.8,1,-130622,114870,245492,-15752,0,0,2757,0,0,,2757,2757
33,08/17/2017,63,15:30,15:45,48.13,,0,48.13,48.13,1,-136515,97129,233644,-39386,0,0,26946,0,0,,26946,26946
33,08/17/2017,64,15:45,16:00,32.7,,0,32.7,32.7,1,-134538,104233,238771,-30305,0,0,16861,0,0,,16861,16861
33,08/17/2017,65,16:00,16:15,32.7,28.25,0,28.25,28.25,-1,-106702,97694,204396,-9008,0,-513,950,0,0,,1463,437
33,08/17/2017,66,16:15,16:30,,28.25,0,28.25,28.25,-1,-114599,88198,202797,-26401,0,-591,0,0,0,,591,-591
33,08/17/2017,67,16:30,16:45,,29.26,0,29.26,29.26,-1,-131864,93830,225694,-38034,0,-29,0,0,0,,29,-29
33,08/17/2017,68,16:45,17:00,,,0,28.62,28.62,0,-155353,94828,250181,-60525,0,0,0,0,0,,0,0
33,08/17/2017,69,17:00,17:15,,,0,29.12,29.12,0,-132446,61768,194214,-70678,0,0,0,0,0,,0,0
33,08/17/2017,70,17:15,17:30,,,0,29.11,29.11,0,-135829,63923,199752,-71906,0,0,0,0,0,,0,0
33,08/17/2017,71,17:30,17:45,32.7,,0,32.7,32.7,1,-140829,82023,222852,-58806,0,0,743,0,0,,743,743
33,08/17/2017,72,17:45,18:00,28.7,,0,28.7,28.7,1,-135357,106572,241929,-28785,0,0,882,0,0,,882,882
33,08/17/2017,73,18:00,18:15,,,0,29.12,29.12,0,-105557,85737,191294,-19820,0,0,130,0,0,,130,130
33,08/17/2017,74,18:15,18:30,,,0,29.13,29.13,0,-86968,96219,183187,9251,0,0,0,0,0,,0,0
33,08/17/2017,75,18:30,18:45,,,0,29.15,29.15,0,-86951,98697,185648,11746,0,0,0,0,0,,0,0
33,08/17/2017,76,18:45,19:00,,,0,29.15,29.15,0,-86174,100365,186539,14191,0,0,0,0,0,,0,0
33,08/17/2017,77,19:00,19:15,,26.76,0,26.76,26.76,-1,-86348,96834,183182,10486,0,-1268,0,0,0,,1268,-1268
33,08/17/2017,78,19:15,19:30,,28.23,0,28.23,28.23,-1,-81417,106370,187787,24953,0,-1589,0,0,0,,1589,-1589
33,08/17/2017,79,19:30,19:45,,30.26,0,30.26,30.26,-1,-69995,122934,192929,52939,0,-345,0,0,0,,345,-345
33,08/17/2017,80,19:45,20:00,,,0,29.14,29.14,0,-74167,125936,200103,51769,0,0,0,0,0,,0,0
33,08/17/2017,81,20:00,20:15,,30.23,0,30.23,30.23,-1,-15850,135439,151289,119589,0,-634,0,0,0,,634,-634
33,08/17/2017,82,20:15,20:30,,21.96,0,21.96,21.96,-1,-11037,115568,126605,104531,0,-7429,0,0,0,,7429,-7429
33,08/17/2017,83,20:30,20:45,,27.03,0,27.03,27.03,-1,-7774,114349,122123,106575,0,-6989,0,0,0,,6989,-6989
33,08/17/2017,84,20:45,21:00,,26.42,0,26.42,26.42,-1,-8672,145743,154415,137071,0,-1089,0,0,0,,1089,-1089
33,08/17/2017,85,21:00,21:15,,26.42,0,26.42,26.42,-1,-26898,140207,167105,113309,0,-2557,0,0,0,,2557,-2557
33,08/17/2017,86,21:15,21:30,,27.27,0,27.27,27.27,-1,-34417,118192,152609,83775,0,-105,0,0,0,,105,-105
33,08/17/2017,87,21:30,21:45,,15.27,0,15.27,15.27,-1,-32986,112949,145935,79963,0,-2169,0,0,0,,2169,-2169
33,08/17/2017,88,21:45,22:00,,-15.11,0,-15.11,-15.11,-1,-21537,121744,143281,100207,0,-37183,0,0,0,,37183,-37183
33,08/17/2017,89,22:00,22:15,32.7,-15.11,0,32.7,32.7,1,-108109,35108,143217,-73001,0,-20813,269,0,0,,21082,-20544
33,08/17/2017,90,22:15,22:30,,,0,29.49,29.49,0,-79374,24405,103779,-54969,0,0,3,0,0,,3,3
33,08/17/2017,91,22:30,22:45,28.7,,0,28.7,28.7,1,-52418,31923,84341,-20495,0,0,120,0,0,,120,120
33,08/17/2017,92,22:45,23:00,28.7,27.03,0,27.03,27.03,-1,-48933,63397,112330,14464,0,-2664,14,0,0,,2678,-2650
33,08/17/2017,93,23:00,23:15,101.02,27.03,0,101.02,101.02,1,-133232,45940,179172,-87292,0,-1364,14568,0,0,,15932,13204
33,08/17/2017,94,23:15,23:30,33.02,,0,33.02,33.02,1,-110874,16815,127689,-94059,0,0,8118,0,0,,8118,8118
33,08/17/2017,95,23:30,23:45,,,0,28.63,28.63,0,-66281,35420,101701,-30861,0,0,0,0,0,,0,0
33,08/17/2017,96,23:45,0:00,,27.42,0,27.42,27.42,-1,-88173,82249,170422,-5924,0,-494,0,0,0,,494,-494
33,08/18/2017,1,0:00,0:15,,22.83,0,22.83,22.83,-1,-84593,158560,243153,73967,0,-1366,0,0,0,,1366,-1366
33,08/18/2017,2,0:15,0:30,,26.83,0,26.83,26.83,-1,-90336,115595,205931,25259,0,-276,0,0,0,,276,-276
33,08/18/2017,3,0:30,0:45,,22.83,0,22.83,22.83,-1,-90548,122146,212694,31598,0,-3067,0,0,0,,3067,-3067
33,08/18/2017,4,0:45,1:00,,11.16,0,11.16,11.16,-1,-85157,133960,219117,48803,0,-33811,0,0,0,,33811,-33811
33,08/18/2017,5,1:00,1:15,,8.51,0,8.51,8.51,-1,-45374,104227,149601,58853,0,-29855,0,0,0,,29855,-29855
33,08/18/2017,6,1:15,1:30,,26.78,0,26.78,26.78,-1,-50532,76745,127277,26213,0,-6287,0,0,0,,6287,-6287
33,08/18/2017,7,1:30,1:45,,4.07,0,4.07,4.07,-1,-45710,90347,136057,44637,0,-20509,0,0,0,,20509,-20509
33,08/18/2017,8,1:45,2:00,,4.07,0,4.07,4.07,-1,-61516,95339,156855,33823,0,-39774,0,0,0,,39774,-39774
33,08/18/2017,9,2:00,2:15,,26.55,0,26.55,26.55,-1,-63518,72129,135647,8611,0,-19755,0,0,0,,19755,-19755
33,08/18/2017,10,2:15,2:30,33.83,26.55,0,33.83,33.83,1,-75257,61372,136629,-13885,0,-25,113,0,0,,138,88
33,08/18/2017,11,2:30,2:45,,,0,28.66,28.66,0,-95232,62922,158154,-32310,0,0,0,0,0,,0,0
33,08/18/2017,12,2:45,3:00,,,0,28.66,28.66,0,-89156,60400,149556,-28756,0,0,0,0,0,,0,0
33,08/18/2017,13,3:00,3:15,30.69,,0,30.69,30.69,1,-68465,54936,123401,-13529,0,0,958,0,0,,958,958
33,08/18/2017,14,3:15,3:30,,,0,28.79,28.79,0,-61338,59200,120538,-2138,0,0,505,0,0,,505,505
33,08/18/2017,15,3:30,3:45,,26.78,0,26.78,26.78,-1,-44027,66369,110396,22342,0,-2605,0,0,0,,2605,-2605
33,08/18/2017,16,3:45,4:00,,26.78,0,26.78,26.78,-1,-36346,55761,92107,19415,0,-11313,0,0,0,,11313,-11313
33,08/18/2017,17,4:00,4:15,,22.83,0,22.83,22.83,-1,-45258,52360,97618,7102,0,-15807,0,0,0,,15807,-15807
33,08/18/2017,18,4:15,4:30,31.62,22.83,0,31.62,31.62,1,-59277,42305,101582,-16972,0,-3383,1007,0,0,,4390,-2376
33,08/18/2017,19,4:30,4:45,26.67,,0,26.67,26.67,1,-36194,60609,96803,24415,0,0,85,0,0,,85,85
33,08/18/2017,20,4:45,5:00,26.67,,0,26.67,26.67,1,-28116,66712,94828,38596,0,0,14,0,0,,14,14
33,08/18/2017,21,5:00,5:15,31.14,,0,31.14,31.14,1,-63731,43404,107135,-20327,0,0,1223,0,0,,1223,1223
33,08/18/2017,22,5:15,5:30,,,0,29.07,29.07,0,-34279,66714,100993,32435,0,0,0,0,0,,0,0
33,08/18/2017,23,5:30,5:45,,27.83,0,27.83,27.83,-1,-35179,50589,85768,15410,0,-178,0,0,0,,178,-178
33,08/18/2017,24,5:45,6:00,,,0,29,29,0,-29630,24677,54307,-4953,0,0,0,0,0,,0,0
33,08/18/2017,25,6:00,6:15,34.37,,0,34.37,34.37,1,-76649,46796,123445,-29853,0,0,931,0,0,,931,931
33,08/18/2017,26,6:15,6:30,30.12,,0,30.12,30.12,1,-31256,38144,69400,6888,0,0,171,0,0,,171,171
33,08/18/2017,27,6:30,6:45,31.71,,0,31.71,31.71,1,-39059,34910,73969,-4149,0,0,617,0,0,,617,617
33,08/18/2017,28,6:45,7:00,31.71,25.3,0,25.3,25.3,-1,-34945,48488,83433,13543,0,-265,6,0,0,,271,-259
33,08/18/2017,29,7:00,7:15,,-54.78,0,-54.78,-54.78,-1,-34704,91722,126426,57018,0,-33108,0,0,0,,33108,-33108
33,08/18/2017,30,7:15,7:30,,27.78,0,27.78,27.78,-1,-65249,85380,150629,20131,0,-2893,0,0,0,,2893,-2893
33,08/18/2017,31,7:30,7:45,,,0,30.55,30.55,0,-70375,80547,150922,10172,0,0,0,0,0,,0,0
33,08/18/2017,32,7:45,8:00,34.42,,0,34.42,34.42,1,-81469,78894,160363,-2575,0,0,1747,0,0,,1747,1747
33,08/18/2017,33,8:00,8:15,,,0,30.61,30.61,0,-76419,159871,236290,83452,0,0,23,0,0,,23,23
33,08/18/2017,34,8:15,8:30,,,0,30.58,30.58,0,-80189,109768,189957,29579,0,0,0,0,0,,0,0
33,08/18/2017,35,8:30,8:45,37.25,,0,37.25,37.25,1,-86986,85772,172758,-1214,0,0,1055,0,0,,1055,1055
33,08/18/2017,36,8:45,9:00,65.12,,0,65.12,65.12,1,-111829,90729,202558,-21100,0,0,20836,0,0,,20836,20836
33,08/18/2017,37,9:00,9:15,51,,0,51,51,1,-102158,78464,180622,-23694,0,0,25275,0,0,,25275,25275
33,08/18/2017,38,9:15,9:30,152.86,,0,152.86,152.86,1,-113378,70497,183875,-42881,0,0,26152,0,0,,26152,26152
33,08/18/2017,39,9:30,9:45,350.12,,0,350.12,350.12,1,-114964,75897,190861,-39067,0,0,46177,0,0,,46177,46177
33,08/18/2017,40,9:45,10:00,32.25,31.03,0,32.25,30.73,2,-96464,100864,197328,4400,0,-21,5528,0,0,,5549,5507
33,08/18/2017,41,10:00,10:15,32.67,,0,32.67,32.67,1,-101614,100691,202305,-923,0,0,1121,0,0,,1121,1121
33,08/18/2017,42,10:15,10:30,49.01,,0,49.01,49.01,1,-116370,88292,204662,-28078,0,0,2193,0,0,,2193,2193
33,08/18/2017,43,10:30,10:45,350.12,,0,350.12,350.12,1,-118013,93334,211347,-24679,0,0,27105,0,0,,27105,27105
33,08/18/2017,44,10:45,11:00,350.12,28.14,0,28.14,28.14,-1,-94519,134584,229103,40065,0,-604,4055,0,0,,4659,3451
33,08/18/2017,45,11:00,11:15,,30.97,0,30.97,30.97,-1,-116909,66806,183715,-50103,0,-60,0,0,0,,60,-60
33,08/18/2017,46,11:15,11:30,31.71,,0,31.71,31.71,1,-113466,60541,174007,-52925,0,0,774,0,0,,774,774
33,08/18/2017,47,11:30,11:45,350.12,,0,350.12,350.12,1,-110408,61250,171658,-49158,0,0,19637,0,0,,19637,19637
33,08/18/2017,48,11:45,12:00,50.2,,0,50.2,50.2,1,-98546,95836,194382,-2710,0,0,19070,0,0,,19070,19070
33,08/18/2017,49,12:00,12:15,267.12,,0,267.12,267.12,1,-156116,103200,259316,-52916,0,0,20264,0,0,,20264,20264
33,08/18/2017,50,12:15,12:30,32.75,,0,32.75,32.75,1,-156643,130290,286933,-26353,0,0,8452,0,0,,8452,8452
33,08/18/2017,51,12:30,12:45,67.12,,0,67.12,67.12,1,-149848,113654,263502,-36194,0,0,8491,0,0,,8491,8491
33,08/18/2017,52,12:45,13:00,32.34,,0,32.34,32.34,1,-131039,124575,255614,-6464,0,0,3213,0,0,,3213,3213
33,08/18/2017,53,13:00,13:15,278.12,,0,278.12,278.12,1,-119897,72345,192242,-47552,0,0,24360,0,0,,24360,24360
33,08/18/2017,54,13:15,13:30,57.12,,0,57.12,57.12,1,-118096,87929,206025,-30167,0,0,35590,0,0,,35590,35590
33,08/18/2017,55,13:30,13:45,57.12,,0,57.12,57.12,1,-119697,83935,203632,-35762,0,0,30580,0,0,,30580,30580
33,08/18/2017,56,13:45,14:00,31.41,,0,31.41,31.41,1,-117676,76725,194401,-40951,0,0,8362,0,0,,8362,8362
33,08/18/2017,57,14:00,14:15,31.41,,0,31.41,31.41,1,-100791,103963,204754,3172,0,0,219,0,0,,219,219
33,08/18/2017,58,14:15,14:30,42.12,,0,42.12,42.12,1,-125644,91508,217152,-34136,0,0,7082,0,0,,7082,7082
33,08/18/2017,59,14:30,14:45,31.61,,0,31.61,31.61,1,-120195,102135,222330,-18060,0,0,3826,0,0,,3826,3826
33,08/18/2017,60,14:45,15:00,29.67,,0,29.67,29.67,1,-132788,93159,225947,-39629,0,0,644,0,0,,644,644
33,08/18/2017,61,15:00,15:15,29.67,,0,29.67,29.67,1,-164024,120590,284614,-43434,0,0,137,0,0,,137,137
33,08/18/2017,62,15:15,15:30,29.67,,0,29.67,29.67,1,-151202,112607,263809,-38595,0,0,244,0,0,,244,244
33,08/18/2017,63,15:30,15:45,,,0,27.84,27.84,0,-150458,110511,260969,-39947,0,0,0,0,0,,0,0
33,08/18/2017,64,15:45,16:00,,,0,27.84,27.84,0,-150891,116096,266987,-34795,0,0,0,0,0,,0,0
33,08/18/2017,65,16:00,16:15,32.28,,0,32.28,32.28,1,-111720,69247,180967,-42473,0,0,330,0,0,,330,330
33,08/18/2017,66,16:15,16:30,29.67,,0,29.67,29.67,1,-99551,71015,170566,-28536,0,0,285,0,0,,285,285
33,08/18/2017,67,16:30,16:45,,,0,27.79,27.79,0,-98219,80664,178883,-17555,0,0,0,0,0,,0,0
33,08/18/2017,68,16:45,17:00,29.67,,0,29.67,29.67,1,-103749,91320,195069,-12429,0,0,71,0,0,,71,71
33,08/18/2017,69,17:00,17:15,350.12,,0,350.12,350.12,1,-112104,27703,139807,-84401,0,0,16859,0,0,,16859,16859
33,08/18/2017,70,17:15,17:30,278.12,,0,278.12,278.12,1,-87502,56637,144139,-30865,0,0,38376,0,0,,38376,38376
33,08/18/2017,71,17:30,17:45,29.67,31.06,0,30.37,30.37,2,-80491,78385,158876,-2106,0,-86,2531,0,0,,2617,2445
33,08/18/2017,72,17:45,18:00,41.71,,0,41.71,41.71,1,-99597,60144,159741,-39453,0,0,5518,0,0,,5518,5518
33,08/18/2017,73,18:00,18:15,43.43,,0,43.43,43.43,1,-127697,53396,181093,-74301,0,0,8479,0,0,,8479,8479
33,08/18/2017,74,18:15,18:30,117.47,,0,117.47,117.47,1,-98552,59412,157964,-39140,0,0,6049,0,0,,6049,6049
33,08/18/2017,75,18:30,18:45,132.74,,0,132.74,132.74,1,-85052,83944,168996,-1108,0,0,17121,0,0,,17121,17121
33,08/18/2017,76,18:45,19:00,,,0,30.36,30.36,0,-84314,99333,183647,15019,0,0,1258,0,0,,1258,1258
33,08/18/2017,77,19:00,19:15,,,0,30.36,30.36,0,-60489,107381,167870,46892,0,0,0,0,0,,0,0
33,08/18/2017,78,19:15,19:30,34.58,,0,34.58,34.58,1,-85674,60541,146215,-25133,0,0,1195,0,0,,1195,1195
33,08/18/2017,79,19:30,19:45,34.27,,0,34.27,34.27,1,-108765,61269,170034,-47496,0,0,3257,0,0,,3257,3257
33,08/18/2017,80,19:45,20:00,29.67,,0,29.67,29.67,1,-105740,66594,172334,-39146,0,0,1864,0,0,,1864,1864
33,08/18/2017,81,20:00,20:15,29.67,30.66,0,30.66,30.66,-1,-37572,89574,127146,52002,0,-93,342,0,0,,435,249
33,08/18/2017,82,20:15,20:30,,30.89,0,30.89,30.89,-1,-31470,98770,130240,67300,0,-1104,0,0,0,,1104,-1104
33,08/18/2017,83,20:30,20:45,,15.3,0,15.3,15.3,-1,-28407,97261,125668,68854,0,-8375,0,0,0,,8375,-8375
33,08/18/2017,84,20:45,21:00,,28.42,0,28.42,28.42,-1,-37483,70150,107633,32667,0,-2481,0,0,0,,2481,-2481
33,08/18/2017,85,21:00,21:15,55.12,28.57,0,55.12,55.12,1,-58832,37810,96642,-21022,0,-1756,1498,0,0,,3254,-258
33,08/18/2017,86,21:15,21:30,239.12,28.57,0,239.12,239.12,1,-111600,45951,157551,-65649,0,-12,30323,0,0,,30335,30311
33,08/18/2017,87,21:30,21:45,29.67,23.42,0,30.39,23.42,2,-74586,81133,155719,6547,0,-4138,4468,0,0,,8606,330
33,08/18/2017,88,21:45,22:00,,-22.88,0,-22.88,-22.88,-1,-73280,107390,180670,34110,0,-14624,0,0,0,,14624,-14624
33,08/18/2017,89,22:00,22:15,40.95,-20.78,0,40.95,40.95,1,-101423,26171,127594,-75252,0,-25728,479,0,0,,26207,-25249
33,08/18/2017,90,22:15,22:30,44.31,-20.78,0,44.31,44.31,1,-128426,15693,144119,-112733,0,-145,2836,0,0,,2981,2691
33,08/18/2017,91,22:30,22:45,39.9,,0,39.9,39.9,1,-105573,64840,170413,-40733,0,0,2408,0,0,,2408,2408
33,08/18/2017,92,22:45,23:00,39.9,1.78,0,1.78,1.78,-1,-95796,115008,210804,19212,0,-8889,85,0,0,,8974,-8804
33,08/18/2017,93,23:00,23:15,46.21,27.42,0,46.21,46.21,1,-129896,103894,233790,-26002,0,-4231,2287,0,0,,6518,-1944
33,08/18/2017,94,23:15,23:30,105.12,,0,105.12,105.12,1,-153711,88508,242219,-65203,0,0,43295,0,0,,43295,43295
33,08/18/2017,95,23:30,23:45,44.36,,0,44.36,44.36,1,-112414,88967,201381,-23447,0,0,22140,0,0,,22140,22140
33,08/18/2017,96,23:45,0:00,73.39,,0,73.39,73.39,1,-126349,78916,205265,-47433,0,0,3493,0,0,,3493,3493
34,08/19/2017,1,0:00,0:15,31.62,30.88,0,31.62,28.28,2,-61014,66221,127235,5207,0,-124,1376,0,0,,1500,1252
34,08/19/2017,2,0:15,0:30,40.32,,0,40.32,40.32,1,-75777,39049,114826,-36728,0,0,8355,0,0,,8355,8355
34,08/19/2017,3,0:30,0:45,,,0,28.33,28.33,0,-82363,41630,123993,-40733,0,0,737,0,0,,737,737
34,08/19/2017,4,0:45,1:00,,30.65,0,30.65,30.65,-1,-78488,76915,155403,-1573,0,-142,0,0,0,,142,-142
34,08/19/2017,5,1:00,1:15,34.32,27.32,0,34.32,27.32,2,-76205,56602,132807,-19603,0,-607,930,0,0,,1537,323
34,08/19/2017,6,1:15,1:30,34.32,27.32,0,34.32,27.32,2,-60942,63655,124597,2713,0,-392,993,0,0,,1385,601
34,08/19/2017,7,1:30,1:45,,27.03,0,27.03,27.03,-1,-38248,65306,103554,27058,0,-943,0,0,0,,943,-943
34,08/19/2017,8,1:45,2:00,,-9.27,0,-9.27,-9.27,-1,-40557,68864,109421,28307,0,-22439,0,0,0,,22439,-22439
34,08/19/2017,9,2:00,2:15,26.03,23.11,0,26.03,26.03,1,-78290,63624,141914,-14666,0,-14137,32,0,0,,14169,-14105
34,08/19/2017,10,2:15,2:30,30.32,23.11,0,30.32,30.32,1,-89675,46214,135889,-43461,0,-464,1255,0,0,,1719,791
34,08/19/2017,11,2:30,2:45,18.46,,0,18.46,18.46,1,-83802,53457,137259,-30345,0,0,920,0,0,,920,920
34,08/19/2017,12,2:45,3:00,,,0,24.66,24.66,0,-69483,51030,120513,-18453,0,0,0,0,0,,0,0
34,08/19/2017,13,3:00,3:15,135.02,,0,135.02,135.02,1,-142004,37879,179883,-104125,0,0,31931,0,0,,31931,31931
34,08/19/2017,14,3:15,3:30,135.02,,0,135.02,135.02,1,-109629,60320,169949,-49309,0,0,67561,0,0,,67561,67561
34,08/19/2017,15,3:30,3:45,30.32,-37.03,0,30.32,-37.03,2,-88971,98573,187544,9602,0,-5653,8951,0,0,,14604,3298
34,08/19/2017,16,3:45,4:00,40.32,-37.03,0,40.32,40.32,1,-83001,63385,146386,-19616,0,-328,9523,0,0,,9851,9195
34,08/19/2017,17,4:00,4:15,35.36,30.39,0,30.39,30.39,-1,-67998,62218,130216,-5780,0,-33,6873,0,0,,6906,6840
34,08/19/2017,18,4:15,4:30,35.36,25.8,0,25.8,25.8,-1,-59556,74144,133700,14588,0,-2178,33,0,0,,2211,-2145
34,08/19/2017,19,4:30,4:45,,29.03,0,29.03,29.03,-1,-41995,64471,106466,22476,0,-2794,0,0,0,,2794,-2794
34,08/19/2017,20,4:45,5:00,,30.88,0,30.88,30.88,-1,-53956,69479,123435,15523,0,-964,0,0,0,,964,-964
34,08/19/2017,21,5:00,5:15,34.32,30.89,0,34.32,24.58,2,-73147,59243,132390,-13904,0,-15,5000,0,0,,5015,4985
34,08/19/2017,22,5:15,5:30,32.04,,0,32.04,32.04,1,-88421,69544,157965,-18877,0,0,6668,0,0,,6668,6668
34,08/19/2017,23,5:30,5:45,34.32,,0,34.32,34.32,1,-100168,75190,175358,-24978,0,0,10866,0,0,,10866,10866
34,08/19/2017,24,5:45,6:00,111.02,,0,111.02,111.02,1,-105022,54623,159645,-50399,0,0,23023,0,0,,23023,23023
34,08/19/2017,25,6:00,6:15,111.02,,0,111.02,111.02,1,-115805,65259,181064,-50546,0,0,40904,0,0,,40904,40904
34,08/19/2017,26,6:15,6:30,120.02,29.23,0,120.02,24.59,2,-76756,78142,154898,1386,0,-24,38340,0,0,,38364,38316
34,08/19/2017,27,6:30,6:45,120.02,22.03,0,22.03,22.03,-1,-69915,84095,154010,14180,0,-683,1877,0,0,,2560,1194
34,08/19/2017,28,6:45,7:00,40.41,,0,40.41,40.41,1,-76354,53554,129908,-22800,0,0,4926,0,0,,4926,4926
34,08/19/2017,29,7:00,7:15,40.41,15.93,0,15.93,15.93,-1,-62081,95610,157691,33529,0,-3603,984,0,0,,4587,-2619
34,08/19/2017,30,7:15,7:30,30.41,30.89,0,30.41,24.59,2,-81326,64946,146272,-16380,0,-545,368,0,0,,913,-177
34,08/19/2017,31,7:30,7:45,130.02,,0,130.02,130.02,1,-115153,62845,177998,-52308,0,0,14403,0,0,,14403,14403
34,08/19/2017,32,7:45,8:00,47.02,,0,47.02,47.02,1,-107384,73250,180634,-34134,0,0,33120,0,0,,33120,33120
34,08/19/2017,33,8:00,8:15,32.88,12.36,0,32.88,12.36,2,-103551,87794,191345,-15757,0,-2607,5058,0,0,,7665,2451
34,08/19/2017,34,8:15,8:30,51.02,,0,51.02,51.02,1,-102036,73632,175668,-28404,0,0,10557,0,0,,10557,10557
34,08/19/2017,35,8:30,8:45,31.32,,0,31.32,31.32,1,-98156,89410,187566,-8746,0,0,5514,0,0,,5514,5514
34,08/19/2017,36,8:45,9:00,25.3,,0,25.3,25.3,1,-117162,124405,241567,7243,0,0,185,0,0,,185,185
34,08/19/2017,37,9:00,9:15,103.02,,0,103.02,103.02,1,-86778,77612,164390,-9166,0,0,10384,0,0,,10384,10384
34,08/19/2017,38,9:15,9:30,,,0,27.99,27.99,0,-80547,101576,182123,21029,0,0,989,0,0,,989,989
34,08/19/2017,39,9:30,9:45,,,0,27.99,27.99,0,-89195,103842,193037,14647,0,0,0,0,0,,0,0
34,08/19/2017,40,9:45,10:00,,,0,27.99,27.99,0,-88525,105697,194222,17172,0,0,0,0,0,,0,0
34,08/19/2017,41,10:00,10:15,,16.41,0,16.41,16.41,-1,-73911,157984,231895,84073,0,-1424,0,0,0,,1424,-1424
34,08/19/2017,42,10:15,10:30,,-30.03,0,-30.03,-30.03,-1,-76433,156061,232494,79628,0,-26736,0,0,0,,26736,-26736
34,08/19/2017,43,10:30,10:45,,4.03,0,4.03,4.03,-1,-81924,169064,250988,87140,0,-30563,0,0,0,,30563,-30563
34,08/19/2017,44,10:45,11:00,,-73.07,0,-73.07,-73.07,-1,-56752,177388,234140,120636,0,-50467,0,0,0,,50467,-50467
34,08/19/2017,45,11:00,11:15,120.02,8.03,0,120.02,120.02,1,-83293,62534,145827,-20759,0,-27718,2067,0,0,,29785,-25651
34,08/19/2017,46,11:15,11:30,24.38,-50.03,0,-50.03,-50.03,-1,-50748,113978,164726,63230,0,-11068,989,0,0,,12057,-10079
34,08/19/2017,47,11:30,11:45,,16.41,0,16.41,16.41,-1,-61191,122596,183787,61405,0,-24464,0,0,0,,24464,-24464
34,08/19/2017,48,11:45,12:00,,22.96,0,22.96,22.96,-1,-56104,114473,170577,58369,0,-21980,0,0,0,,21980,-21980
34,08/19/2017,49,12:00,12:15,206.02,24.41,0,206.02,24.41,2,-83183,27975,111158,-55208,0,-11173,10572,0,0,,21745,-601
34,08/19/2017,50,12:15,12:30,37.41,,0,37.41,37.41,1,-39094,40360,79454,1266,0,0,6150,0,0,,6150,6150
34,08/19/2017,51,12:30,12:45,32.05,30.28,0,32.05,27.52,2,-39423,57474,96897,18051,0,-115,2121,0,0,,2236,2006
34,08/19/2017,52,12:45,13:00,32.05,24.41,0,24.41,24.41,-1,-39021,74477,113498,35456,0,-4965,29,0,0,,4994,-4936
34,08/19/2017,53,13:00,13:15,,14.61,0,14.61,14.61,-1,-58623,92816,151439,34193,0,-9606,0,0,0,,9606,-9606
34,08/19/2017,54,13:15,13:30,,28.41,0,28.41,28.41,-1,-60821,71938,132759,11117,0,-1508,0,0,0,,1508,-1508
34,08/19/2017,55,13:30,13:45,,,0,27.35,27.35,0,-63914,76741,140655,12827,0,0,0,0,0,,0,0
34,08/19/2017,56,13:45,14:00,,,0,27.35,27.35,0,-64030,80823,144853,16793,0,0,0,0,0,,0,0
34,08/19/2017,57,14:00,14:15,,16.41,0,16.41,16.41,-1,-50716,51577,102293,861,0,-939,0,0,0,,939,-939
34,08/19/2017,58,14:15,14:30,,16.41,0,16.41,16.41,-1,-50923,56375,107298,5452,0,-4260,0,0,0,,4260,-4260
34,08/19/2017,59,14:30,14:45,,21.23,0,21.23,21.23,-1,-49864,76417,126281,26553,0,-5526,0,0,0,,5526,-5526
34,08/19/2017,60,14:45,15:00,,16.41,0,16.41,16.41,-1,-47943,60875,108818,12932,0,-18359,0,0,0,,18359,-18359
34,08/19/2017,61,15:00,15:15,,-50.03,0,-50.03,-50.03,-1,-49675,59964,109639,10289,0,-21832,0,0,0,,21832,-21832
34,08/19/2017,62,15:15,15:30,,-74.23,0,-74.23,-74.23,-1,-42476,82863,125339,40387,0,-16410,0,0,0,,16410,-16410
34,08/19/2017,63,15:30,15:45,,-15.26,0,-15.26,-15.26,-1,-48532,90619,139151,42087,0,-10495,0,0,0,,10495,-10495
34,08/19/2017,64,15:45,16:00,,16.41,0,16.41,16.41,-1,-68656,81034,149690,12378,0,-14298,0,0,0,,14298,-14298
34,08/19/2017,65,16:00,16:15,,4.03,0,4.03,4.03,-1,-27857,130908,158765,103051,0,-20871,0,0,0,,20871,-20871
34,08/19/2017,66,16:15,16:30,,16.41,0,16.41,16.41,-1,-18994,111726,130720,92732,0,-15389,0,0,0,,15389,-15389
34,08/19/2017,67,16:30,16:45,,15.55,0,15.55,15.55,-1,-19127,99995,119122,80868,0,-14335,0,0,0,,14335,-14335
34,08/19/2017,68,16:45,17:00,,24.41,0,24.41,24.41,-1,-24258,93787,118045,69529,0,-2257,0,0,0,,2257,-2257
34,08/19/2017,69,17:00,17:15,,-30.03,0,-30.03,-30.03,-1,-42372,79649,122021,37277,0,-16555,0,0,0,,16555,-16555
34,08/19/2017,70,17:15,17:30,34.33,-30.03,0,34.33,34.33,1,-46775,55231,102006,8456,0,-543,719,0,0,,1262,176
34,08/19/2017,71,17:30,17:45,44.12,,0,44.12,44.12,1,-46505,40680,87185,-5825,0,0,8870,0,0,,8870,8870
34,08/19/2017,72,17:45,18:00,32.04,,0,32.04,32.04,1,-54700,39261,93961,-15439,0,0,9393,0,0,,9393,9393
34,08/19/2017,73,18:00,18:15,32.04,30.6,0,30.6,30.6,-1,-19215,77174,96389,57959,0,-102,2722,0,0,,2824,2620
34,08/19/2017,74,18:15,18:30,,30.59,0,30.59,30.59,-1,-15838,46056,61894,30218,0,-917,0,0,0,,917,-917
34,08/19/2017,75,18:30,18:45,,,0,27.03,27.03,0,-21442,55966,77408,34524,0,-21,0,0,0,,21,-21
34,08/19/2017,76,18:45,19:00,,30.95,0,30.95,30.95,-1,-23417,70856,94273,47439,0,-380,0,0,0,,380,-380
34,08/19/2017,77,19:00,19:15,,15.71,0,15.71,15.71,-1,-23691,86117,109808,62426,0,-11532,0,0,0,,11532,-11532
34,08/19/2017,78,19:15,19:30,,16.41,0,16.41,16.41,-1,-20195,45036,65231,24841,0,-19321,0,0,0,,19321,-19321
34,08/19/2017,79,19:30,19:45,,,0,27.14,27.14,0,-33593,49154,82747,15561,0,-4136,0,0,0,,4136,-4136
34,08/19/2017,80,19:45,20:00,44.13,,0,44.13,44.13,1,-51504,36007,87511,-15497,0,0,2426,0,0,,2426,2426
34,08/19/2017,81,20:00,20:15,30.41,16.38,0,16.38,16.38,-1,-41443,96065,137508,54622,0,-2291,1149,0,0,,3440,-1142
34,08/19/2017,82,20:15,20:30,,16.41,0,16.41,16.41,-1,-27081,82684,109765,55603,0,-16859,0,0,0,,16859,-16859
34,08/19/2017,83,20:30,20:45,,30.72,0,30.72,30.72,-1,-22401,61683,84084,39282,0,-5423,0,0,0,,5423,-5423
34,08/19/2017,84,20:45,21:00,,24.41,0,24.41,24.41,-1,-27070,63554,90624,36484,0,-3182,0,0,0,,3182,-3182
34,08/19/2017,85,21:00,21:15,,24.41,0,24.41,24.41,-1,-41692,67858,109550,26166,0,-3883,0,0,0,,3883,-3883
34,08/19/2017,86,21:15,21:30,37.41,,0,37.41,37.41,1,-34792,53845,88637,19053,0,0,1876,0,0,,1876,1876
34,08/19/2017,87,21:30,21:45,,,0,27.37,27.37,0,-11035,85174,96209,74139,0,0,0,0,0,,0,0
34,08/19/2017,88,21:45,22:00,,,0,27.38,27.38,0,-13376,61110,74486,47734,0,0,0,0,0,,0,0
34,08/19/2017,89,22:00,22:15,63.68,28.41,0,63.68,28.41,2,-68056,26618,94674,-41438,0,-222,4898,0,0,,5120,4676
34,08/19/2017,90,22:15,22:30,34.28,16.86,0,34.28,16.86,2,-32175,41601,73776,9426,0,-2061,5175,0,0,,7236,3114
34,08/19/2017,91,22:30,22:45,,16.41,0,16.41,16.41,-1,-12276,42527,54803,30251,0,-4772,0,0,0,,4772,-4772
34,08/19/2017,92,22:45,23:00,,-10.03,0,-10.03,-10.03,-1,-9419,68534,77953,59115,0,-10032,0,0,0,,10032,-10032
34,08/19/2017,93,23:00,23:15,,-38.03,0,-38.03,-38.03,-1,-41768,55883,97651,14115,0,-21774,0,0,0,,21774,-21774
34,08/19/2017,94,23:15,23:30,,12.8,0,12.8,12.8,-1,-28169,40922,69091,12753,0,-24804,0,0,0,,24804,-24804
34,08/19/2017,95,23:30,23:45,,23.03,0,23.03,23.03,-1,-21376,49456,70832,28080,0,-23029,0,0,0,,23029,-23029
34,08/19/2017,96,23:45,0:00,,-10.03,0,-10.03,-10.03,-1,-21446,54858,76304,33412,0,-33606,0,0,0,,33606,-33606
34,08/20/2017,1,0:00,0:15,,-150.78,0,-150.78,-150.78,-1,-59387,95704,155091,36317,0,-32401,0,0,0,,32401,-32401
34,08/20/2017,2,0:15,0:30,,27.28,0,27.28,27.28,-1,-43395,42865,86260,-530,0,-3848,0,0,0,,3848,-3848
34,08/20/2017,3,0:30,0:45,,-16.78,0,-16.78,-16.78,-1,-25610,44480,70090,18870,0,-18743,0,0,0,,18743,-18743
34,08/20/2017,4,0:45,1:00,,27.78,0,27.78,27.78,-1,-37408,46655,84063,9247,0,-8845,0,0,0,,8845,-8845
34,08/20/2017,5,1:00,1:15,,22.66,0,22.66,22.66,-1,-51311,39076,90387,-12235,0,-4333,0,0,0,,4333,-4333
34,08/20/2017,6,1:15,1:30,30.28,22.66,0,30.28,30.28,1,-68372,28536,96908,-39836,0,-154,862,0,0,,1016,708
34,08/20/2017,7,1:30,1:45,30.28,23.23,0,30.28,23.23,2,-46790,43150,89940,-3640,0,-320,1701,0,0,,2021,1381
34,08/20/2017,8,1:45,2:00,,-2.76,0,-2.76,-2.76,-1,-27430,55593,83023,28163,0,-20725,0,0,0,,20725,-20725
34,08/20/2017,9,2:00,2:15,31.79,21.95,0,31.79,31.79,1,-57632,37876,95508,-19756,0,-14055,518,0,0,,14573,-13537
34,08/20/2017,10,2:15,2:30,,,0,27.95,27.95,0,-44544,30817,75361,-13727,0,-34,65,0,0,,99,31
34,08/20/2017,11,2:30,2:45,,,0,27.94,27.94,0,-50852,33863,84715,-16989,0,0,0,0,0,,0,0
34,08/20/2017,12,2:45,3:00,,,0,27.9,27.9,0,-47549,34732,82281,-12817,0,0,0,0,0,,0,0
34,08/20/2017,13,3:00,3:15,32.04,,0,32.04,32.04,1,-40642,24243,64885,-16399,0,0,630,0,0,,630,630
34,08/20/2017,14,3:15,3:30,24.89,30.28,0,30.28,30.28,-1,-34590,35706,70296,1116,0,-62,172,0,0,,234,110
34,08/20/2017,15,3:30,3:45,,24.08,0,24.08,24.08,-1,-25549,42725,68274,17176,0,-6545,0,0,0,,6545,-6545
34,08/20/2017,16,3:45,4:00,,27.78,0,27.78,27.78,-1,-20896,48828,69724,27932,0,-8020,0,0,0,,8020,-8020
34,08/20/2017,17,4:00,4:15,,,0,27.89,27.89,0,-22391,49682,72073,27291,0,-743,0,0,0,,743,-743
34,08/20/2017,18,4:15,4:30,,,0,27.89,27.89,0,-26757,49434,76191,22677,0,0,0,0,0,,0,0
34,08/20/2017,19,4:30,4:45,,,0,27.94,27.94,0,-26313,55481,81794,29168,0,0,0,0,0,,0,0
34,08/20/2017,20,4:45,5:00,,,0,27.94,27.94,0,-26768,69708,96476,42940,0,0,0,0,0,,0,0
34,08/20/2017,21,5:00,5:15,,30.88,0,30.88,30.88,-1,-25353,55451,80804,30098,0,-535,0,0,0,,535,-535
34,08/20/2017,22,5:15,5:30,,30.28,0,30.28,30.28,-1,-29106,60663,89769,31557,0,-1580,0,0,0,,1580,-1580
34,08/20/2017,23,5:30,5:45,,,0,27.89,27.89,0,-35606,41608,77214,6002,0,-335,0,0,0,,335,-335
34,08/20/2017,24,5:45,6:00,,,0,27.89,27.89,0,-37642,47844,85486,10202,0,0,0,0,0,,0,0
34,08/20/2017,25,6:00,6:15,,,0,27.89,27.89,0,-43607,66724,110331,23117,0,0,0,0,0,,0,0
34,08/20/2017,26,6:15,6:30,,19.82,0,19.82,19.82,-1,-17339,73800,91139,56461,0,-7953,0,0,0,,7953,-7953
34,08/20/2017,27,6:30,6:45,,21.63,0,21.63,21.63,-1,-25593,71791,97384,46198,0,-10409,0,0,0,,10409,-10409
34,08/20/2017,28,6:45,7:00,,-3.78,0,-3.78,-3.78,-1,-33281,71364,104645,38083,0,-26619,0,0,0,,26619,-26619
34,08/20/2017,29,7:00,7:15,,28.28,0,28.28,28.28,-1,-28169,38774,66943,10605,0,-8801,0,0,0,,8801,-8801
34,08/20/2017,30,7:15,7:30,,16.78,0,16.78,16.78,-1,-25913,54034,79947,28121,0,-8541,0,0,0,,8541,-8541
34,08/20/2017,31,7:30,7:45,,26.78,0,26.78,26.78,-1,-25291,44032,69323,18741,0,-14123,0,0,0,,14123,-14123
34,08/20/2017,32,7:45,8:00,,28.28,0,28.28,28.28,-1,-34581,45079,79660,10498,0,-6868,0,0,0,,6868,-6868
34,08/20/2017,33,8:00,8:15,,,0,27.95,27.95,0,-32132,72382,104514,40250,0,-18,0,0,0,,18,-18
34,08/20/2017,34,8:15,8:30,,23.28,0,23.28,23.28,-1,-27781,68693,96474,40912,0,-4642,0,0,0,,4642,-4642
34,08/20/2017,35,8:30,8:45,,27.28,0,27.28,27.28,-1,-33052,59277,92329,26225,0,-2065,0,0,0,,2065,-2065
34,08/20/2017,36,8:45,9:00,,27.28,0,27.28,27.28,-1,-46186,59768,105954,13582,0,-3474,0,0,0,,3474,-3474
34,08/20/2017,37,9:00,9:15,,23.28,0,23.28,23.28,-1,-45801,76252,122053,30451,0,-3138,0,0,0,,3138,-3138
34,08/20/2017,38,9:15,9:30,,30.88,0,30.88,30.88,-1,-83627,61974,145601,-21653,0,-1388,0,0,0,,1388,-1388
34,08/20/2017,39,9:30,9:45,,,0,29.5,29.5,0,-72015,68903,140918,-3112,0,0,0,0,0,,0,0
34,08/20/2017,40,9:45,10:00,,23.28,0,23.28,23.28,-1,-58242,87289,145531,29047,0,-945,0,0,0,,945,-945
34,08/20/2017,41,10:00,10:15,,23.28,0,23.28,23.28,-1,-72506,78902,151408,6396,0,-1903,0,0,0,,1903,-1903
34,08/20/2017,42,10:15,10:30,,13.78,0,13.78,13.78,-1,-55505,82321,137826,26816,0,-3214,0,0,0,,3214,-3214
34,08/20/2017,43,10:30,10:45,,-15.78,0,-15.78,-15.78,-1,-39213,64028,103241,24815,0,-22967,0,0,0,,22967,-22967
34,08/20/2017,44,10:45,11:00,,23.28,0,23.28,23.28,-1,-24762,87467,112229,62705,0,-9481,0,0,0,,9481,-9481
34,08/20/2017,45,11:00,11:15,,22.04,0,22.04,22.04,-1,-39118,70443,109561,31325,0,-8360,0,0,0,,8360,-8360
34,08/20/2017,46,11:15,11:30,,-9.44,0,-9.44,-9.44,-1,-39672,75244,114916,35572,0,-27193,0,0,0,,27193,-27193
34,08/20/2017,47,11:30,11:45,,21.83,0,21.83,21.83,-1,-44402,106687,151089,62285,0,-22695,0,0,0,,22695,-22695
34,08/20/2017,48,11:45,12:00,,5.18,0,5.18,5.18,-1,-44217,81651,125868,37434,0,-27042,0,0,0,,27042,-27042
34,08/20/2017,49,12:00,12:15,,,0,29.04,29.04,0,-50048,67884,117932,17836,0,-5199,0,0,0,,5199,-5199
34,08/20/2017,50,12:15,12:30,127.12,,0,127.12,127.12,1,-65776,42683,108459,-23093,0,0,2807,0,0,,2807,2807
34,08/20/2017,51,12:30,12:45,242.12,30.61,0,242.12,29.04,2,-51206,61641,112847,10435,0,-36,24135,0,0,,24171,24099
34,08/20/2017,52,12:45,13:00,242.12,27.28,0,27.28,27.28,-1,-24736,109549,134285,84813,0,-829,21,0,0,,850,-808
34,08/20/2017,53,13:00,13:15,,27.28,0,27.28,27.28,-1,-29653,87679,117332,58026,0,-2573,0,0,0,,2573,-2573
34,08/20/2017,54,13:15,13:30,,-73.36,0,-73.36,-73.36,-1,-41325,108442,149767,67117,0,-24496,0,0,0,,24496,-24496
34,08/20/2017,55,13:30,13:45,,0.06,0,0.06,0.06,-1,-38120,127479,165599,89359,0,-20919,0,0,0,,20919,-20919
34,08/20/2017,56,13:45,14:00,,-5.78,0,-5.78,-5.78,-1,-46044,95698,141742,49654,0,-25716,0,0,0,,25716,-25716
34,08/20/2017,57,14:00,14:15,,-73.42,0,-73.42,-73.42,-1,-38022,98132,136154,60110,0,-39968,0,0,0,,39968,-39968
34,08/20/2017,58,14:15,14:30,,-73.42,0,-73.42,-73.42,-1,-37994,103984,141978,65990,0,-32800,0,0,0,,32800,-32800
34,08/20/2017,59,14:30,14:45,,-73.42,0,-73.42,-73.42,-1,-35508,89451,124959,53943,0,-40280,0,0,0,,40280,-40280
34,08/20/2017,60,14:45,15:00,,1.53,0,1.53,1.53,-1,-45862,88828,134690,42966,0,-39165,0,0,0,,39165,-39165
34,08/20/2017,61,15:00,15:15,,26.78,0,26.78,26.78,-1,-36906,69476,106382,32570,0,-16101,0,0,0,,16101,-16101
34,08/20/2017,62,15:15,15:30,,,0,29.57,29.57,0,-28745,101729,130474,72984,0,0,0,0,0,,0,0
34,08/20/2017,63,15:30,15:45,,,0,29.56,29.56,0,-33509,102465,135974,68956,0,0,0,0,0,,0,0
34,08/20/2017,64,15:45,16:00,,23.28,0,23.28,23.28,-1,-28045,112554,140599,84509,0,-839,0,0,0,,839,-839
34,08/20/2017,65,16:00,16:15,,-19.78,0,-19.78,-19.78,-1,-41777,136277,178054,94500,0,-19378,0,0,0,,19378,-19378
34,08/20/2017,66,16:15,16:30,,-49.78,0,-49.78,-49.78,-1,-44200,132739,176939,88539,0,-13360,0,0,0,,13360,-13360
34,08/20/2017,67,16:30,16:45,,18.78,0,18.78,18.78,-1,-57550,107371,164921,49821,0,-23581,0,0,0,,23581,-23581
34,08/20/2017,68,16:45,17:00,,26.78,0,26.78,26.78,-1,-63401,100669,164070,37268,0,-8962,0,0,0,,8962,-8962
34,08/20/2017,69,17:00,17:15,,-42.78,0,-42.78,-42.78,-1,-42884,160502,203386,117618,0,-19087,0,0,0,,19087,-19087
34,08/20/2017,70,17:15,17:30,,23.7,0,23.7,23.7,-1,-46854,124608,171462,77754,0,-9258,0,0,0,,9258,-9258
34,08/20/2017,71,17:30,17:45,,,0,29.54,29.54,0,-62995,85537,148532,22542,0,-716,0,0,0,,716,-716
34,08/20/2017,72,17:45,18:00,58.28,,0,58.28,58.28,1,-74521,52983,127504,-21538,0,0,4308,0,0,,4308,4308
34,08/20/2017,73,18:00,18:15,31.88,23.95,0,31.88,23.95,2,-45304,119204,164508,73900,0,-1278,1679,0,0,,2957,401
34,08/20/2017,74,18:15,18:30,,24.28,0,24.28,24.28,-1,-41800,100295,142095,58495,0,-527,0,0,0,,527,-527
34,08/20/2017,75,18:30,18:45,,,0,29.54,29.54,0,-42097,86413,128510,44316,0,0,0,0,0,,0,0
34,08/20/2017,76,18:45,19:00,,30.95,0,30.95,30.95,-1,-58134,81073,139207,22939,0,-9,0,0,0,,9,-9
34,08/20/2017,77,19:00,19:15,,-25.78,0,-25.78,-25.78,-1,-46628,90458,137086,43830,0,-16396,0,0,0,,16396,-16396
34,08/20/2017,78,19:15,19:30,,23.28,0,23.28,23.28,-1,-71582,76090,147672,4508,0,-18462,0,0,0,,18462,-18462
34,08/20/2017,79,19:30,19:45,52.28,23.28,0,52.28,52.28,1,-87292,66387,153679,-20905,0,-3109,5269,0,0,,8378,2160
34,08/20/2017,80,19:45,20:00,58.28,,0,58.28,58.28,1,-102616,61585,164201,-41031,0,0,16226,0,0,,16226,16226
34,08/20/2017,81,20:00,20:15,42.28,26.78,0,26.78,26.78,-1,-58149,72664,130813,14515,0,-279,11582,0,0,,11861,11303
34,08/20/2017,82,20:15,20:30,34.59,26.78,0,34.59,34.59,1,-60283,44949,105232,-15334,0,-229,857,0,0,,1086,628
34,08/20/2017,83,20:30,20:45,39.12,,0,39.12,39.12,1,-72677,48017,120694,-24660,0,0,825,0,0,,825,825
34,08/20/2017,84,20:45,21:00,183.28,,0,183.28,183.28,1,-104953,46280,151233,-58673,0,0,15864,0,0,,15864,15864
34,08/20/2017,85,21:00,21:15,59.5,,0,59.5,59.5,1,-134011,77014,211025,-56997,0,0,41101,0,0,,41101,41101
34,08/20/2017,86,21:15,21:30,59.5,,0,59.5,59.5,1,-102188,78873,181061,-23315,0,0,33383,0,0,,33383,33383
34,08/20/2017,87,21:30,21:45,59.5,29.66,0,29.66,29.66,-1,-73677,74192,147869,515,0,-487,3156,0,0,,3643,2669
34,08/20/2017,88,21:45,22:00,52.28,,0,52.28,52.28,1,-105534,81338,186872,-24196,0,0,6562,0,0,,6562,6562
34,08/20/2017,89,22:00,22:15,69,,0,69,69,1,-125302,71713,197015,-53589,0,0,22143,0,0,,22143,22143
34,08/20/2017,90,22:15,22:30,57.5,24.28,0,24.28,24.28,-1,-73872,77846,151718,3974,0,-342,17781,0,0,,18123,17439
34,08/20/2017,91,22:30,22:45,57.5,21.62,0,21.62,21.62,-1,-64427,96938,161365,32511,0,-6735,433,0,0,,7168,-6302
34,08/20/2017,92,22:45,23:00,,27.78,0,27.78,27.78,-1,-75699,115430,191129,39731,0,-7521,0,0,0,,7521,-7521
34,08/20/2017,93,23:00,23:15,292.12,30.88,0,292.12,292.12,1,-114057,61934,175991,-52123,0,-2653,17938,0,0,,20591,15285
34,08/20/2017,94,23:15,23:30,65.03,29.53,0,29.53,29.53,-1,-69323,59000,128323,-10323,0,-25,32861,0,0,,32886,32836
34,08/20/2017,95,23:30,23:45,65.03,21.74,0,21.74,21.74,-1,-43872,84665,128537,40793,0,-1207,2446,0,0,,3653,1239
34,08/20/2017,96,23:45,0:00,,23.28,0,23.28,23.28,-1,-83267,81489,164756,-1778,0,-162,0,0,0,,162,-162
34,08/21/2017,1,0:00,0:15,,23.28,0,23.28,23.28,-1,-71194,98025,169219,26831,0,-1783,0,0,0,,1783,-1783
34,08/21/2017,2,0:15,0:30,,-25.03,0,-25.03,-25.03,-1,-64549,107434,171983,42885,0,-9191,0,0,0,,9191,-9191
34,08/21/2017,3,0:30,0:45,,-27.03,0,-27.03,-27.03,-1,-57525,60502,118027,2977,0,-16566,0,0,0,,16566,-16566
34,08/21/2017,4,0:45,1:00,,-50.03,0,-50.03,-50.03,-1,-44799,86410,131209,41611,0,-19670,0,0,0,,19670,-19670
34,08/21/2017,5,1:00,1:15,44.35,23.28,0,44.35,23.28,2,-75827,40213,116040,-35614,0,-16457,1298,0,0,,17755,-15159
34,08/21/2017,6,1:15,1:30,,,0,32.99,32.99,0,-63815,52583,116398,-11232,0,-3,68,0,0,,71,65
34,08/21/2017,7,1:30,1:45,,,0,33.01,33.01,0,-60190,53464,113654,-6726,0,0,0,0,0,,0,0
34,08/21/2017,8,1:45,2:00,,27.83,0,27.83,27.83,-1,-58477,60037,118514,1560,0,-686,0,0,0,,686,-686
34,08/21/2017,9,2:00,2:15,48.02,27.83,0,48.02,48.02,1,-76358,47134,123492,-29224,0,-197,4269,0,0,,4466,4072
34,08/21/2017,10,2:15,2:30,31.15,,0,31.15,31.15,1,-68861,52266,121127,-16595,0,0,2449,0,0,,2449,2449
34,08/21/2017,11,2:30,2:45,,,0,32.99,32.99,0,-71413,48745,120158,-22668,0,0,221,0,0,,221,221
34,08/21/2017,12,2:45,3:00,,,0,32.99,32.99,0,-68982,49158,118140,-19824,0,0,0,0,0,,0,0
34,08/21/2017,13,3:00,3:15,40.28,,0,40.28,40.28,1,-68077,55273,123350,-12804,0,0,2917,0,0,,2917,2917
34,08/21/2017,14,3:15,3:30,36.02,,0,36.02,36.02,1,-70673,50799,121472,-19874,0,0,6148,0,0,,6148,6148
34,08/21/2017,15,3:30,3:45,,,0,33.48,33.48,0,-66901,60982,127883,-5919,0,0,756,0,0,,756,756
34,08/21/2017,16,3:45,4:00,,27.28,0,27.28,27.28,-1,-67235,68185,135420,950,0,-507,0,0,0,,507,-507
34,08/21/2017,17,4:00,4:15,,23.28,0,23.28,23.28,-1,-48017,76092,124109,28075,0,-12537,0,0,0,,12537,-12537
34,08/21/2017,18,4:15,4:30,,28.28,0,28.28,28.28,-1,-55007,87954,142961,32947,0,-5972,0,0,0,,5972,-5972
34,08/21/2017,19,4:30,4:45,,28.28,0,28.28,28.28,-1,-59935,82199,142134,22264,0,-2500,0,0,0,,2500,-2500
34,08/21/2017,20,4:45,5:00,30.28,28.28,0,30.28,30.28,1,-63062,63466,126528,404,0,-86,227,0,0,,313,141
34,08/21/2017,21,5:00,5:15,30.28,27.03,0,33.51,27.03,2,-36673,112472,149145,75799,0,-3253,75,0,0,,3328,-3178
34,08/21/2017,22,5:15,5:30,,20.34,0,20.34,20.34,-1,-60573,89820,150393,29247,0,-11919,0,0,0,,11919,-11919
34,08/21/2017,23,5:30,5:45,,,0,33.46,33.46,0,-79300,80949,160249,1649,0,-1709,0,0,0,,1709,-1709
34,08/21/2017,24,5:45,6:00,40.58,,0,40.58,40.58,1,-108071,76714,184785,-31357,0,0,4347,0,0,,4347,4347
34,08/21/2017,25,6:00,6:15,28.02,,0,28.02,28.02,1,-59395,79084,138479,19689,0,0,285,0,0,,285,285
34,08/21/2017,26,6:15,6:30,,38.74,0,38.74,38.74,-1,-64077,79559,143636,15482,0,-265,0,0,0,,265,-265
34,08/21/2017,27,6:30,6:45,,28.4,0,28.4,28.4,-1,-50872,51840,102712,968,0,-2226,0,0,0,,2226,-2226
34,08/21/2017,28,6:45,7:00,,38.53,0,38.53,38.53,-1,-48209,55297,103506,7088,0,-1533,0,0,0,,1533,-1533
34,08/21/2017,29,7:00,7:15,,27.03,0,27.03,27.03,-1,-47751,73644,121395,25893,0,-5430,0,0,0,,5430,-5430
34,08/21/2017,30,7:15,7:30,,23.4,0,23.4,23.4,-1,-64816,119537,184353,54721,0,-9322,0,0,0,,9322,-9322
34,08/21/2017,31,7:30,7:45,,27.4,0,27.4,27.4,-1,-56741,94123,150864,37382,0,-5624,0,0,0,,5624,-5624
34,08/21/2017,32,7:45,8:00,,27.4,0,27.4,27.4,-1,-29871,102778,132649,72907,0,-4724,0,0,0,,4724,-4724
34,08/21/2017,33,8:00,8:15,,9.98,0,9.98,9.98,-1,-130532,149347,279879,18815,0,-15311,0,0,0,,15311,-15311
34,08/21/2017,34,8:15,8:30,29.55,9.98,0,29.55,29.55,1,-125673,109710,235383,-15963,0,-3276,54,0,0,,3330,-3222
34,08/21/2017,35,8:30,8:45,29.57,23.4,0,23.4,23.4,-1,-88287,97883,186170,9596,0,-2647,73,0,0,,2720,-2574
34,08/21/2017,36,8:45,9:00,,11.82,0,11.82,11.82,-1,-74644,101273,175917,26629,0,-22403,0,0,0,,22403,-22403
34,08/21/2017,37,9:00,9:15,33.65,27.4,0,34.32,27.4,2,-105582,102797,208379,-2785,0,-1421,477,0,0,,1898,-944
34,08/21/2017,38,9:15,9:30,,27.4,0,27.4,27.4,-1,-94987,123905,218892,28918,0,-3787,0,0,0,,3787,-3787
34,08/21/2017,39,9:30,9:45,,28.4,0,28.4,28.4,-1,-88774,135845,224619,47071,0,-3594,0,0,0,,3594,-3594
34,08/21/2017,40,9:45,10:00,,39.04,0,39.04,39.04,-1,-84778,140622,225400,55844,0,-490,0,0,0,,490,-490
34,08/21/2017,41,10:00,10:15,41,39.03,0,41,34.34,2,-131129,104914,236043,-26215,0,-97,4441,0,0,,4538,4344
34,08/21/2017,42,10:15,10:30,32.38,,0,32.38,32.38,1,-122291,106001,228292,-16290,0,0,8461,0,0,,8461,8461
34,08/21/2017,43,10:30,10:45,31.73,,0,31.73,31.73,1,-111403,108175,219578,-3228,0,0,6315,0,0,,6315,6315
34,08/21/2017,44,10:45,11:00,31.73,28.4,0,28.4,28.4,-1,-114019,120802,234821,6783,0,-184,412,0,0,,596,228
34,08/21/2017,45,11:00,11:15,32.52,28.14,0,34.37,28.14,2,-120297,110909,231206,-9388,0,-432,792,0,0,,1224,360
34,08/21/2017,46,11:15,11:30,38.79,,0,38.79,38.79,1,-122295,112054,234349,-10241,0,0,2472,0,0,,2472,2472
34,08/21/2017,47,11:30,11:45,49.79,,0,49.79,49.79,1,-128991,106863,235854,-22128,0,0,13382,0,0,,13382,13382
34,08/21/2017,48,11:45,12:00,33.69,,0,33.69,33.69,1,-120757,114208,234965,-6549,0,0,12068,0,0,,12068,12068
34,08/21/2017,49,12:00,12:15,33.69,38.74,0,38.74,38.74,-1,-144794,149371,294165,4577,0,-21,1072,0,0,,1093,1051
34,08/21/2017,50,12:15,12:30,,26.34,0,26.34,26.34,-1,-138182,159194,297376,21012,0,-5501,0,0,0,,5501,-5501
34,08/21/2017,51,12:30,12:45,,23.4,0,23.4,23.4,-1,-128284,152323,280607,24039,0,-11372,0,0,0,,11372,-11372
34,08/21/2017,52,12:45,13:00,,27.03,0,27.03,27.03,-1,-125131,139944,265075,14813,0,-2513,0,0,0,,2513,-2513
34,08/21/2017,53,13:00,13:15,48.94,28.4,0,48.94,48.94,1,-138686,145268,283954,6582,0,-2893,445,0,0,,3338,-2448
34,08/21/2017,54,13:15,13:30,259.02,,0,259.02,259.02,1,-188867,154121,342988,-34746,0,0,27548,0,0,,27548,27548
34,08/21/2017,55,13:30,13:45,259.02,25.93,0,25.93,25.93,-1,-161780,187466,349246,25686,0,-4722,3628,0,0,,8350,-1094
34,08/21/2017,56,13:45,14:00,,23.4,0,23.4,23.4,-1,-136595,170322,306917,33727,0,-11353,0,0,0,,11353,-11353
34,08/21/2017,57,14:00,14:15,,13.75,0,13.75,13.75,-1,-107121,151841,258962,44720,0,-18545,0,0,0,,18545,-18545
34,08/21/2017,58,14:15,14:30,,19.9,0,19.9,19.9,-1,-109300,159392,268692,50092,0,-3860,0,0,0,,3860,-3860
34,08/21/2017,59,14:30,14:45,,13.89,0,13.89,13.89,-1,-111888,151141,263029,39253,0,-20647,0,0,0,,20647,-20647
34,08/21/2017,60,14:45,15:00,,26.22,0,26.22,26.22,-1,-115157,123801,238958,8644,0,-18011,0,0,0,,18011,-18011
34,08/21/2017,61,15:00,15:15,39.65,26.22,0,39.65,39.65,1,-117248,106083,223331,-11165,0,-1649,3107,0,0,,4756,1458
34,08/21/2017,62,15:15,15:30,39.65,,0,39.65,39.65,1,-120392,101941,222333,-18451,0,0,6556,0,0,,6556,6556
34,08/21/2017,63,15:30,15:45,33.65,,0,33.65,33.65,1,-119181,109921,229102,-9260,0,0,9587,0,0,,9587,9587
34,08/21/2017,64,15:45,16:00,49.55,,0,49.55,49.55,1,-122665,94892,217557,-27773,0,0,9417,0,0,,9417,9417
34,08/21/2017,65,16:00,16:15,38.09,29.9,0,38.09,29.9,2,-117367,138288,255655,20921,0,-76,11055,0,0,,11131,10979
34,08/21/2017,66,16:15,16:30,38.09,23.4,0,23.4,23.4,-1,-94686,145505,240191,50819,0,-5340,266,0,0,,5606,-5074
34,08/21/2017,67,16:30,16:45,,28.4,0,28.4,28.4,-1,-95225,138734,233959,43509,0,-2326,0,0,0,,2326,-2326
34,08/21/2017,68,16:45,17:00,,27.4,0,27.4,27.4,-1,-101757,126543,228300,24786,0,-2472,0,0,0,,2472,-2472
34,08/21/2017,69,17:00,17:15,33.65,27.4,0,34.43,27.4,2,-108085,111404,219489,3319,0,-3402,345,0,0,,3747,-3057
34,08/21/2017,70,17:15,17:30,40.71,27.4,0,40.71,40.71,1,-108220,96456,204676,-11764,0,-190,4622,0,0,,4812,4432
34,08/21/2017,71,17:30,17:45,33.65,,0,33.65,33.65,1,-113306,102869,216175,-10437,0,0,6568,0,0,,6568,6568
34,08/21/2017,72,17:45,18:00,46.09,,0,46.09,46.09,1,-115755,99596,215351,-16159,0,0,18755,0,0,,18755,18755
34,08/21/2017,73,18:00,18:15,45.8,23.4,0,23.4,23.4,-1,-115673,107580,223253,-8093,0,-1083,13015,0,0,,14098,11932
34,08/21/2017,74,18:15,18:30,45.8,23.4,0,23.4,23.4,-1,-117885,118626,236511,741,0,-3994,59,0,0,,4053,-3935
34,08/21/2017,75,18:30,18:45,,37.26,0,37.26,37.26,-1,-115350,131953,247303,16603,0,-2010,0,0,0,,2010,-2010
34,08/21/2017,76,18:45,19:00,,38.85,0,38.85,38.85,-1,-110666,119405,230071,8739,0,-1399,0,0,0,,1399,-1399
34,08/21/2017,77,19:00,19:15,29.65,,0,29.65,29.65,1,-135663,92914,228577,-42749,0,0,1107,0,0,,1107,1107
34,08/21/2017,78,19:15,19:30,29.65,,0,29.65,29.65,1,-125411,82110,207521,-43301,0,0,1815,0,0,,1815,1815
34,08/21/2017,79,19:30,19:45,67.09,,0,67.09,67.09,1,-127789,82948,210737,-44841,0,0,12501,0,0,,12501,12501
34,08/21/2017,80,19:45,20:00,143.09,,0,143.09,143.09,1,-115238,84846,200084,-30392,0,0,38973,0,0,,38973,38973
34,08/21/2017,81,20:00,20:15,31.18,27.8,0,34.42,27.8,2,-64105,104401,168506,40296,0,-810,11633,0,0,,12443,10823
34,08/21/2017,82,20:15,20:30,,,0,34.43,34.43,0,-71767,99745,171512,27978,0,0,0,0,0,,0,0
34,08/21/2017,83,20:30,20:45,,28.4,0,28.4,28.4,-1,-79651,94212,173863,14561,0,-748,0,0,0,,748,-748
34,08/21/2017,84,20:45,21:00,,39.25,0,39.25,39.25,-1,-86336,78598,164934,-7738,0,-569,0,0,0,,569,-569
34,08/21/2017,85,21:00,21:15,46.31,,0,46.31,46.31,1,-94525,92069,186594,-2456,0,0,1467,0,0,,1467,1467
34,08/21/2017,86,21:15,21:30,49.27,,0,49.27,49.27,1,-103612,81655,185267,-21957,0,0,12532,0,0,,12532,12532
34,08/21/2017,87,21:30,21:45,32.58,27.4,0,34.41,27.4,2,-77954,90278,168232,12324,0,-549,6706,0,0,,7255,6157
34,08/21/2017,88,21:45,22:00,,16.38,0,16.38,16.38,-1,-72002,96821,168823,24819,0,-13607,0,0,0,,13607,-13607
34,08/21/2017,89,22:00,22:15,350.09,38.47,0,350.09,350.09,1,-146550,41375,187925,-105175,0,-4125,22301,0,0,,26426,18176
34,08/21/2017,90,22:15,22:30,96.09,,0,96.09,96.09,1,-102465,55708,158173,-46757,0,0,43504,0,0,,43504,43504
34,08/21/2017,91,22:30,22:45,96.09,26.72,0,26.72,26.72,-1,-81100,88569,169669,7469,0,-4947,4516,0,0,,9463,-431
34,08/21/2017,92,22:45,23:00,,28.82,0,28.82,28.82,-1,-93937,101812,195749,7875,0,-4673,0,0,0,,4673,-4673
34,08/21/2017,93,23:00,23:15,222.09,28.82,0,222.09,222.09,1,-100165,36158,136323,-64007,0,-853,24645,0,0,,25498,23792
34,08/21/2017,94,23:15,23:30,222.09,,0,222.09,222.09,1,-108647,49304,157951,-59343,0,0,71168,0,0,,71168,71168
34,08/21/2017,95,23:30,23:45,30.12,,0,30.12,30.12,1,-86440,87580,174020,1140,0,0,9427,0,0,,9427,9427
34,08/21/2017,96,23:45,0:00,,24.98,0,24.98,24.98,-1,-69932,80034,149966,10102,0,-5507,0,0,0,,5507,-5507
34,08/22/2017,1,0:00,0:15,33.04,24.98,0,33.04,33.04,1,-66451,49662,116113,-16789,0,-1470,983,0,0,,2453,-487
34,08/22/2017,2,0:15,0:30,34.4,,0,34.4,34.4,1,-80160,28211,108371,-51949,0,0,809,0,0,,809,809
34,08/22/2017,3,0:30,0:45,,,0,34.62,34.62,0,-85814,26913,112727,-58901,0,0,0,0,0,,0,0
34,08/22/2017,4,0:45,1:00,,,0,34.62,34.62,0,-75385,33732,109117,-41653,0,0,0,0,0,,0,0
34,08/22/2017,5,1:00,1:15,38.71,,0,38.71,38.71,1,-65756,33717,99473,-32039,0,0,3321,0,0,,3321,3321
34,08/22/2017,6,1:15,1:30,40.03,,0,40.03,40.03,1,-61185,38028,99213,-23157,0,0,4739,0,0,,4739,4739
34,08/22/2017,7,1:30,1:45,,,0,34.6,34.6,0,-62086,39024,101110,-23062,0,0,0,0,0,,0,0
34,08/22/2017,8,1:45,2:00,,28.37,0,28.37,28.37,-1,-56086,53138,109224,-2948,0,-1415,0,0,0,,1415,-1415
34,08/22/2017,9,2:00,2:15,,,0,34.52,34.52,0,-80467,29010,109477,-51457,0,0,0,0,0,,0,0
34,08/22/2017,10,2:15,2:30,,,0,34.53,34.53,0,-72278,45082,117360,-27196,0,0,0,0,0,,0,0
34,08/22/2017,11,2:30,2:45,,39.07,0,39.07,39.07,-1,-69652,50737,120389,-18915,0,-238,0,0,0,,238,-238
34,08/22/2017,12,2:45,3:00,,28.4,0,28.4,28.4,-1,-73534,52637,126171,-20897,0,-605,0,0,0,,605,-605
34,08/22/2017,13,3:00,3:15,30.39,27.79,0,30.39,30.39,1,-69909,57933,127842,-11976,0,-764,63,0,0,,827,-701
34,08/22/2017,14,3:15,3:30,30.39,,0,30.39,30.39,1,-73084,60026,133110,-13058,0,0,1052,0,0,,1052,1052
34,08/22/2017,15,3:30,3:45,,,0,34.52,34.52,0,-67645,60893,128538,-6752,0,0,60,0,0,,60,60
34,08/22/2017,16,3:45,4:00,,28.4,0,28.4,28.4,-1,-62339,58174,120513,-4165,0,-433,0,0,0,,433,-433
34,08/22/2017,17,4:00,4:15,,,0,34.52,34.52,0,-67930,53731,121661,-14199,0,-158,0,0,0,,158,-158
34,08/22/2017,18,4:15,4:30,,,0,34.52,34.52,0,-68456,47029,115485,-21427,0,0,0,0,0,,0,0
34,08/22/2017,19,4:30,4:45,,,0,34.53,34.53,0,-69549,52417,121966,-17132,0,0,0,0,0,,0,0
34,08/22/2017,20,4:45,5:00,31.05,,0,31.05,31.05,1,-70721,61844,132565,-8877,0,0,599,0,0,,599,599
34,08/22/2017,21,5:00,5:15,30.39,,0,30.39,30.39,1,-100249,48825,149074,-51424,0,0,964,0,0,,964,964
34,08/22/2017,22,5:15,5:30,,,0,34.73,34.73,0,-68504,51919,120423,-16585,0,0,0,0,0,,0,0
34,08/22/2017,23,5:30,5:45,32.71,,0,32.71,32.71,1,-68144,44394,112538,-23750,0,0,1066,0,0,,1066,1066
34,08/22/2017,24,5:45,6:00,34.4,,0,34.4,34.4,1,-80369,42680,123049,-37689,0,0,5834,0,0,,5834,5834
34,08/22/2017,25,6:00,6:15,30.07,,0,30.07,30.07,1,-95770,59579,155349,-36191,0,0,484,0,0,,484,484
34,08/22/2017,26,6:15,6:30,33.34,,0,33.34,33.34,1,-69657,38308,107965,-31349,0,0,419,0,0,,419,419
34,08/22/2017,27,6:30,6:45,32.06,,0,32.06,32.06,1,-70820,31259,102079,-39561,0,0,1385,0,0,,1385,1385
34,08/22/2017,28,6:45,7:00,31.78,,0,31.78,31.78,1,-77914,36356,114270,-41558,0,0,2055,0,0,,2055,2055
34,08/22/2017,29,7:00,7:15,31.78,27.75,0,27.75,27.75,-1,-55702,70112,125814,14410,0,-3686,126,0,0,,3812,-3560
34,08/22/2017,30,7:15,7:30,30,38.92,0,34.55,34.55,2,-60074,48324,108398,-11750,0,-2040,34,0,0,,2074,-2006
34,08/22/2017,31,7:30,7:45,36.31,38.92,0,36.31,36.31,1,-71143,40509,111652,-30634,0,-203,1013,0,0,,1216,810
34,08/22/2017,32,7:45,8:00,62.12,,0,62.12,62.12,1,-107456,52280,159736,-55176,0,0,8069,0,0,,8069,8069
34,08/22/2017,33,8:00,8:15,36.54,,0,36.54,36.54,1,-105538,91910,197448,-13628,0,0,2435,0,0,,2435,2435
34,08/22/2017,34,8:15,8:30,33.22,,0,33.22,33.22,1,-107136,77492,184628,-29644,0,0,2447,0,0,,2447,2447
34,08/22/2017,35,8:30,8:45,37.42,,0,37.42,37.42,1,-118568,60249,178817,-58319,0,0,6935,0,0,,6935,6935
34,08/22/2017,36,8:45,9:00,54.92,,0,54.92,54.92,1,-137577,71266,208843,-66311,0,0,12642,0,0,,12642,12642
34,08/22/2017,37,9:00,9:15,34.23,23.22,0,23.22,23.22,-1,-87042,138925,225967,51883,0,-1411,6696,0,0,,8107,5285
34,08/22/2017,38,9:15,9:30,,21.1,0,21.1,21.1,-1,-91455,140680,232135,49225,0,-4278,0,0,0,,4278,-4278
34,08/22/2017,39,9:30,9:45,,23.75,0,23.75,23.75,-1,-86549,129212,215761,42663,0,-7614,0,0,0,,7614,-7614
34,08/22/2017,40,9:45,10:00,,5.65,0,5.65,5.65,-1,-82869,130769,213638,47900,0,-24073,0,0,0,,24073,-24073
34,08/22/2017,41,10:00,10:15,30,23.75,0,30,30,1,-100904,103371,204275,2467,0,-15984,46,0,0,,16030,-15938
34,08/22/2017,42,10:15,10:30,30,27.75,0,34.55,27.75,2,-94671,122522,217193,27851,0,-430,71,0,0,,501,-359
34,08/22/2017,43,10:30,10:45,,7.82,0,7.82,7.82,-1,-90566,114871,205437,24305,0,-19042,0,0,0,,19042,-19042
34,08/22/2017,44,10:45,11:00,,21.35,0,21.35,21.35,-1,-91181,124702,215883,33521,0,-9114,0,0,0,,9114,-9114
34,08/22/2017,45,11:00,11:15,,21.14,0,21.14,21.14,-1,-112865,99879,212744,-12986,0,-11397,0,0,0,,11397,-11397
34,08/22/2017,46,11:15,11:30,,,0,34.57,34.57,0,-118073,107114,225187,-10959,0,-110,0,0,0,,110,-110
34,08/22/2017,47,11:30,11:45,,,0,34.57,34.57,0,-115082,111489,226571,-3593,0,0,0,0,0,,0,0
34,08/22/2017,48,11:45,12:00,,39.13,0,39.13,39.13,-1,-115456,130809,246265,15353,0,-76,0,0,0,,76,-76
34,08/22/2017,49,12:00,12:15,,39.17,0,39.17,39.17,-1,-112411,92082,204493,-20329,0,-103,0,0,0,,103,-103
34,08/22/2017,50,12:15,12:30,,,0,34.59,34.59,0,-111178,92719,203897,-18459,0,0,0,0,0,,0,0
34,08/22/2017,51,12:30,12:45,34,,0,34,34,1,-107719,105332,213051,-2387,0,0,637,0,0,,637,637
34,08/22/2017,52,12:45,13:00,41.57,,0,41.57,41.57,1,-102810,124099,226909,21289,0,0,1269,0,0,,1269,1269
34,08/22/2017,53,13:00,13:15,41.86,,0,41.86,41.86,1,-100627,79999,180626,-20628,0,0,4304,0,0,,4304,4304
34,08/22/2017,54,13:15,13:30,30,,0,30,30,1,-112490,86528,199018,-25962,0,0,2406,0,0,,2406,2406
34,08/22/2017,55,13:30,13:45,30,,0,30,30,1,-115044,96267,211311,-18777,0,0,1298,0,0,,1298,1298
34,08/22/2017,56,13:45,14:00,,,0,34.62,34.62,0,-105096,81537,186633,-23559,0,0,0,0,0,,0,0
34,08/22/2017,57,14:00,14:15,,,0,34.66,34.66,0,-94554,98980,193534,4426,0,0,0,0,0,,0,0
34,08/22/2017,58,14:15,14:30,30,,0,30,30,1,-95355,103101,198456,7746,0,0,596,0,0,,596,596
34,08/22/2017,59,14:30,14:45,,,0,34.66,34.66,0,-92019,100473,192492,8454,0,0,10,0,0,,10,10
34,08/22/2017,60,14:45,15:00,,,0,34.66,34.66,0,-93054,98883,191937,5829,0,0,0,0,0,,0,0
34,08/22/2017,61,15:00,15:15,,,0,34.68,34.68,0,-87453,81720,169173,-5733,0,0,0,0,0,,0,0
34,08/22/2017,62,15:15,15:30,,,0,34.68,34.68,0,-90403,79085,169488,-11318,0,0,0,0,0,,0,0
34,08/22/2017,63,15:30,15:45,30,,0,30,30,1,-96350,84793,181143,-11557,0,0,4,0,0,,4,4
34,08/22/2017,64,15:45,16:00,32.75,,0,32.75,32.75,1,-92428,80016,172444,-12412,0,0,644,0,0,,644,644
34,08/22/2017,65,16:00,16:15,32.82,,0,32.82,32.82,1,-102471,38886,141357,-63585,0,0,2118,0,0,,2118,2118
34,08/22/2017,66,16:15,16:30,34,,0,34,34,1,-100844,38175,139019,-62669,0,0,1973,0,0,,1973,1973
34,08/22/2017,67,16:30,16:45,49.18,,0,49.18,49.18,1,-107106,56276,163382,-50830,0,0,3168,0,0,,3168,3168
34,08/22/2017,68,16:45,17:00,92.22,,0,92.22,92.22,1,-124465,48953,173418,-75512,0,0,23989,0,0,,23989,23989
34,08/22/2017,69,17:00,17:15,37.02,,0,37.02,37.02,1,-102420,69135,171555,-33285,0,0,12992,0,0,,12992,12992
34,08/22/2017,70,17:15,17:30,54.52,,0,54.52,54.52,1,-100532,68560,169092,-31972,0,0,2160,0,0,,2160,2160
34,08/22/2017,71,17:30,17:45,55.22,,0,55.22,55.22,1,-104603,75033,179636,-29570,0,0,10045,0,0,,10045,10045
34,08/22/2017,72,17:45,18:00,61.61,,0,61.61,61.61,1,-102431,85233,187664,-17198,0,0,18883,0,0,,18883,18883
34,08/22/2017,73,18:00,18:15,36.22,,0,36.22,36.22,1,-115396,61989,177385,-53407,0,0,8757,0,0,,8757,8757
34,08/22/2017,74,18:15,18:30,36.22,38.93,0,38.93,38.93,-1,-100112,94087,194199,-6025,0,-49,63,0,0,,112,14
34,08/22/2017,75,18:30,18:45,30,30.04,0,34.73,30.04,2,-99809,104342,204151,4533,0,-434,8,0,0,,442,-426
34,08/22/2017,76,18:45,19:00,39.71,,0,39.71,39.71,1,-97321,104851,202172,7530,0,0,1181,0,0,,1181,1181
34,08/22/2017,77,19:00,19:15,350.22,,0,350.22,350.22,1,-144595,58625,203220,-85970,0,0,33069,0,0,,33069,33069
34,08/22/2017,78,19:15,19:30,129.22,,0,129.22,129.22,1,-109455,104719,214174,-4736,0,0,24340,0,0,,24340,24340
34,08/22/2017,79,19:30,19:45,129.22,39.25,0,39.25,39.25,-1,-104480,117583,222063,13103,0,-666,21,0,0,,687,-645
34,08/22/2017,80,19:45,20:00,,,0,37.99,37.99,0,-103653,116597,220250,12944,0,-48,0,0,0,,48,-48
34,08/22/2017,81,20:00,20:15,,28.75,0,28.75,28.75,-1,-56786,105697,162483,48911,0,-29,0,0,0,,29,-29
34,08/22/2017,82,20:15,20:30,,27.75,0,27.75,27.75,-1,-54425,82385,136810,27960,0,-3137,0,0,0,,3137,-3137
34,08/22/2017,83,20:30,20:45,,27.75,0,27.75,27.75,-1,-62627,76602,139229,13975,0,-4828,0,0,0,,4828,-4828
34,08/22/2017,84,20:45,21:00,,,0,34.69,34.69,0,-66921,58820,125741,-8101,0,-401,0,0,0,,401,-401
34,08/22/2017,85,21:00,21:15,49.38,,0,49.38,49.38,1,-70805,52200,123005,-18605,0,0,2031,0,0,,2031,2031
34,08/22/2017,86,21:15,21:30,102.96,,0,102.96,102.96,1,-73165,51050,124215,-22115,0,0,18322,0,0,,18322,18322
34,08/22/2017,87,21:30,21:45,102.96,39.36,0,39.36,39.36,-1,-43798,68405,112203,24607,0,-224,2343,0,0,,2567,2119
34,08/22/2017,88,21:45,22:00,,16.19,0,16.19,16.19,-1,-40463,85740,126203,45277,0,-7861,0,0,0,,7861,-7861
34,08/22/2017,89,22:00,22:15,,27.75,0,27.75,27.75,-1,-92238,61577,153815,-30661,0,-7608,0,0,0,,7608,-7608
34,08/22/2017,90,22:15,22:30,,23.75,0,23.75,23.75,-1,-56272,57146,113418,874,0,-1552,0,0,0,,1552,-1552
34,08/22/2017,91,22:30,22:45,,23.75,0,23.75,23.75,-1,-47525,91022,138547,43497,0,-12227,0,0,0,,12227,-12227
34,08/22/2017,92,22:45,23:00,,-55.33,0,-55.33,-55.33,-1,-39539,111602,151141,72063,0,-19190,0,0,0,,19190,-19190
34,08/22/2017,93,23:00,23:15,42.21,-57.49,0,42.21,-57.49,2,-70383,57110,127493,-13273,0,-22898,1813,0,0,,24711,-21085
34,08/22/2017,94,23:15,23:30,33.17,,0,33.17,33.17,1,-71339,52188,123527,-19151,0,0,1557,0,0,,1557,1557
34,08/22/2017,95,23:30,23:45,,,0,34.62,34.62,0,-76868,55893,132761,-20975,0,0,0,0,0,,0,0
34,08/22/2017,96,23:45,0:00,,38.74,0,38.74,38.74,-1,-88793,87567,176360,-1226,0,-344,0,0,0,,344,-344
34,08/23/2017,1,0:00,0:15,34.75,38.74,0,34.75,34.75,1,-90035,54519,144554,-35516,0,-88,1234,0,0,,1322,1146
34,08/23/2017,2,0:15,0:30,29.94,,0,29.94,29.94,1,-68185,48285,116470,-19900,0,0,1310,0,0,,1310,1310
34,08/23/2017,3,0:30,0:45,29.94,23.76,0,23.76,23.76,-1,-54441,63713,118154,9272,0,-1067,112,0,0,,1179,-955
34,08/23/2017,4,0:45,1:00,,20.68,0,20.68,20.68,-1,-54983,72221,127204,17238,0,-16675,0,0,0,,16675,-16675
34,08/23/2017,5,1:00,1:15,46.12,18.03,0,46.12,46.12,1,-55697,52140,107837,-3557,0,-11438,3376,0,0,,14814,-8062
34,08/23/2017,6,1:15,1:30,31.57,18.03,0,31.57,31.57,1,-60050,45963,106013,-14087,0,-98,3413,0,0,,3511,3315
34,08/23/2017,7,1:30,1:45,,,0,34.54,34.54,0,-48168,60164,108332,11996,0,0,0,0,0,,0,0
34,08/23/2017,8,1:45,2:00,,25.03,0,25.03,25.03,-1,-44579,72057,116636,27478,0,-6038,0,0,0,,6038,-6038
34,08/23/2017,9,2:00,2:15,126.56,25.03,0,126.56,126.56,1,-84637,53160,137797,-31477,0,-4362,5984,0,0,,10346,1622
34,08/23/2017,10,2:15,2:30,151.02,,0,151.02,151.02,1,-76848,47467,124315,-29381,0,0,28704,0,0,,28704,28704
34,08/23/2017,11,2:30,2:45,151.02,26.17,0,26.17,26.17,-1,-71285,74645,145930,3360,0,-560,1270,0,0,,1830,710
34,08/23/2017,12,2:45,3:00,,24.1,0,24.1,24.1,-1,-74847,78205,153052,3358,0,-1273,0,0,0,,1273,-1273
34,08/23/2017,13,3:00,3:15,34.75,23.4,0,34.75,34.75,1,-66680,59053,125733,-7627,0,-2341,1301,0,0,,3642,-1040
34,08/23/2017,14,3:15,3:30,34.75,,0,34.75,34.75,1,-76045,66477,142522,-9568,0,0,4303,0,0,,4303,4303
34,08/23/2017,15,3:30,3:45,32.22,,0,32.22,32.22,1,-73462,65640,139102,-7822,0,0,1944,0,0,,1944,1944
34,08/23/2017,16,3:45,4:00,32.22,,0,32.22,32.22,1,-69647,55391,125038,-14256,0,0,781,0,0,,781,781
34,08/23/2017,17,4:00,4:15,34.75,,0,34.75,34.75,1,-65876,66898,132774,1022,0,0,3047,0,0,,3047,3047
34,08/23/2017,18,4:15,4:30,30.75,,0,30.75,30.75,1,-68642,75046,143688,6404,0,0,561,0,0,,561,561
34,08/23/2017,19,4:30,4:45,31.57,,0,31.57,31.57,1,-70778,79850,150628,9072,0,0,3045,0,0,,3045,3045
34,08/23/2017,20,4:45,5:00,31.57,,0,31.57,31.57,1,-68975,76006,144981,7031,0,0,3417,0,0,,3417,3417
34,08/23/2017,21,5:00,5:15,30.75,,0,30.75,30.75,1,-82521,67476,149997,-15045,0,0,1667,0,0,,1667,1667
34,08/23/2017,22,5:15,5:30,,,0,34.26,34.26,0,-79431,79247,158678,-184,0,0,0,0,0,,0,0
34,08/23/2017,23,5:30,5:45,34.75,38.58,0,34.75,34.26,2,-82323,79159,161482,-3164,0,-166,347,0,0,,513,181
34,08/23/2017,24,5:45,6:00,40.75,,0,40.75,40.75,1,-92082,63679,155761,-28403,0,0,10498,0,0,,10498,10498
34,08/23/2017,25,6:00,6:15,30.75,,0,30.75,30.75,1,-96498,72852,169350,-23646,0,0,3548,0,0,,3548,3548
34,08/23/2017,26,6:15,6:30,,27.8,0,27.8,27.8,-1,-72789,85243,158032,12454,0,-1100,0,0,0,,1100,-1100
34,08/23/2017,27,6:30,6:45,,25.2,0,25.2,25.2,-1,-84689,76695,161384,-7994,0,-4125,0,0,0,,4125,-4125
34,08/23/2017,28,6:45,7:00,,25.2,0,25.2,25.2,-1,-82714,76829,159543,-5885,0,-423,0,0,0,,423,-423
34,08/23/2017,29,7:00,7:15,,-37.57,0,-37.57,-37.57,-1,-42783,106891,149674,64108,0,-31768,0,0,0,,31768,-31768
34,08/23/2017,30,7:15,7:30,31.18,20.46,0,31.18,31.18,1,-72154,75065,147219,2911,0,-17104,141,0,0,,17245,-16963
34,08/23/2017,31,7:30,7:45,34,20.46,0,34,34,1,-84649,61396,146045,-23253,0,-95,519,0,0,,614,424
34,08/23/2017,32,7:45,8:00,350.02,,0,350.02,350.02,1,-108841,57046,165887,-51795,0,0,27641,0,0,,27641,27641
34,08/23/2017,33,8:00,8:15,33.34,-3.03,0,34.49,-3.03,2,-85733,152258,237991,66525,0,-3604,8884,0,0,,12488,5280
34,08/23/2017,34,8:15,8:30,,38.98,0,38.98,38.98,-1,-112151,128761,240912,16610,0,-1025,0,0,0,,1025,-1025
34,08/23/2017,35,8:30,8:45,65.02,,0,65.02,65.02,1,-118777,101626,220403,-17151,0,0,6730,0,0,,6730,6730
34,08/23/2017,36,8:45,9:00,40,,0,40,40,1,-128771,102108,230879,-26663,0,0,18377,0,0,,18377,18377
34,08/23/2017,37,9:00,9:15,30.02,36.88,0,34.52,34.52,2,-114085,142842,256927,28757,0,-601,7838,0,0,,8439,7237
34,08/23/2017,38,9:15,9:30,,,0,34.52,34.52,0,-120959,131757,252716,10798,0,-9,0,0,0,,9,-9
34,08/23/2017,39,9:30,9:45,,,0,34.52,34.52,0,-110543,142523,253066,31980,0,0,0,0,0,,0,0
34,08/23/2017,40,9:45,10:00,,,0,34.52,34.52,0,-111287,147024,258311,35737,0,0,0,0,0,,0,0
34,08/23/2017,41,10:00,10:15,,,0,34.56,34.56,0,-110094,119204,229298,9110,0,0,0,0,0,,0,0
34,08/23/2017,42,10:15,10:30,,37.57,0,37.57,37.57,-1,-107516,116510,224026,8994,0,-1707,0,0,0,,1707,-1707
34,08/23/2017,43,10:30,10:45,,38.08,0,38.08,38.08,-1,-109159,109397,218556,238,0,-1780,0,0,0,,1780,-1780
34,08/23/2017,44,10:45,11:00,,28.3,0,28.3,28.3,-1,-115242,107203,222445,-8039,0,-2102,0,0,0,,2102,-2102
34,08/23/2017,45,11:00,11:15,,,0,34.61,34.61,0,-122581,81824,204405,-40757,0,-28,0,0,0,,28,-28
34,08/23/2017,46,11:15,11:30,,,0,34.61,34.61,0,-111855,96145,208000,-15710,0,0,0,0,0,,0,0
34,08/23/2017,47,11:30,11:45,34,,0,34,34,1,-114989,90138,205127,-24851,0,0,422,0,0,,422,422
34,08/23/2017,48,11:45,12:00,53.02,,0,53.02,53.02,1,-115236,84482,199718,-30754,0,0,15291,0,0,,15291,15291
34,08/23/2017,49,12:00,12:15,50.05,,0,50.05,50.05,1,-118877,70563,189440,-48314,0,0,23272,0,0,,23272,23272
34,08/23/2017,50,12:15,12:30,33.34,,0,33.34,33.34,1,-111431,74483,185914,-36948,0,0,11011,0,0,,11011,11011
34,08/23/2017,51,12:30,12:45,33.34,,0,33.34,33.34,1,-108956,87562,196518,-21394,0,0,293,0,0,,293,293
34,08/23/2017,52,12:45,13:00,33.24,,0,33.24,33.24,1,-114454,72150,186604,-42304,0,0,294,0,0,,294,294
34,08/23/2017,53,13:00,13:15,31.57,,0,31.57,31.57,1,-92563,94838,187401,2275,0,0,536,0,0,,536,536
34,08/23/2017,54,13:15,13:30,30,,0,30,30,1,-99786,64757,164543,-35029,0,0,1451,0,0,,1451,1451
34,08/23/2017,55,13:30,13:45,34,,0,34,34,1,-107803,56309,164112,-51494,0,0,3332,0,0,,3332,3332
34,08/23/2017,56,13:45,14:00,,,0,34.74,34.74,0,-90732,70312,161044,-20420,0,0,927,0,0,,927,927
34,08/23/2017,57,14:00,14:15,31.57,,0,31.57,31.57,1,-78513,76503,155016,-2010,0,0,316,0,0,,316,316
34,08/23/2017,58,14:15,14:30,34,,0,34,34,1,-83787,69257,153044,-14530,0,0,5000,0,0,,5000,5000
34,08/23/2017,59,14:30,14:45,30,,0,30,30,1,-84769,72397,157166,-12372,0,0,1936,0,0,,1936,1936
34,08/23/2017,60,14:45,15:00,,,0,34.78,34.78,0,-85065,71293,156358,-13772,0,0,0,0,0,,0,0
34,08/23/2017,61,15:00,15:15,34,,0,34,34,1,-99608,79762,179370,-19846,0,0,1681,0,0,,1681,1681
34,08/23/2017,62,15:15,15:30,40,,0,40,40,1,-103617,76008,179625,-27609,0,0,8983,0,0,,8983,8983
34,08/23/2017,63,15:30,15:45,66.02,,0,66.02,66.02,1,-106992,72250,179242,-34742,0,0,28520,0,0,,28520,28520
34,08/23/2017,64,15:45,16:00,40,,0,40,40,1,-106689,68563,175252,-38126,0,0,20514,0,0,,20514,20514
34,08/23/2017,65,16:00,16:15,34,,0,34,34,1,-104114,59738,163852,-44376,0,0,17163,0,0,,17163,17163
34,08/23/2017,66,16:15,16:30,30,,0,30,30,1,-120213,65411,185624,-54802,0,0,3158,0,0,,3158,3158
34,08/23/2017,67,16:30,16:45,40,,0,40,40,1,-129717,62056,191773,-67661,0,0,4320,0,0,,4320,4320
34,08/23/2017,68,16:45,17:00,91.31,,0,91.31,91.31,1,-163151,58877,222028,-104274,0,0,11539,0,0,,11539,11539
34,08/23/2017,69,17:00,17:15,113.02,,0,113.02,113.02,1,-127166,95580,222746,-31586,0,0,12338,0,0,,12338,12338
34,08/23/2017,70,17:15,17:30,35.24,,0,35.24,35.24,1,-114705,86561,201266,-28144,0,0,7086,0,0,,7086,7086
34,08/23/2017,71,17:30,17:45,33.13,,0,33.13,33.13,1,-114601,98411,213012,-16190,0,0,8270,0,0,,8270,8270
34,08/23/2017,72,17:45,18:00,46.24,,0,46.24,46.24,1,-121754,106216,227970,-15538,0,0,5359,0,0,,5359,5359
34,08/23/2017,73,18:00,18:15,53.02,,0,53.02,53.02,1,-154371,67448,221819,-86923,0,0,9920,0,0,,9920,9920
34,08/23/2017,74,18:15,18:30,,,0,37.86,37.86,0,-122936,81300,204236,-41636,0,0,470,0,0,,470,470
34,08/23/2017,75,18:30,18:45,29.5,,0,29.5,29.5,1,-115517,89184,204701,-26333,0,0,7,0,0,,7,7
34,08/23/2017,76,18:45,19:00,33.13,,0,33.13,33.13,1,-99274,100317,199591,1043,0,0,572,0,0,,572,572
34,08/23/2017,77,19:00,19:15,31.57,,0,31.57,31.57,1,-120661,56139,176800,-64522,0,0,933,0,0,,933,933
34,08/23/2017,78,19:15,19:30,,,0,37.83,37.83,0,-104346,72219,176565,-32127,0,0,96,0,0,,96,96
34,08/23/2017,79,19:30,19:45,,39.18,0,39.18,39.18,-1,-86400,94045,180445,7645,0,-53,0,0,0,,53,-53
34,08/23/2017,80,19:45,20:00,,37.41,0,37.41,37.41,-1,-83383,100823,184206,17440,0,-1931,0,0,0,,1931,-1931
34,08/23/2017,81,20:00,20:15,,37.76,0,37.76,37.76,-1,-42581,86649,129230,44068,0,-3159,0,0,0,,3159,-3159
34,08/23/2017,82,20:15,20:30,,38.47,0,38.47,38.47,-1,-62428,71304,133732,8876,0,-2003,0,0,0,,2003,-2003
34,08/23/2017,83,20:30,20:45,,,0,34.51,34.51,0,-90971,57090,148061,-33881,0,-71,0,0,0,,71,-71
34,08/23/2017,84,20:45,21:00,32.47,,0,32.47,32.47,1,-116588,56351,172939,-60237,0,0,145,0,0,,145,145
34,08/23/2017,85,21:00,21:15,69.49,,0,69.49,69.49,1,-97127,66619,163746,-30508,0,0,12582,0,0,,12582,12582
34,08/23/2017,86,21:15,21:30,42.02,,0,42.02,42.02,1,-76875,73294,150169,-3581,0,0,19964,0,0,,19964,19964
34,08/23/2017,87,21:30,21:45,42.02,29.9,0,29.9,29.9,-1,-56352,81001,137353,24649,0,-819,1920,0,0,,2739,1101
34,08/23/2017,88,21:45,22:00,,27.5,0,27.5,27.5,-1,-53052,88350,141402,35298,0,-306,0,0,0,,306,-306
34,08/23/2017,89,22:00,22:15,,27.5,0,27.5,27.5,-1,-75795,63852,139647,-11943,0,-455,0,0,0,,455,-455
34,08/23/2017,90,22:15,22:30,,28.86,0,28.86,28.86,-1,-54071,55253,109324,1182,0,-1042,0,0,0,,1042,-1042
34,08/23/2017,91,22:30,22:45,,27.5,0,27.5,27.5,-1,-45947,64791,110738,18844,0,-837,0,0,0,,837,-837
34,08/23/2017,92,22:45,23:00,,38.22,0,38.22,38.22,-1,-55311,54977,110288,-334,0,-48,0,0,0,,48,-48
34,08/23/2017,93,23:00,23:15,42.02,38.47,0,42.02,42.02,1,-57047,65572,122619,8525,0,-66,1722,0,0,,1788,1656
34,08/23/2017,94,23:15,23:30,61.94,,0,61.94,61.94,1,-86856,54333,141189,-32523,0,0,8409,0,0,,8409,8409
34,08/23/2017,95,23:30,23:45,33.5,,0,33.5,33.5,1,-82052,60611,142663,-21441,0,0,1637,0,0,,1637,1637
34,08/23/2017,96,23:45,0:00,,27.5,0,27.5,27.5,-1,-82893,89378,172271,6485,0,-142,0,0,0,,142,-142
34,08/24/2017,1,0:00,0:15,129.12,,0,129.12,129.12,1,-127033,15142,142175,-111891,0,0,22145,0,0,,22145,22145
34,08/24/2017,2,0:15,0:30,49.86,,0,49.86,49.86,1,-75171,42939,118110,-32232,0,0,37060,0,0,,37060,37060
34,08/24/2017,3,0:30,0:45,49.86,26.26,0,26.26,26.26,-1,-52093,51955,104048,-138,0,-2345,3526,0,0,,5871,1181
34,08/24/2017,4,0:45,1:00,,23.5,0,23.5,23.5,-1,-44695,57361,102056,12666,0,-7853,0,0,0,,7853,-7853
34,08/24/2017,5,1:00,1:15,182.48,39.21,0,182.48,182.48,1,-92086,2806,94892,-89280,0,-2112,18628,0,0,,20740,16516
34,08/24/2017,6,1:15,1:30,164.12,,0,164.12,164.12,1,-84817,36687,121504,-48130,0,0,40876,0,0,,40876,40876
34,08/24/2017,7,1:30,1:45,33.67,,0,33.67,33.67,1,-75123,57310,132433,-17813,0,0,6785,0,0,,6785,6785
34,08/24/2017,8,1:45,2:00,,,0,34.35,34.35,0,-69696,58083,127779,-11613,0,0,941,0,0,,941,941
34,08/24/2017,9,2:00,2:15,45.21,,0,45.21,45.21,1,-82299,59712,142011,-22587,0,0,4741,0,0,,4741,4741
34,08/24/2017,10,2:15,2:30,49.56,,0,49.56,49.56,1,-76007,49778,125785,-26229,0,0,28299,0,0,,28299,28299
34,08/24/2017,11,2:30,2:45,29.48,,0,29.48,29.48,1,-73076,47594,120670,-25482,0,0,8613,0,0,,8613,8613
34,08/24/2017,12,2:45,3:00,,,0,34.16,34.16,0,-67672,44002,111674,-23670,0,0,0,0,0,,0,0
34,08/24/2017,13,3:00,3:15,31.59,38.77,0,34.14,34.14,2,-49678,54634,104312,4956,0,-280,234,0,0,,514,-46
34,08/24/2017,14,3:15,3:30,39.48,,0,39.48,39.48,1,-68290,29152,97442,-39138,0,0,7456,0,0,,7456,7456
34,08/24/2017,15,3:30,3:45,33.48,,0,33.48,33.48,1,-66417,39930,106347,-26487,0,0,8475,0,0,,8475,8475
34,08/24/2017,16,3:45,4:00,29.64,,0,29.64,29.64,1,-70019,34366,104385,-35653,0,0,3252,0,0,,3252,3252
34,08/24/2017,17,4:00,4:15,29.12,,0,29.12,29.12,1,-93207,43306,136513,-49901,0,0,532,0,0,,532,532
34,08/24/2017,18,4:15,4:30,,,0,34.13,34.13,0,-100344,39641,139985,-60703,0,0,0,0,0,,0,0
34,08/24/2017,19,4:30,4:45,29.12,,0,29.12,29.12,1,-111342,36611,147953,-74731,0,0,73,0,0,,73,73
34,08/24/2017,20,4:45,5:00,29.48,,0,29.48,29.48,1,-118560,34892,153452,-83668,0,0,1825,0,0,,1825,1825
34,08/24/2017,21,5:00,5:15,39.48,,0,39.48,39.48,1,-133685,30595,164280,-103090,0,0,5621,0,0,,5621,5621
34,08/24/2017,22,5:15,5:30,29.48,,0,29.48,29.48,1,-103356,44929,148285,-58427,0,0,390,0,0,,390,390
34,08/24/2017,23,5:30,5:45,76.12,,0,76.12,76.12,1,-110353,37912,148265,-72441,0,0,5631,0,0,,5631,5631
34,08/24/2017,24,5:45,6:00,222.12,,0,222.12,222.12,1,-118639,27208,145847,-91431,0,0,25683,0,0,,25683,25683
34,08/24/2017,25,6:00,6:15,42.45,,0,42.45,42.45,1,-124837,59624,184461,-65213,0,0,14520,0,0,,14520,14520
34,08/24/2017,26,6:15,6:30,120.12,,0,120.12,120.12,1,-109583,52220,161803,-57363,0,0,12895,0,0,,12895,12895
34,08/24/2017,27,6:30,6:45,48.95,,0,48.95,48.95,1,-104911,65918,170829,-38993,0,0,19174,0,0,,19174,19174
34,08/24/2017,28,6:45,7:00,55.12,,0,55.12,55.12,1,-121510,72456,193966,-49054,0,0,30262,0,0,,30262,30262
34,08/24/2017,29,7:00,7:15,29.51,26.51,0,34.32,26.51,2,-82636,104223,186859,21587,0,-1412,9707,0,0,,11119,8295
34,08/24/2017,30,7:15,7:30,33.23,,0,33.23,33.23,1,-111960,70131,182091,-41829,0,0,440,0,0,,440,440
34,08/24/2017,31,7:30,7:45,176.25,,0,176.25,176.25,1,-149074,45945,195019,-103129,0,0,8321,0,0,,8321,8321
34,08/24/2017,32,7:45,8:00,199.16,,0,199.16,199.16,1,-168128,43073,211201,-125055,0,0,68210,0,0,,68210,68210
34,08/24/2017,33,8:00,8:15,48.14,,0,48.14,48.14,1,-152559,95622,248181,-56937,0,0,36830,0,0,,36830,36830
34,08/24/2017,34,8:15,8:30,226.12,,0,226.12,226.12,1,-162536,52969,215505,-109567,0,0,11328,0,0,,11328,11328
34,08/24/2017,35,8:30,8:45,226.12,,0,226.12,226.12,1,-181971,66832,248803,-115139,0,0,72378,0,0,,72378,72378
34,08/24/2017,36,8:45,9:00,188.12,,0,188.12,188.12,1,-201185,97586,298771,-103599,0,0,71866,0,0,,71866,71866
34,08/24/2017,37,9:00,9:15,148.12,,0,148.12,148.12,1,-146670,104998,251668,-41672,0,0,51867,0,0,,51867,51867
34,08/24/2017,38,9:15,9:30,,,0,34.14,34.14,0,-144694,81281,225975,-63413,0,0,2577,0,0,,2577,2577
34,08/24/2017,39,9:30,9:45,54.59,,0,54.59,54.59,1,-150344,64482,214826,-85862,0,0,8644,0,0,,8644,8644
34,08/24/2017,40,9:45,10:00,61.69,,0,61.69,61.69,1,-160982,66181,227163,-94801,0,0,25676,0,0,,25676,25676
34,08/24/2017,41,10:00,10:15,193.12,,0,193.12,193.12,1,-146513,88017,234530,-58496,0,0,31419,0,0,,31419,31419
34,08/24/2017,42,10:15,10:30,49.61,,0,49.61,49.61,1,-128185,108115,236300,-20070,0,0,23322,0,0,,23322,23322
34,08/24/2017,43,10:30,10:45,33.23,,0,33.23,33.23,1,-128823,108457,237280,-20366,0,0,5642,0,0,,5642,5642
34,08/24/2017,44,10:45,11:00,65.12,,0,65.12,65.12,1,-136620,100803,237423,-35817,0,0,11382,0,0,,11382,11382
34,08/24/2017,45,11:00,11:15,33.23,,0,33.23,33.23,1,-158615,60972,219587,-97643,0,0,7047,0,0,,7047,7047
34,08/24/2017,46,11:15,11:30,45.94,,0,45.94,45.94,1,-147657,58694,206351,-88963,0,0,11142,0,0,,11142,11142
34,08/24/2017,47,11:30,11:45,,,0,34.38,34.38,0,-138751,77452,216203,-61299,0,0,1091,0,0,,1091,1091
34,08/24/2017,48,11:45,12:00,,,0,34.38,34.38,0,-135223,89886,225109,-45337,0,0,0,0,0,,0,0
34,08/24/2017,49,12:00,12:15,,29.17,0,29.17,29.17,-1,-112952,126386,239338,13434,0,-603,0,0,0,,603,-603
34,08/24/2017,50,12:15,12:30,,29.17,0,29.17,29.17,-1,-126646,109878,236524,-16768,0,-918,0,0,0,,918,-918
34,08/24/2017,51,12:30,12:45,,27.51,0,27.51,27.51,-1,-120479,136874,257353,16395,0,-1740,0,0,0,,1740,-1740
34,08/24/2017,52,12:45,13:00,,18.51,0,18.51,18.51,-1,-122158,142769,264927,20611,0,-7223,0,0,0,,7223,-7223
34,08/24/2017,53,13:00,13:15,,16.78,0,16.78,16.78,-1,-99633,130373,230006,30740,0,-11347,0,0,0,,11347,-11347
34,08/24/2017,54,13:15,13:30,,,0,34.22,34.22,0,-130981,119037,250018,-11944,0,-12,0,0,0,,12,-12
34,08/24/2017,55,13:30,13:45,,,0,34.22,34.22,0,-127019,119098,246117,-7921,0,0,0,0,0,,0,0
34,08/24/2017,56,13:45,14:00,,39.31,0,39.31,39.31,-1,-120316,128875,249191,8559,0,-61,0,0,0,,61,-61
34,08/24/2017,57,14:00,14:15,40.54,39.33,0,40.54,40.54,1,-141907,79961,221868,-61946,0,-15,8117,0,0,,8132,8102
34,08/24/2017,58,14:15,14:30,49.86,,0,49.86,49.86,1,-107728,79577,187305,-28151,0,0,23873,0,0,,23873,23873
34,08/24/2017,59,14:30,14:45,32.32,,0,32.32,32.32,1,-98606,88325,186931,-10281,0,0,3780,0,0,,3780,3780
34,08/24/2017,60,14:45,15:00,32.32,38.51,0,38.51,38.51,-1,-101693,100708,202401,-985,0,-475,148,0,0,,623,-327
34,08/24/2017,61,15:00,15:15,,27.51,0,27.51,27.51,-1,-97843,96381,194224,-1462,0,-1054,0,0,0,,1054,-1054
34,08/24/2017,62,15:15,15:30,,38.53,0,38.53,38.53,-1,-98427,87352,185779,-11075,0,-109,0,0,0,,109,-109
34,08/24/2017,63,15:30,15:45,,27.51,0,27.51,27.51,-1,-93055,69874,162929,-23181,0,-371,0,0,0,,371,-371
34,08/24/2017,64,15:45,16:00,,,0,34.24,34.24,0,-72520,61126,133646,-11394,0,0,0,0,0,,0,0
34,08/24/2017,65,16:00,16:15,40.76,,0,40.76,40.76,1,-116026,58254,174280,-57772,0,0,9318,0,0,,9318,9318
34,08/24/2017,66,16:15,16:30,34.4,,0,34.4,34.4,1,-111564,75634,187198,-35930,0,0,11125,0,0,,11125,11125
34,08/24/2017,67,16:30,16:45,33.51,,0,33.51,33.51,1,-115836,84382,200218,-31454,0,0,9486,0,0,,9486,9486
34,08/24/2017,68,16:45,17:00,34.4,,0,34.4,34.4,1,-119949,86656,206605,-33293,0,0,7217,0,0,,7217,7217
34,08/24/2017,69,17:00,17:15,29.51,,0,29.51,29.51,1,-121637,125590,247227,3953,0,0,2868,0,0,,2868,2868
34,08/24/2017,70,17:15,17:30,64.12,,0,64.12,64.12,1,-135336,110603,245939,-24733,0,0,8232,0,0,,8232,8232
34,08/24/2017,71,17:30,17:45,34.7,,0,34.7,34.7,1,-143590,120414,264004,-23176,0,0,10885,0,0,,10885,10885
34,08/24/2017,72,17:45,18:00,81.12,,0,81.12,81.12,1,-154720,113664,268384,-41056,0,0,13996,0,0,,13996,13996
34,08/24/2017,73,18:00,18:15,,,0,34.23,34.23,0,-131021,103763,234784,-27258,0,0,3259,0,0,,3259,3259
34,08/24/2017,74,18:15,18:30,,,0,34.23,34.23,0,-127884,103980,231864,-23904,0,0,0,0,0,,0,0
34,08/24/2017,75,18:30,18:45,95.12,,0,95.12,95.12,1,-127692,88616,216308,-39076,0,0,6106,0,0,,6106,6106
34,08/24/2017,76,18:45,19:00,129.98,,0,129.98,129.98,1,-126166,99253,225419,-26913,0,0,23781,0,0,,23781,23781
34,08/24/2017,77,19:00,19:15,129.98,27.9,0,27.9,27.9,-1,-103650,111205,214855,7555,0,-751,5780,0,0,,6531,5029
34,08/24/2017,78,19:15,19:30,,,0,34.41,34.41,0,-113593,102812,216405,-10781,0,0,0,0,0,,0,0
34,08/24/2017,79,19:30,19:45,,,0,34.41,34.41,0,-123681,107275,230956,-16406,0,0,0,0,0,,0,0
34,08/24/2017,80,19:45,20:00,,,0,34.41,34.41,0,-132724,109562,242286,-23162,0,0,0,0,0,,0,0
34,08/24/2017,81,20:00,20:15,,,0,34.39,34.39,0,-68537,107267,175804,38730,0,0,0,0,0,,0,0
34,08/24/2017,82,20:15,20:30,,,0,34.39,34.39,0,-75811,83604,159415,7793,0,0,0,0,0,,0,0
34,08/24/2017,83,20:30,20:45,,,0,34.39,34.39,0,-96206,74839,171045,-21367,0,0,0,0,0,,0,0
34,08/24/2017,84,20:45,21:00,50.55,,0,50.55,50.55,1,-135048,66199,201247,-68849,0,0,1713,0,0,,1713,1713
34,08/24/2017,85,21:00,21:15,233.12,,0,233.12,233.12,1,-121730,59665,181395,-62065,0,0,49330,0,0,,49330,49330
34,08/24/2017,86,21:15,21:30,31.67,22.51,0,22.51,22.51,-1,-66389,93788,160177,27399,0,-1168,18673,0,0,,19841,17505
34,08/24/2017,87,21:30,21:45,,22.51,0,22.51,22.51,-1,-45358,93336,138694,47978,0,-8446,0,0,0,,8446,-8446
34,08/24/2017,88,21:45,22:00,,11.41,0,11.41,11.41,-1,-48719,83587,132306,34868,0,-37450,0,0,0,,37450,-37450
34,08/24/2017,89,22:00,22:15,32.32,27.9,0,34.32,27.9,2,-102379,80242,182621,-22137,0,-10631,184,0,0,,10815,-10447
34,08/24/2017,90,22:15,22:30,,19.67,0,19.67,19.67,-1,-70992,89226,160218,18234,0,-4663,0,0,0,,4663,-4663
34,08/24/2017,91,22:30,22:45,,7.2,0,7.2,7.2,-1,-45909,89210,135119,43301,0,-16076,0,0,0,,16076,-16076
34,08/24/2017,92,22:45,23:00,,-52.78,0,-52.78,-52.78,-1,-35027,111450,146477,76423,0,-12154,0,0,0,,12154,-12154
34,08/24/2017,93,23:00,23:15,130.12,-48.78,0,130.12,-48.78,2,-91831,54476,146307,-37355,0,-12938,8483,0,0,,21421,-4455
34,08/24/2017,94,23:15,23:30,33.51,,0,33.51,33.51,1,-59779,51161,110940,-8618,0,0,5922,0,0,,5922,5922
34,08/24/2017,95,23:30,23:45,33.51,28.4,0,34.31,28.4,2,-67885,64235,132120,-3650,0,-84,2067,0,0,,2151,1983
34,08/24/2017,96,23:45,0:00,,28.78,0,28.78,28.78,-1,-75022,56820,131842,-18202,0,-111,0,0,0,,111,-111
34,08/25/2017,1,0:00,0:15,,28.58,0,28.58,28.58,-1,-32218,46018,78236,13800,0,-234,0,0,0,,234,-234
34,08/25/2017,2,0:15,0:30,,39.17,0,39.17,39.17,-1,-42425,40015,82440,-2410,0,-3,0,0,0,,3,-3
34,08/25/2017,3,0:30,0:45,,28.58,0,28.58,28.58,-1,-44188,65048,109236,20860,0,-2438,0,0,0,,2438,-2438
34,08/25/2017,4,0:45,1:00,,16.54,0,16.54,16.54,-1,-39255,77534,116789,38279,0,-28997,0,0,0,,28997,-28997
34,08/25/2017,5,1:00,1:15,40.58,27.58,0,40.58,27.58,2,-37662,38625,76287,963,0,-15192,1261,0,0,,16453,-13931
34,08/25/2017,6,1:15,1:30,40.58,27.62,0,27.62,27.62,-1,-41906,45408,87314,3502,0,-561,177,0,0,,738,-384
34,08/25/2017,7,1:30,1:45,,27.58,0,27.58,27.58,-1,-56428,63559,119987,7131,0,-2336,0,0,0,,2336,-2336
34,08/25/2017,8,1:45,2:00,,21.16,0,21.16,21.16,-1,-50340,69493,119833,19153,0,-19982,0,0,0,,19982,-19982
34,08/25/2017,9,2:00,2:15,46.66,39.13,0,46.66,34.39,2,-53317,36387,89704,-16930,0,-4684,4997,0,0,,9681,313
34,08/25/2017,10,2:15,2:30,,,0,34.41,34.41,0,-29008,50929,79937,21921,0,0,287,0,0,,287,287
34,08/25/2017,11,2:30,2:45,,25.85,0,25.85,25.85,-1,-32870,55169,88039,22299,0,-997,0,0,0,,997,-997
34,08/25/2017,12,2:45,3:00,,22.48,0,22.48,22.48,-1,-34090,53882,87972,19792,0,-18190,0,0,0,,18190,-18190
34,08/25/2017,13,3:00,3:15,,27.58,0,27.58,27.58,-1,-25646,56549,82195,30903,0,-10637,0,0,0,,10637,-10637
34,08/25/2017,14,3:15,3:30,,24.19,0,24.19,24.19,-1,-31840,52500,84340,20660,0,-2533,0,0,0,,2533,-2533
34,08/25/2017,15,3:30,3:45,,23.58,0,23.58,23.58,-1,-40172,57486,97658,17314,0,-18328,0,0,0,,18328,-18328
34,08/25/2017,16,3:45,4:00,,28.03,0,28.03,28.03,-1,-45281,57040,102321,11759,0,-11359,0,0,0,,11359,-11359
34,08/25/2017,17,4:00,4:15,,24.79,0,24.79,24.79,-1,-43367,55085,98452,11718,0,-10387,0,0,0,,10387,-10387
34,08/25/2017,18,4:15,4:30,,27.58,0,27.58,27.58,-1,-43954,39652,83606,-4302,0,-9368,0,0,0,,9368,-9368
34,08/25/2017,19,4:30,4:45,,,0,34.34,34.34,0,-45893,23405,69298,-22488,0,-312,0,0,0,,312,-312
34,08/25/2017,20,4:45,5:00,,,0,34.34,34.34,0,-50182,34311,84493,-15871,0,0,0,0,0,,0,0
34,08/25/2017,21,5:00,5:15,,,0,34.35,34.35,0,-87403,49755,137158,-37648,0,0,0,0,0,,0,0
34,08/25/2017,22,5:15,5:30,,,0,34.35,34.35,0,-65681,52052,117733,-13629,0,0,0,0,0,,0,0
34,08/25/2017,23,5:30,5:45,,,0,34.32,34.32,0,-58055,34051,92106,-24004,0,0,0,0,0,,0,0
34,08/25/2017,24,5:45,6:00,,,0,34.29,34.29,0,-45320,31040,76360,-14280,0,0,0,0,0,,0,0
34,08/25/2017,25,6:00,6:15,65,,0,65,65,1,-114224,33138,147362,-81086,0,0,5450,0,0,,5450,5450
34,08/25/2017,26,6:15,6:30,38.27,,0,38.27,38.27,1,-47863,28278,76141,-19585,0,0,8659,0,0,,8659,8659
34,08/25/2017,27,6:30,6:45,73.02,,0,73.02,73.02,1,-62749,25342,88091,-37407,0,0,8350,0,0,,8350,8350
34,08/25/2017,28,6:45,7:00,35.02,,0,35.02,35.02,1,-51247,34790,86037,-16457,0,0,10024,0,0,,10024,10024
34,08/25/2017,29,7:00,7:15,35.02,39.18,0,39.18,39.18,-1,-100625,45773,146398,-54852,0,-132,19,0,0,,151,-113
34,08/25/2017,30,7:15,7:30,48.97,,0,48.97,48.97,1,-107242,46103,153345,-61139,0,0,1129,0,0,,1129,1129
34,08/25/2017,31,7:30,7:45,130.5,,0,130.5,130.5,1,-117188,61274,178462,-55914,0,0,23198,0,0,,23198,23198
34,08/25/2017,32,7:45,8:00,48.97,,0,48.97,48.97,1,-102923,101262,204185,-1661,0,0,21683,0,0,,21683,21683
34,08/25/2017,33,8:00,8:15,48.97,18.01,0,18.01,18.01,-1,-21051,93144,114195,72093,0,-2997,1110,0,0,,4107,-1887
34,08/25/2017,34,8:15,8:30,,39.18,0,39.18,39.18,-1,-23626,68469,92095,44843,0,-177,0,0,0,,177,-177
34,08/25/2017,35,8:30,8:45,,,0,34.08,34.08,0,-43006,63243,106249,20237,0,0,0,0,0,,0,0
34,08/25/2017,36,8:45,9:00,39.9,,0,39.9,39.9,1,-66194,61998,128192,-4196,0,0,915,0,0,,915,915
34,08/25/2017,37,9:00,9:15,50.67,,0,50.67,50.67,1,-63141,26244,89385,-36897,0,0,8179,0,0,,8179,8179
34,08/25/2017,38,9:15,9:30,45.49,,0,45.49,45.49,1,-78847,40037,118884,-38810,0,0,9720,0,0,,9720,9720
34,08/25/2017,39,9:30,9:45,34.02,,0,34.02,34.02,1,-75221,45266,120487,-29955,0,0,9917,0,0,,9917,9917
34,08/25/2017,40,9:45,10:00,131.02,,0,131.02,131.02,1,-120489,49831,170320,-70658,0,0,13213,0,0,,13213,13213
34,08/25/2017,41,10:00,10:15,30.69,,0,30.69,30.69,1,-75584,41404,116988,-34180,0,0,1383,0,0,,1383,1383
34,08/25/2017,42,10:15,10:30,,,0,34.97,34.97,0,-64137,53570,117707,-10567,0,0,0,0,0,,0,0
34,08/25/2017,43,10:30,10:45,,,0,34.97,34.97,0,-45453,48175,93628,2722,0,0,0,0,0,,0,0
34,08/25/2017,44,10:45,11:00,,,0,34.96,34.96,0,-49360,44611,93971,-4749,0,0,0,0,0,,0,0
34,08/25/2017,45,11:00,11:15,,28.38,0,28.38,28.38,-1,-47974,87511,135485,39537,0,-2507,0,0,0,,2507,-2507
34,08/25/2017,46,11:15,11:30,,28.36,0,28.36,28.36,-1,-48860,79238,128098,30378,0,-8095,0,0,0,,8095,-8095
34,08/25/2017,47,11:30,11:45,,27.63,0,27.63,27.63,-1,-46014,71482,117496,25468,0,-21255,0,0,0,,21255,-21255
34,08/25/2017,48,11:45,12:00,,28.69,0,28.69,28.69,-1,-45967,58685,104652,12718,0,-16293,0,0,0,,16293,-16293
34,08/25/2017,49,12:00,12:15,,28.69,0,28.69,28.69,-1,-37407,50191,87598,12784,0,-4595,0,0,0,,4595,-4595
34,08/25/2017,50,12:15,12:30,,28.42,0,28.42,28.42,-1,-42400,51404,93804,9004,0,-5497,0,0,0,,5497,-5497
34,08/25/2017,51,12:30,12:45,,28.78,0,28.78,28.78,-1,-43556,50102,93658,6546,0,-2114,0,0,0,,2114,-2114
34,08/25/2017,52,12:45,13:00,,28.97,0,28.97,28.97,-1,-44625,56585,101210,11960,0,-2890,0,0,0,,2890,-2890
34,08/25/2017,53,13:00,13:15,34.69,28.58,0,34.69,28.58,2,-47370,41955,89325,-5415,0,-1717,1776,0,0,,3493,59
34,08/25/2017,54,13:15,13:30,34.69,,0,34.69,34.69,1,-65593,35164,100757,-30429,0,0,6468,0,0,,6468,6468
34,08/25/2017,55,13:30,13:45,31.25,,0,31.25,31.25,1,-67359,32924,100283,-34435,0,0,2035,0,0,,2035,2035
34,08/25/2017,56,13:45,14:00,30.69,,0,30.69,30.69,1,-75315,28761,104076,-46554,0,0,1519,0,0,,1519,1519
34,08/25/2017,57,14:00,14:15,34.69,,0,34.69,34.69,1,-59333,43067,102400,-16266,0,0,1808,0,0,,1808,1808
34,08/25/2017,58,14:15,14:30,32.43,,0,32.43,32.43,1,-50042,32781,82823,-17261,0,0,2066,0,0,,2066,2066
34,08/25/2017,59,14:30,14:45,30.69,,0,30.69,30.69,1,-53455,35697,89152,-17758,0,0,572,0,0,,572,572
34,08/25/2017,60,14:45,15:00,,,0,32.51,32.51,0,-57619,37226,94845,-20393,0,0,0,0,0,,0,0
34,08/25/2017,61,15:00,15:15,33.54,,0,33.54,33.54,1,-53296,43475,96771,-9821,0,0,1411,0,0,,1411,1411
34,08/25/2017,62,15:15,15:30,34.9,,0,34.9,34.9,1,-54368,41441,95809,-12927,0,0,4937,0,0,,4937,4937
34,08/25/2017,63,15:30,15:45,34.92,,0,34.92,34.92,1,-55102,34005,89107,-21097,0,0,10913,0,0,,10913,10913
34,08/25/2017,64,15:45,16:00,89.02,,0,89.02,89.02,1,-67718,30911,98629,-36807,0,0,21653,0,0,,21653,21653
34,08/25/2017,65,16:00,16:15,206.02,,0,206.02,206.02,1,-90914,19556,110470,-71358,0,0,59177,0,0,,59177,59177
34,08/25/2017,66,16:15,16:30,30.69,,0,30.69,30.69,1,-51252,46592,97844,-4660,0,0,18190,0,0,,18190,18190
34,08/25/2017,67,16:30,16:45,34.69,,0,34.69,34.69,1,-45796,38857,84653,-6939,0,0,1916,0,0,,1916,1916
34,08/25/2017,68,16:45,17:00,42.04,,0,42.04,42.04,1,-50537,27081,77618,-23456,0,0,9937,0,0,,9937,9937
34,08/25/2017,69,17:00,17:15,49.89,,0,49.89,49.89,1,-57552,53512,111064,-4040,0,0,10475,0,0,,10475,10475
34,08/25/2017,70,17:15,17:30,46.41,,0,46.41,46.41,1,-59064,27905,86969,-31159,0,0,3611,0,0,,3611,3611
34,08/25/2017,71,17:30,17:45,49.89,,0,49.89,49.89,1,-60141,13260,73401,-46881,0,0,19984,0,0,,19984,19984
34,08/25/2017,72,17:45,18:00,65.02,,0,65.02,65.02,1,-57646,11871,69517,-45775,0,0,28214,0,0,,28214,28214
34,08/25/2017,73,18:00,18:15,49.98,,0,49.98,49.98,1,-57661,14811,72472,-42850,0,0,25284,0,0,,25284,25284
34,08/25/2017,74,18:15,18:30,,,0,30.48,30.48,0,-35165,20248,55413,-14917,0,0,3218,0,0,,3218,3218
34,08/25/2017,75,18:30,18:45,49.98,28.69,0,49.98,28.69,2,-31617,19991,51608,-11626,0,-5,1523,0,0,,1528,1518
34,08/25/2017,76,18:45,19:00,49.98,,0,49.98,49.98,1,-28319,20100,48419,-8219,0,0,10649,0,0,,10649,10649
34,08/25/2017,77,19:00,19:15,30.69,,0,30.69,30.69,1,-54618,18447,73065,-36171,0,0,2942,0,0,,2942,2942
34,08/25/2017,78,19:15,19:30,162.02,,0,162.02,162.02,1,-68874,19295,88169,-49579,0,0,16615,0,0,,16615,16615
34,08/25/2017,79,19:30,19:45,51.7,,0,51.7,51.7,1,-49247,23145,72392,-26102,0,0,25442,0,0,,25442,25442
34,08/25/2017,80,19:45,20:00,,,0,30.82,30.82,0,-47263,24161,71424,-23102,0,0,5625,0,0,,5625,5625
34,08/25/2017,81,20:00,20:15,,28.69,0,28.69,28.69,-1,-41818,39686,81504,-2132,0,-2,0,0,0,,2,-2
34,08/25/2017,82,20:15,20:30,,,0,30.82,30.82,0,-59947,24886,84833,-35061,0,0,0,0,0,,0,0
34,08/25/2017,83,20:30,20:45,,,0,30.82,30.82,0,-85138,25043,110181,-60095,0,0,0,0,0,,0,0
34,08/25/2017,84,20:45,21:00,32.16,,0,32.16,32.16,1,-109057,24531,133588,-84526,0,0,1579,0,0,,1579,1579
34,08/25/2017,85,21:00,21:15,212.55,,0,212.55,212.55,1,-126602,25353,151955,-101249,0,0,30657,0,0,,30657,30657
34,08/25/2017,86,21:15,21:30,115.36,,0,115.36,115.36,1,-104169,29599,133768,-74570,0,0,48627,0,0,,48627,48627
34,08/25/2017,87,21:30,21:45,115.36,27.8,0,27.8,27.8,-1,-56803,47636,104439,-9167,0,-174,3811,0,0,,3985,3637
34,08/25/2017,88,21:45,22:00,,28.25,0,28.25,28.25,-1,-58448,50899,109347,-7549,0,-692,0,0,0,,692,-692
34,08/25/2017,89,22:00,22:15,32.57,28.25,0,32.57,32.57,1,-98744,21303,120047,-77441,0,-40,1205,0,0,,1245,1165
34,08/25/2017,90,22:15,22:30,34.7,,0,34.7,34.7,1,-102915,19794,122709,-83121,0,0,5341,0,0,,5341,5341
34,08/25/2017,91,22:30,22:45,34.7,,0,34.7,34.7,1,-59036,21879,80915,-37157,0,0,3696,0,0,,3696,3696
34,08/25/2017,92,22:45,23:00,200.23,,0,239.7,239.7,1,-185002,37649,222651,-147353,0,0,36621,0,0,,36621,36621
34,08/25/2017,93,23:00,23:15,335.43,,0,368.97,368.97,1,-214189,155633,369822,-58556,0,0,63702,11250,0,,74952,74952
34,08/25/2017,94,23:15,23:30,335.43,28.65,0,28.65,28.65,-1,-169604,167399,337003,-2205,0,-93,2519,0,0,,2612,2426
34,08/25/2017,95,23:30,23:45,258.02,,0,258.02,258.02,1,-193327,110175,303502,-83152,0,0,20817,0,0,,20817,20817
34,08/25/2017,96,23:45,0:00,41.43,,0,41.43,41.43,1,-192930,114029,306959,-78901,0,0,14531,0,0,,14531,14531
35,08/26/2017,1,0:00,0:15,,6.76,0,6.76,6.76,-1,-42849,85836,128685,42987,0,-10292,0,0,0,,10292,-10292
35,08/26/2017,2,0:15,0:30,,19.86,0,19.86,19.86,-1,-27838,63931,91769,36093,0,-12946,0,0,0,,12946,-12946
35,08/26/2017,3,0:30,0:45,,19.1,0,19.1,19.1,-1,-23909,61953,85862,38044,0,-19495,0,0,0,,19495,-19495
35,08/26/2017,4,0:45,1:00,,27.89,0,27.89,27.89,-1,-84147,83616,167763,-531,0,-17201,0,0,0,,17201,-17201
35,08/26/2017,5,1:00,1:15,30.89,27.89,0,30.89,30.89,1,-57403,41271,98674,-16132,0,-7566,194,0,0,,7760,-7372
35,08/26/2017,6,1:15,1:30,31.41,27.89,0,31.41,31.41,1,-47292,43411,90703,-3881,0,-7,1130,0,0,,1137,1123
35,08/26/2017,7,1:30,1:45,,27.78,0,27.78,27.78,-1,-37344,51344,88688,14000,0,-1757,0,0,0,,1757,-1757
35,08/26/2017,8,1:45,2:00,,27.78,0,27.78,27.78,-1,-23999,56287,80286,32288,0,-16445,0,0,0,,16445,-16445
35,08/26/2017,9,2:00,2:15,31.95,31.24,0,31.95,30.68,2,-75372,18311,93683,-57061,0,-6140,836,0,0,,6976,-5304
35,08/26/2017,10,2:15,2:30,,,0,30.69,30.69,0,-59050,22071,81121,-36979,0,0,2,0,0,,2,2
35,08/26/2017,11,2:30,2:45,,,0,30.69,30.69,0,-56914,27153,84067,-29761,0,0,0,0,0,,0,0
35,08/26/2017,12,2:45,3:00,,29.31,0,29.31,29.31,-1,-47400,34273,81673,-13127,0,-50,0,0,0,,50,-50
35,08/26/2017,13,3:00,3:15,31.91,29.16,0,31.91,29.16,2,-47409,13834,61243,-33575,0,-239,174,0,0,,413,-65
35,08/26/2017,14,3:15,3:30,,,0,30.69,30.69,0,-52596,15676,68272,-36920,0,0,0,0,0,,0,0
35,08/26/2017,15,3:30,3:45,,,0,30.69,30.69,0,-38057,24677,62734,-13380,0,0,0,0,0,,0,0
35,08/26/2017,16,3:45,4:00,,,0,30.69,30.69,0,-72445,15549,87994,-56896,0,0,0,0,0,,0,0
35,08/26/2017,17,4:00,4:15,,,0,30.68,30.68,0,-20975,44005,64980,23030,0,0,0,0,0,,0,0
35,08/26/2017,18,4:15,4:30,,,0,30.69,30.69,0,-24148,62578,86726,38430,0,0,0,0,0,,0,0
35,08/26/2017,19,4:30,4:45,,27.03,0,27.03,27.03,-1,-26780,77454,104234,50674,0,-916,0,0,0,,916,-916
35,08/26/2017,20,4:45,5:00,,27.89,0,27.89,27.89,-1,-30608,59838,90446,29230,0,-570,0,0,0,,570,-570
35,08/26/2017,21,5:00,5:15,,17.02,0,17.02,17.02,-1,-123525,105816,229341,-17709,0,-6283,0,0,0,,6283,-6283
35,08/26/2017,22,5:15,5:30,,,0,30.52,30.52,0,-178826,102121,280947,-76705,0,-66,0,0,0,,66,-66
35,08/26/2017,23,5:30,5:45,30.89,,0,30.89,30.89,1,-165531,92909,258440,-72622,0,0,197,0,0,,197,197
35,08/26/2017,24,5:45,6:00,95.12,,0,95.12,95.12,1,-159825,98630,258455,-61195,0,0,10996,0,0,,10996,10996
35,08/26/2017,25,6:00,6:15,111.12,,0,111.12,111.12,1,-172865,44841,217706,-128024,0,0,24303,0,0,,24303,24303
35,08/26/2017,26,6:15,6:30,130.12,,0,130.12,130.12,1,-135139,53626,188765,-81513,0,0,66217,0,0,,66217,66217
35,08/26/2017,27,6:30,6:45,31.62,29.11,0,29.11,29.11,-1,-84205,75049,159254,-9156,0,-159,14984,0,0,,15143,14825
35,08/26/2017,28,6:45,7:00,,28.6,0,28.6,28.6,-1,-90118,63331,153449,-26787,0,-573,0,0,0,,573,-573
35,08/26/2017,29,7:00,7:15,,23.6,0,23.6,23.6,-1,-22665,63157,85822,40492,0,-6697,0,0,0,,6697,-6697
35,08/26/2017,30,7:15,7:30,,27.6,0,27.6,27.6,-1,-32945,86417,119362,53472,0,-959,0,0,0,,959,-959
35,08/26/2017,31,7:30,7:45,,27.3,0,27.3,27.3,-1,-38488,91716,130204,53228,0,-4328,0,0,0,,4328,-4328
35,08/26/2017,32,7:45,8:00,,29.15,0,29.15,29.15,-1,-59556,90392,149948,30836,0,-1212,0,0,0,,1212,-1212
35,08/26/2017,33,8:00,8:15,,28.6,0,28.6,28.6,-1,-42117,82297,124414,40180,0,-653,0,0,0,,653,-653
35,08/26/2017,34,8:15,8:30,,24.93,0,24.93,24.93,-1,-24442,76042,100484,51600,0,-2406,0,0,0,,2406,-2406
35,08/26/2017,35,8:30,8:45,,,0,30.69,30.69,0,-25939,42722,68661,16783,0,-134,0,0,0,,134,-134
35,08/26/2017,36,8:45,9:00,31.85,,0,31.85,31.85,1,-39899,31522,71421,-8377,0,0,732,0,0,,732,732
35,08/26/2017,37,9:00,9:15,,,0,30.69,30.69,0,-24546,64114,88660,39568,0,0,3,0,0,,3,3
35,08/26/2017,38,9:15,9:30,,,0,30.66,30.66,0,-28375,57625,86000,29250,0,0,0,0,0,,0,0
35,08/26/2017,39,9:30,9:45,,,0,30.65,30.65,0,-30968,57093,88061,26125,0,0,0,0,0,,0,0
35,08/26/2017,40,9:45,10:00,,,0,30.64,30.64,0,-34866,44292,79158,9426,0,0,0,0,0,,0,0
35,08/26/2017,41,10:00,10:15,,,0,30.66,30.66,0,-24847,56673,81520,31826,0,0,0,0,0,,0,0
35,08/26/2017,42,10:15,10:30,,,0,30.66,30.66,0,-31208,36426,67634,5218,0,0,0,0,0,,0,0
35,08/26/2017,43,10:30,10:45,,31.2,0,31.2,31.2,-1,-29789,47970,77759,18181,0,-29,0,0,0,,29,-29
35,08/26/2017,44,10:45,11:00,,28.53,0,28.53,28.53,-1,-25747,50634,76381,24887,0,-997,0,0,0,,997,-997
35,08/26/2017,45,11:00,11:15,,28.53,0,28.53,28.53,-1,-28653,36751,65404,8098,0,-923,0,0,0,,923,-923
35,08/26/2017,46,11:15,11:30,,,0,30.7,30.7,0,-33505,36884,70389,3379,0,0,0,0,0,,0,0
35,08/26/2017,47,11:30,11:45,,,0,30.7,30.7,0,-45231,31740,76971,-13491,0,0,0,0,0,,0,0
35,08/26/2017,48,11:45,12:00,,24.43,0,24.43,24.43,-1,-39076,60537,99613,21461,0,-3338,0,0,0,,3338,-3338
35,08/26/2017,49,12:00,12:15,42.66,31.18,0,42.66,30.65,2,-55247,21259,76506,-33988,0,-896,3719,0,0,,4615,2823
35,08/26/2017,50,12:15,12:30,32.48,,0,32.48,32.48,1,-54651,23085,77736,-31566,0,0,3766,0,0,,3766,3766
35,08/26/2017,51,12:30,12:45,33.45,,0,33.45,33.45,1,-42111,32262,74373,-9849,0,0,1300,0,0,,1300,1300
35,08/26/2017,52,12:45,13:00,33.45,31.18,0,31.18,31.18,-1,-34571,30880,65451,-3691,0,-58,28,0,0,,86,-30
35,08/26/2017,53,13:00,13:15,,31.17,0,31.17,31.17,-1,-48417,21340,69757,-27077,0,-25,0,0,0,,25,-25
35,08/26/2017,54,13:15,13:30,,,0,30.65,30.65,0,-52491,22100,74591,-30391,0,0,0,0,0,,0,0
35,08/26/2017,55,13:30,13:45,,,0,30.65,30.65,0,-53080,27867,80947,-25213,0,0,0,0,0,,0,0
35,08/26/2017,56,13:45,14:00,,28.5,0,28.5,28.5,-1,-39202,31519,70721,-7683,0,-392,0,0,0,,392,-392
35,08/26/2017,57,14:00,14:15,,,0,30.52,30.52,0,-47952,39491,87443,-8461,0,-130,0,0,0,,130,-130
35,08/26/2017,58,14:15,14:30,,,0,30.52,30.52,0,-33584,41366,74950,7782,0,0,0,0,0,,0,0
35,08/26/2017,59,14:30,14:45,29.79,,0,29.79,29.79,1,-38421,44429,82850,6008,0,0,79,0,0,,79,79
35,08/26/2017,60,14:45,15:00,30.6,,0,30.6,30.6,1,-43055,52717,95772,9662,0,0,729,0,0,,729,729
35,08/26/2017,61,15:00,15:15,34.65,,0,34.65,34.65,1,-49257,33181,82438,-16076,0,0,4952,0,0,,4952,4952
35,08/26/2017,62,15:15,15:30,30.83,,0,30.83,30.83,1,-34628,34612,69240,-16,0,0,1462,0,0,,1462,1462
35,08/26/2017,63,15:30,15:45,,,0,30.51,30.51,0,-34435,43717,78152,9282,0,0,441,0,0,,441,441
35,08/26/2017,64,15:45,16:00,,,0,30.51,30.51,0,-25817,53463,79280,27646,0,0,0,0,0,,0,0
35,08/26/2017,65,16:00,16:15,,,0,30.5,30.5,0,-20766,83719,104485,62953,0,0,0,0,0,,0,0
35,08/26/2017,66,16:15,16:30,,,0,30.68,30.68,0,-16652,77001,93653,60349,0,0,0,0,0,,0,0
35,08/26/2017,67,16:30,16:45,,,0,30.67,30.67,0,-17437,60978,78415,43541,0,0,0,0,0,,0,0
35,08/26/2017,68,16:45,17:00,,,0,30.67,30.67,0,-24582,53873,78455,29291,0,0,0,0,0,,0,0
35,08/26/2017,69,17:00,17:15,,,0,30.66,30.66,0,-59393,81330,140723,21937,0,0,0,0,0,,0,0
35,08/26/2017,70,17:15,17:30,34.6,,0,34.6,34.6,1,-57871,56455,114326,-1416,0,0,1056,0,0,,1056,1056
35,08/26/2017,71,17:30,17:45,34.6,,0,34.6,34.6,1,-53596,36221,89817,-17375,0,0,7955,0,0,,7955,7955
35,08/26/2017,72,17:45,18:00,42.82,,0,42.82,42.82,1,-57339,33301,90640,-24038,0,0,17945,0,0,,17945,17945
35,08/26/2017,73,18:00,18:15,38.12,30.75,0,30.75,30.75,-1,-74990,28408,103398,-46582,0,-86,12065,0,0,,12151,11979
35,08/26/2017,74,18:15,18:30,38.12,28.43,0,28.43,28.43,-1,-53944,30463,84407,-23481,0,-130,69,0,0,,199,-61
35,08/26/2017,75,18:30,18:45,130.12,,0,130.12,130.12,1,-58160,20208,78368,-37952,0,0,13108,0,0,,13108,13108
35,08/26/2017,76,18:45,19:00,55.12,,0,55.12,55.12,1,-48076,29565,77641,-18511,0,0,28043,0,0,,28043,28043
35,08/26/2017,77,19:00,19:15,55.12,27.6,0,27.6,27.6,-1,-38488,42921,81409,4433,0,-1351,4205,0,0,,5556,2854
35,08/26/2017,78,19:15,19:30,,28.78,0,28.78,28.78,-1,-42453,29024,71477,-13429,0,-1816,0,0,0,,1816,-1816
35,08/26/2017,79,19:30,19:45,,,0,30.65,30.65,0,-60412,28648,89060,-31764,0,-183,0,0,0,,183,-183
35,08/26/2017,80,19:45,20:00,,,0,30.65,30.65,0,-63106,30903,94009,-32203,0,0,0,0,0,,0,0
35,08/26/2017,81,20:00,20:15,,,0,30.66,30.66,0,-56453,43697,100150,-12756,0,0,0,0,0,,0,0
35,08/26/2017,82,20:15,20:30,,,0,30.66,30.66,0,-59600,40319,99919,-19281,0,0,0,0,0,,0,0
35,08/26/2017,83,20:30,20:45,,,0,30.66,30.66,0,-70619,39540,110159,-31079,0,0,0,0,0,,0,0
35,08/26/2017,84,20:45,21:00,280.12,,0,280.12,280.12,1,-112045,31368,143413,-80677,0,0,13745,0,0,,13745,13745
35,08/26/2017,85,21:00,21:15,60.12,,0,60.12,60.12,1,-40316,54004,94320,13688,0,0,24128,0,0,,24128,24128
35,08/26/2017,86,21:15,21:30,60.12,28.54,0,28.54,28.54,-1,-33220,62129,95349,28909,0,-995,689,0,0,,1684,-306
35,08/26/2017,87,21:30,21:45,,20.23,0,20.23,20.23,-1,-32888,63617,96505,30729,0,-3930,0,0,0,,3930,-3930
35,08/26/2017,88,21:45,22:00,,17.57,0,17.57,17.57,-1,-44216,67840,112056,23624,0,-13258,0,0,0,,13258,-13258
35,08/26/2017,89,22:00,22:15,,30.75,0,30.75,30.75,-1,-120242,63236,183478,-57006,0,-4098,0,0,0,,4098,-4098
35,08/26/2017,90,22:15,22:30,30.12,,0,30.12,30.12,1,-92655,65938,158593,-26717,0,0,36,0,0,,36,36
35,08/26/2017,91,22:30,22:45,,27.6,0,27.6,27.6,-1,-62703,80980,143683,18277,0,-2782,0,0,0,,2782,-2782
35,08/26/2017,92,22:45,23:00,,25.01,0,25.01,25.01,-1,-54515,98347,152862,43832,0,-11888,0,0,0,,11888,-11888
35,08/26/2017,93,23:00,23:15,69.85,27.89,0,69.85,27.89,2,-83156,55210,138366,-27946,0,-8275,3298,0,0,,11573,-4977
35,08/26/2017,94,23:15,23:30,32.49,28.6,0,28.6,28.6,-1,-49958,56851,106809,6893,0,-89,2194,0,0,,2283,2105
35,08/26/2017,95,23:30,23:45,,27.6,0,27.6,27.6,-1,-24963,65362,90325,40399,0,-1541,0,0,0,,1541,-1541
35,08/26/2017,96,23:45,0:00,,5.18,0,5.18,5.18,-1,-61751,92506,154257,30755,0,-20421,0,0,0,,20421,-20421
35,08/27/2017,1,0:00,0:15,40.95,-0.38,0,40.95,40.95,1,-31740,63479,95219,31739,0,-22945,512,0,0,,23457,-22433
35,08/27/2017,2,0:15,0:30,115.37,-0.38,0,115.37,115.37,1,-42437,8010,50447,-34427,0,-8,23250,0,0,,23258,23242
35,08/27/2017,3,0:30,0:45,115.37,27.6,0,27.6,27.6,-1,-23111,31909,55020,8798,0,-2472,648,0,0,,3120,-1824
35,08/27/2017,4,0:45,1:00,,7.93,0,7.93,7.93,-1,-28291,60820,89111,32529,0,-22228,0,0,0,,22228,-22228
35,08/27/2017,5,1:00,1:15,46.02,1.03,0,46.02,46.02,1,-42386,45210,87596,2824,0,-25670,535,0,0,,26205,-25135
35,08/27/2017,6,1:15,1:30,94.02,1.03,0,94.02,94.02,1,-38092,21530,59622,-16562,0,-68,9961,0,0,,10029,9893
35,08/27/2017,7,1:30,1:45,,,0,37.5,37.5,0,-33922,39490,73412,5568,0,0,21,0,0,,21,21
35,08/27/2017,8,1:45,2:00,,27.03,0,27.03,27.03,-1,-24048,44696,68744,20648,0,-8516,0,0,0,,8516,-8516
35,08/27/2017,9,2:00,2:15,30.6,28.6,0,30.6,30.6,1,-38110,38684,76794,574,0,-8973,45,0,0,,9018,-8928
35,08/27/2017,10,2:15,2:30,31.44,36.12,0,34.19,34.19,2,-31923,31796,63719,-127,0,-165,444,0,0,,609,279
35,08/27/2017,11,2:30,2:45,,28.6,0,28.6,28.6,-1,-33351,36427,69778,3076,0,-1690,0,0,0,,1690,-1690
35,08/27/2017,12,2:45,3:00,,27.6,0,27.6,27.6,-1,-36412,46471,82883,10059,0,-7512,0,0,0,,7512,-7512
35,08/27/2017,13,3:00,3:15,,27.6,0,27.6,27.6,-1,-40884,57412,98296,16528,0,-2146,0,0,0,,2146,-2146
35,08/27/2017,14,3:15,3:30,,38.95,0,38.95,38.95,-1,-40958,54709,95667,13751,0,-118,0,0,0,,118,-118
35,08/27/2017,15,3:30,3:45,,14.03,0,14.03,14.03,-1,-39311,66883,106194,27572,0,-8804,0,0,0,,8804,-8804
35,08/27/2017,16,3:45,4:00,,23.6,0,23.6,23.6,-1,-39462,72328,111790,32866,0,-27083,0,0,0,,27083,-27083
35,08/27/2017,17,4:00,4:15,31.78,23.6,0,31.78,31.78,1,-59613,64076,123689,4463,0,-16156,16,0,0,,16172,-16140
35,08/27/2017,18,4:15,4:30,31.82,23.6,0,31.82,31.82,1,-55152,49957,105109,-5195,0,-91,150,0,0,,241,59
35,08/27/2017,19,4:30,4:45,30.6,,0,30.6,30.6,1,-53977,49043,103020,-4934,0,0,1496,0,0,,1496,1496
35,08/27/2017,20,4:45,5:00,30.6,,0,30.6,30.6,1,-54158,53775,107933,-383,0,0,605,0,0,,605,605
35,08/27/2017,21,5:00,5:15,29.02,,0,29.02,29.02,1,-47816,56054,103870,8238,0,0,130,0,0,,130,130
35,08/27/2017,22,5:15,5:30,30.6,,0,30.6,30.6,1,-54393,51628,106021,-2765,0,0,354,0,0,,354,354
35,08/27/2017,23,5:30,5:45,31.44,,0,31.44,31.44,1,-61493,55895,117388,-5598,0,0,2038,0,0,,2038,2038
35,08/27/2017,24,5:45,6:00,31.83,,0,31.83,31.83,1,-56403,56057,112460,-346,0,0,1980,0,0,,1980,1980
35,08/27/2017,25,6:00,6:15,32.47,,0,32.47,32.47,1,-69486,52921,122407,-16565,0,0,1734,0,0,,1734,1734
35,08/27/2017,26,6:15,6:30,33.37,,0,33.37,33.37,1,-64210,48076,112286,-16134,0,0,3065,0,0,,3065,3065
35,08/27/2017,27,6:30,6:45,30.65,,0,30.65,30.65,1,-42414,45411,87825,2997,0,0,1267,0,0,,1267,1267
35,08/27/2017,28,6:45,7:00,30.65,39.3,0,39.3,39.3,-1,-36019,51191,87210,15172,0,-105,73,0,0,,178,-32
35,08/27/2017,29,7:00,7:15,,27.03,0,27.03,27.03,-1,-33825,49643,83468,15818,0,-6654,0,0,0,,6654,-6654
35,08/27/2017,30,7:15,7:30,,36.24,0,36.24,36.24,-1,-25920,54021,79941,28101,0,-6378,0,0,0,,6378,-6378
35,08/27/2017,31,7:30,7:45,,,0,34.16,34.16,0,-36018,44251,80269,8233,0,-988,0,0,0,,988,-988
35,08/27/2017,32,7:45,8:00,,,0,34.14,34.14,0,-49917,60660,110577,10743,0,0,0,0,0,,0,0
35,08/27/2017,33,8:00,8:15,,27.99,0,27.99,27.99,-1,-21859,58975,80834,37116,0,-1120,0,0,0,,1120,-1120
35,08/27/2017,34,8:15,8:30,,,0,34.18,34.18,0,-27989,51625,79614,23636,0,-159,0,0,0,,159,-159
35,08/27/2017,35,8:30,8:45,,,0,34.17,34.17,0,-31409,61875,93284,30466,0,0,0,0,0,,0,0
35,08/27/2017,36,8:45,9:00,,,0,34.15,34.15,0,-32704,65565,98269,32861,0,0,0,0,0,,0,0
35,08/27/2017,37,9:00,9:15,,,0,34.21,34.21,0,-35282,59707,94989,24425,0,0,0,0,0,,0,0
35,08/27/2017,38,9:15,9:30,,39.37,0,39.37,39.37,-1,-26269,39738,66007,13469,0,-8,0,0,0,,8,-8
35,08/27/2017,39,9:30,9:45,,26.99,0,26.99,26.99,-1,-29709,51123,80832,21414,0,-10284,0,0,0,,10284,-10284
35,08/27/2017,40,9:45,10:00,,26.99,0,26.99,26.99,-1,-28830,61203,90033,32373,0,-25264,0,0,0,,25264,-25264
35,08/27/2017,41,10:00,10:15,,27.03,0,27.03,27.03,-1,-45400,57635,103035,12235,0,-22917,0,0,0,,22917,-22917
35,08/27/2017,42,10:15,10:30,,36.3,0,36.3,36.3,-1,-44565,50186,94751,5621,0,-6710,0,0,0,,6710,-6710
35,08/27/2017,43,10:30,10:45,,37.42,0,37.42,37.42,-1,-44422,57876,102298,13454,0,-3585,0,0,0,,3585,-3585
35,08/27/2017,44,10:45,11:00,,22.99,0,22.99,22.99,-1,-39554,60634,100188,21080,0,-4655,0,0,0,,4655,-4655
35,08/27/2017,45,11:00,11:15,,-9.36,0,-9.36,-9.36,-1,-28499,57070,85569,28571,0,-35836,0,0,0,,35836,-35836
35,08/27/2017,46,11:15,11:30,,26.99,0,26.99,26.99,-1,-30844,53482,84326,22638,0,-30827,0,0,0,,30827,-30827
35,08/27/2017,47,11:30,11:45,,22.99,0,22.99,22.99,-1,-42502,57719,100221,15217,0,-26970,0,0,0,,26970,-26970
35,08/27/2017,48,11:45,12:00,32.47,38.42,0,34.25,34.25,2,-41105,34008,75113,-7097,0,-4302,502,0,0,,4804,-3800
35,08/27/2017,49,12:00,12:15,,36.43,0,36.43,36.43,-1,-24145,52192,76337,28047,0,-138,0,0,0,,138,-138
35,08/27/2017,50,12:15,12:30,,38.98,0,38.98,38.98,-1,-31365,42848,74213,11483,0,-973,0,0,0,,973,-973
35,08/27/2017,51,12:30,12:45,,38.98,0,38.98,38.98,-1,-25861,41373,67234,15512,0,-1381,0,0,0,,1381,-1381
35,08/27/2017,52,12:45,13:00,,,0,34.19,34.19,0,-30347,46745,77092,16398,0,0,0,0,0,,0,0
35,08/27/2017,53,13:00,13:15,33.99,,0,33.99,33.99,1,-50646,44946,95592,-5700,0,0,922,0,0,,922,922
35,08/27/2017,54,13:15,13:30,31.84,,0,31.84,31.84,1,-55099,47431,102530,-7668,0,0,2590,0,0,,2590,2590
35,08/27/2017,55,13:30,13:45,33.45,,0,33.45,33.45,1,-60531,48595,109126,-11936,0,0,2800,0,0,,2800,2800
35,08/27/2017,56,13:45,14:00,31.45,38.7,0,33.86,33.86,2,-43378,54883,98261,11505,0,-1,2210,0,0,,2211,2209
35,08/27/2017,57,14:00,14:15,31.45,37.47,0,37.47,37.47,-1,-25663,62083,87746,36420,0,-740,92,0,0,,832,-648
35,08/27/2017,58,14:15,14:30,,37.86,0,37.86,37.86,-1,-33098,68939,102037,35841,0,-229,0,0,0,,229,-229
35,08/27/2017,59,14:30,14:45,,37.86,0,37.86,37.86,-1,-30843,69468,100311,38625,0,-69,0,0,0,,69,-69
35,08/27/2017,60,14:45,15:00,,,0,33.44,33.44,0,-49889,68751,118640,18862,0,0,0,0,0,,0,0
35,08/27/2017,61,15:00,15:15,,37.25,0,37.25,37.25,-1,-30285,71372,101657,41087,0,-33,0,0,0,,33,-33
35,08/27/2017,62,15:15,15:30,,,0,33.14,33.14,0,-42879,65662,108541,22783,0,0,0,0,0,,0,0
35,08/27/2017,63,15:30,15:45,,,0,33.14,33.14,0,-46290,64381,110671,18091,0,0,0,0,0,,0,0
35,08/27/2017,64,15:45,16:00,,,0,33.14,33.14,0,-48528,61388,109916,12860,0,0,0,0,0,,0,0
35,08/27/2017,65,16:00,16:15,,27.99,0,27.99,27.99,-1,-36381,69829,106210,33448,0,-2631,0,0,0,,2631,-2631
35,08/27/2017,66,16:15,16:30,,14.03,0,14.03,14.03,-1,-45836,82973,128809,37137,0,-11940,0,0,0,,11940,-11940
35,08/27/2017,67,16:30,16:45,,,0,33.55,33.55,0,-52370,63084,115454,10714,0,-1822,0,0,0,,1822,-1822
35,08/27/2017,68,16:45,17:00,31.85,,0,31.85,31.85,1,-54379,37506,91885,-16873,0,0,1135,0,0,,1135,1135
35,08/27/2017,69,17:00,17:15,,,0,33.45,33.45,0,-67660,105097,172757,37437,0,0,244,0,0,,244,244
35,08/27/2017,70,17:15,17:30,,26.99,0,26.99,26.99,-1,-33608,84677,118285,51069,0,-1710,0,0,0,,1710,-1710
35,08/27/2017,71,17:30,17:45,,36.77,0,36.77,36.77,-1,-43304,87408,130712,44104,0,-1555,0,0,0,,1555,-1555
35,08/27/2017,72,17:45,18:00,29.99,36.77,0,29.99,29.99,1,-59645,72960,132605,13315,0,-93,26,0,0,,119,-67
35,08/27/2017,73,18:00,18:15,56.02,,0,56.02,56.02,1,-58183,13916,72099,-44267,0,0,5322,0,0,,5322,5322
35,08/27/2017,74,18:15,18:30,34.98,37.15,0,34.98,33.47,2,-47493,37007,84500,-10486,0,-11,495,0,0,,506,484
35,08/27/2017,75,18:30,18:45,46.8,,0,46.8,46.8,1,-45402,31587,76989,-13815,0,0,6877,0,0,,6877,6877
35,08/27/2017,76,18:45,19:00,41.2,,0,41.2,41.2,1,-43295,20000,63295,-23295,0,0,15182,0,0,,15182,15182
35,08/27/2017,77,19:00,19:15,33.02,,0,33.02,33.02,1,-45459,23477,68936,-21982,0,0,9027,0,0,,9027,9027
35,08/27/2017,78,19:15,19:30,,,0,33.91,33.91,0,-57549,16549,74098,-41000,0,0,21,0,0,,21,21
35,08/27/2017,79,19:30,19:45,30.02,,0,30.02,30.02,1,-68522,17175,85697,-51347,0,0,218,0,0,,218,218
35,08/27/2017,80,19:45,20:00,31.44,,0,31.44,31.44,1,-65241,18047,83288,-47194,0,0,1861,0,0,,1861,1861
35,08/27/2017,81,20:00,20:15,,,0,38.11,38.11,0,-39938,36978,76916,-2960,0,0,132,0,0,,132,132
35,08/27/2017,82,20:15,20:30,,,0,38.1,38.1,0,-47998,32493,80491,-15505,0,0,0,0,0,,0,0
35,08/27/2017,83,20:30,20:45,,,0,38.1,38.1,0,-50675,28221,78896,-22454,0,0,0,0,0,,0,0
35,08/27/2017,84,20:45,21:00,48.21,,0,48.21,48.21,1,-83427,18581,102008,-64846,0,0,3454,0,0,,3454,3454
35,08/27/2017,85,21:00,21:15,32.46,,0,32.46,32.46,1,-63171,26367,89538,-36804,0,0,3152,0,0,,3152,3152
35,08/27/2017,86,21:15,21:30,29.99,,0,29.99,29.99,1,-64562,22509,87071,-42053,0,0,1251,0,0,,1251,1251
35,08/27/2017,87,21:30,21:45,29.99,,0,29.99,29.99,1,-49572,26123,75695,-23449,0,0,531,0,0,,531,531
35,08/27/2017,88,21:45,22:00,,38.26,0,38.26,38.26,-1,-43665,31610,75275,-12055,0,-195,0,0,0,,195,-195
35,08/27/2017,89,22:00,22:15,156.02,39.15,0,156.02,156.02,1,-104712,13683,118395,-91029,0,-53,21691,0,0,,21744,21638
35,08/27/2017,90,22:15,22:30,56.02,,0,56.02,56.02,1,-71404,19465,90869,-51939,0,0,37952,0,0,,37952,37952
35,08/27/2017,91,22:30,22:45,56.02,28.03,0,28.03,28.03,-1,-35471,40495,75966,5024,0,-1253,9353,0,0,,10606,8100
35,08/27/2017,92,22:45,23:00,,27.99,0,27.99,27.99,-1,-42921,61598,104519,18677,0,-11032,0,0,0,,11032,-11032
35,08/27/2017,93,23:00,23:15,44.64,39.38,0,44.64,34.53,2,-77520,30884,108404,-46636,0,-3469,6128,0,0,,9597,2659
35,08/27/2017,94,23:15,23:30,31.54,31.33,0,31.33,31.33,-1,-60890,43907,104797,-16983,0,-21,5104,0,0,,5125,5083
35,08/27/2017,95,23:30,23:45,31.54,19.09,0,19.09,19.09,-1,-32722,53335,86057,20613,0,-17894,182,0,0,,18076,-17712
35,08/27/2017,96,23:45,0:00,,26.99,0,26.99,26.99,-1,-42803,65025,107828,22222,0,-30279,0,0,0,,30279,-30279
35,08/28/2017,1,0:00,0:15,31.85,27.99,0,31.85,27.99,2,-69297,29642,98939,-39655,0,-13325,855,0,0,,14180,-12470
35,08/28/2017,2,0:15,0:30,,,0,31.54,31.54,0,-46551,20516,67067,-26035,0,0,82,0,0,,82,82
35,08/28/2017,3,0:30,0:45,,33.09,0,33.09,33.09,-1,-35223,26862,62085,-8361,0,-686,0,0,0,,686,-686
35,08/28/2017,4,0:45,1:00,,24.82,0,24.82,24.82,-1,-34803,47412,82215,12609,0,-3253,0,0,0,,3253,-3253
35,08/28/2017,5,1:00,1:15,45.62,25.94,0,45.62,45.62,1,-68503,36038,104541,-32465,0,-4366,4965,0,0,,9331,599
35,08/28/2017,6,1:15,1:30,33.12,25.94,0,33.12,33.12,1,-41823,28056,69879,-13767,0,-35,6238,0,0,,6273,6203
35,08/28/2017,7,1:30,1:45,,,0,31.87,31.87,0,-32338,18160,50498,-14178,0,0,0,0,0,,0,0
35,08/28/2017,8,1:45,2:00,,33.61,0,33.61,33.61,-1,-28454,38739,67193,10285,0,-38,0,0,0,,38,-38
35,08/28/2017,9,2:00,2:15,,31.89,0,31.89,31.89,-1,-40897,28389,69286,-12508,0,-1742,0,0,0,,1742,-1742
35,08/28/2017,10,2:15,2:30,,29.78,0,29.78,29.78,-1,-37665,26653,64318,-11012,0,-325,0,0,0,,325,-325
35,08/28/2017,11,2:30,2:45,,27.99,0,27.99,27.99,-1,-29886,33545,63431,3659,0,-1147,0,0,0,,1147,-1147
35,08/28/2017,12,2:45,3:00,,33.25,0,33.25,33.25,-1,-26571,30388,56959,3817,0,-725,0,0,0,,725,-725
35,08/28/2017,13,3:00,3:15,,33.62,0,33.62,33.62,-1,-38035,41096,79131,3061,0,-192,0,0,0,,192,-192
35,08/28/2017,14,3:15,3:30,,,0,32.43,32.43,0,-36133,40541,76674,4408,0,0,0,0,0,,0,0
35,08/28/2017,15,3:30,3:45,,29.3,0,29.3,29.3,-1,-32727,41757,74484,9030,0,-282,0,0,0,,282,-282
35,08/28/2017,16,3:45,4:00,,29.37,0,29.37,29.37,-1,-22966,50324,73290,27358,0,-1404,0,0,0,,1404,-1404
35,08/28/2017,17,4:00,4:15,34.49,29.37,0,34.49,34.49,1,-48325,17345,65670,-30980,0,-8,523,0,0,,531,515
35,08/28/2017,18,4:15,4:30,39.99,,0,39.99,39.99,1,-36545,17988,54533,-18557,0,0,11267,0,0,,11267,11267
35,08/28/2017,19,4:30,4:45,29.99,,0,29.99,29.99,1,-33081,30574,63655,-2507,0,0,615,0,0,,615,615
35,08/28/2017,20,4:45,5:00,29.99,,0,29.99,29.99,1,-27998,34302,62300,6304,0,0,50,0,0,,50,50
35,08/28/2017,21,5:00,5:15,32.11,,0,32.11,32.11,1,-48873,25727,74600,-23146,0,0,223,0,0,,223,223
35,08/28/2017,22,5:15,5:30,34.8,,0,34.8,34.8,1,-53917,37659,91576,-16258,0,0,1757,0,0,,1757,1757
35,08/28/2017,23,5:30,5:45,30.12,,0,30.12,30.12,1,-39956,36311,76267,-3645,0,0,2498,0,0,,2498,2498
35,08/28/2017,24,5:45,6:00,35.54,,0,35.54,35.54,1,-63015,65846,128861,2831,0,0,2407,0,0,,2407,2407
35,08/28/2017,25,6:00,6:15,165.12,,0,165.12,165.12,1,-129489,47567,177056,-81922,0,0,23071,0,0,,23071,23071
35,08/28/2017,26,6:15,6:30,36.99,35.18,0,35.18,35.18,-1,-30376,62751,93127,32375,0,-120,9721,0,0,,9841,9601
35,08/28/2017,27,6:30,6:45,36.99,27.96,0,27.96,27.96,-1,-31007,48626,79633,17619,0,-1845,20,0,0,,1865,-1825
35,08/28/2017,28,6:45,7:00,47.99,,0,47.99,47.99,1,-78422,47337,125759,-31085,0,0,5250,0,0,,5250,5250
35,08/28/2017,29,7:00,7:15,47.99,7.08,0,7.08,7.08,-1,-29002,92451,121453,63449,0,-22203,189,0,0,,22392,-22014
35,08/28/2017,30,7:15,7:30,,31.49,0,31.49,31.49,-1,-26638,60337,86975,33699,0,-12488,0,0,0,,12488,-12488
35,08/28/2017,31,7:30,7:45,,,0,37.87,37.87,0,-35134,50387,85521,15253,0,-1798,0,0,0,,1798,-1798
35,08/28/2017,32,7:45,8:00,32.81,,0,32.81,32.81,1,-72547,54908,127455,-17639,0,0,1561,0,0,,1561,1561
35,08/28/2017,33,8:00,8:15,32.81,30.43,0,30.43,30.43,-1,-23081,76560,99641,53479,0,-705,53,0,0,,758,-652
35,08/28/2017,34,8:15,8:30,,45.76,0,45.76,45.76,-1,-28904,58855,87759,29951,0,-387,0,0,0,,387,-387
35,08/28/2017,35,8:30,8:45,,29.13,0,29.13,29.13,-1,-33130,49178,82308,16048,0,-1278,0,0,0,,1278,-1278
35,08/28/2017,36,8:45,9:00,,45.68,0,45.68,45.68,-1,-48007,57997,106004,9990,0,-1177,0,0,0,,1177,-1177
35,08/28/2017,37,9:00,9:15,,,0,37.91,37.91,0,-37929,12602,50531,-25327,0,-277,0,0,0,,277,-277
35,08/28/2017,38,9:15,9:30,39.97,,0,39.97,39.97,1,-46770,21834,68604,-24936,0,0,2619,0,0,,2619,2619
35,08/28/2017,39,9:30,9:45,31.44,,0,31.44,31.44,1,-36599,33112,69711,-3487,0,0,3115,0,0,,3115,3115
35,08/28/2017,40,9:45,10:00,29.86,,0,29.86,29.86,1,-43284,40153,83437,-3131,0,0,482,0,0,,482,482
35,08/28/2017,41,10:00,10:15,49.5,,0,49.5,49.5,1,-58324,31566,89890,-26758,0,0,8313,0,0,,8313,8313
35,08/28/2017,42,10:15,10:30,32.52,,0,32.52,32.52,1,-51985,35171,87156,-16814,0,0,4175,0,0,,4175,4175
35,08/28/2017,43,10:30,10:45,49.5,,0,49.5,49.5,1,-63018,30044,93062,-32974,0,0,12609,0,0,,12609,12609
35,08/28/2017,44,10:45,11:00,49.5,,0,49.5,49.5,1,-59285,30678,89963,-28607,0,0,22212,0,0,,22212,22212
35,08/28/2017,45,11:00,11:15,46.06,,0,46.06,46.06,1,-60719,19535,80254,-41184,0,0,20365,0,0,,20365,20365
35,08/28/2017,46,11:15,11:30,46.06,,0,46.06,46.06,1,-48005,18128,66133,-29877,0,0,26763,0,0,,26763,26763
35,08/28/2017,47,11:30,11:45,52.12,,0,52.12,52.12,1,-51190,17453,68643,-33737,0,0,21355,0,0,,21355,21355
35,08/28/2017,48,11:45,12:00,96.12,,0,96.12,96.12,1,-54445,13546,67991,-40899,0,0,32734,0,0,,32734,32734
35,08/28/2017,49,12:00,12:15,33.86,,0,33.86,33.86,1,-70411,39505,109916,-30906,0,0,17763,0,0,,17763,17763
35,08/28/2017,50,12:15,12:30,33.12,,0,33.12,33.12,1,-70523,38480,109003,-32043,0,0,4674,0,0,,4674,4674
35,08/28/2017,51,12:30,12:45,41.63,,0,41.63,41.63,1,-81817,37497,119314,-44320,0,0,5032,0,0,,5032,5032
35,08/28/2017,52,12:45,13:00,33.39,,0,33.39,33.39,1,-109899,27986,137885,-81913,0,0,4282,0,0,,4282,4282
35,08/28/2017,53,13:00,13:15,58.69,,0,58.69,58.69,1,-113801,38992,152793,-74809,0,0,5484,0,0,,5484,5484
35,08/28/2017,54,13:15,13:30,40.59,,0,40.59,40.59,1,-114511,23095,137606,-91416,0,0,16547,0,0,,16547,16547
35,08/28/2017,55,13:30,13:45,46.21,,0,46.21,46.21,1,-85878,22878,108756,-63000,0,0,21779,0,0,,21779,21779
35,08/28/2017,56,13:45,14:00,57.83,,0,57.83,57.83,1,-87054,20134,107188,-66920,0,0,23651,0,0,,23651,23651
35,08/28/2017,57,14:00,14:15,45.96,,0,45.96,45.96,1,-94104,42280,136384,-51824,0,0,35185,0,0,,35185,35185
35,08/28/2017,58,14:15,14:30,77.9,,0,77.9,77.9,1,-99154,36418,135572,-62736,0,0,39961,0,0,,39961,39961
35,08/28/2017,59,14:30,14:45,39.86,,0,39.86,39.86,1,-99794,39506,139300,-60288,0,0,30097,0,0,,30097,30097
35,08/28/2017,60,14:45,15:00,45.34,,0,45.34,45.34,1,-104612,42160,146772,-62452,0,0,36327,0,0,,36327,36327
35,08/28/2017,61,15:00,15:15,82.12,,0,82.12,82.12,1,-127516,41301,168817,-86215,0,0,37948,0,0,,37948,37948
35,08/28/2017,62,15:15,15:30,56.12,,0,56.12,56.12,1,-103893,46033,149926,-57860,0,0,30448,0,0,,30448,30448
35,08/28/2017,63,15:30,15:45,50.43,,0,50.43,50.43,1,-82265,42534,124799,-39731,0,0,17789,0,0,,17789,17789
35,08/28/2017,64,15:45,16:00,116.34,,0,116.34,116.34,1,-89330,34669,123999,-54661,0,0,34782,0,0,,34782,34782
35,08/28/2017,65,16:00,16:15,38.12,,0,38.12,38.12,1,-73098,64940,138038,-8158,0,0,17960,0,0,,17960,17960
35,08/28/2017,66,16:15,16:30,,30.43,0,30.43,30.43,-1,-68946,59736,128682,-9210,0,-223,0,0,0,,223,-223
35,08/28/2017,67,16:30,16:45,34.38,,0,34.38,34.38,1,-77620,42000,119620,-35620,0,0,325,0,0,,325,325
35,08/28/2017,68,16:45,17:00,76.12,,0,76.12,76.12,1,-84093,25804,109897,-58289,0,0,8304,0,0,,8304,8304
35,08/28/2017,69,17:00,17:15,82.29,30.91,0,30.91,30.91,-1,-66931,93453,160384,26522,0,-124,10056,0,0,,10180,9932
35,08/28/2017,70,17:15,17:30,82.29,28.89,0,28.89,28.89,-1,-70423,71707,142130,1284,0,-1469,60,0,0,,1529,-1409
35,08/28/2017,71,17:30,17:45,,,0,37.53,37.53,0,-73520,68225,141745,-5295,0,-7,0,0,0,,7,-7
35,08/28/2017,72,17:45,18:00,39.53,,0,39.53,39.53,1,-80513,62512,143025,-18001,0,0,1883,0,0,,1883,1883
35,08/28/2017,73,18:00,18:15,52.6,,0,52.6,52.6,1,-110723,29442,140165,-81281,0,0,1805,0,0,,1805,1805
35,08/28/2017,74,18:15,18:30,147.12,,0,147.12,147.12,1,-83667,33445,117112,-50222,0,0,17548,0,0,,17548,17548
35,08/28/2017,75,18:30,18:45,52.6,,0,52.6,52.6,1,-65954,37910,103864,-28044,0,0,27579,0,0,,27579,27579
35,08/28/2017,76,18:45,19:00,52.6,,0,52.6,52.6,1,-62299,49787,112086,-12512,0,0,24531,0,0,,24531,24531
35,08/28/2017,77,19:00,19:15,45,,0,45,45,1,-76220,15888,92108,-60332,0,0,13065,0,0,,13065,13065
35,08/28/2017,78,19:15,19:30,31.41,,0,31.41,31.41,1,-71170,8358,79528,-62812,0,0,1729,0,0,,1729,1729
35,08/28/2017,79,19:30,19:45,45,,0,45,45,1,-78179,8217,86396,-69962,0,0,2664,0,0,,2664,2664
35,08/28/2017,80,19:45,20:00,350.12,,0,350.12,350.12,1,-82718,13925,96643,-68793,0,0,39523,0,0,,39523,39523
35,08/28/2017,81,20:00,20:15,42.12,28.99,0,28.99,28.99,-1,-52098,76302,128400,24204,0,-134,20303,0,0,,20437,20169
35,08/28/2017,82,20:15,20:30,,28.99,0,28.99,28.99,-1,-38642,72095,110737,33453,0,-250,0,0,0,,250,-250
35,08/28/2017,83,20:30,20:45,53.59,,0,53.59,53.59,1,-85054,49032,134086,-36022,0,0,1040,0,0,,1040,1040
35,08/28/2017,84,20:45,21:00,215.12,,0,215.12,215.12,1,-120154,38637,158791,-81517,0,0,27547,0,0,,27547,27547
35,08/28/2017,85,21:00,21:15,131.12,,0,131.12,131.12,1,-101821,59479,161300,-42342,0,0,41150,0,0,,41150,41150
35,08/28/2017,86,21:15,21:30,50.26,,0,50.26,50.26,1,-79755,66427,146182,-13328,0,0,28865,0,0,,28865,28865
35,08/28/2017,87,21:30,21:45,50.26,27.61,0,27.61,27.61,-1,-55789,79046,134835,23257,0,-1828,3000,0,0,,4828,1172
35,08/28/2017,88,21:45,22:00,,19.08,0,19.08,19.08,-1,-48421,76921,125342,28500,0,-16684,0,0,0,,16684,-16684
35,08/28/2017,89,22:00,22:15,31.37,27.61,0,31.37,31.37,1,-115801,83427,199228,-32374,0,-12190,152,0,0,,12342,-12038
35,08/28/2017,90,22:15,22:30,31.55,27.61,0,31.55,31.55,1,-93451,49831,143282,-43620,0,-215,1778,0,0,,1993,1563
35,08/28/2017,91,22:30,22:45,29.86,,0,29.86,29.86,1,-72396,37464,109860,-34932,0,0,970,0,0,,970,970
35,08/28/2017,92,22:45,23:00,29.86,,0,29.86,29.86,1,-57966,36847,94813,-21119,0,0,745,0,0,,745,745
35,08/28/2017,93,23:00,23:15,50.61,,0,50.61,50.61,1,-113640,27729,141369,-85911,0,0,8356,0,0,,8356,8356
35,08/28/2017,94,23:15,23:30,31.55,,0,31.55,31.55,1,-92505,23787,116292,-68718,0,0,4039,0,0,,4039,4039
35,08/28/2017,95,23:30,23:45,40.61,,0,40.61,40.61,1,-94427,22458,116885,-71969,0,0,1929,0,0,,1929,1929
35,08/28/2017,96,23:45,0:00,30.61,,0,30.61,30.61,1,-85259,15663,100922,-69596,0,0,374,0,0,,374,374
35,08/29/2017,1,0:00,0:15,30.92,,0,30.92,30.92,1,-79553,17369,96922,-62184,0,0,326,0,0,,326,326
35,08/29/2017,2,0:15,0:30,30.02,,0,30.02,30.02,1,-61903,17388,79291,-44515,0,0,95,0,0,,95,95
35,08/29/2017,3,0:30,0:45,,,0,30.97,30.97,0,-48003,35485,83488,-12518,0,0,0,0,0,,0,0
35,08/29/2017,4,0:45,1:00,,28.03,0,28.03,28.03,-1,-51551,60932,112483,9381,0,-5938,0,0,0,,5938,-5938
35,08/29/2017,5,1:00,1:15,52.02,31.46,0,52.02,52.02,1,-57764,22804,80568,-34960,0,-2420,5767,0,0,,8187,3347
35,08/29/2017,6,1:15,1:30,72.87,,0,72.87,72.87,1,-52482,33379,85861,-19103,0,0,21292,0,0,,21292,21292
35,08/29/2017,7,1:30,1:45,72.87,30.46,0,30.46,30.46,-1,-39629,49575,89204,9946,0,-502,1137,0,0,,1639,635
35,08/29/2017,8,1:45,2:00,,26.46,0,26.46,26.46,-1,-40518,70258,110776,29740,0,-14828,0,0,0,,14828,-14828
35,08/29/2017,9,2:00,2:15,46.05,30.46,0,46.05,30.46,2,-60946,29574,90520,-31372,0,-8369,7967,0,0,,16336,-402
35,08/29/2017,10,2:15,2:30,33.52,,0,33.52,33.52,1,-66283,28049,94332,-38234,0,0,10569,0,0,,10569,10569
35,08/29/2017,11,2:30,2:45,,,0,31.27,31.27,0,-57759,38022,95781,-19737,0,0,184,0,0,,184,184
35,08/29/2017,12,2:45,3:00,,30.46,0,30.46,30.46,-1,-53839,43737,97576,-10102,0,-727,0,0,0,,727,-727
35,08/29/2017,13,3:00,3:15,37.46,30.46,0,37.46,37.46,1,-64794,21663,86457,-43131,0,-3,950,0,0,,953,947
35,08/29/2017,14,3:15,3:30,33.46,,0,33.46,33.46,1,-57318,23402,80720,-33916,0,0,1731,0,0,,1731,1731
35,08/29/2017,15,3:30,3:45,,,0,31.4,31.4,0,-53478,22139,75617,-31339,0,0,0,0,0,,0,0
35,08/29/2017,16,3:45,4:00,,,0,31.4,31.4,0,-50053,23901,73954,-26152,0,0,0,0,0,,0,0
35,08/29/2017,17,4:00,4:15,33.46,,0,33.46,33.46,1,-57189,19400,76589,-37789,0,0,779,0,0,,779,779
35,08/29/2017,18,4:15,4:30,33.54,,0,33.54,33.54,1,-60760,18380,79140,-42380,0,0,2489,0,0,,2489,2489
35,08/29/2017,19,4:30,4:45,,,0,31.61,31.61,0,-51079,16485,67564,-34594,0,0,323,0,0,,323,323
35,08/29/2017,20,4:45,5:00,32.15,,0,32.15,32.15,1,-56214,22776,78990,-33438,0,0,803,0,0,,803,803
35,08/29/2017,21,5:00,5:15,30.21,,0,30.21,30.21,1,-86535,36637,123172,-49898,0,0,834,0,0,,834,834
35,08/29/2017,22,5:15,5:30,,,0,31.68,31.68,0,-80500,32573,113073,-47927,0,0,0,0,0,,0,0
35,08/29/2017,23,5:30,5:45,43.46,,0,43.46,43.46,1,-86137,32068,118205,-54069,0,0,8640,0,0,,8640,8640
35,08/29/2017,24,5:45,6:00,43.46,,0,43.46,43.46,1,-65511,51380,116891,-14131,0,0,24005,0,0,,24005,24005
35,08/29/2017,25,6:00,6:15,43.46,32.6,0,32.6,32.6,-1,-60253,58490,118743,-1763,0,-363,3255,0,0,,3618,2892
35,08/29/2017,26,6:15,6:30,,33.26,0,33.26,33.26,-1,-45267,49784,95051,4517,0,-227,0,0,0,,227,-227
35,08/29/2017,27,6:30,6:45,37.46,33.42,0,37.46,31.72,2,-58350,28868,87218,-29482,0,-212,1280,0,0,,1492,1068
35,08/29/2017,28,6:45,7:00,37.46,,0,37.46,37.46,1,-63323,43132,106455,-20191,0,0,5519,0,0,,5519,5519
35,08/29/2017,29,7:00,7:15,37.46,25.26,0,25.26,25.26,-1,-45993,105532,151525,59539,0,-6885,902,0,0,,7787,-5983
35,08/29/2017,30,7:15,7:30,,,0,38.12,38.12,0,-24008,61190,85198,37182,0,-70,0,0,0,,70,-70
35,08/29/2017,31,7:30,7:45,48.07,,0,48.07,48.07,1,-57173,43822,100995,-13351,0,0,1238,0,0,,1238,1238
35,08/29/2017,32,7:45,8:00,186.46,,0,186.46,186.46,1,-93845,50609,144454,-43236,0,0,29768,0,0,,29768,29768
35,08/29/2017,33,8:00,8:15,36.63,10.52,0,38.13,10.52,2,-19444,70723,90167,51279,0,-10099,11058,0,0,,21157,959
35,08/29/2017,34,8:15,8:30,34.67,29.03,0,38.13,29.03,2,-44588,40862,85450,-3726,0,-7207,523,0,0,,7730,-6684
35,08/29/2017,35,8:30,8:45,51.54,,0,51.54,51.54,1,-66181,38876,105057,-27305,0,0,12577,0,0,,12577,12577
35,08/29/2017,36,8:45,9:00,48.59,,0,48.59,48.59,1,-88566,46867,135433,-41699,0,0,28645,0,0,,28645,28645
35,08/29/2017,37,9:00,9:15,33.46,30.46,0,38.16,30.46,2,-43980,87194,131174,43214,0,-664,11422,0,0,,12086,10758
35,08/29/2017,38,9:15,9:30,,,0,38.16,38.16,0,-60419,86834,147253,26415,0,-11,0,0,0,,11,-11
35,08/29/2017,39,9:30,9:45,,,0,38.17,38.17,0,-71536,89691,161227,18155,0,0,0,0,0,,0,0
35,08/29/2017,40,9:45,10:00,,,0,38.16,38.16,0,-71840,87779,159619,15939,0,0,0,0,0,,0,0
35,08/29/2017,41,10:00,10:15,,,0,30.81,30.81,0,-62482,54075,116557,-8407,0,0,0,0,0,,0,0
35,08/29/2017,42,10:15,10:30,32.02,,0,32.02,32.02,1,-70029,55725,125754,-14304,0,0,713,0,0,,713,713
35,08/29/2017,43,10:30,10:45,33.46,,0,33.46,33.46,1,-69173,49165,118338,-20008,0,0,2370,0,0,,2370,2370
35,08/29/2017,44,10:45,11:00,32.41,,0,32.41,32.41,1,-69071,48573,117644,-20498,0,0,1171,0,0,,1171,1171
35,08/29/2017,45,11:00,11:15,31.82,,0,31.82,31.82,1,-72152,47828,119980,-24324,0,0,865,0,0,,865,865
35,08/29/2017,46,11:15,11:30,33.46,,0,33.46,33.46,1,-69897,48541,118438,-21356,0,0,917,0,0,,917,917
35,08/29/2017,47,11:30,11:45,37.46,,0,37.46,37.46,1,-75235,45722,120957,-29513,0,0,4968,0,0,,4968,4968
35,08/29/2017,48,11:45,12:00,37.46,,0,37.46,37.46,1,-65182,49016,114198,-16166,0,0,6012,0,0,,6012,6012
35,08/29/2017,49,12:00,12:15,43.6,,0,43.6,43.6,1,-88301,81639,169940,-6662,0,0,4273,0,0,,4273,4273
35,08/29/2017,50,12:15,12:30,48.59,28.08,0,48.59,28.08,2,-81669,89977,171646,8308,0,-437,10806,0,0,,11243,10369
35,08/29/2017,51,12:30,12:45,48.59,28.41,0,28.41,28.41,-1,-72990,101773,174763,28783,0,-1460,97,0,0,,1557,-1363
35,08/29/2017,52,12:45,13:00,,26.46,0,26.46,26.46,-1,-69545,98219,167764,28674,0,-14457,0,0,0,,14457,-14457
35,08/29/2017,53,13:00,13:15,,29,0,29,29,-1,-56363,109334,165697,52971,0,-11048,0,0,0,,11048,-11048
35,08/29/2017,54,13:15,13:30,,,0,30.81,30.81,0,-70012,87657,157669,17645,0,-35,0,0,0,,35,-35
35,08/29/2017,55,13:30,13:45,,31.46,0,31.46,31.46,-1,-77054,88048,165102,10994,0,-184,0,0,0,,184,-184
35,08/29/2017,56,13:45,14:00,,31.46,0,31.46,31.46,-1,-89832,90323,180155,491,0,-365,0,0,0,,365,-365
35,08/29/2017,57,14:00,14:15,30.51,31.46,0,30.81,30.81,2,-99814,87189,187003,-12625,0,-90,403,0,0,,493,313
35,08/29/2017,58,14:15,14:30,30.02,,0,30.02,30.02,1,-79054,88991,168045,9937,0,0,162,0,0,,162,162
35,08/29/2017,59,14:30,14:45,34.83,,0,34.83,34.83,1,-88244,81935,170179,-6309,0,0,504,0,0,,504,504
35,08/29/2017,60,14:45,15:00,,,0,30.81,30.81,0,-91206,85298,176504,-5908,0,0,112,0,0,,112,112
35,08/29/2017,61,15:00,15:15,,,0,30.81,30.81,0,-94047,97116,191163,3069,0,0,0,0,0,,0,0
35,08/29/2017,62,15:15,15:30,,30.46,0,30.46,30.46,-1,-87161,80014,167175,-7147,0,-428,0,0,0,,428,-428
35,08/29/2017,63,15:30,15:45,,,0,30.81,30.81,0,-104086,59306,163392,-44780,0,0,0,0,0,,0,0
35,08/29/2017,64,15:45,16:00,152.02,,0,152.02,152.02,1,-112675,51292,163967,-61383,0,0,16764,0,0,,16764,16764
35,08/29/2017,65,16:00,16:15,43.68,,0,43.68,43.68,1,-90293,82314,172607,-7979,0,0,13165,0,0,,13165,13165
35,08/29/2017,66,16:15,16:30,36.63,,0,36.63,36.63,1,-70538,68243,138781,-2295,0,0,2485,0,0,,2485,2485
35,08/29/2017,67,16:30,16:45,30.73,,0,30.73,30.73,1,-74570,52369,126939,-22201,0,0,1493,0,0,,1493,1493
35,08/29/2017,68,16:45,17:00,35.25,,0,35.25,35.25,1,-72556,44041,116597,-28515,0,0,633,0,0,,633,633
35,08/29/2017,69,17:00,17:15,51.47,,0,51.47,51.47,1,-97841,40493,138334,-57348,0,0,6896,0,0,,6896,6896
35,08/29/2017,70,17:15,17:30,33.02,,0,33.02,33.02,1,-63233,40272,103505,-22961,0,0,3471,0,0,,3471,3471
35,08/29/2017,71,17:30,17:45,40.47,,0,40.47,40.47,1,-58639,46611,105250,-12028,0,0,1657,0,0,,1657,1657
35,08/29/2017,72,17:45,18:00,51.47,,0,51.47,51.47,1,-72291,44009,116300,-28282,0,0,21550,0,0,,21550,21550
35,08/29/2017,73,18:00,18:15,55.01,,0,55.01,55.01,1,-98685,59626,158311,-39059,0,0,28421,0,0,,28421,28421
35,08/29/2017,74,18:15,18:30,30.73,30.04,0,37.24,30.04,2,-71850,69414,141264,-2436,0,-398,6637,0,0,,7035,6239
35,08/29/2017,75,18:30,18:45,35.63,,0,35.63,35.63,1,-76603,68566,145169,-8037,0,0,1228,0,0,,1228,1228
35,08/29/2017,76,18:45,19:00,44.01,,0,44.01,44.01,1,-73299,64715,138014,-8584,0,0,4401,0,0,,4401,4401
35,08/29/2017,77,19:00,19:15,32.8,,0,32.8,32.8,1,-90069,57263,147332,-32806,0,0,1828,0,0,,1828,1828
35,08/29/2017,78,19:15,19:30,,,0,37.55,37.55,0,-83941,42594,126535,-41347,0,0,5,0,0,,5,5
35,08/29/2017,79,19:30,19:45,,,0,37.57,37.57,0,-74265,33468,107733,-40797,0,0,0,0,0,,0,0
35,08/29/2017,80,19:45,20:00,,,0,37.57,37.57,0,-68159,38789,106948,-29370,0,0,0,0,0,,0,0
35,08/29/2017,81,20:00,20:15,,,0,37.94,37.94,0,-67206,44982,112188,-22224,0,0,0,0,0,,0,0
35,08/29/2017,82,20:15,20:30,,,0,37.94,37.94,0,-74445,36268,110713,-38177,0,0,0,0,0,,0,0
35,08/29/2017,83,20:30,20:45,43.59,,0,43.59,43.59,1,-112939,28452,141391,-84487,0,0,1529,0,0,,1529,1529
35,08/29/2017,84,20:45,21:00,44.98,,0,44.98,44.98,1,-133013,22661,155674,-110352,0,0,9096,0,0,,9096,9096
35,08/29/2017,85,21:00,21:15,51.87,,0,51.87,51.87,1,-106018,32384,138402,-73634,0,0,11754,0,0,,11754,11754
35,08/29/2017,86,21:15,21:30,51.87,,0,51.87,51.87,1,-84475,44935,129410,-39540,0,0,11726,0,0,,11726,11726
35,08/29/2017,87,21:30,21:45,30.73,,0,30.73,30.73,1,-48182,48771,96953,589,0,0,3502,0,0,,3502,3502
35,08/29/2017,88,21:45,22:00,30.73,28.73,0,28.73,28.73,-1,-30846,50252,81098,19406,0,-454,136,0,0,,590,-318
35,08/29/2017,89,22:00,22:15,,27.73,0,27.73,27.73,-1,-85723,56779,142502,-28944,0,-1044,0,0,0,,1044,-1044
35,08/29/2017,90,22:15,22:30,,,0,38.23,38.23,0,-77342,48931,126273,-28411,0,0,0,0,0,,0,0
35,08/29/2017,91,22:30,22:45,30.73,,0,30.73,30.73,1,-56759,43408,100167,-13351,0,0,101,0,0,,101,101
35,08/29/2017,92,22:45,23:00,30.02,31.39,0,38.25,31.39,2,-61792,59542,121334,-2250,0,-35,174,0,0,,209,139
35,08/29/2017,93,23:00,23:15,33.46,28.16,0,33.46,28.16,2,-65233,48284,113517,-16949,0,-220,832,0,0,,1052,612
35,08/29/2017,94,23:15,23:30,37.46,,0,37.46,37.46,1,-68507,38151,106658,-30356,0,0,1123,0,0,,1123,1123
35,08/29/2017,95,23:30,23:45,,31.46,0,31.46,31.46,-1,-62695,39546,102241,-23149,0,-167,0,0,0,,167,-167
35,08/29/2017,96,23:45,0:00,,31.46,0,31.46,31.46,-1,-64788,37172,101960,-27616,0,-1,0,0,0,,1,-1
35,08/30/2017,1,0:00,0:15,,30.46,0,30.46,30.46,-1,-87360,74625,161985,-12735,0,-202,0,0,0,,202,-202
35,08/30/2017,2,0:15,0:30,,,0,32.06,32.06,0,-74759,45703,120462,-29056,0,0,0,0,0,,0,0
35,08/30/2017,3,0:30,0:45,,,0,32.06,32.06,0,-69315,32899,102214,-36416,0,0,0,0,0,,0,0
35,08/30/2017,4,0:45,1:00,,31.46,0,31.46,31.46,-1,-45566,47055,92621,1489,0,-782,0,0,0,,782,-782
35,08/30/2017,5,1:00,1:15,43.46,26.46,0,43.46,26.46,2,-56514,34674,91188,-21840,0,-4345,1299,0,0,,5644,-3046
35,08/30/2017,6,1:15,1:30,82.3,26.46,0,82.3,82.3,1,-68414,36802,105216,-31612,0,-2,20314,0,0,,20316,20312
35,08/30/2017,7,1:30,1:45,,,0,32.06,32.06,0,-50278,48988,99266,-1290,0,0,545,0,0,,545,545
35,08/30/2017,8,1:45,2:00,,17.78,0,17.78,17.78,-1,-42032,66267,108299,24235,0,-11395,0,0,0,,11395,-11395
35,08/30/2017,9,2:00,2:15,30.1,33.22,0,30.1,30.1,1,-66616,57773,124389,-8843,0,-6607,118,0,0,,6725,-6489
35,08/30/2017,10,2:15,2:30,30.1,,0,30.1,30.1,1,-55577,60477,116054,4900,0,0,250,0,0,,250,250
35,08/30/2017,11,2:30,2:45,30.13,,0,30.13,30.13,1,-47866,64168,112034,16302,0,0,192,0,0,,192,192
35,08/30/2017,12,2:45,3:00,,30.46,0,30.46,30.46,-1,-44732,60894,105626,16162,0,-6530,0,0,0,,6530,-6530
35,08/30/2017,13,3:00,3:15,33.46,31.46,0,33.46,31.46,2,-65758,42460,108218,-23298,0,-5218,488,0,0,,5706,-4730
35,08/30/2017,14,3:15,3:30,40.57,31.46,0,40.57,40.57,1,-56228,30043,86271,-26185,0,-15,8979,0,0,,8994,8964
35,08/30/2017,15,3:30,3:45,36.67,,0,36.67,36.67,1,-55506,23341,78847,-32165,0,0,12092,0,0,,12092,12092
35,08/30/2017,16,3:45,4:00,33.46,,0,33.46,33.46,1,-46517,30228,76745,-16289,0,0,8278,0,0,,8278,8278
35,08/30/2017,17,4:00,4:15,33.46,34.75,0,34.75,34.75,-1,-53359,28706,82065,-24653,0,-193,82,0,0,,275,-111
35,08/30/2017,18,4:15,4:30,,,0,32.44,32.44,0,-56070,38953,95023,-17117,0,0,0,0,0,,0,0
35,08/30/2017,19,4:30,4:45,,,0,32.44,32.44,0,-61369,64489,125858,3120,0,0,0,0,0,,0,0
35,08/30/2017,20,4:45,5:00,,,0,32.44,32.44,0,-60428,61857,122285,1429,0,0,0,0,0,,0,0
35,08/30/2017,21,5:00,5:15,,34.15,0,34.15,34.15,-1,-37159,66485,103644,29326,0,-164,0,0,0,,164,-164
35,08/30/2017,22,5:15,5:30,,32.34,0,32.34,32.34,-1,-48126,47522,95648,-604,0,-641,0,0,0,,641,-641
35,08/30/2017,23,5:30,5:45,56.12,,0,56.12,56.12,1,-78052,42369,120421,-35683,0,0,14864,0,0,,14864,14864
35,08/30/2017,24,5:45,6:00,64.45,,0,64.45,64.45,1,-98909,46093,145002,-52816,0,0,46868,0,0,,46868,46868
35,08/30/2017,25,6:00,6:15,43.24,32.24,0,32.24,32.24,-1,-86293,48876,135169,-37417,0,-13,17852,0,0,,17865,17839
35,08/30/2017,26,6:15,6:30,31.85,,0,31.85,31.85,1,-83965,63141,147106,-20824,0,0,8,0,0,,8,8
35,08/30/2017,27,6:30,6:45,70.72,,0,70.72,70.72,1,-122450,28710,151160,-93740,0,0,4975,0,0,,4975,4975
35,08/30/2017,28,6:45,7:00,95.12,,0,95.12,95.12,1,-82213,56288,138501,-25925,0,0,18992,0,0,,18992,18992
35,08/30/2017,29,7:00,7:15,95.12,30.24,0,30.24,30.24,-1,-60094,80581,140675,20487,0,-2181,1184,0,0,,3365,-997
35,08/30/2017,30,7:15,7:30,,35.34,0,35.34,35.34,-1,-71562,75188,146750,3626,0,-1394,0,0,0,,1394,-1394
35,08/30/2017,31,7:30,7:45,48,35.34,0,48,48,1,-100175,67290,167465,-32885,0,-38,569,0,0,,607,531
35,08/30/2017,32,7:45,8:00,209.05,,0,209.05,209.05,1,-141943,77738,219681,-64205,0,0,40347,0,0,,40347,40347
35,08/30/2017,33,8:00,8:15,33.24,35.61,0,35.61,35.61,-1,-65189,155596,220785,90407,0,-134,12047,0,0,,12181,11913
35,08/30/2017,34,8:15,8:30,,35.59,0,35.59,35.59,-1,-91025,101904,192929,10879,0,-478,0,0,0,,478,-478
35,08/30/2017,35,8:30,8:45,50.43,,0,50.43,50.43,1,-116591,89867,206458,-26724,0,0,4331,0,0,,4331,4331
35,08/30/2017,36,8:45,9:00,82.12,,0,82.12,82.12,1,-141350,106758,248108,-34592,0,0,31463,0,0,,31463,31463
35,08/30/2017,37,9:00,9:15,38.97,34.88,0,34.88,34.88,-1,-108805,120105,228910,11300,0,-79,16270,0,0,,16349,16191
35,08/30/2017,38,9:15,9:30,89.12,32.37,0,89.12,89.12,1,-133410,101517,234927,-31893,0,-16,5877,0,0,,5893,5861
35,08/30/2017,39,9:30,9:45,139.12,,0,139.12,139.12,1,-142034,110821,252855,-31213,0,0,30118,0,0,,30118,30118
35,08/30/2017,40,9:45,10:00,169.64,,0,169.64,169.64,1,-163792,110331,274123,-53461,0,0,29749,0,0,,29749,29749
35,08/30/2017,41,10:00,10:15,49.39,,0,49.39,49.39,1,-145982,134419,280401,-11563,0,0,27982,0,0,,27982,27982
35,08/30/2017,42,10:15,10:30,49.39,31.99,0,31.99,31.99,-1,-130447,141299,271746,10852,0,-762,2644,0,0,,3406,1882
35,08/30/2017,43,10:30,10:45,,,0,38.05,38.05,0,-112379,164871,277250,52492,0,0,0,0,0,,0,0
35,08/30/2017,44,10:45,11:00,,,0,38.06,38.06,0,-82317,168980,251297,86663,0,0,0,0,0,,0,0
35,08/30/2017,45,11:00,11:15,,-31.21,0,-31.21,-31.21,-1,-80629,152971,233600,72342,0,-18768,0,0,0,,18768,-18768
35,08/30/2017,46,11:15,11:30,,31.24,0,31.24,31.24,-1,-82292,144148,226440,61856,0,-4511,0,0,0,,4511,-4511
35,08/30/2017,47,11:30,11:45,,,0,32.21,32.21,0,-76994,148896,225890,71902,0,0,0,0,0,,0,0
35,08/30/2017,48,11:45,12:00,,,0,32.2,32.2,0,-98194,121088,219282,22894,0,0,0,0,0,,0,0
35,08/30/2017,49,12:00,12:15,31.96,,0,31.96,31.96,1,-97184,91999,189183,-5185,0,0,520,0,0,,520,520
35,08/30/2017,50,12:15,12:30,31.96,,0,31.96,31.96,1,-94482,90943,185425,-3539,0,0,1710,0,0,,1710,1710
35,08/30/2017,51,12:30,12:45,33.24,,0,33.24,33.24,1,-90695,82656,173351,-8039,0,0,1942,0,0,,1942,1942
35,08/30/2017,52,12:45,13:00,32.87,,0,32.87,32.87,1,-99964,82808,182772,-17156,0,0,2535,0,0,,2535,2535
35,08/30/2017,53,13:00,13:15,121.12,,0,121.12,121.12,1,-142170,51764,193934,-90406,0,0,16550,0,0,,16550,16550
35,08/30/2017,54,13:15,13:30,43.24,,0,43.24,43.24,1,-143413,61077,204490,-82336,0,0,26696,0,0,,26696,26696
35,08/30/2017,55,13:30,13:45,62.97,,0,62.97,62.97,1,-143664,65791,209455,-77873,0,0,4857,0,0,,4857,4857
35,08/30/2017,56,13:45,14:00,83.37,,0,83.37,83.37,1,-142258,64859,207117,-77399,0,0,18622,0,0,,18622,18622
35,08/30/2017,57,14:00,14:15,153.88,,0,153.88,153.88,1,-148967,70323,219290,-78644,0,0,16843,0,0,,16843,16843
35,08/30/2017,58,14:15,14:30,164.12,,0,164.12,164.12,1,-144447,91705,236152,-52742,0,0,50966,0,0,,50966,50966
35,08/30/2017,59,14:30,14:45,33.24,,0,33.24,33.24,1,-128375,113025,241400,-15350,0,0,8660,0,0,,8660,8660
35,08/30/2017,60,14:45,15:00,33.24,,0,33.24,33.24,1,-115685,96145,211830,-19540,0,0,1036,0,0,,1036,1036
35,08/30/2017,61,15:00,15:15,43.24,,0,43.24,43.24,1,-124219,95863,220082,-28356,0,0,8925,0,0,,8925,8925
35,08/30/2017,62,15:15,15:30,33.24,,0,33.24,33.24,1,-117076,99038,216114,-18038,0,0,9561,0,0,,9561,9561
35,08/30/2017,63,15:30,15:45,,,0,32.06,32.06,0,-111981,88452,200433,-23529,0,0,140,0,0,,140,140
35,08/30/2017,64,15:45,16:00,43.24,,0,43.24,43.24,1,-123802,67806,191608,-55996,0,0,1569,0,0,,1569,1569
35,08/30/2017,65,16:00,16:15,60.12,,0,60.12,60.12,1,-134431,88559,222990,-45872,0,0,11197,0,0,,11197,11197
35,08/30/2017,66,16:15,16:30,,,0,32.06,32.06,0,-128189,85879,214068,-42310,0,0,635,0,0,,635,635
35,08/30/2017,67,16:30,16:45,,,0,32.06,32.06,0,-127057,83752,210809,-43305,0,0,0,0,0,,0,0
35,08/30/2017,68,16:45,17:00,,,0,32.06,32.06,0,-135902,73657,209559,-62245,0,0,0,0,0,,0,0
35,08/30/2017,69,17:00,17:15,151.12,,0,151.12,151.12,1,-166338,57935,224273,-108403,0,0,9807,0,0,,9807,9807
35,08/30/2017,70,17:15,17:30,33.22,,0,33.22,33.22,1,-137164,63284,200448,-73880,0,0,6926,0,0,,6926,6926
35,08/30/2017,71,17:30,17:45,,,0,38.16,38.16,0,-131866,74335,206201,-57531,0,0,53,0,0,,53,53
35,08/30/2017,72,17:45,18:00,,,0,38.16,38.16,0,-113967,76064,190031,-37903,0,0,0,0,0,,0,0
35,08/30/2017,73,18:00,18:15,,,0,38.14,38.14,0,-145250,75689,220939,-69561,0,0,0,0,0,,0,0
35,08/30/2017,74,18:15,18:30,,,0,38.14,38.14,0,-103744,83199,186943,-20545,0,0,0,0,0,,0,0
35,08/30/2017,75,18:30,18:45,,30.24,0,30.24,30.24,-1,-88880,113691,202571,24811,0,-1785,0,0,0,,1785,-1785
35,08/30/2017,76,18:45,19:00,,33.99,0,33.99,33.99,-1,-88393,115737,204130,27344,0,-250,0,0,0,,250,-250
35,08/30/2017,77,19:00,19:15,,28.78,0,28.78,28.78,-1,-118659,106092,224751,-12567,0,-3095,0,0,0,,3095,-3095
35,08/30/2017,78,19:15,19:30,,,0,38.14,38.14,0,-142568,127275,269843,-15293,0,-61,0,0,0,,61,-61
35,08/30/2017,79,19:30,19:45,,30.24,0,30.24,30.24,-1,-136627,192689,329316,56062,0,-765,0,0,0,,765,-765
35,08/30/2017,80,19:45,20:00,,29.17,0,29.17,29.17,-1,-134024,222240,356264,88216,0,-1554,0,0,0,,1554,-1554
35,08/30/2017,81,20:00,20:15,,3.62,0,3.62,3.62,-1,-67524,193947,261471,126423,0,-7863,0,0,0,,7863,-7863
35,08/30/2017,82,20:15,20:30,,-13.98,0,-13.98,-13.98,-1,-79746,155901,235647,76155,0,-26667,0,0,0,,26667,-26667
35,08/30/2017,83,20:30,20:45,,2.97,0,2.97,2.97,-1,-85210,162827,248037,77617,0,-25420,0,0,0,,25420,-25420
35,08/30/2017,84,20:45,21:00,,-22.03,0,-22.03,-22.03,-1,-81517,170183,251700,88666,0,-60388,0,0,0,,60388,-60388
35,08/30/2017,85,21:00,21:15,,-57.9,0,-57.9,-57.9,-1,-28734,166996,195730,138262,0,-40121,0,0,0,,40121,-40121
35,08/30/2017,86,21:15,21:30,,-53.78,0,-53.78,-53.78,-1,-16484,209371,225855,192887,0,-29504,0,0,0,,29504,-29504
35,08/30/2017,87,21:30,21:45,,-54.86,0,-54.86,-54.86,-1,-15442,193950,209392,178508,0,-127687,0,0,0,,127687,-127687
35,08/30/2017,88,21:45,22:00,,-61.78,0,-61.78,-61.78,-1,-25988,273875,299863,247887,0,-147056,0,0,0,,147056,-147056
35,08/30/2017,89,22:00,22:15,,-63.59,0,-63.59,-63.59,-1,-64994,191485,256479,126491,0,-126179,0,0,0,,126179,-126179
35,08/30/2017,90,22:15,22:30,,-21.02,0,-21.02,-21.02,-1,-57333,118425,175758,61092,0,-46495,0,0,0,,46495,-46495
35,08/30/2017,91,22:30,22:45,,-9.83,0,-9.83,-9.83,-1,-49929,112914,162843,62985,0,-62058,0,0,0,,62058,-62058
35,08/30/2017,92,22:45,23:00,,-30.63,0,-30.63,-30.63,-1,-59826,155889,215715,96063,0,-72906,0,0,0,,72906,-72906
35,08/30/2017,93,23:00,23:15,54.98,-7.78,0,54.98,54.98,1,-102047,102295,204342,248,0,-49366,629,0,0,,49995,-48737
35,08/30/2017,94,23:15,23:30,151.12,14.81,0,151.12,14.81,2,-83181,107545,190726,24364,0,-2614,5470,0,0,,8084,2856
35,08/30/2017,95,23:30,23:45,,-63.1,0,-63.1,-63.1,-1,-89689,149616,239305,59927,0,-43770,0,0,0,,43770,-43770
35,08/30/2017,96,23:45,0:00,,22.24,0,22.24,22.24,-1,-104434,155359,259793,50925,0,-21409,0,0,0,,21409,-21409
35,08/31/2017,1,0:00,0:15,,9.57,0,9.57,9.57,-1,-50904,119614,170518,68710,0,-35564,0,0,0,,35564,-35564
35,08/31/2017,2,0:15,0:30,,18.82,0,18.82,18.82,-1,-48943,130662,179605,81719,0,-29171,0,0,0,,29171,-29171
35,08/31/2017,3,0:30,0:45,,3.28,0,3.28,3.28,-1,-59463,136384,195847,76921,0,-58275,0,0,0,,58275,-58275
35,08/31/2017,4,0:45,1:00,,11.88,0,11.88,11.88,-1,-65089,129139,194228,64050,0,-70800,0,0,0,,70800,-70800
35,08/31/2017,5,1:00,1:15,40.18,11.88,0,40.18,40.18,1,-71655,78073,149728,6418,0,-28154,996,0,0,,29150,-27158
35,08/31/2017,6,1:15,1:30,40.18,,0,40.18,40.18,1,-55914,79382,135296,23468,0,0,2433,0,0,,2433,2433
35,08/31/2017,7,1:30,1:45,,24.13,0,24.13,24.13,-1,-46841,84281,131122,37440,0,-7599,0,0,0,,7599,-7599
35,08/31/2017,8,1:45,2:00,,24.13,0,24.13,24.13,-1,-44156,70965,115121,26809,0,-24965,0,0,0,,24965,-24965
35,08/31/2017,9,2:00,2:15,,23.18,0,23.18,23.18,-1,-37703,114294,151997,76591,0,-18743,0,0,0,,18743,-18743
35,08/31/2017,10,2:15,2:30,,9.04,0,9.04,9.04,-1,-35037,89482,124519,54445,0,-34523,0,0,0,,34523,-34523
35,08/31/2017,11,2:30,2:45,,23.18,0,23.18,23.18,-1,-34837,81497,116334,46660,0,-46202,0,0,0,,46202,-46202
35,08/31/2017,12,2:45,3:00,,15.27,0,15.27,15.27,-1,-31712,91955,123667,60243,0,-55577,0,0,0,,55577,-55577
35,08/31/2017,13,3:00,3:15,,22.56,0,22.56,22.56,-1,-34010,77310,111320,43300,0,-30883,0,0,0,,30883,-30883
35,08/31/2017,14,3:15,3:30,,,0,34.68,34.68,0,-25261,89158,114419,63897,0,-2,0,0,0,,2,-2
35,08/31/2017,15,3:30,3:45,,,0,34.68,34.68,0,-17378,70761,88139,53383,0,0,0,0,0,,0,0
35,08/31/2017,16,3:45,4:00,,6.8,0,6.8,6.8,-1,-12960,68511,81471,55551,0,-12485,0,0,0,,12485,-12485
35,08/31/2017,17,4:00,4:15,,27.18,0,27.18,27.18,-1,-31933,76790,108723,44857,0,-9962,0,0,0,,9962,-9962
35,08/31/2017,18,4:15,4:30,,28.18,0,28.18,28.18,-1,-20984,67906,88890,46922,0,-5138,0,0,0,,5138,-5138
35,08/31/2017,19,4:30,4:45,,27.18,0,27.18,27.18,-1,-19844,63889,83733,44045,0,-7452,0,0,0,,7452,-7452
35,08/31/2017,20,4:45,5:00,,37.33,0,37.33,37.33,-1,-19059,92984,112043,73925,0,-5589,0,0,0,,5589,-5589
35,08/31/2017,21,5:00,5:15,,,0,34.69,34.69,0,-26333,66343,92676,40010,0,-411,0,0,0,,411,-411
35,08/31/2017,22,5:15,5:30,,,0,34.68,34.68,0,-28293,70495,98788,42202,0,0,0,0,0,,0,0
35,08/31/2017,23,5:30,5:45,,,0,34.67,34.67,0,-44848,62322,107170,17474,0,0,0,0,0,,0,0
35,08/31/2017,24,5:45,6:00,,,0,34.64,34.64,0,-58410,57972,116382,-438,0,0,0,0,0,,0,0
35,08/31/2017,25,6:00,6:15,,,0,34.7,34.7,0,-28766,65337,94103,36571,0,0,0,0,0,,0,0
35,08/31/2017,26,6:15,6:30,,,0,34.7,34.7,0,-20654,78846,99500,58192,0,0,0,0,0,,0,0
35,08/31/2017,27,6:30,6:45,,,0,34.67,34.67,0,-48080,59098,107178,11018,0,0,0,0,0,,0,0
35,08/31/2017,28,6:45,7:00,,,0,34.63,34.63,0,-39205,122985,162190,83780,0,0,0,0,0,,0,0
35,08/31/2017,29,7:00,7:15,,9.49,0,9.49,9.49,-1,-51783,91184,142967,39401,0,-17092,0,0,0,,17092,-17092
35,08/31/2017,30,7:15,7:30,,-35.74,0,-35.74,-35.74,-1,-35392,66251,101643,30859,0,-54515,0,0,0,,54515,-54515
35,08/31/2017,31,7:30,7:45,,38.74,0,38.74,38.74,-1,-72552,86481,159033,13929,0,-4703,0,0,0,,4703,-4703
35,08/31/2017,32,7:45,8:00,30.48,39.03,0,30.48,30.48,1,-107477,88108,195585,-19369,0,-642,76,0,0,,718,-566
35,08/31/2017,33,8:00,8:15,30.48,29.03,0,29.03,29.03,-1,-52627,81700,134327,29073,0,-3751,1,0,0,,3752,-3750
35,08/31/2017,34,8:15,8:30,,30.8,0,30.8,30.8,-1,-81184,101770,182954,20586,0,-4080,0,0,0,,4080,-4080
35,08/31/2017,35,8:30,8:45,,,0,37.96,37.96,0,-93472,97443,190915,3971,0,-513,0,0,0,,513,-513
35,08/31/2017,36,8:45,9:00,,29.18,0,29.18,29.18,-1,-90827,93415,184242,2588,0,-332,0,0,0,,332,-332
35,08/31/2017,37,9:00,9:15,,5.38,0,5.38,5.38,-1,-48307,109145,157452,60838,0,-9159,0,0,0,,9159,-9159
35,08/31/2017,38,9:15,9:30,,3.36,0,3.36,3.36,-1,-58277,76748,135025,18471,0,-16730,0,0,0,,16730,-16730
35,08/31/2017,39,9:30,9:45,,29.16,0,29.16,29.16,-1,-59796,76909,136705,17113,0,-2692,0,0,0,,2692,-2692
35,08/31/2017,40,9:45,10:00,,30.2,0,30.2,30.2,-1,-69404,71414,140818,2010,0,-4967,0,0,0,,4967,-4967
35,08/31/2017,41,10:00,10:15,,,0,37.99,37.99,0,-73470,50898,124368,-22572,0,-5,0,0,0,,5,-5
35,08/31/2017,42,10:15,10:30,,,0,37.99,37.99,0,-70994,62401,133395,-8593,0,0,0,0,0,,0,0
35,08/31/2017,43,10:30,10:45,,29.03,0,29.03,29.03,-1,-59291,77531,136822,18240,0,-9167,0,0,0,,9167,-9167
35,08/31/2017,44,10:45,11:00,,28.48,0,28.48,28.48,-1,-48020,77533,125553,29513,0,-21932,0,0,0,,21932,-21932
35,08/31/2017,45,11:00,11:15,,25.74,0,25.74,25.74,-1,-70323,98752,169075,28429,0,-28811,0,0,0,,28811,-28811
35,08/31/2017,46,11:15,11:30,,29.2,0,29.2,29.2,-1,-61057,84990,146047,23933,0,-16541,0,0,0,,16541,-16541
35,08/31/2017,47,11:30,11:45,,29.27,0,29.27,29.27,-1,-58634,66849,125483,8215,0,-12274,0,0,0,,12274,-12274
35,08/31/2017,48,11:45,12:00,,29.98,0,29.98,29.98,-1,-63636,80113,143749,16477,0,-3432,0,0,0,,3432,-3432
35,08/31/2017,49,12:00,12:15,,39,0,39,39,-1,-91658,63116,154774,-28542,0,-1428,0,0,0,,1428,-1428
35,08/31/2017,50,12:15,12:30,,30.59,0,30.59,30.59,-1,-73425,77309,150734,3884,0,-236,0,0,0,,236,-236
35,08/31/2017,51,12:30,12:45,,27.48,0,27.48,27.48,-1,-54776,89077,143853,34301,0,-16227,0,0,0,,16227,-16227
35,08/31/2017,52,12:45,13:00,,29.03,0,29.03,29.03,-1,-54023,71212,125235,17189,0,-21881,0,0,0,,21881,-21881
35,08/31/2017,53,13:00,13:15,,27.48,0,27.48,27.48,-1,-47542,87058,134600,39516,0,-22625,0,0,0,,22625,-22625
35,08/31/2017,54,13:15,13:30,,29.03,0,29.03,29.03,-1,-51245,63191,114436,11946,0,-19203,0,0,0,,19203,-19203
35,08/31/2017,55,13:30,13:45,,28.35,0,28.35,28.35,-1,-42561,72529,115090,29968,0,-16797,0,0,0,,16797,-16797
35,08/31/2017,56,13:45,14:00,,-6.45,0,-6.45,-6.45,-1,-35196,94486,129682,59290,0,-42481,0,0,0,,42481,-42481
35,08/31/2017,57,14:00,14:15,,-6.48,0,-6.48,-6.48,-1,-25998,85213,111211,59215,0,-52066,0,0,0,,52066,-52066
35,08/31/2017,58,14:15,14:30,,-10.65,0,-10.65,-10.65,-1,-25755,70408,96163,44653,0,-52098,0,0,0,,52098,-52098
35,08/31/2017,59,14:30,14:45,,27.75,0,27.75,27.75,-1,-37459,82549,120008,45090,0,-36808,0,0,0,,36808,-36808
35,08/31/2017,60,14:45,15:00,,27.48,0,27.48,27.48,-1,-38250,81600,119850,43350,0,-34959,0,0,0,,34959,-34959
35,08/31/2017,61,15:00,15:15,,29.03,0,29.03,29.03,-1,-59388,90720,150108,31332,0,-21695,0,0,0,,21695,-21695
35,08/31/2017,62,15:15,15:30,,28.48,0,28.48,28.48,-1,-64658,72248,136906,7590,0,-16737,0,0,0,,16737,-16737
35,08/31/2017,63,15:30,15:45,30.48,28.48,0,30.48,30.48,1,-71125,75828,146953,4703,0,-1913,54,0,0,,1967,-1859
35,08/31/2017,64,15:45,16:00,,37.82,0,37.82,37.82,-1,-77514,78383,155897,869,0,-275,0,0,0,,275,-275
35,08/31/2017,65,16:00,16:15,,30.77,0,30.77,30.77,-1,-72230,71248,143478,-982,0,-610,0,0,0,,610,-610
35,08/31/2017,66,16:15,16:30,,,0,38.07,38.07,0,-68716,64900,133616,-3816,0,0,0,0,0,,0,0
35,08/31/2017,67,16:30,16:45,,,0,38.07,38.07,0,-63483,78822,142305,15339,0,0,0,0,0,,0,0
35,08/31/2017,68,16:45,17:00,,29.94,0,29.94,29.94,-1,-69273,85533,154806,16260,0,-857,0,0,0,,857,-857
35,08/31/2017,69,17:00,17:15,,23.48,0,23.48,23.48,-1,-49647,115901,165548,66254,0,-14950,0,0,0,,14950,-14950
35,08/31/2017,70,17:15,17:30,,29.53,0,29.53,29.53,-1,-50608,91568,142176,40960,0,-7443,0,0,0,,7443,-7443
35,08/31/2017,71,17:30,17:45,,39.16,0,39.16,39.16,-1,-57538,83172,140710,25634,0,-1996,0,0,0,,1996,-1996
35,08/31/2017,72,17:45,18:00,,26.19,0,26.19,26.19,-1,-58346,78570,136916,20224,0,-4077,0,0,0,,4077,-4077
35,08/31/2017,73,18:00,18:15,,23.48,0,23.48,23.48,-1,-43181,91217,134398,48036,0,-30347,0,0,0,,30347,-30347
35,08/31/2017,74,18:15,18:30,,23.48,0,23.48,23.48,-1,-37742,68351,106093,30609,0,-34836,0,0,0,,34836,-34836
35,08/31/2017,75,18:30,18:45,,39.24,0,39.24,39.24,-1,-34883,68148,103031,33265,0,-8415,0,0,0,,8415,-8415
35,08/31/2017,76,18:45,19:00,,,0,38.07,38.07,0,-43282,80691,123973,37409,0,0,0,0,0,,0,0
35,08/31/2017,77,19:00,19:15,,,0,38.05,38.05,0,-52805,89189,141994,36384,0,0,0,0,0,,0,0
35,08/31/2017,78,19:15,19:30,,29.29,0,29.29,29.29,-1,-52528,88807,141335,36279,0,-274,0,0,0,,274,-274
35,08/31/2017,79,19:30,19:45,,-0.28,0,-0.28,-0.28,-1,-51694,114769,166463,63075,0,-27421,0,0,0,,27421,-27421
35,08/31/2017,80,19:45,20:00,,29.32,0,29.32,29.32,-1,-66398,102506,168904,36108,0,-7758,0,0,0,,7758,-7758
35,08/31/2017,81,20:00,20:15,39.09,,0,39.09,39.09,1,-30724,113975,144699,83251,0,0,1195,0,0,,1195,1195
35,08/31/2017,82,20:15,20:30,52.12,,0,52.12,52.12,1,-44377,92592,136969,48215,0,0,21923,0,0,,21923,21923
35,08/31/2017,83,20:30,20:45,137.02,,0,137.02,137.02,1,-65920,78223,144143,12303,0,0,39264,0,0,,39264,39264
35,08/31/2017,84,20:45,21:00,217.07,,0,217.07,217.07,1,-78689,97821,176510,19132,0,0,50143,0,0,,50143,50143
35,08/31/2017,85,21:00,21:15,217.07,35.58,0,35.58,35.58,-1,-52103,134100,186203,81997,0,-370,4799,0,0,,5169,4429
35,08/31/2017,86,21:15,21:30,,28.48,0,28.48,28.48,-1,-39417,110798,150215,71381,0,-2055,0,0,0,,2055,-2055
35,08/31/2017,87,21:30,21:45,,28.48,0,28.48,28.48,-1,-30898,96839,127737,65941,0,-6377,0,0,0,,6377,-6377
35,08/31/2017,88,21:45,22:00,,-24.05,0,-24.05,-24.05,-1,-30314,95497,125811,65183,0,-31738,0,0,0,,31738,-31738
35,08/31/2017,89,22:00,22:15,51.32,-53.55,0,51.32,51.32,1,-83939,98368,182307,14429,0,-30114,1635,0,0,,31749,-28479
35,08/31/2017,90,22:15,22:30,32.08,26.2,0,26.2,26.2,-1,-51819,108019,159838,56200,0,-2172,658,0,0,,2830,-1514
35,08/31/2017,91,22:30,22:45,,18.14,0,18.14,18.14,-1,-27904,123487,151391,95583,0,-17894,0,0,0,,17894,-17894
35,08/31/2017,92,22:45,23:00,,26.2,0,26.2,26.2,-1,-31479,113825,145304,82346,0,-21077,0,0,0,,21077,-21077
35,08/31/2017,93,23:00,23:15,,7.03,0,7.03,7.03,-1,-71185,100573,171758,29388,0,-18602,0,0,0,,18602,-18602
35,08/31/2017,94,23:15,23:30,,26.2,0,26.2,26.2,-1,-44215,63554,107769,19339,0,-5457,0,0,0,,5457,-5457
35,08/31/2017,95,23:30,23:45,,15.35,0,15.35,15.35,-1,-59471,74716,134187,15245,0,-29960,0,0,0,,29960,-29960
35,08/31/2017,96,23:45,0:00,,39.23,0,39.23,39.23,-1,-75280,83478,158758,8198,0,-6185,0,0,0,,6185,-6185
35,09-01-17,1,0:00,0:15,,40.48,0,40.48,40.48,-1,-58737,65300,124037,6563,0,-871,0,0,0,,871,-871
35,09-01-17,2,0:15,0:30,,41.71,0,41.71,41.71,-1,-49405,54474,103879,5069,0,-1079,0,0,0,,1079,-1079
35,09-01-17,3,0:30,0:45,,41.71,0,41.71,41.71,-1,-59158,32764,91922,-26394,0,-420,0,0,0,,420,-420
35,09-01-17,4,0:45,1:00,,37.82,0,37.82,37.82,-1,-43229,62894,106123,19665,0,-990,0,0,0,,990,-990
35,09-01-17,5,1:00,1:15,30.48,37.66,0,30.48,30.48,1,-47615,43947,91562,-3668,0,-201,37,0,0,,238,-164
35,09-01-17,6,1:15,1:30,30.48,,0,30.48,30.48,1,-34166,53875,88041,19709,0,0,747,0,0,,747,747
35,09-01-17,7,1:30,1:45,30.45,,0,30.45,30.45,1,-34885,66806,101691,31921,0,0,250,0,0,,250,250
35,09-01-17,8,1:45,2:00,,7.36,0,7.36,7.36,-1,-41105,83520,124625,42415,0,-11483,0,0,0,,11483,-11483
35,09-01-17,9,2:00,2:15,30.48,28.48,0,30.48,30.48,1,-35710,73041,108751,37331,0,-5982,80,0,0,,6062,-5902
35,09-01-17,10,2:15,2:30,30.84,37.63,0,36.06,36.06,2,-31982,71654,103636,39672,0,-55,1230,0,0,,1285,1175
35,09-01-17,11,2:30,2:45,,12.53,0,12.53,12.53,-1,-30039,83589,113628,53550,0,-25201,0,0,0,,25201,-25201
35,09-01-17,12,2:45,3:00,,22.04,0,22.04,22.04,-1,-26549,82264,108813,55715,0,-46989,0,0,0,,46989,-46989
35,09-01-17,13,3:00,3:15,,23.09,0,23.09,23.09,-1,-40011,72796,112807,32785,0,-24313,0,0,0,,24313,-24313
35,09-01-17,14,3:15,3:30,,,0,36.06,36.06,0,-34725,64606,99331,29881,0,0,0,0,0,,0,0
35,09-01-17,15,3:30,3:45,,,0,36.06,36.06,0,-29249,62846,92095,33597,0,0,0,0,0,,0,0
35,09-01-17,16,3:45,4:00,,28.48,0,28.48,28.48,-1,-26092,68407,94499,42315,0,-847,0,0,0,,847,-847
35,09-01-17,17,4:00,4:15,,28.48,0,28.48,28.48,-1,-21797,75928,97725,54131,0,-4527,0,0,0,,4527,-4527
35,09-01-17,18,4:15,4:30,,37.44,0,37.44,37.44,-1,-26072,69123,95195,43051,0,-1230,0,0,0,,1230,-1230
35,09-01-17,19,4:30,4:45,,,0,36.05,36.05,0,-29194,88137,117331,58943,0,0,0,0,0,,0,0
35,09-01-17,20,4:45,5:00,,41.64,0,41.64,41.64,-1,-28204,77662,105866,49458,0,-236,0,0,0,,236,-236
35,09-01-17,21,5:00,5:15,,17.03,0,17.03,17.03,-1,-39884,87669,127553,47785,0,-15191,0,0,0,,15191,-15191
35,09-01-17,22,5:15,5:30,,23.48,0,23.48,23.48,-1,-38938,96389,135327,57451,0,-37648,0,0,0,,37648,-37648
35,09-01-17,23,5:30,5:45,,27.48,0,27.48,27.48,-1,-49578,71054,120632,21476,0,-21033,0,0,0,,21033,-21033
35,09-01-17,24,5:45,6:00,30.48,35.32,0,35.28,35.28,2,-43120,94338,137458,51218,0,-1031,18,0,0,,1049,-1013
35,09-01-17,25,6:00,6:15,,39.92,0,39.92,39.92,-1,-45356,52080,97436,6724,0,-436,0,0,0,,436,-436
35,09-01-17,26,6:15,6:30,,37.75,0,37.75,37.75,-1,-60086,101172,161258,41086,0,-349,0,0,0,,349,-349
35,09-01-17,27,6:30,6:45,32.76,,0,32.76,32.76,1,-68315,68095,136410,-220,0,0,314,0,0,,314,314
35,09-01-17,28,6:45,7:00,32.76,,0,32.76,32.76,1,-59429,93308,152737,33879,0,0,419,0,0,,419,419
35,09-01-17,29,7:00,7:15,,12.98,0,12.98,12.98,-1,-44514,120075,164589,75561,0,-12615,0,0,0,,12615,-12615
35,09-01-17,30,7:15,7:30,,31.59,0,31.59,31.59,-1,-43224,115966,159190,72742,0,-5624,0,0,0,,5624,-5624
35,09-01-17,31,7:30,7:45,,29.01,0,29.01,29.01,-1,-44411,89676,134087,45265,0,-7918,0,0,0,,7918,-7918
35,09-01-17,32,7:45,8:00,,,0,39.53,39.53,0,-61463,92317,153780,30854,0,-2198,0,0,0,,2198,-2198
35,09-01-17,33,8:00,8:15,,27.49,0,27.49,27.49,-1,-34843,58113,92956,23270,0,-5843,0,0,0,,5843,-5843
35,09-01-17,34,8:15,8:30,,37.75,0,37.75,37.75,-1,-36059,44958,81017,8899,0,-6427,0,0,0,,6427,-6427
35,09-01-17,35,8:30,8:45,,40.32,0,40.32,40.32,-1,-44854,38108,82962,-6746,0,-2458,0,0,0,,2458,-2458
35,09-01-17,36,8:45,9:00,30.56,40.32,0,30.56,30.56,1,-75750,46730,122480,-29020,0,-13,416,0,0,,429,403
35,09-01-17,37,9:00,9:15,30.49,,0,30.49,30.49,1,-43751,34124,77875,-9627,0,0,554,0,0,,554,554
35,09-01-17,38,9:15,9:30,,33.26,0,33.26,33.26,-1,-39048,37215,76263,-1833,0,-135,0,0,0,,135,-135
35,09-01-17,39,9:30,9:45,,23.09,0,23.09,23.09,-1,-28463,65472,93935,37009,0,-16408,0,0,0,,16408,-16408
35,09-01-17,40,9:45,10:00,,29.03,0,29.03,29.03,-1,-42595,76339,118934,33744,0,-27177,0,0,0,,27177,-27177
35,09-01-17,41,10:00,10:15,34.17,30.06,0,39.62,30.06,2,-67865,62258,130123,-5607,0,-13157,1077,0,0,,14234,-12080
35,09-01-17,42,10:15,10:30,34.17,27.49,0,27.49,27.49,-1,-33887,73603,107490,39716,0,-1055,135,0,0,,1190,-920
35,09-01-17,43,10:30,10:45,,21.92,0,21.92,21.92,-1,-35663,62190,97853,26527,0,-13348,0,0,0,,13348,-13348
35,09-01-17,44,10:45,11:00,,35.91,0,35.91,35.91,-1,-40973,65635,106608,24662,0,-5665,0,0,0,,5665,-5665
35,09-01-17,45,11:00,11:15,,,0,39.66,39.66,0,-54825,56677,111502,1852,0,-176,0,0,0,,176,-176
35,09-01-17,46,11:15,11:30,,,0,39.66,39.66,0,-32699,53134,85833,20435,0,0,0,0,0,,0,0
35,09-01-17,47,11:30,11:45,,41.71,0,41.71,41.71,-1,-30015,54500,84515,24485,0,-64,0,0,0,,64,-64
35,09-01-17,48,11:45,12:00,,41.69,0,41.69,41.69,-1,-30103,66277,96380,36174,0,-591,0,0,0,,591,-591
35,09-01-17,49,12:00,12:15,,41.72,0,41.72,41.72,-1,-43308,48803,92111,5495,0,-164,0,0,0,,164,-164
35,09-01-17,50,12:15,12:30,,41.73,0,41.73,41.73,-1,-42226,61568,103794,19342,0,-1263,0,0,0,,1263,-1263
35,09-01-17,51,12:30,12:45,,40.59,0,40.59,40.59,-1,-39650,65161,104811,25511,0,-2559,0,0,0,,2559,-2559
35,09-01-17,52,12:45,13:00,,27.49,0,27.49,27.49,-1,-39136,56846,95982,17710,0,-6099,0,0,0,,6099,-6099
35,09-01-17,53,13:00,13:15,,23.49,0,23.49,23.49,-1,-37764,68981,106745,31217,0,-10359,0,0,0,,10359,-10359
35,09-01-17,54,13:15,13:30,30.49,23.49,0,30.49,30.49,1,-39098,47012,86110,7914,0,-153,174,0,0,,327,21
35,09-01-17,55,13:30,13:45,30.49,,0,30.49,30.49,1,-43495,51414,94909,7919,0,0,763,0,0,,763,763
35,09-01-17,56,13:45,14:00,30.48,,0,30.48,30.48,1,-42548,62465,105013,19917,0,0,213,0,0,,213,213
35,09-01-17,57,14:00,14:15,,,0,36.21,36.21,0,-31225,52970,84195,21745,0,0,0,0,0,,0,0
35,09-01-17,58,14:15,14:30,,,0,36.22,36.22,0,-30264,67688,97952,37424,0,0,0,0,0,,0,0
35,09-01-17,59,14:30,14:45,,27.49,0,27.49,27.49,-1,-31343,68181,99524,36838,0,-6214,0,0,0,,6214,-6214
35,09-01-17,60,14:45,15:00,,28.49,0,28.49,28.49,-1,-35534,62955,98489,27421,0,-15900,0,0,0,,15900,-15900
35,09-01-17,61,15:00,15:15,,31.59,0,31.59,31.59,-1,-37340,79304,116644,41964,0,-10000,0,0,0,,10000,-10000
35,09-01-17,62,15:15,15:30,,41.97,0,41.97,41.97,-1,-34838,87045,121883,52207,0,-80,0,0,0,,80,-80
35,09-01-17,63,15:30,15:45,,23.49,0,23.49,23.49,-1,-34940,80423,115363,45483,0,-13460,0,0,0,,13460,-13460
35,09-01-17,64,15:45,16:00,,27.49,0,27.49,27.49,-1,-42657,73847,116504,31190,0,-26651,0,0,0,,26651,-26651
35,09-01-17,65,16:00,16:15,,23.49,0,23.49,23.49,-1,-22030,104116,126146,82086,0,-27999,0,0,0,,27999,-27999
35,09-01-17,66,16:15,16:30,,21.82,0,21.82,21.82,-1,-23992,111394,135386,87402,0,-21327,0,0,0,,21327,-21327
35,09-01-17,67,16:30,16:45,,21.82,0,21.82,21.82,-1,-41331,97158,138489,55827,0,-34529,0,0,0,,34529,-34529
35,09-01-17,68,16:45,17:00,,20.28,0,20.28,20.28,-1,-39766,87769,127535,48003,0,-42258,0,0,0,,42258,-42258
35,09-01-17,69,17:00,17:15,,27.49,0,27.49,27.49,-1,-33027,96137,129164,63110,0,-28590,0,0,0,,28590,-28590
35,09-01-17,70,17:15,17:30,,,0,36.23,36.23,0,-31779,103053,134832,71274,0,-2717,0,0,0,,2717,-2717
35,09-01-17,71,17:30,17:45,,,0,36.22,36.22,0,-35124,113179,148303,78055,0,0,0,0,0,,0,0
35,09-01-17,72,17:45,18:00,,,0,36.21,36.21,0,-34744,121223,155967,86479,0,0,0,0,0,,0,0
35,09-01-17,73,18:00,18:15,,-51.97,0,-51.97,-51.97,-1,-30498,104389,134887,73891,0,-29342,0,0,0,,29342,-29342
35,09-01-17,74,18:15,18:30,,27.35,0,27.35,27.35,-1,-30889,69552,100441,38663,0,-23241,0,0,0,,23241,-23241
35,09-01-17,75,18:30,18:45,,27.49,0,27.49,27.49,-1,-29983,97311,127294,67328,0,-9624,0,0,0,,9624,-9624
35,09-01-17,76,18:45,19:00,,23.49,0,23.49,23.49,-1,-31471,127502,158973,96031,0,-14220,0,0,0,,14220,-14220
35,09-01-17,77,19:00,19:15,,-47.04,0,-47.04,-47.04,-1,-18852,103048,121900,84196,0,-52726,0,0,0,,52726,-52726
35,09-01-17,78,19:15,19:30,,28.49,0,28.49,28.49,-1,-25008,43342,68350,18334,0,-14339,0,0,0,,14339,-14339
35,09-01-17,79,19:30,19:45,,37.76,0,37.76,37.76,-1,-20134,86238,106372,66104,0,-470,0,0,0,,470,-470
35,09-01-17,80,19:45,20:00,,35.42,0,35.42,35.42,-1,-20292,88101,108393,67809,0,-501,0,0,0,,501,-501
35,09-01-17,81,20:00,20:15,,23.49,0,23.49,23.49,-1,-15180,157021,172201,141841,0,-12830,0,0,0,,12830,-12830
35,09-01-17,82,20:15,20:30,,,0,39.67,39.67,0,-16695,85629,102324,68934,0,-860,0,0,0,,860,-860
35,09-01-17,83,20:30,20:45,,,0,39.67,39.67,0,-19247,65419,84666,46172,0,0,0,0,0,,0,0
35,09-01-17,84,20:45,21:00,,,0,39.66,39.66,0,-34384,61151,95535,26767,0,0,0,0,0,,0,0
35,09-01-17,85,21:00,21:15,,,0,36.09,36.09,0,-44557,60501,105058,15944,0,0,0,0,0,,0,0
35,09-01-17,86,21:15,21:30,,41.4,0,41.4,41.4,-1,-34653,62389,97042,27736,0,-7,0,0,0,,7,-7
35,09-01-17,87,21:30,21:45,,38.07,0,38.07,38.07,-1,-31662,75612,107274,43950,0,-1835,0,0,0,,1835,-1835
35,09-01-17,88,21:45,22:00,,20.18,0,20.18,20.18,-1,-62244,90732,152976,28488,0,-5727,0,0,0,,5727,-5727
35,09-01-17,89,22:00,22:15,,-3.48,0,-3.48,-3.48,-1,-72940,53923,126863,-19017,0,-13233,0,0,0,,13233,-13233
35,09-01-17,90,22:15,22:30,30.44,-3.48,0,30.44,30.44,1,-79963,45351,125314,-34612,0,-253,228,0,0,,481,-25
35,09-01-17,91,22:30,22:45,30.48,,0,30.48,30.48,1,-62154,61563,123717,-591,0,0,21,0,0,,21,21
35,09-01-17,92,22:45,23:00,42.81,,0,42.81,42.81,1,-88742,56959,145701,-31783,0,0,6373,0,0,,6373,6373
35,09-01-17,93,23:00,23:15,42.81,41.11,0,41.11,41.11,-1,-37268,89705,126973,52437,0,-273,1309,0,0,,1582,1036
35,09-01-17,94,23:15,23:30,,37.31,0,37.31,37.31,-1,-45764,66144,111908,20380,0,-1375,0,0,0,,1375,-1375
35,09-01-17,95,23:30,23:45,,38.29,0,38.29,38.29,-1,-56069,77053,133122,20984,0,-601,0,0,0,,601,-601
35,09-01-17,96,23:45,0:00,,29.16,0,29.16,29.16,-1,-74758,95451,170209,20693,0,-486,0,0,0,,486,-486
36,09-02-17,1,0:00,0:15,,-1.58,0,-1.58,-1.58,-1,-35054,139958,175012,104904,0,-10591,0,0,0,,10591,-10591
36,09-02-17,2,0:15,0:30,,,0,35.94,35.94,0,-42797,73621,116418,30824,0,-45,0,0,0,,45,-45
36,09-02-17,3,0:30,0:45,,25.47,0,25.47,25.47,-1,-36283,82120,118403,45837,0,-1284,0,0,0,,1284,-1284
36,09-02-17,4,0:45,1:00,,13.44,0,13.44,13.44,-1,-77676,97780,175456,20104,0,-17877,0,0,0,,17877,-17877
36,09-02-17,5,1:00,1:15,,30.86,0,30.86,30.86,-1,-60022,150762,210784,90740,0,-7589,0,0,0,,7589,-7589
36,09-02-17,6,1:15,1:30,30.3,30.86,0,30.3,30.3,1,-46350,69583,115933,23233,0,-34,165,0,0,,199,131
36,09-02-17,7,1:30,1:45,,29.86,0,29.86,29.86,-1,-12000,91181,103181,79181,0,-1292,0,0,0,,1292,-1292
36,09-02-17,8,1:45,2:00,,40.39,0,40.39,40.39,-1,-23988,82217,106205,58229,0,-1886,0,0,0,,1886,-1886
36,09-02-17,9,2:00,2:15,,,0,35.92,35.92,0,-39740,45373,85113,5633,0,-22,0,0,0,,22,-22
36,09-02-17,10,2:15,2:30,,,0,35.93,35.93,0,-19504,50415,69919,30911,0,0,0,0,0,,0,0
36,09-02-17,11,2:30,2:45,,29.86,0,29.86,29.86,-1,-21084,50515,71599,29431,0,-1989,0,0,0,,1989,-1989
36,09-02-17,12,2:45,3:00,,27.78,0,27.78,27.78,-1,-18653,32401,51054,13748,0,-12584,0,0,0,,12584,-12584
36,09-02-17,13,3:00,3:15,30.69,41.72,0,30.69,30.69,1,-23685,21454,45139,-2231,0,-3746,4,0,0,,3750,-3742
36,09-02-17,14,3:15,3:30,32.86,,0,32.86,32.86,1,-27597,15723,43320,-11874,0,0,1576,0,0,,1576,1576
36,09-02-17,15,3:30,3:45,32.12,,0,32.12,32.12,1,-26791,23659,50450,-3132,0,0,3590,0,0,,3590,3590
36,09-02-17,16,3:45,4:00,32.12,29.86,0,29.86,29.86,-1,-17809,28970,46779,11161,0,-856,572,0,0,,1428,-284
36,09-02-17,17,4:00,4:15,,29.86,0,29.86,29.86,-1,-15149,24481,39630,9332,0,-1203,0,0,0,,1203,-1203
36,09-02-17,18,4:15,4:30,,,0,35.93,35.93,0,-12791,23098,35889,10307,0,0,0,0,0,,0,0
36,09-02-17,19,4:30,4:45,,,0,35.93,35.93,0,-9276,35999,45275,26723,0,0,0,0,0,,0,0
36,09-02-17,20,4:45,5:00,,,0,35.93,35.93,0,-7384,30620,38004,23236,0,0,0,0,0,,0,0
36,09-02-17,21,5:00,5:15,,30.86,0,30.86,30.86,-1,-8998,29454,38452,20456,0,-840,0,0,0,,840,-840
36,09-02-17,22,5:15,5:30,,39.85,0,39.85,39.85,-1,-13834,31131,44965,17297,0,-2548,0,0,0,,2548,-2548
36,09-02-17,23,5:30,5:45,,29.86,0,29.86,29.86,-1,-21291,31288,52579,9997,0,-2629,0,0,0,,2629,-2629
36,09-02-17,24,5:45,6:00,,29.86,0,29.86,29.86,-1,-21504,21848,43352,344,0,-2955,0,0,0,,2955,-2955
36,09-02-17,25,6:00,6:15,,25.55,0,25.55,25.55,-1,-11547,39953,51500,28406,0,-9094,0,0,0,,9094,-9094
36,09-02-17,26,6:15,6:30,,30.55,0,30.55,30.55,-1,-15203,35297,50500,20094,0,-2167,0,0,0,,2167,-2167
36,09-02-17,27,6:30,6:45,,41.69,0,41.69,41.69,-1,-18191,35185,53376,16994,0,-742,0,0,0,,742,-742
36,09-02-17,28,6:45,7:00,,30.55,0,30.55,30.55,-1,-15846,56070,71916,40224,0,-489,0,0,0,,489,-489
36,09-02-17,29,7:00,7:15,,-8.78,0,-8.78,-8.78,-1,-23106,71673,94779,48567,0,-27571,0,0,0,,27571,-27571
36,09-02-17,30,7:15,7:30,,24.66,0,24.66,24.66,-1,-18970,47789,66759,28819,0,-31577,0,0,0,,31577,-31577
36,09-02-17,31,7:30,7:45,,29.55,0,29.55,29.55,-1,-9377,53995,63372,44618,0,-18364,0,0,0,,18364,-18364
36,09-02-17,32,7:45,8:00,,41.04,0,41.04,41.04,-1,-28767,97519,126286,68752,0,-6832,0,0,0,,6832,-6832
36,09-02-17,33,8:00,8:15,32.55,,0,32.55,32.55,1,-35968,42806,78774,6838,0,0,33,0,0,,33,33
36,09-02-17,34,8:15,8:30,,,0,35.93,35.93,0,-41930,42000,83930,70,0,0,0,0,0,,0,0
36,09-02-17,35,8:30,8:45,32.55,,0,32.55,32.55,1,-40771,30532,71303,-10239,0,0,869,0,0,,869,869
36,09-02-17,36,8:45,9:00,31.13,,0,31.13,31.13,1,-46313,41186,87499,-5127,0,0,480,0,0,,480,480
36,09-02-17,37,9:00,9:15,,,0,35.96,35.96,0,-19090,72641,91731,53551,0,0,0,0,0,,0,0
36,09-02-17,38,9:15,9:30,,,0,35.93,35.93,0,-27440,76283,103723,48843,0,0,0,0,0,,0,0
36,09-02-17,39,9:30,9:45,,,0,35.93,35.93,0,-26616,86057,112673,59441,0,0,0,0,0,,0,0
36,09-02-17,40,9:45,10:00,,40.22,0,40.22,40.22,-1,-24802,92965,117767,68163,0,-624,0,0,0,,624,-624
36,09-02-17,41,10:00,10:15,,29.55,0,29.55,29.55,-1,-30351,108326,138677,77975,0,-3638,0,0,0,,3638,-3638
36,09-02-17,42,10:15,10:30,,25.55,0,25.55,25.55,-1,-24629,111865,136494,87236,0,-14965,0,0,0,,14965,-14965
36,09-02-17,43,10:30,10:45,,4.29,0,4.29,4.29,-1,-19954,111450,131404,91496,0,-23527,0,0,0,,23527,-23527
36,09-02-17,44,10:45,11:00,,5.01,0,5.01,5.01,-1,-26861,101663,128524,74802,0,-24280,0,0,0,,24280,-24280
36,09-02-17,45,11:00,11:15,,5.55,0,5.55,5.55,-1,-52631,63966,116597,11335,0,-17491,0,0,0,,17491,-17491
36,09-02-17,46,11:15,11:30,,,0,35.98,35.98,0,-41863,82515,124378,40652,0,-23,0,0,0,,23,-23
36,09-02-17,47,11:30,11:45,,,0,35.99,35.99,0,-42771,83246,126017,40475,0,0,0,0,0,,0,0
36,09-02-17,48,11:45,12:00,,,0,36,36,0,-44176,88709,132885,44533,0,0,0,0,0,,0,0
36,09-02-17,49,12:00,12:15,32.55,,0,32.55,32.55,1,-62056,58078,120134,-3978,0,0,581,0,0,,581,581
36,09-02-17,50,12:15,12:30,30.12,,0,30.12,30.12,1,-47040,56471,103511,9431,0,0,17,0,0,,17,17
36,09-02-17,51,12:30,12:45,,,0,36.01,36.01,0,-51384,65237,116621,13853,0,0,0,0,0,,0,0
36,09-02-17,52,12:45,13:00,30.32,,0,30.32,30.32,1,-49246,60240,109486,10994,0,0,132,0,0,,132,132
36,09-02-17,53,13:00,13:15,32.55,,0,32.55,32.55,1,-46986,41604,88590,-5382,0,0,1101,0,0,,1101,1101
36,09-02-17,54,13:15,13:30,33.52,,0,33.52,33.52,1,-55970,32619,88589,-23351,0,0,4419,0,0,,4419,4419
36,09-02-17,55,13:30,13:45,30.32,,0,30.32,30.32,1,-51287,50199,101486,-1088,0,0,850,0,0,,850,850
36,09-02-17,56,13:45,14:00,30.32,26.8,0,26.8,26.8,-1,-40696,81938,122634,41242,0,-5338,4,0,0,,5342,-5334
36,09-02-17,57,14:00,14:15,,38.84,0,38.84,38.84,-1,-70985,80982,151967,9997,0,-2191,0,0,0,,2191,-2191
36,09-02-17,58,14:15,14:30,,41.65,0,41.65,41.65,-1,-69747,89353,159100,19606,0,-37,0,0,0,,37,-37
36,09-02-17,59,14:30,14:45,,29.55,0,29.55,29.55,-1,-66264,86469,152733,20205,0,-1452,0,0,0,,1452,-1452
36,09-02-17,60,14:45,15:00,,26.68,0,26.68,26.68,-1,-80949,86945,167894,5996,0,-6985,0,0,0,,6985,-6985
36,09-02-17,61,15:00,15:15,,23.11,0,23.11,23.11,-1,-49610,78615,128225,29005,0,-12307,0,0,0,,12307,-12307
36,09-02-17,62,15:15,15:30,,23.68,0,23.68,23.68,-1,-33383,72040,105423,38657,0,-32538,0,0,0,,32538,-32538
36,09-02-17,63,15:30,15:45,,25.55,0,25.55,25.55,-1,-36590,56814,93404,20224,0,-28627,0,0,0,,28627,-28627
36,09-02-17,64,15:45,16:00,,27.78,0,27.78,27.78,-1,-25026,53073,78099,28047,0,-17560,0,0,0,,17560,-17560
36,09-02-17,65,16:00,16:15,,19.72,0,19.72,19.72,-1,-22320,62748,85068,40428,0,-29849,0,0,0,,29849,-29849
36,09-02-17,66,16:15,16:30,,25.55,0,25.55,25.55,-1,-22876,57393,80269,34517,0,-34675,0,0,0,,34675,-34675
36,09-02-17,67,16:30,16:45,,25.93,0,25.93,25.93,-1,-27574,48549,76123,20975,0,-27339,0,0,0,,27339,-27339
36,09-02-17,68,16:45,17:00,,13.25,0,13.25,13.25,-1,-28141,45471,73612,17330,0,-24225,0,0,0,,24225,-24225
36,09-02-17,69,17:00,17:15,,10.78,0,10.78,10.78,-1,-33197,86191,119388,52994,0,-31748,0,0,0,,31748,-31748
36,09-02-17,70,17:15,17:30,,1.18,0,1.18,1.18,-1,-27757,81612,109369,53855,0,-32064,0,0,0,,32064,-32064
36,09-02-17,71,17:30,17:45,,25.55,0,25.55,25.55,-1,-28185,64337,92522,36152,0,-24352,0,0,0,,24352,-24352
36,09-02-17,72,17:45,18:00,132.99,30.55,0,132.99,132.99,1,-37706,43094,80800,5388,0,-9554,9039,0,0,,18593,-515
36,09-02-17,73,18:00,18:15,137.25,30.55,0,137.25,137.25,1,-24049,58398,82447,34349,0,-9,52607,0,0,,52616,52598
36,09-02-17,74,18:15,18:30,117.04,,0,117.04,117.04,1,-23626,102052,125678,78426,0,0,52523,0,0,,52523,52523
36,09-02-17,75,18:30,18:45,62.12,,0,62.12,62.12,1,-24163,129070,153233,104907,0,0,46725,0,0,,46725,46725
36,09-02-17,76,18:45,19:00,63.53,,0,63.53,63.53,1,-24237,122344,146581,98107,0,0,32745,0,0,,32745,32745
36,09-02-17,77,19:00,19:15,46.32,,0,46.32,46.32,1,-4038,134484,138522,130446,0,0,19154,0,0,,19154,19154
36,09-02-17,78,19:15,19:30,66.85,,0,66.85,66.85,1,-3756,109319,113075,105563,0,0,3584,0,0,,3584,3584
36,09-02-17,79,19:30,19:45,140.42,,0,140.42,140.42,1,-3655,85567,89222,81912,0,0,58256,0,0,,58256,58256
36,09-02-17,80,19:45,20:00,140.42,,0,140.42,140.42,1,-4166,98311,102477,94145,0,0,73114,0,0,,73114,73114
36,09-02-17,81,20:00,20:15,140.42,4.1,0,4.1,4.1,-1,-5380,240384,245764,235004,0,-5638,14680,0,0,,20318,9042
36,09-02-17,82,20:15,20:30,,41.97,0,41.97,41.97,-1,-5364,185085,190449,179721,0,-973,0,0,0,,973,-973
36,09-02-17,83,20:30,20:45,,,0,36.04,36.04,0,-5795,133257,139052,127462,0,0,0,0,0,,0,0
36,09-02-17,84,20:45,21:00,46.52,,0,46.52,46.52,1,-14354,101581,115935,87227,0,0,2895,0,0,,2895,2895
36,09-02-17,85,21:00,21:15,138.02,,0,138.02,138.02,1,-61178,77949,139127,16771,0,0,28246,0,0,,28246,28246
36,09-02-17,86,21:15,21:30,46.72,25.55,0,25.55,25.55,-1,-19808,106703,126511,86895,0,-542,24584,0,0,,25126,24042
36,09-02-17,87,21:30,21:45,46.72,25.55,0,25.55,25.55,-1,-5836,141673,147509,135837,0,-1790,63,0,0,,1853,-1727
36,09-02-17,88,21:45,22:00,,-27.09,0,-27.09,-27.09,-1,-5666,172684,178350,167018,0,-34899,0,0,0,,34899,-34899
36,09-02-17,89,22:00,22:15,,-27.09,0,-27.09,-27.09,-1,-45888,74854,120742,28966,0,-34389,0,0,0,,34389,-34389
36,09-02-17,90,22:15,22:30,,,0,35.99,35.99,0,-29466,50536,80002,21070,0,0,0,0,0,,0,0
36,09-02-17,91,22:30,22:45,,41.9,0,41.9,41.9,-1,-17091,71180,88271,54089,0,-677,0,0,0,,677,-677
36,09-02-17,92,22:45,23:00,,41.9,0,41.9,41.9,-1,-34400,116254,150654,81854,0,-999,0,0,0,,999,-999
36,09-02-17,93,23:00,23:15,,,0,35.96,35.96,0,-41282,52572,93854,11290,0,-73,0,0,0,,73,-73
36,09-02-17,94,23:15,23:30,,,0,35.97,35.97,0,-24126,66346,90472,42220,0,0,0,0,0,,0,0
36,09-02-17,95,23:30,23:45,,,0,35.99,35.99,0,-13513,79493,93006,65980,0,0,0,0,0,,0,0
36,09-02-17,96,23:45,0:00,,6.78,0,6.78,6.78,-1,-19911,117394,137305,97483,0,-8229,0,0,0,,8229,-8229
36,09-03-17,1,0:00,0:15,,,0,35.88,35.88,0,-43990,79632,123622,35642,0,-2073,0,0,0,,2073,-2073
36,09-03-17,2,0:15,0:30,,29.55,0,29.55,29.55,-1,-26538,50477,77015,23939,0,-1180,0,0,0,,1180,-1180
36,09-03-17,3,0:30,0:45,,25.55,0,25.55,25.55,-1,-21359,41082,62441,19723,0,-16219,0,0,0,,16219,-16219
36,09-03-17,4,0:45,1:00,,25.55,0,25.55,25.55,-1,-23760,57597,81357,33837,0,-23206,0,0,0,,23206,-23206
36,09-03-17,5,1:00,1:15,,35.64,0,35.64,35.64,-1,-39728,45259,84987,5531,0,-9858,0,0,0,,9858,-9858
36,09-03-17,6,1:15,1:30,,25.55,0,25.55,25.55,-1,-18588,44159,62747,25571,0,-2898,0,0,0,,2898,-2898
36,09-03-17,7,1:30,1:45,,25.55,0,25.55,25.55,-1,-12853,35782,48635,22929,0,-5048,0,0,0,,5048,-5048
36,09-03-17,8,1:45,2:00,,11.5,0,11.5,11.5,-1,-18076,47157,65233,29081,0,-32690,0,0,0,,32690,-32690
36,09-03-17,9,2:00,2:15,,-70.2,0,-70.2,-70.2,-1,-41080,115492,156572,74412,0,-58510,0,0,0,,58510,-58510
36,09-03-17,10,2:15,2:30,32.16,-70.2,0,32.16,32.16,1,-60909,25885,86794,-35024,0,-11878,405,0,0,,12283,-11473
36,09-03-17,11,2:30,2:45,,29.55,0,29.55,29.55,-1,-41550,26879,68429,-14671,0,-2622,0,0,0,,2622,-2622
36,09-03-17,12,2:45,3:00,,-4.53,0,-4.53,-4.53,-1,-20736,26884,47620,6148,0,-19707,0,0,0,,19707,-19707
36,09-03-17,13,3:00,3:15,32.55,29.55,0,32.55,32.55,1,-29402,28231,57633,-1171,0,-10688,475,0,0,,11163,-10213
36,09-03-17,14,3:15,3:30,32.55,29.55,0,32.55,32.55,1,-37294,16269,53563,-21025,0,-122,764,0,0,,886,642
36,09-03-17,15,3:30,3:45,30.3,,0,30.3,30.3,1,-23993,23119,47112,-874,0,0,319,0,0,,319,319
36,09-03-17,16,3:45,4:00,,29.55,0,29.55,29.55,-1,-22635,41595,64230,18960,0,-3930,0,0,0,,3930,-3930
36,09-03-17,17,4:00,4:15,,41.31,0,41.31,41.31,-1,-21044,33835,54879,12791,0,-1276,0,0,0,,1276,-1276
36,09-03-17,18,4:15,4:30,,,0,35.87,35.87,0,-18872,33869,52741,14997,0,0,0,0,0,,0,0
36,09-03-17,19,4:30,4:45,,,0,35.87,35.87,0,-14792,28043,42835,13251,0,0,0,0,0,,0,0
36,09-03-17,20,4:45,5:00,,,0,35.87,35.87,0,-12445,34931,47376,22486,0,0,0,0,0,,0,0
36,09-03-17,21,5:00,5:15,,,0,35.86,35.86,0,-12914,36081,48995,23167,0,0,0,0,0,,0,0
36,09-03-17,22,5:15,5:30,,41.31,0,41.31,41.31,-1,-12514,36177,48691,23663,0,-1012,0,0,0,,1012,-1012
36,09-03-17,23,5:30,5:45,,41.7,0,41.7,41.7,-1,-12640,37665,50305,25025,0,-879,0,0,0,,879,-879
36,09-03-17,24,5:45,6:00,,,0,35.86,35.86,0,-12311,32022,44333,19711,0,0,0,0,0,,0,0
36,09-03-17,25,6:00,6:15,,,0,35.36,35.36,0,-29497,40846,70343,11349,0,0,0,0,0,,0,0
36,09-03-17,26,6:15,6:30,,,0,35.36,35.36,0,-28931,34535,63466,5604,0,0,0,0,0,,0,0
36,09-03-17,27,6:30,6:45,,,0,35.36,35.36,0,-24247,39432,63679,15185,0,0,0,0,0,,0,0
36,09-03-17,28,6:45,7:00,,41.69,0,41.69,41.69,-1,-11718,78645,90363,66927,0,-71,0,0,0,,71,-71
36,09-03-17,29,7:00,7:15,,7.16,0,7.16,7.16,-1,-7268,60900,68168,53632,0,-5408,0,0,0,,5408,-5408
36,09-03-17,30,7:15,7:30,,-39.21,0,-39.21,-39.21,-1,-15670,47869,63539,32199,0,-38502,0,0,0,,38502,-38502
36,09-03-17,31,7:30,7:45,,30.69,0,30.69,30.69,-1,-26026,39778,65804,13752,0,-10747,0,0,0,,10747,-10747
36,09-03-17,32,7:45,8:00,,39.67,0,39.67,39.67,-1,-21791,45617,67408,23826,0,-102,0,0,0,,102,-102
36,09-03-17,33,8:00,8:15,,40.57,0,40.57,40.57,-1,-18312,28281,46593,9969,0,-1691,0,0,0,,1691,-1691
36,09-03-17,34,8:15,8:30,,,0,35.88,35.88,0,-26726,35044,61770,8318,0,0,0,0,0,,0,0
36,09-03-17,35,8:30,8:45,,,0,35.36,35.36,0,-31679,42066,73745,10387,0,0,0,0,0,,0,0
36,09-03-17,36,8:45,9:00,,,0,35.34,35.34,0,-24674,57584,82258,32910,0,0,0,0,0,,0,0
36,09-03-17,37,9:00,9:15,,40.64,0,40.64,40.64,-1,-30867,66080,96947,35213,0,-1561,0,0,0,,1561,-1561
36,09-03-17,38,9:15,9:30,,25.69,0,25.69,25.69,-1,-24826,89300,114126,64474,0,-6035,0,0,0,,6035,-6035
36,09-03-17,39,9:30,9:45,,0.22,0,0.22,0.22,-1,-24191,87759,111950,63568,0,-31222,0,0,0,,31222,-31222
36,09-03-17,40,9:45,10:00,,25.69,0,25.69,25.69,-1,-32227,79970,112197,47743,0,-31531,0,0,0,,31531,-31531
36,09-03-17,41,10:00,10:15,,21.56,0,21.56,21.56,-1,-44910,75076,119986,30166,0,-36934,0,0,0,,36934,-36934
36,09-03-17,42,10:15,10:30,,19.8,0,19.8,19.8,-1,-52106,71524,123630,19418,0,-41131,0,0,0,,41131,-41131
36,09-03-17,43,10:30,10:45,,22.69,0,22.69,22.69,-1,-45198,68432,113630,23234,0,-40569,0,0,0,,40569,-40569
36,09-03-17,44,10:45,11:00,,23.94,0,23.94,23.94,-1,-44724,60558,105282,15834,0,-35841,0,0,0,,35841,-35841
36,09-03-17,45,11:00,11:15,,,0,35.94,35.94,0,-45621,51476,97097,5855,0,-4348,0,0,0,,4348,-4348
36,09-03-17,46,11:15,11:30,,,0,35.94,35.94,0,-45705,56866,102571,11161,0,0,0,0,0,,0,0
36,09-03-17,47,11:30,11:45,,37.94,0,37.94,37.94,-1,-59708,55868,115576,-3840,0,-708,0,0,0,,708,-708
36,09-03-17,48,11:45,12:00,,37.75,0,37.75,37.75,-1,-52108,41955,94063,-10153,0,-374,0,0,0,,374,-374
36,09-03-17,49,12:00,12:15,,,0,35.96,35.96,0,-54871,45679,100550,-9192,0,-83,0,0,0,,83,-83
36,09-03-17,50,12:15,12:30,,,0,35.96,35.96,0,-56899,40301,97200,-16598,0,0,0,0,0,,0,0
36,09-03-17,51,12:30,12:45,34.63,,0,34.63,34.63,1,-54351,40583,94934,-13768,0,0,1624,0,0,,1624,1624
36,09-03-17,52,12:45,13:00,30.25,,0,30.25,30.25,1,-54781,38093,92874,-16688,0,0,323,0,0,,323,323
36,09-03-17,53,13:00,13:15,,,0,35.98,35.98,0,-50067,63279,113346,13212,0,0,39,0,0,,39,39
36,09-03-17,54,13:15,13:30,,24.11,0,24.11,24.11,-1,-45946,54283,100229,8337,0,-4453,0,0,0,,4453,-4453
36,09-03-17,55,13:30,13:45,,22.56,0,22.56,22.56,-1,-46536,49540,96076,3004,0,-16871,0,0,0,,16871,-16871
36,09-03-17,56,13:45,14:00,,25.93,0,25.93,25.93,-1,-35770,50787,86557,15017,0,-19206,0,0,0,,19206,-19206
36,09-03-17,57,14:00,14:15,30.26,29.69,0,30.26,30.26,1,-43442,39284,82726,-4158,0,-12519,51,0,0,,12570,-12468
36,09-03-17,58,14:15,14:30,30.63,29.69,0,36.02,29.69,2,-33583,45506,79089,11923,0,-1655,165,0,0,,1820,-1490
36,09-03-17,59,14:30,14:45,,30.69,0,30.69,30.69,-1,-45485,52670,98155,7185,0,-5001,0,0,0,,5001,-5001
36,09-03-17,60,14:45,15:00,,30.69,0,30.69,30.69,-1,-48034,56326,104360,8292,0,-6045,0,0,0,,6045,-6045
36,09-03-17,61,15:00,15:15,,27.03,0,27.03,27.03,-1,-37591,46754,84345,9163,0,-10292,0,0,0,,10292,-10292
36,09-03-17,62,15:15,15:30,,30.69,0,30.69,30.69,-1,-32298,47453,79751,15155,0,-4708,0,0,0,,4708,-4708
36,09-03-17,63,15:30,15:45,,30.69,0,30.69,30.69,-1,-43469,45309,88778,1840,0,-3410,0,0,0,,3410,-3410
36,09-03-17,64,15:45,16:00,,,0,36.06,36.06,0,-42326,36578,78904,-5748,0,-128,0,0,0,,128,-128
36,09-03-17,65,16:00,16:15,,42.13,0,42.13,42.13,-1,-34171,64944,99115,30773,0,-400,0,0,0,,400,-400
36,09-03-17,66,16:15,16:30,,42.13,0,42.13,42.13,-1,-41005,57216,98221,16211,0,-235,0,0,0,,235,-235
36,09-03-17,67,16:30,16:45,,,0,35.58,35.58,0,-52631,48246,100877,-4385,0,0,0,0,0,,0,0
36,09-03-17,68,16:45,17:00,34.88,,0,34.88,34.88,1,-58899,34275,93174,-24624,0,0,5351,0,0,,5351,5351
36,09-03-17,69,17:00,17:15,30.32,,0,30.32,30.32,1,-55247,80642,135889,25395,0,0,1687,0,0,,1687,1687
36,09-03-17,70,17:15,17:30,30.63,,0,30.63,30.63,1,-37070,50827,87897,13757,0,0,91,0,0,,91,91
36,09-03-17,71,17:30,17:45,46.74,,0,46.74,46.74,1,-63216,33105,96321,-30111,0,0,10597,0,0,,10597,10597
36,09-03-17,72,17:45,18:00,60.49,,0,60.49,60.49,1,-63385,39127,102512,-24258,0,0,32219,0,0,,32219,32219
36,09-03-17,73,18:00,18:15,30.63,,0,30.63,30.63,1,-55057,19323,74380,-35734,0,0,8299,0,0,,8299,8299
36,09-03-17,74,18:15,18:30,37.55,,0,37.55,37.55,1,-51787,26405,78192,-25382,0,0,1077,0,0,,1077,1077
36,09-03-17,75,18:30,18:45,46.32,,0,46.32,46.32,1,-47733,32454,80187,-15279,0,0,16499,0,0,,16499,16499
36,09-03-17,76,18:45,19:00,40.63,,0,40.63,40.63,1,-57134,29223,86357,-27911,0,0,16325,0,0,,16325,16325
36,09-03-17,77,19:00,19:15,35.12,,0,35.12,35.12,1,-69722,39631,109353,-30091,0,0,19058,0,0,,19058,19058
36,09-03-17,78,19:15,19:30,34.63,,0,34.63,34.63,1,-43768,37477,81245,-6291,0,0,8610,0,0,,8610,8610
36,09-03-17,79,19:30,19:45,30.66,,0,30.66,30.66,1,-45354,35942,81296,-9412,0,0,5123,0,0,,5123,5123
36,09-03-17,80,19:45,20:00,44.88,,0,44.88,44.88,1,-47301,28241,75542,-19060,0,0,11742,0,0,,11742,11742
36,09-03-17,81,20:00,20:15,31.15,32.6,0,39.53,32.6,2,-10949,72522,83471,61573,0,-798,5814,0,0,,6612,5016
36,09-03-17,82,20:15,20:30,,,0,39.52,39.52,0,-27774,49707,77481,21933,0,0,0,0,0,,0,0
36,09-03-17,83,20:30,20:45,,,0,39.51,39.51,0,-47452,37252,84704,-10200,0,0,0,0,0,,0,0
36,09-03-17,84,20:45,21:00,30.63,,0,30.63,30.63,1,-62550,26470,89020,-36080,0,0,392,0,0,,392,392
36,09-03-17,85,21:00,21:15,34.91,,0,34.91,34.91,1,-48227,51496,99723,3269,0,0,4624,0,0,,4624,4624
36,09-03-17,86,21:15,21:30,30.25,23.63,0,23.63,23.63,-1,-27507,57136,84643,29629,0,-2110,1614,0,0,,3724,-496
36,09-03-17,87,21:30,21:45,,23.63,0,23.63,23.63,-1,-17051,62893,79944,45842,0,-4496,0,0,0,,4496,-4496
36,09-03-17,88,21:45,22:00,,7.39,0,7.39,7.39,-1,-18732,72627,91359,53895,0,-23080,0,0,0,,23080,-23080
36,09-03-17,89,22:00,22:15,30.63,29.03,0,30.63,30.63,1,-73436,33283,106719,-40153,0,-8053,675,0,0,,8728,-7378
36,09-03-17,90,22:15,22:30,30.63,,0,30.63,30.63,1,-51780,28317,80097,-23463,0,0,1891,0,0,,1891,1891
36,09-03-17,91,22:30,22:45,,,0,35.95,35.95,0,-35211,43250,78461,8039,0,0,157,0,0,,157,157
36,09-03-17,92,22:45,23:00,,28.03,0,28.03,28.03,-1,-37785,74730,112515,36945,0,-1806,0,0,0,,1806,-1806
36,09-03-17,93,23:00,23:15,36,28.03,0,36,28.03,2,-64035,39483,103518,-24552,0,-2560,3942,0,0,,6502,1382
36,09-03-17,94,23:15,23:30,31.26,,0,31.26,31.26,1,-54008,27974,81982,-26034,0,0,2129,0,0,,2129,2129
36,09-03-17,95,23:30,23:45,30.63,,0,30.63,30.63,1,-34783,33773,68556,-1010,0,0,617,0,0,,617,617
36,09-03-17,96,23:45,0:00,30.32,27.37,0,35.98,27.37,2,-25755,49695,75450,23940,0,-4824,88,0,0,,4912,-4736
36,09-04-17,1,0:00,0:15,42.69,27.37,0,42.69,42.69,1,-50904,31043,81947,-19861,0,-1482,5270,0,0,,6752,3788
36,09-04-17,2,0:15,0:30,32.69,,0,32.69,32.69,1,-36540,24312,60852,-12228,0,0,2687,0,0,,2687,2687
36,09-04-17,3,0:30,0:45,,,0,35.96,35.96,0,-56099,31302,87401,-24797,0,0,0,0,0,,0,0
36,09-04-17,4,0:45,1:00,,17.21,0,17.21,17.21,-1,-40383,57849,98232,17466,0,-2849,0,0,0,,2849,-2849
36,09-04-17,5,1:00,1:15,30.12,-8.52,0,35.89,-8.52,2,-42857,66782,109639,23925,0,-11374,1,0,0,,11375,-11373
36,09-04-17,6,1:15,1:30,30.19,23.79,0,35.9,23.79,2,-29941,34117,64058,4176,0,-1994,250,0,0,,2244,-1744
36,09-04-17,7,1:30,1:45,,20.83,0,20.83,20.83,-1,-37287,50460,87747,13173,0,-16300,0,0,0,,16300,-16300
36,09-04-17,8,1:45,2:00,,27.78,0,27.78,27.78,-1,-35574,47615,83189,12041,0,-19244,0,0,0,,19244,-19244
36,09-04-17,9,2:00,2:15,32.64,25.78,0,32.64,32.64,1,-27443,49412,76855,21969,0,-11020,225,0,0,,11245,-10795
36,09-04-17,10,2:15,2:30,32.69,25.78,0,32.69,32.69,1,-23764,31343,55107,7579,0,-143,358,0,0,,501,215
36,09-04-17,11,2:30,2:45,,30.69,0,30.69,30.69,-1,-21415,24196,45611,2781,0,-1194,0,0,0,,1194,-1194
36,09-04-17,12,2:45,3:00,,25.69,0,25.69,25.69,-1,-21871,29770,51641,7899,0,-7887,0,0,0,,7887,-7887
36,09-04-17,13,3:00,3:15,,41.76,0,41.76,41.76,-1,-22985,22769,45754,-216,0,-1828,0,0,0,,1828,-1828
36,09-04-17,14,3:15,3:30,30.25,,0,30.25,30.25,1,-25208,17232,42440,-7976,0,0,435,0,0,,435,435
36,09-04-17,15,3:30,3:45,30.64,,0,30.64,30.64,1,-21990,17276,39266,-4714,0,0,1317,0,0,,1317,1317
36,09-04-17,16,3:45,4:00,30.64,41.74,0,41.74,41.74,-1,-18928,37983,56911,19055,0,-15,36,0,0,,51,21
36,09-04-17,17,4:00,4:15,,41.75,0,41.75,41.75,-1,-34972,28818,63790,-6154,0,-28,0,0,0,,28,-28
36,09-04-17,18,4:15,4:30,,,0,35.94,35.94,0,-30390,23726,54116,-6664,0,0,0,0,0,,0,0
36,09-04-17,19,4:30,4:45,,30.69,0,30.69,30.69,-1,-13785,23916,37701,10131,0,-583,0,0,0,,583,-583
36,09-04-17,20,4:45,5:00,,41.74,0,41.74,41.74,-1,-6961,53090,60051,46129,0,-582,0,0,0,,582,-582
36,09-04-17,21,5:00,5:15,,,0,35.97,35.97,0,-73042,25323,98365,-47719,0,-19,0,0,0,,19,-19
36,09-04-17,22,5:15,5:30,,30.69,0,30.69,30.69,-1,-24987,43085,68072,18098,0,-691,0,0,0,,691,-691
36,09-04-17,23,5:30,5:45,,23.27,0,23.27,23.27,-1,-40716,68374,109090,27658,0,-10673,0,0,0,,10673,-10673
36,09-04-17,24,5:45,6:00,32.69,23.27,0,32.69,32.69,1,-59265,52318,111583,-6947,0,-1154,437,0,0,,1591,-717
36,09-04-17,25,6:00,6:15,33.12,,0,33.12,33.12,1,-71556,44903,116459,-26653,0,0,1276,0,0,,1276,1276
36,09-04-17,26,6:15,6:30,36.69,,0,36.69,36.69,1,-23275,34751,58026,11476,0,0,936,0,0,,936,936
36,09-04-17,27,6:30,6:45,96.12,,0,96.12,96.12,1,-56983,11386,68369,-45597,0,0,9011,0,0,,9011,9011
36,09-04-17,28,6:45,7:00,120.12,,0,120.12,120.12,1,-61661,68747,130408,7086,0,0,27612,0,0,,27612,27612
36,09-04-17,29,7:00,7:15,120.12,38.08,0,38.08,38.08,-1,-33951,95764,129715,61813,0,-1314,2133,0,0,,3447,819
36,09-04-17,30,7:15,7:30,,,0,39.58,39.58,0,-28704,50628,79332,21924,0,0,0,0,0,,0,0
36,09-04-17,31,7:30,7:45,,,0,39.52,39.52,0,-39690,48289,87979,8599,0,0,0,0,0,,0,0
36,09-04-17,32,7:45,8:00,35.89,,0,35.89,35.89,1,-74362,55071,129433,-19291,0,0,3232,0,0,,3232,3232
36,09-04-17,33,8:00,8:15,35.89,25.33,0,25.33,25.33,-1,-46580,66384,112964,19804,0,-9069,807,0,0,,9876,-8262
36,09-04-17,34,8:15,8:30,,34.02,0,34.02,34.02,-1,-50859,51315,102174,456,0,-8196,0,0,0,,8196,-8196
36,09-04-17,35,8:30,8:45,,,0,39.47,39.47,0,-66154,42020,108174,-24134,0,-775,0,0,0,,775,-775
36,09-04-17,36,8:45,9:00,,,0,39.46,39.46,0,-82146,38641,120787,-43505,0,0,0,0,0,,0,0
36,09-04-17,37,9:00,9:15,,,0,39.49,39.49,0,-85805,34937,120742,-50868,0,0,0,0,0,,0,0
36,09-04-17,38,9:15,9:30,32.12,,0,32.12,32.12,1,-85718,33889,119607,-51829,0,0,597,0,0,,597,597
36,09-04-17,39,9:30,9:45,32.69,,0,32.69,32.69,1,-75313,35550,110863,-39763,0,0,1368,0,0,,1368,1368
36,09-04-17,40,9:45,10:00,30.29,,0,30.29,30.29,1,-70526,34952,105478,-35574,0,0,1093,0,0,,1093,1093
36,09-04-17,41,10:00,10:15,44.85,,0,44.85,44.85,1,-69852,28372,98224,-41480,0,0,11027,0,0,,11027,11027
36,09-04-17,42,10:15,10:30,33.8,,0,33.8,33.8,1,-62481,28669,91150,-33812,0,0,5377,0,0,,5377,5377
36,09-04-17,43,10:30,10:45,30.3,,0,30.3,30.3,1,-68468,27442,95910,-41026,0,0,934,0,0,,934,934
36,09-04-17,44,10:45,11:00,,,0,35.99,35.99,0,-68531,28512,97043,-40019,0,0,43,0,0,,43,43
36,09-04-17,45,11:00,11:15,,30.78,0,30.78,30.78,-1,-55417,52145,107562,-3272,0,-745,0,0,0,,745,-745
36,09-04-17,46,11:15,11:30,,30.69,0,30.69,30.69,-1,-48094,53797,101891,5703,0,-5743,0,0,0,,5743,-5743
36,09-04-17,47,11:30,11:45,,38.09,0,38.09,38.09,-1,-36428,76844,113272,40416,0,-3511,0,0,0,,3511,-3511
36,09-04-17,48,11:45,12:00,,20.75,0,20.75,20.75,-1,-24563,105300,129863,80737,0,-2030,0,0,0,,2030,-2030
36,09-04-17,49,12:00,12:15,,7.07,0,7.07,7.07,-1,-34948,103912,138860,68964,0,-22873,0,0,0,,22873,-22873
36,09-04-17,50,12:15,12:30,,-0.69,0,-0.69,-0.69,-1,-30434,107706,138140,77272,0,-47149,0,0,0,,47149,-47149
36,09-04-17,51,12:30,12:45,,-5.48,0,-5.48,-5.48,-1,-30890,115629,146519,84739,0,-28805,0,0,0,,28805,-28805
36,09-04-17,52,12:45,13:00,,-26.78,0,-26.78,-26.78,-1,-43015,119433,162448,76418,0,-25547,0,0,0,,25547,-25547
36,09-04-17,53,13:00,13:15,,8.25,0,8.25,8.25,-1,-58366,79678,138044,21312,0,-24661,0,0,0,,24661,-24661
36,09-04-17,54,13:15,13:30,,,0,36.06,36.06,0,-63421,78445,141866,15024,0,-5,0,0,0,,5,-5
36,09-04-17,55,13:30,13:45,,36.11,0,36.11,36.11,-1,-49362,62448,111810,13086,0,-254,0,0,0,,254,-254
36,09-04-17,56,13:45,14:00,,30.69,0,30.69,30.69,-1,-45692,46508,92200,816,0,-6476,0,0,0,,6476,-6476
36,09-04-17,57,14:00,14:15,76.12,30.69,0,76.12,76.12,1,-76124,25480,101604,-50644,0,-819,12543,0,0,,13362,11724
36,09-04-17,58,14:15,14:30,42.42,,0,42.42,42.42,1,-59229,45935,105164,-13294,0,0,26691,0,0,,26691,26691
36,09-04-17,59,14:30,14:45,42.42,38.2,0,38.2,38.2,-1,-52764,45534,98298,-7230,0,-105,3323,0,0,,3428,3218
36,09-04-17,60,14:45,15:00,,,0,36.08,36.08,0,-58351,51048,109399,-7303,0,0,0,0,0,,0,0
36,09-04-17,61,15:00,15:15,,,0,36.07,36.07,0,-80756,61239,141995,-19517,0,0,0,0,0,,0,0
36,09-04-17,62,15:15,15:30,,,0,36.03,36.03,0,-64135,48365,112500,-15770,0,0,0,0,0,,0,0
36,09-04-17,63,15:30,15:45,34.35,,0,34.35,34.35,1,-86118,41546,127664,-44572,0,0,688,0,0,,688,688
36,09-04-17,64,15:45,16:00,33,,0,33,33,1,-96249,38322,134571,-57927,0,0,1688,0,0,,1688,1688
36,09-04-17,65,16:00,16:15,34.1,,0,34.1,34.1,1,-74389,53558,127947,-20831,0,0,1298,0,0,,1298,1298
36,09-04-17,66,16:15,16:30,33.96,,0,33.96,33.96,1,-60143,54604,114747,-5539,0,0,791,0,0,,791,791
36,09-04-17,67,16:30,16:45,42.69,,0,42.69,42.69,1,-78182,53505,131687,-24677,0,0,8565,0,0,,8565,8565
36,09-04-17,68,16:45,17:00,49.1,,0,49.1,49.1,1,-92238,58607,150845,-33631,0,0,27444,0,0,,27444,27444
36,09-04-17,69,17:00,17:15,49.1,29.69,0,29.69,29.69,-1,-66182,69225,135407,3043,0,-1083,5722,0,0,,6805,4639
36,09-04-17,70,17:15,17:30,45.23,,0,45.23,45.23,1,-83035,54798,137833,-28237,0,0,4008,0,0,,4008,4008
36,09-04-17,71,17:30,17:45,41.53,,0,41.53,41.53,1,-75210,50207,125417,-25003,0,0,13419,0,0,,13419,13419
36,09-04-17,72,17:45,18:00,35.6,,0,35.6,35.6,1,-63550,55317,118867,-8233,0,0,15455,0,0,,15455,15455
36,09-04-17,73,18:00,18:15,33.54,,0,33.54,33.54,1,-83247,24954,108201,-58293,0,0,7343,0,0,,7343,7343
36,09-04-17,74,18:15,18:30,32.69,,0,32.69,32.69,1,-48020,30428,78448,-17592,0,0,142,0,0,,142,142
36,09-04-17,75,18:30,18:45,33.1,,0,33.1,33.1,1,-37669,36254,73923,-1415,0,0,182,0,0,,182,182
36,09-04-17,76,18:45,19:00,34.03,,0,34.03,34.03,1,-38525,35551,74076,-2974,0,0,1103,0,0,,1103,1103
36,09-04-17,77,19:00,19:15,30.3,,0,30.3,30.3,1,-42107,24537,66644,-17570,0,0,302,0,0,,302,302
36,09-04-17,78,19:15,19:30,35.15,,0,35.15,35.15,1,-43842,24519,68361,-19323,0,0,1768,0,0,,1768,1768
36,09-04-17,79,19:30,19:45,34.53,,0,34.53,34.53,1,-47050,37743,84793,-9307,0,0,1364,0,0,,1364,1364
36,09-04-17,80,19:45,20:00,32.69,,0,32.69,32.69,1,-55102,39998,95100,-15104,0,0,1931,0,0,,1931,1931
36,09-04-17,81,20:00,20:15,,,0,39.72,39.72,0,-32039,51997,84036,19958,0,0,152,0,0,,152,152
36,09-04-17,82,20:15,20:30,30.33,,0,30.33,30.33,1,-43184,33562,76746,-9622,0,0,70,0,0,,70,70
36,09-04-17,83,20:30,20:45,51.71,,0,51.71,51.71,1,-72242,34004,106246,-38238,0,0,3091,0,0,,3091,3091
36,09-04-17,84,20:45,21:00,33.89,,0,33.89,33.89,1,-82359,36605,118964,-45754,0,0,2366,0,0,,2366,2366
36,09-04-17,85,21:00,21:15,62.12,,0,62.12,62.12,1,-73855,33039,106894,-40816,0,0,14208,0,0,,14208,14208
36,09-04-17,86,21:15,21:30,42.38,,0,42.38,42.38,1,-55170,35676,90846,-19494,0,0,22821,0,0,,22821,22821
36,09-04-17,87,21:30,21:45,42.38,37.9,0,37.9,37.9,-1,-39069,60699,99768,21630,0,-890,2374,0,0,,3264,1484
36,09-04-17,88,21:45,22:00,,12.83,0,12.83,12.83,-1,-36920,76861,113781,39941,0,-10422,0,0,0,,10422,-10422
36,09-04-17,89,22:00,22:15,,2.14,0,2.14,2.14,-1,-84397,38092,122489,-46305,0,-16126,0,0,0,,16126,-16126
36,09-04-17,90,22:15,22:30,,29.69,0,29.69,29.69,-1,-53530,33371,86901,-20159,0,-394,0,0,0,,394,-394
36,09-04-17,91,22:30,22:45,,25.69,0,25.69,25.69,-1,-34718,59457,94175,24739,0,-6422,0,0,0,,6422,-6422
36,09-04-17,92,22:45,23:00,,3.71,0,3.71,3.71,-1,-26087,83909,109996,57822,0,-15699,0,0,0,,15699,-15699
36,09-04-17,93,23:00,23:15,45.12,-52.95,0,45.12,-52.95,2,-77196,43020,120216,-34176,0,-17580,3407,0,0,,20987,-14173
36,09-04-17,94,23:15,23:30,32.12,,0,32.12,32.12,1,-70654,35114,105768,-35540,0,0,1674,0,0,,1674,1674
36,09-04-17,95,23:30,23:45,,,0,36.22,36.22,0,-58748,32330,91078,-26418,0,0,0,0,0,,0,0
36,09-04-17,96,23:45,0:00,,30.69,0,30.69,30.69,-1,-50195,44496,94691,-5699,0,-285,0,0,0,,285,-285
36,09-05-17,1,0:00,0:15,,29.69,0,29.69,29.69,-1,-64039,29602,93641,-34437,0,-579,0,0,0,,579,-579
36,09-05-17,2,0:15,0:30,,,0,35.91,35.91,0,-57133,25415,82548,-31718,0,0,0,0,0,,0,0
36,09-05-17,3,0:30,0:45,,,0,36.02,36.02,0,-71338,29989,101327,-41349,0,0,0,0,0,,0,0
36,09-05-17,4,0:45,1:00,,29.69,0,29.69,29.69,-1,-58395,47961,106356,-10434,0,-1317,0,0,0,,1317,-1317
36,09-05-17,5,1:00,1:15,89.72,25.69,0,89.72,25.69,2,-61974,30250,92224,-31724,0,-3003,7918,0,0,,10921,4915
36,09-05-17,6,1:15,1:30,129.93,,0,129.93,129.93,1,-66032,46085,112117,-19947,0,0,33053,0,0,,33053,33053
36,09-05-17,7,1:30,1:45,129.93,30.69,0,30.69,30.69,-1,-34623,59592,94215,24969,0,-2090,616,0,0,,2706,-1474
36,09-05-17,8,1:45,2:00,,21.23,0,21.23,21.23,-1,-42825,65556,108381,22731,0,-21746,0,0,0,,21746,-21746
36,09-05-17,9,2:00,2:15,37.05,29.69,0,37.05,37.05,1,-56293,43866,100159,-12427,0,-12628,1402,0,0,,14030,-11226
36,09-05-17,10,2:15,2:30,42.69,29.69,0,42.69,42.69,1,-44553,38977,83530,-5576,0,-46,10157,0,0,,10203,10111
36,09-05-17,11,2:30,2:45,42.69,40.98,0,40.98,40.98,-1,-35400,54568,89968,19168,0,-20,188,0,0,,208,168
36,09-05-17,12,2:45,3:00,,3.93,0,3.93,3.93,-1,-23103,73671,96774,50568,0,-27041,0,0,0,,27041,-27041
36,09-05-17,13,3:00,3:15,,-13.64,0,-13.64,-13.64,-1,-35243,43758,79001,8515,0,-33218,0,0,0,,33218,-33218
36,09-05-17,14,3:15,3:30,,0.27,0,0.27,0.27,-1,-31424,67443,98867,36019,0,-10274,0,0,0,,10274,-10274
36,09-05-17,15,3:30,3:45,,1.96,0,1.96,1.96,-1,-45306,63387,108693,18081,0,-29127,0,0,0,,29127,-29127
36,09-05-17,16,3:45,4:00,,29.69,0,29.69,29.69,-1,-49738,57862,107600,8124,0,-6451,0,0,0,,6451,-6451
36,09-05-17,17,4:00,4:15,,40.8,0,40.8,40.8,-1,-44482,44300,88782,-182,0,-2145,0,0,0,,2145,-2145
36,09-05-17,18,4:15,4:30,,39.99,0,39.99,39.99,-1,-54866,47008,101874,-7858,0,-2694,0,0,0,,2694,-2694
36,09-05-17,19,4:30,4:45,,39.64,0,39.64,39.64,-1,-48171,54438,102609,6267,0,-953,0,0,0,,953,-953
36,09-05-17,20,4:45,5:00,,39.35,0,39.35,39.35,-1,-54160,60045,114205,5885,0,-1341,0,0,0,,1341,-1341
36,09-05-17,21,5:00,5:15,,29.69,0,29.69,29.69,-1,-74641,75143,149784,502,0,-1885,0,0,0,,1885,-1885
36,09-05-17,22,5:15,5:30,,30.69,0,30.69,30.69,-1,-59577,72417,131994,12840,0,-1062,0,0,0,,1062,-1062
36,09-05-17,23,5:30,5:45,,29.69,0,29.69,29.69,-1,-44339,60290,104629,15951,0,-1776,0,0,0,,1776,-1776
36,09-05-17,24,5:45,6:00,32.69,,0,32.69,32.69,1,-55824,52776,108600,-3048,0,0,39,0,0,,39,39
36,09-05-17,25,6:00,6:15,32.69,30.69,0,36.02,30.69,2,-77931,53286,131217,-24645,0,-227,217,0,0,,444,-10
36,09-05-17,26,6:15,6:30,,,0,36.02,36.02,0,-62297,72582,134879,10285,0,0,0,0,0,,0,0
36,09-05-17,27,6:30,6:45,36.69,,0,36.69,36.69,1,-105650,48832,154482,-56818,0,0,2114,0,0,,2114,2114
36,09-05-17,28,6:45,7:00,146.81,,0,146.81,146.81,1,-104228,43372,147600,-60856,0,0,22681,0,0,,22681,22681
36,09-05-17,29,7:00,7:15,33.02,19.73,0,36.04,19.73,2,-52803,94680,147483,41877,0,-6729,4518,0,0,,11247,-2211
36,09-05-17,30,7:15,7:30,,30.69,0,30.69,30.69,-1,-43662,69608,113270,25946,0,-6192,0,0,0,,6192,-6192
36,09-05-17,31,7:30,7:45,,30.69,0,30.69,30.69,-1,-79368,75957,155325,-3411,0,-5937,0,0,0,,5937,-5937
36,09-05-17,32,7:45,8:00,54.89,30.69,0,54.89,54.89,1,-127366,73951,201317,-53415,0,-350,8147,0,0,,8497,7797
36,09-05-17,33,8:00,8:15,34.02,,0,34.02,34.02,1,-75854,64605,140459,-11249,0,0,4813,0,0,,4813,4813
36,09-05-17,34,8:15,8:30,,,0,39.51,39.51,0,-89222,61936,151158,-27286,0,0,0,0,0,,0,0
36,09-05-17,35,8:30,8:45,34.19,,0,34.19,34.19,1,-105959,76182,182141,-29777,0,0,219,0,0,,219,219
36,09-05-17,36,8:45,9:00,56.55,,0,56.55,56.55,1,-117533,73062,190595,-44471,0,0,8811,0,0,,8811,8811
36,09-05-17,37,9:00,9:15,,,0,39.51,39.51,0,-79254,80457,159711,1203,0,0,557,0,0,,557,557
36,09-05-17,38,9:15,9:30,30,,0,30,30,1,-70324,67902,138226,-2422,0,0,66,0,0,,66,66
36,09-05-17,39,9:30,9:45,30.02,,0,30.02,30.02,1,-61143,82260,143403,21117,0,0,40,0,0,,40,40
36,09-05-17,40,9:45,10:00,,36.87,0,36.87,36.87,-1,-55853,96406,152259,40553,0,-1211,0,0,0,,1211,-1211
36,09-05-17,41,10:00,10:15,,,0,36.01,36.01,0,-43296,69018,112314,25722,0,-106,0,0,0,,106,-106
36,09-05-17,42,10:15,10:30,,,0,36.02,36.02,0,-48715,94743,143458,46028,0,0,0,0,0,,0,0
36,09-05-17,43,10:30,10:45,,,0,36.02,36.02,0,-53279,90880,144159,37601,0,0,0,0,0,,0,0
36,09-05-17,44,10:45,11:00,,37.46,0,37.46,37.46,-1,-55309,88550,143859,33241,0,-180,0,0,0,,180,-180
36,09-05-17,45,11:00,11:15,,30.69,0,30.69,30.69,-1,-65537,60247,125784,-5290,0,-1087,0,0,0,,1087,-1087
36,09-05-17,46,11:15,11:30,,32.99,0,32.99,32.99,-1,-64948,71441,136389,6493,0,-888,0,0,0,,888,-888
36,09-05-17,47,11:30,11:45,,30.69,0,30.69,30.69,-1,-72088,73371,145459,1283,0,-3048,0,0,0,,3048,-3048
36,09-05-17,48,11:45,12:00,,42.1,0,42.1,42.1,-1,-81815,70060,151875,-11755,0,-452,0,0,0,,452,-452
36,09-05-17,49,12:00,12:15,,,0,36.05,36.05,0,-117914,31863,149777,-86051,0,0,0,0,0,,0,0
36,09-05-17,50,12:15,12:30,,,0,36.05,36.05,0,-118158,57518,175676,-60640,0,0,0,0,0,,0,0
36,09-05-17,51,12:30,12:45,,,0,36.06,36.06,0,-88156,64478,152634,-23678,0,0,0,0,0,,0,0
36,09-05-17,52,12:45,13:00,,,0,36.06,36.06,0,-99077,57561,156638,-41516,0,0,0,0,0,,0,0
36,09-05-17,53,13:00,13:15,,41.74,0,41.74,41.74,-1,-95439,98090,193529,2651,0,-399,0,0,0,,399,-399
36,09-05-17,54,13:15,13:30,,39.22,0,39.22,39.22,-1,-119882,108590,228472,-11292,0,-973,0,0,0,,973,-973
36,09-05-17,55,13:30,13:45,,,0,36.03,36.03,0,-146020,93995,240015,-52025,0,-29,0,0,0,,29,-29
36,09-05-17,56,13:45,14:00,,,0,36.01,36.01,0,-151085,98313,249398,-52772,0,0,0,0,0,,0,0
36,09-05-17,57,14:00,14:15,58.82,,0,58.82,58.82,1,-144311,108619,252930,-35692,0,0,13048,0,0,,13048,13048
36,09-05-17,58,14:15,14:30,35.19,,0,35.19,35.19,1,-130580,118880,249460,-11700,0,0,12570,0,0,,12570,12570
36,09-05-17,59,14:30,14:45,36.4,,0,36.4,36.4,1,-122054,101921,223975,-20133,0,0,9542,0,0,,9542,9542
36,09-05-17,60,14:45,15:00,34.15,,0,34.15,34.15,1,-115222,91680,206902,-23542,0,0,15558,0,0,,15558,15558
36,09-05-17,61,15:00,15:15,30.11,,0,30.11,30.11,1,-110680,105610,216290,-5070,0,0,3935,0,0,,3935,3935
36,09-05-17,62,15:15,15:30,32.69,,0,32.69,32.69,1,-117743,112714,230457,-5029,0,0,1144,0,0,,1144,1144
36,09-05-17,63,15:30,15:45,30.11,,0,30.11,30.11,1,-117252,115013,232265,-2239,0,0,2470,0,0,,2470,2470
36,09-05-17,64,15:45,16:00,,,0,36.04,36.04,0,-109306,137000,246306,27694,0,0,399,0,0,,399,399
36,09-05-17,65,16:00,16:15,,,0,36.04,36.04,0,-93434,164449,257883,71015,0,0,0,0,0,,0,0
36,09-05-17,66,16:15,16:30,,42.15,0,42.15,42.15,-1,-70312,161847,232159,91535,0,-307,0,0,0,,307,-307
36,09-05-17,67,16:30,16:45,,42.15,0,42.15,42.15,-1,-72518,142799,215317,70281,0,-853,0,0,0,,853,-853
36,09-05-17,68,16:45,17:00,,,0,36.04,36.04,0,-70527,124717,195244,54190,0,0,0,0,0,,0,0
36,09-05-17,69,17:00,17:15,33.42,,0,33.42,33.42,1,-88461,76656,165117,-11805,0,0,951,0,0,,951,951
36,09-05-17,70,17:15,17:30,36.69,,0,36.69,36.69,1,-80097,65688,145785,-14409,0,0,5057,0,0,,5057,5057
36,09-05-17,71,17:30,17:45,32.69,,0,32.69,32.69,1,-79971,88658,168629,8687,0,0,5871,0,0,,5871,5871
36,09-05-17,72,17:45,18:00,,,0,36.05,36.05,0,-77504,121966,199470,44462,0,0,133,0,0,,133,133
36,09-05-17,73,18:00,18:15,,,0,39.6,39.6,0,-122114,102165,224279,-19949,0,0,0,0,0,,0,0
36,09-05-17,74,18:15,18:30,,41.84,0,41.84,41.84,-1,-89907,102861,192768,12954,0,-367,0,0,0,,367,-367
36,09-05-17,75,18:30,18:45,,36.52,0,36.52,36.52,-1,-84789,108993,193782,24204,0,-836,0,0,0,,836,-836
36,09-05-17,76,18:45,19:00,,,0,39.62,39.62,0,-86430,109670,196100,23240,0,0,0,0,0,,0,0
36,09-05-17,77,19:00,19:15,34.35,,0,34.35,34.35,1,-111850,87860,199710,-23990,0,0,462,0,0,,462,462
36,09-05-17,78,19:15,19:30,36.11,,0,36.11,36.11,1,-102328,74365,176693,-27963,0,0,4831,0,0,,4831,4831
36,09-05-17,79,19:30,19:45,30.35,,0,30.35,30.35,1,-83719,112115,195834,28396,0,0,1044,0,0,,1044,1044
36,09-05-17,80,19:45,20:00,,,0,39.62,39.62,0,-73516,118009,191525,44493,0,0,0,0,0,,0,0
36,09-05-17,81,20:00,20:15,,39.5,0,39.5,39.5,-1,-40348,143310,183658,102962,0,-149,0,0,0,,149,-149
36,09-05-17,82,20:15,20:30,,39.88,0,39.88,39.88,-1,-39712,128957,168669,89245,0,-157,0,0,0,,157,-157
36,09-05-17,83,20:30,20:45,,29.69,0,29.69,29.69,-1,-60625,128483,189108,67858,0,-4701,0,0,0,,4701,-4701
36,09-05-17,84,20:45,21:00,,25.69,0,25.69,25.69,-1,-57422,98750,156172,41328,0,-22026,0,0,0,,22026,-22026
36,09-05-17,85,21:00,21:15,,30.69,0,30.69,30.69,-1,-74369,112485,186854,38116,0,-13967,0,0,0,,13967,-13967
36,09-05-17,86,21:15,21:30,,,0,36.07,36.07,0,-68057,112475,180532,44418,0,-189,0,0,0,,189,-189
36,09-05-17,87,21:30,21:45,,3.8,0,3.8,3.8,-1,-39412,112720,152132,73308,0,-6183,0,0,0,,6183,-6183
36,09-05-17,88,21:45,22:00,,3.41,0,3.41,3.41,-1,-51431,86364,137795,34933,0,-41286,0,0,0,,41286,-41286
36,09-05-17,89,22:00,22:15,36.69,29.69,0,36.69,29.69,2,-120043,43324,163367,-76719,0,-18917,1290,0,0,,20207,-17627
36,09-05-17,90,22:15,22:30,36.69,37.92,0,37.92,37.92,-1,-91441,47373,138814,-44068,0,-315,1021,0,0,,1336,706
36,09-05-17,91,22:30,22:45,,30.19,0,30.19,30.19,-1,-51429,71802,123231,20373,0,-2703,0,0,0,,2703,-2703
36,09-05-17,92,22:45,23:00,,25.03,0,25.03,25.03,-1,-48601,70802,119403,22201,0,-9600,0,0,0,,9600,-9600
36,09-05-17,93,23:00,23:15,30.39,9.03,0,30.39,30.39,1,-52908,56559,109467,3651,0,-12095,76,0,0,,12171,-12019
36,09-05-17,94,23:15,23:30,30.37,40.63,0,36.03,36.03,2,-51658,45459,97117,-6199,0,-95,715,0,0,,810,620
36,09-05-17,95,23:30,23:45,,25.03,0,25.03,25.03,-1,-51678,67912,119590,16234,0,-4734,0,0,0,,4734,-4734
36,09-05-17,96,23:45,0:00,,31.99,0,31.99,31.99,-1,-81580,51667,133247,-29913,0,-5437,0,0,0,,5437,-5437
36,09-06-17,1,0:00,0:15,32.69,31.99,0,32.69,32.69,1,-70371,30354,100725,-40017,0,-3,856,0,0,,859,853
36,09-06-17,2,0:15,0:30,29.99,,0,29.99,29.99,1,-75330,29480,104810,-45850,0,0,816,0,0,,816,816
36,09-06-17,3,0:30,0:45,,,0,36.06,36.06,0,-66409,28986,95395,-37423,0,0,0,0,0,,0,0
36,09-06-17,4,0:45,1:00,,29.69,0,29.69,29.69,-1,-67106,41630,108736,-25476,0,-234,0,0,0,,234,-234
36,09-06-17,5,1:00,1:15,,13.67,0,13.67,13.67,-1,-66175,69682,135857,3507,0,-6559,0,0,0,,6559,-6559
36,09-06-17,6,1:15,1:30,,29.69,0,29.69,29.69,-1,-58579,39826,98405,-18753,0,-1524,0,0,0,,1524,-1524
36,09-06-17,7,1:30,1:45,,29.69,0,29.69,29.69,-1,-58098,42124,100222,-15974,0,-2370,0,0,0,,2370,-2370
36,09-06-17,8,1:45,2:00,,,0,35.05,35.05,0,-79064,36003,115067,-43061,0,0,0,0,0,,0,0
36,09-06-17,9,2:00,2:15,94.44,,0,94.44,94.44,1,-78235,38990,117225,-39245,0,0,10671,0,0,,10671,10671
36,09-06-17,10,2:15,2:30,127.83,,0,127.83,127.83,1,-66689,37555,104244,-29134,0,0,36329,0,0,,36329,36329
36,09-06-17,11,2:30,2:45,127.83,41.59,0,41.59,41.59,-1,-65193,55411,120604,-9782,0,-192,1105,0,0,,1297,913
36,09-06-17,12,2:45,3:00,,41.94,0,41.94,41.94,-1,-73135,51508,124643,-21627,0,-250,0,0,0,,250,-250
36,09-06-17,13,3:00,3:15,32.69,41.88,0,34.5,34.5,2,-91457,56456,147913,-35001,0,-7,405,0,0,,412,398
36,09-06-17,14,3:15,3:30,36.21,,0,36.21,36.21,1,-90176,55995,146171,-34181,0,0,4408,0,0,,4408,4408
36,09-06-17,15,3:30,3:45,30.02,,0,30.02,30.02,1,-76340,49162,125502,-27178,0,0,943,0,0,,943,943
36,09-06-17,16,3:45,4:00,30.63,,0,30.63,30.63,1,-65842,50448,116290,-15394,0,0,37,0,0,,37,37
36,09-06-17,17,4:00,4:15,38.55,,0,38.55,38.55,1,-67855,42614,110469,-25241,0,0,9839,0,0,,9839,9839
36,09-06-17,18,4:15,4:30,30.67,,0,30.67,30.67,1,-58111,45530,103641,-12581,0,0,1177,0,0,,1177,1177
36,09-06-17,19,4:30,4:45,33.07,,0,33.07,33.07,1,-52507,47522,100029,-4985,0,0,2132,0,0,,2132,2132
36,09-06-17,20,4:45,5:00,34.87,,0,34.87,34.87,1,-27503,57030,84533,29527,0,0,3181,0,0,,3181,3181
36,09-06-17,21,5:00,5:15,32.69,,0,32.69,32.69,1,-83736,74542,158278,-9194,0,0,354,0,0,,354,354
36,09-06-17,22,5:15,5:30,,42,0,42,42,-1,-25202,98336,123538,73134,0,-568,0,0,0,,568,-568
36,09-06-17,23,5:30,5:45,,-4.65,0,-4.65,-4.65,-1,-26708,89813,116521,63105,0,-15122,0,0,0,,15122,-15122
36,09-06-17,24,5:45,6:00,,41.9,0,41.9,41.9,-1,-49618,79421,129039,29803,0,-2829,0,0,0,,2829,-2829
36,09-06-17,25,6:00,6:15,,,0,36.02,36.02,0,-102322,91792,194114,-10530,0,0,0,0,0,,0,0
36,09-06-17,26,6:15,6:30,,41.84,0,41.84,41.84,-1,-48097,91110,139207,43013,0,-790,0,0,0,,790,-790
36,09-06-17,27,6:30,6:45,40.25,41.93,0,40.25,35.97,2,-68155,63147,131302,-5008,0,-865,2049,0,0,,2914,1184
36,09-06-17,28,6:45,7:00,42.77,,0,42.77,42.77,1,-58807,105664,164471,46857,0,0,6844,0,0,,6844,6844
36,09-06-17,29,7:00,7:15,42.77,29.77,0,29.77,29.77,-1,-51658,182844,234502,131186,0,-1735,107,0,0,,1842,-1628
36,09-06-17,30,7:15,7:30,,39.39,0,39.39,39.39,-1,-55560,155520,211080,99960,0,-1418,0,0,0,,1418,-1418
36,09-06-17,31,7:30,7:45,,28.79,0,28.79,28.79,-1,-49652,161465,211117,111813,0,-5992,0,0,0,,5992,-5992
36,09-06-17,32,7:45,8:00,,18.41,0,18.41,18.41,-1,-54646,194173,248819,139527,0,-14529,0,0,0,,14529,-14529
36,09-06-17,33,8:00,8:15,,12.5,0,12.5,12.5,-1,-35589,167458,203047,131869,0,-15693,0,0,0,,15693,-15693
36,09-06-17,34,8:15,8:30,,29.77,0,29.77,29.77,-1,-35411,183664,219075,148253,0,-12618,0,0,0,,12618,-12618
36,09-06-17,35,8:30,8:45,,29.77,0,29.77,29.77,-1,-35967,186371,222338,150404,0,-4047,0,0,0,,4047,-4047
36,09-06-17,36,8:45,9:00,,25.77,0,25.77,25.77,-1,-44680,187694,232374,143014,0,-12743,0,0,0,,12743,-12743
36,09-06-17,37,9:00,9:15,,,0,39.51,39.51,0,-53579,128168,181747,74589,0,-2529,0,0,0,,2529,-2529
36,09-06-17,38,9:15,9:30,,,0,39.49,39.49,0,-35556,105066,140622,69510,0,0,0,0,0,,0,0
36,09-06-17,39,9:30,9:45,,41.85,0,41.85,41.85,-1,-24503,87042,111545,62539,0,-885,0,0,0,,885,-885
36,09-06-17,40,9:45,10:00,,12.5,0,12.5,12.5,-1,-27839,109035,136874,81196,0,-12785,0,0,0,,12785,-12785
36,09-06-17,41,10:00,10:15,30.47,30.64,0,30.47,30.47,1,-112511,51838,164349,-60673,0,-5633,330,0,0,,5963,-5303
36,09-06-17,42,10:15,10:30,30.58,30.64,0,30.58,30.58,1,-86658,83036,169694,-3622,0,-7,946,0,0,,953,939
36,09-06-17,43,10:30,10:45,,31.99,0,31.99,31.99,-1,-82558,85452,168010,2894,0,-376,0,0,0,,376,-376
36,09-06-17,44,10:45,11:00,,31.99,0,31.99,31.99,-1,-87827,68251,156078,-19576,0,-1211,0,0,0,,1211,-1211
36,09-06-17,45,11:00,11:15,46.68,31.99,0,46.68,46.68,1,-96101,52779,148880,-43322,0,-15,8129,0,0,,8144,8114
36,09-06-17,46,11:15,11:30,30.5,,0,30.5,30.5,1,-62165,71042,133207,8877,0,0,1722,0,0,,1722,1722
36,09-06-17,47,11:30,11:45,,,0,36.01,36.01,0,-44632,73116,117748,28484,0,0,0,0,0,,0,0
36,09-06-17,48,11:45,12:00,,37.06,0,37.06,37.06,-1,-61721,64719,126440,2998,0,-103,0,0,0,,103,-103
36,09-06-17,49,12:00,12:15,,23.31,0,23.31,23.31,-1,-38320,77274,115594,38954,0,-8136,0,0,0,,8136,-8136
36,09-06-17,50,12:15,12:30,,40.64,0,40.64,40.64,-1,-45175,45710,90885,535,0,-2212,0,0,0,,2212,-2212
36,09-06-17,51,12:30,12:45,,42.08,0,42.08,42.08,-1,-56192,45845,102037,-10347,0,-637,0,0,0,,637,-637
36,09-06-17,52,12:45,13:00,,,0,36.05,36.05,0,-86565,42216,128781,-44349,0,0,0,0,0,,0,0
36,09-06-17,53,13:00,13:15,36.77,,0,36.77,36.77,1,-53242,57179,110421,3937,0,0,396,0,0,,396,396
36,09-06-17,54,13:15,13:30,42.77,,0,42.77,42.77,1,-59371,47571,106942,-11800,0,0,8182,0,0,,8182,8182
36,09-06-17,55,13:30,13:45,36.77,,0,36.77,36.77,1,-58560,62597,121157,4037,0,0,2344,0,0,,2344,2344
36,09-06-17,56,13:45,14:00,36.77,40.1,0,36.77,35.95,2,-60415,60394,120809,-21,0,-27,5012,0,0,,5039,4985
36,09-06-17,57,14:00,14:15,,39.49,0,39.49,39.49,-1,-45543,47369,92912,1826,0,-326,0,0,0,,326,-326
36,09-06-17,58,14:15,14:30,,,0,35.99,35.99,0,-66517,68114,134631,1597,0,0,0,0,0,,0,0
36,09-06-17,59,14:30,14:45,,25.77,0,25.77,25.77,-1,-47376,71070,118446,23694,0,-6954,0,0,0,,6954,-6954
36,09-06-17,60,14:45,15:00,,30.77,0,30.77,30.77,-1,-51541,63930,115471,12389,0,-3945,0,0,0,,3945,-3945
36,09-06-17,61,15:00,15:15,,8.58,0,8.58,8.58,-1,-40204,78155,118359,37951,0,-25408,0,0,0,,25408,-25408
36,09-06-17,62,15:15,15:30,,30.78,0,30.78,30.78,-1,-29225,85978,115203,56753,0,-15454,0,0,0,,15454,-15454
36,09-06-17,63,15:30,15:45,,,0,35.96,35.96,0,-33980,97655,131635,63675,0,0,0,0,0,,0,0
36,09-06-17,64,15:45,16:00,,19.19,0,19.19,19.19,-1,-35740,79111,114851,43371,0,-13443,0,0,0,,13443,-13443
36,09-06-17,65,16:00,16:15,,15.98,0,15.98,15.98,-1,-45542,119774,165316,74232,0,-40331,0,0,0,,40331,-40331
36,09-06-17,66,16:15,16:30,,25.77,0,25.77,25.77,-1,-58601,97271,155872,38670,0,-23199,0,0,0,,23199,-23199
36,09-06-17,67,16:30,16:45,49.02,25.77,0,49.02,49.02,1,-71710,54623,126333,-17087,0,-323,8494,0,0,,8817,8171
36,09-06-17,68,16:45,17:00,33.9,,0,33.9,33.9,1,-46296,48567,94863,2271,0,0,10793,0,0,,10793,10793
36,09-06-17,69,17:00,17:15,34.26,,0,34.26,34.26,1,-93069,55964,149033,-37105,0,0,4737,0,0,,4737,4737
36,09-06-17,70,17:15,17:30,38.55,,0,38.55,38.55,1,-95474,51811,147285,-43663,0,0,3165,0,0,,3165,3165
36,09-06-17,71,17:30,17:45,47.2,,0,47.2,47.2,1,-94431,31850,126281,-62581,0,0,21414,0,0,,21414,21414
36,09-06-17,72,17:45,18:00,126.33,,0,126.33,126.33,1,-85264,27660,112924,-57604,0,0,37229,0,0,,37229,37229
36,09-06-17,73,18:00,18:15,41.3,30.78,0,30.78,30.78,-1,-60559,43657,104216,-16902,0,-707,19190,0,0,,19897,18483
36,09-06-17,74,18:15,18:30,,,0,39.55,39.55,0,-41323,54990,96313,13667,0,-430,0,0,0,,430,-430
36,09-06-17,75,18:30,18:45,,38.69,0,38.69,38.69,-1,-31209,73156,104365,41947,0,-1553,0,0,0,,1553,-1553
36,09-06-17,76,18:45,19:00,,41.81,0,41.81,41.81,-1,-51151,56985,108136,5834,0,-539,0,0,0,,539,-539
36,09-06-17,77,19:00,19:15,,41.28,0,41.28,41.28,-1,-34583,81336,115919,46753,0,-991,0,0,0,,991,-991
36,09-06-17,78,19:15,19:30,,41.95,0,41.95,41.95,-1,-35459,54513,89972,19054,0,-914,0,0,0,,914,-914
36,09-06-17,79,19:30,19:45,39.15,,0,39.15,39.15,1,-47357,41314,88671,-6043,0,0,2493,0,0,,2493,2493
36,09-06-17,80,19:45,20:00,48.83,,0,48.83,48.83,1,-42815,51396,94211,8581,0,0,8692,0,0,,8692,8692
36,09-06-17,81,20:00,20:15,48.83,38.24,0,38.24,38.24,-1,-22149,85993,108142,63844,0,-576,69,0,0,,645,-507
36,09-06-17,82,20:15,20:30,,,0,39.5,39.5,0,-31594,77739,109333,46145,0,0,0,0,0,,0,0
36,09-06-17,83,20:30,20:45,,,0,39.5,39.5,0,-58938,90686,149624,31748,0,0,0,0,0,,0,0
36,09-06-17,84,20:45,21:00,,,0,39.5,39.5,0,-37238,119214,156452,81976,0,0,0,0,0,,0,0
36,09-06-17,85,21:00,21:15,,16.16,0,16.16,16.16,-1,-35124,143286,178410,108162,0,-6403,0,0,0,,6403,-6403
36,09-06-17,86,21:15,21:30,,7.95,0,7.95,7.95,-1,-38501,120623,159124,82122,0,-49897,0,0,0,,49897,-49897
36,09-06-17,87,21:30,21:45,,16.16,0,16.16,16.16,-1,-42527,124044,166571,81517,0,-51355,0,0,0,,51355,-51355
36,09-06-17,88,21:45,22:00,,-14.22,0,-14.22,-14.22,-1,-46391,119727,166118,73336,0,-72155,0,0,0,,72155,-72155
36,09-06-17,89,22:00,22:15,,26.78,0,26.78,26.78,-1,-68590,86375,154965,17785,0,-16265,0,0,0,,16265,-16265
36,09-06-17,90,22:15,22:30,,12.5,0,12.5,12.5,-1,-38779,90581,129360,51802,0,-25726,0,0,0,,25726,-25726
36,09-06-17,91,22:30,22:45,,12.5,0,12.5,12.5,-1,-42166,115805,157971,73639,0,-46796,0,0,0,,46796,-46796
36,09-06-17,92,22:45,23:00,,-35.5,0,-35.5,-35.5,-1,-55359,158160,213519,102801,0,-84983,0,0,0,,84983,-84983
36,09-06-17,93,23:00,23:15,36.95,-13.78,0,36.95,36.95,1,-70147,95737,165884,25590,0,-54891,110,0,0,,55001,-54781
36,09-06-17,94,23:15,23:30,42.77,30.77,0,42.77,30.77,2,-57630,79624,137254,21994,0,-171,344,0,0,,515,173
36,09-06-17,95,23:30,23:45,,29.77,0,29.77,29.77,-1,-63892,89626,153518,25734,0,-1310,0,0,0,,1310,-1310
36,09-06-17,96,23:45,0:00,,2.49,0,2.49,2.49,-1,-55793,119137,174930,63344,0,-30303,0,0,0,,30303,-30303
36,09-07-17,1,0:00,0:15,36.75,-57.52,0,36.75,-57.52,2,-42026,67862,109888,25836,0,-43738,161,0,0,,43899,-43577
36,09-07-17,2,0:15,0:30,120.02,38.04,0,120.02,36.28,2,-65389,68035,133424,2646,0,-707,8180,0,0,,8887,7473
36,09-07-17,3,0:30,0:45,120.02,23.51,0,23.51,23.51,-1,-46282,102863,149145,56581,0,-14197,5,0,0,,14202,-14192
36,09-07-17,4,0:45,1:00,,13.34,0,13.34,13.34,-1,-39878,108485,148363,68607,0,-51302,0,0,0,,51302,-51302
36,09-07-17,5,1:00,1:15,34,8.71,0,36.27,8.71,2,-37677,84415,122092,46738,0,-42505,35,0,0,,42540,-42470
36,09-07-17,6,1:15,1:30,37.23,29.03,0,37.23,29.03,2,-46981,66640,113621,19659,0,-3106,538,0,0,,3644,-2568
36,09-07-17,7,1:30,1:45,,40.34,0,40.34,40.34,-1,-39214,58154,97368,18940,0,-2006,0,0,0,,2006,-2006
36,09-07-17,8,1:45,2:00,,29.03,0,29.03,29.03,-1,-63099,72288,135387,9189,0,-2135,0,0,0,,2135,-2135
36,09-07-17,9,2:00,2:15,,29.03,0,29.03,29.03,-1,-32386,61519,93905,29133,0,-2082,0,0,0,,2082,-2082
36,09-07-17,10,2:15,2:30,,28.99,0,28.99,28.99,-1,-36452,58159,94611,21707,0,-688,0,0,0,,688,-688
36,09-07-17,11,2:30,2:45,30.51,28.99,0,30.51,30.51,1,-47360,47091,94451,-269,0,-500,45,0,0,,545,-455
36,09-07-17,12,2:45,3:00,81.94,,0,81.94,81.94,1,-73804,20394,94198,-53410,0,0,8511,0,0,,8511,8511
36,09-07-17,13,3:00,3:15,129.8,,0,129.8,129.8,1,-84139,27151,111290,-56988,0,0,57186,0,0,,57186,57186
36,09-07-17,14,3:15,3:30,43.02,,0,43.02,43.02,1,-81100,46425,127525,-34675,0,0,35588,0,0,,35588,35588
36,09-07-17,15,3:30,3:45,38.55,,0,38.55,38.55,1,-77541,41741,119282,-35800,0,0,23429,0,0,,23429,23429
36,09-07-17,16,3:45,4:00,34.51,,0,34.51,34.51,1,-76602,43423,120025,-33179,0,0,19385,0,0,,19385,19385
36,09-07-17,17,4:00,4:15,34.51,40.26,0,40.26,40.26,-1,-51480,74787,126267,23307,0,-531,6570,0,0,,7101,6039
36,09-07-17,18,4:15,4:30,,,0,36.08,36.08,0,-40512,64299,104811,23787,0,0,0,0,0,,0,0
36,09-07-17,19,4:30,4:45,,,0,36.07,36.07,0,-33273,46700,79973,13427,0,0,0,0,0,,0,0
36,09-07-17,20,4:45,5:00,,,0,36.08,36.08,0,-19607,45190,64797,25583,0,0,0,0,0,,0,0
36,09-07-17,21,5:00,5:15,,-18.06,0,-18.06,-18.06,-1,-21845,86030,107875,64185,0,-22238,0,0,0,,22238,-22238
36,09-07-17,22,5:15,5:30,,23.51,0,23.51,23.51,-1,-22219,43366,65585,21147,0,-25650,0,0,0,,25650,-25650
36,09-07-17,23,5:30,5:45,,41.73,0,41.73,41.73,-1,-24230,50341,74571,26111,0,-1426,0,0,0,,1426,-1426
36,09-07-17,24,5:45,6:00,,28.51,0,28.51,28.51,-1,-32520,72498,105018,39978,0,-995,0,0,0,,995,-995
36,09-07-17,25,6:00,6:15,,4.22,0,4.22,4.22,-1,-36234,110637,146871,74403,0,-28154,0,0,0,,28154,-28154
36,09-07-17,26,6:15,6:30,,39.42,0,39.42,39.42,-1,-36602,87503,124105,50901,0,-5123,0,0,0,,5123,-5123
36,09-07-17,27,6:30,6:45,,,0,36.02,36.02,0,-48445,58321,106766,9876,0,0,0,0,0,,0,0
36,09-07-17,28,6:45,7:00,,,0,35.97,35.97,0,-34665,92381,127046,57716,0,0,0,0,0,,0,0
36,09-07-17,29,7:00,7:15,,26.51,0,26.51,26.51,-1,-58323,113049,171372,54726,0,-2928,0,0,0,,2928,-2928
36,09-07-17,30,7:15,7:30,,30.51,0,30.51,30.51,-1,-37552,87977,125529,50425,0,-6302,0,0,0,,6302,-6302
36,09-07-17,31,7:30,7:45,33.51,30.51,0,33.51,33.51,1,-52686,50681,103367,-2005,0,-140,566,0,0,,706,426
36,09-07-17,32,7:45,8:00,33.51,,0,33.51,33.51,1,-83405,89514,172919,6109,0,0,1278,0,0,,1278,1278
36,09-07-17,33,8:00,8:15,,,0,40.04,40.04,0,-51689,90459,142148,38770,0,0,0,0,0,,0,0
36,09-07-17,34,8:15,8:30,,,0,40,40,0,-47831,96427,144258,48596,0,0,0,0,0,,0,0
36,09-07-17,35,8:30,8:45,35.48,,0,35.48,35.48,1,-64275,66084,130359,1809,0,0,820,0,0,,820,820
36,09-07-17,36,8:45,9:00,33.69,,0,33.69,33.69,1,-81777,61700,143477,-20077,0,0,758,0,0,,758,758
36,09-07-17,37,9:00,9:15,,,0,40.01,40.01,0,-65055,76314,141369,11259,0,0,74,0,0,,74,74
36,09-07-17,38,9:15,9:30,,,0,40,40,0,-75693,78945,154638,3252,0,0,0,0,0,,0,0
36,09-07-17,39,9:30,9:45,31.2,,0,31.2,31.2,1,-73027,62227,135254,-10800,0,0,24,0,0,,24,24
36,09-07-17,40,9:45,10:00,36.23,,0,36.23,36.23,1,-65124,62313,127437,-2811,0,0,2361,0,0,,2361,2361
36,09-07-17,41,10:00,10:15,120.5,,0,120.5,120.5,1,-108285,64175,172460,-44110,0,0,19629,0,0,,19629,19629
36,09-07-17,42,10:15,10:30,39.02,,0,39.02,39.02,1,-78935,46101,125036,-32834,0,0,26928,0,0,,26928,26928
36,09-07-17,43,10:30,10:45,41.82,,0,41.82,41.82,1,-63319,35459,98778,-27860,0,0,27276,0,0,,27276,27276
36,09-07-17,44,10:45,11:00,30.79,49,0,49,49,-1,-51282,52670,103952,1388,0,-71,6994,0,0,,7065,6923
36,09-07-17,45,11:00,11:15,,31.51,0,31.51,31.51,-1,-63784,89520,153304,25736,0,-1081,0,0,0,,1081,-1081
36,09-07-17,46,11:15,11:30,,,0,46.62,46.62,0,-54687,111518,166205,56831,0,-9,0,0,0,,9,-9
36,09-07-17,47,11:30,11:45,,,0,46.63,46.63,0,-45920,145740,191660,99820,0,0,0,0,0,,0,0
36,09-07-17,48,11:45,12:00,,39,0,39,39,-1,-44735,150806,195541,106071,0,-168,0,0,0,,168,-168
36,09-07-17,49,12:00,12:15,,30.51,0,30.51,30.51,-1,-50242,142291,192533,92049,0,-796,0,0,0,,796,-796
36,09-07-17,50,12:15,12:30,,38.46,0,38.46,38.46,-1,-40579,127949,168528,87370,0,-1251,0,0,0,,1251,-1251
36,09-07-17,51,12:30,12:45,,41.95,0,41.95,41.95,-1,-38456,140141,178597,101685,0,-1585,0,0,0,,1585,-1585
36,09-07-17,52,12:45,13:00,,7.16,0,7.16,7.16,-1,-39585,146382,185967,106797,0,-1840,0,0,0,,1840,-1840
36,09-07-17,53,13:00,13:15,,-27.12,0,-27.12,-27.12,-1,-38200,79090,117290,40890,0,-7363,0,0,0,,7363,-7363
36,09-07-17,54,13:15,13:30,30.92,,0,30.92,30.92,1,-54641,54204,108845,-437,0,0,328,0,0,,328,328
36,09-07-17,55,13:30,13:45,30.74,,0,30.74,30.74,1,-43458,54809,98267,11351,0,0,421,0,0,,421,421
36,09-07-17,56,13:45,14:00,,22.25,0,22.25,22.25,-1,-41933,59120,101053,17187,0,-12008,0,0,0,,12008,-12008
36,09-07-17,57,14:00,14:15,,30.4,0,30.4,30.4,-1,-35931,69789,105720,33858,0,-15903,0,0,0,,15903,-15903
36,09-07-17,58,14:15,14:30,,38.5,0,38.5,38.5,-1,-36360,73559,109919,37199,0,-135,0,0,0,,135,-135
36,09-07-17,59,14:30,14:45,,26.51,0,26.51,26.51,-1,-53765,88526,142291,34761,0,-1724,0,0,0,,1724,-1724
36,09-07-17,60,14:45,15:00,,19.37,0,19.37,19.37,-1,-61945,86825,148770,24880,0,-25901,0,0,0,,25901,-25901
36,09-07-17,61,15:00,15:15,37.51,38.32,0,37.51,37.51,1,-86924,72090,159014,-14834,0,-9466,1754,0,0,,11220,-7712
36,09-07-17,62,15:15,15:30,33.93,,0,33.93,33.93,1,-99785,87270,187055,-12515,0,0,3000,0,0,,3000,3000
36,09-07-17,63,15:30,15:45,,39.9,0,39.9,39.9,-1,-74533,99589,174122,25056,0,-1378,0,0,0,,1378,-1378
36,09-07-17,64,15:45,16:00,,30.51,0,30.51,30.51,-1,-56743,101193,157936,44450,0,-4894,0,0,0,,4894,-4894
36,09-07-17,65,16:00,16:15,,31.51,0,31.51,31.51,-1,-54724,68331,123055,13607,0,-7982,0,0,0,,7982,-7982
36,09-07-17,66,16:15,16:30,,31.51,0,31.51,31.51,-1,-48588,73547,122135,24959,0,-5749,0,0,0,,5749,-5749
36,09-07-17,67,16:30,16:45,,24.27,0,24.27,24.27,-1,-42646,78210,120856,35564,0,-18566,0,0,0,,18566,-18566
36,09-07-17,68,16:45,17:00,,37.34,0,37.34,37.34,-1,-37131,59509,96640,22378,0,-8079,0,0,0,,8079,-8079
36,09-07-17,69,17:00,17:15,,16.09,0,16.09,16.09,-1,-45069,80935,126004,35866,0,-22949,0,0,0,,22949,-22949
36,09-07-17,70,17:15,17:30,,31.51,0,31.51,31.51,-1,-49803,53593,103396,3790,0,-12255,0,0,0,,12255,-12255
36,09-07-17,71,17:30,17:45,30.92,31.51,0,30.92,30.92,1,-60525,72747,133272,12222,0,-494,786,0,0,,1280,292
36,09-07-17,72,17:45,18:00,33.51,,0,33.51,33.51,1,-68637,92566,161203,23929,0,0,490,0,0,,490,490
36,09-07-17,73,18:00,18:15,62.34,,0,62.34,62.34,1,-83633,17883,101516,-65750,0,0,9012,0,0,,9012,9012
36,09-07-17,74,18:15,18:30,33.51,,0,33.51,33.51,1,-62860,38743,101603,-24117,0,0,1367,0,0,,1367,1367
36,09-07-17,75,18:30,18:45,,,0,40.03,40.03,0,-63903,47890,111793,-16013,0,0,165,0,0,,165,165
36,09-07-17,76,18:45,19:00,33.51,,0,33.51,33.51,1,-61553,61114,122667,-439,0,0,580,0,0,,580,580
36,09-07-17,77,19:00,19:15,31.09,,0,31.09,31.09,1,-55034,69387,124421,14353,0,0,1079,0,0,,1079,1079
36,09-07-17,78,19:15,19:30,31.13,,0,31.13,31.13,1,-59558,91853,151411,32295,0,0,602,0,0,,602,602
36,09-07-17,79,19:30,19:45,,,0,40.06,40.06,0,-51494,89618,141112,38124,0,0,0,0,0,,0,0
36,09-07-17,80,19:45,20:00,,,0,40.06,40.06,0,-74589,89580,164169,14991,0,0,0,0,0,,0,0
36,09-07-17,81,20:00,20:15,,,0,40.04,40.04,0,-40083,33305,73388,-6778,0,0,0,0,0,,0,0
36,09-07-17,82,20:15,20:30,,,0,40.04,40.04,0,-67984,32927,100911,-35057,0,0,0,0,0,,0,0
36,09-07-17,83,20:30,20:45,,37.9,0,37.9,37.9,-1,-64469,48041,112510,-16428,0,-265,0,0,0,,265,-265
36,09-07-17,84,20:45,21:00,,36.06,0,36.06,36.06,-1,-56111,50316,106427,-5795,0,-935,0,0,0,,935,-935
36,09-07-17,85,21:00,21:15,34.95,33.07,0,36.43,33.07,2,-76145,58641,134786,-17504,0,-445,2314,0,0,,2759,1869
36,09-07-17,86,21:15,21:30,34.95,31.51,0,31.51,31.51,-1,-61165,65152,126317,3987,0,-295,194,0,0,,489,-101
36,09-07-17,87,21:30,21:45,,26.51,0,26.51,26.51,-1,-33068,74479,107547,41411,0,-13986,0,0,0,,13986,-13986
36,09-07-17,88,21:45,22:00,,31.03,0,31.03,31.03,-1,-42290,82026,124316,39736,0,-19103,0,0,0,,19103,-19103
36,09-07-17,89,22:00,22:15,33.51,33.05,0,33.51,33.51,1,-94440,23939,118379,-70501,0,-9007,493,0,0,,9500,-8514
36,09-07-17,90,22:15,22:30,33.51,37.87,0,37.87,37.87,-1,-49160,27109,76269,-22051,0,-92,41,0,0,,133,-51
36,09-07-17,91,22:30,22:45,,19.25,0,19.25,19.25,-1,-31478,97518,128996,66040,0,-2991,0,0,0,,2991,-2991
36,09-07-17,92,22:45,23:00,,-51.46,0,-51.46,-51.46,-1,-34360,110747,145107,76387,0,-27637,0,0,0,,27637,-27637
36,09-07-17,93,23:00,23:15,133.99,-57.52,0,133.99,133.99,1,-63083,64574,127657,1491,0,-24878,4033,0,0,,28911,-20845
36,09-07-17,94,23:15,23:30,37.75,,0,37.75,37.75,1,-40184,20312,60496,-19872,0,0,7284,0,0,,7284,7284
36,09-07-17,95,23:30,23:45,37.75,30.51,0,30.51,30.51,-1,-30263,35524,65787,5261,0,-190,30,0,0,,220,-160
36,09-07-17,96,23:45,0:00,,23.09,0,23.09,23.09,-1,-39366,57552,96918,18186,0,-17227,0,0,0,,17227,-17227
36,09-08-17,1,0:00,0:15,,23.92,0,23.92,23.92,-1,-36911,88181,125092,51270,0,-11732,0,0,0,,11732,-11732
36,09-08-17,2,0:15,0:30,,9.9,0,9.9,9.9,-1,-22923,42830,65753,19907,0,-2709,0,0,0,,2709,-2709
36,09-08-17,3,0:30,0:45,,-32.64,0,-32.64,-32.64,-1,-29291,109513,138804,80222,0,-65004,0,0,0,,65004,-65004
36,09-08-17,4,0:45,1:00,,-6.99,0,-6.99,-6.99,-1,-57688,109993,167681,52305,0,-88693,0,0,0,,88693,-88693
36,09-08-17,5,1:00,1:15,43.51,-6.99,0,43.51,43.51,1,-46616,29911,76527,-16705,0,-13133,6248,0,0,,19381,-6885
36,09-08-17,6,1:15,1:30,36.88,,0,36.88,36.88,1,-56724,17051,73775,-39673,0,0,13951,0,0,,13951,13951
36,09-08-17,7,1:30,1:45,36.88,41.57,0,41.57,41.57,-1,-38273,24447,62720,-13826,0,-1146,1164,0,0,,2310,18
36,09-08-17,8,1:45,2:00,,28.92,0,28.92,28.92,-1,-51260,37369,88629,-13891,0,-1724,0,0,0,,1724,-1724
36,09-08-17,9,2:00,2:15,53.12,28.92,0,53.12,28.92,2,-110847,56239,167086,-54608,0,-679,8385,0,0,,9064,7706
36,09-08-17,10,2:15,2:30,33.51,,0,33.51,33.51,1,-102250,26017,128267,-76233,0,0,5541,0,0,,5541,5541
36,09-08-17,11,2:30,2:45,,,0,36.4,36.4,0,-90204,27198,117402,-63006,0,0,6,0,0,,6,6
36,09-08-17,12,2:45,3:00,,,0,36.44,36.44,0,-95636,28972,124608,-66664,0,0,0,0,0,,0,0
36,09-08-17,13,3:00,3:15,89.26,,0,89.26,89.26,1,-106203,43300,149503,-62903,0,0,12220,0,0,,12220,12220
36,09-08-17,14,3:15,3:30,138.8,,0,138.8,138.8,1,-90155,40438,130593,-49717,0,0,60540,0,0,,60540,60540
36,09-08-17,15,3:30,3:45,33.79,,0,33.79,33.79,1,-46732,45645,92377,-1087,0,0,10572,0,0,,10572,10572
36,09-08-17,16,3:45,4:00,,,0,36.34,36.34,0,-33557,44569,78126,11012,0,0,0,0,0,,0,0
36,09-08-17,17,4:00,4:15,33.51,28.92,0,36.3,28.92,2,-51489,27639,79128,-23850,0,-294,183,0,0,,477,-111
36,09-08-17,18,4:15,4:30,,16.85,0,16.85,16.85,-1,-30907,39374,70281,8467,0,-4821,0,0,0,,4821,-4821
36,09-08-17,19,4:30,4:45,,38.3,0,38.3,38.3,-1,-34989,41904,76893,6915,0,-2968,0,0,0,,2968,-2968
36,09-08-17,20,4:45,5:00,,28.92,0,28.92,28.92,-1,-24098,53551,77649,29453,0,-807,0,0,0,,807,-807
36,09-08-17,21,5:00,5:15,,15.91,0,15.91,15.91,-1,-12033,55027,67060,42994,0,-17921,0,0,0,,17921,-17921
36,09-08-17,22,5:15,5:30,,12.96,0,12.96,12.96,-1,-12292,49738,62030,37446,0,-31867,0,0,0,,31867,-31867
36,09-08-17,23,5:30,5:45,,,0,36.33,36.33,0,-26095,42011,68106,15916,0,-3086,0,0,0,,3086,-3086
36,09-08-17,24,5:45,6:00,33.51,,0,33.51,33.51,1,-41924,67595,109519,25671,0,0,11,0,0,,11,11
36,09-08-17,25,6:00,6:15,,14.76,0,14.76,14.76,-1,-31539,96043,127582,64504,0,-6830,0,0,0,,6830,-6830
36,09-08-17,26,6:15,6:30,,42.12,0,42.12,42.12,-1,-34707,83578,118285,48871,0,-538,0,0,0,,538,-538
36,09-08-17,27,6:30,6:45,,,0,36.33,36.33,0,-48538,65271,113809,16733,0,0,0,0,0,,0,0
36,09-08-17,28,6:45,7:00,30.58,,0,30.58,30.58,1,-53051,75958,129009,22907,0,0,8,0,0,,8,8
36,09-08-17,29,7:00,7:15,32.11,,0,32.11,32.11,1,-113493,76032,189525,-37461,0,0,1090,0,0,,1090,1090
36,09-08-17,30,7:15,7:30,,,0,36.42,36.42,0,-68970,84672,153642,15702,0,0,0,0,0,,0,0
36,09-08-17,31,7:30,7:45,,,0,36.33,36.33,0,-101891,78417,180308,-23474,0,0,0,0,0,,0,0
36,09-08-17,32,7:45,8:00,50.99,,0,50.99,50.99,1,-129269,72922,202191,-56347,0,0,10388,0,0,,10388,10388
36,09-08-17,33,8:00,8:15,31.31,26.57,0,36.42,26.57,2,-31368,142815,174183,111447,0,-2696,2998,0,0,,5694,302
36,09-08-17,34,8:15,8:30,,,0,36.42,36.42,0,-43435,108280,151715,64845,0,-119,0,0,0,,119,-119
36,09-08-17,35,8:30,8:45,,,0,36.42,36.42,0,-77823,94287,172110,16464,0,0,0,0,0,,0,0
36,09-08-17,36,8:45,9:00,,,0,36.34,36.34,0,-102268,83853,186121,-18415,0,0,0,0,0,,0,0
36,09-08-17,37,9:00,9:15,,42.15,0,42.15,42.15,-1,-40069,101685,141754,61616,0,-257,0,0,0,,257,-257
36,09-08-17,38,9:15,9:30,30.71,,0,30.71,30.71,1,-78307,93915,172222,15608,0,0,2,0,0,,2,2
36,09-08-17,39,9:30,9:45,32.11,,0,32.11,32.11,1,-98023,96657,194680,-1366,0,0,1008,0,0,,1008,1008
36,09-08-17,40,9:45,10:00,31.19,,0,31.19,31.19,1,-105104,111301,216405,6197,0,0,1851,0,0,,1851,1851
36,09-08-17,41,10:00,10:15,31.31,42.02,0,42.02,42.02,-1,-86527,126295,212822,39768,0,-17,1178,0,0,,1195,1161
36,09-08-17,42,10:15,10:30,,27.91,0,27.91,27.91,-1,-92610,124474,217084,31864,0,-7466,0,0,0,,7466,-7466
36,09-08-17,43,10:30,10:45,32.11,42.02,0,32.11,32.11,1,-104576,94723,199299,-9853,0,-2890,119,0,0,,3009,-2771
36,09-08-17,44,10:45,11:00,34.54,,0,34.54,34.54,1,-98806,96688,195494,-2118,0,0,950,0,0,,950,950
36,09-08-17,45,11:00,11:15,36.1,,0,36.1,36.1,1,-91621,88169,179790,-3452,0,0,1993,0,0,,1993,1993
36,09-08-17,46,11:15,11:30,38,,0,38,38,1,-99182,85929,185111,-13253,0,0,4382,0,0,,4382,4382
36,09-08-17,47,11:30,11:45,43.18,,0,43.18,43.18,1,-107262,90707,197969,-16555,0,0,15239,0,0,,15239,15239
36,09-08-17,48,11:45,12:00,49,,0,49,49,1,-118245,86217,204462,-32028,0,0,20839,0,0,,20839,20839
36,09-08-17,49,12:00,12:15,49.36,,0,49.36,49.36,1,-121299,79973,201272,-41326,0,0,29024,0,0,,29024,29024
36,09-08-17,50,12:15,12:30,36.32,,0,36.32,36.32,1,-127555,85702,213257,-41853,0,0,14742,0,0,,14742,14742
36,09-08-17,51,12:30,12:45,80.6,,0,80.6,80.6,1,-131191,88433,219624,-42758,0,0,12727,0,0,,12727,12727
36,09-08-17,52,12:45,13:00,116.3,,0,116.3,116.3,1,-133656,98967,232623,-34689,0,0,46532,0,0,,46532,46532
36,09-08-17,53,13:00,13:15,66.12,,0,66.12,66.12,1,-128124,100070,228194,-28054,0,0,23116,0,0,,23116,23116
36,09-08-17,54,13:15,13:30,145.3,,0,145.3,145.3,1,-144716,105628,250344,-39088,0,0,40426,0,0,,40426,40426
36,09-08-17,55,13:30,13:45,55.26,,0,55.26,55.26,1,-163774,113693,277467,-50081,0,0,31698,0,0,,31698,31698
36,09-08-17,56,13:45,14:00,55.26,,0,55.26,55.26,1,-147631,108091,255722,-39540,0,0,26371,0,0,,26371,26371
36,09-08-17,57,14:00,14:15,66.17,,0,66.17,66.17,1,-129424,98305,227729,-31119,0,0,5923,0,0,,5923,5923
36,09-08-17,58,14:15,14:30,149.16,,0,149.16,149.16,1,-124072,96905,220977,-27167,0,0,30526,0,0,,30526,30526
36,09-08-17,59,14:30,14:45,33.83,40.97,0,39.95,39.95,2,-113849,93477,207326,-20372,0,-289,6594,0,0,,6883,6305
36,09-08-17,60,14:45,15:00,243.19,,0,243.19,243.19,1,-126168,75308,201476,-50860,0,0,25103,0,0,,25103,25103
36,09-08-17,61,15:00,15:15,39.12,41.95,0,41.95,41.95,-1,-62694,113978,176672,51284,0,-110,9301,0,0,,9411,9191
36,09-08-17,62,15:15,15:30,41.91,41.98,0,41.91,39.98,2,-74929,73781,148710,-1148,0,-436,1507,0,0,,1943,1071
36,09-08-17,63,15:30,15:45,34.35,,0,34.35,34.35,1,-81882,61801,143683,-20081,0,0,3541,0,0,,3541,3541
36,09-08-17,64,15:45,16:00,37.69,,0,37.69,37.69,1,-102937,62065,165002,-40872,0,0,2450,0,0,,2450,2450
36,09-08-17,65,16:00,16:15,,,0,40,40,0,-71034,115862,186896,44828,0,0,0,0,0,,0,0
36,09-08-17,66,16:15,16:30,,,0,40,40,0,-56023,118857,174880,62834,0,0,0,0,0,,0,0
36,09-08-17,67,16:30,16:45,,,0,40,40,0,-56455,136890,193345,80435,0,0,0,0,0,,0,0
36,09-08-17,68,16:45,17:00,,39.7,0,39.7,39.7,-1,-72941,157499,230440,84558,0,-34,0,0,0,,34,-34
36,09-08-17,69,17:00,17:15,,13.17,0,13.17,13.17,-1,-41093,166758,207851,125665,0,-11417,0,0,0,,11417,-11417
36,09-08-17,70,17:15,17:30,,,0,36.48,36.48,0,-53722,150160,203882,96438,0,-890,0,0,0,,890,-890
36,09-08-17,71,17:30,17:45,,,0,36.48,36.48,0,-44526,119771,164297,75245,0,0,0,0,0,,0,0
36,09-08-17,72,17:45,18:00,,,0,36.48,36.48,0,-49435,152892,202327,103457,0,0,0,0,0,,0,0
36,09-08-17,73,18:00,18:15,,38.11,0,38.11,38.11,-1,-54989,92530,147519,37541,0,-1455,0,0,0,,1455,-1455
36,09-08-17,74,18:15,18:30,,39.08,0,39.08,39.08,-1,-45071,98850,143921,53779,0,-1168,0,0,0,,1168,-1168
36,09-08-17,75,18:30,18:45,,41.2,0,41.2,41.2,-1,-53061,107311,160372,54250,0,-484,0,0,0,,484,-484
36,09-08-17,76,18:45,19:00,,41.89,0,41.89,41.89,-1,-49084,132110,181194,83026,0,-1263,0,0,0,,1263,-1263
36,09-08-17,77,19:00,19:15,,,0,36.16,36.16,0,-95443,100706,196149,5263,0,-115,0,0,0,,115,-115
36,09-08-17,78,19:15,19:30,38.5,,0,38.5,38.5,1,-96749,95267,192016,-1482,0,0,1251,0,0,,1251,1251
36,09-08-17,79,19:30,19:45,43.66,,0,43.66,43.66,1,-87862,120841,208703,32979,0,0,5026,0,0,,5026,5026
36,09-08-17,80,19:45,20:00,,,0,36.47,36.47,0,-77736,140484,218220,62748,0,0,0,0,0,,0,0
36,09-08-17,81,20:00,20:15,,,0,36.16,36.16,0,-64746,137571,202317,72825,0,0,0,0,0,,0,0
36,09-08-17,82,20:15,20:30,57.49,,0,57.49,57.49,1,-133040,98042,231082,-34998,0,0,3703,0,0,,3703,3703
36,09-08-17,83,20:30,20:45,34.92,,0,34.92,34.92,1,-142306,92415,234721,-49891,0,0,5416,0,0,,5416,5416
36,09-08-17,84,20:45,21:00,,,0,36.39,36.39,0,-129409,77495,206904,-51914,0,0,0,0,0,,0,0
36,09-08-17,85,21:00,21:15,204.76,,0,204.76,204.76,1,-181572,66611,248183,-114961,0,0,26069,0,0,,26069,26069
36,09-08-17,86,21:15,21:30,186.66,37.67,0,186.66,36.09,2,-142500,106321,248821,-36179,0,-122,34814,0,0,,34936,34692
36,09-08-17,87,21:30,21:45,,23.91,0,23.91,23.91,-1,-90123,115673,205796,25550,0,-10825,0,0,0,,10825,-10825
36,09-08-17,88,21:45,22:00,31.07,28.91,0,31.07,31.07,1,-137878,91848,229726,-46030,0,-9854,78,0,0,,9932,-9776
36,09-08-17,89,22:00,22:15,37.66,28.91,0,37.66,37.66,1,-167480,114778,282258,-52702,0,-125,5713,0,0,,5838,5588
36,09-08-17,90,22:15,22:30,30.99,,0,30.99,30.99,1,-173514,101977,275491,-71537,0,0,1210,0,0,,1210,1210
36,09-08-17,91,22:30,22:45,328.97,,0,328.97,328.97,1,-163087,87003,250090,-76084,0,0,23654,0,0,,23654,23654
36,09-08-17,92,22:45,23:00,328.97,,0,328.97,328.97,1,-173456,114226,287682,-59230,0,0,58443,0,0,,58443,58443
36,09-08-17,93,23:00,23:15,328.97,-17.82,0,-17.82,-17.82,-1,-81489,213146,294635,131657,0,-14380,5581,0,0,,19961,-8799
36,09-08-17,94,23:15,23:30,,28.91,0,28.91,28.91,-1,-88603,107028,195631,18425,0,-6331,0,0,0,,6331,-6331
36,09-08-17,95,23:30,23:45,,,0,36.06,36.06,0,-88726,92443,181169,3717,0,-237,0,0,0,,237,-237
36,09-08-17,96,23:45,0:00,34.51,,0,34.51,34.51,1,-91038,98187,189225,7149,0,0,1234,0,0,,1234,1234
37,09-09-17,1,0:00,0:15,43.66,,0,43.66,43.66,1,-121768,97338,219106,-24430,0,0,11528,0,0,,11528,11528
37,09-09-17,2,0:15,0:30,45.11,,0,45.11,45.11,1,-102175,63856,166031,-38319,0,0,18835,0,0,,18835,18835
37,09-09-17,3,0:30,0:45,62.34,,0,62.34,62.34,1,-116148,41871,158019,-74277,0,0,46420,0,0,,46420,46420
37,09-09-17,4,0:45,1:00,106.43,,0,106.43,106.43,1,-154142,53413,207555,-100729,0,0,57765,0,0,,57765,57765
37,09-09-17,5,1:00,1:15,50.19,,0,50.19,50.19,1,-88304,23663,111967,-64641,0,0,59651,0,0,,59651,59651
37,09-09-17,6,1:15,1:30,45.9,,0,45.9,45.9,1,-67657,22541,90198,-45116,0,0,46566,0,0,,46566,46566
37,09-09-17,7,1:30,1:45,34.35,,0,34.35,34.35,1,-55102,29080,84182,-26022,0,0,19868,0,0,,19868,19868
37,09-09-17,8,1:45,2:00,40.3,,0,40.3,40.3,1,-59628,24078,83706,-35550,0,0,15636,0,0,,15636,15636
37,09-09-17,9,2:00,2:15,70.61,,0,70.61,70.61,1,-76590,19665,96255,-56925,0,0,44573,0,0,,44573,44573
37,09-09-17,10,2:15,2:30,46.02,,0,46.02,46.02,1,-69631,26280,95911,-43351,0,0,49995,0,0,,49995,49995
37,09-09-17,11,2:30,2:45,33.66,,0,33.66,33.66,1,-59695,26496,86191,-33199,0,0,12908,0,0,,12908,12908
37,09-09-17,12,2:45,3:00,49.75,,0,49.75,49.75,1,-62218,30690,92908,-31528,0,0,20664,0,0,,20664,20664
37,09-09-17,13,3:00,3:15,30.78,39.97,0,39.97,39.97,-1,-22167,63582,85749,41415,0,-571,6363,0,0,,6934,5792
37,09-09-17,14,3:15,3:30,,40.26,0,40.26,40.26,-1,-28074,50671,78745,22597,0,-1495,0,0,0,,1495,-1495
37,09-09-17,15,3:30,3:45,,,0,36.36,36.36,0,-29445,61474,90919,32029,0,-65,0,0,0,,65,-65
37,09-09-17,16,3:45,4:00,,42.08,0,42.08,42.08,-1,-23691,70506,94197,46815,0,-287,0,0,0,,287,-287
37,09-09-17,17,4:00,4:15,,42.05,0,42.05,42.05,-1,-18424,74239,92663,55815,0,-7,0,0,0,,7,-7
37,09-09-17,18,4:15,4:30,,42.05,0,42.05,42.05,-1,-16124,94457,110581,78333,0,-190,0,0,0,,190,-190
37,09-09-17,19,4:30,4:45,,42.16,0,42.16,42.16,-1,-16140,88815,104955,72675,0,-23,0,0,0,,23,-23
37,09-09-17,20,4:45,5:00,,42.16,0,42.16,42.16,-1,-18993,92823,111816,73830,0,-52,0,0,0,,52,-52
37,09-09-17,21,5:00,5:15,,42.13,0,42.13,42.13,-1,-38471,37139,75610,-1332,0,-40,0,0,0,,40,-40
37,09-09-17,22,5:15,5:30,,,0,36.38,36.38,0,-30746,47643,78389,16897,0,0,0,0,0,,0,0
37,09-09-17,23,5:30,5:45,,,0,36.36,36.36,0,-29822,39994,69816,10172,0,0,0,0,0,,0,0
37,09-09-17,24,5:45,6:00,,,0,36.31,36.31,0,-35818,50328,86146,14510,0,0,0,0,0,,0,0
37,09-09-17,25,6:00,6:15,32.21,,0,32.21,32.21,1,-51336,47224,98560,-4112,0,0,750,0,0,,750,750
37,09-09-17,26,6:15,6:30,37.7,,0,37.7,37.7,1,-62041,40955,102996,-21086,0,0,5642,0,0,,5642,5642
37,09-09-17,27,6:30,6:45,79.19,,0,79.19,79.19,1,-73590,31547,105137,-42043,0,0,28844,0,0,,28844,28844
37,09-09-17,28,6:45,7:00,46.1,,0,46.1,46.1,1,-46963,41944,88907,-5019,0,0,29893,0,0,,29893,29893
37,09-09-17,29,7:00,7:15,46.1,13.27,0,13.27,13.27,-1,-15941,59844,75785,43903,0,-17461,2880,0,0,,20341,-14581
37,09-09-17,30,7:15,7:30,,30.7,0,30.7,30.7,-1,-29335,27802,57137,-1533,0,-11991,0,0,0,,11991,-11991
37,09-09-17,31,7:30,7:45,42.23,30.7,0,42.23,42.23,1,-42585,26416,69001,-16169,0,-130,4031,0,0,,4161,3901
37,09-09-17,32,7:45,8:00,43.7,,0,43.7,43.7,1,-40598,22323,62921,-18275,0,0,28466,0,0,,28466,28466
37,09-09-17,33,8:00,8:15,43.7,26.7,0,26.7,26.7,-1,-60408,62602,123010,2194,0,-4369,6992,0,0,,11361,2623
37,09-09-17,34,8:15,8:30,39.82,40.74,0,39.82,39.82,1,-56368,33588,89956,-22780,0,-2630,1230,0,0,,3860,-1400
37,09-09-17,35,8:30,8:45,71.55,,0,71.55,71.55,1,-89893,27690,117583,-62203,0,0,31040,0,0,,31040,31040
37,09-09-17,36,8:45,9:00,92.02,,0,92.02,92.02,1,-102537,29836,132373,-72701,0,0,60670,0,0,,60670,60670
37,09-09-17,37,9:00,9:15,66.36,,0,66.36,66.36,1,-48826,30887,79713,-17939,0,0,34794,0,0,,34794,34794
37,09-09-17,38,9:15,9:30,47.72,,0,47.72,47.72,1,-61108,31252,92360,-29856,0,0,15965,0,0,,15965,15965
37,09-09-17,39,9:30,9:45,52.23,,0,52.23,52.23,1,-75452,28985,104437,-46467,0,0,29503,0,0,,29503,29503
37,09-09-17,40,9:45,10:00,71.25,,0,71.25,71.25,1,-85420,31605,117025,-53815,0,0,40444,0,0,,40444,40444
37,09-09-17,41,10:00,10:15,52.02,,0,52.02,52.02,1,-56843,24543,81386,-32300,0,0,31051,0,0,,31051,31051
37,09-09-17,42,10:15,10:30,59.9,,0,59.9,59.9,1,-63970,25718,89688,-38252,0,0,32399,0,0,,32399,32399
37,09-09-17,43,10:30,10:45,44.9,,0,44.9,44.9,1,-43793,36771,80564,-7022,0,0,21808,0,0,,21808,21808
37,09-09-17,44,10:45,11:00,44.9,40.9,0,40.9,40.9,-1,-31449,45017,76466,13568,0,-530,1586,0,0,,2116,1056
37,09-09-17,45,11:00,11:15,,,0,39.86,39.86,0,-39855,44717,84572,4862,0,0,0,0,0,,0,0
37,09-09-17,46,11:15,11:30,,29.64,0,29.64,29.64,-1,-42501,69405,111906,26904,0,-4037,0,0,0,,4037,-4037
37,09-09-17,47,11:30,11:45,,23.99,0,23.99,23.99,-1,-44761,77725,122486,32964,0,-16649,0,0,0,,16649,-16649
37,09-09-17,48,11:45,12:00,,26.7,0,26.7,26.7,-1,-31925,71819,103744,39894,0,-20996,0,0,0,,20996,-20996
37,09-09-17,49,12:00,12:15,,31.7,0,31.7,31.7,-1,-44194,41326,85520,-2868,0,-6708,0,0,0,,6708,-6708
37,09-09-17,50,12:15,12:30,,26.7,0,26.7,26.7,-1,-47083,68561,115644,21478,0,-3061,0,0,0,,3061,-3061
37,09-09-17,51,12:30,12:45,,12.09,0,12.09,12.09,-1,-40409,84379,124788,43970,0,-21681,0,0,0,,21681,-21681
37,09-09-17,52,12:45,13:00,,20.88,0,20.88,20.88,-1,-35354,73357,108711,38003,0,-15279,0,0,0,,15279,-15279
37,09-09-17,53,13:00,13:15,33.14,30.7,0,33.14,33.14,1,-52133,38609,90742,-13524,0,-12072,588,0,0,,12660,-11484
37,09-09-17,54,13:15,13:30,32.5,30.7,0,32.5,32.5,1,-55976,49514,105490,-6462,0,-124,368,0,0,,492,244
37,09-09-17,55,13:30,13:45,,30.7,0,30.7,30.7,-1,-39140,55458,94598,16318,0,-3603,0,0,0,,3603,-3603
37,09-09-17,56,13:45,14:00,,-24.86,0,-24.86,-24.86,-1,-28938,90423,119361,61485,0,-40913,0,0,0,,40913,-40913
37,09-09-17,57,14:00,14:15,31.75,24.03,0,31.75,31.75,1,-57476,43806,101282,-13670,0,-17087,94,0,0,,17181,-16993
37,09-09-17,58,14:15,14:30,34.02,24.03,0,34.02,34.02,1,-70183,51532,121715,-18651,0,-7,2430,0,0,,2437,2423
37,09-09-17,59,14:30,14:45,32.97,,0,32.97,32.97,1,-68352,57823,126175,-10529,0,0,1265,0,0,,1265,1265
37,09-09-17,60,14:45,15:00,35.2,,0,35.2,35.2,1,-69739,62239,131978,-7500,0,0,2903,0,0,,2903,2903
37,09-09-17,61,15:00,15:15,35.2,5.07,0,5.07,5.07,-1,-49910,97152,147062,47242,0,-15310,459,0,0,,15769,-14851
37,09-09-17,62,15:15,15:30,,30.7,0,30.7,30.7,-1,-65198,87917,153115,22719,0,-13039,0,0,0,,13039,-13039
37,09-09-17,63,15:30,15:45,,31.7,0,31.7,31.7,-1,-58496,84001,142497,25505,0,-2738,0,0,0,,2738,-2738
37,09-09-17,64,15:45,16:00,,42.38,0,42.38,42.38,-1,-38901,83263,122164,44362,0,-350,0,0,0,,350,-350
37,09-09-17,65,16:00,16:15,,30.7,0,30.7,30.7,-1,-33337,140596,173933,107259,0,-3132,0,0,0,,3132,-3132
37,09-09-17,66,16:15,16:30,,21.38,0,21.38,21.38,-1,-48655,122877,171532,74222,0,-17208,0,0,0,,17208,-17208
37,09-09-17,67,16:30,16:45,,,0,36.47,36.47,0,-47275,98784,146059,51509,0,-3790,0,0,0,,3790,-3790
37,09-09-17,68,16:45,17:00,,,0,36.41,36.41,0,-45651,72966,118617,27315,0,0,0,0,0,,0,0
37,09-09-17,69,17:00,17:15,,30.7,0,30.7,30.7,-1,-44780,152126,196906,107346,0,-608,0,0,0,,608,-608
37,09-09-17,70,17:15,17:30,,38.44,0,38.44,38.44,-1,-35707,143236,178943,107529,0,-1103,0,0,0,,1103,-1103
37,09-09-17,71,17:30,17:45,,,0,36.43,36.43,0,-38177,121063,159240,82886,0,0,0,0,0,,0,0
37,09-09-17,72,17:45,18:00,,,0,36.4,36.4,0,-35709,93769,129478,58060,0,0,0,0,0,,0,0
37,09-09-17,73,18:00,18:15,,25.03,0,25.03,25.03,-1,-35974,74836,110810,38862,0,-5742,0,0,0,,5742,-5742
37,09-09-17,74,18:15,18:30,,36.22,0,36.22,36.22,-1,-38224,49883,88107,11659,0,-2905,0,0,0,,2905,-2905
37,09-09-17,75,18:30,18:45,,,0,36.44,36.44,0,-34295,42015,76310,7720,0,0,0,0,0,,0,0
37,09-09-17,76,18:45,19:00,33.31,,0,33.31,33.31,1,-40253,32754,73007,-7499,0,0,1831,0,0,,1831,1831
37,09-09-17,77,19:00,19:15,30.52,,0,30.52,30.52,1,-33700,50287,83987,16587,0,0,879,0,0,,879,879
37,09-09-17,78,19:15,19:30,,,0,36.42,36.42,0,-34844,53205,88049,18361,0,0,0,0,0,,0,0
37,09-09-17,79,19:30,19:45,,,0,36.44,36.44,0,-36887,69305,106192,32418,0,0,0,0,0,,0,0
37,09-09-17,80,19:45,20:00,,,0,36.43,36.43,0,-34992,54494,89486,19502,0,0,0,0,0,,0,0
37,09-09-17,81,20:00,20:15,,,0,36.42,36.42,0,-20956,83348,104304,62392,0,0,0,0,0,,0,0
37,09-09-17,82,20:15,20:30,32.83,,0,32.83,32.83,1,-38252,50825,89077,12573,0,0,401,0,0,,401,401
37,09-09-17,83,20:30,20:45,37.7,,0,37.7,37.7,1,-50969,36553,87522,-14416,0,0,6659,0,0,,6659,6659
37,09-09-17,84,20:45,21:00,,,0,36.42,36.42,0,-40104,46558,86662,6454,0,0,313,0,0,,313,313
37,09-09-17,85,21:00,21:15,37.7,,0,37.7,37.7,1,-62493,40676,103169,-21817,0,0,3874,0,0,,3874,3874
37,09-09-17,86,21:15,21:30,30.95,,0,30.95,30.95,1,-56968,46797,103765,-10171,0,0,3644,0,0,,3644,3644
37,09-09-17,87,21:30,21:45,30.95,39.73,0,39.73,39.73,-1,-37668,48117,85785,10449,0,-142,750,0,0,,892,608
37,09-09-17,88,21:45,22:00,,26.7,0,26.7,26.7,-1,-40987,60693,101680,19706,0,-7088,0,0,0,,7088,-7088
37,09-09-17,89,22:00,22:15,,33.12,0,33.12,33.12,-1,-74255,48733,122988,-25522,0,-4284,0,0,0,,4284,-4284
37,09-09-17,90,22:15,22:30,,,0,36.32,36.32,0,-60832,32001,92833,-28831,0,-48,0,0,0,,48,-48
37,09-09-17,91,22:30,22:45,33.62,,0,33.62,33.62,1,-66676,37607,104283,-29069,0,0,965,0,0,,965,965
37,09-09-17,92,22:45,23:00,31.95,,0,31.95,31.95,1,-88628,70602,159230,-18026,0,0,687,0,0,,687,687
37,09-09-17,93,23:00,23:15,31.95,38.48,0,38.48,38.48,-1,-52118,84486,136604,32368,0,-1544,1,0,0,,1545,-1543
37,09-09-17,94,23:15,23:30,,23.03,0,23.03,23.03,-1,-52639,73605,126244,20966,0,-4212,0,0,0,,4212,-4212
37,09-09-17,95,23:30,23:45,,8.48,0,8.48,8.48,-1,-41044,102174,143218,61130,0,-24980,0,0,0,,24980,-24980
37,09-09-17,96,23:45,0:00,,6.17,0,6.17,6.17,-1,-57922,97944,155866,40022,0,-37909,0,0,0,,37909,-37909
37,09-10-17,1,0:00,0:15,,30.7,0,30.7,30.7,-1,-48085,83261,131346,35176,0,-16372,0,0,0,,16372,-16372
37,09-10-17,2,0:15,0:30,,7.95,0,7.95,7.95,-1,-38649,73707,112356,35058,0,-5911,0,0,0,,5911,-5911
37,09-10-17,3,0:30,0:45,,-68.94,0,-68.94,-68.94,-1,-27111,86280,113391,59169,0,-61272,0,0,0,,61272,-61272
37,09-10-17,4,0:45,1:00,,21.48,0,21.48,21.48,-1,-54624,100212,154836,45588,0,-47819,0,0,0,,47819,-47819
37,09-10-17,5,1:00,1:15,,30.7,0,30.7,30.7,-1,-55566,63019,118585,7453,0,-19095,0,0,0,,19095,-19095
37,09-10-17,6,1:15,1:30,31.58,30.7,0,36.05,30.7,2,-45382,55338,100720,9956,0,-2330,476,0,0,,2806,-1854
37,09-10-17,7,1:30,1:45,,25.43,0,25.43,25.43,-1,-30266,68153,98419,37887,0,-20803,0,0,0,,20803,-20803
37,09-10-17,8,1:45,2:00,,-13.78,0,-13.78,-13.78,-1,-23604,93090,116694,69486,0,-48028,0,0,0,,48028,-48028
37,09-10-17,9,2:00,2:15,37.7,8.29,0,37.7,37.7,1,-40792,41326,82118,534,0,-35076,404,0,0,,35480,-34672
37,09-10-17,10,2:15,2:30,37.7,24.08,0,24.08,24.08,-1,-40914,58501,99415,17587,0,-1705,482,0,0,,2187,-1223
37,09-10-17,11,2:30,2:45,,17.29,0,17.29,17.29,-1,-36710,75272,111982,38562,0,-27573,0,0,0,,27573,-27573
37,09-10-17,12,2:45,3:00,,23.78,0,23.78,23.78,-1,-31099,80384,111483,49285,0,-36984,0,0,0,,36984,-36984
37,09-10-17,13,3:00,3:15,,15.78,0,15.78,15.78,-1,-34307,67643,101950,33336,0,-26813,0,0,0,,26813,-26813
37,09-10-17,14,3:15,3:30,,7.47,0,7.47,7.47,-1,-36884,84728,121612,47844,0,-5401,0,0,0,,5401,-5401
37,09-10-17,15,3:30,3:45,,0.49,0,0.49,0.49,-1,-36203,77475,113678,41272,0,-19590,0,0,0,,19590,-19590
37,09-10-17,16,3:45,4:00,,39.12,0,39.12,39.12,-1,-34712,67503,102215,32791,0,-730,0,0,0,,730,-730
37,09-10-17,17,4:00,4:15,32.36,,0,32.36,32.36,1,-48518,47715,96233,-803,0,0,182,0,0,,182,182
37,09-10-17,18,4:15,4:30,,,0,36.24,36.24,0,-33715,50911,84626,17196,0,0,0,0,0,,0,0
37,09-10-17,19,4:30,4:45,,41.94,0,41.94,41.94,-1,-22916,59702,82618,36786,0,-18,0,0,0,,18,-18
37,09-10-17,20,4:45,5:00,,31.7,0,31.7,31.7,-1,-20047,79157,99204,59110,0,-602,0,0,0,,602,-602
37,09-10-17,21,5:00,5:15,,-1.78,0,-1.78,-1.78,-1,-27446,76862,104308,49416,0,-14810,0,0,0,,14810,-14810
37,09-10-17,22,5:15,5:30,,-14.55,0,-14.55,-14.55,-1,-24426,70211,94637,45785,0,-38132,0,0,0,,38132,-38132
37,09-10-17,23,5:30,5:45,,7.73,0,7.73,7.73,-1,-30258,97090,127348,66832,0,-35827,0,0,0,,35827,-35827
37,09-10-17,24,5:45,6:00,,7.91,0,7.91,7.91,-1,-29629,95090,124719,65461,0,-40708,0,0,0,,40708,-40708
37,09-10-17,25,6:00,6:15,,23.94,0,23.94,23.94,-1,-32208,119925,152133,87717,0,-32005,0,0,0,,32005,-32005
37,09-10-17,26,6:15,6:30,,26.96,0,26.96,26.96,-1,-24820,120822,145642,96002,0,-18516,0,0,0,,18516,-18516
37,09-10-17,27,6:30,6:45,,20.87,0,20.87,20.87,-1,-26586,125879,152465,99293,0,-23319,0,0,0,,23319,-23319
37,09-10-17,28,6:45,7:00,,-70.44,0,-70.44,-70.44,-1,-26650,138146,164796,111496,0,-53875,0,0,0,,53875,-53875
37,09-10-17,29,7:00,7:15,,-5.78,0,-5.78,-5.78,-1,-31464,81905,113369,50441,0,-52292,0,0,0,,52292,-52292
37,09-10-17,30,7:15,7:30,,-18.78,0,-18.78,-18.78,-1,-23230,80938,104168,57708,0,-33149,0,0,0,,33149,-33149
37,09-10-17,31,7:30,7:45,,-73.92,0,-73.92,-73.92,-1,-39651,35155,74806,-4496,0,-36036,0,0,0,,36036,-36036
37,09-10-17,32,7:45,8:00,,,0,36.22,36.22,0,-44366,69657,114023,25291,0,-590,0,0,0,,590,-590
37,09-10-17,33,8:00,8:15,,,0,36.39,36.39,0,-71382,40434,111816,-30948,0,0,0,0,0,,0,0
37,09-10-17,34,8:15,8:30,33.96,,0,33.96,33.96,1,-67076,38245,105321,-28831,0,0,492,0,0,,492,492
37,09-10-17,35,8:30,8:45,37.96,,0,37.96,37.96,1,-65230,48220,113450,-17010,0,0,7022,0,0,,7022,7022
37,09-10-17,36,8:45,9:00,31.96,,0,31.96,31.96,1,-57030,68373,125403,11343,0,0,4778,0,0,,4778,4778
37,09-10-17,37,9:00,9:15,31.05,,0,31.05,31.05,1,-63518,66819,130337,3301,0,0,2112,0,0,,2112,2112
37,09-10-17,38,9:15,9:30,,,0,36.3,36.3,0,-63114,80977,144091,17863,0,0,56,0,0,,56,56
37,09-10-17,39,9:30,9:45,,,0,36.37,36.37,0,-59621,88448,148069,28827,0,0,0,0,0,,0,0
37,09-10-17,40,9:45,10:00,,,0,36.35,36.35,0,-54841,98639,153480,43798,0,0,0,0,0,,0,0
37,09-10-17,41,10:00,10:15,,,0,36.4,36.4,0,-49832,130463,180295,80631,0,0,0,0,0,,0,0
37,09-10-17,42,10:15,10:30,,,0,36.4,36.4,0,-42756,133775,176531,91019,0,0,0,0,0,,0,0
37,09-10-17,43,10:30,10:45,,38.87,0,38.87,38.87,-1,-38727,124505,163232,85778,0,-620,0,0,0,,620,-620
37,09-10-17,44,10:45,11:00,,26.96,0,26.96,26.96,-1,-48019,116446,164465,68427,0,-1593,0,0,0,,1593,-1593
37,09-10-17,45,11:00,11:15,,7.16,0,7.16,7.16,-1,-70614,106094,176708,35480,0,-26164,0,0,0,,26164,-26164
37,09-10-17,46,11:15,11:30,,-70.58,0,-70.58,-70.58,-1,-47301,123176,170477,75875,0,-46725,0,0,0,,46725,-46725
37,09-10-17,47,11:30,11:45,,-70.58,0,-70.58,-70.58,-1,-51729,148244,199973,96515,0,-42115,0,0,0,,42115,-42115
37,09-10-17,48,11:45,12:00,,4.44,0,4.44,4.44,-1,-56502,119264,175766,62762,0,-57528,0,0,0,,57528,-57528
37,09-10-17,49,12:00,12:15,,11.67,0,11.67,11.67,-1,-49174,70043,119217,20869,0,-35449,0,0,0,,35449,-35449
37,09-10-17,50,12:15,12:30,,-9.78,0,-9.78,-9.78,-1,-39390,83696,123086,44306,0,-9184,0,0,0,,9184,-9184
37,09-10-17,51,12:30,12:45,,-71.56,0,-71.56,-71.56,-1,-45437,58313,103750,12876,0,-26835,0,0,0,,26835,-26835
37,09-10-17,52,12:45,13:00,,-71.56,0,-71.56,-71.56,-1,-34079,85540,119619,51461,0,-27713,0,0,0,,27713,-27713
37,09-10-17,53,13:00,13:15,,30.96,0,30.96,30.96,-1,-67885,75403,143288,7518,0,-9203,0,0,0,,9203,-9203
37,09-10-17,54,13:15,13:30,,5.9,0,5.9,5.9,-1,-60504,97844,158348,37340,0,-12967,0,0,0,,12967,-12967
37,09-10-17,55,13:30,13:45,,3.13,0,3.13,3.13,-1,-67224,111218,178442,43994,0,-37503,0,0,0,,37503,-37503
37,09-10-17,56,13:45,14:00,,3.13,0,3.13,3.13,-1,-63770,116942,180712,53172,0,-48613,0,0,0,,48613,-48613
37,09-10-17,57,14:00,14:15,,23.78,0,23.78,23.78,-1,-57716,83007,140723,25291,0,-23730,0,0,0,,23730,-23730
37,09-10-17,58,14:15,14:30,,5.21,0,5.21,5.21,-1,-47960,113613,161573,65653,0,-2682,0,0,0,,2682,-2682
37,09-10-17,59,14:30,14:45,,-71.8,0,-71.8,-71.8,-1,-70499,87547,158046,17048,0,-24520,0,0,0,,24520,-24520
37,09-10-17,60,14:45,15:00,,3.2,0,3.2,3.2,-1,-61251,105023,166274,43772,0,-20493,0,0,0,,20493,-20493
37,09-10-17,61,15:00,15:15,,30.96,0,30.96,30.96,-1,-68182,66314,134496,-1868,0,-11955,0,0,0,,11955,-11955
37,09-10-17,62,15:15,15:30,,26.96,0,26.96,26.96,-1,-51879,74676,126555,22797,0,-9136,0,0,0,,9136,-9136
37,09-10-17,63,15:30,15:45,,26.25,0,26.25,26.25,-1,-52942,76290,129232,23348,0,-20318,0,0,0,,20318,-20318
37,09-10-17,64,15:45,16:00,,39.37,0,39.37,39.37,-1,-58572,58510,117082,-62,0,-8725,0,0,0,,8725,-8725
37,09-10-17,65,16:00,16:15,,21.4,0,21.4,21.4,-1,-27331,87068,114399,59737,0,-6070,0,0,0,,6070,-6070
37,09-10-17,66,16:15,16:30,,42.06,0,42.06,42.06,-1,-38396,60999,99395,22603,0,-1880,0,0,0,,1880,-1880
37,09-10-17,67,16:30,16:45,,,0,36.54,36.54,0,-44218,47989,92207,3771,0,-67,0,0,0,,67,-67
37,09-10-17,68,16:45,17:00,38.62,,0,38.62,38.62,1,-65471,41348,106819,-24123,0,0,3861,0,0,,3861,3861
37,09-10-17,69,17:00,17:15,32.21,,0,32.21,32.21,1,-57925,111845,169770,53920,0,0,2003,0,0,,2003,2003
37,09-10-17,70,17:15,17:30,,,0,36.54,36.54,0,-46274,95277,141551,49003,0,0,0,0,0,,0,0
37,09-10-17,71,17:30,17:45,37.96,,0,37.96,37.96,1,-75950,68879,144829,-7071,0,0,2215,0,0,,2215,2215
37,09-10-17,72,17:45,18:00,49.14,,0,49.14,49.14,1,-103372,64911,168283,-38461,0,0,31581,0,0,,31581,31581
37,09-10-17,73,18:00,18:15,38.14,,0,38.14,38.14,1,-74807,58653,133460,-16154,0,0,25596,0,0,,25596,25596
37,09-10-17,74,18:15,18:30,38.37,39.15,0,38.37,36.53,2,-71573,53744,125317,-17829,0,-435,4038,0,0,,4473,3603
37,09-10-17,75,18:30,18:45,40.49,,0,40.49,40.49,1,-71690,52502,124192,-19188,0,0,5314,0,0,,5314,5314
37,09-10-17,76,18:45,19:00,34.65,,0,34.65,34.65,1,-61813,62164,123977,351,0,0,6642,0,0,,6642,6642
37,09-10-17,77,19:00,19:15,30.62,12.29,0,12.29,12.29,-1,-64078,106605,170683,42527,0,-2655,2116,0,0,,4771,-539
37,09-10-17,78,19:15,19:30,,8.97,0,8.97,8.97,-1,-60190,93766,153956,33576,0,-18851,0,0,0,,18851,-18851
37,09-10-17,79,19:30,19:45,,20.39,0,20.39,20.39,-1,-48980,132889,181869,83909,0,-9418,0,0,0,,9418,-9418
37,09-10-17,80,19:45,20:00,,42.07,0,42.07,42.07,-1,-47783,139175,186958,91392,0,-2797,0,0,0,,2797,-2797
37,09-10-17,81,20:00,20:15,,,0,40.08,40.08,0,-48279,120444,168723,72165,0,0,0,0,0,,0,0
37,09-10-17,82,20:15,20:30,,26.96,0,26.96,26.96,-1,-53778,116906,170684,63128,0,-5143,0,0,0,,5143,-5143
37,09-10-17,83,20:30,20:45,,7.66,0,7.66,7.66,-1,-53976,123203,177179,69227,0,-37556,0,0,0,,37556,-37556
37,09-10-17,84,20:45,21:00,,2.77,0,2.77,2.77,-1,-63449,127895,191344,64446,0,-55851,0,0,0,,55851,-55851
37,09-10-17,85,21:00,21:15,31.03,-8.71,0,31.03,31.03,1,-73446,57789,131235,-15657,0,-35573,55,0,0,,35628,-35518
37,09-10-17,86,21:15,21:30,32.21,26.96,0,36.44,26.96,2,-59815,64330,124145,4515,0,-1925,183,0,0,,2108,-1742
37,09-10-17,87,21:30,21:45,,11.77,0,11.77,11.77,-1,-43836,73750,117586,29914,0,-24395,0,0,0,,24395,-24395
37,09-10-17,88,21:45,22:00,,6.37,0,6.37,6.37,-1,-43616,93509,137125,49893,0,-32374,0,0,0,,32374,-32374
37,09-10-17,89,22:00,22:15,31.45,22.74,0,31.45,31.45,1,-86725,59930,146655,-26795,0,-18835,140,0,0,,18975,-18695
37,09-10-17,90,22:15,22:30,31.45,8.02,0,8.02,8.02,-1,-58826,72126,130952,13300,0,-4998,84,0,0,,5082,-4914
37,09-10-17,91,22:30,22:45,,-68.1,0,-68.1,-68.1,-1,-53431,80491,133922,27060,0,-44394,0,0,0,,44394,-44394
37,09-10-17,92,22:45,23:00,,13.67,0,13.67,13.67,-1,-60902,106872,167774,45970,0,-31738,0,0,0,,31738,-31738
37,09-10-17,93,23:00,23:15,33.96,14.29,0,33.96,33.96,1,-70190,60423,130613,-9767,0,-27723,503,0,0,,28226,-27220
37,09-10-17,94,23:15,23:30,33.96,14.29,0,14.29,14.29,-1,-52156,74915,127071,22759,0,-3571,400,0,0,,3971,-3171
37,09-10-17,95,23:30,23:45,,-18.78,0,-18.78,-18.78,-1,-42621,73745,116366,31124,0,-34897,0,0,0,,34897,-34897
37,09-10-17,96,23:45,0:00,,-41.88,0,-41.88,-41.88,-1,-46148,98402,144550,52254,0,-43292,0,0,0,,43292,-43292
37,09-11-17,1,0:00,0:15,,-12.03,0,-12.03,-12.03,-1,-49221,101844,151065,52623,0,-14550,0,0,0,,14550,-14550
37,09-11-17,2,0:15,0:30,,-72.6,0,-72.6,-72.6,-1,-77207,94716,171923,17509,0,-25777,0,0,0,,25777,-25777
37,09-11-17,3,0:30,0:45,,-72.6,0,-72.6,-72.6,-1,-47590,101676,149266,54086,0,-26859,0,0,0,,26859,-26859
37,09-11-17,4,0:45,1:00,,-72.6,0,-72.6,-72.6,-1,-70581,107794,178375,37213,0,-44894,0,0,0,,44894,-44894
37,09-11-17,5,1:00,1:15,43.96,-72.6,0,43.96,43.96,1,-89389,48757,138146,-40632,0,-8425,3421,0,0,,11846,-5004
37,09-11-17,6,1:15,1:30,30.65,27.03,0,27.03,27.03,-1,-56259,60815,117074,4556,0,-1712,485,0,0,,2197,-1227
37,09-11-17,7,1:30,1:45,,24.74,0,24.74,24.74,-1,-40929,71284,112213,30355,0,-15046,0,0,0,,15046,-15046
37,09-11-17,8,1:45,2:00,,18.05,0,18.05,18.05,-1,-46516,80786,127302,34270,0,-37952,0,0,0,,37952,-37952
37,09-11-17,9,2:00,2:15,,24.73,0,24.73,24.73,-1,-42808,80626,123434,37818,0,-30260,0,0,0,,30260,-30260
37,09-11-17,10,2:15,2:30,,19.54,0,19.54,19.54,-1,-44279,71995,116274,27716,0,-5166,0,0,0,,5166,-5166
37,09-11-17,11,2:30,2:45,,6.03,0,6.03,6.03,-1,-31490,66622,98112,35132,0,-21004,0,0,0,,21004,-21004
37,09-11-17,12,2:45,3:00,,28.38,0,28.38,28.38,-1,-47002,65468,112470,18466,0,-10750,0,0,0,,10750,-10750
37,09-11-17,13,3:00,3:15,,27.03,0,27.03,27.03,-1,-26967,65606,92573,38639,0,-7656,0,0,0,,7656,-7656
37,09-11-17,14,3:15,3:30,,,0,36.14,36.14,0,-42000,58503,100503,16503,0,-131,0,0,0,,131,-131
37,09-11-17,15,3:30,3:45,,,0,36.14,36.14,0,-42299,47990,90289,5691,0,0,0,0,0,,0,0
37,09-11-17,16,3:45,4:00,,,0,36.13,36.13,0,-53870,39640,93510,-14230,0,0,0,0,0,,0,0
37,09-11-17,17,4:00,4:15,,,0,36.16,36.16,0,-30656,70912,101568,40256,0,0,0,0,0,,0,0
37,09-11-17,18,4:15,4:30,,,0,36.16,36.16,0,-34744,62833,97577,28089,0,0,0,0,0,,0,0
37,09-11-17,19,4:30,4:45,,,0,36.15,36.15,0,-44291,52434,96725,8143,0,0,0,0,0,,0,0
37,09-11-17,20,4:45,5:00,31.95,,0,31.95,31.95,1,-54257,50631,104888,-3626,0,0,431,0,0,,431,431
37,09-11-17,21,5:00,5:15,31.29,25.63,0,36.15,25.63,2,-44784,88227,133011,43443,0,-5112,98,0,0,,5210,-5014
37,09-11-17,22,5:15,5:30,,27.38,0,27.38,27.38,-1,-40865,66728,107593,25863,0,-3140,0,0,0,,3140,-3140
37,09-11-17,23,5:30,5:45,35.27,30.96,0,36.1,30.96,2,-63239,67239,130478,4000,0,-4040,357,0,0,,4397,-3683
37,09-11-17,24,5:45,6:00,37.96,30.96,0,37.96,37.96,1,-72579,55374,127953,-17205,0,-330,10167,0,0,,10497,9837
37,09-11-17,25,6:00,6:15,33.96,,0,33.96,33.96,1,-44914,61865,106779,16951,0,0,7918,0,0,,7918,7918
37,09-11-17,26,6:15,6:30,,,0,36.15,36.15,0,-34299,67294,101593,32995,0,0,821,0,0,,821,821
37,09-11-17,27,6:30,6:45,105.91,,0,105.91,105.91,1,-78199,34856,113055,-43343,0,0,15382,0,0,,15382,15382
37,09-11-17,28,6:45,7:00,132.33,42.07,0,132.33,36.05,2,-69675,88753,158428,19078,0,-1,44543,0,0,,44544,44542
37,09-11-17,29,7:00,7:15,132.33,-150.03,0,-150.03,-150.03,-1,-32844,103031,135875,70187,0,-30689,1687,0,0,,32376,-29002
37,09-11-17,30,7:15,7:30,,15.49,0,15.49,15.49,-1,-37778,94317,132095,56539,0,-37847,0,0,0,,37847,-37847
37,09-11-17,31,7:30,7:45,,27.75,0,27.75,27.75,-1,-56729,84068,140797,27339,0,-31923,0,0,0,,31923,-31923
37,09-11-17,32,7:45,8:00,37.25,27.75,0,37.25,37.25,1,-76952,68631,145583,-8321,0,-5089,1617,0,0,,6706,-3472
37,09-11-17,33,8:00,8:15,41.1,,0,41.1,41.1,1,-27768,29416,57184,1648,0,0,2161,0,0,,2161,2161
37,09-11-17,34,8:15,8:30,30.86,35.98,0,40.05,35.98,2,-33258,44015,77273,10757,0,-2104,557,0,0,,2661,-1547
37,09-11-17,35,8:30,8:45,,31.56,0,31.56,31.56,-1,-26645,36654,63299,10009,0,-5944,0,0,0,,5944,-5944
37,09-11-17,36,8:45,9:00,,30.96,0,30.96,30.96,-1,-31011,42371,73382,11360,0,-10822,0,0,0,,10822,-10822
37,09-11-17,37,9:00,9:15,,7.17,0,7.17,7.17,-1,-34877,81096,115973,46219,0,-15741,0,0,0,,15741,-15741
37,09-11-17,38,9:15,9:30,,2.41,0,2.41,2.41,-1,-38835,58019,96854,19184,0,-34742,0,0,0,,34742,-34742
37,09-11-17,39,9:30,9:45,,-24.83,0,-24.83,-24.83,-1,-33625,97427,131052,63802,0,-36695,0,0,0,,36695,-36695
37,09-11-17,40,9:45,10:00,,5.2,0,5.2,5.2,-1,-35118,100222,135340,65104,0,-56863,0,0,0,,56863,-56863
37,09-11-17,41,10:00,10:15,32.38,-10.67,0,32.38,32.38,1,-59910,50133,110043,-9777,0,-35502,152,0,0,,35654,-35350
37,09-11-17,42,10:15,10:30,32.38,30.96,0,30.96,30.96,-1,-46326,58916,105242,12590,0,-1649,46,0,0,,1695,-1603
37,09-11-17,43,10:30,10:45,,18.22,0,18.22,18.22,-1,-45139,105341,150480,60202,0,-21473,0,0,0,,21473,-21473
37,09-11-17,44,10:45,11:00,,13.04,0,13.04,13.04,-1,-51382,105062,156444,53680,0,-21811,0,0,0,,21811,-21811
37,09-11-17,45,11:00,11:15,,37.92,0,37.92,37.92,-1,-80972,83205,164177,2233,0,-3867,0,0,0,,3867,-3867
37,09-11-17,46,11:15,11:30,,37.89,0,37.89,37.89,-1,-77161,95861,173022,18700,0,-526,0,0,0,,526,-526
37,09-11-17,47,11:30,11:45,,38.2,0,38.2,38.2,-1,-77108,110205,187313,33097,0,-978,0,0,0,,978,-978
37,09-11-17,48,11:45,12:00,,30.96,0,30.96,30.96,-1,-79722,110541,190263,30819,0,-650,0,0,0,,650,-650
37,09-11-17,49,12:00,12:15,,30.96,0,30.96,30.96,-1,-106182,118561,224743,12379,0,-2669,0,0,0,,2669,-2669
37,09-11-17,50,12:15,12:30,,7.03,0,7.03,7.03,-1,-99250,124974,224224,25724,0,-8790,0,0,0,,8790,-8790
37,09-11-17,51,12:30,12:45,,-68.2,0,-68.2,-68.2,-1,-124709,116877,241586,-7832,0,-31970,0,0,0,,31970,-31970
37,09-11-17,52,12:45,13:00,,-68.2,0,-68.2,-68.2,-1,-107484,139027,246511,31543,0,-14898,0,0,0,,14898,-14898
37,09-11-17,53,13:00,13:15,33.5,-68.04,0,36.35,-68.04,2,-53273,53117,106390,-156,0,-21046,551,0,0,,21597,-20495
37,09-11-17,54,13:15,13:30,33.5,-68.04,0,-68.04,-68.04,-1,-37002,78634,115636,41632,0,-10902,20,0,0,,10922,-10882
37,09-11-17,55,13:30,13:45,31.15,-68.04,0,36.36,-68.04,2,-93460,49868,143328,-43592,0,-18936,26,0,0,,18962,-18910
37,09-11-17,56,13:45,14:00,32.38,-68.04,0,32.38,32.38,1,-65645,45688,111333,-19957,0,-22,1420,0,0,,1442,1398
37,09-11-17,57,14:00,14:15,43.96,,0,43.96,43.96,1,-102374,65729,168103,-36645,0,0,3148,0,0,,3148,3148
37,09-11-17,58,14:15,14:30,45.13,,0,45.13,45.13,1,-113129,47547,160676,-65582,0,0,23704,0,0,,23704,23704
37,09-11-17,59,14:30,14:45,36.99,,0,36.99,36.99,1,-100048,47688,147736,-52360,0,0,18821,0,0,,18821,18821
37,09-11-17,60,14:45,15:00,33.98,,0,33.98,33.98,1,-104893,47712,152605,-57181,0,0,11900,0,0,,11900,11900
37,09-11-17,61,15:00,15:15,33.98,37.65,0,37.65,37.65,-1,-67030,72277,139307,5247,0,-204,2322,0,0,,2526,2118
37,09-11-17,62,15:15,15:30,,40.71,0,40.71,40.71,-1,-76878,64628,141506,-12250,0,-231,0,0,0,,231,-231
37,09-11-17,63,15:30,15:45,32.38,40.71,0,32.38,32.38,1,-91348,67527,158875,-23821,0,-122,152,0,0,,274,30
37,09-11-17,64,15:45,16:00,39.26,,0,39.26,39.26,1,-98266,72167,170433,-26099,0,0,11728,0,0,,11728,11728
37,09-11-17,65,16:00,16:15,39.26,40.16,0,40.16,40.16,-1,-60908,81134,142042,20226,0,-398,2753,0,0,,3151,2355
37,09-11-17,66,16:15,16:30,,36.94,0,36.94,36.94,-1,-61695,75038,136733,13343,0,-1894,0,0,0,,1894,-1894
37,09-11-17,67,16:30,16:45,,30.96,0,30.96,30.96,-1,-52019,74635,126654,22616,0,-6761,0,0,0,,6761,-6761
37,09-11-17,68,16:45,17:00,32.38,30.96,0,32.38,32.38,1,-61440,57438,118878,-4002,0,-2023,523,0,0,,2546,-1500
37,09-11-17,69,17:00,17:15,32.38,26.76,0,26.76,26.76,-1,-47681,113982,161663,66301,0,-4752,56,0,0,,4808,-4696
37,09-11-17,70,17:15,17:30,,30.96,0,30.96,30.96,-1,-45569,101475,147044,55906,0,-7239,0,0,0,,7239,-7239
37,09-11-17,71,17:30,17:45,,,0,35.66,35.66,0,-41230,87529,128759,46299,0,-35,0,0,0,,35,-35
37,09-11-17,72,17:45,18:00,,,0,35.68,35.68,0,-43092,101886,144978,58794,0,0,0,0,0,,0,0
37,09-11-17,73,18:00,18:15,,38.51,0,38.51,38.51,-1,-85331,78332,163663,-6999,0,-225,0,0,0,,225,-225
37,09-11-17,74,18:15,18:30,,38.66,0,38.66,38.66,-1,-50925,73525,124450,22600,0,-1856,0,0,0,,1856,-1856
37,09-11-17,75,18:30,18:45,,40.91,0,40.91,40.91,-1,-42632,75799,118431,33167,0,-195,0,0,0,,195,-195
37,09-11-17,76,18:45,19:00,,40.92,0,40.92,40.92,-1,-35409,81771,117180,46362,0,-67,0,0,0,,67,-67
37,09-11-17,77,19:00,19:15,,,0,36.18,36.18,0,-56565,65759,122324,9194,0,0,0,0,0,,0,0
37,09-11-17,78,19:15,19:30,33.86,,0,33.86,33.86,1,-62420,57409,119829,-5011,0,0,175,0,0,,175,175
37,09-11-17,79,19:30,19:45,43.96,,0,43.96,43.96,1,-69909,49423,119332,-20486,0,0,6000,0,0,,6000,6000
37,09-11-17,80,19:45,20:00,71.6,,0,71.6,71.6,1,-97095,46819,143914,-50276,0,0,13990,0,0,,13990,13990
37,09-11-17,81,20:00,20:15,49.94,,0,49.94,49.94,1,-60886,49726,110612,-11160,0,0,19554,0,0,,19554,19554
37,09-11-17,82,20:15,20:30,154.94,,0,154.94,154.94,1,-90782,32298,123080,-58484,0,0,24727,0,0,,24727,24727
37,09-11-17,83,20:30,20:45,60.94,,0,60.94,60.94,1,-96589,42164,138753,-54425,0,0,48048,0,0,,48048,48048
37,09-11-17,84,20:45,21:00,34.94,,0,34.94,34.94,1,-86617,63796,150413,-22821,0,0,20079,0,0,,20079,20079
37,09-11-17,85,21:00,21:15,48.86,,0,48.86,48.86,1,-104750,78405,183155,-26345,0,0,6960,0,0,,6960,6960
37,09-11-17,86,21:15,21:30,36.99,,0,36.99,36.99,1,-91953,69607,161560,-22346,0,0,13250,0,0,,13250,13250
37,09-11-17,87,21:30,21:45,36.99,35.06,0,35.06,35.06,-1,-50420,71674,122094,21254,0,-1499,1840,0,0,,3339,341
37,09-11-17,88,21:45,22:00,,22.86,0,22.86,22.86,-1,-35974,80924,116898,44950,0,-14343,0,0,0,,14343,-14343
37,09-11-17,89,22:00,22:15,42.79,31.96,0,42.79,31.96,2,-121679,74117,195796,-47562,0,-7746,4254,0,0,,12000,-3492
37,09-11-17,90,22:15,22:30,32.16,,0,32.16,32.16,1,-83815,64517,148332,-19298,0,0,2761,0,0,,2761,2761
37,09-11-17,91,22:30,22:45,32.16,39.26,0,39.26,39.26,-1,-74270,82550,156820,8280,0,-267,33,0,0,,300,-234
37,09-11-17,92,22:45,23:00,,26.96,0,26.96,26.96,-1,-83891,104398,188289,20507,0,-11815,0,0,0,,11815,-11815
37,09-11-17,93,23:00,23:15,37.96,26.96,0,37.96,26.96,2,-89546,81319,170865,-8227,0,-15763,1378,0,0,,17141,-14385
37,09-11-17,94,23:15,23:30,40.74,26.96,0,40.74,40.74,1,-91063,54651,145714,-36412,0,-660,10106,0,0,,10766,9446
37,09-11-17,95,23:30,23:45,33.06,,0,33.06,33.06,1,-107189,68463,175652,-38726,0,0,903,0,0,,903,903
37,09-11-17,96,23:45,0:00,37.96,,0,37.96,37.96,1,-111179,76773,187952,-34406,0,0,4596,0,0,,4596,4596
37,09-12-17,1,0:00,0:15,131.8,,0,131.8,131.8,1,-112679,41679,154358,-71000,0,0,21426,0,0,,21426,21426
37,09-12-17,2,0:15,0:30,131.8,,0,131.8,131.8,1,-88755,55807,144562,-32948,0,0,44687,0,0,,44687,44687
37,09-12-17,3,0:30,0:45,131.8,30.96,0,30.96,30.96,-1,-55673,57530,113203,1857,0,-599,876,0,0,,1475,277
37,09-12-17,4,0:45,1:00,,7.83,0,7.83,7.83,-1,-51326,77193,128519,25867,0,-25523,0,0,0,,25523,-25523
37,09-12-17,5,1:00,1:15,,30.96,0,30.96,30.96,-1,-46091,105274,151365,59183,0,-10542,0,0,0,,10542,-10542
37,09-12-17,6,1:15,1:30,33.96,30.96,0,33.96,33.96,1,-58763,53518,112281,-5245,0,-42,1104,0,0,,1146,1062
37,09-12-17,7,1:30,1:45,39.47,,0,39.47,39.47,1,-88944,39520,128464,-49424,0,0,7790,0,0,,7790,7790
37,09-12-17,8,1:45,2:00,33.12,,0,33.12,33.12,1,-92698,50674,143372,-42024,0,0,5320,0,0,,5320,5320
37,09-12-17,9,2:00,2:15,31.15,,0,31.15,31.15,1,-84198,48051,132249,-36147,0,0,962,0,0,,962,962
37,09-12-17,10,2:15,2:30,34.26,,0,34.26,34.26,1,-91578,40611,132189,-50967,0,0,1477,0,0,,1477,1477
37,09-12-17,11,2:30,2:45,31.15,,0,31.15,31.15,1,-104904,31354,136258,-73550,0,0,1642,0,0,,1642,1642
37,09-12-17,12,2:45,3:00,29.12,,0,29.12,29.12,1,-127327,27966,155293,-99361,0,0,247,0,0,,247,247
37,09-12-17,13,3:00,3:15,55.71,,0,55.71,55.71,1,-118707,42073,160780,-76634,0,0,3507,0,0,,3507,3507
37,09-12-17,14,3:15,3:30,31.15,,0,31.15,31.15,1,-118729,41493,160222,-77236,0,0,922,0,0,,922,922
37,09-12-17,15,3:30,3:45,,,0,35.68,35.68,0,-113659,38284,151943,-75375,0,0,0,0,0,,0,0
37,09-12-17,16,3:45,4:00,,,0,35.68,35.68,0,-100354,57160,157514,-43194,0,0,0,0,0,,0,0
37,09-12-17,17,4:00,4:15,,,0,35.68,35.68,0,-74452,73230,147682,-1222,0,0,0,0,0,,0,0
37,09-12-17,18,4:15,4:30,,,0,35.68,35.68,0,-77170,49403,126573,-27767,0,0,0,0,0,,0,0
37,09-12-17,19,4:30,4:45,31.15,,0,31.15,31.15,1,-62502,46166,108668,-16336,0,0,450,0,0,,450,450
37,09-12-17,20,4:45,5:00,31.15,25.77,0,25.77,25.77,-1,-60965,107910,168875,46945,0,-3701,42,0,0,,3743,-3659
37,09-12-17,21,5:00,5:15,,26.96,0,26.96,26.96,-1,-86470,90248,176718,3778,0,-14989,0,0,0,,14989,-14989
37,09-12-17,22,5:15,5:30,43.9,39.24,0,43.9,35.7,2,-136027,67740,203767,-68287,0,-7241,2738,0,0,,9979,-4503
37,09-12-17,23,5:30,5:45,52.67,39.24,0,52.67,52.67,1,-161706,80790,242496,-80916,0,-3,16304,0,0,,16307,16301
37,09-12-17,24,5:45,6:00,38.55,,0,38.55,38.55,1,-150618,77225,227843,-73393,0,0,30583,0,0,,30583,30583
37,09-12-17,25,6:00,6:15,33.96,,0,33.96,33.96,1,-163021,81967,244988,-81054,0,0,10296,0,0,,10296,10296
37,09-12-17,26,6:15,6:30,,30.96,0,30.96,30.96,-1,-88378,78940,167318,-9438,0,-26,0,0,0,,26,-26
37,09-12-17,27,6:30,6:45,37.96,,0,37.96,37.96,1,-106312,105209,211521,-1103,0,0,750,0,0,,750,750
37,09-12-17,28,6:45,7:00,60.16,,0,60.16,60.16,1,-86444,119652,206096,33208,0,0,14065,0,0,,14065,14065
37,09-12-17,29,7:00,7:15,60.16,30.96,0,30.96,30.96,-1,-36892,117603,154495,80711,0,-516,269,0,0,,785,-247
37,09-12-17,30,7:15,7:30,,,0,36.64,36.64,0,-28097,82701,110798,54604,0,0,0,0,0,,0,0
37,09-12-17,31,7:30,7:45,,,0,36.55,36.55,0,-62550,75562,138112,13012,0,0,0,0,0,,0,0
37,09-12-17,32,7:45,8:00,33.52,,0,33.52,33.52,1,-101918,99008,200926,-2910,0,0,721,0,0,,721,721
37,09-12-17,33,8:00,8:15,30.94,,0,30.94,30.94,1,-39731,83991,123722,44260,0,0,449,0,0,,449,449
37,09-12-17,34,8:15,8:30,,,0,40.16,40.16,0,-40142,80308,120450,40166,0,0,0,0,0,,0,0
37,09-12-17,35,8:30,8:45,,,0,40.17,40.17,0,-47745,77154,124899,29409,0,0,0,0,0,,0,0
37,09-12-17,36,8:45,9:00,,40.37,0,40.37,40.37,-1,-53100,77140,130240,24040,0,-24,0,0,0,,24,-24
37,09-12-17,37,9:00,9:15,,36.17,0,36.17,36.17,-1,-48267,54728,102995,6461,0,-189,0,0,0,,189,-189
37,09-12-17,38,9:15,9:30,,23.94,0,23.94,23.94,-1,-40873,67960,108833,27087,0,-6751,0,0,0,,6751,-6751
37,09-12-17,39,9:30,9:45,,8.26,0,8.26,8.26,-1,-35588,101226,136814,65638,0,-8104,0,0,0,,8104,-8104
37,09-12-17,40,9:45,10:00,,8.9,0,8.9,8.9,-1,-32348,103592,135940,71244,0,-22645,0,0,0,,22645,-22645
37,09-12-17,41,10:00,10:15,,27.94,0,27.94,27.94,-1,-48482,73021,121503,24539,0,-13870,0,0,0,,13870,-13870
37,09-12-17,42,10:15,10:30,,16.87,0,16.87,16.87,-1,-53183,106098,159281,52915,0,-11434,0,0,0,,11434,-11434
37,09-12-17,43,10:30,10:45,,10.76,0,10.76,10.76,-1,-58716,85483,144199,26767,0,-20770,0,0,0,,20770,-20770
37,09-12-17,44,10:45,11:00,,21.37,0,21.37,21.37,-1,-63794,104304,168098,40510,0,-11701,0,0,0,,11701,-11701
37,09-12-17,45,11:00,11:15,,27.94,0,27.94,27.94,-1,-79254,85865,165119,6611,0,-17169,0,0,0,,17169,-17169
37,09-12-17,46,11:15,11:30,,21.92,0,21.92,21.92,-1,-72118,89920,162038,17802,0,-7611,0,0,0,,7611,-7611
37,09-12-17,47,11:30,11:45,,9.21,0,9.21,9.21,-1,-71040,95371,166411,24331,0,-18678,0,0,0,,18678,-18678
37,09-12-17,48,11:45,12:00,,-23.68,0,-23.68,-23.68,-1,-48362,115610,163972,67248,0,-29933,0,0,0,,29933,-29933
37,09-12-17,49,12:00,12:15,,6.77,0,6.77,6.77,-1,-47654,83925,131579,36271,0,-35381,0,0,0,,35381,-35381
37,09-12-17,50,12:15,12:30,,1.73,0,1.73,1.73,-1,-42490,115607,158097,73117,0,-47012,0,0,0,,47012,-47012
37,09-12-17,51,12:30,12:45,,-8.31,0,-8.31,-8.31,-1,-48283,135525,183808,87242,0,-50700,0,0,0,,50700,-50700
37,09-12-17,52,12:45,13:00,,-31.4,0,-31.4,-31.4,-1,-50545,162142,212687,111597,0,-33905,0,0,0,,33905,-33905
37,09-12-17,53,13:00,13:15,,-47.04,0,-47.04,-47.04,-1,-41867,139667,181534,97800,0,-35059,0,0,0,,35059,-35059
37,09-12-17,54,13:15,13:30,,-49.6,0,-49.6,-49.6,-1,-36581,148999,185580,112418,0,-39489,0,0,0,,39489,-39489
37,09-12-17,55,13:30,13:45,,-46.6,0,-46.6,-46.6,-1,-45495,132787,178282,87292,0,-60366,0,0,0,,60366,-60366
37,09-12-17,56,13:45,14:00,,-44.04,0,-44.04,-44.04,-1,-59960,130009,189969,70049,0,-69692,0,0,0,,69692,-69692
37,09-12-17,57,14:00,14:15,,16.83,0,16.83,16.83,-1,-75892,110195,186087,34303,0,-32267,0,0,0,,32267,-32267
37,09-12-17,58,14:15,14:30,,10.74,0,10.74,10.74,-1,-66171,112258,178429,46087,0,-45756,0,0,0,,45756,-45756
37,09-12-17,59,14:30,14:45,,23.92,0,23.92,23.92,-1,-67620,129245,196865,61625,0,-32784,0,0,0,,32784,-32784
37,09-12-17,60,14:45,15:00,,21.96,0,21.96,21.96,-1,-72109,119700,191809,47591,0,-29483,0,0,0,,29483,-29483
37,09-12-17,61,15:00,15:15,,39.49,0,39.49,39.49,-1,-82253,120272,202525,38019,0,-10220,0,0,0,,10220,-10220
37,09-12-17,62,15:15,15:30,,28.94,0,28.94,28.94,-1,-56973,129627,186600,72654,0,-1310,0,0,0,,1310,-1310
37,09-12-17,63,15:30,15:45,,-16.58,0,-16.58,-16.58,-1,-54052,106001,160053,51949,0,-22556,0,0,0,,22556,-22556
37,09-12-17,64,15:45,16:00,,9.4,0,9.4,9.4,-1,-68981,92954,161935,23973,0,-23130,0,0,0,,23130,-23130
37,09-12-17,65,16:00,16:15,,-6.48,0,-6.48,-6.48,-1,-75151,150533,225684,75382,0,-66508,0,0,0,,66508,-66508
37,09-12-17,66,16:15,16:30,,18.76,0,18.76,18.76,-1,-83506,102138,185644,18632,0,-30320,0,0,0,,30320,-30320
37,09-12-17,67,16:30,16:45,,10.35,0,10.35,10.35,-1,-64985,104626,169611,39641,0,-10093,0,0,0,,10093,-10093
37,09-12-17,68,16:45,17:00,,27.94,0,27.94,27.94,-1,-70264,68034,138298,-2230,0,-8549,0,0,0,,8549,-8549
37,09-12-17,69,17:00,17:15,,28.94,0,28.94,28.94,-1,-46228,175766,221994,129538,0,-665,0,0,0,,665,-665
37,09-12-17,70,17:15,17:30,,,0,36.72,36.72,0,-41560,130553,172113,88993,0,0,0,0,0,,0,0
37,09-12-17,71,17:30,17:45,,,0,36.71,36.71,0,-53809,113515,167324,59706,0,0,0,0,0,,0,0
37,09-12-17,72,17:45,18:00,,,0,36.71,36.71,0,-62298,109702,172000,47404,0,0,0,0,0,,0,0
37,09-12-17,73,18:00,18:15,,23.94,0,23.94,23.94,-1,-53815,61676,115491,7861,0,-6979,0,0,0,,6979,-6979
37,09-12-17,74,18:15,18:30,,42.12,0,42.12,42.12,-1,-50353,53650,104003,3297,0,-1680,0,0,0,,1680,-1680
37,09-12-17,75,18:30,18:45,,,0,36.72,36.72,0,-53931,59479,113410,5548,0,0,0,0,0,,0,0
37,09-12-17,76,18:45,19:00,44.38,,0,44.38,44.38,1,-75590,52363,127953,-23227,0,0,7984,0,0,,7984,7984
37,09-12-17,77,19:00,19:15,36.04,,0,36.04,36.04,1,-59022,80094,139116,21072,0,0,8455,0,0,,8455,8455
37,09-12-17,78,19:15,19:30,,49.56,0,49.56,49.56,-1,-63223,88292,151515,25069,0,-388,0,0,0,,388,-388
37,09-12-17,79,19:30,19:45,,,0,40.26,40.26,0,-77021,98258,175279,21237,0,-17,0,0,0,,17,-17
37,09-12-17,80,19:45,20:00,130.12,,0,130.12,130.12,1,-104996,75113,180109,-29883,0,0,11462,0,0,,11462,11462
37,09-12-17,81,20:00,20:15,40.52,,0,40.52,40.52,1,-55618,103823,159441,48205,0,0,9207,0,0,,9207,9207
37,09-12-17,82,20:15,20:30,154.24,,0,154.24,154.24,1,-100460,64712,165172,-35748,0,0,9935,0,0,,9935,9935
37,09-12-17,83,20:30,20:45,217.12,,0,217.12,217.12,1,-93638,71414,165052,-22224,0,0,30721,0,0,,30721,30721
37,09-12-17,84,20:45,21:00,217.12,9.78,0,9.78,9.78,-1,-53065,83813,136878,30748,0,-17236,1778,0,0,,19014,-15458
37,09-12-17,85,21:00,21:15,42.94,23.65,0,42.94,42.94,1,-88822,72956,161778,-15866,0,-15657,1696,0,0,,17353,-13961
37,09-12-17,86,21:15,21:30,30.94,28.94,0,28.94,28.94,-1,-68448,60210,128658,-8238,0,-436,816,0,0,,1252,380
37,09-12-17,87,21:30,21:45,,28.94,0,28.94,28.94,-1,-65581,85904,151485,20323,0,-646,0,0,0,,646,-646
37,09-12-17,88,21:45,22:00,,4.56,0,4.56,4.56,-1,-100661,122412,223073,21751,0,-12140,0,0,0,,12140,-12140
37,09-12-17,89,22:00,22:15,33.52,-57.18,0,36.62,-57.18,2,-91373,61452,152825,-29921,0,-29291,17,0,0,,29308,-29274
37,09-12-17,90,22:15,22:30,38.26,-57.18,0,38.26,38.26,1,-73000,18159,91159,-54841,0,-570,954,0,0,,1524,384
37,09-12-17,91,22:30,22:45,34.94,,0,34.94,34.94,1,-47147,50940,98087,3793,0,0,503,0,0,,503,503
37,09-12-17,92,22:45,23:00,,-6.48,0,-6.48,-6.48,-1,-71459,107953,179412,36494,0,-13057,0,0,0,,13057,-13057
37,09-12-17,93,23:00,23:15,33.61,-49.22,0,36.62,-49.22,2,-69592,90574,160166,20982,0,-23753,221,0,0,,23974,-23532
37,09-12-17,94,23:15,23:30,34.94,27.94,0,36.65,27.94,2,-47751,63095,110846,15344,0,-938,347,0,0,,1285,-591
37,09-12-17,95,23:30,23:45,,-8,0,-8,-8,-1,-36490,91956,128446,55466,0,-13166,0,0,0,,13166,-13166
37,09-12-17,96,23:45,0:00,,-15.35,0,-15.35,-15.35,-1,-40611,91455,132066,50844,0,-44627,0,0,0,,44627,-44627
37,09/13/2017,1,0:00,0:15,50.47,26.96,0,50.47,26.96,2,-85144,70886,156030,-14258,0,-16024,2783,0,0,,18807,-13241
37,09/13/2017,2,0:15,0:30,53.07,27.51,0,53.07,27.51,2,-65328,49205,114533,-16123,0,-839,4592,0,0,,5431,3753
37,09/13/2017,3,0:30,0:45,33.96,12.09,0,12.09,12.09,-1,-40665,70809,111474,30144,0,-2858,3185,0,0,,6043,327
37,09/13/2017,4,0:45,1:00,,-9.03,0,-9.03,-9.03,-1,-58530,96557,155087,38027,0,-30395,0,0,0,,30395,-30395
37,09/13/2017,5,1:00,1:15,,,0,39.19,39.19,0,-47673,49545,97218,1872,0,-1856,0,0,0,,1856,-1856
37,09/13/2017,6,1:15,1:30,,30.96,0,30.96,30.96,-1,-21343,69478,90821,48135,0,-37,0,0,0,,37,-37
37,09/13/2017,7,1:30,1:45,,17.9,0,17.9,17.9,-1,-22543,83029,105572,60486,0,-2095,0,0,0,,2095,-2095
37,09/13/2017,8,1:45,2:00,,-99.61,0,-99.61,-99.61,-1,-54735,73169,127904,18434,0,-24056,0,0,0,,24056,-24056
37,09/13/2017,9,2:00,2:15,,31.96,0,31.96,31.96,-1,-77685,83035,160720,5350,0,-1029,0,0,0,,1029,-1029
37,09/13/2017,10,2:15,2:30,,,0,29.95,29.95,0,-77510,73748,151258,-3762,0,0,0,0,0,,0,0
37,09/13/2017,11,2:30,2:45,,,0,29.95,29.95,0,-65578,86372,151950,20794,0,0,0,0,0,,0,0
37,09/13/2017,12,2:45,3:00,,23.02,0,23.02,23.02,-1,-56682,86918,143600,30236,0,-1900,0,0,0,,1900,-1900
37,09/13/2017,13,3:00,3:15,55.17,31.31,0,55.17,55.17,1,-101899,59874,161773,-42025,0,-508,9330,0,0,,9838,8822
37,09/13/2017,14,3:15,3:30,37.96,,0,37.96,37.96,1,-92095,71202,163297,-20893,0,0,14005,0,0,,14005,14005
37,09/13/2017,15,3:30,3:45,37.96,25.21,0,25.21,25.21,-1,-68074,76863,144937,8789,0,-232,283,0,0,,515,51
37,09/13/2017,16,3:45,4:00,,-22.03,0,-22.03,-22.03,-1,-45532,82868,128400,37336,0,-13558,0,0,0,,13558,-13558
37,09/13/2017,17,4:00,4:15,,23.55,0,23.55,23.55,-1,-59734,70984,130718,11250,0,-6670,0,0,0,,6670,-6670
37,09/13/2017,18,4:15,4:30,,,0,29.53,29.53,0,-51091,81267,132358,30176,0,0,0,0,0,,0,0
37,09/13/2017,19,4:30,4:45,,,0,29.53,29.53,0,-45763,79680,125443,33917,0,0,0,0,0,,0,0
37,09/13/2017,20,4:45,5:00,,,0,29.53,29.53,0,-46426,81169,127595,34743,0,0,0,0,0,,0,0
37,09/13/2017,21,5:00,5:15,,,0,31.8,31.8,0,-39309,130761,170070,91452,0,0,0,0,0,,0,0
37,09/13/2017,22,5:15,5:30,,,0,30.99,30.99,0,-45890,120327,166217,74437,0,0,0,0,0,,0,0
37,09/13/2017,23,5:30,5:45,,,0,30.99,30.99,0,-55052,97850,152902,42798,0,0,0,0,0,,0,0
37,09/13/2017,24,5:45,6:00,,,0,30.99,30.99,0,-60815,90855,151670,30040,0,0,0,0,0,,0,0
37,09/13/2017,25,6:00,6:15,,31.38,0,31.38,31.38,-1,-51242,125111,176353,73869,0,-67,0,0,0,,67,-67
37,09/13/2017,26,6:15,6:30,,31.17,0,31.17,31.17,-1,-53740,95340,149080,41600,0,-1408,0,0,0,,1408,-1408
37,09/13/2017,27,6:30,6:45,60.92,,0,60.92,60.92,1,-100216,67744,167960,-32472,0,0,15960,0,0,,15960,15960
37,09/13/2017,28,6:45,7:00,79.54,,0,79.54,79.54,1,-114716,66582,181298,-48134,0,0,62661,0,0,,62661,62661
37,09/13/2017,29,7:00,7:15,42.29,23,0,23,23,-1,-110521,114250,224771,3729,0,-1280,26719,0,0,,27999,25439
37,09/13/2017,30,7:15,7:30,97.32,31.2,0,97.32,97.32,1,-114542,77108,191650,-37434,0,-1341,3945,0,0,,5286,2604
37,09/13/2017,31,7:30,7:45,132.4,,0,132.4,132.4,1,-104508,76481,180989,-28027,0,0,39994,0,0,,39994,39994
37,09/13/2017,32,7:45,8:00,42.29,,0,42.29,42.29,1,-84518,91840,176358,7322,0,0,5034,0,0,,5034,5034
37,09/13/2017,33,8:00,8:15,394.27,,0,394.27,394.27,1,-189501,72585,262086,-116916,0,0,45831,0,0,,45831,45831
37,09/13/2017,34,8:15,8:30,394.27,30.71,0,30.71,30.71,-1,-85740,94193,179933,8453,0,-307,17802,0,0,,18109,17495
37,09/13/2017,35,8:30,8:45,71.24,46.96,0,71.24,71.24,1,-111047,72188,183235,-38859,0,-22,5799,0,0,,5821,5777
37,09/13/2017,36,8:45,9:00,394.27,,0,394.27,394.27,1,-153603,66876,220479,-86727,0,0,58839,0,0,,58839,58839
37,09/13/2017,37,9:00,9:15,31.64,30.23,0,39.32,30.23,2,-104504,132963,237467,28459,0,-94,18850,0,0,,18944,18756
37,09/13/2017,38,9:15,9:30,50,,0,50,50,1,-132214,108095,240309,-24119,0,0,5155,0,0,,5155,5155
37,09/13/2017,39,9:30,9:45,31.64,,0,31.64,31.64,1,-126228,113336,239564,-12892,0,0,810,0,0,,810,810
37,09/13/2017,40,9:45,10:00,35,,0,35,35,1,-124513,106514,231027,-17999,0,0,1628,0,0,,1628,1628
37,09/13/2017,41,10:00,10:15,37.98,,0,37.98,37.98,1,-98131,89878,188009,-8253,0,0,3090,0,0,,3090,3090
37,09/13/2017,42,10:15,10:30,38.47,,0,38.47,38.47,1,-97221,82129,179350,-15092,0,0,5309,0,0,,5309,5309
37,09/13/2017,43,10:30,10:45,32.24,,0,32.24,32.24,1,-105213,96830,202043,-8383,0,0,4237,0,0,,4237,4237
37,09/13/2017,44,10:45,11:00,38.11,,0,38.11,38.11,1,-126637,102949,229586,-23688,0,0,5235,0,0,,5235,5235
37,09/13/2017,45,11:00,11:15,40.69,,0,40.69,40.69,1,-136361,125816,262177,-10545,0,0,6172,0,0,,6172,6172
37,09/13/2017,46,11:15,11:30,31.6,,0,31.6,31.6,1,-138350,131358,269708,-6992,0,0,458,0,0,,458,458
37,09/13/2017,47,11:30,11:45,,28.6,0,28.6,28.6,-1,-136482,148909,285391,12427,0,-1428,0,0,0,,1428,-1428
37,09/13/2017,48,11:45,12:00,,48.12,0,48.12,48.12,-1,-137158,149254,286412,12096,0,-946,0,0,0,,946,-946
37,09/13/2017,49,12:00,12:15,350.8,,0,350.8,350.8,1,-169635,109204,278839,-60431,0,0,20883,0,0,,20883,20883
37,09/13/2017,50,12:15,12:30,35.12,20.78,0,39.8,20.78,2,-142565,187946,330511,45381,0,-4202,7438,0,0,,11640,3236
37,09/13/2017,51,12:30,12:45,,24.6,0,24.6,24.6,-1,-131083,185554,316637,54471,0,-5409,0,0,0,,5409,-5409
37,09/13/2017,52,12:45,13:00,,24.6,0,24.6,24.6,-1,-135673,184090,319763,48417,0,-2647,0,0,0,,2647,-2647
37,09/13/2017,53,13:00,13:15,,12.56,0,12.56,12.56,-1,-136284,220241,356525,83957,0,-4162,0,0,0,,4162,-4162
37,09/13/2017,54,13:15,13:30,,-3.41,0,-3.41,-3.41,-1,-138980,205687,344667,66707,0,-18248,0,0,0,,18248,-18248
37,09/13/2017,55,13:30,13:45,31.59,-3.41,0,31.59,31.59,1,-142317,149021,291338,6704,0,-23943,46,0,0,,23989,-23897
37,09/13/2017,56,13:45,14:00,31.94,26.44,0,31.94,26.44,2,-162506,181953,344459,19447,0,-3797,163,0,0,,3960,-3634
37,09/13/2017,57,14:00,14:15,,23.56,0,23.56,23.56,-1,-134295,166295,300590,32000,0,-10605,0,0,0,,10605,-10605
37,09/13/2017,58,14:15,14:30,,28.6,0,28.6,28.6,-1,-126555,191227,317782,64672,0,-626,0,0,0,,626,-626
37,09/13/2017,59,14:30,14:45,,28.6,0,28.6,28.6,-1,-121826,200478,322304,78652,0,-1236,0,0,0,,1236,-1236
37,09/13/2017,60,14:45,15:00,,28.6,0,28.6,28.6,-1,-103357,202132,305489,98775,0,-1774,0,0,0,,1774,-1774
37,09/13/2017,61,15:00,15:15,,31.32,0,31.32,31.32,-1,-106051,157433,263484,51382,0,-1309,0,0,0,,1309,-1309
37,09/13/2017,62,15:15,15:30,,33.04,0,33.04,33.04,-1,-78661,129253,207914,50592,0,-220,0,0,0,,220,-220
37,09/13/2017,63,15:30,15:45,,32.44,0,32.44,32.44,-1,-64900,142325,207225,77425,0,-831,0,0,0,,831,-831
37,09/13/2017,64,15:45,16:00,,1.67,0,1.67,1.67,-1,-51040,153780,204820,102740,0,-8474,0,0,0,,8474,-8474
37,09/13/2017,65,16:00,16:15,,24.6,0,24.6,24.6,-1,-84703,118115,202818,33412,0,-10363,0,0,0,,10363,-10363
37,09/13/2017,66,16:15,16:30,31.6,24.6,0,31.6,31.6,1,-97566,107772,205338,10206,0,-138,134,0,0,,272,-4
37,09/13/2017,67,16:30,16:45,36.01,,0,36.01,36.01,1,-87560,92749,180309,5189,0,0,1691,0,0,,1691,1691
37,09/13/2017,68,16:45,17:00,58.2,,0,58.2,58.2,1,-91240,58754,149994,-32486,0,0,21120,0,0,,21120,21120
37,09/13/2017,69,17:00,17:15,31.6,30.38,0,39.9,30.38,2,-74527,103209,177736,28682,0,-579,7493,0,0,,8072,6914
37,09/13/2017,70,17:15,17:30,38.8,,0,38.8,38.8,1,-70753,59912,130665,-10841,0,0,2073,0,0,,2073,2073
37,09/13/2017,71,17:30,17:45,56.3,,0,56.3,56.3,1,-84682,50241,134923,-34441,0,0,12530,0,0,,12530,12530
37,09/13/2017,72,17:45,18:00,93.56,,0,93.56,93.56,1,-104999,48920,153919,-56079,0,0,45218,0,0,,45218,45218
37,09/13/2017,73,18:00,18:15,86.56,30.23,0,86.56,29.63,2,-67698,35794,103492,-31904,0,-65,32901,0,0,,32966,32836
37,09/13/2017,74,18:15,18:30,42.6,29.35,0,42.6,29.35,2,-52015,38203,90218,-13812,0,-283,2412,0,0,,2695,2129
37,09/13/2017,75,18:30,18:45,55.56,,0,55.56,55.56,1,-57283,42144,99427,-15139,0,0,19918,0,0,,19918,19918
37,09/13/2017,76,18:45,19:00,87.7,,0,87.7,87.7,1,-92117,49839,141956,-42278,0,0,34266,0,0,,34266,34266
37,09/13/2017,77,19:00,19:15,47.4,,0,47.4,47.4,1,-85886,54886,140772,-31000,0,0,27603,0,0,,27603,27603
37,09/13/2017,78,19:15,19:30,41.94,,0,41.94,41.94,1,-100723,53364,154087,-47359,0,0,4537,0,0,,4537,4537
37,09/13/2017,79,19:30,19:45,36.17,,0,36.17,36.17,1,-114112,62918,177030,-51194,0,0,4869,0,0,,4869,4869
37,09/13/2017,80,19:45,20:00,60.56,,0,60.56,60.56,1,-129063,51296,180359,-77767,0,0,4991,0,0,,4991,4991
37,09/13/2017,81,20:00,20:15,185.29,,0,185.29,185.29,1,-112129,26546,138675,-85583,0,0,56304,0,0,,56304,56304
37,09/13/2017,82,20:15,20:30,185.29,,0,185.29,185.29,1,-170685,38348,209033,-132337,0,0,83618,0,0,,83618,83618
37,09/13/2017,83,20:30,20:45,327.72,,0,327.72,327.72,1,-166341,75166,241507,-91175,0,0,81355,15000,0,,96355,96355
37,09/13/2017,84,20:45,21:00,,,0,32.38,32.38,0,-114148,95431,209579,-18717,0,0,18668,0,0,,18668,18668
37,09/13/2017,85,21:00,21:15,328.35,,0,328.35,328.35,1,-128393,78013,206406,-50380,0,0,17443,0,0,,17443,17443
37,09/13/2017,86,21:15,21:30,328.35,,0,328.35,328.35,1,-97481,60580,158061,-36901,0,0,41330,0,0,,41330,41330
37,09/13/2017,87,21:30,21:45,328.35,30.87,0,30.87,30.87,-1,-74800,77266,152066,2466,0,-4,5482,0,0,,5486,5478
37,09/13/2017,88,21:45,22:00,,,0,39.32,39.32,0,-88147,78208,166355,-9939,0,0,0,0,0,,0,0
37,09/13/2017,89,22:00,22:15,48.4,,0,48.4,48.4,1,-164617,55628,220245,-108989,0,0,7104,0,0,,7104,7104
37,09/13/2017,90,22:15,22:30,37.4,,0,37.4,37.4,1,-136081,32953,169034,-103128,0,0,13992,0,0,,13992,13992
37,09/13/2017,91,22:30,22:45,343.36,,0,343.36,343.36,1,-113058,34005,147063,-79053,0,0,31805,0,0,,31805,31805
37,09/13/2017,92,22:45,23:00,57.31,,0,57.31,57.31,1,-80729,70656,151385,-10073,0,0,31450,0,0,,31450,31450
37,09/13/2017,93,23:00,23:15,371.07,,0,371.07,371.07,1,-113729,42380,156109,-71349,0,0,26098,0,0,,26098,26098
37,09/13/2017,94,23:15,23:30,53.28,,0,53.28,53.28,1,-78448,45588,124036,-32860,0,0,38912,0,0,,38912,38912
37,09/13/2017,95,23:30,23:45,53.28,29.6,0,29.6,29.6,-1,-61450,52670,114120,-8780,0,-46,11140,0,0,,11186,11094
37,09/13/2017,96,23:45,0:00,,29.6,0,29.6,29.6,-1,-61927,50331,112258,-11596,0,-631,0,0,0,,631,-631
37,09/14/2017,1,0:00,0:15,,31.17,0,31.17,31.17,-1,-53183,77114,130297,23931,0,-1108,0,0,0,,1108,-1108
37,09/14/2017,2,0:15,0:30,,31.1,0,31.1,31.1,-1,-60064,64599,124663,4535,0,-1531,0,0,0,,1531,-1531
37,09/14/2017,3,0:30,0:45,,30.65,0,30.65,30.65,-1,-66460,77244,143704,10784,0,-3712,0,0,0,,3712,-3712
37,09/14/2017,4,0:45,1:00,,27.17,0,27.17,27.17,-1,-57017,81269,138286,24252,0,-5397,0,0,0,,5397,-5397
37,09/14/2017,5,1:00,1:15,135.45,27.17,0,135.45,135.45,1,-102590,41504,144094,-61086,0,-1471,14183,0,0,,15654,12712
37,09/14/2017,6,1:15,1:30,37.12,,0,37.12,37.12,1,-67605,37992,105597,-29613,0,0,17501,0,0,,17501,17501
37,09/14/2017,7,1:30,1:45,33.9,,0,33.9,33.9,1,-70503,47693,118196,-22810,0,0,4166,0,0,,4166,4166
37,09/14/2017,8,1:45,2:00,31.91,,0,31.91,31.91,1,-74956,38537,113493,-36419,0,0,1438,0,0,,1438,1438
37,09/14/2017,9,2:00,2:15,136.98,,0,136.98,136.98,1,-76218,14707,90925,-61511,0,0,18032,0,0,,18032,18032
37,09/14/2017,10,2:15,2:30,44.17,,0,44.17,44.17,1,-76262,10917,87179,-65345,0,0,33441,0,0,,33441,33441
37,09/14/2017,11,2:30,2:45,37.23,,0,37.23,37.23,1,-64829,14110,78939,-50719,0,0,12249,0,0,,12249,12249
37,09/14/2017,12,2:45,3:00,34.17,,0,34.17,34.17,1,-68998,15071,84069,-53927,0,0,4359,0,0,,4359,4359
37,09/14/2017,13,3:00,3:15,,,0,38.55,38.55,0,-63486,68004,131490,4518,0,0,238,0,0,,238,238
37,09/14/2017,14,3:15,3:30,32.65,,0,32.65,32.65,1,-57284,42070,99354,-15214,0,0,693,0,0,,693,693
37,09/14/2017,15,3:30,3:45,33.37,,0,33.37,33.37,1,-62073,45252,107325,-16821,0,0,3449,0,0,,3449,3449
37,09/14/2017,16,3:45,4:00,31.73,29.78,0,38.55,29.78,2,-54475,63886,118361,9411,0,-1685,1675,0,0,,3360,-10
37,09/14/2017,17,4:00,4:15,,28.15,0,28.15,28.15,-1,-51981,60454,112435,8473,0,-7538,0,0,0,,7538,-7538
37,09/14/2017,18,4:15,4:30,,29.46,0,29.46,29.46,-1,-58555,56984,115539,-1571,0,-12715,0,0,0,,12715,-12715
37,09/14/2017,19,4:30,4:45,,31.17,0,31.17,31.17,-1,-57952,56668,114620,-1284,0,-6075,0,0,0,,6075,-6075
37,09/14/2017,20,4:45,5:00,,30.76,0,30.76,30.76,-1,-53428,74428,127856,21000,0,-3390,0,0,0,,3390,-3390
37,09/14/2017,21,5:00,5:15,,27.17,0,27.17,27.17,-1,-71419,90751,162170,19332,0,-10602,0,0,0,,10602,-10602
37,09/14/2017,22,5:15,5:30,,27.17,0,27.17,27.17,-1,-50020,73213,123233,23193,0,-16571,0,0,0,,16571,-16571
37,09/14/2017,23,5:30,5:45,,30.69,0,30.69,30.69,-1,-66443,86787,153230,20344,0,-13077,0,0,0,,13077,-13077
37,09/14/2017,24,5:45,6:00,32.1,30.69,0,32.1,32.1,1,-94075,105132,199207,11057,0,-742,105,0,0,,847,-637
37,09/14/2017,25,6:00,6:15,,31.25,0,31.25,31.25,-1,-61530,78984,140514,17454,0,-1244,0,0,0,,1244,-1244
37,09/14/2017,26,6:15,6:30,,,0,30.15,30.15,0,-62885,56132,119017,-6753,0,0,0,0,0,,0,0
37,09/14/2017,27,6:30,6:45,42.38,,0,42.38,42.38,1,-95196,53989,149185,-41207,0,0,2575,0,0,,2575,2575
37,09/14/2017,28,6:45,7:00,42.38,,0,42.38,42.38,1,-79669,156209,235878,76540,0,0,6944,0,0,,6944,6944
37,09/14/2017,29,7:00,7:15,34.67,-54.46,0,38.51,-54.46,2,-85240,64061,149301,-21179,0,-1573,373,0,0,,1946,-1200
37,09/14/2017,30,7:15,7:30,,,0,38.47,38.47,0,-70578,69546,140124,-1032,0,0,0,0,0,,0,0
37,09/14/2017,31,7:30,7:45,35.24,,0,35.24,35.24,1,-74058,58155,132213,-15903,0,0,653,0,0,,653,653
37,09/14/2017,32,7:45,8:00,45.9,,0,45.9,45.9,1,-81095,52293,133388,-28802,0,0,11823,0,0,,11823,11823
37,09/14/2017,33,8:00,8:15,53.91,,0,53.91,53.91,1,-105788,54646,160434,-51142,0,0,15619,0,0,,15619,15619
37,09/14/2017,34,8:15,8:30,68.26,,0,68.26,68.26,1,-97676,50629,148305,-47047,0,0,22647,0,0,,22647,22647
37,09/14/2017,35,8:30,8:45,42.91,,0,42.91,42.91,1,-93929,34696,128625,-59233,0,0,23706,0,0,,23706,23706
37,09/14/2017,36,8:45,9:00,53.91,,0,53.91,53.91,1,-91717,33090,124807,-58627,0,0,20112,0,0,,20112,20112
37,09/14/2017,37,9:00,9:15,255.91,,0,255.91,255.91,1,-99131,52317,151448,-46814,0,0,37999,0,0,,37999,37999
37,09/14/2017,38,9:15,9:30,40.81,,0,40.81,40.81,1,-81291,64748,146039,-16543,0,0,11942,0,0,,11942,11942
37,09/14/2017,39,9:30,9:45,31.68,,0,31.68,31.68,1,-60699,66305,127004,5606,0,0,1872,0,0,,1872,1872
37,09/14/2017,40,9:45,10:00,,,0,31.24,31.24,0,-42251,68453,110704,26202,0,0,0,0,0,,0,0
37,09/14/2017,41,10:00,10:15,,,0,31.21,31.21,0,-40862,140993,181855,100131,0,0,0,0,0,,0,0
37,09/14/2017,42,10:15,10:30,,28.68,0,28.68,28.68,-1,-35139,155923,191062,120784,0,-667,0,0,0,,667,-667
37,09/14/2017,43,10:30,10:45,,9.44,0,9.44,9.44,-1,-35969,137843,173812,101874,0,-14957,0,0,0,,14957,-14957
37,09/14/2017,44,10:45,11:00,,27.49,0,27.49,27.49,-1,-27837,133036,160873,105199,0,-12984,0,0,0,,12984,-12984
37,09/14/2017,45,11:00,11:15,,20.96,0,20.96,20.96,-1,-36951,109341,146292,72390,0,-23138,0,0,0,,23138,-23138
37,09/14/2017,46,11:15,11:30,,-12.78,0,-12.78,-12.78,-1,-53559,129511,183070,75952,0,-43339,0,0,0,,43339,-43339
37,09/14/2017,47,11:30,11:45,,21.89,0,21.89,21.89,-1,-70274,106976,177250,36702,0,-39630,0,0,0,,39630,-39630
37,09/14/2017,48,11:45,12:00,,25.74,0,25.74,25.74,-1,-74070,108285,182355,34215,0,-30996,0,0,0,,30996,-30996
37,09/14/2017,49,12:00,12:15,,28.68,0,28.68,28.68,-1,-95798,103218,199016,7420,0,-19083,0,0,0,,19083,-19083
37,09/14/2017,50,12:15,12:30,,29.68,0,29.68,29.68,-1,-75845,71007,146852,-4838,0,-2481,0,0,0,,2481,-2481
37,09/14/2017,51,12:30,12:45,,29.68,0,29.68,29.68,-1,-70078,67027,137105,-3051,0,-597,0,0,0,,597,-597
37,09/14/2017,52,12:45,13:00,,,0,32.51,32.51,0,-76029,59288,135317,-16741,0,0,0,0,0,,0,0
37,09/14/2017,53,13:00,13:15,46.09,,0,46.09,46.09,1,-82054,73361,155415,-8693,0,0,2921,0,0,,2921,2921
37,09/14/2017,54,13:15,13:30,45.64,30.19,0,45.64,30.19,2,-60528,58199,118727,-2329,0,-171,8830,0,0,,9001,8659
37,09/14/2017,55,13:30,13:45,35.68,29.16,0,35.68,29.16,2,-86022,70260,156282,-15762,0,-1379,246,0,0,,1625,-1133
37,09/14/2017,56,13:45,14:00,42.03,,0,42.03,42.03,1,-120787,74870,195657,-45917,0,0,4482,0,0,,4482,4482
37,09/14/2017,57,14:00,14:15,42.03,28.68,0,28.68,28.68,-1,-49680,147095,196775,97415,0,-665,238,0,0,,903,-427
37,09/14/2017,58,14:15,14:30,,24.11,0,24.11,24.11,-1,-71729,120237,191966,48508,0,-5745,0,0,0,,5745,-5745
37,09/14/2017,59,14:30,14:45,31.68,28.78,0,31.68,31.68,1,-103640,99853,203493,-3787,0,-11330,8,0,0,,11338,-11322
37,09/14/2017,60,14:45,15:00,36.77,28.78,0,36.77,36.77,1,-146308,120691,266999,-25617,0,-124,1643,0,0,,1767,1519
37,09/14/2017,61,15:00,15:15,37.16,,0,37.16,37.16,1,-129299,111277,240576,-18022,0,0,1159,0,0,,1159,1159
37,09/14/2017,62,15:15,15:30,43.4,,0,43.4,43.4,1,-120345,92285,212630,-28060,0,0,11635,0,0,,11635,11635
37,09/14/2017,63,15:30,15:45,100.12,,0,100.12,100.12,1,-139371,93782,233153,-45589,0,0,24720,0,0,,24720,24720
37,09/14/2017,64,15:45,16:00,191.41,,0,191.41,191.41,1,-157756,110149,267905,-47607,0,0,49555,0,0,,49555,49555
37,09/14/2017,65,16:00,16:15,31.68,30.33,0,32.01,30.33,2,-93298,137962,231260,44664,0,-680,7509,0,0,,8189,6829
37,09/14/2017,66,16:15,16:30,,28.72,0,28.72,28.72,-1,-88510,108550,197060,20040,0,-3417,0,0,0,,3417,-3417
37,09/14/2017,67,16:30,16:45,,23.79,0,23.79,23.79,-1,-72627,100091,172718,27464,0,-12476,0,0,0,,12476,-12476
37,09/14/2017,68,16:45,17:00,,3.6,0,3.6,3.6,-1,-59149,106632,165781,47483,0,-18477,0,0,0,,18477,-18477
37,09/14/2017,69,17:00,17:15,,13.69,0,13.69,13.69,-1,-36196,84962,121158,48766,0,-43925,0,0,0,,43925,-43925
37,09/14/2017,70,17:15,17:30,,8.78,0,8.78,8.78,-1,-58537,77546,136083,19009,0,-39344,0,0,0,,39344,-39344
37,09/14/2017,71,17:30,17:45,,,0,32.01,32.01,0,-70713,98743,169456,28030,0,-1359,0,0,0,,1359,-1359
37,09/14/2017,72,17:45,18:00,35.34,,0,35.34,35.34,1,-75632,98817,174449,23185,0,0,559,0,0,,559,559
37,09/14/2017,73,18:00,18:15,35.34,31.42,0,31.42,31.42,-1,-106666,101352,208018,-5314,0,-300,66,0,0,,366,-234
37,09/14/2017,74,18:15,18:30,,31.05,0,31.05,31.05,-1,-81107,107799,188906,26692,0,-425,0,0,0,,425,-425
37,09/14/2017,75,18:30,18:45,,,0,38.06,38.06,0,-62970,124636,187606,61666,0,0,0,0,0,,0,0
37,09/14/2017,76,18:45,19:00,,,0,38.06,38.06,0,-56637,154673,211310,98036,0,0,0,0,0,,0,0
37,09/14/2017,77,19:00,19:15,,14.15,0,14.15,14.15,-1,-49571,97411,146982,47840,0,-15108,0,0,0,,15108,-15108
37,09/14/2017,78,19:15,19:30,,29.68,0,29.68,29.68,-1,-53311,74969,128280,21658,0,-7254,0,0,0,,7254,-7254
37,09/14/2017,79,19:30,19:45,,45.91,0,45.91,45.91,-1,-57152,98870,156022,41718,0,-68,0,0,0,,68,-68
37,09/14/2017,80,19:45,20:00,,45.91,0,45.91,45.91,-1,-64702,119697,184399,54995,0,-705,0,0,0,,705,-705
37,09/14/2017,81,20:00,20:15,,45.76,0,45.76,45.76,-1,-52252,142579,194831,90327,0,-741,0,0,0,,741,-741
37,09/14/2017,82,20:15,20:30,,45.5,0,45.5,45.5,-1,-60346,117003,177349,56657,0,-1367,0,0,0,,1367,-1367
37,09/14/2017,83,20:30,20:45,,29.68,0,29.68,29.68,-1,-47729,111955,159684,64226,0,-3275,0,0,0,,3275,-3275
37,09/14/2017,84,20:45,21:00,,21.35,0,21.35,21.35,-1,-41270,100188,141458,58918,0,-21368,0,0,0,,21368,-21368
37,09/14/2017,85,21:00,21:15,,21.35,0,21.35,21.35,-1,-61122,115944,177066,54822,0,-19997,0,0,0,,19997,-19997
37,09/14/2017,86,21:15,21:30,,45.91,0,45.91,45.91,-1,-58068,111034,169102,52966,0,-70,0,0,0,,70,-70
37,09/14/2017,87,21:30,21:45,,27.65,0,27.65,27.65,-1,-43559,150049,193608,106490,0,-11206,0,0,0,,11206,-11206
37,09/14/2017,88,21:45,22:00,,21.35,0,21.35,21.35,-1,-41814,123986,165800,82172,0,-13732,0,0,0,,13732,-13732
37,09/14/2017,89,22:00,22:15,57.32,8.78,0,57.32,57.32,1,-99519,53905,153424,-45614,0,-10851,4276,0,0,,15127,-6575
37,09/14/2017,90,22:15,22:30,36.8,29.68,0,29.68,29.68,-1,-77422,58143,135565,-19279,0,-247,7594,0,0,,7841,7347
37,09/14/2017,91,22:30,22:45,,27.11,0,27.11,27.11,-1,-56508,65689,122197,9181,0,-3843,0,0,0,,3843,-3843
37,09/14/2017,92,22:45,23:00,,27.65,0,27.65,27.65,-1,-71808,81070,152878,9262,0,-2098,0,0,0,,2098,-2098
37,09/14/2017,93,23:00,23:15,31.68,24.68,0,31.68,31.68,1,-71864,87390,159254,15526,0,-4093,57,0,0,,4150,-4036
37,09/14/2017,94,23:15,23:30,37.16,30.05,0,37.16,30.05,2,-59744,57959,117703,-1785,0,-212,2273,0,0,,2485,2061
37,09/14/2017,95,23:30,23:45,37.16,30.05,0,37.16,30.05,2,-71416,62349,133765,-9067,0,-304,1313,0,0,,1617,1009
37,09/14/2017,96,23:45,0:00,42.54,,0,42.54,42.54,1,-113925,74119,188044,-39806,0,0,2477,0,0,,2477,2477
37,09/15/2017,1,0:00,0:15,33.37,,0,33.37,33.37,1,-67058,50103,117161,-16955,0,0,3559,0,0,,3559,3559
37,09/15/2017,2,0:15,0:30,48.02,,0,48.02,48.02,1,-56407,22904,79311,-33503,0,0,11588,0,0,,11588,11588
37,09/15/2017,3,0:30,0:45,31.88,,0,31.88,31.88,1,-47309,22904,70213,-24405,0,0,3852,0,0,,3852,3852
37,09/15/2017,4,0:45,1:00,,,0,30.94,30.94,0,-73243,40790,114033,-32453,0,0,0,0,0,,0,0
37,09/15/2017,5,1:00,1:15,32.1,29.88,0,32.1,29.88,2,-50399,37539,87938,-12860,0,-387,236,0,0,,623,-151
37,09/15/2017,6,1:15,1:30,32.1,32.2,0,32.2,32.2,-1,-36666,29988,66654,-6678,0,-19,12,0,0,,31,-7
37,09/15/2017,7,1:30,1:45,,30.62,0,30.62,30.62,-1,-39744,28310,68054,-11434,0,-962,0,0,0,,962,-962
37,09/15/2017,8,1:45,2:00,,29.88,0,29.88,29.88,-1,-44728,33458,78186,-11270,0,-1316,0,0,0,,1316,-1316
37,09/15/2017,9,2:00,2:15,27.93,29.18,0,30.06,29.18,2,-34318,50696,85014,16378,0,-2514,21,0,0,,2535,-2493
37,09/15/2017,10,2:15,2:30,33.63,,0,33.63,33.63,1,-53892,41862,95754,-12030,0,0,1598,0,0,,1598,1598
37,09/15/2017,11,2:30,2:45,31.78,,0,31.78,31.78,1,-43834,56503,100337,12669,0,0,829,0,0,,829,829
37,09/15/2017,12,2:45,3:00,31.78,28.98,0,28.98,28.98,-1,-41638,57722,99360,16084,0,-2928,28,0,0,,2956,-2900
37,09/15/2017,13,3:00,3:15,31.88,30.16,0,31.88,31.88,1,-35912,37573,73485,1661,0,-2787,84,0,0,,2871,-2703
37,09/15/2017,14,3:15,3:30,32.64,,0,32.64,32.64,1,-49517,40785,90302,-8732,0,0,731,0,0,,731,731
37,09/15/2017,15,3:30,3:45,,,0,31.18,31.18,0,-42288,50508,92796,8220,0,0,0,0,0,,0,0
37,09/15/2017,16,3:45,4:00,,31.36,0,31.36,31.36,-1,-43461,55200,98661,11739,0,-231,0,0,0,,231,-231
37,09/15/2017,17,4:00,4:15,,31.23,0,31.23,31.23,-1,-36624,41992,78616,5368,0,-268,0,0,0,,268,-268
37,09/15/2017,18,4:15,4:30,,31.02,0,31.02,31.02,-1,-41142,50346,91488,9204,0,-370,0,0,0,,370,-370
37,09/15/2017,19,4:30,4:45,,29.88,0,29.88,29.88,-1,-38853,51494,90347,12641,0,-2745,0,0,0,,2745,-2745
37,09/15/2017,20,4:45,5:00,,31.19,0,31.19,31.19,-1,-35837,48689,84526,12852,0,-1219,0,0,0,,1219,-1219
37,09/15/2017,21,5:00,5:15,,,0,31.83,31.83,0,-30720,73692,104412,42972,0,0,0,0,0,,0,0
37,09/15/2017,22,5:15,5:30,,30.74,0,30.74,30.74,-1,-44663,54210,98873,9547,0,-902,0,0,0,,902,-902
37,09/15/2017,23,5:30,5:45,,30.9,0,30.9,30.9,-1,-47841,52540,100381,4699,0,-1408,0,0,0,,1408,-1408
37,09/15/2017,24,5:45,6:00,32.1,30.9,0,32.1,32.1,1,-50263,68775,119038,18512,0,-131,407,0,0,,538,276
37,09/15/2017,25,6:00,6:15,,32.96,0,32.96,32.96,-1,-54225,80590,134815,26365,0,-424,0,0,0,,424,-424
37,09/15/2017,26,6:15,6:30,,29.65,0,29.65,29.65,-1,-55094,81093,136187,25999,0,-4121,0,0,0,,4121,-4121
37,09/15/2017,27,6:30,6:45,38.04,29.65,0,38.04,38.04,1,-76656,49534,126190,-27122,0,-158,4551,0,0,,4709,4393
37,09/15/2017,28,6:45,7:00,46.24,,0,46.24,46.24,1,-92244,92476,184720,232,0,0,21653,0,0,,21653,21653
37,09/15/2017,29,7:00,7:15,46.24,29.31,0,29.31,29.31,-1,-47011,117889,164900,70878,0,-2186,1762,0,0,,3948,-424
37,09/15/2017,30,7:15,7:30,,30.31,0,30.31,30.31,-1,-67665,112176,179841,44511,0,-2270,0,0,0,,2270,-2270
37,09/15/2017,31,7:30,7:45,,,0,32.42,32.42,0,-81362,90519,171881,9157,0,-40,0,0,0,,40,-40
37,09/15/2017,32,7:45,8:00,186.02,,0,186.02,186.02,1,-104834,41517,146351,-63317,0,0,18141,0,0,,18141,18141
37,09/15/2017,33,8:00,8:15,37.62,,0,37.62,37.62,1,-73319,65452,138771,-7867,0,0,13891,0,0,,13891,13891
37,09/15/2017,34,8:15,8:30,45.83,,0,45.83,45.83,1,-86273,51798,138071,-34475,0,0,10734,0,0,,10734,10734
37,09/15/2017,35,8:30,8:45,116.68,,0,116.68,116.68,1,-98049,44362,142411,-53687,0,0,34399,0,0,,34399,34399
37,09/15/2017,36,8:45,9:00,95.02,,0,95.02,95.02,1,-113648,57270,170918,-56378,0,0,33781,0,0,,33781,33781
37,09/15/2017,37,9:00,9:15,65.84,,0,65.84,65.84,1,-90065,43335,133400,-46730,0,0,35288,0,0,,35288,35288
37,09/15/2017,38,9:15,9:30,50.84,,0,50.84,50.84,1,-79508,41744,121252,-37764,0,0,34131,0,0,,34131,34131
37,09/15/2017,39,9:30,9:45,39.3,48.74,0,48.74,48.74,-1,-62398,60078,122476,-2320,0,-95,19586,0,0,,19681,19491
37,09/15/2017,40,9:45,10:00,39.3,29.31,0,29.31,29.31,-1,-70562,82738,153300,12176,0,-5553,570,0,0,,6123,-4983
37,09/15/2017,41,10:00,10:15,,32.03,0,32.03,32.03,-1,-87513,90040,177553,2527,0,-3492,0,0,0,,3492,-3492
37,09/15/2017,42,10:15,10:30,,25.31,0,25.31,25.31,-1,-68198,97232,165430,29034,0,-9198,0,0,0,,9198,-9198
37,09/15/2017,43,10:30,10:45,,23.07,0,23.07,23.07,-1,-67616,114827,182443,47211,0,-30447,0,0,0,,30447,-30447
37,09/15/2017,44,10:45,11:00,,13.55,0,13.55,13.55,-1,-65595,103524,169119,37929,0,-45031,0,0,0,,45031,-45031
37,09/15/2017,45,11:00,11:15,,27.53,0,27.53,27.53,-1,-67752,96603,164355,28851,0,-21971,0,0,0,,21971,-21971
37,09/15/2017,46,11:15,11:30,,29.31,0,29.31,29.31,-1,-59033,98508,157541,39475,0,-22116,0,0,0,,22116,-22116
37,09/15/2017,47,11:30,11:45,,29.31,0,29.31,29.31,-1,-55946,96598,152544,40652,0,-15706,0,0,0,,15706,-15706
37,09/15/2017,48,11:45,12:00,,,0,40.43,40.43,0,-51084,77565,128649,26481,0,-718,0,0,0,,718,-718
37,09/15/2017,49,12:00,12:15,50.26,,0,50.26,50.26,1,-76342,50350,126692,-25992,0,0,6220,0,0,,6220,6220
37,09/15/2017,50,12:15,12:30,36.31,29.31,0,29.31,29.31,-1,-71790,76518,148308,4728,0,-415,9138,0,0,,9553,8723
37,09/15/2017,51,12:30,12:45,36.31,29.31,0,29.31,29.31,-1,-63273,120303,183576,57030,0,-1319,101,0,0,,1420,-1218
37,09/15/2017,52,12:45,13:00,,20.88,0,20.88,20.88,-1,-64508,123091,187599,58583,0,-14011,0,0,0,,14011,-14011
37,09/15/2017,53,13:00,13:15,,30.65,0,30.65,30.65,-1,-66083,135203,201286,69120,0,-7761,0,0,0,,7761,-7761
37,09/15/2017,54,13:15,13:30,,,0,30.73,30.73,0,-42478,149590,192068,107112,0,0,0,0,0,,0,0
37,09/15/2017,55,13:30,13:45,,10.08,0,10.08,10.08,-1,-43823,153898,197721,110075,0,-1561,0,0,0,,1561,-1561
37,09/15/2017,56,13:45,14:00,,-17.9,0,-17.9,-17.9,-1,-62696,109996,172692,47300,0,-34021,0,0,0,,34021,-34021
37,09/15/2017,57,14:00,14:15,,29.31,0,29.31,29.31,-1,-62553,92333,154886,29780,0,-16975,0,0,0,,16975,-16975
37,09/15/2017,58,14:15,14:30,,29.31,0,29.31,29.31,-1,-44138,74008,118146,29870,0,-1097,0,0,0,,1097,-1097
37,09/15/2017,59,14:30,14:45,,-15.69,0,-15.69,-15.69,-1,-28252,99295,127547,71043,0,-34943,0,0,0,,34943,-34943
37,09/15/2017,60,14:45,15:00,,26.84,0,26.84,26.84,-1,-32326,84001,116327,51675,0,-40587,0,0,0,,40587,-40587
37,09/15/2017,61,15:00,15:15,32.31,29.31,0,32.31,32.31,1,-82836,80388,163224,-2448,0,-20505,83,0,0,,20588,-20422
37,09/15/2017,62,15:15,15:30,32.31,30.82,0,30.82,30.82,-1,-80910,104157,185067,23247,0,-1360,16,0,0,,1376,-1344
37,09/15/2017,63,15:30,15:45,,14.06,0,14.06,14.06,-1,-63065,113778,176843,50713,0,-22204,0,0,0,,22204,-22204
37,09/15/2017,64,15:45,16:00,,25.31,0,25.31,25.31,-1,-68113,111773,179886,43660,0,-39047,0,0,0,,39047,-39047
37,09/15/2017,65,16:00,16:15,,30.31,0,30.31,30.31,-1,-99979,132888,232867,32909,0,-19341,0,0,0,,19341,-19341
37,09/15/2017,66,16:15,16:30,,17.58,0,17.58,17.58,-1,-98449,140436,238885,41987,0,-22366,0,0,0,,22366,-22366
37,09/15/2017,67,16:30,16:45,,30.93,0,30.93,30.93,-1,-109021,181137,290158,72116,0,-7535,0,0,0,,7535,-7535
37,09/15/2017,68,16:45,17:00,,14.34,0,14.34,14.34,-1,-120595,146108,266703,25513,0,-12670,0,0,0,,12670,-12670
37,09/15/2017,69,17:00,17:15,,14.06,0,14.06,14.06,-1,-86291,137817,224108,51526,0,-20853,0,0,0,,20853,-20853
37,09/15/2017,70,17:15,17:30,,25.31,0,25.31,25.31,-1,-96659,124643,221302,27984,0,-30577,0,0,0,,30577,-30577
37,09/15/2017,71,17:30,17:45,,32.72,0,32.72,32.72,-1,-104062,111708,215770,7646,0,-5823,0,0,0,,5823,-5823
37,09/15/2017,72,17:45,18:00,,,0,40.45,40.45,0,-103181,90516,193697,-12665,0,-53,0,0,0,,53,-53
37,09/15/2017,73,18:00,18:15,,,0,40.55,40.55,0,-77625,38320,115945,-39305,0,0,0,0,0,,0,0
37,09/15/2017,74,18:15,18:30,,31.17,0,31.17,31.17,-1,-51996,51614,103610,-382,0,-351,0,0,0,,351,-351
37,09/15/2017,75,18:30,18:45,42.91,31.16,0,42.91,42.91,1,-59463,29876,89339,-29587,0,-400,1175,0,0,,1575,775
37,09/15/2017,76,18:45,19:00,145.47,,0,145.47,145.47,1,-72159,20910,93069,-51249,0,0,35304,0,0,,35304,35304
37,09/15/2017,77,19:00,19:15,35.76,25.31,0,40.51,25.31,2,-59739,88126,147865,28387,0,-3245,11110,0,0,,14355,7865
37,09/15/2017,78,19:15,19:30,,30.88,0,30.88,30.88,-1,-61524,70643,132167,9119,0,-1781,0,0,0,,1781,-1781
37,09/15/2017,79,19:30,19:45,,30.31,0,30.31,30.31,-1,-60270,84019,144289,23749,0,-323,0,0,0,,323,-323
37,09/15/2017,80,19:45,20:00,60.26,,0,60.26,60.26,1,-90936,50139,141075,-40797,0,0,9007,0,0,,9007,9007
37,09/15/2017,81,20:00,20:15,33.76,,0,33.76,33.76,1,-19144,115129,134273,95985,0,0,4082,0,0,,4082,4082
37,09/15/2017,82,20:15,20:30,,,0,40.49,40.49,0,-42919,98984,141903,56065,0,0,0,0,0,,0,0
37,09/15/2017,83,20:30,20:45,,,0,40.49,40.49,0,-41417,140427,181844,99010,0,0,0,0,0,,0,0
37,09/15/2017,84,20:45,21:00,,21.26,0,21.26,21.26,-1,-28846,132438,161284,103592,0,-4983,0,0,0,,4983,-4983
37,09/15/2017,85,21:00,21:15,,29.31,0,29.31,29.31,-1,-57935,90084,148019,32149,0,-3764,0,0,0,,3764,-3764
37,09/15/2017,86,21:15,21:30,,,0,29.51,29.51,0,-53452,90636,144088,37184,0,0,0,0,0,,0,0
37,09/15/2017,87,21:30,21:45,,,0,29.55,29.55,0,-46314,81855,128169,35541,0,0,0,0,0,,0,0
37,09/15/2017,88,21:45,22:00,,4.94,0,4.94,4.94,-1,-45222,101445,146667,56223,0,-5021,0,0,0,,5021,-5021
37,09/15/2017,89,22:00,22:15,27.84,-8.84,0,29.56,-8.84,2,-61992,38346,100338,-23646,0,-11554,2,0,0,,11556,-11552
37,09/15/2017,90,22:15,22:30,31.69,,0,31.69,31.69,1,-48758,39933,88691,-8825,0,0,291,0,0,,291,291
37,09/15/2017,91,22:30,22:45,,30.99,0,30.99,30.99,-1,-34455,76440,110895,41985,0,-995,0,0,0,,995,-995
37,09/15/2017,92,22:45,23:00,,17.78,0,17.78,17.78,-1,-38862,76376,115238,37514,0,-5460,0,0,0,,5460,-5460
37,09/15/2017,93,23:00,23:15,34.16,-2.4,0,34.16,34.16,1,-84440,86147,170587,1707,0,-10379,56,0,0,,10435,-10323
37,09/15/2017,94,23:15,23:30,64.22,30.31,0,64.22,29.56,2,-99117,64650,163767,-34467,0,-306,8131,0,0,,8437,7825
37,09/15/2017,95,23:30,23:45,64.22,29.31,0,29.31,29.31,-1,-80538,84961,165499,4423,0,-129,40,0,0,,169,-89
37,09/15/2017,96,23:45,0:00,36.31,,0,36.31,36.31,1,-97785,91677,189462,-6108,0,0,423,0,0,,423,423
38,09/16/2017,1,0:00,0:15,36.55,,0,36.55,36.55,1,-93457,94539,187996,1082,0,0,3248,0,0,,3248,3248
38,09/16/2017,2,0:15,0:30,,,0,30.56,30.56,0,-58881,78107,136988,19226,0,0,368,0,0,,368,368
38,09/16/2017,3,0:30,0:45,36.55,,0,36.55,36.55,1,-104293,75504,179797,-28789,0,0,2858,0,0,,2858,2858
38,09/16/2017,4,0:45,1:00,28.29,,0,28.29,28.29,1,-159342,98493,257835,-60849,0,0,1234,0,0,,1234,1234
38,09/16/2017,5,1:00,1:15,,31.89,0,31.89,31.89,-1,-47582,102526,150108,54944,0,-200,0,0,0,,200,-200
38,09/16/2017,6,1:15,1:30,,31.3,0,31.3,31.3,-1,-54899,62756,117655,7857,0,-1014,0,0,0,,1014,-1014
38,09/16/2017,7,1:30,1:45,,32.89,0,32.89,32.89,-1,-82157,74898,157055,-7259,0,-42,0,0,0,,42,-42
38,09/16/2017,8,1:45,2:00,,31.52,0,31.52,31.52,-1,-69619,87847,157466,18228,0,-2757,0,0,0,,2757,-2757
38,09/16/2017,9,2:00,2:15,,32.89,0,32.89,32.89,-1,-41786,92151,133937,50365,0,-833,0,0,0,,833,-833
38,09/16/2017,10,2:15,2:30,,9.39,0,9.39,9.39,-1,-39778,89153,128931,49375,0,-8888,0,0,0,,8888,-8888
38,09/16/2017,11,2:30,2:45,,6.94,0,6.94,6.94,-1,-41144,95776,136920,54632,0,-19687,0,0,0,,19687,-19687
38,09/16/2017,12,2:45,3:00,,-1.69,0,-1.69,-1.69,-1,-26088,111699,137787,85611,0,-28532,0,0,0,,28532,-28532
38,09/16/2017,13,3:00,3:15,,25.78,0,25.78,25.78,-1,-31661,60829,92490,29168,0,-14246,0,0,0,,14246,-14246
38,09/16/2017,14,3:15,3:30,,,0,30.59,30.59,0,-33605,56472,90077,22867,0,-10,0,0,0,,10,-10
38,09/16/2017,15,3:30,3:45,,,0,30.6,30.6,0,-26423,63162,89585,36739,0,0,0,0,0,,0,0
38,09/16/2017,16,3:45,4:00,,30.8,0,30.8,30.8,-1,-24840,73491,98331,48651,0,-535,0,0,0,,535,-535
38,09/16/2017,17,4:00,4:15,34.89,30.8,0,34.89,34.89,1,-37627,37210,74837,-417,0,-20,391,0,0,,411,371
38,09/16/2017,18,4:15,4:30,34.89,,0,34.89,34.89,1,-32648,50938,83586,18290,0,0,1772,0,0,,1772,1772
38,09/16/2017,19,4:30,4:45,28.46,,0,28.46,28.46,1,-40945,47041,87986,6096,0,0,1647,0,0,,1647,1647
38,09/16/2017,20,4:45,5:00,28.5,,0,28.5,28.5,1,-41654,46774,88428,5120,0,0,1285,0,0,,1285,1285
38,09/16/2017,21,5:00,5:15,28.5,31.89,0,31.89,31.89,-1,-54400,66376,120776,11976,0,-216,11,0,0,,227,-205
38,09/16/2017,22,5:15,5:30,,29.66,0,29.66,29.66,-1,-40899,65576,106475,24677,0,-5634,0,0,0,,5634,-5634
38,09/16/2017,23,5:30,5:45,,31.89,0,31.89,31.89,-1,-44441,62678,107119,18237,0,-4230,0,0,0,,4230,-4230
38,09/16/2017,24,5:45,6:00,,,0,30.65,30.65,0,-38850,51964,90814,13114,0,-8,0,0,0,,8,-8
38,09/16/2017,25,6:00,6:15,,31.76,0,31.76,31.76,-1,-28260,75098,103358,46838,0,-627,0,0,0,,627,-627
38,09/16/2017,26,6:15,6:30,,28.49,0,28.49,28.49,-1,-36133,60341,96474,24208,0,-2596,0,0,0,,2596,-2596
38,09/16/2017,27,6:30,6:45,,,0,30.91,30.91,0,-36301,41606,77907,5305,0,0,0,0,0,,0,0
38,09/16/2017,28,6:45,7:00,,,0,30.89,30.89,0,-47664,46295,93959,-1369,0,0,0,0,0,,0,0
38,09/16/2017,29,7:00,7:15,,,0,31.01,31.01,0,-41582,28311,69893,-13271,0,0,0,0,0,,0,0
38,09/16/2017,30,7:15,7:30,,,0,31.01,31.01,0,-29191,32424,61615,3233,0,0,0,0,0,,0,0
38,09/16/2017,31,7:30,7:45,,,0,30.98,30.98,0,-46380,23776,70156,-22604,0,0,0,0,0,,0,0
38,09/16/2017,32,7:45,8:00,,,0,30.93,30.93,0,-73696,35001,108697,-38695,0,0,0,0,0,,0,0
38,09/16/2017,33,8:00,8:15,,,0,31.01,31.01,0,-22291,64772,87063,42481,0,0,0,0,0,,0,0
38,09/16/2017,34,8:15,8:30,33.15,,0,33.15,33.15,1,-36761,44365,81126,7604,0,0,121,0,0,,121,121
38,09/16/2017,35,8:30,8:45,39.02,,0,39.02,39.02,1,-61808,35837,97645,-25971,0,0,2906,0,0,,2906,2906
38,09/16/2017,36,8:45,9:00,86.22,,0,86.22,86.22,1,-85923,32304,118227,-53619,0,0,25163,0,0,,25163,25163
38,09/16/2017,37,9:00,9:15,41.07,31.76,0,31.76,31.76,-1,-34586,62472,97058,27886,0,-253,13328,0,0,,13581,13075
38,09/16/2017,38,9:15,9:30,36.37,31.76,0,36.37,36.37,1,-50445,47404,97849,-3041,0,-9,606,0,0,,615,597
38,09/16/2017,39,9:30,9:45,42.24,,0,42.24,42.24,1,-63876,43604,107480,-20272,0,0,13653,0,0,,13653,13653
38,09/16/2017,40,9:45,10:00,39.54,,0,39.54,39.54,1,-73118,49508,122626,-23610,0,0,18977,0,0,,18977,18977
38,09/16/2017,41,10:00,10:15,32.41,33.49,0,33.49,33.49,-1,-33763,50431,84194,16668,0,-22,7245,0,0,,7267,7223
38,09/16/2017,42,10:15,10:30,,31.71,0,31.71,31.71,-1,-42371,48517,90888,6146,0,-1224,0,0,0,,1224,-1224
38,09/16/2017,43,10:30,10:45,,28.49,0,28.49,28.49,-1,-42257,55208,97465,12951,0,-2277,0,0,0,,2277,-2277
38,09/16/2017,44,10:45,11:00,,28.49,0,28.49,28.49,-1,-41281,68315,109596,27034,0,-13051,0,0,0,,13051,-13051
38,09/16/2017,45,11:00,11:15,,28.49,0,28.49,28.49,-1,-45897,62965,108862,17068,0,-10562,0,0,0,,10562,-10562
38,09/16/2017,46,11:15,11:30,,29.74,0,29.74,29.74,-1,-46702,63265,109967,16563,0,-7427,0,0,0,,7427,-7427
38,09/16/2017,47,11:30,11:45,,30.86,0,30.86,30.86,-1,-48580,65668,114248,17088,0,-9317,0,0,0,,9317,-9317
38,09/16/2017,48,11:45,12:00,,30.86,0,30.86,30.86,-1,-49214,69099,118313,19885,0,-10184,0,0,0,,10184,-10184
38,09/16/2017,49,12:00,12:15,,32.49,0,32.49,32.49,-1,-57640,71144,128784,13504,0,-4163,0,0,0,,4163,-4163
38,09/16/2017,50,12:15,12:30,,26.19,0,26.19,26.19,-1,-53996,76956,130952,22960,0,-6802,0,0,0,,6802,-6802
38,09/16/2017,51,12:30,12:45,,30.37,0,30.37,30.37,-1,-42790,86287,129077,43497,0,-7743,0,0,0,,7743,-7743
38,09/16/2017,52,12:45,13:00,,,0,30.87,30.87,0,-39537,90594,130131,51057,0,-13,0,0,0,,13,-13
38,09/16/2017,53,13:00,13:15,,,0,30.86,30.86,0,-48359,67597,115956,19238,0,0,0,0,0,,0,0
38,09/16/2017,54,13:15,13:30,,31.32,0,31.32,31.32,-1,-57517,75638,133155,18121,0,-188,0,0,0,,188,-188
38,09/16/2017,55,13:30,13:45,,30.78,0,30.78,30.78,-1,-56782,67284,124066,10502,0,-825,0,0,0,,825,-825
38,09/16/2017,56,13:45,14:00,,30.8,0,30.8,30.8,-1,-54909,69771,124680,14862,0,-3354,0,0,0,,3354,-3354
38,09/16/2017,57,14:00,14:15,33.15,32.49,0,33.15,33.15,1,-67099,61716,128815,-5383,0,-1447,621,0,0,,2068,-826
38,09/16/2017,58,14:15,14:30,34.36,,0,34.36,34.36,1,-71064,62883,133947,-8181,0,0,2045,0,0,,2045,2045
38,09/16/2017,59,14:30,14:45,32.37,,0,32.37,32.37,1,-72810,70539,143349,-2271,0,0,1206,0,0,,1206,1206
38,09/16/2017,60,14:45,15:00,28.16,,0,28.16,28.16,1,-78091,64190,142281,-13901,0,0,398,0,0,,398,398
38,09/16/2017,61,15:00,15:15,36.08,,0,36.08,36.08,1,-70789,57691,128480,-13098,0,0,1546,0,0,,1546,1546
38,09/16/2017,62,15:15,15:30,33.15,,0,33.15,33.15,1,-61254,60589,121843,-665,0,0,1064,0,0,,1064,1064
38,09/16/2017,63,15:30,15:45,33.15,,0,33.15,33.15,1,-61449,60104,121553,-1345,0,0,3039,0,0,,3039,3039
38,09/16/2017,64,15:45,16:00,33.15,31.33,0,33.15,30.79,2,-54925,67536,122461,12611,0,-465,2647,0,0,,3112,2182
38,09/16/2017,65,16:00,16:15,33.15,32.49,0,32.49,32.49,-1,-50201,87020,137221,36819,0,-2005,53,0,0,,2058,-1952
38,09/16/2017,66,16:15,16:30,,32.49,0,32.49,32.49,-1,-54082,70938,125020,16856,0,-2111,0,0,0,,2111,-2111
38,09/16/2017,67,16:30,16:45,,32.49,0,32.49,32.49,-1,-53752,55352,109104,1600,0,-1963,0,0,0,,1963,-1963
38,09/16/2017,68,16:45,17:00,,,0,30.75,30.75,0,-61696,36930,98626,-24766,0,0,0,0,0,,0,0
38,09/16/2017,69,17:00,17:15,,30.32,0,30.32,30.32,-1,-39643,77864,117507,38221,0,-2074,0,0,0,,2074,-2074
38,09/16/2017,70,17:15,17:30,,33.49,0,33.49,33.49,-1,-38422,63381,101803,24959,0,-459,0,0,0,,459,-459
38,09/16/2017,71,17:30,17:45,33.15,33.49,0,33.15,33.15,1,-47444,49336,96780,1892,0,-10,188,0,0,,198,178
38,09/16/2017,72,17:45,18:00,46.03,,0,46.03,46.03,1,-60950,41242,102192,-19708,0,0,10364,0,0,,10364,10364
38,09/16/2017,73,18:00,18:15,34.23,31.36,0,31.36,31.36,-1,-45141,34628,79769,-10513,0,-152,5778,0,0,,5930,5626
38,09/16/2017,74,18:15,18:30,,30.73,0,30.73,30.73,-1,-45557,47271,92828,1714,0,-525,0,0,0,,525,-525
38,09/16/2017,75,18:30,18:45,,33.49,0,33.49,33.49,-1,-36753,48713,85466,11960,0,-357,0,0,0,,357,-357
38,09/16/2017,76,18:45,19:00,,33.49,0,33.49,33.49,-1,-41431,53311,94742,11880,0,-848,0,0,0,,848,-848
38,09/16/2017,77,19:00,19:15,,30.66,0,30.66,30.66,-1,-38906,59330,98236,20424,0,-1724,0,0,0,,1724,-1724
38,09/16/2017,78,19:15,19:30,,,0,32.7,32.7,0,-31514,60228,91742,28714,0,-216,0,0,0,,216,-216
38,09/16/2017,79,19:30,19:45,,33.49,0,33.49,33.49,-1,-35205,63113,98318,27908,0,-486,0,0,0,,486,-486
38,09/16/2017,80,19:45,20:00,,,0,32.7,32.7,0,-54782,61004,115786,6222,0,-33,0,0,0,,33,-33
38,09/16/2017,81,20:00,20:15,39.4,,0,39.4,39.4,1,-53395,36351,89746,-17044,0,0,844,0,0,,844,844
38,09/16/2017,82,20:15,20:30,59.12,,0,59.12,59.12,1,-70016,28997,99013,-41019,0,0,21206,0,0,,21206,21206
38,09/16/2017,83,20:30,20:45,33.15,33.49,0,33.49,33.49,-1,-44401,42386,86787,-2015,0,-52,6885,0,0,,6937,6833
38,09/16/2017,84,20:45,21:00,,28.49,0,28.49,28.49,-1,-36319,53904,90223,17585,0,-6369,0,0,0,,6369,-6369
38,09/16/2017,85,21:00,21:15,350.49,33.49,0,350.49,350.49,1,-75086,23462,98548,-51624,0,-1720,17019,0,0,,18739,15299
38,09/16/2017,86,21:15,21:30,50.12,31.64,0,31.64,31.64,-1,-48061,55694,103755,7633,0,-72,21142,0,0,,21214,21070
38,09/16/2017,87,21:30,21:45,50.12,21.29,0,21.29,21.29,-1,-33542,81900,115442,48358,0,-3168,205,0,0,,3373,-2963
38,09/16/2017,88,21:45,22:00,,11.36,0,11.36,11.36,-1,-33851,77702,111553,43851,0,-28662,0,0,0,,28662,-28662
38,09/16/2017,89,22:00,22:15,35.81,32.49,0,35.81,30.87,2,-63561,26612,90173,-36949,0,-10003,1073,0,0,,11076,-8930
38,09/16/2017,90,22:15,22:30,,,0,30.89,30.89,0,-55995,26460,82455,-29535,0,0,6,0,0,,6,6
38,09/16/2017,91,22:30,22:45,,,0,30.93,30.93,0,-38934,41461,80395,2527,0,0,0,0,0,,0,0
38,09/16/2017,92,22:45,23:00,,,0,30.95,30.95,0,-41035,55213,96248,14178,0,0,0,0,0,,0,0
38,09/16/2017,93,23:00,23:15,,,0,30.89,30.89,0,-48145,64430,112575,16285,0,0,0,0,0,,0,0
38,09/16/2017,94,23:15,23:30,33.15,,0,33.15,33.15,1,-47282,37728,85010,-9554,0,0,1524,0,0,,1524,1524
38,09/16/2017,95,23:30,23:45,32.34,,0,32.34,32.34,1,-48763,39760,88523,-9003,0,0,2062,0,0,,2062,2062
38,09/16/2017,96,23:45,0:00,32.34,31.57,0,31.57,31.57,-1,-58189,52882,111071,-5307,0,-817,430,0,0,,1247,-387
38,09/17/2017,1,0:00,0:15,197.28,31.57,0,197.28,197.28,1,-54373,12840,67213,-41533,0,-230,14088,0,0,,14318,13858
38,09/17/2017,2,0:15,0:30,41.92,,0,41.92,41.92,1,-27775,16982,44757,-10793,0,0,24434,0,0,,24434,24434
38,09/17/2017,3,0:30,0:45,41.92,19.23,0,19.23,19.23,-1,-15470,34038,49508,18568,0,-8684,4464,0,0,,13148,-4220
38,09/17/2017,4,0:45,1:00,,29.03,0,29.03,29.03,-1,-64407,43208,107615,-21199,0,-11559,0,0,0,,11559,-11559
38,09/17/2017,5,1:00,1:15,,33.49,0,33.49,33.49,-1,-17335,43940,61275,26605,0,-493,0,0,0,,493,-493
38,09/17/2017,6,1:15,1:30,27.19,31.69,0,30.34,30.34,2,-22730,30634,53364,7904,0,-211,143,0,0,,354,-68
38,09/17/2017,7,1:30,1:45,,28.49,0,28.49,28.49,-1,-22056,49749,71805,27693,0,-2186,0,0,0,,2186,-2186
38,09/17/2017,8,1:45,2:00,,28.49,0,28.49,28.49,-1,-25388,41955,67343,16567,0,-10367,0,0,0,,10367,-10367
38,09/17/2017,9,2:00,2:15,35.85,32.49,0,35.85,35.85,1,-24496,39965,64461,15469,0,-4223,663,0,0,,4886,-3560
38,09/17/2017,10,2:15,2:30,32.33,,0,32.33,32.33,1,-27686,32622,60308,4936,0,0,1668,0,0,,1668,1668
38,09/17/2017,11,2:30,2:45,27.28,,0,27.28,27.28,1,-29623,42597,72220,12974,0,0,358,0,0,,358,358
38,09/17/2017,12,2:45,3:00,,30.58,0,30.58,30.58,-1,-24607,45587,70194,20980,0,-1781,0,0,0,,1781,-1781
38,09/17/2017,13,3:00,3:15,42.36,33.49,0,42.36,42.36,1,-26282,24564,50846,-1718,0,-38,5085,0,0,,5123,5047
38,09/17/2017,14,3:15,3:30,35.49,,0,35.49,35.49,1,-39122,31446,70568,-7676,0,0,8834,0,0,,8834,8834
38,09/17/2017,15,3:30,3:45,,,0,30.4,30.4,0,-37442,29100,66542,-8342,0,0,17,0,0,,17,17
38,09/17/2017,16,3:45,4:00,,,0,30.4,30.4,0,-36191,30404,66595,-5787,0,0,0,0,0,,0,0
38,09/17/2017,17,4:00,4:15,,33.49,0,33.49,33.49,-1,-19451,22708,42159,3257,0,-76,0,0,0,,76,-76
38,09/17/2017,18,4:15,4:30,27.37,,0,27.37,27.37,1,-23579,17988,41567,-5591,0,0,438,0,0,,438,438
38,09/17/2017,19,4:30,4:45,35.49,,0,35.49,35.49,1,-28190,18419,46609,-9771,0,0,904,0,0,,904,904
38,09/17/2017,20,4:45,5:00,27.34,,0,27.34,27.34,1,-21436,19823,41259,-1613,0,0,348,0,0,,348,348
38,09/17/2017,21,5:00,5:15,,,0,30.44,30.44,0,-24328,27372,51700,3044,0,0,0,0,0,,0,0
38,09/17/2017,22,5:15,5:30,,33.49,0,33.49,33.49,-1,-28857,27722,56579,-1135,0,-1137,0,0,0,,1137,-1137
38,09/17/2017,23,5:30,5:45,,33.49,0,33.49,33.49,-1,-22567,32571,55138,10004,0,-815,0,0,0,,815,-815
38,09/17/2017,24,5:45,6:00,,,0,30.44,30.44,0,-28026,36141,64167,8115,0,0,0,0,0,,0,0
38,09/17/2017,25,6:00,6:15,,31.97,0,31.97,31.97,-1,-33077,40918,73995,7841,0,-302,0,0,0,,302,-302
38,09/17/2017,26,6:15,6:30,,30.45,0,30.45,30.45,-1,-33348,34005,67353,657,0,-1496,0,0,0,,1496,-1496
38,09/17/2017,27,6:30,6:45,,,0,30.19,30.19,0,-48480,27300,75780,-21180,0,0,0,0,0,,0,0
38,09/17/2017,28,6:45,7:00,38.97,,0,38.97,38.97,1,-48140,27413,75553,-20727,0,0,4282,0,0,,4282,4282
38,09/17/2017,29,7:00,7:15,31.02,,0,31.02,31.02,1,-49272,24018,73290,-25254,0,0,1426,0,0,,1426,1426
38,09/17/2017,30,7:15,7:30,,,0,30.19,30.19,0,-28711,26037,54748,-2674,0,0,0,0,0,,0,0
38,09/17/2017,31,7:30,7:45,,,0,30.17,30.17,0,-30172,20588,50760,-9584,0,0,0,0,0,,0,0
38,09/17/2017,32,7:45,8:00,35.61,,0,35.61,35.61,1,-37803,35457,73260,-2346,0,0,4373,0,0,,4373,4373
38,09/17/2017,33,8:00,8:15,27.47,,0,27.47,27.47,1,-79418,35383,114801,-44035,0,0,1064,0,0,,1064,1064
38,09/17/2017,34,8:15,8:30,27.38,,0,27.38,27.38,1,-69076,29378,98454,-39698,0,0,755,0,0,,755,755
38,09/17/2017,35,8:30,8:45,38.97,,0,38.97,38.97,1,-77136,24654,101790,-52482,0,0,2864,0,0,,2864,2864
38,09/17/2017,36,8:45,9:00,53.26,,0,53.26,53.26,1,-71819,28561,100380,-43258,0,0,27341,0,0,,27341,27341
38,09/17/2017,37,9:00,9:15,35.31,27.97,0,35.31,27.97,2,-33348,43144,76492,9796,0,-941,10726,0,0,,11667,9785
38,09/17/2017,38,9:15,9:30,,,0,30.2,30.2,0,-27190,38971,66161,11781,0,-13,0,0,0,,13,-13
38,09/17/2017,39,9:30,9:45,,,0,30.18,30.18,0,-32615,47889,80504,15274,0,0,0,0,0,,0,0
38,09/17/2017,40,9:45,10:00,,,0,30.14,30.14,0,-31535,66885,98420,35350,0,0,0,0,0,,0,0
38,09/17/2017,41,10:00,10:15,,31.97,0,31.97,31.97,-1,-21944,90432,112376,68488,0,-306,0,0,0,,306,-306
38,09/17/2017,42,10:15,10:30,,,0,30.17,30.17,0,-26606,90034,116640,63428,0,0,0,0,0,,0,0
38,09/17/2017,43,10:30,10:45,,12.61,0,12.61,12.61,-1,-27232,98431,125663,71199,0,-4363,0,0,0,,4363,-4363
38,09/17/2017,44,10:45,11:00,,2.89,0,2.89,2.89,-1,-22044,88989,111033,66945,0,-24310,0,0,0,,24310,-24310
38,09/17/2017,45,11:00,11:15,,-67.35,0,-67.35,-67.35,-1,-26172,100454,126626,74282,0,-50222,0,0,0,,50222,-50222
38,09/17/2017,46,11:15,11:30,,8.69,0,8.69,8.69,-1,-40940,71537,112477,30597,0,-43435,0,0,0,,43435,-43435
38,09/17/2017,47,11:30,11:45,,11.18,0,11.18,11.18,-1,-35612,79766,115378,44154,0,-11277,0,0,0,,11277,-11277
38,09/17/2017,48,11:45,12:00,,27.97,0,27.97,27.97,-1,-27003,93788,120791,66785,0,-16172,0,0,0,,16172,-16172
38,09/17/2017,49,12:00,12:15,,31.97,0,31.97,31.97,-1,-40757,61447,102204,20690,0,-3462,0,0,0,,3462,-3462
38,09/17/2017,50,12:15,12:30,,27.97,0,27.97,27.97,-1,-45496,66680,112176,21184,0,-6123,0,0,0,,6123,-6123
38,09/17/2017,51,12:30,12:45,,31.29,0,31.29,31.29,-1,-45832,65366,111198,19534,0,-4884,0,0,0,,4884,-4884
38,09/17/2017,52,12:45,13:00,,31.64,0,31.64,31.64,-1,-47578,67689,115267,20111,0,-774,0,0,0,,774,-774
38,09/17/2017,53,13:00,13:15,,,0,30.01,30.01,0,-57278,61709,118987,4431,0,-27,0,0,0,,27,-27
38,09/17/2017,54,13:15,13:30,32.83,,0,32.83,32.83,1,-64342,53351,117693,-10991,0,0,580,0,0,,580,580
38,09/17/2017,55,13:30,13:45,32.83,,0,32.83,32.83,1,-71039,44905,115944,-26134,0,0,1683,0,0,,1683,1683
38,09/17/2017,56,13:45,14:00,28.08,,0,28.08,28.08,1,-69563,29373,98936,-40190,0,0,715,0,0,,715,715
38,09/17/2017,57,14:00,14:15,35.02,,0,35.02,35.02,1,-45224,39200,84424,-6024,0,0,859,0,0,,859,859
38,09/17/2017,58,14:15,14:30,38.54,,0,38.54,38.54,1,-53023,35840,88863,-17183,0,0,9254,0,0,,9254,9254
38,09/17/2017,59,14:30,14:45,33.89,,0,33.89,33.89,1,-58093,37786,95879,-20307,0,0,5964,0,0,,5964,5964
38,09/17/2017,60,14:45,15:00,36.48,,0,36.48,36.48,1,-56945,27286,84231,-29659,0,0,4606,0,0,,4606,4606
38,09/17/2017,61,15:00,15:15,32.83,,0,32.83,32.83,1,-43184,32773,75957,-10411,0,0,2623,0,0,,2623,2623
38,09/17/2017,62,15:15,15:30,35.17,,0,35.17,35.17,1,-46425,30999,77424,-15426,0,0,5119,0,0,,5119,5119
38,09/17/2017,63,15:30,15:45,33.99,,0,33.99,33.99,1,-40300,29397,69697,-10903,0,0,5120,0,0,,5120,5120
38,09/17/2017,64,15:45,16:00,27.8,,0,27.8,27.8,1,-35575,54223,89798,18648,0,0,1145,0,0,,1145,1145
38,09/17/2017,65,16:00,16:15,,24.83,0,24.83,24.83,-1,-29450,94645,124095,65195,0,-1862,0,0,0,,1862,-1862
38,09/17/2017,66,16:15,16:30,,31.65,0,31.65,31.65,-1,-36204,81173,117377,44969,0,-153,0,0,0,,153,-153
38,09/17/2017,67,16:30,16:45,,31.63,0,31.63,31.63,-1,-50563,80554,131117,29991,0,-920,0,0,0,,920,-920
38,09/17/2017,68,16:45,17:00,,,0,29.64,29.64,0,-53179,74283,127462,21104,0,-60,0,0,0,,60,-60
38,09/17/2017,69,17:00,17:15,,31.53,0,31.53,31.53,-1,-66606,111633,178239,45027,0,-659,0,0,0,,659,-659
38,09/17/2017,70,17:15,17:30,,20.46,0,20.46,20.46,-1,-33799,68682,102481,34883,0,-6306,0,0,0,,6306,-6306
38,09/17/2017,71,17:30,17:45,69.1,20.46,0,69.1,69.1,1,-64352,25749,90101,-38603,0,-475,5277,0,0,,5752,4802
38,09/17/2017,72,17:45,18:00,66.31,,0,66.31,66.31,1,-63884,50182,114066,-13702,0,0,27451,0,0,,27451,27451
38,09/17/2017,73,18:00,18:15,36.83,,0,36.83,36.83,1,-123276,8866,132142,-114410,0,0,12819,0,0,,12819,12819
38,09/17/2017,74,18:15,18:30,,,0,29.7,29.7,0,-52657,23030,75687,-29627,0,0,1741,0,0,,1741,1741
38,09/17/2017,75,18:30,18:45,36.83,,0,36.83,36.83,1,-51885,18503,70388,-33382,0,0,226,0,0,,226,226
38,09/17/2017,76,18:45,19:00,62.31,,0,62.31,62.31,1,-49605,18678,68283,-30927,0,0,16497,0,0,,16497,16497
38,09/17/2017,77,19:00,19:15,36.14,31.25,0,31.25,31.25,-1,-57921,46900,104821,-11021,0,-247,8927,0,0,,9174,8680
38,09/17/2017,78,19:15,19:30,41.87,,0,41.87,41.87,1,-54285,32073,86358,-22212,0,0,992,0,0,,992,992
38,09/17/2017,79,19:30,19:45,51.09,,0,51.09,51.09,1,-82106,34051,116157,-48055,0,0,6574,0,0,,6574,6574
38,09/17/2017,80,19:45,20:00,318.75,,0,318.75,318.75,1,-122033,44399,166432,-77634,0,0,44934,0,0,,44934,44934
38,09/17/2017,81,20:00,20:15,118.31,,0,118.31,118.31,1,-91251,42167,133418,-49084,0,0,58374,0,0,,58374,58374
38,09/17/2017,82,20:15,20:30,62.31,,0,62.31,62.31,1,-68508,54185,122693,-14323,0,0,36180,0,0,,36180,36180
38,09/17/2017,83,20:30,20:45,38.3,29.83,0,38.3,29.83,2,-51909,54093,106002,2184,0,-822,4193,0,0,,5015,3371
38,09/17/2017,84,20:45,21:00,45,,0,45,45,1,-38615,45027,83642,6412,0,0,5437,0,0,,5437,5437
38,09/17/2017,85,21:00,21:15,59.48,31.58,0,59.48,31.04,2,-62535,41092,103627,-21443,0,-112,5650,0,0,,5762,5538
38,09/17/2017,86,21:15,21:30,73.31,,0,73.31,73.31,1,-49471,30759,80230,-18712,0,0,24107,0,0,,24107,24107
38,09/17/2017,87,21:30,21:45,73.31,30.83,0,30.83,30.83,-1,-30214,29600,59814,-614,0,-558,5306,0,0,,5864,4748
38,09/17/2017,88,21:45,22:00,38.77,31.68,0,38.77,31.07,2,-38597,35281,73878,-3316,0,-192,619,0,0,,811,427
38,09/17/2017,89,22:00,22:15,293.39,31.68,0,293.39,293.39,1,-81720,31477,113197,-50243,0,-82,15230,0,0,,15312,15148
38,09/17/2017,90,22:15,22:30,42.18,,0,42.18,42.18,1,-55185,32523,87708,-22662,0,0,19812,0,0,,19812,19812
38,09/17/2017,91,22:30,22:45,42.18,30.69,0,30.69,30.69,-1,-26817,44349,71166,17532,0,-501,2521,0,0,,3022,2020
38,09/17/2017,92,22:45,23:00,,27.93,0,27.93,27.93,-1,-22833,46661,69494,23828,0,-4365,0,0,0,,4365,-4365
38,09/17/2017,93,23:00,23:15,,29.83,0,29.83,29.83,-1,-75588,80937,156525,5349,0,-4505,0,0,0,,4505,-4505
38,09/17/2017,94,23:15,23:30,41.2,,0,41.2,41.2,1,-56544,36216,92760,-20328,0,0,2936,0,0,,2936,2936
38,09/17/2017,95,23:30,23:45,41.2,29.15,0,29.15,29.15,-1,-16328,34156,50484,17828,0,-615,491,0,0,,1106,-124
38,09/17/2017,96,23:45,0:00,,13.81,0,13.81,13.81,-1,-36334,60623,96957,24289,0,-15499,0,0,0,,15499,-15499
38,09/18/2017,1,0:00,0:15,58.96,0.13,0,58.96,0.13,2,-72818,67677,140495,-5141,0,-14994,2705,0,0,,17699,-12289
38,09/18/2017,2,0:15,0:30,34.97,0.13,0,34.97,34.97,1,-63755,49694,113449,-14061,0,-13,1787,0,0,,1800,1774
38,09/18/2017,3,0:30,0:45,,31.97,0,31.97,31.97,-1,-70965,62277,133242,-8688,0,-386,0,0,0,,386,-386
38,09/18/2017,4,0:45,1:00,,27.97,0,27.97,27.97,-1,-89221,88533,177754,-688,0,-9943,0,0,0,,9943,-9943
38,09/18/2017,5,1:00,1:15,36.12,27.97,0,36.12,36.12,1,-66126,66474,132600,348,0,-1420,276,0,0,,1696,-1144
38,09/18/2017,6,1:15,1:30,37.39,27.09,0,37.39,27.09,2,-58074,67685,125759,9611,0,-1030,904,0,0,,1934,-126
38,09/18/2017,7,1:30,1:45,,16.61,0,16.61,16.61,-1,-43995,75348,119343,31353,0,-14140,0,0,0,,14140,-14140
38,09/18/2017,8,1:45,2:00,,28.52,0,28.52,28.52,-1,-47071,73794,120865,26723,0,-14574,0,0,0,,14574,-14574
38,09/18/2017,9,2:00,2:15,33.36,31.48,0,33.36,33.36,1,-47579,64992,112571,17413,0,-8058,25,0,0,,8083,-8033
38,09/18/2017,10,2:15,2:30,34.97,31.48,0,39.41,31.48,2,-51899,60093,111992,8194,0,-272,222,0,0,,494,-50
38,09/18/2017,11,2:30,2:45,,31.97,0,31.97,31.97,-1,-45042,54835,99877,9793,0,-160,0,0,0,,160,-160
38,09/18/2017,12,2:45,3:00,,29.69,0,29.69,29.69,-1,-44926,50546,95472,5620,0,-2663,0,0,0,,2663,-2663
38,09/18/2017,13,3:00,3:15,38.97,31.97,0,38.97,38.97,1,-59619,39521,99140,-20098,0,-1681,1762,0,0,,3443,81
38,09/18/2017,14,3:15,3:30,38.97,,0,38.97,38.97,1,-66268,34800,101068,-31468,0,0,5710,0,0,,5710,5710
38,09/18/2017,15,3:30,3:45,,,0,39.41,39.41,0,-46238,38368,84606,-7870,0,0,653,0,0,,653,653
38,09/18/2017,16,3:45,4:00,,15.17,0,15.17,15.17,-1,-42247,57249,99496,15002,0,-5490,0,0,0,,5490,-5490
38,09/18/2017,17,4:00,4:15,,10.47,0,10.47,10.47,-1,-40454,44973,85427,4519,0,-13250,0,0,0,,13250,-13250
38,09/18/2017,18,4:15,4:30,,,0,32.44,32.44,0,-44895,39884,84779,-5011,0,-353,0,0,0,,353,-353
38,09/18/2017,19,4:30,4:45,,,0,32.44,32.44,0,-36963,43348,80311,6385,0,0,0,0,0,,0,0
38,09/18/2017,20,4:45,5:00,,31.97,0,31.97,31.97,-1,-20791,66029,86820,45238,0,-1436,0,0,0,,1436,-1436
38,09/18/2017,21,5:00,5:15,38.97,31.97,0,38.97,38.97,1,-92116,19654,111770,-72462,0,-58,681,0,0,,739,623
38,09/18/2017,22,5:15,5:30,,32.97,0,32.97,32.97,-1,-33656,23709,57365,-9947,0,-216,0,0,0,,216,-216
38,09/18/2017,23,5:30,5:45,,32.97,0,32.97,32.97,-1,-41943,37342,79285,-4601,0,-318,0,0,0,,318,-318
38,09/18/2017,24,5:45,6:00,,30.6,0,30.6,30.6,-1,-29726,81037,110763,51311,0,-1886,0,0,0,,1886,-1886
38,09/18/2017,25,6:00,6:15,,27.97,0,27.97,27.97,-1,-32056,36690,68746,4634,0,-2065,0,0,0,,2065,-2065
38,09/18/2017,26,6:15,6:30,,,0,39.39,39.39,0,-52627,44266,96893,-8361,0,0,0,0,0,,0,0
38,09/18/2017,27,6:30,6:45,,,0,39.36,39.36,0,-58284,51843,110127,-6441,0,0,0,0,0,,0,0
38,09/18/2017,28,6:45,7:00,34.97,,0,34.97,34.97,1,-62468,73414,135882,10946,0,0,95,0,0,,95,95
38,09/18/2017,29,7:00,7:15,31.92,,0,31.92,31.92,1,-68286,72306,140592,4020,0,0,109,0,0,,109,109
38,09/18/2017,30,7:15,7:30,,31.04,0,31.04,31.04,-1,-26785,66803,93588,40018,0,-87,0,0,0,,87,-87
38,09/18/2017,31,7:30,7:45,,,0,39.35,39.35,0,-47649,56745,104394,9096,0,0,0,0,0,,0,0
38,09/18/2017,32,7:45,8:00,,30.04,0,30.04,30.04,-1,-62699,70498,133197,7799,0,-333,0,0,0,,333,-333
38,09/18/2017,33,8:00,8:15,,13.98,0,13.98,13.98,-1,-23902,67929,91831,44027,0,-9811,0,0,0,,9811,-9811
38,09/18/2017,34,8:15,8:30,,46.78,0,46.78,46.78,-1,-21100,45220,66320,24120,0,-268,0,0,0,,268,-268
38,09/18/2017,35,8:30,8:45,,34.21,0,34.21,34.21,-1,-46016,41475,87491,-4541,0,-652,0,0,0,,652,-652
38,09/18/2017,36,8:45,9:00,65.73,,0,65.73,65.73,1,-89574,32895,122469,-56679,0,0,11110,0,0,,11110,11110
38,09/18/2017,37,9:00,9:15,38.46,,0,38.46,38.46,1,-101764,40174,141938,-61590,0,0,13460,0,0,,13460,13460
38,09/18/2017,38,9:15,9:30,,,0,39.36,39.36,0,-73667,38430,112097,-35237,0,0,737,0,0,,737,737
38,09/18/2017,39,9:30,9:45,,,0,39.36,39.36,0,-64472,35693,100165,-28779,0,0,0,0,0,,0,0
38,09/18/2017,40,9:45,10:00,,,0,39.36,39.36,0,-68819,31877,100696,-36942,0,0,0,0,0,,0,0
38,09/18/2017,41,10:00,10:15,,,0,39.38,39.38,0,-64165,44129,108294,-20036,0,0,0,0,0,,0,0
38,09/18/2017,42,10:15,10:30,,46.83,0,46.83,46.83,-1,-53612,44265,97877,-9347,0,-3,0,0,0,,3,-3
38,09/18/2017,43,10:30,10:45,,46.83,0,46.83,46.83,-1,-49005,38817,87822,-10188,0,-418,0,0,0,,418,-418
38,09/18/2017,44,10:45,11:00,,46.83,0,46.83,46.83,-1,-50276,38917,89193,-11359,0,-522,0,0,0,,522,-522
38,09/18/2017,45,11:00,11:15,,31.04,0,31.04,31.04,-1,-46646,68658,115304,22012,0,-2125,0,0,0,,2125,-2125
38,09/18/2017,46,11:15,11:30,,34.15,0,34.15,34.15,-1,-46109,77300,123409,31191,0,-1095,0,0,0,,1095,-1095
38,09/18/2017,47,11:30,11:45,,46.65,0,46.65,46.65,-1,-44875,71652,116527,26777,0,-1235,0,0,0,,1235,-1235
38,09/18/2017,48,11:45,12:00,,24.04,0,24.04,24.04,-1,-41554,83686,125240,42132,0,-5578,0,0,0,,5578,-5578
38,09/18/2017,49,12:00,12:15,,21.26,0,21.26,21.26,-1,-50327,82003,132330,31676,0,-10088,0,0,0,,10088,-10088
38,09/18/2017,50,12:15,12:30,,-25.54,0,-25.54,-25.54,-1,-23637,125093,148730,101456,0,-13541,0,0,0,,13541,-13541
38,09/18/2017,51,12:30,12:45,,-49.46,0,-49.46,-49.46,-1,-22646,92569,115215,69923,0,-32488,0,0,0,,32488,-32488
38,09/18/2017,52,12:45,13:00,,9.82,0,9.82,9.82,-1,-28948,92123,121071,63175,0,-29655,0,0,0,,29655,-29655
38,09/18/2017,53,13:00,13:15,32.83,27,0,32.83,32.83,1,-53747,56549,110296,2802,0,-17301,163,0,0,,17464,-17138
38,09/18/2017,54,13:15,13:30,32.83,26.04,0,39.43,26.04,2,-56557,81051,137608,24494,0,-6968,92,0,0,,7060,-6876
38,09/18/2017,55,13:30,13:45,,29.71,0,29.71,29.71,-1,-65437,79768,145205,14331,0,-11441,0,0,0,,11441,-11441
38,09/18/2017,56,13:45,14:00,,30.04,0,30.04,30.04,-1,-70468,82906,153374,12438,0,-1456,0,0,0,,1456,-1456
38,09/18/2017,57,14:00,14:15,,47.05,0,47.05,47.05,-1,-71412,62241,133653,-9171,0,-448,0,0,0,,448,-448
38,09/18/2017,58,14:15,14:30,143.18,34.09,0,243.18,34.09,2,-128876,56354,185230,-72522,0,-144,4712,0,0,,4856,4568
38,09/18/2017,59,14:30,14:45,143.18,,0,243.18,243.18,1,-270694,122369,393063,-148325,0,0,44915,0,27501,,72416,72416
38,09/18/2017,60,14:45,15:00,143.18,,0,243.18,243.18,1,-261380,179005,440385,-82375,0,0,1060,0,27501,,28561,28561
38,09/18/2017,61,15:00,15:15,56.12,,0,56.12,56.12,1,-269561,185977,455538,-83584,0,0,5777,0,5000,,10777,10777
38,09/18/2017,62,15:15,15:30,113.12,,0,113.12,113.12,1,-276687,161143,437830,-115544,0,0,14254,0,0,,14254,14254
38,09/18/2017,63,15:30,15:45,141.88,,0,141.88,141.88,1,-284667,145887,430554,-138780,0,0,55342,0,0,,55342,55342
38,09/18/2017,64,15:45,16:00,54.38,,0,54.38,54.38,1,-282752,141994,424746,-140758,0,0,44396,0,0,,44396,44396
38,09/18/2017,65,16:00,16:15,34.95,,0,34.95,34.95,1,-202193,187473,389666,-14720,0,0,14466,0,0,,14466,14466
38,09/18/2017,66,16:15,16:30,,,0,39.48,39.48,0,-193739,184305,378044,-9434,0,0,0,0,0,,0,0
38,09/18/2017,67,16:30,16:45,,,0,39.48,39.48,0,-191524,168274,359798,-23250,0,0,0,0,0,,0,0
38,09/18/2017,68,16:45,17:00,,29.04,0,29.04,29.04,-1,-196595,153949,350544,-42646,0,-156,0,0,0,,156,-156
38,09/18/2017,69,17:00,17:15,,-49.46,0,-49.46,-49.46,-1,-58325,129339,187664,71014,0,-35475,0,0,0,,35475,-35475
38,09/18/2017,70,17:15,17:30,,28.78,0,28.78,28.78,-1,-57138,82368,139506,25230,0,-8938,0,0,0,,8938,-8938
38,09/18/2017,71,17:30,17:45,,30.04,0,30.04,30.04,-1,-54299,103162,157461,48863,0,-1016,0,0,0,,1016,-1016
38,09/18/2017,72,17:45,18:00,,30.04,0,30.04,30.04,-1,-40097,115413,155510,75316,0,-1557,0,0,0,,1557,-1557
38,09/18/2017,73,18:00,18:15,,30.04,0,30.04,30.04,-1,-71347,70380,141727,-967,0,-1932,0,0,0,,1932,-1932
38,09/18/2017,74,18:15,18:30,32.83,30.04,0,32.83,32.83,1,-51151,45545,96696,-5606,0,-1622,26,0,0,,1648,-1596
38,09/18/2017,75,18:30,18:45,32.83,,0,32.83,32.83,1,-48025,49301,97326,1276,0,0,1269,0,0,,1269,1269
38,09/18/2017,76,18:45,19:00,37.7,,0,37.7,37.7,1,-41916,54294,96210,12378,0,0,1787,0,0,,1787,1787
38,09/18/2017,77,19:00,19:15,32.89,,0,32.89,32.89,1,-70092,35022,105114,-35070,0,0,611,0,0,,611,611
38,09/18/2017,78,19:15,19:30,47.89,,0,47.89,47.89,1,-48666,33161,81827,-15505,0,0,6576,0,0,,6576,6576
38,09/18/2017,79,19:30,19:45,47.89,,0,47.89,47.89,1,-48877,33564,82441,-15313,0,0,4106,0,0,,4106,4106
38,09/18/2017,80,19:45,20:00,67.12,,0,67.12,67.12,1,-79839,34532,114371,-45307,0,0,18452,0,0,,18452,18452
38,09/18/2017,81,20:00,20:15,48.14,,0,48.14,48.14,1,-49088,52128,101216,3040,0,0,20842,0,0,,20842,20842
38,09/18/2017,82,20:15,20:30,48.14,31.9,0,31.9,31.9,-1,-42001,44856,86857,2855,0,-299,1229,0,0,,1528,930
38,09/18/2017,83,20:30,20:45,31.92,28.05,0,39.44,28.05,2,-32973,52275,85248,19302,0,-435,127,0,0,,562,-308
38,09/18/2017,84,20:45,21:00,,23.39,0,23.39,23.39,-1,-27048,59487,86535,32439,0,-23912,0,0,0,,23912,-23912
38,09/18/2017,85,21:00,21:15,82.36,27.06,0,82.36,82.36,1,-60389,36533,96922,-23856,0,-14542,4629,0,0,,19171,-9913
38,09/18/2017,86,21:15,21:30,37.17,30.04,0,30.04,30.04,-1,-42825,40289,83114,-2536,0,-191,4543,0,0,,4734,4352
38,09/18/2017,87,21:30,21:45,,23.09,0,23.09,23.09,-1,-19468,62592,82060,43124,0,-16700,0,0,0,,16700,-16700
38,09/18/2017,88,21:45,22:00,,27.2,0,27.2,27.2,-1,-59855,77690,137545,17835,0,-21016,0,0,0,,21016,-21016
38,09/18/2017,89,22:00,22:15,139.66,27.2,0,139.66,139.66,1,-95853,32752,128605,-63101,0,-1401,10099,0,0,,11500,8698
38,09/18/2017,90,22:15,22:30,32.26,,0,32.26,32.26,1,-64787,24867,89654,-39920,0,0,1412,0,0,,1412,1412
38,09/18/2017,91,22:30,22:45,35.63,,0,35.63,35.63,1,-38217,37969,76186,-248,0,0,1228,0,0,,1228,1228
38,09/18/2017,92,22:45,23:00,31.99,21.96,0,21.96,21.96,-1,-38454,75049,113503,36595,0,-2665,173,0,0,,2838,-2492
38,09/18/2017,93,23:00,23:15,,0.54,0,0.54,0.54,-1,-55672,55897,111569,225,0,-8038,0,0,0,,8038,-8038
38,09/18/2017,94,23:15,23:30,,,0,31.78,31.78,0,-48625,35013,83638,-13612,0,-10,0,0,0,,10,-10
38,09/18/2017,95,23:30,23:45,,,0,31.81,31.81,0,-52471,37007,89478,-15464,0,0,0,0,0,,0,0
38,09/18/2017,96,23:45,0:00,,8.98,0,8.98,8.98,-1,-54265,65900,120165,11635,0,-15551,0,0,0,,15551,-15551
38,09/19/2017,1,0:00,0:15,36.12,-50.81,0,36.12,-50.81,2,-63030,113282,176312,50252,0,-22014,294,0,0,,22308,-21720
38,09/19/2017,2,0:15,0:30,37.53,25.83,0,37.53,25.83,2,-48887,62795,111682,13908,0,-650,1120,0,0,,1770,470
38,09/19/2017,3,0:30,0:45,,15.18,0,15.18,15.18,-1,-36945,59311,96256,22366,0,-18147,0,0,0,,18147,-18147
38,09/19/2017,4,0:45,1:00,,22.59,0,22.59,22.59,-1,-34495,71755,106250,37260,0,-17482,0,0,0,,17482,-17482
38,09/19/2017,5,1:00,1:15,46.6,25.83,0,46.6,46.6,1,-38993,26592,65585,-12401,0,-14081,1694,0,0,,15775,-12387
38,09/19/2017,6,1:15,1:30,60.69,29.15,0,60.69,29.15,2,-26064,25043,51107,-1021,0,-262,9974,0,0,,10236,9712
38,09/19/2017,7,1:30,1:45,60.69,25.83,0,25.83,25.83,-1,-22025,48100,70125,26075,0,-8970,51,0,0,,9021,-8919
38,09/19/2017,8,1:45,2:00,,25.83,0,25.83,25.83,-1,-32925,56399,89324,23474,0,-12615,0,0,0,,12615,-12615
38,09/19/2017,9,2:00,2:15,36.83,15.08,0,36.83,15.08,2,-39823,41295,81118,1472,0,-14204,589,0,0,,14793,-13615
38,09/19/2017,10,2:15,2:30,36.83,15.08,0,36.83,36.83,1,-34938,32885,67823,-2053,0,-319,958,0,0,,1277,639
38,09/19/2017,11,2:30,2:45,,32.3,0,32.3,32.3,-1,-36772,27804,64576,-8968,0,-36,0,0,0,,36,-36
38,09/19/2017,12,2:45,3:00,,30.57,0,30.57,30.57,-1,-37158,31328,68486,-5830,0,-2021,0,0,0,,2021,-2021
38,09/19/2017,13,3:00,3:15,42.83,31.9,0,42.83,42.83,1,-38023,27073,65096,-10950,0,-1017,2340,0,0,,3357,1323
38,09/19/2017,14,3:15,3:30,43.02,,0,43.02,43.02,1,-38244,22392,60636,-15852,0,0,10441,0,0,,10441,10441
38,09/19/2017,15,3:30,3:45,,,0,30.06,30.06,0,-40371,24817,65188,-15554,0,0,197,0,0,,197,197
38,09/19/2017,16,3:45,4:00,,,0,30.05,30.05,0,-40821,16675,57496,-24146,0,0,0,0,0,,0,0
38,09/19/2017,17,4:00,4:15,,28.94,0,28.94,28.94,-1,-42446,32448,74894,-9998,0,-461,0,0,0,,461,-461
38,09/19/2017,18,4:15,4:30,,26.72,0,26.72,26.72,-1,-32036,26196,58232,-5840,0,-3188,0,0,0,,3188,-3188
38,09/19/2017,19,4:30,4:45,32.55,26.72,0,32.55,32.55,1,-34013,29412,63425,-4601,0,-28,9,0,0,,37,-19
38,09/19/2017,20,4:45,5:00,36.83,,0,36.83,36.83,1,-37232,45723,82955,8491,0,0,1634,0,0,,1634,1634
38,09/19/2017,21,5:00,5:15,36.83,15.08,0,15.08,15.08,-1,-24961,50399,75360,25438,0,-13852,11,0,0,,13863,-13841
38,09/19/2017,22,5:15,5:30,32.83,27.53,0,32.83,27.53,2,-29899,30452,60351,553,0,-23823,14,0,0,,23837,-23809
38,09/19/2017,23,5:30,5:45,36.83,27.53,0,36.83,36.83,1,-42282,24816,67098,-17466,0,-1058,965,0,0,,2023,-93
38,09/19/2017,24,5:45,6:00,38.14,,0,38.14,38.14,1,-67295,39136,106431,-28159,0,0,6036,0,0,,6036,6036
38,09/19/2017,25,6:00,6:15,46,31.46,0,31.46,31.46,-1,-72512,50587,123099,-21925,0,-216,4658,0,0,,4874,4442
38,09/19/2017,26,6:15,6:30,46,29.96,0,29.96,29.96,-1,-39583,63254,102837,23671,0,-2549,19,0,0,,2568,-2530
38,09/19/2017,27,6:30,6:45,36.96,,0,36.96,36.96,1,-57867,46295,104162,-11572,0,0,4903,0,0,,4903,4903
38,09/19/2017,28,6:45,7:00,35.46,,0,35.46,35.46,1,-76963,73564,150527,-3399,0,0,6382,0,0,,6382,6382
38,09/19/2017,29,7:00,7:15,47.1,,0,47.1,47.1,1,-78752,63813,142565,-14939,0,0,3776,0,0,,3776,3776
38,09/19/2017,30,7:15,7:30,56.02,,0,56.02,56.02,1,-68276,50312,118588,-17964,0,0,13080,0,0,,13080,13080
38,09/19/2017,31,7:30,7:45,150.02,,0,150.02,150.02,1,-73736,12141,85877,-61595,0,0,24979,0,0,,24979,24979
38,09/19/2017,32,7:45,8:00,212.23,,0,212.23,212.23,1,-88087,31812,119899,-56275,0,0,49021,0,0,,49021,49021
38,09/19/2017,33,8:00,8:15,59.76,31.65,0,31.65,31.65,-1,-95904,88545,184449,-7359,0,-36,25627,0,0,,25663,25591
38,09/19/2017,34,8:15,8:30,,30.54,0,30.54,30.54,-1,-104053,55136,159189,-48917,0,-5,0,0,0,,5,-5
38,09/19/2017,35,8:30,8:45,414.41,,0,414.41,414.41,1,-130149,40956,171105,-89193,0,0,22415,0,0,,22415,22415
38,09/19/2017,36,8:45,9:00,59.76,,0,59.76,59.76,1,-124617,50053,174670,-74564,0,0,30491,0,0,,30491,30491
38,09/19/2017,37,9:00,9:15,37.22,,0,37.22,37.22,1,-67672,57659,125331,-10013,0,0,11356,0,0,,11356,11356
38,09/19/2017,38,9:15,9:30,,,0,39.67,39.67,0,-66879,44650,111529,-22229,0,0,0,0,0,,0,0
38,09/19/2017,39,9:30,9:45,,46.8,0,46.8,46.8,-1,-60101,52614,112715,-7487,0,-9,0,0,0,,9,-9
38,09/19/2017,40,9:45,10:00,,30.96,0,30.96,30.96,-1,-51117,62233,113350,11116,0,-2014,0,0,0,,2014,-2014
38,09/19/2017,41,10:00,10:15,,46.8,0,46.8,46.8,-1,-43830,96303,140133,52473,0,-997,0,0,0,,997,-997
38,09/19/2017,42,10:15,10:30,,26.18,0,26.18,26.18,-1,-34139,114729,148868,80590,0,-1266,0,0,0,,1266,-1266
38,09/19/2017,43,10:30,10:45,,12.03,0,12.03,12.03,-1,-40794,72729,113523,31935,0,-14631,0,0,0,,14631,-14631
38,09/19/2017,44,10:45,11:00,,30.18,0,30.18,30.18,-1,-41715,108540,150255,66825,0,-1427,0,0,0,,1427,-1427
38,09/19/2017,45,11:00,11:15,,30.18,0,30.18,30.18,-1,-75471,44148,119619,-31323,0,-1646,0,0,0,,1646,-1646
38,09/19/2017,46,11:15,11:30,33.12,,0,33.12,33.12,1,-69442,33252,102694,-36190,0,0,202,0,0,,202,202
38,09/19/2017,47,11:30,11:45,32.62,,0,32.62,32.62,1,-66694,40655,107349,-26039,0,0,92,0,0,,92,92
38,09/19/2017,48,11:45,12:00,,,0,39.76,39.76,0,-61652,52304,113956,-9348,0,0,0,0,0,,0,0
38,09/19/2017,49,12:00,12:15,33.18,,0,33.18,33.18,1,-76893,39530,116423,-37363,0,0,705,0,0,,705,705
38,09/19/2017,50,12:15,12:30,33.18,,0,33.18,33.18,1,-64592,42039,106631,-22553,0,0,625,0,0,,625,625
38,09/19/2017,51,12:30,12:45,33.18,,0,33.18,33.18,1,-51896,75025,126921,23129,0,0,476,0,0,,476,476
38,09/19/2017,52,12:45,13:00,,31.18,0,31.18,31.18,-1,-52258,89840,142098,37582,0,-618,0,0,0,,618,-618
38,09/19/2017,53,13:00,13:15,,31.02,0,31.02,31.02,-1,-39425,98447,137872,59022,0,-655,0,0,0,,655,-655
38,09/19/2017,54,13:15,13:30,,28.93,0,28.93,28.93,-1,-36281,97676,133957,61395,0,-1122,0,0,0,,1122,-1122
38,09/19/2017,55,13:30,13:45,,18.84,0,18.84,18.84,-1,-34356,99838,134194,65482,0,-20886,0,0,0,,20886,-20886
38,09/19/2017,56,13:45,14:00,,10.73,0,10.73,10.73,-1,-42379,93959,136338,51580,0,-33328,0,0,0,,33328,-33328
38,09/19/2017,57,14:00,14:15,,24.7,0,24.7,24.7,-1,-39148,73306,112454,34158,0,-29674,0,0,0,,29674,-29674
38,09/19/2017,58,14:15,14:30,,29.46,0,29.46,29.46,-1,-35304,69427,104731,34123,0,-1830,0,0,0,,1830,-1830
38,09/19/2017,59,14:30,14:45,,26.18,0,26.18,26.18,-1,-33358,91751,125109,58393,0,-8942,0,0,0,,8942,-8942
38,09/19/2017,60,14:45,15:00,,5.45,0,5.45,5.45,-1,-31546,89226,120772,57680,0,-24614,0,0,0,,24614,-24614
38,09/19/2017,61,15:00,15:15,,31.03,0,31.03,31.03,-1,-39270,65234,104504,25964,0,-10009,0,0,0,,10009,-10009
38,09/19/2017,62,15:15,15:30,,,0,39.83,39.83,0,-36646,64409,101055,27763,0,0,0,0,0,,0,0
38,09/19/2017,63,15:30,15:45,,30.18,0,30.18,30.18,-1,-36601,62482,99083,25881,0,-1571,0,0,0,,1571,-1571
38,09/19/2017,64,15:45,16:00,,26.18,0,26.18,26.18,-1,-37932,57850,95782,19918,0,-12198,0,0,0,,12198,-12198
38,09/19/2017,65,16:00,16:15,,30.18,0,30.18,30.18,-1,-50357,72101,122458,21744,0,-6256,0,0,0,,6256,-6256
38,09/19/2017,66,16:15,16:30,,31.18,0,31.18,31.18,-1,-45847,52869,98716,7022,0,-5003,0,0,0,,5003,-5003
38,09/19/2017,67,16:30,16:45,,26.18,0,26.18,26.18,-1,-46166,65185,111351,19019,0,-6174,0,0,0,,6174,-6174
38,09/19/2017,68,16:45,17:00,,31.18,0,31.18,31.18,-1,-50640,60267,110907,9627,0,-2052,0,0,0,,2052,-2052
38,09/19/2017,69,17:00,17:15,,29.97,0,29.97,29.97,-1,-38162,63395,101557,25233,0,-3705,0,0,0,,3705,-3705
38,09/19/2017,70,17:15,17:30,,,0,39.78,39.78,0,-50439,68123,118562,17684,0,-230,0,0,0,,230,-230
38,09/19/2017,71,17:30,17:45,40.35,,0,40.35,40.35,1,-58449,43394,101843,-15055,0,0,1527,0,0,,1527,1527
38,09/19/2017,72,17:45,18:00,64.02,,0,64.02,64.02,1,-66028,51952,117980,-14076,0,0,18087,0,0,,18087,18087
38,09/19/2017,73,18:00,18:15,38.38,30.18,0,30.18,30.18,-1,-62563,39230,101793,-23333,0,-290,5431,0,0,,5721,5141
38,09/19/2017,74,18:15,18:30,38.38,30.18,0,30.18,30.18,-1,-44816,61933,106749,17117,0,-1548,8,0,0,,1556,-1540
38,09/19/2017,75,18:30,18:45,,31.18,0,31.18,31.18,-1,-53636,106428,160064,52792,0,-312,0,0,0,,312,-312
38,09/19/2017,76,18:45,19:00,,,0,39.8,39.8,0,-48167,107714,155881,59547,0,0,0,0,0,,0,0
38,09/19/2017,77,19:00,19:15,,30.18,0,30.18,30.18,-1,-50459,90964,141423,40505,0,-1361,0,0,0,,1361,-1361
38,09/19/2017,78,19:15,19:30,,,0,39.81,39.81,0,-41816,85745,127561,43929,0,0,0,0,0,,0,0
38,09/19/2017,79,19:30,19:45,,,0,39.81,39.81,0,-53828,94058,147886,40230,0,0,0,0,0,,0,0
38,09/19/2017,80,19:45,20:00,33.18,,0,33.18,33.18,1,-70753,73003,143756,2250,0,0,204,0,0,,204,204
38,09/19/2017,81,20:00,20:15,32.96,,0,32.96,32.96,1,-47511,80271,127782,32760,0,0,117,0,0,,117,117
38,09/19/2017,82,20:15,20:30,,28.21,0,28.21,28.21,-1,-50598,82473,133071,31875,0,-969,0,0,0,,969,-969
38,09/19/2017,83,20:30,20:45,,25.96,0,25.96,25.96,-1,-41400,70602,112002,29202,0,-8328,0,0,0,,8328,-8328
38,09/19/2017,84,20:45,21:00,,22.28,0,22.28,22.28,-1,-41294,81528,122822,40234,0,-29977,0,0,0,,29977,-29977
38,09/19/2017,85,21:00,21:15,46,6.47,0,46,46,1,-67790,88940,156730,21150,0,-19294,1581,0,0,,20875,-17713
38,09/19/2017,86,21:15,21:30,46,29.22,0,29.22,29.22,-1,-70876,97273,168149,26397,0,-658,397,0,0,,1055,-261
38,09/19/2017,87,21:30,21:45,,25.96,0,25.96,25.96,-1,-34630,115315,149945,80685,0,-2830,0,0,0,,2830,-2830
38,09/19/2017,88,21:45,22:00,,-5.08,0,-5.08,-5.08,-1,-44458,102098,146556,57640,0,-38232,0,0,0,,38232,-38232
38,09/19/2017,89,22:00,22:15,43.34,-25.38,0,43.34,-25.38,2,-68314,103625,171939,35311,0,-35683,764,0,0,,36447,-34919
38,09/19/2017,90,22:15,22:30,43.34,29.96,0,43.34,29.96,2,-44982,55164,100146,10182,0,-1221,1016,0,0,,2237,-205
38,09/19/2017,91,22:30,22:45,,25.96,0,25.96,25.96,-1,-50259,74148,124407,23889,0,-3553,0,0,0,,3553,-3553
38,09/19/2017,92,22:45,23:00,,15.08,0,15.08,15.08,-1,-57801,79985,137786,22184,0,-13367,0,0,0,,13367,-13367
38,09/19/2017,93,23:00,23:15,42.96,-1.38,0,42.96,42.96,1,-104692,62054,166746,-42638,0,-12561,489,0,0,,13050,-12072
38,09/19/2017,94,23:15,23:30,306.08,-1.38,0,306.08,306.08,1,-100114,32444,132558,-67670,0,-37,25628,0,0,,25665,25591
38,09/19/2017,95,23:30,23:45,306.08,30.96,0,30.96,30.96,-1,-72146,51839,123985,-20307,0,-29,4695,0,0,,4724,4666
38,09/19/2017,96,23:45,0:00,,22.28,0,22.28,22.28,-1,-67377,94037,161414,26660,0,-8139,0,0,0,,8139,-8139
38,09/20/2017,1,0:00,0:15,216.68,30.96,0,216.68,30.96,2,-76802,34130,110932,-42672,0,-4367,14014,0,0,,18381,9647
38,09/20/2017,2,0:15,0:30,42.58,,0,42.58,42.58,1,-55986,48113,104099,-7873,0,0,16919,0,0,,16919,16919
38,09/20/2017,3,0:30,0:45,42.58,25.96,0,25.96,25.96,-1,-40800,69766,110566,28966,0,-3900,592,0,0,,4492,-3308
38,09/20/2017,4,0:45,1:00,,22.12,0,22.12,22.12,-1,-37996,66364,104360,28368,0,-21731,0,0,0,,21731,-21731
38,09/20/2017,5,1:00,1:15,290.57,29.96,0,290.57,29.96,2,-90094,39423,129517,-50671,0,-10991,11145,0,0,,22136,154
38,09/20/2017,6,1:15,1:30,350.15,30.23,0,350.15,30.23,2,-53669,57979,111648,4310,0,-660,27264,0,0,,27924,26604
38,09/20/2017,7,1:30,1:45,,25.96,0,25.96,25.96,-1,-45139,83321,128460,38182,0,-405,0,0,0,,405,-405
38,09/20/2017,8,1:45,2:00,,-4.53,0,-4.53,-4.53,-1,-53509,109192,162701,55683,0,-24854,0,0,0,,24854,-24854
38,09/20/2017,9,2:00,2:15,,29.77,0,29.77,29.77,-1,-24313,128597,152910,104284,0,-7373,0,0,0,,7373,-7373
38,09/20/2017,10,2:15,2:30,,-1.83,0,-1.83,-1.83,-1,-26451,109671,136122,83220,0,-4032,0,0,0,,4032,-4032
38,09/20/2017,11,2:30,2:45,,-7.85,0,-7.85,-7.85,-1,-31465,121650,153115,90185,0,-39130,0,0,0,,39130,-39130
38,09/20/2017,12,2:45,3:00,,-8.07,0,-8.07,-8.07,-1,-35377,115667,151044,80290,0,-45142,0,0,0,,45142,-45142
38,09/20/2017,13,3:00,3:15,,15.45,0,15.45,15.45,-1,-37987,85139,123126,47152,0,-25667,0,0,0,,25667,-25667
38,09/20/2017,14,3:15,3:30,,,0,33.32,33.32,0,-36560,84964,121524,48404,0,0,0,0,0,,0,0
38,09/20/2017,15,3:30,3:45,,6.85,0,6.85,6.85,-1,-30933,96950,127883,66017,0,-12112,0,0,0,,12112,-12112
38,09/20/2017,16,3:45,4:00,,8.7,0,8.7,8.7,-1,-26194,101010,127204,74816,0,-49230,0,0,0,,49230,-49230
38,09/20/2017,17,4:00,4:15,,25.96,0,25.96,25.96,-1,-56506,71348,127854,14842,0,-25391,0,0,0,,25391,-25391
38,09/20/2017,18,4:15,4:30,,,0,33.33,33.33,0,-31214,75296,106510,44082,0,0,0,0,0,,0,0
38,09/20/2017,19,4:30,4:45,,,0,33.33,33.33,0,-31825,68267,100092,36442,0,0,0,0,0,,0,0
38,09/20/2017,20,4:45,5:00,,,0,33.32,33.32,0,-36666,63764,100430,27098,0,0,0,0,0,,0,0
38,09/20/2017,21,5:00,5:15,,14.09,0,14.09,14.09,-1,-68270,85731,154001,17461,0,-3301,0,0,0,,3301,-3301
38,09/20/2017,22,5:15,5:30,,0.52,0,0.52,0.52,-1,-20628,85499,106127,64871,0,-20172,0,0,0,,20172,-20172
38,09/20/2017,23,5:30,5:45,32.81,,0,32.81,32.81,1,-21909,42562,64471,20653,0,0,52,0,0,,52,52
38,09/20/2017,24,5:45,6:00,45.06,,0,45.06,45.06,1,-38763,30463,69226,-8300,0,0,8434,0,0,,8434,8434
38,09/20/2017,25,6:00,6:15,32.46,-11.48,0,-11.48,-11.48,-1,-29075,84060,113135,54985,0,-13759,1823,0,0,,15582,-11936
38,09/20/2017,26,6:15,6:30,,-18.2,0,-18.2,-18.2,-1,-31588,72491,104079,40903,0,-23365,0,0,0,,23365,-23365
38,09/20/2017,27,6:30,6:45,,42.57,0,42.57,42.57,-1,-38443,68264,106707,29821,0,-620,0,0,0,,620,-620
38,09/20/2017,28,6:45,7:00,,-1.54,0,-1.54,-1.54,-1,-68957,151847,220804,82890,0,-9270,0,0,0,,9270,-9270
38,09/20/2017,29,7:00,7:15,,29.65,0,29.65,29.65,-1,-46666,98322,144988,51656,0,-8213,0,0,0,,8213,-8213
38,09/20/2017,30,7:15,7:30,,,0,37.78,37.78,0,-51605,82917,134522,31312,0,0,0,0,0,,0,0
38,09/20/2017,31,7:30,7:45,37.48,,0,37.48,37.48,1,-61197,36862,98059,-24335,0,0,62,0,0,,62,62
38,09/20/2017,32,7:45,8:00,372.07,,0,372.07,372.07,1,-94017,25843,119860,-68174,0,0,32265,0,0,,32265,32265
38,09/20/2017,33,8:00,8:15,372.07,21.47,0,21.47,21.47,-1,-25329,142555,167884,117226,0,-1837,7967,0,0,,9804,6130
38,09/20/2017,34,8:15,8:30,,,0,37.63,37.63,0,-44135,78882,123017,34747,0,0,0,0,0,,0,0
38,09/20/2017,35,8:30,8:45,,,0,37.62,37.62,0,-61693,58288,119981,-3405,0,0,0,0,0,,0,0
38,09/20/2017,36,8:45,9:00,,,0,37.59,37.59,0,-75701,49702,125403,-25999,0,0,0,0,0,,0,0
38,09/20/2017,37,9:00,9:15,,,0,37.64,37.64,0,-64521,45033,109554,-19488,0,0,0,0,0,,0,0
38,09/20/2017,38,9:15,9:30,,,0,37.63,37.63,0,-69056,47578,116634,-21478,0,0,0,0,0,,0,0
38,09/20/2017,39,9:30,9:45,,,0,37.64,37.64,0,-59466,45301,104767,-14165,0,0,0,0,0,,0,0
38,09/20/2017,40,9:45,10:00,,,0,37.63,37.63,0,-62291,44332,106623,-17959,0,0,0,0,0,,0,0
38,09/20/2017,41,10:00,10:15,32.76,,0,32.76,32.76,1,-53490,41054,94544,-12436,0,0,914,0,0,,914,914
38,09/20/2017,42,10:15,10:30,32.2,34.22,0,34.22,34.22,-1,-41086,44920,86006,3834,0,-55,311,0,0,,366,256
38,09/20/2017,43,10:30,10:45,,25.38,0,25.38,25.38,-1,-48526,65667,114193,17141,0,-8771,0,0,0,,8771,-8771
38,09/20/2017,44,10:45,11:00,,25.2,0,25.2,25.2,-1,-44415,77351,121766,32936,0,-17736,0,0,0,,17736,-17736
38,09/20/2017,45,11:00,11:15,32.2,29.2,0,32.2,32.2,1,-56723,61866,118589,5143,0,-11485,215,0,0,,11700,-11270
38,09/20/2017,46,11:15,11:30,,25.2,0,25.2,25.2,-1,-51246,86171,137417,34925,0,-1709,0,0,0,,1709,-1709
38,09/20/2017,47,11:30,11:45,,25.2,0,25.2,25.2,-1,-44976,86165,131141,41189,0,-6243,0,0,0,,6243,-6243
38,09/20/2017,48,11:45,12:00,,19.03,0,19.03,19.03,-1,-42078,80898,122976,38820,0,-8817,0,0,0,,8817,-8817
38,09/20/2017,49,12:00,12:15,,13.95,0,13.95,13.95,-1,-53778,70326,124104,16548,0,-9295,0,0,0,,9295,-9295
38,09/20/2017,50,12:15,12:30,,11.53,0,11.53,11.53,-1,-45429,93808,139237,48379,0,-7319,0,0,0,,7319,-7319
38,09/20/2017,51,12:30,12:45,,8.9,0,8.9,8.9,-1,-43867,81681,125548,37814,0,-20626,0,0,0,,20626,-20626
38,09/20/2017,52,12:45,13:00,,29.8,0,29.8,29.8,-1,-44721,67606,112327,22885,0,-9532,0,0,0,,9532,-9532
38,09/20/2017,53,13:00,13:15,32.8,43.19,0,37.81,37.81,2,-54192,59338,113530,5146,0,-1927,535,0,0,,2462,-1392
38,09/20/2017,54,13:15,13:30,32.41,32.23,0,32.23,32.23,-1,-51085,62495,113580,11410,0,-447,102,0,0,,549,-345
38,09/20/2017,55,13:30,13:45,,29.8,0,29.8,29.8,-1,-52406,68778,121184,16372,0,-2069,0,0,0,,2069,-2069
38,09/20/2017,56,13:45,14:00,,29.8,0,29.8,29.8,-1,-53362,90565,143927,37203,0,-9230,0,0,0,,9230,-9230
38,09/20/2017,57,14:00,14:15,,28.78,0,28.78,28.78,-1,-42600,68855,111455,26255,0,-18434,0,0,0,,18434,-18434
38,09/20/2017,58,14:15,14:30,,15.47,0,15.47,15.47,-1,-28826,75134,103960,46308,0,-20001,0,0,0,,20001,-20001
38,09/20/2017,59,14:30,14:45,,8.69,0,8.69,8.69,-1,-31660,64948,96608,33288,0,-39428,0,0,0,,39428,-39428
38,09/20/2017,60,14:45,15:00,,5.8,0,5.8,5.8,-1,-26814,87311,114125,60497,0,-22316,0,0,0,,22316,-22316
38,09/20/2017,61,15:00,15:15,,16.22,0,16.22,16.22,-1,-30645,92427,123072,61782,0,-34397,0,0,0,,34397,-34397
38,09/20/2017,62,15:15,15:30,,22.78,0,22.78,22.78,-1,-29130,76720,105850,47590,0,-43275,0,0,0,,43275,-43275
38,09/20/2017,63,15:30,15:45,,29.8,0,29.8,29.8,-1,-26556,81423,107979,54867,0,-21035,0,0,0,,21035,-21035
38,09/20/2017,64,15:45,16:00,,-63.73,0,-63.73,-63.73,-1,-28416,123049,151465,94633,0,-11415,0,0,0,,11415,-11415
38,09/20/2017,65,16:00,16:15,,-33.08,0,-33.08,-33.08,-1,-52547,82601,135148,30054,0,-30966,0,0,0,,30966,-30966
38,09/20/2017,66,16:15,16:30,,6.78,0,6.78,6.78,-1,-43244,103377,146621,60133,0,-26882,0,0,0,,26882,-26882
38,09/20/2017,67,16:30,16:45,,27.12,0,27.12,27.12,-1,-57025,119220,176245,62195,0,-28343,0,0,0,,28343,-28343
38,09/20/2017,68,16:45,17:00,,25.8,0,25.8,25.8,-1,-53502,104337,157839,50835,0,-16523,0,0,0,,16523,-16523
38,09/20/2017,69,17:00,17:15,32.8,43.32,0,37.89,37.89,2,-75916,65136,141052,-10780,0,-5467,501,0,0,,5968,-4966
38,09/20/2017,70,17:15,17:30,36.82,,0,36.82,36.82,1,-73641,58279,131920,-15362,0,0,318,0,0,,318,318
38,09/20/2017,71,17:30,17:45,38.94,,0,38.94,38.94,1,-71001,43586,114587,-27415,0,0,1337,0,0,,1337,1337
38,09/20/2017,72,17:45,18:00,38.94,,0,38.94,38.94,1,-60889,48965,109854,-11924,0,0,1684,0,0,,1684,1684
38,09/20/2017,73,18:00,18:15,,,0,37.82,37.82,0,-94992,25132,120124,-69860,0,0,81,0,0,,81,81
38,09/20/2017,74,18:15,18:30,54.93,,0,54.93,54.93,1,-80454,41008,121462,-39446,0,0,3177,0,0,,3177,3177
38,09/20/2017,75,18:30,18:45,54.93,,0,54.93,54.93,1,-72234,58327,130561,-13907,0,0,7130,0,0,,7130,7130
38,09/20/2017,76,18:45,19:00,37.87,,0,37.87,37.87,1,-62055,58037,120092,-4018,0,0,5724,0,0,,5724,5724
38,09/20/2017,77,19:00,19:15,32.5,30.8,0,37.9,30.8,2,-43955,72325,116280,28370,0,-2353,1869,0,0,,4222,-484
38,09/20/2017,78,19:15,19:30,,,0,37.89,37.89,0,-49059,84805,133864,35746,0,-5,0,0,0,,5,-5
38,09/20/2017,79,19:30,19:45,,,0,37.89,37.89,0,-64757,84069,148826,19312,0,0,0,0,0,,0,0
38,09/20/2017,80,19:45,20:00,58.12,,0,58.12,58.12,1,-87119,56484,143603,-30635,0,0,4383,0,0,,4383,4383
38,09/20/2017,81,20:00,20:15,75.12,43.2,0,75.12,37.84,2,-50449,68439,118888,17990,0,-36,8896,0,0,,8932,8860
38,09/20/2017,82,20:15,20:30,,43.2,0,43.2,43.2,-1,-44586,65358,109944,20772,0,-60,0,0,0,,60,-60
38,09/20/2017,83,20:30,20:45,,30.8,0,30.8,30.8,-1,-35889,65788,101677,29899,0,-250,0,0,0,,250,-250
38,09/20/2017,84,20:45,21:00,,22.12,0,22.12,22.12,-1,-31102,86821,117923,55719,0,-17659,0,0,0,,17659,-17659
38,09/20/2017,85,21:00,21:15,38.98,32.23,0,38.98,32.23,2,-50187,74921,125108,24734,0,-8149,1519,0,0,,9668,-6630
38,09/20/2017,86,21:15,21:30,,25.8,0,25.8,25.8,-1,-35033,69491,104524,34458,0,-2755,0,0,0,,2755,-2755
38,09/20/2017,87,21:30,21:45,,25.8,0,25.8,25.8,-1,-24354,69259,93613,44905,0,-21159,0,0,0,,21159,-21159
38,09/20/2017,88,21:45,22:00,,29.8,0,29.8,29.8,-1,-73985,67781,141766,-6204,0,-20123,0,0,0,,20123,-20123
38,09/20/2017,89,22:00,22:15,35.28,-1.54,0,37.71,-1.54,2,-63872,53266,117138,-10606,0,-17692,219,0,0,,17911,-17473
38,09/20/2017,90,22:15,22:30,36.8,29.8,0,37.77,29.8,2,-50694,34416,85110,-16278,0,-1019,779,0,0,,1798,-240
38,09/20/2017,91,22:30,22:45,,28.67,0,28.67,28.67,-1,-31730,80682,112412,48952,0,-1848,0,0,0,,1848,-1848
38,09/20/2017,92,22:45,23:00,,5.8,0,5.8,5.8,-1,-31620,76231,107851,44611,0,-12829,0,0,0,,12829,-12829
38,09/20/2017,93,23:00,23:15,188.46,-24.19,0,188.46,188.46,1,-48255,52106,100361,3851,0,-14654,8383,0,0,,23037,-6271
38,09/20/2017,94,23:15,23:30,185.8,5.52,0,185.8,5.52,2,-38789,41323,80112,2534,0,-1592,35325,0,0,,36917,33733
38,09/20/2017,95,23:30,23:45,36.8,-18.07,0,37.8,-18.07,2,-33976,53868,87844,19892,0,-19074,329,0,0,,19403,-18745
38,09/20/2017,96,23:45,0:00,,-22.1,0,-22.1,-22.1,-1,-41821,88569,130390,46748,0,-26071,0,0,0,,26071,-26071
38,09/21/2017,1,0:00,0:15,78.18,-25,0,78.18,78.18,1,-66732,21907,88639,-44825,0,-27177,4193,0,0,,31370,-22984
38,09/21/2017,2,0:15,0:30,131.02,31.95,0,131.02,31,2,-53921,21203,75124,-32718,0,-16,28956,0,0,,28972,28940
38,09/21/2017,3,0:30,0:45,131.02,29.14,0,29.14,29.14,-1,-36437,52095,88532,15658,0,-605,127,0,0,,732,-478
38,09/21/2017,4,0:45,1:00,,10,0,10,10,-1,-40734,88136,128870,47402,0,-22092,0,0,0,,22092,-22092
38,09/21/2017,5,1:00,1:15,73.96,31.42,0,73.96,73.96,1,-59914,22406,82320,-37508,0,-8786,9188,0,0,,17974,402
38,09/21/2017,6,1:15,1:30,37.02,30.02,0,30.02,30.02,-1,-50690,40245,90935,-10445,0,-42,10884,0,0,,10926,10842
38,09/21/2017,7,1:30,1:45,37.02,29.12,0,29.12,29.12,-1,-50441,58024,108465,7583,0,-403,14,0,0,,417,-389
38,09/21/2017,8,1:45,2:00,,15,0,15,15,-1,-51056,82979,134035,31923,0,-20662,0,0,0,,20662,-20662
38,09/21/2017,9,2:00,2:15,42.81,4.9,0,42.81,42.81,1,-36330,58163,94493,21833,0,-16652,2871,0,0,,19523,-13781
38,09/21/2017,10,2:15,2:30,32.27,,0,32.27,32.27,1,-45782,57538,103320,11756,0,0,2202,0,0,,2202,2202
38,09/21/2017,11,2:30,2:45,,,0,31.49,31.49,0,-37233,49856,87089,12623,0,0,0,0,0,,0,0
38,09/21/2017,12,2:45,3:00,,27.91,0,27.91,27.91,-1,-32444,52403,84847,19959,0,-227,0,0,0,,227,-227
38,09/21/2017,13,3:00,3:15,,27.38,0,27.38,27.38,-1,-28102,47864,75966,19762,0,-483,0,0,0,,483,-483
38,09/21/2017,14,3:15,3:30,,,0,31.49,31.49,0,-32944,48044,80988,15100,0,0,0,0,0,,0,0
38,09/21/2017,15,3:30,3:45,,,0,31.49,31.49,0,-31460,52209,83669,20749,0,0,0,0,0,,0,0
38,09/21/2017,16,3:45,4:00,,,0,31.49,31.49,0,-32795,55294,88089,22499,0,0,0,0,0,,0,0
38,09/21/2017,17,4:00,4:15,,31.56,0,31.56,31.56,-1,-36993,49457,86450,12464,0,-145,0,0,0,,145,-145
38,09/21/2017,18,4:15,4:30,,30.8,0,30.8,30.8,-1,-37688,37591,75279,-97,0,-392,0,0,0,,392,-392
38,09/21/2017,19,4:30,4:45,34.52,,0,34.52,34.52,1,-42391,39891,82282,-2500,0,0,3242,0,0,,3242,3242
38,09/21/2017,20,4:45,5:00,33.38,,0,33.38,33.38,1,-39109,45139,84248,6030,0,0,2654,0,0,,2654,2654
38,09/21/2017,21,5:00,5:15,33.38,26.29,0,26.29,26.29,-1,-40272,45846,86118,5574,0,-1482,50,0,0,,1532,-1432
38,09/21/2017,22,5:15,5:30,,24.41,0,24.41,24.41,-1,-45136,65280,110416,20144,0,-4662,0,0,0,,4662,-4662
38,09/21/2017,23,5:30,5:45,42.8,,0,42.8,42.8,1,-60651,60258,120909,-393,0,0,935,0,0,,935,935
38,09/21/2017,24,5:45,6:00,72.74,,0,72.74,72.74,1,-61095,70095,131190,9000,0,0,14837,0,0,,14837,14837
38,09/21/2017,25,6:00,6:15,36.52,29.51,0,36.52,29.51,2,-99963,42893,142856,-57070,0,-903,2287,0,0,,3190,1384
38,09/21/2017,26,6:15,6:30,,27.22,0,27.22,27.22,-1,-47680,74475,122155,26795,0,-5826,0,0,0,,5826,-5826
38,09/21/2017,27,6:30,6:45,42.25,27.22,0,42.25,42.25,1,-85476,36995,122471,-48481,0,-75,585,0,0,,660,510
38,09/21/2017,28,6:45,7:00,120.02,,0,120.02,120.02,1,-94003,65629,159632,-28374,0,0,19747,0,0,,19747,19747
38,09/21/2017,29,7:00,7:15,120.02,-49.62,0,-49.62,-49.62,-1,-22551,115490,138041,92939,0,-22340,3327,0,0,,25667,-19013
38,09/21/2017,30,7:15,7:30,,25.51,0,25.51,25.51,-1,-31587,97247,128834,65660,0,-14012,0,0,0,,14012,-14012
38,09/21/2017,31,7:30,7:45,,47.93,0,47.93,47.93,-1,-45927,76721,122648,30794,0,-1623,0,0,0,,1623,-1623
38,09/21/2017,32,7:45,8:00,,,0,40.01,40.01,0,-64318,63379,127697,-939,0,-22,0,0,0,,22,-22
38,09/21/2017,33,8:00,8:15,,,0,40.15,40.15,0,-30290,98535,128825,68245,0,0,0,0,0,,0,0
38,09/21/2017,34,8:15,8:30,,31.54,0,31.54,31.54,-1,-32906,95139,128045,62233,0,-706,0,0,0,,706,-706
38,09/21/2017,35,8:30,8:45,,22.03,0,22.03,22.03,-1,-39948,95246,135194,55298,0,-19645,0,0,0,,19645,-19645
38,09/21/2017,36,8:45,9:00,,28.47,0,28.47,28.47,-1,-57774,89845,147619,32071,0,-26458,0,0,0,,26458,-26458
38,09/21/2017,37,9:00,9:15,36.46,28.47,0,36.46,36.46,1,-77357,54443,131800,-22914,0,-6092,1004,0,0,,7096,-5088
38,09/21/2017,38,9:15,9:30,,,0,40.1,40.1,0,-60892,45233,106125,-15659,0,0,0,0,0,,0,0
38,09/21/2017,39,9:30,9:45,,,0,40.1,40.1,0,-48203,53588,101791,5385,0,0,0,0,0,,0,0
38,09/21/2017,40,9:45,10:00,,33.76,0,33.76,33.76,-1,-36654,61550,98204,24896,0,-27,0,0,0,,27,-27
38,09/21/2017,41,10:00,10:15,,32.03,0,32.03,32.03,-1,-31185,54053,85238,22868,0,-261,0,0,0,,261,-261
38,09/21/2017,42,10:15,10:30,,31.95,0,31.95,31.95,-1,-29783,61916,91699,32133,0,-81,0,0,0,,81,-81
38,09/21/2017,43,10:30,10:45,,30.51,0,30.51,30.51,-1,-26042,64537,90579,38495,0,-1557,0,0,0,,1557,-1557
38,09/21/2017,44,10:45,11:00,,18.57,0,18.57,18.57,-1,-25696,85128,110824,59432,0,-3850,0,0,0,,3850,-3850
38,09/21/2017,45,11:00,11:15,,13.47,0,13.47,13.47,-1,-33312,48393,81705,15081,0,-6528,0,0,0,,6528,-6528
38,09/21/2017,46,11:15,11:30,,28.4,0,28.4,28.4,-1,-34940,59678,94618,24738,0,-1129,0,0,0,,1129,-1129
38,09/21/2017,47,11:30,11:45,,25.51,0,25.51,25.51,-1,-35441,71230,106671,35789,0,-16952,0,0,0,,16952,-16952
38,09/21/2017,48,11:45,12:00,,6.35,0,6.35,6.35,-1,-35229,80128,115357,44899,0,-30272,0,0,0,,30272,-30272
38,09/21/2017,49,12:00,12:15,36.51,6.32,0,36.51,36.51,1,-46947,35566,82513,-11381,0,-22112,1129,0,0,,23241,-20983
38,09/21/2017,50,12:15,12:30,36.51,25.51,0,25.51,25.51,-1,-44845,62061,106906,17216,0,-12029,89,0,0,,12118,-11940
38,09/21/2017,51,12:30,12:45,,25.51,0,25.51,25.51,-1,-34298,81107,115405,46809,0,-16409,0,0,0,,16409,-16409
38,09/21/2017,52,12:45,13:00,,-37.19,0,-37.19,-37.19,-1,-31802,84128,115930,52326,0,-30166,0,0,0,,30166,-30166
38,09/21/2017,53,13:00,13:15,,30.51,0,30.51,30.51,-1,-46753,95773,142526,49020,0,-8026,0,0,0,,8026,-8026
38,09/21/2017,54,13:15,13:30,,23.16,0,23.16,23.16,-1,-46959,90184,137143,43225,0,-4410,0,0,0,,4410,-4410
38,09/21/2017,55,13:30,13:45,,22.03,0,22.03,22.03,-1,-46713,76588,123301,29875,0,-11731,0,0,0,,11731,-11731
38,09/21/2017,56,13:45,14:00,,29.24,0,29.24,29.24,-1,-51087,64857,115944,13770,0,-6104,0,0,0,,6104,-6104
38,09/21/2017,57,14:00,14:15,,27.41,0,27.41,27.41,-1,-53764,83725,137489,29961,0,-5918,0,0,0,,5918,-5918
38,09/21/2017,58,14:15,14:30,,31.56,0,31.56,31.56,-1,-48431,81942,130373,33511,0,-212,0,0,0,,212,-212
38,09/21/2017,59,14:30,14:45,,31.56,0,31.56,31.56,-1,-53938,81208,135146,27270,0,-337,0,0,0,,337,-337
38,09/21/2017,60,14:45,15:00,,33.52,0,33.52,33.52,-1,-62393,69653,132046,7260,0,-107,0,0,0,,107,-107
38,09/21/2017,61,15:00,15:15,,,0,33.1,33.1,0,-58369,77387,135756,19018,0,0,0,0,0,,0,0
38,09/21/2017,62,15:15,15:30,,,0,33.1,33.1,0,-61535,67728,129263,6193,0,0,0,0,0,,0,0
38,09/21/2017,63,15:30,15:45,36.51,,0,36.51,36.51,1,-72865,50002,122867,-22863,0,0,1147,0,0,,1147,1147
38,09/21/2017,64,15:45,16:00,39.87,,0,39.87,39.87,1,-75681,46819,122500,-28862,0,0,9265,0,0,,9265,9265
38,09/21/2017,65,16:00,16:15,39.87,33.99,0,33.99,33.99,-1,-61117,84172,145289,23055,0,-24,367,0,0,,391,343
38,09/21/2017,66,16:15,16:30,,,0,33.1,33.1,0,-59128,65257,124385,6129,0,0,0,0,0,,0,0
38,09/21/2017,67,16:30,16:45,39.36,,0,39.36,39.36,1,-65964,54276,120240,-11688,0,0,4287,0,0,,4287,4287
38,09/21/2017,68,16:45,17:00,35.1,,0,35.1,35.1,1,-75136,55637,130773,-19499,0,0,8898,0,0,,8898,8898
38,09/21/2017,69,17:00,17:15,35.1,19.86,0,19.86,19.86,-1,-46460,83619,130079,37159,0,-8748,2872,0,0,,11620,-5876
38,09/21/2017,70,17:15,17:30,,,0,40.94,40.94,0,-59165,68511,127676,9346,0,-1488,0,0,0,,1488,-1488
38,09/21/2017,71,17:30,17:45,42.3,,0,42.3,42.3,1,-67811,58516,126327,-9295,0,0,1738,0,0,,1738,1738
38,09/21/2017,72,17:45,18:00,43.36,,0,43.36,43.36,1,-73772,61153,134925,-12619,0,0,15873,0,0,,15873,15873
38,09/21/2017,73,18:00,18:15,43.73,,0,43.73,43.73,1,-80464,25902,106366,-54562,0,0,9592,0,0,,9592,9592
38,09/21/2017,74,18:15,18:30,45.25,,0,45.25,45.25,1,-63008,34990,97998,-28018,0,0,3683,0,0,,3683,3683
38,09/21/2017,75,18:30,18:45,43.73,,0,43.73,43.73,1,-53205,33940,87145,-19265,0,0,6302,0,0,,6302,6302
38,09/21/2017,76,18:45,19:00,43.73,,0,43.73,43.73,1,-42860,32002,74862,-10858,0,0,10492,0,0,,10492,10492
38,09/21/2017,77,19:00,19:15,32.77,25.51,0,25.51,25.51,-1,-31824,48840,80664,17016,0,-7369,4135,0,0,,11504,-3234
38,09/21/2017,78,19:15,19:30,36.67,29.51,0,36.67,36.67,1,-39764,38423,78187,-1341,0,-9865,449,0,0,,10314,-9416
38,09/21/2017,79,19:30,19:45,58.77,29.51,0,58.77,58.77,1,-74517,34425,108942,-40092,0,-16,4359,0,0,,4375,4343
38,09/21/2017,80,19:45,20:00,408.22,,0,408.22,408.22,1,-119601,34342,153943,-85259,0,0,46767,0,0,,46767,46767
38,09/21/2017,81,20:00,20:15,101.25,27.54,0,27.54,27.54,-1,-81386,73764,155150,-7622,0,-1091,37321,0,0,,38412,36230
38,09/21/2017,82,20:15,20:30,32.51,28.57,0,40.9,28.57,2,-62859,58492,121351,-4367,0,-701,367,0,0,,1068,-334
38,09/21/2017,83,20:30,20:45,32.27,29.51,0,29.51,29.51,-1,-40077,58162,98239,18085,0,-460,19,0,0,,479,-441
38,09/21/2017,84,20:45,21:00,,25.55,0,25.55,25.55,-1,-29434,54389,83823,24955,0,-13711,0,0,0,,13711,-13711
38,09/21/2017,85,21:00,21:15,61.81,24.88,0,61.81,24.88,2,-59730,51143,110873,-8587,0,-10287,5228,0,0,,15515,-5059
38,09/21/2017,86,21:15,21:30,32.15,,0,32.15,32.15,1,-45786,51028,96814,5242,0,0,986,0,0,,986,986
38,09/21/2017,87,21:30,21:45,,49.5,0,49.5,49.5,-1,-20713,66464,87177,45751,0,-48,0,0,0,,48,-48
38,09/21/2017,88,21:45,22:00,,-55.9,0,-55.9,-55.9,-1,-21848,117072,138920,95224,0,-42403,0,0,0,,42403,-42403
38,09/21/2017,89,22:00,22:15,317.9,-13.46,0,317.9,317.9,1,-99176,12429,111605,-86747,0,-32546,8245,0,0,,40791,-24301
38,09/21/2017,90,22:15,22:30,317.9,30.77,0,317.9,30.77,2,-55663,26629,82292,-29034,0,-323,22388,0,0,,22711,22065
38,09/21/2017,91,22:30,22:45,,,0,33.13,33.13,0,-24432,74398,98830,49966,0,-23,1,0,0,,24,-22
38,09/21/2017,92,22:45,23:00,,29.51,0,29.51,29.51,-1,-33461,97347,130808,63886,0,-123,0,0,0,,123,-123
38,09/21/2017,93,23:00,23:15,42.51,24.88,0,42.51,42.51,1,-49018,64463,113481,15445,0,-449,1888,0,0,,2337,1439
38,09/21/2017,94,23:15,23:30,35.69,,0,35.69,35.69,1,-48852,48960,97812,108,0,0,2625,0,0,,2625,2625
38,09/21/2017,95,23:30,23:45,36.23,,0,36.23,36.23,1,-62760,56730,119490,-6030,0,0,621,0,0,,621,621
38,09/21/2017,96,23:45,0:00,36.23,29.51,0,29.51,29.51,-1,-60966,85327,146293,24361,0,-3412,15,0,0,,3427,-3397
38,09/22/2017,1,0:00,0:15,54.7,31.99,0,54.7,31.29,2,-76483,38470,114953,-38013,0,-706,11215,0,0,,11921,10509
38,09/22/2017,2,0:15,0:30,36.13,31.88,0,36.13,31.29,2,-33716,21039,54755,-12677,0,-1,19171,0,0,,19172,19170
38,09/22/2017,3,0:30,0:45,36.13,29.51,0,29.51,29.51,-1,-39467,53793,93260,14326,0,-2887,2346,0,0,,5233,-541
38,09/22/2017,4,0:45,1:00,,29.19,0,29.19,29.19,-1,-34833,55754,90587,20921,0,-5541,0,0,0,,5541,-5541
38,09/22/2017,5,1:00,1:15,70.75,29.51,0,70.75,70.75,1,-45220,24346,69566,-20874,0,-2344,8058,0,0,,10402,5714
38,09/22/2017,6,1:15,1:30,39.52,31.99,0,31.99,31.99,-1,-30215,29554,59769,-661,0,-32,10468,0,0,,10500,10436
38,09/22/2017,7,1:30,1:45,27.74,31.99,0,31.37,31.37,2,-35660,36128,71788,468,0,-76,32,0,0,,108,-44
38,09/22/2017,8,1:45,2:00,,,0,31.39,31.39,0,-41727,35838,77565,-5889,0,0,0,0,0,,0,0
38,09/22/2017,9,2:00,2:15,130.4,,0,130.4,130.4,1,-91223,26743,117966,-64480,0,0,18117,0,0,,18117,18117
38,09/22/2017,10,2:15,2:30,130.4,30.9,0,130.4,30.9,2,-78061,56575,134636,-21486,0,-277,33336,0,0,,33613,33059
38,09/22/2017,11,2:30,2:45,36.19,30.92,0,36.19,30.92,2,-68389,39256,107645,-29133,0,-186,1185,0,0,,1371,999
38,09/22/2017,12,2:45,3:00,36.51,,0,36.51,36.51,1,-79060,48042,127102,-31018,0,0,3794,0,0,,3794,3794
38,09/22/2017,13,3:00,3:15,,,0,31.4,31.4,0,-27098,48698,75796,21600,0,0,126,0,0,,126,126
38,09/22/2017,14,3:15,3:30,,,0,31.4,31.4,0,-30183,54974,85157,24791,0,0,0,0,0,,0,0
38,09/22/2017,15,3:30,3:45,,34.99,0,34.99,34.99,-1,-31248,52129,83377,20881,0,-8,0,0,0,,8,-8
38,09/22/2017,16,3:45,4:00,,,0,31.4,31.4,0,-34033,52654,86687,18621,0,0,0,0,0,,0,0
38,09/22/2017,17,4:00,4:15,,,0,31.41,31.41,0,-122967,59572,182539,-63395,0,0,0,0,0,,0,0
38,09/22/2017,18,4:15,4:30,,,0,31.4,31.4,0,-88794,51350,140144,-37444,0,0,0,0,0,,0,0
38,09/22/2017,19,4:30,4:45,42.51,,0,42.51,42.51,1,-93107,51232,144339,-41875,0,0,5314,0,0,,5314,5314
38,09/22/2017,20,4:45,5:00,45.99,,0,45.99,45.99,1,-94720,61900,156620,-32820,0,0,24292,0,0,,24292,24292
38,09/22/2017,21,5:00,5:15,45.99,16.86,0,16.86,16.86,-1,-41048,53974,95022,12926,0,-6698,8027,0,0,,14725,1329
38,09/22/2017,22,5:15,5:30,36.51,6.49,0,36.51,6.49,2,-45884,65547,111431,19663,0,-16946,349,0,0,,17295,-16597
38,09/22/2017,23,5:30,5:45,36.51,29.77,0,29.77,29.77,-1,-57160,45008,102168,-12152,0,-542,135,0,0,,677,-407
38,09/22/2017,24,5:45,6:00,,,0,31.38,31.38,0,-62114,70280,132394,8166,0,0,0,0,0,,0,0
38,09/22/2017,25,6:00,6:15,,33.21,0,33.21,33.21,-1,-94579,76437,171016,-18142,0,-123,0,0,0,,123,-123
38,09/22/2017,26,6:15,6:30,31.84,34.99,0,31.84,31.84,1,-74370,78238,152608,3868,0,-21,9,0,0,,30,-12
38,09/22/2017,27,6:30,6:45,328.72,,0,328.72,328.72,1,-116082,47730,163812,-68352,0,0,25152,0,0,,25152,25152
38,09/22/2017,28,6:45,7:00,328.72,33.21,0,328.72,33.21,2,-116368,78914,195282,-37454,0,-2,65680,0,0,,65682,65678
38,09/22/2017,29,7:00,7:15,328.72,-5.71,0,-5.71,-5.71,-1,-11966,167208,179174,155242,0,-10230,6595,0,0,,16825,-3635
38,09/22/2017,30,7:15,7:30,,,0,33.49,33.49,0,-22180,102020,124200,79840,0,-34,0,0,0,,34,-34
38,09/22/2017,31,7:30,7:45,,29.05,0,29.05,29.05,-1,-42785,49539,92324,6754,0,-1466,0,0,0,,1466,-1466
38,09/22/2017,32,7:45,8:00,55.5,,0,55.5,55.5,1,-85035,39513,124548,-45522,0,0,4622,0,0,,4622,4622
38,09/22/2017,33,8:00,8:15,55.5,30.29,0,30.29,30.29,-1,-33165,48301,81466,15136,0,-621,1258,0,0,,1879,637
38,09/22/2017,34,8:15,8:30,64.11,,0,64.11,64.11,1,-119772,40371,160143,-79401,0,0,6379,0,0,,6379,6379
38,09/22/2017,35,8:30,8:45,70.4,,0,70.4,70.4,1,-148784,53604,202388,-95180,0,0,17273,0,0,,17273,17273
38,09/22/2017,36,8:45,9:00,127.13,,0,127.13,127.13,1,-171770,51530,223300,-120240,0,0,23143,0,0,,23143,23143
38,09/22/2017,37,9:00,9:15,344.32,,0,344.32,344.32,1,-130056,44085,174141,-85971,0,0,57804,0,0,,57804,57804
38,09/22/2017,38,9:15,9:30,39.66,30.63,0,30.63,30.63,-1,-97880,70191,168071,-27689,0,-464,19521,0,0,,19985,19057
38,09/22/2017,39,9:30,9:45,79.13,,0,79.13,79.13,1,-103957,54369,158326,-49588,0,0,15782,0,0,,15782,15782
38,09/22/2017,40,9:45,10:00,34.95,,0,34.95,34.95,1,-109108,69231,178339,-39877,0,0,18381,0,0,,18381,18381
38,09/22/2017,41,10:00,10:15,32.13,,0,32.13,32.13,1,-53866,50060,103926,-3806,0,0,7164,0,0,,7164,7164
38,09/22/2017,42,10:15,10:30,,,0,32.55,32.55,0,-46064,64990,111054,18926,0,0,130,0,0,,130,130
38,09/22/2017,43,10:30,10:45,,,0,32.55,32.55,0,-44896,69195,114091,24299,0,0,0,0,0,,0,0
38,09/22/2017,44,10:45,11:00,,25.05,0,25.05,25.05,-1,-38980,88729,127709,49749,0,-1646,0,0,0,,1646,-1646
38,09/22/2017,45,11:00,11:15,40.34,31.25,0,40.34,31.25,2,-82726,43099,125825,-39627,0,-1371,4381,0,0,,5752,3010
38,09/22/2017,46,11:15,11:30,34.9,,0,34.9,34.9,1,-66606,46039,112645,-20567,0,0,6649,0,0,,6649,6649
38,09/22/2017,47,11:30,11:45,,,0,32.7,32.7,0,-61457,48204,109661,-13253,0,0,401,0,0,,401,401
38,09/22/2017,48,11:45,12:00,,,0,32.7,32.7,0,-77278,34299,111577,-42979,0,0,0,0,0,,0,0
38,09/22/2017,49,12:00,12:15,375.01,,0,375.01,375.01,1,-127755,29088,156843,-98667,0,0,21868,0,0,,21868,21868
38,09/22/2017,50,12:15,12:30,,,0,32.66,32.66,0,-86363,53742,140105,-32621,0,0,6308,0,0,,6308,6308
38,09/22/2017,51,12:30,12:45,61.52,,0,61.52,61.52,1,-109604,58635,168239,-50969,0,0,3018,0,0,,3018,3018
38,09/22/2017,52,12:45,13:00,63.8,,0,63.8,63.8,1,-155512,46099,201611,-109413,0,0,11509,0,0,,11509,11509
38,09/22/2017,53,13:00,13:15,375.01,,0,412.51,412.51,1,-257399,29317,286716,-228082,0,0,60005,0,11666,,71671,71671
38,09/22/2017,54,13:15,13:30,375.01,,0,412.51,412.51,1,-261375,104635,366010,-156740,0,0,49180,3750,47499,,100429,100429
38,09/22/2017,55,13:30,13:45,31.84,,0,238.07,238.07,1,-256247,133362,389609,-122885,0,0,123,0,47499,,47622,47622
38,09/22/2017,56,13:45,14:00,82.45,,0,82.45,82.45,1,-228454,100411,328865,-128043,0,0,15180,0,4167,,19347,19347
38,09/22/2017,57,14:00,14:15,82.45,30.24,0,30.24,30.24,-1,-72457,127144,199601,54687,0,-689,3667,0,0,,4356,2978
38,09/22/2017,58,14:15,14:30,,,0,31.64,31.64,0,-85944,109452,195396,23508,0,0,0,0,0,,0,0
38,09/22/2017,59,14:30,14:45,,30.05,0,30.05,30.05,-1,-75665,103376,179041,27711,0,-1000,0,0,0,,1000,-1000
38,09/22/2017,60,14:45,15:00,,33.03,0,33.03,33.03,-1,-81768,72920,154688,-8848,0,-20,0,0,0,,20,-20
38,09/22/2017,61,15:00,15:15,,30.05,0,30.05,30.05,-1,-53809,116339,170148,62530,0,-415,0,0,0,,415,-415
38,09/22/2017,62,15:15,15:30,,30.05,0,30.05,30.05,-1,-56018,103599,159617,47581,0,-354,0,0,0,,354,-354
38,09/22/2017,63,15:30,15:45,,,0,31.62,31.62,0,-69457,106083,175540,36626,0,0,0,0,0,,0,0
38,09/22/2017,64,15:45,16:00,,,0,31.62,31.62,0,-79034,102972,182006,23938,0,0,0,0,0,,0,0
38,09/22/2017,65,16:00,16:15,43.31,,0,43.31,43.31,1,-123418,71050,194468,-52368,0,0,2930,0,0,,2930,2930
38,09/22/2017,66,16:15,16:30,,,0,31.6,31.6,0,-115855,91882,207737,-23973,0,0,94,0,0,,94,94
38,09/22/2017,67,16:30,16:45,,,0,31.6,31.6,0,-112579,94409,206988,-18170,0,0,0,0,0,,0,0
38,09/22/2017,68,16:45,17:00,37.67,,0,37.67,37.67,1,-140169,95376,235545,-44793,0,0,1617,0,0,,1617,1617
38,09/22/2017,69,17:00,17:15,,,0,31.62,31.62,0,-68828,62557,131385,-6271,0,0,49,0,0,,49,49
38,09/22/2017,70,17:15,17:30,,,0,31.6,31.6,0,-84249,50467,134716,-33782,0,0,0,0,0,,0,0
38,09/22/2017,71,17:30,17:45,,,0,31.6,31.6,0,-91032,58488,149520,-32544,0,0,0,0,0,,0,0
38,09/22/2017,72,17:45,18:00,55.12,,0,55.12,55.12,1,-93553,40121,133674,-53432,0,0,7807,0,0,,7807,7807
38,09/22/2017,73,18:00,18:15,36.88,,0,36.88,36.88,1,-108215,32573,140788,-75642,0,0,2181,0,0,,2181,2181
38,09/22/2017,74,18:15,18:30,40.92,,0,40.92,40.92,1,-80769,36769,117538,-44000,0,0,4910,0,0,,4910,4910
38,09/22/2017,75,18:30,18:45,41.21,,0,41.21,41.21,1,-53559,39010,92569,-14549,0,0,10221,0,0,,10221,10221
38,09/22/2017,76,18:45,19:00,39.5,,0,39.5,39.5,1,-47586,44110,91696,-3476,0,0,9800,0,0,,9800,9800
38,09/22/2017,77,19:00,19:15,,,0,33.42,33.42,0,-66476,54437,120913,-12039,0,0,471,0,0,,471,471
38,09/22/2017,78,19:15,19:30,,,0,33.42,33.42,0,-46923,52514,99437,5591,0,0,0,0,0,,0,0
38,09/22/2017,79,19:30,19:45,31.84,,0,31.84,31.84,1,-67928,63880,131808,-4048,0,0,3,0,0,,3,3
38,09/22/2017,80,19:45,20:00,339.94,,0,339.94,339.94,1,-111514,57117,168631,-54397,0,0,20304,0,0,,20304,20304
38,09/22/2017,81,20:00,20:15,66.12,29.59,0,66.12,29.59,2,-63510,62015,125525,-1495,0,-756,22862,0,0,,23618,22106
38,09/22/2017,82,20:15,20:30,66.12,30.05,0,30.05,30.05,-1,-35329,60539,95868,25210,0,-156,8,0,0,,164,-148
38,09/22/2017,83,20:30,20:45,,18.01,0,18.01,18.01,-1,-26160,61788,87948,35628,0,-7220,0,0,0,,7220,-7220
38,09/22/2017,84,20:45,21:00,,10.25,0,10.25,10.25,-1,-44764,75035,119799,30271,0,-44229,0,0,0,,44229,-44229
38,09/22/2017,85,21:00,21:15,348.99,10.25,0,348.99,348.99,1,-114555,10616,125171,-103939,0,-7033,17118,0,0,,24151,10085
38,09/22/2017,86,21:15,21:30,35.3,,0,35.3,35.3,1,-47247,30835,78082,-16412,0,0,6725,0,0,,6725,6725
38,09/22/2017,87,21:30,21:45,35.3,29.78,0,29.78,29.78,-1,-36458,46383,82841,9925,0,-2435,22,0,0,,2457,-2413
38,09/22/2017,88,21:45,22:00,,23.12,0,23.12,23.12,-1,-56797,78679,135476,21882,0,-8052,0,0,0,,8052,-8052
38,09/22/2017,89,22:00,22:15,34.15,29.05,0,34.15,29.05,2,-79257,27090,106347,-52167,0,-10674,281,0,0,,10955,-10393
38,09/22/2017,90,22:15,22:30,31.84,,0,31.84,31.84,1,-88439,44931,133370,-43508,0,0,475,0,0,,475,475
38,09/22/2017,91,22:30,22:45,,,0,33.42,33.42,0,-46253,52032,98285,5779,0,0,0,0,0,,0,0
38,09/22/2017,92,22:45,23:00,,29.19,0,29.19,29.19,-1,-43283,85073,128356,41790,0,-1843,0,0,0,,1843,-1843
38,09/22/2017,93,23:00,23:15,48.12,25.05,0,48.12,25.05,2,-129297,62323,191620,-66974,0,-3125,4421,0,0,,7546,1296
38,09/22/2017,94,23:15,23:30,31.89,,0,31.89,31.89,1,-87946,60553,148499,-27393,0,0,2016,0,0,,2016,2016
38,09/22/2017,95,23:30,23:45,35.84,,0,35.84,35.84,1,-64739,67980,132719,3241,0,0,572,0,0,,572,572
38,09/22/2017,96,23:45,0:00,,31.73,0,31.73,31.73,-1,-67238,53125,120363,-14113,0,-402,0,0,0,,402,-402
39,09/23/2017,1,0:00,0:15,134.67,33.11,0,134.67,33.11,2,-83410,46874,130284,-36536,0,-102,13227,0,0,,13329,13125
39,09/23/2017,2,0:15,0:30,134.67,,0,134.67,134.67,1,-63529,20445,83974,-43084,0,0,50378,0,0,,50378,50378
39,09/23/2017,3,0:30,0:45,134.67,32.11,0,32.11,32.11,-1,-50671,53365,104036,2694,0,-222,7323,0,0,,7545,7101
39,09/23/2017,4,0:45,1:00,,32.11,0,32.11,32.11,-1,-38698,82185,120883,43487,0,-294,0,0,0,,294,-294
39,09/23/2017,5,1:00,1:15,45.11,,0,45.11,45.11,1,-44543,55991,100534,11448,0,0,1829,0,0,,1829,1829
39,09/23/2017,6,1:15,1:30,58.65,32.11,0,58.65,32.11,2,-42157,39059,81216,-3098,0,-254,10574,0,0,,10828,10320
39,09/23/2017,7,1:30,1:45,,,0,37.38,37.38,0,-23171,53047,76218,29876,0,-42,5,0,0,,47,-37
39,09/23/2017,8,1:45,2:00,,17.96,0,17.96,17.96,-1,-14894,61403,76297,46509,0,-12918,0,0,0,,12918,-12918
39,09/23/2017,9,2:00,2:15,64.23,30.66,0,64.23,64.23,1,-51806,27543,79349,-24263,0,-6926,7410,0,0,,14336,484
39,09/23/2017,10,2:15,2:30,39.11,32.11,0,39.11,32.11,2,-35950,27135,63085,-8815,0,-25,16588,0,0,,16613,16563
39,09/23/2017,11,2:30,2:45,39.11,31.99,0,31.99,31.99,-1,-18714,30682,49396,11968,0,-856,1334,0,0,,2190,478
39,09/23/2017,12,2:45,3:00,,30.72,0,30.72,30.72,-1,-13494,35066,48560,21572,0,-3208,0,0,0,,3208,-3208
39,09/23/2017,13,3:00,3:15,,,0,37.35,37.35,0,-30674,34549,65223,3875,0,-568,0,0,0,,568,-568
39,09/23/2017,14,3:15,3:30,31.16,,0,31.16,31.16,1,-24724,26770,51494,2046,0,0,108,0,0,,108,108
39,09/23/2017,15,3:30,3:45,,,0,37.36,37.36,0,-17566,24691,42257,7125,0,0,0,0,0,,0,0
39,09/23/2017,16,3:45,4:00,,,0,37.38,37.38,0,-23229,27722,50951,4493,0,0,0,0,0,,0,0
39,09/23/2017,17,4:00,4:15,,,0,37.36,37.36,0,-24007,30804,54811,6797,0,0,0,0,0,,0,0
39,09/23/2017,18,4:15,4:30,,,0,37.36,37.36,0,-35826,33626,69452,-2200,0,0,0,0,0,,0,0
39,09/23/2017,19,4:30,4:45,,,0,37.37,37.37,0,-32744,31606,64350,-1138,0,0,0,0,0,,0,0
39,09/23/2017,20,4:45,5:00,,,0,37.37,37.37,0,-30179,30374,60553,195,0,0,0,0,0,,0,0
39,09/23/2017,21,5:00,5:15,33.58,,0,33.58,33.58,1,-38004,29656,67660,-8348,0,0,739,0,0,,739,739
39,09/23/2017,22,5:15,5:30,31.53,,0,31.53,31.53,1,-34914,45759,80673,10845,0,0,176,0,0,,176,176
39,09/23/2017,23,5:30,5:45,,,0,32.13,32.13,0,-44234,52812,97046,8578,0,0,0,0,0,,0,0
39,09/23/2017,24,5:45,6:00,39.11,,0,39.11,39.11,1,-65550,37791,103341,-27759,0,0,1241,0,0,,1241,1241
39,09/23/2017,25,6:00,6:15,38.62,,0,38.62,38.62,1,-71431,44594,116025,-26837,0,0,652,0,0,,652,652
39,09/23/2017,26,6:15,6:30,32.96,,0,32.96,32.96,1,-58060,57517,115577,-543,0,0,140,0,0,,140,140
39,09/23/2017,27,6:30,6:45,35.95,,0,35.95,35.95,1,-57878,50533,108411,-7345,0,0,3210,0,0,,3210,3210
39,09/23/2017,28,6:45,7:00,31.07,,0,31.07,31.07,1,-67931,94287,162218,26356,0,0,1032,0,0,,1032,1032
39,09/23/2017,29,7:00,7:15,,,0,37.32,37.32,0,-44155,48984,93139,4829,0,0,0,0,0,,0,0
39,09/23/2017,30,7:15,7:30,32.96,,0,32.96,32.96,1,-36970,51886,88856,14916,0,0,305,0,0,,305,305
39,09/23/2017,31,7:30,7:45,,,0,37.21,37.21,0,-49384,34876,84260,-14508,0,0,0,0,0,,0,0
39,09/23/2017,32,7:45,8:00,72.02,,0,72.02,72.02,1,-72139,30622,102761,-41517,0,0,9971,0,0,,9971,9971
39,09/23/2017,33,8:00,8:15,38.62,32.62,0,38.62,32.62,2,-30710,38789,69499,8079,0,-184,6890,0,0,,7074,6706
39,09/23/2017,34,8:15,8:30,38.62,43.42,0,38.62,37.28,2,-43688,20846,64534,-22842,0,-19,1122,0,0,,1141,1103
39,09/23/2017,35,8:30,8:45,187.62,,0,187.62,187.62,1,-73330,19559,92889,-53771,0,0,38071,0,0,,38071,38071
39,09/23/2017,36,8:45,9:00,51.02,,0,51.02,51.02,1,-90128,37636,127764,-52492,0,0,46279,0,0,,46279,46279
39,09/23/2017,37,9:00,9:15,37.4,29.56,0,29.56,29.56,-1,-37125,56153,93278,19028,0,-907,18257,0,0,,19164,17350
39,09/23/2017,38,9:15,9:30,,,0,37.29,37.29,0,-36635,46509,83144,9874,0,-217,0,0,0,,217,-217
39,09/23/2017,39,9:30,9:45,,,0,37.28,37.28,0,-33506,47045,80551,13539,0,0,0,0,0,,0,0
39,09/23/2017,40,9:45,10:00,,,0,37.23,37.23,0,-39449,62038,101487,22589,0,0,0,0,0,,0,0
39,09/23/2017,41,10:00,10:15,,,0,37.31,37.31,0,-43530,51386,94916,7856,0,0,0,0,0,,0,0
39,09/23/2017,42,10:15,10:30,,,0,37.31,37.31,0,-30099,61685,91784,31586,0,0,0,0,0,,0,0
39,09/23/2017,43,10:30,10:45,,26.33,0,26.33,26.33,-1,-21336,77889,99225,56553,0,-7477,0,0,0,,7477,-7477
39,09/23/2017,44,10:45,11:00,,9.2,0,9.2,9.2,-1,-30568,87198,117766,56630,0,-26002,0,0,0,,26002,-26002
39,09/23/2017,45,11:00,11:15,47.02,31.62,0,47.02,31.62,2,-51672,22652,74324,-29020,0,-12685,2667,0,0,,15352,-10018
39,09/23/2017,46,11:15,11:30,,,0,37.33,37.33,0,-39095,43971,83066,4876,0,0,19,0,0,,19,19
39,09/23/2017,47,11:30,11:45,,27.62,0,27.62,27.62,-1,-41565,57528,99093,15963,0,-4608,0,0,0,,4608,-4608
39,09/23/2017,48,11:45,12:00,,25.69,0,25.69,25.69,-1,-37537,55263,92800,17726,0,-23335,0,0,0,,23335,-23335
39,09/23/2017,49,12:00,12:15,,31.62,0,31.62,31.62,-1,-46537,65665,112202,19128,0,-11293,0,0,0,,11293,-11293
39,09/23/2017,50,12:15,12:30,,31.62,0,31.62,31.62,-1,-42484,66670,109154,24186,0,-3007,0,0,0,,3007,-3007
39,09/23/2017,51,12:30,12:45,,30.75,0,30.75,30.75,-1,-38590,81084,119674,42494,0,-1251,0,0,0,,1251,-1251
39,09/23/2017,52,12:45,13:00,,30.77,0,30.77,30.77,-1,-57272,82618,139890,25346,0,-2542,0,0,0,,2542,-2542
39,09/23/2017,53,13:00,13:15,,27.25,0,27.25,27.25,-1,-40203,67686,107889,27483,0,-7244,0,0,0,,7244,-7244
39,09/23/2017,54,13:15,13:30,,27.3,0,27.3,27.3,-1,-48884,75478,124362,26594,0,-5569,0,0,0,,5569,-5569
39,09/23/2017,55,13:30,13:45,,23.03,0,23.03,23.03,-1,-43172,78743,121915,35571,0,-34037,0,0,0,,34037,-34037
39,09/23/2017,56,13:45,14:00,,24.83,0,24.83,24.83,-1,-32777,75783,108560,43006,0,-40883,0,0,0,,40883,-40883
39,09/23/2017,57,14:00,14:15,49.9,27.62,0,49.9,49.9,1,-68026,51246,119272,-16780,0,-20437,2217,0,0,,22654,-18220
39,09/23/2017,58,14:15,14:30,55.37,,0,55.37,55.37,1,-67814,63309,131123,-4505,0,0,13181,0,0,,13181,13181
39,09/23/2017,59,14:30,14:45,,,0,37.3,37.3,0,-64783,77170,141953,12387,0,0,904,0,0,,904,904
39,09/23/2017,60,14:45,15:00,,,0,37.31,37.31,0,-64508,68372,132880,3864,0,0,0,0,0,,0,0
39,09/23/2017,61,15:00,15:15,,,0,32.34,32.34,0,-48715,52657,101372,3942,0,0,0,0,0,,0,0
39,09/23/2017,62,15:15,15:30,,,0,32.34,32.34,0,-42678,69443,112121,26765,0,0,0,0,0,,0,0
39,09/23/2017,63,15:30,15:45,,,0,32.34,32.34,0,-45832,67330,113162,21498,0,0,0,0,0,,0,0
39,09/23/2017,64,15:45,16:00,,,0,32.34,32.34,0,-41790,61362,103152,19572,0,0,0,0,0,,0,0
39,09/23/2017,65,16:00,16:15,,,0,32.32,32.32,0,-75260,79504,154764,4244,0,0,0,0,0,,0,0
39,09/23/2017,66,16:15,16:30,,,0,32.32,32.32,0,-39279,57525,96804,18246,0,0,0,0,0,,0,0
39,09/23/2017,67,16:30,16:45,35.24,,0,35.24,35.24,1,-42698,33463,76161,-9235,0,0,829,0,0,,829,829
39,09/23/2017,68,16:45,17:00,39.91,,0,39.91,39.91,1,-43187,16730,59917,-26457,0,0,8925,0,0,,8925,8925
39,09/23/2017,69,17:00,17:15,39.91,30.89,0,30.89,30.89,-1,-39996,60662,100658,20666,0,-380,3061,0,0,,3441,2681
39,09/23/2017,70,17:15,17:30,,,0,39.53,39.53,0,-40034,39131,79165,-903,0,0,0,0,0,,0,0
39,09/23/2017,71,17:30,17:45,168.78,,0,168.78,168.78,1,-60064,14887,74951,-45177,0,0,9921,0,0,,9921,9921
39,09/23/2017,72,17:45,18:00,168.78,,0,168.78,168.78,1,-74722,16755,91477,-57967,0,0,57499,0,0,,57499,57499
39,09/23/2017,73,18:00,18:15,168.78,25.7,0,25.7,25.7,-1,-23593,52217,75810,28624,0,-2256,16563,0,0,,18819,14307
39,09/23/2017,74,18:15,18:30,,,0,39.42,39.42,0,-32837,29167,62004,-3670,0,-91,0,0,0,,91,-91
39,09/23/2017,75,18:30,18:45,48.44,,0,48.44,48.44,1,-33533,21495,55028,-12038,0,0,2366,0,0,,2366,2366
39,09/23/2017,76,18:45,19:00,94.02,,0,94.02,94.02,1,-43757,15751,59508,-28006,0,0,27970,0,0,,27970,27970
39,09/23/2017,77,19:00,19:15,94.02,19.4,0,19.4,19.4,-1,-23786,65617,89403,41831,0,-3809,7667,0,0,,11476,3858
39,09/23/2017,78,19:15,19:30,,,0,39.52,39.52,0,-27898,61767,89665,33869,0,-25,0,0,0,,25,-25
39,09/23/2017,79,19:30,19:45,,,0,39.47,39.47,0,-36497,53720,90217,17223,0,0,0,0,0,,0,0
39,09/23/2017,80,19:45,20:00,173.33,,0,173.33,173.33,1,-86073,36294,122367,-49779,0,0,4750,0,0,,4750,4750
39,09/23/2017,81,20:00,20:15,220.29,43.37,0,220.29,37.31,2,-40423,77174,117597,36751,0,-100,10137,0,0,,10237,10037
39,09/23/2017,82,20:15,20:30,,31.62,0,31.62,31.62,-1,-33717,89009,122726,55292,0,-67,0,0,0,,67,-67
39,09/23/2017,83,20:30,20:45,,-1.17,0,-1.17,-1.17,-1,-18950,109746,128696,90796,0,-3237,0,0,0,,3237,-3237
39,09/23/2017,84,20:45,21:00,,-4.54,0,-4.54,-4.54,-1,-21320,80955,102275,59635,0,-22395,0,0,0,,22395,-22395
39,09/23/2017,85,21:00,21:15,45.08,31.62,0,45.08,31.62,2,-47304,26408,73712,-20896,0,-10879,3732,0,0,,14611,-7147
39,09/23/2017,86,21:15,21:30,31.19,,0,31.19,31.19,1,-29774,31894,61668,2120,0,0,424,0,0,,424,424
39,09/23/2017,87,21:30,21:45,,43.47,0,43.47,43.47,-1,-18600,55297,73897,36697,0,-195,0,0,0,,195,-195
39,09/23/2017,88,21:45,22:00,,27.62,0,27.62,27.62,-1,-13965,82621,96586,68656,0,-1855,0,0,0,,1855,-1855
39,09/23/2017,89,22:00,22:15,,18.51,0,18.51,18.51,-1,-44599,26493,71092,-18106,0,-2884,0,0,0,,2884,-2884
39,09/23/2017,90,22:15,22:30,,,0,37.37,37.37,0,-36274,19333,55607,-16941,0,0,0,0,0,,0,0
39,09/23/2017,91,22:30,22:45,,32.62,0,32.62,32.62,-1,-28151,53789,81940,25638,0,-429,0,0,0,,429,-429
39,09/23/2017,92,22:45,23:00,,20.82,0,20.82,20.82,-1,-32866,80871,113737,48005,0,-8429,0,0,0,,8429,-8429
39,09/23/2017,93,23:00,23:15,33.91,15.7,0,37.37,15.7,2,-44046,60944,104990,16898,0,-10258,173,0,0,,10431,-10085
39,09/23/2017,94,23:15,23:30,,32.62,0,32.62,32.62,-1,-34354,30040,64394,-4314,0,-14,0,0,0,,14,-14
39,09/23/2017,95,23:30,23:45,,31.62,0,31.62,31.62,-1,-18314,28104,46418,9790,0,-69,0,0,0,,69,-69
39,09/23/2017,96,23:45,0:00,,,0,37.43,37.43,0,-63361,40746,104107,-22615,0,0,0,0,0,,0,0
39,09/24/2017,1,0:00,0:15,34.62,,0,34.62,34.62,1,-27507,65123,92630,37616,0,0,60,0,0,,60,60
39,09/24/2017,2,0:15,0:30,,31.62,0,31.62,31.62,-1,-20065,50301,70366,30236,0,-95,0,0,0,,95,-95
39,09/24/2017,3,0:30,0:45,,27.62,0,27.62,27.62,-1,-43147,64713,107860,21566,0,-12361,0,0,0,,12361,-12361
39,09/24/2017,4,0:45,1:00,,29.13,0,29.13,29.13,-1,-80449,80553,161002,104,0,-11573,0,0,0,,11573,-11573
39,09/24/2017,5,1:00,1:15,,27.62,0,27.62,27.62,-1,-15187,60054,75241,44867,0,-2868,0,0,0,,2868,-2868
39,09/24/2017,6,1:15,1:30,,31.62,0,31.62,31.62,-1,-37464,52995,90459,15531,0,-595,0,0,0,,595,-595
39,09/24/2017,7,1:30,1:45,,29.51,0,29.51,29.51,-1,-23600,75549,99149,51949,0,-4038,0,0,0,,4038,-4038
39,09/24/2017,8,1:45,2:00,,14.08,0,14.08,14.08,-1,-25410,86924,112334,61514,0,-26625,0,0,0,,26625,-26625
39,09/24/2017,9,2:00,2:15,,18.85,0,18.85,18.85,-1,-25011,73323,98334,48312,0,-27768,0,0,0,,27768,-27768
39,09/24/2017,10,2:15,2:30,,31.62,0,31.62,31.62,-1,-25911,57083,82994,31172,0,-147,0,0,0,,147,-147
39,09/24/2017,11,2:30,2:45,,26.21,0,26.21,26.21,-1,-28910,73675,102585,44765,0,-4836,0,0,0,,4836,-4836
39,09/24/2017,12,2:45,3:00,,14.08,0,14.08,14.08,-1,-24301,83294,107595,58993,0,-42017,0,0,0,,42017,-42017
39,09/24/2017,13,3:00,3:15,,14.45,0,14.45,14.45,-1,-19122,53305,72427,34183,0,-24577,0,0,0,,24577,-24577
39,09/24/2017,14,3:15,3:30,44.62,,0,44.62,44.62,1,-25619,44957,70576,19338,0,0,17,0,0,,17,17
39,09/24/2017,15,3:30,3:45,,,0,37.31,37.31,0,-21066,62806,83872,41740,0,0,0,0,0,,0,0
39,09/24/2017,16,3:45,4:00,,,0,37.32,37.32,0,-22078,75489,97567,53411,0,0,0,0,0,,0,0
39,09/24/2017,17,4:00,4:15,,,0,37.29,37.29,0,-26620,45910,72530,19290,0,0,0,0,0,,0,0
39,09/24/2017,18,4:15,4:30,,,0,37.29,37.29,0,-25886,50724,76610,24838,0,0,0,0,0,,0,0
39,09/24/2017,19,4:30,4:45,,,0,37.29,37.29,0,-25367,46387,71754,21020,0,0,0,0,0,,0,0
39,09/24/2017,20,4:45,5:00,42.37,,0,42.37,42.37,1,-86870,54931,141801,-31939,0,0,2511,0,0,,2511,2511
39,09/24/2017,21,5:00,5:15,81.39,,0,81.39,81.39,1,-121395,74676,196071,-46719,0,0,23906,0,0,,23906,23906
39,09/24/2017,22,5:15,5:30,44.62,,0,44.62,44.62,1,-117815,69366,187181,-48449,0,0,15496,0,0,,15496,15496
39,09/24/2017,23,5:30,5:45,47.42,,0,47.42,47.42,1,-115647,71358,187005,-44289,0,0,22300,0,0,,22300,22300
39,09/24/2017,24,5:45,6:00,46.37,,0,46.37,46.37,1,-116252,68531,184783,-47721,0,0,21247,0,0,,21247,21247
39,09/24/2017,25,6:00,6:15,38.57,29.18,0,29.18,29.18,-1,-114762,116316,231078,1554,0,-535,11813,0,0,,12348,11278
39,09/24/2017,26,6:15,6:30,38.48,29.18,0,38.48,38.48,1,-117260,104719,221979,-12541,0,-44,712,0,0,,756,668
39,09/24/2017,27,6:30,6:45,38.57,,0,38.57,38.57,1,-119425,95918,215343,-23507,0,0,8516,0,0,,8516,8516
39,09/24/2017,28,6:45,7:00,46.02,,0,46.02,46.02,1,-122617,87714,210331,-34903,0,0,22852,0,0,,22852,22852
39,09/24/2017,29,7:00,7:15,31.3,30.01,0,37.09,30.01,2,-91907,102322,194229,10415,0,-1024,8910,0,0,,9934,7886
39,09/24/2017,30,7:15,7:30,,43.47,0,43.47,43.47,-1,-64336,99703,164039,35367,0,-47,0,0,0,,47,-47
39,09/24/2017,31,7:30,7:45,,43.42,0,43.42,43.42,-1,-56630,90019,146649,33389,0,-247,0,0,0,,247,-247
39,09/24/2017,32,7:45,8:00,,29.08,0,29.08,29.08,-1,-47233,100933,148166,53700,0,-761,0,0,0,,761,-761
39,09/24/2017,33,8:00,8:15,,29.19,0,29.19,29.19,-1,-39261,59512,98773,20251,0,-997,0,0,0,,997,-997
39,09/24/2017,34,8:15,8:30,,32.57,0,32.57,32.57,-1,-41220,53716,94936,12496,0,-707,0,0,0,,707,-707
39,09/24/2017,35,8:30,8:45,35.77,,0,35.77,35.77,1,-59979,51679,111658,-8300,0,0,895,0,0,,895,895
39,09/24/2017,36,8:45,9:00,42.49,,0,42.49,42.49,1,-63755,63958,127713,203,0,0,9627,0,0,,9627,9627
39,09/24/2017,37,9:00,9:15,44.57,,0,44.57,44.57,1,-63900,21201,85101,-42699,0,0,6864,0,0,,6864,6864
39,09/24/2017,38,9:15,9:30,37.21,,0,37.21,37.21,1,-46634,19729,66363,-26905,0,0,8855,0,0,,8855,8855
39,09/24/2017,39,9:30,9:45,38.57,,0,38.57,38.57,1,-59871,32668,92539,-27203,0,0,12984,0,0,,12984,12984
39,09/24/2017,40,9:45,10:00,32.98,,0,32.98,32.98,1,-55158,50736,105894,-4422,0,0,5603,0,0,,5603,5603
39,09/24/2017,41,10:00,10:15,61.66,,0,61.66,61.66,1,-74759,24379,99138,-50380,0,0,10382,0,0,,10382,10382
39,09/24/2017,42,10:15,10:30,43.65,,0,43.65,43.65,1,-72747,36959,109706,-35788,0,0,25232,0,0,,25232,25232
39,09/24/2017,43,10:30,10:45,38.57,,0,38.57,38.57,1,-75312,44637,119949,-30675,0,0,16182,0,0,,16182,16182
39,09/24/2017,44,10:45,11:00,,,0,37.06,37.06,0,-66756,53124,119880,-13632,0,0,1116,0,0,,1116,1116
39,09/24/2017,45,11:00,11:15,,,0,37.15,37.15,0,-78897,30778,109675,-48119,0,0,0,0,0,,0,0
39,09/24/2017,46,11:15,11:30,,,0,37.09,37.09,0,-80878,37831,118709,-43047,0,0,0,0,0,,0,0
39,09/24/2017,47,11:30,11:45,,,0,37.09,37.09,0,-69119,38292,107411,-30827,0,0,0,0,0,,0,0
39,09/24/2017,48,11:45,12:00,,,0,37.09,37.09,0,-63112,43571,106683,-19541,0,0,0,0,0,,0,0
39,09/24/2017,49,12:00,12:15,,,0,37.08,37.08,0,-43061,48227,91288,5166,0,0,0,0,0,,0,0
39,09/24/2017,50,12:15,12:30,,31.57,0,31.57,31.57,-1,-35515,38752,74267,3237,0,-636,0,0,0,,636,-636
39,09/24/2017,51,12:30,12:45,,31.57,0,31.57,31.57,-1,-39074,52528,91602,13454,0,-664,0,0,0,,664,-664
39,09/24/2017,52,12:45,13:00,,,0,37.08,37.08,0,-25761,61140,86901,35379,0,0,0,0,0,,0,0
39,09/24/2017,53,13:00,13:15,,,0,37.09,37.09,0,-41472,79729,121201,38257,0,0,0,0,0,,0,0
39,09/24/2017,54,13:15,13:30,,,0,37.06,37.06,0,-55656,84131,139787,28475,0,0,0,0,0,,0,0
39,09/24/2017,55,13:30,13:45,,29.22,0,29.22,29.22,-1,-50251,87160,137411,36909,0,-388,0,0,0,,388,-388
39,09/24/2017,56,13:45,14:00,,5.68,0,5.68,5.68,-1,-44415,94255,138670,49840,0,-28329,0,0,0,,28329,-28329
39,09/24/2017,57,14:00,14:15,,22.88,0,22.88,22.88,-1,-47344,100255,147599,52911,0,-21710,0,0,0,,21710,-21710
39,09/24/2017,58,14:15,14:30,,31.57,0,31.57,31.57,-1,-42467,106501,148968,64034,0,-36,0,0,0,,36,-36
39,09/24/2017,59,14:30,14:45,,26.35,0,26.35,26.35,-1,-36055,107817,143872,71762,0,-6556,0,0,0,,6556,-6556
39,09/24/2017,60,14:45,15:00,,31.57,0,31.57,31.57,-1,-44626,105116,149742,60490,0,-948,0,0,0,,948,-948
39,09/24/2017,61,15:00,15:15,,32.57,0,32.57,32.57,-1,-38170,102481,140651,64311,0,-27,0,0,0,,27,-27
39,09/24/2017,62,15:15,15:30,,,0,31.61,31.61,0,-35104,100547,135651,65443,0,0,0,0,0,,0,0
39,09/24/2017,63,15:30,15:45,,,0,31.61,31.61,0,-39281,91425,130706,52144,0,0,0,0,0,,0,0
39,09/24/2017,64,15:45,16:00,,,0,31.61,31.61,0,-44437,78897,123334,34460,0,0,0,0,0,,0,0
39,09/24/2017,65,16:00,16:15,,27.57,0,27.57,27.57,-1,-27321,107970,135291,80649,0,-1414,0,0,0,,1414,-1414
39,09/24/2017,66,16:15,16:30,,29.34,0,29.34,29.34,-1,-30629,99877,130506,69248,0,-2852,0,0,0,,2852,-2852
39,09/24/2017,67,16:30,16:45,,,0,31.6,31.6,0,-39897,65885,105782,25988,0,0,0,0,0,,0,0
39,09/24/2017,68,16:45,17:00,,,0,31.35,31.35,0,-44504,48409,92913,3905,0,0,0,0,0,,0,0
39,09/24/2017,69,17:00,17:15,,,0,39.26,39.26,0,-26935,102050,128985,75115,0,0,0,0,0,,0,0
39,09/24/2017,70,17:15,17:30,,,0,39.29,39.29,0,-25669,98438,124107,72769,0,0,0,0,0,,0,0
39,09/24/2017,71,17:30,17:45,,,0,39.21,39.21,0,-24747,66059,90806,41312,0,0,0,0,0,,0,0
39,09/24/2017,72,17:45,18:00,,,0,39.18,39.18,0,-30887,59286,90173,28399,0,0,0,0,0,,0,0
39,09/24/2017,73,18:00,18:15,,,0,39.19,39.19,0,-38425,50216,88641,11791,0,0,0,0,0,,0,0
39,09/24/2017,74,18:15,18:30,,47.39,0,47.39,47.39,-1,-30912,37589,68501,6677,0,-235,0,0,0,,235,-235
39,09/24/2017,75,18:30,18:45,,,0,39.22,39.22,0,-25106,37710,62816,12604,0,0,0,0,0,,0,0
39,09/24/2017,76,18:45,19:00,,,0,39.22,39.22,0,-15390,31767,47157,16377,0,0,0,0,0,,0,0
39,09/24/2017,77,19:00,19:15,,14.9,0,14.9,14.9,-1,-17403,98654,116057,81251,0,-6201,0,0,0,,6201,-6201
39,09/24/2017,78,19:15,19:30,,,0,39.24,39.24,0,-24310,89920,114230,65610,0,-319,0,0,0,,319,-319
39,09/24/2017,79,19:30,19:45,,,0,39.21,39.21,0,-31543,74610,106153,43067,0,0,0,0,0,,0,0
39,09/24/2017,80,19:45,20:00,34.28,,0,34.28,34.28,1,-64560,63231,127791,-1329,0,0,492,0,0,,492,492
39,09/24/2017,81,20:00,20:15,35.64,,0,35.64,35.64,1,-46873,49600,96473,2727,0,0,3657,0,0,,3657,3657
39,09/24/2017,82,20:15,20:30,39.21,43.38,0,39.21,37,2,-40698,35806,76504,-4892,0,-7,3010,0,0,,3017,3003
39,09/24/2017,83,20:30,20:45,39.21,27.57,0,27.57,27.57,-1,-12578,48579,61157,36001,0,-2538,47,0,0,,2585,-2491
39,09/24/2017,84,20:45,21:00,,13.16,0,13.16,13.16,-1,-11060,65923,76983,54863,0,-20301,0,0,0,,20301,-20301
39,09/24/2017,85,21:00,21:15,30.63,27.57,0,30.63,30.63,1,-21069,27378,48447,6309,0,-15865,137,0,0,,16002,-15728
39,09/24/2017,86,21:15,21:30,30.64,27.57,0,37.05,27.57,2,-22066,38888,60954,16822,0,-1241,5,0,0,,1246,-1236
39,09/24/2017,87,21:30,21:45,,13.16,0,13.16,13.16,-1,-21884,64620,86504,42736,0,-12591,0,0,0,,12591,-12591
39,09/24/2017,88,21:45,22:00,,11.31,0,11.31,11.31,-1,-30708,70687,101395,39979,0,-36975,0,0,0,,36975,-36975
39,09/24/2017,89,22:00,22:15,187.57,11.31,0,187.57,187.57,1,-67491,26976,94467,-40515,0,-11309,14636,0,0,,25945,3327
39,09/24/2017,90,22:15,22:30,40.53,24.49,0,24.49,24.49,-1,-22551,46966,69517,24415,0,-1898,10458,0,0,,12356,8560
39,09/24/2017,91,22:30,22:45,40.53,25.36,0,25.36,25.36,-1,-15416,64565,79981,49149,0,-3911,23,0,0,,3934,-3888
39,09/24/2017,92,22:45,23:00,,27.57,0,27.57,27.57,-1,-24375,111340,135715,86965,0,-2771,0,0,0,,2771,-2771
39,09/24/2017,93,23:00,23:15,,42.88,0,42.88,42.88,-1,-31171,76596,107767,45425,0,-977,0,0,0,,977,-977
39,09/24/2017,94,23:15,23:30,,9.04,0,9.04,9.04,-1,-29125,62360,91485,33235,0,-1131,0,0,0,,1131,-1131
39,09/24/2017,95,23:30,23:45,,13.16,0,13.16,13.16,-1,-27829,77342,105171,49513,0,-7037,0,0,0,,7037,-7037
39,09/24/2017,96,23:45,0:00,,13.16,0,13.16,13.16,-1,-38446,75845,114291,37399,0,-8683,0,0,0,,8683,-8683
39,09/25/2017,1,0:00,0:15,,27.57,0,27.57,27.57,-1,-31196,71175,102371,39979,0,-8502,0,0,0,,8502,-8502
39,09/25/2017,2,0:15,0:30,,29.32,0,29.32,29.32,-1,-34055,42193,76248,8138,0,-2072,0,0,0,,2072,-2072
39,09/25/2017,3,0:30,0:45,,32.57,0,32.57,32.57,-1,-66285,42866,109151,-23419,0,-800,0,0,0,,800,-800
39,09/25/2017,4,0:45,1:00,,29.96,0,29.96,29.96,-1,-60414,53745,114159,-6669,0,-1242,0,0,0,,1242,-1242
39,09/25/2017,5,1:00,1:15,36.22,32.57,0,36.22,36.22,1,-34722,31320,66042,-3402,0,-1105,950,0,0,,2055,-155
39,09/25/2017,6,1:15,1:30,38.57,,0,38.57,38.57,1,-32337,32079,64416,-258,0,0,5133,0,0,,5133,5133
39,09/25/2017,7,1:30,1:45,38.57,,0,38.57,38.57,1,-40388,28465,68853,-11923,0,0,1811,0,0,,1811,1811
39,09/25/2017,8,1:45,2:00,34.57,,0,34.57,34.57,1,-36562,27563,64125,-8999,0,0,2225,0,0,,2225,2225
39,09/25/2017,9,2:00,2:15,35.09,,0,35.09,35.09,1,-31659,29495,61154,-2164,0,0,411,0,0,,411,411
39,09/25/2017,10,2:15,2:30,,32.57,0,32.57,32.57,-1,-29869,30765,60634,896,0,-7,0,0,0,,7,-7
39,09/25/2017,11,2:30,2:45,,31.57,0,31.57,31.57,-1,-25865,30810,56675,4945,0,-1010,0,0,0,,1010,-1010
39,09/25/2017,12,2:45,3:00,,27.39,0,27.39,27.39,-1,-25342,37530,62872,12188,0,-3818,0,0,0,,3818,-3818
39,09/25/2017,13,3:00,3:15,,22.93,0,22.93,22.93,-1,-18476,73074,91550,54598,0,-7845,0,0,0,,7845,-7845
39,09/25/2017,14,3:15,3:30,,,0,30.7,30.7,0,-18633,61854,80487,43221,0,-65,0,0,0,,65,-65
39,09/25/2017,15,3:30,3:45,,,0,30.69,30.69,0,-18140,60879,79019,42739,0,0,0,0,0,,0,0
39,09/25/2017,16,3:45,4:00,,,0,30.69,30.69,0,-16406,79583,95989,63177,0,0,0,0,0,,0,0
39,09/25/2017,17,4:00,4:15,,,0,30.74,30.74,0,-18448,45166,63614,26718,0,0,0,0,0,,0,0
39,09/25/2017,18,4:15,4:30,,,0,30.74,30.74,0,-14474,74674,89148,60200,0,0,0,0,0,,0,0
39,09/25/2017,19,4:30,4:45,,,0,30.74,30.74,0,-17368,62429,79797,45061,0,0,0,0,0,,0,0
39,09/25/2017,20,4:45,5:00,28.9,,0,28.9,28.9,1,-19283,73832,93115,54549,0,0,9,0,0,,9,9
39,09/25/2017,21,5:00,5:15,34.57,,0,34.57,34.57,1,-70132,36094,106226,-34038,0,0,635,0,0,,635,635
39,09/25/2017,22,5:15,5:30,,32.57,0,32.57,32.57,-1,-14435,69856,84291,55421,0,-43,0,0,0,,43,-43
39,09/25/2017,23,5:30,5:45,,27.57,0,27.57,27.57,-1,-20561,62276,82837,41715,0,-964,0,0,0,,964,-964
39,09/25/2017,24,5:45,6:00,,32.57,0,32.57,32.57,-1,-32814,105113,137927,72299,0,-300,0,0,0,,300,-300
39,09/25/2017,25,6:00,6:15,36.05,,0,36.05,36.05,1,-148477,83598,232075,-64879,0,0,280,0,0,,280,280
39,09/25/2017,26,6:15,6:30,,31.57,0,31.57,31.57,-1,-23882,79397,103279,55515,0,-870,0,0,0,,870,-870
39,09/25/2017,27,6:30,6:45,350.02,,0,350.02,350.02,1,-52951,22361,75312,-30590,0,0,7614,0,0,,7614,7614
39,09/25/2017,28,6:45,7:00,355.99,33.11,0,355.99,31.82,2,-53927,55514,109441,1587,0,-37,36545,0,0,,36582,36508
39,09/25/2017,29,7:00,7:15,355.99,27.57,0,27.57,27.57,-1,-73747,127304,201051,53557,0,-1147,1615,0,0,,2762,468
39,09/25/2017,30,7:15,7:30,,,0,40.21,40.21,0,-44680,86036,130716,41356,0,0,0,0,0,,0,0
39,09/25/2017,31,7:30,7:45,58.44,,0,58.44,58.44,1,-55558,51127,106685,-4431,0,0,2270,0,0,,2270,2270
39,09/25/2017,32,7:45,8:00,172.64,,0,172.64,172.64,1,-104574,55688,160262,-48886,0,0,26342,0,0,,26342,26342
39,09/25/2017,33,8:00,8:15,172.64,29.92,0,29.92,29.92,-1,-28991,85961,114952,56970,0,-1354,8012,0,0,,9366,6658
39,09/25/2017,34,8:15,8:30,,,0,40.21,40.21,0,-30812,53723,84535,22911,0,0,0,0,0,,0,0
39,09/25/2017,35,8:30,8:45,,,0,40.17,40.17,0,-46023,37790,83813,-8233,0,0,0,0,0,,0,0
39,09/25/2017,36,8:45,9:00,59.77,,0,59.77,59.77,1,-77932,36441,114373,-41491,0,0,3949,0,0,,3949,3949
39,09/25/2017,37,9:00,9:15,185.02,,0,185.02,185.02,1,-79987,17135,97122,-62852,0,0,25915,0,0,,25915,25915
39,09/25/2017,38,9:15,9:30,93.64,,0,93.64,93.64,1,-68850,22430,91280,-46420,0,0,35130,0,0,,35130,35130
39,09/25/2017,39,9:30,9:45,47.4,49.74,0,49.74,49.74,-1,-64080,46802,110882,-17278,0,-2,29745,0,0,,29747,29743
39,09/25/2017,40,9:45,10:00,47.4,31.57,0,47.4,31.57,2,-66783,44568,111351,-22215,0,-631,4976,0,0,,5607,4345
39,09/25/2017,41,10:00,10:15,132.41,,0,132.41,132.41,1,-92631,27575,120206,-65056,0,0,34574,0,0,,34574,34574
39,09/25/2017,42,10:15,10:30,36.26,,0,36.26,36.26,1,-89861,54167,144028,-35694,0,0,23549,0,0,,23549,23549
39,09/25/2017,43,10:30,10:45,40.95,,0,40.95,40.95,1,-91679,48790,140469,-42889,0,0,15403,0,0,,15403,15403
39,09/25/2017,44,10:45,11:00,46.1,,0,46.1,46.1,1,-98726,56541,155267,-42185,0,0,25986,0,0,,25986,25986
39,09/25/2017,45,11:00,11:15,101.02,,0,101.02,101.02,1,-110578,53927,164505,-56651,0,0,33983,0,0,,33983,33983
39,09/25/2017,46,11:15,11:30,101.02,,0,101.02,101.02,1,-101417,41988,143405,-59429,0,0,46047,0,0,,46047,46047
39,09/25/2017,47,11:30,11:45,59.02,,0,59.02,59.02,1,-91334,43699,135033,-47635,0,0,46353,0,0,,46353,46353
39,09/25/2017,48,11:45,12:00,36.26,,0,36.26,36.26,1,-82100,40719,122819,-41381,0,0,20129,0,0,,20129,20129
39,09/25/2017,49,12:00,12:15,50.93,,0,50.93,50.93,1,-77280,50509,127789,-26771,0,0,14231,0,0,,14231,14231
39,09/25/2017,50,12:15,12:30,33.08,31.57,0,31.57,31.57,-1,-61504,51774,113278,-9730,0,-95,7440,0,0,,7535,7345
39,09/25/2017,51,12:30,12:45,33.08,31.57,0,31.57,31.57,-1,-53643,52145,105788,-1498,0,-656,26,0,0,,682,-630
39,09/25/2017,52,12:45,13:00,31.02,,0,31.02,31.02,1,-56016,39463,95479,-16553,0,0,521,0,0,,521,521
39,09/25/2017,53,13:00,13:15,,,0,31.72,31.72,0,-50506,76682,127188,26176,0,0,115,0,0,,115,115
39,09/25/2017,54,13:15,13:30,,,0,31.72,31.72,0,-54937,59724,114661,4787,0,0,0,0,0,,0,0
39,09/25/2017,55,13:30,13:45,33.08,,0,33.08,33.08,1,-69016,60750,129766,-8266,0,0,81,0,0,,81,81
39,09/25/2017,56,13:45,14:00,33.08,,0,33.08,33.08,1,-67693,72045,139738,4352,0,0,1323,0,0,,1323,1323
39,09/25/2017,57,14:00,14:15,38.18,,0,38.18,38.18,1,-72094,35491,107585,-36603,0,0,2497,0,0,,2497,2497
39,09/25/2017,58,14:15,14:30,42.76,,0,42.76,42.76,1,-80129,39947,120076,-40182,0,0,4594,0,0,,4594,4594
39,09/25/2017,59,14:30,14:45,,,0,32.79,32.79,0,-83243,46315,129558,-36928,0,0,926,0,0,,926,926
39,09/25/2017,60,14:45,15:00,,,0,32.79,32.79,0,-87094,46392,133486,-40702,0,0,0,0,0,,0,0
39,09/25/2017,61,15:00,15:15,,,0,32.79,32.79,0,-83860,49972,133832,-33888,0,0,0,0,0,,0,0
39,09/25/2017,62,15:15,15:30,33.54,,0,33.54,33.54,1,-67732,42680,110412,-25052,0,0,207,0,0,,207,207
39,09/25/2017,63,15:30,15:45,34.7,,0,34.7,34.7,1,-79022,34706,113728,-44316,0,0,396,0,0,,396,396
39,09/25/2017,64,15:45,16:00,38.57,,0,38.57,38.57,1,-70844,24393,95237,-46451,0,0,343,0,0,,343,343
39,09/25/2017,65,16:00,16:15,45.02,,0,45.02,45.02,1,-60754,38062,98816,-22692,0,0,11764,0,0,,11764,11764
39,09/25/2017,66,16:15,16:30,40.65,,0,40.65,40.65,1,-51818,23551,75369,-28267,0,0,20027,0,0,,20027,20027
39,09/25/2017,67,16:30,16:45,42.49,,0,42.49,42.49,1,-50805,15319,66124,-35486,0,0,24949,0,0,,24949,24949
39,09/25/2017,68,16:45,17:00,49.93,,0,49.93,49.93,1,-57651,15128,72779,-42523,0,0,32554,0,0,,32554,32554
39,09/25/2017,69,17:00,17:15,30.89,31.99,0,31.99,31.99,-1,-54555,44194,98749,-10361,0,-250,12198,0,0,,12448,11948
39,09/25/2017,70,17:15,17:30,41.13,,0,41.13,41.13,1,-58229,24958,83187,-33271,0,0,7375,0,0,,7375,7375
39,09/25/2017,71,17:30,17:45,66.25,,0,66.25,66.25,1,-65538,18116,83654,-47422,0,0,26395,0,0,,26395,26395
39,09/25/2017,72,17:45,18:00,70.02,,0,70.02,70.02,1,-54403,16706,71109,-37697,0,0,40461,0,0,,40461,40461
39,09/25/2017,73,18:00,18:15,36.04,,0,36.04,36.04,1,-66366,13402,79768,-52964,0,0,14734,0,0,,14734,14734
39,09/25/2017,74,18:15,18:30,36.26,,0,36.26,36.26,1,-46864,21551,68415,-25313,0,0,374,0,0,,374,374
39,09/25/2017,75,18:30,18:45,41.11,,0,41.11,41.11,1,-36918,26501,63419,-10417,0,0,3346,0,0,,3346,3346
39,09/25/2017,76,18:45,19:00,41.02,,0,41.02,41.02,1,-31212,32533,63745,1321,0,0,5227,0,0,,5227,5227
39,09/25/2017,77,19:00,19:15,30.74,,0,30.74,30.74,1,-19489,62552,82041,43063,0,0,514,0,0,,514,514
39,09/25/2017,78,19:15,19:30,,,0,32.86,32.86,0,-33803,46142,79945,12339,0,0,0,0,0,,0,0
39,09/25/2017,79,19:30,19:45,,,0,32.84,32.84,0,-58344,43027,101371,-15317,0,0,0,0,0,,0,0
39,09/25/2017,80,19:45,20:00,120.02,,0,120.02,120.02,1,-95683,36430,132113,-59253,0,0,4909,0,0,,4909,4909
39,09/25/2017,81,20:00,20:15,187.57,,0,187.57,187.57,1,-74968,37138,112106,-37830,0,0,29889,0,0,,29889,29889
39,09/25/2017,82,20:15,20:30,187.57,27.57,0,27.57,27.57,-1,-53221,68937,122158,15716,0,-3917,8647,0,0,,12564,4730
39,09/25/2017,83,20:30,20:45,,22.58,0,22.58,22.58,-1,-44957,76221,121178,31264,0,-4263,0,0,0,,4263,-4263
39,09/25/2017,84,20:45,21:00,,4,0,4,4,-1,-50674,81115,131789,30441,0,-36539,0,0,0,,36539,-36539
39,09/25/2017,85,21:00,21:15,51,4,0,51,51,1,-58830,62334,121164,3504,0,-4643,2913,0,0,,7556,-1730
39,09/25/2017,86,21:15,21:30,,31.57,0,31.57,31.57,-1,-49730,92903,142633,43173,0,-275,0,0,0,,275,-275
39,09/25/2017,87,21:30,21:45,,28.74,0,28.74,28.74,-1,-52111,111418,163529,59307,0,-1852,0,0,0,,1852,-1852
39,09/25/2017,88,21:45,22:00,,-46.44,0,-46.44,-46.44,-1,-70571,141136,211707,70565,0,-20808,0,0,0,,20808,-20808
39,09/25/2017,89,22:00,22:15,37.04,-57.74,0,37.04,-57.74,2,-70569,131089,201658,60520,0,-30365,611,0,0,,30976,-29754
39,09/25/2017,90,22:15,22:30,37.04,27.57,0,27.57,27.57,-1,-55626,75003,130629,19377,0,-2418,92,0,0,,2510,-2326
39,09/25/2017,91,22:30,22:45,,27.57,0,27.57,27.57,-1,-54286,82803,137089,28517,0,-3874,0,0,0,,3874,-3874
39,09/25/2017,92,22:45,23:00,,30.03,0,30.03,30.03,-1,-45570,66814,112384,21244,0,-5238,0,0,0,,5238,-5238
39,09/25/2017,93,23:00,23:15,187.57,27.57,0,187.57,27.57,2,-84810,36460,121270,-48350,0,-6865,10409,0,0,,17274,3544
39,09/25/2017,94,23:15,23:30,205.24,27.57,0,205.24,205.24,1,-72099,41867,113966,-30232,0,-50,42783,0,0,,42833,42733
39,09/25/2017,95,23:30,23:45,205.24,28.6,0,28.6,28.6,-1,-45715,67793,113508,22078,0,-2791,7242,0,0,,10033,4451
39,09/25/2017,96,23:45,0:00,,29.5,0,29.5,29.5,-1,-67534,80811,148345,13277,0,-7722,0,0,0,,7722,-7722
39,09/26/2017,1,0:00,0:15,38.58,29.5,0,38.58,38.58,1,-93872,54839,148711,-39033,0,-1356,3995,0,0,,5351,2639
39,09/26/2017,2,0:15,0:30,38.57,,0,38.57,38.57,1,-53892,26096,79988,-27796,0,0,11350,0,0,,11350,11350
39,09/26/2017,3,0:30,0:45,38.57,,0,38.57,38.57,1,-75693,22663,98356,-53030,0,0,3076,0,0,,3076,3076
39,09/26/2017,4,0:45,1:00,31.55,,0,31.55,31.55,1,-75611,36586,112197,-39025,0,0,2724,0,0,,2724,2724
39,09/26/2017,5,1:00,1:15,120.12,,0,120.12,120.12,1,-62934,13002,75936,-49932,0,0,16805,0,0,,16805,16805
39,09/26/2017,6,1:15,1:30,38.57,,0,38.57,38.57,1,-43028,17804,60832,-25224,0,0,11603,0,0,,11603,11603
39,09/26/2017,7,1:30,1:45,38.57,,0,38.57,38.57,1,-48040,25928,73968,-22112,0,0,3189,0,0,,3189,3189
39,09/26/2017,8,1:45,2:00,,,0,30.19,30.19,0,-50086,43577,93663,-6509,0,0,475,0,0,,475,475
39,09/26/2017,9,2:00,2:15,35.16,,0,35.16,35.16,1,-38872,24282,63154,-14590,0,0,791,0,0,,791,791
39,09/26/2017,10,2:15,2:30,38.57,,0,38.57,38.57,1,-42876,27901,70777,-14975,0,0,6414,0,0,,6414,6414
39,09/26/2017,11,2:30,2:45,34.57,,0,34.57,34.57,1,-40400,23749,64149,-16651,0,0,1713,0,0,,1713,1713
39,09/26/2017,12,2:45,3:00,,,0,30.14,30.14,0,-64729,29281,94010,-35448,0,0,43,0,0,,43,43
39,09/26/2017,13,3:00,3:15,35.15,,0,35.15,35.15,1,-39532,30898,70430,-8634,0,0,639,0,0,,639,639
39,09/26/2017,14,3:15,3:30,31.57,32.67,0,31.57,30.18,2,-36790,32846,69636,-3944,0,-1,1051,0,0,,1052,1050
39,09/26/2017,15,3:30,3:45,,32.57,0,32.57,32.57,-1,-36915,34193,71108,-2722,0,-992,0,0,0,,992,-992
39,09/26/2017,16,3:45,4:00,,,0,30.19,30.19,0,-37968,28108,66076,-9860,0,0,0,0,0,,0,0
39,09/26/2017,17,4:00,4:15,,32.57,0,32.57,32.57,-1,-36270,38338,74608,2068,0,-553,0,0,0,,553,-553
39,09/26/2017,18,4:15,4:30,,31.57,0,31.57,31.57,-1,-30932,42439,73371,11507,0,-2173,0,0,0,,2173,-2173
39,09/26/2017,19,4:30,4:45,,31.57,0,31.57,31.57,-1,-29443,41926,71369,12483,0,-1454,0,0,0,,1454,-1454
39,09/26/2017,20,4:45,5:00,35.22,,0,35.22,35.22,1,-29494,34452,63946,4958,0,0,563,0,0,,563,563
39,09/26/2017,21,5:00,5:15,,,0,30.28,30.28,0,-64939,40132,105071,-24807,0,0,0,0,0,,0,0
39,09/26/2017,22,5:15,5:30,,,0,30.28,30.28,0,-56520,26402,82922,-30118,0,0,0,0,0,,0,0
39,09/26/2017,23,5:30,5:45,44.57,,0,44.57,44.57,1,-53040,14532,67572,-38508,0,0,9529,0,0,,9529,9529
39,09/26/2017,24,5:45,6:00,37.66,,0,37.66,37.66,1,-46221,54746,100967,8525,0,0,13296,0,0,,13296,13296
39,09/26/2017,25,6:00,6:15,37.66,28.88,0,28.88,28.88,-1,-93999,66689,160688,-27310,0,-940,578,0,0,,1518,-362
39,09/26/2017,26,6:15,6:30,,27.57,0,27.57,27.57,-1,-58075,77621,135696,19546,0,-8179,0,0,0,,8179,-8179
39,09/26/2017,27,6:30,6:45,,,0,30.45,30.45,0,-69148,44691,113839,-24457,0,-171,0,0,0,,171,-171
39,09/26/2017,28,6:45,7:00,48.52,,0,48.52,48.52,1,-90835,44360,135195,-46475,0,0,6355,0,0,,6355,6355
39,09/26/2017,29,7:00,7:15,33.09,11.41,0,33.09,11.41,2,-55673,95671,151344,39998,0,-14421,942,0,0,,15363,-13479
39,09/26/2017,30,7:15,7:30,47.59,11.41,0,47.59,47.59,1,-74713,40219,114932,-34494,0,-300,7344,0,0,,7644,7044
39,09/26/2017,31,7:30,7:45,81.81,,0,81.81,81.81,1,-95538,28805,124343,-66733,0,0,28654,0,0,,28654,28654
39,09/26/2017,32,7:45,8:00,277.71,,0,277.71,277.71,1,-152155,35863,188018,-116292,0,0,70487,0,0,,70487,70487
39,09/26/2017,33,8:00,8:15,87.12,26.18,0,26.18,26.18,-1,-37871,76937,114808,39066,0,-1797,37747,0,0,,39544,35950
39,09/26/2017,34,8:15,8:30,35.2,26.18,0,35.2,35.2,1,-53499,50427,103926,-3072,0,-421,167,0,0,,588,-254
39,09/26/2017,35,8:30,8:45,50.2,,0,50.2,50.2,1,-84719,32128,116847,-52591,0,0,2587,0,0,,2587,2587
39,09/26/2017,36,8:45,9:00,97.68,,0,97.68,97.68,1,-117694,32865,150559,-84829,0,0,22622,0,0,,22622,22622
39,09/26/2017,37,9:00,9:15,345.6,,0,345.6,345.6,1,-99951,34073,134024,-65878,0,0,54086,0,0,,54086,54086
39,09/26/2017,38,9:15,9:30,64.06,,0,64.06,64.06,1,-91475,42924,134399,-48551,0,0,34816,0,0,,34816,34816
39,09/26/2017,39,9:30,9:45,305.84,,0,305.84,305.84,1,-99091,49618,148709,-49473,0,0,48343,0,0,,48343,48343
39,09/26/2017,40,9:45,10:00,53.06,33.48,0,53.06,33.48,2,-80046,59093,139139,-20953,0,-196,16767,0,0,,16963,16571
39,09/26/2017,41,10:00,10:15,310.7,,0,310.7,310.7,1,-90031,6215,96246,-83816,0,0,46311,0,0,,46311,46311
39,09/26/2017,42,10:15,10:30,79.05,,0,79.05,79.05,1,-75007,21036,96043,-53971,0,0,43560,0,0,,43560,43560
39,09/26/2017,43,10:30,10:45,54.18,,0,54.18,54.18,1,-82713,35397,118110,-47316,0,0,32495,0,0,,32495,32495
39,09/26/2017,44,10:45,11:00,65.18,,0,65.18,65.18,1,-78000,31349,109349,-46651,0,0,18534,0,0,,18534,18534
39,09/26/2017,45,11:00,11:15,225.03,,0,225.03,225.03,1,-99618,20487,120105,-79131,0,0,55122,0,0,,55122,55122
39,09/26/2017,46,11:15,11:30,59.79,,0,59.79,59.79,1,-85034,28789,113823,-56245,0,0,40338,0,0,,40338,40338
39,09/26/2017,47,11:30,11:45,59.79,,0,59.79,59.79,1,-85809,33012,118821,-52797,0,0,35316,0,0,,35316,35316
39,09/26/2017,48,11:45,12:00,59.79,,0,59.79,59.79,1,-79048,34896,113944,-44152,0,0,35537,0,0,,35537,35537
39,09/26/2017,49,12:00,12:15,209.65,,0,209.65,209.65,1,-107532,33255,140787,-74277,0,0,33097,0,0,,33097,33097
39,09/26/2017,50,12:15,12:30,50.05,,0,50.05,50.05,1,-82160,50251,132411,-31909,0,0,25350,0,0,,25350,25350
39,09/26/2017,51,12:30,12:45,45.6,,0,45.6,45.6,1,-80687,53552,134239,-27135,0,0,3071,0,0,,3071,3071
39,09/26/2017,52,12:45,13:00,34.57,,0,34.57,34.57,1,-81436,47200,128636,-34236,0,0,2346,0,0,,2346,2346
39,09/26/2017,53,13:00,13:15,65.05,,0,65.05,65.05,1,-80651,41325,121976,-39326,0,0,13212,0,0,,13212,13212
39,09/26/2017,54,13:15,13:30,42.99,,0,42.99,42.99,1,-86200,44013,130213,-42187,0,0,24136,0,0,,24136,24136
39,09/26/2017,55,13:30,13:45,46.82,,0,46.82,46.82,1,-83169,40163,123332,-43006,0,0,22423,0,0,,22423,22423
39,09/26/2017,56,13:45,14:00,40.8,,0,40.8,40.8,1,-77610,42422,120032,-35188,0,0,20598,0,0,,20598,20598
39,09/26/2017,57,14:00,14:15,60.29,,0,60.29,60.29,1,-66487,32836,99323,-33651,0,0,16786,0,0,,16786,16786
39,09/26/2017,58,14:15,14:30,53.79,,0,53.79,53.79,1,-79169,34110,113279,-45059,0,0,37107,0,0,,37107,37107
39,09/26/2017,59,14:30,14:45,43.05,,0,43.05,43.05,1,-74686,44570,119256,-30116,0,0,30885,0,0,,30885,30885
39,09/26/2017,60,14:45,15:00,41.48,,0,41.48,41.48,1,-72163,46301,118464,-25862,0,0,21165,0,0,,21165,21165
39,09/26/2017,61,15:00,15:15,,,0,32.26,32.26,0,-62396,58113,120509,-4283,0,0,2225,0,0,,2225,2225
39,09/26/2017,62,15:15,15:30,45.6,,0,45.6,45.6,1,-61676,48889,110565,-12787,0,0,3305,0,0,,3305,3305
39,09/26/2017,63,15:30,15:45,39.05,,0,39.05,39.05,1,-61967,45209,107176,-16758,0,0,7002,0,0,,7002,7002
39,09/26/2017,64,15:45,16:00,42.77,,0,42.77,42.77,1,-73451,48507,121958,-24944,0,0,8724,0,0,,8724,8724
39,09/26/2017,65,16:00,16:15,31.84,27.57,0,32.26,27.57,2,-37857,67693,105550,29836,0,-3289,2031,0,0,,5320,-1258
39,09/26/2017,66,16:15,16:30,,30.91,0,30.91,30.91,-1,-39986,53358,93344,13372,0,-2126,0,0,0,,2126,-2126
39,09/26/2017,67,16:30,16:45,,,0,32.26,32.26,0,-53339,47908,101247,-5431,0,0,0,0,0,,0,0
39,09/26/2017,68,16:45,17:00,43.31,,0,43.31,43.31,1,-67561,41106,108667,-26455,0,0,4720,0,0,,4720,4720
39,09/26/2017,69,17:00,17:15,43.31,30.89,0,30.89,30.89,-1,-44950,46693,91643,1743,0,-865,1673,0,0,,2538,808
39,09/26/2017,70,17:15,17:30,,,0,32.28,32.28,0,-65790,29366,95156,-36424,0,0,0,0,0,,0,0
39,09/26/2017,71,17:30,17:45,37.38,,0,37.38,37.38,1,-77589,29407,106996,-48182,0,0,377,0,0,,377,377
39,09/26/2017,72,17:45,18:00,60.05,,0,60.05,60.05,1,-76381,40288,116669,-36093,0,0,16323,0,0,,16323,16323
39,09/26/2017,73,18:00,18:15,242.89,,0,242.89,242.89,1,-206035,11152,217187,-194883,0,0,53463,0,0,,53463,53463
39,09/26/2017,74,18:15,18:30,150.82,,0,150.82,150.82,1,-134850,58562,193412,-76288,0,0,32101,1250,0,,33351,33351
39,09/26/2017,75,18:30,18:45,150.82,,0,150.82,150.82,1,-119575,79488,199063,-40087,0,0,12,1250,0,,1262,1262
39,09/26/2017,76,18:45,19:00,47.89,,0,47.89,47.89,1,-111102,80420,191522,-30682,0,0,4785,0,0,,4785,4785
39,09/26/2017,77,19:00,19:15,35.29,28.32,0,35.29,28.32,2,-88903,105823,194726,16920,0,-1577,2704,0,0,,4281,1127
39,09/26/2017,78,19:15,19:30,,,0,32.28,32.28,0,-77408,74935,152343,-2473,0,0,0,0,0,,0,0
39,09/26/2017,79,19:30,19:45,35.32,,0,35.32,35.32,1,-124648,65291,189939,-59357,0,0,434,0,0,,434,434
39,09/26/2017,80,19:45,20:00,258.96,,0,258.96,258.96,1,-158562,41453,200015,-117109,0,0,35499,0,0,,35499,35499
39,09/26/2017,81,20:00,20:15,40.19,28.73,0,40.19,28.73,2,-51611,75631,127242,24020,0,-954,20397,0,0,,21351,19443
39,09/26/2017,82,20:15,20:30,,31.57,0,31.57,31.57,-1,-38797,82586,121383,43789,0,-66,0,0,0,,66,-66
39,09/26/2017,83,20:30,20:45,,12.17,0,12.17,12.17,-1,-29761,83472,113233,53711,0,-2305,0,0,0,,2305,-2305
39,09/26/2017,84,20:45,21:00,,8.17,0,8.17,8.17,-1,-31547,98624,130171,67077,0,-22897,0,0,0,,22897,-22897
39,09/26/2017,85,21:00,21:15,75.61,-2.76,0,75.61,-2.76,2,-64838,30207,95045,-34631,0,-16289,5382,0,0,,21671,-10907
39,09/26/2017,86,21:15,21:30,34.57,,0,34.57,34.57,1,-64691,30136,94827,-34555,0,0,2979,0,0,,2979,2979
39,09/26/2017,87,21:30,21:45,,30.89,0,30.89,30.89,-1,-34062,46289,80351,12227,0,-551,0,0,0,,551,-551
39,09/26/2017,88,21:45,22:00,,4.58,0,4.58,4.58,-1,-40372,85697,126069,45325,0,-29015,0,0,0,,29015,-29015
39,09/26/2017,89,22:00,22:15,73.1,-26.76,0,73.1,73.1,1,-81985,20995,102980,-60990,0,-33050,2082,0,0,,35132,-30968
39,09/26/2017,90,22:15,22:30,248.13,25.19,0,248.13,25.19,2,-78554,40195,118749,-38359,0,-906,6809,0,0,,7715,5903
39,09/26/2017,91,22:30,22:45,,16.76,0,16.76,16.76,-1,-17938,76385,94323,58447,0,-3884,0,0,0,,3884,-3884
39,09/26/2017,92,22:45,23:00,,30.8,0,30.8,30.8,-1,-48596,80348,128944,31752,0,-206,0,0,0,,206,-206
39,09/26/2017,93,23:00,23:15,172.1,-57.16,0,172.1,-57.16,2,-92986,69286,162272,-23700,0,-4094,8050,0,0,,12144,3956
39,09/26/2017,94,23:15,23:30,172.1,29.72,0,172.1,29.72,2,-66364,39758,106122,-26606,0,-45,39274,0,0,,39319,39229
39,09/26/2017,95,23:30,23:45,172.1,15.58,0,15.58,15.58,-1,-34336,49673,84009,15337,0,-8731,366,0,0,,9097,-8365
39,09/26/2017,96,23:45,0:00,36.04,30.8,0,36.04,30.16,2,-55486,60246,115732,4760,0,-1818,86,0,0,,1904,-1732
39,09/27/2017,1,0:00,0:15,53.5,30.8,0,53.5,53.5,1,-45712,28918,74630,-16794,0,-38,14286,0,0,,14324,14248
39,09/27/2017,2,0:15,0:30,,,0,40.25,40.25,0,-40114,37463,77577,-2651,0,0,1065,0,0,,1065,1065
39,09/27/2017,3,0:30,0:45,,28.74,0,28.74,28.74,-1,-44932,61308,106240,16376,0,-2179,0,0,0,,2179,-2179
39,09/27/2017,4,0:45,1:00,,28.74,0,28.74,28.74,-1,-51508,72679,124187,21171,0,-14615,0,0,0,,14615,-14615
39,09/27/2017,5,1:00,1:15,38.12,31.99,0,38.12,38.12,1,-33595,19041,52636,-14554,0,-5493,2639,0,0,,8132,-2854
39,09/27/2017,6,1:15,1:30,31.55,,0,31.55,31.55,1,-44172,21833,66005,-22339,0,0,1617,0,0,,1617,1617
39,09/27/2017,7,1:30,1:45,31.66,,0,31.66,31.66,1,-54619,30954,85573,-23665,0,0,162,0,0,,162,162
39,09/27/2017,8,1:45,2:00,31.68,32.95,0,32.95,32.95,-1,-53083,45928,99011,-7155,0,-2,158,0,0,,160,156
39,09/27/2017,9,2:00,2:15,38.12,32.86,0,38.12,30.17,2,-42374,30616,72990,-11758,0,-82,1229,0,0,,1311,1147
39,09/27/2017,10,2:15,2:30,44.12,,0,44.12,44.12,1,-50143,26627,76770,-23516,0,0,15806,0,0,,15806,15806
39,09/27/2017,11,2:30,2:45,,,0,30.2,30.2,0,-29083,27119,56202,-1964,0,0,3093,0,0,,3093,3093
39,09/27/2017,12,2:45,3:00,,32.87,0,32.87,32.87,-1,-25170,35731,60901,10561,0,-11,0,0,0,,11,-11
39,09/27/2017,13,3:00,3:15,,32.9,0,32.9,32.9,-1,-48960,40103,89063,-8857,0,-80,0,0,0,,80,-80
39,09/27/2017,14,3:15,3:30,,30.03,0,30.03,30.03,-1,-27984,33395,61379,5411,0,-811,0,0,0,,811,-811
39,09/27/2017,15,3:30,3:45,,,0,30.23,30.23,0,-43436,23848,67284,-19588,0,-24,0,0,0,,24,-24
39,09/27/2017,16,3:45,4:00,,,0,30.21,30.21,0,-51788,20970,72758,-30818,0,0,0,0,0,,0,0
39,09/27/2017,17,4:00,4:15,,,0,30.25,30.25,0,-33075,31093,64168,-1982,0,0,0,0,0,,0,0
39,09/27/2017,18,4:15,4:30,,,0,30.24,30.24,0,-28321,30004,58325,1683,0,0,0,0,0,,0,0
39,09/27/2017,19,4:30,4:45,,,0,30.24,30.24,0,-32518,33183,65701,665,0,0,0,0,0,,0,0
39,09/27/2017,20,4:45,5:00,34.03,,0,34.03,34.03,1,-34099,36320,70419,2221,0,0,210,0,0,,210,210
39,09/27/2017,21,5:00,5:15,,,0,30.29,30.29,0,-80233,45782,126015,-34451,0,0,0,0,0,,0,0
39,09/27/2017,22,5:15,5:30,,,0,30.29,30.29,0,-62595,35867,98462,-26728,0,0,0,0,0,,0,0
39,09/27/2017,23,5:30,5:45,,,0,30.25,30.25,0,-63337,32843,96180,-30494,0,0,0,0,0,,0,0
39,09/27/2017,24,5:45,6:00,31.35,,0,31.35,31.35,1,-59563,52485,112048,-7078,0,0,27,0,0,,27,27
39,09/27/2017,25,6:00,6:15,31.74,28.46,0,31.74,28.46,2,-49924,50179,100103,255,0,-1593,125,0,0,,1718,-1468
39,09/27/2017,26,6:15,6:30,,21.09,0,21.09,21.09,-1,-39752,77171,116923,37419,0,-24395,0,0,0,,24395,-24395
39,09/27/2017,27,6:30,6:45,,,0,30.36,30.36,0,-56331,52938,109269,-3393,0,-2808,0,0,0,,2808,-2808
39,09/27/2017,28,6:45,7:00,81.02,,0,81.02,81.02,1,-84352,36091,120443,-48261,0,0,12589,0,0,,12589,12589
39,09/27/2017,29,7:00,7:15,81.02,7.09,0,7.09,7.09,-1,-29040,76903,105943,47863,0,-11024,4635,0,0,,15659,-6389
39,09/27/2017,30,7:15,7:30,31.43,7.09,0,31.43,31.43,1,-64090,64182,128272,92,0,-330,57,0,0,,387,-273
39,09/27/2017,31,7:30,7:45,,,0,40.17,40.17,0,-65904,54556,120460,-11348,0,0,0,0,0,,0,0
39,09/27/2017,32,7:45,8:00,227.1,,0,227.1,227.1,1,-108344,49849,158193,-58495,0,0,11039,0,0,,11039,11039
39,09/27/2017,33,8:00,8:15,425.17,30.07,0,30.07,30.07,-1,-39205,98308,137513,59103,0,-674,19173,0,0,,19847,18499
39,09/27/2017,34,8:15,8:30,,,0,40.19,40.19,0,-43090,95368,138458,52278,0,-36,0,0,0,,36,-36
39,09/27/2017,35,8:30,8:45,54.19,,0,54.19,54.19,1,-65454,65080,130534,-374,0,0,2177,0,0,,2177,2177
39,09/27/2017,36,8:45,9:00,65.19,,0,65.19,65.19,1,-79054,54543,133597,-24511,0,0,21414,0,0,,21414,21414
39,09/27/2017,37,9:00,9:15,73.17,,0,73.17,73.17,1,-69109,34894,104003,-34215,0,0,22546,0,0,,22546,22546
39,09/27/2017,38,9:15,9:30,72.5,,0,72.5,72.5,1,-80544,36234,116778,-44310,0,0,36235,0,0,,36235,36235
39,09/27/2017,39,9:30,9:45,55,33.51,0,55,33.51,2,-61817,42842,104659,-18975,0,-113,26214,0,0,,26327,26101
39,09/27/2017,40,9:45,10:00,401.27,30.22,0,401.27,30.22,2,-68488,32931,101419,-35557,0,-636,7891,0,0,,8527,7255
39,09/27/2017,41,10:00,10:15,258.92,,0,258.92,258.92,1,-78782,42596,121378,-36186,0,0,48948,0,0,,48948,48948
39,09/27/2017,42,10:15,10:30,44.01,28.93,0,44.01,28.93,2,-51426,45960,97386,-5466,0,-1169,7848,0,0,,9017,6679
39,09/27/2017,43,10:30,10:45,50,30.07,0,50,30.07,2,-58003,50288,108291,-7715,0,-467,6444,0,0,,6911,5977
39,09/27/2017,44,10:45,11:00,,,0,40.19,40.19,0,-60902,49380,110282,-11522,0,-32,10,0,0,,42,-22
39,09/27/2017,45,11:00,11:15,130.57,,0,130.57,130.57,1,-83123,43529,126652,-39594,0,0,17819,0,0,,17819,17819
39,09/27/2017,46,11:15,11:30,49,30.71,0,30.71,30.71,-1,-70879,69637,140516,-1242,0,-100,23123,0,0,,23223,23023
39,09/27/2017,47,11:30,11:45,49,24.93,0,24.93,24.93,-1,-67982,75545,143527,7563,0,-8315,508,0,0,,8823,-7807
39,09/27/2017,48,11:45,12:00,42.8,33.46,0,42.8,33.46,2,-59839,55174,115013,-4665,0,-506,6319,0,0,,6825,5813
39,09/27/2017,49,12:00,12:15,42.8,28.93,0,28.93,28.93,-1,-73768,86604,160372,12836,0,-3141,381,0,0,,3522,-2760
39,09/27/2017,50,12:15,12:30,,28.93,0,28.93,28.93,-1,-58724,80490,139214,21766,0,-7673,0,0,0,,7673,-7673
39,09/27/2017,51,12:30,12:45,,24.43,0,24.43,24.43,-1,-43753,77486,121239,33733,0,-15685,0,0,0,,15685,-15685
39,09/27/2017,52,12:45,13:00,,28.93,0,28.93,28.93,-1,-38977,57610,96587,18633,0,-6327,0,0,0,,6327,-6327
39,09/27/2017,53,13:00,13:15,,24.93,0,24.93,24.93,-1,-28606,42108,70714,13502,0,-3269,0,0,0,,3269,-3269
39,09/27/2017,54,13:15,13:30,,29.93,0,29.93,29.93,-1,-33524,38572,72096,5048,0,-734,0,0,0,,734,-734
39,09/27/2017,55,13:30,13:45,,29.93,0,29.93,29.93,-1,-27441,50963,78404,23522,0,-2290,0,0,0,,2290,-2290
39,09/27/2017,56,13:45,14:00,,29.93,0,29.93,29.93,-1,-39002,41251,80253,2249,0,-2310,0,0,0,,2310,-2310
39,09/27/2017,57,14:00,14:15,43.98,29.93,0,43.98,43.98,1,-38213,27745,65958,-10468,0,-22,5545,0,0,,5567,5523
39,09/27/2017,58,14:15,14:30,31.77,,0,31.77,31.77,1,-43684,50377,94061,6693,0,0,1611,0,0,,1611,1611
39,09/27/2017,59,14:30,14:45,35.55,,0,35.55,35.55,1,-40594,44015,84609,3421,0,0,311,0,0,,311,311
39,09/27/2017,60,14:45,15:00,44.32,,0,44.32,44.32,1,-44336,39068,83404,-5268,0,0,1617,0,0,,1617,1617
39,09/27/2017,61,15:00,15:15,148.58,33.2,0,148.58,32.28,2,-46938,28818,75756,-18120,0,-6,25329,0,0,,25335,25323
39,09/27/2017,62,15:15,15:30,49.39,30.06,0,49.39,30.06,2,-36921,33496,70417,-3425,0,-548,3458,0,0,,4006,2910
39,09/27/2017,63,15:30,15:45,55.89,,0,55.89,55.89,1,-44852,29571,74423,-15281,0,0,16864,0,0,,16864,16864
39,09/27/2017,64,15:45,16:00,49.39,,0,49.39,49.39,1,-45369,25227,70596,-20142,0,0,21080,0,0,,21080,21080
39,09/27/2017,65,16:00,16:15,37.54,29.38,0,29.38,29.38,-1,-47265,61589,108854,14324,0,-1532,11077,0,0,,12609,9545
39,09/27/2017,66,16:15,16:30,49.7,29.38,0,49.7,49.7,1,-54537,27550,82087,-26987,0,-49,12849,0,0,,12898,12800
39,09/27/2017,67,16:30,16:45,88.02,,0,88.02,88.02,1,-71709,26160,97869,-45549,0,0,42146,0,0,,42146,42146
39,09/27/2017,68,16:45,17:00,68.02,,0,68.02,68.02,1,-73870,30208,104078,-43662,0,0,51821,0,0,,51821,51821
39,09/27/2017,69,17:00,17:15,68.02,26.68,0,26.68,26.68,-1,-46874,83217,130091,36343,0,-1928,12971,0,0,,14899,11043
39,09/27/2017,70,17:15,17:30,60.22,,0,60.22,60.22,1,-68044,57854,125898,-10190,0,0,3078,0,0,,3078,3078
39,09/27/2017,71,17:30,17:45,66.72,,0,66.72,66.72,1,-66614,53009,119623,-13605,0,0,17814,0,0,,17814,17814
39,09/27/2017,72,17:45,18:00,49.22,,0,49.22,49.22,1,-79881,57265,137146,-22616,0,0,17772,0,0,,17772,17772
39,09/27/2017,73,18:00,18:15,55.99,,0,55.99,55.99,1,-85315,43128,128443,-42187,0,0,19956,0,0,,19956,19956
39,09/27/2017,74,18:15,18:30,55.99,,0,55.99,55.99,1,-64831,47520,112351,-17311,0,0,18415,0,0,,18415,18415
39,09/27/2017,75,18:30,18:45,39.78,,0,39.78,39.78,1,-67682,49678,117360,-18004,0,0,17975,0,0,,17975,17975
39,09/27/2017,76,18:45,19:00,40.96,,0,40.96,40.96,1,-64192,57415,121607,-6777,0,0,14383,0,0,,14383,14383
39,09/27/2017,77,19:00,19:15,31.8,,0,31.8,31.8,1,-60296,73188,133484,12892,0,0,1758,0,0,,1758,1758
39,09/27/2017,78,19:15,19:30,39.74,,0,39.74,39.74,1,-59196,63008,122204,3812,0,0,1262,0,0,,1262,1262
39,09/27/2017,79,19:30,19:45,61.78,,0,61.78,61.78,1,-95760,68757,164517,-27003,0,0,9255,0,0,,9255,9255
39,09/27/2017,80,19:45,20:00,228.66,,0,228.66,228.66,1,-107478,70104,177582,-37374,0,0,43898,0,0,,43898,43898
39,09/27/2017,81,20:00,20:15,228.66,28.93,0,28.93,28.93,-1,-66163,87241,153404,21078,0,-1082,8590,0,0,,9672,7508
39,09/27/2017,82,20:15,20:30,,,0,41,41,0,-61381,69238,130619,7857,0,0,0,0,0,,0,0
39,09/27/2017,83,20:30,20:45,,50.66,0,50.66,50.66,-1,-32058,81416,113474,49358,0,-13,0,0,0,,13,-13
39,09/27/2017,84,20:45,21:00,,13.89,0,13.89,13.89,-1,-25467,104547,130014,79080,0,-5973,0,0,0,,5973,-5973
39,09/27/2017,85,21:00,21:15,390.52,-2.01,0,390.52,-2.01,2,-71150,19742,90892,-51408,0,-6952,17683,0,0,,24635,10731
39,09/27/2017,86,21:15,21:30,45,28.93,0,28.93,28.93,-1,-24128,39242,63370,15114,0,-1070,13258,0,0,,14328,12188
39,09/27/2017,87,21:30,21:45,,21.09,0,21.09,21.09,-1,-17943,68675,86618,50732,0,-21494,0,0,0,,21494,-21494
39,09/27/2017,88,21:45,22:00,39.28,29.73,0,39.28,29.73,2,-75661,81267,156928,5606,0,-19856,169,0,0,,20025,-19687
39,09/27/2017,89,22:00,22:15,39.9,29.73,0,39.9,39.9,1,-55497,50691,106188,-4806,0,-1429,6032,0,0,,7461,4603
39,09/27/2017,90,22:15,22:30,42.67,30.07,0,42.67,30.07,2,-39593,38533,78126,-1060,0,-58,8940,0,0,,8998,8882
39,09/27/2017,91,22:30,22:45,42.67,28.93,0,28.93,28.93,-1,-20227,53681,73908,33454,0,-10489,245,0,0,,10734,-10244
39,09/27/2017,92,22:45,23:00,,21.09,0,21.09,21.09,-1,-30948,78705,109653,47757,0,-28827,0,0,0,,28827,-28827
39,09/27/2017,93,23:00,23:15,139.83,19.77,0,139.83,139.83,1,-57574,37709,95283,-19865,0,-21902,5329,0,0,,27231,-16573
39,09/27/2017,94,23:15,23:30,178.55,,0,178.55,178.55,1,-54252,26898,81150,-27354,0,0,34861,0,0,,34861,34861
39,09/27/2017,95,23:30,23:45,178.55,29.07,0,29.07,29.07,-1,-40338,53286,93624,12948,0,-1751,6334,0,0,,8085,4583
39,09/27/2017,96,23:45,0:00,,24.93,0,24.93,24.93,-1,-47384,63594,110978,16210,0,-9841,0,0,0,,9841,-9841
39,09/28/2017,1,0:00,0:15,170.48,30.34,0,170.48,30.34,2,-97975,14557,112532,-83418,0,-5844,13876,0,0,,19720,8032
39,09/28/2017,2,0:15,0:30,43.12,,0,43.12,43.12,1,-80632,21869,102501,-58763,0,0,14646,0,0,,14646,14646
39,09/28/2017,3,0:30,0:45,51.71,,0,51.71,51.71,1,-88036,24072,112108,-63964,0,0,22752,0,0,,22752,22752
39,09/28/2017,4,0:45,1:00,50.25,,0,50.25,50.25,1,-110004,62403,172407,-47601,0,0,4944,0,0,,4944,4944
39,09/28/2017,5,1:00,1:15,153.87,,0,153.87,153.87,1,-156347,47642,203989,-108705,0,0,52995,0,0,,52995,52995
39,09/28/2017,6,1:15,1:30,153.87,,0,153.87,153.87,1,-146265,75016,221281,-71249,0,0,81222,0,0,,81222,81222
39,09/28/2017,7,1:30,1:45,32.66,,0,32.66,32.66,1,-124689,100461,225150,-24228,0,0,13088,0,0,,13088,13088
39,09/28/2017,8,1:45,2:00,42.3,,0,42.3,42.3,1,-149089,97002,246091,-52087,0,0,6345,0,0,,6345,6345
39,09/28/2017,9,2:00,2:15,,,0,33,33,0,-71101,73410,144511,2309,0,0,298,0,0,,298,298
39,09/28/2017,10,2:15,2:30,35.32,,0,35.32,35.32,1,-68265,43851,112116,-24414,0,0,646,0,0,,646,646
39,09/28/2017,11,2:30,2:45,36.93,,0,36.93,36.93,1,-65644,30486,96130,-35158,0,0,8256,0,0,,8256,8256
39,09/28/2017,12,2:45,3:00,36.93,33.89,0,33.89,33.89,-1,-72167,28044,100211,-44123,0,-5,1225,0,0,,1230,1220
39,09/28/2017,13,3:00,3:15,,30.93,0,30.93,30.93,-1,-31393,84829,116222,53436,0,-135,0,0,0,,135,-135
39,09/28/2017,14,3:15,3:30,,,0,30.3,30.3,0,-35749,40242,75991,4493,0,0,0,0,0,,0,0
39,09/28/2017,15,3:30,3:45,,,0,30.3,30.3,0,-39346,37158,76504,-2188,0,0,0,0,0,,0,0
39,09/28/2017,16,3:45,4:00,32.72,,0,32.72,32.72,1,-49985,37188,87173,-12797,0,0,512,0,0,,512,512
39,09/28/2017,17,4:00,4:15,32.93,,0,32.93,32.93,1,-67477,33816,101293,-33661,0,0,2270,0,0,,2270,2270
39,09/28/2017,18,4:15,4:30,,,0,30.3,30.3,0,-60214,32510,92724,-27704,0,0,1172,0,0,,1172,1172
39,09/28/2017,19,4:30,4:45,32.93,,0,32.93,32.93,1,-61626,30433,92059,-31193,0,0,532,0,0,,532,532
39,09/28/2017,20,4:45,5:00,32.93,,0,32.93,32.93,1,-65232,32263,97495,-32969,0,0,288,0,0,,288,288
39,09/28/2017,21,5:00,5:15,,,0,30.35,30.35,0,-82618,34794,117412,-47824,0,0,0,0,0,,0,0
39,09/28/2017,22,5:15,5:30,,,0,29.96,29.96,0,-61064,27802,88866,-33262,0,0,0,0,0,,0,0
39,09/28/2017,23,5:30,5:45,,,0,29.91,29.91,0,-69994,26592,96586,-43402,0,0,0,0,0,,0,0
39,09/28/2017,24,5:45,6:00,,31.94,0,31.94,31.94,-1,-58665,60309,118974,1644,0,-99,0,0,0,,99,-99
39,09/28/2017,25,6:00,6:15,,,0,33.15,33.15,0,-114658,51179,165837,-63479,0,0,0,0,0,,0,0
39,09/28/2017,26,6:15,6:30,,,0,33.11,33.11,0,-56906,51377,108283,-5529,0,0,0,0,0,,0,0
39,09/28/2017,27,6:30,6:45,33.7,,0,33.7,33.7,1,-103045,54650,157695,-48395,0,0,591,0,0,,591,591
39,09/28/2017,28,6:45,7:00,178.89,,0,178.89,178.89,1,-122180,50063,172243,-72117,0,0,41849,0,0,,41849,41849
39,09/28/2017,29,7:00,7:15,33.12,22,0,33.16,22,2,-35568,74368,109936,38800,0,-1267,10467,0,0,,11734,9200
39,09/28/2017,30,7:15,7:30,48.6,,0,48.6,48.6,1,-103917,57040,160957,-46877,0,0,23939,0,0,,23939,23939
39,09/28/2017,31,7:30,7:45,170.22,,0,170.22,170.22,1,-139055,62116,201171,-76939,0,0,50438,0,0,,50438,50438
39,09/28/2017,32,7:45,8:00,185.56,,0,185.56,185.56,1,-143161,59424,202585,-83737,0,0,73927,0,0,,73927,73927
39,09/28/2017,33,8:00,8:15,33.83,29.56,0,41.44,29.56,2,-58631,75321,133952,16690,0,-1052,19312,0,0,,20364,18260
39,09/28/2017,34,8:15,8:30,44.29,,0,44.29,44.29,1,-76119,54163,130282,-21956,0,0,6633,0,0,,6633,6633
39,09/28/2017,35,8:30,8:45,65.61,,0,65.61,65.61,1,-100577,57327,157904,-43250,0,0,25763,0,0,,25763,25763
39,09/28/2017,36,8:45,9:00,104.05,,0,104.05,104.05,1,-132210,67128,199338,-65082,0,0,49849,0,0,,49849,49849
39,09/28/2017,37,9:00,9:15,60.12,29.94,0,29.94,29.94,-1,-77271,68569,145840,-8702,0,-1029,25938,0,0,,26967,24909
39,09/28/2017,38,9:15,9:30,45.49,29.94,0,45.49,45.49,1,-100148,51944,152092,-48204,0,-88,9471,0,0,,9559,9383
39,09/28/2017,39,9:30,9:45,193.22,,0,193.22,193.22,1,-101086,45328,146414,-55758,0,0,29991,0,0,,29991,29991
39,09/28/2017,40,9:45,10:00,278.79,,0,278.79,278.79,1,-89450,54059,143509,-35391,0,0,44971,0,0,,44971,44971
39,09/28/2017,41,10:00,10:15,36.03,29.56,0,41.45,29.56,2,-52918,52187,105105,-731,0,-1225,4907,0,0,,6132,3682
39,09/28/2017,42,10:15,10:30,62.03,,0,62.03,62.03,1,-77659,43911,121570,-33748,0,0,7752,0,0,,7752,7752
39,09/28/2017,43,10:30,10:45,38.89,,0,38.89,38.89,1,-74154,44779,118933,-29375,0,0,15683,0,0,,15683,15683
39,09/28/2017,44,10:45,11:00,62.03,,0,62.03,62.03,1,-79772,43134,122906,-36638,0,0,8286,0,0,,8286,8286
39,09/28/2017,45,11:00,11:15,99.46,,0,99.46,99.46,1,-79314,39033,118347,-40281,0,0,35255,0,0,,35255,35255
39,09/28/2017,46,11:15,11:30,38.22,,0,38.22,38.22,1,-77793,51768,129561,-26025,0,0,18182,0,0,,18182,18182
39,09/28/2017,47,11:30,11:45,36.59,,0,36.59,36.59,1,-84570,59747,144317,-24823,0,0,2193,0,0,,2193,2193
39,09/28/2017,48,11:45,12:00,42.33,,0,42.33,42.33,1,-99832,56029,155861,-43803,0,0,3777,0,0,,3777,3777
39,09/28/2017,49,12:00,12:15,205.6,,0,205.6,205.6,1,-97373,20145,117518,-77228,0,0,31695,0,0,,31695,31695
39,09/28/2017,50,12:15,12:30,,,0,41.54,41.54,0,-78061,37141,115202,-40920,0,0,9444,0,0,,9444,9444
39,09/28/2017,51,12:30,12:45,37.86,,0,37.86,37.86,1,-65184,48214,113398,-16970,0,0,1040,0,0,,1040,1040
39,09/28/2017,52,12:45,13:00,,,0,41.57,41.57,0,-62663,50421,113084,-12242,0,0,375,0,0,,375,375
39,09/28/2017,53,13:00,13:15,36.65,,0,36.65,36.65,1,-71282,47114,118396,-24168,0,0,527,0,0,,527,527
39,09/28/2017,54,13:15,13:30,32.92,,0,32.92,32.92,1,-76293,52087,128380,-24206,0,0,575,0,0,,575,575
39,09/28/2017,55,13:30,13:45,,,0,41.59,41.59,0,-57910,54313,112223,-3597,0,0,0,0,0,,0,0
39,09/28/2017,56,13:45,14:00,,,0,41.59,41.59,0,-72846,56844,129690,-16002,0,0,0,0,0,,0,0
39,09/28/2017,57,14:00,14:15,,,0,41.62,41.62,0,-64218,87743,151961,23525,0,0,0,0,0,,0,0
39,09/28/2017,58,14:15,14:30,,33.29,0,33.29,33.29,-1,-64902,90727,155629,25825,0,-28,0,0,0,,28,-28
39,09/28/2017,59,14:30,14:45,,30.56,0,30.56,30.56,-1,-50472,90465,140937,39993,0,-1320,0,0,0,,1320,-1320
39,09/28/2017,60,14:45,15:00,,29.2,0,29.2,29.2,-1,-57558,80813,138371,23255,0,-6890,0,0,0,,6890,-6890
39,09/28/2017,61,15:00,15:15,32.56,32.78,0,32.56,31.18,2,-69588,67445,137033,-2143,0,-1187,194,0,0,,1381,-993
39,09/28/2017,62,15:15,15:30,36.88,,0,36.88,36.88,1,-82891,62877,145768,-20014,0,0,2375,0,0,,2375,2375
39,09/28/2017,63,15:30,15:45,81.12,,0,81.12,81.12,1,-97124,48308,145432,-48816,0,0,7935,0,0,,7935,7935
39,09/28/2017,64,15:45,16:00,185.56,,0,185.56,185.56,1,-92860,53618,146478,-39242,0,0,31225,0,0,,31225,31225
39,09/28/2017,65,16:00,16:15,43.24,,0,43.24,43.24,1,-77039,43108,120147,-33931,0,0,3871,0,0,,3871,3871
39,09/28/2017,66,16:15,16:30,46.79,,0,46.79,46.79,1,-100338,31757,132095,-68581,0,0,6772,0,0,,6772,6772
39,09/28/2017,67,16:30,16:45,210.09,,0,210.09,210.09,1,-118359,19867,138226,-98492,0,0,17584,0,0,,17584,17584
39,09/28/2017,68,16:45,17:00,210.09,,0,210.09,210.09,1,-105454,29338,134792,-76116,0,0,39756,0,0,,39756,39756
39,09/28/2017,69,17:00,17:15,88.23,,0,88.23,88.23,1,-77376,32774,110150,-44602,0,0,30071,0,0,,30071,30071
39,09/28/2017,70,17:15,17:30,234.56,,0,234.56,234.56,1,-79695,14613,94308,-65082,0,0,23364,0,0,,23364,23364
39,09/28/2017,71,17:30,17:45,234.56,,0,234.56,234.56,1,-59982,18297,78279,-41685,0,0,39992,0,0,,39992,39992
39,09/28/2017,72,17:45,18:00,51.6,,0,51.6,51.6,1,-61523,41006,102529,-20517,0,0,21988,0,0,,21988,21988
39,09/28/2017,73,18:00,18:15,58.5,26.79,0,58.5,26.79,2,-76169,73325,149494,-2844,0,-2976,14416,0,0,,17392,11440
39,09/28/2017,74,18:15,18:30,58.5,26.79,0,26.79,26.79,-1,-63881,68142,132023,4261,0,-4926,157,0,0,,5083,-4769
39,09/28/2017,75,18:30,18:45,,33.23,0,33.23,33.23,-1,-59202,71872,131074,12670,0,-308,0,0,0,,308,-308
39,09/28/2017,76,18:45,19:00,,,0,33.15,33.15,0,-66066,74116,140182,8050,0,-84,0,0,0,,84,-84
39,09/28/2017,77,19:00,19:15,,33.92,0,33.92,33.92,-1,-60013,70920,130933,10907,0,-329,0,0,0,,329,-329
39,09/28/2017,78,19:15,19:30,,,0,33.09,33.09,0,-68951,63558,132509,-5393,0,-52,0,0,0,,52,-52
39,09/28/2017,79,19:30,19:45,63.28,,0,63.28,63.28,1,-112618,66215,178833,-46403,0,0,10264,0,0,,10264,10264
39,09/28/2017,80,19:45,20:00,185.56,,0,185.56,185.56,1,-100088,63605,163693,-36483,0,0,39413,0,0,,39413,39413
39,09/28/2017,81,20:00,20:15,62.66,,0,62.66,62.66,1,-76903,29953,106856,-46950,0,0,26833,0,0,,26833,26833
39,09/28/2017,82,20:15,20:30,44.52,30.97,0,30.97,30.97,-1,-55713,43899,99612,-11814,0,-271,21136,0,0,,21407,20865
39,09/28/2017,83,20:30,20:45,37.34,30.56,0,37.34,30.56,2,-40615,37796,78411,-2819,0,-645,1190,0,0,,1835,545
39,09/28/2017,84,20:45,21:00,,26.79,0,26.79,26.79,-1,-40825,60102,100927,19277,0,-7857,0,0,0,,7857,-7857
39,09/28/2017,85,21:00,21:15,70.59,31.34,0,70.59,31.16,2,-85662,51158,136820,-34504,0,-2775,10726,0,0,,13501,7951
39,09/28/2017,86,21:15,21:30,44.29,29.56,0,44.29,29.56,2,-63231,49704,112935,-13527,0,-657,16187,0,0,,16844,15530
39,09/28/2017,87,21:30,21:45,44.29,29.56,0,29.56,29.56,-1,-42015,54093,96108,12078,0,-868,248,0,0,,1116,-620
39,09/28/2017,88,21:45,22:00,,27.28,0,27.28,27.28,-1,-45689,72702,118391,27013,0,-13545,0,0,0,,13545,-13545
39,09/28/2017,89,22:00,22:15,185.56,27.28,0,185.56,185.56,1,-151603,36414,188017,-115189,0,-1274,31257,0,0,,32531,29983
39,09/28/2017,90,22:15,22:30,72.14,,0,72.14,72.14,1,-100341,55739,156080,-44602,0,0,45793,0,0,,45793,45793
39,09/28/2017,91,22:30,22:45,32.34,30.64,0,33.15,30.64,2,-51683,63427,115110,11744,0,-863,8971,0,0,,9834,8108
39,09/28/2017,92,22:45,23:00,,29.2,0,29.2,29.2,-1,-55143,71755,126898,16612,0,-3142,0,0,0,,3142,-3142
39,09/28/2017,93,23:00,23:15,179.64,27.47,0,179.64,179.64,1,-79973,40150,120123,-39823,0,-2157,17309,0,0,,19466,15152
39,09/28/2017,94,23:15,23:30,179.64,31.62,0,179.64,31.62,2,-75712,53460,129172,-22252,0,-28,45225,0,0,,45253,45197
39,09/28/2017,95,23:30,23:45,32.34,29.98,0,33.15,29.98,2,-67812,74913,142725,7101,0,-1213,2361,0,0,,3574,1148
39,09/28/2017,96,23:45,0:00,,28.78,0,28.78,28.78,-1,-45228,48128,93356,2900,0,-8520,0,0,0,,8520,-8520
39,09/29/2017,1,0:00,0:15,32.68,30.56,0,32.68,32.68,1,-87830,86923,174753,-907,0,-1152,165,0,0,,1317,-987
39,09/29/2017,2,0:15,0:30,39.74,,0,39.74,39.74,1,-79326,52688,132014,-26638,0,0,8123,0,0,,8123,8123
39,09/29/2017,3,0:30,0:45,32.65,,0,32.65,32.65,1,-87817,46947,134764,-40870,0,0,659,0,0,,659,659
39,09/29/2017,4,0:45,1:00,32.87,31.83,0,32.92,31.83,2,-81220,59839,141059,-21381,0,-36,971,0,0,,1007,935
39,09/29/2017,5,1:00,1:15,42.56,30.56,0,42.56,42.56,1,-66686,48066,114752,-18620,0,-178,4161,0,0,,4339,3983
39,09/29/2017,6,1:15,1:30,34.12,32.03,0,32.03,32.03,-1,-52592,49067,101659,-3525,0,-87,6797,0,0,,6884,6710
39,09/29/2017,7,1:30,1:45,,32.03,0,32.03,32.03,-1,-50237,50992,101229,755,0,-412,0,0,0,,412,-412
39,09/29/2017,8,1:45,2:00,,32.4,0,32.4,32.4,-1,-52203,45734,97937,-6469,0,-74,0,0,0,,74,-74
39,09/29/2017,9,2:00,2:15,34.91,,0,34.91,34.91,1,-64514,48529,113043,-15985,0,0,3798,0,0,,3798,3798
39,09/29/2017,10,2:15,2:30,33.28,,0,33.28,33.28,1,-57793,26983,84776,-30810,0,0,2687,0,0,,2687,2687
39,09/29/2017,11,2:30,2:45,,,0,32.3,32.3,0,-54236,17428,71664,-36808,0,0,0,0,0,,0,0
39,09/29/2017,12,2:45,3:00,,,0,32.31,32.31,0,-43638,22368,66006,-21270,0,0,0,0,0,,0,0
39,09/29/2017,13,3:00,3:15,78.54,,0,78.54,78.54,1,-66443,21370,87813,-45073,0,0,15180,0,0,,15180,15180
39,09/29/2017,14,3:15,3:30,42.47,,0,42.47,42.47,1,-53069,21228,74297,-31841,0,0,25470,0,0,,25470,25470
39,09/29/2017,15,3:30,3:45,33.57,,0,33.57,33.57,1,-40259,22833,63092,-17426,0,0,6151,0,0,,6151,6151
39,09/29/2017,16,3:45,4:00,32.56,,0,32.56,32.56,1,-45753,34744,80497,-11009,0,0,1870,0,0,,1870,1870
39,09/29/2017,17,4:00,4:15,32.21,,0,32.21,32.21,1,-37802,28431,66233,-9371,0,0,671,0,0,,671,671
39,09/29/2017,18,4:15,4:30,32.2,,0,32.2,32.2,1,-41985,21782,63767,-20203,0,0,7,0,0,,7,7
39,09/29/2017,19,4:30,4:45,32.62,,0,32.62,32.62,1,-61824,18145,79969,-43679,0,0,260,0,0,,260,260
39,09/29/2017,20,4:45,5:00,42.56,,0,42.56,42.56,1,-52789,15037,67826,-37752,0,0,4737,0,0,,4737,4737
39,09/29/2017,21,5:00,5:15,33.41,,0,33.41,33.41,1,-87000,20359,107359,-66641,0,0,3069,0,0,,3069,3069
39,09/29/2017,22,5:15,5:30,,,0,32.38,32.38,0,-61745,28048,89793,-33697,0,0,0,0,0,,0,0
39,09/29/2017,23,5:30,5:45,32.59,,0,32.59,32.59,1,-76724,19931,96655,-56793,0,0,289,0,0,,289,289
39,09/29/2017,24,5:45,6:00,36.56,,0,36.56,36.56,1,-51473,44059,95532,-7414,0,0,5786,0,0,,5786,5786
39,09/29/2017,25,6:00,6:15,32.51,,0,32.51,32.51,1,-100033,63793,163826,-36240,0,0,1358,0,0,,1358,1358
39,09/29/2017,26,6:15,6:30,,,0,39.59,39.59,0,-49894,72191,122085,22297,0,0,0,0,0,,0,0
39,09/29/2017,27,6:30,6:45,,34.24,0,34.24,34.24,-1,-64461,58566,123027,-5895,0,-183,0,0,0,,183,-183
39,09/29/2017,28,6:45,7:00,36.51,,0,36.51,36.51,1,-86703,70900,157603,-15803,0,0,1028,0,0,,1028,1028
39,09/29/2017,29,7:00,7:15,36.51,33.01,0,33.01,33.01,-1,-50777,117167,167944,66390,0,-74,16,0,0,,90,-58
39,09/29/2017,30,7:15,7:30,,,0,39.58,39.58,0,-57663,75193,132856,17530,0,0,0,0,0,,0,0
39,09/29/2017,31,7:30,7:45,44.91,,0,44.91,44.91,1,-86207,78373,164580,-7834,0,0,2175,0,0,,2175,2175
39,09/29/2017,32,7:45,8:00,55.91,,0,55.91,55.91,1,-108488,81654,190142,-26834,0,0,12666,0,0,,12666,12666
39,09/29/2017,33,8:00,8:15,55.91,33.63,0,33.63,33.63,-1,-42133,76519,118652,34386,0,-684,2411,0,0,,3095,1727
39,09/29/2017,34,8:15,8:30,,29.51,0,29.51,29.51,-1,-48343,71619,119962,23276,0,-3305,0,0,0,,3305,-3305
39,09/29/2017,35,8:30,8:45,,46.82,0,46.82,46.82,-1,-75351,67302,142653,-8049,0,-1328,0,0,0,,1328,-1328
39,09/29/2017,36,8:45,9:00,,,0,39.47,39.47,0,-93079,73427,166506,-19652,0,0,0,0,0,,0,0
39,09/29/2017,37,9:00,9:15,36.47,,0,36.47,36.47,1,-60259,68576,128835,8317,0,0,372,0,0,,372,372
39,09/29/2017,38,9:15,9:30,,,0,39.52,39.52,0,-70020,63749,133769,-6271,0,0,0,0,0,,0,0
39,09/29/2017,39,9:30,9:45,,33.99,0,33.99,33.99,-1,-69257,66244,135501,-3013,0,-287,0,0,0,,287,-287
39,09/29/2017,40,9:45,10:00,,46.84,0,46.84,46.84,-1,-70328,65800,136128,-4528,0,-323,0,0,0,,323,-323
39,09/29/2017,41,10:00,10:15,32.37,,0,32.37,32.37,1,-73553,25544,99097,-48009,0,0,348,0,0,,348,348
39,09/29/2017,42,10:15,10:30,32.18,,0,32.18,32.18,1,-83176,28367,111543,-54809,0,0,347,0,0,,347,347
39,09/29/2017,43,10:30,10:45,36.38,,0,36.38,36.38,1,-90860,29443,120303,-61417,0,0,546,0,0,,546,546
39,09/29/2017,44,10:45,11:00,,,0,39.54,39.54,0,-84148,36239,120387,-47909,0,0,0,0,0,,0,0
39,09/29/2017,45,11:00,11:15,44.21,,0,44.21,44.21,1,-114743,21187,135930,-93556,0,0,7314,0,0,,7314,7314
39,09/29/2017,46,11:15,11:30,38.06,,0,38.06,38.06,1,-103977,23262,127239,-80715,0,0,8778,0,0,,8778,8778
39,09/29/2017,47,11:30,11:45,35,,0,35,35,1,-99022,24021,123043,-75001,0,0,7272,0,0,,7272,7272
39,09/29/2017,48,11:45,12:00,32.51,,0,32.51,32.51,1,-87336,20793,108129,-66543,0,0,167,0,0,,167,167
39,09/29/2017,49,12:00,12:15,163.04,,0,163.04,163.04,1,-140599,11804,152403,-128795,0,0,25069,0,0,,25069,25069
39,09/29/2017,50,12:15,12:30,43.83,,0,43.83,43.83,1,-113627,42338,155965,-71289,0,0,18348,0,0,,18348,18348
39,09/29/2017,51,12:30,12:45,,,0,40.16,40.16,0,-88762,51575,140337,-37187,0,0,63,0,0,,63,63
39,09/29/2017,52,12:45,13:00,,,0,40.17,40.17,0,-79450,37930,117380,-41520,0,0,0,0,0,,0,0
39,09/29/2017,53,13:00,13:15,,,0,40.17,40.17,0,-92443,41319,133762,-51124,0,0,0,0,0,,0,0
39,09/29/2017,54,13:15,13:30,32.15,,0,32.15,32.15,1,-94538,58796,153334,-35742,0,0,5,0,0,,5,5
39,09/29/2017,55,13:30,13:45,,,0,40.19,40.19,0,-74830,63530,138360,-11300,0,0,0,0,0,,0,0
39,09/29/2017,56,13:45,14:00,,31.03,0,31.03,31.03,-1,-70137,65647,135784,-4490,0,-742,0,0,0,,742,-742
39,09/29/2017,57,14:00,14:15,,31.44,0,31.44,31.44,-1,-49699,62096,111795,12397,0,-550,0,0,0,,550,-550
39,09/29/2017,58,14:15,14:30,,,0,40.23,40.23,0,-48610,63700,112310,15090,0,-14,0,0,0,,14,-14
39,09/29/2017,59,14:30,14:45,,31.55,0,31.55,31.55,-1,-51709,79859,131568,28150,0,-487,0,0,0,,487,-487
39,09/29/2017,60,14:45,15:00,,25.51,0,25.51,25.51,-1,-47259,90297,137556,43038,0,-14328,0,0,0,,14328,-14328
39,09/29/2017,61,15:00,15:15,,28.75,0,28.75,28.75,-1,-47732,99052,146784,51320,0,-20532,0,0,0,,20532,-20532
39,09/29/2017,62,15:15,15:30,,29.51,0,29.51,29.51,-1,-47499,85189,132688,37690,0,-18939,0,0,0,,18939,-18939
39,09/29/2017,63,15:30,15:45,,,0,33.9,33.9,0,-50724,66253,116977,15529,0,-2029,0,0,0,,2029,-2029
39,09/29/2017,64,15:45,16:00,,,0,33.86,33.86,0,-48283,56527,104810,8244,0,0,0,0,0,,0,0
39,09/29/2017,65,16:00,16:15,,,0,33.94,33.94,0,-73804,37767,111571,-36037,0,0,0,0,0,,0,0
39,09/29/2017,66,16:15,16:30,,,0,33.89,33.89,0,-67926,17448,85374,-50478,0,0,0,0,0,,0,0
39,09/29/2017,67,16:30,16:45,32.51,,0,32.51,32.51,1,-78104,11758,89862,-66346,0,0,36,0,0,,36,36
39,09/29/2017,68,16:45,17:00,141.23,,0,141.23,141.23,1,-113722,14989,128711,-98733,0,0,17226,0,0,,17226,17226
39,09/29/2017,69,17:00,17:15,51.17,,0,51.17,51.17,1,-101975,43632,145607,-58343,0,0,15125,0,0,,15125,15125
39,09/29/2017,70,17:15,17:30,43.15,,0,43.15,43.15,1,-113322,25042,138364,-88280,0,0,7885,0,0,,7885,7885
39,09/29/2017,71,17:30,17:45,173.24,,0,173.24,173.24,1,-111209,39293,150502,-71916,0,0,27664,0,0,,27664,27664
39,09/29/2017,72,17:45,18:00,51.17,,0,51.17,51.17,1,-102933,40924,143857,-62009,0,0,31444,0,0,,31444,31444
39,09/29/2017,73,18:00,18:15,51.17,29.51,0,29.51,29.51,-1,-85234,60049,145283,-25185,0,-976,7489,0,0,,8465,6513
39,09/29/2017,74,18:15,18:30,,35.55,0,35.55,35.55,-1,-71040,74417,145457,3377,0,-1595,0,0,0,,1595,-1595
39,09/29/2017,75,18:30,18:45,,33.86,0,33.86,33.86,-1,-64477,99296,163773,34819,0,-2229,0,0,0,,2229,-2229
39,09/29/2017,76,18:45,19:00,,,0,40.25,40.25,0,-53332,88778,142110,35446,0,-60,0,0,0,,60,-60
39,09/29/2017,77,19:00,19:15,,5.61,0,5.61,5.61,-1,-48958,110285,159243,61327,0,-21245,0,0,0,,21245,-21245
39,09/29/2017,78,19:15,19:30,37.79,29.51,0,37.79,37.79,1,-74108,81109,155217,7001,0,-17603,449,0,0,,18052,-17154
39,09/29/2017,79,19:30,19:45,37.31,33.89,0,40.24,33.89,2,-89747,101891,191638,12144,0,-251,933,0,0,,1184,682
39,09/29/2017,80,19:45,20:00,,28.84,0,28.84,28.84,-1,-84288,115082,199370,30794,0,-11345,0,0,0,,11345,-11345
39,09/29/2017,81,20:00,20:15,,33.41,0,33.41,33.41,-1,-89074,105634,194708,16560,0,-1228,0,0,0,,1228,-1228
39,09/29/2017,82,20:15,20:30,,30.16,0,30.16,30.16,-1,-98940,99142,198082,202,0,-1430,0,0,0,,1430,-1430
39,09/29/2017,83,20:30,20:45,,48.21,0,48.21,48.21,-1,-93695,81289,174984,-12406,0,-79,0,0,0,,79,-79
39,09/29/2017,84,20:45,21:00,,33.58,0,33.58,33.58,-1,-106703,60594,167297,-46109,0,-233,0,0,0,,233,-233
39,09/29/2017,85,21:00,21:15,35.02,29.51,0,35.02,29.51,2,-137842,143304,281146,5462,0,-1213,533,0,0,,1746,-680
39,09/29/2017,86,21:15,21:30,44.19,,0,44.19,44.19,1,-116939,84946,201885,-31993,0,0,8778,0,0,,8778,8778
39,09/29/2017,87,21:30,21:45,66.75,,0,66.75,66.75,1,-127254,86824,214078,-40430,0,0,20944,0,0,,20944,20944
39,09/29/2017,88,21:45,22:00,36.51,33.03,0,33.03,33.03,-1,-123407,105987,229394,-17420,0,-30,13908,0,0,,13938,13878
39,09/29/2017,89,22:00,22:15,149,30.92,0,149,30.92,2,-196100,132420,328520,-63680,0,-478,18203,0,0,,18681,17725
39,09/29/2017,90,22:15,22:30,48.02,30.01,0,30.01,30.01,-1,-118251,112810,231061,-5441,0,-184,29111,0,0,,29295,28927
39,09/29/2017,91,22:30,22:45,48.02,22.24,0,22.24,22.24,-1,-95573,117007,212580,21434,0,-1942,1054,0,0,,2996,-888
39,09/29/2017,92,22:45,23:00,36.51,29.91,0,36.51,29.91,2,-150478,144117,294595,-6361,0,-902,1189,0,0,,2091,287
39,09/29/2017,93,23:00,23:15,87.15,35.72,0,87.15,33.93,2,-155184,118471,273655,-36713,0,-39,6460,0,0,,6499,6421
39,09/29/2017,94,23:15,23:30,140.61,,0,140.61,140.61,1,-96580,66072,162652,-30508,0,0,31271,0,0,,31271,31271
39,09/29/2017,95,23:30,23:45,35.44,,0,35.44,35.44,1,-93001,77452,170453,-15549,0,0,5985,0,0,,5985,5985
39,09/29/2017,96,23:45,0:00,48.37,,0,48.37,48.37,1,-93468,50080,143548,-43388,0,0,13541,0,0,,13541,13541
40,09/30/2017,1,0:00,0:15,188.53,,0,188.53,188.53,1,-78663,29340,108003,-49323,0,0,19605,0,0,,19605,19605
40,09/30/2017,2,0:15,0:30,117.29,,0,117.29,117.29,1,-86373,22855,109228,-63518,0,0,40935,0,0,,40935,40935
40,09/30/2017,3,0:30,0:45,43.94,,0,43.94,43.94,1,-72752,14863,87615,-57889,0,0,32930,0,0,,32930,32930
40,09/30/2017,4,0:45,1:00,48,,0,48,48,1,-64865,5606,70471,-59259,0,0,27520,0,0,,27520,27520
40,09/30/2017,5,1:00,1:15,36.56,,0,36.56,36.56,1,-95391,48715,144106,-46676,0,0,11544,0,0,,11544,11544
40,09/30/2017,6,1:15,1:30,38.46,,0,38.46,38.46,1,-74242,28389,102631,-45853,0,0,5525,0,0,,5525,5525
40,09/30/2017,7,1:30,1:45,36.3,,0,36.3,36.3,1,-55581,26677,82258,-28904,0,0,484,0,0,,484,484
40,09/30/2017,8,1:45,2:00,36.76,,0,36.76,36.76,1,-54042,27655,81697,-26387,0,0,796,0,0,,796,796
40,09/30/2017,9,2:00,2:15,46.98,,0,46.98,46.98,1,-35862,30141,66003,-5721,0,0,8996,0,0,,8996,8996
40,09/30/2017,10,2:15,2:30,,,0,30.18,30.18,0,-37263,30511,67774,-6752,0,0,2518,0,0,,2518,2518
40,09/30/2017,11,2:30,2:45,42.39,,0,42.39,42.39,1,-44061,22764,66825,-21297,0,0,9595,0,0,,9595,9595
40,09/30/2017,12,2:45,3:00,36.39,30.61,0,30.61,30.61,-1,-38557,29163,67720,-9394,0,-105,14301,0,0,,14406,14196
40,09/30/2017,13,3:00,3:15,36.39,25.39,0,36.39,25.39,2,-42385,48446,90831,6061,0,-2086,1851,0,0,,3937,-235
40,09/30/2017,14,3:15,3:30,36.39,,0,36.39,36.39,1,-41997,33269,75266,-8728,0,0,2087,0,0,,2087,2087
40,09/30/2017,15,3:30,3:45,,,0,30.27,30.27,0,-46354,33451,79805,-12903,0,0,0,0,0,,0,0
40,09/30/2017,16,3:45,4:00,,,0,30.27,30.27,0,-44676,31178,75854,-13498,0,0,0,0,0,,0,0
40,09/30/2017,17,4:00,4:15,37.34,,0,37.34,37.34,1,-34028,29338,63366,-4690,0,0,1941,0,0,,1941,1941
40,09/30/2017,18,4:15,4:30,41.29,,0,41.29,41.29,1,-39199,30925,70124,-8274,0,0,6716,0,0,,6716,6716
40,09/30/2017,19,4:30,4:45,42.39,,0,42.39,42.39,1,-55739,32692,88431,-23047,0,0,5642,0,0,,5642,5642
40,09/30/2017,20,4:45,5:00,49.16,,0,49.16,49.16,1,-75371,35254,110625,-40117,0,0,31338,0,0,,31338,31338
40,09/30/2017,21,5:00,5:15,38.29,31.69,0,31.69,31.69,-1,-40454,25801,66255,-14653,0,-177,19582,0,0,,19759,19405
40,09/30/2017,22,5:15,5:30,39.41,31.55,0,39.41,30.35,2,-50165,18851,69016,-31314,0,-79,3662,0,0,,3741,3583
40,09/30/2017,23,5:30,5:45,61.35,,0,61.35,61.35,1,-64754,13548,78302,-51206,0,0,15972,0,0,,15972,15972
40,09/30/2017,24,5:45,6:00,69.33,30.75,0,69.33,30.67,2,-41083,36423,77506,-4660,0,-95,33215,0,0,,33310,33120
40,09/30/2017,25,6:00,6:15,69.33,30.99,0,30.99,30.99,-1,-19676,39145,58821,19469,0,-235,771,0,0,,1006,536
40,09/30/2017,26,6:15,6:30,,,0,30.91,30.91,0,-24137,37485,61622,13348,0,0,0,0,0,,0,0
40,09/30/2017,27,6:30,6:45,41.03,,0,41.03,41.03,1,-42903,31127,74030,-11776,0,0,5249,0,0,,5249,5249
40,09/30/2017,28,6:45,7:00,41.03,,0,41.03,41.03,1,-59485,28003,87488,-31482,0,0,24783,0,0,,24783,24783
40,09/30/2017,29,7:00,7:15,44.6,,0,44.6,44.6,1,-132240,39193,171433,-93047,0,0,19356,0,0,,19356,19356
40,09/30/2017,30,7:15,7:30,44.6,29.03,0,29.03,29.03,-1,-60601,32542,93143,-28059,0,-63,559,0,0,,622,496
40,09/30/2017,31,7:30,7:45,,35.29,0,35.29,35.29,-1,-44128,37670,81798,-6458,0,-386,0,0,0,,386,-386
40,09/30/2017,32,7:45,8:00,,-25.85,0,-25.85,-25.85,-1,-58461,113061,171522,54600,0,-16917,0,0,0,,16917,-16917
40,09/30/2017,33,8:00,8:15,35.03,28.11,0,35.03,28.11,2,-63977,28719,92696,-35258,0,-12825,557,0,0,,13382,-12268
40,09/30/2017,34,8:15,8:30,32.75,28.11,0,32.75,32.75,1,-71221,33290,104511,-37931,0,-46,503,0,0,,549,457
40,09/30/2017,35,8:30,8:45,45,,0,45,45,1,-99530,25358,124888,-74172,0,0,5009,0,0,,5009,5009
40,09/30/2017,36,8:45,9:00,174.82,,0,174.82,174.82,1,-108372,33875,142247,-74497,0,0,36670,0,0,,36670,36670
40,09/30/2017,37,9:00,9:15,174.82,28.91,0,28.91,28.91,-1,-56930,43741,100671,-13189,0,-1241,11637,0,0,,12878,10396
40,09/30/2017,38,9:15,9:30,37.7,,0,37.7,37.7,1,-77570,32992,110562,-44578,0,0,1667,0,0,,1667,1667
40,09/30/2017,39,9:30,9:45,37.72,,0,37.72,37.72,1,-100876,34617,135493,-66259,0,0,2906,0,0,,2906,2906
40,09/30/2017,40,9:45,10:00,184.03,,0,184.03,184.03,1,-109540,35316,144856,-74224,0,0,35062,0,0,,35062,35062
40,09/30/2017,41,10:00,10:15,45.36,,0,45.36,45.36,1,-84508,60040,144548,-24468,0,0,23331,0,0,,23331,23331
40,09/30/2017,42,10:15,10:30,44.4,,0,44.4,44.4,1,-92324,56659,148983,-35665,0,0,13273,0,0,,13273,13273
40,09/30/2017,43,10:30,10:45,68.16,,0,68.16,68.16,1,-102020,51259,153279,-50761,0,0,30867,0,0,,30867,30867
40,09/30/2017,44,10:45,11:00,101.46,,0,101.46,101.46,1,-115368,61147,176515,-54221,0,0,54656,0,0,,54656,54656
40,09/30/2017,45,11:00,11:15,,,0,31.91,31.91,0,-133832,51143,184975,-82689,0,0,15966,0,0,,15966,15966
40,09/30/2017,46,11:15,11:30,38.2,,0,38.2,38.2,1,-144749,42441,187190,-102308,0,0,1508,0,0,,1508,1508
40,09/30/2017,47,11:30,11:45,184.03,,0,184.03,184.03,1,-157314,37867,195181,-119447,0,0,39711,0,0,,39711,39711
40,09/30/2017,48,11:45,12:00,184.03,,0,184.03,184.03,1,-118292,46427,164719,-71865,0,0,65724,0,0,,65724,65724
40,09/30/2017,49,12:00,12:15,123.51,,0,123.51,123.51,1,-122499,50660,173159,-71839,0,0,57910,0,0,,57910,57910
40,09/30/2017,50,12:15,12:30,58.16,,0,58.16,58.16,1,-104194,60937,165131,-43257,0,0,38471,0,0,,38471,38471
40,09/30/2017,51,12:30,12:45,85.6,,0,85.6,85.6,1,-106314,58414,164728,-47900,0,0,13381,0,0,,13381,13381
40,09/30/2017,52,12:45,13:00,31.03,32.68,0,32.68,32.68,-1,-113584,57342,170926,-56242,0,-38,3981,0,0,,4019,3943
40,09/30/2017,53,13:00,13:15,35.05,29.75,0,35.05,29.75,2,-154203,56203,210406,-98000,0,-351,507,0,0,,858,156
40,09/30/2017,54,13:15,13:30,63.49,,0,63.49,63.49,1,-144217,67196,211413,-77021,0,0,16236,0,0,,16236,16236
40,09/30/2017,55,13:30,13:45,35.15,,0,35.15,35.15,1,-133962,66691,200653,-67271,0,0,5349,0,0,,5349,5349
40,09/30/2017,56,13:45,14:00,35.03,,0,35.03,35.03,1,-151783,59218,211001,-92565,0,0,1955,0,0,,1955,1955
40,09/30/2017,57,14:00,14:15,164.43,,0,164.43,164.43,1,-167352,64631,231983,-102721,0,0,30592,0,0,,30592,30592
40,09/30/2017,58,14:15,14:30,164.43,,0,164.43,164.43,1,-129505,71706,201211,-57799,0,0,64429,0,0,,64429,64429
40,09/30/2017,59,14:30,14:45,35.03,,0,35.03,35.03,1,-117794,84995,202789,-32799,0,0,16792,0,0,,16792,16792
40,09/30/2017,60,14:45,15:00,36.41,,0,36.41,36.41,1,-143920,84497,228417,-59423,0,0,2492,0,0,,2492,2492
40,09/30/2017,61,15:00,15:15,133,,0,133,133,1,-137565,49570,187135,-87995,0,0,42683,0,0,,42683,42683
40,09/30/2017,62,15:15,15:30,45.5,,0,45.5,45.5,1,-110221,60134,170355,-50087,0,0,36581,0,0,,36581,36581
40,09/30/2017,63,15:30,15:45,41.03,,0,41.03,41.03,1,-111601,81013,192614,-30588,0,0,22435,0,0,,22435,22435
40,09/30/2017,64,15:45,16:00,,,0,31.76,31.76,0,-113331,98732,212063,-14599,0,0,6002,0,0,,6002,6002
40,09/30/2017,65,16:00,16:15,,34.64,0,34.64,34.64,-1,-115406,173853,289259,58447,0,-151,0,0,0,,151,-151
40,09/30/2017,66,16:15,16:30,,14.61,0,14.61,14.61,-1,-101807,176532,278339,74725,0,-14041,0,0,0,,14041,-14041
40,09/30/2017,67,16:30,16:45,,12.44,0,12.44,12.44,-1,-105330,153986,259316,48656,0,-41819,0,0,0,,41819,-41819
40,09/30/2017,68,16:45,17:00,,14.86,0,14.86,14.86,-1,-120087,185747,305834,65660,0,-28915,0,0,0,,28915,-28915
40,09/30/2017,69,17:00,17:15,,-5.55,0,-5.55,-5.55,-1,-62795,142370,205165,79575,0,-59943,0,0,0,,59943,-59943
40,09/30/2017,70,17:15,17:30,,24.03,0,24.03,24.03,-1,-75499,139540,215039,64041,0,-34177,0,0,0,,34177,-34177
40,09/30/2017,71,17:30,17:45,,31.41,0,31.41,31.41,-1,-108597,162386,270983,53789,0,-13098,0,0,0,,13098,-13098
40,09/30/2017,72,17:45,18:00,,,0,31.85,31.85,0,-117098,150203,267301,33105,0,0,0,0,0,,0,0
40,09/30/2017,73,18:00,18:15,,5.49,0,5.49,5.49,-1,-86564,120318,206882,33754,0,-21974,0,0,0,,21974,-21974
40,09/30/2017,74,18:15,18:30,,24.03,0,24.03,24.03,-1,-89549,106090,195639,16541,0,-20480,0,0,0,,20480,-20480
40,09/30/2017,75,18:30,18:45,,34.46,0,34.46,34.46,-1,-73968,113993,187961,40025,0,-974,0,0,0,,974,-974
40,09/30/2017,76,18:45,19:00,,35.7,0,35.7,35.7,-1,-57807,108998,166805,51191,0,-389,0,0,0,,389,-389
40,09/30/2017,77,19:00,19:15,,-33.39,0,-33.39,-33.39,-1,-43281,108474,151755,65193,0,-29534,0,0,0,,29534,-29534
40,09/30/2017,78,19:15,19:30,,29.03,0,29.03,29.03,-1,-59320,74986,134306,15666,0,-9446,0,0,0,,9446,-9446
40,09/30/2017,79,19:30,19:45,87.66,,0,87.66,87.66,1,-90483,52395,142878,-38088,0,0,6494,0,0,,6494,6494
40,09/30/2017,80,19:45,20:00,206.22,28.03,0,206.22,28.03,2,-72626,44256,116882,-28370,0,-522,22651,0,0,,23173,22129
40,09/30/2017,81,20:00,20:15,206.22,27.84,0,27.84,27.84,-1,-55826,38506,94332,-17320,0,-1301,273,0,0,,1574,-1028
40,09/30/2017,82,20:15,20:30,32.4,,0,32.4,32.4,1,-49014,19582,68596,-29432,0,0,1216,0,0,,1216,1216
40,09/30/2017,83,20:30,20:45,31.03,28.03,0,31.79,28.03,2,-33061,30509,63570,-2552,0,-2691,540,0,0,,3231,-2151
40,09/30/2017,84,20:45,21:00,,17.55,0,17.55,17.55,-1,-30177,56930,87107,26753,0,-37297,0,0,0,,37297,-37297
40,09/30/2017,85,21:00,21:15,172.73,17.55,0,172.73,172.73,1,-65196,17473,82669,-47723,0,-8773,13996,0,0,,22769,5223
40,09/30/2017,86,21:15,21:30,172.73,30.99,0,30.99,30.99,-1,-34117,37247,71364,3130,0,-1865,2094,0,0,,3959,229
40,09/30/2017,87,21:30,21:45,,29.01,0,29.01,29.01,-1,-19161,59530,78691,40369,0,-2169,0,0,0,,2169,-2169
40,09/30/2017,88,21:45,22:00,,28.03,0,28.03,28.03,-1,-18672,78120,96792,59448,0,-4120,0,0,0,,4120,-4120
40,09/30/2017,89,22:00,22:15,42.86,28.03,0,42.86,42.86,1,-59372,33560,92932,-25812,0,-83,7230,0,0,,7313,7147
40,09/30/2017,90,22:15,22:30,32.15,31.71,0,33.26,31.71,2,-43512,42090,85602,-1422,0,-406,2905,0,0,,3311,2499
40,09/30/2017,91,22:30,22:45,,,0,33.18,33.18,0,-24138,57149,81287,33011,0,0,0,0,0,,0,0
40,09/30/2017,92,22:45,23:00,,29.03,0,29.03,29.03,-1,-44813,72694,117507,27881,0,-115,0,0,0,,115,-115
40,09/30/2017,93,23:00,23:15,,9.99,0,9.99,9.99,-1,-46347,119535,165882,73188,0,-15814,0,0,0,,15814,-15814
40,09/30/2017,94,23:15,23:30,,26.98,0,26.98,26.98,-1,-37195,65367,102562,28172,0,-23558,0,0,0,,23558,-23558
40,09/30/2017,95,23:30,23:45,,29.03,0,29.03,29.03,-1,-36185,64759,100944,28574,0,-3600,0,0,0,,3600,-3600
40,09/30/2017,96,23:45,0:00,,24.03,0,24.03,24.03,-1,-61633,56140,117773,-5493,0,-11499,0,0,0,,11499,-11499
40,10-01-17,1,0:00,0:15,,24.03,0,24.03,24.03,-1,-31742,124981,156723,93239,0,-3954,0,0,0,,3954,-3954
40,10-01-17,2,0:15,0:30,,24.03,0,24.03,24.03,-1,-30584,52945,83529,22361,0,-3737,0,0,0,,3737,-3737
40,10-01-17,3,0:30,0:45,,24.03,0,24.03,24.03,-1,-31913,45970,77883,14057,0,-10164,0,0,0,,10164,-10164
40,10-01-17,4,0:45,1:00,31.03,29.03,0,31.03,31.03,1,-92105,56378,148483,-35727,0,-5659,133,0,0,,5792,-5526
40,10-01-17,5,1:00,1:15,32.08,29.03,0,32.08,32.08,1,-45691,36771,82462,-8920,0,-16,688,0,0,,704,672
40,10-01-17,6,1:15,1:30,32.08,24.03,0,24.03,24.03,-1,-28294,42312,70606,14018,0,-911,1,0,0,,912,-910
40,10-01-17,7,1:30,1:45,,17.89,0,17.89,17.89,-1,-19462,51839,71301,32377,0,-21035,0,0,0,,21035,-21035
40,10-01-17,8,1:45,2:00,,17.89,0,17.89,17.89,-1,-28192,53727,81919,25535,0,-16655,0,0,0,,16655,-16655
40,10-01-17,9,2:00,2:15,,10.1,0,10.1,10.1,-1,-35173,71686,106859,36513,0,-35263,0,0,0,,35263,-35263
40,10-01-17,10,2:15,2:30,,21.85,0,21.85,21.85,-1,-47961,70405,118366,22444,0,-12923,0,0,0,,12923,-12923
40,10-01-17,11,2:30,2:45,,-14.26,0,-14.26,-14.26,-1,-46885,95486,142371,48601,0,-40625,0,0,0,,40625,-40625
40,10-01-17,12,2:45,3:00,,24.03,0,24.03,24.03,-1,-66095,111995,178090,45900,0,-25009,0,0,0,,25009,-25009
40,10-01-17,13,3:00,3:15,34.89,17.26,0,34.89,34.89,1,-59184,62083,121267,2899,0,-13260,813,0,0,,14073,-12447
40,10-01-17,14,3:15,3:30,,,0,37.03,37.03,0,-54863,49505,104368,-5358,0,-15,23,0,0,,38,8
40,10-01-17,15,3:30,3:45,,,0,37.03,37.03,0,-40655,42176,82831,1521,0,0,0,0,0,,0,0
40,10-01-17,16,3:45,4:00,,27.32,0,27.32,27.32,-1,-39992,40616,80608,624,0,-2634,0,0,0,,2634,-2634
40,10-01-17,17,4:00,4:15,,28.03,0,28.03,28.03,-1,-33501,52226,85727,18725,0,-3741,0,0,0,,3741,-3741
40,10-01-17,18,4:15,4:30,,,0,31.93,31.93,0,-55229,39167,94396,-16062,0,0,0,0,0,,0,0
40,10-01-17,19,4:30,4:45,,,0,31.93,31.93,0,-59335,37960,97295,-21375,0,0,0,0,0,,0,0
40,10-01-17,20,4:45,5:00,,,0,31.93,31.93,0,-63384,37564,100948,-25820,0,0,0,0,0,,0,0
40,10-01-17,21,5:00,5:15,,29.03,0,29.03,29.03,-1,-56231,63270,119501,7039,0,-559,0,0,0,,559,-559
40,10-01-17,22,5:15,5:30,,24.03,0,24.03,24.03,-1,-65017,76082,141099,11065,0,-8363,0,0,0,,8363,-8363
40,10-01-17,23,5:30,5:45,,23.18,0,23.18,23.18,-1,-63810,75996,139806,12186,0,-4376,0,0,0,,4376,-4376
40,10-01-17,24,5:45,6:00,,14.03,0,14.03,14.03,-1,-66668,76604,143272,9936,0,-20131,0,0,0,,20131,-20131
40,10-01-17,25,6:00,6:15,,24.06,0,24.06,24.06,-1,-37564,82509,120073,44945,0,-21940,0,0,0,,21940,-21940
40,10-01-17,26,6:15,6:30,31.06,4.26,0,31.69,4.26,2,-49032,63054,112086,14022,0,-22977,18,0,0,,22995,-22959
40,10-01-17,27,6:30,6:45,32.64,28.06,0,32.64,28.06,2,-61411,66699,128110,5288,0,-1991,874,0,0,,2865,-1117
40,10-01-17,28,6:45,7:00,,28.06,0,28.06,28.06,-1,-44391,74552,118943,30161,0,-4355,0,0,0,,4355,-4355
40,10-01-17,29,7:00,7:15,,24.57,0,24.57,24.57,-1,-38983,69137,108120,30154,0,-5544,0,0,0,,5544,-5544
40,10-01-17,30,7:15,7:30,,26.01,0,26.01,26.01,-1,-29097,82558,111655,53461,0,-13172,0,0,0,,13172,-13172
40,10-01-17,31,7:30,7:45,,23.03,0,23.03,23.03,-1,-25941,88562,114503,62621,0,-24284,0,0,0,,24284,-24284
40,10-01-17,32,7:45,8:00,,26.02,0,26.02,26.02,-1,-34164,94630,128794,60466,0,-20145,0,0,0,,20145,-20145
40,10-01-17,33,8:00,8:15,31.06,26.02,0,31.06,31.06,1,-57796,42779,100575,-15017,0,-5664,132,0,0,,5796,-5532
40,10-01-17,34,8:15,8:30,31.06,23.49,0,37.06,23.49,2,-22046,49078,71124,27032,0,-6509,228,0,0,,6737,-6281
40,10-01-17,35,8:30,8:45,,28.06,0,28.06,28.06,-1,-23539,51217,74756,27678,0,-7771,0,0,0,,7771,-7771
40,10-01-17,36,8:45,9:00,31.06,28.06,0,31.06,31.06,1,-40616,56653,97269,16037,0,-249,128,0,0,,377,-121
40,10-01-17,37,9:00,9:15,31.06,,0,31.06,31.06,1,-78249,43038,121287,-35211,0,0,81,0,0,,81,81
40,10-01-17,38,9:15,9:30,,43.02,0,43.02,43.02,-1,-35137,44099,79236,8962,0,-1,0,0,0,,1,-1
40,10-01-17,39,9:30,9:45,,29.06,0,29.06,29.06,-1,-38871,39737,78608,866,0,-1169,0,0,0,,1169,-1169
40,10-01-17,40,9:45,10:00,,,0,37.01,37.01,0,-32480,51631,84111,19151,0,-45,0,0,0,,45,-45
40,10-01-17,41,10:00,10:15,,43.02,0,43.02,43.02,-1,-32288,58202,90490,25914,0,-29,0,0,0,,29,-29
40,10-01-17,42,10:15,10:30,,32.48,0,32.48,32.48,-1,-21259,94686,115945,73427,0,-1061,0,0,0,,1061,-1061
40,10-01-17,43,10:30,10:45,,29.06,0,29.06,29.06,-1,-20325,136875,157200,116550,0,-1700,0,0,0,,1700,-1700
40,10-01-17,44,10:45,11:00,,24.06,0,24.06,24.06,-1,-21972,139645,161617,117673,0,-6671,0,0,0,,6671,-6671
40,10-01-17,45,11:00,11:15,,28.06,0,28.06,28.06,-1,-24701,80937,105638,56236,0,-2122,0,0,0,,2122,-2122
40,10-01-17,46,11:15,11:30,,42.8,0,42.8,42.8,-1,-23461,100563,124024,77102,0,-1252,0,0,0,,1252,-1252
40,10-01-17,47,11:30,11:45,,29.18,0,29.18,29.18,-1,-20804,124924,145728,104120,0,-43,0,0,0,,43,-43
40,10-01-17,48,11:45,12:00,,29.06,0,29.06,29.06,-1,-16742,143399,160141,126657,0,-524,0,0,0,,524,-524
40,10-01-17,49,12:00,12:15,,42.86,0,42.86,42.86,-1,-31906,98573,130479,66667,0,-98,0,0,0,,98,-98
40,10-01-17,50,12:15,12:30,,-14.52,0,-14.52,-14.52,-1,-32766,99470,132236,66704,0,-9747,0,0,0,,9747,-9747
40,10-01-17,51,12:30,12:45,,-15.21,0,-15.21,-15.21,-1,-44679,84254,128933,39575,0,-24060,0,0,0,,24060,-24060
40,10-01-17,52,12:45,13:00,,-23.22,0,-23.22,-23.22,-1,-41882,102532,144414,60650,0,-43200,0,0,0,,43200,-43200
40,10-01-17,53,13:00,13:15,,16.21,0,16.21,16.21,-1,-39059,81725,120784,42666,0,-30117,0,0,0,,30117,-30117
40,10-01-17,54,13:15,13:30,,22.59,0,22.59,22.59,-1,-50191,88721,138912,38530,0,-9653,0,0,0,,9653,-9653
40,10-01-17,55,13:30,13:45,,14.06,0,14.06,14.06,-1,-47317,92715,140032,45398,0,-27484,0,0,0,,27484,-27484
40,10-01-17,56,13:45,14:00,,-34.54,0,-34.54,-34.54,-1,-60862,95227,156089,34365,0,-44102,0,0,0,,44102,-44102
40,10-01-17,57,14:00,14:15,,24.06,0,24.06,24.06,-1,-32410,127497,159907,95087,0,-18300,0,0,0,,18300,-18300
40,10-01-17,58,14:15,14:30,,14.06,0,14.06,14.06,-1,-29863,132967,162830,103104,0,-13746,0,0,0,,13746,-13746
40,10-01-17,59,14:30,14:45,,6.08,0,6.08,6.08,-1,-34770,109186,143956,74416,0,-18207,0,0,0,,18207,-18207
40,10-01-17,60,14:45,15:00,47.06,-34.9,0,47.06,-34.9,2,-55160,69277,124437,14117,0,-32242,376,0,0,,32618,-31866
40,10-01-17,61,15:00,15:15,47.06,29.06,0,47.06,29.06,2,-33782,91086,124868,57304,0,-1931,1178,0,0,,3109,-753
40,10-01-17,62,15:15,15:30,,31.21,0,31.21,31.21,-1,-34787,85292,120079,50505,0,-406,0,0,0,,406,-406
40,10-01-17,63,15:30,15:45,,33.21,0,33.21,33.21,-1,-44318,51823,96141,7505,0,-242,0,0,0,,242,-242
40,10-01-17,64,15:45,16:00,,28.06,0,28.06,28.06,-1,-40311,49505,89816,9194,0,-925,0,0,0,,925,-925
40,10-01-17,65,16:00,16:15,41.06,,0,41.06,41.06,1,-82021,45877,127898,-36144,0,0,10884,0,0,,10884,10884
40,10-01-17,66,16:15,16:30,47.06,,0,47.06,47.06,1,-62138,28466,90604,-33672,0,0,12681,0,0,,12681,12681
40,10-01-17,67,16:30,16:45,61.27,,0,61.27,61.27,1,-79765,32593,112358,-47172,0,0,34159,0,0,,34159,34159
40,10-01-17,68,16:45,17:00,58.29,,0,58.29,58.29,1,-86654,62015,148669,-24639,0,0,38349,0,0,,38349,38349
40,10-01-17,69,17:00,17:15,111.66,,0,111.66,111.66,1,-169350,61201,230551,-108149,0,0,43956,0,0,,43956,43956
40,10-01-17,70,17:15,17:30,34.52,29.39,0,34.52,29.39,2,-45425,54175,99600,8750,0,-996,13319,0,0,,14315,12323
40,10-01-17,71,17:30,17:45,36.53,29.39,0,36.53,36.53,1,-70489,43674,114163,-26815,0,-36,3128,0,0,,3164,3092
40,10-01-17,72,17:45,18:00,43,,0,43,43,1,-72077,63989,136066,-8088,0,0,8018,0,0,,8018,8018
40,10-01-17,73,18:00,18:15,35.06,,0,35.06,35.06,1,-125877,53525,179402,-72352,0,0,1721,0,0,,1721,1721
40,10-01-17,74,18:15,18:30,,29.06,0,29.06,29.06,-1,-67944,59910,127854,-8034,0,-485,0,0,0,,485,-485
40,10-01-17,75,18:30,18:45,,,0,36.93,36.93,0,-58011,47292,105303,-10719,0,0,0,0,0,,0,0
40,10-01-17,76,18:45,19:00,36.54,,0,36.54,36.54,1,-65061,48271,113332,-16790,0,0,3239,0,0,,3239,3239
40,10-01-17,77,19:00,19:15,36.54,29.06,0,29.06,29.06,-1,-34117,47239,81356,13122,0,-2534,574,0,0,,3108,-1960
40,10-01-17,78,19:15,19:30,,,0,36.97,36.97,0,-73123,37627,110750,-35496,0,-7,0,0,0,,7,-7
40,10-01-17,79,19:30,19:45,,,0,36.94,36.94,0,-94802,31699,126501,-63103,0,0,0,0,0,,0,0
40,10-01-17,80,19:45,20:00,31.06,,0,31.06,31.06,1,-90437,22898,113335,-67539,0,0,223,0,0,,223,223
40,10-01-17,81,20:00,20:15,56.1,,0,56.1,56.1,1,-88582,43418,132000,-45164,0,0,6179,0,0,,6179,6179
40,10-01-17,82,20:15,20:30,31.06,,0,31.06,31.06,1,-79760,50769,130529,-28991,0,0,831,0,0,,831,831
40,10-01-17,83,20:30,20:45,,24.06,0,24.06,24.06,-1,-59343,68931,128274,9588,0,-10220,0,0,0,,10220,-10220
40,10-01-17,84,20:45,21:00,,23.82,0,23.82,23.82,-1,-49662,70094,119756,20432,0,-18828,0,0,0,,18828,-18828
40,10-01-17,85,21:00,21:15,47.06,23.82,0,47.06,47.06,1,-77191,31556,108747,-45635,0,-754,8219,0,0,,8973,7465
40,10-01-17,86,21:15,21:30,32,,0,32,32,1,-64046,33416,97462,-30630,0,0,3335,0,0,,3335,3335
40,10-01-17,87,21:30,21:45,31.06,28.06,0,36.95,28.06,2,-44096,53322,97418,9226,0,-1405,597,0,0,,2002,-808
40,10-01-17,88,21:45,22:00,,28.95,0,28.95,28.95,-1,-41526,47309,88835,5783,0,-4573,0,0,0,,4573,-4573
40,10-01-17,89,22:00,22:15,,46.98,0,46.98,46.98,-1,-100124,35435,135559,-64689,0,-1075,0,0,0,,1075,-1075
40,10-01-17,90,22:15,22:30,,,0,39.02,39.02,0,-82606,14718,97324,-67888,0,0,0,0,0,,0,0
40,10-01-17,91,22:30,22:45,31.06,,0,31.06,31.06,1,-42768,24209,66977,-18559,0,0,137,0,0,,137,137
40,10-01-17,92,22:45,23:00,,27.64,0,27.64,27.64,-1,-43683,60807,104490,17124,0,-5800,0,0,0,,5800,-5800
40,10-01-17,93,23:00,23:15,32.02,24.06,0,32.02,24.06,2,-55728,56799,112527,1071,0,-6067,247,0,0,,6314,-5820
40,10-01-17,94,23:15,23:30,,,0,31.16,31.16,0,-50258,25239,75497,-25019,0,0,22,0,0,,22,22
40,10-01-17,95,23:30,23:45,,29.06,0,29.06,29.06,-1,-38949,45738,84687,6789,0,-121,0,0,0,,121,-121
40,10-01-17,96,23:45,0:00,,25.24,0,25.24,25.24,-1,-55071,64584,119655,9513,0,-8786,0,0,0,,8786,-8786
40,10-02-17,1,0:00,0:15,41.06,25.24,0,41.06,41.06,1,-52293,50579,102872,-1714,0,-997,8671,0,0,,9668,7674
40,10-02-17,2,0:15,0:30,44.04,,0,44.04,44.04,1,-51304,27796,79100,-23508,0,0,21050,0,0,,21050,21050
40,10-02-17,3,0:30,0:45,41.06,,0,41.06,41.06,1,-57502,27895,85397,-29607,0,0,26956,0,0,,26956,26956
40,10-02-17,4,0:45,1:00,27.93,14.06,0,14.06,14.06,-1,-42860,38207,81067,-4653,0,-2415,10995,0,0,,13410,8580
40,10-02-17,5,1:00,1:15,125.92,-72.8,0,125.92,-72.8,2,-67082,50667,117749,-16415,0,-16816,7685,0,0,,24501,-9131
40,10-02-17,6,1:15,1:30,116.5,28.06,0,116.5,28.06,2,-36255,46767,83022,10512,0,-154,13087,0,0,,13241,12933
40,10-02-17,7,1:30,1:45,,30.16,0,30.16,30.16,-1,-27353,44414,71767,17061,0,-545,0,0,0,,545,-545
40,10-02-17,8,1:45,2:00,,21.34,0,21.34,21.34,-1,-35635,56656,92291,21021,0,-7774,0,0,0,,7774,-7774
40,10-02-17,9,2:00,2:15,30.15,30.95,0,30.24,30.24,2,-44925,66697,111622,21772,0,-5081,233,0,0,,5314,-4848
40,10-02-17,10,2:15,2:30,,22.52,0,22.52,22.52,-1,-35492,54350,89842,18858,0,-4672,0,0,0,,4672,-4672
40,10-02-17,11,2:30,2:45,,31.35,0,31.35,31.35,-1,-35658,39122,74780,3464,0,-1011,0,0,0,,1011,-1011
40,10-02-17,12,2:45,3:00,,30.99,0,30.99,30.99,-1,-38533,47244,85777,8711,0,-42,0,0,0,,42,-42
40,10-02-17,13,3:00,3:15,,25.64,0,25.64,25.64,-1,-30340,49471,79811,19131,0,-1804,0,0,0,,1804,-1804
40,10-02-17,14,3:15,3:30,,25.64,0,25.64,25.64,-1,-29441,44884,74325,15443,0,-4197,0,0,0,,4197,-4197
40,10-02-17,15,3:30,3:45,,31.03,0,31.03,31.03,-1,-25948,29868,55816,3920,0,-994,0,0,0,,994,-994
40,10-02-17,16,3:45,4:00,,,0,30.24,30.24,0,-27044,30129,57173,3085,0,0,0,0,0,,0,0
40,10-02-17,17,4:00,4:15,,-9.47,0,-9.47,-9.47,-1,-34377,85066,119443,50689,0,-10257,0,0,0,,10257,-10257
40,10-02-17,18,4:15,4:30,,5.53,0,5.53,5.53,-1,-28947,62310,91257,33363,0,-12392,0,0,0,,12392,-12392
40,10-02-17,19,4:30,4:45,31.06,15.53,0,31.06,31.06,1,-37757,51974,89731,14217,0,-11048,148,0,0,,11196,-10900
40,10-02-17,20,4:45,5:00,31.06,15.53,0,31.06,31.06,1,-53442,58930,112372,5488,0,-203,1928,0,0,,2131,1725
40,10-02-17,21,5:00,5:15,31.06,25.81,0,25.81,25.81,-1,-48756,107383,156139,58627,0,-1012,19,0,0,,1031,-993
40,10-02-17,22,5:15,5:30,,,0,30.26,30.26,0,-36569,61925,98494,25356,0,-187,0,0,0,,187,-187
40,10-02-17,23,5:30,5:45,31.4,,0,31.4,31.4,1,-52062,45570,97632,-6492,0,0,487,0,0,,487,487
40,10-02-17,24,5:45,6:00,28.99,15.81,0,30.15,15.81,2,-37993,78780,116773,40787,0,-546,243,0,0,,789,-303
40,10-02-17,25,6:00,6:15,,23.01,0,23.01,23.01,-1,-131117,59293,190410,-71824,0,-3187,0,0,0,,3187,-3187
40,10-02-17,26,6:15,6:30,50.86,,0,50.86,50.86,1,-71562,22048,93610,-49514,0,0,4115,0,0,,4115,4115
40,10-02-17,27,6:30,6:45,32.19,27.99,0,32.19,27.99,2,-52074,59619,111693,7545,0,-1106,2029,0,0,,3135,923
40,10-02-17,28,6:45,7:00,,29.85,0,29.85,29.85,-1,-83514,88789,172303,5275,0,-62,0,0,0,,62,-62
40,10-02-17,29,7:00,7:15,,7.65,0,7.65,7.65,-1,-49838,121379,171217,71541,0,-17617,0,0,0,,17617,-17617
40,10-02-17,30,7:15,7:30,,30.15,0,30.15,30.15,-1,-36975,69040,106015,32065,0,-8288,0,0,0,,8288,-8288
40,10-02-17,31,7:30,7:45,,27.58,0,27.58,27.58,-1,-65184,59656,124840,-5528,0,-4668,0,0,0,,4668,-4668
40,10-02-17,32,7:45,8:00,,,0,31.22,31.22,0,-103013,64830,167843,-38183,0,-247,0,0,0,,247,-247
40,10-02-17,33,8:00,8:15,30.99,,0,30.99,30.99,1,-96220,23927,120147,-72293,0,0,11,0,0,,11,11
40,10-02-17,34,8:15,8:30,,,0,31.27,31.27,0,-87211,20646,107857,-66565,0,0,0,0,0,,0,0
40,10-02-17,35,8:30,8:45,30.99,,0,30.99,30.99,1,-119775,31939,151714,-87836,0,0,32,0,0,,32,32
40,10-02-17,36,8:45,9:00,81.52,,0,81.52,81.52,1,-160741,32296,193037,-128445,0,0,11817,0,0,,11817,11817
40,10-02-17,37,9:00,9:15,88.21,,0,88.21,88.21,1,-141408,29927,171335,-111481,0,0,28967,0,0,,28967,28967
40,10-02-17,38,9:15,9:30,50.5,,0,50.5,50.5,1,-139244,41069,180313,-98175,0,0,7065,0,0,,7065,7065
40,10-02-17,39,9:30,9:45,37.8,,0,37.8,37.8,1,-127536,36100,163636,-91436,0,0,7726,0,0,,7726,7726
40,10-02-17,40,9:45,10:00,30.99,,0,30.99,30.99,1,-93559,47233,140792,-46326,0,0,2707,0,0,,2707,2707
40,10-02-17,41,10:00,10:15,34.99,,0,34.99,34.99,1,-104740,72703,177443,-32037,0,0,1788,0,0,,1788,1788
40,10-02-17,42,10:15,10:30,34.99,27.99,0,27.99,27.99,-1,-76315,82955,159270,6640,0,-1328,45,0,0,,1373,-1283
40,10-02-17,43,10:30,10:45,,13,0,13,13,-1,-57872,95921,153793,38049,0,-12453,0,0,0,,12453,-12453
40,10-02-17,44,10:45,11:00,,6.77,0,6.77,6.77,-1,-50510,112810,163320,62300,0,-48023,0,0,0,,48023,-48023
40,10-02-17,45,11:00,11:15,41,3.21,0,41,3.21,2,-83230,90751,173981,7521,0,-30658,738,0,0,,31396,-29920
40,10-02-17,46,11:15,11:30,41,12.63,0,12.63,12.63,-1,-71909,100303,172212,28394,0,-9772,150,0,0,,9922,-9622
40,10-02-17,47,11:30,11:45,,25.29,0,25.29,25.29,-1,-77218,92511,169729,15293,0,-18963,0,0,0,,18963,-18963
40,10-02-17,48,11:45,12:00,,27.14,0,27.14,27.14,-1,-65780,97133,162913,31353,0,-7008,0,0,0,,7008,-7008
40,10-02-17,49,12:00,12:15,,28.99,0,28.99,28.99,-1,-77621,79808,157429,2187,0,-4674,0,0,0,,4674,-4674
40,10-02-17,50,12:15,12:30,,26.82,0,26.82,26.82,-1,-63299,89544,152843,26245,0,-3905,0,0,0,,3905,-3905
40,10-02-17,51,12:30,12:45,,26.97,0,26.97,26.97,-1,-52506,109893,162399,57387,0,-7039,0,0,0,,7039,-7039
40,10-02-17,52,12:45,13:00,,23.81,0,23.81,23.81,-1,-59308,104234,163542,44926,0,-12639,0,0,0,,12639,-12639
40,10-02-17,53,13:00,13:15,32.78,23.04,0,32.78,32.78,1,-72883,72631,145514,-252,0,-14078,161,0,0,,14239,-13917
40,10-02-17,54,13:15,13:30,32.74,23.04,0,32.74,32.74,1,-99993,64299,164292,-35694,0,-422,476,0,0,,898,54
40,10-02-17,55,13:30,13:45,,,0,31.22,31.22,0,-98130,62648,160778,-35482,0,0,0,0,0,,0,0
40,10-02-17,56,13:45,14:00,,,0,31.24,31.24,0,-109409,77039,186448,-32370,0,0,0,0,0,,0,0
40,10-02-17,57,14:00,14:15,,,0,31.22,31.22,0,-82296,106650,188946,24354,0,0,0,0,0,,0,0
40,10-02-17,58,14:15,14:30,33.74,,0,33.74,33.74,1,-97700,88164,185864,-9536,0,0,310,0,0,,310,310
40,10-02-17,59,14:30,14:45,,,0,31.22,31.22,0,-96953,77016,173969,-19937,0,0,28,0,0,,28,28
40,10-02-17,60,14:45,15:00,,,0,31.24,31.24,0,-112385,89100,201485,-23285,0,0,0,0,0,,0,0
40,10-02-17,61,15:00,15:15,,,0,31.23,31.23,0,-88558,91945,180503,3387,0,0,0,0,0,,0,0
40,10-02-17,62,15:15,15:30,32.83,,0,32.83,32.83,1,-98285,71670,169955,-26615,0,0,173,0,0,,173,173
40,10-02-17,63,15:30,15:45,50.76,,0,50.76,50.76,1,-127999,61246,189245,-66753,0,0,7976,0,0,,7976,7976
40,10-02-17,64,15:45,16:00,42.08,,0,42.08,42.08,1,-118306,63649,181955,-54657,0,0,3738,0,0,,3738,3738
40,10-02-17,65,16:00,16:15,46.99,,0,46.99,46.99,1,-99468,50968,150436,-48500,0,0,10867,0,0,,10867,10867
40,10-02-17,66,16:15,16:30,,,0,31.23,31.23,0,-82177,48513,130690,-33664,0,0,2860,0,0,,2860,2860
40,10-02-17,67,16:30,16:45,71.21,,0,71.21,71.21,1,-92330,43843,136173,-48487,0,0,8236,0,0,,8236,8236
40,10-02-17,68,16:45,17:00,335.7,,0,335.7,335.7,1,-96441,63573,160014,-32868,0,0,40070,0,0,,40070,40070
40,10-02-17,69,17:00,17:15,50.53,8.72,0,50.53,8.72,2,-67256,48720,115976,-18536,0,-6014,5782,0,0,,11796,-232
40,10-02-17,70,17:15,17:30,356.68,8.72,0,356.68,356.68,1,-96927,25273,122200,-71654,0,-68,44841,0,0,,44909,44773
40,10-02-17,71,17:30,17:45,46.99,,0,46.99,46.99,1,-92950,72394,165344,-20556,0,0,26953,0,0,,26953,26953
40,10-02-17,72,17:45,18:00,171.32,,0,171.32,171.32,1,-96588,54160,150748,-42428,0,0,20578,0,0,,20578,20578
40,10-02-17,73,18:00,18:15,307.18,28.38,0,307.18,28.38,2,-108699,73974,182673,-34725,0,-135,36708,0,0,,36843,36573
40,10-02-17,74,18:15,18:30,34.99,23.33,0,34.99,23.33,2,-68959,87912,156871,18953,0,-1932,1486,0,0,,3418,-446
40,10-02-17,75,18:30,18:45,70.87,11.86,0,70.87,11.86,2,-65798,50433,116231,-15365,0,-4591,3425,0,0,,8016,-1166
40,10-02-17,76,18:45,19:00,347.11,,0,347.11,347.11,1,-103290,56457,159747,-46833,0,0,47588,0,0,,47588,47588
40,10-02-17,77,19:00,19:15,37.11,2.43,0,37.11,2.43,2,-79560,81481,161041,1921,0,-3956,14505,0,0,,18461,10549
40,10-02-17,78,19:15,19:30,73.42,,0,73.42,73.42,1,-107188,77119,184307,-30069,0,0,15827,0,0,,15827,15827
40,10-02-17,79,19:30,19:45,359.62,,0,359.62,359.62,1,-130263,65056,195319,-65207,0,0,38524,0,0,,38524,38524
40,10-02-17,80,19:45,20:00,51,,0,51,51,1,-112915,78107,191022,-34808,0,0,26382,0,0,,26382,26382
40,10-02-17,81,20:00,20:15,51,13.99,0,13.99,13.99,-1,-112298,129156,241454,16858,0,-5469,3579,0,0,,9048,-1890
40,10-02-17,82,20:15,20:30,30.99,25.21,0,31.25,25.21,2,-91493,96462,187955,4969,0,-1813,67,0,0,,1880,-1746
40,10-02-17,83,20:30,20:45,30.99,23.99,0,23.99,23.99,-1,-83014,95678,178692,12664,0,-5309,240,0,0,,5549,-5069
40,10-02-17,84,20:45,21:00,,13.99,0,13.99,13.99,-1,-80549,113114,193663,32565,0,-26343,0,0,0,,26343,-26343
40,10-02-17,85,21:00,21:15,183.2,2.21,0,183.2,183.2,1,-82181,55950,138131,-26231,0,-16740,8700,0,0,,25440,-8040
40,10-02-17,86,21:15,21:30,36.99,28.99,0,28.99,28.99,-1,-57587,65297,122884,7710,0,-142,10122,0,0,,10264,9980
40,10-02-17,87,21:30,21:45,36.99,13.99,0,13.99,13.99,-1,-44319,109231,153550,64912,0,-1402,119,0,0,,1521,-1283
40,10-02-17,88,21:45,22:00,,-2.91,0,-2.91,-2.91,-1,-56478,116599,173077,60121,0,-34462,0,0,0,,34462,-34462
40,10-02-17,89,22:00,22:15,35.62,23.99,0,35.62,35.62,1,-76075,52540,128615,-23535,0,-20390,962,0,0,,21352,-19428
40,10-02-17,90,22:15,22:30,35.62,23.99,0,23.99,23.99,-1,-46461,60678,107139,14217,0,-1321,481,0,0,,1802,-840
40,10-02-17,91,22:30,22:45,,23.45,0,23.45,23.45,-1,-37898,81294,119192,43396,0,-3889,0,0,0,,3889,-3889
40,10-02-17,92,22:45,23:00,,28.99,0,28.99,28.99,-1,-51670,68982,120652,17312,0,-348,0,0,0,,348,-348
40,10-02-17,93,23:00,23:15,,,0,29.65,29.65,0,-77709,42194,119903,-35515,0,-118,0,0,0,,118,-118
40,10-02-17,94,23:15,23:30,,,0,29.65,29.65,0,-89571,23957,113528,-65614,0,0,0,0,0,,0,0
40,10-02-17,95,23:30,23:45,231.04,,0,231.04,231.04,1,-116332,33123,149455,-83209,0,0,16062,0,0,,16062,16062
40,10-02-17,96,23:45,0:00,231.04,28.25,0,231.04,28.25,2,-82757,67165,149922,-15592,0,-838,29246,0,0,,30084,28408
40,10-03-17,1,0:00,0:15,34.99,28.25,0,34.99,34.99,1,-55123,30476,85599,-24647,0,-221,4355,0,0,,4576,4134
40,10-03-17,2,0:15,0:30,36.86,29.03,0,36.86,29.03,2,-51958,48264,100222,-3694,0,-304,7018,0,0,,7322,6714
40,10-03-17,3,0:30,0:45,56.37,,0,56.37,56.37,1,-66387,48514,114901,-17873,0,0,16187,0,0,,16187,16187
40,10-03-17,4,0:45,1:00,31.33,22.49,0,31.33,22.49,2,-64545,81409,145954,16864,0,-9203,2116,0,0,,11319,-7087
40,10-03-17,5,1:00,1:15,41.55,22.49,0,41.55,41.55,1,-58342,39147,97489,-19195,0,-1129,13715,0,0,,14844,12586
40,10-03-17,6,1:15,1:30,30.99,,0,30.99,30.99,1,-36563,44749,81312,8186,0,0,2066,0,0,,2066,2066
40,10-03-17,7,1:30,1:45,31.26,,0,31.26,31.26,1,-15838,41625,57463,25787,0,0,665,0,0,,665,665
40,10-03-17,8,1:45,2:00,,,0,31.94,31.94,0,-25781,54229,80010,28448,0,0,35,0,0,,35,35
40,10-03-17,9,2:00,2:15,46.99,,0,46.99,46.99,1,-39199,29497,68696,-9702,0,0,2437,0,0,,2437,2437
40,10-03-17,10,2:15,2:30,46.99,30.86,0,46.99,30.86,2,-30634,46063,76697,15429,0,-65,8633,0,0,,8698,8568
40,10-03-17,11,2:30,2:45,,30.88,0,30.88,30.88,-1,-21726,33154,54880,11428,0,-52,0,0,0,,52,-52
40,10-03-17,12,2:45,3:00,40.99,,0,40.99,40.99,1,-43068,29384,72452,-13684,0,0,3312,0,0,,3312,3312
40,10-03-17,13,3:00,3:15,40.99,28.99,0,28.99,28.99,-1,-16404,124633,141037,108229,0,-647,13,0,0,,660,-634
40,10-03-17,14,3:15,3:30,,,0,30.07,30.07,0,-24733,52022,76755,27289,0,0,0,0,0,,0,0
40,10-03-17,15,3:30,3:45,,,0,30.07,30.07,0,-29985,33985,63970,4000,0,0,0,0,0,,0,0
40,10-03-17,16,3:45,4:00,29.39,,0,29.39,29.39,1,-36972,29728,66700,-7244,0,0,232,0,0,,232,232
40,10-03-17,17,4:00,4:15,,,0,30.17,30.17,0,-13492,88668,102160,75176,0,0,61,0,0,,61,61
40,10-03-17,18,4:15,4:30,,,0,30.17,30.17,0,-16324,56632,72956,40308,0,0,0,0,0,,0,0
40,10-03-17,19,4:30,4:45,,,0,30.17,30.17,0,-22339,35420,57759,13081,0,0,0,0,0,,0,0
40,10-03-17,20,4:45,5:00,,,0,30.17,30.17,0,-27623,55387,83010,27764,0,0,0,0,0,,0,0
40,10-03-17,21,5:00,5:15,,15.86,0,15.86,15.86,-1,-21570,61688,83258,40118,0,-5932,0,0,0,,5932,-5932
40,10-03-17,22,5:15,5:30,34.99,14.34,0,34.99,34.99,1,-27573,40433,68006,12860,0,-13032,189,0,0,,13221,-12843
40,10-03-17,23,5:30,5:45,34.99,14.34,0,34.99,34.99,1,-34334,25366,59700,-8968,0,-117,3511,0,0,,3628,3394
40,10-03-17,24,5:45,6:00,33.22,30.93,0,33.22,30.12,2,-41791,89659,131450,47868,0,-122,3121,0,0,,3243,2999
40,10-03-17,25,6:00,6:15,33.22,24.1,0,24.1,24.1,-1,-64050,64397,128447,347,0,-2671,17,0,0,,2688,-2654
40,10-03-17,26,6:15,6:30,,17.75,0,17.75,17.75,-1,-42500,54538,97038,12038,0,-20707,0,0,0,,20707,-20707
40,10-03-17,27,6:30,6:45,31.37,17.75,0,31.37,31.37,1,-62289,39879,102168,-22410,0,-1277,759,0,0,,2036,-518
40,10-03-17,28,6:45,7:00,,13.72,0,13.72,13.72,-1,-68755,77168,145923,8413,0,-1216,0,0,0,,1216,-1216
40,10-03-17,29,7:00,7:15,,9.03,0,9.03,9.03,-1,-53604,98679,152283,45075,0,-26270,0,0,0,,26270,-26270
40,10-03-17,30,7:15,7:30,30.72,28.02,0,31.81,28.02,2,-76725,86456,163181,9731,0,-20035,41,0,0,,20076,-19994
40,10-03-17,31,7:30,7:45,32.24,29.33,0,32.24,29.33,2,-65589,66297,131886,708,0,-1247,1329,0,0,,2576,82
40,10-03-17,32,7:45,8:00,,28.03,0,28.03,28.03,-1,-60256,79804,140060,19548,0,-972,0,0,0,,972,-972
40,10-03-17,33,8:00,8:15,34.72,28.03,0,34.72,34.72,1,-59431,41599,101030,-17832,0,-22,327,0,0,,349,305
40,10-03-17,34,8:15,8:30,30.72,,0,30.72,30.72,1,-60941,47128,108069,-13813,0,0,136,0,0,,136,136
40,10-03-17,35,8:30,8:45,33.43,,0,33.43,33.43,1,-91271,43076,134347,-48195,0,0,1250,0,0,,1250,1250
40,10-03-17,36,8:45,9:00,,,0,40.18,40.18,0,-95984,36252,132236,-59732,0,0,0,0,0,,0,0
40,10-03-17,37,9:00,9:15,,,0,31.43,31.43,0,-87568,79407,166975,-8161,0,0,0,0,0,,0,0
40,10-03-17,38,9:15,9:30,,,0,31.43,31.43,0,-82539,86526,169065,3987,0,0,0,0,0,,0,0
40,10-03-17,39,9:30,9:45,,,0,31.43,31.43,0,-82809,95513,178322,12704,0,0,0,0,0,,0,0
40,10-03-17,40,9:45,10:00,,30.61,0,30.61,30.61,-1,-86999,109425,196424,22426,0,-452,0,0,0,,452,-452
40,10-03-17,41,10:00,10:15,,7.8,0,7.8,7.8,-1,-66613,93851,160464,27238,0,-5355,0,0,0,,5355,-5355
40,10-03-17,42,10:15,10:30,,6.88,0,6.88,6.88,-1,-58050,82845,140895,24795,0,-29348,0,0,0,,29348,-29348
40,10-03-17,43,10:30,10:45,,27.09,0,27.09,27.09,-1,-39919,88852,128771,48933,0,-24051,0,0,0,,24051,-24051
40,10-03-17,44,10:45,11:00,,11.93,0,11.93,11.93,-1,-32239,91223,123462,58984,0,-38242,0,0,0,,38242,-38242
40,10-03-17,45,11:00,11:15,44.26,29.54,0,44.26,29.54,2,-85289,51764,137053,-33525,0,-13259,3063,0,0,,16322,-10196
40,10-03-17,46,11:15,11:30,34.72,,0,34.72,34.72,1,-80356,72403,152759,-7953,0,0,2117,0,0,,2117,2117
40,10-03-17,47,11:30,11:45,30.72,28.03,0,28.03,28.03,-1,-75004,85813,160817,10809,0,-926,1028,0,0,,1954,102
40,10-03-17,48,11:45,12:00,30.72,27.06,0,31.42,27.06,2,-68190,80951,149141,12761,0,-8344,66,0,0,,8410,-8278
40,10-03-17,49,12:00,12:15,34.72,27.06,0,34.72,34.72,1,-71619,52934,124553,-18685,0,-42,3357,0,0,,3399,3315
40,10-03-17,50,12:15,12:30,,27.06,0,27.06,27.06,-1,-66663,86607,153270,19944,0,-8140,0,0,0,,8140,-8140
40,10-03-17,51,12:30,12:45,,23.72,0,23.72,23.72,-1,-71076,97364,168440,26288,0,-18524,0,0,0,,18524,-18524
40,10-03-17,52,12:45,13:00,34.72,30.57,0,34.72,30.57,2,-86060,94685,180745,8625,0,-4563,759,0,0,,5322,-3804
40,10-03-17,53,13:00,13:15,,27.72,0,27.72,27.72,-1,-66500,97188,163688,30688,0,-8502,0,0,0,,8502,-8502
40,10-03-17,54,13:15,13:30,,27.72,0,27.72,27.72,-1,-68743,96959,165702,28216,0,-10891,0,0,0,,10891,-10891
40,10-03-17,55,13:30,13:45,,27.72,0,27.72,27.72,-1,-75888,81760,157648,5872,0,-7189,0,0,0,,7189,-7189
40,10-03-17,56,13:45,14:00,,16.98,0,16.98,16.98,-1,-75957,100081,176038,24124,0,-5992,0,0,0,,5992,-5992
40,10-03-17,57,14:00,14:15,35.07,13.72,0,35.07,13.72,2,-82532,68325,150857,-14207,0,-10309,824,0,0,,11133,-9485
40,10-03-17,58,14:15,14:30,,,0,31.81,31.81,0,-74035,73627,147662,-408,0,-16,0,0,0,,16,-16
40,10-03-17,59,14:30,14:45,,28.72,0,28.72,28.72,-1,-69582,75153,144735,5571,0,-113,0,0,0,,113,-113
40,10-03-17,60,14:45,15:00,,27.72,0,27.72,27.72,-1,-68681,72150,140831,3469,0,-3632,0,0,0,,3632,-3632
40,10-03-17,61,15:00,15:15,,27.72,0,27.72,27.72,-1,-66845,61846,128691,-4999,0,-2435,0,0,0,,2435,-2435
40,10-03-17,62,15:15,15:30,61.29,,0,61.29,61.29,1,-94127,40513,134640,-53614,0,0,6830,0,0,,6830,6830
40,10-03-17,63,15:30,15:45,34.72,,0,34.72,34.72,1,-83475,63463,146938,-20012,0,0,5798,0,0,,5798,5798
40,10-03-17,64,15:45,16:00,,30.79,0,30.79,30.79,-1,-78336,69071,147407,-9265,0,-29,0,0,0,,29,-29
40,10-03-17,65,16:00,16:15,,1.81,0,1.81,1.81,-1,-57658,99630,157288,41972,0,-24777,0,0,0,,24777,-24777
40,10-03-17,66,16:15,16:30,,27.72,0,27.72,27.72,-1,-59013,74284,133297,15271,0,-11055,0,0,0,,11055,-11055
40,10-03-17,67,16:30,16:45,,29.03,0,29.03,29.03,-1,-63250,80461,143711,17211,0,-673,0,0,0,,673,-673
40,10-03-17,68,16:45,17:00,34.72,30.33,0,40.3,30.33,2,-71413,67005,138418,-4408,0,-317,421,0,0,,738,104
40,10-03-17,69,17:00,17:15,,1.84,0,1.84,1.84,-1,-48789,87971,136760,39182,0,-17596,0,0,0,,17596,-17596
40,10-03-17,70,17:15,17:30,67.02,32.37,0,67.02,67.02,1,-61698,38355,100053,-23343,0,-3902,11808,0,0,,15710,7906
40,10-03-17,71,17:30,17:45,37.26,,0,37.26,37.26,1,-61100,41805,102905,-19295,0,0,20923,0,0,,20923,20923
40,10-03-17,72,17:45,18:00,35.85,,0,35.85,35.85,1,-72369,40215,112584,-32154,0,0,22440,0,0,,22440,22440
40,10-03-17,73,18:00,18:15,33.8,22.99,0,22.99,22.99,-1,-66513,77833,144346,11320,0,-3328,7093,0,0,,10421,3765
40,10-03-17,74,18:15,18:30,34.72,22.03,0,40.31,22.03,2,-48295,68581,116876,20286,0,-9928,356,0,0,,10284,-9572
40,10-03-17,75,18:30,18:45,,13.72,0,13.72,13.72,-1,-42740,86041,128781,43301,0,-11937,0,0,0,,11937,-11937
40,10-03-17,76,18:45,19:00,34.72,27.72,0,40.3,27.72,2,-53739,54536,108275,797,0,-12320,380,0,0,,12700,-11940
40,10-03-17,77,19:00,19:15,,-43.23,0,-43.23,-43.23,-1,-49574,115326,164900,65752,0,-25183,0,0,0,,25183,-25183
40,10-03-17,78,19:15,19:30,34.72,49.6,0,40.26,40.26,2,-78474,74995,153469,-3479,0,-4455,303,0,0,,4758,-4152
40,10-03-17,79,19:30,19:45,89.02,,0,89.02,89.02,1,-97324,56630,153954,-40694,0,0,23426,0,0,,23426,23426
40,10-03-17,80,19:45,20:00,54,,0,54,54,1,-85957,52479,138436,-33478,0,0,23567,0,0,,23567,23567
40,10-03-17,81,20:00,20:15,53.37,,0,53.37,53.37,1,-66833,50685,117518,-16148,0,0,27206,0,0,,27206,27206
40,10-03-17,82,20:15,20:30,53.37,27.72,0,27.72,27.72,-1,-57262,48813,106075,-8449,0,-2174,7546,0,0,,9720,5372
40,10-03-17,83,20:30,20:45,,12.24,0,12.24,12.24,-1,-57234,70494,127728,13260,0,-5619,0,0,0,,5619,-5619
40,10-03-17,84,20:45,21:00,,11.96,0,11.96,11.96,-1,-67002,81002,148004,14000,0,-19305,0,0,0,,19305,-19305
40,10-03-17,85,21:00,21:15,388,11.96,0,388,388,1,-83471,37272,120743,-46199,0,-1449,19778,0,0,,21227,18329
40,10-03-17,86,21:15,21:30,36.75,27.72,0,27.72,27.72,-1,-66713,63489,130202,-3224,0,-822,12174,0,0,,12996,11352
40,10-03-17,87,21:30,21:45,,-3.68,0,-3.68,-3.68,-1,-52547,88320,140867,35773,0,-17135,0,0,0,,17135,-17135
40,10-03-17,88,21:45,22:00,,-1.2,0,-1.2,-1.2,-1,-76162,75190,151352,-972,0,-27124,0,0,0,,27124,-27124
40,10-03-17,89,22:00,22:15,46.72,28.72,0,46.72,46.72,1,-64423,53248,117671,-11175,0,-2141,9359,0,0,,11500,7218
40,10-03-17,90,22:15,22:30,46.72,30.93,0,30.93,30.93,-1,-50692,30451,81143,-20241,0,-1,18877,0,0,,18878,18876
40,10-03-17,91,22:30,22:45,46.72,-3.99,0,-3.99,-3.99,-1,-41461,80267,121728,38806,0,-24756,799,0,0,,25555,-23957
40,10-03-17,92,22:45,23:00,,10.26,0,10.26,10.26,-1,-42007,98740,140747,56733,0,-63424,0,0,0,,63424,-63424
40,10-03-17,93,23:00,23:15,96.54,10.26,0,96.54,96.54,1,-79529,33274,112803,-46255,0,-18954,7468,0,0,,26422,-11486
40,10-03-17,94,23:15,23:30,96.54,23.72,0,23.72,23.72,-1,-42252,46854,89106,4602,0,-2477,564,0,0,,3041,-1913
40,10-03-17,95,23:30,23:45,,16.16,0,16.16,16.16,-1,-56326,66461,122787,10135,0,-17091,0,0,0,,17091,-17091
40,10-03-17,96,23:45,0:00,,27.72,0,27.72,27.72,-1,-62154,54914,117068,-7240,0,-17379,0,0,0,,17379,-17379
40,10-04-17,1,0:00,0:15,113.61,27.72,0,113.61,113.61,1,-53785,26046,79831,-27739,0,-4511,15041,0,0,,19552,10530
40,10-04-17,2,0:15,0:30,45.56,,0,45.56,45.56,1,-64641,32974,97615,-31667,0,0,15575,0,0,,15575,15575
40,10-04-17,3,0:30,0:45,35.19,29.46,0,37.78,29.46,2,-48817,30142,78959,-18675,0,-295,14762,0,0,,15057,14467
40,10-04-17,4,0:45,1:00,35.19,24.19,0,24.19,24.19,-1,-42846,57937,100783,15091,0,-18990,734,0,0,,19724,-18256
40,10-04-17,5,1:00,1:15,41.19,28.98,0,41.19,41.19,1,-87615,21793,109408,-65822,0,-10892,3478,0,0,,14370,-7414
40,10-04-17,6,1:15,1:30,32.36,25.85,0,25.85,25.85,-1,-37870,18906,56776,-18964,0,-1581,3221,0,0,,4802,1640
40,10-04-17,7,1:30,1:45,,24.19,0,24.19,24.19,-1,-36118,59118,95236,23000,0,-6958,0,0,0,,6958,-6958
40,10-04-17,8,1:45,2:00,,18.86,0,18.86,18.86,-1,-45197,93182,138379,47985,0,-37221,0,0,0,,37221,-37221
40,10-04-17,9,2:00,2:15,60.38,25.99,0,60.38,60.38,1,-38390,24401,62791,-13989,0,-22452,4174,0,0,,26626,-18278
40,10-04-17,10,2:15,2:30,33.41,25.99,0,33.41,33.41,1,-39642,28390,68032,-11252,0,-14,2175,0,0,,2189,2161
40,10-04-17,11,2:30,2:45,32.71,,0,32.71,32.71,1,-26372,30899,57271,4527,0,0,1094,0,0,,1094,1094
40,10-04-17,12,2:45,3:00,32.71,26.71,0,26.71,26.71,-1,-26493,53527,80020,27034,0,-7071,10,0,0,,7081,-7061
40,10-04-17,13,3:00,3:15,35.87,25.96,0,35.87,35.87,1,-30867,31409,62276,542,0,-10585,603,0,0,,11188,-9982
40,10-04-17,14,3:15,3:30,41.19,25.96,0,41.19,41.19,1,-39237,21609,60846,-17628,0,-201,4362,0,0,,4563,4161
40,10-04-17,15,3:30,3:45,48.7,,0,48.7,48.7,1,-41950,15959,57909,-25991,0,0,25394,0,0,,25394,25394
40,10-04-17,16,3:45,4:00,47.19,,0,47.19,47.19,1,-43277,17362,60639,-25915,0,0,8954,0,0,,8954,8954
40,10-04-17,17,4:00,4:15,47.19,24.19,0,24.19,24.19,-1,-68598,83276,151874,14678,0,-998,10445,0,0,,11443,9447
40,10-04-17,18,4:15,4:30,77.52,24.19,0,77.52,24.19,2,-64346,29450,93796,-34896,0,-1275,15910,0,0,,17185,14635
40,10-04-17,19,4:30,4:45,45.23,,0,45.23,45.23,1,-50746,23644,74390,-27102,0,0,20747,0,0,,20747,20747
40,10-04-17,20,4:45,5:00,52.99,24.19,0,52.99,24.19,2,-48757,45319,94076,-3438,0,-315,29617,0,0,,29932,29302
40,10-04-17,21,5:00,5:15,52.99,14.19,0,14.19,14.19,-1,-59707,53504,113211,-6203,0,-5727,3125,0,0,,8852,-2602
40,10-04-17,22,5:15,5:30,,,0,37.78,37.78,0,-68382,26486,94868,-41896,0,0,0,0,0,,0,0
40,10-04-17,23,5:30,5:45,41.19,,0,41.19,41.19,1,-58770,26918,85688,-31852,0,0,1033,0,0,,1033,1033
40,10-04-17,24,5:45,6:00,41.19,,0,41.19,41.19,1,-67973,36505,104478,-31468,0,0,16374,0,0,,16374,16374
40,10-04-17,25,6:00,6:15,41.19,23.03,0,23.03,23.03,-1,-43760,51360,95120,7600,0,-11659,2872,0,0,,14531,-8787
40,10-04-17,26,6:15,6:30,,28.9,0,28.9,28.9,-1,-46431,64604,111035,18173,0,-6403,0,0,0,,6403,-6403
40,10-04-17,27,6:30,6:45,,28.78,0,28.78,28.78,-1,-60338,41765,102103,-18573,0,-1173,0,0,0,,1173,-1173
40,10-04-17,28,6:45,7:00,,2.16,0,2.16,2.16,-1,-77674,99259,176933,21585,0,-5541,0,0,0,,5541,-5541
40,10-04-17,29,7:00,7:15,,-16.08,0,-16.08,-16.08,-1,-60034,94414,154448,34380,0,-44766,0,0,0,,44766,-44766
40,10-04-17,30,7:15,7:30,32.27,-16.08,0,32.27,32.27,1,-66078,49066,115144,-17012,0,-2648,699,0,0,,3347,-1949
40,10-04-17,31,7:30,7:45,,,0,37.65,37.65,0,-71022,26845,97867,-44177,0,0,48,0,0,,48,48
40,10-04-17,32,7:45,8:00,31.02,,0,31.02,31.02,1,-103269,25195,128464,-78074,0,0,132,0,0,,132,132
40,10-04-17,33,8:00,8:15,31.48,,0,31.48,31.48,1,-105186,21530,126716,-83656,0,0,2477,0,0,,2477,2477
40,10-04-17,34,8:15,8:30,55.93,,0,55.93,55.93,1,-103037,14025,117062,-89012,0,0,9350,0,0,,9350,9350
40,10-04-17,35,8:30,8:45,61.93,,0,61.93,61.93,1,-113207,8384,121591,-104823,0,0,20367,0,0,,20367,20367
40,10-04-17,36,8:45,9:00,35.62,,0,35.62,35.62,1,-117134,13422,130556,-103712,0,0,12116,0,0,,12116,12116
40,10-04-17,37,9:00,9:15,35.62,,0,35.62,35.62,1,-104582,52689,157271,-51893,0,0,6916,0,0,,6916,6916
40,10-04-17,38,9:15,9:30,33.84,,0,33.84,33.84,1,-92587,51814,144401,-40773,0,0,5278,0,0,,5278,5278
40,10-04-17,39,9:30,9:45,31.62,,0,31.62,31.62,1,-85997,63982,149979,-22015,0,0,4078,0,0,,4078,4078
40,10-04-17,40,9:45,10:00,,,0,37.71,37.71,0,-75748,64328,140076,-11420,0,0,789,0,0,,789,789
40,10-04-17,41,10:00,10:15,133.39,,0,133.39,133.39,1,-105297,12806,118103,-92491,0,0,30291,0,0,,30291,30291
40,10-04-17,42,10:15,10:30,50.2,,0,50.2,50.2,1,-86161,52736,138897,-33425,0,0,33042,0,0,,33042,33042
40,10-04-17,43,10:30,10:45,39.01,,0,39.01,39.01,1,-71793,48021,119814,-23772,0,0,2577,0,0,,2577,2577
40,10-04-17,44,10:45,11:00,39.17,43.9,0,43.9,43.9,-1,-76100,53365,129465,-22735,0,-31,3446,0,0,,3477,3415
40,10-04-17,45,11:00,11:15,39.17,26.33,0,26.33,26.33,-1,-67354,102923,170277,35569,0,-6285,40,0,0,,6325,-6245
40,10-04-17,46,11:15,11:30,,12.99,0,12.99,12.99,-1,-61102,109941,171043,48839,0,-20096,0,0,0,,20096,-20096
40,10-04-17,47,11:30,11:45,,7.42,0,7.42,7.42,-1,-59099,100845,159944,41746,0,-28368,0,0,0,,28368,-28368
40,10-04-17,48,11:45,12:00,,2.14,0,2.14,2.14,-1,-56191,119024,175215,62833,0,-35779,0,0,0,,35779,-35779
40,10-04-17,49,12:00,12:15,94.12,-0.92,0,94.12,94.12,1,-83018,47475,130493,-35543,0,-33607,8383,0,0,,41990,-25224
40,10-04-17,50,12:15,12:30,33.06,13.67,0,13.67,13.67,-1,-75179,102558,177737,27379,0,-5777,4054,0,0,,9831,-1723
40,10-04-17,51,12:30,12:45,,-8.33,0,-8.33,-8.33,-1,-57046,118163,175209,61117,0,-52347,0,0,0,,52347,-52347
40,10-04-17,52,12:45,13:00,,5.61,0,5.61,5.61,-1,-56641,122039,178680,65398,0,-52752,0,0,0,,52752,-52752
40,10-04-17,53,13:00,13:15,41.62,24.59,0,41.62,41.62,1,-70537,63789,134326,-6748,0,-28458,1179,0,0,,29637,-27279
40,10-04-17,54,13:15,13:30,,,0,37.69,37.69,0,-74843,63167,138010,-11676,0,-103,870,0,0,,973,767
40,10-04-17,55,13:30,13:45,,,0,37.69,37.69,0,-73935,70578,144513,-3357,0,0,0,0,0,,0,0
40,10-04-17,56,13:45,14:00,31.09,,0,31.09,31.09,1,-79237,66698,145935,-12539,0,0,4,0,0,,4,4
40,10-04-17,57,14:00,14:15,31.62,,0,31.62,31.62,1,-63266,60703,123969,-2563,0,0,386,0,0,,386,386
40,10-04-17,58,14:15,14:30,,,0,37.69,37.69,0,-65338,68687,134025,3349,0,0,0,0,0,,0,0
40,10-04-17,59,14:30,14:45,32.99,,0,32.99,32.99,1,-66480,67495,133975,1015,0,0,530,0,0,,530,530
40,10-04-17,60,14:45,15:00,33.08,,0,33.08,33.08,1,-61067,46192,107259,-14875,0,0,684,0,0,,684,684
40,10-04-17,61,15:00,15:15,45.06,,0,45.06,45.06,1,-69792,48428,118220,-21364,0,0,11633,0,0,,11633,11633
40,10-04-17,62,15:15,15:30,34.19,,0,34.19,34.19,1,-76474,55104,131578,-21370,0,0,1295,0,0,,1295,1295
40,10-04-17,63,15:30,15:45,31.62,,0,31.62,31.62,1,-80810,51041,131851,-29769,0,0,735,0,0,,735,735
40,10-04-17,64,15:45,16:00,,,0,31.14,31.14,0,-82303,48983,131286,-33320,0,0,0,0,0,,0,0
40,10-04-17,65,16:00,16:15,,,0,31.14,31.14,0,-70858,73827,144685,2969,0,0,0,0,0,,0,0
40,10-04-17,66,16:15,16:30,37.49,30.83,0,37.49,30.83,2,-68132,59620,127752,-8512,0,-172,1639,0,0,,1811,1467
40,10-04-17,67,16:30,16:45,35.62,,0,35.62,35.62,1,-57621,45255,102876,-12366,0,0,5592,0,0,,5592,5592
40,10-04-17,68,16:45,17:00,47.62,,0,47.62,47.62,1,-60421,47523,107944,-12898,0,0,24795,0,0,,24795,24795
40,10-04-17,69,17:00,17:15,47.62,8.55,0,8.55,8.55,-1,-58018,78119,136137,20101,0,-10789,9036,0,0,,19825,-1753
40,10-04-17,70,17:15,17:30,41.62,28.62,0,41.62,28.62,2,-49714,45210,94924,-4504,0,-6886,4092,0,0,,10978,-2794
40,10-04-17,71,17:30,17:45,35.62,24.62,0,35.62,24.62,2,-48467,68001,116468,19534,0,-2627,7586,0,0,,10213,4959
40,10-04-17,72,17:45,18:00,31.62,22.62,0,31.62,22.62,2,-56670,75093,131763,18423,0,-8578,13,0,0,,8591,-8565
40,10-04-17,73,18:00,18:15,33.74,14.62,0,33.74,14.62,2,-54548,58667,113215,4119,0,-2689,161,0,0,,2850,-2528
40,10-04-17,74,18:15,18:30,31.23,-2.89,0,31.23,-2.89,2,-40032,70969,111001,30937,0,-31634,9,0,0,,31643,-31625
40,10-04-17,75,18:30,18:45,35.56,24.62,0,35.56,24.62,2,-50099,79214,129313,29115,0,-6591,1150,0,0,,7741,-5441
40,10-04-17,76,18:45,19:00,,24.59,0,24.59,24.59,-1,-44135,65465,109600,21330,0,-11143,0,0,0,,11143,-11143
40,10-04-17,77,19:00,19:15,,15.6,0,15.6,15.6,-1,-41926,145602,187528,103676,0,-11654,0,0,0,,11654,-11654
40,10-04-17,78,19:15,19:30,,15.44,0,15.44,15.44,-1,-39848,103772,143620,63924,0,-7435,0,0,0,,7435,-7435
40,10-04-17,79,19:30,19:45,,27.8,0,27.8,27.8,-1,-65247,90868,156115,25621,0,-8973,0,0,0,,8973,-8973
40,10-04-17,80,19:45,20:00,,25.99,0,25.99,25.99,-1,-56450,81239,137689,24789,0,-20326,0,0,0,,20326,-20326
40,10-04-17,81,20:00,20:15,,23.76,0,23.76,23.76,-1,-64719,99524,164243,34805,0,-30458,0,0,0,,30458,-30458
40,10-04-17,82,20:15,20:30,,28.62,0,28.62,28.62,-1,-73047,84405,157452,11358,0,-14969,0,0,0,,14969,-14969
40,10-04-17,83,20:30,20:45,,24.62,0,24.62,24.62,-1,-63802,93547,157349,29745,0,-18777,0,0,0,,18777,-18777
40,10-04-17,84,20:45,21:00,,18.52,0,18.52,18.52,-1,-57653,85356,143009,27703,0,-46029,0,0,0,,46029,-46029
40,10-04-17,85,21:00,21:15,109.29,18.52,0,109.29,109.29,1,-134678,41122,175800,-93556,0,-14569,13693,0,0,,28262,-876
40,10-04-17,86,21:15,21:30,,,0,31.11,31.11,0,-99251,60027,159278,-39224,0,0,2623,0,0,,2623,2623
40,10-04-17,87,21:30,21:45,,,0,31.1,31.1,0,-79697,72590,152287,-7107,0,0,0,0,0,,0,0
40,10-04-17,88,21:45,22:00,,19.7,0,19.7,19.7,-1,-70785,96453,167238,25668,0,-5920,0,0,0,,5920,-5920
40,10-04-17,89,22:00,22:15,49.01,3.78,0,49.01,3.78,2,-102822,41621,144443,-61201,0,-9146,2867,0,0,,12013,-6279
40,10-04-17,90,22:15,22:30,,,0,31.06,31.06,0,-84620,48922,133542,-35698,0,0,71,0,0,,71,71
40,10-04-17,91,22:30,22:45,,14.62,0,14.62,14.62,-1,-61702,79337,141039,17635,0,-4381,0,0,0,,4381,-4381
40,10-04-17,92,22:45,23:00,,4.78,0,4.78,4.78,-1,-69012,92833,161845,23821,0,-40823,0,0,0,,40823,-40823
40,10-04-17,93,23:00,23:15,38.16,4.78,0,38.16,38.16,1,-82892,64371,147263,-18521,0,-10747,1075,0,0,,11822,-9672
40,10-04-17,94,23:15,23:30,,,0,31.06,31.06,0,-97981,32708,130689,-65273,0,0,0,0,0,,0,0
40,10-04-17,95,23:30,23:45,33.06,,0,33.06,33.06,1,-79576,26079,105655,-53497,0,0,246,0,0,,246,246
40,10-04-17,96,23:45,0:00,,,0,31.06,31.06,0,-101546,38900,140446,-62646,0,0,0,0,0,,0,0
40,10-05-17,1,0:00,0:15,35.62,44.38,0,36.7,36.7,2,-81572,62041,143613,-19531,0,-85,750,0,0,,835,665
40,10-05-17,2,0:15,0:30,41.62,,0,41.62,41.62,1,-92595,38843,131438,-53752,0,0,8026,0,0,,8026,8026
40,10-05-17,3,0:30,0:45,41.62,44.52,0,44.52,44.52,-1,-83499,51762,135261,-31737,0,-68,1023,0,0,,1091,955
40,10-05-17,4,0:45,1:00,,44.52,0,44.52,44.52,-1,-97585,58613,156198,-38972,0,-42,0,0,0,,42,-42
40,10-05-17,5,1:00,1:15,139.57,,0,139.57,139.57,1,-126421,17579,144000,-108842,0,0,31488,0,0,,31488,31488
40,10-05-17,6,1:15,1:30,58.02,,0,58.02,58.02,1,-89342,49882,139224,-39460,0,0,38947,0,0,,38947,38947
40,10-05-17,7,1:30,1:45,49.46,,0,49.46,49.46,1,-69796,29053,98849,-40743,0,0,13871,0,0,,13871,13871
40,10-05-17,8,1:45,2:00,35.44,43.95,0,43.95,43.95,-1,-66261,34216,100477,-32045,0,-48,10108,0,0,,10156,10060
40,10-05-17,9,2:00,2:15,31.62,28.03,0,36.25,28.03,2,-90792,94936,185728,4144,0,-4616,112,0,0,,4728,-4504
40,10-05-17,10,2:15,2:30,81.31,,0,81.31,81.31,1,-102892,37383,140275,-65509,0,0,16937,0,0,,16937,16937
40,10-05-17,11,2:30,2:45,,,0,36.25,36.25,0,-81171,51821,132992,-29350,0,0,3209,0,0,,3209,3209
40,10-05-17,12,2:45,3:00,,,0,36.27,36.27,0,-69872,55100,124972,-14772,0,0,0,0,0,,0,0
40,10-05-17,13,3:00,3:15,47.62,,0,47.62,47.62,1,-73186,42177,115363,-31009,0,0,11265,0,0,,11265,11265
40,10-05-17,14,3:15,3:30,47.62,28.62,0,28.62,28.62,-1,-51782,58529,110311,6747,0,-1258,2351,0,0,,3609,1093
40,10-05-17,15,3:30,3:45,,,0,35.73,35.73,0,-52360,48424,100784,-3936,0,0,0,0,0,,0,0
40,10-05-17,16,3:45,4:00,30.88,,0,30.88,30.88,1,-72421,47181,119602,-25240,0,0,6,0,0,,6,6
40,10-05-17,17,4:00,4:15,39.47,,0,39.47,39.47,1,-82615,63309,145924,-19306,0,0,7603,0,0,,7603,7603
40,10-05-17,18,4:15,4:30,38.29,,0,38.29,38.29,1,-86132,66168,152300,-19964,0,0,3060,0,0,,3060,3060
40,10-05-17,19,4:30,4:45,55.73,,0,55.73,55.73,1,-99236,44729,143965,-54507,0,0,33846,0,0,,33846,33846
40,10-05-17,20,4:45,5:00,70.21,,0,70.21,70.21,1,-89689,56899,146588,-32790,0,0,49612,0,0,,49612,49612
40,10-05-17,21,5:00,5:15,70.21,8,0,8,8,-1,-82605,92032,174637,9427,0,-5864,9836,0,0,,15700,3972
40,10-05-17,22,5:15,5:30,,29.62,0,29.62,29.62,-1,-89879,83545,173424,-6334,0,-2521,0,0,0,,2521,-2521
40,10-05-17,23,5:30,5:45,32.05,,0,32.05,32.05,1,-85191,60182,145373,-25009,0,0,143,0,0,,143,143
40,10-05-17,24,5:45,6:00,,,0,36.7,36.7,0,-71491,58174,129665,-13317,0,0,0,0,0,,0,0
40,10-05-17,25,6:00,6:15,,29.03,0,29.03,29.03,-1,-37324,68165,105489,30841,0,-5859,0,0,0,,5859,-5859
40,10-05-17,26,6:15,6:30,,25.13,0,25.13,25.13,-1,-40453,67535,107988,27082,0,-15704,0,0,0,,15704,-15704
40,10-05-17,27,6:30,6:45,36.13,25.13,0,36.13,36.13,1,-73004,55638,128642,-17366,0,-1509,523,0,0,,2032,-986
40,10-05-17,28,6:45,7:00,,,0,31.04,31.04,0,-71136,83002,154138,11866,0,0,0,0,0,,0,0
40,10-05-17,29,7:00,7:15,,26.92,0,26.92,26.92,-1,-41012,103932,144944,62920,0,-2841,0,0,0,,2841,-2841
40,10-05-17,30,7:15,7:30,,,0,31.07,31.07,0,-33485,89477,122962,55992,0,0,0,0,0,,0,0
40,10-05-17,31,7:30,7:45,,,0,31.02,31.02,0,-57723,96566,154289,38843,0,0,0,0,0,,0,0
40,10-05-17,32,7:45,8:00,31.56,,0,31.56,31.56,1,-97984,109569,207553,11585,0,0,44,0,0,,44,44
40,10-05-17,33,8:00,8:15,31.02,45.73,0,38.37,38.37,2,-64824,99720,164544,34896,0,-15,160,0,0,,175,145
40,10-05-17,34,8:15,8:30,,29.13,0,29.13,29.13,-1,-64661,100674,165335,36013,0,-3231,0,0,0,,3231,-3231
40,10-05-17,35,8:30,8:45,,29.13,0,29.13,29.13,-1,-72825,79332,152157,6507,0,-5548,0,0,0,,5548,-5548
40,10-05-17,36,8:45,9:00,113.11,29.13,0,241.92,241.92,1,-148914,45665,194579,-103249,0,-590,8284,0,0,,8874,7694
40,10-05-17,37,9:00,9:15,158.8,,0,255,255,1,-196393,45497,241890,-150896,0,0,69753,0,19997,,89750,89750
40,10-05-17,38,9:15,9:30,98.11,,0,255,255,1,-158083,54358,212441,-103725,0,0,63566,0,25050,,88616,88616
40,10-05-17,39,9:30,9:45,70.76,,0,255,255,1,-183402,48587,231989,-134815,0,0,15520,0,19167,,34687,34687
40,10-05-17,40,9:45,10:00,158.8,,0,158.8,158.8,1,-216436,46081,262517,-170355,0,0,62200,0,0,,62200,62200
40,10-05-17,41,10:00,10:15,176.6,,0,256.6,256.6,1,-260762,27834,288596,-232928,0,0,84342,0,11666,,96008,96008
40,10-05-17,42,10:15,10:30,488.35,,0,537.19,537.19,1,-213248,19115,232363,-194133,0,0,91737,1250,34998,,127985,127985
40,10-05-17,43,10:30,10:45,488.35,,0,537.19,537.19,1,-160083,20138,180221,-139945,0,0,90097,1250,49164,,140511,140511
40,10-05-17,44,10:45,11:00,156.6,19.66,0,256.6,19.66,2,-75859,19883,95742,-55976,0,-4594,16426,1250,56247,,78517,69329
40,10-05-17,45,11:00,11:15,,18.51,0,18.51,18.51,-1,-107631,107528,215159,-103,0,-11584,0,0,50414,,61998,38830
40,10-05-17,46,11:15,11:30,36.13,28.45,0,234.9,234.9,1,-136428,113485,249913,-22943,0,-12828,1176,0,19999,,34003,8347
40,10-05-17,47,11:30,11:45,39.03,28.45,0,39.03,39.03,1,-103995,92402,196397,-11593,0,-43,6776,0,0,,6819,6733
40,10-05-17,48,11:45,12:00,39.03,25.99,0,25.99,25.99,-1,-93614,121124,214738,27510,0,-6961,1296,0,0,,8257,-5665
40,10-05-17,49,12:00,12:15,60.51,31.68,0,60.51,31.68,2,-86236,57183,143419,-29053,0,-1765,10249,0,0,,12014,8484
40,10-05-17,50,12:15,12:30,60.51,17.62,0,17.62,17.62,-1,-77653,102539,180192,24886,0,-11431,3283,0,0,,14714,-8148
40,10-05-17,51,12:30,12:45,,20.93,0,20.93,20.93,-1,-75788,117606,193394,41818,0,-31198,0,0,0,,31198,-31198
40,10-05-17,52,12:45,13:00,127.18,26.92,0,233,26.92,2,-182043,114086,296129,-67957,0,-19515,11542,0,5000,,36057,-2973
40,10-05-17,53,13:00,13:15,207.32,25.44,0,234,25.44,2,-300433,216608,517041,-83825,0,-2899,50928,2500,59659,,115986,110188
40,10-05-17,54,13:15,13:30,207.32,19.5,0,19.5,19.5,-1,-299312,272082,571394,-27230,0,-8682,556,0,39660,,48898,31534
40,10-05-17,55,13:30,13:45,43.48,19.5,0,43.48,43.48,1,-293857,263443,557300,-30414,0,-639,2404,0,5833,,8876,7598
40,10-05-17,56,13:45,14:00,49.18,,0,49.18,49.18,1,-292509,262123,554632,-30386,0,0,8785,0,0,,8785,8785
40,10-05-17,57,14:00,14:15,49.18,31.79,0,31.79,31.79,-1,-282335,283805,566140,1470,0,-121,304,0,0,,425,183
40,10-05-17,58,14:15,14:30,38.04,,0,38.04,38.04,1,-283835,268739,552574,-15096,0,0,1940,0,0,,1940,1940
40,10-05-17,59,14:30,14:45,37.89,,0,37.89,37.89,1,-285221,269643,554864,-15578,0,0,3393,0,0,,3393,3393
40,10-05-17,60,14:45,15:00,32.15,,0,32.15,32.15,1,-285607,251884,537491,-33723,0,0,2038,0,0,,2038,2038
40,10-05-17,61,15:00,15:15,,,0,31.68,31.68,0,-128300,179123,307423,50823,0,0,123,0,0,,123,123
40,10-05-17,62,15:15,15:30,,,0,31.68,31.68,0,-130662,182381,313043,51719,0,0,0,0,0,,0,0
40,10-05-17,63,15:30,15:45,,,0,31.7,31.7,0,-124123,183446,307569,59323,0,0,0,0,0,,0,0
40,10-05-17,64,15:45,16:00,,,0,31.72,31.72,0,-127094,180966,308060,53872,0,0,0,0,0,,0,0
40,10-05-17,65,16:00,16:15,,-45.35,0,-45.35,-45.35,-1,-66640,195857,262497,129217,0,-33657,0,0,0,,33657,-33657
40,10-05-17,66,16:15,16:30,,25.13,0,25.13,25.13,-1,-64585,149404,213989,84819,0,-15061,0,0,0,,15061,-15061
40,10-05-17,67,16:30,16:45,,15.13,0,15.13,15.13,-1,-57815,166761,224576,108946,0,-12579,0,0,0,,12579,-12579
40,10-05-17,68,16:45,17:00,,,0,31.74,31.74,0,-74784,150247,225031,75463,0,-1088,0,0,0,,1088,-1088
40,10-05-17,69,17:00,17:15,,29.13,0,29.13,29.13,-1,-80962,83143,164105,2181,0,-1984,0,0,0,,1984,-1984
40,10-05-17,70,17:15,17:30,,27.11,0,27.11,27.11,-1,-76376,55147,131523,-21229,0,-4403,0,0,0,,4403,-4403
40,10-05-17,71,17:30,17:45,343.36,,0,343.36,343.36,1,-113731,48881,162612,-64850,0,0,12564,0,0,,12564,12564
40,10-05-17,72,17:45,18:00,343.36,,0,343.36,343.36,1,-81134,58633,139767,-22501,0,0,33053,0,0,,33053,33053
40,10-05-17,73,18:00,18:15,343.36,17.13,0,17.13,17.13,-1,-54169,82174,136343,28005,0,-10300,2258,0,0,,12558,-8042
40,10-05-17,74,18:15,18:30,,26.48,0,26.48,26.48,-1,-36435,74299,110734,37864,0,-19467,0,0,0,,19467,-19467
40,10-05-17,75,18:30,18:45,30.91,25.13,0,37.71,25.13,2,-47804,62807,110611,15003,0,-21234,5,0,0,,21239,-21229
40,10-05-17,76,18:45,19:00,39,25.13,0,39,39,1,-72274,72809,145083,535,0,-2922,1702,0,0,,4624,-1220
40,10-05-17,77,19:00,19:15,,-0.55,0,-0.55,-0.55,-1,-41294,80072,121366,38778,0,-22770,0,0,0,,22770,-22770
40,10-05-17,78,19:15,19:30,75.9,43.08,0,75.9,75.9,1,-64758,40794,105552,-23964,0,-5131,3856,0,0,,8987,-1275
40,10-05-17,79,19:30,19:45,441,,0,441,441,1,-87590,34837,122427,-52753,0,0,42440,0,0,,42440,42440
40,10-05-17,80,19:45,20:00,75.9,29.13,0,75.9,29.13,2,-65464,73760,139224,8296,0,-1321,12722,0,0,,14043,11401
40,10-05-17,81,20:00,20:15,359.62,,0,359.62,359.62,1,-284127,78268,362395,-205859,0,0,54617,0,0,,54617,54617
40,10-05-17,82,20:15,20:30,406.37,,0,447.01,447.01,1,-248497,113644,362141,-134853,0,0,84182,0,14661,,98843,98843
40,10-05-17,83,20:30,20:45,406.37,-6.05,0,-6.05,-6.05,-1,-222989,202830,425819,-20159,0,-7793,26013,0,30533,,64339,48753
40,10-05-17,84,20:45,21:00,35.79,-1.49,0,35.79,35.79,1,-210095,185843,395938,-24252,0,-11555,533,0,0,,12088,-11022
40,10-05-17,85,21:00,21:15,395.11,,0,395.11,395.11,1,-238984,172263,411247,-66721,0,0,30540,0,0,,30540,30540
40,10-05-17,86,21:15,21:30,66,,0,66,66,1,-214658,182014,396672,-32644,0,0,30497,0,0,,30497,30497
40,10-05-17,87,21:30,21:45,66,25.99,0,25.99,25.99,-1,-195062,191388,386450,-3674,0,-2428,12716,0,0,,15144,10288
40,10-05-17,88,21:45,22:00,,29.01,0,29.01,29.01,-1,-187861,186518,374379,-1343,0,-1107,0,0,0,,1107,-1107
40,10-05-17,89,22:00,22:15,,25.13,0,25.13,25.13,-1,-138570,176918,315488,38348,0,-9173,0,0,0,,9173,-9173
40,10-05-17,90,22:15,22:30,,25.13,0,25.13,25.13,-1,-125169,143961,269130,18792,0,-5691,0,0,0,,5691,-5691
40,10-05-17,91,22:30,22:45,,28.67,0,28.67,28.67,-1,-118869,145193,264062,26324,0,-2726,0,0,0,,2726,-2726
40,10-05-17,92,22:45,23:00,,6.67,0,6.67,6.67,-1,-110944,173450,284394,62506,0,-18353,0,0,0,,18353,-18353
40,10-05-17,93,23:00,23:15,395.11,29.13,0,395.11,29.13,2,-126717,84474,211191,-42243,0,-8606,11185,0,0,,19791,2579
40,10-05-17,94,23:15,23:30,395.11,23.1,0,23.1,23.1,-1,-81702,113116,194818,31414,0,-4381,1677,0,0,,6058,-2704
40,10-05-17,95,23:30,23:45,30.92,24.3,0,30.92,30.92,1,-72989,87410,160399,14421,0,-6399,76,0,0,,6475,-6323
40,10-05-17,96,23:45,0:00,,29.03,0,29.03,29.03,-1,-73093,103670,176763,30577,0,-5156,0,0,0,,5156,-5156
40,10-06-17,1,0:00,0:15,75.68,25.42,0,75.68,75.68,1,-99335,98588,197923,-747,0,-2641,6412,0,0,,9053,3771
40,10-06-17,2,0:15,0:30,82.11,30.2,0,82.11,30.2,2,-71424,70693,142117,-731,0,-45,25127,0,0,,25172,25082
40,10-06-17,3,0:30,0:45,82.11,-43.6,0,-43.6,-43.6,-1,-40416,97638,138054,57222,0,-25466,1590,0,0,,27056,-23876
40,10-06-17,4,0:45,1:00,,9.3,0,9.3,9.3,-1,-46844,103543,150387,56699,0,-19651,0,0,0,,19651,-19651
40,10-06-17,5,1:00,1:15,,20.78,0,20.78,20.78,-1,-71209,81349,152558,10140,0,-25071,0,0,0,,25071,-25071
40,10-06-17,6,1:15,1:30,,25.42,0,25.42,25.42,-1,-45872,59555,105427,13683,0,-14452,0,0,0,,14452,-14452
40,10-06-17,7,1:30,1:45,36.42,25.42,0,36.42,25.42,2,-38312,45723,84035,7411,0,-2724,1171,0,0,,3895,-1553
40,10-06-17,8,1:45,2:00,,2.66,0,2.66,2.66,-1,-44859,81993,126852,37134,0,-28322,0,0,0,,28322,-28322
40,10-06-17,9,2:00,2:15,65.35,2.66,0,65.35,65.35,1,-66317,44273,110590,-22044,0,-2817,7411,0,0,,10228,4594
40,10-06-17,10,2:15,2:30,36.59,25.26,0,36.59,25.26,2,-48212,62193,110405,13981,0,-3884,6067,0,0,,9951,2183
40,10-06-17,11,2:30,2:45,,29.78,0,29.78,29.78,-1,-49237,60446,109683,11209,0,-7076,0,0,0,,7076,-7076
40,10-06-17,12,2:45,3:00,,30.42,0,30.42,30.42,-1,-49841,50678,100519,837,0,-4831,0,0,0,,4831,-4831
40,10-06-17,13,3:00,3:15,32.42,30.42,0,32.42,32.42,1,-56545,61565,118110,5020,0,-231,105,0,0,,336,-126
40,10-06-17,14,3:15,3:30,32.42,24.71,0,24.71,24.71,-1,-37873,59106,96979,21233,0,-4233,25,0,0,,4258,-4208
40,10-06-17,15,3:30,3:45,,24.78,0,24.78,24.78,-1,-44857,54124,98981,9267,0,-16463,0,0,0,,16463,-16463
40,10-06-17,16,3:45,4:00,42.42,24.78,0,42.42,42.42,1,-41451,41922,83373,471,0,-2139,4557,0,0,,6696,2418
40,10-06-17,17,4:00,4:15,58.64,,0,58.64,58.64,1,-71144,38180,109324,-32964,0,0,5321,0,0,,5321,5321
40,10-06-17,18,4:15,4:30,58.42,,0,58.42,58.42,1,-57188,35967,93155,-21221,0,0,14953,0,0,,14953,14953
40,10-06-17,19,4:30,4:45,42.52,,0,42.52,42.52,1,-71896,35532,107428,-36364,0,0,7235,0,0,,7235,7235
40,10-06-17,20,4:45,5:00,48.42,25.42,0,48.42,25.42,2,-61967,54139,116106,-7828,0,-307,14423,0,0,,14730,14116
40,10-06-17,21,5:00,5:15,48.42,-72.1,0,-72.1,-72.1,-1,-42708,99280,141988,56572,0,-31222,924,0,0,,32146,-30298
40,10-06-17,22,5:15,5:30,,12.9,0,12.9,12.9,-1,-61502,81449,142951,19947,0,-6700,0,0,0,,6700,-6700
40,10-06-17,23,5:30,5:45,32.66,-4.78,0,32.66,-4.78,2,-74335,67049,141384,-7286,0,-18576,197,0,0,,18773,-18379
40,10-06-17,24,5:45,6:00,125.99,-4.78,0,125.99,125.99,1,-192221,114932,307153,-77289,0,-190,32337,0,0,,32527,32147
40,10-06-17,25,6:00,6:15,125.99,30.75,0,30.75,30.75,-1,-140627,121424,262051,-19203,0,-24,2780,0,0,,2804,2756
40,10-06-17,26,6:15,6:30,32.11,,0,32.11,32.11,1,-128260,68054,196314,-60206,0,0,20,0,0,,20,20
40,10-06-17,27,6:30,6:45,103.78,,0,103.78,103.78,1,-185859,48224,234083,-137635,0,0,16273,0,0,,16273,16273
40,10-06-17,28,6:45,7:00,114.64,,0,114.64,114.64,1,-178683,116953,295636,-61730,0,0,28686,0,0,,28686,28686
40,10-06-17,29,7:00,7:15,37.68,,0,37.68,37.68,1,-119387,82401,201788,-36986,0,0,2942,0,0,,2942,2942
40,10-06-17,30,7:15,7:30,133.12,,0,133.12,133.12,1,-121028,80938,201966,-40090,0,0,19105,0,0,,19105,19105
40,10-06-17,31,7:30,7:45,385.17,,0,385.17,385.17,1,-187829,90841,278670,-96988,0,0,74498,0,0,,74498,74498
40,10-06-17,32,7:45,8:00,108.12,,0,108.12,108.12,1,-199645,128182,327827,-71463,0,0,64710,0,0,,64710,64710
40,10-06-17,33,8:00,8:15,65.61,,0,65.61,65.61,1,-107019,71954,178973,-35065,0,0,37412,0,0,,37412,37412
40,10-06-17,34,8:15,8:30,463.69,,0,510.06,510.06,1,-201314,56052,257366,-145262,0,0,34387,0,1706,,36093,36093
40,10-06-17,35,8:30,8:45,463.69,,0,510.06,510.06,1,-256896,76329,333225,-180567,0,0,83480,0,67614,,151094,151094
40,10-06-17,36,8:45,9:00,463.69,,0,510.06,510.06,1,-254534,102212,356746,-152322,0,0,73359,0,65531,,138890,138890
40,10-06-17,37,9:00,9:15,36.32,26.33,0,249.9,26.33,2,-158011,119739,277750,-38272,0,-1755,21318,0,49164,,72237,68727
40,10-06-17,38,9:15,9:30,345.37,,0,379.91,379.91,1,-176405,100086,276491,-76319,0,0,28456,0,23332,,51788,51788
40,10-06-17,39,9:30,9:45,55.9,,0,55.9,55.9,1,-167808,112629,280437,-55179,0,0,35776,0,0,,35776,35776
40,10-06-17,40,9:45,10:00,56.38,,0,56.38,56.38,1,-178966,100694,279660,-78272,0,0,29829,0,0,,29829,29829
40,10-06-17,41,10:00,10:15,36.59,29.32,0,29.32,29.32,-1,-103311,116182,219493,12871,0,-646,25225,0,0,,25871,24579
40,10-06-17,42,10:15,10:30,36.59,28.2,0,28.2,28.2,-1,-92640,99375,192015,6735,0,-1353,715,0,0,,2068,-638
40,10-06-17,43,10:30,10:45,,25.32,0,25.32,25.32,-1,-81109,128415,209524,47306,0,-2792,0,0,0,,2792,-2792
40,10-06-17,44,10:45,11:00,,30.32,0,30.32,30.32,-1,-69610,117041,186651,47431,0,-2465,0,0,0,,2465,-2465
40,10-06-17,45,11:00,11:15,34.94,45.79,0,38.95,38.95,2,-101682,95196,196878,-6486,0,-57,329,0,0,,386,272
40,10-06-17,46,11:15,11:30,,,0,38.95,38.95,0,-90264,108547,198811,18283,0,0,22,0,0,,22,22
40,10-06-17,47,11:30,11:45,,3.25,0,3.25,3.25,-1,-61504,148860,210364,87356,0,-18832,0,0,0,,18832,-18832
40,10-06-17,48,11:45,12:00,,28.52,0,28.52,28.52,-1,-63979,148188,212167,84209,0,-14784,0,0,0,,14784,-14784
40,10-06-17,49,12:00,12:15,39.51,45.79,0,39.51,38.95,2,-97203,69886,167089,-27317,0,-1638,1796,0,0,,3434,158
40,10-06-17,50,12:15,12:30,,25.32,0,25.32,25.32,-1,-103806,125627,229433,21821,0,-4408,0,0,0,,4408,-4408
40,10-06-17,51,12:30,12:45,,15.86,0,15.86,15.86,-1,-103622,145874,249496,42252,0,-36238,0,0,0,,36238,-36238
40,10-06-17,52,12:45,13:00,,8.3,0,8.3,8.3,-1,-79719,148063,227782,68344,0,-34145,0,0,0,,34145,-34145
40,10-06-17,53,13:00,13:15,,22.48,0,22.48,22.48,-1,-92761,106229,198990,13468,0,-25711,0,0,0,,25711,-25711
40,10-06-17,54,13:15,13:30,,-1.83,0,-1.83,-1.83,-1,-67910,119861,187771,51951,0,-12274,0,0,0,,12274,-12274
40,10-06-17,55,13:30,13:45,,-9.19,0,-9.19,-9.19,-1,-40886,101685,142571,60799,0,-37338,0,0,0,,37338,-37338
40,10-06-17,56,13:45,14:00,,-8.53,0,-8.53,-8.53,-1,-53222,111746,164968,58524,0,-55919,0,0,0,,55919,-55919
40,10-06-17,57,14:00,14:15,,23.43,0,23.43,23.43,-1,-39245,114996,154241,75751,0,-31516,0,0,0,,31516,-31516
40,10-06-17,58,14:15,14:30,,8.84,0,8.84,8.84,-1,-43014,120934,163948,77920,0,-31033,0,0,0,,31033,-31033
40,10-06-17,59,14:30,14:45,,22.46,0,22.46,22.46,-1,-46357,122442,168799,76085,0,-32645,0,0,0,,32645,-32645
40,10-06-17,60,14:45,15:00,,,0,32.93,32.93,0,-82904,105142,188046,22238,0,-4655,0,0,0,,4655,-4655
40,10-06-17,61,15:00,15:15,,,0,32.84,32.84,0,-118152,128238,246390,10086,0,0,0,0,0,,0,0
40,10-06-17,62,15:15,15:30,,,0,32.84,32.84,0,-114010,130059,244069,16049,0,0,0,0,0,,0,0
40,10-06-17,63,15:30,15:45,42.32,,0,42.32,42.32,1,-117772,101159,218931,-16613,0,0,3445,0,0,,3445,3445
40,10-06-17,64,15:45,16:00,37.05,,0,37.05,37.05,1,-115465,84416,199881,-31049,0,0,14197,0,0,,14197,14197
40,10-06-17,65,16:00,16:15,36.32,33.78,0,36.32,32.92,2,-75473,73489,148962,-1984,0,-26,4550,0,0,,4576,4524
40,10-06-17,66,16:15,16:30,36.99,,0,36.99,36.99,1,-90495,75104,165599,-15391,0,0,4628,0,0,,4628,4628
40,10-06-17,67,16:30,16:45,129.05,,0,129.05,129.05,1,-108892,50957,159849,-57935,0,0,37315,0,0,,37315,37315
40,10-06-17,68,16:45,17:00,50.05,29.82,0,29.82,29.82,-1,-80609,73184,153793,-7425,0,-400,27389,0,0,,27789,26989
40,10-06-17,69,17:00,17:15,35.11,29.32,0,38.99,29.32,2,-76101,69824,145925,-6277,0,-760,385,0,0,,1145,-375
40,10-06-17,70,17:15,17:30,219.3,,0,219.3,219.3,1,-118499,72902,191401,-45597,0,0,23722,0,0,,23722,23722
40,10-06-17,71,17:30,17:45,62.43,,0,62.43,62.43,1,-102378,75131,177509,-27247,0,0,32275,0,0,,32275,32275
40,10-06-17,72,17:45,18:00,66.79,,0,66.79,66.79,1,-104646,74002,178648,-30644,0,0,24264,0,0,,24264,24264
40,10-06-17,73,18:00,18:15,50.5,20.55,0,50.5,20.55,2,-48684,76973,125657,28289,0,-4640,16822,0,0,,21462,12182
40,10-06-17,74,18:15,18:30,36.32,30.78,0,38.99,30.78,2,-50719,50524,101243,-195,0,-3490,760,0,0,,4250,-2730
40,10-06-17,75,18:30,18:45,,,0,38.99,38.99,0,-73304,81359,154663,8055,0,0,56,0,0,,56,56
40,10-06-17,76,18:45,19:00,56.5,,0,56.5,56.5,1,-90337,70153,160490,-20184,0,0,5660,0,0,,5660,5660
40,10-06-17,77,19:00,19:15,56.5,-48.35,0,-48.35,-48.35,-1,-54825,125669,180494,70844,0,-20895,739,0,0,,21634,-20156
40,10-06-17,78,19:15,19:30,431.25,-48.35,0,431.25,431.25,1,-110423,62635,173058,-47788,0,-6617,16547,0,0,,23164,9930
40,10-06-17,79,19:30,19:45,431.25,-2.85,0,-2.85,-2.85,-1,-52059,68286,120345,16227,0,-3126,26020,0,0,,29146,22894
40,10-06-17,80,19:45,20:00,431.25,-14.21,0,431.25,-14.21,2,-62563,40943,103506,-21620,0,-13519,5125,0,0,,18644,-8394
40,10-06-17,81,20:00,20:15,237.97,,0,237.97,237.97,1,-131525,46364,177889,-85161,0,0,62387,0,0,,62387,62387
40,10-06-17,82,20:15,20:30,40.8,,0,40.8,40.8,1,-115596,74768,190364,-40828,0,0,25803,0,0,,25803,25803
40,10-06-17,83,20:30,20:45,48.4,,0,48.4,48.4,1,-105676,79831,185507,-25845,0,0,13388,0,0,,13388,13388
40,10-06-17,84,20:45,21:00,32.32,29.32,0,29.32,29.32,-1,-107015,92129,199144,-14886,0,-439,4083,0,0,,4522,3644
40,10-06-17,85,21:00,21:15,,29.32,0,29.32,29.32,-1,-68214,113402,181616,45188,0,-949,0,0,0,,949,-949
40,10-06-17,86,21:15,21:30,,28.55,0,28.55,28.55,-1,-53803,74693,128496,20890,0,-1955,0,0,0,,1955,-1955
40,10-06-17,87,21:30,21:45,,25.32,0,25.32,25.32,-1,-38966,93731,132697,54765,0,-1920,0,0,0,,1920,-1920
40,10-06-17,88,21:45,22:00,,25.32,0,25.32,25.32,-1,-46863,106282,153145,59419,0,-4128,0,0,0,,4128,-4128
40,10-06-17,89,22:00,22:15,405.66,25.32,0,405.66,405.66,1,-116640,22619,139259,-94021,0,-1498,19119,0,0,,20617,17621
40,10-06-17,90,22:15,22:30,50.9,3.2,0,3.2,3.2,-1,-58250,66440,124690,8190,0,-3084,22294,0,0,,25378,19210
40,10-06-17,91,22:30,22:45,,-3.95,0,-3.95,-3.95,-1,-49886,87690,137576,37804,0,-11005,0,0,0,,11005,-11005
40,10-06-17,92,22:45,23:00,,30.32,0,30.32,30.32,-1,-63749,91212,154961,27463,0,-244,0,0,0,,244,-244
40,10-06-17,93,23:00,23:15,412.87,30.32,0,412.87,30.32,2,-119505,17575,137080,-101930,0,-246,15234,0,0,,15480,14988
40,10-06-17,94,23:15,23:30,412.87,33.61,0,33.61,33.61,-1,-69614,50737,120351,-18877,0,-589,2122,0,0,,2711,1533
40,10-06-17,95,23:30,23:45,32.32,,0,32.32,32.32,1,-60657,34432,95089,-26225,0,0,79,0,0,,79,79
40,10-06-17,96,23:45,0:00,32.13,15.32,0,38.25,15.32,2,-39312,39057,78369,-255,0,-2300,97,0,0,,2397,-2203
41,10-07-17,1,0:00,0:15,,15.6,0,15.6,15.6,-1,-40115,108301,148416,68186,0,-3454,0,0,0,,3454,-3454
41,10-07-17,2,0:15,0:30,66.69,,0,66.69,66.69,1,-63198,19359,82557,-43839,0,0,14417,0,0,,14417,14417
41,10-07-17,3,0:30,0:45,,,0,32.09,32.09,0,-41413,20513,61926,-20900,0,0,2848,0,0,,2848,2848
41,10-07-17,4,0:45,1:00,42.6,,0,42.6,42.6,1,-81899,28126,110025,-53773,0,0,513,0,0,,513,513
41,10-07-17,5,1:00,1:15,135.02,,0,135.02,135.02,1,-106950,14878,121828,-92072,0,0,48414,0,0,,48414,48414
41,10-07-17,6,1:15,1:30,110.02,,0,110.02,110.02,1,-83143,12950,96093,-70193,0,0,69729,0,0,,69729,69729
41,10-07-17,7,1:30,1:45,110.02,25.91,0,25.91,25.91,-1,-45287,25112,70399,-20175,0,-56,5536,0,0,,5592,5480
41,10-07-17,8,1:45,2:00,,30.76,0,30.76,30.76,-1,-42938,27284,70222,-15654,0,-119,0,0,0,,119,-119
41,10-07-17,9,2:00,2:15,,29.03,0,29.03,29.03,-1,-30892,55247,86139,24355,0,-1177,0,0,0,,1177,-1177
41,10-07-17,10,2:15,2:30,,24.82,0,24.82,24.82,-1,-36110,58751,94861,22641,0,-9753,0,0,0,,9753,-9753
41,10-07-17,11,2:30,2:45,,29.6,0,29.6,29.6,-1,-40137,77309,117446,37172,0,-12685,0,0,0,,12685,-12685
41,10-07-17,12,2:45,3:00,,4.03,0,4.03,4.03,-1,-38180,91210,129390,53030,0,-4816,0,0,0,,4816,-4816
41,10-07-17,13,3:00,3:15,,-44.31,0,-44.31,-44.31,-1,-37906,82661,120567,44755,0,-14244,0,0,0,,14244,-14244
41,10-07-17,14,3:15,3:30,,-107.01,0,-107.01,-107.01,-1,-30276,78472,108748,48196,0,-29602,0,0,0,,29602,-29602
41,10-07-17,15,3:30,3:45,,10.69,0,10.69,10.69,-1,-29709,73566,103275,43857,0,-33757,0,0,0,,33757,-33757
41,10-07-17,16,3:45,4:00,,-35.09,0,-35.09,-35.09,-1,-16864,89874,106738,73010,0,-58405,0,0,0,,58405,-58405
41,10-07-17,17,4:00,4:15,51.17,-35.09,0,51.17,51.17,1,-59134,27523,86657,-31611,0,-17134,2091,0,0,,19225,-15043
41,10-07-17,18,4:15,4:30,,27.99,0,27.99,27.99,-1,-31316,51523,82839,20207,0,-6574,0,0,0,,6574,-6574
41,10-07-17,19,4:30,4:45,,27.17,0,27.17,27.17,-1,-35756,52626,88382,16870,0,-18307,0,0,0,,18307,-18307
41,10-07-17,20,4:45,5:00,,29.6,0,29.6,29.6,-1,-37524,50124,87648,12600,0,-17408,0,0,0,,17408,-17408
41,10-07-17,21,5:00,5:15,,26.85,0,26.85,26.85,-1,-29592,90695,120287,61103,0,-16406,0,0,0,,16406,-16406
41,10-07-17,22,5:15,5:30,,14.84,0,14.84,14.84,-1,-24312,78919,103231,54607,0,-28137,0,0,0,,28137,-28137
41,10-07-17,23,5:30,5:45,,25.6,0,25.6,25.6,-1,-34061,75289,109350,41228,0,-24506,0,0,0,,24506,-24506
41,10-07-17,24,5:45,6:00,,15.6,0,15.6,15.6,-1,-32123,81145,113268,49022,0,-4531,0,0,0,,4531,-4531
41,10-07-17,25,6:00,6:15,,-69.58,0,-69.58,-69.58,-1,-15819,81613,97432,65794,0,-51842,0,0,0,,51842,-51842
41,10-07-17,26,6:15,6:30,,26.64,0,26.64,26.64,-1,-32217,72933,105150,40716,0,-29261,0,0,0,,29261,-29261
41,10-07-17,27,6:30,6:45,,15.03,0,15.03,15.03,-1,-45717,69894,115611,24177,0,-25260,0,0,0,,25260,-25260
41,10-07-17,28,6:45,7:00,,25.42,0,25.42,25.42,-1,-54886,101268,156154,46382,0,-18607,0,0,0,,18607,-18607
41,10-07-17,29,7:00,7:15,,-30.88,0,-30.88,-30.88,-1,-54193,120972,175165,66779,0,-43582,0,0,0,,43582,-43582
41,10-07-17,30,7:15,7:30,,29.42,0,29.42,29.42,-1,-61361,75144,136505,13783,0,-27842,0,0,0,,27842,-27842
41,10-07-17,31,7:30,7:45,34.11,29.42,0,34.11,34.11,1,-74899,80129,155028,5230,0,-3659,1155,0,0,,4814,-2504
41,10-07-17,32,7:45,8:00,,15.42,0,15.42,15.42,-1,-69323,110862,180185,41539,0,-7609,0,0,0,,7609,-7609
41,10-07-17,33,8:00,8:15,,19.42,0,19.42,19.42,-1,-65825,102020,167845,36195,0,-32348,0,0,0,,32348,-32348
41,10-07-17,34,8:15,8:30,,16.99,0,16.99,16.99,-1,-77850,112361,190211,34511,0,-44927,0,0,0,,44927,-44927
41,10-07-17,35,8:30,8:45,33.06,16.99,0,33.06,33.06,1,-87672,93680,181352,6008,0,-7260,962,0,0,,8222,-6298
41,10-07-17,36,8:45,9:00,33.06,45.65,0,45.65,45.65,-1,-94908,91507,186415,-3401,0,-121,23,0,0,,144,-98
41,10-07-17,37,9:00,9:15,,30.42,0,30.42,30.42,-1,-79866,84873,164739,5007,0,-431,0,0,0,,431,-431
41,10-07-17,38,9:15,9:30,,45.72,0,45.72,45.72,-1,-83684,67415,151099,-16269,0,-71,0,0,0,,71,-71
41,10-07-17,39,9:30,9:45,,29.42,0,29.42,29.42,-1,-80374,83857,164231,3483,0,-327,0,0,0,,327,-327
41,10-07-17,40,9:45,10:00,,25.42,0,25.42,25.42,-1,-93876,101804,195680,7928,0,-6342,0,0,0,,6342,-6342
41,10-07-17,41,10:00,10:15,35.51,,0,35.51,35.51,1,-47849,52268,100117,4419,0,0,736,0,0,,736,736
41,10-07-17,42,10:15,10:30,44.32,,0,44.32,44.32,1,-55646,53194,108840,-2452,0,0,8275,0,0,,8275,8275
41,10-07-17,43,10:30,10:45,32.14,,0,32.14,32.14,1,-59533,63259,122792,3726,0,0,307,0,0,,307,307
41,10-07-17,44,10:45,11:00,44.32,,0,44.32,44.32,1,-54586,50681,105267,-3905,0,0,2158,0,0,,2158,2158
41,10-07-17,45,11:00,11:15,250.8,,0,250.8,250.8,1,-127238,27633,154871,-99605,0,0,46863,0,0,,46863,46863
41,10-07-17,46,11:15,11:30,250.8,21.24,0,21.24,21.24,-1,-63942,67819,131761,3877,0,-2190,26255,0,0,,28445,24065
41,10-07-17,47,11:30,11:45,65.02,21.24,0,65.02,65.02,1,-75547,43674,119221,-31873,0,-57,11322,0,0,,11379,11265
41,10-07-17,48,11:45,12:00,51.36,,0,51.36,51.36,1,-85236,40338,125574,-44898,0,0,31792,0,0,,31792,31792
41,10-07-17,49,12:00,12:15,,,0,38.96,38.96,0,-78644,35159,113803,-43485,0,0,8093,0,0,,8093,8093
41,10-07-17,50,12:15,12:30,,,0,38.96,38.96,0,-82968,35303,118271,-47665,0,0,0,0,0,,0,0
41,10-07-17,51,12:30,12:45,50.32,,0,50.32,50.32,1,-76269,36474,112743,-39795,0,0,6097,0,0,,6097,6097
41,10-07-17,52,12:45,13:00,43.02,,0,43.02,43.02,1,-74129,41192,115321,-32937,0,0,6232,0,0,,6232,6232
41,10-07-17,53,13:00,13:15,125.68,,0,125.68,125.68,1,-103414,65015,168429,-38399,0,0,12653,0,0,,12653,12653
41,10-07-17,54,13:15,13:30,40.97,,0,40.97,40.97,1,-96137,40330,136467,-55807,0,0,13069,0,0,,13069,13069
41,10-07-17,55,13:30,13:45,32.16,,0,32.16,32.16,1,-110807,29137,139944,-81670,0,0,189,0,0,,189,189
41,10-07-17,56,13:45,14:00,37.37,,0,37.37,37.37,1,-121580,25567,147147,-96013,0,0,2510,0,0,,2510,2510
41,10-07-17,57,14:00,14:15,148.76,,0,148.76,148.76,1,-126158,32829,158987,-93329,0,0,28793,0,0,,28793,28793
41,10-07-17,58,14:15,14:30,73.02,,0,73.02,73.02,1,-121179,41411,162590,-79768,0,0,57237,0,0,,57237,57237
41,10-07-17,59,14:30,14:45,57.39,,0,57.39,57.39,1,-115958,49394,165352,-66564,0,0,30992,0,0,,30992,30992
41,10-07-17,60,14:45,15:00,38.64,,0,38.64,38.64,1,-109351,48774,158125,-60577,0,0,17678,0,0,,17678,17678
41,10-07-17,61,15:00,15:15,44.32,,0,44.32,44.32,1,-113166,81759,194925,-31407,0,0,19770,0,0,,19770,19770
41,10-07-17,62,15:15,15:30,37.37,,0,37.37,37.37,1,-99059,82485,181544,-16574,0,0,13517,0,0,,13517,13517
41,10-07-17,63,15:30,15:45,,,0,32.8,32.8,0,-94400,76073,170473,-18327,0,0,154,0,0,,154,154
41,10-07-17,64,15:45,16:00,,,0,32.81,32.81,0,-92329,66141,158470,-26188,0,0,0,0,0,,0,0
41,10-07-17,65,16:00,16:15,37.37,,0,37.37,37.37,1,-85602,79265,164867,-6337,0,0,1320,0,0,,1320,1320
41,10-07-17,66,16:15,16:30,37.37,,0,37.37,37.37,1,-90474,68894,159368,-21580,0,0,5081,0,0,,5081,5081
41,10-07-17,67,16:30,16:45,149.57,,0,149.57,149.57,1,-115114,57995,173109,-57119,0,0,16307,0,0,,16307,16307
41,10-07-17,68,16:45,17:00,135.02,,0,135.02,135.02,1,-128887,63051,191938,-65836,0,0,68458,0,0,,68458,68458
41,10-07-17,69,17:00,17:15,36.81,,0,36.81,36.81,1,-107025,69362,176387,-37663,0,0,24507,0,0,,24507,24507
41,10-07-17,70,17:15,17:30,188.47,,0,188.47,188.47,1,-110556,32193,142749,-78363,0,0,37363,0,0,,37363,37363
41,10-07-17,71,17:30,17:45,188.47,,0,188.47,188.47,1,-145748,50679,196427,-95069,0,0,84050,0,0,,84050,84050
41,10-07-17,72,17:45,18:00,188.47,,0,188.47,188.47,1,-146957,83779,230736,-63178,0,0,75673,0,0,,75673,75673
41,10-07-17,73,18:00,18:15,32.29,25.42,0,39.01,25.42,2,-76080,56037,132117,-20043,0,-255,18229,0,0,,18484,17974
41,10-07-17,74,18:15,18:30,58.61,,0,58.61,58.61,1,-81666,60080,141746,-21586,0,0,1254,0,0,,1254,1254
41,10-07-17,75,18:30,18:45,360.37,,0,360.37,360.37,1,-98297,57596,155893,-40701,0,0,35168,0,0,,35168,35168
41,10-07-17,76,18:45,19:00,36.83,,0,36.83,36.83,1,-95260,75926,171186,-19334,0,0,6674,0,0,,6674,6674
41,10-07-17,77,19:00,19:15,36.83,3.15,0,3.15,3.15,-1,-42005,101875,143880,59870,0,-18639,26,0,0,,18665,-18613
41,10-07-17,78,19:15,19:30,,29.42,0,29.42,29.42,-1,-52248,77972,130220,25724,0,-22812,0,0,0,,22812,-22812
41,10-07-17,79,19:30,19:45,,30.42,0,30.42,30.42,-1,-53375,70239,123614,16864,0,-5063,0,0,0,,5063,-5063
41,10-07-17,80,19:45,20:00,,23.36,0,23.36,23.36,-1,-48368,77840,126208,29472,0,-21684,0,0,0,,21684,-21684
41,10-07-17,81,20:00,20:15,37.03,44.06,0,39,39,2,-75484,60191,135675,-15293,0,-8951,633,0,0,,9584,-8318
41,10-07-17,82,20:15,20:30,,30.42,0,30.42,30.42,-1,-64149,64153,128302,4,0,-200,0,0,0,,200,-200
41,10-07-17,83,20:30,20:45,,28.77,0,28.77,28.77,-1,-57433,74779,132212,17346,0,-2790,0,0,0,,2790,-2790
41,10-07-17,84,20:45,21:00,,13.25,0,13.25,13.25,-1,-51971,99755,151726,47784,0,-34940,0,0,0,,34940,-34940
41,10-07-17,85,21:00,21:15,210.59,13.25,0,210.59,210.59,1,-73504,34315,107819,-39189,0,-13383,13030,0,0,,26413,-353
41,10-07-17,86,21:15,21:30,38.43,30.42,0,39,30.42,2,-71428,67214,138642,-4214,0,-217,9611,0,0,,9828,9394
41,10-07-17,87,21:30,21:45,,29.37,0,29.37,29.37,-1,-65915,92113,158028,26198,0,-1261,0,0,0,,1261,-1261
41,10-07-17,88,21:45,22:00,,21.58,0,21.58,21.58,-1,-65239,101820,167059,36581,0,-25291,0,0,0,,25291,-25291
41,10-07-17,89,22:00,22:15,34.11,29.42,0,38.99,29.42,2,-97918,47813,145731,-50105,0,-10606,830,0,0,,11436,-9776
41,10-07-17,90,22:15,22:30,,,0,38.99,38.99,0,-108207,35104,143311,-73103,0,0,2,0,0,,2,2
41,10-07-17,91,22:30,22:45,137.63,,0,137.63,137.63,1,-97378,31682,129060,-65696,0,0,11662,0,0,,11662,11662
41,10-07-17,92,22:45,23:00,137.63,29.8,0,137.63,29.8,2,-65926,48285,114211,-17641,0,-816,31934,0,0,,32750,31118
41,10-07-17,93,23:00,23:15,53.49,25.2,0,53.49,25.2,2,-88977,83949,172926,-5028,0,-1278,4800,0,0,,6078,3522
41,10-07-17,94,23:15,23:30,32.42,,0,32.42,32.42,1,-67172,39445,106617,-27727,0,0,1601,0,0,,1601,1601
41,10-07-17,95,23:30,23:45,,,0,38.98,38.98,0,-48670,59084,107754,10414,0,0,0,0,0,,0,0
41,10-07-17,96,23:45,0:00,,29.42,0,29.42,29.42,-1,-47423,65647,113070,18224,0,-2627,0,0,0,,2627,-2627
41,10-08-17,1,0:00,0:15,49.71,15.42,0,49.71,15.42,2,-55009,73295,128304,18286,0,-4780,2154,0,0,,6934,-2626
41,10-08-17,2,0:15,0:30,50.32,,0,50.32,50.32,1,-77525,58978,136503,-18547,0,0,7131,0,0,,7131,7131
41,10-08-17,3,0:30,0:45,,,0,38.92,38.92,0,-82751,74704,157455,-8047,0,0,0,0,0,,0,0
41,10-08-17,4,0:45,1:00,,25.42,0,25.42,25.42,-1,-69477,88115,157592,18638,0,-5645,0,0,0,,5645,-5645
41,10-08-17,5,1:00,1:15,46.48,25.42,0,46.48,46.48,1,-73538,68325,141863,-5213,0,-7896,2328,0,0,,10224,-5568
41,10-08-17,6,1:15,1:30,50.32,25.42,0,50.32,25.42,2,-73376,74884,148260,1508,0,-592,12152,0,0,,12744,11560
41,10-08-17,7,1:30,1:45,50.32,10.78,0,10.78,10.78,-1,-42772,90058,132830,47286,0,-29441,118,0,0,,29559,-29323
41,10-08-17,8,1:45,2:00,,25.42,0,25.42,25.42,-1,-53001,82151,135152,29150,0,-32073,0,0,0,,32073,-32073
41,10-08-17,9,2:00,2:15,42.42,19.78,0,42.42,42.42,1,-70460,80339,150799,9879,0,-12090,1839,0,0,,13929,-10251
41,10-08-17,10,2:15,2:30,42.42,19.78,0,42.42,42.42,1,-58971,57223,116194,-1748,0,-17,3057,0,0,,3074,3040
41,10-08-17,11,2:30,2:45,,,0,38.28,38.28,0,-55979,60326,116305,4347,0,0,65,0,0,,65,65
41,10-08-17,12,2:45,3:00,,29.42,0,29.42,29.42,-1,-58398,59433,117831,1035,0,-429,0,0,0,,429,-429
41,10-08-17,13,3:00,3:15,,28.78,0,28.78,28.78,-1,-54133,107667,161800,53534,0,-1491,0,0,0,,1491,-1491
41,10-08-17,14,3:15,3:30,,,0,38.21,38.21,0,-59314,86397,145711,27083,0,0,0,0,0,,0,0
41,10-08-17,15,3:30,3:45,,,0,38.21,38.21,0,-57654,86358,144012,28704,0,0,0,0,0,,0,0
41,10-08-17,16,3:45,4:00,,21.66,0,21.66,21.66,-1,-39927,79566,119493,39639,0,-1428,0,0,0,,1428,-1428
41,10-08-17,17,4:00,4:15,,-38.97,0,-38.97,-38.97,-1,-31382,98500,129882,67118,0,-35840,0,0,0,,35840,-35840
41,10-08-17,18,4:15,4:30,,29.42,0,29.42,29.42,-1,-44860,56170,101030,11310,0,-19270,0,0,0,,19270,-19270
41,10-08-17,19,4:30,4:45,32.83,29.42,0,32.83,32.83,1,-48573,41173,89746,-7400,0,-3905,218,0,0,,4123,-3687
41,10-08-17,20,4:45,5:00,,15.42,0,15.42,15.42,-1,-49167,65311,114478,16144,0,-6202,0,0,0,,6202,-6202
41,10-08-17,21,5:00,5:15,32.17,-72.74,0,38.27,-72.74,2,-40122,75202,115324,35080,0,-30508,44,0,0,,30552,-30464
41,10-08-17,22,5:15,5:30,33.12,25.42,0,38.27,25.42,2,-39312,76384,115696,37072,0,-3001,409,0,0,,3410,-2592
41,10-08-17,23,5:30,5:45,32.42,29.85,0,38.27,29.85,2,-41536,44357,85893,2821,0,-923,201,0,0,,1124,-722
41,10-08-17,24,5:45,6:00,,29.42,0,29.42,29.42,-1,-46387,56447,102834,10060,0,-307,0,0,0,,307,-307
41,10-08-17,25,6:00,6:15,,-70,0,-70,-70,-1,-40617,96280,136897,55663,0,-13367,0,0,0,,13367,-13367
41,10-08-17,26,6:15,6:30,39.37,-70,0,39.37,39.37,1,-67003,65180,132183,-1823,0,-21463,1016,0,0,,22479,-20447
41,10-08-17,27,6:30,6:45,36.84,,0,36.84,36.84,1,-64663,50684,115347,-13979,0,0,4914,0,0,,4914,4914
41,10-08-17,28,6:45,7:00,42.46,,0,42.46,42.46,1,-71311,71641,142952,330,0,0,1266,0,0,,1266,1266
41,10-08-17,29,7:00,7:15,126.28,,0,126.28,126.28,1,-146601,24213,170814,-122388,0,0,56275,0,0,,56275,56275
41,10-08-17,30,7:15,7:30,78.65,13.24,0,13.24,13.24,-1,-61050,61417,122467,367,0,-2502,40020,0,0,,42522,37518
41,10-08-17,31,7:30,7:45,49.82,30.46,0,49.82,49.82,1,-74950,53451,128401,-21499,0,-3782,4098,0,0,,7880,316
41,10-08-17,32,7:45,8:00,60.14,,0,60.14,60.14,1,-76418,62987,139405,-13431,0,0,20792,0,0,,20792,20792
41,10-08-17,33,8:00,8:15,60.14,29.46,0,29.46,29.46,-1,-54425,73994,128419,19569,0,-5604,702,0,0,,6306,-4902
41,10-08-17,34,8:15,8:30,34.42,30.46,0,38.19,30.46,2,-64656,64935,129591,279,0,-2647,627,0,0,,3274,-2020
41,10-08-17,35,8:30,8:45,41.6,,0,41.6,41.6,1,-69681,50890,120571,-18791,0,0,11776,0,0,,11776,11776
41,10-08-17,36,8:45,9:00,42.46,,0,42.46,42.46,1,-81158,64992,146150,-16166,0,0,22098,0,0,,22098,22098
41,10-08-17,37,9:00,9:15,36.46,27.64,0,38.19,27.64,2,-61919,59552,121471,-2367,0,-761,17354,0,0,,18115,16593
41,10-08-17,38,9:15,9:30,36.46,25.46,0,25.46,25.46,-1,-63545,97944,161489,34399,0,-1212,1032,0,0,,2244,-180
41,10-08-17,39,9:30,9:45,,,0,38.19,38.19,0,-60537,86498,147035,25961,0,0,0,0,0,,0,0
41,10-08-17,40,9:45,10:00,,,0,38.19,38.19,0,-37827,108511,146338,70684,0,0,0,0,0,,0,0
41,10-08-17,41,10:00,10:15,,41.64,0,41.64,41.64,-1,-38555,38783,77338,228,0,-1160,0,0,0,,1160,-1160
41,10-08-17,42,10:15,10:30,32.93,29.46,0,38.19,29.46,2,-44535,37828,82363,-6707,0,-5672,66,0,0,,5738,-5606
41,10-08-17,43,10:30,10:45,36.8,29.46,0,36.8,36.8,1,-48865,32328,81193,-16537,0,-213,987,0,0,,1200,774
41,10-08-17,44,10:45,11:00,35.87,43.72,0,38.19,38.19,2,-49604,24238,73842,-25366,0,-7,402,0,0,,409,395
41,10-08-17,45,11:00,11:15,42.01,42.24,0,42.01,38.2,2,-45148,36305,81453,-8843,0,-116,4982,0,0,,5098,4866
41,10-08-17,46,11:15,11:30,38.39,,0,38.39,38.39,1,-57811,33800,91611,-24011,0,0,10168,0,0,,10168,10168
41,10-08-17,47,11:30,11:45,40.16,,0,40.16,40.16,1,-55666,34709,90375,-20957,0,0,14003,0,0,,14003,14003
41,10-08-17,48,11:45,12:00,38.54,,0,38.54,38.54,1,-54758,38925,93683,-15833,0,0,6905,0,0,,6905,6905
41,10-08-17,49,12:00,12:15,31.99,43.21,0,38.2,38.2,2,-43519,42611,86130,-908,0,-52,625,0,0,,677,573
41,10-08-17,50,12:15,12:30,,29.31,0,29.31,29.31,-1,-37323,52767,90090,15444,0,-5094,0,0,0,,5094,-5094
41,10-08-17,51,12:30,12:45,,25.46,0,25.46,25.46,-1,-36640,61829,98469,25189,0,-19161,0,0,0,,19161,-19161
41,10-08-17,52,12:45,13:00,,23.56,0,23.56,23.56,-1,-46871,70642,117513,23771,0,-15134,0,0,0,,15134,-15134
41,10-08-17,53,13:00,13:15,32.93,23.44,0,32.93,32.93,1,-44793,55448,100241,10655,0,-11796,181,0,0,,11977,-11615
41,10-08-17,54,13:15,13:30,,25.46,0,25.46,25.46,-1,-53564,71873,125437,18309,0,-11699,0,0,0,,11699,-11699
41,10-08-17,55,13:30,13:45,,29.46,0,29.46,29.46,-1,-51738,73155,124893,21417,0,-17200,0,0,0,,17200,-17200
41,10-08-17,56,13:45,14:00,,29.31,0,29.31,29.31,-1,-48410,78337,126747,29927,0,-26817,0,0,0,,26817,-26817
41,10-08-17,57,14:00,14:15,,25.46,0,25.46,25.46,-1,-35448,73043,108491,37595,0,-17121,0,0,0,,17121,-17121
41,10-08-17,58,14:15,14:30,42.72,25.46,0,42.72,42.72,1,-41146,44695,85841,3549,0,-25,147,0,0,,172,122
41,10-08-17,59,14:30,14:45,,,0,38.2,38.2,0,-42662,58696,101358,16034,0,0,0,0,0,,0,0
41,10-08-17,60,14:45,15:00,,41.94,0,41.94,41.94,-1,-46699,56280,102979,9581,0,-66,0,0,0,,66,-66
41,10-08-17,61,15:00,15:15,,-55.05,0,-55.05,-55.05,-1,-11466,111824,123290,100358,0,-28868,0,0,0,,28868,-28868
41,10-08-17,62,15:15,15:30,,27.27,0,27.27,27.27,-1,-19609,60839,80448,41230,0,-13784,0,0,0,,13784,-13784
41,10-08-17,63,15:30,15:45,,25.46,0,25.46,25.46,-1,-25466,64848,90314,39382,0,-20010,0,0,0,,20010,-20010
41,10-08-17,64,15:45,16:00,,25.46,0,25.46,25.46,-1,-29275,60927,90202,31652,0,-32365,0,0,0,,32365,-32365
41,10-08-17,65,16:00,16:15,,16.88,0,16.88,16.88,-1,-30104,115194,145298,85090,0,-38313,0,0,0,,38313,-38313
41,10-08-17,66,16:15,16:30,,25.46,0,25.46,25.46,-1,-28485,68387,96872,39902,0,-30334,0,0,0,,30334,-30334
41,10-08-17,67,16:30,16:45,,29.46,0,29.46,29.46,-1,-28207,50238,78445,22031,0,-14515,0,0,0,,14515,-14515
41,10-08-17,68,16:45,17:00,,32.26,0,32.26,32.26,-1,-36104,70120,106224,34016,0,-1574,0,0,0,,1574,-1574
41,10-08-17,69,17:00,17:15,32.93,32.26,0,32.93,32.93,1,-73370,74636,148006,1266,0,-9,629,0,0,,638,620
41,10-08-17,70,17:15,17:30,,,0,38.21,38.21,0,-39426,75143,114569,35717,0,0,0,0,0,,0,0
41,10-08-17,71,17:30,17:45,38.36,,0,38.36,38.36,1,-55873,56381,112254,508,0,0,1008,0,0,,1008,1008
41,10-08-17,72,17:45,18:00,50.57,,0,50.57,50.57,1,-66419,47831,114250,-18588,0,0,18265,0,0,,18265,18265
41,10-08-17,73,18:00,18:15,50.57,3.39,0,3.39,3.39,-1,-11348,100461,111809,89113,0,-14901,4123,0,0,,19024,-10778
41,10-08-17,74,18:15,18:30,,29.46,0,29.46,29.46,-1,-14308,70151,84459,55843,0,-12160,0,0,0,,12160,-12160
41,10-08-17,75,18:30,18:45,,,0,38.2,38.2,0,-15585,82721,98306,67136,0,-73,0,0,0,,73,-73
41,10-08-17,76,18:45,19:00,,,0,38.2,38.2,0,-26137,89744,115881,63607,0,0,0,0,0,,0,0
41,10-08-17,77,19:00,19:15,,29.46,0,29.46,29.46,-1,-21256,101305,122561,80049,0,-1640,0,0,0,,1640,-1640
41,10-08-17,78,19:15,19:30,,,0,38.2,38.2,0,-34264,68189,102453,33925,0,-48,0,0,0,,48,-48
41,10-08-17,79,19:30,19:45,,44.47,0,44.47,44.47,-1,-38295,55186,93481,16891,0,-51,0,0,0,,51,-51
41,10-08-17,80,19:45,20:00,,,0,38.2,38.2,0,-35331,49913,85244,14582,0,0,0,0,0,,0,0
41,10-08-17,81,20:00,20:15,59.12,,0,59.12,59.12,1,-84282,64585,148867,-19697,0,0,8154,0,0,,8154,8154
41,10-08-17,82,20:15,20:30,34.34,25.46,0,25.46,25.46,-1,-62226,80609,142835,18383,0,-1937,5610,0,0,,7547,3673
41,10-08-17,83,20:30,20:45,,24.33,0,24.33,24.33,-1,-47616,87170,134786,39554,0,-16014,0,0,0,,16014,-16014
41,10-08-17,84,20:45,21:00,,18,0,18,18,-1,-34680,93714,128394,59034,0,-26042,0,0,0,,26042,-26042
41,10-08-17,85,21:00,21:15,38.36,29.46,0,38.36,38.36,1,-61885,62707,124592,822,0,-13513,694,0,0,,14207,-12819
41,10-08-17,86,21:15,21:30,,,0,38.18,38.18,0,-58207,64683,122890,6476,0,0,16,0,0,,16,16
41,10-08-17,87,21:30,21:45,,,0,38.18,38.18,0,-42917,71753,114670,28836,0,0,0,0,0,,0,0
41,10-08-17,88,21:45,22:00,,30.46,0,30.46,30.46,-1,-38594,87976,126570,49382,0,-512,0,0,0,,512,-512
41,10-08-17,89,22:00,22:15,44.06,29.78,0,44.06,29.78,2,-74249,39524,113773,-34725,0,-716,3182,0,0,,3898,2466
41,10-08-17,90,22:15,22:30,32.47,,0,32.47,32.47,1,-59850,50831,110681,-9019,0,0,1992,0,0,,1992,1992
41,10-08-17,91,22:30,22:45,31.98,,0,31.98,31.98,1,-55971,57606,113577,1635,0,0,18,0,0,,18,18
41,10-08-17,92,22:45,23:00,32.1,,0,32.1,32.1,1,-54408,71334,125742,16926,0,0,362,0,0,,362,362
41,10-08-17,93,23:00,23:15,38.36,,0,38.36,38.36,1,-64419,49775,114194,-14644,0,0,953,0,0,,953,953
41,10-08-17,94,23:15,23:30,,,0,38.16,38.16,0,-50422,43886,94308,-6536,0,0,23,0,0,,23,23
41,10-08-17,95,23:30,23:45,,,0,38.16,38.16,0,-38783,57342,96125,18559,0,0,0,0,0,,0,0
41,10-08-17,96,23:45,0:00,,26.33,0,26.33,26.33,-1,-30447,51931,82378,21484,0,-3173,0,0,0,,3173,-3173
41,10-09-17,1,0:00,0:15,393.16,27.1,0,393.16,27.1,2,-61036,12719,73755,-48317,0,-3475,12630,0,0,,16105,9155
41,10-09-17,2,0:15,0:30,393.16,29.46,0,29.46,29.46,-1,-25383,42120,67503,16737,0,-773,2483,0,0,,3256,1710
41,10-09-17,3,0:30,0:45,,24.77,0,24.77,24.77,-1,-21616,63994,85610,42378,0,-3517,0,0,0,,3517,-3517
41,10-09-17,4,0:45,1:00,,18.72,0,18.72,18.72,-1,-27547,67467,95014,39920,0,-36830,0,0,0,,36830,-36830
41,10-09-17,5,1:00,1:15,,27.03,0,27.03,27.03,-1,-26801,52139,78940,25338,0,-19410,0,0,0,,19410,-19410
41,10-09-17,6,1:15,1:30,38.04,32.15,0,38.09,32.15,2,-24682,42854,67536,18172,0,-234,1,0,0,,235,-233
41,10-09-17,7,1:30,1:45,,33.17,0,33.17,33.17,-1,-24426,44021,68447,19595,0,-863,0,0,0,,863,-863
41,10-09-17,8,1:45,2:00,,24.67,0,24.67,24.67,-1,-31399,51456,82855,20057,0,-15934,0,0,0,,15934,-15934
41,10-09-17,9,2:00,2:15,44.36,28.31,0,44.36,44.36,1,-12014,37237,49251,25223,0,-14827,840,0,0,,15667,-13987
41,10-09-17,10,2:15,2:30,32.46,32.05,0,38.1,32.05,2,-20593,20688,41281,95,0,-167,1641,0,0,,1808,1474
41,10-09-17,11,2:30,2:45,,31.03,0,31.03,31.03,-1,-19109,24199,43308,5090,0,-238,0,0,0,,238,-238
41,10-09-17,12,2:45,3:00,,29.46,0,29.46,29.46,-1,-19508,25849,45357,6341,0,-2897,0,0,0,,2897,-2897
41,10-09-17,13,3:00,3:15,,28.56,0,28.56,28.56,-1,-26986,45378,72364,18392,0,-4411,0,0,0,,4411,-4411
41,10-09-17,14,3:15,3:30,,,0,38.11,38.11,0,-43413,26295,69708,-17118,0,0,0,0,0,,0,0
41,10-09-17,15,3:30,3:45,,,0,38.11,38.11,0,-41895,31019,72914,-10876,0,0,0,0,0,,0,0
41,10-09-17,16,3:45,4:00,,32.88,0,32.88,32.88,-1,-51313,35751,87064,-15562,0,-21,0,0,0,,21,-21
41,10-09-17,17,4:00,4:15,,21.69,0,21.69,21.69,-1,-19672,85492,105164,65820,0,-14781,0,0,0,,14781,-14781
41,10-09-17,18,4:15,4:30,,29.82,0,29.82,29.82,-1,-34432,65143,99575,30711,0,-14436,0,0,0,,14436,-14436
41,10-09-17,19,4:30,4:45,,44.2,0,44.2,44.2,-1,-39857,56449,96306,16592,0,-580,0,0,0,,580,-580
41,10-09-17,20,4:45,5:00,,31.07,0,31.07,31.07,-1,-29322,60011,89333,30689,0,-1262,0,0,0,,1262,-1262
41,10-09-17,21,5:00,5:15,,33.37,0,33.37,33.37,-1,-61376,43900,105276,-17476,0,-624,0,0,0,,624,-624
41,10-09-17,22,5:15,5:30,,32.07,0,32.07,32.07,-1,-24551,48488,73039,23937,0,-3562,0,0,0,,3562,-3562
41,10-09-17,23,5:30,5:45,38.04,32.07,0,38.04,38.04,1,-46152,33803,79955,-12349,0,-222,533,0,0,,755,311
41,10-09-17,24,5:45,6:00,44.36,,0,44.36,44.36,1,-53328,64476,117804,11148,0,0,5457,0,0,,5457,5457
41,10-09-17,25,6:00,6:15,,-7.54,0,-7.54,-7.54,-1,-32709,111682,144391,78973,0,-24014,0,0,0,,24014,-24014
41,10-09-17,26,6:15,6:30,,30.99,0,30.99,30.99,-1,-23728,61834,85562,38106,0,-15734,0,0,0,,15734,-15734
41,10-09-17,27,6:30,6:45,,42.89,0,42.89,42.89,-1,-46985,60621,107606,13636,0,-1860,0,0,0,,1860,-1860
41,10-09-17,28,6:45,7:00,61.34,42.89,0,61.34,61.34,1,-85001,51541,136542,-33460,0,-59,6565,0,0,,6624,6506
41,10-09-17,29,7:00,7:15,61.34,26.99,0,26.99,26.99,-1,-76464,125334,201798,48870,0,-2806,1269,0,0,,4075,-1537
41,10-09-17,30,7:15,7:30,,,0,38.97,38.97,0,-82211,95177,177388,12966,0,0,0,0,0,,0,0
41,10-09-17,31,7:30,7:45,40.98,,0,40.98,40.98,1,-96543,87749,184292,-8794,0,0,1613,0,0,,1613,1613
41,10-09-17,32,7:45,8:00,41.37,,0,41.37,41.37,1,-108236,82890,191126,-25346,0,0,7627,0,0,,7627,7627
41,10-09-17,33,8:00,8:15,41.37,4.13,0,4.13,4.13,-1,-28567,96785,125352,68218,0,-19486,1945,0,0,,21431,-17541
41,10-09-17,34,8:15,8:30,,30.21,0,30.21,30.21,-1,-35527,70896,106423,35369,0,-11472,0,0,0,,11472,-11472
41,10-09-17,35,8:30,8:45,32.99,26.21,0,38.97,26.21,2,-52315,68717,121032,16402,0,-20607,65,0,0,,20672,-20542
41,10-09-17,36,8:45,9:00,35.48,26.21,0,35.48,35.48,1,-68367,57100,125467,-11267,0,-1923,1309,0,0,,3232,-614
41,10-09-17,37,9:00,9:15,,30.99,0,30.99,30.99,-1,-40031,56094,96125,16063,0,-3721,0,0,0,,3721,-3721
41,10-09-17,38,9:15,9:30,,30.61,0,30.61,30.61,-1,-47660,45784,93444,-1876,0,-6084,0,0,0,,6084,-6084
41,10-09-17,39,9:30,9:45,,31.21,0,31.21,31.21,-1,-40206,53107,93313,12901,0,-3064,0,0,0,,3064,-3064
41,10-09-17,40,9:45,10:00,,34.03,0,34.03,34.03,-1,-47433,38436,85869,-8997,0,-4414,0,0,0,,4414,-4414
41,10-09-17,41,10:00,10:15,34.47,41.81,0,39.08,39.08,2,-56517,26566,83083,-29951,0,-287,1206,0,0,,1493,919
41,10-09-17,42,10:15,10:30,32.39,,0,32.39,32.39,1,-61100,26539,87639,-34561,0,0,923,0,0,,923,923
41,10-09-17,43,10:30,10:45,,,0,39.11,39.11,0,-65374,26036,91410,-39338,0,0,24,0,0,,24,24
41,10-09-17,44,10:45,11:00,,,0,39.11,39.11,0,-70655,23275,93930,-47380,0,0,0,0,0,,0,0
41,10-09-17,45,11:00,11:15,69.04,,0,69.04,69.04,1,-102739,16958,119697,-85781,0,0,5611,0,0,,5611,5611
41,10-09-17,46,11:15,11:30,32.39,,0,32.39,32.39,1,-89078,19440,108518,-69638,0,0,1591,0,0,,1591,1591
41,10-09-17,47,11:30,11:45,35.96,,0,35.96,35.96,1,-84723,29764,114487,-54959,0,0,896,0,0,,896,896
41,10-09-17,48,11:45,12:00,34.31,,0,34.31,34.31,1,-86838,21573,108411,-65265,0,0,1606,0,0,,1606,1606
41,10-09-17,49,12:00,12:15,60.58,,0,60.58,60.58,1,-100167,19177,119344,-80990,0,0,6907,0,0,,6907,6907
41,10-09-17,50,12:15,12:30,33.21,,0,33.21,33.21,1,-87571,21051,108622,-66520,0,0,2751,0,0,,2751,2751
41,10-09-17,51,12:30,12:45,119.16,,0,119.16,119.16,1,-69743,21986,91729,-47757,0,0,9715,0,0,,9715,9715
41,10-09-17,52,12:45,13:00,33.39,,0,33.39,33.39,1,-59777,24381,84158,-35396,0,0,3760,0,0,,3760,3760
41,10-09-17,53,13:00,13:15,41.34,,0,41.34,41.34,1,-66249,24494,90743,-41755,0,0,3493,0,0,,3493,3493
41,10-09-17,54,13:15,13:30,65.19,,0,65.19,65.19,1,-84220,19847,104067,-64373,0,0,10361,0,0,,10361,10361
41,10-09-17,55,13:30,13:45,33.98,,0,33.98,33.98,1,-66788,18045,84833,-48743,0,0,554,0,0,,554,554
41,10-09-17,56,13:45,14:00,,,0,39.48,39.48,0,-69013,18279,87292,-50734,0,0,0,0,0,,0,0
41,10-09-17,57,14:00,14:15,435.36,,0,435.36,435.36,1,-72170,14131,86301,-58039,0,0,17741,0,0,,17741,17741
41,10-09-17,58,14:15,14:30,56.11,,0,56.11,56.11,1,-51921,32200,84121,-19721,0,0,19507,0,0,,19507,19507
41,10-09-17,59,14:30,14:45,33.21,,0,33.21,33.21,1,-61254,19847,81101,-41407,0,0,654,0,0,,654,654
41,10-09-17,60,14:45,15:00,40.3,,0,40.3,40.3,1,-76634,10525,87159,-66109,0,0,889,0,0,,889,889
41,10-09-17,61,15:00,15:15,365.11,,0,365.11,365.11,1,-97106,10082,107188,-87024,0,0,44924,0,0,,44924,44924
41,10-09-17,62,15:15,15:30,53.26,,0,53.26,53.26,1,-81696,47044,128740,-34652,0,0,27045,0,0,,27045,27045
41,10-09-17,63,15:30,15:45,365.11,,0,365.11,365.11,1,-98224,35730,133954,-62494,0,0,46999,0,0,,46999,46999
41,10-09-17,64,15:45,16:00,83.97,,0,83.97,83.97,1,-105059,39878,144937,-65181,0,0,55050,0,0,,55050,55050
41,10-09-17,65,16:00,16:15,33.06,30.99,0,39.49,30.99,2,-70951,90780,161731,19829,0,-2040,17144,0,0,,19184,15104
41,10-09-17,66,16:15,16:30,34.27,30.99,0,34.27,34.27,1,-66779,59155,125934,-7624,0,-5,1626,0,0,,1631,1621
41,10-09-17,67,16:30,16:45,57.51,,0,57.51,57.51,1,-66008,35979,101987,-30029,0,0,4125,0,0,,4125,4125
41,10-09-17,68,16:45,17:00,57.51,,0,57.51,57.51,1,-53019,38589,91608,-14430,0,0,7131,0,0,,7131,7131
41,10-09-17,69,17:00,17:15,33.21,31.85,0,39.49,31.85,2,-54237,53255,107492,-982,0,-335,527,0,0,,862,192
41,10-09-17,70,17:15,17:30,,,0,39.5,39.5,0,-58595,40230,98825,-18365,0,0,0,0,0,,0,0
41,10-09-17,71,17:30,17:45,,,0,39.49,39.49,0,-60792,54223,115015,-6569,0,0,0,0,0,,0,0
41,10-09-17,72,17:45,18:00,,,0,39.5,39.5,0,-54304,77257,131561,22953,0,0,0,0,0,,0,0
41,10-09-17,73,18:00,18:15,,26.21,0,26.21,26.21,-1,-52820,68299,121119,15479,0,-6475,0,0,0,,6475,-6475
41,10-09-17,74,18:15,18:30,33.21,26.21,0,33.21,33.21,1,-43007,55660,98667,12653,0,-9266,189,0,0,,9455,-9077
41,10-09-17,75,18:30,18:45,33.21,,0,33.21,33.21,1,-48672,62814,111486,14142,0,0,256,0,0,,256,256
41,10-09-17,76,18:45,19:00,39.74,,0,39.74,39.74,1,-63144,61849,124993,-1295,0,0,3593,0,0,,3593,3593
41,10-09-17,77,19:00,19:15,81,,0,81,81,1,-70689,41871,112560,-28818,0,0,9003,0,0,,9003,9003
41,10-09-17,78,19:15,19:30,35,,0,35,35,1,-81542,52436,133978,-29106,0,0,384,0,0,,384,384
41,10-09-17,79,19:30,19:45,,,0,39.48,39.48,0,-56439,53601,110040,-2838,0,0,69,0,0,,69,69
41,10-09-17,80,19:45,20:00,,31.21,0,31.21,31.21,-1,-40099,67077,107176,26978,0,-630,0,0,0,,630,-630
41,10-09-17,81,20:00,20:15,33.21,31.21,0,33.21,33.21,1,-56993,62650,119643,5657,0,-64,149,0,0,,213,85
41,10-09-17,82,20:15,20:30,,19.61,0,19.61,19.61,-1,-42906,85201,128107,42295,0,-5001,0,0,0,,5001,-5001
41,10-09-17,83,20:30,20:45,,16.21,0,16.21,16.21,-1,-29579,79289,108868,49710,0,-23889,0,0,0,,23889,-23889
41,10-09-17,84,20:45,21:00,,9.5,0,9.5,9.5,-1,-36511,108571,145082,72060,0,-44180,0,0,0,,44180,-44180
41,10-09-17,85,21:00,21:15,54.63,9.5,0,54.63,54.63,1,-76391,27107,103498,-49284,0,-11869,1574,0,0,,13443,-10295
41,10-09-17,86,21:15,21:30,,45.49,0,45.49,45.49,-1,-53554,56090,109644,2536,0,-37,0,0,0,,37,-37
41,10-09-17,87,21:30,21:45,,26.21,0,26.21,26.21,-1,-50835,75592,126427,24757,0,-14509,0,0,0,,14509,-14509
41,10-09-17,88,21:45,22:00,,26.99,0,26.99,26.99,-1,-61068,90408,151476,29340,0,-16568,0,0,0,,16568,-16568
41,10-09-17,89,22:00,22:15,38.64,31.21,0,39.46,31.21,2,-87115,16694,103809,-70421,0,-9067,1402,0,0,,10469,-7665
41,10-09-17,90,22:15,22:30,,44.5,0,44.5,44.5,-1,-54842,37842,92684,-17000,0,-35,0,0,0,,35,-35
41,10-09-17,91,22:30,22:45,,26.21,0,26.21,26.21,-1,-41492,71194,112686,29702,0,-15579,0,0,0,,15579,-15579
41,10-09-17,92,22:45,23:00,,14.58,0,14.58,14.58,-1,-47951,100825,148776,52874,0,-35461,0,0,0,,35461,-35461
41,10-09-17,93,23:00,23:15,38.29,-3.05,0,39.45,-3.05,2,-45174,56238,101412,11064,0,-27359,576,0,0,,27935,-26783
41,10-09-17,94,23:15,23:30,39.06,26.21,0,39.06,26.21,2,-31194,39890,71084,8696,0,-6696,211,0,0,,6907,-6485
41,10-09-17,95,23:30,23:45,,25.34,0,25.34,25.34,-1,-46596,74369,120965,27773,0,-31840,0,0,0,,31840,-31840
41,10-09-17,96,23:45,0:00,32.56,30.21,0,32.56,32.56,1,-96490,86220,182710,-10270,0,-19649,337,0,0,,19986,-19312
41,10-10-17,1,0:00,0:15,32.56,-58.56,0,-58.56,-58.56,-1,-52863,132831,185694,79968,0,-26111,68,0,0,,26179,-26043
41,10-10-17,2,0:15,0:30,37.65,31.67,0,38.71,31.67,2,-47073,42263,89336,-4810,0,-8351,607,0,0,,8958,-7744
41,10-10-17,3,0:30,0:45,33.04,23.32,0,23.32,23.32,-1,-32920,52146,85066,19226,0,-4777,32,0,0,,4809,-4745
41,10-10-17,4,0:45,1:00,,17.67,0,17.67,17.67,-1,-43728,80918,124646,37190,0,-43801,0,0,0,,43801,-43801
41,10-10-17,5,1:00,1:15,40.49,1.13,0,40.49,1.13,2,-43864,67463,111327,23599,0,-36357,387,0,0,,36744,-35970
41,10-10-17,6,1:15,1:30,50.67,27.67,0,50.67,27.67,2,-34940,45231,80171,10291,0,-4576,2275,0,0,,6851,-2301
41,10-10-17,7,1:30,1:45,,27.67,0,27.67,27.67,-1,-30654,61335,91989,30681,0,-23059,0,0,0,,23059,-23059
41,10-10-17,8,1:45,2:00,,8.6,0,8.6,8.6,-1,-37538,91162,128700,53624,0,-46646,0,0,0,,46646,-46646
41,10-10-17,9,2:00,2:15,41.92,8.6,0,41.92,41.92,1,-49033,51913,100946,2880,0,-23453,1599,0,0,,25052,-21854
41,10-10-17,10,2:15,2:30,41.92,27.67,0,27.67,27.67,-1,-37453,50084,87537,12631,0,-12273,89,0,0,,12362,-12184
41,10-10-17,11,2:30,2:45,,31.78,0,31.78,31.78,-1,-38966,47365,86331,8399,0,-8122,0,0,0,,8122,-8122
41,10-10-17,12,2:45,3:00,,28.72,0,28.72,28.72,-1,-42840,57709,100549,14869,0,-7006,0,0,0,,7006,-7006
41,10-10-17,13,3:00,3:15,34.67,27.67,0,34.67,27.67,2,-38093,44928,83021,6835,0,-10435,395,0,0,,10830,-10040
41,10-10-17,14,3:15,3:30,,33.41,0,33.41,33.41,-1,-50231,40880,91111,-9351,0,-279,0,0,0,,279,-279
41,10-10-17,15,3:30,3:45,33.49,,0,33.49,33.49,1,-49489,32374,81863,-17115,0,0,503,0,0,,503,503
41,10-10-17,16,3:45,4:00,36.45,31.67,0,36.45,31.67,2,-53156,38830,91986,-14326,0,-279,2874,0,0,,3153,2595
41,10-10-17,17,4:00,4:15,36.45,31.67,0,31.67,31.67,-1,-30539,32780,63319,2241,0,-584,55,0,0,,639,-529
41,10-10-17,18,4:15,4:30,,32.67,0,32.67,32.67,-1,-34119,29591,63710,-4528,0,-2071,0,0,0,,2071,-2071
41,10-10-17,19,4:30,4:45,,,0,33.45,33.45,0,-37285,30477,67762,-6808,0,-44,0,0,0,,44,-44
41,10-10-17,20,4:45,5:00,34.67,,0,34.67,34.67,1,-37541,38793,76334,1252,0,0,26,0,0,,26,26
41,10-10-17,21,5:00,5:15,34.67,32.67,0,34.67,32.67,2,-38972,67490,106462,28518,0,-995,265,0,0,,1260,-730
41,10-10-17,22,5:15,5:30,,21.52,0,21.52,21.52,-1,-20015,50900,70915,30885,0,-9530,0,0,0,,9530,-9530
41,10-10-17,23,5:30,5:45,35.11,21.52,0,35.11,35.11,1,-52996,26601,79597,-26395,0,-308,442,0,0,,750,134
41,10-10-17,24,5:45,6:00,44.67,,0,44.67,44.67,1,-63244,24640,87884,-38604,0,0,2344,0,0,,2344,2344
41,10-10-17,25,6:00,6:15,,26.13,0,26.13,26.13,-1,-69843,91177,161020,21334,0,-7364,0,0,0,,7364,-7364
41,10-10-17,26,6:15,6:30,,17.16,0,17.16,17.16,-1,-29771,55092,84863,25321,0,-36508,0,0,0,,36508,-36508
41,10-10-17,27,6:30,6:45,421.92,17.16,0,421.92,421.92,1,-70401,26716,97117,-43685,0,-6094,11215,0,0,,17309,5121
41,10-10-17,28,6:45,7:00,421.92,32.78,0,421.92,32.78,2,-64748,84327,149075,19579,0,-394,23404,0,0,,23798,23010
41,10-10-17,29,7:00,7:15,421.92,-16.8,0,-16.8,-16.8,-1,-63621,147113,210734,83492,0,-18754,465,0,0,,19219,-18289
41,10-10-17,30,7:15,7:30,,,0,39.44,39.44,0,-37487,63835,101322,26348,0,-485,0,0,0,,485,-485
41,10-10-17,31,7:30,7:45,35.99,,0,35.99,35.99,1,-44618,43592,88210,-1026,0,0,1229,0,0,,1229,1229
41,10-10-17,32,7:45,8:00,,,0,39.4,39.4,0,-47601,69571,117172,21970,0,0,321,0,0,,321,321
41,10-10-17,33,8:00,8:15,,45.89,0,45.89,45.89,-1,-15391,106767,122158,91376,0,-334,0,0,0,,334,-334
41,10-10-17,34,8:15,8:30,,33.21,0,33.21,33.21,-1,-12934,102294,115228,89360,0,-1087,0,0,0,,1087,-1087
41,10-10-17,35,8:30,8:45,,45.41,0,45.41,45.41,-1,-33254,82819,116073,49565,0,-779,0,0,0,,779,-779
41,10-10-17,36,8:45,9:00,,44.47,0,44.47,44.47,-1,-34984,87154,122138,52170,0,-159,0,0,0,,159,-159
41,10-10-17,37,9:00,9:15,469.76,,0,469.76,469.76,1,-72254,27363,99617,-44891,0,0,14527,0,0,,14527,14527
41,10-10-17,38,9:15,9:30,53.12,,0,53.12,53.12,1,-63577,50784,114361,-12793,0,0,27909,0,0,,27909,27909
41,10-10-17,39,9:30,9:45,34.08,45.9,0,45.9,45.9,-1,-55558,58416,113974,2858,0,-24,5292,0,0,,5316,5268
41,10-10-17,40,9:45,10:00,34.47,45.72,0,39.45,39.45,2,-51063,67724,118787,16661,0,-66,918,0,0,,984,852
41,10-10-17,41,10:00,10:15,37.71,,0,37.71,37.71,1,-56144,51857,108001,-4287,0,0,573,0,0,,573,573
41,10-10-17,42,10:15,10:30,,41.59,0,41.59,41.59,-1,-46677,62167,108844,15490,0,-1030,0,0,0,,1030,-1030
41,10-10-17,43,10:30,10:45,475.45,17.67,0,475.45,17.67,2,-59737,94372,154109,34635,0,-4090,1151,0,0,,5241,-2939
41,10-10-17,44,10:45,11:00,,17.67,0,17.67,17.67,-1,-60229,102773,163002,42544,0,-13938,0,0,0,,13938,-13938
41,10-10-17,45,11:00,11:15,34.67,31.78,0,39.45,31.78,2,-67327,77269,144596,9942,0,-7406,346,0,0,,7752,-7060
41,10-10-17,46,11:15,11:30,34.67,27.67,0,27.67,27.67,-1,-48726,69188,117914,20462,0,-2878,53,0,0,,2931,-2825
41,10-10-17,47,11:30,11:45,,27.67,0,27.67,27.67,-1,-62473,64775,127248,2302,0,-12290,0,0,0,,12290,-12290
41,10-10-17,48,11:45,12:00,33,31.67,0,39.46,31.67,2,-56153,61979,118132,5826,0,-1515,42,0,0,,1557,-1473
41,10-10-17,49,12:00,12:15,33.03,31.67,0,39.46,31.67,2,-63444,35390,98834,-28054,0,-1453,144,0,0,,1597,-1309
41,10-10-17,50,12:15,12:30,,,0,39.47,39.47,0,-45227,30156,75383,-15071,0,0,0,0,0,,0,0
41,10-10-17,51,12:30,12:45,,32.67,0,32.67,32.67,-1,-36184,41105,77289,4921,0,-6609,0,0,0,,6609,-6609
41,10-10-17,52,12:45,13:00,,27.67,0,27.67,27.67,-1,-35963,64614,100577,28651,0,-19608,0,0,0,,19608,-19608
41,10-10-17,53,13:00,13:15,53.08,27.67,0,53.08,27.67,2,-67164,32102,99266,-35062,0,-16475,4074,0,0,,20549,-12401
41,10-10-17,54,13:15,13:30,53.08,33.94,0,33.94,33.94,-1,-51093,36254,87347,-14839,0,-201,1235,0,0,,1436,1034
41,10-10-17,55,13:30,13:45,,33.4,0,33.4,33.4,-1,-50203,34829,85032,-15374,0,-323,0,0,0,,323,-323
41,10-10-17,56,13:45,14:00,,,0,39.5,39.5,0,-54825,36744,91569,-18081,0,0,0,0,0,,0,0
41,10-10-17,57,14:00,14:15,56.21,,0,56.21,56.21,1,-81216,58872,140088,-22344,0,0,9450,0,0,,9450,9450
41,10-10-17,58,14:15,14:30,39.01,,0,39.01,39.01,1,-75683,62233,137916,-13450,0,0,10774,0,0,,10774,10774
41,10-10-17,59,14:30,14:45,38.67,,0,38.67,38.67,1,-81632,58278,139910,-23354,0,0,3216,0,0,,3216,3216
41,10-10-17,60,14:45,15:00,,,0,39.48,39.48,0,-84465,54130,138595,-30335,0,0,1057,0,0,,1057,1057
41,10-10-17,61,15:00,15:15,34.08,,0,34.08,34.08,1,-62856,56101,118957,-6755,0,0,97,0,0,,97,97
41,10-10-17,62,15:15,15:30,35.43,,0,35.43,35.43,1,-75407,56728,132135,-18679,0,0,2518,0,0,,2518,2518
41,10-10-17,63,15:30,15:45,34.12,,0,34.12,34.12,1,-61791,57366,119157,-4425,0,0,2400,0,0,,2400,2400
41,10-10-17,64,15:45,16:00,34.67,,0,34.67,34.67,1,-64672,61567,126239,-3105,0,0,1329,0,0,,1329,1329
41,10-10-17,65,16:00,16:15,34.47,29.67,0,40.93,29.67,2,-55688,69791,125479,14103,0,-3277,1380,0,0,,4657,-1897
41,10-10-17,66,16:15,16:30,34.47,32.99,0,32.99,32.99,-1,-48093,54405,102498,6312,0,-1947,16,0,0,,1963,-1931
41,10-10-17,67,16:30,16:45,50.67,34.74,0,50.67,50.67,1,-70975,41506,112481,-29469,0,-668,6775,0,0,,7443,6107
41,10-10-17,68,16:45,17:00,50.67,,0,50.67,50.67,1,-62924,45752,108676,-17172,0,0,14710,0,0,,14710,14710
41,10-10-17,69,17:00,17:15,50.67,32.67,0,32.67,32.67,-1,-72572,94426,166998,21854,0,-1564,706,0,0,,2270,-858
41,10-10-17,70,17:15,17:30,34.05,48.78,0,40.88,40.88,2,-73499,73563,147062,64,0,-286,43,0,0,,329,-243
41,10-10-17,71,17:30,17:45,34.67,48.74,0,40.86,40.86,2,-70623,81076,151699,10453,0,-23,912,0,0,,935,889
41,10-10-17,72,17:45,18:00,,27.67,0,27.67,27.67,-1,-56192,89580,145772,33388,0,-11272,0,0,0,,11272,-11272
41,10-10-17,73,18:00,18:15,,-40.95,0,-40.95,-40.95,-1,-50343,135311,185654,84968,0,-51482,0,0,0,,51482,-51482
41,10-10-17,74,18:15,18:30,,23.78,0,23.78,23.78,-1,-41241,98807,140048,57566,0,-44392,0,0,0,,44392,-44392
41,10-10-17,75,18:30,18:45,,27.67,0,27.67,27.67,-1,-42840,85164,128004,42324,0,-34612,0,0,0,,34612,-34612
41,10-10-17,76,18:45,19:00,38.67,27.67,0,38.67,38.67,1,-73735,97977,171712,24242,0,-2298,24,0,0,,2322,-2274
41,10-10-17,77,19:00,19:15,,29.6,0,29.6,29.6,-1,-52542,109972,162514,57430,0,-3184,0,0,0,,3184,-3184
41,10-10-17,78,19:15,19:30,,16.64,0,16.64,16.64,-1,-42344,99176,141520,56832,0,-29482,0,0,0,,29482,-29482
41,10-10-17,79,19:30,19:45,,24.4,0,24.4,24.4,-1,-37015,97513,134528,60498,0,-22975,0,0,0,,22975,-22975
41,10-10-17,80,19:45,20:00,,-14.74,0,-14.74,-14.74,-1,-33671,103055,136726,69384,0,-60080,0,0,0,,60080,-60080
41,10-10-17,81,20:00,20:15,,31.67,0,31.67,31.67,-1,-53605,84470,138075,30865,0,-13086,0,0,0,,13086,-13086
41,10-10-17,82,20:15,20:30,,-3.82,0,-3.82,-3.82,-1,-32711,105668,138379,72957,0,-15825,0,0,0,,15825,-15825
41,10-10-17,83,20:30,20:45,,-21.39,0,-21.39,-21.39,-1,-33451,78136,111587,44685,0,-42189,0,0,0,,42189,-42189
41,10-10-17,84,20:45,21:00,,-10.77,0,-10.77,-10.77,-1,-26985,98609,125594,71624,0,-52978,0,0,0,,52978,-52978
41,10-10-17,85,21:00,21:15,227.56,-10.77,0,227.56,227.56,1,-98486,56234,154720,-42252,0,-14664,8949,0,0,,23613,-5715
41,10-10-17,86,21:15,21:30,227.56,24.98,0,24.98,24.98,-1,-33426,66780,100206,33354,0,-5401,930,0,0,,6331,-4471
41,10-10-17,87,21:30,21:45,,12.76,0,12.76,12.76,-1,-25806,74890,100696,49084,0,-42978,0,0,0,,42978,-42978
41,10-10-17,88,21:45,22:00,,6,0,6,6,-1,-48417,100068,148485,51651,0,-44325,0,0,0,,44325,-44325
41,10-10-17,89,22:00,22:15,38.93,-48.64,0,38.93,-48.64,2,-38190,117209,155399,79019,0,-37310,380,0,0,,37690,-36930
41,10-10-17,90,22:15,22:30,37.59,-47.27,0,37.59,-47.27,2,-25392,120117,145509,94725,0,-24100,472,0,0,,24572,-23628
41,10-10-17,91,22:30,22:45,,-19.78,0,-19.78,-19.78,-1,-16277,121243,137520,104966,0,-77685,0,0,0,,77685,-77685
41,10-10-17,92,22:45,23:00,,-29.63,0,-29.63,-29.63,-1,-25094,126374,151468,101280,0,-86950,0,0,0,,86950,-86950
41,10-10-17,93,23:00,23:15,84.2,-51.9,0,84.2,84.2,1,-78419,82000,160419,3581,0,-49186,2788,0,0,,51974,-46398
41,10-10-17,94,23:15,23:30,84.2,-58.2,0,-58.2,-58.2,-1,-36160,128164,164324,92004,0,-26219,486,0,0,,26705,-25733
41,10-10-17,95,23:30,23:45,,-57.2,0,-57.2,-57.2,-1,-52748,141010,193758,88262,0,-63476,0,0,0,,63476,-63476
41,10-10-17,96,23:45,0:00,,-41.37,0,-41.37,-41.37,-1,-55371,154814,210185,99443,0,-79289,0,0,0,,79289,-79289
41,10-11-17,1,0:00,0:15,,,0,38.75,38.75,0,-65487,99901,165388,34414,0,-12585,0,0,0,,12585,-12585
41,10-11-17,2,0:15,0:30,,20.14,0,20.14,20.14,-1,-58812,110190,169002,51378,0,-5793,0,0,0,,5793,-5793
41,10-11-17,3,0:30,0:45,,21.2,0,21.2,21.2,-1,-83428,130823,214251,47395,0,-5127,0,0,0,,5127,-5127
41,10-11-17,4,0:45,1:00,,-40.54,0,-40.54,-40.54,-1,-61534,137528,199062,75994,0,-57795,0,0,0,,57795,-57795
41,10-11-17,5,1:00,1:15,,21.78,0,21.78,21.78,-1,-69057,118616,187673,49559,0,-21108,0,0,0,,21108,-21108
41,10-11-17,6,1:15,1:30,,8.42,0,8.42,8.42,-1,-62913,125851,188764,62938,0,-8755,0,0,0,,8755,-8755
41,10-11-17,7,1:30,1:45,,7.67,0,7.67,7.67,-1,-59320,112343,171663,53023,0,-38151,0,0,0,,38151,-38151
41,10-11-17,8,1:45,2:00,,17.67,0,17.67,17.67,-1,-95048,110899,205947,15851,0,-41813,0,0,0,,41813,-41813
41,10-11-17,9,2:00,2:15,,22.67,0,22.67,22.67,-1,-64082,121867,185949,57785,0,-16646,0,0,0,,16646,-16646
41,10-11-17,10,2:15,2:30,,14.59,0,14.59,14.59,-1,-58293,106020,164313,47727,0,-37314,0,0,0,,37314,-37314
41,10-11-17,11,2:30,2:45,,14.59,0,14.59,14.59,-1,-58153,109365,167518,51212,0,-34756,0,0,0,,34756,-34756
41,10-11-17,12,2:45,3:00,,27.08,0,27.08,27.08,-1,-74220,115870,190090,41650,0,-14587,0,0,0,,14587,-14587
41,10-11-17,13,3:00,3:15,,28.61,0,28.61,28.61,-1,-66009,100131,166140,34122,0,-13838,0,0,0,,13838,-13838
41,10-11-17,14,3:15,3:30,,28.22,0,28.22,28.22,-1,-67914,93208,161122,25294,0,-4195,0,0,0,,4195,-4195
41,10-11-17,15,3:30,3:45,,29.12,0,29.12,29.12,-1,-68612,92993,161605,24381,0,-1333,0,0,0,,1333,-1333
41,10-11-17,16,3:45,4:00,,24.61,0,24.61,24.61,-1,-65842,101005,166847,35163,0,-10795,0,0,0,,10795,-10795
41,10-11-17,17,4:00,4:15,33.31,24.09,0,38.84,24.09,2,-60151,62968,123119,2817,0,-8438,60,0,0,,8498,-8378
41,10-11-17,18,4:15,4:30,,24.11,0,24.11,24.11,-1,-57104,68309,125413,11205,0,-15354,0,0,0,,15354,-15354
41,10-11-17,19,4:30,4:45,34.67,24.11,0,34.67,34.67,1,-63805,59541,123346,-4264,0,-1270,789,0,0,,2059,-481
41,10-11-17,20,4:45,5:00,,,0,38.84,38.84,0,-57849,68162,126011,10313,0,0,0,0,0,,0,0
41,10-11-17,21,5:00,5:15,,-32.91,0,-32.91,-32.91,-1,-87215,152997,240212,65782,0,-28230,0,0,0,,28230,-28230
41,10-11-17,22,5:15,5:30,,-36.02,0,-36.02,-36.02,-1,-54920,89302,144222,34382,0,-43423,0,0,0,,43423,-43423
41,10-11-17,23,5:30,5:45,,27.67,0,27.67,27.67,-1,-53442,81464,134906,28022,0,-18230,0,0,0,,18230,-18230
41,10-11-17,24,5:45,6:00,,32.67,0,32.67,32.67,-1,-47639,125176,172815,77537,0,-1931,0,0,0,,1931,-1931
41,10-11-17,25,6:00,6:15,,22.82,0,22.82,22.82,-1,-129231,144144,273375,14913,0,-3893,0,0,0,,3893,-3893
41,10-11-17,26,6:15,6:30,,-29.64,0,-29.64,-29.64,-1,-54542,106783,161325,52241,0,-47519,0,0,0,,47519,-47519
41,10-11-17,27,6:30,6:45,40.36,-29.64,0,40.36,40.36,1,-72970,84067,157037,11097,0,-3399,535,0,0,,3934,-2864
41,10-11-17,28,6:45,7:00,41.12,,0,41.12,41.12,1,-102122,111846,213968,9724,0,0,990,0,0,,990,990
41,10-11-17,29,7:00,7:15,,-40.54,0,-40.54,-40.54,-1,-59839,111219,171058,51380,0,-9534,0,0,0,,9534,-9534
41,10-11-17,30,7:15,7:30,35.42,,0,35.42,35.42,1,-71237,77829,149066,6592,0,0,364,0,0,,364,364
41,10-11-17,31,7:30,7:45,420.51,,0,420.51,420.51,1,-121199,39348,160547,-81851,0,0,23499,0,0,,23499,23499
41,10-11-17,32,7:45,8:00,83.12,,0,83.12,83.12,1,-128467,81444,209911,-47023,0,0,43673,0,0,,43673,43673
41,10-11-17,33,8:00,8:15,83.12,30.5,0,30.5,30.5,-1,-89372,118957,208329,29585,0,-776,2902,0,0,,3678,2126
41,10-11-17,34,8:15,8:30,,32.52,0,32.52,32.52,-1,-81029,95035,176064,14006,0,-580,0,0,0,,580,-580
41,10-11-17,35,8:30,8:45,441.21,,0,441.21,441.21,1,-148773,66949,215722,-81824,0,0,6356,0,0,,6356,6356
41,10-11-17,36,8:45,9:00,441.21,32.59,0,441.21,32.59,2,-106316,54721,161037,-51595,0,-131,31443,0,0,,31574,31312
41,10-11-17,37,9:00,9:15,38.39,29.69,0,38.77,29.69,2,-42220,57752,99972,15532,0,-1243,1293,0,0,,2536,50
41,10-11-17,38,9:15,9:30,53,,0,53,53,1,-55577,27080,82657,-28497,0,0,7081,0,0,,7081,7081
41,10-11-17,39,9:30,9:45,38.39,,0,38.39,38.39,1,-50637,37483,88120,-13154,0,0,8043,0,0,,8043,8043
41,10-11-17,40,9:45,10:00,53,,0,53,53,1,-61826,40768,102594,-21058,0,0,14157,0,0,,14157,14157
41,10-11-17,41,10:00,10:15,50.52,32.52,0,50.52,32.52,2,-57358,61738,119096,4380,0,-380,15320,0,0,,15700,14940
41,10-11-17,42,10:15,10:30,33.75,32.52,0,38.77,32.52,2,-61710,54548,116258,-7162,0,-265,272,0,0,,537,7
41,10-11-17,43,10:30,10:45,61.61,,0,61.61,61.61,1,-94008,73015,167023,-20993,0,0,6708,0,0,,6708,6708
41,10-11-17,44,10:45,11:00,161,,0,161,161,1,-123158,73990,197148,-49168,0,0,33608,0,0,,33608,33608
41,10-11-17,45,11:00,11:15,139.57,,0,139.57,139.57,1,-101139,51297,152436,-49842,0,0,65899,0,0,,65899,65899
41,10-11-17,46,11:15,11:30,60.09,,0,60.09,60.09,1,-89668,42499,132167,-47169,0,0,37019,0,0,,37019,37019
41,10-11-17,47,11:30,11:45,59.32,,0,59.32,59.32,1,-92149,45237,137386,-46912,0,0,45574,0,0,,45574,45574
41,10-11-17,48,11:45,12:00,139.57,,0,139.57,139.57,1,-101470,40290,141760,-61180,0,0,43259,0,0,,43259,43259
41,10-11-17,49,12:00,12:15,201.98,,0,201.98,201.98,1,-123038,44693,167731,-78345,0,0,73019,0,0,,73019,73019
41,10-11-17,50,12:15,12:30,147,31.22,0,31.22,31.22,-1,-74049,58202,132251,-15847,0,-699,28015,1250,0,,29964,28566
41,10-11-17,51,12:30,12:45,45.01,27.52,0,45.01,27.52,2,-65615,61952,127567,-3663,0,-3777,1176,0,0,,4953,-2601
41,10-11-17,52,12:45,13:00,60.48,,0,60.48,60.48,1,-73408,41015,114423,-32393,0,0,17420,0,0,,17420,17420
41,10-11-17,53,13:00,13:15,139.98,,0,139.98,139.98,1,-97331,44088,141419,-53243,0,0,40252,0,0,,40252,40252
41,10-11-17,54,13:15,13:30,178.74,,0,178.74,178.74,1,-114706,51886,166592,-62820,0,0,51165,0,0,,51165,51165
41,10-11-17,55,13:30,13:45,178.74,,0,178.74,178.74,1,-114239,53750,167989,-60489,0,0,69211,0,0,,69211,69211
41,10-11-17,56,13:45,14:00,100.12,,0,100.12,100.12,1,-106293,51414,157707,-54879,0,0,35586,0,0,,35586,35586
41,10-11-17,57,14:00,14:15,50.52,31.52,0,31.52,31.52,-1,-92350,99559,191909,7209,0,-880,21138,0,0,,22018,20258
41,10-11-17,58,14:15,14:30,67.24,31.52,0,67.24,31.52,2,-101213,77159,178372,-24054,0,-989,7635,0,0,,8624,6646
41,10-11-17,59,14:30,14:45,78.12,,0,78.12,78.12,1,-104444,80805,185249,-23639,0,0,23796,0,0,,23796,23796
41,10-11-17,60,14:45,15:00,55.72,,0,55.72,55.72,1,-117080,82208,199288,-34872,0,0,21117,0,0,,21117,21117
41,10-11-17,61,15:00,15:15,38.52,,0,38.52,38.52,1,-106735,95016,201751,-11719,0,0,14926,0,0,,14926,14926
41,10-11-17,62,15:15,15:30,51,,0,51,51,1,-97543,89353,186896,-8190,0,0,18609,0,0,,18609,18609
41,10-11-17,63,15:30,15:45,34.52,33.38,0,40.99,33.38,2,-97909,79746,177655,-18163,0,-395,2483,0,0,,2878,2088
41,10-11-17,64,15:45,16:00,50.52,,0,50.52,50.52,1,-115988,93953,209941,-22035,0,0,5186,0,0,,5186,5186
41,10-11-17,65,16:00,16:15,96.78,,0,96.78,96.78,1,-107030,53095,160125,-53935,0,0,22290,0,0,,22290,22290
41,10-11-17,66,16:15,16:30,35.26,,0,35.26,35.26,1,-85641,66184,151825,-19457,0,0,10648,0,0,,10648,10648
41,10-11-17,67,16:30,16:45,38.52,,0,38.52,38.52,1,-100079,74211,174290,-25868,0,0,2554,0,0,,2554,2554
41,10-11-17,68,16:45,17:00,38.52,,0,38.52,38.52,1,-107413,79646,187059,-27767,0,0,6223,0,0,,6223,6223
41,10-11-17,69,17:00,17:15,35.41,31.47,0,40.99,31.47,2,-60372,62834,123206,2462,0,-1895,4591,0,0,,6486,2696
41,10-11-17,70,17:15,17:30,35.41,48.82,0,48.82,48.82,-1,-64078,73547,137625,9469,0,-85,54,0,0,,139,-31
41,10-11-17,71,17:30,17:45,38.52,,0,38.52,38.52,1,-60911,71472,132383,10561,0,0,182,0,0,,182,182
41,10-11-17,72,17:45,18:00,100.12,,0,100.12,100.12,1,-117773,78689,196462,-39084,0,0,25893,0,0,,25893,25893
41,10-11-17,73,18:00,18:15,48.98,23.78,0,23.78,23.78,-1,-86750,82906,169656,-3844,0,-2798,21116,0,0,,23914,18318
41,10-11-17,74,18:15,18:30,48.98,31.52,0,31.52,31.52,-1,-75793,77361,153154,1568,0,-2909,157,0,0,,3066,-2752
41,10-11-17,75,18:30,18:45,,48.86,0,48.86,48.86,-1,-58464,94661,153125,36197,0,-246,0,0,0,,246,-246
41,10-11-17,76,18:45,19:00,,,0,40.98,40.98,0,-71798,107374,179172,35576,0,-41,0,0,0,,41,-41
41,10-11-17,77,19:00,19:15,,,0,40.97,40.97,0,-81921,94624,176545,12703,0,0,0,0,0,,0,0
41,10-11-17,78,19:15,19:30,40.56,,0,40.56,40.56,1,-96118,79196,175314,-16922,0,0,5971,0,0,,5971,5971
41,10-11-17,79,19:30,19:45,33.11,,0,33.11,33.11,1,-81766,80297,162063,-1469,0,0,1370,0,0,,1370,1370
41,10-11-17,80,19:45,20:00,,,0,40.97,40.97,0,-82618,83811,166429,1193,0,0,0,0,0,,0,0
41,10-11-17,81,20:00,20:15,50.52,,0,50.52,50.52,1,-98603,85785,184388,-12818,0,0,4656,0,0,,4656,4656
41,10-11-17,82,20:15,20:30,50.52,27.52,0,27.52,27.52,-1,-67729,82792,150521,15063,0,-2292,708,0,0,,3000,-1584
41,10-11-17,83,20:30,20:45,,25.99,0,25.99,25.99,-1,-58142,94729,152871,36587,0,-23287,0,0,0,,23287,-23287
41,10-11-17,84,20:45,21:00,,23.78,0,23.78,23.78,-1,-65452,99822,165274,34370,0,-39589,0,0,0,,39589,-39589
41,10-11-17,85,21:00,21:15,66.18,24.69,0,66.18,24.69,2,-96721,64219,160940,-32502,0,-21299,4218,0,0,,25517,-17081
41,10-11-17,86,21:15,21:30,,,0,38.77,38.77,0,-80560,61853,142413,-18707,0,-30,819,0,0,,849,789
41,10-11-17,87,21:30,21:45,,32.52,0,32.52,32.52,-1,-75257,81121,156378,5864,0,-169,0,0,0,,169,-169
41,10-11-17,88,21:45,22:00,,31.52,0,31.52,31.52,-1,-104940,99326,204266,-5614,0,-1737,0,0,0,,1737,-1737
41,10-11-17,89,22:00,22:15,133.13,23.78,0,133.13,23.78,2,-84278,62054,146332,-22224,0,-4827,5002,0,0,,9829,175
41,10-11-17,90,22:15,22:30,126.01,3.11,0,126.01,3.11,2,-60545,56711,117256,-3834,0,-1453,29111,0,0,,30564,27658
41,10-11-17,91,22:30,22:45,46.86,-40.45,0,46.86,-40.45,2,-44594,55603,100197,11009,0,-31986,942,0,0,,32928,-31044
41,10-11-17,92,22:45,23:00,46.86,-52.35,0,-52.35,-52.35,-1,-36531,129229,165760,92698,0,-35885,329,0,0,,36214,-35556
41,10-11-17,93,23:00,23:15,88.37,-52.35,0,88.37,88.37,1,-107563,22430,129993,-85133,0,-9029,6959,0,0,,15988,-2070
41,10-11-17,94,23:15,23:30,,,0,38.8,38.8,0,-52330,42035,94365,-10295,0,0,791,0,0,,791,791
41,10-11-17,95,23:30,23:45,,31.52,0,31.52,31.52,-1,-38527,73276,111803,34749,0,-1395,0,0,0,,1395,-1395
41,10-11-17,96,23:45,0:00,,23.13,0,23.13,23.13,-1,-39581,100631,140212,61050,0,-26910,0,0,0,,26910,-26910
41,10-12-17,1,0:00,0:15,30.03,-16.91,0,31.28,-16.91,2,-76588,130310,206898,53722,0,-38912,3,0,0,,38915,-38909
41,10-12-17,2,0:15,0:30,38.52,27.52,0,38.52,27.52,2,-40552,52449,93001,11897,0,-6876,1423,0,0,,8299,-5453
41,10-12-17,3,0:30,0:45,,21.77,0,21.77,21.77,-1,-40077,78781,118858,38704,0,-25092,0,0,0,,25092,-25092
41,10-12-17,4,0:45,1:00,,11.23,0,11.23,11.23,-1,-40537,110724,151261,70187,0,-58723,0,0,0,,58723,-58723
41,10-12-17,5,1:00,1:15,63.49,17.64,0,63.49,63.49,1,-64088,37555,101643,-26533,0,-32318,2928,0,0,,35246,-29390
41,10-12-17,6,1:15,1:30,,,0,31.31,31.31,0,-46240,42398,88638,-3842,0,0,1227,0,0,,1227,1227
41,10-12-17,7,1:30,1:45,36.25,,0,36.25,36.25,1,-56395,39703,96098,-16692,0,0,944,0,0,,944,944
41,10-12-17,8,1:45,2:00,29.92,,0,29.92,29.92,1,-57468,45606,103074,-11862,0,0,886,0,0,,886,886
41,10-12-17,9,2:00,2:15,,29.7,0,29.7,29.7,-1,-40022,50565,90587,10543,0,-3612,0,0,0,,3612,-3612
41,10-12-17,10,2:15,2:30,38.52,32.54,0,38.52,38.52,1,-57349,41732,99081,-15617,0,-543,1684,0,0,,2227,1141
41,10-12-17,11,2:30,2:45,43.37,,0,43.37,43.37,1,-57528,33128,90656,-24400,0,0,13610,0,0,,13610,13610
41,10-12-17,12,2:45,3:00,44.52,,0,44.52,44.52,1,-66380,29134,95514,-37246,0,0,23784,0,0,,23784,23784
41,10-12-17,13,3:00,3:15,37.12,31.52,0,31.52,31.52,-1,-65364,56475,121839,-8889,0,-335,14203,0,0,,14538,13868
41,10-12-17,14,3:15,3:30,38.52,32.4,0,38.52,31.29,2,-66042,42504,108546,-23538,0,-159,972,0,0,,1131,813
41,10-12-17,15,3:30,3:45,44.52,,0,44.52,44.52,1,-66484,33418,99902,-33066,0,0,14869,0,0,,14869,14869
41,10-12-17,16,3:45,4:00,44.52,,0,44.52,44.52,1,-65241,34830,100071,-30411,0,0,3352,0,0,,3352,3352
41,10-12-17,17,4:00,4:15,32,28.39,0,28.39,28.39,-1,-46987,65246,112233,18259,0,-1721,1470,0,0,,3191,-251
41,10-12-17,18,4:15,4:30,,27.52,0,27.52,27.52,-1,-34248,46997,81245,12749,0,-7672,0,0,0,,7672,-7672
41,10-12-17,19,4:30,4:45,,31.9,0,31.9,31.9,-1,-47491,47926,95417,435,0,-638,0,0,0,,638,-638
41,10-12-17,20,4:45,5:00,40.48,,0,40.48,40.48,1,-70875,41812,112687,-29063,0,0,4036,0,0,,4036,4036
41,10-12-17,21,5:00,5:15,40.48,-69,0,-69,-69,-1,-27843,112449,140292,84606,0,-24098,714,0,0,,24812,-23384
41,10-12-17,22,5:15,5:30,,21.9,0,21.9,21.9,-1,-37943,74649,112592,36706,0,-43082,0,0,0,,43082,-43082
41,10-12-17,23,5:30,5:45,,27.52,0,27.52,27.52,-1,-39813,57007,96820,17194,0,-27916,0,0,0,,27916,-27916
41,10-12-17,24,5:45,6:00,,16,0,16,16,-1,-44381,71946,116327,27565,0,-19679,0,0,0,,19679,-19679
41,10-12-17,25,6:00,6:15,,-57.28,0,-57.28,-57.28,-1,-50204,154375,204579,104171,0,-57903,0,0,0,,57903,-57903
41,10-12-17,26,6:15,6:30,,-64.23,0,-64.23,-64.23,-1,-46892,104457,151349,57565,0,-76128,0,0,0,,76128,-76128
41,10-12-17,27,6:30,6:45,,25.39,0,25.39,25.39,-1,-53262,88556,141818,35294,0,-25028,0,0,0,,25028,-25028
41,10-12-17,28,6:45,7:00,,-56.44,0,-56.44,-56.44,-1,-83891,150731,234622,66840,0,-59023,0,0,0,,59023,-59023
41,10-12-17,29,7:00,7:15,,20.99,0,20.99,20.99,-1,-73054,124277,197331,51223,0,-52543,0,0,0,,52543,-52543
41,10-12-17,30,7:15,7:30,,,0,32.4,32.4,0,-82142,95336,177478,13194,0,-11302,0,0,0,,11302,-11302
41,10-12-17,31,7:30,7:45,38.92,,0,38.92,38.92,1,-107683,84658,192341,-23025,0,0,23,0,0,,23,23
41,10-12-17,32,7:45,8:00,106.12,,0,106.12,106.12,1,-132894,87286,220180,-45608,0,0,18960,0,0,,18960,18960
41,10-12-17,33,8:00,8:15,,,0,41.54,41.54,0,-107738,91104,198842,-16634,0,0,3807,0,0,,3807,3807
41,10-12-17,34,8:15,8:30,,,0,41.54,41.54,0,-83522,109056,192578,25534,0,0,0,0,0,,0,0
41,10-12-17,35,8:30,8:45,,,0,41.54,41.54,0,-108651,107485,216136,-1166,0,0,0,0,0,,0,0
41,10-12-17,36,8:45,9:00,69.12,,0,69.12,69.12,1,-135586,96134,231720,-39452,0,0,11617,0,0,,11617,11617
41,10-12-17,37,9:00,9:15,32.93,51.15,0,41.52,41.52,2,-94488,95115,189603,627,0,-91,5976,0,0,,6067,5885
41,10-12-17,38,9:15,9:30,,,0,41.54,41.54,0,-98119,94282,192401,-3837,0,0,0,0,0,,0,0
41,10-12-17,39,9:30,9:45,,,0,41.52,41.52,0,-96127,98921,195048,2794,0,0,0,0,0,,0,0
41,10-12-17,40,9:45,10:00,,,0,41.52,41.52,0,-99478,103595,203073,4117,0,0,0,0,0,,0,0
41,10-12-17,41,10:00,10:15,36.06,31.92,0,36.06,31.92,2,-96449,92639,189088,-3810,0,-22,1699,0,0,,1721,1677
41,10-12-17,42,10:15,10:30,,27.08,0,27.08,27.08,-1,-70764,93240,164004,22476,0,-8782,0,0,0,,8782,-8782
41,10-12-17,43,10:30,10:45,,17.73,0,17.73,17.73,-1,-59296,97472,156768,38176,0,-23531,0,0,0,,23531,-23531
41,10-12-17,44,10:45,11:00,,11,0,11,11,-1,-57741,104903,162644,47162,0,-45618,0,0,0,,45618,-45618
41,10-12-17,45,11:00,11:15,38.78,11,0,38.78,38.78,1,-73175,53395,126570,-19780,0,-6036,1312,0,0,,7348,-4724
41,10-12-17,46,11:15,11:30,,,0,32.84,32.84,0,-71422,78997,150419,7575,0,0,0,0,0,,0,0
41,10-12-17,47,11:30,11:45,,,0,32.84,32.84,0,-59717,96031,155748,36314,0,0,0,0,0,,0,0
41,10-12-17,48,11:45,12:00,,17.92,0,17.92,17.92,-1,-58353,112019,170372,53666,0,-3488,0,0,0,,3488,-3488
41,10-12-17,49,12:00,12:15,,14.99,0,14.99,14.99,-1,-61178,79896,141074,18718,0,-10010,0,0,0,,10010,-10010
41,10-12-17,50,12:15,12:30,,31.43,0,31.43,31.43,-1,-65367,86730,152097,21363,0,-1441,0,0,0,,1441,-1441
41,10-12-17,51,12:30,12:45,,27.92,0,27.92,27.92,-1,-60527,101362,161889,40835,0,-8675,0,0,0,,8675,-8675
41,10-12-17,52,12:45,13:00,,10.92,0,10.92,10.92,-1,-55412,106349,161761,50937,0,-35232,0,0,0,,35232,-35232
41,10-12-17,53,13:00,13:15,44.92,21.78,0,44.92,44.92,1,-68903,52513,121416,-16390,0,-25117,1623,0,0,,26740,-23494
41,10-12-17,54,13:15,13:30,44.92,28.95,0,28.95,28.95,-1,-69082,81918,151000,12836,0,-3542,154,0,0,,3696,-3388
41,10-12-17,55,13:30,13:45,,27.92,0,27.92,27.92,-1,-65452,84122,149574,18670,0,-16087,0,0,0,,16087,-16087
41,10-12-17,56,13:45,14:00,,29.63,0,29.63,29.63,-1,-69591,78426,148017,8835,0,-3784,0,0,0,,3784,-3784
41,10-12-17,57,14:00,14:15,,7.1,0,7.1,7.1,-1,-45471,118794,164265,73323,0,-19477,0,0,0,,19477,-19477
41,10-12-17,58,14:15,14:30,38.78,-2.23,0,38.78,-2.23,2,-72071,74922,146993,2851,0,-31552,763,0,0,,32315,-30789
41,10-12-17,59,14:30,14:45,38.78,21.65,0,21.65,21.65,-1,-65900,86519,152419,20619,0,-4481,451,0,0,,4932,-4030
41,10-12-17,60,14:45,15:00,,17.4,0,17.4,17.4,-1,-55813,103674,159487,47861,0,-41659,0,0,0,,41659,-41659
41,10-12-17,61,15:00,15:15,,10.55,0,10.55,10.55,-1,-60900,138522,199422,77622,0,-70720,0,0,0,,70720,-70720
41,10-12-17,62,15:15,15:30,,17.7,0,17.7,17.7,-1,-56633,98229,154862,41596,0,-58617,0,0,0,,58617,-58617
41,10-12-17,63,15:30,15:45,,18.27,0,18.27,18.27,-1,-60311,103912,164223,43601,0,-27816,0,0,0,,27816,-27816
41,10-12-17,64,15:45,16:00,,24.93,0,24.93,24.93,-1,-62229,102208,164437,39979,0,-35084,0,0,0,,35084,-35084
41,10-12-17,65,16:00,16:15,,4.79,0,4.79,4.79,-1,-54780,141759,196539,86979,0,-51511,0,0,0,,51511,-51511
41,10-12-17,66,16:15,16:30,,28.82,0,28.82,28.82,-1,-47433,100996,148429,53563,0,-30639,0,0,0,,30639,-30639
41,10-12-17,67,16:30,16:45,,,0,32.83,32.83,0,-56151,92083,148234,35932,0,-1556,0,0,0,,1556,-1556
41,10-12-17,68,16:45,17:00,,32.92,0,32.92,32.92,-1,-59777,69312,129089,9535,0,-171,0,0,0,,171,-171
41,10-12-17,69,17:00,17:15,,17.35,0,17.35,17.35,-1,-65916,96300,162216,30384,0,-17701,0,0,0,,17701,-17701
41,10-12-17,70,17:15,17:30,38.78,17.35,0,38.78,38.78,1,-72636,56188,128824,-16448,0,-3044,2543,0,0,,5587,-501
41,10-12-17,71,17:30,17:45,50.92,,0,50.92,50.92,1,-82617,44583,127200,-38034,0,0,3682,0,0,,3682,3682
41,10-12-17,72,17:45,18:00,121.12,,0,121.12,121.12,1,-97360,64279,161639,-33081,0,0,28171,0,0,,28171,28171
41,10-12-17,73,18:00,18:15,121.12,12.78,0,12.78,12.78,-1,-52248,83328,135576,31080,0,-13724,7287,0,0,,21011,-6437
41,10-12-17,74,18:15,18:30,35.35,31.78,0,35.35,35.35,1,-59489,56406,115895,-3083,0,-7653,726,0,0,,8379,-6927
41,10-12-17,75,18:30,18:45,32.88,,0,32.88,32.88,1,-67807,61893,129700,-5914,0,0,476,0,0,,476,476
41,10-12-17,76,18:45,19:00,33.48,,0,33.48,33.48,1,-76049,92522,168571,16473,0,0,370,0,0,,370,370
41,10-12-17,77,19:00,19:15,583.05,,0,583.05,583.05,1,-143721,31172,174893,-112549,0,0,17932,0,0,,17932,17932
41,10-12-17,78,19:15,19:30,583.05,,0,583.05,583.05,1,-118634,23312,141946,-95322,0,0,65827,0,0,,65827,65827
41,10-12-17,79,19:30,19:45,,,0,41.55,41.55,0,-77202,33379,110581,-43823,0,0,13709,0,0,,13709,13709
41,10-12-17,80,19:45,20:00,,,0,41.55,41.55,0,-94228,30642,124870,-63586,0,0,0,0,0,,0,0
41,10-12-17,81,20:00,20:15,,31.49,0,31.49,31.49,-1,-78262,98324,176586,20062,0,-976,0,0,0,,976,-976
41,10-12-17,82,20:15,20:30,,31.49,0,31.49,31.49,-1,-57972,64612,122584,6640,0,-3578,0,0,0,,3578,-3578
41,10-12-17,83,20:30,20:45,,31.92,0,31.92,31.92,-1,-42177,57381,99558,15204,0,-9504,0,0,0,,9504,-9504
41,10-12-17,84,20:45,21:00,32.88,31.49,0,41.53,31.49,2,-47115,40320,87435,-6795,0,-13095,245,0,0,,13340,-12850
41,10-12-17,85,21:00,21:15,33.3,51.09,0,41.51,41.51,2,-80705,86720,167425,6015,0,-419,365,0,0,,784,-54
41,10-12-17,86,21:15,21:30,,30.66,0,30.66,30.66,-1,-60991,80877,141868,19886,0,-8240,0,0,0,,8240,-8240
41,10-12-17,87,21:30,21:45,,27.92,0,27.92,27.92,-1,-47178,80145,127323,32967,0,-20812,0,0,0,,20812,-20812
41,10-12-17,88,21:45,22:00,,17.92,0,17.92,17.92,-1,-59202,110361,169563,51159,0,-42748,0,0,0,,42748,-42748
41,10-12-17,89,22:00,22:15,327.72,17.92,0,327.72,327.72,1,-114782,63894,178676,-50888,0,-15144,14010,0,0,,29154,-1134
41,10-12-17,90,22:15,22:30,38.61,17.31,0,17.31,17.31,-1,-75433,98408,173841,22975,0,-6402,9168,0,0,,15570,2766
41,10-12-17,91,22:30,22:45,,16.78,0,16.78,16.78,-1,-80303,141315,221618,61012,0,-49930,0,0,0,,49930,-49930
41,10-12-17,92,22:45,23:00,,16.78,0,16.78,16.78,-1,-80323,158206,238529,77883,0,-69590,0,0,0,,69590,-69590
41,10-12-17,93,23:00,23:15,110.12,23.44,0,110.12,23.44,2,-113783,62370,176153,-51413,0,-29851,6397,0,0,,36248,-23454
41,10-12-17,94,23:15,23:30,32.3,,0,32.3,32.3,1,-95912,41224,137136,-54688,0,0,2384,0,0,,2384,2384
41,10-12-17,95,23:30,23:45,,,0,32.8,32.8,0,-109050,63638,172688,-45412,0,0,0,0,0,,0,0
41,10-12-17,96,23:45,0:00,,31.92,0,31.92,31.92,-1,-126428,98669,225097,-27759,0,-17,0,0,0,,17,-17
41,10/13/2017,1,0:00,0:15,64.41,11.36,0,64.41,11.36,2,-60869,61536,122405,667,0,-6091,4277,0,0,,10368,-1814
41,10/13/2017,2,0:15,0:30,38.92,,0,38.92,38.92,1,-54369,31591,85960,-22778,0,0,15055,0,0,,15055,15055
41,10/13/2017,3,0:30,0:45,38.92,18.52,0,18.52,18.52,-1,-57391,71484,128875,14093,0,-3199,5878,0,0,,9077,2679
41,10/13/2017,4,0:45,1:00,,19.49,0,19.49,19.49,-1,-57917,115519,173436,57602,0,-43063,0,0,0,,43063,-43063
41,10/13/2017,5,1:00,1:15,85.3,18.96,0,85.3,85.3,1,-78393,43181,121574,-35212,0,-34293,3598,0,0,,37891,-30695
41,10/13/2017,6,1:15,1:30,121.02,-3.08,0,121.02,-3.08,2,-40760,61774,102534,21014,0,-5537,13313,0,0,,18850,7776
41,10/13/2017,7,1:30,1:45,,-6.74,0,-6.74,-6.74,-1,-47418,66138,113556,18720,0,-18722,0,0,0,,18722,-18722
41,10/13/2017,8,1:45,2:00,,31.92,0,31.92,31.92,-1,-53203,64052,117255,10849,0,-2744,0,0,0,,2744,-2744
41,10/13/2017,9,2:00,2:15,40.15,32.05,0,40.15,31.67,2,-39738,28037,67775,-11701,0,-938,2116,0,0,,3054,1178
41,10/13/2017,10,2:15,2:30,44.92,,0,44.92,44.92,1,-47608,22113,69721,-25495,0,0,13220,0,0,,13220,13220
41,10/13/2017,11,2:30,2:45,,,0,31.66,31.66,0,-53934,30211,84145,-23723,0,0,838,0,0,,838,838
41,10/13/2017,12,2:45,3:00,,,0,31.66,31.66,0,-47683,37629,85312,-10054,0,0,0,0,0,,0,0
41,10/13/2017,13,3:00,3:15,30.4,31.92,0,31.66,31.66,2,-33860,57487,91347,23627,0,-146,11,0,0,,157,-135
41,10/13/2017,14,3:15,3:30,30.4,32.92,0,32.92,32.92,-1,-32983,53536,86519,20553,0,-11,117,0,0,,128,106
41,10/13/2017,15,3:30,3:45,,31.92,0,31.92,31.92,-1,-36485,55945,92430,19460,0,-614,0,0,0,,614,-614
41,10/13/2017,16,3:45,4:00,,31.92,0,31.92,31.92,-1,-40671,57329,98000,16658,0,-3665,0,0,0,,3665,-3665
41,10/13/2017,17,4:00,4:15,,27.92,0,27.92,27.92,-1,-41107,62969,104076,21862,0,-7670,0,0,0,,7670,-7670
41,10/13/2017,18,4:15,4:30,,31.92,0,31.92,31.92,-1,-40101,53451,93552,13350,0,-3125,0,0,0,,3125,-3125
41,10/13/2017,19,4:30,4:45,,31.92,0,31.92,31.92,-1,-42513,53194,95707,10681,0,-3766,0,0,0,,3766,-3766
41,10/13/2017,20,4:45,5:00,,32.92,0,32.92,32.92,-1,-50885,46192,97077,-4693,0,-891,0,0,0,,891,-891
41,10/13/2017,21,5:00,5:15,,30.11,0,30.11,30.11,-1,-59084,44145,103229,-14939,0,-1725,0,0,0,,1725,-1725
41,10/13/2017,22,5:15,5:30,,27.92,0,27.92,27.92,-1,-53124,50676,103800,-2448,0,-4126,0,0,0,,4126,-4126
41,10/13/2017,23,5:30,5:45,34.92,,0,34.92,34.92,1,-64841,35664,100505,-29177,0,0,86,0,0,,86,86
41,10/13/2017,24,5:45,6:00,34.92,32.92,0,32.92,32.92,-1,-59798,63153,122951,3355,0,-226,52,0,0,,278,-174
41,10/13/2017,25,6:00,6:15,34.81,32.81,0,34.81,31.58,2,-127690,65999,193689,-61691,0,-139,694,0,0,,833,555
41,10/13/2017,26,6:15,6:30,,32.62,0,32.62,32.62,-1,-48340,46928,95268,-1412,0,-1901,0,0,0,,1901,-1901
41,10/13/2017,27,6:30,6:45,34.81,32.69,0,34.81,34.81,1,-53465,30445,83910,-23020,0,-1377,190,0,0,,1567,-1187
41,10/13/2017,28,6:45,7:00,38.81,31.81,0,38.81,31.76,2,-88868,47381,136249,-41487,0,-66,2065,0,0,,2131,1999
41,10/13/2017,29,7:00,7:15,32.2,25.22,0,32.2,25.22,2,-75841,94656,170497,18815,0,-11035,151,0,0,,11186,-10884
41,10/13/2017,30,7:15,7:30,38.97,25.22,0,38.97,38.97,1,-97172,63312,160484,-33860,0,-100,1769,0,0,,1869,1669
41,10/13/2017,31,7:30,7:45,38.81,,0,38.81,38.81,1,-117033,42459,159492,-74574,0,0,2352,0,0,,2352,2352
41,10/13/2017,32,7:45,8:00,36.76,,0,36.76,36.76,1,-114409,39193,153602,-75216,0,0,1834,0,0,,1834,1834
41,10/13/2017,33,8:00,8:15,,,0,32.45,32.45,0,-75013,34027,109040,-40986,0,0,38,0,0,,38,38
41,10/13/2017,34,8:15,8:30,41.34,,0,41.34,41.34,1,-58420,19949,78369,-38471,0,0,3200,0,0,,3200,3200
41,10/13/2017,35,8:30,8:45,33.24,,0,33.24,33.24,1,-63929,21133,85062,-42796,0,0,1409,0,0,,1409,1409
41,10/13/2017,36,8:45,9:00,70.82,,0,70.82,70.82,1,-86124,17084,103208,-69040,0,0,6801,0,0,,6801,6801
41,10/13/2017,37,9:00,9:15,38.81,,0,38.81,38.81,1,-56875,54366,111241,-2509,0,0,1012,0,0,,1012,1012
41,10/13/2017,38,9:15,9:30,59.9,,0,59.9,59.9,1,-63090,35936,99026,-27154,0,0,3739,0,0,,3739,3739
41,10/13/2017,39,9:30,9:45,59.9,,0,59.9,59.9,1,-54478,41658,96136,-12820,0,0,18938,0,0,,18938,18938
41,10/13/2017,40,9:45,10:00,59.9,28.47,0,28.47,28.47,-1,-58812,66449,125261,7637,0,-3164,2339,0,0,,5503,-825
41,10/13/2017,41,10:00,10:15,32.76,32.81,0,32.76,31.57,2,-47465,60106,107571,12641,0,-36,77,0,0,,113,41
41,10/13/2017,42,10:15,10:30,,27.81,0,27.81,27.81,-1,-49690,81627,131317,31937,0,-8318,0,0,0,,8318,-8318
41,10/13/2017,43,10:30,10:45,,16.69,0,16.69,16.69,-1,-50543,86969,137512,36426,0,-7958,0,0,0,,7958,-7958
41,10/13/2017,44,10:45,11:00,,9.16,0,9.16,9.16,-1,-54044,92262,146306,38218,0,-32323,0,0,0,,32323,-32323
41,10/13/2017,45,11:00,11:15,,26.49,0,26.49,26.49,-1,-56725,82548,139273,25823,0,-19852,0,0,0,,19852,-19852
41,10/13/2017,46,11:15,11:30,,7.03,0,7.03,7.03,-1,-52432,114715,167147,62283,0,-35727,0,0,0,,35727,-35727
41,10/13/2017,47,11:30,11:45,,-12.39,0,-12.39,-12.39,-1,-69607,107792,177399,38185,0,-48973,0,0,0,,48973,-48973
41,10/13/2017,48,11:45,12:00,,-19.33,0,-19.33,-19.33,-1,-46854,124522,171376,77668,0,-29129,0,0,0,,29129,-29129
41,10/13/2017,49,12:00,12:15,34.81,31.38,0,34.81,31.38,2,-54575,63751,118326,9176,0,-8319,581,0,0,,8900,-7738
41,10/13/2017,50,12:15,12:30,,26.73,0,26.73,26.73,-1,-61831,92572,154403,30741,0,-16445,0,0,0,,16445,-16445
41,10/13/2017,51,12:30,12:45,,9.84,0,9.84,9.84,-1,-59337,120505,179842,61168,0,-38696,0,0,0,,38696,-38696
41,10/13/2017,52,12:45,13:00,,20.86,0,20.86,20.86,-1,-62296,121312,183608,59016,0,-48554,0,0,0,,48554,-48554
41,10/13/2017,53,13:00,13:15,,18.62,0,18.62,18.62,-1,-63150,91278,154428,28128,0,-38387,0,0,0,,38387,-38387
41,10/13/2017,54,13:15,13:30,,17.81,0,17.81,17.81,-1,-63429,98298,161727,34869,0,-9293,0,0,0,,9293,-9293
41,10/13/2017,55,13:30,13:45,,17.81,0,17.81,17.81,-1,-65176,98690,163866,33514,0,-28612,0,0,0,,28612,-28612
41,10/13/2017,56,13:45,14:00,,28.27,0,28.27,28.27,-1,-69387,97993,167380,28606,0,-27132,0,0,0,,27132,-27132
41,10/13/2017,57,14:00,14:15,297.16,28.27,0,297.16,297.16,1,-94013,48504,142517,-45509,0,-6313,17196,0,0,,23509,10883
41,10/13/2017,58,14:15,14:30,297.16,29.74,0,29.74,29.74,-1,-69864,81288,151152,11424,0,-3391,5563,0,0,,8954,2172
41,10/13/2017,59,14:30,14:45,30.08,32.81,0,31.45,31.45,2,-77600,74590,152190,-3010,0,-785,16,0,0,,801,-769
41,10/13/2017,60,14:45,15:00,34.81,,0,34.81,34.81,1,-85832,56360,142192,-29472,0,0,2157,0,0,,2157,2157
41,10/13/2017,61,15:00,15:15,336.04,,0,336.04,336.04,1,-117788,44257,162045,-73531,0,0,26134,0,0,,26134,26134
41,10/13/2017,62,15:15,15:30,47.23,,0,47.23,47.23,1,-95956,61997,157953,-33959,0,0,21900,0,0,,21900,21900
41,10/13/2017,63,15:30,15:45,82.02,,0,82.02,82.02,1,-108235,58021,166256,-50214,0,0,33680,0,0,,33680,33680
41,10/13/2017,64,15:45,16:00,37.02,,0,37.02,37.02,1,-97474,63777,161251,-33697,0,0,20936,0,0,,20936,20936
41,10/13/2017,65,16:00,16:15,37.02,32.81,0,32.81,32.81,-1,-70438,79985,150423,9547,0,-126,2265,0,0,,2391,2139
41,10/13/2017,66,16:15,16:30,,,0,32.42,32.42,0,-65797,69932,135729,4135,0,0,0,0,0,,0,0
41,10/13/2017,67,16:30,16:45,32.02,,0,32.02,32.02,1,-66381,67102,133483,721,0,0,18,0,0,,18,18
41,10/13/2017,68,16:45,17:00,34.81,,0,34.81,34.81,1,-76654,61887,138541,-14767,0,0,571,0,0,,571,571
41,10/13/2017,69,17:00,17:15,34.81,32.81,0,34.81,32.42,2,-43086,65133,108219,22047,0,-877,425,0,0,,1302,-452
41,10/13/2017,70,17:15,17:30,34.81,32.81,0,34.81,34.81,1,-45927,45485,91412,-442,0,-125,456,0,0,,581,331
41,10/13/2017,71,17:30,17:45,38.81,,0,38.81,38.81,1,-50956,41595,92551,-9361,0,0,2347,0,0,,2347,2347
41,10/13/2017,72,17:45,18:00,41.21,,0,41.21,41.21,1,-46148,58694,104842,12546,0,0,4793,0,0,,4793,4793
41,10/13/2017,73,18:00,18:15,41.1,31.71,0,41.1,31.71,2,-66338,66160,132498,-178,0,-1230,2134,0,0,,3364,904
41,10/13/2017,74,18:15,18:30,,31.32,0,31.32,31.32,-1,-57613,70792,128405,13179,0,-2817,0,0,0,,2817,-2817
41,10/13/2017,75,18:30,18:45,,31.81,0,31.81,31.81,-1,-59253,82739,141992,23486,0,-2993,0,0,0,,2993,-2993
41,10/13/2017,76,18:45,19:00,,16.67,0,16.67,16.67,-1,-57449,106451,163900,49002,0,-19067,0,0,0,,19067,-19067
41,10/13/2017,77,19:00,19:15,38.81,31.81,0,38.81,38.81,1,-75849,66062,141911,-9787,0,-11909,1265,0,0,,13174,-10644
41,10/13/2017,78,19:15,19:30,53.3,31.81,0,53.3,53.3,1,-90975,76804,167779,-14171,0,-76,8947,0,0,,9023,8871
41,10/13/2017,79,19:30,19:45,36.71,,0,36.71,36.71,1,-85190,66722,151912,-18468,0,0,4003,0,0,,4003,4003
41,10/13/2017,80,19:45,20:00,36.71,29.03,0,29.03,29.03,-1,-77731,86292,164023,8561,0,-7971,19,0,0,,7990,-7952
41,10/13/2017,81,20:00,20:15,,27.81,0,27.81,27.81,-1,-77273,99372,176645,22099,0,-25434,0,0,0,,25434,-25434
41,10/13/2017,82,20:15,20:30,34.81,29.03,0,34.81,29.03,2,-72479,80071,152550,7592,0,-7473,930,0,0,,8403,-6543
41,10/13/2017,83,20:30,20:45,,27.81,0,27.81,27.81,-1,-72264,81954,154218,9690,0,-12317,0,0,0,,12317,-12317
41,10/13/2017,84,20:45,21:00,,29.8,0,29.8,29.8,-1,-86658,102018,188676,15360,0,-6787,0,0,0,,6787,-6787
41,10/13/2017,85,21:00,21:15,328.04,25.74,0,328.04,25.74,2,-96957,60720,157677,-36237,0,-9164,5372,0,0,,14536,-3792
41,10/13/2017,86,21:15,21:30,370.68,-46.82,0,370.68,-46.82,2,-51293,82214,133507,30921,0,-5634,23036,0,0,,28670,17402
41,10/13/2017,87,21:30,21:45,38.81,-57.84,0,38.81,-57.84,2,-66169,90037,156206,23868,0,-29971,231,0,0,,30202,-29740
41,10/13/2017,88,21:45,22:00,37.02,27.81,0,27.81,27.81,-1,-69307,79207,148514,9900,0,-3000,375,0,0,,3375,-2625
41,10/13/2017,89,22:00,22:15,290.57,17.81,0,290.57,17.81,2,-93194,74882,168076,-18312,0,-11038,4802,0,0,,15840,-6236
41,10/13/2017,90,22:15,22:30,328.35,32.81,0,32.81,32.81,-1,-68850,57425,126275,-11425,0,-8,11737,0,0,,11745,11729
41,10/13/2017,91,22:30,22:45,328.35,26.86,0,26.86,26.86,-1,-59141,87248,146389,28107,0,-13868,450,0,0,,14318,-13418
41,10/13/2017,92,22:45,23:00,,28.03,0,28.03,28.03,-1,-57107,75289,132396,18182,0,-23598,0,0,0,,23598,-23598
41,10/13/2017,93,23:00,23:15,186.36,27.81,0,186.36,27.81,2,-79702,81141,160843,1439,0,-17635,2132,0,0,,19767,-15503
41,10/13/2017,94,23:15,23:30,388,27.87,0,388,27.87,2,-60346,40509,100855,-19837,0,-1669,30761,0,0,,32430,29092
41,10/13/2017,95,23:30,23:45,50.81,16.58,0,50.81,16.58,2,-72363,62203,134566,-10160,0,-4708,3926,0,0,,8634,-782
41,10/13/2017,96,23:45,0:00,56.02,32.81,0,56.02,31.36,2,-105971,86488,192459,-19483,0,-3,16473,0,0,,16476,16470
42,10/14/2017,1,0:00,0:15,50.81,-57.75,0,50.81,-57.75,2,-60057,92803,152860,32746,0,-19743,4797,0,0,,24540,-14946
42,10/14/2017,2,0:15,0:30,141.12,-57.75,0,141.12,141.12,1,-54190,14818,69008,-39372,0,-6,34622,0,0,,34628,34616
42,10/14/2017,3,0:30,0:45,141.12,19.75,0,19.75,19.75,-1,-38621,64401,103022,25780,0,-15835,3352,0,0,,19187,-12483
42,10/14/2017,4,0:45,1:00,,27.01,0,27.01,27.01,-1,-41159,52048,93207,10889,0,-22018,0,0,0,,22018,-22018
42,10/14/2017,5,1:00,1:15,30.99,14,0,31.1,14,2,-53480,74665,128145,21185,0,-16056,11,0,0,,16067,-16045
42,10/14/2017,6,1:15,1:30,32.67,28,0,32.67,28,2,-51411,55688,107099,4277,0,-3112,472,0,0,,3584,-2640
42,10/14/2017,7,1:30,1:45,,27.84,0,27.84,27.84,-1,-55811,76759,132570,20948,0,-5015,0,0,0,,5015,-5015
42,10/14/2017,8,1:45,2:00,,24,0,24,24,-1,-58546,90330,148876,31784,0,-24024,0,0,0,,24024,-24024
42,10/14/2017,9,2:00,2:15,35.53,28,0,35.53,28,2,-65723,73032,138755,7309,0,-12892,1116,0,0,,14008,-11776
42,10/14/2017,10,2:15,2:30,,,0,31.06,31.06,0,-72079,72571,144650,492,0,-12,54,0,0,,66,42
42,10/14/2017,11,2:30,2:45,,29,0,29,29,-1,-71014,76521,147535,5507,0,-993,0,0,0,,993,-993
42,10/14/2017,12,2:45,3:00,,24,0,24,24,-1,-52453,83398,135851,30945,0,-3525,0,0,0,,3525,-3525
42,10/14/2017,13,3:00,3:15,131.12,24,0,131.12,131.12,1,-77726,3851,81577,-73875,0,-725,14013,0,0,,14738,13288
42,10/14/2017,14,3:15,3:30,131.12,,0,131.12,131.12,1,-64846,10149,74995,-54697,0,0,43424,0,0,,43424,43424
42,10/14/2017,15,3:30,3:45,131.12,29,0,29,29,-1,-39190,25894,65084,-13296,0,-472,7946,0,0,,8418,7474
42,10/14/2017,16,3:45,4:00,,,0,31.05,31.05,0,-51083,14704,65787,-36379,0,0,0,0,0,,0,0
42,10/14/2017,17,4:00,4:15,38.81,,0,38.81,38.81,1,-44298,23373,67671,-20925,0,0,2831,0,0,,2831,2831
42,10/14/2017,18,4:15,4:30,40.8,,0,40.8,40.8,1,-50567,26133,76700,-24434,0,0,13742,0,0,,13742,13742
42,10/14/2017,19,4:30,4:45,51.61,,0,51.61,51.61,1,-61786,13978,75764,-47808,0,0,24617,0,0,,24617,24617
42,10/14/2017,20,4:45,5:00,46.12,,0,46.12,46.12,1,-60890,8360,69250,-52530,0,0,42999,0,0,,42999,42999
42,10/14/2017,21,5:00,5:15,38.81,,0,38.81,38.81,1,-63552,23167,86719,-40385,0,0,19374,0,0,,19374,19374
42,10/14/2017,22,5:15,5:30,44.15,,0,44.15,44.15,1,-69466,17330,86796,-52136,0,0,18188,0,0,,18188,18188
42,10/14/2017,23,5:30,5:45,44.81,,0,44.81,44.81,1,-84789,20417,105206,-64372,0,0,14789,0,0,,14789,14789
42,10/14/2017,24,5:45,6:00,44.81,,0,44.81,44.81,1,-81934,22641,104575,-59293,0,0,11000,0,0,,11000,11000
42,10/14/2017,25,6:00,6:15,44.81,27.68,0,27.68,27.68,-1,-47164,54837,102001,7673,0,-1561,764,0,0,,2325,-797
42,10/14/2017,26,6:15,6:30,30.49,31.56,0,30.49,30.49,1,-61389,54041,115430,-7348,0,-623,8,0,0,,631,-615
42,10/14/2017,27,6:30,6:45,32.44,,0,32.44,32.44,1,-84963,58746,143709,-26217,0,0,1597,0,0,,1597,1597
42,10/14/2017,28,6:45,7:00,123.35,,0,123.35,123.35,1,-111546,38565,150111,-72981,0,0,26692,0,0,,26692,26692
42,10/14/2017,29,7:00,7:15,123.35,24.7,0,24.7,24.7,-1,-93833,81641,175474,-12192,0,-430,14624,0,0,,15054,14194
42,10/14/2017,30,7:15,7:30,34.75,27.4,0,34.75,27.4,2,-92513,89677,182190,-2836,0,-3094,551,0,0,,3645,-2543
42,10/14/2017,31,7:30,7:45,53.11,,0,53.11,53.11,1,-116369,77900,194269,-38469,0,0,24945,0,0,,24945,24945
42,10/14/2017,32,7:45,8:00,53.11,-57.35,0,-57.35,-57.35,-1,-67312,125789,193101,58477,0,-14390,10334,0,0,,24724,-4056
42,10/14/2017,33,8:00,8:15,384.11,-57.35,0,384.11,384.11,1,-143970,22244,166214,-121726,0,-3784,19656,0,0,,23440,15872
42,10/14/2017,34,8:15,8:30,36.21,,0,36.21,36.21,1,-73789,52879,126668,-20910,0,0,2563,0,0,,2563,2563
42,10/14/2017,35,8:30,8:45,78.42,,0,78.42,78.42,1,-92423,30919,123342,-61504,0,0,8083,0,0,,8083,8083
42,10/14/2017,36,8:45,9:00,47.85,,0,47.85,47.85,1,-102769,37571,140340,-65198,0,0,22703,0,0,,22703,22703
42,10/14/2017,37,9:00,9:15,51.17,,0,51.17,51.17,1,-65733,39935,105668,-25798,0,0,18020,0,0,,18020,18020
42,10/14/2017,38,9:15,9:30,49.18,,0,49.18,49.18,1,-77618,36418,114036,-41200,0,0,29432,0,0,,29432,29432
42,10/14/2017,39,9:30,9:45,47.89,,0,47.89,47.89,1,-85352,40554,125906,-44798,0,0,29292,0,0,,29292,29292
42,10/14/2017,40,9:45,10:00,39.17,,0,39.17,39.17,1,-91078,57702,148780,-33376,0,0,15886,0,0,,15886,15886
42,10/14/2017,41,10:00,10:15,36.7,,0,36.7,36.7,1,-67700,43832,111532,-23868,0,0,594,0,0,,594,594
42,10/14/2017,42,10:15,10:30,39.17,,0,39.17,39.17,1,-61643,44333,105976,-17310,0,0,3009,0,0,,3009,3009
42,10/14/2017,43,10:30,10:45,31.03,31.51,0,31.91,31.51,2,-60345,69174,129519,8829,0,-3,5,0,0,,8,2
42,10/14/2017,44,10:45,11:00,,28.36,0,28.36,28.36,-1,-55704,80056,135760,24352,0,-9424,0,0,0,,9424,-9424
42,10/14/2017,45,11:00,11:15,,28.73,0,28.73,28.73,-1,-62990,68312,131302,5322,0,-9369,0,0,0,,9369,-9369
42,10/14/2017,46,11:15,11:30,,,0,31.9,31.9,0,-64989,50960,115949,-14029,0,-147,0,0,0,,147,-147
42,10/14/2017,47,11:30,11:45,,,0,31.88,31.88,0,-56422,49322,105744,-7100,0,0,0,0,0,,0,0
42,10/14/2017,48,11:45,12:00,,30.27,0,30.27,30.27,-1,-51977,39960,91937,-12017,0,-67,0,0,0,,67,-67
42,10/14/2017,49,12:00,12:15,,24.36,0,24.36,24.36,-1,-53250,84508,137758,31258,0,-3309,0,0,0,,3309,-3309
42,10/14/2017,50,12:15,12:30,,20.63,0,20.63,20.63,-1,-58358,76648,135006,18290,0,-14786,0,0,0,,14786,-14786
42,10/14/2017,51,12:30,12:45,,8.48,0,8.48,8.48,-1,-49656,110542,160198,60886,0,-25814,0,0,0,,25814,-25814
42,10/14/2017,52,12:45,13:00,,16.13,0,16.13,16.13,-1,-47758,97054,144812,49296,0,-49188,0,0,0,,49188,-49188
42,10/14/2017,53,13:00,13:15,,20.59,0,20.59,20.59,-1,-35783,100901,136684,65118,0,-40901,0,0,0,,40901,-40901
42,10/14/2017,54,13:15,13:30,,7.73,0,7.73,7.73,-1,-44814,112558,157372,67744,0,-38745,0,0,0,,38745,-38745
42,10/14/2017,55,13:30,13:45,,12.45,0,12.45,12.45,-1,-46198,108279,154477,62081,0,-53560,0,0,0,,53560,-53560
42,10/14/2017,56,13:45,14:00,,18.05,0,18.05,18.05,-1,-47704,95188,142892,47484,0,-55700,0,0,0,,55700,-55700
42,10/14/2017,57,14:00,14:15,,20.07,0,20.07,20.07,-1,-46872,79650,126522,32778,0,-32990,0,0,0,,32990,-32990
42,10/14/2017,58,14:15,14:30,,14.28,0,14.28,14.28,-1,-45219,92091,137310,46872,0,-4587,0,0,0,,4587,-4587
42,10/14/2017,59,14:30,14:45,,9.18,0,9.18,9.18,-1,-47060,93838,140898,46778,0,-22063,0,0,0,,22063,-22063
42,10/14/2017,60,14:45,15:00,,15.54,0,15.54,15.54,-1,-46132,107058,153190,60926,0,-33511,0,0,0,,33511,-33511
42,10/14/2017,61,15:00,15:15,35.36,31.78,0,35.36,31.78,2,-76712,37945,114657,-38767,0,-11145,1496,0,0,,12641,-9649
42,10/14/2017,62,15:15,15:30,35.36,25.61,0,25.61,25.61,-1,-51212,67145,118357,15933,0,-8647,7,0,0,,8654,-8640
42,10/14/2017,63,15:30,15:45,,,0,31.27,31.27,0,-57409,44229,101638,-13180,0,-599,0,0,0,,599,-599
42,10/14/2017,64,15:45,16:00,,,0,31.27,31.27,0,-50847,40928,91775,-9919,0,0,0,0,0,,0,0
42,10/14/2017,65,16:00,16:15,34.56,,0,34.56,34.56,1,-75891,60352,136243,-15539,0,0,944,0,0,,944,944
42,10/14/2017,66,16:15,16:30,33.22,,0,33.22,33.22,1,-76429,57471,133900,-18958,0,0,309,0,0,,309,309
42,10/14/2017,67,16:30,16:45,35.36,,0,35.36,35.36,1,-77078,28581,105659,-48497,0,0,836,0,0,,836,836
42,10/14/2017,68,16:45,17:00,31.65,,0,31.65,31.65,1,-92090,28669,120759,-63421,0,0,150,0,0,,150,150
42,10/14/2017,69,17:00,17:15,31.44,,0,31.44,31.44,1,-91825,60408,152233,-31417,0,0,394,0,0,,394,394
42,10/14/2017,70,17:15,17:30,40,,0,40,40,1,-87036,51386,138422,-35650,0,0,5311,0,0,,5311,5311
42,10/14/2017,71,17:30,17:45,303.91,,0,303.91,303.91,1,-105889,41195,147084,-64694,0,0,15226,0,0,,15226,15226
42,10/14/2017,72,17:45,18:00,303.91,,0,303.91,303.91,1,-74561,50798,125359,-23763,0,0,42008,0,0,,42008,42008
42,10/14/2017,73,18:00,18:15,36.98,-41.61,0,36.98,-41.61,2,-46615,112934,159549,66319,0,-16126,14113,0,0,,30239,-2013
42,10/14/2017,74,18:15,18:30,30.58,24.36,0,30.58,30.58,1,-58694,63207,121901,4513,0,-9451,191,0,0,,9642,-9260
42,10/14/2017,75,18:30,18:45,30.58,10.55,0,32.18,10.55,2,-39100,101352,140452,62252,0,-11397,96,0,0,,11493,-11301
42,10/14/2017,76,18:45,19:00,,26.69,0,26.69,26.69,-1,-54340,87124,141464,32784,0,-12354,0,0,0,,12354,-12354
42,10/14/2017,77,19:00,19:15,,29.36,0,29.36,29.36,-1,-51389,68360,119749,16971,0,-1064,0,0,0,,1064,-1064
42,10/14/2017,78,19:15,19:30,36.5,,0,36.5,36.5,1,-82555,56875,139430,-25680,0,0,2351,0,0,,2351,2351
42,10/14/2017,79,19:30,19:45,30.58,,0,30.58,30.58,1,-59424,71616,131040,12192,0,0,1066,0,0,,1066,1066
42,10/14/2017,80,19:45,20:00,,,0,32.18,32.18,0,-62618,76588,139206,13970,0,0,0,0,0,,0,0
42,10/14/2017,81,20:00,20:15,,29.36,0,29.36,29.36,-1,-74255,80297,154552,6042,0,-1217,0,0,0,,1217,-1217
42,10/14/2017,82,20:15,20:30,,29.48,0,29.48,29.48,-1,-64509,63156,127665,-1353,0,-1318,0,0,0,,1318,-1318
42,10/14/2017,83,20:30,20:45,,15.61,0,15.61,15.61,-1,-48159,67622,115781,19463,0,-15009,0,0,0,,15009,-15009
42,10/14/2017,84,20:45,21:00,30.91,30.19,0,30.91,30.91,1,-45177,62941,108118,17764,0,-7890,138,0,0,,8028,-7752
42,10/14/2017,85,21:00,21:15,51.84,31.55,0,51.84,31.55,2,-75449,14573,90022,-60876,0,-135,4497,0,0,,4632,4362
42,10/14/2017,86,21:15,21:30,51.84,,0,51.84,51.84,1,-63637,21064,84701,-42573,0,0,11253,0,0,,11253,11253
42,10/14/2017,87,21:30,21:45,51.84,29.69,0,29.69,29.69,-1,-47695,21514,69209,-26181,0,-182,362,0,0,,544,180
42,10/14/2017,88,21:45,22:00,,31.61,0,31.61,31.61,-1,-51865,36449,88314,-15416,0,-8,0,0,0,,8,-8
42,10/14/2017,89,22:00,22:15,,31.52,0,31.52,31.52,-1,-44940,17148,62088,-27792,0,-295,0,0,0,,295,-295
42,10/14/2017,90,22:15,22:30,,,0,32.18,32.18,0,-44264,22111,66375,-22153,0,0,0,0,0,,0,0
42,10/14/2017,91,22:30,22:45,34.58,,0,34.58,34.58,1,-41245,32154,73399,-9091,0,0,353,0,0,,353,353
42,10/14/2017,92,22:45,23:00,30.92,,0,30.92,30.92,1,-66790,44098,110888,-22692,0,0,492,0,0,,492,492
42,10/14/2017,93,23:00,23:15,380.93,,0,380.93,380.93,1,-98108,19954,118062,-78154,0,0,27602,0,0,,27602,27602
42,10/14/2017,94,23:15,23:30,32.99,,0,32.99,32.99,1,-67311,43643,110954,-23668,0,0,11062,0,0,,11062,11062
42,10/14/2017,95,23:30,23:45,,,0,32.37,32.37,0,-50294,40474,90768,-9820,0,0,0,0,0,,0,0
42,10/14/2017,96,23:45,0:00,,29.36,0,29.36,29.36,-1,-82372,42129,124501,-40243,0,-39,0,0,0,,39,-39
42,10/15/2017,1,0:00,0:15,34.05,25.23,0,34.05,25.23,2,-33901,83385,117286,49484,0,-276,207,0,0,,483,-69
42,10/15/2017,2,0:15,0:30,39.17,,0,39.17,39.17,1,-48634,40072,88706,-8562,0,0,5079,0,0,,5079,5079
42,10/15/2017,3,0:30,0:45,,,0,31.84,31.84,0,-51264,65418,116682,14154,0,0,119,0,0,,119,119
42,10/15/2017,4,0:45,1:00,36.55,,0,36.55,36.55,1,-94543,52983,147526,-41560,0,0,3190,0,0,,3190,3190
42,10/15/2017,5,1:00,1:15,39.17,,0,39.17,39.17,1,-62062,70626,132688,8564,0,0,641,0,0,,641,641
42,10/15/2017,6,1:15,1:30,47,,0,47,47,1,-44413,30655,75068,-13758,0,0,3413,0,0,,3413,3413
42,10/15/2017,7,1:30,1:45,,,0,32.07,32.07,0,-33801,33858,67659,57,0,0,0,0,0,,0,0
42,10/15/2017,8,1:45,2:00,,,0,32.04,32.04,0,-53043,35857,88900,-17186,0,0,0,0,0,,0,0
42,10/15/2017,9,2:00,2:15,42.6,,0,42.6,42.6,1,-38660,41469,80129,2809,0,0,2719,0,0,,2719,2719
42,10/15/2017,10,2:15,2:30,35.17,33.17,0,35.17,31.9,2,-38292,33878,72170,-4414,0,-2,6318,0,0,,6320,6316
42,10/15/2017,11,2:30,2:45,35.17,33.17,0,35.17,31.89,2,-54438,23578,78016,-30860,0,-31,1524,0,0,,1555,1493
42,10/15/2017,12,2:45,3:00,30.97,,0,30.97,30.97,1,-83715,35336,119051,-48379,0,0,764,0,0,,764,764
42,10/15/2017,13,3:00,3:15,,32.17,0,32.17,32.17,-1,-42386,57277,99663,14891,0,-716,0,0,0,,716,-716
42,10/15/2017,14,3:15,3:30,45.17,,0,45.17,45.17,1,-53782,10346,64128,-43436,0,0,5711,0,0,,5711,5711
42,10/15/2017,15,3:30,3:45,,,0,31.9,31.9,0,-58754,18604,77358,-40150,0,0,227,0,0,,227,227
42,10/15/2017,16,3:45,4:00,,,0,31.89,31.89,0,-62322,23183,85505,-39139,0,0,0,0,0,,0,0
42,10/15/2017,17,4:00,4:15,30.88,,0,30.88,30.88,1,-55318,45885,101203,-9433,0,0,118,0,0,,118,118
42,10/15/2017,18,4:15,4:30,33.35,,0,33.35,33.35,1,-51185,33528,84713,-17657,0,0,1279,0,0,,1279,1279
42,10/15/2017,19,4:30,4:45,32.87,,0,32.87,32.87,1,-39828,31250,71078,-8578,0,0,2794,0,0,,2794,2794
42,10/15/2017,20,4:45,5:00,30.58,,0,30.58,30.58,1,-27832,33123,60955,5291,0,0,921,0,0,,921,921
42,10/15/2017,21,5:00,5:15,,33.17,0,33.17,33.17,-1,-25096,37052,62148,11956,0,-13,0,0,0,,13,-13
42,10/15/2017,22,5:15,5:30,,,0,31.88,31.88,0,-21571,46233,67804,24662,0,0,0,0,0,,0,0
42,10/15/2017,23,5:30,5:45,,16.92,0,16.92,16.92,-1,-22852,64698,87550,41846,0,-12791,0,0,0,,12791,-12791
42,10/15/2017,24,5:45,6:00,,29.29,0,29.29,29.29,-1,-23385,65978,89363,42593,0,-9952,0,0,0,,9952,-9952
42,10/15/2017,25,6:00,6:15,,28.94,0,28.94,28.94,-1,-36790,83724,120514,46934,0,-10495,0,0,0,,10495,-10495
42,10/15/2017,26,6:15,6:30,,30.75,0,30.75,30.75,-1,-40253,67590,107843,27337,0,-11663,0,0,0,,11663,-11663
42,10/15/2017,27,6:30,6:45,,32.1,0,32.1,32.1,-1,-35065,62527,97592,27462,0,-1589,0,0,0,,1589,-1589
42,10/15/2017,28,6:45,7:00,,29.79,0,29.79,29.79,-1,-23525,111233,134758,87708,0,-2211,0,0,0,,2211,-2211
42,10/15/2017,29,7:00,7:15,,31.63,0,31.63,31.63,-1,-61495,44194,105689,-17301,0,-334,0,0,0,,334,-334
42,10/15/2017,30,7:15,7:30,,32.1,0,32.1,32.1,-1,-40522,48234,88756,7712,0,-1181,0,0,0,,1181,-1181
42,10/15/2017,31,7:30,7:45,31.7,33.1,0,31.85,31.85,2,-50172,32984,83156,-17188,0,-298,302,0,0,,600,4
42,10/15/2017,32,7:45,8:00,31.37,31.56,0,31.56,31.56,-1,-50933,75114,126047,24181,0,-72,527,0,0,,599,455
42,10/15/2017,33,8:00,8:15,,8.81,0,8.81,8.81,-1,-21736,81890,103626,60154,0,-14840,0,0,0,,14840,-14840
42,10/15/2017,34,8:15,8:30,,24.24,0,24.24,24.24,-1,-21502,82089,103591,60587,0,-4214,0,0,0,,4214,-4214
42,10/15/2017,35,8:30,8:45,,18.1,0,18.1,18.1,-1,-22269,85267,107536,62998,0,-11374,0,0,0,,11374,-11374
42,10/15/2017,36,8:45,9:00,,31.07,0,31.07,31.07,-1,-29516,82825,112341,53309,0,-2471,0,0,0,,2471,-2471
42,10/15/2017,37,9:00,9:15,,18.58,0,18.58,18.58,-1,-25759,70057,95816,44298,0,-4912,0,0,0,,4912,-4912
42,10/15/2017,38,9:15,9:30,,28.1,0,28.1,28.1,-1,-37932,61661,99593,23729,0,-1444,0,0,0,,1444,-1444
42,10/15/2017,39,9:30,9:45,,28.1,0,28.1,28.1,-1,-39868,46697,86565,6829,0,-1691,0,0,0,,1691,-1691
42,10/15/2017,40,9:45,10:00,35.1,33.1,0,35.1,31.87,2,-49015,49785,98800,770,0,-16,651,0,0,,667,635
42,10/15/2017,41,10:00,10:15,,28.1,0,28.1,28.1,-1,-37349,93506,130855,56157,0,-2966,0,0,0,,2966,-2966
42,10/15/2017,42,10:15,10:30,,11.67,0,11.67,11.67,-1,-39884,88266,128150,48382,0,-12781,0,0,0,,12781,-12781
42,10/15/2017,43,10:30,10:45,,10.85,0,10.85,10.85,-1,-43660,91863,135523,48203,0,-22375,0,0,0,,22375,-22375
42,10/15/2017,44,10:45,11:00,,2.04,0,2.04,2.04,-1,-31801,101885,133686,70084,0,-47555,0,0,0,,47555,-47555
42,10/15/2017,45,11:00,11:15,39.1,24.03,0,39.1,39.1,1,-59797,49386,109183,-10411,0,-24413,1548,0,0,,25961,-22865
42,10/15/2017,46,11:15,11:30,,,0,32.04,32.04,0,-57793,67370,125163,9577,0,-32,351,0,0,,383,319
42,10/15/2017,47,11:30,11:45,,28.1,0,28.1,28.1,-1,-52055,58173,110228,6118,0,-3260,0,0,0,,3260,-3260
42,10/15/2017,48,11:45,12:00,,31.17,0,31.17,31.17,-1,-42769,55071,97840,12302,0,-2431,0,0,0,,2431,-2431
42,10/15/2017,49,12:00,12:15,,31.16,0,31.16,31.16,-1,-29447,58057,87504,28610,0,-1743,0,0,0,,1743,-1743
42,10/15/2017,50,12:15,12:30,,18.1,0,18.1,18.1,-1,-25590,58081,83671,32491,0,-14066,0,0,0,,14066,-14066
42,10/15/2017,51,12:30,12:45,,22.74,0,22.74,22.74,-1,-29551,73718,103269,44167,0,-30289,0,0,0,,30289,-30289
42,10/15/2017,52,12:45,13:00,,7.64,0,7.64,7.64,-1,-28009,76617,104626,48608,0,-47991,0,0,0,,47991,-47991
42,10/15/2017,53,13:00,13:15,,0.14,0,0.14,0.14,-1,-53385,119908,173293,66523,0,-46224,0,0,0,,46224,-46224
42,10/15/2017,54,13:15,13:30,,9.32,0,9.32,9.32,-1,-47663,78296,125959,30633,0,-16356,0,0,0,,16356,-16356
42,10/15/2017,55,13:30,13:45,,10.67,0,10.67,10.67,-1,-45795,65116,110911,19321,0,-31139,0,0,0,,31139,-31139
42,10/15/2017,56,13:45,14:00,,26.83,0,26.83,26.83,-1,-44229,51499,95728,7270,0,-9459,0,0,0,,9459,-9459
42,10/15/2017,57,14:00,14:15,,6.82,0,6.82,6.82,-1,-26736,110918,137654,84182,0,-10759,0,0,0,,10759,-10759
42,10/15/2017,58,14:15,14:30,,26,0,26,26,-1,-30263,75799,106062,45536,0,-1668,0,0,0,,1668,-1668
42,10/15/2017,59,14:30,14:45,,,0,31.67,31.67,0,-37346,90436,127782,53090,0,-523,0,0,0,,523,-523
42,10/15/2017,60,14:45,15:00,,28,0,28,28,-1,-38972,100101,139073,61129,0,-2357,0,0,0,,2357,-2357
42,10/15/2017,61,15:00,15:15,,13.68,0,13.68,13.68,-1,-38109,75028,113137,36919,0,-6805,0,0,0,,6805,-6805
42,10/15/2017,62,15:15,15:30,,14.99,0,14.99,14.99,-1,-32987,77531,110518,44544,0,-14067,0,0,0,,14067,-14067
42,10/15/2017,63,15:30,15:45,,26.63,0,26.63,26.63,-1,-35943,81283,117226,45340,0,-14559,0,0,0,,14559,-14559
42,10/15/2017,64,15:45,16:00,,30.33,0,30.33,30.33,-1,-32336,74396,106732,42060,0,-8183,0,0,0,,8183,-8183
42,10/15/2017,65,16:00,16:15,,-26.9,0,-26.9,-26.9,-1,-37078,82662,119740,45584,0,-21328,0,0,0,,21328,-21328
42,10/15/2017,66,16:15,16:30,30.21,14.81,0,30.21,30.21,1,-72609,103537,176146,30928,0,-18764,16,0,0,,18780,-18748
42,10/15/2017,67,16:30,16:45,39.1,14.81,0,39.1,39.1,1,-75791,62009,137800,-13782,0,-16,1272,0,0,,1288,1256
42,10/15/2017,68,16:45,17:00,45.1,32.1,0,45.1,31.69,2,-55183,95388,150571,40205,0,-85,9728,0,0,,9813,9643
42,10/15/2017,69,17:00,17:15,45.1,13.92,0,13.92,13.92,-1,-66265,69446,135711,3181,0,-16467,59,0,0,,16526,-16408
42,10/15/2017,70,17:15,17:30,35.1,13.92,0,35.1,35.1,1,-67308,49541,116849,-17767,0,-7057,760,0,0,,7817,-6297
42,10/15/2017,71,17:30,17:45,45.38,,0,45.38,45.38,1,-74332,39310,113642,-35022,0,0,2177,0,0,,2177,2177
42,10/15/2017,72,17:45,18:00,45.38,,0,45.38,45.38,1,-61974,74753,136727,12779,0,0,5668,0,0,,5668,5668
42,10/15/2017,73,18:00,18:15,45.38,30.28,0,30.28,30.28,-1,-65216,62053,127269,-3163,0,-1053,134,0,0,,1187,-919
42,10/15/2017,74,18:15,18:30,,30.3,0,30.3,30.3,-1,-37436,70998,108434,33562,0,-5302,0,0,0,,5302,-5302
42,10/15/2017,75,18:30,18:45,,28.05,0,28.05,28.05,-1,-38318,104041,142359,65723,0,-7518,0,0,0,,7518,-7518
42,10/15/2017,76,18:45,19:00,,,0,32.04,32.04,0,-53911,111059,164970,57148,0,-434,0,0,0,,434,-434
42,10/15/2017,77,19:00,19:15,,,0,32.01,32.01,0,-37886,67802,105688,29916,0,0,0,0,0,,0,0
42,10/15/2017,78,19:15,19:30,,,0,32.03,32.03,0,-40318,61630,101948,21312,0,0,0,0,0,,0,0
42,10/15/2017,79,19:30,19:45,,28.1,0,28.1,28.1,-1,-41698,77235,118933,35537,0,-1652,0,0,0,,1652,-1652
42,10/15/2017,80,19:45,20:00,,7.57,0,7.57,7.57,-1,-34782,91052,125834,56270,0,-6817,0,0,0,,6817,-6817
42,10/15/2017,81,20:00,20:15,,9.56,0,9.56,9.56,-1,-67957,91791,159748,23834,0,-10361,0,0,0,,10361,-10361
42,10/15/2017,82,20:15,20:30,,26.61,0,26.61,26.61,-1,-59262,77791,137053,18529,0,-1501,0,0,0,,1501,-1501
42,10/15/2017,83,20:30,20:45,,2.42,0,2.42,2.42,-1,-60568,113798,174366,53230,0,-39423,0,0,0,,39423,-39423
42,10/15/2017,84,20:45,21:00,,11.41,0,11.41,11.41,-1,-65323,113429,178752,48106,0,-40538,0,0,0,,40538,-40538
42,10/15/2017,85,21:00,21:15,,-26.54,0,-26.54,-26.54,-1,-48073,89491,137564,41418,0,-41414,0,0,0,,41414,-41414
42,10/15/2017,86,21:15,21:30,,16.32,0,16.32,16.32,-1,-53438,81182,134620,27744,0,-11798,0,0,0,,11798,-11798
42,10/15/2017,87,21:30,21:45,,9.82,0,9.82,9.82,-1,-49844,107202,157046,57358,0,-35623,0,0,0,,35623,-35623
42,10/15/2017,88,21:45,22:00,,12.66,0,12.66,12.66,-1,-81730,125766,207496,44036,0,-41329,0,0,0,,41329,-41329
42,10/15/2017,89,22:00,22:15,340.86,28.1,0,340.86,340.86,1,-109939,65249,175188,-44690,0,-16606,9160,0,0,,25766,-7446
42,10/15/2017,90,22:15,22:30,340.86,18.1,0,340.86,18.1,2,-91611,88664,180275,-2947,0,-1121,21360,0,0,,22481,20239
42,10/15/2017,91,22:30,22:45,340.86,16.22,0,16.22,16.22,-1,-103564,125753,229317,22189,0,-9986,589,0,0,,10575,-9397
42,10/15/2017,92,22:45,23:00,,30.89,0,30.89,30.89,-1,-117095,115696,232791,-1399,0,-8490,0,0,0,,8490,-8490
42,10/15/2017,93,23:00,23:15,51.1,32.1,0,51.1,31.78,2,-112128,103333,215461,-8795,0,-1585,4661,0,0,,6246,3076
42,10/15/2017,94,23:15,23:30,48.92,11.47,0,11.47,11.47,-1,-95994,116301,212295,20307,0,-6425,6435,0,0,,12860,10
42,10/15/2017,95,23:30,23:45,,0.39,0,0.39,0.39,-1,-71232,136405,207637,65173,0,-56689,0,0,0,,56689,-56689
42,10/15/2017,96,23:45,0:00,,14.52,0,14.52,14.52,-1,-89434,113161,202595,23727,0,-50532,0,0,0,,50532,-50532
42,10/16/2017,1,0:00,0:15,43.96,14.52,0,43.96,43.96,1,-72920,74266,147186,1346,0,-5350,3120,0,0,,8470,-2230
42,10/16/2017,2,0:15,0:30,44.48,23.66,0,44.48,23.66,2,-76592,80219,156811,3627,0,-1632,8770,0,0,,10402,7138
42,10/16/2017,3,0:30,0:45,,21.44,0,21.44,21.44,-1,-68877,95416,164293,26539,0,-12507,0,0,0,,12507,-12507
42,10/16/2017,4,0:45,1:00,,7.09,0,7.09,7.09,-1,-69699,121467,191166,51768,0,-50712,0,0,0,,50712,-50712
42,10/16/2017,5,1:00,1:15,,17.3,0,17.3,17.3,-1,-63118,109442,172560,46324,0,-25857,0,0,0,,25857,-25857
42,10/16/2017,6,1:15,1:30,,,0,30.45,30.45,0,-78070,103949,182019,25879,0,0,0,0,0,,0,0
42,10/16/2017,7,1:30,1:45,,,0,30.56,30.56,0,-83745,104129,187874,20384,0,0,0,0,0,,0,0
42,10/16/2017,8,1:45,2:00,,30.61,0,30.61,30.61,-1,-90250,97047,187297,6797,0,-22,0,0,0,,22,-22
42,10/16/2017,9,2:00,2:15,,27.66,0,27.66,27.66,-1,-83155,97433,180588,14278,0,-5739,0,0,0,,5739,-5739
42,10/16/2017,10,2:15,2:30,,27.66,0,27.66,27.66,-1,-76441,90210,166651,13769,0,-14555,0,0,0,,14555,-14555
42,10/16/2017,11,2:30,2:45,30.84,29.78,0,30.84,30.84,1,-78348,72754,151102,-5594,0,-4978,384,0,0,,5362,-4594
42,10/16/2017,12,2:45,3:00,30.66,23.66,0,23.66,23.66,-1,-75667,85782,161449,10115,0,-8963,403,0,0,,9366,-8560
42,10/16/2017,13,3:00,3:15,,18.39,0,18.39,18.39,-1,-58238,93966,152204,35728,0,-18605,0,0,0,,18605,-18605
42,10/16/2017,14,3:15,3:30,34.66,28.66,0,34.66,28.66,2,-66938,76665,143603,9727,0,-469,5,0,0,,474,-464
42,10/16/2017,15,3:30,3:45,,27.66,0,27.66,27.66,-1,-65654,72812,138466,7158,0,-3462,0,0,0,,3462,-3462
42,10/16/2017,16,3:45,4:00,,19.55,0,19.55,19.55,-1,-60532,82810,143342,22278,0,-13096,0,0,0,,13096,-13096
42,10/16/2017,17,4:00,4:15,,26.59,0,26.59,26.59,-1,-48558,91938,140496,43380,0,-16773,0,0,0,,16773,-16773
42,10/16/2017,18,4:15,4:30,,28.66,0,28.66,28.66,-1,-47143,85132,132275,37989,0,-1325,0,0,0,,1325,-1325
42,10/16/2017,19,4:30,4:45,,,0,31.01,31.01,0,-43083,72510,115593,29427,0,0,0,0,0,,0,0
42,10/16/2017,20,4:45,5:00,,,0,31.01,31.01,0,-48160,121485,169645,73325,0,0,0,0,0,,0,0
42,10/16/2017,21,5:00,5:15,,29.89,0,29.89,29.89,-1,-108726,65023,173749,-43703,0,-102,0,0,0,,102,-102
42,10/16/2017,22,5:15,5:30,,28.66,0,28.66,28.66,-1,-35259,73782,109041,38523,0,-866,0,0,0,,866,-866
42,10/16/2017,23,5:30,5:45,,,0,30.6,30.6,0,-48468,66818,115286,18350,0,0,0,0,0,,0,0
42,10/16/2017,24,5:45,6:00,,,0,30.83,30.83,0,-49519,146309,195828,96790,0,0,0,0,0,,0,0
42,10/16/2017,25,6:00,6:15,31.8,,0,31.8,31.8,1,-165439,90197,255636,-75242,0,0,197,0,0,,197,197
42,10/16/2017,26,6:15,6:30,,27.78,0,27.78,27.78,-1,-44868,92397,137265,47529,0,-2878,0,0,0,,2878,-2878
42,10/16/2017,27,6:30,6:45,34.78,27.78,0,34.78,34.78,1,-50537,54898,105435,4361,0,-91,261,0,0,,352,170
42,10/16/2017,28,6:45,7:00,48,,0,48,48,1,-59609,56322,115931,-3287,0,0,13363,0,0,,13363,13363
42,10/16/2017,29,7:00,7:15,48,-42.24,0,-42.24,-42.24,-1,-39059,127796,166855,88737,0,-31594,537,0,0,,32131,-31057
42,10/16/2017,30,7:15,7:30,61.34,27.89,0,61.34,27.89,2,-47792,74942,122734,27150,0,-16681,1203,0,0,,17884,-15478
42,10/16/2017,31,7:30,7:45,61.34,27.89,0,61.34,61.34,1,-78388,50496,128884,-27892,0,-1401,6320,0,0,,7721,4919
42,10/16/2017,32,7:45,8:00,34.78,,0,34.78,34.78,1,-90012,39475,129487,-50537,0,0,7658,0,0,,7658,7658
42,10/16/2017,33,8:00,8:15,34.78,23.78,0,23.78,23.78,-1,-46713,74655,121368,27942,0,-6842,592,0,0,,7434,-6250
42,10/16/2017,34,8:15,8:30,,29.51,0,29.51,29.51,-1,-62865,68217,131082,5352,0,-7963,0,0,0,,7963,-7963
42,10/16/2017,35,8:30,8:45,31.89,30.72,0,31.89,31.89,1,-72969,65817,138786,-7152,0,-3571,173,0,0,,3744,-3398
42,10/16/2017,36,8:45,9:00,65.5,30.72,0,65.5,65.5,1,-84174,60266,144440,-23908,0,-48,4112,0,0,,4160,4064
42,10/16/2017,37,9:00,9:15,72.37,,0,72.37,72.37,1,-68964,48409,117373,-20555,0,0,18559,0,0,,18559,18559
42,10/16/2017,38,9:15,9:30,31.39,,0,31.39,31.39,1,-49892,42060,91952,-7832,0,0,1718,0,0,,1718,1718
42,10/16/2017,39,9:30,9:45,38.55,,0,38.55,38.55,1,-57730,39189,96919,-18541,0,0,2871,0,0,,2871,2871
42,10/16/2017,40,9:45,10:00,66.37,30.94,0,66.37,30.94,2,-63203,39544,102747,-23659,0,-42,18941,0,0,,18983,18899
42,10/16/2017,41,10:00,10:15,38.68,30.96,0,38.68,30.96,2,-55415,37054,92469,-18361,0,-154,6293,0,0,,6447,6139
42,10/16/2017,42,10:15,10:30,34.78,,0,34.78,34.78,1,-71555,47189,118744,-24366,0,0,10736,0,0,,10736,10736
42,10/16/2017,43,10:30,10:45,50.34,,0,50.34,50.34,1,-71875,39310,111185,-32565,0,0,11863,0,0,,11863,11863
42,10/16/2017,44,10:45,11:00,34.78,,0,34.78,34.78,1,-52134,40804,92938,-11330,0,0,13091,0,0,,13091,13091
42,10/16/2017,45,11:00,11:15,391.95,,0,391.95,391.95,1,-96245,25100,121345,-71145,0,0,28239,0,0,,28239,28239
42,10/16/2017,46,11:15,11:30,50.17,29.38,0,29.38,29.38,-1,-34583,41117,75700,6534,0,-928,20102,0,0,,21030,19174
42,10/16/2017,47,11:30,11:45,,,0,31.39,31.39,0,-39705,56985,96690,17280,0,-178,59,0,0,,237,-119
42,10/16/2017,48,11:45,12:00,36.64,,0,36.64,36.64,1,-45627,37712,83339,-7915,0,0,929,0,0,,929,929
42,10/16/2017,49,12:00,12:15,154.4,,0,154.4,154.4,1,-63950,20757,84707,-43193,0,0,28322,0,0,,28322,28322
42,10/16/2017,50,12:15,12:30,34.78,29.95,0,29.95,29.95,-1,-46457,36868,83325,-9589,0,-85,11866,0,0,,11951,11781
42,10/16/2017,51,12:30,12:45,38.43,,0,38.43,38.43,1,-61269,44722,105991,-16547,0,0,2061,0,0,,2061,2061
42,10/16/2017,52,12:45,13:00,46.78,,0,46.78,46.78,1,-70650,45659,116309,-24991,0,0,9879,0,0,,9879,9879
42,10/16/2017,53,13:00,13:15,35.6,30.8,0,35.6,30.8,2,-59441,53958,113399,-5483,0,-84,3677,0,0,,3761,3593
42,10/16/2017,54,13:15,13:30,40.56,,0,40.56,40.56,1,-72759,40533,113292,-32226,0,0,11984,0,0,,11984,11984
42,10/16/2017,55,13:30,13:45,38.5,,0,38.5,38.5,1,-85144,43399,128543,-41745,0,0,15520,0,0,,15520,15520
42,10/16/2017,56,13:45,14:00,68.89,,0,68.89,68.89,1,-84940,39806,124746,-45134,0,0,29210,0,0,,29210,29210
42,10/16/2017,57,14:00,14:15,46.56,,0,46.56,46.56,1,-76340,37286,113626,-39054,0,0,11552,0,0,,11552,11552
42,10/16/2017,58,14:15,14:30,76.12,,0,76.12,76.12,1,-62690,41382,104072,-21308,0,0,20229,0,0,,20229,20229
42,10/16/2017,59,14:30,14:45,76.12,31.63,0,31.63,31.63,-1,-59706,59562,119268,-144,0,-132,3593,0,0,,3725,3461
42,10/16/2017,60,14:45,15:00,30.78,,0,30.78,30.78,1,-54996,54732,109728,-264,0,0,32,0,0,,32,32
42,10/16/2017,61,15:00,15:15,31.79,,0,31.79,31.79,1,-66207,67195,133402,988,0,0,420,0,0,,420,420
42,10/16/2017,62,15:15,15:30,,,0,31.39,31.39,0,-71254,67135,138389,-4119,0,0,0,0,0,,0,0
42,10/16/2017,63,15:30,15:45,34.78,,0,34.78,34.78,1,-85761,68047,153808,-17714,0,0,698,0,0,,698,698
42,10/16/2017,64,15:45,16:00,34.78,,0,34.78,34.78,1,-97790,53099,150889,-44691,0,0,1720,0,0,,1720,1720
42,10/16/2017,65,16:00,16:15,30.78,,0,30.78,30.78,1,-75099,26174,101273,-48925,0,0,49,0,0,,49,49
42,10/16/2017,66,16:15,16:30,151.85,,0,151.85,151.85,1,-85925,18465,104390,-67460,0,0,11819,0,0,,11819,11819
42,10/16/2017,67,16:30,16:45,35,,0,35,35,1,-76776,33824,110600,-42952,0,0,17927,0,0,,17927,17927
42,10/16/2017,68,16:45,17:00,34.78,,0,34.78,34.78,1,-72542,48402,120944,-24140,0,0,9374,0,0,,9374,9374
42,10/16/2017,69,17:00,17:15,35.46,,0,35.46,35.46,1,-87194,20690,107884,-66504,0,0,1353,0,0,,1353,1353
42,10/16/2017,70,17:15,17:30,,,0,31.38,31.38,0,-93234,21714,114948,-71520,0,0,0,0,0,,0,0
42,10/16/2017,71,17:30,17:45,35.62,,0,35.62,35.62,1,-88292,26599,114891,-61693,0,0,2340,0,0,,2340,2340
42,10/16/2017,72,17:45,18:00,40.24,,0,40.24,40.24,1,-94790,31685,126475,-63105,0,0,2035,0,0,,2035,2035
42,10/16/2017,73,18:00,18:15,38.77,,0,38.77,38.77,1,-143783,31759,175542,-112024,0,0,6836,0,0,,6836,6836
42,10/16/2017,74,18:15,18:30,,,0,31.39,31.39,0,-95271,36944,132215,-58327,0,0,1667,0,0,,1667,1667
42,10/16/2017,75,18:30,18:45,,,0,31.39,31.39,0,-57588,48871,106459,-8717,0,0,0,0,0,,0,0
42,10/16/2017,76,18:45,19:00,69.47,,0,69.47,69.47,1,-95318,77655,172973,-17663,0,0,3687,0,0,,3687,3687
42,10/16/2017,77,19:00,19:15,558.54,,0,558.54,558.54,1,-106529,38468,144997,-68061,0,0,44352,0,0,,44352,44352
42,10/16/2017,78,19:15,19:30,558.54,26.22,0,26.22,26.22,-1,-69643,75448,145091,5805,0,-1821,12021,0,0,,13842,10200
42,10/16/2017,79,19:30,19:45,,30.08,0,30.08,30.08,-1,-73876,73562,147438,-314,0,-1348,0,0,0,,1348,-1348
42,10/16/2017,80,19:45,20:00,,28.78,0,28.78,28.78,-1,-61497,66773,128270,5276,0,-1842,0,0,0,,1842,-1842
42,10/16/2017,81,20:00,20:15,31.46,28.78,0,31.46,31.46,1,-90110,45049,135159,-45061,0,-20,49,0,0,,69,29
42,10/16/2017,82,20:15,20:30,,,0,31.61,31.61,0,-66436,39949,106385,-26487,0,0,0,0,0,,0,0
42,10/16/2017,83,20:30,20:45,,31.01,0,31.01,31.01,-1,-60602,55880,116482,-4722,0,-28,0,0,0,,28,-28
42,10/16/2017,84,20:45,21:00,,21.35,0,21.35,21.35,-1,-55572,79618,135190,24046,0,-5777,0,0,0,,5777,-5777
42,10/16/2017,85,21:00,21:15,159,28.25,0,159,28.25,2,-87703,79701,167404,-8002,0,-9363,6930,0,0,,16293,-2433
42,10/16/2017,86,21:15,21:30,39.33,27.13,0,27.13,27.13,-1,-62694,73010,135704,10316,0,-1443,9262,0,0,,10705,7819
42,10/16/2017,87,21:30,21:45,,14.25,0,14.25,14.25,-1,-45777,81221,126998,35444,0,-23823,0,0,0,,23823,-23823
42,10/16/2017,88,21:45,22:00,32.48,31.84,0,32.48,31.66,2,-105079,63924,169003,-41155,0,-6486,707,0,0,,7193,-5779
42,10/16/2017,89,22:00,22:15,334.99,,0,334.99,334.99,1,-111654,16050,127704,-95604,0,0,22963,0,0,,22963,22963
42,10/16/2017,90,22:15,22:30,334.99,-61.19,0,334.99,-61.19,2,-44264,62126,106390,17862,0,-3137,44060,0,0,,47197,40923
42,10/16/2017,91,22:30,22:45,334.99,-63.17,0,-63.17,-63.17,-1,-51416,92073,143489,40657,0,-35382,198,0,0,,35580,-35184
42,10/16/2017,92,22:45,23:00,,14.25,0,14.25,14.25,-1,-50788,78333,129121,27545,0,-11794,0,0,0,,11794,-11794
42,10/16/2017,93,23:00,23:15,201.77,28.78,0,201.77,28.78,2,-107204,46356,153560,-60848,0,-6655,17009,0,0,,23664,10354
42,10/16/2017,94,23:15,23:30,41.25,31.33,0,31.33,31.33,-1,-54681,35433,90114,-19248,0,-4,13548,0,0,,13552,13544
42,10/16/2017,95,23:30,23:45,31.25,30.68,0,31.25,30.68,2,-48565,35742,84307,-12823,0,-210,136,0,0,,346,-74
42,10/16/2017,96,23:45,0:00,30.42,29.25,0,31.16,29.25,2,-72868,42267,115135,-30601,0,-50,809,0,0,,859,759
42,10/17/2017,1,0:00,0:15,,-67.92,0,-67.92,-67.92,-1,-83611,189589,273200,105978,0,-35179,0,0,0,,35179,-35179
42,10/17/2017,2,0:15,0:30,32.25,27.78,0,32.25,27.78,2,-59464,56122,115586,-3342,0,-3755,152,0,0,,3907,-3603
42,10/17/2017,3,0:30,0:45,35.94,27.78,0,35.94,35.94,1,-57663,31712,89375,-25951,0,-311,3953,0,0,,4264,3642
42,10/17/2017,4,0:45,1:00,32.16,29.14,0,32.16,29.14,2,-54179,49345,103524,-4834,0,-240,2217,0,0,,2457,1977
42,10/17/2017,5,1:00,1:15,132.02,29.14,0,132.02,132.02,1,-65664,12087,77751,-53577,0,-13,15820,0,0,,15833,15807
42,10/17/2017,6,1:15,1:30,45.1,23.78,0,23.78,23.78,-1,-42644,24637,67281,-18007,0,-1097,22882,0,0,,23979,21785
42,10/17/2017,7,1:30,1:45,45.1,18.19,0,18.19,18.19,-1,-33801,33787,67588,-14,0,-11883,91,0,0,,11974,-11792
42,10/17/2017,8,1:45,2:00,,23.78,0,23.78,23.78,-1,-39480,49279,88759,9799,0,-24545,0,0,0,,24545,-24545
42,10/17/2017,9,2:00,2:15,39.1,27.78,0,39.1,39.1,1,-18592,19868,38460,1276,0,-14816,991,0,0,,15807,-13825
42,10/17/2017,10,2:15,2:30,39.1,27.78,0,39.1,27.78,2,-19209,25991,45200,6782,0,-2513,1713,0,0,,4226,-800
42,10/17/2017,11,2:30,2:45,,27.78,0,27.78,27.78,-1,-13779,31517,45296,17738,0,-9282,0,0,0,,9282,-9282
42,10/17/2017,12,2:45,3:00,,28.74,0,28.74,28.74,-1,-31621,39948,71569,8327,0,-2853,0,0,0,,2853,-2853
42,10/17/2017,13,3:00,3:15,,,0,30.82,30.82,0,-57523,42056,99579,-15467,0,-245,0,0,0,,245,-245
42,10/17/2017,14,3:15,3:30,30.52,24.25,0,24.25,24.25,-1,-30921,37697,68618,6776,0,-1739,12,0,0,,1751,-1727
42,10/17/2017,15,3:30,3:45,,19.73,0,19.73,19.73,-1,-27065,40940,68005,13875,0,-18994,0,0,0,,18994,-18994
42,10/17/2017,16,3:45,4:00,,21.92,0,21.92,21.92,-1,-33356,33118,66474,-238,0,-23577,0,0,0,,23577,-23577
42,10/17/2017,17,4:00,4:15,,14.47,0,14.47,14.47,-1,-29316,31686,61002,2370,0,-22576,0,0,0,,22576,-22576
42,10/17/2017,18,4:15,4:30,,28.25,0,28.25,28.25,-1,-25696,19009,44705,-6687,0,-9164,0,0,0,,9164,-9164
42,10/17/2017,19,4:30,4:45,35.1,28.25,0,35.1,35.1,1,-30225,5009,35234,-25216,0,-1067,622,0,0,,1689,-445
42,10/17/2017,20,4:45,5:00,47.12,29.22,0,47.12,29.22,2,-25105,23528,48633,-1577,0,-63,12109,0,0,,12172,12046
42,10/17/2017,21,5:00,5:15,47.25,30.99,0,47.25,30.82,2,-98798,27317,126115,-71481,0,-220,9174,0,0,,9394,8954
42,10/17/2017,22,5:15,5:30,41.25,,0,41.25,41.25,1,-66674,23085,89759,-43589,0,0,16015,0,0,,16015,16015
42,10/17/2017,23,5:30,5:45,37.24,,0,37.24,37.24,1,-51272,13577,64849,-37695,0,0,24538,0,0,,24538,24538
42,10/17/2017,24,5:45,6:00,32.86,14.25,0,32.86,14.25,2,-40388,41407,81795,1019,0,-440,9678,0,0,,10118,9238
42,10/17/2017,25,6:00,6:15,36.09,-202.01,0,36.09,-202.01,2,-43410,59367,102777,15957,0,-19649,1899,0,0,,21548,-17750
42,10/17/2017,26,6:15,6:30,35.24,,0,35.24,35.24,1,-65817,52524,118341,-13293,0,0,1080,0,0,,1080,1080
42,10/17/2017,27,6:30,6:45,349.27,,0,349.27,349.27,1,-100419,33233,133652,-67186,0,0,36642,0,0,,36642,36642
42,10/17/2017,28,6:45,7:00,70.02,-8.7,0,-8.7,-8.7,-1,-66797,74608,141405,7811,0,-1091,28265,0,0,,29356,27174
42,10/17/2017,29,7:00,7:15,70.02,-70.76,0,-70.76,-70.76,-1,-35887,120695,156582,84808,0,-50253,23,0,0,,50276,-50230
42,10/17/2017,30,7:15,7:30,,15.6,0,15.6,15.6,-1,-33701,67893,101594,34192,0,-46198,0,0,0,,46198,-46198
42,10/17/2017,31,7:30,7:45,371.74,15.6,0,371.74,371.74,1,-88076,36289,124365,-51787,0,-5645,18387,0,0,,24032,12742
42,10/17/2017,32,7:45,8:00,371.74,30.43,0,371.74,30.43,2,-90720,40642,131362,-50078,0,-13,48547,0,0,,48560,48534
42,10/17/2017,33,8:00,8:15,371.74,-42.95,0,-42.95,-42.95,-1,-24621,101857,126478,77236,0,-25658,3848,0,0,,29506,-21810
42,10/17/2017,34,8:15,8:30,,28.24,0,28.24,28.24,-1,-58723,74881,133604,16158,0,-5258,0,0,0,,5258,-5258
42,10/17/2017,35,8:30,8:45,31.08,31.06,0,31.31,31.06,2,-68761,45516,114277,-23245,0,-462,228,0,0,,690,-234
42,10/17/2017,36,8:45,9:00,35.09,,0,35.09,35.09,1,-97613,51942,149555,-45671,0,0,2359,0,0,,2359,2359
42,10/17/2017,37,9:00,9:15,399.3,,0,399.3,399.3,1,-100555,46220,146775,-54335,0,0,27445,0,0,,27445,27445
42,10/17/2017,38,9:15,9:30,35.09,27.41,0,35.09,27.41,2,-54711,45023,99734,-9688,0,-751,11849,0,0,,12600,11098
42,10/17/2017,39,9:30,9:45,39.09,,0,39.09,39.09,1,-80087,51549,131636,-28538,0,0,4246,0,0,,4246,4246
42,10/17/2017,40,9:45,10:00,56.02,,0,56.02,56.02,1,-88344,49052,137396,-39292,0,0,19961,0,0,,19961,19961
42,10/17/2017,41,10:00,10:15,56.02,,0,56.02,56.02,1,-138134,71901,210035,-66233,0,0,33276,0,0,,33276,33276
42,10/17/2017,42,10:15,10:30,47.43,,0,47.43,47.43,1,-125697,63142,188839,-62555,0,0,27249,0,0,,27249,27249
42,10/17/2017,43,10:30,10:45,51.09,,0,51.09,51.09,1,-140892,60451,201343,-80441,0,0,23675,0,0,,23675,23675
42,10/17/2017,44,10:45,11:00,56.02,,0,56.02,56.02,1,-139118,59214,198332,-79904,0,0,31288,0,0,,31288,31288
42,10/17/2017,45,11:00,11:15,52.09,,0,52.09,52.09,1,-170105,65331,235436,-104774,0,0,25552,0,0,,25552,25552
42,10/17/2017,46,11:15,11:30,58.2,,0,58.2,58.2,1,-187771,62900,250671,-124871,0,0,36368,0,0,,36368,36368
42,10/17/2017,47,11:30,11:45,77.02,,0,77.02,77.02,1,-181702,66799,248501,-114903,0,0,46445,0,0,,46445,46445
42,10/17/2017,48,11:45,12:00,140.83,,0,140.83,140.83,1,-178333,64174,242507,-114159,0,0,34238,0,0,,34238,34238
42,10/17/2017,49,12:00,12:15,56.02,,0,56.02,56.02,1,-170618,64552,235170,-106066,0,0,41647,0,0,,41647,41647
42,10/17/2017,50,12:15,12:30,56.02,,0,56.02,56.02,1,-187396,58951,246347,-128445,0,0,35004,0,0,,35004,35004
42,10/17/2017,51,12:30,12:45,132.02,,0,132.02,132.02,1,-173598,64232,237830,-109366,0,0,49316,0,0,,49316,49316
42,10/17/2017,52,12:45,13:00,132.02,,0,132.02,132.02,1,-170525,69327,239852,-101198,0,0,57240,0,0,,57240,57240
42,10/17/2017,53,13:00,13:15,41.24,,0,41.24,41.24,1,-138602,113199,251801,-25403,0,0,35535,0,0,,35535,35535
42,10/17/2017,54,13:15,13:30,47.24,,0,47.24,47.24,1,-155416,102638,258054,-52778,0,0,11454,0,0,,11454,11454
42,10/17/2017,55,13:30,13:45,35.24,,0,35.24,35.24,1,-144812,99755,244567,-45057,0,0,6073,0,0,,6073,6073
42,10/17/2017,56,13:45,14:00,30.49,,0,30.49,30.49,1,-138851,94815,233666,-44036,0,0,1927,0,0,,1927,1927
42,10/17/2017,57,14:00,14:15,120.02,,0,120.02,120.02,1,-130984,71414,202398,-59570,0,0,19436,0,0,,19436,19436
42,10/17/2017,58,14:15,14:30,45.09,,0,45.09,45.09,1,-122771,80931,203702,-41840,0,0,33531,0,0,,33531,33531
42,10/17/2017,59,14:30,14:45,41.98,,0,41.98,41.98,1,-144396,78500,222896,-65896,0,0,17067,0,0,,17067,17067
42,10/17/2017,60,14:45,15:00,179.44,,0,179.44,179.44,1,-137793,78219,216012,-59574,0,0,11333,0,0,,11333,11333
42,10/17/2017,61,15:00,15:15,315.84,,0,315.84,315.84,1,-141385,64692,206077,-76693,0,0,55019,0,0,,55019,55019
42,10/17/2017,62,15:15,15:30,315.84,,0,315.84,315.84,1,-152282,72805,225087,-79477,0,0,46371,0,0,,46371,46371
42,10/17/2017,63,15:30,15:45,315.84,,0,315.84,315.84,1,-135129,74054,209183,-61075,0,0,69962,0,0,,69962,69962
42,10/17/2017,64,15:45,16:00,51.09,,0,51.09,51.09,1,-116922,80693,197615,-36229,0,0,27336,0,0,,27336,27336
42,10/17/2017,65,16:00,16:15,224.21,,0,224.21,224.21,1,-108591,57900,166491,-50691,0,0,32565,0,0,,32565,32565
42,10/17/2017,66,16:15,16:30,51.95,,0,51.95,51.95,1,-102687,65650,168337,-37037,0,0,25582,0,0,,25582,25582
42,10/17/2017,67,16:30,16:45,365.56,,0,365.56,365.56,1,-116783,63408,180191,-53375,0,0,44711,0,0,,44711,44711
42,10/17/2017,68,16:45,17:00,365.57,,0,365.57,365.57,1,-115202,53120,168322,-62082,0,0,66000,0,0,,66000,66000
42,10/17/2017,69,17:00,17:15,365.57,23.54,0,23.54,23.54,-1,-52765,55777,108542,3012,0,-2373,26701,0,0,,29074,24328
42,10/17/2017,70,17:15,17:30,538.53,23.54,0,538.53,538.53,1,-87047,37455,124502,-49592,0,-72,24709,0,0,,24781,24637
42,10/17/2017,71,17:30,17:45,538.53,,0,538.53,538.53,1,-78621,36910,115531,-41711,0,0,53059,0,0,,53059,53059
42,10/17/2017,72,17:45,18:00,39.09,,0,39.09,39.09,1,-74232,44500,118732,-29732,0,0,24714,0,0,,24714,24714
42,10/17/2017,73,18:00,18:15,39.09,-12.03,0,-12.03,-12.03,-1,-23749,143337,167086,119588,0,-43291,8147,0,0,,51438,-35144
42,10/17/2017,74,18:15,18:30,,-12.03,0,-12.03,-12.03,-1,-18851,127546,146397,108695,0,-112311,0,0,0,,112311,-112311
42,10/17/2017,75,18:30,18:45,,7.6,0,7.6,7.6,-1,-47047,142835,189882,95788,0,-77949,0,0,0,,77949,-77949
42,10/17/2017,76,18:45,19:00,,11.6,0,11.6,11.6,-1,-80064,124621,204685,44557,0,-55808,0,0,0,,55808,-55808
42,10/17/2017,77,19:00,19:15,34.52,11.6,0,34.52,34.52,1,-83910,85306,169216,1396,0,-3078,513,0,0,,3591,-2565
42,10/17/2017,78,19:15,19:30,,26.99,0,26.99,26.99,-1,-55380,82254,137634,26874,0,-2592,0,0,0,,2592,-2592
42,10/17/2017,79,19:30,19:45,,23.58,0,23.58,23.58,-1,-46615,79786,126401,33171,0,-16255,0,0,0,,16255,-16255
42,10/17/2017,80,19:45,20:00,,24.24,0,24.24,24.24,-1,-40237,76449,116686,36212,0,-15192,0,0,0,,15192,-15192
42,10/17/2017,81,20:00,20:15,35.81,17.94,0,35.81,17.94,2,-64379,64101,128480,-278,0,-7795,621,0,0,,8416,-7174
42,10/17/2017,82,20:15,20:30,,28.24,0,28.24,28.24,-1,-63282,73093,136375,9811,0,-4349,0,0,0,,4349,-4349
42,10/17/2017,83,20:30,20:45,,26.66,0,26.66,26.66,-1,-62879,77246,140125,14367,0,-5791,0,0,0,,5791,-5791
42,10/17/2017,84,20:45,21:00,,24.37,0,24.37,24.37,-1,-52585,91112,143697,38527,0,-25939,0,0,0,,25939,-25939
42,10/17/2017,85,21:00,21:15,39.05,24.24,0,39.05,24.24,2,-61565,72040,133605,10475,0,-24706,804,0,0,,25510,-23902
42,10/17/2017,86,21:15,21:30,36.23,18.45,0,36.23,18.45,2,-58191,81862,140053,23671,0,-8293,829,0,0,,9122,-7464
42,10/17/2017,87,21:30,21:45,,21.03,0,21.03,21.03,-1,-44221,81908,126129,37687,0,-31771,0,0,0,,31771,-31771
42,10/17/2017,88,21:45,22:00,,19.43,0,19.43,19.43,-1,-44765,88810,133575,44045,0,-35329,0,0,0,,35329,-35329
42,10/17/2017,89,22:00,22:15,38.23,11.18,0,38.23,38.23,1,-95150,36936,132086,-58214,0,-23032,1198,0,0,,24230,-21834
42,10/17/2017,90,22:15,22:30,,,0,31.29,31.29,0,-72298,29872,102170,-42426,0,-87,703,0,0,,790,616
42,10/17/2017,91,22:30,22:45,,24.24,0,24.24,24.24,-1,-42419,62275,104694,19856,0,-3965,0,0,0,,3965,-3965
42,10/17/2017,92,22:45,23:00,,14.24,0,14.24,14.24,-1,-40333,84381,124714,44048,0,-37592,0,0,0,,37592,-37592
42,10/17/2017,93,23:00,23:15,43.5,-18.39,0,43.5,-18.39,2,-58512,81361,139873,22849,0,-33497,947,0,0,,34444,-32550
42,10/17/2017,94,23:15,23:30,47.24,24.24,0,24.24,24.24,-1,-46882,56429,103311,9547,0,-2053,1685,0,0,,3738,-368
42,10/17/2017,95,23:30,23:45,,14.24,0,14.24,14.24,-1,-21681,53845,75526,32164,0,-27989,0,0,0,,27989,-27989
42,10/17/2017,96,23:45,0:00,,28.24,0,28.24,28.24,-1,-43422,62920,106342,19498,0,-22899,0,0,0,,22899,-22899
42,10/18/2017,1,0:00,0:15,331.03,28.24,0,331.03,331.03,1,-90757,25595,116352,-65162,0,-7567,17484,0,0,,25051,9917
42,10/18/2017,2,0:15,0:30,40.77,,0,40.77,40.77,1,-68479,26847,95326,-41632,0,0,26866,0,0,,26866,26866
42,10/18/2017,3,0:30,0:45,,,0,30.61,30.61,0,-68011,49271,117282,-18740,0,0,5235,0,0,,5235,5235
42,10/18/2017,4,0:45,1:00,,,0,30.61,30.61,0,-93696,58756,152452,-34940,0,0,0,0,0,,0,0
42,10/18/2017,5,1:00,1:15,229.47,,0,229.47,229.47,1,-114488,8940,123428,-105548,0,0,20936,0,0,,20936,20936
42,10/18/2017,6,1:15,1:30,51.09,,0,51.09,51.09,1,-62601,23171,85772,-39430,0,0,36832,0,0,,36832,36832
42,10/18/2017,7,1:30,1:45,34.88,,0,34.88,34.88,1,-50606,33368,83974,-17238,0,0,2967,0,0,,2967,2967
42,10/18/2017,8,1:45,2:00,36.45,,0,36.45,36.45,1,-48694,33581,82275,-15113,0,0,3373,0,0,,3373,3373
42,10/18/2017,9,2:00,2:15,43.07,,0,43.07,43.07,1,-44325,19481,63806,-24844,0,0,8678,0,0,,8678,8678
42,10/18/2017,10,2:15,2:30,38.12,,0,38.12,38.12,1,-45604,22113,67717,-23491,0,0,15400,0,0,,15400,15400
42,10/18/2017,11,2:30,2:45,37.59,,0,37.59,37.59,1,-52828,19330,72158,-33498,0,0,17133,0,0,,17133,17133
42,10/18/2017,12,2:45,3:00,31.5,,0,31.5,31.5,1,-52890,23283,76173,-29607,0,0,7195,0,0,,7195,7195
42,10/18/2017,13,3:00,3:15,,,0,30.69,30.69,0,-26462,37758,64220,11296,0,0,0,0,0,,0,0
42,10/18/2017,14,3:15,3:30,,,0,30.68,30.68,0,-24735,28127,52862,3392,0,0,0,0,0,,0,0
42,10/18/2017,15,3:30,3:45,,,0,30.68,30.68,0,-24642,29358,54000,4716,0,0,0,0,0,,0,0
42,10/18/2017,16,3:45,4:00,,,0,30.68,30.68,0,-26184,33829,60013,7645,0,0,0,0,0,,0,0
42,10/18/2017,17,4:00,4:15,35.96,,0,35.96,35.96,1,-38000,20534,58534,-17466,0,0,1883,0,0,,1883,1883
42,10/18/2017,18,4:15,4:30,32.25,,0,32.25,32.25,1,-28945,27029,55974,-1916,0,0,3004,0,0,,3004,3004
42,10/18/2017,19,4:30,4:45,36.04,,0,36.04,36.04,1,-34272,29685,63957,-4587,0,0,793,0,0,,793,793
42,10/18/2017,20,4:45,5:00,46.77,,0,46.77,46.77,1,-39747,25612,65359,-14135,0,0,12673,0,0,,12673,12673
42,10/18/2017,21,5:00,5:15,29.48,,0,29.48,29.48,1,-107625,63640,171265,-43985,0,0,1133,0,0,,1133,1133
42,10/18/2017,22,5:15,5:30,,,0,30.63,30.63,0,-63408,47027,110435,-16381,0,0,0,0,0,,0,0
42,10/18/2017,23,5:30,5:45,,31.46,0,31.46,31.46,-1,-30804,31300,62104,496,0,-128,0,0,0,,128,-128
42,10/18/2017,24,5:45,6:00,29.71,27.77,0,30.75,27.77,2,-24148,71317,95465,47169,0,-225,128,0,0,,353,-97
42,10/18/2017,25,6:00,6:15,,-151.21,0,-151.21,-151.21,-1,-36049,91236,127285,55187,0,-18166,0,0,0,,18166,-18166
42,10/18/2017,26,6:15,6:30,,,0,31.3,31.3,0,-41946,37768,79714,-4178,0,-427,0,0,0,,427,-427
42,10/18/2017,27,6:30,6:45,89.99,,0,89.99,89.99,1,-57166,20874,78040,-36292,0,0,6271,0,0,,6271,6271
42,10/18/2017,28,6:45,7:00,350.12,,0,350.12,350.12,1,-69377,36662,106039,-32715,0,0,35263,0,0,,35263,35263
42,10/18/2017,29,7:00,7:15,30.81,-150.44,0,43.77,-150.44,2,-18478,137095,155573,118617,0,-28549,6251,0,0,,34800,-22298
42,10/18/2017,30,7:15,7:30,30.81,-150.44,0,30.81,30.81,1,-36907,41685,78592,4778,0,-196,168,0,0,,364,-28
42,10/18/2017,31,7:30,7:45,72,,0,72,72,1,-70119,29837,99956,-40282,0,0,10727,0,0,,10727,10727
42,10/18/2017,32,7:45,8:00,554.79,,0,554.79,554.79,1,-86995,35593,122588,-51402,0,0,47282,0,0,,47282,47282
42,10/18/2017,33,8:00,8:15,554.79,-149.67,0,-149.67,-149.67,-1,-2280,108847,111127,106567,0,-23224,8948,0,0,,32172,-14276
42,10/18/2017,34,8:15,8:30,,28.81,0,28.81,28.81,-1,-23430,46408,69838,22978,0,-4502,0,0,0,,4502,-4502
42,10/18/2017,35,8:30,8:45,,28.82,0,28.82,28.82,-1,-28522,32753,61275,4231,0,-1557,0,0,0,,1557,-1557
42,10/18/2017,36,8:45,9:00,,,0,43.76,43.76,0,-43522,27400,70922,-16122,0,0,0,0,0,,0,0
42,10/18/2017,37,9:00,9:15,,,0,43.79,43.79,0,-50480,63702,114182,13222,0,0,0,0,0,,0,0
42,10/18/2017,38,9:15,9:30,,31.27,0,31.27,31.27,-1,-58617,62580,121197,3963,0,-1028,0,0,0,,1028,-1028
42,10/18/2017,39,9:30,9:45,,30.29,0,30.29,30.29,-1,-49657,62176,111833,12519,0,-1187,0,0,0,,1187,-1187
42,10/18/2017,40,9:45,10:00,,28.81,0,28.81,28.81,-1,-54593,55161,109754,568,0,-1496,0,0,0,,1496,-1496
42,10/18/2017,41,10:00,10:15,487.83,28.81,0,487.83,487.83,1,-93265,44383,137648,-48882,0,-18,22957,0,0,,22975,22939
42,10/18/2017,42,10:15,10:30,34.32,,0,34.32,34.32,1,-68112,63625,131737,-4487,0,0,9395,0,0,,9395,9395
42,10/18/2017,43,10:30,10:45,30.88,,0,30.88,30.88,1,-71974,59605,131579,-12369,0,0,941,0,0,,941,941
42,10/18/2017,44,10:45,11:00,31.84,,0,31.84,31.84,1,-69334,54512,123846,-14822,0,0,1269,0,0,,1269,1269
42,10/18/2017,45,11:00,11:15,35.71,,0,35.71,35.71,1,-70812,42265,113077,-28547,0,0,2366,0,0,,2366,2366
42,10/18/2017,46,11:15,11:30,,,0,43.85,43.85,0,-61226,38550,99776,-22676,0,0,0,0,0,,0,0
42,10/18/2017,47,11:30,11:45,31.83,,0,31.83,31.83,1,-59453,45052,104505,-14401,0,0,995,0,0,,995,995
42,10/18/2017,48,11:45,12:00,30.81,,0,30.81,30.81,1,-42521,55026,97547,12505,0,0,1064,0,0,,1064,1064
42,10/18/2017,49,12:00,12:15,,27.81,0,27.81,27.81,-1,-42046,68735,110781,26689,0,-454,0,0,0,,454,-454
42,10/18/2017,50,12:15,12:30,,17.03,0,17.03,17.03,-1,-45770,75838,121608,30068,0,-14089,0,0,0,,14089,-14089
42,10/18/2017,51,12:30,12:45,,13.81,0,13.81,13.81,-1,-25248,84289,109537,59041,0,-21408,0,0,0,,21408,-21408
42,10/18/2017,52,12:45,13:00,,-0.22,0,-0.22,-0.22,-1,-23387,78604,101991,55217,0,-48179,0,0,0,,48179,-48179
42,10/18/2017,53,13:00,13:15,,27.81,0,27.81,27.81,-1,-42487,74160,116647,31673,0,-16804,0,0,0,,16804,-16804
42,10/18/2017,54,13:15,13:30,,17.91,0,17.91,17.91,-1,-53668,86335,140003,32667,0,-4236,0,0,0,,4236,-4236
42,10/18/2017,55,13:30,13:45,,13.81,0,13.81,13.81,-1,-48972,85213,134185,36241,0,-19313,0,0,0,,19313,-19313
42,10/18/2017,56,13:45,14:00,,26.45,0,26.45,26.45,-1,-44818,82111,126929,37293,0,-16172,0,0,0,,16172,-16172
42,10/18/2017,57,14:00,14:15,31.85,31.11,0,31.85,31.11,2,-46849,46346,93195,-503,0,-7273,550,0,0,,7823,-6723
42,10/18/2017,58,14:15,14:30,31.21,,0,31.21,31.21,1,-43610,50266,93876,6656,0,0,1410,0,0,,1410,1410
42,10/18/2017,59,14:30,14:45,30.81,,0,30.81,30.81,1,-42158,43061,85219,903,0,0,970,0,0,,970,970
42,10/18/2017,60,14:45,15:00,34.81,,0,34.81,34.81,1,-42473,37495,79968,-4978,0,0,790,0,0,,790,790
42,10/18/2017,61,15:00,15:15,34.81,30.11,0,30.11,30.11,-1,-54285,54331,108616,46,0,-457,73,0,0,,530,-384
42,10/18/2017,62,15:15,15:30,31.72,31.35,0,31.72,30.9,2,-53855,40529,94384,-13326,0,-272,231,0,0,,503,-41
42,10/18/2017,63,15:30,15:45,38.56,,0,38.56,38.56,1,-76953,33376,110329,-43577,0,0,3468,0,0,,3468,3468
42,10/18/2017,64,15:45,16:00,59.7,30.35,0,59.7,30.35,2,-71858,28604,100462,-43254,0,-21,10863,0,0,,10884,10842
42,10/18/2017,65,16:00,16:15,34.97,27.56,0,34.97,27.56,2,-93785,32985,126770,-60800,0,-3038,3480,0,0,,6518,442
42,10/18/2017,66,16:15,16:30,225.75,,0,225.75,225.75,1,-91726,22767,114493,-68959,0,0,28629,0,0,,28629,28629
42,10/18/2017,67,16:30,16:45,68.65,,0,68.65,68.65,1,-63141,25864,89005,-37277,0,0,17000,0,0,,17000,17000
42,10/18/2017,68,16:45,17:00,531.11,,0,531.11,531.11,1,-60960,24230,85190,-36730,0,0,38697,0,0,,38697,38697
42,10/18/2017,69,17:00,17:15,531.11,-30.68,0,-30.68,-30.68,-1,-23832,98117,121949,74285,0,-32712,3332,0,0,,36044,-29380
42,10/18/2017,70,17:15,17:30,,28.29,0,28.29,28.29,-1,-50703,36353,87056,-14350,0,-4892,0,0,0,,4892,-4892
42,10/18/2017,71,17:30,17:45,,28.81,0,28.81,28.81,-1,-45163,51089,96252,5926,0,-853,0,0,0,,853,-853
42,10/18/2017,72,17:45,18:00,31.93,,0,31.93,31.93,1,-58452,63393,121845,4941,0,0,1858,0,0,,1858,1858
42,10/18/2017,73,18:00,18:15,,,0,31.33,31.33,0,-98869,48150,147019,-50719,0,0,844,0,0,,844,844
42,10/18/2017,74,18:15,18:30,79.41,,0,79.41,79.41,1,-96381,50053,146434,-46328,0,0,3290,0,0,,3290,3290
42,10/18/2017,75,18:30,18:45,178.86,,0,178.86,178.86,1,-96349,78928,175277,-17421,0,0,13633,0,0,,13633,13633
42,10/18/2017,76,18:45,19:00,607.15,,0,607.15,607.15,1,-152225,72506,224731,-79719,0,0,26500,0,0,,26500,26500
42,10/18/2017,77,19:00,19:15,675.07,,0,675.07,675.07,1,-124948,58018,182966,-66930,0,0,57593,0,0,,57593,57593
42,10/18/2017,78,19:15,19:30,53.02,,0,53.02,53.02,1,-106286,69039,175325,-37247,0,0,7943,0,0,,7943,7943
42,10/18/2017,79,19:30,19:45,31.13,,0,31.13,31.13,1,-125529,74817,200346,-50712,0,0,872,0,0,,872,872
42,10/18/2017,80,19:45,20:00,,,0,31.32,31.32,0,-112232,71843,184075,-40389,0,0,0,0,0,,0,0
42,10/18/2017,81,20:00,20:15,558.74,,0,558.74,558.74,1,-122916,30104,153020,-92812,0,0,18831,0,0,,18831,18831
42,10/18/2017,82,20:15,20:30,36.91,,0,36.91,36.91,1,-95126,51566,146692,-43560,0,0,17813,0,0,,17813,17813
42,10/18/2017,83,20:30,20:45,36.91,30.18,0,30.18,30.18,-1,-79591,65338,144929,-14253,0,-790,1034,0,0,,1824,244
42,10/18/2017,84,20:45,21:00,,,0,31.3,31.3,0,-96471,72091,168562,-24380,0,-12,0,0,0,,12,-12
42,10/18/2017,85,21:00,21:15,61,,0,61,61,1,-108498,69362,177860,-39136,0,0,10182,0,0,,10182,10182
42,10/18/2017,86,21:15,21:30,34.81,,0,34.81,34.81,1,-80861,58670,139531,-22191,0,0,7109,0,0,,7109,7109
42,10/18/2017,87,21:30,21:45,32.41,30.57,0,32.41,30.57,2,-59207,61135,120342,1928,0,-25,3503,0,0,,3528,3478
42,10/18/2017,88,21:45,22:00,32.41,14.62,0,14.62,14.62,-1,-48974,80591,129565,31617,0,-20306,62,0,0,,20368,-20244
42,10/18/2017,89,22:00,22:15,374.21,14.62,0,374.21,374.21,1,-155296,25536,180832,-129760,0,-5954,16666,0,0,,22620,10712
42,10/18/2017,90,22:15,22:30,34.81,,0,34.81,34.81,1,-93543,35560,129103,-57983,0,0,11102,0,0,,11102,11102
42,10/18/2017,91,22:30,22:45,34.81,31.5,0,31.5,31.5,-1,-64324,66553,130877,2229,0,-5,5,0,0,,10,0
42,10/18/2017,92,22:45,23:00,,28.81,0,28.81,28.81,-1,-73560,85257,158817,11697,0,-2400,0,0,0,,2400,-2400
42,10/18/2017,93,23:00,23:15,349.41,30.79,0,349.41,30.79,2,-141325,45645,186970,-95680,0,-644,17850,0,0,,18494,17206
42,10/18/2017,94,23:15,23:30,45.65,,0,45.65,45.65,1,-111729,33936,145665,-77793,0,0,10376,0,0,,10376,10376
42,10/18/2017,95,23:30,23:45,37.37,,0,37.37,37.37,1,-66510,33935,100445,-32575,0,0,1115,0,0,,1115,1115
42,10/18/2017,96,23:45,0:00,,,0,31.04,31.04,0,-66456,42075,108531,-24381,0,0,0,0,0,,0,0
42,10/19/2017,1,0:00,0:15,39.08,,0,39.08,39.08,1,-69955,47012,116967,-22943,0,0,1453,0,0,,1453,1453
42,10/19/2017,2,0:15,0:30,31.2,,0,31.2,31.2,1,-54587,43782,98369,-10805,0,0,1563,0,0,,1563,1563
42,10/19/2017,3,0:30,0:45,31.2,31.16,0,31.16,31.16,-1,-60709,58261,118970,-2448,0,-94,296,0,0,,390,202
42,10/19/2017,4,0:45,1:00,,29.19,0,29.19,29.19,-1,-70503,84366,154869,13863,0,-1139,0,0,0,,1139,-1139
42,10/19/2017,5,1:00,1:15,48.74,30.11,0,48.74,48.74,1,-73115,37395,110510,-35720,0,-213,4445,0,0,,4658,4232
42,10/19/2017,6,1:15,1:30,34.21,,0,34.21,34.21,1,-77512,38852,116364,-38660,0,0,11150,0,0,,11150,11150
42,10/19/2017,7,1:30,1:45,31.07,,0,31.07,31.07,1,-83742,36847,120589,-46895,0,0,1189,0,0,,1189,1189
42,10/19/2017,8,1:45,2:00,,,0,31.11,31.11,0,-104113,50574,154687,-53539,0,0,0,0,0,,0,0
42,10/19/2017,9,2:00,2:15,44.22,,0,44.22,44.22,1,-68715,26085,94800,-42630,0,0,7712,0,0,,7712,7712
42,10/19/2017,10,2:15,2:30,36.74,,0,36.74,36.74,1,-73967,26493,100460,-47474,0,0,14474,0,0,,14474,14474
42,10/19/2017,11,2:30,2:45,36.74,,0,36.74,36.74,1,-77045,23265,100310,-53780,0,0,1984,0,0,,1984,1984
42,10/19/2017,12,2:45,3:00,31.19,,0,31.19,31.19,1,-68588,23512,92100,-45076,0,0,1564,0,0,,1564,1564
42,10/19/2017,13,3:00,3:15,150.93,,0,150.93,150.93,1,-85239,34388,119627,-50851,0,0,21742,0,0,,21742,21742
42,10/19/2017,14,3:15,3:30,45.55,,0,45.55,45.55,1,-65011,33897,98908,-31114,0,0,27530,0,0,,27530,27530
42,10/19/2017,15,3:30,3:45,42.74,,0,42.74,42.74,1,-80519,31098,111617,-49421,0,0,12576,0,0,,12576,12576
42,10/19/2017,16,3:45,4:00,36.74,,0,36.74,36.74,1,-73729,27909,101638,-45820,0,0,16404,0,0,,16404,16404
42,10/19/2017,17,4:00,4:15,350.02,,0,350.02,350.02,1,-123021,29228,152249,-93793,0,0,17639,0,0,,17639,17639
42,10/19/2017,18,4:15,4:30,45.02,,0,45.02,45.02,1,-98633,27264,125897,-71369,0,0,18342,0,0,,18342,18342
42,10/19/2017,19,4:30,4:45,30.83,,0,30.83,30.83,1,-97984,24356,122340,-73628,0,0,20,0,0,,20,20
42,10/19/2017,20,4:45,5:00,32.7,,0,32.7,32.7,1,-100751,54864,155615,-45887,0,0,608,0,0,,608,608
42,10/19/2017,21,5:00,5:15,31,,0,31,31,1,-85378,40590,125968,-44788,0,0,959,0,0,,959,959
42,10/19/2017,22,5:15,5:30,,,0,31.11,31.11,0,-85828,38120,123948,-47708,0,0,0,0,0,,0,0
42,10/19/2017,23,5:30,5:45,31.07,,0,31.07,31.07,1,-104383,26932,131315,-77451,0,0,141,0,0,,141,141
42,10/19/2017,24,5:45,6:00,44.33,,0,44.33,44.33,1,-131033,23270,154303,-107763,0,0,4736,0,0,,4736,4736
42,10/19/2017,25,6:00,6:15,,,0,40.34,40.34,0,-81899,75503,157402,-6396,0,0,1266,0,0,,1266,1266
42,10/19/2017,26,6:15,6:30,53.71,,0,53.71,53.71,1,-67699,32450,100149,-35249,0,0,1818,0,0,,1818,1818
42,10/19/2017,27,6:30,6:45,467.93,,0,467.93,467.93,1,-88582,27893,116475,-60689,0,0,18497,0,0,,18497,18497
42,10/19/2017,28,6:45,7:00,467.93,49.79,0,467.93,40.34,2,-90909,47756,138665,-43153,0,-2,54427,0,0,,54429,54425
42,10/19/2017,29,7:00,7:15,467.93,-28.47,0,-28.47,-28.47,-1,-27649,126315,153964,98666,0,-20951,4518,0,0,,25469,-16433
42,10/19/2017,30,7:15,7:30,39.85,-28.47,0,39.85,39.85,1,-67730,56339,124069,-11391,0,-157,2639,0,0,,2796,2482
42,10/19/2017,31,7:30,7:45,102.36,,0,102.36,102.36,1,-92976,41259,134235,-51717,0,0,28181,0,0,,28181,28181
42,10/19/2017,32,7:45,8:00,73.66,,0,73.66,73.66,1,-115789,47353,163142,-68436,0,0,33290,0,0,,33290,33290
42,10/19/2017,33,8:00,8:15,73.66,23.73,0,23.73,23.73,-1,-64606,77004,141610,12398,0,-2767,9809,0,0,,12576,7042
42,10/19/2017,34,8:15,8:30,,,0,40.33,40.33,0,-60364,63255,123619,2891,0,0,0,0,0,,0,0
42,10/19/2017,35,8:30,8:45,,28.73,0,28.73,28.73,-1,-55088,56062,111150,974,0,-766,0,0,0,,766,-766
42,10/19/2017,36,8:45,9:00,,,0,40.33,40.33,0,-71614,54802,126416,-16812,0,-1,0,0,0,,1,-1
42,10/19/2017,37,9:00,9:15,241.37,,0,241.37,241.37,1,-84078,42445,126523,-41633,0,0,15640,0,0,,15640,15640
42,10/19/2017,38,9:15,9:30,37.68,49.86,0,49.86,49.86,-1,-65468,53411,118879,-12057,0,-5,7958,0,0,,7963,7953
42,10/19/2017,39,9:30,9:45,,27.73,0,27.73,27.73,-1,-43321,57195,100516,13874,0,-2082,0,0,0,,2082,-2082
42,10/19/2017,40,9:45,10:00,,27.73,0,27.73,27.73,-1,-50671,51388,102059,717,0,-3737,0,0,0,,3737,-3737
42,10/19/2017,41,10:00,10:15,119.02,27.73,0,119.02,119.02,1,-63452,49637,113089,-13815,0,-13,10840,0,0,,10853,10827
42,10/19/2017,42,10:15,10:30,,,0,40.37,40.37,0,-45002,61523,106525,16521,0,0,1502,0,0,,1502,1502
42,10/19/2017,43,10:30,10:45,32.14,,0,32.14,32.14,1,-62252,62665,124917,413,0,0,271,0,0,,271,271
42,10/19/2017,44,10:45,11:00,30.8,,0,30.8,30.8,1,-56889,51361,108250,-5528,0,0,300,0,0,,300,300
42,10/19/2017,45,11:00,11:15,36.97,,0,36.97,36.97,1,-81057,50013,131070,-31044,0,0,1466,0,0,,1466,1466
42,10/19/2017,46,11:15,11:30,,,0,40.38,40.38,0,-98772,60261,159033,-38511,0,0,0,0,0,,0,0
42,10/19/2017,47,11:30,11:45,30.81,,0,30.81,30.81,1,-92421,64097,156518,-28324,0,0,90,0,0,,90,90
42,10/19/2017,48,11:45,12:00,,,0,40.38,40.38,0,-78783,66575,145358,-12208,0,0,0,0,0,,0,0
42,10/19/2017,49,12:00,12:15,31.29,,0,31.29,31.29,1,-76851,72086,148937,-4765,0,0,662,0,0,,662,662
42,10/19/2017,50,12:15,12:30,,,0,40.45,40.45,0,-69103,64373,133476,-4730,0,0,41,0,0,,41,41
42,10/19/2017,51,12:30,12:45,,29.44,0,29.44,29.44,-1,-46964,74489,121453,27525,0,-2515,0,0,0,,2515,-2515
42,10/19/2017,52,12:45,13:00,,26.4,0,26.4,26.4,-1,-38483,80734,119217,42251,0,-18387,0,0,0,,18387,-18387
42,10/19/2017,53,13:00,13:15,,25.03,0,25.03,25.03,-1,-50524,81919,132443,31395,0,-13306,0,0,0,,13306,-13306
42,10/19/2017,54,13:15,13:30,,11.82,0,11.82,11.82,-1,-39210,78390,117600,39180,0,-8025,0,0,0,,8025,-8025
42,10/19/2017,55,13:30,13:45,,6.78,0,6.78,6.78,-1,-22253,67975,90228,45722,0,-30510,0,0,0,,30510,-30510
42,10/19/2017,56,13:45,14:00,,23.73,0,23.73,23.73,-1,-31765,75604,107369,43839,0,-32858,0,0,0,,32858,-32858
42,10/19/2017,57,14:00,14:15,36.97,28.73,0,36.97,36.97,1,-55220,54704,109924,-516,0,-15007,799,0,0,,15806,-14208
42,10/19/2017,58,14:15,14:30,,,0,31.11,31.11,0,-57640,55241,112881,-2399,0,-27,48,0,0,,75,21
42,10/19/2017,59,14:30,14:45,,31.4,0,31.4,31.4,-1,-76401,53470,129871,-22931,0,-42,0,0,0,,42,-42
42,10/19/2017,60,14:45,15:00,,,0,31.11,31.11,0,-85298,44889,130187,-40409,0,0,0,0,0,,0,0
42,10/19/2017,61,15:00,15:15,,,0,31.11,31.11,0,-92375,44906,137281,-47469,0,0,0,0,0,,0,0
42,10/19/2017,62,15:15,15:30,31.29,,0,31.29,31.29,1,-91784,53388,145172,-38396,0,0,593,0,0,,593,593
42,10/19/2017,63,15:30,15:45,32.34,,0,32.34,32.34,1,-102545,60599,163144,-41946,0,0,1793,0,0,,1793,1793
42,10/19/2017,64,15:45,16:00,36.97,,0,36.97,36.97,1,-119857,65148,185005,-54709,0,0,2625,0,0,,2625,2625
42,10/19/2017,65,16:00,16:15,30.75,,0,30.75,30.75,1,-95385,89206,184591,-6179,0,0,307,0,0,,307,307
42,10/19/2017,66,16:15,16:30,31.34,,0,31.34,31.34,1,-73549,79801,153350,6252,0,0,468,0,0,,468,468
42,10/19/2017,67,16:30,16:45,,,0,31.11,31.11,0,-68119,95419,163538,27300,0,0,0,0,0,,0,0
42,10/19/2017,68,16:45,17:00,,,0,31.11,31.11,0,-79385,107221,186606,27836,0,0,0,0,0,,0,0
42,10/19/2017,69,17:00,17:15,,,0,31.11,31.11,0,-65200,66217,131417,1017,0,0,0,0,0,,0,0
42,10/19/2017,70,17:15,17:30,33.99,,0,33.99,33.99,1,-84857,66748,151605,-18109,0,0,1352,0,0,,1352,1352
42,10/19/2017,71,17:30,17:45,,,0,31.11,31.11,0,-55830,82609,138439,26779,0,0,123,0,0,,123,123
42,10/19/2017,72,17:45,18:00,,,0,31.11,31.11,0,-39053,107560,146613,68507,0,0,0,0,0,,0,0
42,10/19/2017,73,18:00,18:15,,13.73,0,13.73,13.73,-1,-35392,66634,102026,31242,0,-17489,0,0,0,,17489,-17489
42,10/19/2017,74,18:15,18:30,,24.8,0,24.8,24.8,-1,-31300,93719,125019,62419,0,-29419,0,0,0,,29419,-29419
42,10/19/2017,75,18:30,18:45,,23.73,0,23.73,23.73,-1,-37619,125684,163303,88065,0,-29750,0,0,0,,29750,-29750
42,10/19/2017,76,18:45,19:00,36.97,23.73,0,36.97,36.97,1,-79430,99836,179266,20406,0,-8697,334,0,0,,9031,-8363
42,10/19/2017,77,19:00,19:15,34.72,,0,34.72,34.72,1,-81787,55446,137233,-26341,0,0,3894,0,0,,3894,3894
42,10/19/2017,78,19:15,19:30,31.2,,0,31.2,31.2,1,-68972,66964,135936,-2008,0,0,1266,0,0,,1266,1266
42,10/19/2017,79,19:30,19:45,,19.73,0,19.73,19.73,-1,-60957,85329,146286,24372,0,-4139,0,0,0,,4139,-4139
42,10/19/2017,80,19:45,20:00,,10.08,0,10.08,10.08,-1,-54421,77940,132361,23519,0,-38902,0,0,0,,38902,-38902
42,10/19/2017,81,20:00,20:15,44,10.08,0,44,44,1,-77402,36719,114121,-40683,0,-7968,1693,0,0,,9661,-6275
42,10/19/2017,82,20:15,20:30,,,0,31.11,31.11,0,-57639,46963,104602,-10676,0,0,0,0,0,,0,0
42,10/19/2017,83,20:30,20:45,,27.62,0,27.62,27.62,-1,-39168,47074,86242,7906,0,-7194,0,0,0,,7194,-7194
42,10/19/2017,84,20:45,21:00,,28.73,0,28.73,28.73,-1,-49986,48627,98613,-1359,0,-10047,0,0,0,,10047,-10047
42,10/19/2017,85,21:00,21:15,106.02,23.73,0,106.02,23.73,2,-57182,58985,116167,1803,0,-11442,5131,0,0,,16573,-6311
42,10/19/2017,86,21:15,21:30,30.73,23.73,0,30.73,30.73,1,-46401,34728,81129,-11673,0,-177,2213,0,0,,2390,2036
42,10/19/2017,87,21:30,21:45,,27.31,0,27.31,27.31,-1,-21442,41127,62569,19685,0,-3923,0,0,0,,3923,-3923
42,10/19/2017,88,21:45,22:00,,27.73,0,27.73,27.73,-1,-53904,67242,121146,13338,0,-12675,0,0,0,,12675,-12675
42,10/19/2017,89,22:00,22:15,29.86,28.03,0,29.86,29.86,1,-57411,53602,111013,-3809,0,-5130,84,0,0,,5214,-5046
42,10/19/2017,90,22:15,22:30,29.86,28.03,0,29.86,29.86,1,-56650,12172,68822,-44478,0,-13,386,0,0,,399,373
42,10/19/2017,91,22:30,22:45,34.73,,0,34.73,34.73,1,-42297,23532,65829,-18765,0,0,936,0,0,,936,936
42,10/19/2017,92,22:45,23:00,,27.73,0,27.73,27.73,-1,-58365,41905,100270,-16460,0,-300,0,0,0,,300,-300
42,10/19/2017,93,23:00,23:15,41.33,23.68,0,41.33,23.68,2,-49171,69042,118213,19871,0,-4547,1175,0,0,,5722,-3372
42,10/19/2017,94,23:15,23:30,70.73,29.03,0,70.73,29.03,2,-38912,29610,68522,-9302,0,-143,18688,0,0,,18831,18545
42,10/19/2017,95,23:30,23:45,29.88,25.7,0,30.64,25.7,2,-34290,44371,78661,10081,0,-692,425,0,0,,1117,-267
42,10/19/2017,96,23:45,0:00,32.85,23.68,0,32.85,23.68,2,-59531,72759,132290,13228,0,-8323,93,0,0,,8416,-8230
42,10/20/2017,1,0:00,0:15,74.23,23.68,0,74.23,74.23,1,-87929,24015,111944,-63914,0,-596,24269,0,0,,24865,23673
42,10/20/2017,2,0:15,0:30,50.12,,0,50.12,50.12,1,-69122,21881,91003,-47241,0,0,45027,0,0,,45027,45027
42,10/20/2017,3,0:30,0:45,34.29,,0,34.29,34.29,1,-43380,30436,73816,-12944,0,0,16633,0,0,,16633,16633
42,10/20/2017,4,0:45,1:00,,32.98,0,32.98,32.98,-1,-50855,43198,94053,-7657,0,-18,0,0,0,,18,-18
42,10/20/2017,5,1:00,1:15,53.94,,0,53.94,53.94,1,-106184,31025,137209,-75159,0,0,11315,0,0,,11315,11315
42,10/20/2017,6,1:15,1:30,39.98,,0,39.98,39.98,1,-89569,40176,129745,-49393,0,0,30941,0,0,,30941,30941
42,10/20/2017,7,1:30,1:45,31.11,,0,31.11,31.11,1,-74768,40120,114888,-34648,0,0,12044,0,0,,12044,12044
42,10/20/2017,8,1:45,2:00,30.68,,0,30.68,30.68,1,-80063,51906,131969,-28157,0,0,142,0,0,,142,142
42,10/20/2017,9,2:00,2:15,70.62,,0,70.62,70.62,1,-117530,51599,169129,-65931,0,0,15984,0,0,,15984,15984
42,10/20/2017,10,2:15,2:30,46.69,,0,46.69,46.69,1,-85596,45864,131460,-39732,0,0,30017,0,0,,30017,30017
42,10/20/2017,11,2:30,2:45,34.32,,0,34.32,34.32,1,-70735,55742,126477,-14993,0,0,9927,0,0,,9927,9927
42,10/20/2017,12,2:45,3:00,34.32,21.23,0,21.23,21.23,-1,-50239,66094,116333,15855,0,-7680,628,0,0,,8308,-7052
42,10/20/2017,13,3:00,3:15,35.36,15,0,35.36,35.36,1,-49969,66478,116447,16509,0,-12518,708,0,0,,13226,-11810
42,10/20/2017,14,3:15,3:30,,28.98,0,28.98,28.98,-1,-43847,67913,111760,24066,0,-3271,0,0,0,,3271,-3271
42,10/20/2017,15,3:30,3:45,,28.83,0,28.83,28.83,-1,-41710,59214,100924,17504,0,-6933,0,0,0,,6933,-6933
42,10/20/2017,16,3:45,4:00,,24.79,0,24.79,24.79,-1,-36481,70583,107064,34102,0,-10772,0,0,0,,10772,-10772
42,10/20/2017,17,4:00,4:15,33.59,31.47,0,33.59,31.47,2,-61084,47419,108503,-13665,0,-6362,399,0,0,,6761,-5963
42,10/20/2017,18,4:15,4:30,,,0,32.35,32.35,0,-46881,54371,101252,7490,0,0,0,0,0,,0,0
42,10/20/2017,19,4:30,4:45,32.15,,0,32.15,32.15,1,-37164,56171,93335,19007,0,0,785,0,0,,785,785
42,10/20/2017,20,4:45,5:00,30.7,,0,30.7,30.7,1,-36947,95924,132871,58977,0,0,47,0,0,,47,47
42,10/20/2017,21,5:00,5:15,,28.25,0,28.25,28.25,-1,-47931,109798,157729,61867,0,-3029,0,0,0,,3029,-3029
42,10/20/2017,22,5:15,5:30,,33.98,0,33.98,33.98,-1,-35255,87824,123079,52569,0,-601,0,0,0,,601,-601
42,10/20/2017,23,5:30,5:45,,33.98,0,33.98,33.98,-1,-49820,70933,120753,21113,0,-541,0,0,0,,541,-541
42,10/20/2017,24,5:45,6:00,35.98,32.98,0,35.98,32.37,2,-53619,45793,99412,-7826,0,-14,502,0,0,,516,488
42,10/20/2017,25,6:00,6:15,,-53.37,0,-53.37,-53.37,-1,-44217,97175,141392,52958,0,-34087,0,0,0,,34087,-34087
42,10/20/2017,26,6:15,6:30,,15.96,0,15.96,15.96,-1,-72520,103410,175930,30890,0,-18970,0,0,0,,18970,-18970
42,10/20/2017,27,6:30,6:45,,6.61,0,6.61,6.61,-1,-60319,83223,143542,22904,0,-25681,0,0,0,,25681,-25681
42,10/20/2017,28,6:45,7:00,,-27.04,0,-27.04,-27.04,-1,-82577,101273,183850,18696,0,-13055,0,0,0,,13055,-13055
42,10/20/2017,29,7:00,7:15,,-55.59,0,-55.59,-55.59,-1,-36137,105984,142121,69847,0,-49316,0,0,0,,49316,-49316
42,10/20/2017,30,7:15,7:30,,14.03,0,14.03,14.03,-1,-58086,124735,182821,66649,0,-45307,0,0,0,,45307,-45307
42,10/20/2017,31,7:30,7:45,35.27,28.27,0,35.27,35.27,1,-57370,71841,129211,14471,0,-28917,111,0,0,,29028,-28806
42,10/20/2017,32,7:45,8:00,53.5,28.27,0,53.5,53.5,1,-106648,56539,163187,-50109,0,-3473,8999,0,0,,12472,5526
42,10/20/2017,33,8:00,8:15,57.28,,0,57.28,57.28,1,-92128,66487,158615,-25641,0,0,4700,0,0,,4700,4700
42,10/20/2017,34,8:15,8:30,57.28,,0,57.28,57.28,1,-89263,60363,149626,-28900,0,0,8708,0,0,,8708,8708
42,10/20/2017,35,8:30,8:45,33.69,,0,33.69,33.69,1,-73257,60523,133780,-12734,0,0,2405,0,0,,2405,2405
42,10/20/2017,36,8:45,9:00,35.77,,0,35.77,35.77,1,-88537,56491,145028,-32046,0,0,5769,0,0,,5769,5769
42,10/20/2017,37,9:00,9:15,35.77,30.19,0,30.19,30.19,-1,-54549,75178,129727,20629,0,-178,1205,0,0,,1383,1027
42,10/20/2017,38,9:15,9:30,,,0,31.16,31.16,0,-53829,73333,127162,19504,0,-133,0,0,0,,133,-133
42,10/20/2017,39,9:30,9:45,,,0,31.16,31.16,0,-52902,38760,91662,-14142,0,0,0,0,0,,0,0
42,10/20/2017,40,9:45,10:00,35.27,,0,35.27,35.27,1,-82430,30521,112951,-51909,0,0,3649,0,0,,3649,3649
42,10/20/2017,41,10:00,10:15,71.06,,0,71.06,71.06,1,-56228,28929,85157,-27299,0,0,10960,0,0,,10960,10960
42,10/20/2017,42,10:15,10:30,71.06,28.27,0,28.27,28.27,-1,-29386,52431,81817,23045,0,-2718,832,0,0,,3550,-1886
42,10/20/2017,43,10:30,10:45,,18.1,0,18.1,18.1,-1,-33171,64811,97982,31640,0,-1999,0,0,0,,1999,-1999
42,10/20/2017,44,10:45,11:00,,6.52,0,6.52,6.52,-1,-34560,99306,133866,64746,0,-30696,0,0,0,,30696,-30696
42,10/20/2017,45,11:00,11:15,,3.07,0,3.07,3.07,-1,-51789,84270,136059,32481,0,-16219,0,0,0,,16219,-16219
42,10/20/2017,46,11:15,11:30,31.27,-14.91,0,31.27,-14.91,2,-65160,88553,153713,23393,0,-31376,17,0,0,,31393,-31359
42,10/20/2017,47,11:30,11:45,31.27,16.23,0,31.27,16.23,2,-74119,105548,179667,31429,0,-7709,94,0,0,,7803,-7615
42,10/20/2017,48,11:45,12:00,,9.78,0,9.78,9.78,-1,-77420,108237,185657,30817,0,-39608,0,0,0,,39608,-39608
42,10/20/2017,49,12:00,12:15,35.27,9.78,0,35.27,35.27,1,-100745,69571,170316,-31174,0,-7863,1078,0,0,,8941,-6785
42,10/20/2017,50,12:15,12:30,,,0,31.13,31.13,0,-95700,81890,177590,-13810,0,0,0,0,0,,0,0
42,10/20/2017,51,12:30,12:45,,30.04,0,30.04,30.04,-1,-88096,89572,177668,1476,0,-285,0,0,0,,285,-285
42,10/20/2017,52,12:45,13:00,,28.27,0,28.27,28.27,-1,-82016,94410,176426,12394,0,-3392,0,0,0,,3392,-3392
42,10/20/2017,53,13:00,13:15,,28.27,0,28.27,28.27,-1,-73592,58181,131773,-15411,0,-6159,0,0,0,,6159,-6159
42,10/20/2017,54,13:15,13:30,,,0,31.18,31.18,0,-81669,47871,129540,-33798,0,-11,0,0,0,,11,-11
42,10/20/2017,55,13:30,13:45,,,0,31.18,31.18,0,-79950,45615,125565,-34335,0,0,0,0,0,,0,0
42,10/20/2017,56,13:45,14:00,,,0,31.18,31.18,0,-71749,54805,126554,-16944,0,0,0,0,0,,0,0
42,10/20/2017,57,14:00,14:15,32.85,,0,32.85,32.85,1,-62170,47449,109619,-14721,0,0,645,0,0,,645,645
42,10/20/2017,58,14:15,14:30,35.27,,0,35.27,35.27,1,-65547,38764,104311,-26783,0,0,2497,0,0,,2497,2497
42,10/20/2017,59,14:30,14:45,41.27,,0,41.27,41.27,1,-81398,32770,114168,-48628,0,0,15766,0,0,,15766,15766
42,10/20/2017,60,14:45,15:00,33.87,,0,33.87,33.87,1,-70522,46853,117375,-23669,0,0,10663,0,0,,10663,10663
42,10/20/2017,61,15:00,15:15,30.95,,0,30.95,30.95,1,-74426,57977,132403,-16449,0,0,56,0,0,,56,56
42,10/20/2017,62,15:15,15:30,30.96,,0,30.96,30.96,1,-63507,52994,116501,-10513,0,0,517,0,0,,517,517
42,10/20/2017,63,15:30,15:45,,,0,30.78,30.78,0,-65325,45822,111147,-19503,0,0,0,0,0,,0,0
42,10/20/2017,64,15:45,16:00,,,0,30.78,30.78,0,-76738,49902,126640,-26836,0,0,0,0,0,,0,0
42,10/20/2017,65,16:00,16:15,,29.8,0,29.8,29.8,-1,-73161,63557,136718,-9604,0,-173,0,0,0,,173,-173
42,10/20/2017,66,16:15,16:30,,28.27,0,28.27,28.27,-1,-51158,60338,111496,9180,0,-7861,0,0,0,,7861,-7861
42,10/20/2017,67,16:30,16:45,,29.27,0,29.27,29.27,-1,-45226,58704,103930,13478,0,-5214,0,0,0,,5214,-5214
42,10/20/2017,68,16:45,17:00,,28.27,0,28.27,28.27,-1,-52385,63425,115810,11040,0,-5629,0,0,0,,5629,-5629
42,10/20/2017,69,17:00,17:15,,24.02,0,24.02,24.02,-1,-58872,59839,118711,967,0,-23390,0,0,0,,23390,-23390
42,10/20/2017,70,17:15,17:30,32.03,28.27,0,32.03,28.27,2,-64573,49648,114221,-14925,0,-14793,232,0,0,,15025,-14561
42,10/20/2017,71,17:30,17:45,35.27,28.27,0,35.27,35.27,1,-69928,51085,121013,-18843,0,-836,5195,0,0,,6031,4359
42,10/20/2017,72,17:45,18:00,32.03,24.02,0,24.02,24.02,-1,-70316,81951,152267,11635,0,-1846,2645,0,0,,4491,799
42,10/20/2017,73,18:00,18:15,32.03,-1.53,0,-1.53,-1.53,-1,-60421,79378,139799,18957,0,-33192,9,0,0,,33201,-33183
42,10/20/2017,74,18:15,18:30,,17.06,0,17.06,17.06,-1,-50329,94136,144465,43807,0,-16147,0,0,0,,16147,-16147
42,10/20/2017,75,18:30,18:45,,24.27,0,24.27,24.27,-1,-61757,110971,172728,49214,0,-38004,0,0,0,,38004,-38004
42,10/20/2017,76,18:45,19:00,,26.52,0,26.52,26.52,-1,-61185,92446,153631,31261,0,-31441,0,0,0,,31441,-31441
42,10/20/2017,77,19:00,19:15,,3.69,0,3.69,3.69,-1,-61943,89772,151715,27829,0,-9907,0,0,0,,9907,-9907
42,10/20/2017,78,19:15,19:30,33.38,-11.3,0,33.38,-11.3,2,-103613,71152,174765,-32461,0,-22888,295,0,0,,23183,-22593
42,10/20/2017,79,19:30,19:45,33.38,28.27,0,28.27,28.27,-1,-98192,91527,189719,-6665,0,-521,17,0,0,,538,-504
42,10/20/2017,80,19:45,20:00,,-6.24,0,-6.24,-6.24,-1,-85263,104523,189786,19260,0,-23960,0,0,0,,23960,-23960
42,10/20/2017,81,20:00,20:15,31.39,-6.24,0,31.39,31.39,1,-94637,73752,168389,-20885,0,-942,973,0,0,,1915,31
42,10/20/2017,82,20:15,20:30,30.89,,0,30.89,30.89,1,-112796,90270,203066,-22526,0,0,303,0,0,,303,303
42,10/20/2017,83,20:30,20:45,,24.27,0,24.27,24.27,-1,-102678,111299,213977,8621,0,-7822,0,0,0,,7822,-7822
42,10/20/2017,84,20:45,21:00,,28.27,0,28.27,28.27,-1,-142217,121487,263704,-20730,0,-12787,0,0,0,,12787,-12787
42,10/20/2017,85,21:00,21:15,31.27,17.54,0,31.27,17.54,2,-68557,88931,157488,20374,0,-6876,127,0,0,,7003,-6749
42,10/20/2017,86,21:15,21:30,30.89,17.54,0,30.89,30.89,1,-121474,100069,221543,-21405,0,-507,105,0,0,,612,-402
42,10/20/2017,87,21:30,21:45,35.27,,0,35.27,35.27,1,-145695,109374,255069,-36321,0,0,3596,0,0,,3596,3596
42,10/20/2017,88,21:45,22:00,,,0,30.85,30.85,0,-153371,114880,268251,-38491,0,0,60,0,0,,60,60
42,10/20/2017,89,22:00,22:15,40.09,,0,40.09,40.09,1,-152081,64007,216088,-88074,0,0,3967,0,0,,3967,3967
42,10/20/2017,90,22:15,22:30,31.29,,0,31.29,31.29,1,-138907,60386,199293,-78521,0,0,3192,0,0,,3192,3192
42,10/20/2017,91,22:30,22:45,35.27,,0,35.27,35.27,1,-134860,98342,233202,-36518,0,0,2658,0,0,,2658,2658
42,10/20/2017,92,22:45,23:00,37.26,30.9,0,37.26,30.88,2,-127801,118225,246026,-9576,0,-2,6180,0,0,,6182,6178
42,10/20/2017,93,23:00,23:15,205.53,30.82,0,205.53,205.53,1,-151670,72141,223811,-79529,0,-8,17287,0,0,,17295,17279
42,10/20/2017,94,23:15,23:30,378.67,31.47,0,378.67,31.18,2,-114065,72311,186376,-41754,0,-1,65708,0,0,,65709,65707
42,10/20/2017,95,23:30,23:45,36.68,-1.26,0,36.68,-1.26,2,-104582,98401,202983,-6181,0,-6600,7183,0,0,,13783,583
42,10/20/2017,96,23:45,0:00,37.97,-1.26,0,37.97,37.97,1,-123879,91286,215165,-32593,0,-6,2937,0,0,,2943,2931
43,10/21/2017,1,0:00,0:15,31.02,34.38,0,34.38,34.38,-1,-52426,52789,105215,363,0,-388,873,0,0,,1261,485
43,10/21/2017,2,0:15,0:30,,34.38,0,34.38,34.38,-1,-60817,49842,110659,-10975,0,-167,0,0,0,,167,-167
43,10/21/2017,3,0:30,0:45,36.61,,0,36.61,36.61,1,-94454,52508,146962,-41946,0,0,1637,0,0,,1637,1637
43,10/21/2017,4,0:45,1:00,,29.38,0,29.38,29.38,-1,-86794,69662,156456,-17132,0,-449,0,0,0,,449,-449
43,10/21/2017,5,1:00,1:15,43.41,27.03,0,43.41,27.03,2,-69494,59268,128762,-10226,0,-2962,1461,0,0,,4423,-1501
43,10/21/2017,6,1:15,1:30,72.26,,0,72.26,72.26,1,-106816,31555,138371,-75261,0,0,17865,0,0,,17865,17865
43,10/21/2017,7,1:30,1:45,142,,0,142,142,1,-162457,22082,184539,-140375,0,0,36593,0,0,,36593,36593
43,10/21/2017,8,1:45,2:00,167.86,,0,167.86,167.86,1,-202258,53570,255828,-148688,0,0,81723,0,0,,81723,81723
43,10/21/2017,9,2:00,2:15,30.48,4.74,0,31.7,4.74,2,-53402,102544,155946,49142,0,-3127,22618,0,0,,25745,19491
43,10/21/2017,10,2:15,2:30,36.38,4.74,0,36.38,36.38,1,-44132,49157,93289,5025,0,-2,798,0,0,,800,796
43,10/21/2017,11,2:30,2:45,,,0,32.2,32.2,0,-34327,49477,83804,15150,0,0,0,0,0,,0,0
43,10/21/2017,12,2:45,3:00,,23.26,0,23.26,23.26,-1,-53937,51976,105913,-1961,0,-1040,0,0,0,,1040,-1040
43,10/21/2017,13,3:00,3:15,,13.03,0,13.03,13.03,-1,-33869,120947,154816,87078,0,-2475,0,0,0,,2475,-2475
43,10/21/2017,14,3:15,3:30,,,0,31.7,31.7,0,-37316,64067,101383,26751,0,0,0,0,0,,0,0
43,10/21/2017,15,3:30,3:45,,,0,31.7,31.7,0,-31980,74547,106527,42567,0,0,0,0,0,,0,0
43,10/21/2017,16,3:45,4:00,,,0,31.7,31.7,0,-31397,72196,103593,40799,0,0,0,0,0,,0,0
43,10/21/2017,17,4:00,4:15,,,0,31.7,31.7,0,-37742,78237,115979,40495,0,0,0,0,0,,0,0
43,10/21/2017,18,4:15,4:30,30.41,,0,30.41,30.41,1,-68088,70544,138632,2456,0,0,295,0,0,,295,295
43,10/21/2017,19,4:30,4:45,32.98,,0,32.98,32.98,1,-68669,72983,141652,4314,0,0,514,0,0,,514,514
43,10/21/2017,20,4:45,5:00,,,0,31.7,31.7,0,-70231,91928,162159,21697,0,0,9,0,0,,9,9
43,10/21/2017,21,5:00,5:15,,29.27,0,29.27,29.27,-1,-45608,62286,107894,16678,0,-1452,0,0,0,,1452,-1452
43,10/21/2017,22,5:15,5:30,,33.38,0,33.38,33.38,-1,-53759,81612,135371,27853,0,-956,0,0,0,,956,-956
43,10/21/2017,23,5:30,5:45,,,0,32.2,32.2,0,-59940,85466,145406,25526,0,-28,0,0,0,,28,-28
43,10/21/2017,24,5:45,6:00,,,0,32.2,32.2,0,-55355,109107,164462,53752,0,0,0,0,0,,0,0
43,10/21/2017,25,6:00,6:15,,33.69,0,33.69,33.69,-1,-88255,67643,155898,-20612,0,-2,0,0,0,,2,-2
43,10/21/2017,26,6:15,6:30,,18.65,0,18.65,18.65,-1,-38706,79963,118669,41257,0,-12090,0,0,0,,12090,-12090
43,10/21/2017,27,6:30,6:45,,16.16,0,16.16,16.16,-1,-37505,86034,123539,48529,0,-25662,0,0,0,,25662,-25662
43,10/21/2017,28,6:45,7:00,,29.67,0,29.67,29.67,-1,-78090,137561,215651,59471,0,-2795,0,0,0,,2795,-2795
43,10/21/2017,29,7:00,7:15,,,0,32.06,32.06,0,-109368,62540,171908,-46828,0,0,0,0,0,,0,0
43,10/21/2017,30,7:15,7:30,,29.03,0,29.03,29.03,-1,-61553,78235,139788,16682,0,-1402,0,0,0,,1402,-1402
43,10/21/2017,31,7:30,7:45,36.21,32.69,0,36.21,32.04,2,-63224,56181,119405,-7043,0,-680,76,0,0,,756,-604
43,10/21/2017,32,7:45,8:00,45.69,,0,45.69,45.69,1,-75145,78317,153462,3172,0,0,6030,0,0,,6030,6030
43,10/21/2017,33,8:00,8:15,45.69,30.24,0,30.24,30.24,-1,-59558,177316,236874,117758,0,-2017,3,0,0,,2020,-2014
43,10/21/2017,34,8:15,8:30,,33.69,0,33.69,33.69,-1,-61558,174773,236331,113215,0,-33,0,0,0,,33,-33
43,10/21/2017,35,8:30,8:45,,,0,32.1,32.1,0,-82317,150073,232390,67756,0,0,0,0,0,,0,0
43,10/21/2017,36,8:45,9:00,,,0,32.13,32.13,0,-109535,148705,258240,39170,0,0,0,0,0,,0,0
43,10/21/2017,37,9:00,9:15,,,0,32,32,0,-60794,155373,216167,94579,0,0,0,0,0,,0,0
43,10/21/2017,38,9:15,9:30,,30.36,0,30.36,30.36,-1,-78807,136009,214816,57202,0,-267,0,0,0,,267,-267
43,10/21/2017,39,9:30,9:45,,32.69,0,32.69,32.69,-1,-75849,138100,213949,62251,0,-590,0,0,0,,590,-590
43,10/21/2017,40,9:45,10:00,,33.69,0,33.69,33.69,-1,-94453,132922,227375,38469,0,-168,0,0,0,,168,-168
43,10/21/2017,41,10:00,10:15,,,0,32.05,32.05,0,-83496,94479,177975,10983,0,0,0,0,0,,0,0
43,10/21/2017,42,10:15,10:30,,,0,32.05,32.05,0,-80990,91180,172170,10190,0,0,0,0,0,,0,0
43,10/21/2017,43,10:30,10:45,,,0,32.05,32.05,0,-76578,88885,165463,12307,0,0,0,0,0,,0,0
43,10/21/2017,44,10:45,11:00,,32.69,0,32.69,32.69,-1,-82037,96758,178795,14721,0,-31,0,0,0,,31,-31
43,10/21/2017,45,11:00,11:15,,30.21,0,30.21,30.21,-1,-85779,89856,175635,4077,0,-1062,0,0,0,,1062,-1062
43,10/21/2017,46,11:15,11:30,,32.69,0,32.69,32.69,-1,-89486,100437,189923,10951,0,-668,0,0,0,,668,-668
43,10/21/2017,47,11:30,11:45,,17.45,0,17.45,17.45,-1,-78652,118477,197129,39825,0,-20475,0,0,0,,20475,-20475
43,10/21/2017,48,11:45,12:00,,22.39,0,22.39,22.39,-1,-80770,115737,196507,34967,0,-25274,0,0,0,,25274,-25274
43,10/21/2017,49,12:00,12:15,39.69,29.03,0,39.69,29.03,2,-79896,73422,153318,-6474,0,-14200,1675,0,0,,15875,-12525
43,10/21/2017,50,12:15,12:30,39.69,-9.59,0,-9.59,-9.59,-1,-45484,104651,150135,59167,0,-34528,133,0,0,,34661,-34395
43,10/21/2017,51,12:30,12:45,,5.4,0,5.4,5.4,-1,-49129,111234,160363,62105,0,-41091,0,0,0,,41091,-41091
43,10/21/2017,52,12:45,13:00,,-43.16,0,-43.16,-43.16,-1,-50980,108668,159648,57688,0,-59925,0,0,0,,59925,-59925
43,10/21/2017,53,13:00,13:15,,26.02,0,26.02,26.02,-1,-55292,100877,156169,45585,0,-27610,0,0,0,,27610,-27610
43,10/21/2017,54,13:15,13:30,,6.94,0,6.94,6.94,-1,-58736,108313,167049,49577,0,-31524,0,0,0,,31524,-31524
43,10/21/2017,55,13:30,13:45,33.96,-68.98,0,33.96,-68.98,2,-70926,93120,164046,22194,0,-47288,235,0,0,,47523,-47053
43,10/21/2017,56,13:45,14:00,35.69,-68.98,0,35.69,-68.98,2,-46286,126722,173008,80436,0,-21565,575,0,0,,22140,-20990
43,10/21/2017,57,14:00,14:15,,-8.22,0,-8.22,-8.22,-1,-66686,124889,191575,58203,0,-37886,0,0,0,,37886,-37886
43,10/21/2017,58,14:15,14:30,,-3.17,0,-3.17,-3.17,-1,-53857,139712,193569,85855,0,-44730,0,0,0,,44730,-44730
43,10/21/2017,59,14:30,14:45,,11.96,0,11.96,11.96,-1,-57502,133055,190557,75553,0,-44358,0,0,0,,44358,-44358
43,10/21/2017,60,14:45,15:00,,-9.5,0,-9.5,-9.5,-1,-65452,129451,194903,63999,0,-59103,0,0,0,,59103,-59103
43,10/21/2017,61,15:00,15:15,,17,0,17,17,-1,-77673,109550,187223,31877,0,-16987,0,0,0,,16987,-16987
43,10/21/2017,62,15:15,15:30,,-43.21,0,-43.21,-43.21,-1,-63143,97998,161141,34855,0,-31051,0,0,0,,31051,-31051
43,10/21/2017,63,15:30,15:45,,17,0,17,17,-1,-62426,103887,166313,41461,0,-17213,0,0,0,,17213,-17213
43,10/21/2017,64,15:45,16:00,,28.69,0,28.69,28.69,-1,-70735,105841,176576,35106,0,-24615,0,0,0,,24615,-24615
43,10/21/2017,65,16:00,16:15,,28.69,0,28.69,28.69,-1,-50557,146744,197301,96187,0,-18345,0,0,0,,18345,-18345
43,10/21/2017,66,16:15,16:30,,,0,32.05,32.05,0,-43376,96042,139418,52666,0,-3366,0,0,0,,3366,-3366
43,10/21/2017,67,16:30,16:45,34.05,,0,34.05,34.05,1,-68035,69598,137633,1563,0,0,447,0,0,,447,447
43,10/21/2017,68,16:45,17:00,58.77,,0,58.77,58.77,1,-73452,37531,110983,-35921,0,0,15460,0,0,,15460,15460
43,10/21/2017,69,17:00,17:15,35.69,30.16,0,35.69,30.16,2,-56016,76479,132495,20463,0,-628,9897,0,0,,10525,9269
43,10/21/2017,70,17:15,17:30,,,0,32.05,32.05,0,-56781,64000,120781,7219,0,0,0,0,0,,0,0
43,10/21/2017,71,17:30,17:45,51.69,,0,51.69,51.69,1,-60822,42491,103313,-18331,0,0,6246,0,0,,6246,6246
43,10/21/2017,72,17:45,18:00,39.69,,0,39.69,39.69,1,-67591,52132,119723,-15459,0,0,13783,0,0,,13783,13783
43,10/21/2017,73,18:00,18:15,39.69,30.47,0,30.47,30.47,-1,-45760,81992,127752,36232,0,-370,3973,0,0,,4343,3603
43,10/21/2017,74,18:15,18:30,,,0,32.05,32.05,0,-42237,67958,110195,25721,0,0,0,0,0,,0,0
43,10/21/2017,75,18:30,18:45,,30.19,0,30.19,30.19,-1,-68088,82140,150228,14052,0,-493,0,0,0,,493,-493
43,10/21/2017,76,18:45,19:00,178.89,,0,178.89,178.89,1,-109632,73418,183050,-36214,0,0,12618,0,0,,12618,12618
43,10/21/2017,77,19:00,19:15,205.37,29.05,0,205.37,29.05,2,-97108,82065,179173,-15043,0,-125,14334,0,0,,14459,14209
43,10/21/2017,78,19:15,19:30,,6.97,0,6.97,6.97,-1,-44242,81740,125982,37498,0,-16784,0,0,0,,16784,-16784
43,10/21/2017,79,19:30,19:45,35.69,32.69,0,35.69,32.1,2,-61590,53814,115404,-7776,0,-6121,648,0,0,,6769,-5473
43,10/21/2017,80,19:45,20:00,,33.69,0,33.69,33.69,-1,-82351,55980,138331,-26371,0,-18,0,0,0,,18,-18
43,10/21/2017,81,20:00,20:15,323.22,,0,323.22,323.22,1,-148026,60966,208992,-87060,0,0,18684,0,0,,18684,18684
43,10/21/2017,82,20:15,20:30,,,0,32.09,32.09,0,-109988,63627,173615,-46361,0,0,5510,0,0,,5510,5510
43,10/21/2017,83,20:30,20:45,,28.69,0,28.69,28.69,-1,-60488,72024,132512,11536,0,-1390,0,0,0,,1390,-1390
43,10/21/2017,84,20:45,21:00,30.36,28.69,0,32.03,28.69,2,-74369,42201,116570,-32168,0,-6417,15,0,0,,6432,-6402
43,10/21/2017,85,21:00,21:15,,32.69,0,32.69,32.69,-1,-84184,101205,185389,17021,0,-668,0,0,0,,668,-668
43,10/21/2017,86,21:15,21:30,,,0,32.09,32.09,0,-69749,59418,129167,-10331,0,0,0,0,0,,0,0
43,10/21/2017,87,21:30,21:45,,29.78,0,29.78,29.78,-1,-62875,47757,110632,-15118,0,-370,0,0,0,,370,-370
43,10/21/2017,88,21:45,22:00,,28.69,0,28.69,28.69,-1,-77580,51476,129056,-26104,0,-4246,0,0,0,,4246,-4246
43,10/21/2017,89,22:00,22:15,49.49,33.69,0,49.49,31.86,2,-66500,56955,123455,-9545,0,-131,4373,0,0,,4504,4242
43,10/21/2017,90,22:15,22:30,35.69,28.69,0,28.69,28.69,-1,-46480,40850,87330,-5630,0,-503,6563,0,0,,7066,6060
43,10/21/2017,91,22:30,22:45,,13.6,0,13.6,13.6,-1,-36108,61418,97526,25310,0,-13730,0,0,0,,13730,-13730
43,10/21/2017,92,22:45,23:00,,5.51,0,5.51,5.51,-1,-58747,81169,139916,22422,0,-32542,0,0,0,,32542,-32542
43,10/21/2017,93,23:00,23:15,,27.29,0,27.29,27.29,-1,-84518,98359,182877,13841,0,-12027,0,0,0,,12027,-12027
43,10/21/2017,94,23:15,23:30,,26.89,0,26.89,26.89,-1,-38994,51351,90345,12357,0,-1148,0,0,0,,1148,-1148
43,10/21/2017,95,23:30,23:45,,-16.03,0,-16.03,-16.03,-1,-29481,68360,97841,38879,0,-37879,0,0,0,,37879,-37879
43,10/21/2017,96,23:45,0:00,,26.44,0,26.44,26.44,-1,-35341,83020,118361,47679,0,-31398,0,0,0,,31398,-31398
43,10/22/2017,1,0:00,0:15,40.65,33.69,0,40.65,31.91,2,-88553,60508,149061,-28045,0,-6000,1824,0,0,,7824,-4176
43,10/22/2017,2,0:15,0:30,33.19,,0,33.19,33.19,1,-41770,35536,77306,-6234,0,0,2218,0,0,,2218,2218
43,10/22/2017,3,0:30,0:45,33.19,28.69,0,28.69,28.69,-1,-31038,45976,77014,14938,0,-320,92,0,0,,412,-228
43,10/22/2017,4,0:45,1:00,,-70,0,-70,-70,-1,-12752,56063,68815,43311,0,-33558,0,0,0,,33558,-33558
43,10/22/2017,5,1:00,1:15,34.46,-70,0,34.46,34.46,1,-58785,51273,110058,-7512,0,-7100,401,0,0,,7501,-6699
43,10/22/2017,6,1:15,1:30,,-71.66,0,-71.66,-71.66,-1,-18829,55711,74540,36882,0,-10877,0,0,0,,10877,-10877
43,10/22/2017,7,1:30,1:45,42.84,-71.66,0,42.84,-71.66,2,-58015,56946,114961,-1069,0,-22858,1445,0,0,,24303,-21413
43,10/22/2017,8,1:45,2:00,,-8.78,0,-8.78,-8.78,-1,-30445,71571,102016,41126,0,-32478,0,0,0,,32478,-32478
43,10/22/2017,9,2:00,2:15,54.11,-8.78,0,54.11,54.11,1,-56690,33587,90277,-23103,0,-10146,6006,0,0,,16152,-4140
43,10/22/2017,10,2:15,2:30,39.69,33.69,0,39.69,31.91,2,-42730,32387,75117,-10343,0,-9,15568,0,0,,15577,15559
43,10/22/2017,11,2:30,2:45,39.69,32.69,0,32.69,32.69,-1,-25202,29545,54747,4343,0,-1255,2813,0,0,,4068,1558
43,10/22/2017,12,2:45,3:00,,27.97,0,27.97,27.97,-1,-18207,36848,55055,18641,0,-7606,0,0,0,,7606,-7606
43,10/22/2017,13,3:00,3:15,35.69,27.95,0,35.69,27.95,2,-22757,31633,54390,8876,0,-8348,1122,0,0,,9470,-7226
43,10/22/2017,14,3:15,3:30,35.69,21.37,0,21.37,21.37,-1,-21884,44505,66389,22621,0,-10349,21,0,0,,10370,-10328
43,10/22/2017,15,3:30,3:45,,21.71,0,21.71,21.71,-1,-19764,45371,65135,25607,0,-33118,0,0,0,,33118,-33118
43,10/22/2017,16,3:45,4:00,,27.95,0,27.95,27.95,-1,-28690,39531,68221,10841,0,-25218,0,0,0,,25218,-25218
43,10/22/2017,17,4:00,4:15,,26.14,0,26.14,26.14,-1,-21751,35458,57209,13707,0,-22250,0,0,0,,22250,-22250
43,10/22/2017,18,4:15,4:30,,25.37,0,25.37,25.37,-1,-23203,44034,67237,20831,0,-26602,0,0,0,,26602,-26602
43,10/22/2017,19,4:30,4:45,,,0,31.91,31.91,0,-28110,29128,57238,1018,0,-6253,0,0,0,,6253,-6253
43,10/22/2017,20,4:45,5:00,,26.63,0,26.63,26.63,-1,-25856,38228,64084,12372,0,-3790,0,0,0,,3790,-3790
43,10/22/2017,21,5:00,5:15,,-73.83,0,-73.83,-73.83,-1,-24778,50800,75578,26022,0,-22132,0,0,0,,22132,-22132
43,10/22/2017,22,5:15,5:30,30.78,25.9,0,31.91,25.9,2,-25968,31373,57341,5405,0,-6244,38,0,0,,6282,-6206
43,10/22/2017,23,5:30,5:45,,25.72,0,25.72,25.72,-1,-35771,23626,59397,-12145,0,-7833,0,0,0,,7833,-7833
43,10/22/2017,24,5:45,6:00,,,0,31.91,31.91,0,-63669,19076,82745,-44593,0,0,0,0,0,,0,0
43,10/22/2017,25,6:00,6:15,30.54,,0,30.54,30.54,1,-51901,38524,90425,-13377,0,0,45,0,0,,45,45
43,10/22/2017,26,6:15,6:30,,,0,31.97,31.97,0,-60781,30331,91112,-30450,0,0,0,0,0,,0,0
43,10/22/2017,27,6:30,6:45,56.94,,0,56.94,56.94,1,-93312,26303,119615,-67009,0,0,15537,0,0,,15537,15537
43,10/22/2017,28,6:45,7:00,37.37,32.81,0,37.37,31.97,2,-90651,32464,123115,-58187,0,-7,16152,0,0,,16159,16145
43,10/22/2017,29,7:00,7:15,37.37,28.77,0,28.77,28.77,-1,-74993,48587,123580,-26406,0,-980,2128,0,0,,3108,1148
43,10/22/2017,30,7:15,7:30,,29.92,0,29.92,29.92,-1,-64175,47982,112157,-16193,0,-1564,0,0,0,,1564,-1564
43,10/22/2017,31,7:30,7:45,32.56,,0,32.56,32.56,1,-84330,51900,136230,-32430,0,0,74,0,0,,74,74
43,10/22/2017,32,7:45,8:00,39.81,,0,39.81,39.81,1,-91568,72249,163817,-19319,0,0,2466,0,0,,2466,2466
43,10/22/2017,33,8:00,8:15,32.5,,0,32.5,32.5,1,-59627,53194,112821,-6433,0,0,481,0,0,,481,481
43,10/22/2017,34,8:15,8:30,45.81,,0,45.81,45.81,1,-69991,48785,118776,-21206,0,0,10081,0,0,,10081,10081
43,10/22/2017,35,8:30,8:45,39.81,,0,39.81,39.81,1,-75719,40097,115816,-35622,0,0,27424,0,0,,27424,27424
43,10/22/2017,36,8:45,9:00,51.81,,0,51.81,51.81,1,-81818,50086,131904,-31732,0,0,31129,0,0,,31129,31129
43,10/22/2017,37,9:00,9:15,46.97,,0,46.97,46.97,1,-87314,40479,127793,-46835,0,0,16692,0,0,,16692,16692
43,10/22/2017,38,9:15,9:30,377.89,,0,377.89,377.89,1,-89795,34336,124131,-55459,0,0,28298,0,0,,28298,28298
43,10/22/2017,39,9:30,9:45,377.89,,0,377.89,377.89,1,-80865,46265,127130,-34600,0,0,39738,0,0,,39738,39738
43,10/22/2017,40,9:45,10:00,334.42,,0,334.42,334.42,1,-125505,68423,193928,-57082,0,0,25508,0,0,,25508,25508
43,10/22/2017,41,10:00,10:15,131.12,,0,131.12,131.12,1,-84968,26313,111281,-58655,0,0,49441,0,0,,49441,49441
43,10/22/2017,42,10:15,10:30,51.81,,0,51.81,51.81,1,-97389,51141,148530,-46248,0,0,19629,0,0,,19629,19629
43,10/22/2017,43,10:30,10:45,450,,0,450,450,1,-104441,28613,133054,-75828,0,0,41568,0,0,,41568,41568
43,10/22/2017,44,10:45,11:00,45.81,,0,45.81,45.81,1,-102117,89928,192045,-12189,0,0,22154,0,0,,22154,22154
43,10/22/2017,45,11:00,11:15,,25.52,0,25.52,25.52,-1,-65711,59532,125243,-6179,0,-2807,0,0,0,,2807,-2807
43,10/22/2017,46,11:15,11:30,47.33,25.52,0,47.33,47.33,1,-84045,40710,124755,-43335,0,-38,2808,0,0,,2846,2770
43,10/22/2017,47,11:30,11:45,60.12,,0,60.12,60.12,1,-85361,28564,113925,-56797,0,0,14643,0,0,,14643,14643
43,10/22/2017,48,11:45,12:00,39.81,33.81,0,39.81,32.18,2,-81629,40393,122022,-41236,0,-6,8136,0,0,,8142,8130
43,10/22/2017,49,12:00,12:15,39.81,29.95,0,29.95,29.95,-1,-56060,95822,151882,39762,0,-2440,265,0,0,,2705,-2175
43,10/22/2017,50,12:15,12:30,,6.35,0,6.35,6.35,-1,-42641,78524,121165,35883,0,-8187,0,0,0,,8187,-8187
43,10/22/2017,51,12:30,12:45,,6.34,0,6.34,6.34,-1,-53463,83759,137222,30296,0,-16689,0,0,0,,16689,-16689
43,10/22/2017,52,12:45,13:00,,-48.51,0,-48.51,-48.51,-1,-45421,105248,150669,59827,0,-38158,0,0,0,,38158,-38158
43,10/22/2017,53,13:00,13:15,,23.69,0,23.69,23.69,-1,-52744,96509,149253,43765,0,-20595,0,0,0,,20595,-20595
43,10/22/2017,54,13:15,13:30,,12.34,0,12.34,12.34,-1,-51162,95550,146712,44388,0,-33676,0,0,0,,33676,-33676
43,10/22/2017,55,13:30,13:45,,24.07,0,24.07,24.07,-1,-55826,84091,139917,28265,0,-26288,0,0,0,,26288,-26288
43,10/22/2017,56,13:45,14:00,,25.87,0,25.87,25.87,-1,-53802,77394,131196,23592,0,-18211,0,0,0,,18211,-18211
43,10/22/2017,57,14:00,14:15,,27.21,0,27.21,27.21,-1,-27932,113368,141300,85436,0,-13481,0,0,0,,13481,-13481
43,10/22/2017,58,14:15,14:30,,29.92,0,29.92,29.92,-1,-26355,109322,135677,82967,0,-9592,0,0,0,,9592,-9592
43,10/22/2017,59,14:30,14:45,450,29.92,0,450,450,1,-270764,136318,407082,-134446,0,-160,41919,0,0,,42079,41759
43,10/22/2017,60,14:45,15:00,339.04,29.43,0,29.43,29.43,-1,-270358,229740,500098,-40618,0,-72,48226,5000,0,,53298,53154
43,10/22/2017,61,15:00,15:15,339.04,27.78,0,27.78,27.78,-1,-276203,296995,573198,20792,0,-332,431,0,0,,763,99
43,10/22/2017,62,15:15,15:30,334.99,,0,334.99,334.99,1,-281483,228673,510156,-52810,0,0,14303,0,0,,14303,14303
43,10/22/2017,63,15:30,15:45,296.45,,0,296.45,296.45,1,-280649,256132,536781,-24517,0,0,24979,0,0,,24979,24979
43,10/22/2017,64,15:45,16:00,296.45,,0,296.45,296.45,1,-280199,211773,491972,-68426,0,0,24914,0,0,,24914,24914
43,10/22/2017,65,16:00,16:15,296.45,-69.68,0,-69.68,-69.68,-1,-127481,285372,412853,157891,0,-15814,8344,0,0,,24158,-7470
43,10/22/2017,66,16:15,16:30,,28.81,0,28.81,28.81,-1,-142377,210848,353225,68471,0,-7780,0,0,0,,7780,-7780
43,10/22/2017,67,16:30,16:45,,,0,31.97,31.97,0,-148317,182763,331080,34446,0,0,0,0,0,,0,0
43,10/22/2017,68,16:45,17:00,37.21,,0,37.21,37.21,1,-166243,196866,363109,30623,0,0,2304,0,0,,2304,2304
43,10/22/2017,69,17:00,17:15,226.7,,0,226.7,226.7,1,-242972,120892,363864,-122080,0,0,35060,0,0,,35060,35060
43,10/22/2017,70,17:15,17:30,450,,0,450,450,1,-186997,153967,340964,-33030,0,0,67877,0,0,,67877,67877
43,10/22/2017,71,17:30,17:45,35.81,21.15,0,35.81,21.15,2,-170175,187306,357481,17131,0,-1362,6321,0,0,,7683,4959
43,10/22/2017,72,17:45,18:00,84.12,,0,84.12,84.12,1,-204012,178210,382222,-25802,0,0,15989,0,0,,15989,15989
43,10/22/2017,73,18:00,18:15,35.81,30.23,0,35.81,30.23,2,-128535,135806,264341,7271,0,-1265,9310,0,0,,10575,8045
43,10/22/2017,74,18:15,18:30,35.81,30.23,0,35.81,35.81,1,-137847,132053,269900,-5794,0,-524,1246,0,0,,1770,722
43,10/22/2017,75,18:30,18:45,39.81,,0,39.81,39.81,1,-161372,156004,317376,-5368,0,0,1857,0,0,,1857,1857
43,10/22/2017,76,18:45,19:00,450,,0,450,450,1,-185278,127829,313107,-57449,0,0,37585,0,0,,37585,37585
43,10/22/2017,77,19:00,19:15,37.29,28.81,0,37.29,28.81,2,-161968,197167,359135,35199,0,-511,14524,0,0,,15035,14013
43,10/22/2017,78,19:15,19:30,,,0,32.18,32.18,0,-157246,187203,344449,29957,0,0,0,0,0,,0,0
43,10/22/2017,79,19:30,19:45,35.81,,0,35.81,35.81,1,-155965,152154,308119,-3811,0,0,304,0,0,,304,304
43,10/22/2017,80,19:45,20:00,30.93,,0,30.93,30.93,1,-167512,145576,313088,-21936,0,0,56,0,0,,56,56
43,10/22/2017,81,20:00,20:15,450,,0,450,450,1,-269495,114294,383789,-155201,0,0,25658,0,0,,25658,25658
43,10/22/2017,82,20:15,20:30,60.12,,0,60.12,60.12,1,-251264,154278,405542,-96986,0,0,35058,0,0,,35058,35058
43,10/22/2017,83,20:30,20:45,,,0,32.18,32.18,0,-241713,206190,447903,-35523,0,0,1798,0,0,,1798,1798
43,10/22/2017,84,20:45,21:00,,,0,32.16,32.16,0,-240371,185970,426341,-54401,0,0,0,0,0,,0,0
43,10/22/2017,85,21:00,21:15,169.39,,0,169.39,169.39,1,-183697,143331,327028,-40366,0,0,12525,0,0,,12525,12525
43,10/22/2017,86,21:15,21:30,45.81,,0,45.81,45.81,1,-187166,160366,347532,-26800,0,0,20858,0,0,,20858,20858
43,10/22/2017,87,21:30,21:45,30.54,29.95,0,29.95,29.95,-1,-154627,175265,329892,20638,0,-1044,8464,0,0,,9508,7420
43,10/22/2017,88,21:45,22:00,,-14.7,0,-14.7,-14.7,-1,-85962,150021,235983,64059,0,-28590,0,0,0,,28590,-28590
43,10/22/2017,89,22:00,22:15,297.7,-14.7,0,297.7,297.7,1,-149700,47249,196949,-102451,0,-4385,22832,0,0,,27217,18447
43,10/22/2017,90,22:15,22:30,297.7,,0,297.7,297.7,1,-135245,98846,234091,-36399,0,0,41305,0,0,,41305,41305
43,10/22/2017,91,22:30,22:45,35.81,32.81,0,35.81,32.21,2,-117345,122390,239735,5045,0,-18,3200,0,0,,3218,3182
43,10/22/2017,92,22:45,23:00,35.81,26.02,0,26.02,26.02,-1,-108418,144558,252976,36140,0,-10270,319,0,0,,10589,-9951
43,10/22/2017,93,23:00,23:15,,19.78,0,19.78,19.78,-1,-81139,125981,207120,44842,0,-11055,0,0,0,,11055,-11055
43,10/22/2017,94,23:15,23:30,,8.89,0,8.89,8.89,-1,-52897,99248,152145,46351,0,-4383,0,0,0,,4383,-4383
43,10/22/2017,95,23:30,23:45,,-11.78,0,-11.78,-11.78,-1,-37078,108975,146053,71897,0,-26150,0,0,0,,26150,-26150
43,10/22/2017,96,23:45,0:00,76.6,-68,0,76.6,-68,2,-42804,60481,103285,17677,0,-45014,2493,0,0,,47507,-42521
43,10/23/2017,1,0:00,0:15,208.92,-68,0,208.92,208.92,1,-176087,33696,209783,-142391,0,-628,50420,0,0,,51048,49792
43,10/23/2017,2,0:15,0:30,155.7,17.01,0,155.7,17.01,2,-96260,58508,154768,-37752,0,-296,59525,0,0,,59821,59229
43,10/23/2017,3,0:30,0:45,155.7,4.25,0,4.25,4.25,-1,-94374,80069,174443,-14305,0,-1830,1765,0,0,,3595,-65
43,10/23/2017,4,0:45,1:00,,32.81,0,32.81,32.81,-1,-91882,69659,161541,-22223,0,-600,0,0,0,,600,-600
43,10/23/2017,5,1:00,1:15,59.98,,0,59.98,59.98,1,-129092,63801,192893,-65291,0,0,16975,0,0,,16975,16975
43,10/23/2017,6,1:15,1:30,35.81,12.38,0,12.38,12.38,-1,-83700,93650,177350,9950,0,-5163,9360,0,0,,14523,4197
43,10/23/2017,7,1:30,1:45,,13.11,0,13.11,13.11,-1,-64911,83650,148561,18739,0,-24124,0,0,0,,24124,-24124
43,10/23/2017,8,1:45,2:00,,30.1,0,30.1,30.1,-1,-63194,60463,123657,-2731,0,-6297,0,0,0,,6297,-6297
43,10/23/2017,9,2:00,2:15,30.62,30.1,0,30.62,30.62,1,-93195,90045,183240,-3150,0,-308,5,0,0,,313,-303
43,10/23/2017,10,2:15,2:30,45.81,,0,45.81,45.81,1,-111284,92125,203409,-19159,0,0,9365,0,0,,9365,9365
43,10/23/2017,11,2:30,2:45,34.8,32.81,0,34.8,32.17,2,-104363,106205,210568,1842,0,-278,6690,0,0,,6968,6412
43,10/23/2017,12,2:45,3:00,35.81,,0,35.81,35.81,1,-94067,93629,187696,-438,0,0,157,0,0,,157,157
43,10/23/2017,13,3:00,3:15,45.33,,0,45.33,45.33,1,-104512,57724,162236,-46788,0,0,6160,0,0,,6160,6160
43,10/23/2017,14,3:15,3:30,35.81,,0,35.81,35.81,1,-104868,60644,165512,-44224,0,0,4643,0,0,,4643,4643
43,10/23/2017,15,3:30,3:45,35.81,,0,35.81,35.81,1,-106336,70535,176871,-35801,0,0,690,0,0,,690,690
43,10/23/2017,16,3:45,4:00,30.93,,0,30.93,30.93,1,-104587,77096,181683,-27491,0,0,533,0,0,,533,533
43,10/23/2017,17,4:00,4:15,39.81,,0,39.81,39.81,1,-113134,77803,190937,-35331,0,0,3918,0,0,,3918,3918
43,10/23/2017,18,4:15,4:30,30.62,,0,30.62,30.62,1,-68754,88385,157139,19631,0,0,1257,0,0,,1257,1257
43,10/23/2017,19,4:30,4:45,,,0,32.22,32.22,0,-63514,97918,161432,34404,0,0,0,0,0,,0,0
43,10/23/2017,20,4:45,5:00,,,0,32.19,32.19,0,-66662,94243,160905,27581,0,0,0,0,0,,0,0
43,10/23/2017,21,5:00,5:15,51.81,,0,51.81,51.81,1,-125333,93934,219267,-31399,0,0,8314,0,0,,8314,8314
43,10/23/2017,22,5:15,5:30,48.02,-10.32,0,-10.32,-10.32,-1,-69800,96763,166563,26963,0,-7666,9955,0,0,,17621,2289
43,10/23/2017,23,5:30,5:45,97.75,-26.04,0,97.75,-26.04,2,-101037,74746,175783,-26291,0,-18327,3172,0,0,,21499,-15155
43,10/23/2017,24,5:45,6:00,141.04,23.26,0,141.04,23.26,2,-122821,108888,231709,-13933,0,-2316,9831,0,0,,12147,7515
43,10/23/2017,25,6:00,6:15,35.81,7.34,0,7.34,7.34,-1,-167303,194671,361974,27368,0,-10132,186,0,0,,10318,-9946
43,10/23/2017,26,6:15,6:30,31.81,-8.33,0,32.2,-8.33,2,-135768,143612,279380,7844,0,-27934,33,0,0,,27967,-27901
43,10/23/2017,27,6:30,6:45,34.54,30.54,0,34.54,30.54,2,-137324,130612,267936,-6712,0,-1678,486,0,0,,2164,-1192
43,10/23/2017,28,6:45,7:00,,29.03,0,29.03,29.03,-1,-148292,150625,298917,2333,0,-2692,0,0,0,,2692,-2692
43,10/23/2017,29,7:00,7:15,,-58.93,0,-58.93,-58.93,-1,-28849,116634,145483,87785,0,-43914,0,0,0,,43914,-43914
43,10/23/2017,30,7:15,7:30,31.63,8.63,0,32.18,8.63,2,-56317,101470,157787,45153,0,-23823,28,0,0,,23851,-23795
43,10/23/2017,31,7:30,7:45,60.14,-3.36,0,60.14,-3.36,2,-102398,102690,205088,292,0,-30461,963,0,0,,31424,-29498
43,10/23/2017,32,7:45,8:00,333.58,18.81,0,333.58,18.81,2,-133180,131957,265137,-1223,0,-2005,15549,0,0,,17554,13544
43,10/23/2017,33,8:00,8:15,333.58,-2.91,0,-2.91,-2.91,-1,-100343,133810,234153,33467,0,-24083,3,0,0,,24086,-24080
43,10/23/2017,34,8:15,8:30,,28.81,0,28.81,28.81,-1,-150608,177360,327968,26752,0,-10396,0,0,0,,10396,-10396
43,10/23/2017,35,8:30,8:45,,29.24,0,29.24,29.24,-1,-138415,163844,302259,25429,0,-14849,0,0,0,,14849,-14849
43,10/23/2017,36,8:45,9:00,,28.81,0,28.81,28.81,-1,-122135,132442,254577,10307,0,-18587,0,0,0,,18587,-18587
43,10/23/2017,37,9:00,9:15,,-51.09,0,-51.09,-51.09,-1,-72699,150702,223401,78003,0,-47084,0,0,0,,47084,-47084
43,10/23/2017,38,9:15,9:30,,11.75,0,11.75,11.75,-1,-82936,128522,211458,45586,0,-25558,0,0,0,,25558,-25558
43,10/23/2017,39,9:30,9:45,,27.99,0,27.99,27.99,-1,-98095,111019,209114,12924,0,-19800,0,0,0,,19800,-19800
43,10/23/2017,40,9:45,10:00,,28.81,0,28.81,28.81,-1,-83644,110960,194604,27316,0,-14009,0,0,0,,14009,-14009
43,10/23/2017,41,10:00,10:15,,18.81,0,18.81,18.81,-1,-82662,131075,213737,48413,0,-32651,0,0,0,,32651,-32651
43,10/23/2017,42,10:15,10:30,,13.11,0,13.11,13.11,-1,-64148,105109,169257,40961,0,-51241,0,0,0,,51241,-51241
43,10/23/2017,43,10:30,10:45,,29.54,0,29.54,29.54,-1,-67005,97648,164653,30643,0,-18800,0,0,0,,18800,-18800
43,10/23/2017,44,10:45,11:00,,29.63,0,29.63,29.63,-1,-63776,88238,152014,24462,0,-5509,0,0,0,,5509,-5509
43,10/23/2017,45,11:00,11:15,,-0.07,0,-0.07,-0.07,-1,-95197,141377,236574,46180,0,-26120,0,0,0,,26120,-26120
43,10/23/2017,46,11:15,11:30,,20.93,0,20.93,20.93,-1,-107577,117196,224773,9619,0,-23221,0,0,0,,23221,-23221
43,10/23/2017,47,11:30,11:45,,8.44,0,8.44,8.44,-1,-90249,127504,217753,37255,0,-23892,0,0,0,,23892,-23892
43,10/23/2017,48,11:45,12:00,,28.81,0,28.81,28.81,-1,-99238,122626,221864,23388,0,-23285,0,0,0,,23285,-23285
43,10/23/2017,49,12:00,12:15,35.18,30.44,0,35.18,30.44,2,-112709,115184,227893,2475,0,-4221,924,0,0,,5145,-3297
43,10/23/2017,50,12:15,12:30,,18.02,0,18.02,18.02,-1,-81954,120348,202302,38394,0,-23322,0,0,0,,23322,-23322
43,10/23/2017,51,12:30,12:45,30.56,30.33,0,32.19,30.33,2,-79773,98270,178043,18497,0,-19009,5,0,0,,19014,-19004
43,10/23/2017,52,12:45,13:00,34.28,18.81,0,34.28,18.81,2,-84011,99495,183506,15484,0,-5978,1572,0,0,,7550,-4406
43,10/23/2017,53,13:00,13:15,31.4,-5.56,0,32.42,-5.56,2,-62110,106867,168977,44757,0,-43457,1,0,0,,43458,-43456
43,10/23/2017,54,13:15,13:30,37.99,28.81,0,37.99,28.81,2,-91756,105086,196842,13330,0,-4959,872,0,0,,5831,-4087
43,10/23/2017,55,13:30,13:45,,18.81,0,18.81,18.81,-1,-95910,122212,218122,26302,0,-24179,0,0,0,,24179,-24179
43,10/23/2017,56,13:45,14:00,,21.81,0,21.81,21.81,-1,-95097,127507,222604,32410,0,-7354,0,0,0,,7354,-7354
43,10/23/2017,57,14:00,14:15,,12.19,0,12.19,12.19,-1,-78817,127307,206124,48490,0,-41694,0,0,0,,41694,-41694
43,10/23/2017,58,14:15,14:30,,28.81,0,28.81,28.81,-1,-84149,108167,192316,24018,0,-18820,0,0,0,,18820,-18820
43,10/23/2017,59,14:30,14:45,,28.81,0,28.81,28.81,-1,-82252,104837,187089,22585,0,-19174,0,0,0,,19174,-19174
43,10/23/2017,60,14:45,15:00,32.49,32.62,0,32.49,32.33,2,-83676,84449,168125,773,0,-6400,478,0,0,,6878,-5922
43,10/23/2017,61,15:00,15:15,32.49,-5.56,0,-5.56,-5.56,-1,-81235,153943,235178,72708,0,-29687,17,0,0,,29704,-29670
43,10/23/2017,62,15:15,15:30,,28.81,0,28.81,28.81,-1,-71711,113331,185042,41620,0,-34079,0,0,0,,34079,-34079
43,10/23/2017,63,15:30,15:45,,29.03,0,29.03,29.03,-1,-74071,94971,169042,20900,0,-21910,0,0,0,,21910,-21910
43,10/23/2017,64,15:45,16:00,33.71,31.52,0,33.71,31.52,2,-74173,77185,151358,3012,0,-2248,321,0,0,,2569,-1927
43,10/23/2017,65,16:00,16:15,,6.13,0,6.13,6.13,-1,-56932,96648,153580,39716,0,-29296,0,0,0,,29296,-29296
43,10/23/2017,66,16:15,16:30,,30.03,0,30.03,30.03,-1,-70977,80931,151908,9954,0,-13245,0,0,0,,13245,-13245
43,10/23/2017,67,16:30,16:45,,33.81,0,33.81,33.81,-1,-72005,76837,148842,4832,0,-284,0,0,0,,284,-284
43,10/23/2017,68,16:45,17:00,49.33,,0,49.33,49.33,1,-88621,71447,160068,-17174,0,0,8771,0,0,,8771,8771
43,10/23/2017,69,17:00,17:15,35.02,-13.03,0,35.02,-13.03,2,-51705,93416,145121,41711,0,-19009,7727,0,0,,26736,-11282
43,10/23/2017,70,17:15,17:30,,28.81,0,28.81,28.81,-1,-56477,60774,117251,4297,0,-7130,0,0,0,,7130,-7130
43,10/23/2017,71,17:30,17:45,,33.81,0,33.81,33.81,-1,-58604,63810,122414,5206,0,-135,0,0,0,,135,-135
43,10/23/2017,72,17:45,18:00,30.85,33.81,0,32.33,32.33,2,-65211,74833,140044,9622,0,-48,53,0,0,,101,5
43,10/23/2017,73,18:00,18:15,33.05,32.81,0,33.05,32.33,2,-63007,48982,111989,-14025,0,-90,721,0,0,,811,631
43,10/23/2017,74,18:15,18:30,30.85,30.38,0,32.33,30.38,2,-67973,70926,138899,2953,0,-2261,33,0,0,,2294,-2228
43,10/23/2017,75,18:30,18:45,114.1,,0,114.1,114.1,1,-112487,78843,191330,-33644,0,0,4752,0,0,,4752,4752
43,10/23/2017,76,18:45,19:00,494.59,,0,494.59,494.59,1,-137871,85364,223235,-52507,0,0,48209,0,0,,48209,48209
43,10/23/2017,77,19:00,19:15,494.59,-25.64,0,-25.64,-25.64,-1,-57555,95494,153049,37939,0,-13121,6912,0,0,,20033,-6209
43,10/23/2017,78,19:15,19:30,30.85,33.81,0,32.33,32.33,2,-73233,75953,149186,2720,0,-403,27,0,0,,430,-376
43,10/23/2017,79,19:30,19:45,,32.81,0,32.81,32.81,-1,-74334,74681,149015,347,0,-2503,0,0,0,,2503,-2503
43,10/23/2017,80,19:45,20:00,,30.03,0,30.03,30.03,-1,-70971,85914,156885,14943,0,-4838,0,0,0,,4838,-4838
43,10/23/2017,81,20:00,20:15,359.62,32.81,0,359.62,359.62,1,-122751,60855,183606,-61896,0,-3189,16230,0,0,,19419,13041
43,10/23/2017,82,20:15,20:30,51.81,11.74,0,11.74,11.74,-1,-84177,95985,180162,11808,0,-4347,20838,0,0,,25185,16491
43,10/23/2017,83,20:30,20:45,31.47,12.16,0,32.33,12.16,2,-70480,77452,147932,6972,0,-18113,136,0,0,,18249,-17977
43,10/23/2017,84,20:45,21:00,38.16,32.81,0,38.16,32.33,2,-88341,88045,176386,-296,0,-312,633,0,0,,945,321
43,10/23/2017,85,21:00,21:15,385.17,,0,385.17,385.17,1,-129109,64422,193531,-64687,0,0,34061,0,0,,34061,34061
43,10/23/2017,86,21:15,21:30,38.16,28.81,0,28.81,28.81,-1,-77635,75800,153435,-1835,0,-794,16108,0,0,,16902,15314
43,10/23/2017,87,21:30,21:45,38.16,11.23,0,11.23,11.23,-1,-61344,93286,154630,31942,0,-24325,3,0,0,,24328,-24322
43,10/23/2017,88,21:45,22:00,,24.74,0,24.74,24.74,-1,-71843,105811,177654,33968,0,-30821,0,0,0,,30821,-30821
43,10/23/2017,89,22:00,22:15,38.16,28.14,0,38.16,38.16,1,-101836,86425,188261,-15411,0,-19455,1471,0,0,,20926,-17984
43,10/23/2017,90,22:15,22:30,38.16,26.34,0,26.34,26.34,-1,-72414,85369,157783,12955,0,-1300,474,0,0,,1774,-826
43,10/23/2017,91,22:30,22:45,,18.81,0,18.81,18.81,-1,-58516,103627,162143,45111,0,-11886,0,0,0,,11886,-11886
43,10/23/2017,92,22:45,23:00,,25.69,0,25.69,25.69,-1,-49712,113731,163443,64019,0,-24603,0,0,0,,24603,-24603
43,10/23/2017,93,23:00,23:15,276.18,18.54,0,276.18,276.18,1,-111178,41472,152650,-69706,0,-15850,10967,0,0,,26817,-4883
43,10/23/2017,94,23:15,23:30,276.18,32.81,0,32.81,32.81,-1,-72898,40526,113424,-32372,0,-14,12711,0,0,,12725,12697
43,10/23/2017,95,23:30,23:45,,,0,32.33,32.33,0,-52008,65602,117610,13594,0,0,0,0,0,,0,0
43,10/23/2017,96,23:45,0:00,,32.81,0,32.81,32.81,-1,-55226,82685,137911,27459,0,-28,0,0,0,,28,-28
43,10/24/2017,1,0:00,0:15,,10.29,0,10.29,10.29,-1,-38795,88584,127379,49789,0,-12209,0,0,0,,12209,-12209
43,10/24/2017,2,0:15,0:30,,28.26,0,28.26,28.26,-1,-38703,56794,95497,18091,0,-2130,0,0,0,,2130,-2130
43,10/24/2017,3,0:30,0:45,,24.26,0,24.26,24.26,-1,-40957,74193,115150,33236,0,-3123,0,0,0,,3123,-3123
43,10/24/2017,4,0:45,1:00,,11,0,11,11,-1,-47992,97043,145035,49051,0,-39423,0,0,0,,39423,-39423
43,10/24/2017,5,1:00,1:15,41.11,26.87,0,41.11,41.11,1,-42710,34891,77601,-7819,0,-22136,1729,0,0,,23865,-20407
43,10/24/2017,6,1:15,1:30,41.11,24.26,0,24.26,24.26,-1,-20262,40341,60603,20079,0,-5682,481,0,0,,6163,-5201
43,10/24/2017,7,1:30,1:45,,17.12,0,17.12,17.12,-1,-27052,49363,76415,22311,0,-21414,0,0,0,,21414,-21414
43,10/24/2017,8,1:45,2:00,,11.43,0,11.43,11.43,-1,-33227,85092,118319,51865,0,-35388,0,0,0,,35388,-35388
43,10/24/2017,9,2:00,2:15,,18.47,0,18.47,18.47,-1,-43520,80749,124269,37229,0,-41653,0,0,0,,41653,-41653
43,10/24/2017,10,2:15,2:30,,28.26,0,28.26,28.26,-1,-48283,74130,122413,25847,0,-18320,0,0,0,,18320,-18320
43,10/24/2017,11,2:30,2:45,,23.01,0,23.01,23.01,-1,-40941,78812,119753,37871,0,-30570,0,0,0,,30570,-30570
43,10/24/2017,12,2:45,3:00,,28.23,0,28.23,28.23,-1,-34853,72269,107122,37416,0,-30298,0,0,0,,30298,-30298
43,10/24/2017,13,3:00,3:15,31.1,28.26,0,31.1,31.1,1,-38809,36703,75512,-2106,0,-16428,206,0,0,,16634,-16222
43,10/24/2017,14,3:15,3:30,30.96,28.26,0,30.96,30.96,1,-40594,48528,89122,7934,0,-66,48,0,0,,114,-18
43,10/24/2017,15,3:30,3:45,,,0,30.56,30.56,0,-53835,52954,106789,-881,0,0,0,0,0,,0,0
43,10/24/2017,16,3:45,4:00,,20.67,0,20.67,20.67,-1,-36934,60191,97125,23257,0,-11704,0,0,0,,11704,-11704
43,10/24/2017,17,4:00,4:15,30.85,20.67,0,30.85,30.85,1,-81693,103037,184730,21344,0,-2657,485,0,0,,3142,-2172
43,10/24/2017,18,4:15,4:30,30.58,,0,30.58,30.58,1,-69029,106361,175390,37332,0,0,184,0,0,,184,184
43,10/24/2017,19,4:30,4:45,,32.55,0,32.55,32.55,-1,-57410,104486,161896,47076,0,-53,0,0,0,,53,-53
43,10/24/2017,20,4:45,5:00,,29.26,0,29.26,29.26,-1,-65845,111122,176967,45277,0,-661,0,0,0,,661,-661
43,10/24/2017,21,5:00,5:15,,24.26,0,24.26,24.26,-1,-54736,154546,209282,99810,0,-13101,0,0,0,,13101,-13101
43,10/24/2017,22,5:15,5:30,,24.99,0,24.99,24.99,-1,-49616,149354,198970,99738,0,-12713,0,0,0,,12713,-12713
43,10/24/2017,23,5:30,5:45,,29.26,0,29.26,29.26,-1,-63167,122078,185245,58911,0,-6683,0,0,0,,6683,-6683
43,10/24/2017,24,5:45,6:00,,21.62,0,21.62,21.62,-1,-58667,131674,190341,73007,0,-3830,0,0,0,,3830,-3830
43,10/24/2017,25,6:00,6:15,,24.5,0,24.5,24.5,-1,-102619,141978,244597,39359,0,-3072,0,0,0,,3072,-3072
43,10/24/2017,26,6:15,6:30,34.37,24.26,0,34.37,24.26,2,-80399,138674,219073,58275,0,-12281,63,0,0,,12344,-12218
43,10/24/2017,27,6:30,6:45,274.63,24.26,0,274.63,274.63,1,-104139,86046,190185,-18093,0,-1111,20698,0,0,,21809,19587
43,10/24/2017,28,6:45,7:00,350.68,,0,350.68,350.68,1,-137556,110506,248062,-27050,0,0,66063,0,0,,66063,66063
43,10/24/2017,29,7:00,7:15,350.68,-43.05,0,-43.05,-43.05,-1,-118515,328325,446840,209810,0,-39775,13707,0,0,,53482,-26068
43,10/24/2017,30,7:15,7:30,,30.81,0,30.81,30.81,-1,-143197,221725,364922,78528,0,-8220,0,0,0,,8220,-8220
43,10/24/2017,31,7:30,7:45,454.22,,0,454.22,454.22,1,-172425,155691,328116,-16734,0,0,8829,0,0,,8829,8829
43,10/24/2017,32,7:45,8:00,454.22,,0,454.22,454.22,1,-195877,113424,309301,-82453,0,0,71625,0,0,,71625,71625
43,10/24/2017,33,8:00,8:15,330.7,20.73,0,20.73,20.73,-1,-196559,231127,427686,34568,0,-731,54823,0,0,,55554,54092
43,10/24/2017,34,8:15,8:30,46.12,11.43,0,46.12,11.43,2,-174802,181568,356370,6766,0,-4449,2325,0,0,,6774,-2124
43,10/24/2017,35,8:30,8:45,422.27,,0,422.27,422.27,1,-217426,150645,368071,-66781,0,0,55575,0,0,,55575,55575
43,10/24/2017,36,8:45,9:00,108.12,,0,108.12,108.12,1,-217511,163769,381280,-53742,0,0,55626,0,0,,55626,55626
43,10/24/2017,37,9:00,9:15,121.16,,0,121.16,121.16,1,-200450,192770,393220,-7680,0,0,41833,0,0,,41833,41833
43,10/24/2017,38,9:15,9:30,252.25,,0,252.25,252.25,1,-208612,186835,395447,-21777,0,0,45672,0,0,,45672,45672
43,10/24/2017,39,9:30,9:45,411.28,,0,411.28,411.28,1,-227705,186137,413842,-41568,0,0,45578,0,0,,45578,45578
43,10/24/2017,40,9:45,10:00,411.28,,0,411.28,411.28,1,-241026,215178,456204,-25848,0,0,52225,0,0,,52225,52225
43,10/24/2017,41,10:00,10:15,34.44,,0,34.44,34.44,1,-188695,224306,413001,35611,0,0,5978,0,0,,5978,5978
43,10/24/2017,42,10:15,10:30,33.36,,0,33.36,33.36,1,-183477,186704,370181,3227,0,0,910,0,0,,910,910
43,10/24/2017,43,10:30,10:45,,,0,32.96,32.96,0,-179281,161628,340909,-17653,0,0,0,0,0,,0,0
43,10/24/2017,44,10:45,11:00,,,0,32.96,32.96,0,-179457,144666,324123,-34791,0,0,0,0,0,,0,0
43,10/24/2017,45,11:00,11:15,,,0,32.96,32.96,0,-129201,158074,287275,28873,0,0,0,0,0,,0,0
43,10/24/2017,46,11:15,11:30,,33.99,0,33.99,33.99,-1,-106648,150920,257568,44272,0,-176,0,0,0,,176,-176
43,10/24/2017,47,11:30,11:45,,34.99,0,34.99,34.99,-1,-91678,126051,217729,34373,0,-85,0,0,0,,85,-85
43,10/24/2017,48,11:45,12:00,,,0,32.96,32.96,0,-89950,118933,208883,28983,0,0,0,0,0,,0,0
43,10/24/2017,49,12:00,12:15,42.81,,0,42.81,42.81,1,-130027,78349,208376,-51678,0,0,3925,0,0,,3925,3925
43,10/24/2017,50,12:15,12:30,91.81,,0,91.81,91.81,1,-105116,71081,176197,-34035,0,0,19844,0,0,,19844,19844
43,10/24/2017,51,12:30,12:45,,,0,32.96,32.96,0,-73526,81710,155236,8184,0,0,496,0,0,,496,496
43,10/24/2017,52,12:45,13:00,,,0,32.96,32.96,0,-73783,87694,161477,13911,0,0,0,0,0,,0,0
43,10/24/2017,53,13:00,13:15,,,0,32.97,32.97,0,-127132,112692,239824,-14440,0,0,0,0,0,,0,0
43,10/24/2017,54,13:15,13:30,40.93,,0,40.93,40.93,1,-155281,96478,251759,-58803,0,0,2431,0,0,,2431,2431
43,10/24/2017,55,13:30,13:45,42.81,,0,42.81,42.81,1,-139955,87230,227185,-52725,0,0,13447,0,0,,13447,13447
43,10/24/2017,56,13:45,14:00,,,0,41.61,41.61,0,-134565,96598,231163,-37967,0,0,367,0,0,,367,367
43,10/24/2017,57,14:00,14:15,374.64,,0,374.64,374.64,1,-141113,91699,232812,-49414,0,0,18055,0,0,,18055,18055
43,10/24/2017,58,14:15,14:30,35.81,32.81,0,41.61,32.81,2,-83543,124667,208210,41124,0,-324,11480,0,0,,11804,11156
43,10/24/2017,59,14:30,14:45,,30.81,0,30.81,30.81,-1,-75177,133168,208345,57991,0,-3573,0,0,0,,3573,-3573
43,10/24/2017,60,14:45,15:00,,,0,41.61,41.61,0,-90300,132515,222815,42215,0,0,0,0,0,,0,0
43,10/24/2017,61,15:00,15:15,45,,0,45,45,1,-100815,115930,216745,15115,0,0,7262,0,0,,7262,7262
43,10/24/2017,62,15:15,15:30,45.81,,0,45.81,45.81,1,-108115,117363,225478,9248,0,0,20230,0,0,,20230,20230
43,10/24/2017,63,15:30,15:45,309.52,,0,309.52,309.52,1,-119057,123742,242799,4685,0,0,42821,0,0,,42821,42821
43,10/24/2017,64,15:45,16:00,39.81,33.81,0,33.81,33.81,-1,-106515,146527,253042,40012,0,-653,18847,0,0,,19500,18194
43,10/24/2017,65,16:00,16:15,39.81,32.45,0,32.45,32.45,-1,-81898,166838,248736,84940,0,-1553,12,0,0,,1565,-1541
43,10/24/2017,66,16:15,16:30,,22.06,0,22.06,22.06,-1,-72339,166312,238651,93973,0,-12723,0,0,0,,12723,-12723
43,10/24/2017,67,16:30,16:45,,28.81,0,28.81,28.81,-1,-58510,173348,231858,114838,0,-23456,0,0,0,,23456,-23456
43,10/24/2017,68,16:45,17:00,,21.95,0,21.95,21.95,-1,-70105,181420,251525,111315,0,-31947,0,0,0,,31947,-31947
43,10/24/2017,69,17:00,17:15,,19.44,0,19.44,19.44,-1,-56801,179554,236355,122753,0,-42681,0,0,0,,42681,-42681
43,10/24/2017,70,17:15,17:30,,30.44,0,30.44,30.44,-1,-63924,185172,249096,121248,0,-22428,0,0,0,,22428,-22428
43,10/24/2017,71,17:30,17:45,,,0,32.99,32.99,0,-56822,181574,238396,124752,0,-257,0,0,0,,257,-257
43,10/24/2017,72,17:45,18:00,,,0,33,33,0,-58031,204550,262581,146519,0,0,0,0,0,,0,0
43,10/24/2017,73,18:00,18:15,,16.72,0,16.72,16.72,-1,-42209,160440,202649,118231,0,-17166,0,0,0,,17166,-17166
43,10/24/2017,74,18:15,18:30,,28.81,0,28.81,28.81,-1,-40697,177277,217974,136580,0,-13314,0,0,0,,13314,-13314
43,10/24/2017,75,18:30,18:45,,,0,33,33,0,-56083,190021,246104,133938,0,0,0,0,0,,0,0
43,10/24/2017,76,18:45,19:00,,-54.53,0,-54.53,-54.53,-1,-49410,186394,235804,136984,0,-26311,0,0,0,,26311,-26311
43,10/24/2017,77,19:00,19:15,,21.07,0,21.07,21.07,-1,-42834,166857,209691,124023,0,-25726,0,0,0,,25726,-25726
43,10/24/2017,78,19:15,19:30,,11.66,0,11.66,11.66,-1,-25615,164888,190503,139273,0,-28371,0,0,0,,28371,-28371
43,10/24/2017,79,19:30,19:45,,1.05,0,1.05,1.05,-1,-24074,176255,200329,152181,0,-43181,0,0,0,,43181,-43181
43,10/24/2017,80,19:45,20:00,,-3.53,0,-3.53,-3.53,-1,-29181,183022,212203,153841,0,-74510,0,0,0,,74510,-74510
43,10/24/2017,81,20:00,20:15,,13.65,0,13.65,13.65,-1,-39388,145432,184820,106044,0,-38028,0,0,0,,38028,-38028
43,10/24/2017,82,20:15,20:30,,21.8,0,21.8,21.8,-1,-30397,139493,169890,109096,0,-6140,0,0,0,,6140,-6140
43,10/24/2017,83,20:30,20:45,,-10.3,0,-10.3,-10.3,-1,-29301,161290,190591,131989,0,-66755,0,0,0,,66755,-66755
43,10/24/2017,84,20:45,21:00,,21.8,0,21.8,21.8,-1,-40440,155134,195574,114694,0,-61863,0,0,0,,61863,-61863
43,10/24/2017,85,21:00,21:15,45.81,-1.78,0,45.81,-1.78,2,-49920,97526,147446,47606,0,-43611,721,0,0,,44332,-42890
43,10/24/2017,86,21:15,21:30,45.81,-1.78,0,45.81,45.81,1,-41955,86363,128318,44408,0,-859,1185,0,0,,2044,326
43,10/24/2017,87,21:30,21:45,,,0,32.56,32.56,0,-47639,127053,174692,79414,0,0,0,0,0,,0,0
43,10/24/2017,88,21:45,22:00,,30.33,0,30.33,30.33,-1,-75830,135439,211269,59609,0,-54,0,0,0,,54,-54
43,10/24/2017,89,22:00,22:15,,28.65,0,28.65,28.65,-1,-66780,92417,159197,25637,0,-130,0,0,0,,130,-130
43,10/24/2017,90,22:15,22:30,,,0,31.06,31.06,0,-65799,99159,164958,33360,0,0,0,0,0,,0,0
43,10/24/2017,91,22:30,22:45,,26.14,0,26.14,26.14,-1,-62696,104935,167631,42239,0,-2564,0,0,0,,2564,-2564
43,10/24/2017,92,22:45,23:00,,18.59,0,18.59,18.59,-1,-69276,128070,197346,58794,0,-26079,0,0,0,,26079,-26079
43,10/24/2017,93,23:00,23:15,92.8,23.65,0,92.8,92.8,1,-85482,62981,148463,-22501,0,-16549,5412,0,0,,21961,-11137
43,10/24/2017,94,23:15,23:30,127.84,23.65,0,127.84,127.84,1,-76581,32776,109357,-43805,0,-114,50386,0,0,,50500,50272
43,10/24/2017,95,23:30,23:45,127.84,-4.39,0,-4.39,-4.39,-1,-39018,69257,108275,30239,0,-21799,4948,0,0,,26747,-16851
43,10/24/2017,96,23:45,0:00,,11.43,0,11.43,11.43,-1,-47286,96351,143637,49065,0,-51151,0,0,0,,51151,-51151
43,10/25/2017,1,0:00,0:15,77.07,14.39,0,77.07,77.07,1,-81986,76701,158687,-5285,0,-33068,2131,0,0,,35199,-30937
43,10/25/2017,2,0:15,0:30,87.8,14.39,0,87.8,87.8,1,-56908,26771,83679,-30137,0,-292,15933,0,0,,16225,15641
43,10/25/2017,3,0:30,0:45,87.8,32.81,0,32.81,32.81,-1,-42315,42955,85270,640,0,-505,412,0,0,,917,-93
43,10/25/2017,4,0:45,1:00,,21.93,0,21.93,21.93,-1,-42932,73873,116805,30941,0,-22507,0,0,0,,22507,-22507
43,10/25/2017,5,1:00,1:15,39.18,27.03,0,39.18,39.18,1,-45950,25876,71826,-20074,0,-19957,1558,0,0,,21515,-18399
43,10/25/2017,6,1:15,1:30,,,0,31.92,31.92,0,-47054,25073,72127,-21981,0,-37,88,0,0,,125,51
43,10/25/2017,7,1:30,1:45,,,0,32.24,32.24,0,-45352,39171,84523,-6181,0,0,0,0,0,,0,0
43,10/25/2017,8,1:45,2:00,,29.9,0,29.9,29.9,-1,-41177,37363,78540,-3814,0,-807,0,0,0,,807,-807
43,10/25/2017,9,2:00,2:15,31.11,28.81,0,32.27,28.81,2,-50314,49581,99895,-733,0,-2019,299,0,0,,2318,-1720
43,10/25/2017,10,2:15,2:30,32.81,,0,32.81,32.81,1,-62159,35127,97286,-27032,0,0,593,0,0,,593,593
43,10/25/2017,11,2:30,2:45,40.09,,0,40.09,40.09,1,-65859,31378,97237,-34481,0,0,3365,0,0,,3365,3365
43,10/25/2017,12,2:45,3:00,40.09,29.9,0,29.9,29.9,-1,-46948,34243,81191,-12705,0,-387,172,0,0,,559,-215
43,10/25/2017,13,3:00,3:15,,28,0,28,28,-1,-56453,39924,96377,-16529,0,-1314,0,0,0,,1314,-1314
43,10/25/2017,14,3:15,3:30,,,0,30.72,30.72,0,-37673,26673,64346,-11000,0,0,0,0,0,,0,0
43,10/25/2017,15,3:30,3:45,,,0,30.73,30.73,0,-36971,20487,57458,-16484,0,0,0,0,0,,0,0
43,10/25/2017,16,3:45,4:00,,18.07,0,18.07,18.07,-1,-25076,46436,71512,21360,0,-9993,0,0,0,,9993,-9993
43,10/25/2017,17,4:00,4:15,33.85,17.87,0,33.85,33.85,1,-29974,27960,57934,-2014,0,-13793,437,0,0,,14230,-13356
43,10/25/2017,18,4:15,4:30,33.85,26.18,0,26.18,26.18,-1,-23998,45910,69908,21912,0,-3871,8,0,0,,3879,-3863
43,10/25/2017,19,4:30,4:45,,28,0,28,28,-1,-19826,53296,73122,33470,0,-7185,0,0,0,,7185,-7185
43,10/25/2017,20,4:45,5:00,,30.73,0,30.73,30.73,-1,-27539,51776,79315,24237,0,-631,0,0,0,,631,-631
43,10/25/2017,21,5:00,5:15,,24,0,24,24,-1,-40694,64433,105127,23739,0,-5617,0,0,0,,5617,-5617
43,10/25/2017,22,5:15,5:30,,28,0,28,28,-1,-30307,56669,86976,26362,0,-3839,0,0,0,,3839,-3839
43,10/25/2017,23,5:30,5:45,30.74,28,0,30.74,30.74,1,-27815,29997,57812,2182,0,-100,5,0,0,,105,-95
43,10/25/2017,24,5:45,6:00,31.37,29,0,31.37,29,2,-43481,60866,104347,17385,0,-8,349,0,0,,357,341
43,10/25/2017,25,6:00,6:15,,10.33,0,10.33,10.33,-1,-65176,112705,177881,47529,0,-27692,0,0,0,,27692,-27692
43,10/25/2017,26,6:15,6:30,,19.51,0,19.51,19.51,-1,-38004,95933,133937,57929,0,-40418,0,0,0,,40418,-40418
43,10/25/2017,27,6:30,6:45,41.59,16.81,0,41.59,41.59,1,-29954,51897,81851,21943,0,-30290,811,0,0,,31101,-29479
43,10/25/2017,28,6:45,7:00,45.42,18.06,0,45.42,18.06,2,-47373,102003,149376,54630,0,-7663,1807,0,0,,9470,-5856
43,10/25/2017,29,7:00,7:15,,32.42,0,32.42,32.42,-1,-123436,65480,188916,-57956,0,-4306,0,0,0,,4306,-4306
43,10/25/2017,30,7:15,7:30,,26.72,0,26.72,26.72,-1,-46706,80661,127367,33955,0,-2234,0,0,0,,2234,-2234
43,10/25/2017,31,7:30,7:45,45.41,26.72,0,45.41,45.41,1,-93276,55756,149032,-37520,0,-9,1200,0,0,,1209,1191
43,10/25/2017,32,7:45,8:00,405.24,,0,405.24,405.24,1,-151856,48751,200607,-103105,0,0,37754,0,0,,37754,37754
43,10/25/2017,33,8:00,8:15,405.24,-46.72,0,-46.72,-46.72,-1,-27854,70308,98162,42454,0,-14215,10706,0,0,,24921,-3509
43,10/25/2017,34,8:15,8:30,,26.21,0,26.21,26.21,-1,-58893,53865,112758,-5028,0,-18814,0,0,0,,18814,-18814
43,10/25/2017,35,8:30,8:45,,28.42,0,28.42,28.42,-1,-75740,55496,131236,-20244,0,-27438,0,0,0,,27438,-27438
43,10/25/2017,36,8:45,9:00,31.64,32.42,0,41.7,32.42,2,-100053,49788,149841,-50265,0,-3993,909,0,0,,4902,-3084
43,10/25/2017,37,9:00,9:15,31.64,28.42,0,28.42,28.42,-1,-66625,75915,142540,9290,0,-3287,7,0,0,,3294,-3280
43,10/25/2017,38,9:15,9:30,,30.72,0,30.72,30.72,-1,-91122,68800,159922,-22322,0,-943,0,0,0,,943,-943
43,10/25/2017,39,9:30,9:45,,26.03,0,26.03,26.03,-1,-90881,67174,158055,-23707,0,-18085,0,0,0,,18085,-18085
43,10/25/2017,40,9:45,10:00,,18.42,0,18.42,18.42,-1,-81895,69724,151619,-12171,0,-29201,0,0,0,,29201,-29201
43,10/25/2017,41,10:00,10:15,,29.27,0,29.27,29.27,-1,-62073,54112,116185,-7961,0,-12240,0,0,0,,12240,-12240
43,10/25/2017,42,10:15,10:30,,25.57,0,25.57,25.57,-1,-73117,61464,134581,-11653,0,-2804,0,0,0,,2804,-2804
43,10/25/2017,43,10:30,10:45,,18.42,0,18.42,18.42,-1,-81756,49571,131327,-32185,0,-16323,0,0,0,,16323,-16323
43,10/25/2017,44,10:45,11:00,,32.42,0,32.42,32.42,-1,-99101,37510,136611,-61591,0,-7616,0,0,0,,7616,-7616
43,10/25/2017,45,11:00,11:15,,28.42,0,28.42,28.42,-1,-97630,34193,131823,-63437,0,-2732,0,0,0,,2732,-2732
43,10/25/2017,46,11:15,11:30,31.09,,0,31.09,31.09,1,-127095,27954,155049,-99141,0,0,222,0,0,,222,222
43,10/25/2017,47,11:30,11:45,77.78,,0,77.78,77.78,1,-142804,29648,172452,-113156,0,0,22117,0,0,,22117,22117
43,10/25/2017,48,11:45,12:00,46.58,,0,46.58,46.58,1,-153334,39120,192454,-114214,0,0,29830,0,0,,29830,29830
43,10/25/2017,49,12:00,12:15,124.23,,0,124.23,124.23,1,-219216,53136,272352,-166080,0,0,58170,0,0,,58170,58170
43,10/25/2017,50,12:15,12:30,,,0,32.06,32.06,0,-228088,55545,283633,-172543,0,0,30198,0,0,,30198,30198
43,10/25/2017,51,12:30,12:45,124.23,,0,124.23,124.23,1,-217793,41269,259062,-176524,0,0,29038,0,0,,29038,29038
43,10/25/2017,52,12:45,13:00,39.11,,0,39.11,39.11,1,-178275,80049,258324,-98226,0,0,14720,0,0,,14720,14720
43,10/25/2017,53,13:00,13:15,,32.42,0,32.42,32.42,-1,-109850,86258,196108,-23592,0,-166,0,0,0,,166,-166
43,10/25/2017,54,13:15,13:30,35.77,,0,35.77,35.77,1,-135086,56375,191461,-78711,0,0,1750,0,0,,1750,1750
43,10/25/2017,55,13:30,13:45,51.42,,0,51.42,51.42,1,-158323,70314,228637,-88009,0,0,15879,0,0,,15879,15879
43,10/25/2017,56,13:45,14:00,43.66,,0,43.66,43.66,1,-171146,80162,251308,-90984,0,0,26942,0,0,,26942,26942
43,10/25/2017,57,14:00,14:15,43.66,18.42,0,18.42,18.42,-1,-90423,95408,185831,4985,0,-7602,4974,0,0,,12576,-2628
43,10/25/2017,58,14:15,14:30,,,0,32.84,32.84,0,-113578,74766,188344,-38812,0,-254,0,0,0,,254,-254
43,10/25/2017,59,14:30,14:45,32.94,,0,32.94,32.94,1,-128120,70599,198719,-57521,0,0,403,0,0,,403,403
43,10/25/2017,60,14:45,15:00,,34.99,0,34.99,34.99,-1,-115216,62988,178204,-52228,0,-246,0,0,0,,246,-246
43,10/25/2017,61,15:00,15:15,,32.42,0,32.42,32.42,-1,-134548,59802,194350,-74746,0,-504,0,0,0,,504,-504
43,10/25/2017,62,15:15,15:30,,,0,32.96,32.96,0,-139420,50618,190038,-88802,0,0,0,0,0,,0,0
43,10/25/2017,63,15:30,15:45,,,0,32.98,32.98,0,-147469,49455,196924,-98014,0,0,0,0,0,,0,0
43,10/25/2017,64,15:45,16:00,,,0,33,33,0,-139455,53144,192599,-86311,0,0,0,0,0,,0,0
43,10/25/2017,65,16:00,16:15,,-19.6,0,-19.6,-19.6,-1,-110047,114908,224955,4861,0,-26702,0,0,0,,26702,-26702
43,10/25/2017,66,16:15,16:30,,11.33,0,11.33,11.33,-1,-106065,59080,165145,-46985,0,-28881,0,0,0,,28881,-28881
43,10/25/2017,67,16:30,16:45,35.64,33.42,0,35.64,32.99,2,-95946,47635,143581,-48311,0,-667,4,0,0,,671,-663
43,10/25/2017,68,16:45,17:00,35.64,33.42,0,35.64,33.03,2,-113851,41885,155736,-71966,0,-485,368,0,0,,853,-117
43,10/25/2017,69,17:00,17:15,35.64,17.54,0,17.54,17.54,-1,-114889,68944,183833,-45945,0,-14608,249,0,0,,14857,-14359
43,10/25/2017,70,17:15,17:30,65.95,34.89,0,65.95,65.95,1,-138740,52991,191731,-85749,0,-2550,5367,0,0,,7917,2817
43,10/25/2017,71,17:30,17:45,35.64,32.42,0,35.64,32.42,2,-124745,58451,183196,-66294,0,-59,11711,0,0,,11770,11652
43,10/25/2017,72,17:45,18:00,35.64,30.19,0,30.19,30.19,-1,-117164,56333,173497,-60831,0,-1115,205,0,0,,1320,-910
43,10/25/2017,73,18:00,18:15,,-12.54,0,-12.54,-12.54,-1,-108805,104796,213601,-4009,0,-37673,0,0,0,,37673,-37673
43,10/25/2017,74,18:15,18:30,,-14.61,0,-14.61,-14.61,-1,-112401,70430,182831,-41971,0,-51933,0,0,0,,51933,-51933
43,10/25/2017,75,18:30,18:45,64.61,32.42,0,64.61,64.61,1,-131484,53375,184859,-78109,0,-10211,1196,0,0,,11407,-9015
43,10/25/2017,76,18:45,19:00,70.61,32.42,0,70.61,70.61,1,-184359,77288,261647,-107071,0,-69,16878,0,0,,16947,16809
43,10/25/2017,77,19:00,19:15,35.98,26.3,0,26.3,26.3,-1,-133896,65322,199218,-68574,0,-1781,12138,0,0,,13919,10357
43,10/25/2017,78,19:15,19:30,35.64,26.09,0,35.64,26.09,2,-124459,41520,165979,-82939,0,-4349,562,0,0,,4911,-3787
43,10/25/2017,79,19:30,19:45,65.9,,0,65.9,65.9,1,-126368,39132,165500,-87236,0,0,12790,0,0,,12790,12790
43,10/25/2017,80,19:45,20:00,65.9,26.23,0,26.23,26.23,-1,-104595,45900,150495,-58695,0,-5359,3457,0,0,,8816,-1902
43,10/25/2017,81,20:00,20:15,,32.42,0,32.42,32.42,-1,-93945,61224,155169,-32721,0,-2895,0,0,0,,2895,-2895
43,10/25/2017,82,20:15,20:30,,-1.55,0,-1.55,-1.55,-1,-77688,75339,153027,-2349,0,-27425,0,0,0,,27425,-27425
43,10/25/2017,83,20:30,20:45,,10.51,0,10.51,10.51,-1,-70617,76303,146920,5686,0,-45854,0,0,0,,45854,-45854
43,10/25/2017,84,20:45,21:00,,10.55,0,10.55,10.55,-1,-66717,84402,151119,17685,0,-59197,0,0,0,,59197,-59197
43,10/25/2017,85,21:00,21:15,60.51,10.55,0,60.51,60.51,1,-140268,73841,214109,-66427,0,-24579,2923,0,0,,27502,-21656
43,10/25/2017,86,21:15,21:30,60.51,2.51,0,2.51,2.51,-1,-115931,102635,218566,-13296,0,-14131,67,0,0,,14198,-14064
43,10/25/2017,87,21:30,21:45,,4.4,0,4.4,4.4,-1,-93801,97628,191429,3827,0,-53549,0,0,0,,53549,-53549
43,10/25/2017,88,21:45,22:00,,10.55,0,10.55,10.55,-1,-95967,117526,213493,21559,0,-55477,0,0,0,,55477,-55477
43,10/25/2017,89,22:00,22:15,51.42,16.46,0,51.42,51.42,1,-89617,84948,174565,-4669,0,-29687,2468,0,0,,32155,-27219
43,10/25/2017,90,22:15,22:30,51.42,-48.07,0,-48.07,-48.07,-1,-43281,99820,143101,56539,0,-25374,371,0,0,,25745,-25003
43,10/25/2017,91,22:30,22:45,,12.27,0,12.27,12.27,-1,-44492,127340,171832,82848,0,-66949,0,0,0,,66949,-66949
43,10/25/2017,92,22:45,23:00,,-13.53,0,-13.53,-13.53,-1,-34862,112241,147103,77379,0,-75813,0,0,0,,75813,-75813
43,10/25/2017,93,23:00,23:15,156.5,28.42,0,156.5,28.42,2,-74062,70566,144628,-3496,0,-22605,5632,0,0,,28237,-16973
43,10/25/2017,94,23:15,23:30,156.5,23.36,0,23.36,23.36,-1,-37593,75594,113187,38001,0,-8466,493,0,0,,8959,-7973
43,10/25/2017,95,23:30,23:45,,15.99,0,15.99,15.99,-1,-34609,93864,128473,59255,0,-25505,0,0,0,,25505,-25505
43,10/25/2017,96,23:45,0:00,,-1.99,0,-1.99,-1.99,-1,-33505,127055,160560,93550,0,-72136,0,0,0,,72136,-72136
43,10/26/2017,1,0:00,0:15,,22.52,0,22.52,22.52,-1,-65336,75071,140407,9735,0,-28764,0,0,0,,28764,-28764
43,10/26/2017,2,0:15,0:30,,,0,31.35,31.35,0,-40122,66455,106577,26333,0,0,0,0,0,,0,0
43,10/26/2017,3,0:30,0:45,,14.01,0,14.01,14.01,-1,-35983,89195,125178,53212,0,-9519,0,0,0,,9519,-9519
43,10/26/2017,4,0:45,1:00,,10.33,0,10.33,10.33,-1,-55831,114031,169862,58200,0,-55265,0,0,0,,55265,-55265
43,10/26/2017,5,1:00,1:15,72.45,10.33,0,72.45,72.45,1,-85732,80211,165943,-5521,0,-21965,3430,0,0,,25395,-18535
43,10/26/2017,6,1:15,1:30,39.42,26.22,0,39.42,26.22,2,-58490,62450,120940,3960,0,-1004,9054,0,0,,10058,8050
43,10/26/2017,7,1:30,1:45,39.42,21.33,0,21.33,21.33,-1,-47141,87021,134162,39880,0,-5110,658,0,0,,5768,-4452
43,10/26/2017,8,1:45,2:00,,17.54,0,17.54,17.54,-1,-43954,92814,136768,48860,0,-29450,0,0,0,,29450,-29450
43,10/26/2017,9,2:00,2:15,,27.8,0,27.8,27.8,-1,-58051,79792,137843,21741,0,-21008,0,0,0,,21008,-21008
43,10/26/2017,10,2:15,2:30,,12.47,0,12.47,12.47,-1,-37455,81998,119453,44543,0,-35490,0,0,0,,35490,-35490
43,10/26/2017,11,2:30,2:45,,27.39,0,27.39,27.39,-1,-38405,60790,99195,22385,0,-21636,0,0,0,,21636,-21636
43,10/26/2017,12,2:45,3:00,,16.07,0,16.07,16.07,-1,-35465,64401,99866,28936,0,-25161,0,0,0,,25161,-25161
43,10/26/2017,13,3:00,3:15,,22.55,0,22.55,22.55,-1,-30444,70099,100543,39655,0,-18722,0,0,0,,18722,-18722
43,10/26/2017,14,3:15,3:30,39.42,,0,39.42,39.42,1,-31960,49846,81806,17886,0,0,15,0,0,,15,15
43,10/26/2017,15,3:30,3:45,,,0,31.62,31.62,0,-31116,61406,92522,30290,0,0,0,0,0,,0,0
43,10/26/2017,16,3:45,4:00,,30.89,0,30.89,30.89,-1,-30144,57579,87723,27435,0,-671,0,0,0,,671,-671
43,10/26/2017,17,4:00,4:15,,32.09,0,32.09,32.09,-1,-27487,60184,87671,32697,0,-485,0,0,0,,485,-485
43,10/26/2017,18,4:15,4:30,,,0,31.6,31.6,0,-34958,67626,102584,32668,0,0,0,0,0,,0,0
43,10/26/2017,19,4:30,4:45,,,0,31.6,31.6,0,-42458,73764,116222,31306,0,0,0,0,0,,0,0
43,10/26/2017,20,4:45,5:00,,,0,31.59,31.59,0,-47693,92732,140425,45039,0,0,0,0,0,,0,0
43,10/26/2017,21,5:00,5:15,,24.01,0,24.01,24.01,-1,-65381,81714,147095,16333,0,-2365,0,0,0,,2365,-2365
43,10/26/2017,22,5:15,5:30,35.42,23.61,0,35.42,23.61,2,-43140,51415,94555,8275,0,-7625,161,0,0,,7786,-7464
43,10/26/2017,23,5:30,5:45,41.61,,0,41.61,41.61,1,-59995,39524,99519,-20471,0,0,5518,0,0,,5518,5518
43,10/26/2017,24,5:45,6:00,45.42,,0,45.42,45.42,1,-54885,29694,84579,-25191,0,0,9402,0,0,,9402,9402
43,10/26/2017,25,6:00,6:15,45.42,-42.9,0,-42.9,-42.9,-1,-36335,178038,214373,141703,0,-42542,960,0,0,,43502,-41582
43,10/26/2017,26,6:15,6:30,,6.28,0,6.28,6.28,-1,-29101,116486,145587,87385,0,-72659,0,0,0,,72659,-72659
43,10/26/2017,27,6:30,6:45,,26.65,0,26.65,26.65,-1,-29989,78681,108670,48692,0,-30946,0,0,0,,30946,-30946
43,10/26/2017,28,6:45,7:00,35.49,22.05,0,35.49,22.05,2,-66656,65240,131896,-1416,0,-2404,170,0,0,,2574,-2234
43,10/26/2017,29,7:00,7:15,,-48.88,0,-48.88,-48.88,-1,-134943,136639,271582,1696,0,-62433,0,0,0,,62433,-62433
43,10/26/2017,30,7:15,7:30,,-3.4,0,-3.4,-3.4,-1,-175816,95233,271049,-80583,0,-67991,0,0,0,,67991,-67991
43,10/26/2017,31,7:30,7:45,,29.95,0,29.95,29.95,-1,-196368,75549,271917,-120819,0,-18816,0,0,0,,18816,-18816
43,10/26/2017,32,7:45,8:00,51.49,30.95,0,51.49,30.95,2,-240959,65146,306105,-175813,0,-5096,2576,0,0,,7672,-2520
43,10/26/2017,33,8:00,8:15,31.96,-17.29,0,32.07,-17.29,2,-162300,52744,215044,-109556,0,-18856,1279,0,0,,20135,-17577
43,10/26/2017,34,8:15,8:30,,16.87,0,16.87,16.87,-1,-173319,66120,239439,-107199,0,-19855,0,0,0,,19855,-19855
43,10/26/2017,35,8:30,8:45,37.93,28.49,0,37.93,37.93,1,-184048,38209,222257,-145839,0,-17635,742,0,0,,18377,-16893
43,10/26/2017,36,8:45,9:00,37.93,28.79,0,28.79,28.79,-1,-182527,42428,224955,-140099,0,-3215,355,0,0,,3570,-2860
43,10/26/2017,37,9:00,9:15,87.07,32.49,0,87.07,32.49,2,-210831,37147,247978,-173684,0,-1679,8204,0,0,,9883,6525
43,10/26/2017,38,9:15,9:30,70.47,,0,70.47,70.47,1,-214731,34823,249554,-179908,0,0,25177,0,0,,25177,25177
43,10/26/2017,39,9:30,9:45,40.29,,0,40.29,40.29,1,-212211,38386,250597,-173825,0,0,17516,0,0,,17516,17516
43,10/26/2017,40,9:45,10:00,70.47,,0,70.47,70.47,1,-215725,42274,257999,-173451,0,0,26582,0,0,,26582,26582
43,10/26/2017,41,10:00,10:15,64.93,,0,64.93,64.93,1,-206011,28125,234136,-177886,0,0,24088,0,0,,24088,24088
43,10/26/2017,42,10:15,10:30,35.36,,0,35.36,35.36,1,-221416,59405,280821,-162011,0,0,8598,0,0,,8598,8598
43,10/26/2017,43,10:30,10:45,70.93,,0,70.93,70.93,1,-224392,50133,274525,-174259,0,0,12104,0,0,,12104,12104
43,10/26/2017,44,10:45,11:00,70.93,32.49,0,70.93,32.49,2,-217229,64980,282209,-152249,0,-155,19614,0,0,,19769,19459
43,10/26/2017,45,11:00,11:15,65.95,32.49,0,65.95,32.49,2,-224192,35862,260054,-188330,0,-404,14293,0,0,,14697,13889
43,10/26/2017,46,11:15,11:30,51.49,,0,51.49,51.49,1,-225957,44581,270538,-181376,0,0,25814,0,0,,25814,25814
43,10/26/2017,47,11:30,11:45,36.86,,0,36.86,36.86,1,-219765,50126,269891,-169639,0,0,20481,0,0,,20481,20481
43,10/26/2017,48,11:45,12:00,36.03,,0,36.03,36.03,1,-215641,55577,271218,-160064,0,0,16150,0,0,,16150,16150
43,10/26/2017,49,12:00,12:15,37.72,,0,37.72,37.72,1,-209428,45482,254910,-163946,0,0,7689,0,0,,7689,7689
43,10/26/2017,50,12:15,12:30,51.49,,0,51.49,51.49,1,-209177,32337,241514,-176840,0,0,11829,0,0,,11829,11829
43,10/26/2017,51,12:30,12:45,51.49,29.8,0,29.8,29.8,-1,-199325,69554,268879,-129771,0,-2138,4218,0,0,,6356,2080
43,10/26/2017,52,12:45,13:00,,26.82,0,26.82,26.82,-1,-196273,61556,257829,-134717,0,-14056,0,0,0,,14056,-14056
43,10/26/2017,53,13:00,13:15,,26.67,0,26.67,26.67,-1,-189998,64918,254916,-125080,0,-11149,0,0,0,,11149,-11149
43,10/26/2017,54,13:15,13:30,,30.86,0,30.86,30.86,-1,-186638,56689,243327,-129949,0,-12124,0,0,0,,12124,-12124
43,10/26/2017,55,13:30,13:45,,27.81,0,27.81,27.81,-1,-190344,67698,258042,-122646,0,-16669,0,0,0,,16669,-16669
43,10/26/2017,56,13:45,14:00,,26.92,0,26.92,26.92,-1,-190743,72326,263069,-118417,0,-28513,0,0,0,,28513,-28513
43,10/26/2017,57,14:00,14:15,,28.49,0,28.49,28.49,-1,-195830,78587,274417,-117243,0,-22906,0,0,0,,22906,-22906
43,10/26/2017,58,14:15,14:30,,18.49,0,18.49,18.49,-1,-194407,93764,288171,-100643,0,-45068,0,0,0,,45068,-45068
43,10/26/2017,59,14:30,14:45,,21.3,0,21.3,21.3,-1,-199846,104441,304287,-95405,0,-46139,0,0,0,,46139,-46139
43,10/26/2017,60,14:45,15:00,34.79,20.07,0,34.79,20.07,2,-196506,65078,261584,-131428,0,-36020,85,0,0,,36105,-35935
43,10/26/2017,61,15:00,15:15,51.49,20.07,0,51.49,51.49,1,-213262,59005,272267,-154257,0,-1666,7325,0,0,,8991,5659
43,10/26/2017,62,15:15,15:30,34.68,,0,34.68,34.68,1,-215640,58331,273971,-157309,0,0,425,0,0,,425,425
43,10/26/2017,63,15:30,15:45,45.49,,0,45.49,45.49,1,-219661,49191,268852,-170470,0,0,6084,0,0,,6084,6084
43,10/26/2017,64,15:45,16:00,37.72,,0,37.72,37.72,1,-222966,52175,275141,-170791,0,0,9637,0,0,,9637,9637
43,10/26/2017,65,16:00,16:15,37.72,28.49,0,28.49,28.49,-1,-205631,65253,270884,-140378,0,-3239,1719,0,0,,4958,-1520
43,10/26/2017,66,16:15,16:30,79.07,,0,79.07,79.07,1,-228677,46826,275503,-181851,0,0,13662,0,0,,13662,13662
43,10/26/2017,67,16:30,16:45,37.72,,0,37.72,37.72,1,-215245,48268,263513,-166977,0,0,18009,0,0,,18009,18009
43,10/26/2017,68,16:45,17:00,72.14,,0,72.14,72.14,1,-223403,39126,262529,-184277,0,0,21100,0,0,,21100,21100
43,10/26/2017,69,17:00,17:15,105.17,18.49,0,18.49,18.49,-1,-200522,56377,256899,-144145,0,-4242,21200,0,0,,25442,16958
43,10/26/2017,70,17:15,17:30,515.14,18.49,0,515.14,515.14,1,-222588,32209,254797,-190379,0,-5195,13512,0,0,,18707,8317
43,10/26/2017,71,17:30,17:45,61.12,27.03,0,61.12,27.03,2,-205462,67753,273215,-137709,0,-2418,19180,0,0,,21598,16762
43,10/26/2017,72,17:45,18:00,37.72,27.03,0,37.72,37.72,1,-216468,56807,273275,-159661,0,-721,3095,0,0,,3816,2374
43,10/26/2017,73,18:00,18:15,37.72,33.99,0,44.08,33.99,2,-207100,30385,237485,-176715,0,-18,10548,0,0,,10566,10530
43,10/26/2017,74,18:15,18:30,37.72,31.21,0,31.21,31.21,-1,-196623,51614,248237,-145009,0,-2933,645,0,0,,3578,-2288
43,10/26/2017,75,18:30,18:45,118.12,31.21,0,118.12,118.12,1,-240905,54921,295826,-185984,0,-423,13623,0,0,,14046,13200
43,10/26/2017,76,18:45,19:00,420.64,,0,420.64,420.64,1,-249598,76306,325904,-173292,0,0,42721,0,0,,42721,42721
43,10/26/2017,77,19:00,19:15,420.64,-1.67,0,-1.67,-1.67,-1,-188441,75093,263534,-113348,0,-18489,3763,0,0,,22252,-14726
43,10/26/2017,78,19:15,19:30,34.53,30.79,0,34.53,30.79,2,-203581,52818,256399,-150763,0,-3140,550,0,0,,3690,-2590
43,10/26/2017,79,19:30,19:45,,28.49,0,28.49,28.49,-1,-187439,61737,249176,-125702,0,-11475,0,0,0,,11475,-11475
43,10/26/2017,80,19:45,20:00,,25.01,0,25.01,25.01,-1,-182577,53138,235715,-129439,0,-31116,0,0,0,,31116,-31116
43,10/26/2017,81,20:00,20:15,,29.68,0,29.68,29.68,-1,-211608,83779,295387,-127829,0,-19023,0,0,0,,19023,-19023
43,10/26/2017,82,20:15,20:30,,-25.43,0,-25.43,-25.43,-1,-194005,104938,298943,-89067,0,-19001,0,0,0,,19001,-19001
43,10/26/2017,83,20:30,20:45,,-27.41,0,-27.41,-27.41,-1,-194849,98373,293222,-96476,0,-55453,0,0,0,,55453,-55453
43,10/26/2017,84,20:45,21:00,,11.44,0,11.44,11.44,-1,-189905,102751,292656,-87154,0,-53553,0,0,0,,53553,-53553
43,10/26/2017,85,21:00,21:15,169.39,22.83,0,169.39,169.39,1,-234440,87060,321500,-147380,0,-29485,6480,0,0,,35965,-23005
43,10/26/2017,86,21:15,21:30,37.38,30.78,0,30.78,30.78,-1,-163985,43386,207371,-120599,0,-1276,9282,0,0,,10558,8006
43,10/26/2017,87,21:30,21:45,37.38,27.91,0,27.91,27.91,-1,-162692,62002,224694,-100690,0,-25849,7,0,0,,25856,-25842
43,10/26/2017,88,21:45,22:00,,21.3,0,21.3,21.3,-1,-196941,101198,298139,-95743,0,-24602,0,0,0,,24602,-24602
43,10/26/2017,89,22:00,22:15,,-20.83,0,-20.83,-20.83,-1,-81904,158945,240849,77041,0,-58202,0,0,0,,58202,-58202
43,10/26/2017,90,22:15,22:30,,-27.72,0,-27.72,-27.72,-1,-41718,103945,145663,62227,0,-50956,0,0,0,,50956,-50956
43,10/26/2017,91,22:30,22:45,30.65,21.78,0,32.08,21.78,2,-47601,83320,130921,35719,0,-29885,36,0,0,,29921,-29849
43,10/26/2017,92,22:45,23:00,,-61.63,0,-61.63,-61.63,-1,-27103,127943,155046,100840,0,-64361,0,0,0,,64361,-64361
43,10/26/2017,93,23:00,23:15,,-7.78,0,-7.78,-7.78,-1,-45224,124885,170109,79661,0,-72856,0,0,0,,72856,-72856
43,10/26/2017,94,23:15,23:30,,16.25,0,16.25,16.25,-1,-24907,82801,107708,57894,0,-32817,0,0,0,,32817,-32817
43,10/26/2017,95,23:30,23:45,,13.16,0,13.16,13.16,-1,-36682,101062,137744,64380,0,-55258,0,0,0,,55258,-55258
43,10/26/2017,96,23:45,0:00,,-5.15,0,-5.15,-5.15,-1,-34275,102517,136792,68242,0,-76058,0,0,0,,76058,-76058
43,10/27/2017,1,0:00,0:15,126.41,10.92,0,126.41,126.41,1,-75834,35452,111286,-40382,0,-34718,8177,0,0,,42895,-26541
43,10/27/2017,2,0:15,0:30,124.28,5.52,0,124.28,5.52,2,-46905,60747,107652,13842,0,-3786,19656,0,0,,23442,15870
43,10/27/2017,3,0:30,0:45,124.28,-46.11,0,-46.11,-46.11,-1,-34393,96014,130407,61621,0,-60465,21,0,0,,60486,-60444
43,10/27/2017,4,0:45,1:00,,2.28,0,2.28,2.28,-1,-39784,124355,164139,84571,0,-67983,0,0,0,,67983,-67983
43,10/27/2017,5,1:00,1:15,161.24,32.49,0,161.24,32.24,2,-74921,39544,114465,-35377,0,-21634,6847,0,0,,28481,-14787
43,10/27/2017,6,1:15,1:30,161.24,7.28,0,7.28,7.28,-1,-31723,71411,103134,39688,0,-23632,246,0,0,,23878,-23386
43,10/27/2017,7,1:30,1:45,,14.79,0,14.79,14.79,-1,-39556,98132,137688,58576,0,-54145,0,0,0,,54145,-54145
43,10/27/2017,8,1:45,2:00,,9.2,0,9.2,9.2,-1,-40673,97660,138333,56987,0,-61489,0,0,0,,61489,-61489
43,10/27/2017,9,2:00,2:15,34.95,12.03,0,34.95,34.95,1,-31690,58808,90498,27118,0,-41132,17,0,0,,41149,-41115
43,10/27/2017,10,2:15,2:30,49.99,-2.36,0,49.99,-2.36,2,-36412,56937,93349,20525,0,-10478,2469,0,0,,12947,-8009
43,10/27/2017,11,2:30,2:45,,-1.81,0,-1.81,-1.81,-1,-27662,56364,84026,28702,0,-22157,0,0,0,,22157,-22157
43,10/27/2017,12,2:45,3:00,,2.28,0,2.28,2.28,-1,-21540,66734,88274,45194,0,-29069,0,0,0,,29069,-29069
43,10/27/2017,13,3:00,3:15,,16.3,0,16.3,16.3,-1,-36528,54258,90786,17730,0,-33694,0,0,0,,33694,-33694
43,10/27/2017,14,3:15,3:30,,26.99,0,26.99,26.99,-1,-35296,46207,81503,10911,0,-11483,0,0,0,,11483,-11483
43,10/27/2017,15,3:30,3:45,,33.49,0,33.49,33.49,-1,-39338,43778,83116,4440,0,-4028,0,0,0,,4028,-4028
43,10/27/2017,16,3:45,4:00,,24.19,0,24.19,24.19,-1,-35354,54705,90059,19351,0,-4419,0,0,0,,4419,-4419
43,10/27/2017,17,4:00,4:15,33.56,19.43,0,33.56,19.43,2,-51726,50675,102401,-1051,0,-6171,406,0,0,,6577,-5765
43,10/27/2017,18,4:15,4:30,,25.7,0,25.7,25.7,-1,-41760,59089,100849,17329,0,-5113,0,0,0,,5113,-5113
43,10/27/2017,19,4:30,4:45,,32.49,0,32.49,32.49,-1,-48956,60683,109639,11727,0,-2448,0,0,0,,2448,-2448
43,10/27/2017,20,4:45,5:00,,10.3,0,10.3,10.3,-1,-39413,80299,119712,40886,0,-14380,0,0,0,,14380,-14380
43,10/27/2017,21,5:00,5:15,,13.6,0,13.6,13.6,-1,-41669,83726,125395,42057,0,-44117,0,0,0,,44117,-44117
43,10/27/2017,22,5:15,5:30,,12.81,0,12.81,12.81,-1,-39218,78963,118181,39745,0,-37704,0,0,0,,37704,-37704
43,10/27/2017,23,5:30,5:45,,3.87,0,3.87,3.87,-1,-33266,91482,124748,58216,0,-48350,0,0,0,,48350,-48350
43,10/27/2017,24,5:45,6:00,,-48.68,0,-48.68,-48.68,-1,-47352,125264,172616,77912,0,-46915,0,0,0,,46915,-46915
43,10/27/2017,25,6:00,6:15,,-68,0,-68,-68,-1,-25460,137176,162636,111716,0,-90892,0,0,0,,90892,-90892
43,10/27/2017,26,6:15,6:30,,-32.94,0,-32.94,-32.94,-1,-33110,105024,138134,71914,0,-74795,0,0,0,,74795,-74795
43,10/27/2017,27,6:30,6:45,,15.82,0,15.82,15.82,-1,-29399,109635,139034,80236,0,-9323,0,0,0,,9323,-9323
43,10/27/2017,28,6:45,7:00,,28.45,0,28.45,28.45,-1,-59335,117649,176984,58314,0,-2311,0,0,0,,2311,-2311
43,10/27/2017,29,7:00,7:15,,-60.78,0,-60.78,-60.78,-1,-30323,105896,136219,75573,0,-36394,0,0,0,,36394,-36394
43,10/27/2017,30,7:15,7:30,,30.78,0,30.78,30.78,-1,-46757,105771,152528,59014,0,-2266,0,0,0,,2266,-2266
43,10/27/2017,31,7:30,7:45,,30.75,0,30.75,30.75,-1,-32572,99715,132287,67143,0,-1139,0,0,0,,1139,-1139
43,10/27/2017,32,7:45,8:00,,,0,32.29,32.29,0,-84718,89915,174633,5197,0,0,0,0,0,,0,0
43,10/27/2017,33,8:00,8:15,,32.45,0,32.45,32.45,-1,-28614,112738,141352,84124,0,-555,0,0,0,,555,-555
43,10/27/2017,34,8:15,8:30,,,0,32.21,32.21,0,-26673,100399,127072,73726,0,0,0,0,0,,0,0
43,10/27/2017,35,8:30,8:45,,,0,32.23,32.23,0,-30116,80697,110813,50581,0,0,0,0,0,,0,0
43,10/27/2017,36,8:45,9:00,,,0,32.99,32.99,0,-24730,57298,82028,32568,0,0,0,0,0,,0,0
43,10/27/2017,37,9:00,9:15,,,0,32.99,32.99,0,-22513,86294,108807,63781,0,0,0,0,0,,0,0
43,10/27/2017,38,9:15,9:30,,30.78,0,30.78,30.78,-1,-28083,81048,109131,52965,0,-561,0,0,0,,561,-561
43,10/27/2017,39,9:30,9:45,,23.79,0,23.79,23.79,-1,-28896,101743,130639,72847,0,-1028,0,0,0,,1028,-1028
43,10/27/2017,40,9:45,10:00,,19.93,0,19.93,19.93,-1,-31551,85418,116969,53867,0,-6440,0,0,0,,6440,-6440
43,10/27/2017,41,10:00,10:15,,22.92,0,22.92,22.92,-1,-24858,83866,108724,59008,0,-10730,0,0,0,,10730,-10730
43,10/27/2017,42,10:15,10:30,,-7.46,0,-7.46,-7.46,-1,-35432,100173,135605,64741,0,-32928,0,0,0,,32928,-32928
43,10/27/2017,43,10:30,10:45,,28.45,0,28.45,28.45,-1,-27861,79731,107592,51870,0,-26259,0,0,0,,26259,-26259
43,10/27/2017,44,10:45,11:00,,27.44,0,27.44,27.44,-1,-32615,70553,103168,37938,0,-28552,0,0,0,,28552,-28552
43,10/27/2017,45,11:00,11:15,,31.03,0,31.03,31.03,-1,-60550,78200,138750,17650,0,-13580,0,0,0,,13580,-13580
43,10/27/2017,46,11:15,11:30,,33.45,0,33.45,33.45,-1,-53271,83535,136806,30264,0,-3,0,0,0,,3,-3
43,10/27/2017,47,11:30,11:45,,11.88,0,11.88,11.88,-1,-26626,107521,134147,80895,0,-13824,0,0,0,,13824,-13824
43,10/27/2017,48,11:45,12:00,,-7.7,0,-7.7,-7.7,-1,-28851,114224,143075,85373,0,-62748,0,0,0,,62748,-62748
43,10/27/2017,49,12:00,12:15,,15.77,0,15.77,15.77,-1,-34674,113540,148214,78866,0,-71105,0,0,0,,71105,-71105
43,10/27/2017,50,12:15,12:30,,-3.82,0,-3.82,-3.82,-1,-30820,116122,146942,85302,0,-61454,0,0,0,,61454,-61454
43,10/27/2017,51,12:30,12:45,,-12.85,0,-12.85,-12.85,-1,-26692,134174,160866,107482,0,-95871,0,0,0,,95871,-95871
43,10/27/2017,52,12:45,13:00,,4.36,0,4.36,4.36,-1,-26076,130839,156915,104763,0,-99706,0,0,0,,99706,-99706
43,10/27/2017,53,13:00,13:15,45.92,13.57,0,45.92,45.92,1,-73178,81405,154583,8227,0,-47731,1930,0,0,,49661,-45801
43,10/27/2017,54,13:15,13:30,45.92,22.57,0,22.57,22.57,-1,-63248,91890,155138,28642,0,-5052,345,0,0,,5397,-4707
43,10/27/2017,55,13:30,13:45,,18,0,18,18,-1,-69455,93574,163029,24119,0,-27724,0,0,0,,27724,-27724
43,10/27/2017,56,13:45,14:00,,6.24,0,6.24,6.24,-1,-56970,111407,168377,54437,0,-25465,0,0,0,,25465,-25465
43,10/27/2017,57,14:00,14:15,32.49,28.45,0,32.49,32.49,1,-71079,84384,155463,13305,0,-14241,357,0,0,,14598,-13884
43,10/27/2017,58,14:15,14:30,32.28,32.45,0,32.28,32.19,2,-66925,72854,139779,5929,0,-252,458,0,0,,710,206
43,10/27/2017,59,14:30,14:45,,30.78,0,30.78,30.78,-1,-34150,96425,130575,62275,0,-1062,0,0,0,,1062,-1062
43,10/27/2017,60,14:45,15:00,,31.21,0,31.21,31.21,-1,-45102,83299,128401,38197,0,-1610,0,0,0,,1610,-1610
43,10/27/2017,61,15:00,15:15,,-4.99,0,-4.99,-4.99,-1,-38110,103987,142097,65877,0,-23453,0,0,0,,23453,-23453
43,10/27/2017,62,15:15,15:30,,24.27,0,24.27,24.27,-1,-47314,70528,117842,23214,0,-22112,0,0,0,,22112,-22112
43,10/27/2017,63,15:30,15:45,,29.29,0,29.29,29.29,-1,-54107,68954,123061,14847,0,-15788,0,0,0,,15788,-15788
43,10/27/2017,64,15:45,16:00,31.99,30.65,0,32.28,30.65,2,-60360,71401,131761,11041,0,-4533,376,0,0,,4909,-4157
43,10/27/2017,65,16:00,16:15,,-26.42,0,-26.42,-26.42,-1,-44836,122596,167432,77760,0,-32538,0,0,0,,32538,-32538
43,10/27/2017,66,16:15,16:30,,5.72,0,5.72,5.72,-1,-31571,115479,147050,83908,0,-51361,0,0,0,,51361,-51361
43,10/27/2017,67,16:30,16:45,,31.03,0,31.03,31.03,-1,-29829,84046,113875,54217,0,-19352,0,0,0,,19352,-19352
43,10/27/2017,68,16:45,17:00,31.96,31.03,0,31.96,31.96,1,-62202,71641,133843,9439,0,-131,788,0,0,,919,657
43,10/27/2017,69,17:00,17:15,31.96,-14.69,0,-14.69,-14.69,-1,-37438,84464,121902,47026,0,-26909,12,0,0,,26921,-26897
43,10/27/2017,70,17:15,17:30,,32.45,0,32.45,32.45,-1,-54409,69854,124263,15445,0,-1944,0,0,0,,1944,-1944
43,10/27/2017,71,17:30,17:45,,31.19,0,31.19,31.19,-1,-82883,66979,149862,-15904,0,-1107,0,0,0,,1107,-1107
43,10/27/2017,72,17:45,18:00,38.29,,0,38.29,38.29,1,-100974,68893,169867,-32081,0,0,1410,0,0,,1410,1410
43,10/27/2017,73,18:00,18:15,32.33,31.08,0,32.49,31.08,2,-73819,61861,135680,-11958,0,-1803,1148,0,0,,2951,-655
43,10/27/2017,74,18:15,18:30,,29.19,0,29.19,29.19,-1,-60346,89548,149894,29202,0,-16184,0,0,0,,16184,-16184
43,10/27/2017,75,18:30,18:45,,,0,32.72,32.72,0,-63670,89670,153340,26000,0,-3302,0,0,0,,3302,-3302
43,10/27/2017,76,18:45,19:00,49.69,,0,49.69,49.69,1,-72607,57508,130115,-15099,0,0,7586,0,0,,7586,7586
43,10/27/2017,77,19:00,19:15,49.69,-14.33,0,-14.33,-14.33,-1,-43496,89035,132531,45539,0,-21459,1650,0,0,,23109,-19809
43,10/27/2017,78,19:15,19:30,,31.03,0,31.03,31.03,-1,-56638,51236,107874,-5402,0,-11582,0,0,0,,11582,-11582
43,10/27/2017,79,19:30,19:45,,29.31,0,29.31,29.31,-1,-53030,48389,101419,-4641,0,-2508,0,0,0,,2508,-2508
43,10/27/2017,80,19:45,20:00,,27.26,0,27.26,27.26,-1,-53344,71356,124700,18012,0,-22327,0,0,0,,22327,-22327
43,10/27/2017,81,20:00,20:15,71.19,28.45,0,71.19,28.45,2,-69514,24942,94456,-44572,0,-13921,4427,0,0,,18348,-9494
43,10/27/2017,82,20:15,20:30,31.47,-21.47,0,-21.47,-21.47,-1,-34391,77390,111781,42999,0,-16230,732,0,0,,16962,-15498
43,10/27/2017,83,20:30,20:45,,-17.74,0,-17.74,-17.74,-1,-41172,85579,126751,44407,0,-52140,0,0,0,,52140,-52140
43,10/27/2017,84,20:45,21:00,,20.55,0,20.55,20.55,-1,-54524,98852,153376,44328,0,-30170,0,0,0,,30170,-30170
43,10/27/2017,85,21:00,21:15,160,-4.59,0,160,-4.59,2,-105323,78929,184252,-26394,0,-24933,4472,0,0,,29405,-20461
43,10/27/2017,86,21:15,21:30,328.35,-4.59,0,328.35,328.35,1,-92312,54992,147304,-37320,0,-438,37467,0,0,,37905,37029
43,10/27/2017,87,21:30,21:45,328.35,20.22,0,20.22,20.22,-1,-52663,76243,128906,23580,0,-15361,4551,0,0,,19912,-10810
43,10/27/2017,88,21:45,22:00,31.96,30.03,0,32.42,30.03,2,-52116,72917,125033,20801,0,-11214,134,0,0,,11348,-11080
43,10/27/2017,89,22:00,22:15,343.36,27.17,0,343.36,343.36,1,-111687,50072,161759,-61615,0,-5437,12325,0,0,,17762,6888
43,10/27/2017,90,22:15,22:30,164.92,,0,164.92,164.92,1,-91748,37896,129644,-53852,0,0,56153,0,0,,56153,56153
43,10/27/2017,91,22:30,22:45,164.92,-41.35,0,-41.35,-41.35,-1,-33385,74838,108223,41453,0,-27834,6218,0,0,,34052,-21616
43,10/27/2017,92,22:45,23:00,,15.77,0,15.77,15.77,-1,-40095,96224,136319,56129,0,-39703,0,0,0,,39703,-39703
43,10/27/2017,93,23:00,23:15,242,-2.03,0,242,242,1,-97715,26405,124120,-71310,0,-25773,8231,0,0,,34004,-17542
43,10/27/2017,94,23:15,23:30,167.72,32.45,0,167.72,32.45,2,-73695,40686,114381,-33009,0,-101,29206,0,0,,29307,29105
43,10/27/2017,95,23:30,23:45,32.56,30.08,0,32.56,30.08,2,-46029,57430,103459,11401,0,-1426,844,0,0,,2270,-582
43,10/27/2017,96,23:45,0:00,,-12.1,0,-12.1,-12.1,-1,-44064,101520,145584,57456,0,-37949,0,0,0,,37949,-37949
44,10/28/2017,1,0:00,0:15,,-49.51,0,-49.51,-49.51,-1,-47738,148014,195752,100276,0,-60306,0,0,0,,60306,-60306
44,10/28/2017,2,0:15,0:30,,32.42,0,32.42,32.42,-1,-48523,77880,126403,29357,0,-3127,0,0,0,,3127,-3127
44,10/28/2017,3,0:30,0:45,,31.42,0,31.42,31.42,-1,-57358,63798,121156,6440,0,-944,0,0,0,,944,-944
44,10/28/2017,4,0:45,1:00,34.42,31.42,0,34.42,34.42,1,-113874,75996,189870,-37878,0,-11,2581,0,0,,2592,2570
44,10/28/2017,5,1:00,1:15,56.25,,0,56.25,56.25,1,-52993,32378,85371,-20615,0,0,2010,0,0,,2010,2010
44,10/28/2017,6,1:15,1:30,147.63,32.04,0,147.63,31.54,2,-52018,11494,63512,-40524,0,-5,34696,0,0,,34701,34691
44,10/28/2017,7,1:30,1:45,147.63,-1.24,0,-1.24,-1.24,-1,-6626,41792,48418,35166,0,-19963,2508,0,0,,22471,-17455
44,10/28/2017,8,1:45,2:00,,24.37,0,24.37,24.37,-1,-13817,39745,53562,25928,0,-27513,0,0,0,,27513,-27513
44,10/28/2017,9,2:00,2:15,72.53,10.09,0,72.53,10.09,2,-63515,37119,100634,-26396,0,-18991,3943,0,0,,22934,-15048
44,10/28/2017,10,2:15,2:30,31.05,27.42,0,27.42,27.42,-1,-37782,46733,84515,8951,0,-2031,1820,0,0,,3851,-211
44,10/28/2017,11,2:30,2:45,,24.3,0,24.3,24.3,-1,-33952,47543,81495,13591,0,-12471,0,0,0,,12471,-12471
44,10/28/2017,12,2:45,3:00,,28.78,0,28.78,28.78,-1,-27385,57385,84770,30000,0,-13544,0,0,0,,13544,-13544
44,10/28/2017,13,3:00,3:15,,24.1,0,24.1,24.1,-1,-31349,62508,93857,31159,0,-9137,0,0,0,,9137,-9137
44,10/28/2017,14,3:15,3:30,,30.36,0,30.36,30.36,-1,-32128,50885,83013,18757,0,-65,0,0,0,,65,-65
44,10/28/2017,15,3:30,3:45,,30.36,0,30.36,30.36,-1,-30980,60198,91178,29218,0,-493,0,0,0,,493,-493
44,10/28/2017,16,3:45,4:00,,12.16,0,12.16,12.16,-1,-20336,62582,82918,42246,0,-8123,0,0,0,,8123,-8123
44,10/28/2017,17,4:00,4:15,,28.78,0,28.78,28.78,-1,-33413,50926,84339,17513,0,-7654,0,0,0,,7654,-7654
44,10/28/2017,18,4:15,4:30,,24.42,0,24.42,24.42,-1,-32823,38432,71255,5609,0,-8449,0,0,0,,8449,-8449
44,10/28/2017,19,4:30,4:45,,6.63,0,6.63,6.63,-1,-15061,51819,66880,36758,0,-20473,0,0,0,,20473,-20473
44,10/28/2017,20,4:45,5:00,,-34,0,-34,-34,-1,-15833,55556,71389,39723,0,-44588,0,0,0,,44588,-44588
44,10/28/2017,21,5:00,5:15,,5.42,0,5.42,5.42,-1,-7707,65865,73572,58158,0,-26276,0,0,0,,26276,-26276
44,10/28/2017,22,5:15,5:30,,19.78,0,19.78,19.78,-1,-28617,63234,91851,34617,0,-32367,0,0,0,,32367,-32367
44,10/28/2017,23,5:30,5:45,,15.76,0,15.76,15.76,-1,-32959,59823,92782,26864,0,-19730,0,0,0,,19730,-19730
44,10/28/2017,24,5:45,6:00,,7.34,0,7.34,7.34,-1,-38991,63664,102655,24673,0,-35248,0,0,0,,35248,-35248
44,10/28/2017,25,6:00,6:15,,-68.9,0,-68.9,-68.9,-1,-9575,63094,72669,53519,0,-33485,0,0,0,,33485,-33485
44,10/28/2017,26,6:15,6:30,34.75,-68.9,0,34.75,-68.9,2,-37561,45666,83227,8105,0,-34216,377,0,0,,34593,-33839
44,10/28/2017,27,6:30,6:45,,-12.04,0,-12.04,-12.04,-1,-14851,57197,72048,42346,0,-28136,0,0,0,,28136,-28136
44,10/28/2017,28,6:45,7:00,,25.46,0,25.46,25.46,-1,-38715,48510,87225,9795,0,-17153,0,0,0,,17153,-17153
44,10/28/2017,29,7:00,7:15,,10.02,0,10.02,10.02,-1,-26026,83359,109385,57333,0,-23020,0,0,0,,23020,-23020
44,10/28/2017,30,7:15,7:30,,25.46,0,25.46,25.46,-1,-27029,56147,83176,29118,0,-15141,0,0,0,,15141,-15141
44,10/28/2017,31,7:30,7:45,,4.49,0,4.49,4.49,-1,-27927,54606,82533,26679,0,-21407,0,0,0,,21407,-21407
44,10/28/2017,32,7:45,8:00,,,0,30.96,30.96,0,-35052,98106,133158,63054,0,-5894,0,0,0,,5894,-5894
44,10/28/2017,33,8:00,8:15,,32.46,0,32.46,32.46,-1,-58762,71744,130506,12982,0,-1526,0,0,0,,1526,-1526
44,10/28/2017,34,8:15,8:30,,22.75,0,22.75,22.75,-1,-47928,70913,118841,22985,0,-12765,0,0,0,,12765,-12765
44,10/28/2017,35,8:30,8:45,,,0,31.94,31.94,0,-63830,50191,114021,-13639,0,-2124,0,0,0,,2124,-2124
44,10/28/2017,36,8:45,9:00,72.53,,0,72.53,72.53,1,-89873,40661,130534,-49212,0,0,6113,0,0,,6113,6113
44,10/28/2017,37,9:00,9:15,36.15,,0,36.15,36.15,1,-86122,57085,143207,-29037,0,0,6450,0,0,,6450,6450
44,10/28/2017,38,9:15,9:30,,32.46,0,32.46,32.46,-1,-78346,58689,137035,-19657,0,-512,0,0,0,,512,-512
44,10/28/2017,39,9:30,9:45,32.63,,0,32.63,32.63,1,-84550,33159,117709,-51391,0,0,126,0,0,,126,126
44,10/28/2017,40,9:45,10:00,61.61,,0,61.61,61.61,1,-93030,26127,119157,-66903,0,0,14310,0,0,,14310,14310
44,10/28/2017,41,10:00,10:15,31,33.46,0,33.46,33.46,-1,-60852,80096,140948,19244,0,-72,4266,0,0,,4338,4194
44,10/28/2017,42,10:15,10:30,55,33.46,0,55,32.04,2,-65492,51731,117223,-13761,0,-191,6161,0,0,,6352,5970
44,10/28/2017,43,10:30,10:45,31.01,30.36,0,32.04,30.36,2,-52703,57056,109759,4353,0,-588,1771,0,0,,2359,1183
44,10/28/2017,44,10:45,11:00,31.01,,0,31.01,31.01,1,-47486,49020,96506,1534,0,0,360,0,0,,360,360
44,10/28/2017,45,11:00,11:15,85.03,,0,85.03,85.03,1,-74087,34774,108861,-39313,0,0,11937,0,0,,11937,11937
44,10/28/2017,46,11:15,11:30,39.46,,0,39.46,39.46,1,-71684,39469,111153,-32215,0,0,27383,0,0,,27383,27383
44,10/28/2017,47,11:30,11:45,54.12,,0,54.12,54.12,1,-77798,26644,104442,-51154,0,0,30834,0,0,,30834,30834
44,10/28/2017,48,11:45,12:00,54.12,,0,54.12,54.12,1,-82744,29688,112432,-53056,0,0,34356,0,0,,34356,34356
44,10/28/2017,49,12:00,12:15,196.67,,0,196.67,196.67,1,-102307,38733,141040,-63574,0,0,55820,0,0,,55820,55820
44,10/28/2017,50,12:15,12:30,50.12,18.46,0,18.46,18.46,-1,-47890,32474,80364,-15416,0,-1385,28243,0,0,,29628,26858
44,10/28/2017,51,12:30,12:45,36.1,18.46,0,36.1,18.46,2,-44887,30532,75419,-14355,0,-1957,1057,0,0,,3014,-900
44,10/28/2017,52,12:45,13:00,39.46,,0,39.46,39.46,1,-57775,34866,92641,-22909,0,0,3087,0,0,,3087,3087
44,10/28/2017,53,13:00,13:15,39.46,29.78,0,29.78,29.78,-1,-40919,60955,101874,20036,0,-2517,340,0,0,,2857,-2177
44,10/28/2017,54,13:15,13:30,30.15,29.78,0,30.15,30.15,1,-37135,30775,67910,-6360,0,-6,29,0,0,,35,23
44,10/28/2017,55,13:30,13:45,,,0,31.8,31.8,0,-54640,36836,91476,-17804,0,0,0,0,0,,0,0
44,10/28/2017,56,13:45,14:00,,,0,31.82,31.82,0,-73353,35214,108567,-38139,0,0,0,0,0,,0,0
44,10/28/2017,57,14:00,14:15,,,0,31.76,31.76,0,-40976,31643,72619,-9333,0,0,0,0,0,,0,0
44,10/28/2017,58,14:15,14:30,35.46,,0,35.46,35.46,1,-56407,36023,92430,-20384,0,0,586,0,0,,586,586
44,10/28/2017,59,14:30,14:45,39.46,,0,39.46,39.46,1,-58100,33032,91132,-25068,0,0,1348,0,0,,1348,1348
44,10/28/2017,60,14:45,15:00,,,0,31.76,31.76,0,-70926,22547,93473,-48379,0,0,201,0,0,,201,201
44,10/28/2017,61,15:00,15:15,79.96,,0,79.96,79.96,1,-78593,52374,130967,-26219,0,0,10788,0,0,,10788,10788
44,10/28/2017,62,15:15,15:30,124.49,,0,124.49,124.49,1,-104013,56090,160103,-47923,0,0,53634,0,0,,53634,53634
44,10/28/2017,63,15:30,15:45,124.49,27.25,0,27.25,27.25,-1,-79915,82109,162024,2194,0,-1093,14938,0,0,,16031,13845
44,10/28/2017,64,15:45,16:00,48.72,,0,48.72,48.72,1,-95421,69635,165056,-25786,0,0,6218,0,0,,6218,6218
44,10/28/2017,65,16:00,16:15,35.46,32.46,0,32.46,32.46,-1,-89353,77752,167105,-11601,0,-143,11248,0,0,,11391,11105
44,10/28/2017,66,16:15,16:30,33.9,28.97,0,33.9,28.97,2,-78369,74092,152461,-4277,0,-1050,916,0,0,,1966,-134
44,10/28/2017,67,16:30,16:45,75.84,,0,75.84,75.84,1,-107050,72771,179821,-34279,0,0,24165,0,0,,24165,24165
44,10/28/2017,68,16:45,17:00,76.36,,0,76.36,76.36,1,-119734,72511,192245,-47223,0,0,48274,0,0,,48274,48274
44,10/28/2017,69,17:00,17:15,45.75,,0,45.75,45.75,1,-127388,50870,178258,-76518,0,0,27634,0,0,,27634,27634
44,10/28/2017,70,17:15,17:30,55.83,,0,55.83,55.83,1,-120951,52853,173804,-68098,0,0,20148,0,0,,20148,20148
44,10/28/2017,71,17:30,17:45,95.12,,0,95.12,95.12,1,-136295,64018,200313,-72277,0,0,46435,0,0,,46435,46435
44,10/28/2017,72,17:45,18:00,118.12,,0,118.12,118.12,1,-141578,77749,219327,-63829,0,0,60535,0,0,,60535,60535
44,10/28/2017,73,18:00,18:15,,,0,32.04,32.04,0,-87136,47780,134916,-39356,0,0,23000,0,0,,23000,23000
44,10/28/2017,74,18:15,18:30,,28.46,0,28.46,28.46,-1,-86634,77651,164285,-8983,0,-33,0,0,0,,33,-33
44,10/28/2017,75,18:30,18:45,,29.77,0,29.77,29.77,-1,-72229,92008,164237,19779,0,-1925,0,0,0,,1925,-1925
44,10/28/2017,76,18:45,19:00,,,0,32.06,32.06,0,-55714,119176,174890,63462,0,-60,0,0,0,,60,-60
44,10/28/2017,77,19:00,19:15,,28.46,0,28.46,28.46,-1,-63524,82494,146018,18970,0,-4013,0,0,0,,4013,-4013
44,10/28/2017,78,19:15,19:30,,16.98,0,16.98,16.98,-1,-33739,74679,108418,40940,0,-26501,0,0,0,,26501,-26501
44,10/28/2017,79,19:30,19:45,,11.56,0,11.56,11.56,-1,-22512,61096,83608,38584,0,-36725,0,0,0,,36725,-36725
44,10/28/2017,80,19:45,20:00,,5.55,0,5.55,5.55,-1,-21291,63492,84783,42201,0,-52027,0,0,0,,52027,-52027
44,10/28/2017,81,20:00,20:15,34.85,28.46,0,34.85,28.46,2,-39729,48589,88318,8860,0,-16359,762,0,0,,17121,-15597
44,10/28/2017,82,20:15,20:30,,11.71,0,11.71,11.71,-1,-32689,54187,86876,21498,0,-19681,0,0,0,,19681,-19681
44,10/28/2017,83,20:30,20:45,,1.11,0,1.11,1.11,-1,-26498,67073,93571,40575,0,-10845,0,0,0,,10845,-10845
44,10/28/2017,84,20:45,21:00,,1.83,0,1.83,1.83,-1,-22596,58354,80950,35758,0,-34196,0,0,0,,34196,-34196
44,10/28/2017,85,21:00,21:15,,3.47,0,3.47,3.47,-1,-7947,98656,106603,90709,0,-40450,0,0,0,,40450,-40450
44,10/28/2017,86,21:15,21:30,,7.25,0,7.25,7.25,-1,-16128,53232,69360,37104,0,-34040,0,0,0,,34040,-34040
44,10/28/2017,87,21:30,21:45,,22.47,0,22.47,22.47,-1,-12584,59724,72308,47140,0,-36875,0,0,0,,36875,-36875
44,10/28/2017,88,21:45,22:00,,23.88,0,23.88,23.88,-1,-26382,81596,107978,55214,0,-41114,0,0,0,,41114,-41114
44,10/28/2017,89,22:00,22:15,39.46,28.46,0,39.46,28.46,2,-37307,30398,67705,-6909,0,-18358,621,0,0,,18979,-17737
44,10/28/2017,90,22:15,22:30,39.46,33.46,0,33.46,33.46,-1,-35696,32853,68549,-2843,0,-17,2,0,0,,19,-15
44,10/28/2017,91,22:30,22:45,,30.56,0,30.56,30.56,-1,-36307,49101,85408,12794,0,-1779,0,0,0,,1779,-1779
44,10/28/2017,92,22:45,23:00,,28.71,0,28.71,28.71,-1,-62153,61873,124026,-280,0,-5493,0,0,0,,5493,-5493
44,10/28/2017,93,23:00,23:15,,29.87,0,29.87,29.87,-1,-54238,57177,111415,2939,0,-1703,0,0,0,,1703,-1703
44,10/28/2017,94,23:15,23:30,,30.48,0,30.48,30.48,-1,-64584,62693,127277,-1891,0,-166,0,0,0,,166,-166
44,10/28/2017,95,23:30,23:45,,22.11,0,22.11,22.11,-1,-48527,79265,127792,30738,0,-17553,0,0,0,,17553,-17553
44,10/28/2017,96,23:45,0:00,,27.28,0,27.28,27.28,-1,-76523,100471,176994,23948,0,-28944,0,0,0,,28944,-28944
44,10/29/2017,1,0:00,0:15,39.46,27.28,0,39.46,39.46,1,-61775,38535,100310,-23240,0,-5189,5862,0,0,,11051,673
44,10/29/2017,2,0:15,0:30,31.91,28.46,0,28.46,28.46,-1,-48359,35454,83813,-12905,0,-642,4588,0,0,,5230,3946
44,10/29/2017,3,0:30,0:45,31.91,24.65,0,24.65,24.65,-1,-42049,53949,95998,11900,0,-4913,114,0,0,,5027,-4799
44,10/29/2017,4,0:45,1:00,,7.85,0,7.85,7.85,-1,-44109,75702,119811,31593,0,-37088,0,0,0,,37088,-37088
44,10/29/2017,5,1:00,1:15,53.17,24.83,0,53.17,53.17,1,-55567,37312,92879,-18255,0,-17582,2734,0,0,,20316,-14848
44,10/29/2017,6,1:15,1:30,60.29,28.32,0,60.29,28.32,2,-72758,39387,112145,-33371,0,-187,16279,0,0,,16466,16092
44,10/29/2017,7,1:30,1:45,60.29,28.03,0,28.03,28.03,-1,-52798,58615,111413,5817,0,-932,165,0,0,,1097,-767
44,10/29/2017,8,1:45,2:00,,24.83,0,24.83,24.83,-1,-55290,72008,127298,16718,0,-9050,0,0,0,,9050,-9050
44,10/29/2017,9,2:00,2:15,35.46,30.46,0,35.46,30.46,2,-73513,73654,147167,141,0,-3924,60,0,0,,3984,-3864
44,10/29/2017,10,2:15,2:30,121.55,30.46,0,121.55,121.55,1,-117379,51807,169186,-65572,0,-167,39626,0,0,,39793,39459
44,10/29/2017,11,2:30,2:45,121.55,,0,121.55,121.55,1,-93686,68808,162494,-24878,0,0,47787,0,0,,47787,47787
44,10/29/2017,12,2:45,2:00,39.46,22.17,0,39.46,22.17,2,-87892,89030,176922,1138,0,-1443,3826,0,0,,5269,2383
44,10/29/2017,13,2:00,2:15,,-12.39,0,-12.39,-12.39,-1,-113144,139524,252668,26380,0,-23464,0,0,0,,23464,-23464
44,10/29/2017,14,2:15,2:30,,19.72,0,19.72,19.72,-1,-96349,110876,207225,14527,0,-17023,0,0,0,,17023,-17023
44,10/29/2017,15,2:30,2:45,31.91,19.49,0,31.91,19.49,2,-101203,120580,221783,19377,0,-12249,211,0,0,,12460,-12038
44,10/29/2017,16,2:45,3:00,44.82,-74.39,0,44.82,-74.39,2,-79517,90432,169949,10915,0,-23058,786,0,0,,23844,-22272
44,10/29/2017,17,3:00,3:15,44.82,-80.67,0,-80.67,-80.67,-1,-66214,135501,201715,69287,0,-31117,78,0,0,,31195,-31039
44,10/29/2017,18,3:15,3:30,,-3.67,0,-3.67,-3.67,-1,-78391,97094,175485,18703,0,-34672,0,0,0,,34672,-34672
44,10/29/2017,19,3:30,3:45,,-75.06,0,-75.06,-75.06,-1,-76225,101069,177294,24844,0,-15926,0,0,0,,15926,-15926
44,10/29/2017,20,3:45,4:00,,-80.67,0,-80.67,-80.67,-1,-69893,100103,169996,30210,0,-16466,0,0,0,,16466,-16466
44,10/29/2017,21,4:00,4:15,52.46,31.06,0,52.46,30.84,2,-87522,45435,132957,-42087,0,-4450,10458,0,0,,14908,6008
44,10/29/2017,22,4:15,4:30,69.33,,0,69.33,69.33,1,-111908,61391,173299,-50517,0,0,12835,0,0,,12835,12835
44,10/29/2017,23,4:30,4:45,94.02,,0,94.02,94.02,1,-128771,63897,192668,-64874,0,0,45148,0,0,,45148,45148
44,10/29/2017,24,4:45,5:00,39.46,31.06,0,31.06,31.06,-1,-107654,74233,181887,-33421,0,-43,25305,0,0,,25348,25262
44,10/29/2017,25,5:00,5:15,39.46,-17.24,0,-17.24,-17.24,-1,-71599,110122,181721,38523,0,-6569,1035,0,0,,7604,-5534
44,10/29/2017,26,5:15,5:30,,-30.72,0,-30.72,-30.72,-1,-53829,78510,132339,24681,0,-31154,0,0,0,,31154,-31154
44,10/29/2017,27,5:30,5:45,,22.76,0,22.76,22.76,-1,-42579,69004,111583,26425,0,-15947,0,0,0,,15947,-15947
44,10/29/2017,28,5:45,6:00,31.91,-2.24,0,31.91,-2.24,2,-37711,66873,104584,29162,0,-26230,11,0,0,,26241,-26219
44,10/29/2017,29,6:00,6:15,51.9,30.9,0,51.9,30.89,2,-73153,55583,128736,-17570,0,-5000,6916,0,0,,11916,1916
44,10/29/2017,30,6:15,6:30,51.9,30.9,0,30.9,30.9,-1,-74331,60077,134408,-14254,0,-421,1,0,0,,422,-420
44,10/29/2017,31,6:30,6:45,51.9,,0,51.9,51.9,1,-80563,52900,133463,-27663,0,0,14471,0,0,,14471,14471
44,10/29/2017,32,6:45,7:00,37.23,,0,37.23,37.23,1,-60016,59834,119850,-182,0,0,17941,0,0,,17941,17941
44,10/29/2017,33,7:00,7:15,37.23,30.12,0,30.12,30.12,-1,-56955,113446,170401,56491,0,-1244,3468,0,0,,4712,2224
44,10/29/2017,34,7:15,7:30,,30.9,0,30.9,30.9,-1,-32454,130320,162774,97866,0,-184,0,0,0,,184,-184
44,10/29/2017,35,7:30,7:45,,,0,38.21,38.21,0,-58972,142146,201118,83174,0,0,0,0,0,,0,0
44,10/29/2017,36,7:45,8:00,,,0,38.21,38.21,0,-68509,171436,239945,102927,0,0,0,0,0,,0,0
44,10/29/2017,37,8:00,8:15,70.66,29.3,0,70.66,29.3,2,-120510,56304,176814,-64206,0,-383,5754,0,0,,6137,5371
44,10/29/2017,38,8:15,8:30,115.89,,0,115.89,115.89,1,-101868,37832,139700,-64036,0,0,47805,0,0,,47805,47805
44,10/29/2017,39,8:30,8:45,82.65,,0,82.65,82.65,1,-78828,22401,101229,-56427,0,0,59131,0,0,,59131,59131
44,10/29/2017,40,8:45,9:00,51.9,,0,51.9,51.9,1,-69147,23712,92859,-45435,0,0,48952,0,0,,48952,48952
44,10/29/2017,41,9:00,9:15,,,0,31.12,31.12,0,-57669,70906,128575,13237,0,0,11820,0,0,,11820,11820
44,10/29/2017,42,9:15,9:30,35.9,,0,35.9,35.9,1,-61643,48293,109936,-13350,0,0,1031,0,0,,1031,1031
44,10/29/2017,43,9:30,9:45,30.62,,0,30.62,30.62,1,-61801,42984,104785,-18817,0,0,135,0,0,,135,135
44,10/29/2017,44,9:45,10:00,39.9,,0,39.9,39.9,1,-62515,36940,99455,-25575,0,0,3634,0,0,,3634,3634
44,10/29/2017,45,10:00,10:15,50,29.89,0,50,29.89,2,-80276,65022,145298,-15254,0,-34,9283,0,0,,9317,9249
44,10/29/2017,46,10:15,10:30,33.62,-19.45,0,33.62,-19.45,2,-47906,67843,115749,19937,0,-22367,995,0,0,,23362,-21372
44,10/29/2017,47,10:30,10:45,34.95,15.04,0,34.95,15.04,2,-49334,72795,122129,23461,0,-9008,274,0,0,,9282,-8734
44,10/29/2017,48,10:45,11:00,,5.73,0,5.73,5.73,-1,-57574,76709,134283,19135,0,-19353,0,0,0,,19353,-19353
44,10/29/2017,49,11:00,11:15,,-73.76,0,-73.76,-73.76,-1,-49067,116451,165518,67384,0,-35460,0,0,0,,35460,-35460
44,10/29/2017,50,11:15,11:30,,-73.76,0,-73.76,-73.76,-1,-71407,100630,172037,29223,0,-33302,0,0,0,,33302,-33302
44,10/29/2017,51,11:30,11:45,31.91,-73.76,0,31.91,-73.76,2,-39070,108748,147818,69678,0,-19431,125,0,0,,19556,-19306
44,10/29/2017,52,11:45,12:00,44.55,-73.76,0,44.55,-73.76,2,-73044,76524,149568,3480,0,-23308,1731,0,0,,25039,-21577
44,10/29/2017,53,12:00,12:15,,16,0,16,16,-1,-53560,79319,132879,25759,0,-10635,0,0,0,,10635,-10635
44,10/29/2017,54,12:15,12:30,,3.58,0,3.58,3.58,-1,-44608,74697,119305,30089,0,-30731,0,0,0,,30731,-30731
44,10/29/2017,55,12:30,12:45,,24.65,0,24.65,24.65,-1,-52155,80596,132751,28441,0,-28294,0,0,0,,28294,-28294
44,10/29/2017,56,12:45,13:00,,9.57,0,9.57,9.57,-1,-48860,91738,140598,42878,0,-23041,0,0,0,,23041,-23041
44,10/29/2017,57,13:00,13:15,48.8,-17.43,0,48.8,-17.43,2,-76829,73185,150014,-3644,0,-41279,637,0,0,,41916,-40642
44,10/29/2017,58,13:15,13:30,45.02,18.9,0,45.02,18.9,2,-51241,68907,120148,17666,0,-8623,1422,0,0,,10045,-7201
44,10/29/2017,59,13:30,13:45,,26.16,0,26.16,26.16,-1,-44684,70278,114962,25594,0,-24698,0,0,0,,24698,-24698
44,10/29/2017,60,13:45,14:00,,18.9,0,18.9,18.9,-1,-47433,80387,127820,32954,0,-29040,0,0,0,,29040,-29040
44,10/29/2017,61,14:00,14:15,,28.3,0,28.3,28.3,-1,-53405,69620,123025,16215,0,-15506,0,0,0,,15506,-15506
44,10/29/2017,62,14:15,14:30,,22.17,0,22.17,22.17,-1,-51894,72651,124545,20757,0,-16456,0,0,0,,16456,-16456
44,10/29/2017,63,14:30,14:45,,28.29,0,28.29,28.29,-1,-55647,75518,131165,19871,0,-17163,0,0,0,,17163,-17163
44,10/29/2017,64,14:45,15:00,73.85,28.29,0,73.85,73.85,1,-89040,52558,141598,-36482,0,-4734,11679,0,0,,16413,6945
44,10/29/2017,65,15:00,15:15,39.9,24.65,0,39.9,24.65,2,-72190,82289,154479,10099,0,-2862,8025,0,0,,10887,5163
44,10/29/2017,66,15:15,15:30,,31.76,0,31.76,31.76,-1,-66761,63424,130185,-3337,0,-242,0,0,0,,242,-242
44,10/29/2017,67,15:30,15:45,35.9,,0,35.9,35.9,1,-94789,53775,148564,-41014,0,0,151,0,0,,151,151
44,10/29/2017,68,15:45,16:00,51.9,,0,51.9,51.9,1,-115341,73345,188686,-41996,0,0,15100,0,0,,15100,15100
44,10/29/2017,69,16:00,16:15,76.37,,0,76.37,76.37,1,-94276,44933,139209,-49343,0,0,32475,0,0,,32475,32475
44,10/29/2017,70,16:15,16:30,39.9,29.37,0,29.37,29.37,-1,-60873,60119,120992,-754,0,-591,17367,0,0,,17958,16776
44,10/29/2017,71,16:30,16:45,35.9,29.37,0,35.9,35.9,1,-60445,58267,118712,-2178,0,-449,758,0,0,,1207,309
44,10/29/2017,72,16:45,17:00,132.02,,0,132.02,132.02,1,-131594,54416,186010,-77178,0,0,26049,0,0,,26049,26049
44,10/29/2017,73,17:00,17:15,132.02,-38.88,0,-38.88,-38.88,-1,-46158,96820,142978,50662,0,-14589,9024,0,0,,23613,-5565
44,10/29/2017,74,17:15,17:30,31.01,-38.88,0,31.01,31.01,1,-45842,46216,92058,374,0,-1111,233,0,0,,1344,-878
44,10/29/2017,75,17:30,17:45,257.9,,0,257.9,257.9,1,-105845,54824,160669,-51021,0,0,20778,0,0,,20778,20778
44,10/29/2017,76,17:45,18:00,53,,0,53,53,1,-107152,77576,184728,-29576,0,0,40451,0,0,,40451,40451
44,10/29/2017,77,18:00,18:15,73.74,29.35,0,29.35,29.35,-1,-81017,57451,138468,-23566,0,-157,26009,0,0,,26166,25852
44,10/29/2017,78,18:15,18:30,35.9,28.3,0,38.17,28.3,2,-71223,70111,141334,-1112,0,-316,422,0,0,,738,106
44,10/29/2017,79,18:30,18:45,35.9,28.3,0,28.3,28.3,-1,-59093,82663,141756,23570,0,-3849,23,0,0,,3872,-3826
44,10/29/2017,80,18:45,19:00,,28.29,0,28.29,28.29,-1,-61174,76066,137240,14892,0,-10750,0,0,0,,10750,-10750
44,10/29/2017,81,19:00,19:15,,-26.3,0,-26.3,-26.3,-1,-41261,89855,131116,48594,0,-25615,0,0,0,,25615,-25615
44,10/29/2017,82,19:15,19:30,452.81,43.85,0,452.81,38.16,2,-74991,41440,116431,-33551,0,-5112,11923,0,0,,17035,6811
44,10/29/2017,83,19:30,19:45,452.81,-7.97,0,-7.97,-7.97,-1,-26172,84841,111013,58669,0,-30144,771,0,0,,30915,-29373
44,10/29/2017,84,19:45,20:00,,28.3,0,28.3,28.3,-1,-33976,53823,87799,19847,0,-28747,0,0,0,,28747,-28747
44,10/29/2017,85,20:00,20:15,38.75,28.29,0,38.75,28.29,2,-61433,76648,138081,15215,0,-6441,1744,0,0,,8185,-4697
44,10/29/2017,86,20:15,20:30,,15.61,0,15.61,15.61,-1,-28820,67669,96489,38849,0,-14959,0,0,0,,14959,-14959
44,10/29/2017,87,20:30,20:45,,2.19,0,2.19,2.19,-1,-14251,82498,96749,68247,0,-47658,0,0,0,,47658,-47658
44,10/29/2017,88,20:45,21:00,,6.8,0,6.8,6.8,-1,-23391,88170,111561,64779,0,-55820,0,0,0,,55820,-55820
44,10/29/2017,89,21:00,21:15,89.02,30.46,0,89.02,30.46,2,-60002,46567,106569,-13435,0,-12146,4047,0,0,,16193,-8099
44,10/29/2017,90,21:15,21:30,,29.3,0,29.3,29.3,-1,-45447,46639,92086,1192,0,-509,0,0,0,,509,-509
44,10/29/2017,91,21:30,21:45,,22.36,0,22.36,22.36,-1,-33383,62915,96298,29532,0,-9734,0,0,0,,9734,-9734
44,10/29/2017,92,21:45,22:00,,26.6,0,26.6,26.6,-1,-28267,73350,101617,45083,0,-5423,0,0,0,,5423,-5423
44,10/29/2017,93,22:00,22:15,,20.03,0,20.03,20.03,-1,-37227,106527,143754,69300,0,-3564,0,0,0,,3564,-3564
44,10/29/2017,94,22:15,22:30,,7.15,0,7.15,7.15,-1,-50338,94087,144425,43749,0,-31274,0,0,0,,31274,-31274
44,10/29/2017,95,22:30,22:45,,7.15,0,7.15,7.15,-1,-18515,101603,120118,83088,0,-53362,0,0,0,,53362,-53362
44,10/29/2017,96,22:45,23:00,,-42.89,0,-42.89,-42.89,-1,-31488,155404,186892,123916,0,-45664,0,0,0,,45664,-45664
44,10/29/2017,97,23:00,23:15,86.02,-68,0,86.02,-68,2,-71669,59801,131470,-11868,0,-41084,3183,0,0,,44267,-37901
44,10/29/2017,98,23:15,23:30,140.68,28.3,0,140.68,28.3,2,-48845,31586,80431,-17259,0,-1526,22615,0,0,,24141,21089
44,10/29/2017,99,23:30,23:45,140.68,17,0,17,17,-1,-40099,62693,102792,22594,0,-4922,346,0,0,,5268,-4576
44,10/29/2017,100,23:45,0:00,32.72,17,0,32.72,32.72,1,-46017,55224,101241,9207,0,-8362,25,0,0,,8387,-8337
44,10/30/2017,1,0:00,0:15,78.89,,0,78.89,78.89,1,-95275,49975,145250,-45300,0,0,17750,0,0,,17750,17750
44,10/30/2017,2,0:15,0:30,44.43,44.19,0,44.19,44.19,-1,-51944,34063,86007,-17881,0,-56,15385,0,0,,15441,15329
44,10/30/2017,3,0:30,0:45,63.07,44.19,0,63.07,63.07,1,-83561,47146,130707,-36415,0,-4,11636,0,0,,11640,11632
44,10/30/2017,4,0:45,1:00,40.52,,0,40.52,40.52,1,-84772,50112,134884,-34660,0,0,14904,0,0,,14904,14904
44,10/30/2017,5,1:00,1:15,31.01,28.5,0,37.4,28.5,2,-51505,69293,120798,17788,0,-1900,6221,0,0,,8121,4321
44,10/30/2017,6,1:15,1:30,32.57,28.5,0,37.4,28.5,2,-61188,59175,120363,-2013,0,-989,244,0,0,,1233,-745
44,10/30/2017,7,1:30,1:45,35.17,28.04,0,37.4,28.04,2,-49563,48965,98528,-598,0,-4124,495,0,0,,4619,-3629
44,10/30/2017,8,1:45,2:00,38.81,,0,38.81,38.81,1,-74415,48186,122601,-26229,0,0,4090,0,0,,4090,4090
44,10/30/2017,9,2:00,2:15,35.9,,0,35.9,35.9,1,-87767,66622,154389,-21145,0,0,1527,0,0,,1527,1527
44,10/30/2017,10,2:15,2:30,34.28,,0,34.28,34.28,1,-69308,66994,136302,-2314,0,0,2365,0,0,,2365,2365
44,10/30/2017,11,2:30,2:45,39.9,,0,39.9,39.9,1,-77355,56088,133443,-21267,0,0,6601,0,0,,6601,6601
44,10/30/2017,12,2:45,3:00,30.62,33.9,0,37.4,33.9,2,-55967,53920,109887,-2047,0,-334,3039,0,0,,3373,2705
44,10/30/2017,13,3:00,3:15,140.68,33.9,0,140.68,140.68,1,-103788,51126,154914,-52662,0,-64,19186,0,0,,19250,19122
44,10/30/2017,14,3:15,3:30,45.9,31.68,0,31.68,31.68,-1,-75602,73213,148815,-2389,0,-196,22001,0,0,,22197,21805
44,10/30/2017,15,3:30,3:45,45.9,30.22,0,30.22,30.22,-1,-58377,78500,136877,20123,0,-356,277,0,0,,633,-79
44,10/30/2017,16,3:45,4:00,,8.52,0,8.52,8.52,-1,-48667,87394,136061,38727,0,-14826,0,0,0,,14826,-14826
44,10/30/2017,17,4:00,4:15,,28.9,0,28.9,28.9,-1,-52394,62988,115382,10594,0,-4047,0,0,0,,4047,-4047
44,10/30/2017,18,4:15,4:30,,28.9,0,28.9,28.9,-1,-50594,62212,112806,11618,0,-6061,0,0,0,,6061,-6061
44,10/30/2017,19,4:30,4:45,,32.9,0,32.9,32.9,-1,-56917,59555,116472,2638,0,-1744,0,0,0,,1744,-1744
44,10/30/2017,20,4:45,5:00,,27.83,0,27.83,27.83,-1,-66439,87755,154194,21316,0,-3322,0,0,0,,3322,-3322
44,10/30/2017,21,5:00,5:15,45.9,32.9,0,45.9,45.9,1,-78275,59109,137384,-19166,0,-2939,2042,0,0,,4981,-897
44,10/30/2017,22,5:15,5:30,51.9,,0,51.9,51.9,1,-56255,61316,117571,5061,0,0,4141,0,0,,4141,4141
44,10/30/2017,23,5:30,5:45,,,0,37.7,37.7,0,-58970,70763,129733,11793,0,0,0,0,0,,0,0
44,10/30/2017,24,5:45,6:00,,33.9,0,33.9,33.9,-1,-48417,68249,116666,19832,0,-4,0,0,0,,4,-4
44,10/30/2017,25,6:00,6:15,31.23,32.9,0,37.72,32.9,2,-92028,74565,166593,-17463,0,-816,27,0,0,,843,-789
44,10/30/2017,26,6:15,6:30,39.9,,0,39.9,39.9,1,-69369,59097,128466,-10272,0,0,3236,0,0,,3236,3236
44,10/30/2017,27,6:30,6:45,107.12,,0,107.12,107.12,1,-86899,37382,124281,-49517,0,0,35815,0,0,,35815,35815
44,10/30/2017,28,6:45,7:00,407.86,,0,407.86,407.86,1,-159035,58239,217274,-100796,0,0,52445,0,0,,52445,52445
44,10/30/2017,29,7:00,7:15,42.43,7.19,0,42.43,7.19,2,-67135,99300,166435,32165,0,-4893,22251,0,0,,27144,17358
44,10/30/2017,30,7:15,7:30,,17.9,0,17.9,17.9,-1,-93766,114289,208055,20523,0,-3133,0,0,0,,3133,-3133
44,10/30/2017,31,7:30,7:45,42.43,3.77,0,42.43,3.77,2,-110754,102460,213214,-8294,0,-19974,425,0,0,,20399,-19549
44,10/30/2017,32,7:45,8:00,75.96,3.77,0,75.96,75.96,1,-118727,89683,208410,-29044,0,-67,24406,0,0,,24473,24339
44,10/30/2017,33,8:00,8:15,75.96,29.27,0,29.27,29.27,-1,-89306,103747,193053,14441,0,-381,2188,0,0,,2569,1807
44,10/30/2017,34,8:15,8:30,,26.47,0,26.47,26.47,-1,-74146,92028,166174,17882,0,-4171,0,0,0,,4171,-4171
44,10/30/2017,35,8:30,8:45,77.12,26.47,0,77.12,77.12,1,-102277,61052,163329,-41225,0,-212,6392,0,0,,6604,6180
44,10/30/2017,36,8:45,9:00,124.6,28.27,0,124.6,28.27,2,-101542,107116,208658,5574,0,-1012,14532,0,0,,15544,13520
44,10/30/2017,37,9:00,9:15,134.12,28.27,0,134.12,134.12,1,-184333,106733,291066,-77600,0,-220,18241,0,0,,18461,18021
44,10/30/2017,38,9:15,9:30,35.27,30.46,0,37.7,30.46,2,-166958,149554,316512,-17404,0,-267,3318,0,0,,3585,3051
44,10/30/2017,39,9:30,9:45,35.39,,0,35.39,35.39,1,-166560,124085,290645,-42475,0,0,2787,0,0,,2787,2787
44,10/30/2017,40,9:45,10:00,43.4,,0,43.4,43.4,1,-166071,132565,298636,-33506,0,0,15481,0,0,,15481,15481
44,10/30/2017,41,10:00,10:15,43.4,-63.67,0,-63.67,-63.67,-1,-13993,173437,187430,159444,0,-43564,1212,0,0,,44776,-42352
44,10/30/2017,42,10:15,10:30,,-63.67,0,-63.67,-63.67,-1,-61602,133468,195070,71866,0,-83275,0,0,0,,83275,-83275
44,10/30/2017,43,10:30,10:45,,-63.67,0,-63.67,-63.67,-1,-53604,155087,208691,101483,0,-62336,0,0,0,,62336,-62336
44,10/30/2017,44,10:45,11:00,,0.88,0,0.88,0.88,-1,-71355,161624,232979,90269,0,-80711,0,0,0,,80711,-80711
44,10/30/2017,45,11:00,11:15,,-0.54,0,-0.54,-0.54,-1,-88045,143728,231773,55683,0,-70370,0,0,0,,70370,-70370
44,10/30/2017,46,11:15,11:30,,12.29,0,12.29,12.29,-1,-68948,130547,199495,61599,0,-61242,0,0,0,,61242,-61242
44,10/30/2017,47,11:30,11:45,,-17.78,0,-17.78,-17.78,-1,-72591,146306,218897,73715,-5000,-63228,0,0,0,,68228,-68228
44,10/30/2017,48,11:45,12:00,31.27,-65.78,0,31.27,31.27,1,-81892,116308,198200,34416,-17500,-36327,52,0,0,,53879,-53775
44,10/30/2017,49,12:00,12:15,31.58,28.27,0,37.72,28.27,2,-97049,96726,193775,-323,0,-1685,56,0,0,,1741,-1629
44,10/30/2017,50,12:15,12:30,,-34.2,0,-34.2,-34.2,-1,-68468,126881,195349,58413,0,-40853,0,0,0,,40853,-40853
44,10/30/2017,51,12:30,12:45,,21.36,0,21.36,21.36,-1,-97137,127839,224976,30702,0,-44154,0,0,0,,44154,-44154
44,10/30/2017,52,12:45,13:00,38.09,23.46,0,38.09,23.46,2,-137768,152469,290237,14701,0,-10076,1182,0,0,,11258,-8894
44,10/30/2017,53,13:00,13:15,,-5.28,0,-5.28,-5.28,-1,-64402,105481,169883,41079,0,-30874,0,0,0,,30874,-30874
44,10/30/2017,54,13:15,13:30,,20.51,0,20.51,20.51,-1,-69292,98897,168189,29605,0,-24842,0,0,0,,24842,-24842
44,10/30/2017,55,13:30,13:45,31.91,43.81,0,37.72,37.72,2,-100192,98753,198945,-1439,0,-7489,928,0,0,,8417,-6561
44,10/30/2017,56,13:45,14:00,,40.68,0,40.68,40.68,-1,-102589,104423,207012,1834,0,-639,0,0,0,,639,-639
44,10/30/2017,57,14:00,14:15,,16.78,0,16.78,16.78,-1,-63666,106395,170061,42729,0,-19109,0,0,0,,19109,-19109
44,10/30/2017,58,14:15,14:30,,29.27,0,29.27,29.27,-1,-77597,105968,183565,28371,0,-22880,0,0,0,,22880,-22880
44,10/30/2017,59,14:30,14:45,31.27,42.66,0,37.72,37.72,2,-91314,108413,199727,17099,0,-4805,301,0,0,,5106,-4504
44,10/30/2017,60,14:45,15:00,39.84,42.73,0,39.84,37.72,2,-91690,81594,173284,-10096,0,-200,839,0,0,,1039,639
44,10/30/2017,61,15:00,15:15,39.93,28.27,0,39.93,28.27,2,-70016,108796,178812,38780,0,-3479,1578,0,0,,5057,-1901
44,10/30/2017,62,15:15,15:30,35.27,31.59,0,35.27,35.27,1,-72711,91602,164313,18891,0,-5082,316,0,0,,5398,-4766
44,10/30/2017,63,15:30,15:45,51.8,31.59,0,51.8,51.8,1,-85442,77087,162529,-8355,0,-79,11881,0,0,,11960,11802
44,10/30/2017,64,15:45,16:00,57.8,,0,57.8,57.8,1,-103419,86310,189729,-17109,0,0,23737,0,0,,23737,23737
44,10/30/2017,65,16:00,16:15,56.4,,0,56.4,56.4,1,-107956,96426,204382,-11530,0,0,19069,0,0,,19069,19069
44,10/30/2017,66,16:15,16:30,35.27,,0,35.27,35.27,1,-84624,77461,162085,-7163,0,0,14724,0,0,,14724,14724
44,10/30/2017,67,16:30,16:45,34.32,38.54,0,37.72,37.72,2,-85791,92730,178521,6939,0,-908,2217,0,0,,3125,1309
44,10/30/2017,68,16:45,17:00,49.07,,0,49.07,49.07,1,-105108,73572,178680,-31536,0,0,5334,0,0,,5334,5334
44,10/30/2017,69,17:00,17:15,49.07,-1.79,0,-1.79,-1.79,-1,-36587,165324,201911,128737,0,-18661,572,0,0,,19233,-18089
44,10/30/2017,70,17:15,17:30,,38.33,0,38.33,38.33,-1,-40128,110771,150899,70643,0,-4645,0,0,0,,4645,-4645
44,10/30/2017,71,17:30,17:45,407.69,,0,407.69,407.69,1,-91905,52894,144799,-39011,0,0,17650,0,0,,17650,17650
44,10/30/2017,72,17:45,18:00,67.16,35.08,0,35.08,35.08,-1,-76634,84675,161309,8041,0,-294,31049,0,0,,31343,30755
44,10/30/2017,73,18:00,18:15,383.22,31.62,0,383.22,31.62,2,-177180,48703,225883,-128477,0,-980,6352,0,0,,7332,5372
44,10/30/2017,74,18:15,18:30,383.22,,0,383.22,383.22,1,-130668,74059,204727,-56609,0,0,49010,0,0,,49010,49010
44,10/30/2017,75,18:30,18:45,383.22,31.62,0,31.62,31.62,-1,-95058,95892,190950,834,0,-609,6215,0,0,,6824,5606
44,10/30/2017,76,18:45,19:00,,42.47,0,42.47,42.47,-1,-97518,115189,212707,17671,0,-222,0,0,0,,222,-222
44,10/30/2017,77,19:00,19:15,124.92,41.27,0,124.92,37.7,2,-137954,101053,239007,-36901,0,-325,12075,0,0,,12400,11750
44,10/30/2017,78,19:15,19:30,37.85,,0,37.85,37.85,1,-125233,96677,221910,-28556,0,0,18793,0,0,,18793,18793
44,10/30/2017,79,19:30,19:45,37.85,24.27,0,24.27,24.27,-1,-107659,122516,230175,14857,0,-7739,4277,0,0,,12016,-3462
44,10/30/2017,80,19:45,20:00,33.82,29.27,0,37.71,29.27,2,-108343,105903,214246,-2440,0,-14962,381,0,0,,15343,-14581
44,10/30/2017,81,20:00,20:15,32.35,-64.82,0,37.7,-64.82,2,-38947,127001,165948,88054,0,-20100,573,0,0,,20673,-19527
44,10/30/2017,82,20:15,20:30,36.88,-40.91,0,36.88,36.88,1,-49978,73960,123938,23982,0,-27407,433,0,0,,27840,-26974
44,10/30/2017,83,20:30,20:45,36.88,29.68,0,29.68,29.68,-1,-51970,69414,121384,17444,0,-549,292,0,0,,841,-257
44,10/30/2017,84,20:45,21:00,,21.66,0,21.66,21.66,-1,-50720,102716,153436,51996,0,-10857,0,0,0,,10857,-10857
44,10/30/2017,85,21:00,21:15,35.27,29.76,0,37.68,29.76,2,-101102,48255,149357,-52847,0,-7045,342,0,0,,7387,-6703
44,10/30/2017,86,21:15,21:30,,,0,37.7,37.7,0,-82721,49694,132415,-33027,0,0,0,0,0,,0,0
44,10/30/2017,87,21:30,21:45,,,0,37.71,37.71,0,-98384,89233,187617,-9151,0,0,0,0,0,,0,0
44,10/30/2017,88,21:45,22:00,,20.86,0,20.86,20.86,-1,-94824,137510,232334,42686,0,-3281,0,0,0,,3281,-3281
44,10/30/2017,89,22:00,22:15,234.5,-6.13,0,234.5,-6.13,2,-133528,64798,198326,-68730,0,-12410,9862,0,0,,22272,-2548
44,10/30/2017,90,22:15,22:30,234.5,,0,234.5,234.5,1,-105303,44079,149382,-61224,0,0,51902,0,0,,51902,51902
44,10/30/2017,91,22:30,22:45,234.5,-12.79,0,-12.79,-12.79,-1,-72801,121271,194072,48470,0,-23994,3474,0,0,,27468,-20520
44,10/30/2017,92,22:45,23:00,,0.18,0,0.18,0.18,-1,-78818,115065,193883,36247,0,-45892,0,0,0,,45892,-45892
44,10/30/2017,93,23:00,23:15,,-48.9,0,-48.9,-48.9,-1,-60470,117846,178316,57376,0,-40124,0,0,0,,40124,-40124
44,10/30/2017,94,23:15,23:30,,13.18,0,13.18,13.18,-1,-54129,88051,142180,33922,0,-5491,0,0,0,,5491,-5491
44,10/30/2017,95,23:30,23:45,,14.27,0,14.27,14.27,-1,-48924,80078,129002,31154,0,-22289,0,0,0,,22289,-22289
44,10/30/2017,96,23:45,0:00,,-26.56,0,-26.56,-26.56,-1,-41923,125106,167029,83183,0,-30437,0,0,0,,30437,-30437
44,10/31/2017,1,0:00,0:15,39.25,-38.99,0,40.22,-38.99,2,-45871,63862,109733,17991,0,-34576,579,0,0,,35155,-33997
44,10/31/2017,2,0:15,0:30,39.25,2.32,0,2.32,2.32,-1,-28492,70952,99444,42460,0,-17107,134,0,0,,17241,-16973
44,10/31/2017,3,0:30,0:45,,24.35,0,24.35,24.35,-1,-34181,69391,103572,35210,0,-36863,0,0,0,,36863,-36863
44,10/31/2017,4,0:45,1:00,,28.35,0,28.35,28.35,-1,-64558,90345,154903,25787,0,-17385,0,0,0,,17385,-17385
44,10/31/2017,5,1:00,1:15,350.02,29.35,0,350.02,350.02,1,-89226,49251,138477,-39975,0,-7811,13027,0,0,,20838,5216
44,10/31/2017,6,1:15,1:30,50.02,28.35,0,28.35,28.35,-1,-56625,55574,112199,-1051,0,-897,18485,0,0,,19382,17588
44,10/31/2017,7,1:30,1:45,50.02,28.35,0,28.35,28.35,-1,-45789,53993,99782,8204,0,-817,6,0,0,,823,-811
44,10/31/2017,8,1:45,2:00,,48.29,0,48.29,48.29,-1,-53997,61082,115079,7085,0,-164,0,0,0,,164,-164
44,10/31/2017,9,2:00,2:15,40.33,47.89,0,40.33,40.22,2,-82936,65060,147996,-17876,0,-270,3073,0,0,,3343,2803
44,10/31/2017,10,2:15,2:30,34.11,,0,34.11,34.11,1,-72649,59116,131765,-13533,0,0,2803,0,0,,2803,2803
44,10/31/2017,11,2:30,2:45,,31.17,0,31.17,31.17,-1,-64404,68443,132847,4039,0,-513,0,0,0,,513,-513
44,10/31/2017,12,2:45,3:00,,28.35,0,28.35,28.35,-1,-68821,80632,149453,11811,0,-3853,0,0,0,,3853,-3853
44,10/31/2017,13,3:00,3:15,,22.39,0,22.39,22.39,-1,-55025,101914,156939,46889,0,-5051,0,0,0,,5051,-5051
44,10/31/2017,14,3:15,3:30,,22.83,0,22.83,22.83,-1,-47940,107673,155613,59733,0,-9913,0,0,0,,9913,-9913
44,10/31/2017,15,3:30,3:45,,28.35,0,28.35,28.35,-1,-33736,100501,134237,66765,0,-16472,0,0,0,,16472,-16472
44,10/31/2017,16,3:45,4:00,,0.03,0,0.03,0.03,-1,-22987,105356,128343,82369,0,-37354,0,0,0,,37354,-37354
44,10/31/2017,17,4:00,4:15,,25.62,0,25.62,25.62,-1,-38357,74593,112950,36236,0,-22359,0,0,0,,22359,-22359
44,10/31/2017,18,4:15,4:30,,24.35,0,24.35,24.35,-1,-41152,93160,134312,52008,0,-14658,0,0,0,,14658,-14658
44,10/31/2017,19,4:30,4:45,,-0.01,0,-0.01,-0.01,-1,-29013,93071,122084,64058,0,-42268,0,0,0,,42268,-42268
44,10/31/2017,20,4:45,5:00,,-7.12,0,-7.12,-7.12,-1,-34230,102892,137122,68662,0,-40925,0,0,0,,40925,-40925
44,10/31/2017,21,5:00,5:15,,-48.94,0,-48.94,-48.94,-1,-14637,98083,112720,83446,0,-69114,0,0,0,,69114,-69114
44,10/31/2017,22,5:15,5:30,,-9.51,0,-9.51,-9.51,-1,-33268,91838,125106,58570,0,-70230,0,0,0,,70230,-70230
44,10/31/2017,23,5:30,5:45,,24.35,0,24.35,24.35,-1,-40830,71796,112626,30966,0,-31436,0,0,0,,31436,-31436
44,10/31/2017,24,5:45,6:00,,14.35,0,14.35,14.35,-1,-46284,57449,103733,11165,0,-18729,0,0,0,,18729,-18729
44,10/31/2017,25,6:00,6:15,,-29.85,0,-29.85,-29.85,-1,-30383,87443,117826,57060,0,-49434,0,0,0,,49434,-49434
44,10/31/2017,26,6:15,6:30,,30.06,0,30.06,30.06,-1,-60035,67965,128000,7930,0,-12534,0,0,0,,12534,-12534
44,10/31/2017,27,6:30,6:45,51.9,30.06,0,51.9,51.9,1,-77965,58741,136706,-19224,0,-1059,9084,0,0,,10143,8025
44,10/31/2017,28,6:45,7:00,45.9,,0,45.9,45.9,1,-94883,74537,169420,-20346,0,0,12698,0,0,,12698,12698
44,10/31/2017,29,7:00,7:15,32.71,23.9,0,40.19,23.9,2,-72035,89649,161684,17614,0,-2763,7472,0,0,,10235,4709
44,10/31/2017,30,7:15,7:30,31.84,30.06,0,40.19,30.06,2,-57352,51761,109113,-5591,0,-61,22,0,0,,83,-39
44,10/31/2017,31,7:30,7:45,,21.94,0,21.94,21.94,-1,-38091,53619,91710,15528,0,-12348,0,0,0,,12348,-12348
44,10/31/2017,32,7:45,8:00,43.88,21.94,0,43.88,43.88,1,-72189,50806,122995,-21383,0,-675,3413,0,0,,4088,2738
44,10/31/2017,33,8:00,8:15,32.71,-5.04,0,40.61,-5.04,2,-36729,82149,118878,45420,0,-14375,149,0,0,,14524,-14226
44,10/31/2017,34,8:15,8:30,,-5.03,0,-5.03,-5.03,-1,-46726,55761,102487,9035,0,-25017,0,0,0,,25017,-25017
44,10/31/2017,35,8:30,8:45,,25.06,0,25.06,25.06,-1,-50354,59480,109834,9126,0,-9632,0,0,0,,9632,-9632
44,10/31/2017,36,8:45,9:00,32.71,25.06,0,32.71,32.71,1,-65111,68790,133901,3679,0,-1697,63,0,0,,1760,-1634
44,10/31/2017,37,9:00,9:15,38.51,,0,38.51,38.51,1,-61661,56527,118188,-5134,0,0,2371,0,0,,2371,2371
44,10/31/2017,38,9:15,9:30,43.31,,0,43.31,43.31,1,-71687,61229,132916,-10458,0,0,6472,0,0,,6472,6472
44,10/31/2017,39,9:30,9:45,43.31,29.06,0,29.06,29.06,-1,-58434,81529,139963,23095,0,-3132,111,0,0,,3243,-3021
44,10/31/2017,40,9:45,10:00,,18.44,0,18.44,18.44,-1,-44000,72453,116453,28453,0,-27031,0,0,0,,27031,-27031
44,10/31/2017,41,10:00,10:15,50.02,31.03,0,50.02,31.03,2,-82124,54577,136701,-27547,0,-11511,3342,0,0,,14853,-8169
44,10/31/2017,42,10:15,10:30,32.71,,0,32.71,32.71,1,-75381,69199,144580,-6182,0,0,96,0,0,,96,96
44,10/31/2017,43,10:30,10:45,,25.06,0,25.06,25.06,-1,-63638,79032,142670,15394,0,-2187,0,0,0,,2187,-2187
44,10/31/2017,44,10:45,11:00,,17.97,0,17.97,17.97,-1,-73101,86806,159907,13705,0,-20553,0,0,0,,20553,-20553
44,10/31/2017,45,11:00,11:15,,25.06,0,25.06,25.06,-1,-79646,112863,192509,33217,0,-8405,0,0,0,,8405,-8405
44,10/31/2017,46,11:15,11:30,,-1.75,0,-1.75,-1.75,-1,-74396,130013,204409,55617,0,-39507,0,0,0,,39507,-39507
44,10/31/2017,47,11:30,11:45,,23.26,0,23.26,23.26,-1,-69867,98911,168778,29044,0,-29889,0,0,0,,29889,-29889
44,10/31/2017,48,11:45,12:00,,0.49,0,0.49,0.49,-1,-57549,112052,169601,54503,0,-38981,0,0,0,,38981,-38981
44,10/31/2017,49,12:00,12:15,,25.06,0,25.06,25.06,-1,-57903,66574,124477,8671,0,-20265,0,0,0,,20265,-20265
44,10/31/2017,50,12:15,12:30,35.27,25.06,0,35.27,35.27,1,-74992,66487,141479,-8505,0,-14,1647,0,0,,1661,1633
44,10/31/2017,51,12:30,12:45,35.27,29.06,0,29.06,29.06,-1,-80147,78724,158871,-1423,0,-2727,39,0,0,,2766,-2688
44,10/31/2017,52,12:45,13:00,56.76,31.03,0,56.76,31.03,2,-79301,57768,137069,-21533,0,-3305,5174,0,0,,8479,1869
44,10/31/2017,53,13:00,13:15,56.02,30.99,0,56.02,30.99,2,-72217,66843,139060,-5374,0,-443,8080,0,0,,8523,7637
44,10/31/2017,54,13:15,13:30,87.52,,0,87.52,87.52,1,-90084,41801,131885,-48283,0,0,27523,0,0,,27523,27523
44,10/31/2017,55,13:30,13:45,50.02,,0,50.02,50.02,1,-96713,67781,164494,-28932,0,0,30346,0,0,,30346,30346
44,10/31/2017,56,13:45,14:00,44.5,,0,44.5,44.5,1,-103127,70967,174094,-32160,0,0,28005,0,0,,28005,28005
44,10/31/2017,57,14:00,14:15,39.27,,0,39.27,39.27,1,-95714,71207,166921,-24507,0,0,17597,0,0,,17597,17597
44,10/31/2017,58,14:15,14:30,43.84,,0,43.84,43.84,1,-92741,58532,151273,-34209,0,0,19795,0,0,,19795,19795
44,10/31/2017,59,14:30,14:45,50.02,,0,50.02,50.02,1,-97728,56730,154458,-40998,0,0,32543,0,0,,32543,32543
44,10/31/2017,60,14:45,15:00,66.48,,0,66.48,66.48,1,-110587,61431,172018,-49156,0,0,30307,0,0,,30307,30307
44,10/31/2017,61,15:00,15:15,38.89,,0,38.89,38.89,1,-97268,79208,176476,-18060,0,0,19345,0,0,,19345,19345
44,10/31/2017,62,15:15,15:30,38.89,29.06,0,29.06,29.06,-1,-80909,93046,173955,12137,0,-1406,1275,0,0,,2681,-131
44,10/31/2017,63,15:30,15:45,39.52,31.58,0,40.25,31.58,2,-75359,66069,141428,-9290,0,-629,1615,0,0,,2244,986
44,10/31/2017,64,15:45,16:00,43.78,,0,43.78,43.78,1,-79969,67184,147153,-12785,0,0,14425,0,0,,14425,14425
44,10/31/2017,65,16:00,16:15,32.71,15.06,0,15.06,15.06,-1,-57494,72311,129805,14817,0,-10030,6383,0,0,,16413,-3647
44,10/31/2017,66,16:15,16:30,55.05,15.06,0,55.05,15.06,2,-70364,58888,129252,-11476,0,-21665,2683,0,0,,24348,-18982
44,10/31/2017,67,16:30,16:45,84.9,15.06,0,84.9,84.9,1,-81288,58508,139796,-22780,0,-136,25222,0,0,,25358,25086
44,10/31/2017,68,16:45,17:00,141.16,,0,141.16,141.16,1,-133674,65803,199477,-67871,0,0,44804,0,0,,44804,44804
44,10/31/2017,69,17:00,17:15,63.32,16.64,0,63.32,16.64,2,-66252,76996,143248,10744,0,-6061,28457,0,0,,34518,22396
44,10/31/2017,70,17:15,17:30,45.58,16.64,0,45.58,45.58,1,-94777,72778,167555,-21999,0,-482,1683,0,0,,2165,1201
44,10/31/2017,71,17:30,17:45,99.02,,0,99.02,99.02,1,-113281,77085,190366,-36196,0,0,23133,0,0,,23133,23133
44,10/31/2017,72,17:45,18:00,32.71,31.55,0,40.25,31.55,2,-107908,94091,201999,-13817,0,-1020,3782,0,0,,4802,2762
44,10/31/2017,73,18:00,18:15,32.71,11.58,0,11.58,11.58,-1,-81105,104826,185931,23721,0,-6562,14,0,0,,6576,-6548
44,10/31/2017,74,18:15,18:30,,12.69,0,12.69,12.69,-1,-69289,89026,158315,19737,0,-24370,0,0,0,,24370,-24370
44,10/31/2017,75,18:30,18:45,,11.33,0,11.33,11.33,-1,-59947,112138,172085,52191,0,-34743,0,0,0,,34743,-34743
44,10/31/2017,76,18:45,19:00,,15.06,0,15.06,15.06,-1,-54420,104548,158968,50128,0,-39493,0,0,0,,39493,-39493
44,10/31/2017,77,19:00,19:15,89.02,24.03,0,89.02,24.03,2,-137095,72695,209790,-64400,0,-20179,10609,0,0,,30788,-9570
44,10/31/2017,78,19:15,19:30,32.71,30.06,0,40.72,30.06,2,-98037,91790,189827,-6247,0,-381,2520,0,0,,2901,2139
44,10/31/2017,79,19:30,19:45,,25.06,0,25.06,25.06,-1,-73992,101514,175506,27522,0,-15289,0,0,0,,15289,-15289
44,10/31/2017,80,19:45,20:00,,23.63,0,23.63,23.63,-1,-80009,111904,191913,31895,0,-35474,0,0,0,,35474,-35474
44,10/31/2017,81,20:00,20:15,99.02,7.63,0,99.02,99.02,1,-93883,36283,130166,-57600,0,-26039,7269,0,0,,33308,-18770
44,10/31/2017,82,20:15,20:30,111.75,15.06,0,111.75,15.06,2,-89407,80105,169512,-9302,0,-3440,13959,0,0,,17399,10519
44,10/31/2017,83,20:30,20:45,,13.17,0,13.17,13.17,-1,-74646,91106,165752,16460,0,-20934,0,0,0,,20934,-20934
44,10/31/2017,84,20:45,21:00,,17.47,0,17.47,17.47,-1,-74145,119466,193611,45321,0,-33096,0,0,0,,33096,-33096
44,10/31/2017,85,21:00,21:15,359.62,25.06,0,359.62,359.62,1,-120881,50520,171401,-70361,0,-20029,7931,0,0,,27960,-12098
44,10/31/2017,86,21:15,21:30,406.37,-40.73,0,406.37,-40.73,2,-78886,87375,166261,8489,0,-3737,28539,0,0,,32276,24802
44,10/31/2017,87,21:30,21:45,33.75,-45.63,0,40.73,-45.63,2,-64887,87804,152691,22917,0,-30304,212,0,0,,30516,-30092
44,10/31/2017,88,21:45,22:00,32.71,2.13,0,40.73,2.13,2,-91680,121702,213382,30022,0,-12342,58,0,0,,12400,-12284
44,10/31/2017,89,22:00,22:15,68.36,-49.48,0,68.36,-49.48,2,-94668,123018,217686,28350,0,-45833,368,0,0,,46201,-45465
44,10/31/2017,90,22:15,22:30,134.02,30.06,0,134.02,30.06,2,-97854,63404,161258,-34450,0,-2372,11173,0,0,,13545,8801
44,10/31/2017,91,22:30,22:45,,30.06,0,30.06,30.06,-1,-87174,96419,183593,9245,0,-433,0,0,0,,433,-433
44,10/31/2017,92,22:45,23:00,,30.06,0,30.06,30.06,-1,-92556,101671,194227,9115,0,-476,0,0,0,,476,-476
44,10/31/2017,93,23:00,23:15,34.68,48.23,0,40.67,40.67,2,-88998,81975,170973,-7023,0,-91,285,0,0,,376,194
44,10/31/2017,94,23:15,23:30,32.71,48.66,0,40.69,40.69,2,-83460,73232,156692,-10228,0,-7,141,0,0,,148,134
44,10/31/2017,95,23:30,23:45,,18.56,0,18.56,18.56,-1,-80737,108752,189489,28015,0,-11468,0,0,0,,11468,-11468
44,10/31/2017,96,23:45,0:00,,13.95,0,13.95,13.95,-1,-74452,101528,175980,27076,0,-40770,0,0,0,,40770,-40770
44,11-01-17,1,0:00,0:15,125.02,13.95,0,125.02,125.02,1,-116647,26490,143137,-90157,0,-6566,35283,0,0,,41849,28717
44,11-01-17,2,0:15,0:30,44.71,,0,44.71,44.71,1,-64193,51831,116024,-12362,0,0,29281,0,0,,29281,29281
44,11-01-17,3,0:30,0:45,35.9,30.23,0,39.93,30.23,2,-82031,68054,150085,-13977,0,-623,4346,0,0,,4969,3723
44,11-01-17,4,0:45,1:00,39.9,28.11,0,39.93,28.11,2,-89498,79527,169025,-9971,0,-2512,563,0,0,,3075,-1949
44,11-01-17,5,1:00,1:15,53.09,28.11,0,53.09,53.09,1,-116346,39874,156220,-76472,0,-29,10689,0,0,,10718,10660
44,11-01-17,6,1:15,1:30,33,,0,33,33,1,-77845,47521,125366,-30324,0,0,3909,0,0,,3909,3909
44,11-01-17,7,1:30,1:45,53.09,,0,53.09,53.09,1,-75446,50083,125529,-25363,0,0,12964,0,0,,12964,12964
44,11-01-17,8,1:45,2:00,34.56,,0,34.56,34.56,1,-75736,57228,132964,-18508,0,0,4597,0,0,,4597,4597
44,11-01-17,9,2:00,2:15,75.44,,0,75.44,75.44,1,-97810,48800,146610,-49010,0,0,14674,0,0,,14674,14674
44,11-01-17,10,2:15,2:30,47.17,,0,47.17,47.17,1,-84474,57222,141696,-27252,0,0,20392,0,0,,20392,20392
44,11-01-17,11,2:30,2:45,45.9,,0,45.9,45.9,1,-88774,57110,145884,-31664,0,0,25612,0,0,,25612,25612
44,11-01-17,12,2:45,3:00,45.9,29.23,0,29.23,29.23,-1,-69305,64038,133343,-5267,0,-291,6691,0,0,,6982,6400
44,11-01-17,13,3:00,3:15,39.9,30.23,0,40.85,30.23,2,-61985,57928,119913,-4057,0,-394,1580,0,0,,1974,1186
44,11-01-17,14,3:15,3:30,39.9,29.4,0,29.4,29.4,-1,-56042,71934,127976,15892,0,-1015,474,0,0,,1489,-541
44,11-01-17,15,3:30,3:45,,,0,40.85,40.85,0,-74786,74129,148915,-657,0,-87,0,0,0,,87,-87
44,11-01-17,16,3:45,4:00,,2.12,0,2.12,2.12,-1,-77892,103434,181326,25542,0,-4677,0,0,0,,4677,-4677
44,11-01-17,17,4:00,4:15,39.97,5.03,0,39.97,39.97,1,-51707,56030,107737,4323,0,-9443,1527,0,0,,10970,-7916
44,11-01-17,18,4:15,4:30,42.81,29.23,0,42.81,29.23,2,-48985,64164,113149,15179,0,-1275,2155,0,0,,3430,880
44,11-01-17,19,4:30,4:45,,31.29,0,31.29,31.29,-1,-55645,53027,108672,-2618,0,-1107,0,0,0,,1107,-1107
44,11-01-17,20,4:45,5:00,,29.03,0,29.03,29.03,-1,-56296,56830,113126,534,0,-2087,0,0,0,,2087,-2087
44,11-01-17,21,5:00,5:15,,28.03,0,28.03,28.03,-1,-31299,108466,139765,77167,0,-6925,0,0,0,,6925,-6925
44,11-01-17,22,5:15,5:30,,,0,40.61,40.61,0,-57238,70186,127424,12948,0,-720,0,0,0,,720,-720
44,11-01-17,23,5:30,5:45,75.72,,0,75.72,75.72,1,-80550,47025,127575,-33525,0,0,7593,0,0,,7593,7593
44,11-01-17,24,5:45,6:00,76.12,47.12,0,76.12,40.57,2,-85878,48120,133998,-37758,0,-1,13144,0,0,,13145,13143
44,11-01-17,25,6:00,6:15,76.12,30.24,0,30.24,30.24,-1,-41614,145635,187249,104021,0,-812,36,0,0,,848,-776
44,11-01-17,26,6:15,6:30,,,0,39.89,39.89,0,-55799,98996,154795,43197,0,-59,0,0,0,,59,-59
44,11-01-17,27,6:30,6:45,,,0,39.89,39.89,0,-63478,69463,132941,5985,0,0,0,0,0,,0,0
44,11-01-17,28,6:45,7:00,39.83,,0,39.83,39.83,1,-80698,72597,153295,-8101,0,0,2001,0,0,,2001,2001
44,11-01-17,29,7:00,7:15,39.83,46.65,0,46.65,46.65,-1,-51906,130960,182866,79054,0,-140,13,0,0,,153,-127
44,11-01-17,30,7:15,7:30,,30.9,0,30.9,30.9,-1,-48335,113273,161608,64938,0,-817,0,0,0,,817,-817
44,11-01-17,31,7:30,7:45,32.9,30.9,0,32.9,32.9,1,-54285,73426,127711,19141,0,-51,58,0,0,,109,7
44,11-01-17,32,7:45,8:00,90.02,,0,90.02,90.02,1,-95389,57837,153226,-37552,0,0,4953,0,0,,4953,4953
44,11-01-17,33,8:00,8:15,203.68,,0,203.68,203.68,1,-158944,64547,223491,-94397,0,0,68483,0,0,,68483,68483
44,11-01-17,34,8:15,8:30,203.68,12.68,0,12.68,12.68,-1,-112177,110534,222711,-1643,0,-1510,34283,0,0,,35793,32773
44,11-01-17,35,8:30,8:45,203.68,12.68,0,203.68,203.68,1,-137249,69525,206774,-67724,0,-119,21418,0,0,,21537,21299
44,11-01-17,36,8:45,9:00,180.25,,0,180.25,180.25,1,-140882,78722,219604,-62160,0,0,61481,0,0,,61481,61481
44,11-01-17,37,9:00,9:15,45.25,29.9,0,29.9,29.9,-1,-57063,60598,117661,3535,0,-1578,25899,0,0,,27477,24321
44,11-01-17,38,9:15,9:30,93.02,29.9,0,93.02,93.02,1,-83802,52605,136407,-31197,0,-484,13911,0,0,,14395,13427
44,11-01-17,39,9:30,9:45,42.68,,0,42.68,42.68,1,-80097,67681,147778,-12416,0,0,18019,0,0,,18019,18019
44,11-01-17,40,9:45,10:00,105.94,,0,105.94,105.94,1,-100589,72819,173408,-27770,0,0,20134,0,0,,20134,20134
44,11-01-17,41,10:00,10:15,116.02,40.41,0,40.41,40.41,-1,-69151,67836,136987,-1315,0,-184,30860,0,0,,31044,30676
44,11-01-17,42,10:15,10:30,116.02,41.66,0,41.66,41.66,-1,-56090,87799,143889,31709,0,-642,640,0,0,,1282,-2
44,11-01-17,43,10:30,10:45,,,0,40.07,40.07,0,-48177,97224,145401,49047,0,0,0,0,0,,0,0
44,11-01-17,44,10:45,11:00,,,0,40.07,40.07,0,-40591,96137,136728,55546,0,0,0,0,0,,0,0
44,11-01-17,45,11:00,11:15,42.9,,0,42.9,42.9,1,-124788,98537,223325,-26251,0,0,6654,0,0,,6654,6654
44,11-01-17,46,11:15,11:30,41.22,,0,41.22,41.22,1,-124173,106357,230530,-17816,0,0,9543,0,0,,9543,9543
44,11-01-17,47,11:30,11:45,35.02,31.03,0,40.09,31.03,2,-102792,106351,209143,3559,0,-1400,5606,0,0,,7006,4206
44,11-01-17,48,11:45,12:00,,25.9,0,25.9,25.9,-1,-102536,132403,234939,29867,0,-19497,0,0,0,,19497,-19497
44,11-01-17,49,12:00,12:15,,13.8,0,13.8,13.8,-1,-55720,113366,169086,57646,0,-26511,0,0,0,,26511,-26511
44,11-01-17,50,12:15,12:30,,-5.03,0,-5.03,-5.03,-1,-51910,116748,168658,64838,0,-54516,0,0,0,,54516,-54516
44,11-01-17,51,12:30,12:45,,-10.99,0,-10.99,-10.99,-1,-54782,126152,180934,71370,0,-53640,0,0,0,,53640,-53640
44,11-01-17,52,12:45,13:00,,-3.89,0,-3.89,-3.89,-1,-59027,112500,171527,53473,0,-57485,0,0,0,,57485,-57485
44,11-01-17,53,13:00,13:15,,47.41,0,47.41,47.41,-1,-49894,81428,131322,31534,0,-10282,0,0,0,,10282,-10282
44,11-01-17,54,13:15,13:30,36.24,,0,36.24,36.24,1,-51643,67273,118916,15630,0,0,10,0,0,,10,10
44,11-01-17,55,13:30,13:45,,,0,39.8,39.8,0,-53894,86120,140014,32226,0,0,0,0,0,,0,0
44,11-01-17,56,13:45,14:00,,30.24,0,30.24,30.24,-1,-62992,86080,149072,23088,0,-2082,0,0,0,,2082,-2082
44,11-01-17,57,14:00,14:15,,30.24,0,30.24,30.24,-1,-73118,117071,190189,43953,0,-1939,0,0,0,,1939,-1939
44,11-01-17,58,14:15,14:30,32.24,,0,32.24,32.24,1,-92795,102185,194980,9390,0,0,261,0,0,,261,261
44,11-01-17,59,14:30,14:45,32.24,,0,32.24,32.24,1,-90309,80419,170728,-9890,0,0,1562,0,0,,1562,1562
44,11-01-17,60,14:45,15:00,32.24,,0,32.24,32.24,1,-104084,76422,180506,-27662,0,0,259,0,0,,259,259
44,11-01-17,61,15:00,15:15,,,0,40.16,40.16,0,-85209,110011,195220,24802,0,0,0,0,0,,0,0
44,11-01-17,62,15:15,15:30,35.23,,0,35.23,35.23,1,-95488,96705,192193,1217,0,0,732,0,0,,732,732
44,11-01-17,63,15:30,15:45,39,,0,39,39,1,-101549,76889,178438,-24660,0,0,4051,0,0,,4051,4051
44,11-01-17,64,15:45,16:00,74.58,,0,74.58,74.58,1,-108488,74419,182907,-34069,0,0,31234,0,0,,31234,31234
44,11-01-17,65,16:00,16:15,74.58,14.11,0,14.11,14.11,-1,-94128,129107,223235,34979,0,-9326,10132,0,0,,19458,806
44,11-01-17,66,16:15,16:30,,47.4,0,47.4,47.4,-1,-107996,112180,220176,4184,0,-1917,0,0,0,,1917,-1917
44,11-01-17,67,16:30,16:45,36.9,47.34,0,40.12,40.12,2,-130249,112510,242759,-17739,0,-101,1638,0,0,,1739,1537
44,11-01-17,68,16:45,17:00,160.2,,0,160.2,160.2,1,-177747,99949,277696,-77798,0,0,35906,0,0,,35906,35906
44,11-01-17,69,17:00,17:15,160.2,3.44,0,3.44,3.44,-1,-77740,174365,252105,96625,0,-3397,12111,0,0,,15508,8714
44,11-01-17,70,17:15,17:30,,42.08,0,42.08,42.08,-1,-84880,149881,234761,65001,0,-457,0,0,0,,457,-457
44,11-01-17,71,17:30,17:45,32.9,,0,32.9,32.9,1,-116742,127608,244350,10866,0,0,147,0,0,,147,147
44,11-01-17,72,17:45,18:00,42.86,,0,42.86,42.86,1,-129328,141888,271216,12560,0,0,2134,0,0,,2134,2134
44,11-01-17,73,18:00,18:15,603.76,,0,603.76,603.76,1,-162087,65028,227115,-97059,0,0,34759,0,0,,34759,34759
44,11-01-17,74,18:15,18:30,603.76,44.23,0,44.23,44.23,-1,-118725,135923,254648,17198,0,-616,5373,0,0,,5989,4757
44,11-01-17,75,18:30,18:45,,29.9,0,29.9,29.9,-1,-105702,140376,246078,34674,0,-2634,0,0,0,,2634,-2634
44,11-01-17,76,18:45,19:00,,24.91,0,24.91,24.91,-1,-85848,155318,241166,69470,0,-12529,0,0,0,,12529,-12529
44,11-01-17,77,19:00,19:15,,19.03,0,19.03,19.03,-1,-116158,148528,264686,32370,0,-25101,0,0,0,,25101,-25101
44,11-01-17,78,19:15,19:30,,13.28,0,13.28,13.28,-1,-95646,121742,217388,26096,0,-28554,0,0,0,,28554,-28554
44,11-01-17,79,19:30,19:45,,16.03,0,16.03,16.03,-1,-97028,120514,217542,23486,0,-36349,0,0,0,,36349,-36349
44,11-01-17,80,19:45,20:00,,7.02,0,7.02,7.02,-1,-83212,131842,215054,48630,0,-44339,0,0,0,,44339,-44339
44,11-01-17,81,20:00,20:15,122.02,19.03,0,122.02,122.02,1,-136385,92678,229063,-43707,0,-20269,6960,0,0,,27229,-13309
44,11-01-17,82,20:15,20:30,131.02,30.9,0,131.02,30.9,2,-93717,72383,166100,-21334,0,-286,28061,0,0,,28347,27775
44,11-01-17,83,20:30,20:45,131.02,25.9,0,25.9,25.9,-1,-75159,120540,195699,45381,0,-4610,107,0,0,,4717,-4503
44,11-01-17,84,20:45,21:00,,0.01,0,0.01,0.01,-1,-75942,111272,187214,35330,0,-31453,0,0,0,,31453,-31453
44,11-01-17,85,21:00,21:15,181.82,0.01,0,181.82,181.82,1,-141530,66887,208417,-74643,0,-2229,23967,0,0,,26196,21738
44,11-01-17,86,21:15,21:30,181.82,19.67,0,19.67,19.67,-1,-82951,86457,169408,3506,0,-1893,31446,0,0,,33339,29553
44,11-01-17,87,21:30,21:45,47.43,17.76,0,47.43,17.76,2,-96221,85373,181594,-10848,0,-6924,1985,0,0,,8909,-4939
44,11-01-17,88,21:45,22:00,58.02,-5.72,0,58.02,-5.72,2,-89490,109541,199031,20051,0,-4336,9453,0,0,,13789,5117
44,11-01-17,89,22:00,22:15,145.7,-48.32,0,145.7,-48.32,2,-94895,89386,184281,-5509,0,-26811,2854,0,0,,29665,-23957
44,11-01-17,90,22:15,22:30,186.04,-63.44,0,186.04,-63.44,2,-51641,74024,125665,22383,0,-4190,19621,0,0,,23811,15431
44,11-01-17,91,22:30,22:45,32.9,-63.17,0,39.61,-63.17,2,-65648,100334,165982,34686,0,-38517,27,0,0,,38544,-38490
44,11-01-17,92,22:45,23:00,32.9,-26.56,0,39.63,-26.56,2,-62126,120475,182601,58349,0,-24911,41,0,0,,24952,-24870
44,11-01-17,93,23:00,23:15,50.57,4.25,0,50.57,4.25,2,-62715,70632,133347,7917,0,-26221,1382,0,0,,27603,-24839
44,11-01-17,94,23:15,23:30,50.57,-8.03,0,-8.03,-8.03,-1,-40544,73792,114336,33248,0,-19660,42,0,0,,19702,-19618
44,11-01-17,95,23:30,23:45,,14.77,0,14.77,14.77,-1,-61230,100689,161919,39459,0,-29926,0,0,0,,29926,-29926
44,11-01-17,96,23:45,0:00,,-60.33,0,-60.33,-60.33,-1,-56173,146889,203062,90716,0,-70899,0,0,0,,70899,-70899
44,11-02-17,1,0:00,0:15,143.05,-60.33,0,143.05,143.05,1,-95454,51836,147290,-43618,0,-30229,8729,0,0,,38958,-21500
44,11-02-17,2,0:15,0:30,143.05,30.08,0,143.05,30.08,2,-60339,66501,126840,6162,0,-1224,13261,0,0,,14485,12037
44,11-02-17,3,0:30,0:45,35.02,30.08,0,35.02,35.02,1,-82846,70976,153822,-11870,0,-198,1166,0,0,,1364,968
44,11-02-17,4,0:45,1:00,34.97,31.08,0,34.97,31.08,2,-86279,88918,175197,2639,0,-917,348,0,0,,1265,-569
44,11-02-17,5,1:00,1:15,41.96,31.08,0,41.96,31.08,2,-76264,66929,143193,-9335,0,-278,2529,0,0,,2807,2251
44,11-02-17,6,1:15,1:30,43.16,16.61,0,43.16,16.61,2,-71529,84291,155820,12762,0,-3221,6879,0,0,,10100,3658
44,11-02-17,7,1:30,1:45,,16.61,0,16.61,16.61,-1,-66639,91194,157833,24555,0,-20536,0,0,0,,20536,-20536
44,11-02-17,8,1:45,2:00,,8.16,0,8.16,8.16,-1,-63705,106431,170136,42726,0,-36834,0,0,0,,36834,-36834
44,11-02-17,9,2:00,2:15,,10.95,0,10.95,10.95,-1,-46313,108030,154343,61717,0,-60166,0,0,0,,60166,-60166
44,11-02-17,10,2:15,2:30,,26.78,0,26.78,26.78,-1,-43727,72777,116504,29050,0,-32187,0,0,0,,32187,-32187
44,11-02-17,11,2:30,2:45,,27.78,0,27.78,27.78,-1,-48169,70957,119126,22788,0,-23105,0,0,0,,23105,-23105
44,11-02-17,12,2:45,3:00,,26.18,0,26.18,26.18,-1,-47292,74806,122098,27514,0,-18602,0,0,0,,18602,-18602
44,11-02-17,13,3:00,3:15,36.17,26.18,0,36.17,36.17,1,-46150,46822,92972,672,0,-13115,1451,0,0,,14566,-11664
44,11-02-17,14,3:15,3:30,36.17,27.78,0,27.78,27.78,-1,-44997,65939,110936,20942,0,-4799,718,0,0,,5517,-4081
44,11-02-17,15,3:30,3:45,35.12,31.08,0,35.12,35.12,1,-52549,44237,96786,-8312,0,-3563,964,0,0,,4527,-2599
44,11-02-17,16,3:45,4:00,45.02,,0,45.02,45.02,1,-64856,37047,101903,-27809,0,0,18486,0,0,,18486,18486
44,11-02-17,17,4:00,4:15,36.12,33.74,0,36.12,33.36,2,-76894,73615,150509,-3279,0,-11,10528,0,0,,10539,10517
44,11-02-17,18,4:15,4:30,41.21,31.5,0,41.21,31.5,2,-76368,59350,135718,-17018,0,-283,2011,0,0,,2294,1728
44,11-02-17,19,4:30,4:45,57.42,,0,57.42,57.42,1,-83960,62022,145982,-21938,0,0,16448,0,0,,16448,16448
44,11-02-17,20,4:45,5:00,57.42,30.17,0,30.17,30.17,-1,-73277,74704,147981,1427,0,-522,725,0,0,,1247,203
44,11-02-17,21,5:00,5:15,36.01,30.17,0,36.01,36.01,1,-64314,61836,126150,-2478,0,-49,1008,0,0,,1057,959
44,11-02-17,22,5:15,5:30,148.7,,0,148.7,148.7,1,-82569,49005,131574,-33564,0,0,29612,0,0,,29612,29612
44,11-02-17,23,5:30,5:45,53.12,,0,53.12,53.12,1,-76699,52802,129501,-23897,0,0,38865,0,0,,38865,38865
44,11-02-17,24,5:45,6:00,62.6,33.35,0,62.6,33.35,2,-68750,63696,132446,-5054,0,-6,32338,0,0,,32344,32332
44,11-02-17,25,6:00,6:15,62.6,-53.61,0,-53.61,-53.61,-1,-71155,128985,200140,57830,0,-26979,4622,0,0,,31601,-22357
44,11-02-17,26,6:15,6:30,,21.84,0,21.84,21.84,-1,-69892,93772,163664,23880,0,-30574,0,0,0,,30574,-30574
44,11-02-17,27,6:30,6:45,60.13,31.39,0,60.13,60.13,1,-89401,53442,142843,-35959,0,-7225,3091,0,0,,10316,-4134
44,11-02-17,28,6:45,7:00,426.16,,0,426.16,426.16,1,-106632,39981,146613,-66651,0,0,52348,0,0,,52348,52348
44,11-02-17,29,7:00,7:15,426.16,-68.61,0,-68.61,-68.61,-1,-53847,209294,263141,155447,0,-28939,14309,0,0,,43248,-14630
44,11-02-17,30,7:15,7:30,,-45.11,0,-45.11,-45.11,-1,-76247,122988,199235,46741,0,-73567,0,0,0,,73567,-73567
44,11-02-17,31,7:30,7:45,43.16,31.12,0,43.16,31.12,2,-54865,63781,118646,8916,0,-3496,2870,0,0,,6366,-626
44,11-02-17,32,7:45,8:00,39.12,46.73,0,39.93,39.93,2,-70650,60492,131142,-10158,0,-412,3460,0,0,,3872,3048
44,11-02-17,33,8:00,8:15,39.12,-54.96,0,-54.96,-54.96,-1,-102643,179536,282179,76893,0,-20856,569,0,0,,21425,-20287
44,11-02-17,34,8:15,8:30,43.16,-41.91,0,43.16,-41.91,2,-116343,154585,270928,38242,0,-63374,208,0,0,,63582,-63166
44,11-02-17,35,8:30,8:45,62.59,21.78,0,62.59,21.78,2,-122457,151742,274199,29285,0,-11938,1378,0,0,,13316,-10560
44,11-02-17,36,8:45,9:00,35.36,30.39,0,35.36,35.36,1,-134752,137155,271907,2403,0,-14760,17,0,0,,14777,-14743
44,11-02-17,37,9:00,9:15,359.62,30.39,0,359.62,359.62,1,-110995,63285,174280,-47710,0,-880,30008,0,0,,30888,29128
44,11-02-17,38,9:15,9:30,51,,0,51,51,1,-101187,71773,172960,-29414,0,0,14088,0,0,,14088,14088
44,11-02-17,39,9:30,9:45,56.12,,0,56.12,56.12,1,-98613,67585,166198,-31028,0,0,27092,0,0,,27092,27092
44,11-02-17,40,9:45,10:00,58.41,,0,58.41,58.41,1,-101713,63678,165391,-38035,0,0,30248,0,0,,30248,30248
44,11-02-17,41,10:00,10:15,66.87,,0,66.87,66.87,1,-114297,94636,208933,-19661,0,0,35873,0,0,,35873,35873
44,11-02-17,42,10:15,10:30,47.64,31.45,0,47.64,31.45,2,-106089,79257,185346,-26832,0,-819,7613,0,0,,8432,6794
44,11-02-17,43,10:30,10:45,81.12,,0,81.12,81.12,1,-111533,81130,192663,-30403,0,0,30773,0,0,,30773,30773
44,11-02-17,44,10:45,11:00,41.23,,0,41.23,41.23,1,-103474,74253,177727,-29221,0,0,14926,0,0,,14926,14926
44,11-02-17,45,11:00,11:15,39.12,,0,39.12,39.12,1,-87899,58551,146450,-29348,0,0,18252,0,0,,18252,18252
44,11-02-17,46,11:15,11:30,39.12,,0,39.12,39.12,1,-87690,63109,150799,-24581,0,0,16092,0,0,,16092,16092
44,11-02-17,47,11:30,11:45,45.12,,0,45.12,45.12,1,-91947,63261,155208,-28686,0,0,17504,0,0,,17504,17504
44,11-02-17,48,11:45,12:00,40.21,,0,40.21,40.21,1,-89671,66961,156632,-22710,0,0,23829,0,0,,23829,23829
44,11-02-17,49,12:00,12:15,45.12,,0,45.12,45.12,1,-114497,86141,200638,-28356,0,0,25083,0,0,,25083,25083
44,11-02-17,50,12:15,12:30,59.74,,0,59.74,59.74,1,-95311,61599,156910,-33712,0,0,32463,0,0,,32463,32463
44,11-02-17,51,12:30,12:45,39.12,,0,39.12,39.12,1,-102529,85320,187849,-17209,0,0,17648,0,0,,17648,17648
44,11-02-17,52,12:45,13:00,39.12,31.39,0,31.39,31.39,-1,-105776,96735,202511,-9041,0,-670,1784,0,0,,2454,1114
44,11-02-17,53,13:00,13:15,247.35,,0,247.35,247.35,1,-120071,49557,169628,-70514,0,0,23856,0,0,,23856,23856
44,11-02-17,54,13:15,13:30,158,,0,158,158,1,-141960,71043,213003,-70917,0,0,69840,0,0,,69840,69840
44,11-02-17,55,13:30,13:45,81.12,,0,81.12,81.12,1,-152071,90867,242938,-61204,0,0,49434,0,0,,49434,49434
44,11-02-17,56,13:45,14:00,135.12,,0,135.12,135.12,1,-132398,82789,215187,-49609,0,0,69506,0,0,,69506,69506
44,11-02-17,57,14:00,14:15,100.04,,0,100.04,100.04,1,-121980,102093,224073,-19887,0,0,45992,0,0,,45992,45992
44,11-02-17,58,14:15,14:30,80.12,,0,80.12,80.12,1,-102559,67370,169929,-35189,0,0,13846,0,0,,13846,13846
44,11-02-17,59,14:30,14:45,71.66,,0,71.66,71.66,1,-113366,67986,181352,-45380,0,0,33930,0,0,,33930,33930
44,11-02-17,60,14:45,15:00,144.35,,0,144.35,144.35,1,-136035,66865,202900,-69170,0,0,60487,0,0,,60487,60487
44,11-02-17,61,15:00,15:15,149.44,,0,149.44,149.44,1,-140466,80682,221148,-59784,0,0,63145,0,0,,63145,63145
44,11-02-17,62,15:15,15:30,81.11,,0,81.11,81.11,1,-138299,77295,215594,-61004,0,0,33816,0,0,,33816,33816
44,11-02-17,63,15:30,15:45,275.33,,0,275.33,275.33,1,-140839,60661,201500,-80178,0,0,62736,0,0,,62736,62736
44,11-02-17,64,15:45,16:00,190.82,,0,190.82,190.82,1,-130890,57254,188144,-73636,0,0,68027,0,0,,68027,68027
44,11-02-17,65,16:00,16:15,190.82,10.57,0,10.57,10.57,-1,-99674,115535,215209,15861,0,-6580,31074,0,0,,37654,24494
44,11-02-17,66,16:15,16:30,210.73,10.57,0,210.73,210.73,1,-99629,69967,169596,-29662,0,-2490,14350,0,0,,16840,11860
44,11-02-17,67,16:30,16:45,42.45,,0,42.45,42.45,1,-96941,74268,171209,-22673,0,0,19330,0,0,,19330,19330
44,11-02-17,68,16:45,17:00,495.77,,0,495.77,495.77,1,-129089,62147,191236,-66942,0,0,45678,0,0,,45678,45678
44,11-02-17,69,17:00,17:15,35.12,-1.92,0,40.41,-1.92,2,-107450,118665,226115,11215,0,-9765,16856,0,0,,26621,7091
44,11-02-17,70,17:15,17:30,565.53,-1.92,0,565.53,565.53,1,-127845,83449,211294,-44396,0,-589,20259,0,0,,20848,19670
44,11-02-17,71,17:30,17:45,565.53,,0,565.53,565.53,1,-162621,92464,255085,-70157,0,0,69099,0,0,,69099,69099
44,11-02-17,72,17:45,18:00,41.07,,0,41.07,41.07,1,-133710,106778,240488,-26932,0,0,28270,0,0,,28270,28270
44,11-02-17,73,18:00,18:15,108.07,,0,108.07,108.07,1,-153934,79719,233653,-74215,0,0,23517,0,0,,23517,23517
44,11-02-17,74,18:15,18:30,225,,0,225,225,1,-119444,93380,212824,-26064,0,0,44633,0,0,,44633,44633
44,11-02-17,75,18:30,18:45,225,28.42,0,28.42,28.42,-1,-98422,109950,208372,11528,0,-2422,8293,0,0,,10715,5871
44,11-02-17,76,18:45,19:00,35.9,46.79,0,40.4,40.4,2,-98100,104398,202498,6298,0,-8,325,0,0,,333,317
44,11-02-17,77,19:00,19:15,,44.98,0,44.98,44.98,-1,-93111,85655,178766,-7456,0,-139,0,0,0,,139,-139
44,11-02-17,78,19:15,19:30,61.6,,0,61.6,61.6,1,-96527,70037,166564,-26490,0,0,6676,0,0,,6676,6676
44,11-02-17,79,19:30,19:45,61.6,,0,61.6,61.6,1,-99290,73845,173135,-25445,0,0,16496,0,0,,16496,16496
44,11-02-17,80,19:45,20:00,,,0,40.39,40.39,0,-98920,71249,170169,-27671,0,0,1169,0,0,,1169,1169
44,11-02-17,81,20:00,20:15,47.94,33.33,0,47.94,33.33,2,-94919,89069,183988,-5850,0,-50,2522,0,0,,2572,2472
44,11-02-17,82,20:15,20:30,47.94,30.03,0,30.03,30.03,-1,-88748,96352,185100,7604,0,-3192,14,0,0,,3206,-3178
44,11-02-17,83,20:30,20:45,,30.03,0,30.03,30.03,-1,-83459,104457,187916,20998,0,-11845,0,0,0,,11845,-11845
44,11-02-17,84,20:45,21:00,,30.78,0,30.78,30.78,-1,-116395,115394,231789,-1001,0,-15095,0,0,0,,15095,-15095
44,11-02-17,85,21:00,21:15,35.12,30.78,0,35.12,35.12,1,-99419,71083,170502,-28336,0,-712,494,0,0,,1206,-218
44,11-02-17,86,21:15,21:30,,,0,39.99,39.99,0,-89086,80031,169117,-9055,0,0,11,0,0,,11,11
44,11-02-17,87,21:30,21:45,,20.99,0,20.99,20.99,-1,-89985,113724,203709,23739,0,-7192,0,0,0,,7192,-7192
44,11-02-17,88,21:45,22:00,,5.19,0,5.19,5.19,-1,-88487,149672,238159,61185,0,-49423,0,0,0,,49423,-49423
44,11-02-17,89,22:00,22:15,45.12,-62.51,0,45.12,-62.51,2,-91777,87305,179082,-4472,0,-41991,315,0,0,,42306,-41676
44,11-02-17,90,22:15,22:30,48.03,-27.14,0,48.03,-27.14,2,-62102,94421,156523,32319,0,-10164,860,0,0,,11024,-9304
44,11-02-17,91,22:30,22:45,,-11.09,0,-11.09,-11.09,-1,-57770,123403,181173,65633,0,-52431,0,0,0,,52431,-52431
44,11-02-17,92,22:45,23:00,,-16.85,0,-16.85,-16.85,-1,-60767,149660,210427,88893,0,-76692,0,0,0,,76692,-76692
44,11-02-17,93,23:00,23:15,114.12,-1.93,0,114.12,114.12,1,-117588,91698,209286,-25890,0,-50017,1579,0,0,,51596,-48438
44,11-02-17,94,23:15,23:30,336.62,-59.53,0,336.62,-59.53,2,-53311,68591,121902,15280,0,-3250,20306,0,0,,23556,17056
44,11-02-17,95,23:30,23:45,336.62,-64.95,0,-64.95,-64.95,-1,-45387,99566,144953,54179,0,-49587,202,0,0,,49789,-49385
44,11-02-17,96,23:45,0:00,,26.18,0,26.18,26.18,-1,-67911,93657,161568,25746,0,-15368,0,0,0,,15368,-15368
44,11-03-17,1,0:00,0:15,37.5,18.03,0,37.5,18.03,2,-57345,53389,110734,-3956,0,-13252,239,0,0,,13491,-13013
44,11-03-17,2,0:15,0:30,37.5,26.18,0,26.18,26.18,-1,-38104,45051,83155,6947,0,-1528,14,0,0,,1542,-1514
44,11-03-17,3,0:30,0:45,,18.5,0,18.5,18.5,-1,-41918,66665,108583,24747,0,-21053,0,0,0,,21053,-21053
44,11-03-17,4,0:45,1:00,,21.7,0,21.7,21.7,-1,-49239,91082,140321,41843,0,-24460,0,0,0,,24460,-24460
44,11-03-17,5,1:00,1:15,86.03,21.7,0,86.03,86.03,1,-67701,22247,89948,-45454,0,-10392,6669,0,0,,17061,-3723
44,11-03-17,6,1:15,1:30,34.67,,0,34.67,34.67,1,-47949,34917,82866,-13032,0,0,2248,0,0,,2248,2248
44,11-03-17,7,1:30,1:45,33.18,32.92,0,33.57,32.92,2,-47247,41793,89040,-5454,0,-87,1164,0,0,,1251,1077
44,11-03-17,8,1:45,2:00,,30.18,0,30.18,30.18,-1,-46290,50433,96723,4143,0,-4611,0,0,0,,4611,-4611
44,11-03-17,9,2:00,2:15,37.5,31.18,0,37.5,37.5,1,-44170,39471,83641,-4699,0,-4614,629,0,0,,5243,-3985
44,11-03-17,10,2:15,2:30,40.1,18.25,0,40.1,18.25,2,-42881,46101,88982,3220,0,-1910,4330,0,0,,6240,2420
44,11-03-17,11,2:30,2:45,,9.39,0,9.39,9.39,-1,-45447,55414,100861,9967,0,-18742,0,0,0,,18742,-18742
44,11-03-17,12,2:45,3:00,,26.18,0,26.18,26.18,-1,-35271,48952,84223,13681,0,-8759,0,0,0,,8759,-8759
44,11-03-17,13,3:00,3:15,33.18,31.01,0,33.18,33.18,1,-34002,28761,62763,-5241,0,-7803,42,0,0,,7845,-7761
44,11-03-17,14,3:15,3:30,33.26,31.01,0,33.26,33.26,1,-40074,27265,67339,-12809,0,-127,525,0,0,,652,398
44,11-03-17,15,3:30,3:45,,28.45,0,28.45,28.45,-1,-38170,38161,76331,-9,0,-8004,0,0,0,,8004,-8004
44,11-03-17,16,3:45,4:00,45.12,30.18,0,45.12,30.18,2,-36177,32950,69127,-3227,0,-1013,3465,0,0,,4478,2452
44,11-03-17,17,4:00,4:15,,30.18,0,30.18,30.18,-1,-44751,24986,69737,-19765,0,-1560,0,0,0,,1560,-1560
44,11-03-17,18,4:15,4:30,,31.18,0,31.18,31.18,-1,-41173,41817,82990,644,0,-1030,0,0,0,,1030,-1030
44,11-03-17,19,4:30,4:45,,,0,33.57,33.57,0,-43584,30630,74214,-12954,0,-98,0,0,0,,98,-98
44,11-03-17,20,4:45,5:00,33.18,,0,33.18,33.18,1,-53224,26404,79628,-26820,0,0,434,0,0,,434,434
44,11-03-17,21,5:00,5:15,,-29.02,0,-29.02,-29.02,-1,-23599,75938,99537,52339,0,-15771,0,0,0,,15771,-15771
44,11-03-17,22,5:15,5:30,,-50.13,0,-50.13,-50.13,-1,-47398,60945,108343,13547,0,-34265,0,0,0,,34265,-34265
44,11-03-17,23,5:30,5:45,33.32,30.18,0,33.54,30.18,2,-41064,42275,83339,1211,0,-2097,252,0,0,,2349,-1845
44,11-03-17,24,5:45,6:00,,33.29,0,33.29,33.29,-1,-42163,42414,84577,251,0,-129,0,0,0,,129,-129
44,11-03-17,25,6:00,6:15,,46.14,0,46.14,46.14,-1,-138115,94700,232815,-43415,0,-35,0,0,0,,35,-35
44,11-03-17,26,6:15,6:30,,32.03,0,32.03,32.03,-1,-46959,49648,96607,2689,0,-2244,0,0,0,,2244,-2244
44,11-03-17,27,6:30,6:45,35.51,32.03,0,39.95,32.03,2,-48258,36544,84802,-11714,0,-872,394,0,0,,1266,-478
44,11-03-17,28,6:45,7:00,33.33,26.89,0,39.95,26.89,2,-121746,31834,153580,-89912,0,-442,20,0,0,,462,-422
44,11-03-17,29,7:00,7:15,,-40.37,0,-40.37,-40.37,-1,-19251,120879,140130,101628,0,-55747,0,0,0,,55747,-55747
44,11-03-17,30,7:15,7:30,35.02,31.03,0,39.96,31.03,2,-49158,61252,110410,12094,0,-5640,205,0,0,,5845,-5435
44,11-03-17,31,7:30,7:45,,7.03,0,7.03,7.03,-1,-35686,74970,110656,39284,0,-34841,0,0,0,,34841,-34841
44,11-03-17,32,7:45,8:00,38.14,7.03,0,38.14,38.14,1,-76329,44498,120827,-31831,0,-5490,841,0,0,,6331,-4649
44,11-03-17,33,8:00,8:15,,,0,39.96,39.96,0,-54344,54604,108948,260,0,0,0,0,0,,0,0
44,11-03-17,34,8:15,8:30,,,0,39.95,39.95,0,-57864,43586,101450,-14278,0,0,0,0,0,,0,0
44,11-03-17,35,8:30,8:45,34.23,,0,34.23,34.23,1,-76132,28694,104826,-47438,0,0,398,0,0,,398,398
44,11-03-17,36,8:45,9:00,44.18,,0,44.18,44.18,1,-95242,27892,123134,-67350,0,0,2507,0,0,,2507,2507
44,11-03-17,37,9:00,9:15,165.52,,0,165.52,165.52,1,-124521,30740,155261,-93781,0,0,53888,0,0,,53888,53888
44,11-03-17,38,9:15,9:30,146.47,,0,146.47,146.47,1,-101031,33441,134472,-67590,0,0,69169,0,0,,69169,69169
44,11-03-17,39,9:30,9:45,76.02,,0,76.02,76.02,1,-98585,37444,136029,-61141,0,0,31123,0,0,,31123,31123
44,11-03-17,40,9:45,10:00,102.02,,0,102.02,102.02,1,-114595,38350,152945,-76245,0,0,59836,0,0,,59836,59836
44,11-03-17,41,10:00,10:15,63.93,,0,63.93,63.93,1,-85251,50477,135728,-34774,0,0,41684,0,0,,41684,41684
44,11-03-17,42,10:15,10:30,49.79,,0,49.79,49.79,1,-93451,54471,147922,-38980,0,0,24553,0,0,,24553,24553
44,11-03-17,43,10:30,10:45,50.56,,0,50.56,50.56,1,-94735,52405,147140,-42330,0,0,31762,0,0,,31762,31762
44,11-03-17,44,10:45,11:00,51.39,,0,51.39,51.39,1,-93939,47564,141503,-46375,0,0,36514,0,0,,36514,36514
44,11-03-17,45,11:00,11:15,170.8,,0,170.8,170.8,1,-120565,36481,157046,-84084,0,0,53234,0,0,,53234,53234
44,11-03-17,46,11:15,11:30,151.15,,0,151.15,151.15,1,-103037,49339,152376,-53698,0,0,67136,0,0,,67136,67136
44,11-03-17,47,11:30,11:45,39.02,,0,39.02,39.02,1,-85508,65149,150657,-20359,0,0,19746,0,0,,19746,19746
44,11-03-17,48,11:45,12:00,53.4,,0,53.4,53.4,1,-87853,71659,159512,-16194,0,0,20506,0,0,,20506,20506
44,11-03-17,49,12:00,12:15,78.29,,0,78.29,78.29,1,-96303,53610,149913,-42693,0,0,19152,0,0,,19152,19152
44,11-03-17,50,12:15,12:30,40.21,,0,40.21,40.21,1,-73098,48023,121121,-25075,0,0,26222,0,0,,26222,26222
44,11-03-17,51,12:30,12:45,33.3,,0,33.3,33.3,1,-61575,53559,115134,-8016,0,0,9001,0,0,,9001,9001
44,11-03-17,52,12:45,13:00,33.81,,0,33.81,33.81,1,-60669,57500,118169,-3169,0,0,670,0,0,,670,670
44,11-03-17,53,13:00,13:15,38.14,,0,38.14,38.14,1,-67204,57450,124654,-9754,0,0,2062,0,0,,2062,2062
44,11-03-17,54,13:15,13:30,38.14,,0,38.14,38.14,1,-70237,60573,130810,-9664,0,0,3849,0,0,,3849,3849
44,11-03-17,55,13:30,13:45,36.39,,0,36.39,36.39,1,-73797,66615,140412,-7182,0,0,3720,0,0,,3720,3720
44,11-03-17,56,13:45,14:00,38.14,,0,38.14,38.14,1,-83918,71560,155478,-12358,0,0,4838,0,0,,4838,4838
44,11-03-17,57,14:00,14:15,65.07,,0,65.07,65.07,1,-99015,58146,157161,-40869,0,0,27504,0,0,,27504,27504
44,11-03-17,58,14:15,14:30,48.56,,0,48.56,48.56,1,-94107,55910,150017,-38197,0,0,33884,0,0,,33884,33884
44,11-03-17,59,14:30,14:45,48.98,,0,48.98,48.98,1,-82964,52030,134994,-30934,0,0,32297,0,0,,32297,32297
44,11-03-17,60,14:45,15:00,41.23,,0,41.23,41.23,1,-76347,48802,125149,-27545,0,0,27476,0,0,,27476,27476
44,11-03-17,61,15:00,15:15,38.14,44.14,0,44.14,44.14,-1,-69139,61278,130417,-7861,0,-268,15173,0,0,,15441,14905
44,11-03-17,62,15:15,15:30,41.21,44.09,0,41.21,39.32,2,-74399,59102,133501,-15297,0,-256,5703,0,0,,5959,5447
44,11-03-17,63,15:30,15:45,33.81,,0,33.81,33.81,1,-68967,59824,128791,-9143,0,0,1416,0,0,,1416,1416
44,11-03-17,64,15:45,16:00,34.62,,0,34.62,34.62,1,-77307,69585,146892,-7722,0,0,605,0,0,,605,605
44,11-03-17,65,16:00,16:15,34.62,23.48,0,23.48,23.48,-1,-62924,115759,178683,52835,0,-14212,22,0,0,,14234,-14190
44,11-03-17,66,16:15,16:30,,29.5,0,29.5,29.5,-1,-58290,98712,157002,40422,0,-28903,0,0,0,,28903,-28903
44,11-03-17,67,16:30,16:45,,26.41,0,26.41,26.41,-1,-56994,114307,171301,57313,0,-30405,0,0,0,,30405,-30405
44,11-03-17,68,16:45,17:00,,32.03,0,32.03,32.03,-1,-75658,109064,184722,33406,0,-13206,0,0,0,,13206,-13206
44,11-03-17,69,17:00,17:15,,-31.61,0,-31.61,-31.61,-1,-66801,205133,271934,138332,0,-29047,0,0,0,,29047,-29047
44,11-03-17,70,17:15,17:30,,43.92,0,43.92,43.92,-1,-66052,146481,212533,80429,0,-3395,0,0,0,,3395,-3395
44,11-03-17,71,17:30,17:45,,,0,39.31,39.31,0,-69813,155805,225618,85992,0,0,0,0,0,,0,0
44,11-03-17,72,17:45,18:00,,,0,39.31,39.31,0,-67606,165827,233433,98221,0,0,0,0,0,,0,0
44,11-03-17,73,18:00,18:15,,,0,39.99,39.99,0,-95739,106936,202675,11197,0,0,0,0,0,,0,0
44,11-03-17,74,18:15,18:30,,9.68,0,9.68,9.68,-1,-64063,147022,211085,82959,0,-18187,0,0,0,,18187,-18187
44,11-03-17,75,18:30,18:45,,9.68,0,9.68,9.68,-1,-72957,133430,206387,60473,0,-42191,0,0,0,,42191,-42191
44,11-03-17,76,18:45,19:00,,0.28,0,0.28,0.28,-1,-58193,149159,207352,90966,0,-30381,0,0,0,,30381,-30381
44,11-03-17,77,19:00,19:15,59.07,20.63,0,59.07,20.63,2,-91728,73490,165218,-18238,0,-22451,3315,0,0,,25766,-19136
44,11-03-17,78,19:15,19:30,33.5,20.63,0,33.5,33.5,1,-80615,86868,167483,6253,0,-23,677,0,0,,700,654
44,11-03-17,79,19:30,19:45,33.5,30.25,0,30.25,30.25,-1,-78362,111175,189537,32813,0,-8665,35,0,0,,8700,-8630
44,11-03-17,80,19:45,20:00,,27.03,0,27.03,27.03,-1,-77995,128784,206779,50789,0,-35336,0,0,0,,35336,-35336
44,11-03-17,81,20:00,20:15,76.9,31.81,0,76.9,31.81,2,-101413,81636,183049,-19777,0,-13050,10393,0,0,,23443,-2657
44,11-03-17,82,20:15,20:30,125.02,,0,125.02,125.02,1,-125766,74820,200586,-50946,0,0,14744,0,0,,14744,14744
44,11-03-17,83,20:30,20:45,135.04,24.92,0,135.04,24.92,2,-108932,100366,209298,-8566,0,-730,38393,0,0,,39123,37663
44,11-03-17,84,20:45,21:00,135.04,1.94,0,1.94,1.94,-1,-96272,134906,231178,38634,0,-27805,465,0,0,,28270,-27340
44,11-03-17,85,21:00,21:15,34.4,25.2,0,34.4,25.2,2,-95180,122299,217479,27119,0,-24595,397,0,0,,24992,-24198
44,11-03-17,86,21:15,21:30,34.4,4.09,0,34.4,4.09,2,-61160,117648,178808,56488,0,-16856,323,0,0,,17179,-16533
44,11-03-17,87,21:30,21:45,,-30.25,0,-30.25,-30.25,-1,-55862,121501,177363,65639,0,-56638,0,0,0,,56638,-56638
44,11-03-17,88,21:45,22:00,,-48.12,0,-48.12,-48.12,-1,-72252,187314,259566,115062,0,-61127,0,0,0,,61127,-61127
44,11-03-17,89,22:00,22:15,33.78,18.9,0,39.97,18.9,2,-109058,154584,263642,45526,0,-43555,91,0,0,,43646,-43464
44,11-03-17,90,22:15,22:30,33.78,1.94,0,39.97,1.94,2,-100901,188734,289635,87833,0,-20114,83,0,0,,20197,-20031
44,11-03-17,91,22:30,22:45,,-9.01,0,-9.01,-9.01,-1,-104737,199682,304419,94945,0,-70894,0,0,0,,70894,-70894
44,11-03-17,92,22:45,23:00,,-54.88,0,-54.88,-54.88,-1,-86508,210618,297126,124110,0,-71951,0,0,0,,71951,-71951
44,11-03-17,93,23:00,23:15,38.58,-38.07,0,38.58,-38.07,2,-86428,133336,219764,46908,0,-62298,207,0,0,,62505,-62091
44,11-03-17,94,23:15,23:30,41.89,-53.78,0,41.89,-53.78,2,-106587,174770,281357,68183,0,-25999,157,0,0,,26156,-25842
44,11-03-17,95,23:30,23:45,,9.96,0,9.96,9.96,-1,-171075,211049,382124,39974,0,-44337,0,0,0,,44337,-44337
44,11-03-17,96,23:45,0:00,,8.65,0,8.65,8.65,-1,-182244,264156,446400,81912,0,-18827,0,0,0,,18827,-18827
45,11-04-17,1,0:00,0:15,136.12,31.81,0,136.12,136.12,1,-218945,87530,306475,-131415,0,-7683,21413,0,0,,29096,13730
45,11-04-17,2,0:15,0:30,136.12,,0,136.12,136.12,1,-135903,99666,235569,-36237,0,0,28093,0,0,,28093,28093
45,11-04-17,3,0:30,0:45,136.12,31.81,0,31.81,31.81,-1,-115954,106814,222768,-9140,0,-323,37,0,0,,360,-286
45,11-04-17,4,0:45,1:00,,30.81,0,30.81,30.81,-1,-99302,106110,205412,6808,0,-8395,0,0,0,,8395,-8395
45,11-04-17,5,1:00,1:15,169.79,30.81,0,169.79,169.79,1,-132914,37310,170224,-95604,0,-1363,12485,0,0,,13848,11122
45,11-04-17,6,1:15,1:30,88.12,,0,88.12,88.12,1,-96365,46971,143336,-49394,0,0,40613,0,0,,40613,40613
45,11-04-17,7,1:30,1:45,38.15,,0,38.15,38.15,1,-84926,45578,130504,-39348,0,0,8545,0,0,,8545,8545
45,11-04-17,8,1:45,2:00,50.02,26.81,0,50.02,26.81,2,-66790,44494,111284,-22296,0,-742,9713,0,0,,10455,8971
45,11-04-17,9,2:00,2:15,50.02,15.51,0,15.51,15.51,-1,-38030,75036,113066,37006,0,-1395,6,0,0,,1401,-1389
45,11-04-17,10,2:15,2:30,,,0,34.4,34.4,0,-51030,81841,132871,30811,0,0,0,0,0,,0,0
45,11-04-17,11,2:30,2:45,,35.01,0,35.01,35.01,-1,-46618,86727,133345,40109,0,-5,0,0,0,,5,-5
45,11-04-17,12,2:45,3:00,,2.38,0,2.38,2.38,-1,-47651,91726,139377,44075,0,-24548,0,0,0,,24548,-24548
45,11-04-17,13,3:00,3:15,43.81,25.99,0,43.81,25.99,2,-48464,64682,113146,16218,0,-19218,1373,0,0,,20591,-17845
45,11-04-17,14,3:15,3:30,43.81,30.81,0,30.81,30.81,-1,-51831,68538,120369,16707,0,-1663,735,0,0,,2398,-928
45,11-04-17,15,3:30,3:45,,,0,33.9,33.9,0,-48880,61975,110855,13095,0,-69,0,0,0,,69,-69
45,11-04-17,16,3:45,4:00,,31.81,0,31.81,31.81,-1,-45422,70281,115703,24859,0,-261,0,0,0,,261,-261
45,11-04-17,17,4:00,4:15,38.17,,0,38.17,38.17,1,-45925,39526,85451,-6399,0,0,1643,0,0,,1643,1643
45,11-04-17,18,4:15,4:30,38.15,31.81,0,31.81,31.81,-1,-49713,41465,91178,-8248,0,-143,2435,0,0,,2578,2292
45,11-04-17,19,4:30,4:45,,31.81,0,31.81,31.81,-1,-47159,37984,85143,-9175,0,-879,0,0,0,,879,-879
45,11-04-17,20,4:45,5:00,,33.61,0,33.61,33.61,-1,-61095,40134,101229,-20961,0,-127,0,0,0,,127,-127
45,11-04-17,21,5:00,5:15,,30.81,0,30.81,30.81,-1,-52292,52800,105092,508,0,-1006,0,0,0,,1006,-1006
45,11-04-17,22,5:15,5:30,,31.81,0,31.81,31.81,-1,-42290,49095,91385,6805,0,-3116,0,0,0,,3116,-3116
45,11-04-17,23,5:30,5:45,,31.81,0,31.81,31.81,-1,-43899,36660,80559,-7239,0,-3111,0,0,0,,3111,-3111
45,11-04-17,24,5:45,6:00,,30.81,0,30.81,30.81,-1,-39007,38319,77326,-688,0,-835,0,0,0,,835,-835
45,11-04-17,25,6:00,6:15,,30.22,0,30.22,30.22,-1,-27959,88595,116554,60636,0,-1940,0,0,0,,1940,-1940
45,11-04-17,26,6:15,6:30,,16.17,0,16.17,16.17,-1,-33380,81796,115176,48416,0,-4530,0,0,0,,4530,-4530
45,11-04-17,27,6:30,6:45,33.22,10.76,0,33.22,33.22,1,-40133,50241,90374,10108,0,-8338,163,0,0,,8501,-8175
45,11-04-17,28,6:45,7:00,35.14,,0,35.14,35.14,1,-55174,43644,98818,-11530,0,0,2156,0,0,,2156,2156
45,11-04-17,29,7:00,7:15,,31.22,0,31.22,31.22,-1,-55645,65312,120957,9667,0,-1142,0,0,0,,1142,-1142
45,11-04-17,30,7:15,7:30,,31.22,0,31.22,31.22,-1,-50917,38976,89893,-11941,0,-1009,0,0,0,,1009,-1009
45,11-04-17,31,7:30,7:45,,,0,34,34,0,-55894,40509,96403,-15385,0,0,0,0,0,,0,0
45,11-04-17,32,7:45,8:00,,,0,33.99,33.99,0,-76794,40445,117239,-36349,0,0,0,0,0,,0,0
45,11-04-17,33,8:00,8:15,,34.24,0,34.24,34.24,-1,-62490,76421,138911,13931,0,-630,0,0,0,,630,-630
45,11-04-17,34,8:15,8:30,34.57,46.71,0,34.57,34.57,1,-47425,46367,93792,-1058,0,-212,189,0,0,,401,-23
45,11-04-17,35,8:30,8:45,55.62,,0,55.62,55.62,1,-76704,26965,103669,-49739,0,0,8586,0,0,,8586,8586
45,11-04-17,36,8:45,9:00,62.55,,0,62.55,62.55,1,-95345,29742,125087,-65603,0,0,28161,0,0,,28161,28161
45,11-04-17,37,9:00,9:15,36.98,33.27,0,33.27,33.27,-1,-59791,69350,129141,9559,0,-915,14688,0,0,,15603,13773
45,11-04-17,38,9:15,9:30,34.83,33.27,0,34.83,34.83,1,-69814,60039,129853,-9775,0,-72,866,0,0,,938,794
45,11-04-17,39,9:30,9:45,36.08,,0,36.08,36.08,1,-61404,50765,112169,-10639,0,0,2821,0,0,,2821,2821
45,11-04-17,40,9:45,10:00,35.21,,0,35.21,35.21,1,-69275,53866,123141,-15409,0,0,1427,0,0,,1427,1427
45,11-04-17,41,10:00,10:15,37.26,,0,37.26,37.26,1,-67090,75369,142459,8279,0,0,3110,0,0,,3110,3110
45,11-04-17,42,10:15,10:30,37.26,46.6,0,46.6,46.6,-1,-38320,88299,126619,49979,0,-54,75,0,0,,129,21
45,11-04-17,43,10:30,10:45,,30.44,0,30.44,30.44,-1,-37187,102519,139706,65332,0,-1518,0,0,0,,1518,-1518
45,11-04-17,44,10:45,11:00,,-46.55,0,-46.55,-46.55,-1,-37584,125868,163452,88284,0,-24912,0,0,0,,24912,-24912
45,11-04-17,45,11:00,11:15,,-50.05,0,-50.05,-50.05,-1,-60980,128074,189054,67094,0,-36102,0,0,0,,36102,-36102
45,11-04-17,46,11:15,11:30,,7.42,0,7.42,7.42,-1,-53065,138567,191632,85502,0,-9292,0,0,0,,9292,-9292
45,11-04-17,47,11:30,11:45,,-18.51,0,-18.51,-18.51,-1,-45152,171706,216858,126554,0,-22961,0,0,0,,22961,-22961
45,11-04-17,48,11:45,12:00,,-17.49,0,-17.49,-17.49,-1,-55190,176714,231904,121524,0,-18385,0,0,0,,18385,-18385
45,11-04-17,49,12:00,12:15,,,0,33.89,33.89,0,-59516,151199,210715,91683,0,-180,0,0,0,,180,-180
45,11-04-17,50,12:15,12:30,,3.19,0,3.19,3.19,-1,-59527,157897,217424,98370,0,-9025,0,0,0,,9025,-9025
45,11-04-17,51,12:30,12:45,,14.35,0,14.35,14.35,-1,-62636,162908,225544,100272,0,-14828,0,0,0,,14828,-14828
45,11-04-17,52,12:45,13:00,,-22.32,0,-22.32,-22.32,-1,-64286,161979,226265,97693,0,-10908,0,0,0,,10908,-10908
45,11-04-17,53,13:00,13:15,,31.44,0,31.44,31.44,-1,-78945,150585,229530,71640,0,-4876,0,0,0,,4876,-4876
45,11-04-17,54,13:15,13:30,,33.81,0,33.81,33.81,-1,-74229,106132,180361,31903,0,-97,0,0,0,,97,-97
45,11-04-17,55,13:30,13:45,,33.82,0,33.82,33.82,-1,-81940,98895,180835,16955,0,-110,0,0,0,,110,-110
45,11-04-17,56,13:45,14:00,,,0,33.54,33.54,0,-89221,94773,183994,5552,0,0,0,0,0,,0,0
45,11-04-17,57,14:00,14:15,33.75,,0,33.75,33.75,1,-103562,89089,192651,-14473,0,0,532,0,0,,532,532
45,11-04-17,58,14:15,14:30,35.52,,0,35.52,35.52,1,-81088,66457,147545,-14631,0,0,1151,0,0,,1151,1151
45,11-04-17,59,14:30,14:45,37.26,,0,37.26,37.26,1,-82835,60570,143405,-22265,0,0,1407,0,0,,1407,1407
45,11-04-17,60,14:45,15:00,81.55,,0,81.55,81.55,1,-100018,46725,146743,-53293,0,0,12519,0,0,,12519,12519
45,11-04-17,61,15:00,15:15,136.12,,0,136.12,136.12,1,-129633,45798,175431,-83835,0,0,68605,0,0,,68605,68605
45,11-04-17,62,15:15,15:30,43.44,,0,43.44,43.44,1,-105583,60787,166370,-44796,0,0,28188,0,0,,28188,28188
45,11-04-17,63,15:30,15:45,84.55,,0,84.55,84.55,1,-121558,66630,188188,-54928,0,0,44662,0,0,,44662,44662
45,11-04-17,64,15:45,16:00,44.46,,0,44.46,44.46,1,-133564,107393,240957,-26171,0,0,40693,0,0,,40693,40693
45,11-04-17,65,16:00,16:15,33.02,23.43,0,33.93,23.43,2,-110184,127285,237469,17101,0,-2986,9808,0,0,,12794,6822
45,11-04-17,66,16:15,16:30,50.31,,0,50.31,50.31,1,-149237,129816,279053,-19421,0,0,8395,0,0,,8395,8395
45,11-04-17,67,16:30,16:45,59.41,,0,59.41,59.41,1,-146120,121302,267422,-24818,0,0,28421,0,0,,28421,28421
45,11-04-17,68,16:45,17:00,50.63,,0,50.63,50.63,1,-159753,121789,281542,-37964,0,0,27992,0,0,,27992,27992
45,11-04-17,69,17:00,17:15,33.02,-18.2,0,39.97,-18.2,2,-84316,121997,206313,37681,0,-16264,10102,0,0,,26366,-6162
45,11-04-17,70,17:15,17:30,,31.55,0,31.55,31.55,-1,-98210,127386,225596,29176,0,-7995,0,0,0,,7995,-7995
45,11-04-17,71,17:30,17:45,,31.44,0,31.44,31.44,-1,-87637,124780,212417,37143,0,-884,0,0,0,,884,-884
45,11-04-17,72,17:45,18:00,,,0,39.97,39.97,0,-70192,130882,201074,60690,0,0,0,0,0,,0,0
45,11-04-17,73,18:00,18:15,,23.75,0,23.75,23.75,-1,-81327,113684,195011,32357,0,-836,0,0,0,,836,-836
45,11-04-17,74,18:15,18:30,,1.8,0,1.8,1.8,-1,-88531,113885,202416,25354,0,-14860,0,0,0,,14860,-14860
45,11-04-17,75,18:30,18:45,,-39.99,0,-39.99,-39.99,-1,-57370,123345,180715,65975,0,-31767,0,0,0,,31767,-31767
45,11-04-17,76,18:45,19:00,,-28.48,0,-28.48,-28.48,-1,-62609,112872,175481,50263,0,-34358,0,0,0,,34358,-34358
45,11-04-17,77,19:00,19:15,,30.44,0,30.44,30.44,-1,-60793,72453,133246,11660,0,-12973,0,0,0,,12973,-12973
45,11-04-17,78,19:15,19:30,,30.44,0,30.44,30.44,-1,-60658,67021,127679,6363,0,-15900,0,0,0,,15900,-15900
45,11-04-17,79,19:30,19:45,,22.03,0,22.03,22.03,-1,-56837,88673,145510,31836,0,-14824,0,0,0,,14824,-14824
45,11-04-17,80,19:45,20:00,,26.44,0,26.44,26.44,-1,-57477,95836,153313,38359,0,-28125,0,0,0,,28125,-28125
45,11-04-17,81,20:00,20:15,72.14,11.78,0,72.14,11.78,2,-62049,54133,116182,-7916,0,-20277,4371,0,0,,24648,-15906
45,11-04-17,82,20:15,20:30,33.22,31.78,0,33.96,31.78,2,-66388,72406,138794,6018,0,-760,1293,0,0,,2053,533
45,11-04-17,83,20:30,20:45,35.22,,0,35.22,35.22,1,-99826,78715,178541,-21111,0,0,807,0,0,,807,807
45,11-04-17,84,20:45,21:00,34.06,30.44,0,34.06,30.44,2,-105387,108043,213430,2656,0,-4537,3,0,0,,4540,-4534
45,11-04-17,85,21:00,21:15,343.36,30.44,0,343.36,343.36,1,-158226,5944,164170,-152282,0,-248,30522,0,0,,30770,30274
45,11-04-17,86,21:15,21:30,61.67,,0,61.67,61.67,1,-132772,48925,181697,-83847,0,0,33091,0,0,,33091,33091
45,11-04-17,87,21:30,21:45,48.4,,0,48.4,48.4,1,-126616,61007,187623,-65609,0,0,3013,0,0,,3013,3013
45,11-04-17,88,21:45,22:00,343.36,,0,343.36,343.36,1,-138189,73055,211244,-65134,0,0,30439,0,0,,30439,30439
45,11-04-17,89,22:00,22:15,53.12,,0,53.12,53.12,1,-83337,50764,134101,-32573,0,0,15893,0,0,,15893,15893
45,11-04-17,90,22:15,22:30,82.93,,0,82.93,82.93,1,-120075,53761,173836,-66314,0,0,20334,0,0,,20334,20334
45,11-04-17,91,22:30,22:45,127.12,,0,127.12,127.12,1,-117660,55859,173519,-61801,0,0,7758,0,0,,7758,7758
45,11-04-17,92,22:45,23:00,132.31,,0,132.31,132.31,1,-136228,79074,215302,-57154,0,0,16663,0,0,,16663,16663
45,11-04-17,93,23:00,23:15,33.22,,0,33.22,33.22,1,-121370,59256,180626,-62114,0,0,132,0,0,,132,132
45,11-04-17,94,23:15,23:30,33.22,,0,33.22,33.22,1,-111315,56654,167969,-54661,0,0,713,0,0,,713,713
45,11-04-17,95,23:30,23:45,51.09,,0,51.09,51.09,1,-111174,70813,181987,-40361,0,0,4745,0,0,,4745,4745
45,11-04-17,96,23:45,0:00,49.12,26.22,0,49.12,26.22,2,-129477,83712,213189,-45765,0,-173,17009,0,0,,17182,16836
45,11-05-17,1,0:00,0:15,49.12,-70,0,-70,-70,-1,-56475,194789,251264,138314,0,-38023,1473,0,0,,39496,-36550
45,11-05-17,2,0:15,0:30,127.7,-70,0,127.7,127.7,1,-104829,59626,164455,-45203,0,-3620,19030,0,0,,22650,15410
45,11-05-17,3,0:30,0:45,36.64,10.49,0,36.64,10.49,2,-70641,66206,136847,-4435,0,-5489,1754,0,0,,7243,-3735
45,11-05-17,4,0:45,1:00,38.98,,0,38.98,38.98,1,-80288,60392,140680,-19896,0,0,1636,0,0,,1636,1636
45,11-05-17,5,1:00,1:15,131.51,,0,131.51,131.51,1,-141419,32028,173447,-109391,0,0,36610,0,0,,36610,36610
45,11-05-17,6,1:15,1:30,131.51,,0,131.51,131.51,1,-71933,37108,109041,-34825,0,0,56160,0,0,,56160,56160
45,11-05-17,7,1:30,1:45,118.94,32.76,0,118.94,32.76,2,-79410,42725,122135,-36685,0,-31,11784,0,0,,11815,11753
45,11-05-17,8,1:45,2:00,117.32,,0,117.32,117.32,1,-74491,32399,106890,-42092,0,0,44132,0,0,,44132,44132
45,11-05-17,9,2:00,2:15,36.64,29.64,0,36.64,29.64,2,-66866,65949,132815,-917,0,-685,7758,0,0,,8443,7073
45,11-05-17,10,2:15,2:30,36.64,30.37,0,36.64,30.37,2,-50352,55720,106072,5368,0,-1233,1573,0,0,,2806,340
45,11-05-17,11,2:30,2:45,33.14,28.13,0,33.83,28.13,2,-59480,68003,127483,8523,0,-6334,23,0,0,,6357,-6311
45,11-05-17,12,2:45,3:00,33.54,29.02,0,33.83,29.02,2,-68903,79085,147988,10182,0,-1479,232,0,0,,1711,-1247
45,11-05-17,13,3:00,3:15,46.64,29.02,0,46.64,46.64,1,-88814,59472,148286,-29342,0,-266,5649,0,0,,5915,5383
45,11-05-17,14,3:15,3:30,,,0,33.36,33.36,0,-75078,67912,142990,-7166,0,0,174,0,0,,174,174
45,11-05-17,15,3:30,3:45,37.68,,0,37.68,37.68,1,-72372,53985,126357,-18387,0,0,1969,0,0,,1969,1969
45,11-05-17,16,3:45,4:00,32.02,33.64,0,33.64,33.64,-1,-63924,38847,102771,-25077,0,-64,473,0,0,,537,409
45,11-05-17,17,4:00,4:15,,29.64,0,29.64,29.64,-1,-26011,101835,127846,75824,0,-1211,0,0,0,,1211,-1211
45,11-05-17,18,4:15,4:30,,-8.93,0,-8.93,-8.93,-1,-33361,115163,148524,81802,0,-15442,0,0,0,,15442,-15442
45,11-05-17,19,4:30,4:45,,22.54,0,22.54,22.54,-1,-38110,95132,133242,57022,0,-33917,0,0,0,,33917,-33917
45,11-05-17,20,4:45,5:00,,29.34,0,29.34,29.34,-1,-41878,58279,100157,16401,0,-15571,0,0,0,,15571,-15571
45,11-05-17,21,5:00,5:15,,12.26,0,12.26,12.26,-1,-33407,79067,112474,45660,0,-9689,0,0,0,,9689,-9689
45,11-05-17,22,5:15,5:30,36.64,32.5,0,36.64,32.5,2,-54058,50821,104879,-3237,0,-730,162,0,0,,892,-568
45,11-05-17,23,5:30,5:45,,28.03,0,28.03,28.03,-1,-45503,54945,100448,9442,0,-6569,0,0,0,,6569,-6569
45,11-05-17,24,5:45,6:00,,32.92,0,32.92,32.92,-1,-43047,57475,100522,14428,0,-1209,0,0,0,,1209,-1209
45,11-05-17,25,6:00,6:15,,-6.12,0,-6.12,-6.12,-1,-34218,97353,131571,63135,0,-31759,0,0,0,,31759,-31759
45,11-05-17,26,6:15,6:30,,18.12,0,18.12,18.12,-1,-38123,67836,105959,29713,0,-43855,0,0,0,,43855,-43855
45,11-05-17,27,6:30,6:45,40.37,18.12,0,40.37,40.37,1,-61796,57535,119331,-4261,0,-12778,143,0,0,,12921,-12635
45,11-05-17,28,6:45,7:00,36.59,33.59,0,39.1,33.59,2,-63180,69290,132470,6110,0,-171,592,0,0,,763,421
45,11-05-17,29,7:00,7:15,,34.59,0,34.59,34.59,-1,-84692,83036,167728,-1656,0,-640,0,0,0,,640,-640
45,11-05-17,30,7:15,7:30,,-38.67,0,-38.67,-38.67,-1,-32024,120785,152809,88761,0,-22581,0,0,0,,22581,-22581
45,11-05-17,31,7:30,7:45,,-68.58,0,-68.58,-68.58,-1,-41988,114824,156812,72836,0,-60981,0,0,0,,60981,-60981
45,11-05-17,32,7:45,8:00,33.13,31.2,0,33.13,33.13,1,-58520,92073,150593,33553,0,-22654,6,0,0,,22660,-22648
45,11-05-17,33,8:00,8:15,33.74,26.53,0,39.15,26.53,2,-80026,99892,179918,19866,0,-10273,174,0,0,,10447,-10099
45,11-05-17,34,8:15,8:30,,26.53,0,26.53,26.53,-1,-52539,94195,146734,41656,0,-39074,0,0,0,,39074,-39074
45,11-05-17,35,8:30,8:45,,33.59,0,33.59,33.59,-1,-64780,118747,183527,53967,0,-14687,0,0,0,,14687,-14687
45,11-05-17,36,8:45,9:00,,29.59,0,29.59,29.59,-1,-69317,124960,194277,55643,0,-7899,0,0,0,,7899,-7899
45,11-05-17,37,9:00,9:15,38.9,34.59,0,39.16,34.59,2,-100464,94906,195370,-5558,0,-3571,695,0,0,,4266,-2876
45,11-05-17,38,9:15,9:30,33.09,,0,33.09,33.09,1,-83887,101787,185674,17900,0,0,79,0,0,,79,79
45,11-05-17,39,9:30,9:45,,,0,39.16,39.16,0,-60030,101628,161658,41598,0,0,0,0,0,,0,0
45,11-05-17,40,9:45,10:00,,,0,39.16,39.16,0,-44780,102596,147376,57816,0,0,0,0,0,,0,0
45,11-05-17,41,10:00,10:15,,21.99,0,21.99,21.99,-1,-62896,99632,162528,36736,0,-8119,0,0,0,,8119,-8119
45,11-05-17,42,10:15,10:30,,21.53,0,21.53,21.53,-1,-76292,91878,168170,15586,0,-22901,0,0,0,,22901,-22901
45,11-05-17,43,10:30,10:45,,31.05,0,31.05,31.05,-1,-69175,88756,157931,19581,0,-1889,0,0,0,,1889,-1889
45,11-05-17,44,10:45,11:00,,-10.73,0,-10.73,-10.73,-1,-43173,103352,146525,60179,0,-29225,0,0,0,,29225,-29225
45,11-05-17,45,11:00,11:15,,33.59,0,33.59,33.59,-1,-45643,131495,177138,85852,0,-10092,0,0,0,,10092,-10092
45,11-05-17,46,11:15,11:30,,33.59,0,33.59,33.59,-1,-45843,169589,215432,123746,0,-1783,0,0,0,,1783,-1783
45,11-05-17,47,11:30,11:45,,,0,39.16,39.16,0,-43341,141716,185057,98375,0,0,0,0,0,,0,0
45,11-05-17,48,11:45,12:00,,,0,39.15,39.15,0,-57657,102894,160551,45237,0,0,0,0,0,,0,0
45,11-05-17,49,12:00,12:15,,0.86,0,0.86,0.86,-1,-66982,131258,198240,64276,0,-11435,0,0,0,,11435,-11435
45,11-05-17,50,12:15,12:30,56.02,29.59,0,56.02,56.02,1,-82970,80878,163848,-2092,0,-12664,1787,0,0,,14451,-10877
45,11-05-17,51,12:30,12:45,56.21,34.59,0,34.59,34.59,-1,-69478,73130,142608,3652,0,-211,5204,0,0,,5415,4993
45,11-05-17,52,12:45,13:00,199.7,34.59,0,199.7,199.7,1,-84194,32520,116714,-51674,0,-59,7741,0,0,,7800,7682
45,11-05-17,53,13:00,13:15,281.86,,0,281.86,281.86,1,-99306,77634,176940,-21672,0,0,29172,0,0,,29172,29172
45,11-05-17,54,13:15,13:30,281.86,44.54,0,44.54,44.54,-1,-94423,92901,187324,-1522,0,-76,601,0,0,,677,525
45,11-05-17,55,13:30,13:45,,33.59,0,33.59,33.59,-1,-82889,99850,182739,16961,0,-2777,0,0,0,,2777,-2777
45,11-05-17,56,13:45,14:00,,,0,39.15,39.15,0,-86096,68112,154208,-17984,0,-1044,0,0,0,,1044,-1044
45,11-05-17,57,14:00,14:15,39.33,,0,39.33,39.33,1,-72782,75466,148248,2684,0,0,1661,0,0,,1661,1661
45,11-05-17,58,14:15,14:30,33.16,,0,33.16,33.16,1,-61640,84313,145953,22673,0,0,325,0,0,,325,325
45,11-05-17,59,14:30,14:45,,33.59,0,33.59,33.59,-1,-56315,127779,184094,71464,0,-206,0,0,0,,206,-206
45,11-05-17,60,14:45,15:00,,33.59,0,33.59,33.59,-1,-56998,96299,153297,39301,0,-3842,0,0,0,,3842,-3842
45,11-05-17,61,15:00,15:15,,29.59,0,29.59,29.59,-1,-58485,124942,183427,66457,0,-5639,0,0,0,,5639,-5639
45,11-05-17,62,15:15,15:30,33.1,29.59,0,33.1,33.1,1,-72316,101403,173719,29087,0,-66,115,0,0,,181,49
45,11-05-17,63,15:30,15:45,,,0,39.15,39.15,0,-60378,101091,161469,40713,0,0,0,0,0,,0,0
45,11-05-17,64,15:45,16:00,,,0,39.14,39.14,0,-56835,98009,154844,41174,0,0,0,0,0,,0,0
45,11-05-17,65,16:00,16:15,,,0,39.14,39.14,0,-60391,110169,170560,49778,0,0,0,0,0,,0,0
45,11-05-17,66,16:15,16:30,,33.59,0,33.59,33.59,-1,-35543,125211,160754,89668,0,-1291,0,0,0,,1291,-1291
45,11-05-17,67,16:30,16:45,,,0,39.14,39.14,0,-57424,90712,148136,33288,0,-48,0,0,0,,48,-48
45,11-05-17,68,16:45,17:00,41.86,,0,41.86,41.86,1,-113419,90253,203672,-23166,0,0,3108,0,0,,3108,3108
45,11-05-17,69,17:00,17:15,41.86,-44.37,0,-44.37,-44.37,-1,-50420,219021,269441,168601,0,-42030,532,0,0,,42562,-41498
45,11-05-17,70,17:15,17:30,,29.59,0,29.59,29.59,-1,-43575,116465,160040,72890,0,-32019,0,0,0,,32019,-32019
45,11-05-17,71,17:30,17:45,,4.09,0,4.09,4.09,-1,-43310,113743,157053,70433,0,-21351,0,0,0,,21351,-21351
45,11-05-17,72,17:45,18:00,,44.59,0,44.59,44.59,-1,-50209,108587,158796,58378,0,-6667,0,0,0,,6667,-6667
45,11-05-17,73,18:00,18:15,346.94,44.59,0,346.94,346.94,1,-89877,33173,123050,-56704,0,-66,11425,0,0,,11491,11359
45,11-05-17,74,18:15,18:30,38.21,-1.37,0,-1.37,-1.37,-1,-62371,99703,162074,37332,0,-6328,6418,0,0,,12746,90
45,11-05-17,75,18:30,18:45,,-27.75,0,-27.75,-27.75,-1,-56190,115244,171434,59054,0,-55957,0,0,0,,55957,-55957
45,11-05-17,76,18:45,19:00,,22.17,0,22.17,22.17,-1,-55590,86244,141834,30654,0,-34696,0,0,0,,34696,-34696
45,11-05-17,77,19:00,19:15,34.02,22.17,0,34.02,34.02,1,-74642,43035,117677,-31607,0,-1342,767,0,0,,2109,-575
45,11-05-17,78,19:15,19:30,132.86,,0,132.86,132.86,1,-91081,51239,142320,-39842,0,0,11977,0,0,,11977,11977
45,11-05-17,79,19:30,19:45,37.86,-27.75,0,-27.75,-27.75,-1,-50039,109320,159359,59281,0,-14848,5644,0,0,,20492,-9204
45,11-05-17,80,19:45,20:00,,-27.75,0,-27.75,-27.75,-1,-69460,107092,176552,37632,0,-51930,0,0,0,,51930,-51930
45,11-05-17,81,20:00,20:15,40.59,-27.75,0,40.59,40.59,1,-96878,93833,190711,-3045,0,-2721,1794,0,0,,4515,-927
45,11-05-17,82,20:15,20:30,,25.09,0,25.09,25.09,-1,-85391,99510,184901,14119,0,-4653,0,0,0,,4653,-4653
45,11-05-17,83,20:30,20:45,40.59,19.81,0,40.59,19.81,2,-88700,86699,175399,-2001,0,-12238,146,0,0,,12384,-12092
45,11-05-17,84,20:45,21:00,54.67,33.59,0,54.67,33.59,2,-87692,85560,173252,-2132,0,-897,5977,0,0,,6874,5080
45,11-05-17,85,21:00,21:15,189.86,33.59,0,189.86,33.59,2,-117006,69892,186898,-47114,0,-620,15111,0,0,,15731,14491
45,11-05-17,86,21:15,21:30,46.59,24.52,0,24.52,24.52,-1,-97186,101705,198891,4519,0,-1664,12277,0,0,,13941,10613
45,11-05-17,87,21:30,21:45,,21.65,0,21.65,21.65,-1,-84005,90400,174405,6395,0,-6613,0,0,0,,6613,-6613
45,11-05-17,88,21:45,22:00,,19.08,0,19.08,19.08,-1,-72164,100305,172469,28141,0,-7316,0,0,0,,7316,-7316
45,11-05-17,89,22:00,22:15,374.86,-0.86,0,374.86,374.86,1,-112669,53668,166337,-59001,0,-9805,9830,0,0,,19635,25
45,11-05-17,90,22:15,22:30,42.86,-54.59,0,-54.59,-54.59,-1,-52720,115032,167752,62312,0,-12174,5899,0,0,,18073,-6275
45,11-05-17,91,22:30,22:45,,-38.21,0,-38.21,-38.21,-1,-59300,97011,156311,37711,0,-24822,0,0,0,,24822,-24822
45,11-05-17,92,22:45,23:00,,12.31,0,12.31,12.31,-1,-85464,121132,206596,35668,0,-4231,0,0,0,,4231,-4231
45,11-05-17,93,23:00,23:15,33.76,-62.96,0,39.09,-62.96,2,-55921,73798,129719,17877,0,-30991,37,0,0,,31028,-30954
45,11-05-17,94,23:15,23:30,34.47,-38.07,0,39.1,-38.07,2,-63877,98146,162023,34269,0,-8795,394,0,0,,9189,-8401
45,11-05-17,95,23:30,23:45,,-27.33,0,-27.33,-27.33,-1,-66266,135940,202206,69674,0,-64695,0,0,0,,64695,-64695
45,11-05-17,96,23:45,0:00,,-64.97,0,-64.97,-64.97,-1,-81486,186758,268244,105272,0,-90925,0,0,0,,90925,-90925
45,11-06-17,1,0:00,0:15,,-59.04,0,-59.04,-59.04,-1,-58201,159817,218018,101616,0,-83735,0,0,0,,83735,-83735
45,11-06-17,2,0:15,0:30,,-16.21,0,-16.21,-16.21,-1,-87507,147458,234965,59951,0,-40767,0,0,0,,40767,-40767
45,11-06-17,3,0:30,0:45,,-4.78,0,-4.78,-4.78,-1,-77677,142108,219785,64431,0,-58781,0,0,0,,58781,-58781
45,11-06-17,4,0:45,1:00,,10.84,0,10.84,10.84,-1,-92665,142284,234949,49619,0,-59855,0,0,0,,59855,-59855
45,11-06-17,5,1:00,1:15,,30.29,0,30.29,30.29,-1,-71855,95552,167407,23697,0,-19384,0,0,0,,19384,-19384
45,11-06-17,6,1:15,1:30,,31.29,0,31.29,31.29,-1,-64574,75189,139763,10615,0,-8287,0,0,0,,8287,-8287
45,11-06-17,7,1:30,1:45,,31.29,0,31.29,31.29,-1,-68504,78745,147249,10241,0,-6400,0,0,0,,6400,-6400
45,11-06-17,8,1:45,2:00,,29.66,0,29.66,29.66,-1,-86295,99181,185476,12886,0,-6153,0,0,0,,6153,-6153
45,11-06-17,9,2:00,2:15,,,0,39.08,39.08,0,-85119,76489,161608,-8630,0,-1464,0,0,0,,1464,-1464
45,11-06-17,10,2:15,2:30,46.59,,0,46.59,46.59,1,-88030,60472,148502,-27558,0,0,9626,0,0,,9626,9626
45,11-06-17,11,2:30,2:45,46.59,,0,46.59,46.59,1,-67756,38534,106290,-29222,0,0,25199,0,0,,25199,25199
45,11-06-17,12,2:45,3:00,46.59,15.24,0,15.24,15.24,-1,-52078,70929,123007,18851,0,-8934,5618,0,0,,14552,-3316
45,11-06-17,13,3:00,3:15,33.12,31.29,0,33.12,33.12,1,-49473,55879,105352,6406,0,-4061,154,0,0,,4215,-3907
45,11-06-17,14,3:15,3:30,36.59,,0,36.59,36.59,1,-51212,47054,98266,-4158,0,0,185,0,0,,185,185
45,11-06-17,15,3:30,3:45,51.12,,0,51.12,51.12,1,-84275,51057,135332,-33218,0,0,16992,0,0,,16992,16992
45,11-06-17,16,3:45,4:00,131.15,,0,131.15,131.15,1,-100606,32540,133146,-68066,0,0,34529,0,0,,34529,34529
45,11-06-17,17,4:00,4:15,117.01,,0,117.01,117.01,1,-86894,32608,119502,-54286,0,0,44455,0,0,,44455,44455
45,11-06-17,18,4:15,4:30,68.29,,0,68.29,68.29,1,-95679,53319,148998,-42360,0,0,12652,0,0,,12652,12652
45,11-06-17,19,4:30,4:45,93.12,,0,93.12,93.12,1,-96121,47755,143876,-48366,0,0,26637,0,0,,26637,26637
45,11-06-17,20,4:45,5:00,42.41,,0,42.41,42.41,1,-85263,41163,126426,-44100,0,0,19618,0,0,,19618,19618
45,11-06-17,21,5:00,5:15,42.41,10.84,0,10.84,10.84,-1,-58510,82557,141067,24047,0,-11554,7314,0,0,,18868,-4240
45,11-06-17,22,5:15,5:30,81.93,32,0,81.93,81.93,1,-100699,50685,151384,-50014,0,-3185,6308,0,0,,9493,3123
45,11-06-17,23,5:30,5:45,125.12,,0,125.12,125.12,1,-129280,46925,176205,-82355,0,0,52308,0,0,,52308,52308
45,11-06-17,24,5:45,6:00,128.97,,0,128.97,128.97,1,-132184,76184,208368,-56000,0,0,64664,0,0,,64664,64664
45,11-06-17,25,6:00,6:15,128.97,-3.61,0,-3.61,-3.61,-1,-105883,126715,232598,20832,0,-6534,10410,0,0,,16944,3876
45,11-06-17,26,6:15,6:30,,-33.06,0,-33.06,-33.06,-1,-77183,127561,204744,50378,0,-63717,0,0,0,,63717,-63717
45,11-06-17,27,6:30,6:45,36.59,30.42,0,39.23,30.42,2,-53398,71235,124633,17837,0,-8009,469,0,0,,8478,-7540
45,11-06-17,28,6:45,7:00,54.92,44.94,0,54.92,39.22,2,-84434,65245,149679,-19189,0,-772,3512,0,0,,4284,2740
45,11-06-17,29,7:00,7:15,33.35,27.78,0,39.25,27.78,2,-81144,106500,187644,25356,0,-3085,85,0,0,,3170,-3000
45,11-06-17,30,7:15,7:30,46.59,26.96,0,46.59,46.59,1,-102523,72816,175339,-29707,0,-7077,2446,0,0,,9523,-4631
45,11-06-17,31,7:30,7:45,36.59,,0,36.59,36.59,1,-84192,27967,112159,-56225,0,0,2126,0,0,,2126,2126
45,11-06-17,32,7:45,8:00,61.42,,0,61.42,61.42,1,-85902,44823,130725,-41079,0,0,5288,0,0,,5288,5288
45,11-06-17,33,8:00,8:15,61.42,33.59,0,33.59,33.59,-1,-82602,105766,188368,23164,0,-3326,1227,0,0,,4553,-2099
45,11-06-17,34,8:15,8:30,,33.59,0,33.59,33.59,-1,-63300,77903,141203,14603,0,-4209,0,0,0,,4209,-4209
45,11-06-17,35,8:30,8:45,35.38,33.59,0,35.38,35.38,1,-70637,44503,115140,-26134,0,-141,908,0,0,,1049,767
45,11-06-17,36,8:45,9:00,39.26,,0,39.26,39.26,1,-80564,37278,117842,-43286,0,0,2523,0,0,,2523,2523
45,11-06-17,37,9:00,9:15,182.09,,0,182.09,182.09,1,-91054,39434,130488,-51620,0,0,19751,0,0,,19751,19751
45,11-06-17,38,9:15,9:30,53.12,,0,53.12,53.12,1,-90137,44354,134491,-45783,0,0,30035,0,0,,30035,30035
45,11-06-17,39,9:30,9:45,42.12,,0,42.12,42.12,1,-80495,48862,129357,-31633,0,0,19919,0,0,,19919,19919
45,11-06-17,40,9:45,10:00,36.36,43.88,0,39.26,39.26,2,-69958,59906,129864,-10052,0,-216,3397,0,0,,3613,3181
45,11-06-17,41,10:00,10:15,305.64,,0,305.64,305.64,1,-74237,36961,111198,-37276,0,0,21545,0,0,,21545,21545
45,11-06-17,42,10:15,10:30,305.64,32.78,0,32.78,32.78,-1,-62503,67523,130026,5020,0,-1155,5985,0,0,,7140,4830
45,11-06-17,43,10:30,10:45,,33.59,0,33.59,33.59,-1,-63699,74264,137963,10565,0,-2460,0,0,0,,2460,-2460
45,11-06-17,44,10:45,11:00,,29.59,0,29.59,29.59,-1,-76589,87674,164263,11085,0,-16284,0,0,0,,16284,-16284
45,11-06-17,45,11:00,11:15,36.98,29.59,0,36.98,36.98,1,-71445,56619,128064,-14826,0,-2571,2077,0,0,,4648,-494
45,11-06-17,46,11:15,11:30,,33.46,0,33.46,33.46,-1,-62837,75302,138139,12465,0,-1132,0,0,0,,1132,-1132
45,11-06-17,47,11:30,11:45,,32.35,0,32.35,32.35,-1,-62274,78417,140691,16143,0,-9739,0,0,0,,9739,-9739
45,11-06-17,48,11:45,12:00,,33.59,0,33.59,33.59,-1,-66928,75945,142873,9017,0,-5511,0,0,0,,5511,-5511
45,11-06-17,49,12:00,12:15,,9.78,0,9.78,9.78,-1,-50514,90264,140778,39750,0,-23147,0,0,0,,23147,-23147
45,11-06-17,50,12:15,12:30,,32.78,0,32.78,32.78,-1,-66344,86549,152893,20205,0,-19557,0,0,0,,19557,-19557
45,11-06-17,51,12:30,12:45,,29.09,0,29.09,29.09,-1,-66775,103706,170481,36931,0,-23958,0,0,0,,23958,-23958
45,11-06-17,52,12:45,13:00,,32.78,0,32.78,32.78,-1,-69729,89641,159370,19912,0,-25141,0,0,0,,25141,-25141
45,11-06-17,53,13:00,13:15,,32.76,0,32.76,32.76,-1,-72517,95145,167662,22628,0,-16834,0,0,0,,16834,-16834
45,11-06-17,54,13:15,13:30,35.58,32.76,0,35.58,35.58,1,-72842,67475,140317,-5367,0,-3988,485,0,0,,4473,-3503
45,11-06-17,55,13:30,13:45,49.79,,0,49.79,49.79,1,-78339,53853,132192,-24486,0,0,4059,0,0,,4059,4059
45,11-06-17,56,13:45,14:00,57.83,,0,57.83,57.83,1,-76662,38050,114712,-38612,0,0,17350,0,0,,17350,17350
45,11-06-17,57,14:00,14:15,39.12,29.21,0,40.02,29.21,2,-59257,69208,128465,9951,0,-3880,9779,0,0,,13659,5899
45,11-06-17,58,14:15,14:30,36.27,29.21,0,36.27,36.27,1,-61752,53184,114936,-8568,0,-1062,2292,0,0,,3354,1230
45,11-06-17,59,14:30,14:45,35.38,,0,35.38,35.38,1,-65489,48087,113576,-17402,0,0,3374,0,0,,3374,3374
45,11-06-17,60,14:45,15:00,37.02,,0,37.02,37.02,1,-74838,42058,116896,-32780,0,0,5149,0,0,,5149,5149
45,11-06-17,61,15:00,15:15,,,0,40.02,40.02,0,-48721,75899,124620,27178,0,0,920,0,0,,920,920
45,11-06-17,62,15:15,15:30,35.68,,0,35.68,35.68,1,-55359,53850,109209,-1509,0,0,319,0,0,,319,319
45,11-06-17,63,15:30,15:45,39.38,,0,39.38,39.38,1,-63732,24000,87732,-39732,0,0,5085,0,0,,5085,5085
45,11-06-17,64,15:45,16:00,43.19,,0,43.19,43.19,1,-84872,21051,105923,-63821,0,0,11507,0,0,,11507,11507
45,11-06-17,65,16:00,16:15,35.38,,0,35.38,35.38,1,-75484,77525,153009,2041,0,0,1033,0,0,,1033,1033
45,11-06-17,66,16:15,16:30,,,0,41.04,41.04,0,-70419,64822,135241,-5597,0,0,0,0,0,,0,0
45,11-06-17,67,16:30,16:45,35.38,34.59,0,41.02,34.59,2,-57282,53487,110769,-3795,0,-1354,157,0,0,,1511,-1197
45,11-06-17,68,16:45,17:00,42.21,,0,42.21,42.21,1,-77527,44859,122386,-32668,0,0,4515,0,0,,4515,4515
45,11-06-17,69,17:00,17:15,42.21,12.78,0,12.78,12.78,-1,-82687,118820,201507,36133,0,-12212,1318,0,0,,13530,-10894
45,11-06-17,70,17:15,17:30,641.57,12.78,0,641.57,641.57,1,-86467,47665,134132,-38802,0,-723,14680,0,0,,15403,13957
45,11-06-17,71,17:30,17:45,641.57,43.27,0,641.57,41.03,2,-78568,67232,145800,-11336,0,-46,38517,0,0,,38563,38471
45,11-06-17,72,17:45,18:00,641.57,33.59,0,641.57,33.59,2,-64406,98004,162410,33598,0,-1668,8795,0,0,,10463,7127
45,11-06-17,73,18:00,18:15,723.69,-2.09,0,723.69,-2.09,2,-91561,77892,169453,-13669,0,-1245,31169,0,0,,32414,29924
45,11-06-17,74,18:15,18:30,59.9,-9.78,0,59.9,-9.78,2,-73359,73371,146730,12,0,-13813,1490,0,0,,15303,-12323
45,11-06-17,75,18:30,18:45,35.41,14.61,0,14.61,14.61,-1,-64594,86741,151335,22147,0,-10106,359,0,0,,10465,-9747
45,11-06-17,76,18:45,19:00,,16.9,0,16.9,16.9,-1,-69561,91746,161307,22185,0,-27109,0,0,0,,27109,-27109
45,11-06-17,77,19:00,19:15,127.12,33.59,0,127.12,33.59,2,-77295,54110,131405,-23185,0,-14222,5983,0,0,,20205,-8239
45,11-06-17,78,19:15,19:30,37.43,34.59,0,40.26,34.59,2,-68999,73434,142433,4435,0,-1364,1763,0,0,,3127,399
45,11-06-17,79,19:30,19:45,,32.78,0,32.78,32.78,-1,-64391,87004,151395,22613,0,-3651,0,0,0,,3651,-3651
45,11-06-17,80,19:45,20:00,,14.34,0,14.34,14.34,-1,-57122,76129,133251,19007,0,-23142,0,0,0,,23142,-23142
45,11-06-17,81,20:00,20:15,583.76,14.34,0,583.76,583.76,1,-114130,31823,145953,-82307,0,-4978,32278,0,0,,37256,27300
45,11-06-17,82,20:15,20:30,35.38,43.5,0,43.5,43.5,-1,-79840,69017,148857,-10823,0,-205,17471,0,0,,17676,17266
45,11-06-17,83,20:30,20:45,35.38,-3.37,0,-3.37,-3.37,-1,-46892,86036,132928,39144,0,-15649,47,0,0,,15696,-15602
45,11-06-17,84,20:45,21:00,,32.78,0,32.78,32.78,-1,-56464,79280,135744,22816,0,-32847,0,0,0,,32847,-32847
45,11-06-17,85,21:00,21:15,167.9,12.07,0,167.9,12.07,2,-78785,59809,138594,-18976,0,-18845,5913,0,0,,24758,-12932
45,11-06-17,86,21:15,21:30,181.44,11.66,0,181.44,11.66,2,-54726,63042,117768,8316,0,-3154,13916,0,0,,17070,10762
45,11-06-17,87,21:30,21:45,181.44,-4.92,0,-4.92,-4.92,-1,-47086,85867,132953,38781,0,-44323,34,0,0,,44357,-44289
45,11-06-17,88,21:45,22:00,,-1.88,0,-1.88,-1.88,-1,-62380,122437,184817,60057,0,-52224,0,0,0,,52224,-52224
45,11-06-17,89,22:00,22:15,154.3,-63.51,0,154.3,154.3,1,-82208,76624,158832,-5584,0,-37444,4093,0,0,,41537,-33351
45,11-06-17,90,22:15,22:30,37.43,14.48,0,14.48,14.48,-1,-52715,59785,112500,7070,0,-4556,4379,0,0,,8935,-177
45,11-06-17,91,22:30,22:45,,8.62,0,8.62,8.62,-1,-71316,107028,178344,35712,0,-28693,0,0,0,,28693,-28693
45,11-06-17,92,22:45,23:00,,27.53,0,27.53,27.53,-1,-79328,110055,189383,30727,0,-25020,0,0,0,,25020,-25020
45,11-06-17,93,23:00,23:15,142.06,27.53,0,142.06,142.06,1,-112813,40903,153716,-71910,0,-2644,23227,0,0,,25871,20583
45,11-06-17,94,23:15,23:30,43.66,30.09,0,30.09,30.09,-1,-70098,64232,134330,-5866,0,-897,15150,0,0,,16047,14253
45,11-06-17,95,23:30,23:45,43.66,26.42,0,26.42,26.42,-1,-57297,68338,125635,11041,0,-8909,64,0,0,,8973,-8845
45,11-06-17,96,23:45,0:00,,17.01,0,17.01,17.01,-1,-52493,89261,141754,36768,0,-28194,0,0,0,,28194,-28194
45,11-07-17,1,0:00,0:15,38.91,-50.96,0,39.47,-50.96,2,-45532,80069,125601,34537,0,-37986,191,0,0,,38177,-37795
45,11-07-17,2,0:15,0:30,42.41,-43.9,0,42.41,-43.9,2,-38233,81770,120003,43537,0,-14784,1334,0,0,,16118,-13450
45,11-07-17,3,0:30,0:45,,-21.74,0,-21.74,-21.74,-1,-25354,40883,66237,15529,0,-19563,0,0,0,,19563,-19563
45,11-07-17,4,0:45,1:00,,8.45,0,8.45,8.45,-1,-24224,73827,98051,49603,0,-31795,0,0,0,,31795,-31795
45,11-07-17,5,1:00,1:15,69.89,26.42,0,69.89,69.89,1,-57573,23995,81568,-33578,0,-19840,3920,0,0,,23760,-15920
45,11-07-17,6,1:15,1:30,35.98,30.42,0,30.42,30.42,-1,-33960,33466,67426,-494,0,-1205,2763,0,0,,3968,1558
45,11-07-17,7,1:30,1:45,,31.42,0,31.42,31.42,-1,-28402,31325,59727,2923,0,-922,0,0,0,,922,-922
45,11-07-17,8,1:45,2:00,,21.12,0,21.12,21.12,-1,-27934,55563,83497,27629,0,-25973,0,0,0,,25973,-25973
45,11-07-17,9,2:00,2:15,34.48,27.57,0,34.48,34.48,1,-14168,52077,66245,37909,0,-32403,10,0,0,,32413,-32393
45,11-07-17,10,2:15,2:30,35.38,10.56,0,39.52,10.56,2,-24894,57561,82455,32667,0,-7881,603,0,0,,8484,-7278
45,11-07-17,11,2:30,2:45,,-17.53,0,-17.53,-17.53,-1,-21749,58066,79815,36317,0,-42352,0,0,0,,42352,-42352
45,11-07-17,12,2:45,3:00,,9.32,0,9.32,9.32,-1,-17908,77773,95681,59865,0,-14703,0,0,0,,14703,-14703
45,11-07-17,13,3:00,3:15,,30.42,0,30.42,30.42,-1,-42949,53577,96526,10628,0,-19676,0,0,0,,19676,-19676
45,11-07-17,14,3:15,3:30,,31.42,0,31.42,31.42,-1,-44356,52589,96945,8233,0,-14039,0,0,0,,14039,-14039
45,11-07-17,15,3:30,3:45,,34.31,0,34.31,34.31,-1,-44395,47364,91759,2969,0,-2828,0,0,0,,2828,-2828
45,11-07-17,16,3:45,4:00,,26.75,0,26.75,26.75,-1,-43495,60586,104081,17091,0,-13784,0,0,0,,13784,-13784
45,11-07-17,17,4:00,4:15,,28.99,0,28.99,28.99,-1,-49472,69851,119323,20379,0,-12428,0,0,0,,12428,-12428
45,11-07-17,18,4:15,4:30,,25.79,0,25.79,25.79,-1,-40060,62648,102708,22588,0,-23064,0,0,0,,23064,-23064
45,11-07-17,19,4:30,4:45,35.07,25.79,0,35.07,35.07,1,-49354,53567,102921,4213,0,-5428,412,0,0,,5840,-5016
45,11-07-17,20,4:45,5:00,35.07,26.42,0,26.42,26.42,-1,-42702,59365,102067,16663,0,-8348,5,0,0,,8353,-8343
45,11-07-17,21,5:00,5:15,,1.06,0,1.06,1.06,-1,-36367,75640,112007,39273,0,-20617,0,0,0,,20617,-20617
45,11-07-17,22,5:15,5:30,,18.93,0,18.93,18.93,-1,-36661,82683,119344,46022,0,-40322,0,0,0,,40322,-40322
45,11-07-17,23,5:30,5:45,35.49,3.95,0,38.32,3.95,2,-49687,78824,128511,29137,0,-43728,102,0,0,,43830,-43626
45,11-07-17,24,5:45,6:00,75.35,3.95,0,75.35,75.35,1,-44415,63756,108171,19341,0,-3184,7693,0,0,,10877,4509
45,11-07-17,25,6:00,6:15,75.35,-27.01,0,-27.01,-27.01,-1,-17015,123240,140255,106225,0,-38744,319,0,0,,39063,-38425
45,11-07-17,26,6:15,6:30,,-27.01,0,-27.01,-27.01,-1,-31885,85814,117699,53929,0,-71654,0,0,0,,71654,-71654
45,11-07-17,27,6:30,6:45,35.43,26.46,0,39.5,26.46,2,-48238,68623,116861,20385,0,-13647,62,0,0,,13709,-13585
45,11-07-17,28,6:45,7:00,57.02,26.46,0,57.02,57.02,1,-100007,74373,174380,-25634,0,-1249,17166,0,0,,18415,15917
45,11-07-17,29,7:00,7:15,57.02,-36.68,0,-36.68,-36.68,-1,-35595,130422,166017,94827,0,-30036,4066,0,0,,34102,-25970
45,11-07-17,30,7:15,7:30,41.17,42.31,0,41.17,41.17,1,-65194,67255,132449,2061,0,-4772,2112,0,0,,6884,-2660
45,11-07-17,31,7:30,7:45,103.02,,0,103.02,103.02,1,-73081,54731,127812,-18350,0,0,35923,0,0,,35923,35923
45,11-07-17,32,7:45,8:00,499.09,,0,499.09,499.09,1,-106788,50797,157585,-55991,0,0,62075,0,0,,62075,62075
45,11-07-17,33,8:00,8:15,499.09,-42.02,0,-42.02,-42.02,-1,-14990,127376,142366,112386,0,-18661,22054,0,0,,40715,3393
45,11-07-17,34,8:15,8:30,,30.73,0,30.73,30.73,-1,-28085,89536,117621,61451,0,-21716,0,0,0,,21716,-21716
45,11-07-17,35,8:30,8:45,,29.58,0,29.58,29.58,-1,-19768,82939,102707,63171,0,-32267,0,0,0,,32267,-32267
45,11-07-17,36,8:45,9:00,39.43,29.58,0,39.43,39.43,1,-38838,59080,97918,20242,0,-10970,1714,0,0,,12684,-9256
45,11-07-17,37,9:00,9:15,,29.58,0,29.58,29.58,-1,-24558,76086,100644,51528,0,-9911,0,0,0,,9911,-9911
45,11-07-17,38,9:15,9:30,,33.58,0,33.58,33.58,-1,-31088,70645,101733,39557,0,-19057,0,0,0,,19057,-19057
45,11-07-17,39,9:30,9:45,,29.29,0,29.29,29.29,-1,-25188,86568,111756,61380,0,-26655,0,0,0,,26655,-26655
45,11-07-17,40,9:45,10:00,34.68,29.29,0,34.68,34.68,1,-28232,82100,110332,53868,0,-36211,19,0,0,,36230,-36192
45,11-07-17,41,10:00,10:15,39.43,41.81,0,39.52,39.52,2,-46449,45558,92007,-891,0,-3645,1653,0,0,,5298,-1992
45,11-07-17,42,10:15,10:30,,34.58,0,34.58,34.58,-1,-43339,76724,120063,33385,0,-2493,0,0,0,,2493,-2493
45,11-07-17,43,10:30,10:45,,33.58,0,33.58,33.58,-1,-36105,96785,132890,60680,0,-3724,0,0,0,,3724,-3724
45,11-07-17,44,10:45,11:00,,29.35,0,29.35,29.35,-1,-37928,111740,149668,73812,0,-11748,0,0,0,,11748,-11748
45,11-07-17,45,11:00,11:15,,28.89,0,28.89,28.89,-1,-30415,63485,93900,33070,0,-14567,0,0,0,,14567,-14567
45,11-07-17,46,11:15,11:30,,33.21,0,33.21,33.21,-1,-28957,67724,96681,38767,0,-1640,0,0,0,,1640,-1640
45,11-07-17,47,11:30,11:45,,31.99,0,31.99,31.99,-1,-24438,74365,98803,49927,0,-8394,0,0,0,,8394,-8394
45,11-07-17,48,11:45,12:00,,,0,39.54,39.54,0,-28793,68372,97165,39579,0,-12,0,0,0,,12,-12
45,11-07-17,49,12:00,12:15,,,0,39.57,39.57,0,-51378,35629,87007,-15749,0,0,0,0,0,,0,0
45,11-07-17,50,12:15,12:30,,45.08,0,45.08,45.08,-1,-52012,45515,97527,-6497,0,-8,0,0,0,,8,-8
45,11-07-17,51,12:30,12:45,,41.7,0,41.7,41.7,-1,-43511,72960,116471,29449,0,-964,0,0,0,,964,-964
45,11-07-17,52,12:45,13:00,,44.69,0,44.69,44.69,-1,-46662,79320,125982,32658,0,-159,0,0,0,,159,-159
45,11-07-17,53,13:00,13:15,,45.12,0,45.12,45.12,-1,-50480,65728,116208,15248,0,-78,0,0,0,,78,-78
45,11-07-17,54,13:15,13:30,35.43,,0,35.43,35.43,1,-68770,49324,118094,-19446,0,0,980,0,0,,980,980
45,11-07-17,55,13:30,13:45,56.63,,0,56.63,56.63,1,-76145,44212,120357,-31933,0,0,3811,0,0,,3811,3811
45,11-07-17,56,13:45,14:00,36.06,,0,36.06,36.06,1,-88216,39167,127383,-49049,0,0,4179,0,0,,4179,4179
45,11-07-17,57,14:00,14:15,42.83,,0,42.83,42.83,1,-95145,53836,148981,-41309,0,0,7286,0,0,,7286,7286
45,11-07-17,58,14:15,14:30,42.65,,0,42.65,42.65,1,-89333,44450,133783,-44883,0,0,20976,0,0,,20976,20976
45,11-07-17,59,14:30,14:45,384.28,,0,384.28,384.28,1,-96383,32406,128789,-63977,0,0,39935,0,0,,39935,39935
45,11-07-17,60,14:45,15:00,39.38,,0,39.38,39.38,1,-81646,52431,134077,-29215,0,0,18011,0,0,,18011,18011
45,11-07-17,61,15:00,15:15,34.03,,0,34.03,34.03,1,-46821,72045,118866,25224,0,0,681,0,0,,681,681
45,11-07-17,62,15:15,15:30,35.43,,0,35.43,35.43,1,-61778,61339,123117,-439,0,0,319,0,0,,319,319
45,11-07-17,63,15:30,15:45,95.02,,0,95.02,95.02,1,-80709,42458,123167,-38251,0,0,21550,0,0,,21550,21550
45,11-07-17,64,15:45,16:00,61.38,,0,61.38,61.38,1,-89644,40012,129656,-49632,0,0,37518,0,0,,37518,37518
45,11-07-17,65,16:00,16:15,61.38,-2.71,0,-2.71,-2.71,-1,-64586,136428,201014,71842,0,-17227,12275,0,0,,29502,-4952
45,11-07-17,66,16:15,16:30,,33.03,0,33.03,33.03,-1,-55806,101099,156905,45293,0,-7059,0,0,0,,7059,-7059
45,11-07-17,67,16:30,16:45,,34.58,0,34.58,34.58,-1,-47556,96009,143565,48453,0,-6792,0,0,0,,6792,-6792
45,11-07-17,68,16:45,17:00,,,0,39.61,39.61,0,-60885,89163,150048,28278,0,-611,0,0,0,,611,-611
45,11-07-17,69,17:00,17:15,,-18.43,0,-18.43,-18.43,-1,-54727,151933,206660,97206,0,-36201,0,0,0,,36201,-36201
45,11-07-17,70,17:15,17:30,35.43,34.58,0,35.43,35.43,1,-66510,81403,147913,14893,0,-8610,77,0,0,,8687,-8533
45,11-07-17,71,17:30,17:45,35.43,38.52,0,39.59,38.52,2,-47333,61484,108817,14151,0,-653,209,0,0,,862,-444
45,11-07-17,72,17:45,18:00,,31.99,0,31.99,31.99,-1,-55760,96395,152155,40635,0,-9735,0,0,0,,9735,-9735
45,11-07-17,73,18:00,18:15,58.02,34.58,0,58.02,34.58,2,-86127,63591,149718,-22536,0,-8280,3954,0,0,,12234,-4326
45,11-07-17,74,18:15,18:30,58.02,34.58,0,34.58,34.58,-1,-60746,98566,159312,37820,0,-2666,1267,0,0,,3933,-1399
45,11-07-17,75,18:30,18:45,,33.58,0,33.58,33.58,-1,-56094,100359,156453,44265,0,-10657,0,0,0,,10657,-10657
45,11-07-17,76,18:45,19:00,,31.99,0,31.99,31.99,-1,-44306,104100,148406,59794,0,-17074,0,0,0,,17074,-17074
45,11-07-17,77,19:00,19:15,35.99,33.49,0,35.99,35.99,1,-83794,91703,175497,7909,0,-13115,765,0,0,,13880,-12350
45,11-07-17,78,19:15,19:30,35.99,33.58,0,33.58,33.58,-1,-73372,91190,164562,17818,0,-2777,102,0,0,,2879,-2675
45,11-07-17,79,19:30,19:45,,31.07,0,31.07,31.07,-1,-62341,100734,163075,38393,0,-18690,0,0,0,,18690,-18690
45,11-07-17,80,19:45,20:00,,32.3,0,32.3,32.3,-1,-52944,110742,163686,57798,0,-38819,0,0,0,,38819,-38819
45,11-07-17,81,20:00,20:15,109.02,25.03,0,109.02,109.02,1,-86864,46917,133781,-39947,0,-26740,6578,0,0,,33318,-20162
45,11-07-17,82,20:15,20:30,126.02,20.79,0,126.02,20.79,2,-63060,76588,139648,13528,0,-5026,15375,0,0,,20401,10349
45,11-07-17,83,20:30,20:45,,19.99,0,19.99,19.99,-1,-66505,99833,166338,33328,0,-32015,0,0,0,,32015,-32015
45,11-07-17,84,20:45,21:00,,0.49,0,0.49,0.49,-1,-68624,145468,214092,76844,0,-54464,0,0,0,,54464,-54464
45,11-07-17,85,21:00,21:15,157.71,10.17,0,157.71,157.71,1,-123331,66521,189852,-56810,0,-37367,6753,0,0,,44120,-30614
45,11-07-17,86,21:15,21:30,227.56,33.58,0,227.56,33.58,2,-81993,60694,142687,-21299,0,-290,30316,0,0,,30606,30026
45,11-07-17,87,21:30,21:45,227.56,32.03,0,32.03,32.03,-1,-70791,84133,154924,13342,0,-7505,1308,0,0,,8813,-6197
45,11-07-17,88,21:45,22:00,,33.58,0,33.58,33.58,-1,-95995,105038,201033,9043,0,-10991,0,0,0,,10991,-10991
45,11-07-17,89,22:00,22:15,66.79,30.75,0,66.79,30.75,2,-75117,58180,133297,-16937,0,-6372,4366,0,0,,10738,-2006
45,11-07-17,90,22:15,22:30,70.02,30.75,0,70.02,70.02,1,-87543,66365,153908,-21178,0,-115,15846,0,0,,15961,15731
45,11-07-17,91,22:30,22:45,70.02,32.57,0,32.57,32.57,-1,-79809,92477,172286,12668,0,-2842,3186,0,0,,6028,344
45,11-07-17,92,22:45,23:00,,30.05,0,30.05,30.05,-1,-67550,106530,174080,38980,0,-20883,0,0,0,,20883,-20883
45,11-07-17,93,23:00,23:15,115.1,3.16,0,115.1,3.16,2,-47570,36664,84234,-10906,0,-26425,2984,0,0,,29409,-23441
45,11-07-17,94,23:15,23:30,127.17,31.56,0,127.17,31.56,2,-47419,41563,88982,-5856,0,-2428,13206,0,0,,15634,10778
45,11-07-17,95,23:30,23:45,,31.03,0,31.03,31.03,-1,-47098,70213,117311,23115,0,-15435,0,0,0,,15435,-15435
45,11-07-17,96,23:45,0:00,,25.27,0,25.27,25.27,-1,-47373,83434,130807,36061,0,-37665,0,0,0,,37665,-37665
45,11-08-17,1,0:00,0:15,,7.79,0,7.79,7.79,-1,-24989,81929,106918,56940,0,-44968,0,0,0,,44968,-44968
45,11-08-17,2,0:15,0:30,,32.86,0,32.86,32.86,-1,-36748,45344,82092,8596,0,-8976,0,0,0,,8976,-8976
45,11-08-17,3,0:30,0:45,,31.78,0,31.78,31.78,-1,-39485,50270,89755,10785,0,-9795,0,0,0,,9795,-9795
45,11-08-17,4,0:45,1:00,,31.86,0,31.86,31.86,-1,-51237,57593,108830,6356,0,-2301,0,0,0,,2301,-2301
45,11-08-17,5,1:00,1:15,42.89,5.88,0,42.89,5.88,2,-46057,64158,110215,18101,0,-23943,194,0,0,,24137,-23749
45,11-08-17,6,1:15,1:30,68.28,10.59,0,68.28,10.59,2,-37428,49456,86884,12028,0,-3992,3902,0,0,,7894,-90
45,11-08-17,7,1:30,1:45,,5.78,0,5.78,5.78,-1,-42356,68814,111170,26458,0,-25895,0,0,0,,25895,-25895
45,11-08-17,8,1:45,2:00,,11.95,0,11.95,11.95,-1,-34564,81774,116338,47210,0,-26143,0,0,0,,26143,-26143
45,11-08-17,9,2:00,2:15,68.96,-1.52,0,68.96,68.96,1,-63580,49387,112967,-14193,0,-24907,3411,0,0,,28318,-21496
45,11-08-17,10,2:15,2:30,88.34,32.86,0,88.34,32.86,2,-48511,48058,96569,-453,0,-439,7787,0,0,,8226,7348
45,11-08-17,11,2:30,2:45,,31.86,0,31.86,31.86,-1,-41258,55787,97045,14529,0,-6071,0,0,0,,6071,-6071
45,11-08-17,12,2:45,3:00,,31.86,0,31.86,31.86,-1,-28762,56908,85670,28146,0,-20620,0,0,0,,20620,-20620
45,11-08-17,13,3:00,3:15,,32.86,0,32.86,32.86,-1,-44879,50886,95765,6007,0,-12383,0,0,0,,12383,-12383
45,11-08-17,14,3:15,3:30,,32.78,0,32.78,32.78,-1,-45109,62042,107151,16933,0,-9101,0,0,0,,9101,-9101
45,11-08-17,15,3:30,3:45,,32.86,0,32.86,32.86,-1,-47455,56128,103583,8673,0,-9695,0,0,0,,9695,-9695
45,11-08-17,16,3:45,4:00,,33.16,0,33.16,33.16,-1,-41696,54336,96032,12640,0,-5981,0,0,0,,5981,-5981
45,11-08-17,17,4:00,4:15,,28.01,0,28.01,28.01,-1,-38007,49060,87067,11053,0,-5928,0,0,0,,5928,-5928
45,11-08-17,18,4:15,4:30,,10.82,0,10.82,10.82,-1,-34835,60835,95670,26000,0,-24309,0,0,0,,24309,-24309
45,11-08-17,19,4:30,4:45,,31.86,0,31.86,31.86,-1,-36369,55415,91784,19046,0,-8445,0,0,0,,8445,-8445
45,11-08-17,20,4:45,5:00,,27.86,0,27.86,27.86,-1,-29712,63082,92794,33370,0,-22198,0,0,0,,22198,-22198
45,11-08-17,21,5:00,5:15,,27.78,0,27.78,27.78,-1,-40321,65168,105489,24847,0,-32001,0,0,0,,32001,-32001
45,11-08-17,22,5:15,5:30,,32.78,0,32.78,32.78,-1,-43283,66823,110106,23540,0,-14286,0,0,0,,14286,-14286
45,11-08-17,23,5:30,5:45,,32.78,0,32.78,32.78,-1,-49574,67265,116839,17691,0,-19874,0,0,0,,19874,-19874
45,11-08-17,24,5:45,6:00,62.99,32.78,0,62.99,62.99,1,-75734,50329,126063,-25405,0,-3785,9019,0,0,,12804,5234
45,11-08-17,25,6:00,6:15,62.99,-61.47,0,-61.47,-61.47,-1,-18437,114588,133025,96151,0,-36135,2357,0,0,,38492,-33778
45,11-08-17,26,6:15,6:30,,-52.06,0,-52.06,-52.06,-1,-42618,107513,150131,64895,0,-75176,0,0,0,,75176,-75176
45,11-08-17,27,6:30,6:45,35.16,32.78,0,35.16,35.16,1,-51310,68797,120107,17487,0,-26027,5,0,0,,26032,-26022
45,11-08-17,28,6:45,7:00,41.96,32.78,0,41.96,41.96,1,-76479,66323,142802,-10156,0,-1823,4309,0,0,,6132,2486
45,11-08-17,29,7:00,7:15,38.12,2.83,0,40.52,2.83,2,-18148,99548,117696,81400,0,-15190,4363,0,0,,19553,-10827
45,11-08-17,30,7:15,7:30,36.79,33.95,0,36.79,36.79,1,-46622,61391,108013,14769,0,-11134,114,0,0,,11248,-11020
45,11-08-17,31,7:30,7:45,41.62,33.95,0,41.62,41.62,1,-67326,51730,119056,-15596,0,-18,4572,0,0,,4590,4554
45,11-08-17,32,7:45,8:00,44.49,,0,44.49,44.49,1,-71497,41481,112978,-30016,0,0,13637,0,0,,13637,13637
45,11-08-17,33,8:00,8:15,44.49,-37.82,0,-37.82,-37.82,-1,-28518,117739,146257,89221,0,-37404,3963,0,0,,41367,-33441
45,11-08-17,34,8:15,8:30,,34.95,0,34.95,34.95,-1,-39687,68875,108562,29188,0,-24567,0,0,0,,24567,-24567
45,11-08-17,35,8:30,8:45,,34.95,0,34.95,34.95,-1,-47152,57653,104805,10501,0,-19477,0,0,0,,19477,-19477
45,11-08-17,36,8:45,9:00,37.74,34.95,0,37.74,37.74,1,-62035,45423,107458,-16612,0,-2474,1772,0,0,,4246,-702
45,11-08-17,37,9:00,9:15,37.74,46.82,0,46.82,46.82,-1,-58865,60079,118944,1214,0,-740,154,0,0,,894,-586
45,11-08-17,38,9:15,9:30,44.12,,0,44.12,44.12,1,-82392,61965,144357,-20427,0,0,5506,0,0,,5506,5506
45,11-08-17,39,9:30,9:45,41.62,,0,41.62,41.62,1,-79348,56793,136141,-22555,0,0,17673,0,0,,17673,17673
45,11-08-17,40,9:45,10:00,45.41,,0,45.41,45.41,1,-76050,52757,128807,-23293,0,0,14746,0,0,,14746,14746
45,11-08-17,41,10:00,10:15,374.16,,0,374.16,374.16,1,-96414,34604,131018,-61810,0,0,36640,0,0,,36640,36640
45,11-08-17,42,10:15,10:30,37.62,,0,37.62,37.62,1,-69666,52960,122626,-16706,0,0,15972,0,0,,15972,15972
45,11-08-17,43,10:30,10:45,46.19,,0,46.19,46.19,1,-71499,44069,115568,-27430,0,0,6300,0,0,,6300,6300
45,11-08-17,44,10:45,11:00,58.12,,0,58.12,58.12,1,-83276,38927,122203,-44349,0,0,26830,0,0,,26830,26830
45,11-08-17,45,11:00,11:15,41.62,,0,41.62,41.62,1,-74964,53567,128531,-21397,0,0,17330,0,0,,17330,17330
45,11-08-17,46,11:15,11:30,45.38,,0,45.38,45.38,1,-76131,47748,123879,-28383,0,0,8911,0,0,,8911,8911
45,11-08-17,47,11:30,11:45,45.63,,0,45.63,45.63,1,-78773,50974,129747,-27799,0,0,18395,0,0,,18395,18395
45,11-08-17,48,11:45,12:00,43.03,,0,43.03,43.03,1,-80312,42184,122496,-38128,0,0,22029,0,0,,22029,22029
45,11-08-17,49,12:00,12:15,243.33,,0,243.33,243.33,1,-91344,33935,125279,-57409,0,0,29074,0,0,,29074,29074
45,11-08-17,50,12:15,12:30,45.59,,0,45.59,45.59,1,-75322,49721,125043,-25601,0,0,20145,0,0,,20145,20145
45,11-08-17,51,12:30,12:45,37.62,34.95,0,42.4,34.95,2,-60089,56823,116912,-3266,0,-15,824,0,0,,839,809
45,11-08-17,52,12:45,13:00,41.62,,0,41.62,41.62,1,-65894,49389,115283,-16505,0,0,3828,0,0,,3828,3828
45,11-08-17,53,13:00,13:15,401.38,,0,401.38,401.38,1,-109226,30743,139969,-78483,0,0,42714,0,0,,42714,42714
45,11-08-17,54,13:15,13:30,113.59,,0,113.59,113.59,1,-79432,35834,115266,-43598,0,0,46906,0,0,,46906,46906
45,11-08-17,55,13:30,13:45,50.1,,0,50.1,50.1,1,-72048,30534,102582,-41514,0,0,6204,0,0,,6204,6204
45,11-08-17,56,13:45,14:00,40.1,,0,40.1,40.1,1,-77322,34106,111428,-43216,0,0,3646,0,0,,3646,3646
45,11-08-17,57,14:00,14:15,443.86,,0,443.86,443.86,1,-85603,24019,109622,-61584,0,0,18576,0,0,,18576,18576
45,11-08-17,58,14:15,14:30,443.86,,0,443.86,443.86,1,-69666,32515,102181,-37151,0,0,40662,0,0,,40662,40662
45,11-08-17,59,14:30,14:45,49.9,,0,49.9,49.9,1,-71901,34777,106678,-37124,0,0,12391,0,0,,12391,12391
45,11-08-17,60,14:45,15:00,49.9,,0,49.9,49.9,1,-81172,40020,121192,-41152,0,0,12787,0,0,,12787,12787
45,11-08-17,61,15:00,15:15,49.9,34.95,0,34.95,34.95,-1,-55868,64582,120450,8714,0,-2028,1589,0,0,,3617,-439
45,11-08-17,62,15:15,15:30,36.36,41.87,0,42.44,41.87,2,-68580,68203,136783,-377,0,-2321,61,0,0,,2382,-2260
45,11-08-17,63,15:30,15:45,45,,0,45,45,1,-73233,51824,125057,-21409,0,0,6323,0,0,,6323,6323
45,11-08-17,64,15:45,16:00,45.1,,0,45.1,45.1,1,-83543,47302,130845,-36241,0,0,22923,0,0,,22923,22923
45,11-08-17,65,16:00,16:15,45.1,29.95,0,29.95,29.95,-1,-64150,83576,147726,19426,0,-5320,8302,0,0,,13622,2982
45,11-08-17,66,16:15,16:30,,49.46,0,49.46,49.46,-1,-66743,72605,139348,5862,0,-2385,0,0,0,,2385,-2385
45,11-08-17,67,16:30,16:45,41.83,47.07,0,42.44,42.44,2,-65374,61715,127089,-3659,0,-606,441,0,0,,1047,-165
45,11-08-17,68,16:45,17:00,333.59,,0,333.59,333.59,1,-94411,45543,139954,-48868,0,0,28826,0,0,,28826,28826
45,11-08-17,69,17:00,17:15,333.59,29.95,0,29.95,29.95,-1,-72738,91340,164078,18602,0,-2423,11017,0,0,,13440,8594
45,11-08-17,70,17:15,17:30,,,0,42.42,42.42,0,-88935,55245,144180,-33690,0,0,0,0,0,,0,0
45,11-08-17,71,17:30,17:45,,,0,42.42,42.42,0,-87456,49668,137124,-37788,0,0,0,0,0,,0,0
45,11-08-17,72,17:45,18:00,151.59,,0,151.59,151.59,1,-81696,66172,147868,-15524,0,0,2733,0,0,,2733,2733
45,11-08-17,73,18:00,18:15,460.2,-3.71,0,460.2,-3.71,2,-61465,84757,146222,23292,0,-7920,16580,0,0,,24500,8660
45,11-08-17,74,18:15,18:30,,-3.71,0,-3.71,-3.71,-1,-50969,93570,144539,42601,0,-60200,0,0,0,,60200,-60200
45,11-08-17,75,18:30,18:45,,5.26,0,5.26,5.26,-1,-49084,91886,140970,42802,0,-27954,0,0,0,,27954,-27954
45,11-08-17,76,18:45,19:00,,23.63,0,23.63,23.63,-1,-51738,91799,143537,40061,0,-42782,0,0,0,,42782,-42782
45,11-08-17,77,19:00,19:15,190.58,10.54,0,190.58,10.54,2,-100350,40891,141241,-59459,0,-28382,5823,0,0,,34205,-22559
45,11-08-17,78,19:15,19:30,37.62,49.67,0,49.67,49.67,-1,-74103,55314,129417,-18789,0,-162,6592,0,0,,6754,6430
45,11-08-17,79,19:30,19:45,37.62,34.95,0,34.95,34.95,-1,-61491,67263,128754,5772,0,-3149,39,0,0,,3188,-3110
45,11-08-17,80,19:45,20:00,35.09,22.59,0,42.4,22.59,2,-51900,86991,138891,35091,0,-21983,1,0,0,,21984,-21982
45,11-08-17,81,20:00,20:15,314.69,22.59,0,314.69,314.69,1,-103992,39842,143834,-64150,0,-3705,19563,0,0,,23268,15858
45,11-08-17,82,20:15,20:30,314.69,43.87,0,43.87,43.87,-1,-54112,61851,115963,7739,0,-1256,829,0,0,,2085,-427
45,11-08-17,83,20:30,20:45,,29.95,0,29.95,29.95,-1,-55064,83374,138438,28310,0,-1932,0,0,0,,1932,-1932
45,11-08-17,84,20:45,21:00,,25.28,0,25.28,25.28,-1,-57405,94890,152295,37485,0,-21817,0,0,0,,21817,-21817
45,11-08-17,85,21:00,21:15,49.89,25.28,0,49.89,49.89,1,-68653,46556,115209,-22097,0,-6548,4817,0,0,,11365,-1731
45,11-08-17,86,21:15,21:30,49.89,34.95,0,34.95,34.95,-1,-50844,62048,112892,11204,0,-1524,73,0,0,,1597,-1451
45,11-08-17,87,21:30,21:45,,18.28,0,18.28,18.28,-1,-45990,91774,137764,45784,0,-11232,0,0,0,,11232,-11232
45,11-08-17,88,21:45,22:00,,11.95,0,11.95,11.95,-1,-64808,91291,156099,26483,0,-34988,0,0,0,,34988,-34988
45,11-08-17,89,22:00,22:15,37.18,4.28,0,42.43,4.28,2,-84679,116509,201188,31830,0,-34542,103,0,0,,34645,-34439
45,11-08-17,90,22:15,22:30,41.66,31.28,0,42.43,31.28,2,-51965,47911,99876,-4054,0,-5466,1879,0,0,,7345,-3587
45,11-08-17,91,22:30,22:45,,21.31,0,21.31,21.31,-1,-37881,64568,102449,26687,0,-24569,0,0,0,,24569,-24569
45,11-08-17,92,22:45,23:00,,18.47,0,18.47,18.47,-1,-43595,81068,124663,37473,0,-37926,0,0,0,,37926,-37926
45,11-08-17,93,23:00,23:15,95.47,-41.05,0,95.47,-41.05,2,-87349,111556,198905,24207,0,-47253,694,0,0,,47947,-46559
45,11-08-17,94,23:15,23:30,126.94,-2.3,0,126.94,-2.3,2,-63258,71067,134325,7809,0,-6299,10767,0,0,,17066,4468
45,11-08-17,95,23:30,23:45,,-28.28,0,-28.28,-28.28,-1,-48844,101748,150592,52904,0,-51110,0,0,0,,51110,-51110
45,11-08-17,96,23:45,0:00,,-8.42,0,-8.42,-8.42,-1,-55992,131218,187210,75226,0,-65526,0,0,0,,65526,-65526
45,11-09-17,1,0:00,0:15,,-5.9,0,-5.9,-5.9,-1,-37336,83773,121109,46437,0,-59182,0,0,0,,59182,-59182
45,11-09-17,2,0:15,0:30,50.84,29.95,0,50.84,29.95,2,-44757,53302,98059,8545,0,-6632,2034,0,0,,8666,-4598
45,11-09-17,3,0:30,0:45,,13.35,0,13.35,13.35,-1,-39168,82370,121538,43202,0,-34527,0,0,0,,34527,-34527
45,11-09-17,4,0:45,1:00,,-20.45,0,-20.45,-20.45,-1,-39989,127386,167375,87397,0,-64270,0,0,0,,64270,-64270
45,11-09-17,5,1:00,1:15,39.23,-3.09,0,39.23,39.23,1,-62299,77538,139837,15239,0,-52661,195,0,0,,52856,-52466
45,11-09-17,6,1:15,1:30,42.61,-5.94,0,42.61,-5.94,2,-43529,77040,120569,33511,0,-9381,1196,0,0,,10577,-8185
45,11-09-17,7,1:30,1:45,,-29.95,0,-29.95,-29.95,-1,-52381,80176,132557,27795,0,-33160,0,0,0,,33160,-33160
45,11-09-17,8,1:45,2:00,,6.74,0,6.74,6.74,-1,-43493,85478,128971,41985,0,-18949,0,0,0,,18949,-18949
45,11-09-17,9,2:00,2:15,38.14,-3.45,0,38.14,38.14,1,-52032,60650,112682,8618,0,-27917,388,0,0,,28305,-27529
45,11-09-17,10,2:15,2:30,37.79,25.03,0,42.56,25.03,2,-30820,55985,86805,25165,0,-11018,755,0,0,,11773,-10263
45,11-09-17,11,2:30,2:45,,20.12,0,20.12,20.12,-1,-38502,69840,108342,31338,0,-32426,0,0,0,,32426,-32426
45,11-09-17,12,2:45,3:00,,20.59,0,20.59,20.59,-1,-29338,76699,106037,47361,0,-38251,0,0,0,,38251,-38251
45,11-09-17,13,3:00,3:15,,18.28,0,18.28,18.28,-1,-45196,69219,114415,24023,0,-33466,0,0,0,,33466,-33466
45,11-09-17,14,3:15,3:30,,29.95,0,29.95,29.95,-1,-40603,68189,108792,27586,0,-15360,0,0,0,,15360,-15360
45,11-09-17,15,3:30,3:45,,31.03,0,31.03,31.03,-1,-42079,70815,112894,28736,0,-27940,0,0,0,,27940,-27940
45,11-09-17,16,3:45,4:00,,30.5,0,30.5,30.5,-1,-37062,72195,109257,35133,0,-32589,0,0,0,,32589,-32589
45,11-09-17,17,4:00,4:15,,26.83,0,26.83,26.83,-1,-36871,80587,117458,43716,0,-38551,0,0,0,,38551,-38551
45,11-09-17,18,4:15,4:30,,26.8,0,26.8,26.8,-1,-35182,79887,115069,44705,0,-39264,0,0,0,,39264,-39264
45,11-09-17,19,4:30,4:45,,5.93,0,5.93,5.93,-1,-36666,80200,116866,43534,0,-46829,0,0,0,,46829,-46829
45,11-09-17,20,4:45,5:00,40.58,19.58,0,42.56,19.58,2,-36148,64462,100610,28314,0,-11876,1276,0,0,,13152,-10600
45,11-09-17,21,5:00,5:15,,-37.98,0,-37.98,-37.98,-1,-29122,109719,138841,80597,0,-64603,0,0,0,,64603,-64603
45,11-09-17,22,5:15,5:30,,6.18,0,6.18,6.18,-1,-43732,106414,150146,62682,0,-70448,0,0,0,,70448,-70448
45,11-09-17,23,5:30,5:45,,-5.53,0,-5.53,-5.53,-1,-34329,99769,134098,65440,0,-37072,0,0,0,,37072,-37072
45,11-09-17,24,5:45,6:00,,20.03,0,20.03,20.03,-1,-35439,86549,121988,51110,0,-39379,0,0,0,,39379,-39379
45,11-09-17,25,6:00,6:15,,-54.71,0,-54.71,-54.71,-1,-21737,167472,189209,145735,0,-82940,0,0,0,,82940,-82940
45,11-09-17,26,6:15,6:30,,-54.71,0,-54.71,-54.71,-1,-38317,132143,170460,93826,0,-110660,0,0,0,,110660,-110660
45,11-09-17,27,6:30,6:45,,-1.25,0,-1.25,-1.25,-1,-63312,122947,186259,59635,0,-35885,0,0,0,,35885,-35885
45,11-09-17,28,6:45,7:00,41.69,18.52,0,41.69,41.69,1,-106883,121372,228255,14489,0,-39408,226,0,0,,39634,-39182
45,11-09-17,29,7:00,7:15,40.39,-44.06,0,42.31,-44.06,2,-36132,150643,186775,114511,0,-28006,592,0,0,,28598,-27414
45,11-09-17,30,7:15,7:30,41.94,-42.33,0,42.31,-42.33,2,-52257,81925,134182,29668,0,-57895,938,0,0,,58833,-56957
45,11-09-17,31,7:30,7:45,,0.52,0,0.52,0.52,-1,-46110,100092,146202,53982,0,-26370,0,0,0,,26370,-26370
45,11-09-17,32,7:45,8:00,,31.75,0,31.75,31.75,-1,-72643,86659,159302,14016,0,-21233,0,0,0,,21233,-21233
45,11-09-17,33,8:00,8:15,,30.5,0,30.5,30.5,-1,-74044,109131,183175,35087,0,-22752,0,0,0,,22752,-22752
45,11-09-17,34,8:15,8:30,,28.82,0,28.82,28.82,-1,-69202,111631,180833,42429,0,-31972,0,0,0,,31972,-31972
45,11-09-17,35,8:30,8:45,,32.82,0,32.82,32.82,-1,-75622,93989,169611,18367,0,-26112,0,0,0,,26112,-26112
45,11-09-17,36,8:45,9:00,,34.03,0,34.03,34.03,-1,-79508,95401,174909,15893,0,-6182,0,0,0,,6182,-6182
45,11-09-17,37,9:00,9:15,,1.55,0,1.55,1.55,-1,-60756,106053,166809,45297,0,-20065,0,0,0,,20065,-20065
45,11-09-17,38,9:15,9:30,39.82,1.55,0,42.25,1.55,2,-76210,75380,151590,-830,0,-22092,899,0,0,,22991,-21193
45,11-09-17,39,9:30,9:45,39.82,45.82,0,45.82,45.82,-1,-78761,85665,164426,6904,0,-1007,78,0,0,,1085,-929
45,11-09-17,40,9:45,10:00,,32.82,0,32.82,32.82,-1,-71369,89594,160963,18225,0,-7927,0,0,0,,7927,-7927
45,11-09-17,41,10:00,10:15,40.39,32.82,0,42.27,32.82,2,-81969,74155,156124,-7814,0,-7212,1988,0,0,,9200,-5224
45,11-09-17,42,10:15,10:30,40.39,32.82,0,32.82,32.82,-1,-77154,94305,171459,17151,0,-3932,179,0,0,,4111,-3753
45,11-09-17,43,10:30,10:45,,28.82,0,28.82,28.82,-1,-64424,103575,167999,39151,0,-26594,0,0,0,,26594,-26594
45,11-09-17,44,10:45,11:00,,28.82,0,28.82,28.82,-1,-68753,101345,170098,32592,0,-38502,0,0,0,,38502,-38502
45,11-09-17,45,11:00,11:15,77.42,34.03,0,77.42,34.03,2,-99399,79202,178601,-20197,0,-11402,7120,0,0,,18522,-4282
45,11-09-17,46,11:15,11:30,37.77,11.08,0,11.08,11.08,-1,-66892,107336,174228,40444,0,-14054,4111,0,0,,18165,-9943
45,11-09-17,47,11:30,11:45,,14.03,0,14.03,14.03,-1,-66376,121404,187780,55028,0,-43252,0,0,0,,43252,-43252
45,11-09-17,48,11:45,12:00,,7.78,0,7.78,7.78,-1,-66960,142764,209724,75804,0,-65821,0,0,0,,65821,-65821
45,11-09-17,49,12:00,12:15,,28.4,0,28.4,28.4,-1,-70846,160756,231602,89910,0,-53606,0,0,0,,53606,-53606
45,11-09-17,50,12:15,12:30,,12.88,0,12.88,12.88,-1,-70031,167439,237470,97408,0,-53165,0,0,0,,53165,-53165
45,11-09-17,51,12:30,12:45,,12.88,0,12.88,12.88,-1,-71621,161811,233432,90190,0,-63260,0,0,0,,63260,-63260
45,11-09-17,52,12:45,13:00,,22.39,0,22.39,22.39,-1,-70800,162993,233793,92193,0,-56826,0,0,0,,56826,-56826
45,11-09-17,53,13:00,13:15,,28.82,0,28.82,28.82,-1,-73473,147285,220758,73812,0,-51169,0,0,0,,51169,-51169
45,11-09-17,54,13:15,13:30,,31.53,0,31.53,31.53,-1,-68759,135873,204632,67114,0,-31798,0,0,0,,31798,-31798
45,11-09-17,55,13:30,13:45,,32.82,0,32.82,32.82,-1,-73713,133143,206856,59430,0,-33775,0,0,0,,33775,-33775
45,11-09-17,56,13:45,14:00,37.24,35.64,0,37.24,37.24,1,-75485,105535,181020,30050,0,-10907,577,0,0,,11484,-10330
45,11-09-17,57,14:00,14:15,37.24,27.22,0,27.22,27.22,-1,-72472,103811,176283,31339,0,-15309,26,0,0,,15335,-15283
45,11-09-17,58,14:15,14:30,35.47,33.48,0,35.47,35.47,1,-75019,82097,157116,7078,0,-18524,14,0,0,,18538,-18510
45,11-09-17,59,14:30,14:45,41.69,33.48,0,41.69,41.69,1,-85012,63397,148409,-21615,0,-742,2678,0,0,,3420,1936
45,11-09-17,60,14:45,15:00,41.69,34.03,0,34.03,34.03,-1,-83346,77766,161112,-5580,0,-180,4011,0,0,,4191,3831
45,11-09-17,61,15:00,15:15,,32.82,0,32.82,32.82,-1,-67867,92064,159931,24197,0,-11052,0,0,0,,11052,-11052
45,11-09-17,62,15:15,15:30,,33.82,0,33.82,33.82,-1,-73432,90853,164285,17421,0,-11038,0,0,0,,11038,-11038
45,11-09-17,63,15:30,15:45,,33.82,0,33.82,33.82,-1,-69416,75918,145334,6502,0,-3574,0,0,0,,3574,-3574
45,11-09-17,64,15:45,16:00,35.15,32.82,0,42.39,32.82,2,-76461,89670,166131,13209,0,-1799,5,0,0,,1804,-1794
45,11-09-17,65,16:00,16:15,,32.82,0,32.82,32.82,-1,-78174,96705,174879,18531,0,-8487,0,0,0,,8487,-8487
45,11-09-17,66,16:15,16:30,,23.96,0,23.96,23.96,-1,-77637,119211,196848,41574,0,-23222,0,0,0,,23222,-23222
45,11-09-17,67,16:30,16:45,68.36,32.82,0,68.36,68.36,1,-93500,79956,173456,-13544,0,-18617,1787,0,0,,20404,-16830
45,11-09-17,68,16:45,17:00,205.37,32.82,0,205.37,205.37,1,-107830,82928,190758,-24902,0,-409,26979,0,0,,27388,26570
45,11-09-17,69,17:00,17:15,205.37,-26.04,0,-26.04,-26.04,-1,-73938,152741,226679,78803,0,-30053,484,0,0,,30537,-29569
45,11-09-17,70,17:15,17:30,,0.69,0,0.69,0.69,-1,-71689,132624,204313,60935,0,-39159,0,0,0,,39159,-39159
45,11-09-17,71,17:30,17:45,41.55,0.69,0,41.55,41.55,1,-81705,86052,167757,4347,0,-9063,1017,0,0,,10080,-8046
45,11-09-17,72,17:45,18:00,39.86,49.64,0,42.39,42.39,2,-107459,106275,213734,-1184,0,-72,668,0,0,,740,596
45,11-09-17,73,18:00,18:15,41.69,15.01,0,42.39,15.01,2,-99413,130700,230113,31287,0,-7475,2396,0,0,,9871,-5079
45,11-09-17,74,18:15,18:30,,16.21,0,16.21,16.21,-1,-78429,105428,183857,26999,0,-23006,0,0,0,,23006,-23006
45,11-09-17,75,18:30,18:45,,17.08,0,17.08,17.08,-1,-67438,113801,181239,46363,0,-21886,0,0,0,,21886,-21886
45,11-09-17,76,18:45,19:00,,33.13,0,33.13,33.13,-1,-71134,97158,168292,26024,0,-22980,0,0,0,,22980,-22980
45,11-09-17,77,19:00,19:15,,29.79,0,29.79,29.79,-1,-89572,98551,188123,8979,0,-13561,0,0,0,,13561,-13561
45,11-09-17,78,19:15,19:30,,32.53,0,32.53,32.53,-1,-77862,93126,170988,15264,0,-5192,0,0,0,,5192,-5192
45,11-09-17,79,19:30,19:45,,32.82,0,32.82,32.82,-1,-66186,100450,166636,34264,0,-3871,0,0,0,,3871,-3871
45,11-09-17,80,19:45,20:00,,23.41,0,23.41,23.41,-1,-64872,102257,167129,37385,0,-25834,0,0,0,,25834,-25834
45,11-09-17,81,20:00,20:15,35.12,48.51,0,42.39,42.39,2,-57895,65952,123847,8057,0,-5222,18,0,0,,5240,-5204
45,11-09-17,82,20:15,20:30,,28.88,0,28.88,28.88,-1,-46081,59753,105834,13672,0,-7946,0,0,0,,7946,-7946
45,11-09-17,83,20:30,20:45,,28.82,0,28.82,28.82,-1,-43176,75477,118653,32301,0,-13521,0,0,0,,13521,-13521
45,11-09-17,84,20:45,21:00,,16.51,0,16.51,16.51,-1,-38024,102346,140370,64322,0,-42193,0,0,0,,42193,-42193
45,11-09-17,85,21:00,21:15,123.28,28.08,0,123.28,123.28,1,-121260,60523,181783,-60737,0,-25415,8791,0,0,,34206,-16624
45,11-09-17,86,21:15,21:30,139.3,33.82,0,139.3,33.82,2,-93011,65527,158538,-27484,0,-143,30541,0,0,,30684,30398
45,11-09-17,87,21:30,21:45,139.3,23.57,0,23.57,23.57,-1,-48239,81151,129390,32912,0,-5143,920,0,0,,6063,-4223
45,11-09-17,88,21:45,22:00,,10.03,0,10.03,10.03,-1,-55474,107668,163142,52194,0,-42846,0,0,0,,42846,-42846
45,11-09-17,89,22:00,22:15,41.53,13.51,0,42.4,13.51,2,-76591,85502,162093,8911,0,-33669,152,0,0,,33821,-33517
45,11-09-17,90,22:15,22:30,42.48,30.49,0,42.48,30.49,2,-51269,58823,110092,7554,0,-1635,1776,0,0,,3411,141
45,11-09-17,91,22:30,22:45,,11.48,0,11.48,11.48,-1,-26487,65127,91614,38640,0,-26045,0,0,0,,26045,-26045
45,11-09-17,92,22:45,23:00,,32.82,0,32.82,32.82,-1,-56387,70142,126529,13755,0,-13591,0,0,0,,13591,-13591
45,11-09-17,93,23:00,23:15,133.03,12.1,0,133.03,12.1,2,-63002,40515,103517,-22487,0,-9703,6395,0,0,,16098,-3308
45,11-09-17,94,23:15,23:30,41.69,32.82,0,32.82,32.82,-1,-72968,42670,115638,-30298,0,-964,7035,0,0,,7999,6071
45,11-09-17,95,23:30,23:45,36.17,32.82,0,42.4,32.82,2,-76252,70171,146423,-6081,0,-1445,486,0,0,,1931,-959
45,11-09-17,96,23:45,0:00,36.17,0.75,0,0.75,0.75,-1,-49201,94558,143759,45357,0,-18057,5,0,0,,18062,-18052
45,11-10-17,1,0:00,0:15,,6.05,0,6.05,6.05,-1,-75221,113689,188910,38468,0,-37605,0,0,0,,37605,-37605
45,11-10-17,2,0:15,0:30,35.59,23.6,0,35.59,35.59,1,-83202,86384,169586,3182,0,-28259,100,0,0,,28359,-28159
45,11-10-17,3,0:30,0:45,39.03,23.6,0,39.03,39.03,1,-80108,59997,140105,-20111,0,-649,1852,0,0,,2501,1203
45,11-10-17,4,0:45,1:00,35.59,,0,35.59,35.59,1,-126247,84510,210757,-41737,0,0,2451,0,0,,2451,2451
45,11-10-17,5,1:00,1:15,74.24,,0,74.24,74.24,1,-67061,41373,108434,-25688,0,0,5752,0,0,,5752,5752
45,11-10-17,6,1:15,1:30,79.1,16.64,0,79.1,16.64,2,-48348,44672,93020,-3676,0,-1885,18208,0,0,,20093,16323
45,11-10-17,7,1:30,1:45,40.1,17.81,0,40.1,17.81,2,-62664,30489,93153,-32175,0,-5858,1325,0,0,,7183,-4533
45,11-10-17,8,1:45,2:00,35.43,33.59,0,39.83,33.59,2,-59634,55184,114818,-4450,0,-803,988,0,0,,1791,185
45,11-10-17,9,2:00,2:15,37.46,19.37,0,39.79,19.37,2,-54012,51846,105858,-2166,0,-4257,704,0,0,,4961,-3553
45,11-10-17,10,2:15,2:30,35.59,19.32,0,39.81,19.32,2,-41132,61017,102149,19885,0,-4488,608,0,0,,5096,-3880
45,11-10-17,11,2:30,2:45,,-1.6,0,-1.6,-1.6,-1,-23753,75044,98797,51291,0,-47164,0,0,0,,47164,-47164
45,11-10-17,12,2:45,3:00,,2.86,0,2.86,2.86,-1,-27718,92715,120433,64997,0,-59921,0,0,0,,59921,-59921
45,11-10-17,13,3:00,3:15,59.76,2.86,0,59.76,59.76,1,-65658,54199,119857,-11459,0,-28600,2345,0,0,,30945,-26255
45,11-10-17,14,3:15,3:30,59.76,23.25,0,23.25,23.25,-1,-48766,61204,109970,12438,0,-4465,153,0,0,,4618,-4312
45,11-10-17,15,3:30,3:45,,21.41,0,21.41,21.41,-1,-47150,64012,111162,16862,0,-21642,0,0,0,,21642,-21642
45,11-10-17,16,3:45,4:00,,11.43,0,11.43,11.43,-1,-34555,68070,102625,33515,0,-22981,0,0,0,,22981,-22981
45,11-10-17,17,4:00,4:15,49.25,-118.64,0,49.25,-118.64,2,-47609,72801,120410,25192,0,-41745,709,0,0,,42454,-41036
45,11-10-17,18,4:15,4:30,57.21,1.43,0,57.21,1.43,2,-34269,65969,100238,31700,0,-13600,1300,0,0,,14900,-12300
45,11-10-17,19,4:30,4:45,,-15.6,0,-15.6,-15.6,-1,-44859,71783,116642,26924,0,-35639,0,0,0,,35639,-35639
45,11-10-17,20,4:45,5:00,,-102.69,0,-102.69,-102.69,-1,-23570,96607,120177,73037,0,-24895,0,0,0,,24895,-24895
45,11-10-17,21,5:00,5:15,45.59,30.96,0,45.59,30.96,2,-62452,53003,115455,-9449,0,-10827,1452,0,0,,12279,-9375
45,11-10-17,22,5:15,5:30,39.59,20.24,0,39.82,20.24,2,-37025,47321,84346,10296,0,-13279,324,0,0,,13603,-12955
45,11-10-17,23,5:30,5:45,49.9,20.24,0,49.9,49.9,1,-55182,41543,96725,-13639,0,-367,11423,0,0,,11790,11056
45,11-10-17,24,5:45,6:00,107.24,,0,107.24,107.24,1,-80423,31945,112368,-48478,0,0,29268,0,0,,29268,29268
45,11-10-17,25,6:00,6:15,45.59,31.61,0,45.59,31.61,2,-74251,115119,189370,40868,0,-2303,18293,0,0,,20596,15990
45,11-10-17,26,6:15,6:30,,,0,39.83,39.83,0,-57125,72482,129607,15357,0,-21,0,0,0,,21,-21
45,11-10-17,27,6:30,6:45,,,0,39.83,39.83,0,-61014,71868,132882,10854,0,0,0,0,0,,0,0
45,11-10-17,28,6:45,7:00,82.56,,0,82.56,82.56,1,-83403,48854,132257,-34549,0,0,12135,0,0,,12135,12135
45,11-10-17,29,7:00,7:15,82.56,12.34,0,12.34,12.34,-1,-51765,78242,130007,26477,0,-9296,2596,0,0,,11892,-6700
45,11-10-17,30,7:15,7:30,,11.53,0,11.53,11.53,-1,-52370,86270,138640,33900,0,-15442,0,0,0,,15442,-15442
45,11-10-17,31,7:30,7:45,,32.59,0,32.59,32.59,-1,-56079,86370,142449,30291,0,-2062,0,0,0,,2062,-2062
45,11-10-17,32,7:45,8:00,104.1,,0,104.1,104.1,1,-98334,57186,155520,-41148,0,0,8995,0,0,,8995,8995
45,11-10-17,33,8:00,8:15,104.1,43.17,0,43.17,43.17,-1,-15805,107547,123352,91742,0,-663,2413,0,0,,3076,1750
45,11-10-17,34,8:15,8:30,,,0,39.83,39.83,0,-23759,97997,121756,74238,0,-16,0,0,0,,16,-16
45,11-10-17,35,8:30,8:45,,32.59,0,32.59,32.59,-1,-31298,88038,119336,56740,0,-917,0,0,0,,917,-917
45,11-10-17,36,8:45,9:00,,,0,39.83,39.83,0,-44231,92472,136703,48241,0,-133,0,0,0,,133,-133
45,11-10-17,37,9:00,9:15,37,,0,37,37,1,-66597,63651,130248,-2946,0,0,716,0,0,,716,716
45,11-10-17,38,9:15,9:30,35.84,,0,35.84,35.84,1,-61437,59922,121359,-1515,0,0,558,0,0,,558,558
45,11-10-17,39,9:30,9:45,35.59,,0,35.59,35.59,1,-70094,57215,127309,-12879,0,0,382,0,0,,382,382
45,11-10-17,40,9:45,10:00,35.59,,0,35.59,35.59,1,-56728,63225,119953,6497,0,0,519,0,0,,519,519
45,11-10-17,41,10:00,10:15,82.82,,0,82.82,82.82,1,-77586,47874,125460,-29712,0,0,7086,0,0,,7086,7086
45,11-10-17,42,10:15,10:30,105.76,,0,105.76,105.76,1,-90612,50828,141440,-39784,0,0,22185,0,0,,22185,22185
45,11-10-17,43,10:30,10:45,194.85,,0,194.85,194.85,1,-115138,49661,164799,-65477,0,0,42975,0,0,,42975,42975
45,11-10-17,44,10:45,11:00,66.12,,0,66.12,66.12,1,-121172,62317,183489,-58855,0,0,54020,0,0,,54020,54020
45,11-10-17,45,11:00,11:15,136.12,,0,136.12,136.12,1,-150494,56064,206558,-94430,0,0,61676,0,0,,61676,61676
45,11-10-17,46,11:15,11:30,67.44,,0,67.44,67.44,1,-128146,67371,195517,-60775,0,0,60516,0,0,,60516,60516
45,11-10-17,47,11:30,11:45,39.2,,0,39.2,39.2,1,-103869,74840,178709,-29029,0,0,23700,0,0,,23700,23700
45,11-10-17,48,11:45,12:00,40.1,,0,40.1,40.1,1,-91944,70191,162135,-21753,0,0,4483,0,0,,4483,4483
45,11-10-17,49,12:00,12:15,53.86,,0,53.86,53.86,1,-149354,97086,246440,-52268,0,0,21746,0,0,,21746,21746
45,11-10-17,50,12:15,12:30,35.69,33.78,0,44.64,33.78,2,-101724,95769,197493,-5955,0,-658,9048,0,0,,9706,8390
45,11-10-17,51,12:30,12:45,35.69,33.59,0,33.59,33.59,-1,-46959,101110,148069,54151,0,-1353,2,0,0,,1355,-1351
45,11-10-17,52,12:45,13:00,,32.59,0,32.59,32.59,-1,-17898,105135,123033,87237,0,-1660,0,0,0,,1660,-1660
45,11-10-17,53,13:00,13:15,,21.96,0,21.96,21.96,-1,-20732,138009,158741,117277,0,-1077,0,0,0,,1077,-1077
45,11-10-17,54,13:15,13:30,,8.33,0,8.33,8.33,-1,-24324,113475,137799,89151,0,-13826,0,0,0,,13826,-13826
45,11-10-17,55,13:30,13:45,,20.58,0,20.58,20.58,-1,-37675,75987,113662,38312,0,-10619,0,0,0,,10619,-10619
45,11-10-17,56,13:45,14:00,,21.93,0,21.93,21.93,-1,-31822,71435,103257,39613,0,-16273,0,0,0,,16273,-16273
45,11-10-17,57,14:00,14:15,39.82,32.59,0,44.65,32.59,2,-58225,58885,117110,660,0,-13661,871,0,0,,14532,-12790
45,11-10-17,58,14:15,14:30,39.82,33.59,0,33.59,33.59,-1,-46651,67198,113849,20547,0,-398,37,0,0,,435,-361
45,11-10-17,59,14:30,14:45,,28.59,0,28.59,28.59,-1,-51435,80374,131809,28939,0,-15712,0,0,0,,15712,-15712
45,11-10-17,60,14:45,15:00,,28.17,0,28.17,28.17,-1,-44972,78153,123125,33181,0,-27213,0,0,0,,27213,-27213
45,11-10-17,61,15:00,15:15,,32.59,0,32.59,32.59,-1,-53394,88553,141947,35159,0,-17828,0,0,0,,17828,-17828
45,11-10-17,62,15:15,15:30,35.32,32.4,0,39.85,32.4,2,-43041,57307,100348,14266,0,-19062,22,0,0,,19084,-19040
45,11-10-17,63,15:30,15:45,39.82,32.4,0,39.82,39.82,1,-68646,45553,114199,-23093,0,-2051,1225,0,0,,3276,-826
45,11-10-17,64,15:45,16:00,39.82,,0,39.82,39.82,1,-86965,55624,142589,-31341,0,0,3005,0,0,,3005,3005
45,11-10-17,65,16:00,16:15,39.82,18.46,0,18.46,18.46,-1,-28978,99021,127999,70043,0,-16472,183,0,0,,16655,-16289
45,11-10-17,66,16:15,16:30,35.56,-36.45,0,39.88,-36.45,2,-20354,75789,96143,55435,0,-48695,7,0,0,,48702,-48688
45,11-10-17,67,16:30,16:45,36.78,33.59,0,39.88,33.59,2,-17537,81410,98947,63873,0,-5724,404,0,0,,6128,-5320
45,11-10-17,68,16:45,17:00,,,0,39.88,39.88,0,-35890,80635,116525,44745,0,0,0,0,0,,0,0
45,11-10-17,69,17:00,17:15,,-0.83,0,-0.83,-0.83,-1,-33201,96295,129496,63094,0,-10143,0,0,0,,10143,-10143
45,11-10-17,70,17:15,17:30,37.82,-0.83,0,37.82,37.82,1,-51524,45160,96684,-6364,0,-28,695,0,0,,723,667
45,11-10-17,71,17:30,17:45,71.07,,0,71.07,71.07,1,-90869,50815,141684,-40054,0,0,8855,0,0,,8855,8855
45,11-10-17,72,17:45,18:00,179.9,,0,179.9,179.9,1,-89732,72601,162333,-17131,0,0,33641,0,0,,33641,33641
45,11-10-17,73,18:00,18:15,39.24,29.96,0,29.96,29.96,-1,-50920,55584,106504,4664,0,-2746,8047,0,0,,10793,5301
45,11-10-17,74,18:15,18:30,,29.91,0,29.91,29.91,-1,-28139,50761,78900,22622,0,-5754,0,0,0,,5754,-5754
45,11-10-17,75,18:30,18:45,,-3.52,0,-3.52,-3.52,-1,-29231,101969,131200,72738,0,-47230,0,0,0,,47230,-47230
45,11-10-17,76,18:45,19:00,,20.51,0,20.51,20.51,-1,-17681,99964,117645,82283,0,-44283,0,0,0,,44283,-44283
45,11-10-17,77,19:00,19:15,169.87,20.51,0,169.87,169.87,1,-76882,26037,102919,-50845,0,-16467,9686,0,0,,26153,-6781
45,11-10-17,78,19:15,19:30,38.29,27.83,0,27.83,27.83,-1,-37499,55163,92662,17664,0,-2708,3723,0,0,,6431,1015
45,11-10-17,79,19:30,19:45,,20.82,0,20.82,20.82,-1,-31941,69934,101875,37993,0,-31640,0,0,0,,31640,-31640
45,11-10-17,80,19:45,20:00,,30.17,0,30.17,30.17,-1,-38758,51681,90439,12923,0,-23185,0,0,0,,23185,-23185
45,11-10-17,81,20:00,20:15,46.63,24.82,0,46.63,24.82,2,-78466,78821,157287,355,0,-13956,2161,0,0,,16117,-11795
45,11-10-17,82,20:15,20:30,46.63,15.53,0,15.53,15.53,-1,-28633,92694,121327,64061,0,-3444,30,0,0,,3474,-3414
45,11-10-17,83,20:30,20:45,,0.59,0,0.59,0.59,-1,-23601,125386,148987,101785,0,-12665,0,0,0,,12665,-12665
45,11-10-17,84,20:45,21:00,42.48,-60.36,0,42.48,-60.36,2,-54708,56453,111161,1745,0,-37779,379,0,0,,38158,-37400
45,11-10-17,85,21:00,21:15,38.4,-60.36,0,38.4,38.4,1,-59601,65541,125142,5940,0,-438,743,0,0,,1181,305
45,11-10-17,86,21:15,21:30,37.53,,0,37.53,37.53,1,-41663,33531,75194,-8132,0,0,337,0,0,,337,337
45,11-10-17,87,21:30,21:45,37.53,12.54,0,12.54,12.54,-1,-15366,49483,64849,34117,0,-11817,8,0,0,,11825,-11809
45,11-10-17,88,21:45,22:00,,30.07,0,30.07,30.07,-1,-23611,61319,84930,37708,0,-29987,0,0,0,,29987,-29987
45,11-10-17,89,22:00,22:15,359.62,30.07,0,359.62,359.62,1,-82524,31875,114399,-50649,0,-7337,13335,0,0,,20672,5998
45,11-10-17,90,22:15,22:30,359.62,28.59,0,28.59,28.59,-1,-30582,51907,82489,21325,0,-2977,2496,0,0,,5473,-481
45,11-10-17,91,22:30,22:45,35.25,27.48,0,35.25,35.25,1,-23263,39033,62296,15770,0,-7064,25,0,0,,7089,-7039
45,11-10-17,92,22:45,23:00,35.59,27.55,0,39.73,27.55,2,-33291,38839,72130,5548,0,-2106,363,0,0,,2469,-1743
45,11-10-17,93,23:00,23:15,59.62,13.22,0,59.62,13.22,2,-60238,57866,118104,-2372,0,-7947,1415,0,0,,9362,-6532
45,11-10-17,94,23:15,23:30,109.13,13.22,0,109.13,109.13,1,-72725,47352,120077,-25373,0,-55,19622,0,0,,19677,19567
45,11-10-17,95,23:30,23:45,109.13,35.07,0,35.07,35.07,-1,-55648,47611,103259,-8037,0,-401,634,0,0,,1035,233
45,11-10-17,96,23:45,0:00,35.43,,0,35.43,35.43,1,-79514,39486,119000,-40028,0,0,146,0,0,,146,146
46,11-11-17,1,0:00,0:15,66.47,,0,66.47,66.47,1,-102166,98922,201088,-3244,0,0,10396,0,0,,10396,10396
46,11-11-17,2,0:15,0:30,66.47,,0,66.47,66.47,1,-56667,55345,112012,-1322,0,0,23637,0,0,,23637,23637
46,11-11-17,3,0:30,0:45,36.46,,0,36.46,36.46,1,-40791,45283,86074,4492,0,0,11341,0,0,,11341,11341
46,11-11-17,4,0:45,1:00,36.46,10.16,0,10.16,10.16,-1,-35234,91639,126873,56405,0,-9717,451,0,0,,10168,-9266
46,11-11-17,5,1:00,1:15,41.68,-17.12,0,41.68,-17.12,2,-36442,34086,70528,-2356,0,-18182,1257,0,0,,19439,-16925
46,11-11-17,6,1:15,1:30,34.92,,0,34.92,34.92,1,-69671,28100,97771,-41571,0,0,364,0,0,,364,364
46,11-11-17,7,1:30,1:45,,20.98,0,20.98,20.98,-1,-40490,51569,92059,11079,0,-2582,0,0,0,,2582,-2582
46,11-11-17,8,1:45,2:00,,7.13,0,7.13,7.13,-1,-40869,55765,96634,14896,0,-25677,0,0,0,,25677,-25677
46,11-11-17,9,2:00,2:15,66.47,7.13,0,66.47,66.47,1,-58989,25853,84842,-33136,0,-2798,6889,0,0,,9687,4091
46,11-11-17,10,2:15,2:30,64.09,29.77,0,64.09,29.77,2,-47945,35750,83695,-12195,0,-420,16115,0,0,,16535,15695
46,11-11-17,11,2:30,2:45,64.09,27.52,0,27.52,27.52,-1,-41172,27205,68377,-13967,0,-4041,150,0,0,,4191,-3891
46,11-11-17,12,2:45,3:00,,,0,40.09,40.09,0,-76592,18987,95579,-57605,0,0,0,0,0,,0,0
46,11-11-17,13,3:00,3:15,41.68,,0,41.68,41.68,1,-77781,45281,123062,-32500,0,0,2483,0,0,,2483,2483
46,11-11-17,14,3:15,3:30,35.09,,0,35.09,35.09,1,-69775,63901,133676,-5874,0,0,1532,0,0,,1532,1532
46,11-11-17,15,3:30,3:45,,33.46,0,33.46,33.46,-1,-65558,68704,134262,3146,0,-3039,0,0,0,,3039,-3039
46,11-11-17,16,3:45,4:00,,35.25,0,35.25,35.25,-1,-63918,33413,97331,-30505,0,-1442,0,0,0,,1442,-1442
46,11-11-17,17,4:00,4:15,63.93,,0,63.93,63.93,1,-41684,36364,78048,-5320,0,0,12343,0,0,,12343,12343
46,11-11-17,18,4:15,4:30,36.63,35.07,0,40.09,35.07,2,-35074,52154,87228,17080,0,-99,4720,0,0,,4819,4621
46,11-11-17,19,4:30,4:45,89.9,,0,89.9,89.9,1,-52967,32380,85347,-20587,0,0,25321,0,0,,25321,25321
46,11-11-17,20,4:45,5:00,63.53,,0,63.53,63.53,1,-62596,38307,100903,-24289,0,0,49526,0,0,,49526,49526
46,11-11-17,21,5:00,5:15,36.14,30.19,0,40.07,30.19,2,-53911,56154,110065,2243,0,-1026,15116,0,0,,16142,14090
46,11-11-17,22,5:15,5:30,51.01,,0,51.01,51.01,1,-78800,45645,124445,-33155,0,0,10226,0,0,,10226,10226
46,11-11-17,23,5:30,5:45,,,0,40.08,40.08,0,-59550,35877,95427,-23673,0,0,1879,0,0,,1879,1879
46,11-11-17,24,5:45,6:00,110.91,,0,110.91,110.91,1,-87888,29972,117860,-57916,0,0,18129,0,0,,18129,18129
46,11-11-17,25,6:00,6:15,40.29,35.53,0,40.29,35.53,2,-58127,51065,109192,-7062,0,-72,26519,0,0,,26591,26447
46,11-11-17,26,6:15,6:30,40.29,30.19,0,40.29,30.19,2,-43478,40745,84223,-2733,0,-1595,4016,0,0,,5611,2421
46,11-11-17,27,6:30,6:45,56.17,,0,56.17,56.17,1,-65796,42503,108299,-23293,0,0,18911,0,0,,18911,18911
46,11-11-17,28,6:45,7:00,60.58,,0,60.58,60.58,1,-76385,66761,143146,-9624,0,0,15145,0,0,,15145,15145
46,11-11-17,29,7:00,7:15,57.09,,0,57.09,57.09,1,-78521,45144,123665,-33377,0,0,23309,0,0,,23309,23309
46,11-11-17,30,7:15,7:30,52.51,,0,52.51,52.51,1,-63612,56843,120455,-6769,0,0,22274,0,0,,22274,22274
46,11-11-17,31,7:30,7:45,46.29,,0,46.29,46.29,1,-73018,53736,126754,-19282,0,0,16136,0,0,,16136,16136
46,11-11-17,32,7:45,8:00,91.55,,0,91.55,91.55,1,-94988,63780,158768,-31208,0,0,31252,0,0,,31252,31252
46,11-11-17,33,8:00,8:15,91.55,-35.72,0,-35.72,-35.72,-1,-50484,149288,199772,98804,0,-30480,8354,0,0,,38834,-22126
46,11-11-17,34,8:15,8:30,40.29,12.14,0,40.29,40.29,1,-78278,81722,160000,3444,0,-27341,413,0,0,,27754,-26928
46,11-11-17,35,8:30,8:45,69.11,12.14,0,69.11,69.11,1,-106934,55995,162929,-50939,0,-963,17444,0,0,,18407,16481
46,11-11-17,36,8:45,9:00,127.02,,0,127.02,127.02,1,-100440,67155,167595,-33285,0,0,46720,0,0,,46720,46720
46,11-11-17,37,9:00,9:15,155.84,,0,155.84,155.84,1,-126979,59338,186317,-67641,0,0,37357,0,0,,37357,37357
46,11-11-17,38,9:15,9:30,155.84,37.4,0,37.4,37.4,-1,-60103,63984,124087,3881,0,-1679,7680,0,0,,9359,6001
46,11-11-17,39,9:30,9:45,74.85,,0,74.85,74.85,1,-93426,56512,149938,-36914,0,0,3247,0,0,,3247,3247
46,11-11-17,40,9:45,10:00,414.28,,0,414.28,414.28,1,-96432,37606,134038,-58826,0,0,45268,0,0,,45268,45268
46,11-11-17,41,10:00,10:15,414.28,-42.11,0,-42.11,-42.11,-1,-26704,71511,98215,44807,0,-18301,7470,0,0,,25771,-10831
46,11-11-17,42,10:15,10:30,64.02,45.13,0,64.02,64.02,1,-61252,29209,90461,-32043,0,-2039,6772,0,0,,8811,4733
46,11-11-17,43,10:30,10:45,42.73,,0,42.73,42.73,1,-56991,27214,84205,-29777,0,0,15709,0,0,,15709,15709
46,11-11-17,44,10:45,11:00,42.73,,0,42.73,42.73,1,-54774,26421,81195,-28353,0,0,11348,0,0,,11348,11348
46,11-11-17,45,11:00,11:15,35.26,40.02,0,40.03,40.02,2,-43603,42139,85742,-1464,0,-740,2983,0,0,,3723,2243
46,11-11-17,46,11:15,11:30,69.02,,0,69.02,69.02,1,-64421,36066,100487,-28355,0,0,14736,0,0,,14736,14736
46,11-11-17,47,11:30,11:45,40.29,,0,40.29,40.29,1,-71648,39782,111430,-31866,0,0,16102,0,0,,16102,16102
46,11-11-17,48,11:45,12:00,37.12,,0,37.12,37.12,1,-89209,65737,154946,-23472,0,0,13003,0,0,,13003,13003
46,11-11-17,49,12:00,12:15,158.31,,0,158.31,158.31,1,-140760,55089,195849,-85671,0,0,38983,0,0,,38983,38983
46,11-11-17,50,12:15,12:30,56.02,,0,56.02,56.02,1,-119751,81975,201726,-37776,0,0,36253,0,0,,36253,36253
46,11-11-17,51,12:30,12:45,56.02,34.03,0,34.03,34.03,-1,-75227,72626,147853,-2601,0,-5181,3443,0,0,,8624,-1738
46,11-11-17,52,12:45,13:00,,22.37,0,22.37,22.37,-1,-36256,58232,94488,21976,0,-23892,0,0,0,,23892,-23892
46,11-11-17,53,13:00,13:15,35.99,32.95,0,35.99,35.99,1,-46778,55150,101928,8372,0,-22882,178,0,0,,23060,-22704
46,11-11-17,54,13:15,13:30,35.99,21.84,0,21.84,21.84,-1,-66525,85369,151894,18844,0,-8990,35,0,0,,9025,-8955
46,11-11-17,55,13:30,13:45,,21.59,0,21.59,21.59,-1,-59178,72089,131267,12911,0,-18163,0,0,0,,18163,-18163
46,11-11-17,56,13:45,14:00,,7.2,0,7.2,7.2,-1,-34520,79175,113695,44655,0,-34802,0,0,0,,34802,-34802
46,11-11-17,57,14:00,14:15,34.78,34.29,0,40.05,34.29,2,-68257,74168,142425,5911,0,-13528,53,0,0,,13581,-13475
46,11-11-17,58,14:15,14:30,,25.37,0,25.37,25.37,-1,-58343,86311,144654,27968,0,-21164,0,0,0,,21164,-21164
46,11-11-17,59,14:30,14:45,,34.29,0,34.29,34.29,-1,-50617,84561,135178,33944,0,-16163,0,0,0,,16163,-16163
46,11-11-17,60,14:45,15:00,,20.49,0,20.49,20.49,-1,-28308,80952,109260,52644,0,-37478,0,0,0,,37478,-37478
46,11-11-17,61,15:00,15:15,,32.03,0,32.03,32.03,-1,-29514,70192,99706,40678,0,-33691,0,0,0,,33691,-33691
46,11-11-17,62,15:15,15:30,,27.25,0,27.25,27.25,-1,-20535,75805,96340,55270,0,-48825,0,0,0,,48825,-48825
46,11-11-17,63,15:30,15:45,,23.03,0,23.03,23.03,-1,-19088,72356,91444,53268,0,-58142,0,0,0,,58142,-58142
46,11-11-17,64,15:45,16:00,,33.29,0,33.29,33.29,-1,-33895,64140,98035,30245,0,-30973,0,0,0,,30973,-30973
46,11-11-17,65,16:00,16:15,,21.91,0,21.91,21.91,-1,-37643,83240,120883,45597,0,-17472,0,0,0,,17472,-17472
46,11-11-17,66,16:15,16:30,,16.97,0,16.97,16.97,-1,-27688,69089,96777,41401,0,-36247,0,0,0,,36247,-36247
46,11-11-17,67,16:30,16:45,40.29,16.97,0,40.29,40.29,1,-70919,55908,126827,-15011,0,-7219,1875,0,0,,9094,-5344
46,11-11-17,68,16:45,17:00,38.78,35.54,0,40.06,35.54,2,-72129,59979,132108,-12150,0,-53,3039,0,0,,3092,2986
46,11-11-17,69,17:00,17:15,38.78,2.14,0,2.14,2.14,-1,-37032,69809,106841,32777,0,-27023,170,0,0,,27193,-26853
46,11-11-17,70,17:15,17:30,84.02,2.14,0,84.02,84.02,1,-22632,44244,66876,21612,0,-1022,15171,0,0,,16193,14149
46,11-11-17,71,17:30,17:45,66.24,,0,66.24,66.24,1,-22101,63888,85989,41787,0,0,32598,0,0,,32598,32598
46,11-11-17,72,17:45,18:00,104.96,,0,104.96,104.96,1,-20467,87213,107680,66746,0,0,13853,0,0,,13853,13853
46,11-11-17,73,18:00,18:15,418.19,,0,418.19,418.19,1,-34696,100187,134883,65491,0,0,16599,0,0,,16599,16599
46,11-11-17,74,18:15,18:30,,,0,40.04,40.04,0,-26924,116217,143141,89293,0,0,323,0,0,,323,323
46,11-11-17,75,18:30,18:45,,,0,40.04,40.04,0,-12722,131776,144498,119054,0,0,0,0,0,,0,0
46,11-11-17,76,18:45,19:00,,,0,40.04,40.04,0,-25754,143119,168873,117365,0,0,0,0,0,,0,0
46,11-11-17,77,19:00,19:15,45.02,,0,45.02,45.02,1,-67760,58521,126281,-9239,0,0,6655,0,0,,6655,6655
46,11-11-17,78,19:15,19:30,38.88,,0,38.88,38.88,1,-72402,69029,141431,-3373,0,0,10658,0,0,,10658,10658
46,11-11-17,79,19:30,19:45,547.72,,0,547.72,547.72,1,-90500,52659,143159,-37841,0,0,25976,0,0,,25976,25976
46,11-11-17,80,19:45,20:00,547.72,22.17,0,22.17,22.17,-1,-31605,76023,107628,44418,0,-18601,4640,0,0,,23241,-13961
46,11-11-17,81,20:00,20:15,38.2,34.03,0,40.05,34.03,2,-66037,64768,130805,-1269,0,-10816,936,0,0,,11752,-9880
46,11-11-17,82,20:15,20:30,,-32.15,0,-32.15,-32.15,-1,-36398,40808,77206,4410,0,-26684,0,0,0,,26684,-26684
46,11-11-17,83,20:30,20:45,,15.91,0,15.91,15.91,-1,-54384,32684,87068,-21700,0,-53190,0,0,0,,53190,-53190
46,11-11-17,84,20:45,21:00,,12.83,0,12.83,12.83,-1,-58467,45909,104376,-12558,0,-74247,0,0,0,,74247,-74247
46,11-11-17,85,21:00,21:15,37.86,9.99,0,40.05,9.99,2,-55700,88008,143708,32308,0,-52356,288,0,0,,52644,-52068
46,11-11-17,86,21:15,21:30,51.26,34.29,0,51.26,34.29,2,-62315,73881,136196,11566,0,-2747,672,0,0,,3419,-2075
46,11-11-17,87,21:30,21:45,,33.29,0,33.29,33.29,-1,-39803,62843,102646,23040,0,-15062,0,0,0,,15062,-15062
46,11-11-17,88,21:45,22:00,36.29,35.27,0,36.29,36.29,1,-46661,37855,84516,-8806,0,-8651,524,0,0,,9175,-8127
46,11-11-17,89,22:00,22:15,36.29,34.03,0,34.03,34.03,-1,-39443,60210,99653,20767,0,-2098,16,0,0,,2114,-2082
46,11-11-17,90,22:15,22:30,,10.49,0,10.49,10.49,-1,-32902,81529,114431,48627,0,-29388,0,0,0,,29388,-29388
46,11-11-17,91,22:30,22:45,,20.89,0,20.89,20.89,-1,-27416,71981,99397,44565,0,-53121,0,0,0,,53121,-53121
46,11-11-17,92,22:45,23:00,,34.29,0,34.29,34.29,-1,-53889,91308,145197,37419,0,-18011,0,0,0,,18011,-18011
46,11-11-17,93,23:00,23:15,43.08,34.29,0,43.08,34.29,2,-67184,35799,102983,-31385,0,-3190,2904,0,0,,6094,-286
46,11-11-17,94,23:15,23:30,36.29,34.29,0,34.29,34.29,-1,-62658,43667,106325,-18991,0,-154,3231,0,0,,3385,3077
46,11-11-17,95,23:30,23:45,,27.33,0,27.33,27.33,-1,-34148,59409,93557,25261,0,-17370,0,0,0,,17370,-17370
46,11-11-17,96,23:45,0:00,,30.48,0,30.48,30.48,-1,-80312,95189,175501,14877,0,-32085,0,0,0,,32085,-32085
46,11-12-17,1,0:00,0:15,40.29,30.48,0,40.29,40.29,1,-65135,46695,111830,-18440,0,-6802,1532,0,0,,8334,-5270
46,11-12-17,2,0:15,0:30,40.29,,0,40.29,40.29,1,-57737,34447,92184,-23290,0,0,2025,0,0,,2025,2025
46,11-12-17,3,0:30,0:45,492.1,,0,492.1,492.1,1,-101443,40171,141614,-61272,0,0,27906,0,0,,27906,27906
46,11-12-17,4,0:45,1:00,492.1,32.57,0,492.1,32.57,2,-104446,64624,169070,-39822,0,-205,46800,0,0,,47005,46595
46,11-12-17,5,1:00,1:15,492.1,-45.28,0,-45.28,-45.28,-1,-25684,96212,121896,70528,0,-31210,4665,0,0,,35875,-26545
46,11-12-17,6,1:15,1:30,38.14,1.44,0,39.18,1.44,2,-26432,51239,77671,24807,0,-9979,442,0,0,,10421,-9537
46,11-12-17,7,1:30,1:45,79.22,-1.54,0,79.22,-1.54,2,-31916,22190,54106,-9726,0,-22198,2221,0,0,,24419,-19977
46,11-12-17,8,1:45,2:00,186.36,-1.54,0,186.36,186.36,1,-81316,22674,103990,-58642,0,-17,37506,0,0,,37523,37489
46,11-12-17,9,2:00,2:15,46.14,,0,46.14,46.14,1,-74309,34115,108424,-40194,0,0,20070,0,0,,20070,20070
46,11-12-17,10,2:15,2:30,40.29,,0,40.29,40.29,1,-64128,43818,107946,-20310,0,0,18413,0,0,,18413,18413
46,11-12-17,11,2:30,2:45,36.29,29.29,0,29.29,29.29,-1,-37156,38288,75444,1132,0,-3296,6817,0,0,,10113,3521
46,11-12-17,12,2:45,3:00,,18.43,0,18.43,18.43,-1,-33237,52998,86235,19761,0,-25137,0,0,0,,25137,-25137
46,11-12-17,13,3:00,3:15,40.7,34.29,0,40.7,40.7,1,-55332,40857,96189,-14475,0,-7830,1847,0,0,,9677,-5983
46,11-12-17,14,3:15,3:30,52.12,34.15,0,52.12,34.15,2,-44912,41430,86342,-3482,0,-98,13465,0,0,,13563,13367
46,11-12-17,15,3:30,3:45,52.12,29.29,0,29.29,29.29,-1,-33101,51670,84771,18569,0,-3107,625,0,0,,3732,-2482
46,11-12-17,16,3:45,4:00,,34.29,0,34.29,34.29,-1,-52988,54842,107830,1854,0,-688,0,0,0,,688,-688
46,11-12-17,17,4:00,4:15,47.05,34.29,0,47.05,47.05,1,-71337,54805,126142,-16532,0,-8,2167,0,0,,2175,2159
46,11-12-17,18,4:15,4:30,47.05,29.21,0,29.21,29.21,-1,-57894,63115,121009,5221,0,-1232,2907,0,0,,4139,1675
46,11-12-17,19,4:30,4:45,,17.37,0,17.37,17.37,-1,-38605,67849,106454,29244,0,-23025,0,0,0,,23025,-23025
46,11-12-17,20,4:45,5:00,,33.78,0,33.78,33.78,-1,-55615,67479,123094,11864,0,-11168,0,0,0,,11168,-11168
46,11-12-17,21,5:00,5:15,37.27,33.78,0,37.27,37.27,1,-72298,84319,156617,12021,0,-52,246,0,0,,298,194
46,11-12-17,22,5:15,5:30,,29.29,0,29.29,29.29,-1,-55283,87037,142320,31754,0,-2387,0,0,0,,2387,-2387
46,11-12-17,23,5:30,5:45,,29.29,0,29.29,29.29,-1,-46413,65990,112403,19577,0,-10878,0,0,0,,10878,-10878
46,11-12-17,24,5:45,6:00,,24.35,0,24.35,24.35,-1,-54654,63849,118503,9195,0,-24871,0,0,0,,24871,-24871
46,11-12-17,25,6:00,6:15,,32.04,0,32.04,32.04,-1,-39241,129686,168927,90445,0,-15861,0,0,0,,15861,-15861
46,11-12-17,26,6:15,6:30,,24.83,0,24.83,24.83,-1,-44289,135548,179837,91259,0,-18591,0,0,0,,18591,-18591
46,11-12-17,27,6:30,6:45,,34.13,0,34.13,34.13,-1,-47706,95087,142793,47381,0,-3923,0,0,0,,3923,-3923
46,11-12-17,28,6:45,7:00,,33.29,0,33.29,33.29,-1,-73731,73670,147401,-61,0,-3835,0,0,0,,3835,-3835
46,11-12-17,29,7:00,7:15,,33.29,0,33.29,33.29,-1,-86956,113822,200778,26866,0,-3709,0,0,0,,3709,-3709
46,11-12-17,30,7:15,7:30,,21.22,0,21.22,21.22,-1,-38035,83941,121976,45906,0,-16640,0,0,0,,16640,-16640
46,11-12-17,31,7:30,7:45,,33.78,0,33.78,33.78,-1,-56711,71797,128508,15086,0,-6768,0,0,0,,6768,-6768
46,11-12-17,32,7:45,8:00,,-27.28,0,-27.28,-27.28,-1,-34493,111461,145954,76968,0,-32602,0,0,0,,32602,-32602
46,11-12-17,33,8:00,8:15,,-27.25,0,-27.25,-27.25,-1,-14513,145859,160372,131346,0,-97224,0,0,0,,97224,-97224
46,11-12-17,34,8:15,8:30,,-27.25,0,-27.25,-27.25,-1,-46137,104103,150240,57966,0,-77099,0,0,0,,77099,-77099
46,11-12-17,35,8:30,8:45,,29.29,0,29.29,29.29,-1,-54392,82783,137175,28391,0,-25274,0,0,0,,25274,-25274
46,11-12-17,36,8:45,9:00,61.38,29.29,0,61.38,61.38,1,-68867,58311,127178,-10556,0,-7082,3418,0,0,,10500,-3664
46,11-12-17,37,9:00,9:15,36.29,26.65,0,26.65,26.65,-1,-44744,70907,115651,26163,0,-4427,1736,0,0,,6163,-2691
46,11-12-17,38,9:15,9:30,,34.25,0,34.25,34.25,-1,-33431,91452,124883,58021,0,-6337,0,0,0,,6337,-6337
46,11-12-17,39,9:30,9:45,,,0,40.02,40.02,0,-42801,100740,143541,57939,0,-345,0,0,0,,345,-345
46,11-12-17,40,9:45,10:00,,,0,40.01,40.01,0,-66612,99944,166556,33332,0,0,0,0,0,,0,0
46,11-12-17,41,10:00,10:15,,,0,40.03,40.03,0,-31517,101608,133125,70091,0,0,0,0,0,,0,0
46,11-12-17,42,10:15,10:30,,,0,40.03,40.03,0,-24265,94318,118583,70053,0,0,0,0,0,,0,0
46,11-12-17,43,10:30,10:45,,,0,40.03,40.03,0,-30256,63076,93332,32820,0,0,0,0,0,,0,0
46,11-12-17,44,10:45,11:00,50.67,,0,50.67,50.67,1,-53837,45024,98861,-8813,0,0,686,0,0,,686,686
46,11-12-17,45,11:00,11:15,141.51,,0,141.51,141.51,1,-102916,49180,152096,-53736,0,0,21605,0,0,,21605,21605
46,11-12-17,46,11:15,11:30,55.28,,0,55.28,55.28,1,-90176,65365,155541,-24811,0,0,33165,0,0,,33165,33165
46,11-12-17,47,11:30,11:45,55.28,41.76,0,41.76,41.76,-1,-47415,66015,113430,18600,0,-1180,4389,0,0,,5569,3209
46,11-12-17,48,11:45,12:00,,,0,40.02,40.02,0,-43716,93822,137538,50106,0,0,0,0,0,,0,0
46,11-12-17,49,12:00,12:15,,,0,40.02,40.02,0,-36111,89832,125943,53721,0,0,0,0,0,,0,0
46,11-12-17,50,12:15,12:30,,,0,40.02,40.02,0,-36984,84783,121767,47799,0,0,0,0,0,,0,0
46,11-12-17,51,12:30,12:45,,,0,40.01,40.01,0,-38711,75416,114127,36705,0,0,0,0,0,,0,0
46,11-12-17,52,12:45,13:00,,18.22,0,18.22,18.22,-1,-36572,97661,134233,61089,0,-3738,0,0,0,,3738,-3738
46,11-12-17,53,13:00,13:15,,21.67,0,21.67,21.67,-1,-73921,76285,150206,2364,0,-4628,0,0,0,,4628,-4628
46,11-12-17,54,13:15,13:30,,,0,40.01,40.01,0,-90782,65716,156498,-25066,0,0,0,0,0,,0,0
46,11-12-17,55,13:30,13:45,,20.66,0,20.66,20.66,-1,-58377,74776,133153,16399,0,-2999,0,0,0,,2999,-2999
46,11-12-17,56,13:45,14:00,,-9.91,0,-9.91,-9.91,-1,-15412,83180,98592,67768,0,-46810,0,0,0,,46810,-46810
46,11-12-17,57,14:00,14:15,,29.29,0,29.29,29.29,-1,-25412,56587,81999,31175,0,-23257,0,0,0,,23257,-23257
46,11-12-17,58,14:15,14:30,,,0,40.01,40.01,0,-26634,41285,67919,14651,0,0,0,0,0,,0,0
46,11-12-17,59,14:30,14:45,,33.29,0,33.29,33.29,-1,-27286,61726,89012,34440,0,-239,0,0,0,,239,-239
46,11-12-17,60,14:45,15:00,,30.88,0,30.88,30.88,-1,-40626,79014,119640,38388,0,-13149,0,0,0,,13149,-13149
46,11-12-17,61,15:00,15:15,36.29,30.88,0,36.29,36.29,1,-80508,85054,165562,4546,0,-3428,233,0,0,,3661,-3195
46,11-12-17,62,15:15,15:30,35.1,,0,35.1,35.1,1,-79344,88554,167898,9210,0,0,270,0,0,,270,270
46,11-12-17,63,15:30,15:45,,,0,39.99,39.99,0,-74158,81741,155899,7583,0,0,9,0,0,,9,9
46,11-12-17,64,15:45,16:00,,,0,39.15,39.15,0,-79578,91074,170652,11496,0,0,0,0,0,,0,0
46,11-12-17,65,16:00,16:15,,,0,40.01,40.01,0,-76245,51215,127460,-25030,0,0,0,0,0,,0,0
46,11-12-17,66,16:15,16:30,204.53,,0,204.53,204.53,1,-99775,40969,140744,-58806,0,0,10799,0,0,,10799,10799
46,11-12-17,67,16:30,16:45,204.53,,0,204.53,204.53,1,-80683,46301,126984,-34382,0,0,45604,0,0,,45604,45604
46,11-12-17,68,16:45,17:00,40.29,,0,40.29,40.29,1,-84875,76805,161680,-8070,0,0,6131,0,0,,6131,6131
46,11-12-17,69,17:00,17:15,40.29,-44.69,0,-44.69,-44.69,-1,-35966,97718,133684,61752,0,-23321,19,0,0,,23340,-23302
46,11-12-17,70,17:15,17:30,,43.93,0,43.93,43.93,-1,-46904,49465,96369,2561,0,-4348,0,0,0,,4348,-4348
46,11-12-17,71,17:30,17:45,59.91,,0,59.91,59.91,1,-62998,50996,113994,-12002,0,0,3437,0,0,,3437,3437
46,11-12-17,72,17:45,18:00,59.91,,0,59.91,59.91,1,-43328,67149,110477,23821,0,0,4641,0,0,,4641,4641
46,11-12-17,73,18:00,18:15,40.29,,0,40.29,40.29,1,-53256,51317,104573,-1939,0,0,847,0,0,,847,847
46,11-12-17,74,18:15,18:30,36.29,,0,36.29,36.29,1,-54321,62870,117191,8549,0,0,383,0,0,,383,383
46,11-12-17,75,18:30,18:45,36.29,42.26,0,42.26,42.26,-1,-40141,72238,112379,32097,0,-495,38,0,0,,533,-457
46,11-12-17,76,18:45,19:00,,,0,39.96,39.96,0,-43661,65386,109047,21725,0,0,0,0,0,,0,0
46,11-12-17,77,19:00,19:15,510.05,,0,510.05,510.05,1,-84258,27999,112257,-56259,0,0,22622,0,0,,22622,22622
46,11-12-17,78,19:15,19:30,65.67,,0,65.67,65.67,1,-74516,50492,125008,-24024,0,0,32750,0,0,,32750,32750
46,11-12-17,79,19:30,19:45,45.12,,0,45.12,45.12,1,-63257,45638,108895,-17619,0,0,7510,0,0,,7510,7510
46,11-12-17,80,19:45,20:00,40.29,,0,40.29,40.29,1,-44299,37391,81690,-6908,0,0,14454,0,0,,14454,14454
46,11-12-17,81,20:00,20:15,343.36,,0,343.36,343.36,1,-115678,69242,184920,-46436,0,0,28844,0,0,,28844,28844
46,11-12-17,82,20:15,20:30,36.29,-2.07,0,-2.07,-2.07,-1,-64574,85773,150347,21199,0,-2637,12755,0,0,,15392,10118
46,11-12-17,83,20:30,20:45,36.29,-6.92,0,-6.92,-6.92,-1,-47544,77047,124591,29503,0,-25674,9,0,0,,25683,-25665
46,11-12-17,84,20:45,21:00,,-5.84,0,-5.84,-5.84,-1,-31167,77755,108922,46588,0,-28053,0,0,0,,28053,-28053
46,11-12-17,85,21:00,21:15,123.12,-51.81,0,123.12,-51.81,2,-136093,78446,214539,-57647,0,-30725,5778,0,0,,36503,-24947
46,11-12-17,86,21:15,21:30,129.12,-51.81,0,129.12,129.12,1,-93384,70378,163762,-23006,0,-22,14027,0,0,,14049,14005
46,11-12-17,87,21:30,21:45,35.52,,0,35.52,35.52,1,-83650,70287,153937,-13363,0,0,624,0,0,,624,624
46,11-12-17,88,21:45,22:00,34.85,34.29,0,40.02,34.29,2,-74146,74549,148695,403,0,-474,263,0,0,,737,-211
46,11-12-17,89,22:00,22:15,390.89,44.55,0,390.89,39.14,2,-161465,56620,218085,-104845,0,-208,19738,0,0,,19946,19530
46,11-12-17,90,22:15,22:30,390.89,39.73,0,390.89,39.73,2,-88797,62764,151561,-26033,0,-377,37424,0,0,,37801,37047
46,11-12-17,91,22:30,22:45,56,40.81,0,56,40.04,2,-96215,63500,159715,-32715,0,-103,2048,0,0,,2151,1945
46,11-12-17,92,22:45,23:00,170,,0,170,170,1,-122240,58046,180286,-64194,0,0,23150,0,0,,23150,23150
46,11-12-17,93,23:00,23:15,130.12,,0,130.12,130.12,1,-137661,78486,216147,-59175,0,0,30564,0,0,,30564,30564
46,11-12-17,94,23:15,23:30,53.96,33.78,0,33.78,33.78,-1,-93208,81143,174351,-12065,0,-385,24979,0,0,,25364,24594
46,11-12-17,95,23:30,23:45,36.29,33.29,0,40.04,33.29,2,-96404,90073,186477,-6331,0,-526,542,0,0,,1068,16
46,11-12-17,96,23:45,0:00,,14.19,0,14.19,14.19,-1,-78563,97334,175897,18771,0,-5190,0,0,0,,5190,-5190
46,11/13/2017,1,0:00,0:15,38.95,-31.09,0,38.95,-31.09,2,-61173,115903,177076,54730,0,-35755,99,0,0,,35854,-35656
46,11/13/2017,2,0:15,0:30,61.93,29.29,0,61.93,29.29,2,-62481,72914,135395,10433,0,-3819,4592,0,0,,8411,773
46,11/13/2017,3,0:30,0:45,,29.67,0,29.67,29.67,-1,-47213,53950,101163,6737,0,-3111,0,0,0,,3111,-3111
46,11/13/2017,4,0:45,1:00,,30.78,0,30.78,30.78,-1,-46736,58814,105550,12078,0,-11710,0,0,0,,11710,-11710
46,11/13/2017,5,1:00,1:15,115.42,33.29,0,115.42,115.42,1,-74501,41386,115887,-33115,0,-9718,6713,0,0,,16431,-3005
46,11/13/2017,6,1:15,1:30,123.32,,0,123.32,123.32,1,-54497,35571,90068,-18926,0,0,17046,0,0,,17046,17046
46,11/13/2017,7,1:30,1:45,37.85,,0,37.85,37.85,1,-63329,44437,107766,-18892,0,0,3785,0,0,,3785,3785
46,11/13/2017,8,1:45,2:00,40.29,20.67,0,40.29,20.67,2,-34847,52357,87204,17510,0,-2828,8922,0,0,,11750,6094
46,11/13/2017,9,2:00,2:15,39.66,-10.03,0,39.66,-10.03,2,-39439,23970,63409,-15469,0,-10081,1254,0,0,,11335,-8827
46,11/13/2017,10,2:15,2:30,,12.45,0,12.45,12.45,-1,-38647,63093,101740,24446,0,-9501,0,0,0,,9501,-9501
46,11/13/2017,11,2:30,2:45,,4.03,0,4.03,4.03,-1,-38872,74874,113746,36002,0,-41758,0,0,0,,41758,-41758
46,11/13/2017,12,2:45,3:00,,20.55,0,20.55,20.55,-1,-41420,73345,114765,31925,0,-30974,0,0,0,,30974,-30974
46,11/13/2017,13,3:00,3:15,,3.03,0,3.03,3.03,-1,-22837,81961,104798,59124,0,-22623,0,0,0,,22623,-22623
46,11/13/2017,14,3:15,3:30,40.29,3.03,0,40.29,40.29,1,-36687,33363,70050,-3324,0,-246,12,0,0,,258,-234
46,11/13/2017,15,3:30,3:45,36.29,,0,36.29,36.29,1,-46657,35637,82294,-11020,0,0,425,0,0,,425,425
46,11/13/2017,16,3:45,4:00,41.6,,0,41.6,41.6,1,-61140,35169,96309,-25971,0,0,12516,0,0,,12516,12516
46,11/13/2017,17,4:00,4:15,40.29,,0,40.29,40.29,1,-71473,13647,85120,-57826,0,0,13704,0,0,,13704,13704
46,11/13/2017,18,4:15,4:30,37.02,34.33,0,34.33,34.33,-1,-47599,31865,79464,-15734,0,-197,9997,0,0,,10194,9800
46,11/13/2017,19,4:30,4:45,37.02,34.33,0,34.33,34.33,-1,-28906,33436,62342,4530,0,-138,96,0,0,,234,-42
46,11/13/2017,20,4:45,5:00,,,0,34.36,34.36,0,-31522,55704,87226,24182,0,0,0,0,0,,0,0
46,11/13/2017,21,5:00,5:15,35.99,,0,35.99,35.99,1,-76955,35886,112841,-41069,0,0,245,0,0,,245,245
46,11/13/2017,22,5:15,5:30,36.29,34.33,0,39.38,34.33,2,-48453,35184,83637,-13269,0,-516,150,0,0,,666,-366
46,11/13/2017,23,5:30,5:45,64.86,,0,64.86,64.86,1,-57942,20372,78314,-37570,0,0,3877,0,0,,3877,3877
46,11/13/2017,24,5:45,6:00,224.05,,0,224.05,224.05,1,-111942,32207,144149,-79735,0,0,47671,0,0,,47671,47671
46,11/13/2017,25,6:00,6:15,36.02,-10.49,0,-10.49,-10.49,-1,-87712,111881,199593,24169,0,-3765,18830,0,0,,22595,15065
46,11/13/2017,26,6:15,6:30,94.4,-41.92,0,94.4,-41.92,2,-53175,42217,95392,-10958,0,-23764,4964,0,0,,28728,-18800
46,11/13/2017,27,6:30,6:45,138.02,,0,138.02,138.02,1,-103675,27101,130776,-76574,0,0,62024,0,0,,62024,62024
46,11/13/2017,28,6:45,7:00,138.02,,0,138.02,138.02,1,-134014,51652,185666,-82362,0,0,72237,0,0,,72237,72237
46,11/13/2017,29,7:00,7:15,138.02,-36.2,0,-36.2,-36.2,-1,-18056,144778,162834,126722,0,-33956,16429,0,0,,50385,-17527
46,11/13/2017,30,7:15,7:30,138.02,-49.14,0,138.02,138.02,1,-77937,75700,153637,-2237,0,-53943,3379,0,0,,57322,-50564
46,11/13/2017,31,7:30,7:45,405.66,34.02,0,405.66,34.02,2,-74135,55592,129727,-18543,0,-501,37300,0,0,,37801,36799
46,11/13/2017,32,7:45,8:00,405.66,-38.76,0,-38.76,-38.76,-1,-53887,99559,153446,45672,0,-25570,1453,0,0,,27023,-24117
46,11/13/2017,33,8:00,8:15,,14.34,0,14.34,14.34,-1,-53768,101020,154788,47252,0,-30188,0,0,0,,30188,-30188
46,11/13/2017,34,8:15,8:30,41.69,31.93,0,41.69,41.69,1,-72801,74109,146910,1308,0,-23644,748,0,0,,24392,-22896
46,11/13/2017,35,8:30,8:45,59.5,31.93,0,59.5,59.5,1,-76997,62029,139026,-14968,0,-159,2548,0,0,,2707,2389
46,11/13/2017,36,8:45,9:00,412.78,,0,412.78,412.78,1,-104845,67049,171894,-37796,0,0,31195,0,0,,31195,31195
46,11/13/2017,37,9:00,9:15,58.56,31.24,0,58.56,31.24,2,-66966,51492,118458,-15474,0,-492,29333,0,0,,29825,28841
46,11/13/2017,38,9:15,9:30,133.02,28.73,0,133.02,28.73,2,-84589,34177,118766,-50412,0,-2056,15514,0,0,,17570,13458
46,11/13/2017,39,9:30,9:45,161,,0,161,161,1,-103399,60365,163764,-43034,0,0,46193,0,0,,46193,46193
46,11/13/2017,40,9:45,10:00,161,12.69,0,12.69,12.69,-1,-45534,67425,112959,21891,0,-14548,3525,0,0,,18073,-11023
46,11/13/2017,41,10:00,10:15,42.11,33.03,0,42.11,33.03,2,-49138,43688,92826,-5450,0,-8988,1652,0,0,,10640,-7336
46,11/13/2017,42,10:15,10:30,42.11,25.59,0,25.59,25.59,-1,-50648,75239,125887,24591,0,-14197,10,0,0,,14207,-14187
46,11/13/2017,43,10:30,10:45,42.11,36.13,0,42.11,36.13,2,-62547,60655,123202,-1892,0,-3692,2305,0,0,,5997,-1387
46,11/13/2017,44,10:45,11:00,,33.98,0,33.98,33.98,-1,-60198,64959,125157,4761,0,-1954,0,0,0,,1954,-1954
46,11/13/2017,45,11:00,11:15,48.11,33.98,0,48.11,48.11,1,-74047,54965,129012,-19082,0,-9,6077,0,0,,6086,6068
46,11/13/2017,46,11:15,11:30,42.11,,0,42.11,42.11,1,-79729,61590,141319,-18139,0,0,1994,0,0,,1994,1994
46,11/13/2017,47,11:30,11:45,38.11,,0,38.11,38.11,1,-76777,73334,150111,-3443,0,0,3576,0,0,,3576,3576
46,11/13/2017,48,11:45,12:00,,25.86,0,25.86,25.86,-1,-50845,79483,130328,28638,0,-14613,0,0,0,,14613,-14613
46,11/13/2017,49,12:00,12:15,,33.98,0,33.98,33.98,-1,-68203,75795,143998,7592,0,-11088,0,0,0,,11088,-11088
46,11/13/2017,50,12:15,12:30,,33.98,0,33.98,33.98,-1,-63914,76532,140446,12618,0,-3562,0,0,0,,3562,-3562
46,11/13/2017,51,12:30,12:45,,17.26,0,17.26,17.26,-1,-58693,85281,143974,26588,0,-26977,0,0,0,,26977,-26977
46,11/13/2017,52,12:45,13:00,,33.03,0,33.03,33.03,-1,-58936,73427,132363,14491,0,-17180,0,0,0,,17180,-17180
46,11/13/2017,53,13:00,13:15,54.5,33.03,0,54.5,54.5,1,-78414,56978,135392,-21436,0,-720,8343,0,0,,9063,7623
46,11/13/2017,54,13:15,13:30,55.23,,0,55.23,55.23,1,-78854,57330,136184,-21524,0,0,18377,0,0,,18377,18377
46,11/13/2017,55,13:30,13:45,69.59,,0,69.59,69.59,1,-102522,60640,163162,-41882,0,0,22381,0,0,,22381,22381
46,11/13/2017,56,13:45,14:00,74.02,,0,74.02,74.02,1,-112126,61075,173201,-51051,0,0,41853,0,0,,41853,41853
46,11/13/2017,57,14:00,14:15,60.02,,0,60.02,60.02,1,-82191,72657,154848,-9534,0,0,21426,0,0,,21426,21426
46,11/13/2017,58,14:15,14:30,,,0,41.59,41.59,0,-87741,50917,138658,-36824,0,0,0,0,0,,0,0
46,11/13/2017,59,14:30,14:45,55.99,,0,55.99,55.99,1,-110879,43599,154478,-67280,0,0,7057,0,0,,7057,7057
46,11/13/2017,60,14:45,15:00,42.11,,0,42.11,42.11,1,-94051,45614,139665,-48437,0,0,8290,0,0,,8290,8290
46,11/13/2017,61,15:00,15:15,42.11,32.98,0,32.98,32.98,-1,-38469,67557,106026,29088,0,-3576,503,0,0,,4079,-3073
46,11/13/2017,62,15:15,15:30,,,0,40.97,40.97,0,-59592,56976,116568,-2616,0,0,0,0,0,,0,0
46,11/13/2017,63,15:30,15:45,41.75,,0,41.75,41.75,1,-71493,53401,124894,-18092,0,0,1496,0,0,,1496,1496
46,11/13/2017,64,15:45,16:00,39.03,33.98,0,40.97,33.98,2,-69924,55211,125135,-14713,0,-39,3668,0,0,,3707,3629
46,11/13/2017,65,16:00,16:15,39.03,-38.78,0,-38.78,-38.78,-1,-34338,106517,140855,72179,0,-32554,192,0,0,,32746,-32362
46,11/13/2017,66,16:15,16:30,,10.68,0,10.68,10.68,-1,-30740,100578,131318,69838,0,-15196,0,0,0,,15196,-15196
46,11/13/2017,67,16:30,16:45,427.92,-3.03,0,427.92,-3.03,2,-71429,67762,139191,-3667,0,-23995,2885,0,0,,26880,-21110
46,11/13/2017,68,16:45,17:00,427.92,-3.03,0,427.92,427.92,1,-138221,108989,247210,-29232,0,-24,28928,0,0,,28952,28904
46,11/13/2017,69,17:00,17:15,45.58,21.39,0,45.58,21.39,2,-59963,64224,124187,4261,0,-4531,8076,0,0,,12607,3545
46,11/13/2017,70,17:15,17:30,139.02,,0,139.02,139.02,1,-86959,42983,129942,-43976,0,0,21815,0,0,,21815,21815
46,11/13/2017,71,17:30,17:45,260.74,,0,260.74,260.74,1,-115069,56783,171852,-58286,0,0,46882,0,0,,46882,46882
46,11/13/2017,72,17:45,18:00,69.02,44.81,0,44.81,44.81,-1,-88886,82216,171102,-6670,0,-67,36287,0,0,,36354,36220
46,11/13/2017,73,18:00,18:15,35.44,34.51,0,41.07,34.51,2,-104857,78310,183167,-26547,0,-1061,2979,0,0,,4040,1918
46,11/13/2017,74,18:15,18:30,37.75,46.73,0,41.07,41.07,2,-87237,79840,167077,-7397,0,-31,672,0,0,,703,641
46,11/13/2017,75,18:30,18:45,,45.7,0,45.7,45.7,-1,-96949,87417,184366,-9532,0,-1077,0,0,0,,1077,-1077
46,11/13/2017,76,18:45,19:00,65.81,45.7,0,65.81,65.81,1,-100564,75624,176188,-24940,0,-17,7275,0,0,,7292,7258
46,11/13/2017,77,19:00,19:15,42.84,,0,42.84,42.84,1,-103536,82558,186094,-20978,0,0,5562,0,0,,5562,5562
46,11/13/2017,78,19:15,19:30,42.84,49.54,0,49.54,49.54,-1,-91242,91710,182952,468,0,-17,2072,0,0,,2089,2055
46,11/13/2017,79,19:30,19:45,,32.98,0,32.98,32.98,-1,-74022,85349,159371,11327,0,-8943,0,0,0,,8943,-8943
46,11/13/2017,80,19:45,20:00,,43.31,0,43.31,43.31,-1,-72936,80968,153904,8032,0,-2953,0,0,0,,2953,-2953
46,11/13/2017,81,20:00,20:15,38.61,43.31,0,38.61,38.61,1,-71257,73944,145201,2687,0,-158,431,0,0,,589,273
46,11/13/2017,82,20:15,20:30,38.53,49.33,0,42.59,42.59,2,-60288,57917,118205,-2371,0,-176,343,0,0,,519,167
46,11/13/2017,83,20:30,20:45,40.3,34.51,0,42.58,34.51,2,-55114,59213,114327,4099,0,-676,2470,0,0,,3146,1794
46,11/13/2017,84,20:45,21:00,,19.06,0,19.06,19.06,-1,-36002,79576,115578,43574,0,-35661,0,0,0,,35661,-35661
46,11/13/2017,85,21:00,21:15,64.51,19.06,0,64.51,64.51,1,-65889,55833,121722,-10056,0,-20543,1922,0,0,,22465,-18621
46,11/13/2017,86,21:15,21:30,77.02,,0,77.02,77.02,1,-54036,47361,101397,-6675,0,0,6529,0,0,,6529,6529
46,11/13/2017,87,21:30,21:45,77.02,28.98,0,28.98,28.98,-1,-47057,70383,117440,23326,0,-8781,145,0,0,,8926,-8636
46,11/13/2017,88,21:45,22:00,,28.25,0,28.25,28.25,-1,-47316,91504,138820,44188,0,-36376,0,0,0,,36376,-36376
46,11/13/2017,89,22:00,22:15,258.71,14,0,258.71,14,2,-89656,43662,133318,-45994,0,-26641,3517,0,0,,30158,-23124
46,11/13/2017,90,22:15,22:30,330.35,7.02,0,330.35,7.02,2,-37759,52509,90268,14750,0,-3736,14775,0,0,,18511,11039
46,11/13/2017,91,22:30,22:45,,4.11,0,4.11,4.11,-1,-28137,75426,103563,47289,0,-33999,0,0,0,,33999,-33999
46,11/13/2017,92,22:45,23:00,,20.54,0,20.54,20.54,-1,-62598,107947,170545,45349,0,-27307,0,0,0,,27307,-27307
46,11/13/2017,93,23:00,23:15,251.01,6.08,0,251.01,6.08,2,-62204,25042,87246,-37162,0,-21265,5267,0,0,,26532,-15998
46,11/13/2017,94,23:15,23:30,409.27,31.73,0,409.27,31.73,2,-57334,26940,84274,-30394,0,-510,29288,0,0,,29798,28778
46,11/13/2017,95,23:30,23:45,409.27,2.65,0,2.65,2.65,-1,-30658,59215,89873,28557,0,-28142,412,0,0,,28554,-27730
46,11/13/2017,96,23:45,0:00,,22.43,0,22.43,22.43,-1,-39051,59336,98387,20285,0,-21288,0,0,0,,21288,-21288
46,11/14/2017,1,0:00,0:15,38.34,-46.89,0,40.82,-46.89,2,-33722,73075,106797,39353,0,-30086,193,0,0,,30279,-29893
46,11/14/2017,2,0:15,0:30,42.11,33.78,0,42.11,33.78,2,-25780,19691,45471,-6089,0,-2189,1051,0,0,,3240,-1138
46,11/14/2017,3,0:30,0:45,,33.78,0,33.78,33.78,-1,-37800,34867,72667,-2933,0,-5623,0,0,0,,5623,-5623
46,11/14/2017,4,0:45,1:00,,33.78,0,33.78,33.78,-1,-52738,68532,121270,15794,0,-9999,0,0,0,,9999,-9999
46,11/14/2017,5,1:00,1:15,,31.95,0,31.95,31.95,-1,-31389,25436,56825,-5953,0,-7133,0,0,0,,7133,-7133
46,11/14/2017,6,1:15,1:30,,15.28,0,15.28,15.28,-1,-19417,48518,67935,29101,0,-11054,0,0,0,,11054,-11054
46,11/14/2017,7,1:30,1:45,,5.45,0,5.45,5.45,-1,-14514,68371,82885,53857,0,-36596,0,0,0,,36596,-36596
46,11/14/2017,8,1:45,2:00,,-2.58,0,-2.58,-2.58,-1,-13307,76619,89926,63312,0,-60621,0,0,0,,60621,-60621
46,11/14/2017,9,2:00,2:15,83.69,20.78,0,83.69,83.69,1,-44309,38902,83211,-5407,0,-31228,2312,0,0,,33540,-28916
46,11/14/2017,10,2:15,2:30,83.69,-1.45,0,-1.45,-1.45,-1,-33183,80127,113310,46944,0,-25461,445,0,0,,25906,-25016
46,11/14/2017,11,2:30,2:45,,4.33,0,4.33,4.33,-1,-32741,104958,137699,72217,0,-67286,0,0,0,,67286,-67286
46,11/14/2017,12,2:45,3:00,,23.99,0,23.99,23.99,-1,-44196,90813,135009,46617,0,-55885,0,0,0,,55885,-55885
46,11/14/2017,13,3:00,3:15,42.11,30.78,0,42.11,42.11,1,-47137,51000,98137,3863,0,-21869,994,0,0,,22863,-20875
46,11/14/2017,14,3:15,3:30,42.11,-51.92,0,-51.92,-51.92,-1,-30080,80809,110889,50729,0,-18339,368,0,0,,18707,-17971
46,11/14/2017,15,3:30,3:45,,-46.79,0,-46.79,-46.79,-1,-57598,132226,189824,74628,0,-67216,0,0,0,,67216,-67216
46,11/14/2017,16,3:45,4:00,,-51.39,0,-51.39,-51.39,-1,-45341,125354,170695,80013,0,-80200,0,0,0,,80200,-80200
46,11/14/2017,17,4:00,4:15,,-7.78,0,-7.78,-7.78,-1,-56490,96253,152743,39763,0,-66789,0,0,0,,66789,-66789
46,11/14/2017,18,4:15,4:30,,-17.69,0,-17.69,-17.69,-1,-46866,74125,120991,27259,0,-26427,0,0,0,,26427,-26427
46,11/14/2017,19,4:30,4:45,,-62.84,0,-62.84,-62.84,-1,-67908,74229,142137,6321,0,-43847,0,0,0,,43847,-43847
46,11/14/2017,20,4:45,5:00,,10.49,0,10.49,10.49,-1,-57063,89094,146157,32031,0,-19462,0,0,0,,19462,-19462
46,11/14/2017,21,5:00,5:15,42.41,19.86,0,42.41,19.86,2,-58273,49672,107945,-8601,0,-9079,1706,0,0,,10785,-7373
46,11/14/2017,22,5:15,5:30,,9.91,0,9.91,9.91,-1,-64726,80908,145634,16182,0,-22013,0,0,0,,22013,-22013
46,11/14/2017,23,5:30,5:45,38.11,9.91,0,38.11,38.11,1,-67730,60341,128071,-7389,0,-3219,1209,0,0,,4428,-2010
46,11/14/2017,24,5:45,6:00,51.15,,0,51.15,51.15,1,-85836,42821,128657,-43015,0,0,18563,0,0,,18563,18563
46,11/14/2017,25,6:00,6:15,36.12,-38.37,0,40.89,-38.37,2,-37331,107861,145192,70530,0,-19527,8173,0,0,,27700,-11354
46,11/14/2017,26,6:15,6:30,,25.9,0,25.9,25.9,-1,-33966,57327,91293,23361,0,-26219,0,0,0,,26219,-26219
46,11/14/2017,27,6:30,6:45,,33.38,0,33.38,33.38,-1,-33690,53503,87193,19813,0,-12165,0,0,0,,12165,-12165
46,11/14/2017,28,6:45,7:00,,1.78,0,1.78,1.78,-1,-91161,76533,167694,-14628,0,-21815,0,0,0,,21815,-21815
46,11/14/2017,29,7:00,7:15,,17.38,0,17.38,17.38,-1,-73569,139213,212782,65644,0,-51311,0,0,0,,51311,-51311
46,11/14/2017,30,7:15,7:30,75.67,16.96,0,75.67,16.96,2,-96813,80998,177811,-15815,0,-36901,2979,0,0,,39880,-33922
46,11/14/2017,31,7:30,7:45,139.12,16.96,0,139.12,139.12,1,-111204,38719,149923,-72485,0,-152,39901,0,0,,40053,39749
46,11/14/2017,32,7:45,8:00,121.12,,0,121.12,121.12,1,-141830,49129,190959,-92701,0,0,63310,0,0,,63310,63310
46,11/14/2017,33,8:00,8:15,60.12,-36.58,0,60.12,-36.58,2,-73083,120228,193311,47145,0,-15278,24259,0,0,,39537,8981
46,11/14/2017,34,8:15,8:30,38.55,-36.58,0,38.55,38.55,1,-90947,86674,177621,-4273,0,-1052,707,0,0,,1759,-345
46,11/14/2017,35,8:30,8:45,60.12,47.44,0,60.12,42.46,2,-92121,72381,164502,-19740,0,-273,2940,0,0,,3213,2667
46,11/14/2017,36,8:45,9:00,79.12,,0,79.12,79.12,1,-112414,76568,188982,-35846,0,0,24031,0,0,,24031,24031
46,11/14/2017,37,9:00,9:15,79.12,20.94,0,20.94,20.94,-1,-81648,114050,195698,32402,0,-6828,7929,0,0,,14757,1101
46,11/14/2017,38,9:15,9:30,,34.57,0,34.57,34.57,-1,-79448,88431,167879,8983,0,-2957,0,0,0,,2957,-2957
46,11/14/2017,39,9:30,9:45,49.85,34.57,0,49.85,49.85,1,-154915,98691,253606,-56224,0,-260,5624,0,0,,5884,5364
46,11/14/2017,40,9:45,10:00,,,0,41.93,41.93,0,-166065,114686,280751,-51379,0,0,399,0,0,,399,399
46,11/14/2017,41,10:00,10:15,79.12,,0,79.12,79.12,1,-176255,101039,277294,-75216,0,0,7129,0,0,,7129,7129
46,11/14/2017,42,10:15,10:30,36.86,,0,36.86,36.86,1,-158037,127415,285452,-30622,0,0,2321,0,0,,2321,2321
46,11/14/2017,43,10:30,10:45,36.86,,0,36.86,36.86,1,-150484,145870,296354,-4614,0,0,328,0,0,,328,328
46,11/14/2017,44,10:45,11:00,36.27,,0,36.27,36.27,1,-154290,147304,301594,-6986,0,0,121,0,0,,121,121
46,11/14/2017,45,11:00,11:15,,,0,42.49,42.49,0,-168193,165955,334148,-2238,0,0,0,0,0,,0,0
46,11/14/2017,46,11:15,11:30,39.32,,0,39.32,39.32,1,-156974,160872,317846,3898,0,0,1297,0,0,,1297,1297
46,11/14/2017,47,11:30,11:45,40.39,,0,40.39,40.39,1,-157937,163672,321609,5735,0,0,3615,0,0,,3615,3615
46,11/14/2017,48,11:45,12:00,,,0,42.49,42.49,0,-164477,171975,336452,7498,0,0,29,0,0,,29,29
46,11/14/2017,49,12:00,12:15,67.11,,0,67.11,67.11,1,-167467,159102,326569,-8365,0,0,8961,0,0,,8961,8961
46,11/14/2017,50,12:15,12:30,67.11,,0,67.11,67.11,1,-166277,145337,311614,-20940,0,0,29328,0,0,,29328,29328
46,11/14/2017,51,12:30,12:45,60.61,,0,60.61,60.61,1,-153271,131936,285207,-21335,0,0,30599,0,0,,30599,30599
46,11/14/2017,52,12:45,13:00,105.12,,0,105.12,105.12,1,-158757,129240,287997,-29517,0,0,37318,0,0,,37318,37318
46,11/14/2017,53,13:00,13:15,62.12,31.55,0,62.12,31.55,2,-126304,140424,266728,14120,0,-3319,20018,0,0,,23337,16699
46,11/14/2017,54,13:15,13:30,49.12,31.55,0,49.12,49.12,1,-125862,108087,233949,-17775,0,-321,4701,0,0,,5022,4380
46,11/14/2017,55,13:30,13:45,57.12,,0,57.12,57.12,1,-129498,109851,239349,-19647,0,0,18763,0,0,,18763,18763
46,11/14/2017,56,13:45,14:00,40.72,,0,40.72,40.72,1,-120293,103609,223902,-16684,0,0,10555,0,0,,10555,10555
46,11/14/2017,57,14:00,14:15,39.12,1.29,0,39.12,1.29,2,-35728,103085,138813,67357,0,-19729,2985,0,0,,22714,-16744
46,11/14/2017,58,14:15,14:30,,30.78,0,30.78,30.78,-1,-57996,85970,143966,27974,0,-28849,0,0,0,,28849,-28849
46,11/14/2017,59,14:30,14:45,36.86,30.78,0,36.86,36.86,1,-63518,65084,128602,1566,0,-5899,447,0,0,,6346,-5452
46,11/14/2017,60,14:45,15:00,,,0,38.72,38.72,0,-70824,47408,118232,-23416,0,0,0,0,0,,0,0
46,11/14/2017,61,15:00,15:15,,-27.1,0,-27.1,-27.1,-1,-16053,100011,116064,83958,0,-29723,0,0,0,,29723,-29723
46,11/14/2017,62,15:15,15:30,,26.94,0,26.94,26.94,-1,-38011,71392,109403,33381,0,-42811,0,0,0,,42811,-42811
46,11/14/2017,63,15:30,15:45,39.35,44.2,0,39.35,39.35,1,-40848,38196,79044,-2652,0,-6142,986,0,0,,7128,-5156
46,11/14/2017,64,15:45,16:00,39.11,41.28,0,39.11,38.71,2,-45401,31564,76965,-13837,0,-15,4182,0,0,,4197,4167
46,11/14/2017,65,16:00,16:15,39.11,-3.78,0,-3.78,-3.78,-1,-25018,62548,87566,37530,0,-23387,593,0,0,,23980,-22794
46,11/14/2017,66,16:15,16:30,,34.38,0,34.38,34.38,-1,-20415,36271,56686,15856,0,-2739,0,0,0,,2739,-2739
46,11/14/2017,67,16:30,16:45,55,42.2,0,55,38.75,2,-43935,37305,81240,-6630,0,-4701,1535,0,0,,6236,-3166
46,11/14/2017,68,16:45,17:00,689.06,42.2,0,689.06,689.06,1,-83470,31879,115349,-51591,0,-2,44179,0,0,,44181,44177
46,11/14/2017,69,17:00,17:15,689.06,-6.37,0,-6.37,-6.37,-1,-25994,77413,103407,51419,0,-15001,20240,0,0,,35241,5239
46,11/14/2017,70,17:15,17:30,40.39,-6.37,0,40.39,40.39,1,-38989,48720,87709,9731,0,-2367,1046,0,0,,3413,-1321
46,11/14/2017,71,17:30,17:45,42.86,,0,42.86,42.86,1,-50884,57416,108300,6532,0,0,482,0,0,,482,482
46,11/14/2017,72,17:45,18:00,795.78,42.85,0,795.78,40.33,2,-50187,68805,118992,18618,0,-223,5124,0,0,,5347,4901
46,11/14/2017,73,18:00,18:15,906.67,12.48,0,906.67,12.48,2,-46431,49537,95968,3106,0,-1462,29472,0,0,,30934,28010
46,11/14/2017,74,18:15,18:30,36.3,-18.51,0,40.32,-18.51,2,-34717,60702,95419,25985,0,-24099,75,0,0,,24174,-24024
46,11/14/2017,75,18:30,18:45,36.45,28.01,0,40.32,28.01,2,-45077,76839,121916,31762,0,-3530,255,0,0,,3785,-3275
46,11/14/2017,76,18:45,19:00,,28.01,0,28.01,28.01,-1,-25760,69591,95351,43831,0,-18880,0,0,0,,18880,-18880
46,11/14/2017,77,19:00,19:15,44.56,39.43,0,44.56,24.31,2,-50859,37576,88435,-13283,0,-7531,1700,0,0,,9231,-5831
46,11/14/2017,78,19:15,19:30,,35.81,0,35.81,35.81,-1,-33434,42942,76376,9508,0,-1162,0,0,0,,1162,-1162
46,11/14/2017,79,19:30,19:45,,27.78,0,27.78,27.78,-1,-22816,60090,82906,37274,0,-22931,0,0,0,,22931,-22931
46,11/14/2017,80,19:45,20:00,,27.26,0,27.26,27.26,-1,-24972,66351,91323,41379,0,-32145,0,0,0,,32145,-32145
46,11/14/2017,81,20:00,20:15,42.55,27.26,0,42.55,42.55,1,-48924,28942,77866,-19982,0,-6441,2547,0,0,,8988,-3894
46,11/14/2017,82,20:15,20:30,,33.38,0,33.38,33.38,-1,-25825,40064,65889,14239,0,-5253,0,0,0,,5253,-5253
46,11/14/2017,83,20:30,20:45,,27.56,0,27.56,27.56,-1,-16990,70410,87400,53420,0,-38728,0,0,0,,38728,-38728
46,11/14/2017,84,20:45,21:00,,27.71,0,27.71,27.71,-1,-23670,97723,121393,74053,0,-46291,0,0,0,,46291,-46291
46,11/14/2017,85,21:00,21:15,52.41,40.21,0,52.41,39.79,2,-44944,46181,91125,1237,0,-13474,2812,0,0,,16286,-10662
46,11/14/2017,86,21:15,21:30,52.41,34.38,0,34.38,34.38,-1,-28310,46933,75243,18623,0,-3041,114,0,0,,3155,-2927
46,11/14/2017,87,21:30,21:45,,-2.09,0,-2.09,-2.09,-1,-18312,83143,101455,64831,0,-40061,0,0,0,,40061,-40061
46,11/14/2017,88,21:45,22:00,,1.43,0,1.43,1.43,-1,-27026,98524,125550,71498,0,-62520,0,0,0,,62520,-62520
46,11/14/2017,89,22:00,22:15,108.45,-58.76,0,108.45,-58.76,2,-64045,66196,130241,2151,0,-45666,2692,0,0,,48358,-42974
46,11/14/2017,90,22:15,22:30,134.25,17.54,0,134.25,17.54,2,-18515,36262,54777,17747,0,-2732,16105,0,0,,18837,13373
46,11/14/2017,91,22:30,22:45,,-11.41,0,-11.41,-11.41,-1,-5211,94627,99838,89416,0,-55127,0,0,0,,55127,-55127
46,11/14/2017,92,22:45,23:00,,-58.76,0,-58.76,-58.76,-1,-18700,127502,146202,108802,0,-95256,0,0,0,,95256,-95256
46,11/14/2017,93,23:00,23:15,,-9.78,0,-9.78,-9.78,-1,-67297,102905,170202,35608,0,-49980,0,0,0,,49980,-49980
46,11/14/2017,94,23:15,23:30,,-58.76,0,-58.76,-58.76,-1,-28314,108336,136650,80022,0,-27684,0,0,0,,27684,-27684
46,11/14/2017,95,23:30,23:45,,-36.09,0,-36.09,-36.09,-1,-43834,139848,183682,96014,0,-85280,0,0,0,,85280,-85280
46,11/14/2017,96,23:45,0:00,,-58.76,0,-58.76,-58.76,-1,-32969,171302,204271,138333,0,-106354,0,0,0,,106354,-106354
46,11/15/2017,1,0:00,0:15,,-52.01,0,-52.01,-52.01,-1,-73155,137011,210166,63856,0,-75803,0,0,0,,75803,-75803
46,11/15/2017,2,0:15,0:30,,-52.28,0,-52.28,-52.28,-1,-41335,133936,175271,92601,0,-46003,0,0,0,,46003,-46003
46,11/15/2017,3,0:30,0:45,,11.32,0,11.32,11.32,-1,-61500,123816,185316,62316,0,-70303,0,0,0,,70303,-70303
46,11/15/2017,4,0:45,1:00,,-35.35,0,-35.35,-35.35,-1,-50951,143691,194642,92740,0,-61714,0,0,0,,61714,-61714
46,11/15/2017,5,1:00,1:15,87.18,-58.73,0,87.18,87.18,1,-62111,61879,123990,-232,0,-48069,2594,0,0,,50663,-45475
46,11/15/2017,6,1:15,1:30,77.15,5.13,0,5.13,5.13,-1,-28786,72872,101658,44086,0,-12902,3561,0,0,,16463,-9341
46,11/15/2017,7,1:30,1:45,,-1.66,0,-1.66,-1.66,-1,-25972,78826,104798,52854,0,-52678,0,0,0,,52678,-52678
46,11/15/2017,8,1:45,2:00,,12.5,0,12.5,12.5,-1,-23864,95361,119225,71497,0,-62001,0,0,0,,62001,-62001
46,11/15/2017,9,2:00,2:15,37.7,14.49,0,37.7,37.7,1,-28791,49686,78477,20895,0,-37640,260,0,0,,37900,-37380
46,11/15/2017,10,2:15,2:30,36.77,5.74,0,5.74,5.74,-1,-29876,79956,109832,50080,0,-21783,87,0,0,,21870,-21696
46,11/15/2017,11,2:30,2:45,,-18.93,0,-18.93,-18.93,-1,-20897,100592,121489,79695,0,-59013,0,0,0,,59013,-59013
46,11/15/2017,12,2:45,3:00,,-31.68,0,-31.68,-31.68,-1,-35017,84655,119672,49638,0,-57819,0,0,0,,57819,-57819
46,11/15/2017,13,3:00,3:15,,15.11,0,15.11,15.11,-1,-30863,80184,111047,49321,0,-30313,0,0,0,,30313,-30313
46,11/15/2017,14,3:15,3:30,,21.42,0,21.42,21.42,-1,-25073,77350,102423,52277,0,-45598,0,0,0,,45598,-45598
46,11/15/2017,15,3:30,3:45,,28.53,0,28.53,28.53,-1,-32991,66866,99857,33875,0,-45204,0,0,0,,45204,-45204
46,11/15/2017,16,3:45,4:00,,6.42,0,6.42,6.42,-1,-28915,81379,110294,52464,0,-21094,0,0,0,,21094,-21094
46,11/15/2017,17,4:00,4:15,,2.38,0,2.38,2.38,-1,-31692,112961,144653,81269,0,-71816,0,0,0,,71816,-71816
46,11/15/2017,18,4:15,4:30,,7.44,0,7.44,7.44,-1,-29470,102370,131840,72900,0,-81859,0,0,0,,81859,-81859
46,11/15/2017,19,4:30,4:45,,27.08,0,27.08,27.08,-1,-40478,83272,123750,42794,0,-43766,0,0,0,,43766,-43766
46,11/15/2017,20,4:45,5:00,,29.96,0,29.96,29.96,-1,-40385,86034,126419,45649,0,-33159,0,0,0,,33159,-33159
46,11/15/2017,21,5:00,5:15,,9.28,0,9.28,9.28,-1,-29751,97678,127429,67927,0,-35760,0,0,0,,35760,-35760
46,11/15/2017,22,5:15,5:30,38.62,2.38,0,38.63,2.38,2,-53284,77779,131063,24495,0,-39440,531,0,0,,39971,-38909
46,11/15/2017,23,5:30,5:45,38.64,35.64,0,38.64,35.64,2,-29538,50997,80535,21459,0,-1906,772,0,0,,2678,-1134
46,11/15/2017,24,5:45,6:00,,35.64,0,35.64,35.64,-1,-41299,35840,77139,-5459,0,-1203,0,0,0,,1203,-1203
46,11/15/2017,25,6:00,6:15,,-39.53,0,-39.53,-39.53,-1,-35567,145621,181188,110054,0,-35358,0,0,0,,35358,-35358
46,11/15/2017,26,6:15,6:30,,23.88,0,23.88,23.88,-1,-28345,67509,95854,39164,0,-24583,0,0,0,,24583,-24583
46,11/15/2017,27,6:30,6:45,,13.99,0,13.99,13.99,-1,-37147,71069,108216,33922,0,-42083,0,0,0,,42083,-42083
46,11/15/2017,28,6:45,7:00,54.97,44.13,0,54.97,38.58,2,-79138,46410,125548,-32728,0,-4914,1724,0,0,,6638,-3190
46,11/15/2017,29,7:00,7:15,,-38.98,0,-38.98,-38.98,-1,-11032,122337,133369,111305,0,-45533,0,0,0,,45533,-45533
46,11/15/2017,30,7:15,7:30,35.3,31.85,0,35.3,35.3,1,-41186,57048,98234,15862,0,-23425,8,0,0,,23433,-23417
46,11/15/2017,31,7:30,7:45,64.54,31.85,0,64.54,64.54,1,-66719,43365,110084,-23354,0,-1,3161,0,0,,3162,3160
46,11/15/2017,32,7:45,8:00,502.06,,0,502.06,502.06,1,-84718,20555,105273,-64163,0,0,40209,0,0,,40209,40209
46,11/15/2017,33,8:00,8:15,502.06,-38.99,0,-38.99,-38.99,-1,-20281,156828,177109,136547,0,-34090,8603,0,0,,42693,-25487
46,11/15/2017,34,8:15,8:30,,-5.32,0,-5.32,-5.32,-1,-21505,106983,128488,85478,0,-72590,0,0,0,,72590,-72590
46,11/15/2017,35,8:30,8:45,,34.03,0,34.03,34.03,-1,-29115,70892,100007,41777,0,-31450,0,0,0,,31450,-31450
46,11/15/2017,36,8:45,9:00,,31.85,0,31.85,31.85,-1,-44433,67554,111987,23121,0,-25572,0,0,0,,25572,-25572
46,11/15/2017,37,9:00,9:15,,20.96,0,20.96,20.96,-1,-24494,76952,101446,52458,0,-31914,0,0,0,,31914,-31914
46,11/15/2017,38,9:15,9:30,42.85,42.9,0,42.85,40.82,2,-30129,24009,54138,-6120,0,-11802,2248,0,0,,14050,-9554
46,11/15/2017,39,9:30,9:45,42.85,36.85,0,36.85,36.85,-1,-38252,49991,88243,11739,0,-1302,30,0,0,,1332,-1272
46,11/15/2017,40,9:45,10:00,38.85,39.27,0,40.82,39.27,2,-51743,58664,110407,6921,0,-1339,57,0,0,,1396,-1282
46,11/15/2017,41,10:00,10:15,38.85,41.44,0,40.82,40.82,2,-44386,42386,86772,-2000,0,-723,209,0,0,,932,-514
46,11/15/2017,42,10:15,10:30,42.85,,0,42.85,42.85,1,-50169,38528,88697,-11641,0,0,1454,0,0,,1454,1454
46,11/15/2017,43,10:30,10:45,98.02,,0,98.02,98.02,1,-52075,28749,80824,-23326,0,0,22534,0,0,,22534,22534
46,11/15/2017,44,10:45,11:00,38.85,,0,38.85,38.85,1,-48353,39560,87913,-8793,0,0,7532,0,0,,7532,7532
46,11/15/2017,45,11:00,11:15,41.43,41.6,0,41.43,40.83,2,-41226,38888,80114,-2338,0,-323,769,0,0,,1092,446
46,11/15/2017,46,11:15,11:30,42.85,,0,42.85,42.85,1,-40408,29025,69433,-11383,0,0,7171,0,0,,7171,7171
46,11/15/2017,47,11:30,11:45,42.85,,0,42.85,42.85,1,-41842,26296,68138,-15546,0,0,12462,0,0,,12462,12462
46,11/15/2017,48,11:45,12:00,42.85,,0,42.85,42.85,1,-41433,24613,66046,-16820,0,0,19500,0,0,,19500,19500
46,11/15/2017,49,12:00,12:15,598.89,,0,598.89,598.89,1,-59812,18841,78653,-40971,0,0,33676,0,0,,33676,33676
46,11/15/2017,50,12:15,12:30,598.89,1.02,0,1.02,1.02,-1,-35117,66375,101492,31258,0,-14675,8361,0,0,,23036,-6314
46,11/15/2017,51,12:30,12:45,,44.21,0,44.21,44.21,-1,-36024,42132,78156,6108,0,-2024,0,0,0,,2024,-2024
46,11/15/2017,52,12:45,13:00,38.85,43.83,0,40.85,40.85,2,-44289,33717,78006,-10572,0,-230,508,0,0,,738,278
46,11/15/2017,53,13:00,13:15,38.85,31.11,0,31.11,31.11,-1,-37733,71911,109644,34178,0,-9859,34,0,0,,9893,-9825
46,11/15/2017,54,13:15,13:30,38.85,39.69,0,40.86,39.69,2,-52700,44565,97265,-8135,0,-4677,676,0,0,,5353,-4001
46,11/15/2017,55,13:30,13:45,38.85,39.69,0,38.85,38.85,1,-62753,50765,113518,-11988,0,-11,202,0,0,,213,191
46,11/15/2017,56,13:45,14:00,38.85,,0,38.85,38.85,1,-72224,50053,122277,-22171,0,0,823,0,0,,823,823
46,11/15/2017,57,14:00,14:15,40.07,44.24,0,40.86,40.86,2,-58963,52417,111380,-6546,0,-74,454,0,0,,528,380
46,11/15/2017,58,14:15,14:30,42.85,,0,42.85,42.85,1,-62028,45225,107253,-16803,0,0,3821,0,0,,3821,3821
46,11/15/2017,59,14:30,14:45,,,0,40.87,40.87,0,-59062,52993,112055,-6069,0,0,33,0,0,,33,33
46,11/15/2017,60,14:45,15:00,,,0,40.86,40.86,0,-55344,50631,105975,-4713,0,0,0,0,0,,0,0
46,11/15/2017,61,15:00,15:15,,31.1,0,31.1,31.1,-1,-50207,79484,129691,29277,0,-7171,0,0,0,,7171,-7171
46,11/15/2017,62,15:15,15:30,,23.07,0,23.07,23.07,-1,-44151,73685,117836,29534,0,-26824,0,0,0,,26824,-26824
46,11/15/2017,63,15:30,15:45,,37.49,0,37.49,37.49,-1,-48550,67374,115924,18824,0,-8879,0,0,0,,8879,-8879
46,11/15/2017,64,15:45,16:00,,36.85,0,36.85,36.85,-1,-54648,71525,126173,16877,0,-8322,0,0,0,,8322,-8322
46,11/15/2017,65,16:00,16:15,,18.15,0,18.15,18.15,-1,-46963,94206,141169,47243,0,-33191,0,0,0,,33191,-33191
46,11/15/2017,66,16:15,16:30,,36.03,0,36.03,36.03,-1,-42855,79403,122258,36548,0,-21467,0,0,0,,21467,-21467
46,11/15/2017,67,16:30,16:45,,40.37,0,40.37,40.37,-1,-43415,68209,111624,24794,0,-12371,0,0,0,,12371,-12371
46,11/15/2017,68,16:45,17:00,65.02,40.37,0,65.02,65.02,1,-64779,47917,112696,-16862,0,-793,10731,0,0,,11524,9938
46,11/15/2017,69,17:00,17:15,39.69,23.33,0,40.86,23.33,2,-41587,82867,124454,41280,0,-6607,7009,0,0,,13616,402
46,11/15/2017,70,17:15,17:30,40.21,23.33,0,40.21,40.21,1,-54130,55783,109913,1653,0,-193,257,0,0,,450,64
46,11/15/2017,71,17:30,17:45,40.4,,0,40.4,40.4,1,-53109,59963,113072,6854,0,0,1879,0,0,,1879,1879
46,11/15/2017,72,17:45,18:00,118.09,,0,118.09,118.09,1,-37115,72242,109357,35127,0,0,2904,0,0,,2904,2904
46,11/15/2017,73,18:00,18:15,264.01,36.85,0,264.01,36.85,2,-61815,36024,97839,-25791,0,-628,14945,0,0,,15573,14317
46,11/15/2017,74,18:15,18:30,264.01,20.3,0,20.3,20.3,-1,-28376,71403,99779,43027,0,-29410,11,0,0,,29421,-29399
46,11/15/2017,75,18:30,18:45,,23.1,0,23.1,23.1,-1,-22502,69005,91507,46503,0,-37625,0,0,0,,37625,-37625
46,11/15/2017,76,18:45,19:00,,19.68,0,19.68,19.68,-1,-25428,60899,86327,35471,0,-40340,0,0,0,,40340,-40340
46,11/15/2017,77,19:00,19:15,47.72,36.85,0,47.72,36.85,2,-32508,31137,63645,-1371,0,-11506,1442,0,0,,12948,-10064
46,11/15/2017,78,19:15,19:30,,36.62,0,36.62,36.62,-1,-29250,44482,73732,15232,0,-6907,0,0,0,,6907,-6907
46,11/15/2017,79,19:30,19:45,,31.85,0,31.85,31.85,-1,-12696,49675,62371,36979,0,-25181,0,0,0,,25181,-25181
46,11/15/2017,80,19:45,20:00,,17.03,0,17.03,17.03,-1,-12563,68782,81345,56219,0,-47522,0,0,0,,47522,-47522
46,11/15/2017,81,20:00,20:15,399.17,17.03,0,399.17,399.17,1,-66190,17685,83875,-48505,0,-13161,9948,0,0,,23109,-3213
46,11/15/2017,82,20:15,20:30,399.17,25.24,0,25.24,25.24,-1,-23646,55650,79296,32004,0,-3129,2321,0,0,,5450,-808
46,11/15/2017,83,20:30,20:45,,20.24,0,20.24,20.24,-1,-9379,66952,76331,57573,0,-24965,0,0,0,,24965,-24965
46,11/15/2017,84,20:45,21:00,,31.85,0,31.85,31.85,-1,-15337,64135,79472,48798,0,-29191,0,0,0,,29191,-29191
46,11/15/2017,85,21:00,21:15,,23.52,0,23.52,23.52,-1,-43066,94359,137425,51293,0,-22918,0,0,0,,22918,-22918
46,11/15/2017,86,21:15,21:30,,-3.8,0,-3.8,-3.8,-1,-35706,90754,126460,55048,0,-43640,0,0,0,,43640,-43640
46,11/15/2017,87,21:30,21:45,,7.66,0,7.66,7.66,-1,-46272,104693,150965,58421,0,-49907,0,0,0,,49907,-49907
46,11/15/2017,88,21:45,22:00,,25.1,0,25.1,25.1,-1,-50460,80174,130634,29714,0,-42683,0,0,0,,42683,-42683
46,11/15/2017,89,22:00,22:15,41.58,-0.14,0,41.58,-0.14,2,-71450,107100,178550,35650,0,-36301,113,0,0,,36414,-36188
46,11/15/2017,90,22:15,22:30,90.18,31.85,0,90.18,31.85,2,-56113,47901,104014,-8212,0,-3251,5523,0,0,,8774,2272
46,11/15/2017,91,22:30,22:45,,-26.21,0,-26.21,-26.21,-1,-27829,93175,121004,65346,0,-43866,0,0,0,,43866,-43866
46,11/15/2017,92,22:45,23:00,,-0.19,0,-0.19,-0.19,-1,-31642,113398,145040,81756,0,-69736,0,0,0,,69736,-69736
46,11/15/2017,93,23:00,23:15,119.06,1.31,0,119.06,119.06,1,-116121,104239,220360,-11882,0,-41330,2394,0,0,,43724,-38936
46,11/15/2017,94,23:15,23:30,139.57,22.6,0,139.57,22.6,2,-70030,75092,145122,5062,0,-3782,9321,0,0,,13103,5539
46,11/15/2017,95,23:30,23:45,,-28.14,0,-28.14,-28.14,-1,-17524,100289,117813,82765,0,-64783,0,0,0,,64783,-64783
46,11/15/2017,96,23:45,0:00,,-53.23,0,-53.23,-53.23,-1,-13141,138898,152039,125757,0,-93357,0,0,0,,93357,-93357
46,11/16/2017,1,0:00,0:15,40.28,-45.01,0,40.28,40.28,1,-54876,40771,95647,-14105,0,-54721,449,0,0,,55170,-54272
46,11/16/2017,2,0:15,0:30,36.18,32.86,0,38.71,32.86,2,-38281,42156,80437,3875,0,-421,2,0,0,,423,-419
46,11/16/2017,3,0:30,0:45,,25.87,0,25.87,25.87,-1,-21242,58555,79797,37313,0,-16299,0,0,0,,16299,-16299
46,11/16/2017,4,0:45,1:00,,3.25,0,3.25,3.25,-1,-21193,75411,96604,54218,0,-56023,0,0,0,,56023,-56023
46,11/16/2017,5,1:00,1:15,125.57,4.78,0,125.57,125.57,1,-54258,31517,85775,-22741,0,-34685,5960,0,0,,40645,-28725
46,11/16/2017,6,1:15,1:30,133.12,33.86,0,133.12,33.86,2,-37186,24399,61585,-12787,0,-64,24666,0,0,,24730,24602
46,11/16/2017,7,1:30,1:45,133.12,32.86,0,32.86,32.86,-1,-27622,44237,71859,16615,0,-2673,691,0,0,,3364,-1982
46,11/16/2017,8,1:45,2:00,,33.78,0,33.78,33.78,-1,-39229,57051,96280,17822,0,-6179,0,0,0,,6179,-6179
46,11/16/2017,9,2:00,2:15,37.97,33.86,0,38.69,33.86,2,-54784,46094,100878,-8690,0,-3799,416,0,0,,4215,-3383
46,11/16/2017,10,2:15,2:30,,33.86,0,33.86,33.86,-1,-42913,52618,95531,9705,0,-325,0,0,0,,325,-325
46,11/16/2017,11,2:30,2:45,,32.86,0,32.86,32.86,-1,-35055,53785,88840,18730,0,-2198,0,0,0,,2198,-2198
46,11/16/2017,12,2:45,3:00,,32.78,0,32.78,32.78,-1,-34854,65357,100211,30503,0,-22700,0,0,0,,22700,-22700
46,11/16/2017,13,3:00,3:15,90.61,31.78,0,90.61,90.61,1,-51232,21382,72614,-29850,0,-17096,5894,0,0,,22990,-11202
46,11/16/2017,14,3:15,3:30,37.97,34.58,0,34.58,34.58,-1,-57985,52587,110572,-5398,0,-288,5237,0,0,,5525,4949
46,11/16/2017,15,3:30,3:45,,34.63,0,34.63,34.63,-1,-60400,54118,114518,-6282,0,-678,0,0,0,,678,-678
46,11/16/2017,16,3:45,4:00,,32.86,0,32.86,32.86,-1,-51298,56641,107939,5343,0,-3234,0,0,0,,3234,-3234
46,11/16/2017,17,4:00,4:15,33.12,32.86,0,33.12,33.12,1,-71842,49814,121656,-22028,0,-4727,36,0,0,,4763,-4691
46,11/16/2017,18,4:15,4:30,33.12,,0,33.12,33.12,1,-86541,47444,133985,-39097,0,0,37,0,0,,37,37
46,11/16/2017,19,4:30,4:45,,,0,38.7,38.7,0,-89229,37049,126278,-52180,0,0,0,0,0,,0,0
46,11/16/2017,20,4:45,5:00,33.12,,0,33.12,33.12,1,-87582,44244,131826,-43338,0,0,65,0,0,,65,65
46,11/16/2017,21,5:00,5:15,,,0,38.72,38.72,0,-62562,44975,107537,-17587,0,0,0,0,0,,0,0
46,11/16/2017,22,5:15,5:30,,33.86,0,33.86,33.86,-1,-36326,42042,78368,5716,0,-1881,0,0,0,,1881,-1881
46,11/16/2017,23,5:30,5:45,38.51,35.58,0,38.7,35.58,2,-47939,32036,79975,-15903,0,-1416,377,0,0,,1793,-1039
46,11/16/2017,24,5:45,6:00,45.03,35.58,0,45.03,45.03,1,-59172,19175,78347,-39997,0,-7,2096,0,0,,2103,2089
46,11/16/2017,25,6:00,6:15,35.23,13.78,0,39.69,13.78,2,-45398,73343,118741,27945,0,-9978,134,0,0,,10112,-9844
46,11/16/2017,26,6:15,6:30,,34.31,0,34.31,34.31,-1,-71861,54624,126485,-17237,0,-5410,0,0,0,,5410,-5410
46,11/16/2017,27,6:30,6:45,42.66,,0,42.66,42.66,1,-82850,28750,111600,-54100,0,0,472,0,0,,472,472
46,11/16/2017,28,6:45,7:00,401.14,,0,401.14,401.14,1,-165359,18927,184286,-146432,0,0,40752,0,0,,40752,40752
46,11/16/2017,29,7:00,7:15,401.14,-59.1,0,-59.1,-59.1,-1,-68162,197692,265854,129530,0,-35490,17107,0,0,,52597,-18383
46,11/16/2017,30,7:15,7:30,55.07,11.45,0,55.07,55.07,1,-80199,74325,154524,-5874,0,-27428,844,0,0,,28272,-26584
46,11/16/2017,31,7:30,7:45,132.66,11.45,0,132.66,132.66,1,-133993,40588,174581,-93405,0,-344,43112,0,0,,43456,42768
46,11/16/2017,32,7:45,8:00,132.66,,0,132.66,132.66,1,-134802,34937,169739,-99865,0,0,75093,0,0,,75093,75093
46,11/16/2017,33,8:00,8:15,43.33,,0,43.33,43.33,1,-128320,95403,223723,-32917,0,0,30984,0,0,,30984,30984
46,11/16/2017,34,8:15,8:30,90.12,,0,90.12,90.12,1,-121045,67557,188602,-53488,0,0,12129,0,0,,12129,12129
46,11/16/2017,35,8:30,8:45,441,,0,441,441,1,-122047,46040,168087,-76007,0,0,39537,0,0,,39537,39537
46,11/16/2017,36,8:45,9:00,441,,0,441,441,1,-140362,71104,211466,-69258,0,0,58683,0,0,,58683,58683
46,11/16/2017,37,9:00,9:15,467.86,,0,467.86,467.86,1,-155860,69379,225239,-86481,0,0,55643,0,0,,55643,55643
46,11/16/2017,38,9:15,9:30,120.12,,0,120.12,120.12,1,-120702,74928,195630,-45774,0,0,38838,0,0,,38838,38838
46,11/16/2017,39,9:30,9:45,467.86,,0,467.86,467.86,1,-125826,58523,184349,-67303,0,0,18408,0,0,,18408,18408
46,11/16/2017,40,9:45,10:00,45.64,,0,45.64,45.64,1,-125578,64553,190131,-61025,0,0,22937,0,0,,22937,22937
46,11/16/2017,41,10:00,10:15,36.85,,0,36.85,36.85,1,-94473,73184,167657,-21289,0,0,7664,0,0,,7664,7664
46,11/16/2017,42,10:15,10:30,58.87,,0,58.87,58.87,1,-111990,72553,184543,-39437,0,0,12378,0,0,,12378,12378
46,11/16/2017,43,10:30,10:45,41.81,,0,41.81,41.81,1,-116998,71109,188107,-45889,0,0,15342,0,0,,15342,15342
46,11/16/2017,44,10:45,11:00,41.81,,0,41.81,41.81,1,-120653,65830,186483,-54823,0,0,16299,0,0,,16299,16299
46,11/16/2017,45,11:00,11:15,110.12,,0,110.12,110.12,1,-134106,59035,193141,-75071,0,0,16941,0,0,,16941,16941
46,11/16/2017,46,11:15,11:30,62.4,,0,62.4,62.4,1,-147045,55387,202432,-91658,0,0,34509,0,0,,34509,34509
46,11/16/2017,47,11:30,11:45,345.37,,0,345.37,345.37,1,-135057,63883,198940,-71174,0,0,56792,0,0,,56792,56792
46,11/16/2017,48,11:45,12:00,270.47,,0,270.47,270.47,1,-133112,74236,207348,-58876,0,0,51712,0,0,,51712,51712
46,11/16/2017,49,12:00,12:15,76.12,,0,76.12,76.12,1,-125485,97721,223206,-27764,0,0,32177,0,0,,32177,32177
46,11/16/2017,50,12:15,12:30,71.12,,0,71.12,71.12,1,-128786,79841,208627,-48945,0,0,27384,0,0,,27384,27384
46,11/16/2017,51,12:30,12:45,301.72,,0,301.72,301.72,1,-122693,76409,199102,-46284,0,0,36021,0,0,,36021,36021
46,11/16/2017,52,12:45,13:00,66.12,,0,66.12,66.12,1,-105925,105728,211653,-197,0,0,29318,0,0,,29318,29318
46,11/16/2017,53,13:00,13:15,454.78,,0,454.78,454.78,1,-128491,71484,199975,-57007,0,0,15938,0,0,,15938,15938
46,11/16/2017,54,13:15,13:30,57.12,,0,57.12,57.12,1,-121232,86710,207942,-34522,0,0,23388,0,0,,23388,23388
46,11/16/2017,55,13:30,13:45,40.28,,0,40.28,40.28,1,-111807,75196,187003,-36611,0,0,11325,0,0,,11325,11325
46,11/16/2017,56,13:45,14:00,45.57,,0,45.57,45.57,1,-111526,51079,162605,-60447,0,0,19591,0,0,,19591,19591
46,11/16/2017,57,14:00,14:15,43.01,41.96,0,43.01,40.24,2,-80829,95621,176450,14792,0,-75,17956,0,0,,18031,17881
46,11/16/2017,58,14:15,14:30,43.01,32.93,0,32.93,32.93,-1,-73866,90011,163877,16145,0,-2780,942,0,0,,3722,-1838
46,11/16/2017,59,14:30,14:45,41.81,32.93,0,41.81,41.81,1,-79092,77855,156947,-1237,0,-61,4671,0,0,,4732,4610
46,11/16/2017,60,14:45,15:00,41.81,,0,41.81,41.81,1,-89383,81821,171204,-7562,0,0,6473,0,0,,6473,6473
46,11/16/2017,61,15:00,15:15,65.2,,0,65.2,65.2,1,-97142,60997,158139,-36145,0,0,20742,0,0,,20742,20742
46,11/16/2017,62,15:15,15:30,58.7,,0,58.7,58.7,1,-86683,65954,152637,-20729,0,0,9997,0,0,,9997,9997
46,11/16/2017,63,15:30,15:45,250.1,,0,250.1,250.1,1,-93471,68963,162434,-24508,0,0,29795,0,0,,29795,29795
46,11/16/2017,64,15:45,16:00,37.81,42.37,0,40.24,40.24,2,-86932,74786,161718,-12146,0,-252,7098,0,0,,7350,6846
46,11/16/2017,65,16:00,16:15,,5.27,0,5.27,5.27,-1,-75141,139410,214551,64269,0,-29329,0,0,0,,29329,-29329
46,11/16/2017,66,16:15,16:30,,20.23,0,20.23,20.23,-1,-67776,132805,200581,65029,0,-37445,0,0,0,,37445,-37445
46,11/16/2017,67,16:30,16:45,,32.93,0,32.93,32.93,-1,-82637,124229,206866,41592,0,-32719,0,0,0,,32719,-32719
46,11/16/2017,68,16:45,17:00,41.81,32.93,0,41.81,41.81,1,-111209,132033,243242,20824,0,-9270,1878,0,0,,11148,-7392
46,11/16/2017,69,17:00,17:15,36.12,-12.05,0,40.3,-12.05,2,-54827,126349,181176,71522,0,-27074,117,0,0,,27191,-26957
46,11/16/2017,70,17:15,17:30,,18.48,0,18.48,18.48,-1,-55100,99491,154591,44391,0,-30376,0,0,0,,30376,-30376
46,11/16/2017,71,17:30,17:45,,25.23,0,25.23,25.23,-1,-49105,101145,150250,52040,0,-43989,0,0,0,,43989,-43989
46,11/16/2017,72,17:45,18:00,,18.21,0,18.21,18.21,-1,-51632,115932,167564,64300,0,-53182,0,0,0,,53182,-53182
46,11/16/2017,73,18:00,18:15,347.63,18.21,0,347.63,347.63,1,-99138,41362,140500,-57776,0,-16236,8081,0,0,,24317,-8155
46,11/16/2017,74,18:15,18:30,347.63,20.27,0,20.27,20.27,-1,-67396,102189,169585,34793,0,-16088,1737,0,0,,17825,-14351
46,11/16/2017,75,18:30,18:45,,32.93,0,32.93,32.93,-1,-47272,76813,124085,29541,0,-22607,0,0,0,,22607,-22607
46,11/16/2017,76,18:45,19:00,,33.93,0,33.93,33.93,-1,-44841,62192,107033,17351,0,-26063,0,0,0,,26063,-26063
46,11/16/2017,77,19:00,19:15,128.12,44,0,128.12,39.76,2,-72413,44288,116701,-28125,0,-8481,16478,0,0,,24959,7997
46,11/16/2017,78,19:15,19:30,42.72,35.27,0,35.27,35.27,-1,-59457,55641,115098,-3816,0,-58,22515,0,0,,22573,22457
46,11/16/2017,79,19:30,19:45,35.05,34.78,0,39.76,34.78,2,-55130,67076,122206,11946,0,-827,637,0,0,,1464,-190
46,11/16/2017,80,19:45,20:00,,28.93,0,28.93,28.93,-1,-47135,74660,121795,27525,0,-11272,0,0,0,,11272,-11272
46,11/16/2017,81,20:00,20:15,69.6,33.93,0,69.6,69.6,1,-71601,52325,123926,-19276,0,-7306,8874,0,0,,16180,1568
46,11/16/2017,82,20:15,20:30,41.33,33.93,0,41.33,41.33,1,-87601,60386,147987,-27215,0,-24,20192,0,0,,20216,20168
46,11/16/2017,83,20:30,20:45,37.81,,0,37.81,37.81,1,-80760,73220,153980,-7540,0,0,10767,0,0,,10767,10767
46,11/16/2017,84,20:45,21:00,37.81,28.93,0,28.93,28.93,-1,-47686,75644,123330,27958,0,-12158,102,0,0,,12260,-12056
46,11/16/2017,85,21:00,21:15,47.81,44.32,0,47.81,38.72,2,-77946,40619,118565,-37327,0,-3807,3043,0,0,,6850,-764
46,11/16/2017,86,21:15,21:30,35.51,,0,35.51,35.51,1,-62185,53041,115226,-9144,0,0,522,0,0,,522,522
46,11/16/2017,87,21:30,21:45,,29.18,0,29.18,29.18,-1,-43222,64067,107289,20845,0,-8216,0,0,0,,8216,-8216
46,11/16/2017,88,21:45,22:00,,33.78,0,33.78,33.78,-1,-56166,63898,120064,7732,0,-11528,0,0,0,,11528,-11528
46,11/16/2017,89,22:00,22:15,37.81,32.93,0,38.72,32.93,2,-103501,109775,213276,6274,0,-12474,359,0,0,,12833,-12115
46,11/16/2017,90,22:15,22:30,47.81,33.7,0,47.81,33.7,2,-61975,75385,137360,13410,0,-2649,2814,0,0,,5463,165
46,11/16/2017,91,22:30,22:45,,13.25,0,13.25,13.25,-1,-27809,74858,102667,47049,0,-25535,0,0,0,,25535,-25535
46,11/16/2017,92,22:45,23:00,,13.78,0,13.78,13.78,-1,-49285,79647,128932,30362,0,-39006,0,0,0,,39006,-39006
46,11/16/2017,93,23:00,23:15,43.33,-16.64,0,43.33,-16.64,2,-53318,95939,149257,42621,0,-26109,637,0,0,,26746,-25472
46,11/16/2017,94,23:15,23:30,72,14.71,0,72,14.71,2,-38353,50221,88574,11868,0,-1533,6037,0,0,,7570,4504
46,11/16/2017,95,23:30,23:45,,-34.75,0,-34.75,-34.75,-1,-37343,69896,107239,32553,0,-24394,0,0,0,,24394,-24394
46,11/16/2017,96,23:45,0:00,,13.28,0,13.28,13.28,-1,-31267,76485,107752,45218,0,-11914,0,0,0,,11914,-11914
46,11/17/2017,1,0:00,0:15,133.02,13.28,0,133.02,133.02,1,-97960,48970,146930,-48990,0,-3798,16989,0,0,,20787,13191
46,11/17/2017,2,0:15,0:30,36.02,32.01,0,32.01,32.01,-1,-30328,48666,78994,18338,0,-2334,3612,0,0,,5946,1278
46,11/17/2017,3,0:30,0:45,,29.68,0,29.68,29.68,-1,-33282,39598,72880,6316,0,-5437,0,0,0,,5437,-5437
46,11/17/2017,4,0:45,1:00,,28.01,0,28.01,28.01,-1,-24193,58007,82200,33814,0,-19469,0,0,0,,19469,-19469
46,11/17/2017,5,1:00,1:15,128.02,28.01,0,128.02,128.02,1,-60224,11736,71960,-48488,0,-7744,19696,0,0,,27440,11952
46,11/17/2017,6,1:15,1:30,41.07,33.01,0,41.07,33.01,2,-23740,24181,47921,441,0,-424,9771,0,0,,10195,9347
46,11/17/2017,7,1:30,1:45,41.07,,0,41.07,41.07,1,-28480,23099,51579,-5381,0,0,3478,0,0,,3478,3478
46,11/17/2017,8,1:45,2:00,35.44,24.91,0,24.91,24.91,-1,-20498,41611,62109,21113,0,-3938,1533,0,0,,5471,-2405
46,11/17/2017,9,2:00,2:15,,9.5,0,9.5,9.5,-1,-33093,48710,81803,15617,0,-17840,0,0,0,,17840,-17840
46,11/17/2017,10,2:15,2:30,,32.01,0,32.01,32.01,-1,-22350,31712,54062,9362,0,-13693,0,0,0,,13693,-13693
46,11/17/2017,11,2:30,2:45,,32.84,0,32.84,32.84,-1,-24585,42714,67299,18129,0,-16188,0,0,0,,16188,-16188
46,11/17/2017,12,2:45,3:00,,33.01,0,33.01,33.01,-1,-26551,42375,68926,15824,0,-10429,0,0,0,,10429,-10429
46,11/17/2017,13,3:00,3:15,,32.01,0,32.01,32.01,-1,-46016,54680,100696,8664,0,-3378,0,0,0,,3378,-3378
46,11/17/2017,14,3:15,3:30,,30.19,0,30.19,30.19,-1,-29604,57596,87200,27992,0,-21608,0,0,0,,21608,-21608
46,11/17/2017,15,3:30,3:45,41.41,31.51,0,41.41,41.41,1,-42507,37052,79559,-5455,0,-19190,1438,0,0,,20628,-17752
46,11/17/2017,16,3:45,4:00,,,0,39.68,39.68,0,-45917,44302,90219,-1615,0,-364,1123,0,0,,1487,759
46,11/17/2017,17,4:00,4:15,,31.55,0,31.55,31.55,-1,-38736,48253,86989,9517,0,-4095,0,0,0,,4095,-4095
46,11/17/2017,18,4:15,4:30,,32.01,0,32.01,32.01,-1,-29727,50420,80147,20693,0,-19707,0,0,0,,19707,-19707
46,11/17/2017,19,4:30,4:45,,33.01,0,33.01,33.01,-1,-39418,54444,93862,15026,0,-14438,0,0,0,,14438,-14438
46,11/17/2017,20,4:45,5:00,38.94,36.53,0,38.94,36.53,2,-50162,41431,91593,-8731,0,-4948,1785,0,0,,6733,-3163
46,11/17/2017,21,5:00,5:15,,32.01,0,32.01,32.01,-1,-35576,41198,76774,5622,0,-2944,0,0,0,,2944,-2944
46,11/17/2017,22,5:15,5:30,,28.92,0,28.92,28.92,-1,-30952,49902,80854,18950,0,-9979,0,0,0,,9979,-9979
46,11/17/2017,23,5:30,5:45,41.07,32.03,0,41.07,41.07,1,-35655,33017,68672,-2638,0,-12490,368,0,0,,12858,-12122
46,11/17/2017,24,5:45,6:00,47.07,32.03,0,47.07,47.07,1,-53029,16467,69496,-36562,0,-544,1737,0,0,,2281,1193
46,11/17/2017,25,6:00,6:15,47.07,28.99,0,28.99,28.99,-1,-77138,82766,159904,5628,0,-4138,3,0,0,,4141,-4135
46,11/17/2017,26,6:15,6:30,40.21,43.95,0,40.21,40.21,1,-90719,68044,158763,-22675,0,-1117,591,0,0,,1708,-526
46,11/17/2017,27,6:30,6:45,419.3,,0,419.3,419.3,1,-122245,34201,156446,-88044,0,0,19635,0,0,,19635,19635
46,11/17/2017,28,6:45,7:00,419.3,,0,419.3,419.3,1,-164875,29420,194295,-135455,0,0,73446,0,0,,73446,73446
46,11/17/2017,29,7:00,7:15,419.3,29.26,0,29.26,29.26,-1,-179698,185739,365437,6041,0,-1459,26543,0,0,,28002,25084
46,11/17/2017,30,7:15,7:30,472.45,,0,472.45,472.45,1,-174058,82926,256984,-91132,0,0,21538,0,0,,21538,21538
46,11/17/2017,31,7:30,7:45,472.45,,0,472.45,472.45,1,-187449,86543,273992,-100906,0,0,68261,0,0,,68261,68261
46,11/17/2017,32,7:45,8:00,472.45,,0,472.45,472.45,1,-198376,99959,298335,-98417,0,0,58719,0,0,,58719,58719
46,11/17/2017,33,8:00,8:15,53.02,39.35,0,53.02,38.62,2,-138902,125188,264090,-13714,0,-372,18578,0,0,,18950,18206
46,11/17/2017,34,8:15,8:30,521.42,,0,521.42,521.42,1,-139931,101772,241703,-38159,0,0,28638,0,0,,28638,28638
46,11/17/2017,35,8:30,8:45,76.87,,0,76.87,76.87,1,-139469,110426,249895,-29043,0,0,12629,0,0,,12629,12629
46,11/17/2017,36,8:45,9:00,361.37,,0,361.37,361.37,1,-154308,100056,254364,-54252,0,0,38180,0,0,,38180,38180
46,11/17/2017,37,9:00,9:15,43,41.76,0,43,40.12,2,-123213,95587,218800,-27626,0,-162,17662,0,0,,17824,17500
46,11/17/2017,38,9:15,9:30,79,,0,79,79,1,-120295,61847,182142,-58448,0,0,22040,0,0,,22040,22040
46,11/17/2017,39,9:30,9:45,42.69,,0,42.69,42.69,1,-119589,74067,193656,-45522,0,0,6331,0,0,,6331,6331
46,11/17/2017,40,9:45,10:00,37.55,,0,37.55,37.55,1,-113243,80481,193724,-32762,0,0,1077,0,0,,1077,1077
46,11/17/2017,41,10:00,10:15,37.55,,0,37.55,37.55,1,-80790,88642,169432,7852,0,0,872,0,0,,872,872
46,11/17/2017,42,10:15,10:30,,34.03,0,34.03,34.03,-1,-94184,91777,185961,-2407,0,-2703,0,0,0,,2703,-2703
46,11/17/2017,43,10:30,10:45,,32.69,0,32.69,32.69,-1,-86210,94698,180908,8488,0,-8934,0,0,0,,8934,-8934
46,11/17/2017,44,10:45,11:00,,34.03,0,34.03,34.03,-1,-84447,95389,179836,10942,0,-14096,0,0,0,,14096,-14096
46,11/17/2017,45,11:00,11:15,,33.69,0,33.69,33.69,-1,-83526,107860,191386,24334,0,-7561,0,0,0,,7561,-7561
46,11/17/2017,46,11:15,11:30,,32.69,0,32.69,32.69,-1,-91210,99678,190888,8468,0,-13142,0,0,0,,13142,-13142
46,11/17/2017,47,11:30,11:45,,17.85,0,17.85,17.85,-1,-78029,128033,206062,50004,0,-16094,0,0,0,,16094,-16094
46,11/17/2017,48,11:45,12:00,,28.62,0,28.62,28.62,-1,-75624,126955,202579,51331,0,-35422,0,0,0,,35422,-35422
46,11/17/2017,49,12:00,12:15,,31.3,0,31.3,31.3,-1,-87183,100857,188040,13674,0,-19138,0,0,0,,19138,-19138
46,11/17/2017,50,12:15,12:30,,29.89,0,29.89,29.89,-1,-66439,115635,182074,49196,0,-4763,0,0,0,,4763,-4763
46,11/17/2017,51,12:30,12:45,,10.03,0,10.03,10.03,-1,-47588,138594,186182,91006,0,-34598,0,0,0,,34598,-34598
46,11/17/2017,52,12:45,13:00,,33.69,0,33.69,33.69,-1,-42892,101079,143971,58187,0,-17598,0,0,0,,17598,-17598
46,11/17/2017,53,13:00,13:15,,34.03,0,34.03,34.03,-1,-46214,84736,130950,38522,0,-11751,0,0,0,,11751,-11751
46,11/17/2017,54,13:15,13:30,,33.69,0,33.69,33.69,-1,-48081,83726,131807,35645,0,-3068,0,0,0,,3068,-3068
46,11/17/2017,55,13:30,13:45,,34.03,0,34.03,34.03,-1,-51100,69724,120824,18624,0,-2155,0,0,0,,2155,-2155
46,11/17/2017,56,13:45,14:00,,33.69,0,33.69,33.69,-1,-57457,71246,128703,13789,0,-8336,0,0,0,,8336,-8336
46,11/17/2017,57,14:00,14:15,,,0,40.16,40.16,0,-84330,62644,146974,-21686,0,-2076,0,0,0,,2076,-2076
46,11/17/2017,58,14:15,14:30,36.09,,0,36.09,36.09,1,-91311,66528,157839,-24783,0,0,160,0,0,,160,160
46,11/17/2017,59,14:30,14:45,,,0,40.16,40.16,0,-89718,56935,146653,-32783,0,0,0,0,0,,0,0
46,11/17/2017,60,14:45,15:00,,43.74,0,43.74,43.74,-1,-96621,42804,139425,-53817,0,-7,0,0,0,,7,-7
46,11/17/2017,61,15:00,15:15,41.55,30.85,0,41.55,30.85,2,-83755,74916,158671,-8839,0,-5594,844,0,0,,6438,-4750
46,11/17/2017,62,15:15,15:30,41.55,28.5,0,28.5,28.5,-1,-59168,78369,137537,19201,0,-5139,1565,0,0,,6704,-3574
46,11/17/2017,63,15:30,15:45,,27.03,0,27.03,27.03,-1,-50303,65485,115788,15182,0,-12848,0,0,0,,12848,-12848
46,11/17/2017,64,15:45,16:00,,28.69,0,28.69,28.69,-1,-46158,77187,123345,31029,0,-20185,0,0,0,,20185,-20185
46,11/17/2017,65,16:00,16:15,,23.65,0,23.65,23.65,-1,-42672,79629,122301,36957,0,-35186,0,0,0,,35186,-35186
46,11/17/2017,66,16:15,16:30,,28.88,0,28.88,28.88,-1,-37885,78990,116875,41105,0,-33589,0,0,0,,33589,-33589
46,11/17/2017,67,16:30,16:45,,31.13,0,31.13,31.13,-1,-31011,65847,96858,34836,0,-35010,0,0,0,,35010,-35010
46,11/17/2017,68,16:45,17:00,373.38,31.13,0,373.38,373.38,1,-83608,54764,138372,-28844,0,-9953,7105,0,0,,17058,-2848
46,11/17/2017,69,17:00,17:15,276.8,28.71,0,276.8,28.71,2,-82913,89523,172436,6610,0,-2709,8007,0,0,,10716,5298
46,11/17/2017,70,17:15,17:30,65.66,28.71,0,65.66,65.66,1,-83395,69421,152816,-13974,0,-11,10247,0,0,,10258,10236
46,11/17/2017,71,17:30,17:45,103.02,39.86,0,103.02,39.58,2,-71031,56411,127442,-14620,0,-302,4263,0,0,,4565,3961
46,11/17/2017,72,17:45,18:00,128.02,32.69,0,128.02,32.69,2,-72416,82384,154800,9968,0,-2830,9328,0,0,,12158,6498
46,11/17/2017,73,18:00,18:15,,-2.03,0,-2.03,-2.03,-1,-52253,94655,146908,42402,0,-42073,0,0,0,,42073,-42073
46,11/17/2017,74,18:15,18:30,36.22,5.54,0,39.61,5.54,2,-55685,99362,155047,43677,0,-16459,395,0,0,,16854,-16064
46,11/17/2017,75,18:30,18:45,47.55,-61.64,0,47.55,-61.64,2,-69757,86384,156141,16627,0,-39569,621,0,0,,40190,-38948
46,11/17/2017,76,18:45,19:00,71.34,24.54,0,71.34,24.54,2,-89148,105236,194384,16088,0,-3956,8787,0,0,,12743,4831
46,11/17/2017,77,19:00,19:15,126.67,10.25,0,126.67,10.25,2,-52016,15436,67452,-36580,0,-9803,7723,0,0,,17526,-2080
46,11/17/2017,78,19:15,19:30,126.54,32.69,0,32.69,32.69,-1,-53244,55296,108540,2052,0,-357,20887,0,0,,21244,20530
46,11/17/2017,79,19:30,19:45,45.91,-0.71,0,45.91,-0.71,2,-73417,75540,148957,2123,0,-19786,624,0,0,,20410,-19162
46,11/17/2017,80,19:45,20:00,55.3,32.69,0,55.3,32.69,2,-94134,86017,180151,-8117,0,-2048,7963,0,0,,10011,5915
46,11/17/2017,81,20:00,20:15,231.9,16.03,0,231.9,16.03,2,-97405,46271,143676,-51134,0,-6469,11755,0,0,,18224,5286
46,11/17/2017,82,20:15,20:30,231.9,32.46,0,231.9,32.46,2,-49200,42734,91934,-6466,0,-600,18316,0,0,,18916,17716
46,11/17/2017,83,20:30,20:45,,-13.13,0,-13.13,-13.13,-1,-31279,74470,105749,43191,0,-24118,0,0,0,,24118,-24118
46,11/17/2017,84,20:45,21:00,,26.77,0,26.77,26.77,-1,-27554,58928,86482,31374,0,-41223,0,0,0,,41223,-41223
46,11/17/2017,85,21:00,21:15,118.02,2.03,0,118.02,2.03,2,-109435,92315,201750,-17120,0,-21257,3016,0,0,,24273,-18241
46,11/17/2017,86,21:15,21:30,372.87,2.03,0,372.87,372.87,1,-80199,54772,134971,-25427,0,-84,23718,0,0,,23802,23634
46,11/17/2017,87,21:30,21:45,372.87,32.46,0,32.46,32.46,-1,-64170,107834,172004,43664,0,-501,1956,0,0,,2457,1455
46,11/17/2017,88,21:45,22:00,,32.46,0,32.46,32.46,-1,-60461,77254,137715,16793,0,-1036,0,0,0,,1036,-1036
46,11/17/2017,89,22:00,22:15,,30.94,0,30.94,30.94,-1,-65587,77979,143566,12392,0,-540,0,0,0,,540,-540
46,11/17/2017,90,22:15,22:30,34.96,,0,34.96,34.96,1,-55488,28182,83670,-27306,0,0,149,0,0,,149,149
46,11/17/2017,91,22:30,22:45,,32.46,0,32.46,32.46,-1,-34575,76656,111231,42081,0,-309,0,0,0,,309,-309
46,11/17/2017,92,22:45,23:00,,16.04,0,16.04,16.04,-1,-23878,72811,96689,48933,0,-10384,0,0,0,,10384,-10384
46,11/17/2017,93,23:00,23:15,36.3,10.03,0,39.1,10.03,2,-50724,14662,65386,-36062,0,-9605,895,0,0,,10500,-8710
46,11/17/2017,94,23:15,23:30,,,0,39.15,39.15,0,-36291,39643,75934,3352,0,0,0,0,0,,0,0
46,11/17/2017,95,23:30,23:45,,15.4,0,15.4,15.4,-1,-25078,85774,110852,60696,0,-4823,0,0,0,,4823,-4823
46,11/17/2017,96,23:45,0:00,,9.63,0,9.63,9.63,-1,-25326,128235,153561,102909,0,-35662,0,0,0,,35662,-35662
47,11/18/2017,1,0:00,0:15,38.67,9.63,0,38.67,38.67,1,-64872,84947,149819,20075,0,-11027,485,0,0,,11512,-10542
47,11/18/2017,2,0:15,0:30,,,0,41.22,41.22,0,-39978,59248,99226,19270,0,0,0,0,0,,0,0
47,11/18/2017,3,0:30,0:45,34.57,,0,34.57,34.57,1,-58363,52661,111024,-5702,0,0,62,0,0,,62,62
47,11/18/2017,4,0:45,1:00,34.5,31.63,0,31.63,31.63,-1,-83059,95204,178263,12145,0,-1980,48,0,0,,2028,-1932
47,11/18/2017,5,1:00,1:15,35.57,34.24,0,35.57,35.57,1,-53782,53358,107140,-424,0,-1789,103,0,0,,1892,-1686
47,11/18/2017,6,1:15,1:30,39.07,,0,39.07,39.07,1,-49194,38929,88123,-10265,0,0,3509,0,0,,3509,3509
47,11/18/2017,7,1:30,1:45,,,0,41.24,41.24,0,-41629,57128,98757,15499,0,0,0,0,0,,0,0
47,11/18/2017,8,1:45,2:00,,7.6,0,7.6,7.6,-1,-39183,94313,133496,55130,0,-6403,0,0,0,,6403,-6403
47,11/18/2017,9,2:00,2:15,,33.57,0,33.57,33.57,-1,-44757,65307,110064,20550,0,-3975,0,0,0,,3975,-3975
47,11/18/2017,10,2:15,2:30,,,0,41.29,41.29,0,-37795,56377,94172,18582,0,0,0,0,0,,0,0
47,11/18/2017,11,2:30,2:45,,,0,41.28,41.28,0,-43858,53346,97204,9488,0,0,0,0,0,,0,0
47,11/18/2017,12,2:45,3:00,,32.57,0,32.57,32.57,-1,-46243,58284,104527,12041,0,-1035,0,0,0,,1035,-1035
47,11/18/2017,13,3:00,3:15,45.9,,0,45.9,45.9,1,-82322,35680,118002,-46642,0,0,5815,0,0,,5815,5815
47,11/18/2017,14,3:15,3:30,35.57,,0,35.57,35.57,1,-60676,45271,105947,-15405,0,0,3498,0,0,,3498,3498
47,11/18/2017,15,3:30,3:45,,,0,41.29,41.29,0,-59203,51192,110395,-8011,0,0,2,0,0,,2,2
47,11/18/2017,16,3:45,4:00,,34.87,0,34.87,34.87,-1,-53267,43807,97074,-9460,0,-606,0,0,0,,606,-606
47,11/18/2017,17,4:00,4:15,,33.57,0,33.57,33.57,-1,-50545,67474,118019,16929,0,-137,0,0,0,,137,-137
47,11/18/2017,18,4:15,4:30,,,0,32.75,32.75,0,-48876,54979,103855,6103,0,0,0,0,0,,0,0
47,11/18/2017,19,4:30,4:45,,33.57,0,33.57,33.57,-1,-46977,62460,109437,15483,0,-880,0,0,0,,880,-880
47,11/18/2017,20,4:45,5:00,,28.57,0,28.57,28.57,-1,-39596,71579,111175,31983,0,-14971,0,0,0,,14971,-14971
47,11/18/2017,21,5:00,5:15,,32.57,0,32.57,32.57,-1,-32780,46963,79743,14183,0,-13709,0,0,0,,13709,-13709
47,11/18/2017,22,5:15,5:30,,,0,32.73,32.73,0,-33464,51338,84802,17874,0,-837,0,0,0,,837,-837
47,11/18/2017,23,5:30,5:45,,27.78,0,27.78,27.78,-1,-39237,62360,101597,23123,0,-11461,0,0,0,,11461,-11461
47,11/18/2017,24,5:45,6:00,35.57,32.57,0,35.57,32.57,2,-44116,38654,82770,-5462,0,-7485,237,0,0,,7722,-7248
47,11/18/2017,25,6:00,6:15,,-99.53,0,-99.53,-99.53,-1,-27146,66081,93227,38935,0,-18992,0,0,0,,18992,-18992
47,11/18/2017,26,6:15,6:30,,32.46,0,32.46,32.46,-1,-37252,65190,102442,27938,0,-2163,0,0,0,,2163,-2163
47,11/18/2017,27,6:30,6:45,,33.39,0,33.39,33.39,-1,-44307,55678,99985,11371,0,-476,0,0,0,,476,-476
47,11/18/2017,28,6:45,7:00,35.98,,0,35.98,35.98,1,-59679,43828,103507,-15851,0,0,199,0,0,,199,199
47,11/18/2017,29,7:00,7:15,38.41,35.23,0,38.41,33.22,2,-48610,47506,96116,-1104,0,-43,2654,0,0,,2697,2611
47,11/18/2017,30,7:15,7:30,,33.46,0,33.46,33.46,-1,-35469,70041,105510,34572,0,-1190,0,0,0,,1190,-1190
47,11/18/2017,31,7:30,7:45,35.46,36.35,0,35.46,35.46,1,-38571,46822,85393,8251,0,-283,44,0,0,,327,-239
47,11/18/2017,32,7:45,8:00,39.68,,0,39.68,39.68,1,-38304,55478,93782,17174,0,0,978,0,0,,978,978
47,11/18/2017,33,8:00,8:15,35.46,35.69,0,43.05,35.69,2,-43136,27756,70892,-15380,0,-149,774,0,0,,923,625
47,11/18/2017,34,8:15,8:30,46.94,32.46,0,46.94,32.46,2,-22315,18956,41271,-3359,0,-769,1595,0,0,,2364,826
47,11/18/2017,35,8:30,8:45,160.09,,0,160.09,160.09,1,-48098,16962,65060,-31136,0,0,34221,0,0,,34221,34221
47,11/18/2017,36,8:45,9:00,40.11,,0,40.11,40.11,1,-54110,26788,80898,-27322,0,0,20915,0,0,,20915,20915
47,11/18/2017,37,9:00,9:15,39.68,5.19,0,5.19,5.19,-1,-24964,69929,94893,44965,0,-8762,6532,0,0,,15294,-2230
47,11/18/2017,38,9:15,9:30,35.08,32.08,0,42.83,32.08,2,-32283,37013,69296,4730,0,-6449,248,0,0,,6697,-6201
47,11/18/2017,39,9:30,9:45,35.08,,0,35.08,35.08,1,-41179,28686,69865,-12493,0,0,221,0,0,,221,221
47,11/18/2017,40,9:45,10:00,90.11,,0,90.11,90.11,1,-63454,24818,88272,-38636,0,0,7908,0,0,,7908,7908
47,11/18/2017,41,10:00,10:15,99.11,33.76,0,33.76,33.76,-1,-32323,33623,65946,1300,0,-93,18859,0,0,,18952,18766
47,11/18/2017,42,10:15,10:30,99.11,30,0,30,30,-1,-28467,39331,67798,10864,0,-2562,1324,0,0,,3886,-1238
47,11/18/2017,43,10:30,10:45,35.96,,0,35.96,35.96,1,-28467,29328,57795,861,0,0,222,0,0,,222,222
47,11/18/2017,44,10:45,11:00,35.88,,0,35.88,35.88,1,-38705,31203,69908,-7502,0,0,415,0,0,,415,415
47,11/18/2017,45,11:00,11:15,,,0,35.73,35.73,0,-66163,73113,139276,6950,0,0,0,0,0,,0,0
47,11/18/2017,46,11:15,11:30,35.56,,0,35.56,35.56,1,-85027,80369,165396,-4658,0,0,951,0,0,,951,951
47,11/18/2017,47,11:30,11:45,51,,0,51,51,1,-92178,73389,165567,-18789,0,0,9996,0,0,,9996,9996
47,11/18/2017,48,11:45,12:00,39.04,,0,39.04,39.04,1,-80982,66856,147838,-14126,0,0,12681,0,0,,12681,12681
47,11/18/2017,49,12:00,12:15,39.04,32.08,0,32.08,32.08,-1,-59282,85798,145080,26516,0,-2254,569,0,0,,2823,-1685
47,11/18/2017,50,12:15,12:30,,,0,35.73,35.73,0,-55832,60786,116618,4954,0,0,0,0,0,,0,0
47,11/18/2017,51,12:30,12:45,,18.07,0,18.07,18.07,-1,-36103,71666,107769,35563,0,-6307,0,0,0,,6307,-6307
47,11/18/2017,52,12:45,13:00,,10.11,0,10.11,10.11,-1,-43010,80559,123569,37549,0,-29152,0,0,0,,29152,-29152
47,11/18/2017,53,13:00,13:15,,32.08,0,32.08,32.08,-1,-58293,96291,154584,37998,0,-11224,0,0,0,,11224,-11224
47,11/18/2017,54,13:15,13:30,,,0,35.73,35.73,0,-57699,87187,144886,29488,0,-28,0,0,0,,28,-28
47,11/18/2017,55,13:30,13:45,,33.08,0,33.08,33.08,-1,-81915,97378,179293,15463,0,-438,0,0,0,,438,-438
47,11/18/2017,56,13:45,14:00,,32.08,0,32.08,32.08,-1,-99244,82179,181423,-17065,0,-1429,0,0,0,,1429,-1429
47,11/18/2017,57,14:00,14:15,,23.81,0,23.81,23.81,-1,-48235,89549,137784,41314,0,-1237,0,0,0,,1237,-1237
47,11/18/2017,58,14:15,14:30,,10.91,0,10.91,10.91,-1,-55084,100913,155997,45829,0,-10821,0,0,0,,10821,-10821
47,11/18/2017,59,14:30,14:45,40.03,10.91,0,40.03,40.03,1,-81114,67838,148952,-13276,0,-10,3097,0,0,,3107,3087
47,11/18/2017,60,14:45,15:00,42.27,,0,42.27,42.27,1,-75627,49960,125587,-25667,0,0,15823,0,0,,15823,15823
47,11/18/2017,61,15:00,15:15,45.31,,0,45.31,45.31,1,-70991,52022,123013,-18969,0,0,16907,0,0,,16907,16907
47,11/18/2017,62,15:15,15:30,37.56,,0,37.56,37.56,1,-53743,45286,99029,-8457,0,0,9270,0,0,,9270,9270
47,11/18/2017,63,15:30,15:45,122.48,,0,122.48,122.48,1,-76391,30887,107278,-45504,0,0,18143,0,0,,18143,18143
47,11/18/2017,64,15:45,16:00,126.11,,0,126.11,126.11,1,-90323,62807,153130,-27516,0,0,46068,0,0,,46068,46068
47,11/18/2017,65,16:00,16:15,126.11,-7.23,0,-7.23,-7.23,-1,-68833,96157,164990,27324,0,-9310,9588,0,0,,18898,278
47,11/18/2017,66,16:15,16:30,72.72,-21.8,0,72.72,-21.8,2,-81673,73883,155556,-7790,0,-20323,3619,0,0,,23942,-16704
47,11/18/2017,67,16:30,16:45,370.33,33.75,0,370.33,33.75,2,-73574,72606,146180,-968,0,-314,16952,0,0,,17266,16638
47,11/18/2017,68,16:45,17:00,370.33,33.75,0,370.33,370.33,1,-96975,52509,149484,-44466,0,-64,15646,0,0,,15710,15582
47,11/18/2017,69,17:00,17:15,39.29,-30.53,0,-30.53,-30.53,-1,-47205,127275,174480,80070,0,-19342,11863,0,0,,31205,-7479
47,11/18/2017,70,17:15,17:30,54.55,14.26,0,54.55,54.55,1,-86879,81060,167939,-5819,0,-20678,3013,0,0,,23691,-17665
47,11/18/2017,71,17:30,17:45,82.11,32.62,0,82.11,32.62,2,-62577,60553,123130,-2024,0,-152,15455,0,0,,15607,15303
47,11/18/2017,72,17:45,18:00,82.11,19.19,0,19.19,19.19,-1,-61551,85327,146878,23776,0,-12825,236,0,0,,13061,-12589
47,11/18/2017,73,18:00,18:15,,-41.04,0,-41.04,-41.04,-1,-71616,112943,184559,41327,0,-19367,0,0,0,,19367,-19367
47,11/18/2017,74,18:15,18:30,,19.11,0,19.11,19.11,-1,-99030,112927,211957,13897,0,-24177,0,0,0,,24177,-24177
47,11/18/2017,75,18:30,18:45,,19.26,0,19.26,19.26,-1,-103594,131555,235149,27961,0,-27119,0,0,0,,27119,-27119
47,11/18/2017,76,18:45,19:00,,28.08,0,28.08,28.08,-1,-99733,129017,228750,29284,0,-35125,0,0,0,,35125,-35125
47,11/18/2017,77,19:00,19:15,122.57,28.08,0,122.57,122.57,1,-130253,103775,234028,-26478,0,-17716,5707,0,0,,23423,-12009
47,11/18/2017,78,19:15,19:30,38.89,33.08,0,38.89,33.08,2,-107049,96293,203342,-10756,0,-339,7585,0,0,,7924,7246
47,11/18/2017,79,19:30,19:45,38.89,10.11,0,10.11,10.11,-1,-87882,109016,196898,21134,0,-12931,69,0,0,,13000,-12862
47,11/18/2017,80,19:45,20:00,,9.15,0,9.15,9.15,-1,-83816,110502,194318,26686,0,-39140,0,0,0,,39140,-39140
47,11/18/2017,81,20:00,20:15,88.51,19.2,0,88.51,19.2,2,-92283,75265,167548,-17018,0,-19485,2905,0,0,,22390,-16580
47,11/18/2017,82,20:15,20:30,88.51,13.73,0,13.73,13.73,-1,-65917,87417,153334,21500,0,-13380,953,0,0,,14333,-12427
47,11/18/2017,83,20:30,20:45,,27.02,0,27.02,27.02,-1,-82749,90901,173650,8152,0,-19266,0,0,0,,19266,-19266
47,11/18/2017,84,20:45,21:00,,32.08,0,32.08,32.08,-1,-101929,99543,201472,-2386,0,-3720,0,0,0,,3720,-3720
47,11/18/2017,85,21:00,21:15,44.81,32.08,0,44.81,44.81,1,-91255,74529,165784,-16726,0,-116,2936,0,0,,3052,2820
47,11/18/2017,86,21:15,21:30,63.02,,0,63.02,63.02,1,-106031,63943,169974,-42088,0,0,10183,0,0,,10183,10183
47,11/18/2017,87,21:30,21:45,77.71,,0,77.71,77.71,1,-104100,68344,172444,-35756,0,0,24769,0,0,,24769,24769
47,11/18/2017,88,21:45,22:00,35.08,34.51,0,34.51,34.51,-1,-102000,66741,168741,-35259,0,-356,4871,0,0,,5227,4515
47,11/18/2017,89,22:00,22:15,,-67.18,0,-67.18,-67.18,-1,-56931,146423,203354,89492,0,-30526,0,0,0,,30526,-30526
47,11/18/2017,90,22:15,22:30,35.96,36,0,35.96,35.73,2,-73898,61341,135239,-12557,0,-10714,94,0,0,,10808,-10620
47,11/18/2017,91,22:30,22:45,,24.45,0,24.45,24.45,-1,-90178,101484,191662,11306,0,-5480,0,0,0,,5480,-5480
47,11/18/2017,92,22:45,23:00,,23.11,0,23.11,23.11,-1,-66904,103831,170735,36927,0,-29011,0,0,0,,29011,-29011
47,11/18/2017,93,23:00,23:15,39.08,26.64,0,39.08,39.08,1,-86371,92359,178730,5988,0,-18878,356,0,0,,19234,-18522
47,11/18/2017,94,23:15,23:30,40.22,15.11,0,40.22,15.11,2,-77347,83325,160672,5978,0,-1742,5505,0,0,,7247,3763
47,11/18/2017,95,23:30,23:45,,-67.68,0,-67.68,-67.68,-1,-57761,114975,172736,57214,0,-46888,0,0,0,,46888,-46888
47,11/18/2017,96,23:45,0:00,,-67.68,0,-67.68,-67.68,-1,-58551,113370,171921,54819,0,-52735,0,0,0,,52735,-52735
47,11/19/2017,1,0:00,0:15,62.02,30.03,0,62.02,62.02,1,-95504,93468,188972,-2036,0,-22069,1858,0,0,,23927,-20211
47,11/19/2017,2,0:15,0:30,72.02,,0,72.02,72.02,1,-100589,82251,182840,-18338,0,0,6401,0,0,,6401,6401
47,11/19/2017,3,0:30,0:45,72.02,28.08,0,28.08,28.08,-1,-76660,86453,163113,9793,0,-5377,20,0,0,,5397,-5357
47,11/19/2017,4,0:45,1:00,,33.08,0,33.08,33.08,-1,-94959,77881,172840,-17078,0,-3706,0,0,0,,3706,-3706
47,11/19/2017,5,1:00,1:15,,33.08,0,33.08,33.08,-1,-74329,82182,156511,7853,0,-641,0,0,0,,641,-641
47,11/19/2017,6,1:15,1:30,,32.08,0,32.08,32.08,-1,-66847,75755,142602,8908,0,-2675,0,0,0,,2675,-2675
47,11/19/2017,7,1:30,1:45,,30.03,0,30.03,30.03,-1,-66774,76828,143602,10054,0,-3952,0,0,0,,3952,-3952
47,11/19/2017,8,1:45,2:00,,14.03,0,14.03,14.03,-1,-51859,85768,137627,33909,0,-20632,0,0,0,,20632,-20632
47,11/19/2017,9,2:00,2:15,38.72,11.34,0,38.72,38.72,1,-112415,114880,227295,2465,0,-26724,253,0,0,,26977,-26471
47,11/19/2017,10,2:15,2:30,40.11,22.92,0,40.11,22.92,2,-66684,72286,138970,5602,0,-4989,1010,0,0,,5999,-3979
47,11/19/2017,11,2:30,2:45,,4.7,0,4.7,4.7,-1,-47423,82517,129940,35094,0,-38127,0,0,0,,38127,-38127
47,11/19/2017,12,2:45,3:00,,19.23,0,19.23,19.23,-1,-43505,84611,128116,41106,0,-44245,0,0,0,,44245,-44245
47,11/19/2017,13,3:00,3:15,35.08,32.08,0,35.08,35.08,1,-74430,76374,150804,1944,0,-17062,318,0,0,,17380,-16744
47,11/19/2017,14,3:15,3:30,35.08,15.09,0,15.09,15.09,-1,-50813,69001,119814,18188,0,-11590,21,0,0,,11611,-11569
47,11/19/2017,15,3:30,3:45,,27.21,0,27.21,27.21,-1,-64289,70461,134750,6172,0,-22802,0,0,0,,22802,-22802
47,11/19/2017,16,3:45,4:00,35.08,27.21,0,35.08,35.08,1,-81415,56084,137499,-25331,0,-3486,415,0,0,,3901,-3071
47,11/19/2017,17,4:00,4:15,49.07,,0,49.07,49.07,1,-88523,40303,128826,-48220,0,0,5713,0,0,,5713,5713
47,11/19/2017,18,4:15,4:30,35.08,,0,35.08,35.08,1,-70016,44864,114880,-25152,0,0,2822,0,0,,2822,2822
47,11/19/2017,19,4:30,4:45,42.37,,0,42.37,42.37,1,-74735,42425,117160,-32310,0,0,7312,0,0,,7312,7312
47,11/19/2017,20,4:45,5:00,36.92,,0,36.92,36.92,1,-66105,44734,110839,-21371,0,0,2741,0,0,,2741,2741
47,11/19/2017,21,5:00,5:15,36.92,13.21,0,13.21,13.21,-1,-61077,74192,135269,13115,0,-5315,187,0,0,,5502,-5128
47,11/19/2017,22,5:15,5:30,29.43,32.08,0,32.9,32.08,2,-64161,65436,129597,1275,0,-441,34,0,0,,475,-407
47,11/19/2017,23,5:30,5:45,38.29,32.08,0,38.29,32.08,2,-78216,67823,146039,-10393,0,-2953,713,0,0,,3666,-2240
47,11/19/2017,24,5:45,6:00,45.08,,0,45.08,45.08,1,-88258,61119,149377,-27139,0,0,15131,0,0,,15131,15131
47,11/19/2017,25,6:00,6:15,29.55,25.88,0,32.83,25.88,2,-59550,63278,122828,3728,0,-1567,3329,0,0,,4896,1762
47,11/19/2017,26,6:15,6:30,47.95,,0,47.95,47.95,1,-69772,51924,121696,-17848,0,0,5471,0,0,,5471,5471
47,11/19/2017,27,6:30,6:45,47.95,32.06,0,32.06,32.06,-1,-55349,67945,123294,12596,0,-3017,68,0,0,,3085,-2949
47,11/19/2017,28,6:45,7:00,35.06,32.06,0,35.06,32.06,2,-74206,73322,147528,-884,0,-2565,87,0,0,,2652,-2478
47,11/19/2017,29,7:00,7:15,,-70.8,0,-70.8,-70.8,-1,-37041,98967,136008,61926,0,-10281,0,0,0,,10281,-10281
47,11/19/2017,30,7:15,7:30,48.67,-70.8,0,48.67,-70.8,2,-54693,60767,115460,6074,0,-28238,1255,0,0,,29493,-26983
47,11/19/2017,31,7:30,7:45,48.67,14.51,0,14.51,14.51,-1,-55506,75612,131118,20106,0,-7058,139,0,0,,7197,-6919
47,11/19/2017,32,7:45,8:00,,8.1,0,8.1,8.1,-1,-66070,93457,159527,27387,0,-23837,0,0,0,,23837,-23837
47,11/19/2017,33,8:00,8:15,62.76,8.1,0,62.76,62.76,1,-94906,59387,154293,-35519,0,-6122,4206,0,0,,10328,-1916
47,11/19/2017,34,8:15,8:30,35.06,35.75,0,35.75,35.75,-1,-48878,48086,96964,-792,0,-194,241,0,0,,435,47
47,11/19/2017,35,8:30,8:45,35.06,33.06,0,35.59,33.06,2,-54475,54973,109448,498,0,-929,6,0,0,,935,-923
47,11/19/2017,36,8:45,9:00,52.45,,0,52.45,52.45,1,-84029,59721,143750,-24308,0,0,8751,0,0,,8751,8751
47,11/19/2017,37,9:00,9:15,52.45,16.53,0,16.53,16.53,-1,-55707,81808,137515,26101,0,-9908,364,0,0,,10272,-9544
47,11/19/2017,38,9:15,9:30,,26.05,0,26.05,26.05,-1,-50292,65367,115659,15075,0,-6456,0,0,0,,6456,-6456
47,11/19/2017,39,9:30,9:45,45.06,20.2,0,45.06,20.2,2,-66372,60121,126493,-6251,0,-13728,995,0,0,,14723,-12733
47,11/19/2017,40,9:45,10:00,65.05,33.06,0,65.05,33.06,2,-68931,66065,134996,-2866,0,-530,15175,0,0,,15705,14645
47,11/19/2017,41,10:00,10:15,39.06,28.06,0,39.06,28.06,2,-95230,83978,179208,-11252,0,-1134,2380,0,0,,3514,1246
47,11/19/2017,42,10:15,10:30,,9.25,0,9.25,9.25,-1,-70374,84631,155005,14257,0,-13536,0,0,0,,13536,-13536
47,11/19/2017,43,10:30,10:45,,15.7,0,15.7,15.7,-1,-62691,86659,149350,23968,0,-7337,0,0,0,,7337,-7337
47,11/19/2017,44,10:45,11:00,,11.56,0,11.56,11.56,-1,-67732,95705,163437,27973,0,-22294,0,0,0,,22294,-22294
47,11/19/2017,45,11:00,11:15,,15.62,0,15.62,15.62,-1,-60849,88615,149464,27766,0,-20573,0,0,0,,20573,-20573
47,11/19/2017,46,11:15,11:30,39.06,28.86,0,39.06,39.06,1,-56730,52280,109010,-4450,0,-15766,441,0,0,,16207,-15325
47,11/19/2017,47,11:30,11:45,39.06,28.86,0,39.06,39.06,1,-72768,90664,163432,17896,0,-48,2021,0,0,,2069,1973
47,11/19/2017,48,11:45,12:00,39.06,50.6,0,42.83,42.83,2,-73917,82499,156416,8582,0,-5,2786,0,0,,2791,2781
47,11/19/2017,49,12:00,12:15,,-30.55,0,-30.55,-30.55,-1,-56073,144671,200744,88598,0,-23623,0,0,0,,23623,-23623
47,11/19/2017,50,12:15,12:30,,-30.55,0,-30.55,-30.55,-1,-36682,128180,164862,91498,0,-16617,0,0,0,,16617,-16617
47,11/19/2017,51,12:30,12:45,,-30.55,0,-30.55,-30.55,-1,-50808,111868,162676,61060,0,-38559,0,0,0,,38559,-38559
47,11/19/2017,52,12:45,13:00,,11.92,0,11.92,11.92,-1,-41300,102668,143968,61368,0,-17280,0,0,0,,17280,-17280
47,11/19/2017,53,13:00,13:15,,-70.61,0,-70.61,-70.61,-1,-50772,163513,214285,112741,0,-57082,0,0,0,,57082,-57082
47,11/19/2017,54,13:15,13:30,,-43.72,0,-43.72,-43.72,-1,-52642,125060,177702,72418,0,-56601,0,0,0,,56601,-56601
47,11/19/2017,55,13:30,13:45,,-17.98,0,-17.98,-17.98,-1,-53775,123452,177227,69677,0,-52716,0,0,0,,52716,-52716
47,11/19/2017,56,13:45,14:00,,-105.93,0,-105.93,-105.93,-1,-71230,119886,191116,48656,0,-36285,0,0,0,,36285,-36285
47,11/19/2017,57,14:00,14:15,39.06,32.06,0,42.87,32.06,2,-70820,51617,122437,-19203,0,-560,1477,0,0,,2037,917
47,11/19/2017,58,14:15,14:30,,16.82,0,16.82,16.82,-1,-62048,79545,141593,17497,0,-16640,0,0,0,,16640,-16640
47,11/19/2017,59,14:30,14:45,44.64,16.82,0,44.64,44.64,1,-66304,53599,119903,-12705,0,-1768,1661,0,0,,3429,-107
47,11/19/2017,60,14:45,15:00,350.21,,0,350.21,350.21,1,-93285,43501,136786,-49784,0,0,16144,0,0,,16144,16144
47,11/19/2017,61,15:00,15:15,46.34,-15.47,0,-15.47,-15.47,-1,-67234,131288,198522,64054,0,-7626,21195,0,0,,28821,13569
47,11/19/2017,62,15:15,15:30,47.5,-32.18,0,47.5,-32.18,2,-68791,85655,154446,16864,0,-34277,1087,0,0,,35364,-33190
47,11/19/2017,63,15:30,15:45,47.5,13.84,0,13.84,13.84,-1,-53120,77636,130756,24516,0,-9096,515,0,0,,9611,-8581
47,11/19/2017,64,15:45,16:00,,21.97,0,21.97,21.97,-1,-52747,76502,129249,23755,0,-13813,0,0,0,,13813,-13813
47,11/19/2017,65,16:00,16:15,,-30.55,0,-30.55,-30.55,-1,-18796,124992,143788,106196,0,-55314,0,0,0,,55314,-55314
47,11/19/2017,66,16:15,16:30,,-30.55,0,-30.55,-30.55,-1,-47734,99122,146856,51388,0,-69296,0,0,0,,69296,-69296
47,11/19/2017,67,16:30,16:45,,-2.67,0,-2.67,-2.67,-1,-45693,86218,131911,40525,0,-16518,0,0,0,,16518,-16518
47,11/19/2017,68,16:45,17:00,35.06,-2.67,0,35.06,35.06,1,-67339,76875,144214,9536,0,-1555,224,0,0,,1779,-1331
47,11/19/2017,69,17:00,17:15,,-30.53,0,-30.53,-30.53,-1,-45341,153394,198735,108053,0,-23224,0,0,0,,23224,-23224
47,11/19/2017,70,17:15,17:30,,32.06,0,32.06,32.06,-1,-54842,98114,152956,43272,0,-2379,0,0,0,,2379,-2379
47,11/19/2017,71,17:30,17:45,,19.05,0,19.05,19.05,-1,-52903,88507,141410,35604,0,-5772,0,0,0,,5772,-5772
47,11/19/2017,72,17:45,18:00,,19.05,0,19.05,19.05,-1,-43299,80073,123372,36774,0,-9194,0,0,0,,9194,-9194
47,11/19/2017,73,18:00,18:15,,10.25,0,10.25,10.25,-1,-36741,133193,169934,96452,0,-20514,0,0,0,,20514,-20514
47,11/19/2017,74,18:15,18:30,,0.86,0,0.86,0.86,-1,-32635,100758,133393,68123,0,-33127,0,0,0,,33127,-33127
47,11/19/2017,75,18:30,18:45,,-14.03,0,-14.03,-14.03,-1,-36263,90587,126850,54324,0,-53972,0,0,0,,53972,-53972
47,11/19/2017,76,18:45,19:00,,7.33,0,7.33,7.33,-1,-36669,95302,131971,58633,0,-30804,0,0,0,,30804,-30804
47,11/19/2017,77,19:00,19:15,39.29,7.33,0,39.29,39.29,1,-59574,41911,101485,-17663,0,-13532,1038,0,0,,14570,-12494
47,11/19/2017,78,19:15,19:30,37.32,,0,37.32,37.32,1,-60540,51393,111933,-9147,0,0,924,0,0,,924,924
47,11/19/2017,79,19:30,19:45,37.32,22.7,0,22.7,22.7,-1,-41829,68766,110595,26937,0,-11497,53,0,0,,11550,-11444
47,11/19/2017,80,19:45,20:00,,17.17,0,17.17,17.17,-1,-33196,63514,96710,30318,0,-28740,0,0,0,,28740,-28740
47,11/19/2017,81,20:00,20:15,,27.21,0,27.21,27.21,-1,-41388,65643,107031,24255,0,-20222,0,0,0,,20222,-20222
47,11/19/2017,82,20:15,20:30,,33.06,0,33.06,33.06,-1,-53519,57988,111507,4469,0,-4622,0,0,0,,4622,-4622
47,11/19/2017,83,20:30,20:45,,25.6,0,25.6,25.6,-1,-57552,72157,129709,14605,0,-4701,0,0,0,,4701,-4701
47,11/19/2017,84,20:45,21:00,,-99.54,0,-99.54,-99.54,-1,-32866,77192,110058,44326,0,-27565,0,0,0,,27565,-27565
47,11/19/2017,85,21:00,21:15,,-67.54,0,-67.54,-67.54,-1,-35448,88216,123664,52768,0,-37117,0,0,0,,37117,-37117
47,11/19/2017,86,21:15,21:30,,-67.54,0,-67.54,-67.54,-1,-20599,78271,98870,57672,0,-24085,0,0,0,,24085,-24085
47,11/19/2017,87,21:30,21:45,,25.21,0,25.21,25.21,-1,-48515,69652,118167,21137,0,-16340,0,0,0,,16340,-16340
47,11/19/2017,88,21:45,22:00,,-3.21,0,-3.21,-3.21,-1,-65247,99408,164655,34161,0,-7261,0,0,0,,7261,-7261
47,11/19/2017,89,22:00,22:15,37.05,-10.21,0,37.05,-10.21,2,-114064,45616,159680,-68448,0,-7517,164,0,0,,7681,-7353
47,11/19/2017,90,22:15,22:30,,,0,35.56,35.56,0,-105526,52407,157933,-53119,0,0,0,0,0,,0,0
47,11/19/2017,91,22:30,22:45,45.29,,0,45.29,45.29,1,-98336,68755,167091,-29581,0,0,2731,0,0,,2731,2731
47,11/19/2017,92,22:45,23:00,36.25,28.06,0,36.25,28.06,2,-51166,60325,111491,9159,0,-2030,3258,0,0,,5288,1228
47,11/19/2017,93,23:00,23:15,84.92,2.82,0,84.92,2.82,2,-70897,59780,130677,-11117,0,-10515,1723,0,0,,12238,-8792
47,11/19/2017,94,23:15,23:30,123.17,32.06,0,123.17,32.06,2,-76068,44119,120187,-31949,0,-160,19079,0,0,,19239,18919
47,11/19/2017,95,23:30,23:45,123.17,28.06,0,28.06,28.06,-1,-65352,74329,139681,8977,0,-3166,158,0,0,,3324,-3008
47,11/19/2017,96,23:45,0:00,,27.27,0,27.27,27.27,-1,-62831,79695,142526,16864,0,-13048,0,0,0,,13048,-13048
47,11/20/2017,1,0:00,0:15,200.78,27.27,0,200.78,200.78,1,-114228,43717,157945,-70511,0,-4423,18643,0,0,,23066,14220
47,11/20/2017,2,0:15,0:30,33.12,22.99,0,33.12,22.99,2,-36334,51795,88129,15461,0,-6789,4627,0,0,,11416,-2162
47,11/20/2017,3,0:30,0:45,29.45,22.99,0,29.45,29.45,1,-75023,43724,118747,-31299,0,-1385,606,0,0,,1991,-779
47,11/20/2017,4,0:45,1:00,29.45,32.06,0,32.06,32.06,-1,-69949,67508,137457,-2441,0,-384,147,0,0,,531,-237
47,11/20/2017,5,1:00,1:15,,32.06,0,32.06,32.06,-1,-35097,44181,79278,9084,0,-2368,0,0,0,,2368,-2368
47,11/20/2017,6,1:15,1:30,,32.06,0,32.06,32.06,-1,-39046,25586,64632,-13460,0,-803,0,0,0,,803,-803
47,11/20/2017,7,1:30,1:45,,,0,32.31,32.31,0,-60713,26435,87148,-34278,0,0,0,0,0,,0,0
47,11/20/2017,8,1:45,2:00,,,0,32.31,32.31,0,-43932,31685,75617,-12247,0,0,0,0,0,,0,0
47,11/20/2017,9,2:00,2:15,52.34,,0,52.34,52.34,1,-63811,35194,99005,-28617,0,0,7226,0,0,,7226,7226
47,11/20/2017,10,2:15,2:30,52.12,,0,52.12,52.12,1,-65239,49360,114599,-15879,0,0,14716,0,0,,14716,14716
47,11/20/2017,11,2:30,2:45,52.12,35.76,0,35.76,35.76,-1,-51844,43457,95301,-8387,0,-106,594,0,0,,700,488
47,11/20/2017,12,2:45,3:00,,,0,32.8,32.8,0,-84422,55040,139462,-29382,0,0,0,0,0,,0,0
47,11/20/2017,13,3:00,3:15,,,0,32.76,32.76,0,-72409,80668,153077,8259,0,0,0,0,0,,0,0
47,11/20/2017,14,3:15,3:30,,32.06,0,32.06,32.06,-1,-58252,81127,139379,22875,0,-380,0,0,0,,380,-380
47,11/20/2017,15,3:30,3:45,,27.39,0,27.39,27.39,-1,-44997,92543,137540,47546,0,-4573,0,0,0,,4573,-4573
47,11/20/2017,16,3:45,4:00,,19.13,0,19.13,19.13,-1,-40905,81458,122363,40553,0,-15557,0,0,0,,15557,-15557
47,11/20/2017,17,4:00,4:15,35.29,33.06,0,35.29,32.73,2,-40495,47642,88137,7147,0,-3260,166,0,0,,3426,-3094
47,11/20/2017,18,4:15,4:30,44.5,33.06,0,44.5,44.5,1,-68451,42674,111125,-25777,0,-10,5616,0,0,,5626,5606
47,11/20/2017,19,4:30,4:45,39.29,,0,39.29,39.29,1,-77855,50551,128406,-27304,0,0,10644,0,0,,10644,10644
47,11/20/2017,20,4:45,5:00,149.94,,0,149.94,149.94,1,-141226,74429,215655,-66797,0,0,36064,0,0,,36064,36064
47,11/20/2017,21,5:00,5:15,44.6,,0,44.6,44.6,1,-171035,122839,293874,-48196,0,0,21876,0,0,,21876,21876
47,11/20/2017,22,5:15,5:30,31.12,-150.78,0,-150.78,-150.78,-1,-69236,106796,176032,37560,0,-7985,9306,0,0,,17291,1321
47,11/20/2017,23,5:30,5:45,38.36,-150.78,0,38.36,-150.78,2,-47256,56282,103538,9026,0,-32748,913,0,0,,33661,-31835
47,11/20/2017,24,5:45,6:00,37.06,32.06,0,37.06,32.06,2,-83991,97811,181802,13820,0,-2426,754,0,0,,3180,-1672
47,11/20/2017,25,6:00,6:15,113.36,32.2,0,113.36,32.2,2,-132989,80167,213156,-52822,0,-218,21004,0,0,,21222,20786
47,11/20/2017,26,6:15,6:30,113.36,23.99,0,23.99,23.99,-1,-57825,90038,147863,32213,0,-13903,360,0,0,,14263,-13543
47,11/20/2017,27,6:30,6:45,31.12,28.41,0,33.17,28.41,2,-81824,92686,174510,10862,0,-20771,406,0,0,,21177,-20365
47,11/20/2017,28,6:45,7:00,31.12,28.41,0,31.12,31.12,1,-129478,118542,248020,-10936,0,-1288,1852,0,0,,3140,564
47,11/20/2017,29,7:00,7:15,,,0,34.67,34.67,0,-185547,140110,325657,-45437,0,0,0,0,0,,0,0
47,11/20/2017,30,7:15,7:30,144.86,,0,144.86,144.86,1,-251260,119806,371066,-131454,0,0,21723,0,0,,21723,21723
47,11/20/2017,31,7:30,7:45,128.19,,0,128.19,128.19,1,-297486,98634,396120,-198852,0,0,87800,0,0,,87800,87800
47,11/20/2017,32,7:45,8:00,385.1,,0,423.61,423.61,1,-337554,115764,453318,-221790,0,0,98870,5000,23749,,127619,127619
47,11/20/2017,33,8:00,8:15,348.97,-46.08,0,383.87,-46.08,2,-205929,136655,342584,-69274,0,-10270,45676,5000,84478,,145424,124884
47,11/20/2017,34,8:15,8:30,450,34.16,0,495,495,1,-228232,116897,345129,-111335,0,-3958,13928,0,65657,,83543,75627
47,11/20/2017,35,8:30,8:45,450,,0,495,495,1,-255607,119542,375149,-136065,0,0,70849,3750,56247,,130846,130846
47,11/20/2017,36,8:45,9:00,450,,0,495,495,1,-275757,127223,402980,-148534,0,0,69812,3750,56247,,129809,129809
47,11/20/2017,37,9:00,9:15,280.62,35.36,0,308.68,35.36,2,-205432,109580,315012,-95852,0,-21,57568,0,56247,,113836,113794
47,11/20/2017,38,9:15,9:30,58.24,30.45,0,252.24,30.45,2,-209763,126276,336039,-83487,0,-1667,9919,0,56247,,67833,64499
47,11/20/2017,39,9:30,9:45,35.56,34.16,0,252.24,34.16,2,-178362,135614,313976,-42748,0,-1040,10143,0,34998,,46181,44101
47,11/20/2017,40,9:45,10:00,34.8,11.24,0,252.24,11.24,2,-163113,128505,291618,-34608,0,-2119,492,0,34998,,37609,33371
47,11/20/2017,41,10:00,10:15,,-39.05,0,-39.05,-39.05,-1,-56968,137147,194115,80179,0,-69708,0,0,23332,,93040,-46376
47,11/20/2017,42,10:15,10:30,,11.24,0,11.24,11.24,-1,-52447,117941,170388,65494,0,-56271,0,0,0,,56271,-56271
47,11/20/2017,43,10:30,10:45,,22.36,0,22.36,22.36,-1,-63509,127694,191203,64185,0,-65841,0,0,0,,65841,-65841
47,11/20/2017,44,10:45,11:00,,22.36,0,22.36,22.36,-1,-83079,121701,204780,38622,0,-57940,0,0,0,,57940,-57940
47,11/20/2017,45,11:00,11:15,141.3,22.36,0,141.3,141.3,1,-86559,68835,155394,-17724,0,-9985,3873,0,0,,13858,-6112
47,11/20/2017,46,11:15,11:30,,,0,43.98,43.98,0,-79644,75876,155520,-3768,0,0,83,0,0,,83,83
47,11/20/2017,47,11:30,11:45,34.8,,0,34.8,34.8,1,-78684,70617,149301,-8067,0,0,162,0,0,,162,162
47,11/20/2017,48,11:45,12:00,35.86,,0,35.86,35.86,1,-81695,60599,142294,-21096,0,0,5073,0,0,,5073,5073
47,11/20/2017,49,12:00,12:15,50.36,,0,50.36,50.36,1,-123884,59053,182937,-64831,0,0,23060,0,0,,23060,23060
47,11/20/2017,50,12:15,12:30,35.12,,0,35.12,35.12,1,-134606,54285,188891,-80321,0,0,13003,0,0,,13003,13003
47,11/20/2017,51,12:30,12:45,104.76,,0,104.76,104.76,1,-128941,61649,190590,-67292,0,0,14189,0,0,,14189,14189
47,11/20/2017,52,12:45,13:00,36.12,,0,36.12,36.12,1,-105176,67301,172477,-37875,0,0,20825,0,0,,20825,20825
47,11/20/2017,53,13:00,13:15,57.13,,0,57.13,57.13,1,-81950,51288,133238,-30662,0,0,16713,0,0,,16713,16713
47,11/20/2017,54,13:15,13:30,35.38,,0,35.38,35.38,1,-90635,57973,148608,-32662,0,0,18569,0,0,,18569,18569
47,11/20/2017,55,13:30,13:45,,,0,35.53,35.53,0,-79488,68260,147748,-11228,0,0,724,0,0,,724,724
47,11/20/2017,56,13:45,14:00,,,0,35.53,35.53,0,-89245,70909,160154,-18336,0,0,0,0,0,,0,0
47,11/20/2017,57,14:00,14:15,34.8,,0,34.8,34.8,1,-89384,78518,167902,-10866,0,0,432,0,0,,432,432
47,11/20/2017,58,14:15,14:30,,34.82,0,34.82,34.82,-1,-90725,89177,179902,-1548,0,-831,0,0,0,,831,-831
47,11/20/2017,59,14:30,14:45,,32.67,0,32.67,32.67,-1,-81842,96500,178342,14658,0,-9754,0,0,0,,9754,-9754
47,11/20/2017,60,14:45,15:00,,33.67,0,33.67,33.67,-1,-79722,91907,171629,12185,0,-17290,0,0,0,,17290,-17290
47,11/20/2017,61,15:00,15:15,39.64,33.67,0,39.64,39.64,1,-88119,83173,171292,-4946,0,-2529,1281,0,0,,3810,-1248
47,11/20/2017,62,15:15,15:30,,,0,35.53,35.53,0,-82631,88841,171472,6210,0,0,0,0,0,,0,0
47,11/20/2017,63,15:30,15:45,35.97,,0,35.97,35.97,1,-98754,90391,189145,-8363,0,0,819,0,0,,819,819
47,11/20/2017,64,15:45,16:00,39.64,,0,39.64,39.64,1,-105732,91019,196751,-14713,0,0,2800,0,0,,2800,2800
47,11/20/2017,65,16:00,16:15,,,0,35.31,35.31,0,-87961,103191,191152,15230,0,0,1423,0,0,,1423,1423
47,11/20/2017,66,16:15,16:30,,,0,35.31,35.31,0,-94212,109031,203243,14819,0,0,0,0,0,,0,0
47,11/20/2017,67,16:30,16:45,34.8,,0,34.8,34.8,1,-106140,122816,228956,16676,0,0,83,0,0,,83,83
47,11/20/2017,68,16:45,17:00,116.12,,0,116.12,116.12,1,-150507,123612,274119,-26895,0,0,18916,0,0,,18916,18916
47,11/20/2017,69,17:00,17:15,36.59,15.7,0,44.83,15.7,2,-78254,117208,195462,38954,0,-10419,8548,0,0,,18967,-1871
47,11/20/2017,70,17:15,17:30,,34.88,0,34.88,34.88,-1,-77171,87747,164918,10576,0,-2371,0,0,0,,2371,-2371
47,11/20/2017,71,17:30,17:45,,30.45,0,30.45,30.45,-1,-62103,95060,157163,32957,0,-9033,0,0,0,,9033,-9033
47,11/20/2017,72,17:45,18:00,34.8,34.82,0,44.83,34.82,2,-57725,97476,155201,39751,0,-1899,1,0,0,,1900,-1898
47,11/20/2017,73,18:00,18:15,35.97,-12.41,0,35.97,-12.41,2,-69250,122553,191803,53303,0,-20496,277,0,0,,20773,-20219
47,11/20/2017,74,18:15,18:30,,-25.25,0,-25.25,-25.25,-1,-54770,82080,136850,27310,0,-42864,0,0,0,,42864,-42864
47,11/20/2017,75,18:30,18:45,,2.11,0,2.11,2.11,-1,-30283,100552,130835,70269,0,-40489,0,0,0,,40489,-40489
47,11/20/2017,76,18:45,19:00,,2.51,0,2.51,2.51,-1,-15601,111884,127485,96283,0,-80739,0,0,0,,80739,-80739
47,11/20/2017,77,19:00,19:15,35.97,26.9,0,35.97,26.9,2,-64823,101481,166304,36658,0,-23040,241,0,0,,23281,-22799
47,11/20/2017,78,19:15,19:30,,-8.16,0,-8.16,-8.16,-1,-47792,103825,151617,56033,0,-42458,0,0,0,,42458,-42458
47,11/20/2017,79,19:30,19:45,,14.09,0,14.09,14.09,-1,-44569,103708,148277,59139,0,-56195,0,0,0,,56195,-56195
47,11/20/2017,80,19:45,20:00,,32.5,0,32.5,32.5,-1,-62502,89901,152403,27399,0,-30534,0,0,0,,30534,-30534
47,11/20/2017,81,20:00,20:15,,18.74,0,18.74,18.74,-1,-60204,99348,159552,39144,0,-9034,0,0,0,,9034,-9034
47,11/20/2017,82,20:15,20:30,,23.52,0,23.52,23.52,-1,-33312,85402,118714,52090,0,-9929,0,0,0,,9929,-9929
47,11/20/2017,83,20:30,20:45,,-6.9,0,-6.9,-6.9,-1,-32101,110673,142774,78572,0,-42960,0,0,0,,42960,-42960
47,11/20/2017,84,20:45,21:00,34.8,-41.34,0,34.8,-41.34,2,-72652,104801,177453,32149,0,-58481,12,0,0,,58493,-58469
47,11/20/2017,85,21:00,21:15,37.23,-41.34,0,37.23,37.23,1,-72623,109596,182219,36973,0,-2432,1329,0,0,,3761,-1103
47,11/20/2017,86,21:15,21:30,,32.38,0,32.38,32.38,-1,-45105,99917,145022,54812,0,-835,0,0,0,,835,-835
47,11/20/2017,87,21:30,21:45,,23.52,0,23.52,23.52,-1,-43378,110444,153822,67066,0,-4612,0,0,0,,4612,-4612
47,11/20/2017,88,21:45,22:00,,2.55,0,2.55,2.55,-1,-90479,132524,223003,42045,0,-4972,0,0,0,,4972,-4972
47,11/20/2017,89,22:00,22:15,36.36,-50.01,0,36.36,-50.01,2,-65484,57383,122867,-8101,0,-23122,422,0,0,,23544,-22700
47,11/20/2017,90,22:15,22:30,36.36,33.67,0,33.67,33.67,-1,-56138,55539,111677,-599,0,-115,110,0,0,,225,-5
47,11/20/2017,91,22:30,22:45,,32.67,0,32.67,32.67,-1,-46139,67097,113236,20958,0,-1581,0,0,0,,1581,-1581
47,11/20/2017,92,22:45,23:00,,32.67,0,32.67,32.67,-1,-63680,102695,166375,39015,0,-1580,0,0,0,,1580,-1580
47,11/20/2017,93,23:00,23:15,,9.08,0,9.08,9.08,-1,-53490,81634,135124,28144,0,-13092,0,0,0,,13092,-13092
47,11/20/2017,94,23:15,23:30,43.58,9.08,0,43.58,43.58,1,-63685,46667,110352,-17018,0,-22,7316,0,0,,7338,7294
47,11/20/2017,95,23:30,23:45,34.53,32.67,0,34.53,32.67,2,-38834,39310,78144,476,0,-1106,905,0,0,,2011,-201
47,11/20/2017,96,23:45,0:00,,22.53,0,22.53,22.53,-1,-54616,84535,139151,29919,0,-13318,0,0,0,,13318,-13318
47,11/21/2017,1,0:00,0:15,,-50.93,0,-50.93,-50.93,-1,-26250,102500,128750,76250,0,-41246,0,0,0,,41246,-41246
47,11/21/2017,2,0:15,0:30,43.99,25.79,0,43.99,25.79,2,-68148,62470,130618,-5678,0,-24448,1272,0,0,,25720,-23176
47,11/21/2017,3,0:30,0:45,43.99,30.2,0,30.2,30.2,-1,-53464,66572,120036,13108,0,-3226,188,0,0,,3414,-3038
47,11/21/2017,4,0:45,1:00,,20.97,0,20.97,20.97,-1,-38398,76469,114867,38071,0,-34871,0,0,0,,34871,-34871
47,11/21/2017,5,1:00,1:15,63.37,29.03,0,63.37,63.37,1,-41289,40877,82166,-412,0,-25425,2518,0,0,,27943,-22907
47,11/21/2017,6,1:15,1:30,34.44,29.03,0,34.44,34.44,1,-50004,43221,93225,-6783,0,-309,1810,0,0,,2119,1501
47,11/21/2017,7,1:30,1:45,,,0,32.44,32.44,0,-43569,43190,86759,-379,0,0,68,0,0,,68,68
47,11/21/2017,8,1:45,2:00,,34.2,0,34.2,34.2,-1,-42285,42221,84506,-64,0,-209,0,0,0,,209,-209
47,11/21/2017,9,2:00,2:15,43.83,34.2,0,43.83,32.95,2,-53652,32900,86552,-20752,0,-719,4434,0,0,,5153,3715
47,11/21/2017,10,2:15,2:30,43.41,,0,43.41,43.41,1,-47262,37762,85024,-9500,0,0,11105,0,0,,11105,11105
47,11/21/2017,11,2:30,2:45,43.41,34.2,0,34.2,34.2,-1,-46729,49692,96421,2963,0,-820,128,0,0,,948,-692
47,11/21/2017,12,2:45,3:00,,34.2,0,34.2,34.2,-1,-43542,44688,88230,1146,0,-2154,0,0,0,,2154,-2154
47,11/21/2017,13,3:00,3:15,,32.67,0,32.67,32.67,-1,-30791,39647,70438,8856,0,-2184,0,0,0,,2184,-2184
47,11/21/2017,14,3:15,3:30,34.44,32.67,0,34.44,32.45,2,-40306,37520,77826,-2786,0,-2746,33,0,0,,2779,-2713
47,11/21/2017,15,3:30,3:45,,34.2,0,34.2,34.2,-1,-32661,39735,72396,7074,0,-2744,0,0,0,,2744,-2744
47,11/21/2017,16,3:45,4:00,,32.03,0,32.03,32.03,-1,-26875,45649,72524,18774,0,-6871,0,0,0,,6871,-6871
47,11/21/2017,17,4:00,4:15,,25.03,0,25.03,25.03,-1,-43999,45626,89625,1627,0,-12530,0,0,0,,12530,-12530
47,11/21/2017,18,4:15,4:30,,,0,32.93,32.93,0,-39080,35343,74423,-3737,0,-287,0,0,0,,287,-287
47,11/21/2017,19,4:30,4:45,,,0,32.93,32.93,0,-60656,24798,85454,-35858,0,0,0,0,0,,0,0
47,11/21/2017,20,4:45,5:00,,,0,32.91,32.91,0,-80019,23506,103525,-56513,0,0,0,0,0,,0,0
47,11/21/2017,21,5:00,5:15,,10.29,0,10.29,10.29,-1,-31833,82078,113911,50245,0,-16280,0,0,0,,16280,-16280
47,11/21/2017,22,5:15,5:30,35.13,29.03,0,35.13,35.13,1,-51067,51984,103051,917,0,-16254,429,0,0,,16683,-15825
47,11/21/2017,23,5:30,5:45,35.13,9.34,0,9.34,9.34,-1,-29314,60901,90215,31587,0,-17395,31,0,0,,17426,-17364
47,11/21/2017,24,5:45,6:00,36.47,34.2,0,36.47,32.43,2,-59011,71363,130374,12352,0,-8149,558,0,0,,8707,-7591
47,11/21/2017,25,6:00,6:15,,12.83,0,12.83,12.83,-1,-67954,85902,153856,17948,0,-12846,0,0,0,,12846,-12846
47,11/21/2017,26,6:15,6:30,,3.66,0,3.66,3.66,-1,-29259,74951,104210,45692,0,-48234,0,0,0,,48234,-48234
47,11/21/2017,27,6:30,6:45,,34.03,0,34.03,34.03,-1,-27163,50116,77279,22953,0,-17808,0,0,0,,17808,-17808
47,11/21/2017,28,6:45,7:00,38.13,1.05,0,38.13,1.05,2,-77323,63065,140388,-14258,0,-6618,179,0,0,,6797,-6439
47,11/21/2017,29,7:00,7:15,,-31.82,0,-31.82,-31.82,-1,-23604,186992,210596,163388,0,-82410,0,0,0,,82410,-82410
47,11/21/2017,30,7:15,7:30,,15.81,0,15.81,15.81,-1,-41957,118804,160761,76847,0,-57943,0,0,0,,57943,-57943
47,11/21/2017,31,7:30,7:45,,34.89,0,34.89,34.89,-1,-39944,94130,134074,54186,0,-15276,0,0,0,,15276,-15276
47,11/21/2017,32,7:45,8:00,,34.89,0,34.89,34.89,-1,-84948,71949,156897,-12999,0,-1746,0,0,0,,1746,-1746
47,11/21/2017,33,8:00,8:15,,-22.96,0,-22.96,-22.96,-1,-32923,123278,156201,90355,0,-35472,0,0,0,,35472,-35472
47,11/21/2017,34,8:15,8:30,,15.8,0,15.8,15.8,-1,-39333,98319,137652,58986,0,-51552,0,0,0,,51552,-51552
47,11/21/2017,35,8:30,8:45,,30.4,0,30.4,30.4,-1,-45319,82120,127439,36801,0,-37876,0,0,0,,37876,-37876
47,11/21/2017,36,8:45,9:00,,30.13,0,30.13,30.13,-1,-55924,64757,120681,8833,0,-13728,0,0,0,,13728,-13728
47,11/21/2017,37,9:00,9:15,,26.54,0,26.54,26.54,-1,-24432,65872,90304,41440,0,-4588,0,0,0,,4588,-4588
47,11/21/2017,38,9:15,9:30,,26.86,0,26.86,26.86,-1,-27415,65641,93056,38226,0,-8185,0,0,0,,8185,-8185
47,11/21/2017,39,9:30,9:45,,35.4,0,35.4,35.4,-1,-33203,54734,87937,21531,0,-1733,0,0,0,,1733,-1733
47,11/21/2017,40,9:45,10:00,,35.4,0,35.4,35.4,-1,-26353,58830,85183,32477,0,-1094,0,0,0,,1094,-1094
47,11/21/2017,41,10:00,10:15,37.76,51.98,0,44.58,44.58,2,-67282,52907,120189,-14375,0,-363,395,0,0,,758,32
47,11/21/2017,42,10:15,10:30,,,0,44.58,44.58,0,-56644,68108,124752,11464,0,0,0,0,0,,0,0
47,11/21/2017,43,10:30,10:45,,51.66,0,51.66,51.66,-1,-51671,71108,122779,19437,0,-695,0,0,0,,695,-695
47,11/21/2017,44,10:45,11:00,,,0,44.57,44.57,0,-51377,62290,113667,10913,0,-3,0,0,0,,3,-3
47,11/21/2017,45,11:00,11:15,41.4,,0,41.4,41.4,1,-92846,54403,147249,-38443,0,0,390,0,0,,390,390
47,11/21/2017,46,11:15,11:30,203.45,,0,203.45,203.45,1,-97966,54469,152435,-43497,0,0,25526,0,0,,25526,25526
47,11/21/2017,47,11:30,11:45,203.45,51.84,0,51.84,51.84,-1,-58737,56569,115306,-2168,0,-276,7634,0,0,,7910,7358
47,11/21/2017,48,11:45,12:00,37.03,,0,37.03,37.03,1,-64543,64959,129502,416,0,0,19,0,0,,19,19
47,11/21/2017,49,12:00,12:15,94.97,,0,94.97,94.97,1,-96102,63313,159415,-32789,0,0,9758,0,0,,9758,9758
47,11/21/2017,50,12:15,12:30,94.97,34.84,0,34.84,34.84,-1,-80133,78066,158199,-2067,0,-125,1759,0,0,,1884,1634
47,11/21/2017,51,12:30,12:45,,23.35,0,23.35,23.35,-1,-57105,96808,153913,39703,0,-19486,0,0,0,,19486,-19486
47,11/21/2017,52,12:45,13:00,,18.81,0,18.81,18.81,-1,-52728,114765,167493,62037,0,-47703,0,0,0,,47703,-47703
47,11/21/2017,53,13:00,13:15,184.91,34.4,0,184.91,184.91,1,-102573,69756,172329,-32817,0,-17216,3985,0,0,,21201,-13231
47,11/21/2017,54,13:15,13:30,217.11,35.4,0,217.11,35.4,2,-60473,66346,126819,5873,0,-148,8917,0,0,,9065,8769
47,11/21/2017,55,13:30,13:45,,34.4,0,34.4,34.4,-1,-66870,93484,160354,26614,0,-2402,0,0,0,,2402,-2402
47,11/21/2017,56,13:45,14:00,,33.68,0,33.68,33.68,-1,-72705,102275,174980,29570,0,-10500,0,0,0,,10500,-10500
47,11/21/2017,57,14:00,14:15,,33.17,0,33.17,33.17,-1,-61573,81252,142825,19679,0,-10297,0,0,0,,10297,-10297
47,11/21/2017,58,14:15,14:30,,34.4,0,34.4,34.4,-1,-65099,91031,156130,25932,0,-12753,0,0,0,,12753,-12753
47,11/21/2017,59,14:30,14:45,,30.4,0,30.4,30.4,-1,-69490,103113,172603,33623,0,-19684,0,0,0,,19684,-19684
47,11/21/2017,60,14:45,15:00,,27.25,0,27.25,27.25,-1,-65421,108302,173723,42881,0,-29529,0,0,0,,29529,-29529
47,11/21/2017,61,15:00,15:15,,26.21,0,26.21,26.21,-1,-56149,110969,167118,54820,0,-32172,0,0,0,,32172,-32172
47,11/21/2017,62,15:15,15:30,,20.83,0,20.83,20.83,-1,-59011,110383,169394,51372,0,-40365,0,0,0,,40365,-40365
47,11/21/2017,63,15:30,15:45,,,0,44.12,44.12,0,-58334,80070,138404,21736,0,-6811,0,0,0,,6811,-6811
47,11/21/2017,64,15:45,16:00,,34.84,0,34.84,34.84,-1,-63180,80163,143343,16983,0,-643,0,0,0,,643,-643
47,11/21/2017,65,16:00,16:15,,28.95,0,28.95,28.95,-1,-74758,107646,182404,32888,0,-18117,0,0,0,,18117,-18117
47,11/21/2017,66,16:15,16:30,,35,0,35,35,-1,-78040,89743,167783,11703,0,-10308,0,0,0,,10308,-10308
47,11/21/2017,67,16:30,16:45,,34.39,0,34.39,34.39,-1,-72849,99297,172146,26448,0,-4573,0,0,0,,4573,-4573
47,11/21/2017,68,16:45,17:00,138.46,35.4,0,138.46,35.4,2,-53126,63007,116133,9881,0,-3910,2383,0,0,,6293,-1527
47,11/21/2017,69,17:00,17:15,148.41,16.87,0,16.87,16.87,-1,-93993,157036,251029,63043,0,-13035,3436,0,0,,16471,-9599
47,11/21/2017,70,17:15,17:30,,30.4,0,30.4,30.4,-1,-111818,144896,256714,33078,0,-10404,0,0,0,,10404,-10404
47,11/21/2017,71,17:30,17:45,,21.87,0,21.87,21.87,-1,-107320,160117,267437,52797,0,-12310,0,0,0,,12310,-12310
47,11/21/2017,72,17:45,18:00,,27.72,0,27.72,27.72,-1,-97235,178629,275864,81394,0,-30213,0,0,0,,30213,-30213
47,11/21/2017,73,18:00,18:15,37.4,32.39,0,44.16,32.39,2,-159002,161774,320776,2772,0,-16543,128,0,0,,16671,-16415
47,11/21/2017,74,18:15,18:30,,21.87,0,21.87,21.87,-1,-138550,173185,311735,34635,0,-19006,0,0,0,,19006,-19006
47,11/21/2017,75,18:30,18:45,,16.87,0,16.87,16.87,-1,-116333,172807,289140,56474,0,-37127,0,0,0,,37127,-37127
47,11/21/2017,76,18:45,19:00,,15.89,0,15.89,15.89,-1,-86996,154985,241981,67989,0,-47187,0,0,0,,47187,-47187
47,11/21/2017,77,19:00,19:15,127.11,-2.66,0,127.11,-2.66,2,-104729,56018,160747,-48711,0,-32749,5376,0,0,,38125,-27373
47,11/21/2017,78,19:15,19:30,127.11,30.23,0,30.23,30.23,-1,-77262,87645,164907,10383,0,-2760,1804,0,0,,4564,-956
47,11/21/2017,79,19:30,19:45,,10.74,0,10.74,10.74,-1,-53475,98726,152201,45251,0,-29577,0,0,0,,29577,-29577
47,11/21/2017,80,19:45,20:00,,7.05,0,7.05,7.05,-1,-46118,105574,151692,59456,0,-55787,0,0,0,,55787,-55787
47,11/21/2017,81,20:00,20:15,39.06,-7.62,0,39.06,-7.62,2,-20063,61555,81618,41492,0,-45308,138,0,0,,45446,-45170
47,11/21/2017,82,20:15,20:30,38.32,-29.67,0,38.32,-29.67,2,-13112,62095,75207,48983,0,-13148,314,0,0,,13462,-12834
47,11/21/2017,83,20:30,20:45,,-44.07,0,-44.07,-44.07,-1,-52753,70889,123642,18136,0,-23761,0,0,0,,23761,-23761
47,11/21/2017,84,20:45,21:00,,-10.58,0,-10.58,-10.58,-1,-33356,85741,119097,52385,0,-39488,0,0,0,,39488,-39488
47,11/21/2017,85,21:00,21:15,,,0,35.75,35.75,0,-44403,63381,107784,18978,0,-8202,0,0,0,,8202,-8202
47,11/21/2017,86,21:15,21:30,,-33.47,0,-33.47,-33.47,-1,-14624,70244,84868,55620,0,-18843,0,0,0,,18843,-18843
47,11/21/2017,87,21:30,21:45,,24.99,0,24.99,24.99,-1,-23532,54467,77999,30935,0,-26325,0,0,0,,26325,-26325
47,11/21/2017,88,21:45,22:00,,6.13,0,6.13,6.13,-1,-50387,90898,141285,40511,0,-27298,0,0,0,,27298,-27298
47,11/21/2017,89,22:00,22:15,37.07,-18.25,0,37.07,-18.25,2,-42420,54655,97075,12235,0,-31197,189,0,0,,31386,-31008
47,11/21/2017,90,22:15,22:30,35.32,28.55,0,35.32,28.55,2,-13451,43027,56478,29576,0,-2361,208,0,0,,2569,-2153
47,11/21/2017,91,22:30,22:45,,26.62,0,26.62,26.62,-1,-50117,57217,107334,7100,0,-5485,0,0,0,,5485,-5485
47,11/21/2017,92,22:45,23:00,,4.92,0,4.92,4.92,-1,-28702,89437,118139,60735,0,-32357,0,0,0,,32357,-32357
47,11/21/2017,93,23:00,23:15,65.72,6.76,0,65.72,6.76,2,-58501,56801,115302,-1700,0,-27562,1873,0,0,,29435,-25689
47,11/21/2017,94,23:15,23:30,65.72,5.66,0,5.66,5.66,-1,-26478,58587,85065,32109,0,-17313,246,0,0,,17559,-17067
47,11/21/2017,95,23:30,23:45,,13.66,0,13.66,13.66,-1,-40201,73991,114192,33790,0,-22281,0,0,0,,22281,-22281
47,11/21/2017,96,23:45,0:00,,-2.27,0,-2.27,-2.27,-1,-73927,122149,196076,48222,0,-50976,0,0,0,,50976,-50976
47,11/22/2017,1,0:00,0:15,56.03,-49.19,0,56.03,-49.19,2,-44616,91053,135669,46437,0,-47679,254,0,0,,47933,-47425
47,11/22/2017,2,0:15,0:30,89.13,28.5,0,89.13,28.5,2,-46720,42615,89335,-4105,0,-3435,11722,0,0,,15157,8287
47,11/22/2017,3,0:30,0:45,40.61,-61.92,0,43.15,-61.92,2,-52908,52350,105258,-558,0,-19910,614,0,0,,20524,-19296
47,11/22/2017,4,0:45,1:00,40.61,31.78,0,31.78,31.78,-1,-64469,56492,120961,-7977,0,-1679,305,0,0,,1984,-1374
47,11/22/2017,5,1:00,1:15,,24.58,0,24.58,24.58,-1,-23257,69699,92956,46442,0,-17073,0,0,0,,17073,-17073
47,11/22/2017,6,1:15,1:30,,32.49,0,32.49,32.49,-1,-29613,54435,84048,24822,0,-18984,0,0,0,,18984,-18984
47,11/22/2017,7,1:30,1:45,,28.29,0,28.29,28.29,-1,-39121,66610,105731,27489,0,-24332,0,0,0,,24332,-24332
47,11/22/2017,8,1:45,2:00,,27.89,0,27.89,27.89,-1,-66355,99261,165616,32906,0,-29944,0,0,0,,29944,-29944
47,11/22/2017,9,2:00,2:15,,3.78,0,3.78,3.78,-1,-81998,126106,208104,44108,0,-38537,0,0,0,,38537,-38537
47,11/22/2017,10,2:15,2:30,39.87,3.78,0,39.87,39.87,1,-90925,62066,152991,-28859,0,-6501,1685,0,0,,8186,-4816
47,11/22/2017,11,2:30,2:45,35.06,,0,35.06,35.06,1,-85257,62849,148106,-22408,0,0,340,0,0,,340,340
47,11/22/2017,12,2:45,3:00,,,0,36.3,36.3,0,-83654,65934,149588,-17720,0,0,0,0,0,,0,0
47,11/22/2017,13,3:00,3:15,39.87,,0,39.87,39.87,1,-89026,44656,133682,-44370,0,0,569,0,0,,569,569
47,11/22/2017,14,3:15,3:30,,,0,36.3,36.3,0,-85730,54953,140683,-30777,0,0,0,0,0,,0,0
47,11/22/2017,15,3:30,3:45,,,0,36.3,36.3,0,-78978,59545,138523,-19433,0,0,0,0,0,,0,0
47,11/22/2017,16,3:45,4:00,,33.87,0,33.87,33.87,-1,-76164,69539,145703,-6625,0,-102,0,0,0,,102,-102
47,11/22/2017,17,4:00,4:15,,33.87,0,33.87,33.87,-1,-61402,73295,134697,11893,0,-1901,0,0,0,,1901,-1901
47,11/22/2017,18,4:15,4:30,,34.15,0,34.15,34.15,-1,-65955,63325,129280,-2630,0,-1620,0,0,0,,1620,-1620
47,11/22/2017,19,4:30,4:45,,,0,35.16,35.16,0,-65887,43591,109478,-22296,0,-297,0,0,0,,297,-297
47,11/22/2017,20,4:45,5:00,,33.87,0,33.87,33.87,-1,-67396,60328,127724,-7068,0,-65,0,0,0,,65,-65
47,11/22/2017,21,5:00,5:15,37.86,28.87,0,37.86,28.87,2,-8615,98390,107005,89775,0,-1180,683,0,0,,1863,-497
47,11/22/2017,22,5:15,5:30,96.08,,0,96.08,96.08,1,-14478,90341,104819,75863,0,0,22953,0,0,,22953,22953
47,11/22/2017,23,5:30,5:45,128.74,,0,230.22,230.22,1,-22330,65613,87943,43283,0,0,62856,0,11666,,74522,74522
47,11/22/2017,24,5:45,6:00,44.95,-69.78,0,-69.78,-69.78,-1,-18961,203878,222839,184917,0,-11784,23798,0,34998,,70580,47012
47,11/22/2017,25,6:00,6:15,,-72.16,0,-72.16,-72.16,-1,-37147,215032,252179,177885,0,-44419,0,0,34998,,79417,-9421
47,11/22/2017,26,6:15,6:30,,-29.58,0,-29.58,-29.58,-1,-22664,198777,221441,176113,0,-71770,0,0,34998,,106768,-36772
47,11/22/2017,27,6:30,6:45,,-29.58,0,231.98,231.98,1,-20168,170259,190427,150091,0,-17252,0,0,34998,,52250,17746
47,11/22/2017,28,6:45,7:00,,28.92,0,28.92,28.92,-1,-24232,221118,245350,196886,0,-2023,0,0,34998,,37021,32975
47,11/22/2017,29,7:00,7:15,,33.92,0,33.92,33.92,-1,-76247,211635,287882,135388,0,-867,0,0,34998,,35865,34131
47,11/22/2017,30,7:15,7:30,43.48,33.92,0,239.9,239.9,1,-92902,224773,317675,131871,0,-7,1141,0,34998,,36146,36132
47,11/22/2017,31,7:30,7:45,370.33,,0,407.36,407.36,1,-126934,190194,317128,63260,0,0,48223,0,34998,,83221,83221
47,11/22/2017,32,7:45,8:00,66.91,34.63,0,34.63,34.63,-1,-144884,190758,335642,45874,0,-22,40404,0,34998,,75424,75380
47,11/22/2017,33,8:00,8:15,66.91,-58.81,0,-58.81,-58.81,-1,-70298,182675,252973,112377,0,-33351,2105,0,0,,35456,-31246
47,11/22/2017,34,8:15,8:30,,33.27,0,33.27,33.27,-1,-69733,127491,197224,57758,0,-6657,0,0,0,,6657,-6657
47,11/22/2017,35,8:30,8:45,,34.16,0,34.16,34.16,-1,-62493,117272,179765,54779,0,-90,0,0,0,,90,-90
47,11/22/2017,36,8:45,9:00,,,0,35.25,35.25,0,-84794,86837,171631,2043,0,0,0,0,0,,0,0
47,11/22/2017,37,9:00,9:15,37.63,,0,37.63,37.63,1,-69105,58827,127932,-10278,0,0,1248,0,0,,1248,1248
47,11/22/2017,38,9:15,9:30,37.63,33.27,0,33.27,33.27,-1,-46550,56689,103239,10139,0,-1130,77,0,0,,1207,-1053
47,11/22/2017,39,9:30,9:45,,32.17,0,32.17,32.17,-1,-35669,57535,93204,21866,0,-9428,0,0,0,,9428,-9428
47,11/22/2017,40,9:45,10:00,,33.27,0,33.27,33.27,-1,-43008,47131,90139,4123,0,-12906,0,0,0,,12906,-12906
47,11/22/2017,41,10:00,10:15,,25.26,0,25.26,25.26,-1,-38464,80930,119394,42466,0,-14231,0,0,0,,14231,-14231
47,11/22/2017,42,10:15,10:30,,28.5,0,28.5,28.5,-1,-40855,68469,109324,27614,0,-29990,0,0,0,,29990,-29990
47,11/22/2017,43,10:30,10:45,,33.27,0,33.27,33.27,-1,-38969,54674,93643,15705,0,-9576,0,0,0,,9576,-9576
47,11/22/2017,44,10:45,11:00,,32.27,0,32.27,32.27,-1,-52007,56635,108642,4628,0,-12601,0,0,0,,12601,-12601
47,11/22/2017,45,11:00,11:15,35.53,32.17,0,35.53,32.17,2,-41620,59208,100828,17588,0,-8388,223,0,0,,8611,-8165
47,11/22/2017,46,11:15,11:30,35.27,32.27,0,35.29,32.27,2,-40052,53945,93997,13893,0,-4610,359,0,0,,4969,-4251
47,11/22/2017,47,11:30,11:45,,26.53,0,26.53,26.53,-1,-34766,70227,104993,35461,0,-20374,0,0,0,,20374,-20374
47,11/22/2017,48,11:45,12:00,,30.96,0,30.96,30.96,-1,-33781,67352,101133,33571,0,-32726,0,0,0,,32726,-32726
47,11/22/2017,49,12:00,12:15,,27.3,0,27.3,27.3,-1,-64452,93267,157719,28815,0,-16176,0,0,0,,16176,-16176
47,11/22/2017,50,12:15,12:30,,-12.43,0,-12.43,-12.43,-1,-36360,87255,123615,50895,0,-45086,0,0,0,,45086,-45086
47,11/22/2017,51,12:30,12:45,,0.48,0,0.48,0.48,-1,-30007,108969,138976,78962,0,-35744,0,0,0,,35744,-35744
47,11/22/2017,52,12:45,13:00,,-12.5,0,-12.5,-12.5,-1,-30061,88448,118509,58387,0,-65645,0,0,0,,65645,-65645
47,11/22/2017,53,13:00,13:15,,-12.81,0,-12.81,-12.81,-1,-40644,120699,161343,80055,0,-61701,0,0,0,,61701,-61701
47,11/22/2017,54,13:15,13:30,,17.27,0,17.27,17.27,-1,-39668,104436,144104,64768,0,-52490,0,0,0,,52490,-52490
47,11/22/2017,55,13:30,13:45,,10.99,0,10.99,10.99,-1,-37008,102434,139442,65426,0,-69731,0,0,0,,69731,-69731
47,11/22/2017,56,13:45,14:00,,12.27,0,12.27,12.27,-1,-36625,108549,145174,71924,0,-41624,0,0,0,,41624,-41624
47,11/22/2017,57,14:00,14:15,,28.27,0,28.27,28.27,-1,-47758,92975,140733,45217,0,-48013,0,0,0,,48013,-48013
47,11/22/2017,58,14:15,14:30,,28.27,0,28.27,28.27,-1,-52809,85342,138151,32533,0,-38278,0,0,0,,38278,-38278
47,11/22/2017,59,14:30,14:45,,,0,35.29,35.29,0,-70558,88715,159273,18157,0,-3013,0,0,0,,3013,-3013
47,11/22/2017,60,14:45,15:00,39.97,,0,39.97,39.97,1,-77228,86129,163357,8901,0,0,84,0,0,,84,84
47,11/22/2017,61,15:00,15:15,35.27,,0,35.27,35.27,1,-80645,80824,161469,179,0,0,188,0,0,,188,188
47,11/22/2017,62,15:15,15:30,47.43,,0,47.43,47.43,1,-85409,64734,150143,-20675,0,0,6355,0,0,,6355,6355
47,11/22/2017,63,15:30,15:45,39.94,,0,39.94,39.94,1,-77631,68193,145824,-9438,0,0,5720,0,0,,5720,5720
47,11/22/2017,64,15:45,16:00,41.47,,0,41.47,41.47,1,-72297,44016,116313,-28281,0,0,4605,0,0,,4605,4605
47,11/22/2017,65,16:00,16:15,35.27,-43.42,0,43.13,-43.42,2,-35203,116738,151941,81535,0,-25979,1699,0,0,,27678,-24280
47,11/22/2017,66,16:15,16:30,,2.3,0,2.3,2.3,-1,-36925,116282,153207,79357,0,-49172,0,0,0,,49172,-49172
47,11/22/2017,67,16:30,16:45,,17.25,0,17.25,17.25,-1,-27929,92899,120828,64970,0,-73224,0,0,0,,73224,-73224
47,11/22/2017,68,16:45,17:00,35.27,33.72,0,35.27,35.27,1,-59165,78054,137219,18889,0,-15108,64,0,0,,15172,-15044
47,11/22/2017,69,17:00,17:15,35.27,21.93,0,43.1,21.93,2,-33215,83241,116456,50026,0,-8871,78,0,0,,8949,-8793
47,11/22/2017,70,17:15,17:30,,33.27,0,33.27,33.27,-1,-47622,57763,105385,10141,0,-3284,0,0,0,,3284,-3284
47,11/22/2017,71,17:30,17:45,,29.25,0,29.25,29.25,-1,-30126,62821,92947,32695,0,-9822,0,0,0,,9822,-9822
47,11/22/2017,72,17:45,18:00,,17.96,0,17.96,17.96,-1,-29944,90901,120845,60957,0,-38347,0,0,0,,38347,-38347
47,11/22/2017,73,18:00,18:15,39.94,32.25,0,43.04,32.25,2,-39005,35898,74903,-3107,0,-16022,125,0,0,,16147,-15897
47,11/22/2017,74,18:15,18:30,,22.25,0,22.25,22.25,-1,-29394,87344,116738,57950,0,-25466,0,0,0,,25466,-25466
47,11/22/2017,75,18:30,18:45,,21.78,0,21.78,21.78,-1,-43629,99879,143508,56250,0,-49886,0,0,0,,49886,-49886
47,11/22/2017,76,18:45,19:00,,14.9,0,14.9,14.9,-1,-40756,114570,155326,73814,0,-50707,0,0,0,,50707,-50707
47,11/22/2017,77,19:00,19:15,178.37,-26.86,0,178.37,-26.86,2,-71940,51882,123822,-20058,0,-44925,3248,0,0,,48173,-41677
47,11/22/2017,78,19:15,19:30,227.77,9.78,0,227.77,9.78,2,-47211,75444,122655,28233,0,-8538,5323,0,0,,13861,-3215
47,11/22/2017,79,19:30,19:45,,8.82,0,8.82,8.82,-1,-54167,65327,119494,11160,0,-14407,0,0,0,,14407,-14407
47,11/22/2017,80,19:45,20:00,,10.26,0,10.26,10.26,-1,-56128,94847,150975,38719,0,-25650,0,0,0,,25650,-25650
47,11/22/2017,81,20:00,20:15,175.1,-30.59,0,175.1,-30.59,2,-55823,58591,114414,2768,0,-46425,2309,0,0,,48734,-44116
47,11/22/2017,82,20:15,20:30,175.1,5.98,0,5.98,5.98,-1,-22502,58512,81014,36010,0,-7775,2076,0,0,,9851,-5699
47,11/22/2017,83,20:30,20:45,,5.33,0,5.33,5.33,-1,-33158,59997,93155,26839,0,-29600,0,0,0,,29600,-29600
47,11/22/2017,84,20:45,21:00,,28.5,0,28.5,28.5,-1,-68663,96608,165271,27945,0,-13965,0,0,0,,13965,-13965
47,11/22/2017,85,21:00,21:15,43.96,31.78,0,43.96,31.78,2,-37927,39911,77838,1984,0,-12402,1671,0,0,,14073,-10731
47,11/22/2017,86,21:15,21:30,43.96,28.27,0,28.27,28.27,-1,-27405,50883,78288,23478,0,-2112,235,0,0,,2347,-1877
47,11/22/2017,87,21:30,21:45,,27.9,0,27.9,27.9,-1,-22898,73252,96150,50354,0,-7139,0,0,0,,7139,-7139
47,11/22/2017,88,21:45,22:00,,-5.24,0,-5.24,-5.24,-1,-30876,99319,130195,68443,0,-49328,0,0,0,,49328,-49328
47,11/22/2017,89,22:00,22:15,157,32.5,0,157,157,1,-50181,17063,67244,-33118,0,-14411,8273,0,0,,22684,-6138
47,11/22/2017,90,22:15,22:30,181.47,12.23,0,181.47,12.23,2,-33008,55065,88073,22057,0,-5221,16614,0,0,,21835,11393
47,11/22/2017,91,22:30,22:45,,-13.38,0,-13.38,-13.38,-1,-33099,78796,111895,45697,0,-41298,0,0,0,,41298,-41298
47,11/22/2017,92,22:45,23:00,,-14.09,0,-14.09,-14.09,-1,-27631,96443,124074,68812,0,-47495,0,0,0,,47495,-47495
47,11/22/2017,93,23:00,23:15,46.42,32.27,0,46.42,32.27,2,-38177,31760,69937,-6417,0,-14535,2590,0,0,,17125,-11945
47,11/22/2017,94,23:15,23:30,35.92,32.27,0,35.92,32.27,2,-28315,43965,72280,15650,0,-3159,1359,0,0,,4518,-1800
47,11/22/2017,95,23:30,23:45,,19.88,0,19.88,19.88,-1,-20671,66803,87474,46132,0,-33680,0,0,0,,33680,-33680
47,11/22/2017,96,23:45,0:00,,-5.87,0,-5.87,-5.87,-1,-21549,109940,131489,88391,0,-80078,0,0,0,,80078,-80078
47,11/23/2017,1,0:00,0:15,,29.99,0,29.99,29.99,-1,-53595,70988,124583,17393,0,-30356,0,0,0,,30356,-30356
47,11/23/2017,2,0:15,0:30,,,0,35.28,35.28,0,-45402,52319,97721,6917,0,0,0,0,0,,0,0
47,11/23/2017,3,0:30,0:45,,27.32,0,27.32,27.32,-1,-36463,44423,80886,7960,0,-2366,0,0,0,,2366,-2366
47,11/23/2017,4,0:45,1:00,,-3.03,0,-3.03,-3.03,-1,-35278,63544,98822,28266,0,-45049,0,0,0,,45049,-45049
47,11/23/2017,5,1:00,1:15,60.52,29.31,0,60.52,29.31,2,-45867,39475,85342,-6392,0,-22566,2100,0,0,,24666,-20466
47,11/23/2017,6,1:15,1:30,,,0,32.38,32.38,0,-40175,55284,95459,15109,0,0,210,0,0,,210,210
47,11/23/2017,7,1:30,1:45,,34.31,0,34.31,34.31,-1,-35052,73730,108782,38678,0,-53,0,0,0,,53,-53
47,11/23/2017,8,1:45,2:00,,33.31,0,33.31,33.31,-1,-31438,82075,113513,50637,0,-2223,0,0,0,,2223,-2223
47,11/23/2017,9,2:00,2:15,40.34,33.31,0,40.34,40.34,1,-48071,39473,87544,-8598,0,-1570,1418,0,0,,2988,-152
47,11/23/2017,10,2:15,2:30,51.82,,0,51.82,51.82,1,-51687,30129,81816,-21558,0,0,12975,0,0,,12975,12975
47,11/23/2017,11,2:30,2:45,,,0,36.41,36.41,0,-48185,41517,89702,-6668,0,0,558,0,0,,558,558
47,11/23/2017,12,2:45,3:00,,34.31,0,34.31,34.31,-1,-53298,44361,97659,-8937,0,-590,0,0,0,,590,-590
47,11/23/2017,13,3:00,3:15,,,0,32.38,32.38,0,-33495,61611,95106,28116,0,0,0,0,0,,0,0
47,11/23/2017,14,3:15,3:30,,,0,32.38,32.38,0,-43401,40350,83751,-3051,0,0,0,0,0,,0,0
47,11/23/2017,15,3:30,3:45,,,0,32.38,32.38,0,-37192,68939,106131,31747,0,0,0,0,0,,0,0
47,11/23/2017,16,3:45,4:00,,22.17,0,22.17,22.17,-1,-42315,52085,94400,9770,0,-10469,0,0,0,,10469,-10469
47,11/23/2017,17,4:00,4:15,,20.61,0,20.61,20.61,-1,-22240,73988,96228,51748,0,-11306,0,0,0,,11306,-11306
47,11/23/2017,18,4:15,4:30,,,0,32.36,32.36,0,-29929,64473,94402,34544,0,-97,0,0,0,,97,-97
47,11/23/2017,19,4:30,4:45,,33.31,0,33.31,33.31,-1,-28291,68388,96679,40097,0,-368,0,0,0,,368,-368
47,11/23/2017,20,4:45,5:00,35.28,-16.51,0,35.28,-16.51,2,-36728,36911,73639,183,0,-18408,70,0,0,,18478,-18338
47,11/23/2017,21,5:00,5:15,35.28,34.31,0,35.28,32.33,2,-84524,98627,183151,14103,0,-684,343,0,0,,1027,-341
47,11/23/2017,22,5:15,5:30,35.89,34.31,0,35.89,32.3,2,-74004,73841,147845,-163,0,-215,112,0,0,,327,-103
47,11/23/2017,23,5:30,5:45,49.94,,0,49.94,49.94,1,-100893,49853,150746,-51040,0,0,3289,0,0,,3289,3289
47,11/23/2017,24,5:45,6:00,60.52,,0,60.52,60.52,1,-138503,69306,207809,-69197,0,0,28594,0,0,,28594,28594
47,11/23/2017,25,6:00,6:15,37.52,27.99,0,37.52,27.99,2,-155971,174695,330666,18724,0,-3246,13569,0,0,,16815,10323
47,11/23/2017,26,6:15,6:30,67.99,27.99,0,67.99,67.99,1,-151412,113365,264777,-38047,0,-238,3390,0,0,,3628,3152
47,11/23/2017,27,6:30,6:45,59.39,,0,59.39,59.39,1,-153480,88027,241507,-65453,0,0,13118,0,0,,13118,13118
47,11/23/2017,28,6:45,7:00,35.31,30.43,0,30.43,30.43,-1,-151188,194829,346017,43641,0,-1215,5688,0,0,,6903,4473
47,11/23/2017,29,7:00,7:15,,-39,0,-39,-39,-1,-133679,145638,279317,11959,0,-67420,0,0,0,,67420,-67420
47,11/23/2017,30,7:15,7:30,111.02,-3.28,0,111.02,111.02,1,-119977,99431,219408,-20546,0,-54567,2546,0,0,,57113,-52021
47,11/23/2017,31,7:30,7:45,35.7,32.08,0,43.77,32.08,2,-60167,108321,168488,48154,0,-3777,1634,0,0,,5411,-2143
47,11/23/2017,32,7:45,8:00,,33.59,0,33.59,33.59,-1,-75245,89568,164813,14323,0,-823,0,0,0,,823,-823
47,11/23/2017,33,8:00,8:15,,-58.83,0,-58.83,-58.83,-1,-48637,145353,193990,96716,0,-45763,0,0,0,,45763,-45763
47,11/23/2017,34,8:15,8:30,,-58.83,0,-58.83,-58.83,-1,-47615,144600,192215,96985,0,-68020,0,0,0,,68020,-68020
47,11/23/2017,35,8:30,8:45,,-3.01,0,-3.01,-3.01,-1,-32607,123987,156594,91380,0,-59866,0,0,0,,59866,-59866
47,11/23/2017,36,8:45,9:00,,-13.59,0,-13.59,-13.59,-1,-41483,146715,188198,105232,0,-81654,0,0,0,,81654,-81654
47,11/23/2017,37,9:00,9:15,,17.57,0,17.57,17.57,-1,-75465,89652,165117,14187,0,-38797,0,0,0,,38797,-38797
47,11/23/2017,38,9:15,9:30,,51.93,0,51.93,51.93,-1,-76640,91449,168089,14809,0,-4,0,0,0,,4,-4
47,11/23/2017,39,9:30,9:45,,33.59,0,33.59,33.59,-1,-42660,105730,148390,63070,0,-593,0,0,0,,593,-593
47,11/23/2017,40,9:45,10:00,,32.59,0,32.59,32.59,-1,-50845,92459,143304,41614,0,-2535,0,0,0,,2535,-2535
47,11/23/2017,41,10:00,10:15,,20.57,0,20.57,20.57,-1,-39067,85977,125044,46910,0,-20251,0,0,0,,20251,-20251
47,11/23/2017,42,10:15,10:30,,28.59,0,28.59,28.59,-1,-64086,79880,143966,15794,0,-31839,0,0,0,,31839,-31839
47,11/23/2017,43,10:30,10:45,35.74,33.59,0,35.74,32.26,2,-62161,74327,136488,12166,0,-3388,511,0,0,,3899,-2877
47,11/23/2017,44,10:45,11:00,,32.59,0,32.59,32.59,-1,-75307,86607,161914,11300,0,-9817,0,0,0,,9817,-9817
47,11/23/2017,45,11:00,11:15,36.61,29.01,0,36.61,29.01,2,-41473,50107,91580,8634,0,-9012,231,0,0,,9243,-8781
47,11/23/2017,46,11:15,11:30,36.61,33.33,0,36.61,32.21,2,-43881,52408,96289,8527,0,-1604,463,0,0,,2067,-1141
47,11/23/2017,47,11:30,11:45,,32.59,0,32.59,32.59,-1,-50214,56480,106694,6266,0,-3432,0,0,0,,3432,-3432
47,11/23/2017,48,11:45,12:00,,28.59,0,28.59,28.59,-1,-53927,62727,116654,8800,0,-14517,0,0,0,,14517,-14517
47,11/23/2017,49,12:00,12:15,,-0.15,0,-0.15,-0.15,-1,-51801,97436,149237,45635,0,-20347,0,0,0,,20347,-20347
47,11/23/2017,50,12:15,12:30,,29.16,0,29.16,29.16,-1,-67757,89480,157237,21723,0,-20403,0,0,0,,20403,-20403
47,11/23/2017,51,12:30,12:45,47.53,32.59,0,47.53,47.53,1,-72499,61851,134350,-10648,0,-12727,1335,0,0,,14062,-11392
47,11/23/2017,52,12:45,13:00,56.1,32.59,0,56.1,56.1,1,-68265,55725,123990,-12540,0,-192,8199,0,0,,8391,8007
47,11/23/2017,53,13:00,13:15,56.1,7.73,0,7.73,7.73,-1,-49726,93724,143450,43998,0,-19097,661,0,0,,19758,-18436
47,11/23/2017,54,13:15,13:30,36.06,33.59,0,43.9,33.59,2,-66822,60448,127270,-6374,0,-1927,275,0,0,,2202,-1652
47,11/23/2017,55,13:30,13:45,,32.69,0,32.69,32.69,-1,-74885,61891,136776,-12994,0,-2036,0,0,0,,2036,-2036
47,11/23/2017,56,13:45,14:00,,35.73,0,35.73,35.73,-1,-69700,67342,137042,-2358,0,-86,0,0,0,,86,-86
47,11/23/2017,57,14:00,14:15,,27.99,0,27.99,27.99,-1,-55288,76159,131447,20871,0,-12340,0,0,0,,12340,-12340
47,11/23/2017,58,14:15,14:30,37.91,27.73,0,37.91,37.91,1,-72938,64739,137677,-8199,0,-14879,728,0,0,,15607,-14151
47,11/23/2017,59,14:30,14:45,,,0,43.92,43.92,0,-97157,57576,154733,-39581,0,-6,36,0,0,,42,30
47,11/23/2017,60,14:45,15:00,,,0,43.92,43.92,0,-66771,62549,129320,-4222,0,0,0,0,0,,0,0
47,11/23/2017,61,15:00,15:15,,32.76,0,32.76,32.76,-1,-77647,82903,160550,5256,0,-1952,0,0,0,,1952,-1952
47,11/23/2017,62,15:15,15:30,,,0,43.91,43.91,0,-43173,68260,111433,25087,0,-24,0,0,0,,24,-24
47,11/23/2017,63,15:30,15:45,,,0,43.92,43.92,0,-43870,76505,120375,32635,0,0,0,0,0,,0,0
47,11/23/2017,64,15:45,16:00,,37.17,0,37.17,37.17,-1,-47149,78784,125933,31635,0,-3,0,0,0,,3,-3
47,11/23/2017,65,16:00,16:15,,-48.63,0,-48.63,-48.63,-1,-43172,162225,205397,119053,0,-40853,0,0,0,,40853,-40853
47,11/23/2017,66,16:15,16:30,,22.8,0,22.8,22.8,-1,-38063,140997,179060,102934,0,-37526,0,0,0,,37526,-37526
47,11/23/2017,67,16:30,16:45,,,0,43.91,43.91,0,-35426,140454,175880,105028,0,-6360,0,0,0,,6360,-6360
47,11/23/2017,68,16:45,17:00,,,0,43.91,43.91,0,-55493,97883,153376,42390,0,0,0,0,0,,0,0
47,11/23/2017,69,17:00,17:15,,,0,43.81,43.81,0,-60182,74772,134954,14590,0,0,0,0,0,,0,0
47,11/23/2017,70,17:15,17:30,48.52,,0,48.52,48.52,1,-60754,41045,101799,-19709,0,0,5226,0,0,,5226,5226
47,11/23/2017,71,17:30,17:45,39.74,,0,39.74,39.74,1,-62582,51502,114084,-11080,0,0,6867,0,0,,6867,6867
47,11/23/2017,72,17:45,18:00,39.74,32.59,0,32.59,32.59,-1,-56538,66448,122986,9910,0,-1899,12,0,0,,1911,-1887
47,11/23/2017,73,18:00,18:15,,7.83,0,7.83,7.83,-1,-50808,89344,140152,38536,0,-30604,0,0,0,,30604,-30604
47,11/23/2017,74,18:15,18:30,,7.18,0,7.18,7.18,-1,-44128,87709,131837,43581,0,-13185,0,0,0,,13185,-13185
47,11/23/2017,75,18:30,18:45,,2.83,0,2.83,2.83,-1,-47493,77730,125223,30237,0,-31157,0,0,0,,31157,-31157
47,11/23/2017,76,18:45,19:00,,-2.21,0,-2.21,-2.21,-1,-43054,117644,160698,74590,0,-45370,0,0,0,,45370,-45370
47,11/23/2017,77,19:00,19:15,,7.14,0,7.14,7.14,-1,-53845,65632,119477,11787,0,-30361,0,0,0,,30361,-30361
47,11/23/2017,78,19:15,19:30,,31.64,0,31.64,31.64,-1,-54019,75048,129067,21029,0,-6137,0,0,0,,6137,-6137
47,11/23/2017,79,19:30,19:45,,13.31,0,13.31,13.31,-1,-51137,105604,156741,54467,0,-39416,0,0,0,,39416,-39416
47,11/23/2017,80,19:45,20:00,,19.29,0,19.29,19.29,-1,-50224,115239,165463,65015,0,-57120,0,0,0,,57120,-57120
47,11/23/2017,81,20:00,20:15,112.21,33.59,0,112.21,33.59,2,-68610,47557,116167,-21053,0,-16716,4054,0,0,,20770,-12662
47,11/23/2017,82,20:15,20:30,,22.97,0,22.97,22.97,-1,-44898,81581,126479,36683,0,-15588,0,0,0,,15588,-15588
47,11/23/2017,83,20:30,20:45,,27.97,0,27.97,27.97,-1,-47430,75644,123074,28214,0,-19002,0,0,0,,19002,-19002
47,11/23/2017,84,20:45,21:00,,28.3,0,28.3,28.3,-1,-87821,93278,181099,5457,0,-17879,0,0,0,,17879,-17879
47,11/23/2017,85,21:00,21:15,67.58,-15.03,0,67.58,-15.03,2,-43124,82024,125148,38900,0,-25985,1047,0,0,,27032,-24938
47,11/23/2017,86,21:15,21:30,110,11.37,0,110,11.37,2,-32224,47804,80028,15580,0,-4032,6958,0,0,,10990,2926
47,11/23/2017,87,21:30,21:45,,-40.76,0,-40.76,-40.76,-1,-29736,55173,84909,25437,0,-27921,0,0,0,,27921,-27921
47,11/23/2017,88,21:45,22:00,,15.45,0,15.45,15.45,-1,-42513,81344,123857,38831,0,-17061,0,0,0,,17061,-17061
47,11/23/2017,89,22:00,22:15,36.59,30.78,0,36.59,30.78,2,-56489,63797,120286,7308,0,-15144,303,0,0,,15447,-14841
47,11/23/2017,90,22:15,22:30,36.59,19.29,0,19.29,19.29,-1,-49676,87958,137634,38282,0,-19751,15,0,0,,19766,-19736
47,11/23/2017,91,22:30,22:45,,2.18,0,2.18,2.18,-1,-39138,103590,142728,64452,0,-51418,0,0,0,,51418,-51418
47,11/23/2017,92,22:45,23:00,,7.13,0,7.13,7.13,-1,-47487,128845,176332,81358,0,-73899,0,0,0,,73899,-73899
47,11/23/2017,93,23:00,23:15,107.21,7.13,0,107.21,107.21,1,-72853,32717,105570,-40136,0,-30631,8672,0,0,,39303,-21959
47,11/23/2017,94,23:15,23:30,107.21,2.21,0,2.21,2.21,-1,-37033,73120,110153,36087,0,-15045,1844,0,0,,16889,-13201
47,11/23/2017,95,23:30,23:45,35.56,27.99,0,36.5,27.99,2,-44011,69153,113164,25142,0,-20438,17,0,0,,20455,-20421
47,11/23/2017,96,23:45,0:00,,-45.36,0,-45.36,-45.36,-1,-38086,112457,150543,74371,0,-48722,0,0,0,,48722,-48722
47,11/24/2017,1,0:00,0:15,54.19,13.36,0,54.19,13.36,2,-41540,60221,101761,18681,0,-12965,2007,0,0,,14972,-10958
47,11/24/2017,2,0:15,0:30,40.09,12.93,0,40.09,12.93,2,-38271,43179,81450,4908,0,-14068,269,0,0,,14337,-13799
47,11/24/2017,3,0:30,0:45,,32.59,0,32.59,32.59,-1,-66903,82124,149027,15221,0,-4363,0,0,0,,4363,-4363
47,11/24/2017,4,0:45,1:00,,22.28,0,22.28,22.28,-1,-58395,100972,159367,42577,0,-33900,0,0,0,,33900,-33900
47,11/24/2017,5,1:00,1:15,,,0,36.71,36.71,0,-56897,65758,122655,8861,0,-16136,0,0,0,,16136,-16136
47,11/24/2017,6,1:15,1:30,41.57,,0,41.57,41.57,1,-58245,59730,117975,1485,0,0,129,0,0,,129,129
47,11/24/2017,7,1:30,1:45,35.59,,0,35.59,35.59,1,-64721,67180,131901,2459,0,0,29,0,0,,29,29
47,11/24/2017,8,1:45,2:00,,35.93,0,35.93,35.93,-1,-62085,77960,140045,15875,0,-7,0,0,0,,7,-7
47,11/24/2017,9,2:00,2:15,,,0,36.72,36.72,0,-44510,50753,95263,6243,0,-7,0,0,0,,7,-7
47,11/24/2017,10,2:15,2:30,,37.86,0,37.86,37.86,-1,-47019,57587,104606,10568,0,-5,0,0,0,,5,-5
47,11/24/2017,11,2:30,2:45,,34.67,0,34.67,34.67,-1,-41683,49881,91564,8198,0,-1914,0,0,0,,1914,-1914
47,11/24/2017,12,2:45,3:00,,32.93,0,32.93,32.93,-1,-55085,56410,111495,1325,0,-4866,0,0,0,,4866,-4866
47,11/24/2017,13,3:00,3:15,,29.83,0,29.83,29.83,-1,-24726,91811,116537,67085,0,-6640,0,0,0,,6640,-6640
47,11/24/2017,14,3:15,3:30,,32.93,0,32.93,32.93,-1,-43802,84577,128379,40775,0,-4116,0,0,0,,4116,-4116
47,11/24/2017,15,3:30,3:45,,37.87,0,37.87,37.87,-1,-49512,92028,141540,42516,0,-1606,0,0,0,,1606,-1606
47,11/24/2017,16,3:45,4:00,,32.59,0,32.59,32.59,-1,-50949,68435,119384,17486,0,-1263,0,0,0,,1263,-1263
47,11/24/2017,17,4:00,4:15,,32.59,0,32.59,32.59,-1,-23118,90800,113918,67682,0,-3028,0,0,0,,3028,-3028
47,11/24/2017,18,4:15,4:30,,,0,33.72,33.72,0,-43298,58005,101303,14707,0,0,0,0,0,,0,0
47,11/24/2017,19,4:30,4:45,,,0,33.71,33.71,0,-46150,51541,97691,5391,0,0,0,0,0,,0,0
47,11/24/2017,20,4:45,5:00,37,,0,37,37,1,-47731,50101,97832,2370,0,0,1310,0,0,,1310,1310
47,11/24/2017,21,5:00,5:15,37.99,,0,37.99,37.99,1,-66658,46391,113049,-20267,0,0,4022,0,0,,4022,4022
47,11/24/2017,22,5:15,5:30,,,0,33.72,33.72,0,-22223,67008,89231,44785,0,0,215,0,0,,215,215
47,11/24/2017,23,5:30,5:45,35.59,,0,35.59,35.59,1,-44653,46739,91392,2086,0,0,12,0,0,,12,12
47,11/24/2017,24,5:45,6:00,35.59,,0,35.59,35.59,1,-40006,53148,93154,13142,0,0,984,0,0,,984,984
47,11/24/2017,25,6:00,6:15,35.59,22.97,0,22.97,22.97,-1,-33394,95593,128987,62199,0,-13550,9,0,0,,13559,-13541
47,11/24/2017,26,6:15,6:30,,33.98,0,33.98,33.98,-1,-41887,85005,126892,43118,0,-1739,0,0,0,,1739,-1739
47,11/24/2017,27,6:30,6:45,62.12,33.98,0,62.12,33.98,2,-52187,35900,88087,-16287,0,-1098,4856,0,0,,5954,3758
47,11/24/2017,28,6:45,7:00,72.12,35.97,0,72.12,35.97,2,-77838,21496,99334,-56342,0,-13,12411,0,0,,12424,12398
47,11/24/2017,29,7:00,7:15,72.12,-37.03,0,-37.03,-37.03,-1,-43199,141179,184378,97980,0,-37577,209,0,0,,37786,-37368
47,11/24/2017,30,7:15,7:30,,28.03,0,28.03,28.03,-1,-57597,87336,144933,29739,0,-19348,0,0,0,,19348,-19348
47,11/24/2017,31,7:30,7:45,129.12,28.03,0,129.12,129.12,1,-78732,52845,131577,-25887,0,-3009,11587,0,0,,14596,8578
47,11/24/2017,32,7:45,8:00,368.33,34.43,0,368.33,34.43,2,-98174,60183,158357,-37991,0,-38,45481,0,0,,45519,45443
47,11/24/2017,33,8:00,8:15,368.33,-18.17,0,-18.17,-18.17,-1,-40898,98394,139292,57496,0,-27850,6423,0,0,,34273,-21427
47,11/24/2017,34,8:15,8:30,,28.98,0,28.98,28.98,-1,-43518,86410,129928,42892,0,-20217,0,0,0,,20217,-20217
47,11/24/2017,35,8:30,8:45,,32.98,0,32.98,32.98,-1,-36747,73411,110158,36664,0,-32269,0,0,0,,32269,-32269
47,11/24/2017,36,8:45,9:00,,34.78,0,34.78,34.78,-1,-42437,54504,96941,12067,0,-14054,0,0,0,,14054,-14054
47,11/24/2017,37,9:00,9:15,,34.78,0,34.78,34.78,-1,-40843,79595,120438,38752,0,-1329,0,0,0,,1329,-1329
47,11/24/2017,38,9:15,9:30,,33.98,0,33.98,33.98,-1,-43195,60825,104020,17630,0,-3445,0,0,0,,3445,-3445
47,11/24/2017,39,9:30,9:45,,34.07,0,34.07,34.07,-1,-44422,56749,101171,12327,0,-3911,0,0,0,,3911,-3911
47,11/24/2017,40,9:45,10:00,41.32,36.24,0,43.57,36.24,2,-57870,54340,112210,-3530,0,-2842,428,0,0,,3270,-2414
47,11/24/2017,41,10:00,10:15,41.24,36.24,0,41.24,41.24,1,-73881,80824,154705,6943,0,-95,487,0,0,,582,392
47,11/24/2017,42,10:15,10:30,38.95,36.24,0,43.77,36.24,2,-78551,79906,158457,1355,0,-1303,110,0,0,,1413,-1193
47,11/24/2017,43,10:30,10:45,39.13,,0,39.13,39.13,1,-78274,73836,152110,-4438,0,0,794,0,0,,794,794
47,11/24/2017,44,10:45,11:00,38.99,,0,38.99,38.99,1,-83590,63196,146786,-20394,0,0,693,0,0,,693,693
47,11/24/2017,45,11:00,11:15,,36.24,0,36.24,36.24,-1,-54999,61228,116227,6229,0,-107,0,0,0,,107,-107
47,11/24/2017,46,11:15,11:30,,34.92,0,34.92,34.92,-1,-62931,70447,133378,7516,0,-1478,0,0,0,,1478,-1478
47,11/24/2017,47,11:30,11:45,,34.92,0,34.92,34.92,-1,-60079,71500,131579,11421,0,-868,0,0,0,,868,-868
47,11/24/2017,48,11:45,12:00,,33.98,0,33.98,33.98,-1,-38098,85335,123433,47237,0,-919,0,0,0,,919,-919
47,11/24/2017,49,12:00,12:15,,33.98,0,33.98,33.98,-1,-80516,77455,157971,-3061,0,-1607,0,0,0,,1607,-1607
47,11/24/2017,50,12:15,12:30,,14.05,0,14.05,14.05,-1,-54681,113402,168083,58721,0,-4150,0,0,0,,4150,-4150
47,11/24/2017,51,12:30,12:45,,-15.57,0,-15.57,-15.57,-1,-54694,136063,190757,81369,0,-56077,0,0,0,,56077,-56077
47,11/24/2017,52,12:45,13:00,,29.78,0,29.78,29.78,-1,-32534,109187,141721,76653,0,-43748,0,0,0,,43748,-43748
47,11/24/2017,53,13:00,13:15,,11.43,0,11.43,11.43,-1,-36452,123562,160014,87110,0,-50297,0,0,0,,50297,-50297
47,11/24/2017,54,13:15,13:30,,21.64,0,21.64,21.64,-1,-50133,98948,149081,48815,0,-42544,0,0,0,,42544,-42544
47,11/24/2017,55,13:30,13:45,,28.98,0,28.98,28.98,-1,-41393,93072,134465,51679,0,-33621,0,0,0,,33621,-33621
47,11/24/2017,56,13:45,14:00,,32.19,0,32.19,32.19,-1,-45521,81278,126799,35757,0,-28408,0,0,0,,28408,-28408
47,11/24/2017,57,14:00,14:15,,51.69,0,51.69,51.69,-1,-55650,80503,136153,24853,0,-3982,0,0,0,,3982,-3982
47,11/24/2017,58,14:15,14:30,,33.98,0,33.98,33.98,-1,-32580,94620,127200,62040,0,-315,0,0,0,,315,-315
47,11/24/2017,59,14:30,14:45,,,0,43.79,43.79,0,-29937,99661,129598,69724,0,0,0,0,0,,0,0
47,11/24/2017,60,14:45,15:00,,34.06,0,34.06,34.06,-1,-33667,119356,153023,85689,0,-59,0,0,0,,59,-59
47,11/24/2017,61,15:00,15:15,,34.05,0,34.05,34.05,-1,-28046,96878,124924,68832,0,-354,0,0,0,,354,-354
47,11/24/2017,62,15:15,15:30,,51.59,0,51.59,51.59,-1,-33872,70250,104122,36378,0,-569,0,0,0,,569,-569
47,11/24/2017,63,15:30,15:45,,33.98,0,33.98,33.98,-1,-35775,72924,108699,37149,0,-2847,0,0,0,,2847,-2847
47,11/24/2017,64,15:45,16:00,,33.98,0,33.98,33.98,-1,-36730,59491,96221,22761,0,-2358,0,0,0,,2358,-2358
47,11/24/2017,65,16:00,16:15,,32.19,0,32.19,32.19,-1,-31526,58681,90207,27155,0,-15243,0,0,0,,15243,-15243
47,11/24/2017,66,16:15,16:30,,24.09,0,24.09,24.09,-1,-20308,73879,94187,53571,0,-23428,0,0,0,,23428,-23428
47,11/24/2017,67,16:30,16:45,,29.09,0,29.09,29.09,-1,-15675,74026,89701,58351,0,-14414,0,0,0,,14414,-14414
47,11/24/2017,68,16:45,17:00,47.79,29.09,0,47.79,47.79,1,-63371,72901,136272,9530,0,-862,1191,0,0,,2053,329
47,11/24/2017,69,17:00,17:15,47.79,32.19,0,32.19,32.19,-1,-44197,80052,124249,35855,0,-5627,50,0,0,,5677,-5577
47,11/24/2017,70,17:15,17:30,,,0,43.66,43.66,0,-46126,73230,119356,27104,0,-87,0,0,0,,87,-87
47,11/24/2017,71,17:30,17:45,,16.6,0,16.6,16.6,-1,-45521,93900,139421,48379,0,-16154,0,0,0,,16154,-16154
47,11/24/2017,72,17:45,18:00,,32.98,0,32.98,32.98,-1,-38440,78631,117071,40191,0,-10257,0,0,0,,10257,-10257
47,11/24/2017,73,18:00,18:15,714.86,34.09,0,714.86,34.09,2,-68824,20636,89460,-48188,0,-51,13051,0,0,,13102,13000
47,11/24/2017,74,18:15,18:30,714.86,29.26,0,29.26,29.26,-1,-51372,86941,138313,35569,0,-8495,388,0,0,,8883,-8107
47,11/24/2017,75,18:30,18:45,,2.84,0,2.84,2.84,-1,-29346,104451,133797,75105,0,-29097,0,0,0,,29097,-29097
47,11/24/2017,76,18:45,19:00,,4.09,0,4.09,4.09,-1,-50107,137785,187892,87678,0,-52026,0,0,0,,52026,-52026
47,11/24/2017,77,19:00,19:15,,30.83,0,30.83,30.83,-1,-48913,93328,142241,44415,0,-12500,0,0,0,,12500,-12500
47,11/24/2017,78,19:15,19:30,,4.09,0,4.09,4.09,-1,-32852,96616,129468,63764,0,-30417,0,0,0,,30417,-30417
47,11/24/2017,79,19:30,19:45,,23.24,0,23.24,23.24,-1,-42500,99326,141826,56826,0,-37295,0,0,0,,37295,-37295
47,11/24/2017,80,19:45,20:00,,26.92,0,26.92,26.92,-1,-55591,97235,152826,41644,0,-48559,0,0,0,,48559,-48559
47,11/24/2017,81,20:00,20:15,,32.98,0,32.98,32.98,-1,-55709,60528,116237,4819,0,-21170,0,0,0,,21170,-21170
47,11/24/2017,82,20:15,20:30,42.8,51.39,0,51.39,51.39,-1,-46206,49807,96013,3601,0,-22,12,0,0,,34,-10
47,11/24/2017,83,20:30,20:45,,33.98,0,33.98,33.98,-1,-51133,78910,130043,27777,0,-418,0,0,0,,418,-418
47,11/24/2017,84,20:45,21:00,,17.68,0,17.68,17.68,-1,-54109,112393,166502,58284,0,-31528,0,0,0,,31528,-31528
47,11/24/2017,85,21:00,21:15,42.9,17.68,0,42.9,42.9,1,-54606,49615,104221,-4991,0,-10144,907,0,0,,11051,-9237
47,11/24/2017,86,21:15,21:30,,,0,43.16,43.16,0,-33557,57156,90713,23599,0,0,0,0,0,,0,0
47,11/24/2017,87,21:30,21:45,,37.09,0,37.09,37.09,-1,-31895,79867,111762,47972,0,-157,0,0,0,,157,-157
47,11/24/2017,88,21:45,22:00,,33.98,0,33.98,33.98,-1,-36162,100400,136562,64238,0,-8012,0,0,0,,8012,-8012
47,11/24/2017,89,22:00,22:15,37.69,34.78,0,37.69,37.69,1,-74112,24628,98740,-49484,0,-4716,341,0,0,,5057,-4375
47,11/24/2017,90,22:15,22:30,38.8,,0,38.8,38.8,1,-57600,30101,87701,-27499,0,0,397,0,0,,397,397
47,11/24/2017,91,22:30,22:45,38.8,,0,38.8,38.8,1,-59291,46841,106132,-12450,0,0,1531,0,0,,1531,1531
47,11/24/2017,92,22:45,23:00,38.8,32.98,0,32.98,32.98,-1,-48706,61217,109923,12511,0,-1766,678,0,0,,2444,-1088
47,11/24/2017,93,23:00,23:15,,32.78,0,32.78,32.78,-1,-71121,14818,85939,-56303,0,-2516,0,0,0,,2516,-2516
47,11/24/2017,94,23:15,23:30,,51.49,0,51.49,51.49,-1,-39531,15621,55152,-23910,0,-3,0,0,0,,3,-3
47,11/24/2017,95,23:30,23:45,,33.98,0,33.98,33.98,-1,-35351,47412,82763,12061,0,-6447,0,0,0,,6447,-6447
47,11/24/2017,96,23:45,0:00,,2.41,0,2.41,2.41,-1,-30418,91855,122273,61437,0,-33815,0,0,0,,33815,-33815
48,11/25/2017,1,0:00,0:15,,-57.54,0,-57.54,-57.54,-1,-64634,95005,159639,30371,0,-40306,0,0,0,,40306,-40306
48,11/25/2017,2,0:15,0:30,,32.98,0,32.98,32.98,-1,-44803,67894,112697,23091,0,-8999,0,0,0,,8999,-8999
48,11/25/2017,3,0:30,0:45,,33.98,0,33.98,33.98,-1,-57057,69858,126915,12801,0,-11814,0,0,0,,11814,-11814
48,11/25/2017,4,0:45,1:00,,26.52,0,26.52,26.52,-1,-41800,85611,127411,43811,0,-30155,0,0,0,,30155,-30155
48,11/25/2017,5,1:00,1:15,42.8,31.56,0,42.8,31.56,2,-53561,39367,92928,-14194,0,-20687,893,0,0,,21580,-19794
48,11/25/2017,6,1:15,1:30,42.8,32.98,0,32.98,32.98,-1,-47796,61620,109416,13824,0,-5844,42,0,0,,5886,-5802
48,11/25/2017,7,1:30,1:45,,32.58,0,32.58,32.58,-1,-39304,76243,115547,36939,0,-26163,0,0,0,,26163,-26163
48,11/25/2017,8,1:45,2:00,,31.56,0,31.56,31.56,-1,-38362,84290,122652,45928,0,-36674,0,0,0,,36674,-36674
48,11/25/2017,9,2:00,2:15,59.49,33.98,0,59.49,33.98,2,-60885,49378,110263,-11507,0,-18356,2930,0,0,,21286,-15426
48,11/25/2017,10,2:15,2:30,59.49,34.14,0,34.14,34.14,-1,-54500,65048,119548,10548,0,-2370,801,0,0,,3171,-1569
48,11/25/2017,11,2:30,2:45,,33.98,0,33.98,33.98,-1,-50998,62362,113360,11364,0,-9569,0,0,0,,9569,-9569
48,11/25/2017,12,2:45,3:00,,33.98,0,33.98,33.98,-1,-54057,71955,126012,17898,0,-7203,0,0,0,,7203,-7203
48,11/25/2017,13,3:00,3:15,,35.16,0,35.16,35.16,-1,-50304,57898,108202,7594,0,-5011,0,0,0,,5011,-5011
48,11/25/2017,14,3:15,3:30,,33.98,0,33.98,33.98,-1,-51958,74485,126443,22527,0,-9626,0,0,0,,9626,-9626
48,11/25/2017,15,3:30,3:45,,32.98,0,32.98,32.98,-1,-51552,90207,141759,38655,0,-22844,0,0,0,,22844,-22844
48,11/25/2017,16,3:45,4:00,,32.98,0,32.98,32.98,-1,-43932,86028,129960,42096,0,-32026,0,0,0,,32026,-32026
48,11/25/2017,17,4:00,4:15,,33.49,0,33.49,33.49,-1,-45853,71049,116902,25196,0,-17604,0,0,0,,17604,-17604
48,11/25/2017,18,4:15,4:30,,33.98,0,33.98,33.98,-1,-51111,72579,123690,21468,0,-10297,0,0,0,,10297,-10297
48,11/25/2017,19,4:30,4:45,,33.98,0,33.98,33.98,-1,-49454,76140,125594,26686,0,-14859,0,0,0,,14859,-14859
48,11/25/2017,20,4:45,5:00,,28.98,0,28.98,28.98,-1,-46911,86596,133507,39685,0,-24729,0,0,0,,24729,-24729
48,11/25/2017,21,5:00,5:15,36.86,32.98,0,36.86,36.86,1,-57791,76750,134541,18959,0,-18535,81,0,0,,18616,-18454
48,11/25/2017,22,5:15,5:30,36.87,37.77,0,37.82,37.77,2,-37412,81898,119310,44486,0,-641,23,0,0,,664,-618
48,11/25/2017,23,5:30,5:45,,38.77,0,38.77,38.77,-1,-35462,75266,110728,39804,0,-321,0,0,0,,321,-321
48,11/25/2017,24,5:45,6:00,,34.54,0,34.54,34.54,-1,-39276,77671,116947,38395,0,-204,0,0,0,,204,-204
48,11/25/2017,25,6:00,6:15,,34.05,0,34.05,34.05,-1,-33339,121740,155079,88401,0,-4125,0,0,0,,4125,-4125
48,11/25/2017,26,6:15,6:30,,33.05,0,33.05,33.05,-1,-42469,134703,177172,92234,0,-4050,0,0,0,,4050,-4050
48,11/25/2017,27,6:30,6:45,,28.46,0,28.46,28.46,-1,-52499,123794,176293,71295,0,-23838,0,0,0,,23838,-23838
48,11/25/2017,28,6:45,7:00,,34.03,0,34.03,34.03,-1,-65643,112309,177952,46666,0,-18132,0,0,0,,18132,-18132
48,11/25/2017,29,7:00,7:15,,-43.71,0,-43.71,-43.71,-1,-25560,153360,178920,127800,0,-55930,0,0,0,,55930,-55930
48,11/25/2017,30,7:15,7:30,,20.3,0,20.3,20.3,-1,-48763,116165,164928,67402,0,-69044,0,0,0,,69044,-69044
48,11/25/2017,31,7:30,7:45,,31.08,0,31.08,31.08,-1,-63919,121893,185812,57974,0,-51704,0,0,0,,51704,-51704
48,11/25/2017,32,7:45,8:00,40.7,30.84,0,40.7,40.7,1,-92965,103334,196299,10369,0,-37498,157,0,0,,37655,-37341
48,11/25/2017,33,8:00,8:15,40.7,3.24,0,3.24,3.24,-1,-46891,144019,190910,97128,0,-34346,12,0,0,,34358,-34334
48,11/25/2017,34,8:15,8:30,38.87,33.05,0,43.66,33.05,2,-78877,101914,180791,23037,0,-23071,93,0,0,,23164,-22978
48,11/25/2017,35,8:30,8:45,40.38,33.05,0,40.38,40.38,1,-77006,84042,161048,7036,0,-416,386,0,0,,802,-30
48,11/25/2017,36,8:45,9:00,,49.78,0,49.78,49.78,-1,-74516,63213,137729,-11303,0,-11,0,0,0,,11,-11
48,11/25/2017,37,9:00,9:15,,33.05,0,33.05,33.05,-1,-34099,123971,158070,89872,0,-4085,0,0,0,,4085,-4085
48,11/25/2017,38,9:15,9:30,,34.05,0,34.05,34.05,-1,-39400,83953,123353,44553,0,-1714,0,0,0,,1714,-1714
48,11/25/2017,39,9:30,9:45,,36.46,0,36.46,36.46,-1,-37926,86520,124446,48594,0,-2045,0,0,0,,2045,-2045
48,11/25/2017,40,9:45,10:00,,33.05,0,33.05,33.05,-1,-47193,112141,159334,64948,0,-6561,0,0,0,,6561,-6561
48,11/25/2017,41,10:00,10:15,,34.05,0,34.05,34.05,-1,-33554,118930,152484,85376,0,-1288,0,0,0,,1288,-1288
48,11/25/2017,42,10:15,10:30,,36.46,0,36.46,36.46,-1,-47210,67427,114637,20217,0,-554,0,0,0,,554,-554
48,11/25/2017,43,10:30,10:45,,33.05,0,33.05,33.05,-1,-37851,69821,107672,31970,0,-9739,0,0,0,,9739,-9739
48,11/25/2017,44,10:45,11:00,,18.46,0,18.46,18.46,-1,-25810,99132,124942,73322,0,-40230,0,0,0,,40230,-40230
48,11/25/2017,45,11:00,11:15,,28.46,0,28.46,28.46,-1,-36546,85966,122512,49420,0,-39415,0,0,0,,39415,-39415
48,11/25/2017,46,11:15,11:30,,,0,43.66,43.66,0,-31861,78135,109996,46274,0,-3680,0,0,0,,3680,-3680
48,11/25/2017,47,11:30,11:45,,,0,43.66,43.66,0,-28877,68173,97050,39296,0,0,0,0,0,,0,0
48,11/25/2017,48,11:45,12:00,43.46,,0,43.46,43.46,1,-45136,59298,104434,14162,0,0,998,0,0,,998,998
48,11/25/2017,49,12:00,12:15,36.8,,0,36.8,36.8,1,-49259,30969,80228,-18290,0,0,156,0,0,,156,156
48,11/25/2017,50,12:15,12:30,42.87,,0,42.87,42.87,1,-58328,34688,93016,-23640,0,0,771,0,0,,771,771
48,11/25/2017,51,12:30,12:45,80.57,,0,80.57,80.57,1,-75691,41976,117667,-33715,0,0,11489,0,0,,11489,11489
48,11/25/2017,52,12:45,13:00,40.98,34.97,0,43.66,34.97,2,-67995,78094,146089,10099,0,-394,10550,0,0,,10944,10156
48,11/25/2017,53,13:00,13:15,40.98,33.05,0,33.05,33.05,-1,-51393,79000,130393,27607,0,-2809,210,0,0,,3019,-2599
48,11/25/2017,54,13:15,13:30,,,0,43.66,43.66,0,-99819,35182,135001,-64637,0,0,0,0,0,,0,0
48,11/25/2017,55,13:30,13:45,45.94,,0,45.94,45.94,1,-148794,42248,191042,-106546,0,0,7723,0,0,,7723,7723
48,11/25/2017,56,13:45,14:00,39.47,,0,39.47,39.47,1,-125750,42155,167905,-83595,0,0,9604,0,0,,9604,9604
48,11/25/2017,57,14:00,14:15,38.87,,0,38.87,38.87,1,-134780,46218,180998,-88562,0,0,489,0,0,,489,489
48,11/25/2017,58,14:15,14:30,38.87,,0,38.87,38.87,1,-135403,53287,188690,-82116,0,0,1006,0,0,,1006,1006
48,11/25/2017,59,14:30,14:45,,,0,43.67,43.67,0,-117053,67613,184666,-49440,0,0,0,0,0,,0,0
48,11/25/2017,60,14:45,15:00,,,0,43.67,43.67,0,-94081,80943,175024,-13138,0,0,0,0,0,,0,0
48,11/25/2017,61,15:00,15:15,38.87,,0,38.87,38.87,1,-88533,64563,153096,-23970,0,0,179,0,0,,179,179
48,11/25/2017,62,15:15,15:30,38.88,,0,38.88,38.88,1,-88020,63821,151841,-24199,0,0,1921,0,0,,1921,1921
48,11/25/2017,63,15:30,15:45,39.99,,0,39.99,39.99,1,-84814,81855,166669,-2959,0,0,1027,0,0,,1027,1027
48,11/25/2017,64,15:45,16:00,52.05,36.46,0,52.05,36.46,2,-87496,52694,140190,-34802,0,-31,17208,0,0,,17239,17177
48,11/25/2017,65,16:00,16:15,52.05,31.56,0,31.56,31.56,-1,-73150,107843,180993,34693,0,-3555,3574,0,0,,7129,19
48,11/25/2017,66,16:15,16:30,,36.46,0,36.46,36.46,-1,-52133,127011,179144,74878,0,-357,0,0,0,,357,-357
48,11/25/2017,67,16:30,16:45,,,0,43.66,43.66,0,-47604,140385,187989,92781,0,-171,0,0,0,,171,-171
48,11/25/2017,68,16:45,17:00,,,0,43.66,43.66,0,-81747,125759,207506,44012,0,0,0,0,0,,0,0
48,11/25/2017,69,17:00,17:15,,18.46,0,18.46,18.46,-1,-100848,160884,261732,60036,0,-21180,0,0,0,,21180,-21180
48,11/25/2017,70,17:15,17:30,,28.31,0,28.31,28.31,-1,-68476,138712,207188,70236,0,-31715,0,0,0,,31715,-31715
48,11/25/2017,71,17:30,17:45,,23.46,0,23.46,23.46,-1,-59452,123097,182549,63645,0,-18652,0,0,0,,18652,-18652
48,11/25/2017,72,17:45,18:00,,33.05,0,33.05,33.05,-1,-37570,127015,164585,89445,0,-18052,0,0,0,,18052,-18052
48,11/25/2017,73,18:00,18:15,,-36.54,0,-36.54,-36.54,-1,-63308,146082,209390,82774,0,-42061,0,0,0,,42061,-42061
48,11/25/2017,74,18:15,18:30,,13.46,0,13.46,13.46,-1,-86483,125737,212220,39254,0,-51145,0,0,0,,51145,-51145
48,11/25/2017,75,18:30,18:45,,-27.89,0,-27.89,-27.89,-1,-60528,146379,206907,85851,0,-33798,0,0,0,,33798,-33798
48,11/25/2017,76,18:45,19:00,,-27.89,0,-27.89,-27.89,-1,-63473,146487,209960,83014,0,-77617,0,0,0,,77617,-77617
48,11/25/2017,77,19:00,19:15,42.87,35.03,0,42.87,35.03,2,-68107,68638,136745,531,0,-25810,1053,0,0,,26863,-24757
48,11/25/2017,78,19:15,19:30,,30.83,0,30.83,30.83,-1,-57691,71285,128976,13594,0,-11020,0,0,0,,11020,-11020
48,11/25/2017,79,19:30,19:45,,,0,37.78,37.78,0,-94838,60991,155829,-33847,0,-357,0,0,0,,357,-357
48,11/25/2017,80,19:45,20:00,,,0,37.78,37.78,0,-100968,85600,186568,-15368,0,0,0,0,0,,0,0
48,11/25/2017,81,20:00,20:15,80.02,,0,80.02,80.02,1,-99213,39515,138728,-59698,0,0,4304,0,0,,4304,4304
48,11/25/2017,82,20:15,20:30,80.02,34.05,0,34.05,34.05,-1,-78240,92620,170860,14380,0,-5116,12,0,0,,5128,-5104
48,11/25/2017,83,20:30,20:45,,18.46,0,18.46,18.46,-1,-84251,136597,220848,52346,0,-31819,0,0,0,,31819,-31819
48,11/25/2017,84,20:45,21:00,,34.03,0,34.03,34.03,-1,-83711,113324,197035,29613,0,-27709,0,0,0,,27709,-27709
48,11/25/2017,85,21:00,21:15,39.86,23.46,0,43.6,23.46,2,-68844,75955,144799,7111,0,-16751,1128,0,0,,17879,-15623
48,11/25/2017,86,21:15,21:30,39.86,33.05,0,33.05,33.05,-1,-57544,79113,136657,21569,0,-5928,164,0,0,,6092,-5764
48,11/25/2017,87,21:30,21:45,,32.77,0,32.77,32.77,-1,-39736,71548,111284,31812,0,-22072,0,0,0,,22072,-22072
48,11/25/2017,88,21:45,22:00,,15.9,0,15.9,15.9,-1,-45844,110727,156571,64883,0,-54851,0,0,0,,54851,-54851
48,11/25/2017,89,22:00,22:15,,27.03,0,27.03,27.03,-1,-72628,106160,178788,33532,0,-33337,0,0,0,,33337,-33337
48,11/25/2017,90,22:15,22:30,,9.5,0,9.5,9.5,-1,-40074,115378,155452,75304,0,-46504,0,0,0,,46504,-46504
48,11/25/2017,91,22:30,22:45,,-19.18,0,-19.18,-19.18,-1,-40805,146220,187025,105415,0,-72020,0,0,0,,72020,-72020
48,11/25/2017,92,22:45,23:00,,-0.84,0,-0.84,-0.84,-1,-68340,120341,188681,52001,0,-59619,0,0,0,,59619,-59619
48,11/25/2017,93,23:00,23:15,,33.05,0,33.05,33.05,-1,-80332,87625,167957,7293,0,-7951,0,0,0,,7951,-7951
48,11/25/2017,94,23:15,23:30,,13.46,0,13.46,13.46,-1,-67259,106728,173987,39469,0,-9673,0,0,0,,9673,-9673
48,11/25/2017,95,23:30,23:45,,7.95,0,7.95,7.95,-1,-66966,140508,207474,73542,0,-48768,0,0,0,,48768,-48768
48,11/25/2017,96,23:45,0:00,,0.03,0,0.03,0.03,-1,-50791,99725,150516,48934,0,-65251,0,0,0,,65251,-65251
48,11/26/2017,1,0:00,0:15,,27.78,0,27.78,27.78,-1,-75612,117806,193418,42194,0,-16249,0,0,0,,16249,-16249
48,11/26/2017,2,0:15,0:30,98.67,27.78,0,98.67,98.67,1,-135252,82394,217646,-52858,0,-901,10943,0,0,,11844,10042
48,11/26/2017,3,0:30,0:45,35.33,33.55,0,33.55,33.55,-1,-86898,78386,165284,-8512,0,-963,4634,0,0,,5597,3671
48,11/26/2017,4,0:45,1:00,,28.86,0,28.86,28.86,-1,-68745,74473,143218,5728,0,-14591,0,0,0,,14591,-14591
48,11/26/2017,5,1:00,1:15,64.4,28.86,0,64.4,64.4,1,-78574,55355,133929,-23219,0,-2098,10714,0,0,,12812,8616
48,11/26/2017,6,1:15,1:30,64.4,33.33,0,33.33,33.33,-1,-53791,47925,101716,-5866,0,-314,2813,0,0,,3127,2499
48,11/26/2017,7,1:30,1:45,,32.33,0,32.33,32.33,-1,-42206,68174,110380,25968,0,-11613,0,0,0,,11613,-11613
48,11/26/2017,8,1:45,2:00,,24.9,0,24.9,24.9,-1,-39999,63157,103156,23158,0,-34986,0,0,0,,34986,-34986
48,11/26/2017,9,2:00,2:15,44.63,32.78,0,44.63,44.63,1,-54055,89665,143720,35610,0,-18309,178,0,0,,18487,-18131
48,11/26/2017,10,2:15,2:30,51.57,32.78,0,51.57,51.57,1,-78683,54636,133319,-24047,0,-81,3059,0,0,,3140,2978
48,11/26/2017,11,2:30,2:45,,33.33,0,33.33,33.33,-1,-51339,64714,116053,13375,0,-1449,0,0,0,,1449,-1449
48,11/26/2017,12,2:45,3:00,,34.73,0,34.73,34.73,-1,-62939,63971,126910,1032,0,-844,0,0,0,,844,-844
48,11/26/2017,13,3:00,3:15,,33.78,0,33.78,33.78,-1,-50137,53539,103676,3402,0,-1052,0,0,0,,1052,-1052
48,11/26/2017,14,3:15,3:30,,6.95,0,6.95,6.95,-1,-33034,70365,103399,37331,0,-15397,0,0,0,,15397,-15397
48,11/26/2017,15,3:30,3:45,,22.41,0,22.41,22.41,-1,-33965,78785,112750,44820,0,-46976,0,0,0,,46976,-46976
48,11/26/2017,16,3:45,4:00,,23.07,0,23.07,23.07,-1,-29988,74839,104827,44851,0,-31533,0,0,0,,31533,-31533
48,11/26/2017,17,4:00,4:15,45.33,30.5,0,45.33,45.33,1,-42552,40354,82906,-2198,0,-22656,645,0,0,,23301,-22011
48,11/26/2017,18,4:15,4:30,62.42,30.5,0,62.42,62.42,1,-54022,35760,89782,-18262,0,-582,9551,0,0,,10133,8969
48,11/26/2017,19,4:30,4:45,39.33,34.9,0,39.33,33.11,2,-41672,32236,73908,-9436,0,-290,1066,0,0,,1356,776
48,11/26/2017,20,4:45,5:00,39.33,,0,39.33,39.33,1,-62296,32950,95246,-29346,0,0,4537,0,0,,4537,4537
48,11/26/2017,21,5:00,5:15,77.86,,0,77.86,77.86,1,-73940,29107,103047,-44833,0,0,15334,0,0,,15334,15334
48,11/26/2017,22,5:15,5:30,45.17,,0,45.17,45.17,1,-64824,42872,107696,-21952,0,0,12758,0,0,,12758,12758
48,11/26/2017,23,5:30,5:45,90.12,,0,90.12,90.12,1,-76096,38426,114522,-37670,0,0,21343,0,0,,21343,21343
48,11/26/2017,24,5:45,6:00,45.33,,0,45.33,45.33,1,-73778,44302,118080,-29476,0,0,11076,0,0,,11076,11076
48,11/26/2017,25,6:00,6:15,38.04,32.53,0,38.04,32.53,2,-58979,63462,122441,4483,0,-3099,7073,0,0,,10172,3974
48,11/26/2017,26,6:15,6:30,38.04,33.78,0,33.78,33.78,-1,-51105,48948,100053,-2157,0,-2214,3,0,0,,2217,-2211
48,11/26/2017,27,6:30,6:45,,,0,33.11,33.11,0,-79721,54879,134600,-24842,0,-1,0,0,0,,1,-1
48,11/26/2017,28,6:45,7:00,35.53,,0,35.53,35.53,1,-94953,63352,158305,-31601,0,0,94,0,0,,94,94
48,11/26/2017,29,7:00,7:15,29.65,36.6,0,36.6,36.6,-1,-76306,64901,141207,-11405,0,-6,47,0,0,,53,41
48,11/26/2017,30,7:15,7:30,,36.55,0,36.55,36.55,-1,-79963,54032,133995,-25931,0,-75,0,0,0,,75,-75
48,11/26/2017,31,7:30,7:45,,,0,33.11,33.11,0,-103871,52111,155982,-51760,0,0,0,0,0,,0,0
48,11/26/2017,32,7:45,8:00,100.15,,0,100.15,100.15,1,-148372,44726,193098,-103646,0,0,8223,0,0,,8223,8223
48,11/26/2017,33,8:00,8:15,243.26,,0,243.26,243.26,1,-181963,50974,232937,-130989,0,0,39983,0,0,,39983,39983
48,11/26/2017,34,8:15,8:30,35.53,,0,35.53,35.53,1,-113632,39504,153136,-74128,0,0,3182,0,0,,3182,3182
48,11/26/2017,35,8:30,8:45,243.26,,0,243.26,243.26,1,-97559,37931,135490,-59628,0,0,23121,0,0,,23121,23121
48,11/26/2017,36,8:45,9:00,41.79,23.86,0,41.79,23.86,2,-59172,70998,130170,11826,0,-3710,9668,0,0,,13378,5958
48,11/26/2017,37,9:00,9:15,39.56,34.84,0,39.56,34.84,2,-50184,57243,107427,7059,0,-804,246,0,0,,1050,-558
48,11/26/2017,38,9:15,9:30,45.69,36.53,0,45.69,36.03,2,-67494,57781,125275,-9713,0,-26,4983,0,0,,5009,4957
48,11/26/2017,39,9:30,9:45,47.06,36.5,0,47.06,47.06,1,-63921,45676,109597,-18245,0,-51,4247,0,0,,4298,4196
48,11/26/2017,40,9:45,10:00,248.54,,0,248.54,248.54,1,-100811,21563,122374,-79248,0,0,27555,0,0,,27555,27555
48,11/26/2017,41,10:00,10:15,450,,0,450,450,1,-123287,39833,163120,-83454,0,0,76045,0,0,,76045,76045
48,11/26/2017,42,10:15,10:30,40.7,-8.34,0,40.7,-8.34,2,-69541,79624,149165,10083,0,-10408,26776,0,0,,37184,16368
48,11/26/2017,43,10:30,10:45,450,-8.34,0,450,450,1,-105765,44177,149942,-61588,0,-385,25651,0,0,,26036,25266
48,11/26/2017,44,10:45,11:00,41.79,,0,41.79,41.79,1,-104760,67368,172128,-37392,0,0,12071,0,0,,12071,12071
48,11/26/2017,45,11:00,11:15,46.84,,0,46.84,46.84,1,-78427,58930,137357,-19497,0,0,4719,0,0,,4719,4719
48,11/26/2017,46,11:15,11:30,93.12,,0,93.12,93.12,1,-88916,53285,142201,-35631,0,0,29260,0,0,,29260,29260
48,11/26/2017,47,11:30,11:45,40.7,33.67,0,40.7,33.67,2,-74061,66841,140902,-7220,0,-1799,8576,0,0,,10375,6777
48,11/26/2017,48,11:45,12:00,43.9,,0,43.9,43.9,1,-66126,44466,110592,-21660,0,0,6429,0,0,,6429,6429
48,11/26/2017,49,12:00,12:15,,,0,45.08,45.08,0,-77094,78292,155386,1198,0,0,1153,0,0,,1153,1153
48,11/26/2017,50,12:15,12:30,,,0,45.07,45.07,0,-100610,73406,174016,-27204,0,0,0,0,0,,0,0
48,11/26/2017,51,12:30,12:45,40.38,,0,40.38,40.38,1,-84069,62782,146851,-21287,0,0,720,0,0,,720,720
48,11/26/2017,52,12:45,13:00,35.53,,0,35.53,35.53,1,-100675,68733,169408,-31942,0,0,693,0,0,,693,693
48,11/26/2017,53,13:00,13:15,41.79,,0,41.79,41.79,1,-79544,82725,162269,3181,0,0,464,0,0,,464,464
48,11/26/2017,54,13:15,13:30,35.53,,0,35.53,35.53,1,-84939,78453,163392,-6486,0,0,679,0,0,,679,679
48,11/26/2017,55,13:30,13:45,,,0,36.1,36.1,0,-66520,105210,171730,38690,0,0,8,0,0,,8,8
48,11/26/2017,56,13:45,14:00,,33.67,0,33.67,33.67,-1,-82959,97562,180521,14603,0,-659,0,0,0,,659,-659
48,11/26/2017,57,14:00,14:15,41.79,33.67,0,41.79,33.67,2,-84396,66542,150938,-17854,0,-926,1243,0,0,,2169,317
48,11/26/2017,58,14:15,14:30,40.52,,0,40.52,40.52,1,-86003,72947,158950,-13056,0,0,4580,0,0,,4580,4580
48,11/26/2017,59,14:30,14:45,43.33,,0,43.33,43.33,1,-97152,76165,173317,-20987,0,0,10397,0,0,,10397,10397
48,11/26/2017,60,14:45,15:00,87.12,,0,87.12,87.12,1,-128886,89166,218052,-39720,0,0,27805,0,0,,27805,27805
48,11/26/2017,61,15:00,15:15,50.12,33.67,0,33.67,33.67,-1,-69354,87771,157125,18417,0,-1342,21906,0,0,,23248,20564
48,11/26/2017,62,15:15,15:30,,,0,37.2,37.2,0,-73176,104898,178074,31722,0,-502,349,0,0,,851,-153
48,11/26/2017,63,15:30,15:45,,,0,37.2,37.2,0,-67637,94915,162552,27278,0,0,0,0,0,,0,0
48,11/26/2017,64,15:45,16:00,,,0,37.2,37.2,0,-65367,85971,151338,20604,0,0,0,0,0,,0,0
48,11/26/2017,65,16:00,16:15,,28.53,0,28.53,28.53,-1,-47822,121874,169696,74052,0,-8629,0,0,0,,8629,-8629
48,11/26/2017,66,16:15,16:30,35.53,33.53,0,37.21,33.53,2,-58954,76004,134958,17050,0,-2136,29,0,0,,2165,-2107
48,11/26/2017,67,16:30,16:45,107.12,33.53,0,107.12,107.12,1,-93939,60722,154661,-33217,0,-36,9247,0,0,,9283,9211
48,11/26/2017,68,16:45,17:00,237.27,,0,237.27,237.27,1,-136083,35069,171152,-101014,0,0,62952,0,0,,62952,62952
48,11/26/2017,69,17:00,17:15,237.27,-13.9,0,-13.9,-13.9,-1,-54390,101224,155614,46834,0,-14171,34867,0,0,,49038,20696
48,11/26/2017,70,17:15,17:30,40.47,54.54,0,45.04,45.04,2,-67387,58829,126216,-8558,0,-2756,462,0,0,,3218,-2294
48,11/26/2017,71,17:30,17:45,115.12,,0,115.12,115.12,1,-75923,38927,114850,-36996,0,0,9366,0,0,,9366,9366
48,11/26/2017,72,17:45,18:00,47.12,,0,47.12,47.12,1,-57381,53186,110567,-4195,0,0,13928,0,0,,13928,13928
48,11/26/2017,73,18:00,18:15,150.81,,0,150.81,150.81,1,-80669,42884,123553,-37785,0,0,10604,0,0,,10604,10604
48,11/26/2017,74,18:15,18:30,54.12,,0,54.12,54.12,1,-81966,54659,136625,-27307,0,0,10342,0,0,,10342,10342
48,11/26/2017,75,18:30,18:45,54.12,32.53,0,32.53,32.53,-1,-61694,78223,139917,16529,0,-6067,3417,0,0,,9484,-2650
48,11/26/2017,76,18:45,19:00,,33.53,0,33.53,33.53,-1,-50347,79370,129717,29023,0,-9635,0,0,0,,9635,-9635
48,11/26/2017,77,19:00,19:15,48.7,33.46,0,48.7,33.46,2,-68508,53404,121912,-15104,0,-6931,2636,0,0,,9567,-4295
48,11/26/2017,78,19:15,19:30,35.53,33.46,0,45.03,33.46,2,-53156,62585,115741,9429,0,-3310,1842,0,0,,5152,-1468
48,11/26/2017,79,19:30,19:45,,29.73,0,29.73,29.73,-1,-54097,68985,123082,14888,0,-5974,0,0,0,,5974,-5974
48,11/26/2017,80,19:45,20:00,,20.05,0,20.05,20.05,-1,-61788,83585,145373,21797,0,-26596,0,0,0,,26596,-26596
48,11/26/2017,81,20:00,20:15,39.7,8.67,0,39.7,8.67,2,-44373,82458,126831,38085,0,-14402,61,0,0,,14463,-14341
48,11/26/2017,82,20:15,20:30,55.5,8.67,0,55.5,8.67,2,-67857,58133,125990,-9724,0,-17226,1938,0,0,,19164,-15288
48,11/26/2017,83,20:30,20:45,40.08,,0,40.08,40.08,1,-77198,63406,140604,-13792,0,0,3069,0,0,,3069,3069
48,11/26/2017,84,20:45,21:00,35.53,33.53,0,37.17,33.53,2,-62028,79213,141241,17185,0,-2721,471,0,0,,3192,-2250
48,11/26/2017,85,21:00,21:15,265.53,38.77,0,265.53,37.15,2,-104750,42286,147036,-62464,0,-692,17127,0,0,,17819,16435
48,11/26/2017,86,21:15,21:30,43.9,,0,43.9,43.9,1,-87255,62501,149756,-24754,0,0,11183,0,0,,11183,11183
48,11/26/2017,87,21:30,21:45,,,0,37.16,37.16,0,-72167,63677,135844,-8490,0,0,0,0,0,,0,0
48,11/26/2017,88,21:45,22:00,,35.78,0,35.78,35.78,-1,-74660,72053,146713,-2607,0,-351,0,0,0,,351,-351
48,11/26/2017,89,22:00,22:15,,33.78,0,33.78,33.78,-1,-95774,90916,186690,-4858,0,-533,0,0,0,,533,-533
48,11/26/2017,90,22:15,22:30,,33.53,0,33.53,33.53,-1,-47838,82579,130417,34741,0,-847,0,0,0,,847,-847
48,11/26/2017,91,22:30,22:45,,33.53,0,33.53,33.53,-1,-48801,63278,112079,14477,0,-949,0,0,0,,949,-949
48,11/26/2017,92,22:45,23:00,,11.69,0,11.69,11.69,-1,-58555,108899,167454,50344,0,-14643,0,0,0,,14643,-14643
48,11/26/2017,93,23:00,23:15,41.79,-3.67,0,45.03,-3.67,2,-42228,65313,107541,23085,0,-36814,137,0,0,,36951,-36677
48,11/26/2017,94,23:15,23:30,47.76,-3.67,0,47.76,47.76,1,-74555,62284,136839,-12271,0,-1793,2525,0,0,,4318,732
48,11/26/2017,95,23:30,23:45,35.53,19.85,0,19.85,19.85,-1,-53034,80355,133389,27321,0,-12119,260,0,0,,12379,-11859
48,11/26/2017,96,23:45,0:00,,21.11,0,21.11,21.11,-1,-52307,84877,137184,32570,0,-34117,0,0,0,,34117,-34117
48,11/27/2017,1,0:00,0:15,,-71.59,0,-71.59,-71.59,-1,-56665,140541,197206,83876,0,-47251,0,0,0,,47251,-47251
48,11/27/2017,2,0:15,0:30,,27.68,0,27.68,27.68,-1,-37319,69522,106841,32203,0,-19366,0,0,0,,19366,-19366
48,11/27/2017,3,0:30,0:45,,20.7,0,20.7,20.7,-1,-47863,70475,118338,22612,0,-30309,0,0,0,,30309,-30309
48,11/27/2017,4,0:45,1:00,,24.56,0,24.56,24.56,-1,-42470,88369,130839,45899,0,-19824,0,0,0,,19824,-19824
48,11/27/2017,5,1:00,1:15,133.08,24.56,0,133.08,133.08,1,-98461,24731,123192,-73730,0,-7453,17045,0,0,,24498,9592
48,11/27/2017,6,1:15,1:30,118.72,,0,118.72,118.72,1,-91803,45924,137727,-45879,0,0,48316,0,0,,48316,48316
48,11/27/2017,7,1:30,1:45,54.93,,0,54.93,54.93,1,-85505,39836,125341,-45669,0,0,27372,0,0,,27372,27372
48,11/27/2017,8,1:45,2:00,41.77,,0,41.77,41.77,1,-73745,45113,118858,-28632,0,0,18350,0,0,,18350,18350
48,11/27/2017,9,2:00,2:15,40.5,,0,40.5,40.5,1,-52259,47170,99429,-5089,0,0,3147,0,0,,3147,3147
48,11/27/2017,10,2:15,2:30,51.97,,0,51.97,51.97,1,-80406,49460,129866,-30946,0,0,21920,0,0,,21920,21920
48,11/27/2017,11,2:30,2:45,55.97,,0,55.97,55.97,1,-92361,42128,134489,-50233,0,0,33561,0,0,,33561,33561
48,11/27/2017,12,2:45,3:00,45.02,36.6,0,36.6,36.6,-1,-82647,49198,131845,-33449,0,-7,26817,0,0,,26824,26810
48,11/27/2017,13,3:00,3:15,98.81,32.53,0,98.81,32.53,2,-68384,48852,117236,-19532,0,-1600,5628,0,0,,7228,4028
48,11/27/2017,14,3:15,3:30,117.02,,0,117.02,117.02,1,-81815,44482,126297,-37333,0,0,36807,0,0,,36807,36807
48,11/27/2017,15,3:30,3:45,35.53,22.7,0,35.53,22.7,2,-50087,52609,102696,2522,0,-3082,5636,0,0,,8718,2554
48,11/27/2017,16,3:45,4:00,35.53,27.57,0,27.57,27.57,-1,-40894,63263,104157,22369,0,-9059,5,0,0,,9064,-9054
48,11/27/2017,17,4:00,4:15,31.68,32.03,0,33.4,32.03,2,-58844,59184,118028,340,0,-21387,159,0,0,,21546,-21228
48,11/27/2017,18,4:15,4:30,74.99,32.03,0,74.99,74.99,1,-73805,56023,129828,-17782,0,-2184,14363,0,0,,16547,12179
48,11/27/2017,19,4:30,4:45,74.99,32.53,0,32.53,32.53,-1,-55759,64288,120047,8529,0,-656,2691,0,0,,3347,2035
48,11/27/2017,20,4:45,5:00,,15.01,0,15.01,15.01,-1,-47450,76244,123694,28794,0,-9375,0,0,0,,9375,-9375
48,11/27/2017,21,5:00,5:15,,18.63,0,18.63,18.63,-1,-40032,53760,93792,13728,0,-15892,0,0,0,,15892,-15892
48,11/27/2017,22,5:15,5:30,,16.95,0,16.95,16.95,-1,-40078,64156,104234,24078,0,-26620,0,0,0,,26620,-26620
48,11/27/2017,23,5:30,5:45,35.53,16.95,0,35.53,35.53,1,-61868,60771,122639,-1097,0,-8624,465,0,0,,9089,-8159
48,11/27/2017,24,5:45,6:00,30.47,33.53,0,33.47,33.47,2,-72469,75437,147906,2968,0,-300,124,0,0,,424,-176
48,11/27/2017,25,6:00,6:15,,-2.06,0,-2.06,-2.06,-1,-58721,109563,168284,50842,0,-11112,0,0,0,,11112,-11112
48,11/27/2017,26,6:15,6:30,,-26.07,0,-26.07,-26.07,-1,-45349,74455,119804,29106,0,-36317,0,0,0,,36317,-36317
48,11/27/2017,27,6:30,6:45,,32.37,0,32.37,32.37,-1,-44568,68060,112628,23492,0,-10270,0,0,0,,10270,-10270
48,11/27/2017,28,6:45,7:00,98.02,32.37,0,98.02,98.02,1,-80328,47887,128215,-32441,0,-1996,14311,0,0,,16307,12315
48,11/27/2017,29,7:00,7:15,98.02,-43.19,0,-43.19,-43.19,-1,-58935,157418,216353,98483,0,-34169,4117,0,0,,38286,-30052
48,11/27/2017,30,7:15,7:30,,-2.27,0,-2.27,-2.27,-1,-52927,119831,172758,66904,0,-58417,0,0,0,,58417,-58417
48,11/27/2017,31,7:30,7:45,,30.14,0,30.14,30.14,-1,-60511,90654,151165,30143,0,-39921,0,0,0,,39921,-39921
48,11/27/2017,32,7:45,8:00,,35.08,0,35.08,35.08,-1,-55984,65888,121872,9904,0,-6358,0,0,0,,6358,-6358
48,11/27/2017,33,8:00,8:15,37.13,27.47,0,37.13,27.47,2,-84273,99214,183487,14941,0,-2691,23,0,0,,2714,-2668
48,11/27/2017,34,8:15,8:30,,-16.95,0,-16.95,-16.95,-1,-58557,103443,162000,44886,0,-42846,0,0,0,,42846,-42846
48,11/27/2017,35,8:30,8:45,,1.23,0,1.23,1.23,-1,-43057,102566,145623,59509,0,-27659,0,0,0,,27659,-27659
48,11/27/2017,36,8:45,9:00,,31.61,0,31.61,31.61,-1,-39198,71969,111167,32771,0,-33022,0,0,0,,33022,-33022
48,11/27/2017,37,9:00,9:15,,31.99,0,31.99,31.99,-1,-71213,107964,179177,36751,0,-22868,0,0,0,,22868,-22868
48,11/27/2017,38,9:15,9:30,,28.63,0,28.63,28.63,-1,-54406,87296,141702,32890,0,-31263,0,0,0,,31263,-31263
48,11/27/2017,39,9:30,9:45,,32.71,0,32.71,32.71,-1,-54018,83349,137367,29331,0,-34422,0,0,0,,34422,-34422
48,11/27/2017,40,9:45,10:00,37.37,34.3,0,37.37,37.37,1,-68647,67780,136427,-867,0,-19999,1,0,0,,20000,-19998
48,11/27/2017,41,10:00,10:15,65.02,34.3,0,65.02,65.02,1,-85392,55566,140958,-29826,0,-1095,11368,0,0,,12463,10273
48,11/27/2017,42,10:15,10:30,99.02,,0,99.02,99.02,1,-98177,56308,154485,-41869,0,0,19642,0,0,,19642,19642
48,11/27/2017,43,10:30,10:45,44.29,35.61,0,35.61,35.61,-1,-74172,58574,132746,-15598,0,-88,18318,0,0,,18406,18230
48,11/27/2017,44,10:45,11:00,40.29,34.36,0,40.29,34.36,2,-68654,53441,122095,-15213,0,-2971,762,0,0,,3733,-2209
48,11/27/2017,45,11:00,11:15,161.02,,0,161.02,161.02,1,-120398,62144,182542,-58254,0,0,24992,0,0,,24992,24992
48,11/27/2017,46,11:15,11:30,49.02,,0,49.02,49.02,1,-90972,69508,160480,-21464,0,0,23097,0,0,,23097,23097
48,11/27/2017,47,11:30,11:45,104.65,,0,104.65,104.65,1,-86325,45676,132001,-40649,0,0,19275,0,0,,19275,19275
48,11/27/2017,48,11:45,12:00,53.02,,0,53.02,53.02,1,-90088,45895,135983,-44193,0,0,34693,0,0,,34693,34693
48,11/27/2017,49,12:00,12:15,44.29,36.64,0,36.64,36.64,-1,-74194,63086,137280,-11108,0,-146,22347,0,0,,22493,22201
48,11/27/2017,50,12:15,12:30,44.29,37.03,0,37.03,37.03,-1,-74101,50396,124497,-23705,0,-100,353,0,0,,453,253
48,11/27/2017,51,12:30,12:45,40.17,,0,40.17,40.17,1,-66768,55851,122619,-10917,0,0,253,0,0,,253,253
48,11/27/2017,52,12:45,13:00,37.34,,0,37.34,37.34,1,-82509,39353,121862,-43156,0,0,606,0,0,,606,606
48,11/27/2017,53,13:00,13:15,192.15,,0,192.15,192.15,1,-87806,25242,113048,-62564,0,0,10267,0,0,,10267,10267
48,11/27/2017,54,13:15,13:30,192.15,,0,192.15,192.15,1,-84272,26948,111220,-57324,0,0,29808,0,0,,29808,29808
48,11/27/2017,55,13:30,13:45,228.29,,0,228.29,228.29,1,-97757,18305,116062,-79452,0,0,32909,0,0,,32909,32909
48,11/27/2017,56,13:45,14:00,57.5,,0,57.5,57.5,1,-92488,16834,109322,-75654,0,0,30579,0,0,,30579,30579
48,11/27/2017,57,14:00,14:15,247.75,,0,247.75,247.75,1,-100947,25356,126303,-75591,0,0,39001,0,0,,39001,39001
48,11/27/2017,58,14:15,14:30,74.14,,0,74.14,74.14,1,-81670,29491,111161,-52179,0,0,42789,0,0,,42789,42789
48,11/27/2017,59,14:30,14:45,57.02,,0,57.02,57.02,1,-78393,43373,121766,-35020,0,0,36412,0,0,,36412,36412
48,11/27/2017,60,14:45,15:00,55.9,,0,55.9,55.9,1,-69115,37434,106549,-31681,0,0,28791,0,0,,28791,28791
48,11/27/2017,61,15:00,15:15,40.29,36.66,0,40.29,36.66,2,-61480,62281,123761,801,0,-396,11846,0,0,,12242,11450
48,11/27/2017,62,15:15,15:30,61.02,36.66,0,61.02,61.02,1,-64307,49426,113733,-14881,0,-5,4642,0,0,,4647,4637
48,11/27/2017,63,15:30,15:45,71.02,,0,71.02,71.02,1,-67938,39281,107219,-28657,0,0,22794,0,0,,22794,22794
48,11/27/2017,64,15:45,16:00,44.96,,0,44.96,44.96,1,-68975,31356,100331,-37619,0,0,24554,0,0,,24554,24554
48,11/27/2017,65,16:00,16:15,44.96,23.74,0,23.74,23.74,-1,-69424,115277,184701,45853,0,-3323,8360,0,0,,11683,5037
48,11/27/2017,66,16:15,16:30,39.37,34.36,0,39.37,34.36,2,-73181,91353,164534,18172,0,-4270,20,0,0,,4290,-4250
48,11/27/2017,67,16:30,16:45,71.02,34.36,0,71.02,71.02,1,-89397,65070,154467,-24327,0,-8,5284,0,0,,5292,5276
48,11/27/2017,68,16:45,17:00,217.61,,0,217.61,217.61,1,-105832,66417,172249,-39415,0,0,41421,0,0,,41421,41421
48,11/27/2017,69,17:00,17:15,58.02,,0,58.02,58.02,1,-99288,76621,175909,-22667,0,0,26036,0,0,,26036,26036
48,11/27/2017,70,17:15,17:30,114.06,,0,114.06,114.06,1,-97177,61604,158781,-35573,0,0,5364,0,0,,5364,5364
48,11/27/2017,71,17:30,17:45,135.51,35.69,0,135.51,35.69,2,-79134,77008,156142,-2126,0,-424,13956,0,0,,14380,13532
48,11/27/2017,72,17:45,18:00,42.47,35.69,0,42.47,42.47,1,-68897,62652,131549,-6245,0,-2,119,0,0,,121,117
48,11/27/2017,73,18:00,18:15,92.02,35.36,0,92.02,34.99,2,-101220,73205,174425,-28015,0,-320,7290,0,0,,7610,6970
48,11/27/2017,74,18:15,18:30,,8.69,0,8.69,8.69,-1,-35656,96989,132645,61333,0,-34141,0,0,0,,34141,-34141
48,11/27/2017,75,18:30,18:45,,13.69,0,13.69,13.69,-1,-28525,101359,129884,72834,0,-45908,0,0,0,,45908,-45908
48,11/27/2017,76,18:45,19:00,,14.9,0,14.9,14.9,-1,-23632,90738,114370,67106,0,-60222,0,0,0,,60222,-60222
48,11/27/2017,77,19:00,19:15,190.08,34.03,0,190.08,190.08,1,-58931,26278,85209,-32653,0,-22981,5322,0,0,,28303,-17659
48,11/27/2017,78,19:15,19:30,225.83,35.36,0,225.83,34.93,2,-35857,35190,71047,-667,0,-397,11226,0,0,,11623,10829
48,11/27/2017,79,19:30,19:45,,34.36,0,34.36,34.36,-1,-44955,62580,107535,17625,0,-5107,0,0,0,,5107,-5107
48,11/27/2017,80,19:45,20:00,,33.66,0,33.66,33.66,-1,-56331,77899,134230,21568,0,-9199,0,0,0,,9199,-9199
48,11/27/2017,81,20:00,20:15,105.02,-57.63,0,105.02,-57.63,2,-68744,82205,150949,13461,0,-27263,2230,0,0,,29493,-25033
48,11/27/2017,82,20:15,20:30,105.02,-35.38,0,-35.38,-35.38,-1,-37213,90178,127391,52965,0,-24309,832,0,0,,25141,-23477
48,11/27/2017,83,20:30,20:45,,25.36,0,25.36,25.36,-1,-32542,60603,93145,28061,0,-14683,0,0,0,,14683,-14683
48,11/27/2017,84,20:45,21:00,,7.56,0,7.56,7.56,-1,-45766,69822,115588,24056,0,-41137,0,0,0,,41137,-41137
48,11/27/2017,85,21:00,21:15,45,27.67,0,45,27.67,2,-56391,84715,141106,28324,0,-31772,109,0,0,,31881,-31663
48,11/27/2017,86,21:15,21:30,185.2,35.36,0,185.2,34.94,2,-79443,52063,131506,-27380,0,-3900,19115,0,0,,23015,15215
48,11/27/2017,87,21:30,21:45,185.2,29.94,0,29.94,29.94,-1,-41144,75270,116414,34126,0,-17408,1328,0,0,,18736,-16080
48,11/27/2017,88,21:45,22:00,,15.9,0,15.9,15.9,-1,-32647,87553,120200,54906,0,-42596,0,0,0,,42596,-42596
48,11/27/2017,89,22:00,22:15,,11.21,0,11.21,11.21,-1,-55713,110780,166493,55067,0,-48579,0,0,0,,48579,-48579
48,11/27/2017,90,22:15,22:30,,1.03,0,1.03,1.03,-1,-32011,92430,124441,60419,0,-56154,0,0,0,,56154,-56154
48,11/27/2017,91,22:30,22:45,,29.44,0,29.44,29.44,-1,-36987,83627,120614,46640,0,-41511,0,0,0,,41511,-41511
48,11/27/2017,92,22:45,23:00,,-0.38,0,-0.38,-0.38,-1,-43148,106737,149885,63589,0,-51782,0,0,0,,51782,-51782
48,11/27/2017,93,23:00,23:15,78.25,-11.41,0,78.25,-11.41,2,-54374,55754,110128,1380,0,-40734,2602,0,0,,43336,-38132
48,11/27/2017,94,23:15,23:30,78.25,33.58,0,33.58,33.58,-1,-39354,47277,86631,7923,0,-1861,868,0,0,,2729,-993
48,11/27/2017,95,23:30,23:45,,15.67,0,15.67,15.67,-1,-38669,92758,131427,54089,0,-34973,0,0,0,,34973,-34973
48,11/27/2017,96,23:45,0:00,,-10.73,0,-10.73,-10.73,-1,-41791,123587,165378,81796,0,-63404,0,0,0,,63404,-63404
48,11/28/2017,1,0:00,0:15,133.29,-10.73,0,133.29,133.29,1,-169042,46773,215815,-122269,0,-16093,25925,0,0,,42018,9832
48,11/28/2017,2,0:15,0:30,63.12,34.46,0,34.46,34.46,-1,-77225,66520,143745,-10705,0,-80,23579,0,0,,23659,23499
48,11/28/2017,3,0:30,0:45,43.86,35.56,0,43.86,35.56,2,-51478,25351,76829,-26127,0,-231,1022,0,0,,1253,791
48,11/28/2017,4,0:45,1:00,44.58,,0,44.58,44.58,1,-65242,31581,96823,-33661,0,0,12657,0,0,,12657,12657
48,11/28/2017,5,1:00,1:15,43.86,,0,43.86,43.86,1,-70450,41952,112402,-28498,0,0,1635,0,0,,1635,1635
48,11/28/2017,6,1:15,1:30,45.52,,0,45.52,45.52,1,-63726,16608,80334,-47118,0,0,8045,0,0,,8045,8045
48,11/28/2017,7,1:30,1:45,38.46,,0,38.46,38.46,1,-79238,35318,114556,-43920,0,0,3793,0,0,,3793,3793
48,11/28/2017,8,1:45,2:00,38.39,,0,38.39,38.39,1,-66919,65893,132812,-1026,0,0,426,0,0,,426,426
48,11/28/2017,9,2:00,2:15,143.19,,0,143.19,143.19,1,-92532,23854,116386,-68678,0,0,19356,0,0,,19356,19356
48,11/28/2017,10,2:15,2:30,49.24,,0,49.24,49.24,1,-65455,40076,105531,-25379,0,0,20133,0,0,,20133,20133
48,11/28/2017,11,2:30,2:45,45.83,,0,45.83,45.83,1,-66559,50578,117137,-15981,0,0,3244,0,0,,3244,3244
48,11/28/2017,12,2:45,3:00,53.81,,0,53.81,53.81,1,-71476,44148,115624,-27328,0,0,25343,0,0,,25343,25343
48,11/28/2017,13,3:00,3:15,53.81,35.5,0,35.5,35.5,-1,-57218,70321,127539,13103,0,-1211,6482,0,0,,7693,5271
48,11/28/2017,14,3:15,3:30,,,0,37.66,37.66,0,-45651,54900,100551,9249,0,0,0,0,0,,0,0
48,11/28/2017,15,3:30,3:45,,,0,38.82,38.82,0,-44818,63001,107819,18183,0,0,0,0,0,,0,0
48,11/28/2017,16,3:45,4:00,,,0,38.82,38.82,0,-51388,57725,109113,6337,0,0,0,0,0,,0,0
48,11/28/2017,17,4:00,4:15,,,0,35,35,0,-28207,92774,120981,64567,0,0,0,0,0,,0,0
48,11/28/2017,18,4:15,4:30,,,0,35.01,35.01,0,-32050,65697,97747,33647,0,0,0,0,0,,0,0
48,11/28/2017,19,4:30,4:45,,,0,34.97,34.97,0,-37036,50388,87424,13352,0,0,0,0,0,,0,0
48,11/28/2017,20,4:45,5:00,,,0,33.85,33.85,0,-47920,45048,92968,-2872,0,0,0,0,0,,0,0
48,11/28/2017,21,5:00,5:15,,-58.83,0,-58.83,-58.83,-1,-26485,98995,125480,72510,0,-26058,0,0,0,,26058,-26058
48,11/28/2017,22,5:15,5:30,,33.37,0,33.37,33.37,-1,-63533,75822,139355,12289,0,-18892,0,0,0,,18892,-18892
48,11/28/2017,23,5:30,5:45,43.86,37.51,0,43.86,33.82,2,-83754,74278,158032,-9476,0,-3199,5270,0,0,,8469,2071
48,11/28/2017,24,5:45,6:00,43.86,32.53,0,32.53,32.53,-1,-74585,82500,157085,7915,0,-3090,675,0,0,,3765,-2415
48,11/28/2017,25,6:00,6:15,,11.2,0,11.2,11.2,-1,-77607,124700,202307,47093,0,-20983,0,0,0,,20983,-20983
48,11/28/2017,26,6:15,6:30,30.14,32.53,0,30.14,30.14,1,-64139,79870,144009,15731,0,-27301,11,0,0,,27312,-27290
48,11/28/2017,27,6:30,6:45,37.9,36.6,0,37.9,35.01,2,-66328,72812,139140,6484,0,-3673,42,0,0,,3715,-3631
48,11/28/2017,28,6:45,7:00,41.51,34.95,0,41.51,34.95,2,-91969,98566,190535,6597,0,-136,1641,0,0,,1777,1505
48,11/28/2017,29,7:00,7:15,,16,0,16,16,-1,-50864,66780,117644,15916,0,-7666,0,0,0,,7666,-7666
48,11/28/2017,30,7:15,7:30,41.89,13.83,0,41.89,41.89,1,-61154,48711,109865,-12443,0,-10169,492,0,0,,10661,-9677
48,11/28/2017,31,7:30,7:45,89.72,13.83,0,89.72,89.72,1,-60620,15128,75748,-45492,0,-18,31059,0,0,,31077,31041
48,11/28/2017,32,7:45,8:00,62.63,,0,62.63,62.63,1,-83096,33396,116492,-49700,0,0,45480,0,0,,45480,45480
48,11/28/2017,33,8:00,8:15,45.12,-36.26,0,-36.26,-36.26,-1,-33579,96075,129654,62496,0,-19488,24417,0,0,,43905,4929
48,11/28/2017,34,8:15,8:30,45.12,21.78,0,21.78,21.78,-1,-53764,70000,123764,16236,0,-18999,4,0,0,,19003,-18995
48,11/28/2017,35,8:30,8:45,,30.23,0,30.23,30.23,-1,-43174,82464,125638,39290,0,-26118,0,0,0,,26118,-26118
48,11/28/2017,36,8:45,9:00,43.53,34.78,0,43.53,43.53,1,-49033,49419,98452,386,0,-21371,564,0,0,,21935,-20807
48,11/28/2017,37,9:00,9:15,41.75,6.92,0,41.75,6.92,2,-26066,101623,127689,75557,0,-21931,961,0,0,,22892,-20970
48,11/28/2017,38,9:15,9:30,44.44,35.31,0,44.44,35.31,2,-56515,32848,89363,-23667,0,-8662,3031,0,0,,11693,-5631
48,11/28/2017,39,9:30,9:45,52.63,,0,52.63,52.63,1,-74156,41524,115680,-32632,0,0,8500,0,0,,8500,8500
48,11/28/2017,40,9:45,10:00,40.23,,0,40.23,40.23,1,-74406,55515,129921,-18891,0,0,6166,0,0,,6166,6166
48,11/28/2017,41,10:00,10:15,40.23,38.23,0,38.23,38.23,-1,-58940,50278,109218,-8662,0,-77,9,0,0,,86,-68
48,11/28/2017,42,10:15,10:30,,39.37,0,39.37,39.37,-1,-61521,59922,121443,-1599,0,-899,0,0,0,,899,-899
48,11/28/2017,43,10:30,10:45,,39.74,0,39.74,39.74,-1,-53779,58929,112708,5150,0,-812,0,0,0,,812,-812
48,11/28/2017,44,10:45,11:00,,37.82,0,37.82,37.82,-1,-53189,68103,121292,14914,0,-1384,0,0,0,,1384,-1384
48,11/28/2017,45,11:00,11:15,,33.56,0,33.56,33.56,-1,-69551,89873,159424,20322,0,-7135,0,0,0,,7135,-7135
48,11/28/2017,46,11:15,11:30,,30.5,0,30.5,30.5,-1,-67096,99396,166492,32300,0,-23497,0,0,0,,23497,-23497
48,11/28/2017,47,11:30,11:45,,32.75,0,32.75,32.75,-1,-64031,103158,167189,39127,0,-33978,0,0,0,,33978,-33978
48,11/28/2017,48,11:45,12:00,40.23,35.26,0,40.23,40.23,1,-105019,103038,208057,-1981,0,-22776,493,0,0,,23269,-22283
48,11/28/2017,49,12:00,12:15,42.16,13.83,0,42.16,13.83,2,-75805,117085,192890,41280,0,-16603,1037,0,0,,17640,-15566
48,11/28/2017,50,12:15,12:30,,10.2,0,10.2,10.2,-1,-83921,118951,202872,35030,0,-47055,0,0,0,,47055,-47055
48,11/28/2017,51,12:30,12:45,,34.31,0,34.31,34.31,-1,-88196,110974,199170,22778,0,-24196,0,0,0,,24196,-24196
48,11/28/2017,52,12:45,13:00,,16.4,0,16.4,16.4,-1,-72755,112431,185186,39676,0,-17195,0,0,0,,17195,-17195
48,11/28/2017,53,13:00,13:15,40.44,30.31,0,40.44,40.44,1,-125972,120542,246514,-5430,0,-12658,1487,0,0,,14145,-11171
48,11/28/2017,54,13:15,13:30,37.79,37.88,0,38.82,37.88,2,-78585,90723,169308,12138,0,-441,521,0,0,,962,80
48,11/28/2017,55,13:30,13:45,,,0,38.82,38.82,0,-147517,131565,279082,-15952,0,-28,0,0,0,,28,-28
48,11/28/2017,56,13:45,14:00,,,0,38.82,38.82,0,-153822,111191,265013,-42631,0,0,0,0,0,,0,0
48,11/28/2017,57,14:00,14:15,49.96,,0,49.96,49.96,1,-145728,115403,261131,-30325,0,0,3107,0,0,,3107,3107
48,11/28/2017,58,14:15,14:30,40.23,,0,40.23,40.23,1,-146709,103906,250615,-42803,0,0,700,0,0,,700,700
48,11/28/2017,59,14:30,14:45,48.36,,0,48.36,48.36,1,-152715,119026,271741,-33689,0,0,3313,0,0,,3313,3313
48,11/28/2017,60,14:45,15:00,40.23,,0,40.23,40.23,1,-167436,105195,272631,-62241,0,0,3094,0,0,,3094,3094
48,11/28/2017,61,15:00,15:15,40.23,35.31,0,40.23,35.31,2,-65199,80865,146064,15666,0,-219,303,0,0,,522,84
48,11/28/2017,62,15:15,15:30,,33.06,0,33.06,33.06,-1,-115767,136462,252229,20695,0,-6720,0,0,0,,6720,-6720
48,11/28/2017,63,15:30,15:45,73.16,33.06,0,73.16,73.16,1,-140877,104912,245789,-35965,0,-33,8380,0,0,,8413,8347
48,11/28/2017,64,15:45,16:00,142.28,,0,142.28,142.28,1,-121492,90323,211815,-31169,0,0,51240,0,0,,51240,51240
48,11/28/2017,65,16:00,16:15,142.28,5.06,0,5.06,5.06,-1,-112593,152032,264625,39439,0,-13260,20866,0,0,,34126,7606
48,11/28/2017,66,16:15,16:30,,35.31,0,35.31,35.31,-1,-94291,113680,207971,19389,0,-5862,0,0,0,,5862,-5862
48,11/28/2017,67,16:30,16:45,,34.31,0,34.31,34.31,-1,-79203,111742,190945,32539,0,-3245,0,0,0,,3245,-3245
48,11/28/2017,68,16:45,17:00,279.17,,0,279.17,279.17,1,-140202,94144,234346,-46058,0,0,9868,0,0,,9868,9868
48,11/28/2017,69,17:00,17:15,43.25,24.89,0,43.25,24.89,2,-108475,124599,233074,16124,0,-5922,6668,0,0,,12590,746
48,11/28/2017,70,17:15,17:30,42.89,24.89,0,42.89,42.89,1,-113797,90577,204374,-23220,0,-325,512,0,0,,837,187
48,11/28/2017,71,17:30,17:45,43.05,36.57,0,43.05,36.57,2,-86672,90493,177165,3821,0,-708,1198,0,0,,1906,490
48,11/28/2017,72,17:45,18:00,47.89,,0,47.89,47.89,1,-84143,72691,156834,-11452,0,0,632,0,0,,632,632
48,11/28/2017,73,18:00,18:15,177.42,,0,177.42,177.42,1,-132649,41838,174487,-90811,0,0,14784,0,0,,14784,14784
48,11/28/2017,74,18:15,18:30,38,38.14,0,38.87,38.14,2,-80651,63365,144016,-17286,0,-379,1055,0,0,,1434,676
48,11/28/2017,75,18:30,18:45,38.29,,0,38.29,38.29,1,-83592,60413,144005,-23179,0,0,1629,0,0,,1629,1629
48,11/28/2017,76,18:45,19:00,38.29,25.9,0,25.9,25.9,-1,-69069,106438,175507,37369,0,-10298,113,0,0,,10411,-10185
48,11/28/2017,77,19:00,19:15,344.62,35.14,0,344.62,35.14,2,-98545,41595,140140,-56950,0,-7335,16374,0,0,,23709,9039
48,11/28/2017,78,19:15,19:30,44.3,35.31,0,35.31,35.31,-1,-82984,88786,171770,5802,0,-382,10913,0,0,,11295,10531
48,11/28/2017,79,19:30,19:45,,35.31,0,35.31,35.31,-1,-85475,78985,164460,-6490,0,-763,0,0,0,,763,-763
48,11/28/2017,80,19:45,20:00,,36.63,0,36.63,36.63,-1,-68292,88053,156345,19761,0,-881,0,0,0,,881,-881
48,11/28/2017,81,20:00,20:15,,35.31,0,35.31,35.31,-1,-83453,88162,171615,4709,0,-1228,0,0,0,,1228,-1228
48,11/28/2017,82,20:15,20:30,,35.31,0,35.31,35.31,-1,-68133,77259,145392,9126,0,-5389,0,0,0,,5389,-5389
48,11/28/2017,83,20:30,20:45,,30.1,0,30.1,30.1,-1,-63606,92305,155911,28699,0,-16349,0,0,0,,16349,-16349
48,11/28/2017,84,20:45,21:00,,27.86,0,27.86,27.86,-1,-73416,100812,174228,27396,0,-31346,0,0,0,,31346,-31346
48,11/28/2017,85,21:00,21:15,49.25,20.14,0,49.25,20.14,2,-90415,38965,129380,-51450,0,-23458,2146,0,0,,25604,-21312
48,11/28/2017,86,21:15,21:30,49.25,34.31,0,34.31,34.31,-1,-62249,68390,130639,6141,0,-1289,384,0,0,,1673,-905
48,11/28/2017,87,21:30,21:45,,34.31,0,34.31,34.31,-1,-67067,82590,149657,15523,0,-6146,0,0,0,,6146,-6146
48,11/28/2017,88,21:45,22:00,,9.15,0,9.15,9.15,-1,-65466,122899,188365,57433,0,-38008,0,0,0,,38008,-38008
48,11/28/2017,89,22:00,22:15,186.51,-9.26,0,186.51,-9.26,2,-124318,10594,134912,-113724,0,-34952,3781,0,0,,38733,-31171
48,11/28/2017,90,22:15,22:30,40.84,-9.26,0,40.84,40.84,1,-78863,39122,117985,-39741,0,-32,5311,0,0,,5343,5279
48,11/28/2017,91,22:30,22:45,,35.31,0,35.31,35.31,-1,-84239,86786,171025,2547,0,-1083,0,0,0,,1083,-1083
48,11/28/2017,92,22:45,23:00,,34.31,0,34.31,34.31,-1,-111263,88538,199801,-22725,0,-5936,0,0,0,,5936,-5936
48,11/28/2017,93,23:00,23:15,102.25,,0,102.25,102.25,1,-76249,43708,119957,-32541,0,0,9160,0,0,,9160,9160
48,11/28/2017,94,23:15,23:30,37.72,37.77,0,38.47,37.77,2,-47959,53097,101056,5138,0,-497,2101,0,0,,2598,1604
48,11/28/2017,95,23:30,23:45,,5.25,0,5.25,5.25,-1,-58430,115100,173530,56670,0,-27655,0,0,0,,27655,-27655
48,11/28/2017,96,23:45,0:00,,6.62,0,6.62,6.62,-1,-67809,123376,191185,55567,0,-62926,0,0,0,,62926,-62926
48,11/29/2017,1,0:00,0:15,,-37.23,0,-37.23,-37.23,-1,-44871,104391,149262,59520,0,-43374,0,0,0,,43374,-43374
48,11/29/2017,2,0:15,0:30,,13.48,0,13.48,13.48,-1,-26841,81130,107971,54289,0,-30446,0,0,0,,30446,-30446
48,11/29/2017,3,0:30,0:45,,25.45,0,25.45,25.45,-1,-53884,89742,143626,35858,0,-48545,0,0,0,,48545,-48545
48,11/29/2017,4,0:45,1:00,,29.36,0,29.36,29.36,-1,-62305,112725,175030,50420,0,-45829,0,0,0,,45829,-45829
48,11/29/2017,5,1:00,1:15,52.14,30.03,0,52.14,52.14,1,-73194,51889,125083,-21305,0,-22128,2378,0,0,,24506,-19750
48,11/29/2017,6,1:15,1:30,,,0,34.36,34.36,0,-71098,51847,122945,-19251,0,0,356,0,0,,356,356
48,11/29/2017,7,1:30,1:45,,35.63,0,35.63,35.63,-1,-65281,62615,127896,-2666,0,-532,0,0,0,,532,-532
48,11/29/2017,8,1:45,2:00,,35.47,0,35.47,35.47,-1,-67406,60766,128172,-6640,0,-5916,0,0,0,,5916,-5916
48,11/29/2017,9,2:00,2:15,,35.63,0,35.63,35.63,-1,-50874,45898,96772,-4976,0,-1569,0,0,0,,1569,-1569
48,11/29/2017,10,2:15,2:30,,35.03,0,35.03,35.03,-1,-50060,57484,107544,7424,0,-8210,0,0,0,,8210,-8210
48,11/29/2017,11,2:30,2:45,,22.47,0,22.47,22.47,-1,-45514,74840,120354,29326,0,-21043,0,0,0,,21043,-21043
48,11/29/2017,12,2:45,3:00,,22.24,0,22.24,22.24,-1,-51627,79239,130866,27612,0,-40443,0,0,0,,40443,-40443
48,11/29/2017,13,3:00,3:15,50.42,22.24,0,50.42,50.42,1,-64965,57668,122633,-7297,0,-5280,3256,0,0,,8536,-2024
48,11/29/2017,14,3:15,3:30,39.59,19.86,0,39.59,19.86,2,-22112,50819,72931,28707,0,-6252,180,0,0,,6432,-6072
48,11/29/2017,15,3:30,3:45,,20.03,0,20.03,20.03,-1,-15660,58751,74411,43091,0,-38405,0,0,0,,38405,-38405
48,11/29/2017,16,3:45,4:00,,15.61,0,15.61,15.61,-1,-17393,66390,83783,48997,0,-42293,0,0,0,,42293,-42293
48,11/29/2017,17,4:00,4:15,,15.18,0,15.18,15.18,-1,-14170,73992,88162,59822,0,-53243,0,0,0,,53243,-53243
48,11/29/2017,18,4:15,4:30,,15,0,15,15,-1,-17629,69876,87505,52247,0,-55067,0,0,0,,55067,-55067
48,11/29/2017,19,4:30,4:45,,10,0,10,10,-1,-20782,88363,109145,67581,0,-48230,0,0,0,,48230,-48230
48,11/29/2017,20,4:45,5:00,,20.58,0,20.58,20.58,-1,-24391,88056,112447,63665,0,-58235,0,0,0,,58235,-58235
48,11/29/2017,21,5:00,5:15,44.42,20.58,0,44.42,44.42,1,-107763,54847,162610,-52916,0,-17423,2672,0,0,,20095,-14751
48,11/29/2017,22,5:15,5:30,30.06,,0,30.06,30.06,1,-44593,34180,78773,-10413,0,0,36,0,0,,36,36
48,11/29/2017,23,5:30,5:45,44.4,,0,44.4,44.4,1,-55622,49278,104900,-6344,0,0,1536,0,0,,1536,1536
48,11/29/2017,24,5:45,6:00,49.16,36.67,0,49.16,34.21,2,-53896,52981,106877,-915,0,-64,10203,0,0,,10267,10139
48,11/29/2017,25,6:00,6:15,49.16,-20.17,0,-20.17,-20.17,-1,-15135,110609,125744,95474,0,-30219,782,0,0,,31001,-29437
48,11/29/2017,26,6:15,6:30,,34.58,0,34.58,34.58,-1,-17339,69141,86480,51802,0,-18853,0,0,0,,18853,-18853
48,11/29/2017,27,6:30,6:45,,34.71,0,34.71,34.71,-1,-25177,52153,77330,26976,0,-7358,0,0,0,,7358,-7358
48,11/29/2017,28,6:45,7:00,247.91,34.71,0,247.91,247.91,1,-77274,28529,105803,-48745,0,-267,18032,0,0,,18299,17765
48,11/29/2017,29,7:00,7:15,247.91,-34.9,0,-34.9,-34.9,-1,-5913,200940,206853,195027,0,-39018,7276,0,0,,46294,-31742
48,11/29/2017,30,7:15,7:30,,28.84,0,28.84,28.84,-1,-25608,62617,88225,37009,0,-24098,0,0,0,,24098,-24098
48,11/29/2017,31,7:30,7:45,44.53,28.84,0,44.53,44.53,1,-53732,47202,100934,-6530,0,-2342,1514,0,0,,3856,-828
48,11/29/2017,32,7:45,8:00,301.43,,0,301.43,301.43,1,-134436,57715,192151,-76721,0,0,37868,0,0,,37868,37868
48,11/29/2017,33,8:00,8:15,301.43,30.06,0,30.06,30.06,-1,-30780,66712,97492,35932,0,-2953,17164,0,0,,20117,14211
48,11/29/2017,34,8:15,8:30,,,0,44.81,44.81,0,-36511,51241,87752,14730,0,0,0,0,0,,0,0
48,11/29/2017,35,8:30,8:45,,36.14,0,36.14,36.14,-1,-25450,40626,66076,15176,0,-784,0,0,0,,784,-784
48,11/29/2017,36,8:45,9:00,,,0,44.81,44.81,0,-55037,40626,95663,-14411,0,0,0,0,0,,0,0
48,11/29/2017,37,9:00,9:15,41.75,,0,41.75,41.75,1,-46669,50504,97173,3835,0,0,232,0,0,,232,232
48,11/29/2017,38,9:15,9:30,,52.57,0,52.57,52.57,-1,-46272,75691,121963,29419,0,-161,0,0,0,,161,-161
48,11/29/2017,39,9:30,9:45,40.57,52.57,0,45.6,45.6,2,-51338,64228,115566,12890,0,-256,153,0,0,,409,-103
48,11/29/2017,40,9:45,10:00,264.75,,0,264.75,264.75,1,-60269,34751,95020,-25518,0,0,10272,0,0,,10272,10272
48,11/29/2017,41,10:00,10:15,400.33,52.64,0,400.33,45.57,2,-52749,44798,97547,-7951,0,-8,33298,0,0,,33306,33290
48,11/29/2017,42,10:15,10:30,400.33,34.58,0,34.58,34.58,-1,-32859,60349,93208,27490,0,-1462,3963,0,0,,5425,2501
48,11/29/2017,43,10:30,10:45,,37.12,0,37.12,37.12,-1,-40007,53022,93029,13015,0,-439,0,0,0,,439,-439
48,11/29/2017,44,10:45,11:00,,52.65,0,52.65,52.65,-1,-42408,53926,96334,11518,0,-27,0,0,0,,27,-27
48,11/29/2017,45,11:00,11:15,,,0,46.56,46.56,0,-65156,54345,119501,-10811,0,0,0,0,0,,0,0
48,11/29/2017,46,11:15,11:30,,,0,46.55,46.55,0,-69227,65265,134492,-3962,0,0,0,0,0,,0,0
48,11/29/2017,47,11:30,11:45,44.34,,0,44.34,44.34,1,-69959,59130,129089,-10829,0,0,1318,0,0,,1318,1318
48,11/29/2017,48,11:45,12:00,46,,0,46,46,1,-60302,41357,101659,-18945,0,0,4746,0,0,,4746,4746
48,11/29/2017,49,12:00,12:15,40.75,,0,40.75,40.75,1,-87595,44937,132532,-42658,0,0,1147,0,0,,1147,1147
48,11/29/2017,50,12:15,12:30,42.18,,0,42.18,42.18,1,-93489,28441,121930,-65048,0,0,1713,0,0,,1713,1713
48,11/29/2017,51,12:30,12:45,88.18,,0,88.18,88.18,1,-83004,50929,133933,-32075,0,0,7400,0,0,,7400,7400
48,11/29/2017,52,12:45,13:00,38.8,,0,38.8,38.8,1,-85525,57613,143138,-27912,0,0,2910,0,0,,2910,2910
48,11/29/2017,53,13:00,13:15,42.4,,0,42.4,42.4,1,-102505,40075,142580,-62430,0,0,241,0,0,,241,241
48,11/29/2017,54,13:15,13:30,42.4,,0,42.4,42.4,1,-104463,33814,138277,-70649,0,0,2152,0,0,,2152,2152
48,11/29/2017,55,13:30,13:45,,,0,46.59,46.59,0,-99195,52674,151869,-46521,0,0,185,0,0,,185,185
48,11/29/2017,56,13:45,14:00,,,0,46.59,46.59,0,-115870,56446,172316,-59424,0,0,0,0,0,,0,0
48,11/29/2017,57,14:00,14:15,69.21,,0,69.21,69.21,1,-132301,50337,182638,-81964,0,0,6178,0,0,,6178,6178
48,11/29/2017,58,14:15,14:30,49.21,,0,49.21,49.21,1,-139480,60624,200104,-78856,0,0,8867,0,0,,8867,8867
48,11/29/2017,59,14:30,14:45,403.82,,0,403.82,403.82,1,-141892,44918,186810,-96974,0,0,17029,0,0,,17029,17029
48,11/29/2017,60,14:45,15:00,49.21,,0,49.21,49.21,1,-131039,46226,177265,-84813,0,0,3384,0,0,,3384,3384
48,11/29/2017,61,15:00,15:15,112.16,,0,112.16,112.16,1,-141579,43446,185025,-98133,0,0,19029,0,0,,19029,19029
48,11/29/2017,62,15:15,15:30,38.96,,0,38.96,38.96,1,-127020,50161,177181,-76859,0,0,3936,0,0,,3936,3936
48,11/29/2017,63,15:30,15:45,44.02,,0,44.02,44.02,1,-121959,38344,160303,-83615,0,0,530,0,0,,530,530
48,11/29/2017,64,15:45,16:00,49.18,,0,49.18,49.18,1,-129331,32399,161730,-96932,0,0,2833,0,0,,2833,2833
48,11/29/2017,65,16:00,16:15,49.18,33.25,0,33.25,33.25,-1,-76073,98629,174702,22556,0,-4618,464,0,0,,5082,-4154
48,11/29/2017,66,16:15,16:30,,37.03,0,37.03,37.03,-1,-82760,70705,153465,-12055,0,-2608,0,0,0,,2608,-2608
48,11/29/2017,67,16:30,16:45,132.02,,0,132.02,132.02,1,-83524,41336,124860,-42188,0,0,9110,0,0,,9110,9110
48,11/29/2017,68,16:45,17:00,437.92,,0,437.92,437.92,1,-139700,21798,161498,-117902,0,0,64596,0,0,,64596,64596
48,11/29/2017,69,17:00,17:15,437.92,36.44,0,36.44,36.44,-1,-96359,34172,130531,-62187,0,-388,28172,0,0,,28560,27784
48,11/29/2017,70,17:15,17:30,78.49,,0,78.49,78.49,1,-97407,31432,128839,-65975,0,0,2418,0,0,,2418,2418
48,11/29/2017,71,17:30,17:45,65.23,,0,65.23,65.23,1,-57935,36883,94818,-21052,0,0,4117,0,0,,4117,4117
48,11/29/2017,72,17:45,18:00,41.02,,0,41.02,41.02,1,-50190,55898,106088,5708,0,0,2227,0,0,,2227,2227
48,11/29/2017,73,18:00,18:15,41.02,35.58,0,35.58,35.58,-1,-66276,47984,114260,-18292,0,-706,83,0,0,,789,-623
48,11/29/2017,74,18:15,18:30,,34.13,0,34.13,34.13,-1,-52381,66585,118966,14204,0,-3727,0,0,0,,3727,-3727
48,11/29/2017,75,18:30,18:45,,30.35,0,30.35,30.35,-1,-45813,78169,123982,32356,0,-27293,0,0,0,,27293,-27293
48,11/29/2017,76,18:45,19:00,,33.25,0,33.25,33.25,-1,-48414,84451,132865,36037,0,-21951,0,0,0,,21951,-21951
48,11/29/2017,77,19:00,19:15,255.73,35.03,0,281.3,35.03,2,-156215,27519,183734,-128696,0,-10549,16140,0,5000,,31689,10591
48,11/29/2017,78,19:15,19:30,39.07,,0,278.42,278.42,1,-97740,31040,128780,-66700,0,0,4634,0,15000,,19634,19634
48,11/29/2017,79,19:30,19:45,,34.58,0,34.58,34.58,-1,-83171,75510,158681,-7661,0,-1560,0,0,0,,1560,-1560
48,11/29/2017,80,19:45,20:00,,33.25,0,33.25,33.25,-1,-74667,50494,125161,-24173,0,-7915,0,0,0,,7915,-7915
48,11/29/2017,81,20:00,20:15,327.55,,0,327.55,327.55,1,-130292,36036,166328,-94256,0,0,14902,0,0,,14902,14902
48,11/29/2017,82,20:15,20:30,40.53,,0,40.53,40.53,1,-104334,53835,158169,-50499,0,0,2102,0,0,,2102,2102
48,11/29/2017,83,20:30,20:45,40.53,,0,40.53,40.53,1,-84090,28122,112212,-55968,0,0,149,0,0,,149,149
48,11/29/2017,84,20:45,21:00,,,0,45.25,45.25,0,-87365,45890,133255,-41475,0,0,0,0,0,,0,0
48,11/29/2017,85,21:00,21:15,227.67,,0,227.67,227.67,1,-89795,39605,129400,-50190,0,0,13794,0,0,,13794,13794
48,11/29/2017,86,21:15,21:30,61.63,,0,61.63,61.63,1,-70504,22082,92586,-48422,0,0,15751,0,0,,15751,15751
48,11/29/2017,87,21:30,21:45,61.63,35.58,0,35.58,35.58,-1,-47150,43142,90292,-4008,0,-2086,967,0,0,,3053,-1119
48,11/29/2017,88,21:45,22:00,,35.58,0,35.58,35.58,-1,-59896,67095,126991,7199,0,-7090,0,0,0,,7090,-7090
48,11/29/2017,89,22:00,22:15,70.87,,0,70.87,70.87,1,-76783,66139,142922,-10644,0,0,8981,0,0,,8981,8981
48,11/29/2017,90,22:15,22:30,40.02,29.57,0,29.57,29.57,-1,-44838,58752,103590,13914,0,-4195,4173,0,0,,8368,-22
48,11/29/2017,91,22:30,22:45,,25.41,0,25.41,25.41,-1,-37966,55732,93698,17766,0,-12980,0,0,0,,12980,-12980
48,11/29/2017,92,22:45,23:00,,30.13,0,30.13,30.13,-1,-59733,85786,145519,26053,0,-7837,0,0,0,,7837,-7837
48,11/29/2017,93,23:00,23:15,84.44,24.03,0,84.44,84.44,1,-83011,27138,110149,-55873,0,-7218,9023,0,0,,16241,1805
48,11/29/2017,94,23:15,23:30,46.03,,0,46.03,46.03,1,-64240,41224,105464,-23016,0,0,27796,0,0,,27796,27796
48,11/29/2017,95,23:30,23:45,46.03,12.6,0,12.6,12.6,-1,-32950,55210,88160,22260,0,-4609,7005,0,0,,11614,2396
48,11/29/2017,96,23:45,0:00,,-6.66,0,-6.66,-6.66,-1,-27128,74919,102047,47791,0,-28088,0,0,0,,28088,-28088
48,11/30/2017,1,0:00,0:15,40,32.78,0,40,32.78,2,-108248,85031,193279,-23217,0,-11516,901,0,0,,12417,-10615
48,11/30/2017,2,0:15,0:30,40,35.24,0,35.24,35.24,-1,-97647,86106,183753,-11541,0,-293,9,0,0,,302,-284
48,11/30/2017,3,0:30,0:45,,-10.38,0,-10.38,-10.38,-1,-32547,113487,146034,80940,0,-36763,0,0,0,,36763,-36763
48,11/30/2017,4,0:45,1:00,,15.11,0,15.11,15.11,-1,-51330,160605,211935,109275,0,-62628,0,0,0,,62628,-62628
48,11/30/2017,5,1:00,1:15,,24.19,0,24.19,24.19,-1,-60825,77378,138203,16553,0,-35129,0,0,0,,35129,-35129
48,11/30/2017,6,1:15,1:30,41.43,34.24,0,41.43,33.55,2,-61052,63027,124079,1975,0,-2588,208,0,0,,2796,-2380
48,11/30/2017,7,1:30,1:45,51.24,36.8,0,51.24,33.56,2,-75364,57188,132552,-18176,0,-1865,6821,0,0,,8686,4956
48,11/30/2017,8,1:45,2:00,51.24,30.11,0,30.11,30.11,-1,-58684,74025,132709,15341,0,-9648,586,0,0,,10234,-9062
48,11/30/2017,9,2:00,2:15,40,35.24,0,40,40,1,-89585,81190,170775,-8395,0,-4777,98,0,0,,4875,-4679
48,11/30/2017,10,2:15,2:30,41.31,20.07,0,43.76,20.07,2,-60564,70635,131199,10071,0,-5877,1727,0,0,,7604,-4150
48,11/30/2017,11,2:30,2:45,,20.07,0,20.07,20.07,-1,-56765,78331,135096,21566,0,-33499,0,0,0,,33499,-33499
48,11/30/2017,12,2:45,3:00,,32.78,0,32.78,32.78,-1,-66438,81969,148407,15531,0,-29308,0,0,0,,29308,-29308
48,11/30/2017,13,3:00,3:15,,30.99,0,30.99,30.99,-1,-35380,69467,104847,34087,0,-27290,0,0,0,,27290,-27290
48,11/30/2017,14,3:15,3:30,39.02,34.24,0,39.02,39.02,1,-45343,56745,102088,11402,0,-16504,165,0,0,,16669,-16339
48,11/30/2017,15,3:30,3:45,,28.1,0,28.1,28.1,-1,-31137,69964,101101,38827,0,-21264,0,0,0,,21264,-21264
48,11/30/2017,16,3:45,4:00,,15.07,0,15.07,15.07,-1,-30221,74408,104629,44187,0,-53710,0,0,0,,53710,-53710
48,11/30/2017,17,4:00,4:15,,14.05,0,14.05,14.05,-1,-12644,74535,87179,61891,0,-62173,0,0,0,,62173,-62173
48,11/30/2017,18,4:15,4:30,,27.64,0,27.64,27.64,-1,-42532,78225,120757,35693,0,-48393,0,0,0,,48393,-48393
48,11/30/2017,19,4:30,4:45,,20.66,0,20.66,20.66,-1,-31210,79319,110529,48109,0,-24544,0,0,0,,24544,-24544
48,11/30/2017,20,4:45,5:00,,30.24,0,30.24,30.24,-1,-39306,43516,82822,4210,0,-25949,0,0,0,,25949,-25949
48,11/30/2017,21,5:00,5:15,40,30.24,0,40,30.24,2,-68102,54567,122669,-13535,0,-4545,614,0,0,,5159,-3931
48,11/30/2017,22,5:15,5:30,,35.24,0,35.24,35.24,-1,-45755,40879,86634,-4876,0,-6231,0,0,0,,6231,-6231
48,11/30/2017,23,5:30,5:45,44,35.24,0,44,44,1,-55372,24534,79906,-30838,0,-168,527,0,0,,695,359
48,11/30/2017,24,5:45,6:00,83.56,,0,83.56,83.56,1,-56328,33061,89389,-23267,0,0,23760,0,0,,23760,23760
48,11/30/2017,25,6:00,6:15,83.56,-10.32,0,-10.32,-10.32,-1,-45238,98272,143510,53034,0,-24063,2947,0,0,,27010,-21116
48,11/30/2017,26,6:15,6:30,,35.07,0,35.07,35.07,-1,-58734,60847,119581,2113,0,-5498,0,0,0,,5498,-5498
48,11/30/2017,27,6:30,6:45,,28.93,0,28.93,28.93,-1,-59356,81110,140466,21754,0,-11731,0,0,0,,11731,-11731
48,11/30/2017,28,6:45,7:00,,,0,43.78,43.78,0,-102158,51399,153557,-50759,0,-1979,0,0,0,,1979,-1979
48,11/30/2017,29,7:00,7:15,50,35.84,0,50,35.84,2,-56212,120581,176793,64369,0,-133,1063,0,0,,1196,930
48,11/30/2017,30,7:15,7:30,218.98,,0,218.98,218.98,1,-130892,75364,206256,-55528,0,0,51738,0,0,,51738,51738
48,11/30/2017,31,7:30,7:45,142.32,,0,142.32,142.32,1,-110498,67171,177669,-43327,0,0,36052,0,0,,36052,36052
48,11/30/2017,32,7:45,8:00,367.25,,0,367.25,367.25,1,-169815,25200,195015,-144615,0,0,66585,0,0,,66585,66585
48,11/30/2017,33,8:00,8:15,367.25,0.79,0,0.79,0.79,-1,-40452,102002,142454,61550,0,-8854,37921,0,0,,46775,29067
48,11/30/2017,34,8:15,8:30,,,0,38.15,38.15,0,-48031,79315,127346,31284,0,-1642,0,0,0,,1642,-1642
48,11/30/2017,35,8:30,8:45,,35.84,0,35.84,35.84,-1,-39093,94754,133847,55661,0,-114,0,0,0,,114,-114
48,11/30/2017,36,8:45,9:00,,34.84,0,34.84,34.84,-1,-64705,65097,129802,392,0,-250,0,0,0,,250,-250
48,11/30/2017,37,9:00,9:15,,35.84,0,35.84,35.84,-1,-39380,79065,118445,39685,0,-908,0,0,0,,908,-908
48,11/30/2017,38,9:15,9:30,,35.84,0,35.84,35.84,-1,-77679,75278,152957,-2401,0,-1031,0,0,0,,1031,-1031
48,11/30/2017,39,9:30,9:45,,,0,38.26,38.26,0,-77525,60454,137979,-17071,0,0,0,0,0,,0,0
48,11/30/2017,40,9:45,10:00,,,0,38.25,38.25,0,-71819,57295,129114,-14524,0,0,0,0,0,,0,0
48,11/30/2017,41,10:00,10:15,42.13,,0,42.13,42.13,1,-70822,52913,123735,-17909,0,0,69,0,0,,69,69
48,11/30/2017,42,10:15,10:30,44.07,,0,44.07,44.07,1,-83802,57381,141183,-26421,0,0,566,0,0,,566,566
48,11/30/2017,43,10:30,10:45,64.51,,0,64.51,64.51,1,-127964,72089,200053,-55875,0,0,2897,0,0,,2897,2897
48,11/30/2017,44,10:45,11:00,394.21,,0,394.21,394.21,1,-221950,77953,299903,-143997,0,0,34440,0,0,,34440,34440
48,11/30/2017,45,11:00,11:15,133.08,,0,133.08,133.08,1,-191138,97142,288280,-93996,0,0,37622,0,0,,37622,37622
48,11/30/2017,46,11:15,11:30,393.85,,0,393.85,393.85,1,-193365,86073,279438,-107292,0,0,67509,0,0,,67509,67509
48,11/30/2017,47,11:30,11:45,393.85,,0,393.85,393.85,1,-165445,76570,242015,-88875,0,0,84707,0,0,,84707,84707
48,11/30/2017,48,11:45,12:00,186.7,33.92,0,33.92,33.92,-1,-144377,119343,263720,-25034,0,-452,41413,1250,0,,43115,42211
48,11/30/2017,49,12:00,12:15,186.7,32.48,0,32.48,32.48,-1,-35490,187309,222799,151819,0,-3386,8,0,0,,3394,-3378
48,11/30/2017,50,12:15,12:30,,37.01,0,37.01,37.01,-1,-52986,164475,217461,111489,0,-95,0,0,0,,95,-95
48,11/30/2017,51,12:30,12:45,,25.75,0,25.75,25.75,-1,-41929,200677,242606,158748,0,-11346,0,0,0,,11346,-11346
48,11/30/2017,52,12:45,13:00,,-1.65,0,-1.65,-1.65,-1,-43586,218817,262403,175231,0,-28873,0,0,0,,28873,-28873
48,11/30/2017,53,13:00,13:15,60.08,0.83,0,60.08,0.83,2,-83092,87154,170246,4062,0,-21274,2543,0,0,,23817,-18731
48,11/30/2017,54,13:15,13:30,,,0,38.08,38.08,0,-83955,72999,156954,-10956,0,0,495,0,0,,495,495
48,11/30/2017,55,13:30,13:45,53.34,,0,53.34,53.34,1,-82877,71528,154405,-11349,0,0,3351,0,0,,3351,3351
48,11/30/2017,56,13:45,14:00,,,0,38.1,38.1,0,-84379,87981,172360,3602,0,0,0,0,0,,0,0
48,11/30/2017,57,14:00,14:15,292.2,,0,292.2,292.2,1,-124952,76177,201129,-48775,0,0,14338,0,0,,14338,14338
48,11/30/2017,58,14:15,14:30,52.81,35.84,0,35.84,35.84,-1,-85246,98601,183847,13355,0,-306,11933,0,0,,12239,11627
48,11/30/2017,59,14:30,14:45,52.81,34.23,0,34.23,34.23,-1,-88937,79048,167985,-9889,0,-2981,9,0,0,,2990,-2972
48,11/30/2017,60,14:45,15:00,,,0,38.11,38.11,0,-113884,64969,178853,-48915,0,0,0,0,0,,0,0
48,11/30/2017,61,15:00,15:15,,,0,38.25,38.25,0,-103985,107645,211630,3660,0,0,0,0,0,,0,0
48,11/30/2017,62,15:15,15:30,54.22,,0,54.22,54.22,1,-108909,100056,208965,-8853,0,0,4195,0,0,,4195,4195
48,11/30/2017,63,15:30,15:45,54.22,,0,54.22,54.22,1,-94252,88273,182525,-5979,0,0,9393,0,0,,9393,9393
48,11/30/2017,64,15:45,16:00,42.89,,0,42.89,42.89,1,-94165,90675,184840,-3490,0,0,2604,0,0,,2604,2604
48,11/30/2017,65,16:00,16:15,42.89,31.38,0,31.38,31.38,-1,-36213,184441,220654,148228,0,-7403,300,0,0,,7703,-7103
48,11/30/2017,66,16:15,16:30,,36.9,0,36.9,36.9,-1,-31922,172498,204420,140576,0,-4053,0,0,0,,4053,-4053
48,11/30/2017,67,16:30,16:45,,35.84,0,35.84,35.84,-1,-33058,152402,185460,119344,0,-198,0,0,0,,198,-198
48,11/30/2017,68,16:45,17:00,56.06,,0,56.06,56.06,1,-83111,115727,198838,32616,0,0,455,0,0,,455,455
48,11/30/2017,69,17:00,17:15,106.12,,0,106.12,106.12,1,-147236,48485,195721,-98751,0,0,3459,0,0,,3459,3459
48,11/30/2017,70,17:15,17:30,447.14,,0,447.14,447.14,1,-152490,45563,198053,-106927,0,0,36659,0,0,,36659,36659
48,11/30/2017,71,17:30,17:45,350.08,,0,350.08,350.08,1,-113868,55002,168870,-58866,0,0,59228,0,0,,59228,59228
48,11/30/2017,72,17:45,18:00,70.12,,0,70.12,70.12,1,-74810,58341,133151,-16469,0,0,18654,0,0,,18654,18654
48,11/30/2017,73,18:00,18:15,70.12,36.94,0,36.94,36.94,-1,-99121,51584,150705,-47537,0,-8,325,0,0,,333,317
48,11/30/2017,74,18:15,18:30,,36.6,0,36.6,36.6,-1,-74560,62865,137425,-11695,0,-232,0,0,0,,232,-232
48,11/30/2017,75,18:30,18:45,,,0,34.62,34.62,0,-89103,77372,166475,-11731,0,0,0,0,0,,0,0
48,11/30/2017,76,18:45,19:00,,37.04,0,37.04,37.04,-1,-81164,92340,173504,11176,0,-14,0,0,0,,14,-14
48,11/30/2017,77,19:00,19:15,57.24,,0,57.24,57.24,1,-100630,45030,145660,-55600,0,0,2019,0,0,,2019,2019
48,11/30/2017,78,19:15,19:30,47.24,,0,47.24,47.24,1,-75999,59246,135245,-16753,0,0,1589,0,0,,1589,1589
48,11/30/2017,79,19:30,19:45,,24.45,0,24.45,24.45,-1,-56711,83151,139862,26440,0,-11365,0,0,0,,11365,-11365
48,11/30/2017,80,19:45,20:00,41.82,34.84,0,41.82,41.82,1,-70582,47692,118274,-22890,0,-9630,423,0,0,,10053,-9207
48,11/30/2017,81,20:00,20:15,37.84,,0,37.84,37.84,1,-86162,51015,137177,-35147,0,0,2120,0,0,,2120,2120
48,11/30/2017,82,20:15,20:30,37.24,,0,37.24,37.24,1,-72826,28842,101668,-43984,0,0,583,0,0,,583,583
48,11/30/2017,83,20:30,20:45,51.35,,0,51.35,51.35,1,-75836,38106,113942,-37730,0,0,7153,0,0,,7153,7153
48,11/30/2017,84,20:45,21:00,51.35,51.41,0,51.41,51.41,-1,-59432,66480,125912,7048,0,-104,843,0,0,,947,739
48,11/30/2017,85,21:00,21:15,132.01,51.41,0,132.01,132.01,1,-92025,59961,151986,-32064,0,-10,12484,0,0,,12494,12474
48,11/30/2017,86,21:15,21:30,42.69,32.91,0,44.3,32.91,2,-52154,52125,104279,-29,0,-1011,12316,0,0,,13327,11305
48,11/30/2017,87,21:30,21:45,42.69,32.28,0,32.28,32.28,-1,-55822,56233,112055,411,0,-1061,381,0,0,,1442,-680
48,11/30/2017,88,21:45,22:00,,6.35,0,6.35,6.35,-1,-46727,102445,149172,55718,0,-29519,0,0,0,,29519,-29519
48,11/30/2017,89,22:00,22:15,89.08,14.66,0,89.08,14.66,2,-88719,19994,108713,-68725,0,-26020,2865,0,0,,28885,-23155
48,11/30/2017,90,22:15,22:30,37.65,,0,37.65,37.65,1,-62751,27002,89753,-35749,0,0,724,0,0,,724,724
48,11/30/2017,91,22:30,22:45,,33.71,0,33.71,33.71,-1,-53847,64088,117935,10241,0,-892,0,0,0,,892,-892
48,11/30/2017,92,22:45,23:00,,15.23,0,15.23,15.23,-1,-39464,73366,112830,33902,0,-4588,0,0,0,,4588,-4588
48,11/30/2017,93,23:00,23:15,39.32,-15,0,39.32,-15,2,-29148,33793,62941,4645,0,-24645,127,0,0,,24772,-24518
48,11/30/2017,94,23:15,23:30,,,0,33.47,33.47,0,-75873,30772,106645,-45101,0,-22,21,0,0,,43,-1
48,11/30/2017,95,23:30,23:45,,33.43,0,33.43,33.43,-1,-48549,56871,105420,8322,0,-672,0,0,0,,672,-672
48,11/30/2017,96,23:45,0:00,,-31.35,0,-31.35,-31.35,-1,-35547,96226,131773,60679,0,-35216,0,0,0,,35216,-35216
48,12-01-17,1,0:00,0:15,,-61.68,0,-61.68,-61.68,-1,-34885,105243,140128,70358,0,-63481,0,0,0,,63481,-63481
48,12-01-17,2,0:15,0:30,43.68,-61.68,0,43.68,43.68,1,-99437,70020,169457,-29417,0,-3013,2173,0,0,,5186,-840
48,12-01-17,3,0:30,0:45,41.53,30.07,0,41.53,30.07,2,-64780,69159,133939,4379,0,-981,1752,0,0,,2733,771
48,12-01-17,4,0:45,1:00,41.53,13.98,0,13.98,13.98,-1,-58627,109507,168134,50880,0,-28126,6,0,0,,28132,-28120
48,12-01-17,5,1:00,1:15,133.47,13.98,0,133.47,133.47,1,-139573,12910,152483,-126663,0,-7306,16627,0,0,,23933,9321
48,12-01-17,6,1:15,1:30,133.47,,0,133.47,133.47,1,-81891,35121,117012,-46770,0,0,50062,0,0,,50062,50062
48,12-01-17,7,1:30,1:45,43.68,,0,43.68,43.68,1,-68612,33719,102331,-34893,0,0,4721,0,0,,4721,4721
48,12-01-17,8,1:45,2:00,44.98,35.07,0,44.98,35.07,2,-66699,44553,111252,-22146,0,-68,4650,0,0,,4718,4582
48,12-01-17,9,2:00,2:15,,21.29,0,21.29,21.29,-1,-25864,70944,96808,45080,0,-17444,0,0,0,,17444,-17444
48,12-01-17,10,2:15,2:30,,10.15,0,10.15,10.15,-1,-12858,59911,72769,47053,0,-31493,0,0,0,,31493,-31493
48,12-01-17,11,2:30,2:45,,10.02,0,10.02,10.02,-1,-17559,83965,101524,66406,0,-49102,0,0,0,,49102,-49102
48,12-01-17,12,2:45,3:00,,-9.8,0,-9.8,-9.8,-1,-42054,113098,155152,71044,0,-78194,0,0,0,,78194,-78194
48,12-01-17,13,3:00,3:15,,30.07,0,30.07,30.07,-1,-34041,69899,103940,35858,0,-39026,0,0,0,,39026,-39026
48,12-01-17,14,3:15,3:30,,18.63,0,18.63,18.63,-1,-33336,75840,109176,42504,0,-23554,0,0,0,,23554,-23554
48,12-01-17,15,3:30,3:45,,17.61,0,17.61,17.61,-1,-35713,86144,121857,50431,0,-52469,0,0,0,,52469,-52469
48,12-01-17,16,3:45,4:00,,31.33,0,31.33,31.33,-1,-35703,76365,112068,40662,0,-37954,0,0,0,,37954,-37954
48,12-01-17,17,4:00,4:15,41.53,34.07,0,41.53,34.07,2,-56532,19282,75814,-37250,0,-14268,1217,0,0,,15485,-13051
48,12-01-17,18,4:15,4:30,,,0,34.41,34.41,0,-49104,30816,79920,-18288,0,0,20,0,0,,20,20
48,12-01-17,19,4:30,4:45,,35.07,0,35.07,35.07,-1,-49119,48746,97865,-373,0,-556,0,0,0,,556,-556
48,12-01-17,20,4:45,5:00,,,0,34.4,34.4,0,-47489,29398,76887,-18091,0,-85,0,0,0,,85,-85
48,12-01-17,21,5:00,5:15,,-67.12,0,-67.12,-67.12,-1,-36885,120399,157284,83514,0,-30363,0,0,0,,30363,-30363
48,12-01-17,22,5:15,5:30,,18.03,0,18.03,18.03,-1,-41295,107938,149233,66643,0,-69567,0,0,0,,69567,-69567
48,12-01-17,23,5:30,5:45,37.07,27.88,0,37.07,37.07,1,-43133,66974,110107,23841,0,-37976,27,0,0,,38003,-37949
48,12-01-17,24,5:45,6:00,66.62,27.88,0,66.62,66.62,1,-58203,29274,87477,-28929,0,-679,16198,0,0,,16877,15519
48,12-01-17,25,6:00,6:15,45.06,34.41,0,45.06,34.41,2,-146231,47210,193441,-99021,0,-167,14867,0,0,,15034,14700
48,12-01-17,26,6:15,6:30,45.06,23.04,0,23.04,23.04,-1,-48245,54430,102675,6185,0,-9088,1384,0,0,,10472,-7704
48,12-01-17,27,6:30,6:45,,36.94,0,36.94,36.94,-1,-45682,36451,82133,-9231,0,-85,0,0,0,,85,-85
48,12-01-17,28,6:45,7:00,,4.04,0,4.04,4.04,-1,-93354,34250,127604,-59104,0,-3650,0,0,0,,3650,-3650
48,12-01-17,29,7:00,7:15,,-35.73,0,-35.73,-35.73,-1,-74262,129811,204073,55549,0,-47834,0,0,0,,47834,-47834
48,12-01-17,30,7:15,7:30,44.19,-35.73,0,44.19,44.19,1,-91062,87358,178420,-3704,0,-4994,744,0,0,,5738,-4250
48,12-01-17,31,7:30,7:45,273.88,,0,273.88,273.88,1,-110309,56615,166924,-53694,0,0,25489,0,0,,25489,25489
48,12-01-17,32,7:45,8:00,273.88,,0,273.88,273.88,1,-144696,57162,201858,-87534,0,0,73241,0,0,,73241,73241
48,12-01-17,33,8:00,8:15,273.88,-20.36,0,-20.36,-20.36,-1,-50948,141796,192744,90848,0,-23025,27791,0,0,,50816,4766
48,12-01-17,34,8:15,8:30,,30.03,0,30.03,30.03,-1,-76076,105409,181485,29333,0,-10674,0,0,0,,10674,-10674
48,12-01-17,35,8:30,8:45,,30.26,0,30.26,30.26,-1,-84396,102300,186696,17904,0,-20810,0,0,0,,20810,-20810
48,12-01-17,36,8:45,9:00,38.99,30.26,0,38.99,38.99,1,-90467,84040,174507,-6427,0,-1409,113,0,0,,1522,-1296
48,12-01-17,37,9:00,9:15,91.23,,0,91.23,91.23,1,-87982,60333,148315,-27649,0,0,14484,0,0,,14484,14484
48,12-01-17,38,9:15,9:30,62.77,,0,62.77,62.77,1,-79367,54042,133409,-25325,0,0,18249,0,0,,18249,18249
48,12-01-17,39,9:30,9:45,77.2,,0,77.2,77.2,1,-79164,46530,125694,-32634,0,0,27503,0,0,,27503,27503
48,12-01-17,40,9:45,10:00,350.9,,0,350.9,350.9,1,-123205,40150,163355,-83055,0,0,39599,0,0,,39599,39599
48,12-01-17,41,10:00,10:15,350.9,,0,385.99,385.99,1,-209802,59907,269709,-149895,0,0,76833,0,10000,,86833,86833
48,12-01-17,42,10:15,10:30,198.93,,0,271.53,271.53,1,-176473,91365,267838,-85108,0,0,69575,0,15000,,84575,84575
48,12-01-17,43,10:30,10:45,145.9,,0,271.53,271.53,1,-166779,95754,262533,-71025,0,0,55671,0,15000,,70671,70671
48,12-01-17,44,10:45,11:00,216.83,,0,271.53,271.53,1,-169110,97300,266410,-71810,0,0,33996,0,10000,,43996,43996
48,12-01-17,45,11:00,11:15,201.3,,0,201.3,201.3,1,-139026,76896,215922,-62130,0,0,50068,0,0,,50068,50068
48,12-01-17,46,11:15,11:30,65.28,,0,65.28,65.28,1,-127819,75523,203342,-52296,0,0,29285,0,0,,29285,29285
48,12-01-17,47,11:30,11:45,260.69,,0,260.69,260.69,1,-134687,54561,189248,-80126,0,0,23378,0,0,,23378,23378
48,12-01-17,48,11:45,12:00,85.03,,0,85.03,85.03,1,-128146,66839,194985,-61307,0,0,40740,0,0,,40740,40740
48,12-01-17,49,12:00,12:15,85.03,30.26,0,30.26,30.26,-1,-37700,143907,181607,106207,0,-2708,8859,0,0,,11567,6151
48,12-01-17,50,12:15,12:30,,34.26,0,34.26,34.26,-1,-47095,102019,149114,54924,0,-2504,0,0,0,,2504,-2504
48,12-01-17,51,12:30,12:45,,24.67,0,24.67,24.67,-1,-41014,93077,134091,52063,0,-13407,0,0,0,,13407,-13407
48,12-01-17,52,12:45,13:00,,29.15,0,29.15,29.15,-1,-46815,78826,125641,32011,0,-20832,0,0,0,,20832,-20832
48,12-01-17,53,13:00,13:15,63.52,34.26,0,63.52,34.26,2,-101944,78231,180175,-23713,0,-11123,1856,0,0,,12979,-9267
48,12-01-17,54,13:15,13:30,38.99,54.22,0,46.29,46.29,2,-71669,57888,129557,-13781,0,-12,1194,0,0,,1206,1182
48,12-01-17,55,13:30,13:45,,0.33,0,0.33,0.33,-1,-47047,109430,156477,62383,0,-20203,0,0,0,,20203,-20203
48,12-01-17,56,13:45,14:00,,30.26,0,30.26,30.26,-1,-72974,80559,153533,7585,0,-14227,0,0,0,,14227,-14227
48,12-01-17,57,14:00,14:15,,35.26,0,35.26,35.26,-1,-62960,65690,128650,2730,0,-334,0,0,0,,334,-334
48,12-01-17,58,14:15,14:30,,53.29,0,53.29,53.29,-1,-57824,59386,117210,1562,0,-85,0,0,0,,85,-85
48,12-01-17,59,14:30,14:45,,34.26,0,34.26,34.26,-1,-52865,64587,117452,11722,0,-1997,0,0,0,,1997,-1997
48,12-01-17,60,14:45,15:00,,10.59,0,10.59,10.59,-1,-43561,94058,137619,50497,0,-27074,0,0,0,,27074,-27074
48,12-01-17,61,15:00,15:15,38.99,53.14,0,45.67,45.67,2,-69992,67752,137744,-2240,0,-7205,484,0,0,,7689,-6721
48,12-01-17,62,15:15,15:30,38.99,34.26,0,34.26,34.26,-1,-61172,69370,130542,8198,0,-1874,12,0,0,,1886,-1862
48,12-01-17,63,15:30,15:45,,32.26,0,32.26,32.26,-1,-59703,78378,138081,18675,0,-2256,0,0,0,,2256,-2256
48,12-01-17,64,15:45,16:00,,34.26,0,34.26,34.26,-1,-63639,86011,149650,22372,0,-4441,0,0,0,,4441,-4441
48,12-01-17,65,16:00,16:15,,53.17,0,53.17,53.17,-1,-127914,124721,252635,-3193,0,-273,0,0,0,,273,-273
48,12-01-17,66,16:15,16:30,,51.91,0,51.91,51.91,-1,-87484,105796,193280,18312,0,-1035,0,0,0,,1035,-1035
48,12-01-17,67,16:30,16:45,38.99,29.98,0,45.85,29.98,2,-47120,72051,119171,24931,0,-7507,11,0,0,,7518,-7496
48,12-01-17,68,16:45,17:00,350.9,29.98,0,350.9,350.9,1,-101813,27459,129272,-74354,0,-499,29567,0,0,,30066,29068
48,12-01-17,69,17:00,17:15,357.66,20.59,0,357.66,20.59,2,-28119,36618,64737,8499,0,-1720,50428,0,0,,52148,48708
48,12-01-17,70,17:15,17:30,,,0,46.77,46.77,0,-28379,50891,79270,22512,0,-1626,325,0,0,,1951,-1301
48,12-01-17,71,17:30,17:45,,26.74,0,26.74,26.74,-1,-36058,52252,88310,16194,0,-8434,0,0,0,,8434,-8434
48,12-01-17,72,17:45,18:00,46.99,35.26,0,46.99,35.26,2,-32539,38845,71384,6306,0,-635,728,0,0,,1363,93
48,12-01-17,73,18:00,18:15,,,0,46.5,46.5,0,-71294,37834,109128,-33460,0,0,0,0,0,,0,0
48,12-01-17,74,18:15,18:30,,,0,46.51,46.51,0,-42598,38670,81268,-3928,0,0,0,0,0,,0,0
48,12-01-17,75,18:30,18:45,,34.26,0,34.26,34.26,-1,-33951,49040,82991,15089,0,-2315,0,0,0,,2315,-2315
48,12-01-17,76,18:45,19:00,,20.64,0,20.64,20.64,-1,-37644,80934,118578,43290,0,-20170,0,0,0,,20170,-20170
48,12-01-17,77,19:00,19:15,69.9,20.64,0,69.9,69.9,1,-72173,21042,93215,-51131,0,-12698,1665,0,0,,14363,-11033
48,12-01-17,78,19:15,19:30,,54.21,0,54.21,54.21,-1,-48599,43383,91982,-5216,0,-16,0,0,0,,16,-16
48,12-01-17,79,19:30,19:45,,34.26,0,34.26,34.26,-1,-36809,49027,85836,12218,0,-6474,0,0,0,,6474,-6474
48,12-01-17,80,19:45,20:00,,53.36,0,53.36,53.36,-1,-52223,56681,108904,4458,0,-1135,0,0,0,,1135,-1135
48,12-01-17,81,20:00,20:15,71.21,53.58,0,71.21,45.89,2,-59671,22149,81820,-37522,0,-80,5206,0,0,,5286,5126
48,12-01-17,82,20:15,20:30,44.19,,0,44.19,44.19,1,-52199,31907,84106,-20292,0,0,6650,0,0,,6650,6650
48,12-01-17,83,20:30,20:45,44.19,35.26,0,35.26,35.26,-1,-39145,32814,71959,-6331,0,-144,461,0,0,,605,317
48,12-01-17,84,20:45,21:00,,28.41,0,28.41,28.41,-1,-45131,69197,114328,24066,0,-6606,0,0,0,,6606,-6606
48,12-01-17,85,21:00,21:15,175.51,-6.36,0,175.51,-6.36,2,-42390,34919,77309,-7471,0,-28790,1826,0,0,,30616,-26964
48,12-01-17,86,21:15,21:30,138.9,35.26,0,138.9,35.26,2,-34115,27301,61416,-6814,0,-382,5105,0,0,,5487,4723
48,12-01-17,87,21:30,21:45,,20.55,0,20.55,20.55,-1,-39415,68550,107965,29135,0,-6909,0,0,0,,6909,-6909
48,12-01-17,88,21:45,22:00,,10.4,0,10.4,10.4,-1,-42372,98954,141326,56582,0,-47815,0,0,0,,47815,-47815
48,12-01-17,89,22:00,22:15,39.04,15.1,0,39.04,15.1,2,-67878,70027,137905,2149,0,-34255,126,0,0,,34381,-34129
48,12-01-17,90,22:15,22:30,44.19,27.38,0,44.19,27.38,2,-37313,51957,89270,14644,0,-5591,1260,0,0,,6851,-4331
48,12-01-17,91,22:30,22:45,44.19,24.17,0,44.19,24.17,2,-37256,35383,72639,-1873,0,-14511,200,0,0,,14711,-14311
48,12-01-17,92,22:45,23:00,48.96,24.17,0,48.96,48.96,1,-91949,42642,134591,-49307,0,-283,3326,0,0,,3609,3043
48,12-01-17,93,23:00,23:15,62.35,,0,62.35,62.35,1,-42009,26520,68529,-15489,0,0,2720,0,0,,2720,2720
48,12-01-17,94,23:15,23:30,42.22,,0,42.22,42.22,1,-75180,18662,93842,-56518,0,0,3042,0,0,,3042,3042
48,12-01-17,95,23:30,23:45,51.57,,0,51.57,51.57,1,-67401,26929,94330,-40472,0,0,4486,0,0,,4486,4486
48,12-01-17,96,23:45,0:00,51.57,26.88,0,26.88,26.88,-1,-47305,66211,113516,18906,0,-7586,12,0,0,,7598,-7574
49,12-02-17,1,0:00,0:15,,8.33,0,8.33,8.33,-1,-73208,137866,211074,64658,0,-33542,0,0,0,,33542,-33542
49,12-02-17,2,0:15,0:30,,34.26,0,34.26,34.26,-1,-43343,53361,96704,10018,0,-16907,0,0,0,,16907,-16907
49,12-02-17,3,0:30,0:45,,17.78,0,17.78,17.78,-1,-28916,70331,99247,41415,0,-22190,0,0,0,,22190,-22190
49,12-02-17,4,0:45,1:00,,26.74,0,26.74,26.74,-1,-28071,75026,103097,46955,0,-41861,0,0,0,,41861,-41861
49,12-02-17,5,1:00,1:15,81.98,17.89,0,81.98,81.98,1,-64513,76297,140810,11784,0,-31217,867,0,0,,32084,-30350
49,12-02-17,6,1:15,1:30,133.14,17.89,0,133.14,133.14,1,-76676,32991,109667,-43685,0,-951,31810,0,0,,32761,30859
49,12-02-17,7,1:30,1:45,133.14,31.51,0,31.51,31.51,-1,-21123,39699,60822,18576,0,-8236,2947,0,0,,11183,-5289
49,12-02-17,8,1:45,2:00,,31.37,0,31.37,31.37,-1,-24697,56650,81347,31953,0,-24695,0,0,0,,24695,-24695
49,12-02-17,9,2:00,2:15,44.19,32.57,0,44.19,44.19,1,-40238,34789,75027,-5449,0,-18022,1121,0,0,,19143,-16901
49,12-02-17,10,2:15,2:30,,,0,35.22,35.22,0,-34155,41475,75630,7320,0,-30,372,0,0,,402,342
49,12-02-17,11,2:30,2:45,,30.26,0,30.26,30.26,-1,-24585,49244,73829,24659,0,-8346,0,0,0,,8346,-8346
49,12-02-17,12,2:45,3:00,,30.26,0,30.26,30.26,-1,-27509,59388,86897,31879,0,-22914,0,0,0,,22914,-22914
49,12-02-17,13,3:00,3:15,44.19,30.26,0,44.19,44.19,1,-58858,27018,85876,-31840,0,-7960,1198,0,0,,9158,-6762
49,12-02-17,14,3:15,3:30,44.24,,0,44.24,44.24,1,-52174,28994,81168,-23180,0,0,7968,0,0,,7968,7968
49,12-02-17,15,3:30,3:45,39.08,,0,39.08,39.08,1,-38515,28110,66625,-10405,0,0,2395,0,0,,2395,2395
49,12-02-17,16,3:45,4:00,,,0,35.17,35.17,0,-34076,27912,61988,-6164,0,0,0,0,0,,0,0
49,12-02-17,17,4:00,4:15,,,0,35.16,35.16,0,-34146,36185,70331,2039,0,0,0,0,0,,0,0
49,12-02-17,18,4:15,4:30,,,0,35.15,35.15,0,-37525,35445,72970,-2080,0,0,0,0,0,,0,0
49,12-02-17,19,4:30,4:45,,,0,35.15,35.15,0,-41127,30557,71684,-10570,0,0,0,0,0,,0,0
49,12-02-17,20,4:45,5:00,,,0,35.15,35.15,0,-45885,28270,74155,-17615,0,0,0,0,0,,0,0
49,12-02-17,21,5:00,5:15,,35.26,0,35.26,35.26,-1,-49257,44838,94095,-4419,0,-244,0,0,0,,244,-244
49,12-02-17,22,5:15,5:30,,34.26,0,34.26,34.26,-1,-33412,35031,68443,1619,0,-4729,0,0,0,,4729,-4729
49,12-02-17,23,5:30,5:45,44.19,34.26,0,44.19,44.19,1,-42527,22091,64618,-20436,0,-27,2900,0,0,,2927,2873
49,12-02-17,24,5:45,6:00,44.19,,0,44.19,44.19,1,-48095,21582,69677,-26513,0,0,10962,0,0,,10962,10962
49,12-02-17,25,6:00,6:15,44.19,20.69,0,20.69,20.69,-1,-51080,86837,137917,35757,0,-12925,3403,0,0,,16328,-9522
49,12-02-17,26,6:15,6:30,,33.78,0,33.78,33.78,-1,-29692,44702,74394,15010,0,-19764,0,0,0,,19764,-19764
49,12-02-17,27,6:30,6:45,,35.66,0,35.66,35.66,-1,-34215,38442,72657,4227,0,-2950,0,0,0,,2950,-2950
49,12-02-17,28,6:45,7:00,44.62,35.66,0,44.62,44.62,1,-43682,32295,75977,-11387,0,-12,2744,0,0,,2756,2732
49,12-02-17,29,7:00,7:15,44.62,2.78,0,2.78,2.78,-1,-28191,76609,104800,48418,0,-19041,247,0,0,,19288,-18794
49,12-02-17,30,7:15,7:30,,34.66,0,34.66,34.66,-1,-40588,50677,91265,10089,0,-19403,0,0,0,,19403,-19403
49,12-02-17,31,7:30,7:45,38.5,38.65,0,38.5,35.67,2,-59215,56418,115633,-2797,0,-1350,1,0,0,,1351,-1349
49,12-02-17,32,7:45,8:00,107.12,,0,107.12,107.12,1,-83037,47111,130148,-35926,0,0,19848,0,0,,19848,19848
49,12-02-17,33,8:00,8:15,107.12,-36.34,0,-36.34,-36.34,-1,-26170,110785,136955,84615,0,-30093,6987,0,0,,37080,-23106
49,12-02-17,34,8:15,8:30,,27.5,0,27.5,27.5,-1,-23496,69732,93228,46236,0,-43605,0,0,0,,43605,-43605
49,12-02-17,35,8:30,8:45,38.87,34.84,0,38.87,34.84,2,-33065,46708,79773,13643,0,-18121,28,0,0,,18149,-18093
49,12-02-17,36,8:45,9:00,50.62,34.84,0,50.62,50.62,1,-78066,54405,132471,-23661,0,-1822,10797,0,0,,12619,8975
49,12-02-17,37,9:00,9:15,50.62,26.74,0,26.74,26.74,-1,-23689,70696,94385,47007,0,-8826,4882,0,0,,13708,-3944
49,12-02-17,38,9:15,9:30,40.96,26.74,0,40.96,40.96,1,-39629,44214,83843,4585,0,-603,742,0,0,,1345,139
49,12-02-17,39,9:30,9:45,40.93,,0,40.93,40.93,1,-52721,41672,94393,-11049,0,0,788,0,0,,788,788
49,12-02-17,40,9:45,10:00,52.1,,0,52.1,52.1,1,-79036,46797,125833,-32239,0,0,10052,0,0,,10052,10052
49,12-02-17,41,10:00,10:15,42.93,,0,42.93,42.93,1,-71917,64987,136904,-6930,0,0,13767,0,0,,13767,13767
49,12-02-17,42,10:15,10:30,42.93,36.94,0,36.94,36.94,-1,-79191,68381,147572,-10810,0,-376,947,0,0,,1323,571
49,12-02-17,43,10:30,10:45,,37.85,0,37.85,37.85,-1,-88280,51514,139794,-36766,0,-26,0,0,0,,26,-26
49,12-02-17,44,10:45,11:00,,,0,35.56,35.56,0,-92355,43508,135863,-48847,0,0,0,0,0,,0,0
49,12-02-17,45,11:00,11:15,158.97,,0,158.97,158.97,1,-107566,31050,138616,-76516,0,0,27571,0,0,,27571,27571
49,12-02-17,46,11:15,11:30,158.97,,0,158.97,158.97,1,-79041,39757,118798,-39284,0,0,52100,0,0,,52100,52100
49,12-02-17,47,11:30,11:45,39.51,,0,39.51,39.51,1,-80761,66492,147253,-14269,0,0,6608,0,0,,6608,6608
49,12-02-17,48,11:45,12:00,44.62,,0,44.62,44.62,1,-83695,60537,144232,-23158,0,0,8351,0,0,,8351,8351
49,12-02-17,49,12:00,12:15,120.82,,0,120.82,120.82,1,-99385,36687,136072,-62698,0,0,31851,0,0,,31851,31851
49,12-02-17,50,12:15,12:30,50.62,,0,50.62,50.62,1,-80507,34825,115332,-45682,0,0,30115,0,0,,30115,30115
49,12-02-17,51,12:30,12:45,44.62,,0,44.62,44.62,1,-72282,36412,108694,-35870,0,0,21556,0,0,,21556,21556
49,12-02-17,52,12:45,13:00,41.49,,0,41.49,41.49,1,-66143,42748,108891,-23395,0,0,17525,0,0,,17525,17525
49,12-02-17,53,13:00,13:15,102.25,,0,102.25,102.25,1,-83688,25272,108960,-58416,0,0,17416,0,0,,17416,17416
49,12-02-17,54,13:15,13:30,110.79,,0,110.79,110.79,1,-65567,33812,99379,-31755,0,0,27825,0,0,,27825,27825
49,12-02-17,55,13:30,13:45,38.47,36.8,0,38.47,35.08,2,-55662,49923,105585,-5739,0,-349,1143,0,0,,1492,794
49,12-02-17,56,13:45,14:00,38.87,,0,38.87,38.87,1,-50966,50033,100999,-933,0,0,247,0,0,,247,247
49,12-02-17,57,14:00,14:15,139.25,,0,139.25,139.25,1,-86511,17143,103654,-69368,0,0,30387,0,0,,30387,30387
49,12-02-17,58,14:15,14:30,47,37.67,0,47,35.02,2,-50142,25977,76119,-24165,0,-34,15029,0,0,,15063,14995
49,12-02-17,59,14:30,14:45,59.57,,0,59.57,59.57,1,-65559,28635,94194,-36924,0,0,21385,0,0,,21385,21385
49,12-02-17,60,14:45,15:00,59.98,,0,59.98,59.98,1,-59994,34246,94240,-25748,0,0,29900,0,0,,29900,29900
49,12-02-17,61,15:00,15:15,85.39,,0,85.39,85.39,1,-83886,23514,107400,-60372,0,0,28141,0,0,,28141,28141
49,12-02-17,62,15:15,15:30,50.62,,0,50.62,50.62,1,-63431,28362,91793,-35069,0,0,30757,0,0,,30757,30757
49,12-02-17,63,15:30,15:45,47.89,,0,47.89,47.89,1,-58427,22723,81150,-35704,0,0,26849,0,0,,26849,26849
49,12-02-17,64,15:45,16:00,38.89,,0,38.89,38.89,1,-64689,28852,93541,-35837,0,0,5185,0,0,,5185,5185
49,12-02-17,65,16:00,16:15,40.4,34.66,0,40.4,34.66,2,-61573,80413,141986,18840,0,-1580,232,0,0,,1812,-1348
49,12-02-17,66,16:15,16:30,,34.5,0,34.5,34.5,-1,-65984,70167,136151,4183,0,-3490,0,0,0,,3490,-3490
49,12-02-17,67,16:30,16:45,,,0,38.39,38.39,0,-83971,58490,142461,-25481,0,-104,0,0,0,,104,-104
49,12-02-17,68,16:45,17:00,165.17,,0,165.17,165.17,1,-123708,36124,159832,-87584,0,0,4384,0,0,,4384,4384
49,12-02-17,69,17:00,17:15,195.9,31.39,0,195.9,31.39,2,-79985,84961,164946,4976,0,-1405,16275,0,0,,17680,14870
49,12-02-17,70,17:15,17:30,44.62,38.2,0,48.64,38.2,2,-70456,68825,139281,-1631,0,-1656,361,0,0,,2017,-1295
49,12-02-17,71,17:30,17:45,76.25,38.2,0,76.25,76.25,1,-85254,47807,133061,-37447,0,-47,14391,0,0,,14438,14344
49,12-02-17,72,17:45,18:00,44.72,36.15,0,48.64,36.15,2,-63569,44990,108559,-18579,0,-16,20450,0,0,,20466,20434
49,12-02-17,73,18:00,18:15,44.72,30.66,0,30.66,30.66,-1,-87970,71798,159768,-16172,0,-1920,3133,0,0,,5053,1213
49,12-02-17,74,18:15,18:30,,,0,35.66,35.66,0,-99630,74730,174360,-24900,0,0,0,0,0,,0,0
49,12-02-17,75,18:30,18:45,,29.87,0,29.87,29.87,-1,-86897,103083,189980,16186,0,-3139,0,0,0,,3139,-3139
49,12-02-17,76,18:45,19:00,,8.68,0,8.68,8.68,-1,-81246,114574,195820,33328,0,-40765,0,0,0,,40765,-40765
49,12-02-17,77,19:00,19:15,85.25,-46.1,0,85.25,-46.1,2,-123084,106473,229557,-16611,0,-52596,1106,0,0,,53702,-51490
49,12-02-17,78,19:15,19:30,365.25,-46.1,0,365.25,365.25,1,-128196,65688,193884,-62508,0,-3303,24881,0,0,,28184,21578
49,12-02-17,79,19:30,19:45,365.25,34.66,0,34.66,34.66,-1,-88410,94950,183360,6540,0,-1605,3608,0,0,,5213,2003
49,12-02-17,80,19:45,20:00,,30.66,0,30.66,30.66,-1,-76959,100886,177845,23927,0,-16720,0,0,0,,16720,-16720
49,12-02-17,81,20:00,20:15,132.12,35.66,0,132.12,35.23,2,-141733,91610,233343,-50123,0,-7953,14543,0,0,,22496,6590
49,12-02-17,82,20:15,20:30,44.65,,0,44.65,44.65,1,-104167,94458,198625,-9709,0,0,10484,0,0,,10484,10484
49,12-02-17,83,20:30,20:45,42.48,37.82,0,42.48,35.24,2,-97471,94874,192345,-2597,0,-24,1213,0,0,,1237,1189
49,12-02-17,84,20:45,21:00,40.62,,0,40.62,40.62,1,-87740,88593,176333,853,0,0,1489,0,0,,1489,1489
49,12-02-17,85,21:00,21:15,149.14,,0,149.14,149.14,1,-189478,58202,247680,-131276,0,0,42444,0,0,,42444,42444
49,12-02-17,86,21:15,21:30,250.5,35.45,0,250.5,34.88,2,-109771,63387,173158,-46384,0,-26,60500,3750,0,,64276,64224
49,12-02-17,87,21:30,21:45,40.62,26.74,0,40.62,26.74,2,-87149,77042,164191,-10107,0,-3666,2809,0,0,,6475,-857
49,12-02-17,88,21:45,22:00,38.19,,0,38.19,38.19,1,-88067,77020,165087,-11047,0,0,317,0,0,,317,317
49,12-02-17,89,22:00,22:15,205.8,,0,205.8,205.8,1,-106645,34058,140703,-72587,0,0,22692,0,0,,22692,22692
49,12-02-17,90,22:15,22:30,106.12,33.76,0,33.76,33.76,-1,-80825,65497,146322,-15328,0,-322,32847,0,0,,33169,32525
49,12-02-17,91,22:30,22:45,106.12,31.91,0,31.91,31.91,-1,-69241,95036,164277,25795,0,-14104,187,0,0,,14291,-13917
49,12-02-17,92,22:45,23:00,,30.26,0,30.26,30.26,-1,-62109,101968,164077,39859,0,-23883,0,0,0,,23883,-23883
49,12-02-17,93,23:00,23:15,64.17,21.53,0,64.17,21.53,2,-75299,73743,149042,-1556,0,-24306,1037,0,0,,25343,-23269
49,12-02-17,94,23:15,23:30,86.12,35.5,0,86.12,34.85,2,-72556,59685,132241,-12871,0,-1353,16447,0,0,,17800,15094
49,12-02-17,95,23:30,23:45,86.12,32.91,0,32.91,32.91,-1,-66588,77635,144223,11047,0,-5457,492,0,0,,5949,-4965
49,12-02-17,96,23:45,0:00,,33.78,0,33.78,33.78,-1,-79832,81941,161773,2109,0,-3949,0,0,0,,3949,-3949
49,12-03-17,1,0:00,0:15,,31.91,0,31.91,31.91,-1,-113934,136759,250693,22825,0,-7091,0,0,0,,7091,-7091
49,12-03-17,2,0:15,0:30,50.42,32.91,0,50.42,32.91,2,-91160,88299,179459,-2861,0,-2764,2255,0,0,,5019,-509
49,12-03-17,3,0:30,0:45,40.62,32.91,0,40.62,32.91,2,-78418,67172,145590,-11246,0,-1358,521,0,0,,1879,-837
49,12-03-17,4,0:45,1:00,46.91,,0,46.91,46.91,1,-74059,70362,144421,-3697,0,0,1752,0,0,,1752,1752
49,12-03-17,5,1:00,1:15,132.12,,0,132.12,132.12,1,-107185,24634,131819,-82551,0,0,25617,0,0,,25617,25617
49,12-03-17,6,1:15,1:30,51.72,,0,51.72,51.72,1,-75594,43232,118826,-32362,0,0,32958,0,0,,32958,32958
49,12-03-17,7,1:30,1:45,40.62,,0,40.62,40.62,1,-69454,43864,113318,-25590,0,0,4526,0,0,,4526,4526
49,12-03-17,8,1:45,2:00,,36.36,0,36.36,36.36,-1,-66283,63466,129749,-2817,0,-228,0,0,0,,228,-228
49,12-03-17,9,2:00,2:15,67.83,37.54,0,67.83,67.83,1,-81182,37467,118649,-43715,0,-163,9182,0,0,,9345,9019
49,12-03-17,10,2:15,2:30,67.64,,0,67.64,67.64,1,-70909,43847,114756,-27062,0,0,23533,0,0,,23533,23533
49,12-03-17,11,2:30,2:45,38.46,,0,38.46,38.46,1,-62442,50965,113407,-11477,0,0,1280,0,0,,1280,1280
49,12-03-17,12,2:45,3:00,,,0,34.98,34.98,0,-60520,47021,107541,-13499,0,0,0,0,0,,0,0
49,12-03-17,13,3:00,3:15,147.25,,0,147.25,147.25,1,-96548,27127,123675,-69421,0,0,27304,0,0,,27304,27304
49,12-03-17,14,3:15,3:30,69.12,33.8,0,69.12,33.8,2,-72087,39282,111369,-32805,0,-187,41656,0,0,,41843,41469
49,12-03-17,15,3:30,3:45,44.62,31.75,0,44.62,31.75,2,-67465,43211,110676,-24254,0,-1605,6172,0,0,,7777,4567
49,12-03-17,16,3:45,4:00,44.62,32.91,0,44.62,32.91,2,-65698,72627,138325,6929,0,-2723,3707,0,0,,6430,984
49,12-03-17,17,4:00,4:15,52.01,32.91,0,52.01,52.01,1,-100416,59258,159674,-41158,0,-58,9341,0,0,,9399,9283
49,12-03-17,18,4:15,4:30,39.22,37.82,0,39.22,37.82,2,-67241,56291,123532,-10950,0,-153,3442,0,0,,3595,3289
49,12-03-17,19,4:30,4:45,41.55,,0,41.55,41.55,1,-72640,58502,131142,-14138,0,0,1221,0,0,,1221,1221
49,12-03-17,20,4:45,5:00,66.6,,0,66.6,66.6,1,-80177,38927,119104,-41250,0,0,22257,0,0,,22257,22257
49,12-03-17,21,5:00,5:15,40.86,,0,40.86,40.86,1,-58035,38651,96686,-19384,0,0,14137,0,0,,14137,14137
49,12-03-17,22,5:15,5:30,40.62,,0,40.62,40.62,1,-62368,49827,112195,-12541,0,0,3233,0,0,,3233,3233
49,12-03-17,23,5:30,5:45,52.63,,0,52.63,52.63,1,-64147,41267,105414,-22880,0,0,11508,0,0,,11508,11508
49,12-03-17,24,5:45,6:00,40.62,,0,40.62,40.62,1,-74756,55360,130116,-19396,0,0,11837,0,0,,11837,11837
49,12-03-17,25,6:00,6:15,42.67,35.44,0,42.67,35.44,2,-73919,68011,141930,-5908,0,-1467,1981,0,0,,3448,514
49,12-03-17,26,6:15,6:30,59.12,,0,59.12,59.12,1,-77847,50408,128255,-27439,0,0,20698,0,0,,20698,20698
49,12-03-17,27,6:30,6:45,44.77,,0,44.77,44.77,1,-84283,54034,138317,-30249,0,0,18194,0,0,,18194,18194
49,12-03-17,28,6:45,7:00,77.29,,0,77.29,77.29,1,-97629,50477,148106,-47152,0,0,33204,0,0,,33204,33204
49,12-03-17,29,7:00,7:15,77.29,26.74,0,26.74,26.74,-1,-60410,64509,124919,4099,0,-2452,8564,0,0,,11016,6112
49,12-03-17,30,7:15,7:30,40.67,,0,40.67,40.67,1,-55917,48864,104781,-7053,0,0,120,0,0,,120,120
49,12-03-17,31,7:30,7:45,44.67,38.59,0,44.67,38.59,2,-68102,48303,116405,-19799,0,-58,1660,0,0,,1718,1602
49,12-03-17,32,7:45,8:00,202.05,,0,202.05,202.05,1,-111106,40578,151684,-70528,0,0,22928,0,0,,22928,22928
49,12-03-17,33,8:00,8:15,215.27,,0,215.27,215.27,1,-135456,51152,186608,-84304,0,0,38859,0,0,,38859,38859
49,12-03-17,34,8:15,8:30,83.12,,0,83.12,83.12,1,-123399,75533,198932,-47866,0,0,3316,0,0,,3316,3316
49,12-03-17,35,8:30,8:45,215.27,,0,215.27,215.27,1,-131876,68656,200532,-63220,0,0,42589,0,0,,42589,42589
49,12-03-17,36,8:45,9:00,215.27,,0,215.27,215.27,1,-122682,58107,180789,-64575,0,0,69854,0,0,,69854,69854
49,12-03-17,37,9:00,9:15,124.12,19.27,0,19.27,19.27,-1,-83830,67280,151110,-16550,0,-3289,38024,0,0,,41313,34735
49,12-03-17,38,9:15,9:30,68.2,37.39,0,68.2,68.2,1,-58502,31474,89976,-27028,0,-1837,3538,0,0,,5375,1701
49,12-03-17,39,9:30,9:45,365.25,,0,365.25,365.25,1,-96229,18563,114792,-77666,0,0,50021,0,0,,50021,50021
49,12-03-17,40,9:45,10:00,102.25,30.76,0,30.76,30.76,-1,-71819,43385,115204,-28434,0,-225,37786,0,0,,38011,37561
49,12-03-17,41,10:00,10:15,42.38,24.42,0,42.38,24.42,2,-51460,68588,120048,17128,0,-779,905,0,0,,1684,126
49,12-03-17,42,10:15,10:30,44.25,,0,44.25,44.25,1,-75816,57907,133723,-17909,0,0,5872,0,0,,5872,5872
49,12-03-17,43,10:30,10:45,102.25,,0,102.25,102.25,1,-102075,55238,157313,-46837,0,0,24106,0,0,,24106,24106
49,12-03-17,44,10:45,11:00,63.68,,0,63.68,63.68,1,-97043,59017,156060,-38026,0,0,26372,0,0,,26372,26372
49,12-03-17,45,11:00,11:15,38.65,36.65,0,36.65,36.65,-1,-55654,80781,136435,25127,0,-966,8367,0,0,,9333,7401
49,12-03-17,46,11:15,11:30,41.36,36.65,0,41.36,41.36,1,-78019,67902,145921,-10117,0,-47,714,0,0,,761,667
49,12-03-17,47,11:30,11:45,93.2,,0,93.2,93.2,1,-96781,58065,154846,-38716,0,0,13012,0,0,,13012,13012
49,12-03-17,48,11:45,12:00,139.25,,0,139.25,139.25,1,-103283,61461,164744,-41822,0,0,35571,0,0,,35571,35571
49,12-03-17,49,12:00,12:15,365.25,,0,365.25,365.25,1,-98903,39550,138453,-59353,0,0,39819,0,0,,39819,39819
49,12-03-17,50,12:15,12:30,97.25,,0,97.25,97.25,1,-86612,47434,134046,-39178,0,0,46689,0,0,,46689,46689
49,12-03-17,51,12:30,12:45,123.25,,0,123.25,123.25,1,-96201,49951,146152,-46250,0,0,25626,0,0,,25626,25626
49,12-03-17,52,12:45,13:00,185.06,,0,185.06,185.06,1,-87195,47211,134406,-39984,0,0,43917,0,0,,43917,43917
49,12-03-17,53,13:00,13:15,100.6,,0,100.6,100.6,1,-95298,50799,146097,-44499,0,0,39810,0,0,,39810,39810
49,12-03-17,54,13:15,13:30,44,,0,44,44,1,-103727,30727,134454,-73000,0,0,25224,0,0,,25224,25224
49,12-03-17,55,13:30,13:45,,,0,49.25,49.25,0,-112864,33123,145987,-79741,0,0,3836,0,0,,3836,3836
49,12-03-17,56,13:45,14:00,,,0,49.25,49.25,0,-100220,32071,132291,-68149,0,0,0,0,0,,0,0
49,12-03-17,57,14:00,14:15,76.25,,0,76.25,76.25,1,-95574,53811,149385,-41763,0,0,4032,0,0,,4032,4032
49,12-03-17,58,14:15,14:30,92.25,39.02,0,92.25,35.81,2,-64230,59775,124005,-4455,0,-6,16011,0,0,,16017,16005
49,12-03-17,59,14:30,14:45,92.25,36.65,0,36.65,36.65,-1,-41196,72202,113398,31006,0,-1964,396,0,0,,2360,-1568
49,12-03-17,60,14:45,15:00,,33.36,0,33.36,33.36,-1,-47745,75635,123380,27890,0,-3633,0,0,0,,3633,-3633
49,12-03-17,61,15:00,15:15,44,38.84,0,44,35.75,2,-48823,31942,80765,-16881,0,-1817,5286,0,0,,7103,3469
49,12-03-17,62,15:15,15:30,43.48,,0,43.48,43.48,1,-50791,29243,80034,-21548,0,0,12551,0,0,,12551,12551
49,12-03-17,63,15:30,15:45,60.08,,0,60.08,60.08,1,-61196,37253,98449,-23943,0,0,10528,0,0,,10528,10528
49,12-03-17,64,15:45,16:00,41.94,35.65,0,41.94,35.65,2,-62809,50801,113610,-12008,0,-92,13976,0,0,,14068,13884
49,12-03-17,65,16:00,16:15,41.94,-34.33,0,-34.33,-34.33,-1,-18655,144621,163276,125966,0,-31254,1858,0,0,,33112,-29396
49,12-03-17,66,16:15,16:30,,31.65,0,31.65,31.65,-1,-35786,130810,166596,95024,0,-22149,0,0,0,,22149,-22149
49,12-03-17,67,16:30,16:45,,,0,35.92,35.92,0,-21860,99742,121602,77882,0,-1463,0,0,0,,1463,-1463
49,12-03-17,68,16:45,17:00,,,0,35.28,35.28,0,-36522,76803,113325,40281,0,0,0,0,0,,0,0
49,12-03-17,69,17:00,17:15,,30.24,0,30.24,30.24,-1,-32877,114118,146995,81241,0,-5213,0,0,0,,5213,-5213
49,12-03-17,70,17:15,17:30,,,0,49.29,49.29,0,-23590,75742,99332,52152,0,-358,0,0,0,,358,-358
49,12-03-17,71,17:30,17:45,,,0,49.28,49.28,0,-30809,46503,77312,15694,0,0,0,0,0,,0,0
49,12-03-17,72,17:45,18:00,,34.7,0,34.7,34.7,-1,-23304,54481,77785,31177,0,-577,0,0,0,,577,-577
49,12-03-17,73,18:00,18:15,,5.72,0,5.72,5.72,-1,-27207,75234,102441,48027,0,-22493,0,0,0,,22493,-22493
49,12-03-17,74,18:15,18:30,,27.13,0,27.13,27.13,-1,-40984,72103,113087,31119,0,-35851,0,0,0,,35851,-35851
49,12-03-17,75,18:30,18:45,,27.34,0,27.34,27.34,-1,-53490,85607,139097,32117,0,-18237,0,0,0,,18237,-18237
49,12-03-17,76,18:45,19:00,,25.72,0,25.72,25.72,-1,-44899,91832,136731,46933,0,-45629,0,0,0,,45629,-45629
49,12-03-17,77,19:00,19:15,,30.69,0,30.69,30.69,-1,-39628,78934,118562,39306,0,-33357,0,0,0,,33357,-33357
49,12-03-17,78,19:15,19:30,,29.59,0,29.59,29.59,-1,-37436,77568,115004,40132,0,-28379,0,0,0,,28379,-28379
49,12-03-17,79,19:30,19:45,,27.02,0,27.02,27.02,-1,-39554,79991,119545,40437,0,-37816,0,0,0,,37816,-37816
49,12-03-17,80,19:45,20:00,,27.02,0,27.02,27.02,-1,-43594,97680,141274,54086,0,-39691,0,0,0,,39691,-39691
49,12-03-17,81,20:00,20:15,46.65,35.65,0,46.65,35.65,2,-85505,25668,111173,-59837,0,-16010,1374,0,0,,17384,-14636
49,12-03-17,82,20:15,20:30,,,0,35.67,35.67,0,-60249,29161,89410,-31088,0,0,0,0,0,,0,0
49,12-03-17,83,20:30,20:45,39.41,35.65,0,39.41,35.65,2,-44711,58016,102727,13305,0,-1465,166,0,0,,1631,-1299
49,12-03-17,84,20:45,21:00,,26.74,0,26.74,26.74,-1,-41953,80032,121985,38079,0,-31774,0,0,0,,31774,-31774
49,12-03-17,85,21:00,21:15,42.34,31.24,0,42.34,42.34,1,-47235,68628,115863,21393,0,-27067,868,0,0,,27935,-26199
49,12-03-17,86,21:15,21:30,42.34,15.71,0,42.34,15.71,2,-28015,70194,98209,42179,0,-9828,800,0,0,,10628,-9028
49,12-03-17,87,21:30,21:45,,7.18,0,7.18,7.18,-1,-28759,79396,108155,50637,0,-38573,0,0,0,,38573,-38573
49,12-03-17,88,21:45,22:00,,30.93,0,30.93,30.93,-1,-38325,85880,124205,47555,0,-28366,0,0,0,,28366,-28366
49,12-03-17,89,22:00,22:15,42.65,32.15,0,42.65,32.15,2,-53057,38931,91988,-14126,0,-14844,1114,0,0,,15958,-13730
49,12-03-17,90,22:15,22:30,42.65,28.15,0,28.15,28.15,-1,-51564,68018,119582,16454,0,-1278,36,0,0,,1314,-1242
49,12-03-17,91,22:30,22:45,,3.81,0,3.81,3.81,-1,-40804,85699,126503,44895,0,-30180,0,0,0,,30180,-30180
49,12-03-17,92,22:45,23:00,,31.92,0,31.92,31.92,-1,-47642,79223,126865,31581,0,-10439,0,0,0,,10439,-10439
49,12-03-17,93,23:00,23:15,39.65,19.78,0,39.65,19.78,2,-102506,63917,166423,-38589,0,-9249,320,0,0,,9569,-8929
49,12-03-17,94,23:15,23:30,,,0,35.24,35.24,0,-76201,22929,99130,-53272,0,-45,0,0,0,,45,-45
49,12-03-17,95,23:30,23:45,,,0,35.25,35.25,0,-75784,27196,102980,-48588,0,0,0,0,0,,0,0
49,12-03-17,96,23:45,0:00,,32.15,0,32.15,32.15,-1,-116235,29993,146228,-86242,0,-119,0,0,0,,119,-119
49,12-04-17,1,0:00,0:15,43.9,-67.5,0,43.9,-67.5,2,-29155,143754,172909,114599,0,-30057,91,0,0,,30148,-29966
49,12-04-17,2,0:15,0:30,53.89,32.15,0,53.89,32.15,2,-53457,59172,112629,5715,0,-1722,7019,0,0,,8741,5297
49,12-04-17,3,0:30,0:45,,27.61,0,27.61,27.61,-1,-56526,47463,103989,-9063,0,-4474,0,0,0,,4474,-4474
49,12-04-17,4,0:45,1:00,,33.15,0,33.15,33.15,-1,-64995,64109,129104,-886,0,-1773,0,0,0,,1773,-1773
49,12-04-17,5,1:00,1:15,69.38,19.91,0,69.38,19.91,2,-72442,65933,138375,-6509,0,-8960,2200,0,0,,11160,-6760
49,12-04-17,6,1:15,1:30,83.33,33.71,0,83.33,33.71,2,-49771,34497,84268,-15274,0,-220,28753,0,0,,28973,28533
49,12-04-17,7,1:30,1:45,42.43,29.24,0,42.43,29.24,2,-51363,39453,90816,-11910,0,-752,4813,0,0,,5565,4061
49,12-04-17,8,1:45,2:00,39.15,,0,39.15,39.15,1,-53760,43866,97626,-9894,0,0,7921,0,0,,7921,7921
49,12-04-17,9,2:00,2:15,43.79,,0,43.79,43.79,1,-61278,52787,114065,-8491,0,0,2818,0,0,,2818,2818
49,12-04-17,10,2:15,2:30,51.01,,0,51.01,51.01,1,-57790,43305,101095,-14485,0,0,15609,0,0,,15609,15609
49,12-04-17,11,2:30,2:45,51.01,28.15,0,28.15,28.15,-1,-35396,43129,78525,7733,0,-3155,971,0,0,,4126,-2184
49,12-04-17,12,2:45,3:00,,28.15,0,28.15,28.15,-1,-38672,38834,77506,162,0,-10838,0,0,0,,10838,-10838
49,12-04-17,13,3:00,3:15,39.15,33.15,0,39.15,33.15,2,-44889,41411,86300,-3478,0,-6662,498,0,0,,7160,-6164
49,12-04-17,14,3:15,3:30,56.6,33.15,0,56.6,56.6,1,-46943,28566,75509,-18377,0,-323,14727,0,0,,15050,14404
49,12-04-17,15,3:30,3:45,35.15,33.78,0,35.66,33.78,2,-35701,30086,65787,-5615,0,-715,1865,0,0,,2580,1150
49,12-04-17,16,3:45,4:00,35.15,32.15,0,35.67,32.15,2,-28575,34736,63311,6161,0,-599,154,0,0,,753,-445
49,12-04-17,17,4:00,4:15,35.15,32.15,0,36.27,32.15,2,-29031,32453,61484,3422,0,-1579,2,0,0,,1581,-1577
49,12-04-17,18,4:15,4:30,39.29,,0,39.29,39.29,1,-40503,28417,68920,-12086,0,0,4510,0,0,,4510,4510
49,12-04-17,19,4:30,4:45,44.02,33.78,0,44.02,33.78,2,-40836,33267,74103,-7569,0,-341,11995,0,0,,12336,11654
49,12-04-17,20,4:45,5:00,39.15,33.15,0,39.15,33.15,2,-44484,37304,81788,-7180,0,-582,1397,0,0,,1979,815
49,12-04-17,21,5:00,5:15,39.83,32.15,0,39.83,32.15,2,-50441,53465,103906,3024,0,-1323,3487,0,0,,4810,2164
49,12-04-17,22,5:15,5:30,,26.74,0,26.74,26.74,-1,-39342,46784,86126,7442,0,-8550,0,0,0,,8550,-8550
49,12-04-17,23,5:30,5:45,103.47,26.74,0,103.47,103.47,1,-66781,29598,96379,-37183,0,-22,10342,0,0,,10364,10320
49,12-04-17,24,5:45,6:00,128.69,29.74,0,128.69,29.74,2,-58794,53994,112788,-4800,0,-401,34016,0,0,,34417,33615
49,12-04-17,25,6:00,6:15,128.69,8.42,0,8.42,8.42,-1,-85106,120427,205533,35321,0,-13306,852,0,0,,14158,-12454
49,12-04-17,26,6:15,6:30,,-22.82,0,-22.82,-22.82,-1,-32411,75463,107874,43052,0,-46767,0,0,0,,46767,-46767
49,12-04-17,27,6:30,6:45,,-66.54,0,-66.54,-66.54,-1,-30406,113067,143473,82661,0,-39387,0,0,0,,39387,-39387
49,12-04-17,28,6:45,7:00,66.27,28.46,0,66.27,66.27,1,-63200,82377,145577,19177,0,-26787,1151,0,0,,27938,-25636
49,12-04-17,29,7:00,7:15,71.1,24.98,0,71.1,24.98,2,-85925,90016,175941,4091,0,-4130,4082,0,0,,8212,-48
49,12-04-17,30,7:15,7:30,,17.78,0,17.78,17.78,-1,-39761,69124,108885,29363,0,-27716,0,0,0,,27716,-27716
49,12-04-17,31,7:30,7:45,85.57,34.62,0,85.57,85.57,1,-48912,25180,74092,-23732,0,-15791,3276,0,0,,19067,-12515
49,12-04-17,32,7:45,8:00,201.83,36.15,0,201.83,36.15,2,-64813,25046,89859,-39767,0,-46,35719,0,0,,35765,35673
49,12-04-17,33,8:00,8:15,201.83,4.85,0,4.85,4.85,-1,-32519,64018,96537,31499,0,-15803,1935,0,0,,17738,-13868
49,12-04-17,34,8:15,8:30,39.05,30.62,0,39.05,30.62,2,-36095,46134,82229,10039,0,-4019,128,0,0,,4147,-3891
49,12-04-17,35,8:30,8:45,,26.74,0,26.74,26.74,-1,-21853,43582,65435,21729,0,-22674,0,0,0,,22674,-22674
49,12-04-17,36,8:45,9:00,51,38.37,0,51,51,1,-48138,30768,78906,-17370,0,-5175,2518,0,0,,7693,-2657
49,12-04-17,37,9:00,9:15,84.05,38.37,0,84.05,84.05,1,-60946,21439,82385,-39507,0,-17,24673,0,0,,24690,24656
49,12-04-17,38,9:15,9:30,70.74,,0,70.74,70.74,1,-81120,31920,113040,-49200,0,0,35078,0,0,,35078,35078
49,12-04-17,39,9:30,9:45,118.64,,0,118.64,118.64,1,-80132,25283,105415,-54849,0,0,37233,0,0,,37233,37233
49,12-04-17,40,9:45,10:00,90.12,,0,90.12,90.12,1,-101665,46851,148516,-54814,0,0,31144,0,0,,31144,31144
49,12-04-17,41,10:00,10:15,38.75,35.78,0,38.89,35.78,2,-76640,79607,156247,2967,0,-748,9345,0,0,,10093,8597
49,12-04-17,42,10:15,10:30,40.67,39.02,0,40.67,38.89,2,-61843,64481,126324,2638,0,-38,1258,0,0,,1296,1220
49,12-04-17,43,10:30,10:45,44.05,,0,44.05,44.05,1,-54132,42046,96178,-12086,0,0,2414,0,0,,2414,2414
49,12-04-17,44,10:45,11:00,38.75,35.18,0,38.89,35.18,2,-42747,43762,86509,1015,0,-2515,1372,0,0,,3887,-1143
49,12-04-17,45,11:00,11:15,,35.62,0,35.62,35.62,-1,-59701,53532,113233,-6169,0,-2681,0,0,0,,2681,-2681
49,12-04-17,46,11:15,11:30,50.12,35.62,0,50.12,50.12,1,-77266,56952,134218,-20314,0,-67,3882,0,0,,3949,3815
49,12-04-17,47,11:30,11:45,69.12,,0,69.12,69.12,1,-77521,40641,118162,-36880,0,0,13183,0,0,,13183,13183
49,12-04-17,48,11:45,12:00,238.22,,0,238.22,238.22,1,-96392,25385,121777,-71007,0,0,47790,0,0,,47790,47790
49,12-04-17,49,12:00,12:15,69.12,35.65,0,35.65,35.65,-1,-67120,49608,116728,-17512,0,-70,30538,0,0,,30608,30468
49,12-04-17,50,12:15,12:30,69.12,18.73,0,18.73,18.73,-1,-33383,62132,95515,28749,0,-19020,524,0,0,,19544,-18496
49,12-04-17,51,12:30,12:45,,30.62,0,30.62,30.62,-1,-34540,69083,103623,34543,0,-26038,0,0,0,,26038,-26038
49,12-04-17,52,12:45,13:00,,21.74,0,21.74,21.74,-1,-42284,83249,125533,40965,0,-38043,0,0,0,,38043,-38043
49,12-04-17,53,13:00,13:15,,28.87,0,28.87,28.87,-1,-38257,73438,111695,35181,0,-34449,0,0,0,,34449,-34449
49,12-04-17,54,13:15,13:30,,3.87,0,3.87,3.87,-1,-30390,86711,117101,56321,0,-28668,0,0,0,,28668,-28668
49,12-04-17,55,13:30,13:45,,3.87,0,3.87,3.87,-1,-36528,89574,126102,53046,0,-52064,0,0,0,,52064,-52064
49,12-04-17,56,13:45,14:00,,18.87,0,18.87,18.87,-1,-39770,87939,127709,48169,0,-48211,0,0,0,,48211,-48211
49,12-04-17,57,14:00,14:15,,30.62,0,30.62,30.62,-1,-44351,85047,129398,40696,0,-29625,0,0,0,,29625,-29625
49,12-04-17,58,14:15,14:30,,34.17,0,34.17,34.17,-1,-40806,73927,114733,33121,0,-29987,0,0,0,,29987,-29987
49,12-04-17,59,14:30,14:45,,34.62,0,34.62,34.62,-1,-46440,70248,116688,23808,0,-11314,0,0,0,,11314,-11314
49,12-04-17,60,14:45,15:00,40.44,34.62,0,40.44,34.62,2,-48736,53080,101816,4344,0,-9837,327,0,0,,10164,-9510
49,12-04-17,61,15:00,15:15,41.39,35.62,0,47.74,35.62,2,-48589,50770,99359,2181,0,-1428,722,0,0,,2150,-706
49,12-04-17,62,15:15,15:30,,32.95,0,32.95,32.95,-1,-43894,62553,106447,18659,0,-5792,0,0,0,,5792,-5792
49,12-04-17,63,15:30,15:45,41.39,35.62,0,47.74,35.62,2,-53565,51553,105118,-2012,0,-2977,847,0,0,,3824,-2130
49,12-04-17,64,15:45,16:00,43.24,,0,43.24,43.24,1,-61453,51127,112580,-10326,0,0,1243,0,0,,1243,1243
49,12-04-17,65,16:00,16:15,43.24,-36.11,0,-36.11,-36.11,-1,-48529,139131,187660,90602,0,-34256,160,0,0,,34416,-34096
49,12-04-17,66,16:15,16:30,,12.75,0,12.75,12.75,-1,-50445,113932,164377,63487,0,-51728,0,0,0,,51728,-51728
49,12-04-17,67,16:30,16:45,,18.89,0,18.89,18.89,-1,-32478,84538,117016,52060,0,-50025,0,0,0,,50025,-50025
49,12-04-17,68,16:45,17:00,69.47,18.89,0,69.47,69.47,1,-62866,61934,124800,-932,0,-17776,3862,0,0,,21638,-13914
49,12-04-17,69,17:00,17:15,54.85,,0,54.85,54.85,1,-60686,43188,103874,-17498,0,0,3552,0,0,,3552,3552
49,12-04-17,70,17:15,17:30,211.43,,0,211.43,211.43,1,-77332,41169,118501,-36163,0,0,30864,0,0,,30864,30864
49,12-04-17,71,17:30,17:45,44.85,35.62,0,35.62,35.62,-1,-63081,60563,123644,-2518,0,-720,11716,0,0,,12436,10996
49,12-04-17,72,17:45,18:00,44.85,35.62,0,35.62,35.62,-1,-47014,56445,103459,9431,0,-1026,3,0,0,,1029,-1023
49,12-04-17,73,18:00,18:15,38.75,16.16,0,47.68,16.16,2,-43927,65922,109849,21995,0,-7994,146,0,0,,8140,-7848
49,12-04-17,74,18:15,18:30,,17.49,0,17.49,17.49,-1,-37773,52149,89922,14376,0,-18982,0,0,0,,18982,-18982
49,12-04-17,75,18:30,18:45,,22.49,0,22.49,22.49,-1,-40820,80820,121640,40000,0,-22913,0,0,0,,22913,-22913
49,12-04-17,76,18:45,19:00,,22.49,0,22.49,22.49,-1,-37754,82152,119906,44398,0,-37297,0,0,0,,37297,-37297
49,12-04-17,77,19:00,19:15,131.12,-8.87,0,131.12,-8.87,2,-62208,56254,118462,-5954,0,-35328,2312,0,0,,37640,-33016
49,12-04-17,78,19:15,19:30,137.54,1.63,0,137.54,1.63,2,-37542,77471,115013,39929,0,-14229,2668,0,0,,16897,-11561
49,12-04-17,79,19:30,19:45,,-2.92,0,-2.92,-2.92,-1,-53764,83127,136891,29363,0,-35002,0,0,0,,35002,-35002
49,12-04-17,80,19:45,20:00,,12.75,0,12.75,12.75,-1,-48084,108675,156759,60591,0,-36744,0,0,0,,36744,-36744
49,12-04-17,81,20:00,20:15,42.55,32.74,0,42.55,32.74,2,-64393,41532,105925,-22861,0,-18454,847,0,0,,19301,-17607
49,12-04-17,82,20:15,20:30,42.55,39.09,0,39.09,39.09,-1,-58340,57233,115573,-1107,0,-13,7,0,0,,20,-6
49,12-04-17,83,20:30,20:45,,35.62,0,35.62,35.62,-1,-48733,62626,111359,13893,0,-7474,0,0,0,,7474,-7474
49,12-04-17,84,20:45,21:00,,38.81,0,38.81,38.81,-1,-71588,46045,117633,-25543,0,-3103,0,0,0,,3103,-3103
49,12-04-17,85,21:00,21:15,201.76,34.62,0,201.76,34.62,2,-62960,47708,110668,-15252,0,-3044,4480,0,0,,7524,1436
49,12-04-17,86,21:15,21:30,132.12,34.62,0,132.12,34.62,2,-32854,36838,69692,3984,0,-3294,10888,0,0,,14182,7594
49,12-04-17,87,21:30,21:45,38.55,34.62,0,38.55,34.62,2,-59076,55945,115021,-3131,0,-6140,334,0,0,,6474,-5806
49,12-04-17,88,21:45,22:00,,34.62,0,34.62,34.62,-1,-68464,82521,150985,14057,0,-6050,0,0,0,,6050,-6050
49,12-04-17,89,22:00,22:15,45.67,30.53,0,45.67,30.53,2,-57377,56380,113757,-997,0,-14351,1829,0,0,,16180,-12522
49,12-04-17,90,22:15,22:30,45.67,33.17,0,33.17,33.17,-1,-40967,58475,99442,17508,0,-6868,224,0,0,,7092,-6644
49,12-04-17,91,22:30,22:45,,29.74,0,29.74,29.74,-1,-39125,62602,101727,23477,0,-28078,0,0,0,,28078,-28078
49,12-04-17,92,22:45,23:00,,34.73,0,34.73,34.73,-1,-73535,92750,166285,19215,0,-9626,0,0,0,,9626,-9626
49,12-04-17,93,23:00,23:15,,20,0,20,20,-1,-30718,57428,88146,26710,0,-17011,0,0,0,,17011,-17011
49,12-04-17,94,23:15,23:30,,34.61,0,34.61,34.61,-1,-26812,51513,78325,24701,0,-16918,0,0,0,,16918,-16918
49,12-04-17,95,23:30,23:45,,12.1,0,12.1,12.1,-1,-31259,80738,111997,49479,0,-39381,0,0,0,,39381,-39381
49,12-04-17,96,23:45,0:00,,31.55,0,31.55,31.55,-1,-44226,66031,110257,21805,0,-26771,0,0,0,,26771,-26771
49,12-05-17,1,0:00,0:15,124.66,34.77,0,124.66,34.77,2,-67187,25856,93043,-41331,0,-2422,11037,0,0,,13459,8615
49,12-05-17,2,0:15,0:30,134.77,,0,134.77,134.77,1,-76689,35511,112200,-41178,0,0,48966,0,0,,48966,48966
49,12-05-17,3,0:30,0:45,67.12,,0,67.12,67.12,1,-66586,23442,90028,-43144,0,0,18812,0,0,,18812,18812
49,12-05-17,4,0:45,1:00,47.12,33.17,0,47.12,33.17,2,-42173,43377,85550,1204,0,-1310,16582,0,0,,17892,15272
49,12-05-17,5,1:00,1:15,51.72,33.17,0,51.72,51.72,1,-53460,20648,74108,-32812,0,-310,11028,0,0,,11338,10718
49,12-05-17,6,1:15,1:30,42.01,,0,42.01,42.01,1,-43622,19733,63355,-23889,0,0,19140,0,0,,19140,19140
49,12-05-17,7,1:30,1:45,57.29,,0,57.29,57.29,1,-63379,27490,90869,-35889,0,0,19930,0,0,,19930,19930
49,12-05-17,8,1:45,2:00,41.77,32.5,0,32.5,32.5,-1,-40465,42780,83245,2315,0,-1756,9926,0,0,,11682,8170
49,12-05-17,9,2:00,2:15,37.77,32.74,0,37.77,37.77,1,-36211,36386,72597,175,0,-2415,52,0,0,,2467,-2363
49,12-05-17,10,2:15,2:30,52.86,,0,52.86,52.86,1,-60231,30149,90380,-30082,0,0,11583,0,0,,11583,11583
49,12-05-17,11,2:30,2:45,45.12,,0,45.12,45.12,1,-68964,35046,104010,-33918,0,0,29234,0,0,,29234,29234
49,12-05-17,12,2:45,3:00,52.58,,0,52.58,52.58,1,-71268,32386,103654,-38882,0,0,29034,0,0,,29034,29034
49,12-05-17,13,3:00,3:15,62.83,,0,62.83,62.83,1,-49264,22047,71311,-27217,0,0,31561,0,0,,31561,31561
49,12-05-17,14,3:15,3:30,37.77,35.67,0,37.77,35.39,2,-31794,26127,57921,-5667,0,-689,3952,0,0,,4641,3263
49,12-05-17,15,3:30,3:45,37.77,35.77,0,37.77,35.39,2,-28148,32704,60852,4556,0,-1370,88,0,0,,1458,-1282
49,12-05-17,16,3:45,4:00,,34.77,0,34.77,34.77,-1,-32733,39944,72677,7211,0,-3060,0,0,0,,3060,-3060
49,12-05-17,17,4:00,4:15,,26.74,0,26.74,26.74,-1,-36720,53840,90560,17120,0,-8627,0,0,0,,8627,-8627
49,12-05-17,18,4:15,4:30,,26.03,0,26.03,26.03,-1,-31635,44848,76483,13213,0,-17186,0,0,0,,17186,-17186
49,12-05-17,19,4:30,4:45,,34.77,0,34.77,34.77,-1,-30632,39316,69948,8684,0,-5779,0,0,0,,5779,-5779
49,12-05-17,20,4:45,5:00,,32.69,0,32.69,32.69,-1,-38102,53440,91542,15338,0,-4285,0,0,0,,4285,-4285
49,12-05-17,21,5:00,5:15,,25.06,0,25.06,25.06,-1,-36112,59707,95819,23595,0,-24235,0,0,0,,24235,-24235
49,12-05-17,22,5:15,5:30,39.62,34.77,0,39.62,39.62,1,-45748,48513,94261,2765,0,-14284,107,0,0,,14391,-14177
49,12-05-17,23,5:30,5:45,39.62,33.4,0,39.62,33.4,2,-56725,75076,131801,18351,0,-7538,129,0,0,,7667,-7409
49,12-05-17,24,5:45,6:00,,38.08,0,38.08,38.08,-1,-64846,73018,137864,8172,0,-4041,0,0,0,,4041,-4041
49,12-05-17,25,6:00,6:15,,-16.65,0,-16.65,-16.65,-1,-74410,100739,175149,26329,0,-8734,0,0,0,,8734,-8734
49,12-05-17,26,6:15,6:30,93.13,-44.45,0,93.13,-44.45,2,-61004,57662,118666,-3342,0,-32364,1602,0,0,,33966,-30762
49,12-05-17,27,6:30,6:45,80.81,-44.45,0,80.81,80.81,1,-63306,45080,108386,-18226,0,-160,2039,0,0,,2199,1879
49,12-05-17,28,6:45,7:00,107.12,,0,107.12,107.12,1,-93568,23415,116983,-70153,0,0,17133,0,0,,17133,17133
49,12-05-17,29,7:00,7:15,38.08,-55.99,0,38.08,-55.99,2,-49045,164439,213484,115394,0,-26734,7807,0,0,,34541,-18927
49,12-05-17,30,7:15,7:30,39.58,26.78,0,39.58,39.58,1,-65167,54745,119912,-10422,0,-15676,505,0,0,,16181,-15171
49,12-05-17,31,7:30,7:45,42.8,,0,42.8,42.8,1,-122302,36143,158445,-86159,0,0,1669,0,0,,1669,1669
49,12-05-17,32,7:45,8:00,124.76,,0,124.76,124.76,1,-176550,22311,198861,-154239,0,0,30599,0,0,,30599,30599
49,12-05-17,33,8:00,8:15,47.12,,0,47.12,47.12,1,-105160,69199,174359,-35961,0,0,18807,0,0,,18807,18807
49,12-05-17,34,8:15,8:30,47.12,36.88,0,36.88,36.88,-1,-98678,46474,145152,-52204,0,-18,23,0,0,,41,5
49,12-05-17,35,8:30,8:45,,,0,38.72,38.72,0,-103078,40312,143390,-62766,0,0,0,0,0,,0,0
49,12-05-17,36,8:45,9:00,42.8,,0,42.8,42.8,1,-132558,25824,158382,-106734,0,0,2507,0,0,,2507,2507
49,12-05-17,37,9:00,9:15,263.72,,0,263.72,263.72,1,-109055,21006,130061,-88049,0,0,23459,0,0,,23459,23459
49,12-05-17,38,9:15,9:30,79.12,,0,79.12,79.12,1,-98928,34565,133493,-64363,0,0,30380,0,0,,30380,30380
49,12-05-17,39,9:30,9:45,263.72,,0,263.72,263.72,1,-90597,27682,118279,-62915,0,0,30021,0,0,,30021,30021
49,12-05-17,40,9:45,10:00,48.52,,0,48.52,48.52,1,-86388,31006,117394,-55382,0,0,27443,0,0,,27443,27443
49,12-05-17,41,10:00,10:15,132.12,,0,132.12,132.12,1,-78498,29801,108299,-48697,0,0,31319,0,0,,31319,31319
49,12-05-17,42,10:15,10:30,124.12,,0,124.12,124.12,1,-86842,28603,115445,-58239,0,0,43579,0,0,,43579,43579
49,12-05-17,43,10:30,10:45,201.08,,0,201.08,201.08,1,-83268,32960,116228,-50308,0,0,52619,0,0,,52619,52619
49,12-05-17,44,10:45,11:00,64.99,,0,64.99,64.99,1,-84309,42898,127207,-41411,0,0,17580,0,0,,17580,17580
49,12-05-17,45,11:00,11:15,132.12,,0,132.12,132.12,1,-99849,45043,144892,-54806,0,0,41707,0,0,,41707,41707
49,12-05-17,46,11:15,11:30,47.12,,0,47.12,47.12,1,-89012,49950,138962,-39062,0,0,23509,0,0,,23509,23509
49,12-05-17,47,11:30,11:45,74.12,,0,74.12,74.12,1,-90086,54046,144132,-36040,0,0,27824,0,0,,27824,27824
49,12-05-17,48,11:45,12:00,42.8,,0,42.8,42.8,1,-83383,73093,156476,-10290,0,0,16484,0,0,,16484,16484
49,12-05-17,49,12:00,12:15,114.73,,0,114.73,114.73,1,-125471,45320,170791,-80151,0,0,18673,0,0,,18673,18673
49,12-05-17,50,12:15,12:30,42.8,,0,42.8,42.8,1,-117969,53347,171316,-64622,0,0,19803,0,0,,19803,19803
49,12-05-17,51,12:30,12:45,42.8,,0,42.8,42.8,1,-93816,64795,158611,-29021,0,0,17796,0,0,,17796,17796
49,12-05-17,52,12:45,13:00,42.35,,0,42.35,42.35,1,-84864,70066,154930,-14798,0,0,15686,0,0,,15686,15686
49,12-05-17,53,13:00,13:15,192.38,,0,192.38,192.38,1,-110848,64053,174901,-46795,0,0,13492,0,0,,13492,13492
49,12-05-17,54,13:15,13:30,162.45,,0,162.45,162.45,1,-122099,60537,182636,-61562,0,0,33707,0,0,,33707,33707
49,12-05-17,55,13:30,13:45,57.67,,0,57.67,57.67,1,-121662,66722,188384,-54940,0,0,12932,0,0,,12932,12932
49,12-05-17,56,13:45,14:00,42.8,,0,42.8,42.8,1,-123806,56954,180760,-66852,0,0,18594,0,0,,18594,18594
49,12-05-17,57,14:00,14:15,71.03,,0,71.03,71.03,1,-110070,57289,167359,-52781,0,0,31472,0,0,,31472,31472
49,12-05-17,58,14:15,14:30,48.88,,0,48.88,48.88,1,-106347,52458,158805,-53889,0,0,45268,0,0,,45268,45268
49,12-05-17,59,14:30,14:45,42.8,,0,42.8,42.8,1,-90857,67056,157913,-23801,0,0,25074,0,0,,25074,25074
49,12-05-17,60,14:45,15:00,42.8,38.14,0,38.14,38.14,-1,-77460,72705,150165,-4755,0,-116,1112,0,0,,1228,996
49,12-05-17,61,15:00,15:15,42.8,,0,42.8,42.8,1,-85234,60736,145970,-24498,0,0,1401,0,0,,1401,1401
49,12-05-17,62,15:15,15:30,46.95,,0,46.95,46.95,1,-91030,62373,153403,-28657,0,0,11127,0,0,,11127,11127
49,12-05-17,63,15:30,15:45,50.3,,0,50.3,50.3,1,-86078,60256,146334,-25822,0,0,3426,0,0,,3426,3426
49,12-05-17,64,15:45,16:00,76.29,,0,76.29,76.29,1,-88114,53498,141612,-34616,0,0,26667,0,0,,26667,26667
49,12-05-17,65,16:00,16:15,76.29,-3.89,0,-3.89,-3.89,-1,-60858,109723,170581,48865,0,-21843,8213,0,0,,30056,-13630
49,12-05-17,66,16:15,16:30,,36.88,0,36.88,36.88,-1,-78804,106405,185209,27601,0,-8097,0,0,0,,8097,-8097
49,12-05-17,67,16:30,16:45,,,0,46.17,46.17,0,-82909,105858,188767,22949,0,-355,0,0,0,,355,-355
49,12-05-17,68,16:45,17:00,,54.21,0,54.21,54.21,-1,-91060,98131,189191,7071,0,-60,0,0,0,,60,-60
49,12-05-17,69,17:00,17:15,,36.87,0,36.87,36.87,-1,-75785,96953,172738,21168,0,-1041,0,0,0,,1041,-1041
49,12-05-17,70,17:15,17:30,,37.13,0,37.13,37.13,-1,-81457,105374,186831,23917,0,-2303,0,0,0,,2303,-2303
49,12-05-17,71,17:30,17:45,,32.83,0,32.83,32.83,-1,-71168,103455,174623,32287,0,-6511,0,0,0,,6511,-6511
49,12-05-17,72,17:45,18:00,,27.83,0,27.83,27.83,-1,-59711,109993,169704,50282,0,-7580,0,0,0,,7580,-7580
49,12-05-17,73,18:00,18:15,,26.74,0,26.74,26.74,-1,-62508,68581,131089,6073,0,-10967,0,0,0,,10967,-10967
49,12-05-17,74,18:15,18:30,,11.79,0,11.79,11.79,-1,-49825,100228,150053,50403,0,-41388,0,0,0,,41388,-41388
49,12-05-17,75,18:30,18:45,,-30.7,0,-30.7,-30.7,-1,-59583,136135,195718,76552,0,-54077,0,0,0,,54077,-54077
49,12-05-17,76,18:45,19:00,,11.79,0,11.79,11.79,-1,-65202,136950,202152,71748,0,-64328,0,0,0,,64328,-64328
49,12-05-17,77,19:00,19:15,84.54,-39.22,0,84.54,-39.22,2,-71373,97389,168762,26016,0,-62008,807,0,0,,62815,-61201
49,12-05-17,78,19:15,19:30,89.12,-33.17,0,89.12,-33.17,2,-51462,125368,176830,73906,0,-24233,1640,0,0,,25873,-22593
49,12-05-17,79,19:30,19:45,,-11.78,0,-11.78,-11.78,-1,-52029,144110,196139,92081,0,-77616,0,0,0,,77616,-77616
49,12-05-17,80,19:45,20:00,,21.11,0,21.11,21.11,-1,-79521,115091,194612,35570,0,-60104,0,0,0,,60104,-60104
49,12-05-17,81,20:00,20:15,43.05,35.88,0,43.05,35.88,2,-61013,76144,137157,15131,0,-10659,609,0,0,,11268,-10050
49,12-05-17,82,20:15,20:30,,-20.91,0,-20.91,-20.91,-1,-44560,118114,162674,73554,0,-34827,0,0,0,,34827,-34827
49,12-05-17,83,20:30,20:45,,10.68,0,10.68,10.68,-1,-57254,120587,177841,63333,0,-63231,0,0,0,,63231,-63231
49,12-05-17,84,20:45,21:00,,7.33,0,7.33,7.33,-1,-70782,143636,214418,72854,0,-64667,0,0,0,,64667,-64667
49,12-05-17,85,21:00,21:15,96.89,-51.03,0,96.89,-51.03,2,-83843,87632,171475,3789,0,-55763,1193,0,0,,56956,-54570
49,12-05-17,86,21:15,21:30,125.47,-53.37,0,125.47,-53.37,2,-31805,84229,116034,52424,0,-9800,8186,0,0,,17986,-1614
49,12-05-17,87,21:30,21:45,40.53,-41.45,0,40.53,-41.45,2,-59618,84326,143944,24708,0,-40090,265,0,0,,40355,-39825
49,12-05-17,88,21:45,22:00,40.53,15.88,0,15.88,15.88,-1,-82168,115941,198109,33773,0,-19474,39,0,0,,19513,-19435
49,12-05-17,89,22:00,22:15,48.16,36.88,0,48.16,36.88,2,-58383,50651,109034,-7732,0,-6284,2192,0,0,,8476,-4092
49,12-05-17,90,22:15,22:30,38.88,35.27,0,39.66,35.27,2,-47503,60597,108100,13094,0,-1695,336,0,0,,2031,-1359
49,12-05-17,91,22:30,22:45,,28.04,0,28.04,28.04,-1,-47151,67607,114758,20456,0,-19339,0,0,0,,19339,-19339
49,12-05-17,92,22:45,23:00,,34.27,0,34.27,34.27,-1,-78233,100584,178817,22351,0,-20475,0,0,0,,20475,-20475
49,12-05-17,93,23:00,23:15,38.76,35.88,0,38.76,38.76,1,-52694,66498,119192,13804,0,-11515,202,0,0,,11717,-11313
49,12-05-17,94,23:15,23:30,,30.53,0,30.53,30.53,-1,-49576,72575,122151,22999,0,-6763,0,0,0,,6763,-6763
49,12-05-17,95,23:30,23:45,,19.75,0,19.75,19.75,-1,-53202,100001,153203,46799,0,-35368,0,0,0,,35368,-35368
49,12-05-17,96,23:45,0:00,,14.63,0,14.63,14.63,-1,-62419,123960,186379,61541,0,-57318,0,0,0,,57318,-57318
49,12-06-17,1,0:00,0:15,66.24,32.74,0,66.24,32.74,2,-72363,53818,126181,-18545,0,-19186,4412,0,0,,23598,-14774
49,12-06-17,2,0:15,0:30,39.65,,0,39.65,39.65,1,-45317,25028,70345,-20289,0,0,1869,0,0,,1869,1869
49,12-06-17,3,0:30,0:45,49.77,,0,49.77,49.77,1,-54737,27086,81823,-27651,0,0,4677,0,0,,4677,4677
49,12-06-17,4,0:45,1:00,49.77,33.15,0,33.15,33.15,-1,-50547,49605,100152,-942,0,-1221,1187,0,0,,2408,-34
49,12-06-17,5,1:00,1:15,58.63,28.15,0,58.63,28.15,2,-34617,28691,63308,-5926,0,-3871,2204,0,0,,6075,-1667
49,12-06-17,6,1:15,1:30,76.12,37.99,0,76.12,34.96,2,-41953,21762,63715,-20191,0,-6,25692,0,0,,25698,25686
49,12-06-17,7,1:30,1:45,43.01,30.04,0,43.01,30.04,2,-39627,33293,72920,-6334,0,-440,2830,0,0,,3270,2390
49,12-06-17,8,1:45,2:00,43.01,29.81,0,29.81,29.81,-1,-30141,42882,73023,12741,0,-4503,532,0,0,,5035,-3971
49,12-06-17,9,2:00,2:15,43.46,28.61,0,43.46,43.46,1,-44864,41870,86734,-2994,0,-6987,1425,0,0,,8412,-5562
49,12-06-17,10,2:15,2:30,44.82,,0,44.82,44.82,1,-36944,22645,59589,-14299,0,0,5703,0,0,,5703,5703
49,12-06-17,11,2:30,2:45,44.82,33.15,0,33.15,33.15,-1,-33386,30492,63878,-2894,0,-472,13,0,0,,485,-459
49,12-06-17,12,2:45,3:00,,28.15,0,28.15,28.15,-1,-35237,35330,70567,93,0,-4426,0,0,0,,4426,-4426
49,12-06-17,13,3:00,3:15,,4.78,0,4.78,4.78,-1,-32504,80834,113338,48330,0,-29990,0,0,0,,29990,-29990
49,12-06-17,14,3:15,3:30,,32.15,0,32.15,32.15,-1,-44823,49595,94418,4772,0,-12758,0,0,0,,12758,-12758
49,12-06-17,15,3:30,3:45,,33.15,0,33.15,33.15,-1,-42658,48604,91262,5946,0,-338,0,0,0,,338,-338
49,12-06-17,16,3:45,4:00,,32.15,0,32.15,32.15,-1,-44132,60377,104509,16245,0,-9733,0,0,0,,9733,-9733
49,12-06-17,17,4:00,4:15,44.42,38.78,0,44.42,34.96,2,-39744,71722,111466,31978,0,-3160,3969,0,0,,7129,809
49,12-06-17,18,4:15,4:30,44.42,1.78,0,1.78,1.78,-1,-31864,71574,103438,39710,0,-18700,622,0,0,,19322,-18078
49,12-06-17,19,4:30,4:45,,29.74,0,29.74,29.74,-1,-42632,58164,100796,15532,0,-21349,0,0,0,,21349,-21349
49,12-06-17,20,4:45,5:00,,25.22,0,25.22,25.22,-1,-35397,64056,99453,28659,0,-18990,0,0,0,,18990,-18990
49,12-06-17,21,5:00,5:15,,-59.6,0,-59.6,-59.6,-1,-16350,77548,93898,61198,0,-50289,0,0,0,,50289,-50289
49,12-06-17,22,5:15,5:30,,13.08,0,13.08,13.08,-1,-20464,58872,79336,38408,0,-51010,0,0,0,,51010,-51010
49,12-06-17,23,5:30,5:45,,32.15,0,32.15,32.15,-1,-52916,63162,116078,10246,0,-21284,0,0,0,,21284,-21284
49,12-06-17,24,5:45,6:00,35.15,19.26,0,35.15,19.26,2,-50491,83030,133521,32539,0,-7603,168,0,0,,7771,-7435
49,12-06-17,25,6:00,6:15,,26.74,0,26.74,26.74,-1,-71892,60807,132699,-11085,0,-7197,0,0,0,,7197,-7197
49,12-06-17,26,6:15,6:30,,7.92,0,7.92,7.92,-1,-36406,76351,112757,39945,0,-14355,0,0,0,,14355,-14355
49,12-06-17,27,6:30,6:45,,29.48,0,29.48,29.48,-1,-28254,51104,79358,22850,0,-29146,0,0,0,,29146,-29146
49,12-06-17,28,6:45,7:00,47.36,29.48,0,47.36,47.36,1,-62124,57156,119280,-4968,0,-4682,4236,0,0,,8918,-446
49,12-06-17,29,7:00,7:15,40.57,-38.85,0,-38.85,-38.85,-1,-56550,120930,177480,64380,0,-16232,2755,0,0,,18987,-13477
49,12-06-17,30,7:15,7:30,,16.54,0,16.54,16.54,-1,-35480,79608,115088,44128,0,-33774,0,0,0,,33774,-33774
49,12-06-17,31,7:30,7:45,,37.46,0,37.46,37.46,-1,-26171,51289,77460,25118,0,-312,0,0,0,,312,-312
49,12-06-17,32,7:45,8:00,259.42,,0,259.42,259.42,1,-88623,47148,135771,-41475,0,0,14829,0,0,,14829,14829
49,12-06-17,33,8:00,8:15,45.12,55.05,0,55.05,55.05,-1,-29214,46621,75835,17407,0,-36,11886,0,0,,11922,11850
49,12-06-17,34,8:15,8:30,40.24,55.04,0,46.85,46.85,2,-42465,46133,88598,3668,0,-168,867,0,0,,1035,699
49,12-06-17,35,8:30,8:45,43.55,,0,43.55,43.55,1,-44843,29010,73853,-15833,0,0,1203,0,0,,1203,1203
49,12-06-17,36,8:45,9:00,149.12,,0,149.12,149.12,1,-75163,13632,88795,-61531,0,0,28818,0,0,,28818,28818
49,12-06-17,37,9:00,9:15,295.77,55.25,0,295.77,47.09,2,-40170,21792,61962,-18378,0,-34,32377,0,0,,32411,32343
49,12-06-17,38,9:15,9:30,74.7,40.34,0,74.7,40.34,2,-35050,12288,47338,-22762,0,-437,6724,0,0,,7161,6287
49,12-06-17,39,9:30,9:45,45.39,,0,45.39,45.39,1,-46681,10472,57153,-36209,0,0,21137,0,0,,21137,21137
49,12-06-17,40,9:45,10:00,188.7,,0,188.7,188.7,1,-59036,8262,67298,-50774,0,0,32975,0,0,,32975,32975
49,12-06-17,41,10:00,10:15,84.48,,0,84.48,84.48,1,-46041,38539,84580,-7502,0,0,24044,0,0,,24044,24044
49,12-06-17,42,10:15,10:30,44.4,,0,44.4,44.4,1,-49055,26846,75901,-22209,0,0,9678,0,0,,9678,9678
49,12-06-17,43,10:30,10:45,71,,0,71,71,1,-54064,19314,73378,-34750,0,0,21625,0,0,,21625,21625
49,12-06-17,44,10:45,11:00,45.56,,0,45.56,45.56,1,-59962,24839,84801,-35123,0,0,25755,0,0,,25755,25755
49,12-06-17,45,11:00,11:15,62.49,,0,62.49,62.49,1,-65716,25124,90840,-40592,0,0,25770,0,0,,25770,25770
49,12-06-17,46,11:15,11:30,115.7,,0,115.7,115.7,1,-64539,27815,92354,-36724,0,0,34651,0,0,,34651,34651
49,12-06-17,47,11:30,11:45,251.29,,0,276.42,276.42,1,-139041,39131,178172,-99910,0,0,25800,0,0,,25800,25800
49,12-06-17,48,11:45,12:00,251.29,,0,276.42,276.42,1,-245599,89017,334616,-156582,0,0,74080,0,52498,,126578,126578
49,12-06-17,49,12:00,12:15,82.12,,0,247.4,247.4,1,-246621,132658,379279,-113963,0,0,43287,0,61247,,104534,104534
49,12-06-17,50,12:15,12:30,53.4,,0,247.4,247.4,1,-238084,144999,383083,-93085,0,0,34495,0,56247,,90742,90742
49,12-06-17,51,12:30,12:45,45.12,,0,247.4,247.4,1,-231297,166303,397600,-64994,0,0,19368,0,56247,,75615,75615
49,12-06-17,52,12:45,13:00,168.48,41.22,0,247.4,40.22,2,-223466,109326,332792,-114140,0,-17,12481,0,42081,,54579,54545
49,12-06-17,53,13:00,13:15,227.29,,0,227.29,227.29,1,-230138,116319,346457,-113819,0,0,75781,0,0,,75781,75781
49,12-06-17,54,13:15,13:30,227.29,,0,227.29,227.29,1,-232324,126443,358767,-105881,0,0,86691,0,0,,86691,86691
49,12-06-17,55,13:30,13:45,208.52,,0,208.52,208.52,1,-240247,154285,394532,-85962,0,0,78830,0,0,,78830,78830
49,12-06-17,56,13:45,14:00,82.12,34.52,0,82.12,34.52,2,-222524,168826,391350,-53698,0,-1621,16237,0,0,,17858,14616
49,12-06-17,57,14:00,14:15,183.64,,0,183.64,183.64,1,-175050,66122,241172,-108928,0,0,54594,0,0,,54594,54594
49,12-06-17,58,14:15,14:30,119.12,,0,119.12,119.12,1,-175760,109265,285025,-66495,0,0,52267,0,0,,52267,52267
49,12-06-17,59,14:30,14:45,141.81,,0,141.81,141.81,1,-177193,110760,287953,-66433,0,0,13560,0,0,,13560,13560
49,12-06-17,60,14:45,15:00,218.18,,0,218.18,218.18,1,-191153,107284,298437,-83869,0,0,46519,0,0,,46519,46519
49,12-06-17,61,15:00,15:15,43.55,36.78,0,47.13,36.78,2,-122440,80490,202930,-41950,0,-1102,7747,0,0,,8849,6645
49,12-06-17,62,15:15,15:30,235.52,,0,235.52,235.52,1,-137486,55392,192878,-82094,0,0,34126,0,0,,34126,34126
49,12-06-17,63,15:30,15:45,108.12,,0,108.12,108.12,1,-142385,74330,216715,-68055,0,0,56548,0,0,,56548,56548
49,12-06-17,64,15:45,16:00,119.12,,0,119.12,119.12,1,-152061,76157,228218,-75904,0,0,56437,0,0,,56437,56437
49,12-06-17,65,16:00,16:15,61.12,38.31,0,61.12,38.31,2,-133929,149042,282971,15113,0,-1127,25115,0,0,,26242,23988
49,12-06-17,66,16:15,16:30,58.75,38.31,0,58.75,58.75,1,-139914,94596,234510,-45318,0,-39,6215,0,0,,6254,6176
49,12-06-17,67,16:30,16:45,129.12,,0,129.12,129.12,1,-144335,85083,229418,-59252,0,0,35862,0,0,,35862,35862
49,12-06-17,68,16:45,17:00,237.67,,0,237.67,237.67,1,-166449,72262,238711,-94187,0,0,70522,0,0,,70522,70522
49,12-06-17,69,17:00,17:15,84.46,,0,84.46,84.46,1,-146350,106713,253063,-39637,0,0,32609,0,0,,32609,32609
49,12-06-17,70,17:15,17:30,70.99,,0,70.99,70.99,1,-139082,95219,234301,-43863,0,0,3963,0,0,,3963,3963
49,12-06-17,71,17:30,17:45,70.99,36.65,0,36.65,36.65,-1,-123345,107594,230939,-15751,0,-578,6968,0,0,,7546,6390
49,12-06-17,72,17:45,18:00,39.61,35.65,0,47.58,35.65,2,-121103,127697,248800,6594,0,-3866,6,0,0,,3872,-3860
49,12-06-17,73,18:00,18:15,266.63,35.65,0,266.63,266.63,1,-165955,50783,216738,-115172,0,-304,30124,0,0,,30428,29820
49,12-06-17,74,18:15,18:30,44.84,,0,44.84,44.84,1,-128956,96676,225632,-32280,0,0,11503,0,0,,11503,11503
49,12-06-17,75,18:30,18:45,44.03,,0,44.03,44.03,1,-120761,91064,211825,-29697,0,0,1484,0,0,,1484,1484
49,12-06-17,76,18:45,19:00,64.98,,0,64.98,64.98,1,-116487,89040,205527,-27447,0,0,13227,0,0,,13227,13227
49,12-06-17,77,19:00,19:15,240.57,,0,240.57,240.57,1,-128924,51213,180137,-77711,0,0,25825,0,0,,25825,25825
49,12-06-17,78,19:15,19:30,48.04,,0,48.04,48.04,1,-101245,58559,159804,-42686,0,0,14150,0,0,,14150,14150
49,12-06-17,79,19:30,19:45,40.3,36.76,0,36.76,36.76,-1,-81109,80592,161701,-517,0,-731,3945,0,0,,4676,3214
49,12-06-17,80,19:45,20:00,,41.78,0,41.78,41.78,-1,-65883,68595,134478,2712,0,-2725,0,0,0,,2725,-2725
49,12-06-17,81,20:00,20:15,124.62,36.65,0,124.62,36.65,2,-64826,47357,112183,-17469,0,-1792,6380,0,0,,8172,4588
49,12-06-17,82,20:15,20:30,43.61,36.65,0,36.65,36.65,-1,-34106,53786,87892,19680,0,-547,4680,0,0,,5227,4133
49,12-06-17,83,20:30,20:45,,19.49,0,19.49,19.49,-1,-31296,89114,120410,57818,0,-28285,0,0,0,,28285,-28285
49,12-06-17,84,20:45,21:00,,-6.14,0,-6.14,-6.14,-1,-41589,104958,146547,63369,0,-52460,0,0,0,,52460,-52460
49,12-06-17,85,21:00,21:15,95.97,-56.41,0,95.97,-56.41,2,-79219,61744,140963,-17475,0,-52091,2670,0,0,,54761,-49421
49,12-06-17,86,21:15,21:30,139.12,25.07,0,139.12,25.07,2,-53354,31711,85065,-21643,0,-1694,26610,0,0,,28304,24916
49,12-06-17,87,21:30,21:45,43.7,10.07,0,43.7,10.07,2,-45867,44558,90425,-1309,0,-8149,1824,0,0,,9973,-6325
49,12-06-17,88,21:45,22:00,35.93,29.08,0,38.44,29.08,2,-49040,75368,124408,26328,0,-13925,1066,0,0,,14991,-12859
49,12-06-17,89,22:00,22:15,138.12,33.93,0,138.12,33.93,2,-61568,24169,85737,-37399,0,-8617,12390,0,0,,21007,3773
49,12-06-17,90,22:15,22:30,43.36,36.25,0,43.36,36.25,2,-37840,36976,74816,-864,0,-346,6255,0,0,,6601,5909
49,12-06-17,91,22:30,22:45,35.93,32.93,0,38.36,32.93,2,-43148,56061,99209,12913,0,-919,829,0,0,,1748,-90
49,12-06-17,92,22:45,23:00,,-13.59,0,-13.59,-13.59,-1,-37847,107246,145093,69399,0,-41375,0,0,0,,41375,-41375
49,12-06-17,93,23:00,23:15,138.12,-13.59,0,138.12,138.12,1,-122493,7450,129943,-115043,0,-7764,21119,0,0,,28883,13355
49,12-06-17,94,23:15,23:30,43.36,,0,43.36,43.36,1,-64945,20099,85044,-44846,0,0,8411,0,0,,8411,8411
49,12-06-17,95,23:30,23:45,35.93,,0,35.93,35.93,1,-65172,40773,105945,-24399,0,0,118,0,0,,118,118
49,12-06-17,96,23:45,0:00,35.93,3.58,0,3.58,3.58,-1,-34240,82509,116749,48269,0,-9141,144,0,0,,9285,-8997
49,12-07-17,1,0:00,0:15,43.43,-29.51,0,43.43,-29.51,2,-91319,87147,178466,-4172,0,-20503,289,0,0,,20792,-20214
49,12-07-17,2,0:15,0:30,43.43,-6.08,0,-6.08,-6.08,-1,-31655,80906,112561,49251,0,-6524,27,0,0,,6551,-6497
49,12-07-17,3,0:30,0:45,,-4.52,0,-4.52,-4.52,-1,-47642,78933,126575,31291,0,-23895,0,0,0,,23895,-23895
49,12-07-17,4,0:45,1:00,,21.87,0,21.87,21.87,-1,-43668,84416,128084,40748,0,-38592,0,0,0,,38592,-38592
49,12-07-17,5,1:00,1:15,,34.03,0,34.03,34.03,-1,-37266,64325,101591,27059,0,-17780,0,0,0,,17780,-17780
49,12-07-17,6,1:15,1:30,,12.03,0,12.03,12.03,-1,-26650,85139,111789,58489,0,-7365,0,0,0,,7365,-7365
49,12-07-17,7,1:30,1:45,,5.09,0,5.09,5.09,-1,-31798,88089,119887,56291,0,-29563,0,0,0,,29563,-29563
49,12-07-17,8,1:45,2:00,,6.03,0,6.03,6.03,-1,-31859,111441,143300,79582,0,-51589,0,0,0,,51589,-51589
49,12-07-17,9,2:00,2:15,,9.45,0,9.45,9.45,-1,-36328,62182,98510,25854,0,-33991,0,0,0,,33991,-33991
49,12-07-17,10,2:15,2:30,,32.43,0,32.43,32.43,-1,-26656,84777,111433,58121,0,-4957,0,0,0,,4957,-4957
49,12-07-17,11,2:30,2:45,,15.92,0,15.92,15.92,-1,-30442,110704,141146,80262,0,-19785,0,0,0,,19785,-19785
49,12-07-17,12,2:45,3:00,,17.14,0,17.14,17.14,-1,-40632,113017,153649,72385,0,-38126,0,0,0,,38126,-38126
49,12-07-17,13,3:00,3:15,,36.43,0,36.43,36.43,-1,-23654,94779,118433,71125,0,-16398,0,0,0,,16398,-16398
49,12-07-17,14,3:15,3:30,,26.74,0,26.74,26.74,-1,-20659,98908,119567,78249,0,-13080,0,0,0,,13080,-13080
49,12-07-17,15,3:30,3:45,,7.48,0,7.48,7.48,-1,-20074,95924,115998,75850,0,-33437,0,0,0,,33437,-33437
49,12-07-17,16,3:45,4:00,,3.8,0,3.8,3.8,-1,-32400,101933,134333,69533,0,-40574,0,0,0,,40574,-40574
49,12-07-17,17,4:00,4:15,,-11.11,0,-11.11,-11.11,-1,-27025,144393,171418,117368,0,-56337,0,0,0,,56337,-56337
49,12-07-17,18,4:15,4:30,,34.03,0,34.03,34.03,-1,-26966,141997,168963,115031,0,-18477,0,0,0,,18477,-18477
49,12-07-17,19,4:30,4:45,,36.43,0,36.43,36.43,-1,-29190,126868,156058,97678,0,-6936,0,0,0,,6936,-6936
49,12-07-17,20,4:45,5:00,,18.71,0,18.71,18.71,-1,-32107,118608,150715,86501,0,-3264,0,0,0,,3264,-3264
49,12-07-17,21,5:00,5:15,,-25.75,0,-25.75,-25.75,-1,-73072,89011,162083,15939,0,-28399,0,0,0,,28399,-28399
49,12-07-17,22,5:15,5:30,,1.96,0,1.96,1.96,-1,-31272,90104,121376,58832,0,-28213,0,0,0,,28213,-28213
49,12-07-17,23,5:30,5:45,,26.74,0,26.74,26.74,-1,-45324,81760,127084,36436,0,-33653,0,0,0,,33653,-33653
49,12-07-17,24,5:45,6:00,,29.58,0,29.58,29.58,-1,-69256,92617,161873,23361,0,-5410,0,0,0,,5410,-5410
49,12-07-17,25,6:00,6:15,,-31.05,0,-31.05,-31.05,-1,-47876,125540,173416,77664,0,-45136,0,0,0,,45136,-45136
49,12-07-17,26,6:15,6:30,,-2.32,0,-2.32,-2.32,-1,-52900,123199,176099,70299,0,-23750,0,0,0,,23750,-23750
49,12-07-17,27,6:30,6:45,,34.4,0,34.4,34.4,-1,-53737,97498,151235,43761,0,-22527,0,0,0,,22527,-22527
49,12-07-17,28,6:45,7:00,,26.74,0,26.74,26.74,-1,-70024,119059,189083,49035,0,-7990,0,0,0,,7990,-7990
49,12-07-17,29,7:00,7:15,,25.99,0,25.99,25.99,-1,-119441,133233,252674,13792,0,-13325,0,0,0,,13325,-13325
49,12-07-17,30,7:15,7:30,60.44,25.99,0,60.44,60.44,1,-116859,90629,207488,-26230,0,-2562,11121,0,0,,13683,8559
49,12-07-17,31,7:30,7:45,223.82,,0,223.82,223.82,1,-125546,66916,192462,-58630,0,0,25591,0,0,,25591,25591
49,12-07-17,32,7:45,8:00,223.82,,0,223.82,223.82,1,-166143,70836,236979,-95307,0,0,72142,0,0,,72142,72142
49,12-07-17,33,8:00,8:15,223.82,5.93,0,5.93,5.93,-1,-106535,121606,228141,15071,0,-6575,21559,0,0,,28134,14984
49,12-07-17,34,8:15,8:30,,34.03,0,34.03,34.03,-1,-96860,78857,175717,-18003,0,-2926,0,0,0,,2926,-2926
49,12-07-17,35,8:30,8:45,,29.74,0,29.74,29.74,-1,-75997,83010,159007,7013,0,-26368,0,0,0,,26368,-26368
49,12-07-17,36,8:45,9:00,,30.96,0,30.96,30.96,-1,-83636,82392,166028,-1244,0,-32941,0,0,0,,32941,-32941
49,12-07-17,37,9:00,9:15,,-35.42,0,-35.42,-35.42,-1,-46399,108016,154415,61617,0,-49029,0,0,0,,49029,-49029
49,12-07-17,38,9:15,9:30,,4.58,0,4.58,4.58,-1,-55221,72906,128127,17685,0,-29542,0,0,0,,29542,-29542
49,12-07-17,39,9:30,9:45,,4.14,0,4.14,4.14,-1,-64762,88212,152974,23450,0,-47235,0,0,0,,47235,-47235
49,12-07-17,40,9:45,10:00,,32.74,0,32.74,32.74,-1,-77023,81185,158208,4162,0,-35271,0,0,0,,35271,-35271
49,12-07-17,41,10:00,10:15,,34.78,0,34.78,34.78,-1,-52490,66854,119344,14364,0,-16039,0,0,0,,16039,-16039
49,12-07-17,42,10:15,10:30,,29.74,0,29.74,29.74,-1,-59590,63013,122603,3423,0,-14791,0,0,0,,14791,-14791
49,12-07-17,43,10:30,10:45,,38.03,0,38.03,38.03,-1,-58241,52399,110640,-5842,0,-3781,0,0,0,,3781,-3781
49,12-07-17,44,10:45,11:00,41.86,38.69,0,41.86,38.69,2,-105323,56595,161918,-48728,0,-3642,1069,0,0,,4711,-2573
49,12-07-17,45,11:00,11:15,80.89,38.69,0,80.89,80.89,1,-97704,40628,138332,-57076,0,-131,16794,0,0,,16925,16663
49,12-07-17,46,11:15,11:30,48.02,,0,48.02,48.02,1,-84936,43129,128065,-41807,0,0,30694,0,0,,30694,30694
49,12-07-17,47,11:30,11:45,49.8,,0,49.8,49.8,1,-85137,37947,123084,-47190,0,0,30071,0,0,,30071,30071
49,12-07-17,48,11:45,12:00,52.75,,0,52.75,52.75,1,-87424,33406,120830,-54018,0,0,33428,0,0,,33428,33428
49,12-07-17,49,12:00,12:15,133.02,,0,133.02,133.02,1,-133729,33334,167063,-100395,0,0,59998,0,0,,59998,59998
49,12-07-17,50,12:15,12:30,75.34,,0,75.34,75.34,1,-99377,42276,141653,-57101,0,0,51664,0,0,,51664,51664
49,12-07-17,51,12:30,12:45,48.9,,0,48.9,48.9,1,-87120,57444,144564,-29676,0,0,17186,0,0,,17186,17186
49,12-07-17,52,12:45,13:00,40.27,,0,40.27,40.27,1,-78802,48491,127293,-30311,0,0,3778,0,0,,3778,3778
49,12-07-17,53,13:00,13:15,37.96,,0,37.96,37.96,1,-52996,31358,84354,-21638,0,0,690,0,0,,690,690
49,12-07-17,54,13:15,13:30,38.5,,0,38.5,38.5,1,-74138,26469,100607,-47669,0,0,2101,0,0,,2101,2101
49,12-07-17,55,13:30,13:45,46.66,,0,46.66,46.66,1,-77361,28014,105375,-49347,0,0,13878,0,0,,13878,13878
49,12-07-17,56,13:45,14:00,47.4,,0,47.4,47.4,1,-71402,35395,106797,-36007,0,0,26450,0,0,,26450,26450
49,12-07-17,57,14:00,14:15,72.23,,0,72.23,72.23,1,-93583,51287,144870,-42296,0,0,18768,0,0,,18768,18768
49,12-07-17,58,14:15,14:30,70.02,38.43,0,38.43,38.43,-1,-60776,51940,112716,-8836,0,-532,18401,0,0,,18933,17869
49,12-07-17,59,14:30,14:45,70.02,38.03,0,38.03,38.03,-1,-50253,60979,111232,10726,0,-508,563,0,0,,1071,55
49,12-07-17,60,14:45,15:00,37.96,,0,37.96,37.96,1,-66474,60103,126577,-6371,0,0,2,0,0,,2,2
49,12-07-17,61,15:00,15:15,37.96,39.46,0,39.26,39.26,2,-60606,64858,125464,4252,0,-609,25,0,0,,634,-584
49,12-07-17,62,15:15,15:30,41.54,39.46,0,41.54,39.26,2,-70018,58475,128493,-11543,0,-804,540,0,0,,1344,-264
49,12-07-17,63,15:30,15:45,53.68,,0,53.68,53.68,1,-84474,43405,127879,-41069,0,0,20923,0,0,,20923,20923
49,12-07-17,64,15:45,16:00,49.17,,0,49.17,49.17,1,-85537,49207,134744,-36330,0,0,32174,0,0,,32174,32174
49,12-07-17,65,16:00,16:15,42.84,3.7,0,45.32,3.7,2,-84212,112306,196518,28094,0,-15312,14981,0,0,,30293,-331
49,12-07-17,66,16:15,16:30,37.96,37.03,0,45.32,37.03,2,-83974,81112,165086,-2862,0,-16841,8,0,0,,16849,-16833
49,12-07-17,67,16:30,16:45,60.46,37.03,0,60.46,60.46,1,-105581,68662,174243,-36919,0,-2976,10727,0,0,,13703,7751
49,12-07-17,68,16:45,17:00,70.02,,0,70.02,70.02,1,-127705,70137,197842,-57568,0,0,29146,0,0,,29146,29146
49,12-07-17,69,17:00,17:15,58.29,,0,58.29,58.29,1,-104475,81316,185791,-23159,0,0,23065,0,0,,23065,23065
49,12-07-17,70,17:15,17:30,41.91,,0,41.91,41.91,1,-83032,63682,146714,-19350,0,0,796,0,0,,796,796
49,12-07-17,71,17:30,17:45,43.96,,0,43.96,43.96,1,-86671,65531,152202,-21140,0,0,9364,0,0,,9364,9364
49,12-07-17,72,17:45,18:00,43.46,,0,43.46,43.46,1,-94808,79332,174140,-15476,0,0,6420,0,0,,6420,6420
49,12-07-17,73,18:00,18:15,43.46,5.77,0,5.77,5.77,-1,-102920,156005,258925,53085,0,-17542,873,0,0,,18415,-16669
49,12-07-17,74,18:15,18:30,,34.96,0,34.96,34.96,-1,-103825,115350,219175,11525,0,-18618,0,0,0,,18618,-18618
49,12-07-17,75,18:30,18:45,42.84,34.96,0,42.84,42.84,1,-118877,90307,209184,-28570,0,-2603,4351,0,0,,6954,1748
49,12-07-17,76,18:45,19:00,162.02,,0,162.02,162.02,1,-121916,49793,171709,-72123,0,0,31374,0,0,,31374,31374
49,12-07-17,77,19:00,19:15,151.02,,0,151.02,151.02,1,-160873,33355,194228,-127518,0,0,70533,0,0,,70533,70533
49,12-07-17,78,19:15,19:30,209.44,,0,209.44,209.44,1,-142390,48048,190438,-94342,0,0,86731,0,0,,86731,86731
49,12-07-17,79,19:30,19:45,51,,0,51,51,1,-118032,86585,204617,-31447,0,0,36263,0,0,,36263,36263
49,12-07-17,80,19:45,20:00,40.66,,0,40.66,40.66,1,-110698,86973,197671,-23725,0,0,5032,0,0,,5032,5032
49,12-07-17,81,20:00,20:15,208.86,,0,208.86,208.86,1,-146391,71463,217854,-74928,0,0,25500,0,0,,25500,25500
49,12-07-17,82,20:15,20:30,43.31,40.51,0,40.51,40.51,-1,-110175,99839,210014,-10336,0,-45,15846,0,0,,15891,15801
49,12-07-17,83,20:30,20:45,44.04,,0,44.04,44.04,1,-108306,81956,190262,-26350,0,0,6747,0,0,,6747,6747
49,12-07-17,84,20:45,21:00,38.84,31.96,0,31.96,31.96,-1,-102561,122451,225012,19890,0,-6935,4385,0,0,,11320,-2550
49,12-07-17,85,21:00,21:15,245.5,10.03,0,245.5,10.03,2,-122765,58765,181530,-64000,0,-15459,7862,0,0,,23321,-7597
49,12-07-17,86,21:15,21:30,225.23,36.03,0,225.23,36.03,2,-101348,73573,174921,-27775,0,-282,31567,0,0,,31849,31285
49,12-07-17,87,21:30,21:45,42.84,35.96,0,45.04,35.96,2,-99260,93299,192559,-5961,0,-447,3262,0,0,,3709,2815
49,12-07-17,88,21:45,22:00,42.84,-28.7,0,-28.7,-28.7,-1,-94736,187728,282464,92992,0,-47836,205,0,0,,48041,-47631
49,12-07-17,89,22:00,22:15,93.65,-3.03,0,93.65,-3.03,2,-51368,59521,110889,8153,0,-60811,809,0,0,,61620,-60002
49,12-07-17,90,22:15,22:30,111.26,33.68,0,111.26,33.68,2,-77180,94830,172010,17650,0,-3869,3704,0,0,,7573,-165
49,12-07-17,91,22:30,22:45,,18.96,0,18.96,18.96,-1,-62281,91879,154160,29598,0,-13066,0,0,0,,13066,-13066
49,12-07-17,92,22:45,23:00,,9.86,0,9.86,9.86,-1,-74679,119760,194439,45081,0,-43628,0,0,0,,43628,-43628
49,12-07-17,93,23:00,23:15,136.38,30.03,0,136.38,136.38,1,-75131,54846,129977,-20285,0,-21710,7806,0,0,,29516,-13904
49,12-07-17,94,23:15,23:30,42.94,18.8,0,18.8,18.8,-1,-70618,89775,160393,19157,0,-5478,8533,0,0,,14011,3055
49,12-07-17,95,23:30,23:45,,11.47,0,11.47,11.47,-1,-77846,101805,179651,23959,0,-18111,0,0,0,,18111,-18111
49,12-07-17,96,23:45,0:00,,-20.67,0,-20.67,-20.67,-1,-73632,170865,244497,97233,0,-35368,0,0,0,,35368,-35368
49,12-08-17,1,0:00,0:15,,28.81,0,28.81,28.81,-1,-88619,81189,169808,-7430,0,-16108,0,0,0,,16108,-16108
49,12-08-17,2,0:15,0:30,51.38,28.81,0,51.38,51.38,1,-69192,48409,117601,-20783,0,-12,5729,0,0,,5741,5717
49,12-08-17,3,0:30,0:45,152.55,,0,152.55,152.55,1,-109240,41057,150297,-68183,0,0,17535,0,0,,17535,17535
49,12-08-17,4,0:45,1:00,152.55,,0,152.55,152.55,1,-148783,46681,195464,-102102,0,0,91099,0,0,,91099,91099
49,12-08-17,5,1:00,1:15,152.55,29.08,0,29.08,29.08,-1,-60231,77490,137721,17259,0,-1330,24459,0,0,,25789,23129
49,12-08-17,6,1:15,1:30,35.81,,0,35.81,35.81,1,-50409,39499,89908,-10910,0,0,1584,0,0,,1584,1584
49,12-08-17,7,1:30,1:45,35.81,,0,35.81,35.81,1,-50486,49475,99961,-1011,0,0,158,0,0,,158,158
49,12-08-17,8,1:45,2:00,,32.81,0,32.81,32.81,-1,-57025,49872,106897,-7153,0,-2403,0,0,0,,2403,-2403
49,12-08-17,9,2:00,2:15,39.81,,0,39.81,39.81,1,-74182,44066,118248,-30116,0,0,1182,0,0,,1182,1182
49,12-08-17,10,2:15,2:30,39.81,27.64,0,27.64,27.64,-1,-63089,69529,132618,6440,0,-976,2800,0,0,,3776,1824
49,12-08-17,11,2:30,2:45,,-65.91,0,-65.91,-65.91,-1,-65959,83998,149957,18039,0,-21164,0,0,0,,21164,-21164
49,12-08-17,12,2:45,3:00,31.1,-65.91,0,31.1,31.1,1,-76713,63004,139717,-13709,0,-926,281,0,0,,1207,-645
49,12-08-17,13,3:00,3:15,43.52,,0,43.52,43.52,1,-98594,79473,178067,-19121,0,0,5802,0,0,,5802,5802
49,12-08-17,14,3:15,3:30,45.03,33.81,0,45.03,33.81,2,-81757,69909,151666,-11848,0,-484,2583,0,0,,3067,2099
49,12-08-17,15,3:30,3:45,51.58,,0,51.58,51.58,1,-82531,52511,135042,-30020,0,0,22111,0,0,,22111,22111
49,12-08-17,16,3:45,4:00,39.81,34.78,0,34.78,34.78,-1,-73431,70325,143756,-3106,0,-270,10490,0,0,,10760,10220
49,12-08-17,17,4:00,4:15,39.81,19.79,0,19.79,19.79,-1,-74661,94489,169150,19828,0,-5859,282,0,0,,6141,-5577
49,12-08-17,18,4:15,4:30,,19.15,0,19.15,19.15,-1,-77062,91995,169057,14933,0,-21001,0,0,0,,21001,-21001
49,12-08-17,19,4:30,4:45,,28.81,0,28.81,28.81,-1,-79632,96137,175769,16505,0,-6634,0,0,0,,6634,-6634
49,12-08-17,20,4:45,5:00,,27.09,0,27.09,27.09,-1,-87254,95874,183128,8620,0,-9232,0,0,0,,9232,-9232
49,12-08-17,21,5:00,5:15,,-64,0,-64,-64,-1,-60691,180157,240848,119466,0,-57656,0,0,0,,57656,-57656
49,12-08-17,22,5:15,5:30,,-0.78,0,-0.78,-0.78,-1,-61142,139143,200285,78001,0,-76011,0,0,0,,76011,-76011
49,12-08-17,23,5:30,5:45,,7.39,0,7.39,7.39,-1,-69199,118545,187744,49346,0,-63711,0,0,0,,63711,-63711
49,12-08-17,24,5:45,6:00,,2.78,0,2.78,2.78,-1,-88279,144531,232810,56252,0,-44028,0,0,0,,44028,-44028
49,12-08-17,25,6:00,6:15,,15.65,0,15.65,15.65,-1,-120668,142745,263413,22077,0,-19093,0,0,0,,19093,-19093
49,12-08-17,26,6:15,6:30,75.63,-20,0,75.63,-20,2,-100610,92339,192949,-8271,0,-29972,1366,0,0,,31338,-28606
49,12-08-17,27,6:30,6:45,131.12,-20,0,131.12,131.12,1,-103539,88991,192530,-14548,0,-516,13822,0,0,,14338,13306
49,12-08-17,28,6:45,7:00,41.02,34.94,0,41.02,34.94,2,-89435,87072,176507,-2363,0,-159,1651,0,0,,1810,1492
49,12-08-17,29,7:00,7:15,41.02,-81.41,0,-81.41,-81.41,-1,-96588,235746,332334,139158,0,-59614,69,0,0,,59683,-59545
49,12-08-17,30,7:15,7:30,,-13.78,0,-13.78,-13.78,-1,-100371,161917,262288,61546,0,-76562,0,0,0,,76562,-76562
49,12-08-17,31,7:30,7:45,,-34.11,0,-34.11,-34.11,-1,-91544,172044,263588,80500,0,-61081,0,0,0,,61081,-61081
49,12-08-17,32,7:45,8:00,,29.46,0,29.46,29.46,-1,-113238,155724,268962,42486,0,-51091,0,0,0,,51091,-51091
49,12-08-17,33,8:00,8:15,173.58,29.46,0,173.58,173.58,1,-88368,49119,137487,-39249,0,-11523,9980,0,0,,21503,-1543
49,12-08-17,34,8:15,8:30,173.58,,0,173.58,173.58,1,-100013,43535,143548,-56478,0,0,32152,0,0,,32152,32152
49,12-08-17,35,8:30,8:45,40.12,34.78,0,47.67,34.78,2,-68081,69851,137932,1770,0,-2635,15676,0,0,,18311,13041
49,12-08-17,36,8:45,9:00,87.11,34.78,0,87.11,87.11,1,-93829,54068,147897,-39761,0,-84,16331,0,0,,16415,16247
49,12-08-17,37,9:00,9:15,59.48,31.75,0,59.48,31.75,2,-70641,81574,152215,10933,0,-2662,18797,0,0,,21459,16135
49,12-08-17,38,9:15,9:30,281.93,54.91,0,281.93,281.93,1,-128879,67377,196256,-61502,0,-1046,16798,0,0,,17844,15752
49,12-08-17,39,9:30,9:45,281.93,,0,281.93,281.93,1,-126845,72093,198938,-54752,0,0,56345,0,0,,56345,56345
49,12-08-17,40,9:45,10:00,281.93,,0,281.93,281.93,1,-122658,57944,180602,-64714,0,0,33068,0,0,,33068,33068
49,12-08-17,41,10:00,10:15,277.99,,0,277.99,277.99,1,-176547,61881,238428,-114666,0,0,71500,0,0,,71500,71500
49,12-08-17,42,10:15,10:30,277.99,,0,277.99,277.99,1,-163044,73559,236603,-89485,0,0,83867,0,0,,83867,83867
49,12-08-17,43,10:30,10:45,165.76,38.89,0,38.89,38.89,-1,-127930,99543,227473,-28387,0,-113,49941,1250,0,,51304,51078
49,12-08-17,44,10:45,11:00,59.36,31.04,0,59.36,31.04,2,-120719,94301,215020,-26418,0,-3400,3701,0,0,,7101,301
49,12-08-17,45,11:00,11:15,64.12,,0,64.12,64.12,1,-126554,85197,211751,-41357,0,0,11156,0,0,,11156,11156
49,12-08-17,46,11:15,11:30,141.12,,0,141.12,141.12,1,-127662,36692,164354,-90970,0,0,62751,0,0,,62751,62751
49,12-08-17,47,11:30,11:45,76.35,,0,76.35,76.35,1,-113496,61802,175298,-51694,0,0,56694,0,0,,56694,56694
49,12-08-17,48,11:45,12:00,76.35,37.92,0,37.92,37.92,-1,-93656,98037,191693,4381,0,-1883,5633,0,0,,7516,3750
49,12-08-17,49,12:00,12:15,,37.92,0,37.92,37.92,-1,-114536,117652,232188,3116,0,-2305,0,0,0,,2305,-2305
49,12-08-17,50,12:15,12:30,,,0,38.54,38.54,0,-114005,62702,176707,-51303,0,0,0,0,0,,0,0
49,12-08-17,51,12:30,12:45,41.64,,0,41.64,41.64,1,-99145,57267,156412,-41878,0,0,422,0,0,,422,422
49,12-08-17,52,12:45,13:00,42.28,,0,42.28,42.28,1,-109551,69645,179196,-39906,0,0,866,0,0,,866,866
49,12-08-17,53,13:00,13:15,205.33,,0,205.33,205.33,1,-125861,42806,168667,-83055,0,0,20984,0,0,,20984,20984
49,12-08-17,54,13:15,13:30,205.33,,0,205.33,205.33,1,-116593,39331,155924,-77262,0,0,78347,0,0,,78347,78347
49,12-08-17,55,13:30,13:45,78.51,,0,78.51,78.51,1,-92136,58336,150472,-33800,0,0,34357,0,0,,34357,34357
49,12-08-17,56,13:45,14:00,,38.92,0,38.92,38.92,-1,-72724,95258,167982,22534,0,-140,0,0,0,,140,-140
49,12-08-17,57,14:00,14:15,60.23,,0,60.23,60.23,1,-105638,60501,166139,-45137,0,0,7741,0,0,,7741,7741
49,12-08-17,58,14:15,14:30,112.36,,0,112.36,112.36,1,-111246,54350,165596,-56896,0,0,36488,0,0,,36488,36488
49,12-08-17,59,14:30,14:45,57.12,38.93,0,38.93,38.93,-1,-56618,45125,101743,-11493,0,-22,31743,0,0,,31765,31721
49,12-08-17,60,14:45,15:00,41.06,34.99,0,41.06,34.99,2,-70444,81387,151831,10943,0,-1413,3293,0,0,,4706,1880
49,12-08-17,61,15:00,15:15,42.92,37.92,0,42.92,37.92,2,-69831,61207,131038,-8624,0,-398,1047,0,0,,1445,649
49,12-08-17,62,15:15,15:30,,20.93,0,20.93,20.93,-1,-41676,84919,126595,43243,0,-27179,0,0,0,,27179,-27179
49,12-08-17,63,15:30,15:45,44.92,20.93,0,44.92,44.92,1,-64671,64842,129513,171,0,-6301,881,0,0,,7182,-5420
49,12-08-17,64,15:45,16:00,,30.34,0,30.34,30.34,-1,-40389,86246,126635,45857,0,-14036,0,0,0,,14036,-14036
49,12-08-17,65,16:00,16:15,,-34.07,0,-34.07,-34.07,-1,-52336,131868,184204,79532,0,-45677,0,0,0,,45677,-45677
49,12-08-17,66,16:15,16:30,,33.93,0,33.93,33.93,-1,-71375,140061,211436,68686,0,-32948,0,0,0,,32948,-32948
49,12-08-17,67,16:30,16:45,,33.92,0,33.92,33.92,-1,-89623,158249,247872,68626,0,-25495,0,0,0,,25495,-25495
49,12-08-17,68,16:45,17:00,44.92,33.92,0,44.92,44.92,1,-116011,128480,244491,12469,0,-1461,1173,0,0,,2634,-288
49,12-08-17,69,17:00,17:15,77.19,,0,77.19,77.19,1,-132090,107998,240088,-24092,0,0,11237,0,0,,11237,11237
49,12-08-17,70,17:15,17:30,44.92,24.44,0,24.44,24.44,-1,-95205,126751,221956,31546,0,-6104,10753,0,0,,16857,4649
49,12-08-17,71,17:30,17:45,44.92,14.75,0,14.75,14.75,-1,-101080,123414,224494,22334,0,-26626,107,0,0,,26733,-26519
49,12-08-17,72,17:45,18:00,,20.93,0,20.93,20.93,-1,-61717,118598,180315,56881,0,-17607,0,0,0,,17607,-17607
49,12-08-17,73,18:00,18:15,,6.87,0,6.87,6.87,-1,-92977,138827,231804,45850,0,-39614,0,0,0,,39614,-39614
49,12-08-17,74,18:15,18:30,,25.47,0,25.47,25.47,-1,-108792,112754,221546,3962,0,-30069,0,0,0,,30069,-30069
49,12-08-17,75,18:30,18:45,,34.99,0,34.99,34.99,-1,-87630,94186,181816,6556,0,-5801,0,0,0,,5801,-5801
49,12-08-17,76,18:45,19:00,,38.92,0,38.92,38.92,-1,-63201,41157,104358,-22044,0,-1058,0,0,0,,1058,-1058
49,12-08-17,77,19:00,19:15,202.16,37.92,0,202.16,37.92,2,-102897,58194,161091,-44703,0,-460,11339,0,0,,11799,10879
49,12-08-17,78,19:15,19:30,202.16,33.92,0,202.16,33.92,2,-61361,64279,125640,2918,0,-1852,18557,0,0,,20409,16705
49,12-08-17,79,19:30,19:45,123.12,38.92,0,123.12,38.92,2,-63389,29275,92664,-34114,0,-672,9643,0,0,,10315,8971
49,12-08-17,80,19:45,20:00,44.92,38.92,0,38.92,38.92,-1,-58313,42853,101166,-15460,0,-56,5346,0,0,,5402,5290
49,12-08-17,81,20:00,20:15,203.98,35.97,0,203.98,35.97,2,-71779,26287,98066,-45492,0,-1942,7540,0,0,,9482,5598
49,12-08-17,82,20:15,20:30,189.04,34.25,0,189.04,34.25,2,-75432,59137,134569,-16295,0,-234,33300,0,0,,33534,33066
49,12-08-17,83,20:30,20:45,44.04,25.97,0,44.04,25.97,2,-80029,64148,144177,-15881,0,-1588,3399,0,0,,4987,1811
49,12-08-17,84,20:45,21:00,38.09,17.72,0,17.72,17.72,-1,-51995,85232,137227,33237,0,-6126,2010,0,0,,8136,-4116
49,12-08-17,85,21:00,21:15,122.89,-5.1,0,122.89,-5.1,2,-62772,58825,121597,-3947,0,-22533,2478,0,0,,25011,-20055
49,12-08-17,86,21:15,21:30,38.61,37.92,0,38.61,37.92,2,-40082,43181,83263,3099,0,-1033,1180,0,0,,2213,147
49,12-08-17,87,21:30,21:45,,21.94,0,21.94,21.94,-1,-38853,62232,101085,23379,0,-4345,0,0,0,,4345,-4345
49,12-08-17,88,21:45,22:00,48.67,8.78,0,48.67,8.78,2,-67657,73611,141268,5954,0,-21606,366,0,0,,21972,-21240
49,12-08-17,89,22:00,22:15,140.12,8.78,0,140.12,140.12,1,-126263,52395,178658,-73868,0,-421,40728,0,0,,41149,40307
49,12-08-17,90,22:15,22:30,206.09,,0,206.09,206.09,1,-105199,68229,173428,-36970,0,0,69080,0,0,,69080,69080
49,12-08-17,91,22:30,22:45,38.09,-49.8,0,38.51,-49.8,2,-58384,91417,149801,33033,0,-13057,4647,0,0,,17704,-8410
49,12-08-17,92,22:45,23:00,38.09,37.36,0,38.51,37.36,2,-44869,59179,104048,14310,0,-900,207,0,0,,1107,-693
49,12-08-17,93,23:00,23:15,50.92,35.68,0,50.92,35.68,2,-54520,40910,95430,-13610,0,-1736,5331,0,0,,7067,3595
49,12-08-17,94,23:15,23:30,50.33,,0,50.33,50.33,1,-63570,31224,94794,-32346,0,0,3768,0,0,,3768,3768
49,12-08-17,95,23:30,23:45,117.28,,0,117.28,117.28,1,-94906,26234,121140,-68672,0,0,49303,0,0,,49303,49303
49,12-08-17,96,23:45,0:00,44.74,33.92,0,44.74,33.92,2,-60127,38635,98762,-21492,0,-190,17729,0,0,,17919,17539
50,12-09-17,1,0:00,0:15,44.67,33.77,0,44.67,33.77,2,-99283,101589,200872,2306,0,-105,2541,0,0,,2646,2436
50,12-09-17,2,0:15,0:30,45.84,,0,45.84,45.84,1,-73598,55782,129380,-17816,0,0,9106,0,0,,9106,9106
50,12-09-17,3,0:30,0:45,35.77,38.19,0,35.77,34.63,2,-49809,33062,82871,-16747,0,-42,2576,0,0,,2618,2534
50,12-09-17,4,0:45,1:00,35.77,37.87,0,35.77,34.65,2,-30433,27779,58212,-2654,0,-14,733,0,0,,747,719
50,12-09-17,5,1:00,1:15,35.77,32.79,0,35.77,32.79,2,-42060,35065,77125,-6995,0,-977,75,0,0,,1052,-902
50,12-09-17,6,1:15,1:30,40.49,32.77,0,40.49,32.77,2,-33863,24998,58861,-8865,0,-444,728,0,0,,1172,284
50,12-09-17,7,1:30,1:45,,22.5,0,22.5,22.5,-1,-14184,44198,58382,30014,0,-12554,0,0,0,,12554,-12554
50,12-09-17,8,1:45,2:00,,15.52,0,15.52,15.52,-1,-22445,57074,79519,34629,0,-37209,0,0,0,,37209,-37209
50,12-09-17,9,2:00,2:15,78.02,36.07,0,78.02,34.26,2,-53560,26759,80319,-26801,0,-11540,10141,0,0,,21681,-1399
50,12-09-17,10,2:15,2:30,42.52,18.96,0,18.96,18.96,-1,-24608,41134,65742,16526,0,-2497,8049,0,0,,10546,5552
50,12-09-17,11,2:30,2:45,,14.59,0,14.59,14.59,-1,-16359,41439,57798,25080,0,-15504,0,0,0,,15504,-15504
50,12-09-17,12,2:45,3:00,,26.85,0,26.85,26.85,-1,-15511,43862,59373,28351,0,-7469,0,0,0,,7469,-7469
50,12-09-17,13,3:00,3:15,39.74,33.77,0,39.74,39.74,1,-32089,36043,68132,3954,0,-4414,530,0,0,,4944,-3884
50,12-09-17,14,3:15,3:30,39.76,,0,39.76,39.76,1,-39574,38706,78280,-868,0,0,716,0,0,,716,716
50,12-09-17,15,3:30,3:45,39.73,,0,39.73,39.73,1,-54799,45556,100355,-9243,0,0,1080,0,0,,1080,1080
50,12-09-17,16,3:45,4:00,39.67,19.78,0,39.67,19.78,2,-23415,53259,76674,29844,0,-1074,1164,0,0,,2238,90
50,12-09-17,17,4:00,4:15,,-8.07,0,-8.07,-8.07,-1,-13284,79175,92459,65891,0,-13933,0,0,0,,13933,-13933
50,12-09-17,18,4:15,4:30,,-9.03,0,-9.03,-9.03,-1,-25008,54340,79348,29332,0,-26603,0,0,0,,26603,-26603
50,12-09-17,19,4:30,4:45,,,0,34.34,34.34,0,-18664,53424,72088,34760,0,-794,0,0,0,,794,-794
50,12-09-17,20,4:45,5:00,,,0,34.34,34.34,0,-28853,60234,89087,31381,0,0,0,0,0,,0,0
50,12-09-17,21,5:00,5:15,,,0,34.34,34.34,0,-49131,78991,128122,29860,0,0,0,0,0,,0,0
50,12-09-17,22,5:15,5:30,,,0,34.33,34.33,0,-60476,70811,131287,10335,0,0,0,0,0,,0,0
50,12-09-17,23,5:30,5:45,,,0,34.32,34.32,0,-46914,61066,107980,14152,0,0,0,0,0,,0,0
50,12-09-17,24,5:45,6:00,,,0,34.31,34.31,0,-31146,41252,72398,10106,0,0,0,0,0,,0,0
50,12-09-17,25,6:00,6:15,,28.17,0,28.17,28.17,-1,-39911,65823,105734,25912,0,-4409,0,0,0,,4409,-4409
50,12-09-17,26,6:15,6:30,,32.49,0,32.49,32.49,-1,-32103,32256,64359,153,0,-4651,0,0,0,,4651,-4651
50,12-09-17,27,6:30,6:45,136.64,32.49,0,136.64,136.64,1,-81182,22552,103734,-58630,0,-617,17527,0,0,,18144,16910
50,12-09-17,28,6:45,7:00,136.64,,0,136.64,136.64,1,-110168,21097,131265,-89071,0,0,64872,0,0,,64872,64872
50,12-09-17,29,7:00,7:15,51.07,9.87,0,9.87,9.87,-1,-59800,75343,135143,15543,0,-2830,26482,0,0,,29312,23652
50,12-09-17,30,7:15,7:30,35.57,-7.43,0,35.57,-7.43,2,-76525,38073,114598,-38452,0,-12970,323,0,0,,13293,-12647
50,12-09-17,31,7:30,7:45,40.3,-7.43,0,40.3,40.3,1,-105139,25184,130323,-79955,0,-7,1985,0,0,,1992,1978
50,12-09-17,32,7:45,8:00,162.35,,0,162.35,162.35,1,-120918,29557,150475,-91361,0,0,39709,0,0,,39709,39709
50,12-09-17,33,8:00,8:15,75.02,32.87,0,32.87,32.87,-1,-57996,49766,107762,-8230,0,-538,28781,0,0,,29319,28243
50,12-09-17,34,8:15,8:30,75.02,30.14,0,30.14,30.14,-1,-70321,37737,108058,-32584,0,-731,11,0,0,,742,-720
50,12-09-17,35,8:30,8:45,73.02,,0,73.02,73.02,1,-89724,52617,142341,-37107,0,0,2851,0,0,,2851,2851
50,12-09-17,36,8:45,9:00,233.85,,0,233.85,233.85,1,-129537,53124,182661,-76413,0,0,53139,0,0,,53139,53139
50,12-09-17,37,9:00,9:15,233.85,26.23,0,26.23,26.23,-1,-39823,62880,102703,23057,0,-1964,21721,0,0,,23685,19757
50,12-09-17,38,9:15,9:30,,,0,38.62,38.62,0,-72385,71493,143878,-892,0,-64,0,0,0,,64,-64
50,12-09-17,39,9:30,9:45,74.37,,0,74.37,74.37,1,-74141,44124,118265,-30017,0,0,10771,0,0,,10771,10771
50,12-09-17,40,9:45,10:00,75.02,39.19,0,39.19,39.19,-1,-59414,46367,105781,-13047,0,-1,21164,0,0,,21165,21163
50,12-09-17,41,10:00,10:15,75.02,37.03,0,37.03,37.03,-1,-52317,72025,124342,19708,0,-542,1372,0,0,,1914,830
50,12-09-17,42,10:15,10:30,41.11,,0,41.11,41.11,1,-79341,63940,143281,-15401,0,0,200,0,0,,200,200
50,12-09-17,43,10:30,10:45,111.83,,0,111.83,111.83,1,-131038,59116,190154,-71922,0,0,18308,0,0,,18308,18308
50,12-09-17,44,10:45,11:00,39.03,,0,39.03,39.03,1,-130288,50539,180827,-79749,0,0,5926,0,0,,5926,5926
50,12-09-17,45,11:00,11:15,264.44,,0,264.44,264.44,1,-119202,34347,153549,-84855,0,0,28225,0,0,,28225,28225
50,12-09-17,46,11:15,11:30,51.02,37.03,0,51.02,37.03,2,-50271,62848,113119,12577,0,-254,11711,0,0,,11965,11457
50,12-09-17,47,11:30,11:45,,37.03,0,37.03,37.03,-1,-47927,65032,112959,17105,0,-339,0,0,0,,339,-339
50,12-09-17,48,11:45,12:00,,56.53,0,56.53,56.53,-1,-51411,43388,94799,-8023,0,-663,0,0,0,,663,-663
50,12-09-17,49,12:00,12:15,,,0,35.06,35.06,0,-97190,71592,168782,-25598,0,-92,0,0,0,,92,-92
50,12-09-17,50,12:15,12:30,,,0,35.07,35.07,0,-97015,58311,155326,-38704,0,0,0,0,0,,0,0
50,12-09-17,51,12:30,12:45,151.02,,0,151.02,151.02,1,-105095,52245,157340,-52850,0,0,13085,0,0,,13085,13085
50,12-09-17,52,12:45,13:00,39.03,,0,39.03,39.03,1,-81733,57032,138765,-24701,0,0,3660,0,0,,3660,3660
50,12-09-17,53,13:00,13:15,39.66,,0,39.66,39.66,1,-67126,49476,116602,-17650,0,0,840,0,0,,840,840
50,12-09-17,54,13:15,13:30,39.03,,0,39.03,39.03,1,-105275,28641,133916,-76634,0,0,360,0,0,,360,360
50,12-09-17,55,13:30,13:45,88.55,,0,88.55,88.55,1,-123085,21794,144879,-101291,0,0,16081,0,0,,16081,16081
50,12-09-17,56,13:45,14:00,39.56,,0,39.56,39.56,1,-93135,31681,124816,-61454,0,0,11680,0,0,,11680,11680
50,12-09-17,57,14:00,14:15,142.02,,0,142.02,142.02,1,-110003,30538,140541,-79465,0,0,26272,0,0,,26272,26272
50,12-09-17,58,14:15,14:30,97.02,,0,97.02,97.02,1,-104026,37924,141950,-66102,0,0,44838,0,0,,44838,44838
50,12-09-17,59,14:30,14:45,,,0,35.67,35.67,0,-89189,38517,127706,-50672,0,0,8407,0,0,,8407,8407
50,12-09-17,60,14:45,15:00,,,0,35.67,35.67,0,-105417,36044,141461,-69373,0,0,0,0,0,,0,0
50,12-09-17,61,15:00,15:15,45.17,,0,45.17,45.17,1,-107239,94394,201633,-12845,0,0,6643,0,0,,6643,6643
50,12-09-17,62,15:15,15:30,50.92,,0,50.92,50.92,1,-93636,74806,168442,-18830,0,0,18224,0,0,,18224,18224
50,12-09-17,63,15:30,15:45,43.3,,0,43.3,43.3,1,-92582,85839,178421,-6743,0,0,17877,0,0,,17877,17877
50,12-09-17,64,15:45,16:00,43.3,38.46,0,38.46,38.46,-1,-97450,131333,228783,33883,0,-275,2057,0,0,,2332,1782
50,12-09-17,65,16:00,16:15,121.93,,0,121.93,121.93,1,-106111,50482,156593,-55629,0,0,6873,0,0,,6873,6873
50,12-09-17,66,16:15,16:30,264.81,,0,264.81,264.81,1,-82289,48028,130317,-34261,0,0,21943,0,0,,21943,21943
50,12-09-17,67,16:30,16:45,264.81,,0,264.81,264.81,1,-136049,48020,184069,-88029,0,0,48811,0,0,,48811,48811
50,12-09-17,68,16:45,17:00,264.81,,0,264.81,264.81,1,-187470,52512,239982,-134958,0,0,84237,0,0,,84237,84237
50,12-09-17,69,17:00,17:15,311.8,,0,311.8,311.8,1,-113287,50455,163742,-62832,0,0,72979,0,0,,72979,72979
50,12-09-17,70,17:15,17:30,79.1,,0,79.1,79.1,1,-106642,47910,154552,-58732,0,0,34394,0,0,,34394,34394
50,12-09-17,71,17:30,17:45,66.02,,0,66.02,66.02,1,-80564,58986,139550,-21578,0,0,25314,0,0,,25314,25314
50,12-09-17,72,17:45,18:00,47.9,,0,47.9,47.9,1,-70203,60827,131030,-9376,0,0,4981,0,0,,4981,4981
50,12-09-17,73,18:00,18:15,109.68,32.03,0,109.68,32.03,2,-74130,87369,161499,13239,0,-991,11375,0,0,,12366,10384
50,12-09-17,74,18:15,18:30,109.68,9.45,0,9.45,9.45,-1,-49317,73065,122382,23748,0,-21382,364,0,0,,21746,-21018
50,12-09-17,75,18:30,18:45,41.94,11.15,0,47.77,11.15,2,-39613,76489,116102,36876,0,-8002,365,0,0,,8367,-7637
50,12-09-17,76,18:45,19:00,,6.15,0,6.15,6.15,-1,-27208,77428,104636,50220,0,-34312,0,0,0,,34312,-34312
50,12-09-17,77,19:00,19:15,,29.99,0,29.99,29.99,-1,-30594,82313,112907,51719,0,-23792,0,0,0,,23792,-23792
50,12-09-17,78,19:15,19:30,,4,0,4,4,-1,-39669,89545,129214,49876,0,-23690,0,0,0,,23690,-23690
50,12-09-17,79,19:30,19:45,,-8.83,0,-8.83,-8.83,-1,-47514,75289,122803,27775,0,-36421,0,0,0,,36421,-36421
50,12-09-17,80,19:45,20:00,,14.82,0,14.82,14.82,-1,-50364,88607,138971,38243,0,-14686,0,0,0,,14686,-14686
50,12-09-17,81,20:00,20:15,,32.49,0,32.49,32.49,-1,-55402,69606,125008,14204,0,-14360,0,0,0,,14360,-14360
50,12-09-17,82,20:15,20:30,39.03,37.03,0,39.26,37.03,2,-48077,49543,97620,1466,0,-228,151,0,0,,379,-77
50,12-09-17,83,20:30,20:45,,17.97,0,17.97,17.97,-1,-47393,72982,120375,25589,0,-21087,0,0,0,,21087,-21087
50,12-09-17,84,20:45,21:00,,19.58,0,19.58,19.58,-1,-59682,81848,141530,22166,0,-26898,0,0,0,,26898,-26898
50,12-09-17,85,21:00,21:15,125.54,3.03,0,125.54,3.03,2,-54393,54615,109008,222,0,-26975,1631,0,0,,28606,-25344
50,12-09-17,86,21:15,21:30,136.83,7.15,0,136.83,7.15,2,-30940,72802,103742,41862,0,-5379,4224,0,0,,9603,-1155
50,12-09-17,87,21:30,21:45,106.25,-40.13,0,106.25,-40.13,2,-70252,53442,123694,-16810,0,-21598,2963,0,0,,24561,-18635
50,12-09-17,88,21:45,22:00,42.46,18.8,0,42.46,18.8,2,-43918,57778,101696,13860,0,-4369,3427,0,0,,7796,-942
50,12-09-17,89,22:00,22:15,,7.03,0,7.03,7.03,-1,-91336,65338,156674,-25998,0,-8852,0,0,0,,8852,-8852
50,12-09-17,90,22:15,22:30,42.29,,0,42.29,42.29,1,-91840,36436,128276,-55404,0,0,1398,0,0,,1398,1398
50,12-09-17,91,22:30,22:45,,,0,35.84,35.84,0,-82957,56604,139561,-26353,0,0,0,0,0,,0,0
50,12-09-17,92,22:45,23:00,,36.08,0,36.08,36.08,-1,-74100,67246,141346,-6854,0,-142,0,0,0,,142,-142
50,12-09-17,93,23:00,23:15,,32.57,0,32.57,32.57,-1,-69785,62376,132161,-7409,0,-4509,0,0,0,,4509,-4509
50,12-09-17,94,23:15,23:30,,35.71,0,35.71,35.71,-1,-65226,45947,111173,-19279,0,-86,0,0,0,,86,-86
50,12-09-17,95,23:30,23:45,,33.57,0,33.57,33.57,-1,-42406,60140,102546,17734,0,-6543,0,0,0,,6543,-6543
50,12-09-17,96,23:45,0:00,,17.19,0,17.19,17.19,-1,-24985,80092,105077,55107,0,-35491,0,0,0,,35491,-35491
50,12-10-17,1,0:00,0:15,101.96,-21.52,0,101.96,-21.52,2,-56817,67318,124135,10501,0,-38082,1258,0,0,,39340,-36824
50,12-10-17,2,0:15,0:30,141.12,26.83,0,141.12,26.83,2,-41195,59712,100907,18517,0,-2943,6277,0,0,,9220,3334
50,12-10-17,3,0:30,0:45,141.12,26.16,0,26.16,26.16,-1,-59906,60884,120790,978,0,-8834,3,0,0,,8837,-8831
50,12-10-17,4,0:45,1:00,,22.78,0,22.78,22.78,-1,-43208,64991,108199,21783,0,-17863,0,0,0,,17863,-17863
50,12-10-17,5,1:00,1:15,44.31,34.07,0,44.31,34.07,2,-73028,56475,129503,-16553,0,-13436,792,0,0,,14228,-12644
50,12-10-17,6,1:15,1:30,39.86,38.07,0,39.86,35.72,2,-58624,50886,109510,-7738,0,-526,963,0,0,,1489,437
50,12-10-17,7,1:30,1:45,,35.74,0,35.74,35.74,-1,-41303,53907,95210,12604,0,-3220,0,0,0,,3220,-3220
50,12-10-17,8,1:45,2:00,,30.29,0,30.29,30.29,-1,-25176,50336,75512,25160,0,-5580,0,0,0,,5580,-5580
50,12-10-17,9,2:00,2:15,,25.17,0,25.17,25.17,-1,-40548,56879,97427,16331,0,-18905,0,0,0,,18905,-18905
50,12-10-17,10,2:15,2:30,40.49,25.17,0,40.49,40.49,1,-45054,32273,77327,-12781,0,-4263,814,0,0,,5077,-3449
50,12-10-17,11,2:30,2:45,39.88,,0,39.88,39.88,1,-72818,56390,129208,-16428,0,0,1578,0,0,,1578,1578
50,12-10-17,12,2:45,3:00,,,0,35.8,35.8,0,-84752,49054,133806,-35698,0,0,32,0,0,,32,32
50,12-10-17,13,3:00,3:15,79.77,,0,79.77,79.77,1,-93968,38737,132705,-55231,0,0,11924,0,0,,11924,11924
50,12-10-17,14,3:15,3:30,44.31,,0,44.31,44.31,1,-63969,44118,108087,-19851,0,0,12961,0,0,,12961,12961
50,12-10-17,15,3:30,3:45,,36.75,0,36.75,36.75,-1,-44395,63898,108293,19503,0,-3455,0,0,0,,3455,-3455
50,12-10-17,16,3:45,4:00,,28.74,0,28.74,28.74,-1,-53495,88936,142431,35441,0,-14931,0,0,0,,14931,-14931
50,12-10-17,17,4:00,4:15,,30.77,0,30.77,30.77,-1,-44277,56460,100737,12183,0,-23969,0,0,0,,23969,-23969
50,12-10-17,18,4:15,4:30,,38.07,0,38.07,38.07,-1,-58989,66156,125145,7167,0,-13392,0,0,0,,13392,-13392
50,12-10-17,19,4:30,4:45,45.89,39.07,0,45.89,45.89,1,-78535,42368,120903,-36167,0,-3174,3252,0,0,,6426,78
50,12-10-17,20,4:45,5:00,46.32,,0,46.32,46.32,1,-95913,47165,143078,-48748,0,0,13490,0,0,,13490,13490
50,12-10-17,21,5:00,5:15,46.32,-5.56,0,-5.56,-5.56,-1,-61893,106809,168702,44916,0,-18987,675,0,0,,19662,-18312
50,12-10-17,22,5:15,5:30,,25.63,0,25.63,25.63,-1,-78196,108959,187155,30763,0,-25240,0,0,0,,25240,-25240
50,12-10-17,23,5:30,5:45,,30.32,0,30.32,30.32,-1,-65911,112357,178268,46446,0,-2441,0,0,0,,2441,-2441
50,12-10-17,24,5:45,6:00,,29.18,0,29.18,29.18,-1,-74320,85105,159425,10785,0,-14847,0,0,0,,14847,-14847
50,12-10-17,25,6:00,6:15,,38,0,38,38,-1,-122823,144404,267227,21581,0,-7971,0,0,0,,7971,-7971
50,12-10-17,26,6:15,6:30,,33.77,0,33.77,33.77,-1,-64594,139602,204196,75008,0,-3990,0,0,0,,3990,-3990
50,12-10-17,27,6:30,6:45,,39,0,39,39,-1,-69132,103715,172847,34583,0,-2343,0,0,0,,2343,-2343
50,12-10-17,28,6:45,7:00,,38,0,38,38,-1,-77210,99557,176767,22347,0,-2998,0,0,0,,2998,-2998
50,12-10-17,29,7:00,7:15,,25.02,0,25.02,25.02,-1,-71813,106063,177876,34250,0,-11853,0,0,0,,11853,-11853
50,12-10-17,30,7:15,7:30,141.12,38,0,141.12,141.12,1,-99063,41805,140868,-57258,0,-6063,13853,0,0,,19916,7790
50,12-10-17,31,7:30,7:45,164.06,,0,164.06,164.06,1,-112551,55439,167990,-57112,0,0,52980,0,0,,52980,52980
50,12-10-17,32,7:45,8:00,149.15,,0,149.15,149.15,1,-147344,68752,216096,-78592,0,0,50892,0,0,,50892,50892
50,12-10-17,33,8:00,8:15,40.64,-18,0,40.64,-18,2,-46559,91417,137976,44858,0,-10512,13959,0,0,,24471,3447
50,12-10-17,34,8:15,8:30,73.4,-18,0,73.4,73.4,1,-82578,60221,142799,-22357,0,-237,18020,0,0,,18257,17783
50,12-10-17,35,8:30,8:45,40.64,40.57,0,40.57,40.57,-1,-75854,77135,152989,1281,0,-67,8382,0,0,,8449,8315
50,12-10-17,36,8:45,9:00,,,0,36.2,36.2,0,-72152,96060,168212,23908,0,0,0,0,0,,0,0
50,12-10-17,37,9:00,9:15,,,0,36.23,36.23,0,-68436,89788,158224,21352,0,0,0,0,0,,0,0
50,12-10-17,38,9:15,9:30,,,0,35.44,35.44,0,-65722,106693,172415,40971,0,0,0,0,0,,0,0
50,12-10-17,39,9:30,9:45,38.96,,0,38.96,38.96,1,-78651,90687,169338,12036,0,0,28,0,0,,28,28
50,12-10-17,40,9:45,10:00,95.12,,0,95.12,95.12,1,-98992,67126,166118,-31866,0,0,16701,0,0,,16701,16701
50,12-10-17,41,10:00,10:15,109.12,,0,109.12,109.12,1,-105686,78261,183947,-27425,0,0,34413,0,0,,34413,34413
50,12-10-17,42,10:15,10:30,96.12,,0,96.12,96.12,1,-112015,81666,193681,-30349,0,0,7395,0,0,,7395,7395
50,12-10-17,43,10:30,10:45,234.98,,0,234.98,234.98,1,-130862,91410,222272,-39452,0,0,32496,0,0,,32496,32496
50,12-10-17,44,10:45,11:00,234.98,,0,234.98,234.98,1,-166389,66090,232479,-100299,0,0,51867,0,0,,51867,51867
50,12-10-17,45,11:00,11:15,260.58,,0,260.58,260.58,1,-178803,52826,231629,-125977,0,0,84361,0,0,,84361,84361
50,12-10-17,46,11:15,11:30,359.04,,0,359.04,359.04,1,-161637,67653,229290,-93984,0,0,84933,5000,0,,89933,89933
50,12-10-17,47,11:30,11:45,359.04,,0,359.04,359.04,1,-156375,63738,220113,-92637,0,0,84751,5000,0,,89751,89751
50,12-10-17,48,11:45,12:00,359.04,,0,394.94,394.94,1,-181875,53169,235044,-128706,0,0,84959,5000,0,,89959,89959
50,12-10-17,49,12:00,12:15,262.99,,0,289.29,289.29,1,-311012,28610,339622,-282402,0,0,84975,0,33749,,118724,118724
50,12-10-17,50,12:15,12:30,262.99,,0,289.29,289.29,1,-315437,30465,345902,-284972,0,0,84945,1250,76365,,162560,162560
50,12-10-17,51,12:30,12:45,262.99,,0,289.29,289.29,1,-305093,41612,346705,-263481,0,0,84954,1250,76365,,162569,162569
50,12-10-17,52,12:45,13:00,262.99,,0,289.29,289.29,1,-311847,50335,362182,-261512,0,0,84959,1250,76365,,162574,162574
50,12-10-17,53,13:00,13:15,264.52,,0,290.97,290.97,1,-277496,37657,315153,-239839,0,0,84823,0,76365,,161188,161188
50,12-10-17,54,13:15,13:30,264.52,,0,290.97,290.97,1,-224335,29983,254318,-194352,0,0,84604,0,76365,,160969,160969
50,12-10-17,55,13:30,13:45,180.12,,0,260.12,260.12,1,-183848,60286,244134,-123562,0,0,63780,0,76365,,140145,140145
50,12-10-17,56,13:45,14:00,40.97,39,0,260.12,39,2,-124399,54722,179121,-69677,0,-45,5869,0,62953,,68867,68777
50,12-10-17,57,14:00,14:15,260.07,39,0,286.08,286.08,1,-178156,40768,218924,-137388,0,-24,21568,0,42081,,63673,63625
50,12-10-17,58,14:15,14:30,260.07,,0,286.08,286.08,1,-164472,39664,204136,-124808,0,0,79942,0,34998,,114940,114940
50,12-10-17,59,14:30,14:45,92.47,,0,258.9,258.9,1,-137931,43384,181315,-94547,0,0,56035,0,34998,,91033,91033
50,12-10-17,60,14:45,15:00,90.12,36.1,0,258.9,36.1,2,-98593,45654,144247,-52939,0,-137,30188,0,17499,,47824,47550
50,12-10-17,61,15:00,15:15,90.12,28.78,0,28.78,28.78,-1,-38429,152236,190665,113807,0,-7260,1031,0,17499,,25790,11270
50,12-10-17,62,15:15,15:30,,39,0,39,39,-1,-36240,103363,139603,67123,0,-1349,0,0,0,,1349,-1349
50,12-10-17,63,15:30,15:45,,,0,35.43,35.43,0,-37935,130942,168877,93007,0,0,0,0,0,,0,0
50,12-10-17,64,15:45,16:00,,,0,36.27,36.27,0,-31609,113839,145448,82230,0,0,0,0,0,,0,0
50,12-10-17,65,16:00,16:15,,34,0,34,34,-1,-35666,99949,135615,64283,0,-11678,0,0,0,,11678,-11678
50,12-10-17,66,16:15,16:30,,38,0,38,38,-1,-49008,102530,151538,53522,0,-6988,0,0,0,,6988,-6988
50,12-10-17,67,16:30,16:45,38.97,38.67,0,39.38,38.67,2,-75868,90027,165895,14159,0,-744,3,0,0,,747,-741
50,12-10-17,68,16:45,17:00,209.01,,0,209.01,209.01,1,-132337,67772,200109,-64565,0,0,30604,0,0,,30604,30604
50,12-10-17,69,17:00,17:15,189.61,,0,189.61,189.61,1,-93531,57193,150724,-36338,0,0,49917,0,0,,49917,49917
50,12-10-17,70,17:15,17:30,80.8,,0,80.8,80.8,1,-97574,71238,168812,-26336,0,0,22229,0,0,,22229,22229
50,12-10-17,71,17:30,17:45,173.95,,0,173.95,173.95,1,-115447,56804,172251,-58643,0,0,42356,0,0,,42356,42356
50,12-10-17,72,17:45,18:00,102.12,,0,102.12,102.12,1,-108686,62446,171132,-46240,0,0,41280,0,0,,41280,41280
50,12-10-17,73,18:00,18:15,236.4,,0,236.4,236.4,1,-110921,58546,169467,-52375,0,0,48166,0,0,,48166,48166
50,12-10-17,74,18:15,18:30,236.4,37.6,0,37.6,37.6,-1,-91961,101506,193467,9545,0,-889,13216,0,0,,14105,12327
50,12-10-17,75,18:30,18:45,,35.57,0,35.57,35.57,-1,-104018,124293,228311,20275,0,-3959,0,0,0,,3959,-3959
50,12-10-17,76,18:45,19:00,,34,0,34,34,-1,-106645,147505,254150,40860,0,-24308,0,0,0,,24308,-24308
50,12-10-17,77,19:00,19:15,41.44,37.78,0,41.44,41.44,1,-132418,115083,247501,-17335,0,-14394,1004,0,0,,15398,-13390
50,12-10-17,78,19:15,19:30,,,0,38.76,38.76,0,-128191,123622,251813,-4569,0,-45,165,0,0,,210,120
50,12-10-17,79,19:30,19:45,43.23,,0,43.23,43.23,1,-127638,116474,244112,-11164,0,0,2231,0,0,,2231,2231
50,12-10-17,80,19:45,20:00,40.96,,0,40.96,40.96,1,-133040,106243,239283,-26797,0,0,2227,0,0,,2227,2227
50,12-10-17,81,20:00,20:15,45.13,,0,45.13,45.13,1,-102565,79500,182065,-23065,0,0,7011,0,0,,7011,7011
50,12-10-17,82,20:15,20:30,191.65,,0,191.65,191.65,1,-114690,72470,187160,-42220,0,0,30446,0,0,,30446,30446
50,12-10-17,83,20:30,20:45,43.02,40.55,0,40.55,40.55,-1,-91128,77354,168482,-13774,0,-14,21280,0,0,,21294,21266
50,12-10-17,84,20:45,21:00,40.96,38.78,0,40.96,38.78,2,-74535,75656,150191,1121,0,-1137,2656,0,0,,3793,1519
50,12-10-17,85,21:00,21:15,40.96,36.98,0,36.98,36.98,-1,-111929,81006,192935,-30923,0,-1316,21,0,0,,1337,-1295
50,12-10-17,86,21:15,21:30,,39,0,39,39,-1,-75824,100572,176396,24748,0,-534,0,0,0,,534,-534
50,12-10-17,87,21:30,21:45,46.61,39,0,46.61,39,2,-100341,76509,176850,-23832,0,-572,3688,0,0,,4260,3116
50,12-10-17,88,21:45,22:00,39.57,,0,39.57,39.57,1,-121244,61936,183180,-59308,0,0,1986,0,0,,1986,1986
50,12-10-17,89,22:00,22:15,132.12,,0,132.12,132.12,1,-133754,62508,196262,-71246,0,0,26739,0,0,,26739,26739
50,12-10-17,90,22:15,22:30,132.12,,0,132.12,132.12,1,-132009,32583,164592,-99426,0,0,86239,0,0,,86239,86239
50,12-10-17,91,22:30,22:45,339,,0,339,339,1,-124064,69432,193496,-54632,0,0,63802,18750,0,,82552,82552
50,12-10-17,92,22:45,23:00,339,-65.1,0,-65.1,-65.1,-1,-97971,130775,228746,32804,0,-19968,7531,0,0,,27499,-12437
50,12-10-17,93,23:00,23:15,,36.78,0,36.78,36.78,-1,-71317,89221,160538,17904,0,-12843,0,0,0,,12843,-12843
50,12-10-17,94,23:15,23:30,,13.11,0,13.11,13.11,-1,-67637,104953,172590,37316,0,-27928,0,0,0,,27928,-27928
50,12-10-17,95,23:30,23:45,43.4,33.94,0,43.4,43.4,1,-87485,90105,177590,2620,0,-20104,301,0,0,,20405,-19803
50,12-10-17,96,23:45,0:00,61.69,33.94,0,61.69,61.69,1,-110416,79783,190199,-30633,0,-85,21153,0,0,,21238,21068
50,12-11-17,1,0:00,0:15,45.98,,0,45.98,45.98,1,-72287,62814,135101,-9473,0,0,13365,0,0,,13365,13365
50,12-11-17,2,0:15,0:30,78.02,,0,78.02,78.02,1,-81043,41378,122421,-39665,0,0,23803,0,0,,23803,23803
50,12-11-17,3,0:30,0:45,175.12,,0,175.12,175.12,1,-126480,40218,166698,-86262,0,0,39008,0,0,,39008,39008
50,12-11-17,4,0:45,1:00,146.86,,0,146.86,146.86,1,-102189,68877,171066,-33312,0,0,54671,0,0,,54671,54671
50,12-11-17,5,1:00,1:15,146.86,34,0,34,34,-1,-61682,105385,167067,43703,0,-3320,5598,0,0,,8918,2278
50,12-11-17,6,1:15,1:30,,35.3,0,35.3,35.3,-1,-68200,96472,164672,28272,0,-5954,0,0,0,,5954,-5954
50,12-11-17,7,1:30,1:45,197.17,35.3,0,197.17,197.17,1,-93440,37137,130577,-56303,0,-1057,17568,0,0,,18625,16511
50,12-11-17,8,1:45,2:00,152.25,,0,152.25,152.25,1,-80484,51341,131825,-29143,0,0,41388,0,0,,41388,41388
50,12-11-17,9,2:00,2:15,152.25,36.14,0,36.14,36.14,-1,-48003,68613,116616,20610,0,-1336,6614,0,0,,7950,5278
50,12-11-17,10,2:15,2:30,41.61,,0,41.61,41.61,1,-70996,41803,112799,-29193,0,0,4989,0,0,,4989,4989
50,12-11-17,11,2:30,2:45,40.47,,0,40.47,40.47,1,-70760,46430,117190,-24330,0,0,867,0,0,,867,867
50,12-11-17,12,2:45,3:00,42.21,,0,42.21,42.21,1,-69349,39061,108410,-30288,0,0,3349,0,0,,3349,3349
50,12-11-17,13,3:00,3:15,44.45,39.25,0,44.45,37.8,2,-28732,43944,72676,15212,0,-148,8334,0,0,,8482,8186
50,12-11-17,14,3:15,3:30,44.45,39.59,0,39.59,39.59,-1,-44434,45192,89626,758,0,-832,13,0,0,,845,-819
50,12-11-17,15,3:30,3:45,,39.23,0,39.23,39.23,-1,-44488,36761,81249,-7727,0,-292,0,0,0,,292,-292
50,12-11-17,16,3:45,4:00,,35.38,0,35.38,35.38,-1,-63611,48978,112589,-14633,0,-2078,0,0,0,,2078,-2078
50,12-11-17,17,4:00,4:15,,34.99,0,34.99,34.99,-1,-35443,92172,127615,56729,0,-4163,0,0,0,,4163,-4163
50,12-11-17,18,4:15,4:30,,21.14,0,21.14,21.14,-1,-36899,65827,102726,28928,0,-21947,0,0,0,,21947,-21947
50,12-11-17,19,4:30,4:45,,35.38,0,35.38,35.38,-1,-55709,59350,115059,3641,0,-14241,0,0,0,,14241,-14241
50,12-11-17,20,4:45,5:00,,35.38,0,35.38,35.38,-1,-54038,59658,113696,5620,0,-14278,0,0,0,,14278,-14278
50,12-11-17,21,5:00,5:15,,9.42,0,9.42,9.42,-1,-73494,121058,194552,47564,0,-29658,0,0,0,,29658,-29658
50,12-11-17,22,5:15,5:30,,2.86,0,2.86,2.86,-1,-41958,81607,123565,39649,0,-62254,0,0,0,,62254,-62254
50,12-11-17,23,5:30,5:45,,35.73,0,35.73,35.73,-1,-63130,81484,144614,18354,0,-13852,0,0,0,,13852,-13852
50,12-11-17,24,5:45,6:00,,-8.55,0,-8.55,-8.55,-1,-37051,118727,155778,81676,0,-18666,0,0,0,,18666,-18666
50,12-11-17,25,6:00,6:15,,0.17,0,0.17,0.17,-1,-56564,186620,243184,130056,0,-67229,0,0,0,,67229,-67229
50,12-11-17,26,6:15,6:30,,-47.89,0,-47.89,-47.89,-1,-43454,163280,206734,119826,0,-81790,0,0,0,,81790,-81790
50,12-11-17,27,6:30,6:45,,38.09,0,38.09,38.09,-1,-71057,171273,242330,100216,0,-13708,0,0,0,,13708,-13708
50,12-11-17,28,6:45,7:00,,,0,35.7,35.7,0,-102109,151592,253701,49483,0,0,0,0,0,,0,0
50,12-11-17,29,7:00,7:15,,-37.45,0,-37.45,-37.45,-1,-37518,321539,359057,284021,0,-63257,0,0,0,,63257,-63257
50,12-11-17,30,7:15,7:30,,5.03,0,5.03,5.03,-1,-76445,265197,341642,188752,0,-94223,0,0,0,,94223,-94223
50,12-11-17,31,7:30,7:45,,-30.32,0,-30.32,-30.32,-1,-94053,224682,318735,130629,0,-75507,0,0,0,,75507,-75507
50,12-11-17,32,7:45,8:00,,4.86,0,4.86,4.86,-1,-110893,219645,330538,108752,0,-33076,0,0,0,,33076,-33076
50,12-11-17,33,8:00,8:15,,33.03,0,33.03,33.03,-1,-82567,227046,309613,144479,0,-34971,0,0,0,,34971,-34971
50,12-11-17,34,8:15,8:30,,37.03,0,37.03,37.03,-1,-101923,205076,306999,103153,0,-8752,0,0,0,,8752,-8752
50,12-11-17,35,8:30,8:45,,3.13,0,3.13,3.13,-1,-99668,237276,336944,137608,0,-32819,0,0,0,,32819,-32819
50,12-11-17,36,8:45,9:00,43.23,36.98,0,43.23,43.23,1,-128047,203908,331955,75861,0,-10604,581,0,0,,11185,-10023
50,12-11-17,37,9:00,9:15,85.02,,0,85.02,85.02,1,-132346,147937,280283,15591,0,0,5854,0,0,,5854,5854
50,12-11-17,38,9:15,9:30,85.02,38.47,0,38.47,38.47,-1,-124101,146971,271072,22870,0,-503,9,0,0,,512,-494
50,12-11-17,39,9:30,9:45,,,0,35.93,35.93,0,-113211,141227,254438,28016,0,0,0,0,0,,0,0
50,12-11-17,40,9:45,10:00,,,0,35.93,35.93,0,-99189,135813,235002,36624,0,0,0,0,0,,0,0
50,12-11-17,41,10:00,10:15,79.05,,0,79.05,79.05,1,-117878,83861,201739,-34017,0,0,7538,0,0,,7538,7538
50,12-11-17,42,10:15,10:30,39.92,,0,39.92,39.92,1,-106512,90453,196965,-16059,0,0,10478,0,0,,10478,10478
50,12-11-17,43,10:30,10:45,38.96,,0,38.96,38.96,1,-105612,99696,205308,-5916,0,0,699,0,0,,699,699
50,12-11-17,44,10:45,11:00,38.96,,0,38.96,38.96,1,-101556,108524,210080,6968,0,0,618,0,0,,618,618
50,12-11-17,45,11:00,11:15,,,0,35.64,35.64,0,-118044,138386,256430,20342,0,0,0,0,0,,0,0
50,12-11-17,46,11:15,11:30,,,0,35.64,35.64,0,-122221,135628,257849,13407,0,0,0,0,0,,0,0
50,12-11-17,47,11:30,11:45,,38.5,0,38.5,38.5,-1,-127046,142992,270038,15946,0,-144,0,0,0,,144,-144
50,12-11-17,48,11:45,12:00,38.8,39.76,0,38.8,38.8,1,-130459,139593,270052,9134,0,-27,1,0,0,,28,-26
50,12-11-17,49,12:00,12:15,43.23,,0,43.23,43.23,1,-188929,77372,266301,-111557,0,0,4620,0,0,,4620,4620
50,12-11-17,50,12:15,12:30,,,0,35.62,35.62,0,-153841,71823,225664,-82018,0,0,331,0,0,,331,331
50,12-11-17,51,12:30,12:45,42.45,,0,42.45,42.45,1,-131440,75509,206949,-55931,0,0,509,0,0,,509,509
50,12-11-17,52,12:45,13:00,,,0,35.62,35.62,0,-122748,86954,209702,-35794,0,0,0,0,0,,0,0
50,12-11-17,53,13:00,13:15,48.02,,0,48.02,48.02,1,-154769,62820,217589,-91949,0,0,5146,0,0,,5146,5146
50,12-11-17,54,13:15,13:30,72.5,,0,72.5,72.5,1,-149367,79849,229216,-69518,0,0,11777,0,0,,11777,11777
50,12-11-17,55,13:30,13:45,97.02,,0,97.02,97.02,1,-147668,95975,243643,-51693,0,0,20582,0,0,,20582,20582
50,12-11-17,56,13:45,14:00,43.23,,0,43.23,43.23,1,-142934,107303,250237,-35631,0,0,12976,0,0,,12976,12976
50,12-11-17,57,14:00,14:15,44.33,,0,44.33,44.33,1,-161727,119473,281200,-42254,0,0,3150,0,0,,3150,3150
50,12-11-17,58,14:15,14:30,38.71,,0,38.71,38.71,1,-163306,126517,289823,-36789,0,0,831,0,0,,831,831
50,12-11-17,59,14:30,14:45,31.53,,0,31.53,31.53,1,-163277,129772,293049,-33505,0,0,345,0,0,,345,345
50,12-11-17,60,14:45,15:00,,,0,35.6,35.6,0,-137830,131432,269262,-6398,0,0,0,0,0,,0,0
50,12-11-17,61,15:00,15:15,132.76,,0,132.76,132.76,1,-115018,73706,188724,-41312,0,0,12256,0,0,,12256,12256
50,12-11-17,62,15:15,15:30,60.13,,0,60.13,60.13,1,-111371,70587,181958,-40784,0,0,31627,0,0,,31627,31627
50,12-11-17,63,15:30,15:45,51.02,,0,51.02,51.02,1,-98963,83000,181963,-15963,0,0,29356,0,0,,29356,29356
50,12-11-17,64,15:45,16:00,41.94,37.86,0,41.94,35.68,2,-111022,99074,210096,-11948,0,-203,4708,0,0,,4911,4505
50,12-11-17,65,16:00,16:15,45.64,,0,45.64,45.64,1,-80401,118046,198447,37645,0,0,2104,0,0,,2104,2104
50,12-11-17,66,16:15,16:30,70.02,36.98,0,70.02,36.11,2,-75884,122940,198824,47056,0,-419,14615,0,0,,15034,14196
50,12-11-17,67,16:30,16:45,43.23,33.88,0,43.23,33.88,2,-67578,119356,186934,51778,0,-5355,869,0,0,,6224,-4486
50,12-11-17,68,16:45,17:00,75.02,,0,75.02,75.02,1,-101619,114798,216417,13179,0,0,16616,0,0,,16616,16616
50,12-11-17,69,17:00,17:15,354.78,,0,354.78,354.78,1,-143155,41275,184430,-101880,0,0,56400,0,0,,56400,56400
50,12-11-17,70,17:15,17:30,354.78,,0,390.26,390.26,1,-143703,38788,182491,-104915,0,0,84632,0,5000,,89632,89632
50,12-11-17,71,17:30,17:45,384.9,38.16,0,38.16,38.16,-1,-98481,64954,163435,-33527,0,-4,54796,6250,15000,,76050,76042
50,12-11-17,72,17:45,18:00,384.9,37.44,0,37.44,37.44,-1,-44777,85483,130260,40706,0,-199,740,0,15000,,15939,15541
50,12-11-17,73,18:00,18:15,,35.16,0,35.16,35.16,-1,-44609,120651,165260,76042,0,-3150,0,0,0,,3150,-3150
50,12-11-17,74,18:15,18:30,,37.03,0,37.03,37.03,-1,-34492,121501,155993,87009,0,-4556,0,0,0,,4556,-4556
50,12-11-17,75,18:30,18:45,,36.96,0,36.96,36.96,-1,-29841,99873,129714,70032,0,-4717,0,0,0,,4717,-4717
50,12-11-17,76,18:45,19:00,,15.04,0,15.04,15.04,-1,-26245,103899,130144,77654,0,-25790,0,0,0,,25790,-25790
50,12-11-17,77,19:00,19:15,,-14.41,0,-14.41,-14.41,-1,-46180,111948,158128,65768,0,-45210,0,0,0,,45210,-45210
50,12-11-17,78,19:15,19:30,,35.19,0,35.19,35.19,-1,-64610,98098,162708,33488,0,-27203,0,0,0,,27203,-27203
50,12-11-17,79,19:30,19:45,,30.49,0,30.49,30.49,-1,-55466,100066,155532,44600,0,-29871,0,0,0,,29871,-29871
50,12-11-17,80,19:45,20:00,,30.49,0,30.49,30.49,-1,-68989,113848,182837,44859,0,-36356,0,0,0,,36356,-36356
50,12-11-17,81,20:00,20:15,106,23.9,0,106,23.9,2,-49694,46330,96024,-3364,0,-27753,2622,0,0,,30375,-25131
50,12-11-17,82,20:15,20:30,38.79,13.83,0,38.79,13.83,2,-22482,51760,74242,29278,0,-5323,1608,0,0,,6931,-3715
50,12-11-17,83,20:30,20:45,,2.43,0,2.43,2.43,-1,-15966,44229,60195,28263,0,-28486,0,0,0,,28486,-28486
50,12-11-17,84,20:45,21:00,,17.13,0,17.13,17.13,-1,-17312,83013,100325,65701,0,-49066,0,0,0,,49066,-49066
50,12-11-17,85,21:00,21:15,83.23,17.13,0,83.23,83.23,1,-94230,31162,125392,-63068,0,-27018,1840,0,0,,28858,-25178
50,12-11-17,86,21:15,21:30,40.74,,0,40.74,40.74,1,-66261,36933,103194,-29328,0,0,243,0,0,,243,243
50,12-11-17,87,21:30,21:45,39.61,,0,39.61,39.61,1,-40175,34816,74991,-5359,0,0,488,0,0,,488,488
50,12-11-17,88,21:45,22:00,39.61,17.13,0,17.13,17.13,-1,-20178,78450,98628,58272,0,-9540,84,0,0,,9624,-9456
50,12-11-17,89,22:00,22:15,208.68,36.03,0,208.68,36.03,2,-80000,54742,134742,-25258,0,-6928,8940,0,0,,15868,2012
50,12-11-17,90,22:15,22:30,208.68,16,0,16,16,-1,-42174,75303,117477,33129,0,-10203,614,0,0,,10817,-9589
50,12-11-17,91,22:30,22:45,54.27,11.03,0,54.27,11.03,2,-34598,40750,75348,6152,0,-19334,1360,0,0,,20694,-17974
50,12-11-17,92,22:45,23:00,54.27,16,0,16,16,-1,-35563,65900,101463,30337,0,-13376,171,0,0,,13547,-13205
50,12-11-17,93,23:00,23:15,44.43,11.03,0,44.43,44.43,1,-80116,55375,135491,-24741,0,-17282,553,0,0,,17835,-16729
50,12-11-17,94,23:15,23:30,,,0,39.45,39.45,0,-70122,39480,109602,-30642,0,-25,108,0,0,,133,83
50,12-11-17,95,23:30,23:45,,,0,39.45,39.45,0,-77841,14966,92807,-62875,0,0,0,0,0,,0,0
50,12-11-17,96,23:45,0:00,,,0,39.45,39.45,0,-118319,19674,137993,-98645,0,0,0,0,0,,0,0
50,12-12-17,1,0:00,0:15,113.79,,0,113.79,113.79,1,-132716,109091,241807,-23625,0,0,11482,0,0,,11482,11482
50,12-12-17,2,0:15,0:30,115.34,,0,115.34,115.34,1,-165413,99968,265381,-65445,0,0,49411,0,0,,49411,49411
50,12-12-17,3,0:30,0:45,135.53,,0,135.53,135.53,1,-217002,95371,312373,-121631,0,0,72559,0,0,,72559,72559
50,12-12-17,4,0:45,1:00,135.53,,0,135.53,135.53,1,-179484,102756,282240,-76728,0,0,81419,0,0,,81419,81419
50,12-12-17,5,1:00,1:15,42.16,,0,42.16,42.16,1,-151200,99680,250880,-51520,0,0,12780,0,0,,12780,12780
50,12-12-17,6,1:15,1:30,,,0,38.9,38.9,0,-179805,96261,276066,-83544,0,0,0,0,0,,0,0
50,12-12-17,7,1:30,1:45,138.63,,0,138.63,138.63,1,-173375,67833,241208,-105542,0,0,32763,0,0,,32763,32763
50,12-12-17,8,1:45,2:00,89.12,,0,89.12,89.12,1,-146454,68106,214560,-78348,0,0,53436,0,0,,53436,53436
50,12-12-17,9,2:00,2:15,191.48,,0,191.48,191.48,1,-192919,75381,268300,-117538,0,0,70437,0,0,,70437,70437
50,12-12-17,10,2:15,2:30,191.48,,0,191.48,191.48,1,-166061,94729,260790,-71332,0,0,84999,0,0,,84999,84999
50,12-12-17,11,2:30,2:45,96.1,,0,96.1,96.1,1,-139879,89324,229203,-50555,0,0,41966,0,0,,41966,41966
50,12-12-17,12,2:45,3:00,161.17,,0,161.17,161.17,1,-149404,103355,252759,-46049,0,0,51938,0,0,,51938,51938
50,12-12-17,13,3:00,3:15,161.17,35.25,0,35.25,35.25,-1,-96003,101102,197105,5099,0,-809,8607,0,0,,9416,7798
50,12-12-17,14,3:15,3:30,38.9,,0,38.9,38.9,1,-99682,90805,190487,-8877,0,0,981,0,0,,981,981
50,12-12-17,15,3:30,3:45,42.16,,0,42.16,42.16,1,-91374,80374,171748,-11000,0,0,1504,0,0,,1504,1504
50,12-12-17,16,3:45,4:00,42.16,,0,42.16,42.16,1,-86794,61807,148601,-24987,0,0,3219,0,0,,3219,3219
50,12-12-17,17,4:00,4:15,42.16,,0,42.16,42.16,1,-62010,61191,123201,-819,0,0,2007,0,0,,2007,2007
50,12-12-17,18,4:15,4:30,,,0,38.8,38.8,0,-47104,69857,116961,22753,0,0,31,0,0,,31,31
50,12-12-17,19,4:30,4:45,,,0,38.79,38.79,0,-41545,65075,106620,23530,0,0,0,0,0,,0,0
50,12-12-17,20,4:45,5:00,37.79,,0,37.79,37.79,1,-50913,55229,106142,4316,0,0,128,0,0,,128,128
50,12-12-17,21,5:00,5:15,,-56.96,0,-56.96,-56.96,-1,-20356,82775,103131,62419,0,-22087,0,0,0,,22087,-22087
50,12-12-17,22,5:15,5:30,,36.72,0,36.72,36.72,-1,-40271,49255,89526,8984,0,-5372,0,0,0,,5372,-5372
50,12-12-17,23,5:30,5:45,,39.87,0,39.87,39.87,-1,-44519,43822,88341,-697,0,-1428,0,0,0,,1428,-1428
50,12-12-17,24,5:45,6:00,350.52,39.87,0,350.52,350.52,1,-78875,35263,114138,-43612,0,-359,14713,0,0,,15072,14354
50,12-12-17,25,6:00,6:15,119.52,,0,119.52,119.52,1,-102588,52695,155283,-49893,0,0,46111,0,0,,46111,46111
50,12-12-17,26,6:15,6:30,47.43,,0,47.43,47.43,1,-64877,29447,94324,-35430,0,0,24288,0,0,,24288,24288
50,12-12-17,27,6:30,6:45,55.52,,0,55.52,55.52,1,-57634,30504,88138,-27130,0,0,23254,0,0,,23254,23254
50,12-12-17,28,6:45,7:00,51.48,,0,51.48,51.48,1,-87395,52539,139934,-34856,0,0,22286,0,0,,22286,22286
50,12-12-17,29,7:00,7:15,51.48,-40.88,0,-40.88,-40.88,-1,-11846,155636,167482,143790,0,-42428,6748,0,0,,49176,-35680
50,12-12-17,30,7:15,7:30,,10.93,0,10.93,10.93,-1,-40023,89831,129854,49808,0,-42349,0,0,0,,42349,-42349
50,12-12-17,31,7:30,7:45,,-5.54,0,-5.54,-5.54,-1,-36601,109383,145984,72782,0,-34678,0,0,0,,34678,-34678
50,12-12-17,32,7:45,8:00,51.48,-5.54,0,51.48,51.48,1,-90346,92988,183334,2642,0,-6804,1521,0,0,,8325,-5283
50,12-12-17,33,8:00,8:15,38.64,16.26,0,39.2,16.26,2,-25010,113919,138929,88909,0,-12772,459,0,0,,13231,-12313
50,12-12-17,34,8:15,8:30,,35.5,0,35.5,35.5,-1,-49131,71259,120390,22128,0,-9100,0,0,0,,9100,-9100
50,12-12-17,35,8:30,8:45,67.5,,0,67.5,67.5,1,-69092,63982,133074,-5110,0,0,6353,0,0,,6353,6353
50,12-12-17,36,8:45,9:00,66.26,,0,66.26,66.26,1,-74871,44643,119514,-30228,0,0,20625,0,0,,20625,20625
50,12-12-17,37,9:00,9:15,336.57,,0,336.57,336.57,1,-85589,24773,110362,-60816,0,0,32633,0,0,,32633,32633
50,12-12-17,38,9:15,9:30,336.57,,0,336.57,336.57,1,-101997,27102,129099,-74895,0,0,63449,0,0,,63449,63449
50,12-12-17,39,9:30,9:45,336.57,,0,336.57,336.57,1,-107914,20515,128429,-87399,0,0,63689,0,0,,63689,63689
50,12-12-17,40,9:45,10:00,336.57,,0,336.57,336.57,1,-117805,20028,137833,-97777,0,0,74281,0,0,,74281,74281
50,12-12-17,41,10:00,10:15,373.72,,0,373.72,373.72,1,-113303,32621,145924,-80682,0,0,68458,0,0,,68458,68458
50,12-12-17,42,10:15,10:30,373.72,,0,373.72,373.72,1,-110740,32699,143439,-78041,0,0,76308,0,0,,76308,76308
50,12-12-17,43,10:30,10:45,144.83,,0,144.83,144.83,1,-97064,37570,134634,-59494,0,0,57694,0,0,,57694,57694
50,12-12-17,44,10:45,11:00,144.83,,0,144.83,144.83,1,-104305,27057,131362,-77248,0,0,50841,0,0,,50841,50841
50,12-12-17,45,11:00,11:15,135.26,,0,135.26,135.26,1,-83482,34150,117632,-49332,0,0,47935,0,0,,47935,47935
50,12-12-17,46,11:15,11:30,399.8,,0,399.8,399.8,1,-110316,23603,133919,-86713,0,0,70633,0,0,,70633,70633
50,12-12-17,47,11:30,11:45,399.8,,0,399.8,399.8,1,-110430,31386,141816,-79044,0,0,82996,3750,0,,86746,86746
50,12-12-17,48,11:45,12:00,297.26,,0,297.26,297.26,1,-115291,50106,165397,-65185,0,0,47089,3750,0,,50839,50839
50,12-12-17,49,12:00,12:15,72.26,,0,72.26,72.26,1,-105497,86225,191722,-19272,0,0,28019,0,0,,28019,28019
50,12-12-17,50,12:15,12:30,103.35,,0,103.35,103.35,1,-120716,83502,204218,-37214,0,0,24567,0,0,,24567,24567
50,12-12-17,51,12:30,12:45,38.14,36.79,0,39.05,36.79,2,-111944,96358,208302,-15586,0,-171,3807,0,0,,3978,3636
50,12-12-17,52,12:45,13:00,38.14,36.14,0,36.14,36.14,-1,-104570,108106,212676,3536,0,-152,229,0,0,,381,77
50,12-12-17,53,13:00,13:15,,35.99,0,35.99,35.99,-1,-66212,157055,223267,90843,0,-859,0,0,0,,859,-859
50,12-12-17,54,13:15,13:30,,36.14,0,36.14,36.14,-1,-70028,141953,211981,71925,0,-623,0,0,0,,623,-623
50,12-12-17,55,13:30,13:45,,37.43,0,37.43,37.43,-1,-69774,141055,210829,71281,0,-67,0,0,0,,67,-67
50,12-12-17,56,13:45,14:00,,30.62,0,30.62,30.62,-1,-73122,113442,186564,40320,0,-13547,0,0,0,,13547,-13547
50,12-12-17,57,14:00,14:15,,36.14,0,36.14,36.14,-1,-55916,81511,137427,25595,0,-14921,0,0,0,,14921,-14921
50,12-12-17,58,14:15,14:30,,19.74,0,19.74,19.74,-1,-71989,95980,167969,23991,0,-28548,0,0,0,,28548,-28548
50,12-12-17,59,14:30,14:45,,40.15,0,40.15,40.15,-1,-80072,84855,164927,4783,0,-5310,0,0,0,,5310,-5310
50,12-12-17,60,14:45,15:00,,35.14,0,35.14,35.14,-1,-62306,58475,120781,-3831,0,-4960,0,0,0,,4960,-4960
50,12-12-17,61,15:00,15:15,,12.69,0,12.69,12.69,-1,-42905,84992,127897,42087,0,-30665,0,0,0,,30665,-30665
50,12-12-17,62,15:15,15:30,,30.51,0,30.51,30.51,-1,-59701,70621,130322,10920,0,-25637,0,0,0,,25637,-25637
50,12-12-17,63,15:30,15:45,,40.18,0,40.18,40.18,-1,-70376,71426,141802,1050,0,-1822,0,0,0,,1822,-1822
50,12-12-17,64,15:45,16:00,,31.14,0,31.14,31.14,-1,-56793,71805,128598,15012,0,-9348,0,0,0,,9348,-9348
50,12-12-17,65,16:00,16:15,,6.98,0,6.98,6.98,-1,-65327,123737,189064,58410,0,-40024,0,0,0,,40024,-40024
50,12-12-17,66,16:15,16:30,,-2.97,0,-2.97,-2.97,-1,-35126,118613,153739,83487,0,-53261,0,0,0,,53261,-53261
50,12-12-17,67,16:30,16:45,,26.64,0,26.64,26.64,-1,-38642,115517,154159,76875,0,-56734,0,0,0,,56734,-56734
50,12-12-17,68,16:45,17:00,47.25,35.14,0,47.25,47.25,1,-84908,97786,182694,12878,0,-23898,128,0,0,,24026,-23770
50,12-12-17,69,17:00,17:15,49.54,34.95,0,49.54,34.95,2,-48956,72136,121092,23180,0,-11269,96,0,0,,11365,-11173
50,12-12-17,70,17:15,17:30,,36.14,0,36.14,36.14,-1,-51227,58708,109935,7481,0,-17785,0,0,0,,17785,-17785
50,12-12-17,71,17:30,17:45,,35.77,0,35.77,35.77,-1,-52900,70611,123511,17711,0,-12202,0,0,0,,12202,-12202
50,12-12-17,72,17:45,18:00,,40.27,0,40.27,40.27,-1,-40680,75824,116504,35144,0,-15148,0,0,0,,15148,-15148
50,12-12-17,73,18:00,18:15,51.27,30.47,0,51.27,30.47,2,-55295,39839,95134,-15456,0,-6568,1667,0,0,,8235,-4901
50,12-12-17,74,18:15,18:30,,17.58,0,17.58,17.58,-1,-42545,79977,122522,37432,0,-38371,0,0,0,,38371,-38371
50,12-12-17,75,18:30,18:45,,29.28,0,29.28,29.28,-1,-47380,92110,139490,44730,0,-40841,0,0,0,,40841,-40841
50,12-12-17,76,18:45,19:00,,22.21,0,22.21,22.21,-1,-40531,99019,139550,58488,0,-57287,0,0,0,,57287,-57287
50,12-12-17,77,19:00,19:15,108.26,22.21,0,108.26,108.26,1,-121674,63425,185099,-58249,0,-18435,2371,0,0,,20806,-16064
50,12-12-17,78,19:15,19:30,38.14,44.09,0,42.11,42.11,2,-92950,81534,174484,-11416,0,-61,951,0,0,,1012,890
50,12-12-17,79,19:30,19:45,,27.95,0,27.95,27.95,-1,-73241,111143,184384,37902,0,-9455,0,0,0,,9455,-9455
50,12-12-17,80,19:45,20:00,,37.13,0,37.13,37.13,-1,-61246,104343,165589,43097,0,-25768,0,0,0,,25768,-25768
50,12-12-17,81,20:00,20:15,52.07,31.14,0,52.07,31.14,2,-86359,71118,157477,-15241,0,-21037,1434,0,0,,22471,-19603
50,12-12-17,82,20:15,20:30,53.1,43.81,0,43.81,43.81,-1,-77523,66057,143580,-11466,0,-628,2219,0,0,,2847,1591
50,12-12-17,83,20:30,20:45,,35.14,0,35.14,35.14,-1,-60039,91106,151145,31067,0,-18184,0,0,0,,18184,-18184
50,12-12-17,84,20:45,21:00,,-4.27,0,-4.27,-4.27,-1,-34455,105629,140084,71174,0,-51457,0,0,0,,51457,-51457
50,12-12-17,85,21:00,21:15,52.13,10.77,0,52.13,10.77,2,-136565,110668,247233,-25897,0,-33661,799,0,0,,34460,-32862
50,12-12-17,86,21:15,21:30,52.13,28.25,0,28.25,28.25,-1,-92351,104947,197298,12596,0,-3328,110,0,0,,3438,-3218
50,12-12-17,87,21:30,21:45,,31.14,0,31.14,31.14,-1,-52775,96555,149330,43780,0,-20989,0,0,0,,20989,-20989
50,12-12-17,88,21:45,22:00,,-8.92,0,-8.92,-8.92,-1,-43020,136841,179861,93821,0,-55307,0,0,0,,55307,-55307
50,12-12-17,89,22:00,22:15,169.58,11.56,0,169.58,169.58,1,-147663,33088,180751,-114575,0,-33006,6107,0,0,,39113,-26899
50,12-12-17,90,22:15,22:30,142.73,41.42,0,142.73,41.42,2,-84852,44269,129121,-40583,0,-80,35658,0,0,,35738,35578
50,12-12-17,91,22:30,22:45,142.73,11.07,0,11.07,11.07,-1,-45357,74911,120268,29554,0,-11985,950,0,0,,12935,-11035
50,12-12-17,92,22:45,23:00,,13.28,0,13.28,13.28,-1,-59565,71615,131180,12050,0,-28495,0,0,0,,28495,-28495
50,12-12-17,93,23:00,23:15,77.46,13.28,0,77.46,77.46,1,-114184,18736,132920,-95448,0,-1089,10808,0,0,,11897,9719
50,12-12-17,94,23:15,23:30,38.14,,0,38.14,38.14,1,-106706,34402,141108,-72304,0,0,2701,0,0,,2701,2701
50,12-12-17,95,23:30,23:45,,,0,41.7,41.7,0,-82802,37235,120037,-45567,0,0,0,0,0,,0,0
50,12-12-17,96,23:45,0:00,,36.78,0,36.78,36.78,-1,-76233,65040,141273,-11193,0,-2380,0,0,0,,2380,-2380
50,12/13/2017,1,0:00,0:15,97.02,36.78,1,98.02,96.02,1,-148365,118149,266514,-30216,0,-201,7248,0,0,,7449,7047
50,12/13/2017,2,0:15,0:30,191.31,,1,192.31,190.31,1,-106349,43204,149553,-63145,0,0,49315,0,0,,49315,49315
50,12/13/2017,3,0:30,0:45,191.31,35.14,1,36.14,34.14,-1,-69368,37167,106535,-32201,0,-218,14148,0,0,,14366,13930
50,12/13/2017,4,0:45,1:00,,35.14,1,36.14,34.14,-1,-50568,56194,106762,5626,0,-23999,0,0,0,,23999,-23999
50,12/13/2017,5,1:00,1:15,88.21,36.14,1,89.21,35.14,2,-91404,74660,166064,-16744,0,-10501,5855,0,0,,16356,-4646
50,12/13/2017,6,1:15,1:30,38.14,36.14,1,39.14,37.14,1,-73238,53534,126772,-19704,0,-12,3493,0,0,,3505,3481
50,12/13/2017,7,1:30,1:45,38.14,45.16,1,46.16,44.16,-1,-55069,49909,104978,-5160,0,-5,88,0,0,,93,83
50,12/13/2017,8,1:45,2:00,,21.73,1,22.73,20.73,-1,-29016,64952,93968,35936,0,-18668,0,0,0,,18668,-18668
50,12/13/2017,9,2:00,2:15,48.14,36.03,1,49.14,35.03,2,-54852,38588,93440,-16264,0,-10994,888,0,0,,11882,-10106
50,12/13/2017,10,2:15,2:30,,37.48,1,38.48,36.48,-1,-50439,53371,103810,2932,0,-763,0,0,0,,763,-763
50,12/13/2017,11,2:30,2:45,,35.14,1,36.14,34.14,-1,-41643,63308,104951,21665,0,-16298,0,0,0,,16298,-16298
50,12/13/2017,12,2:45,3:00,,35.14,1,36.14,34.14,-1,-31681,70381,102062,38700,0,-27467,0,0,0,,27467,-27467
50,12/13/2017,13,3:00,3:15,51.48,36.14,1,52.48,50.48,1,-45770,34036,79806,-11734,0,-14435,1820,0,0,,16255,-12615
50,12/13/2017,14,3:15,3:30,38.14,36.14,1,39.14,37.14,1,-45257,42391,87648,-2866,0,-15,2848,0,0,,2863,2833
50,12/13/2017,15,3:30,3:45,,,1,42.48,40.48,0,-36515,48735,85250,12220,0,0,5,0,0,,5,5
50,12/13/2017,16,3:45,4:00,,33.22,1,34.22,32.22,-1,-40365,54047,94412,13682,0,-8090,0,0,0,,8090,-8090
50,12/13/2017,17,4:00,4:15,32.89,-71.54,1,38.95,-72.54,2,-58475,119531,178006,61056,0,-38191,15,0,0,,38206,-38176
50,12/13/2017,18,4:15,4:30,32.7,18.03,1,38.95,17.03,2,-47695,80539,128234,32844,0,-10391,165,0,0,,10556,-10226
50,12/13/2017,19,4:30,4:45,,17.47,1,18.47,16.47,-1,-48888,62790,111678,13902,0,-20359,0,0,0,,20359,-20359
50,12/13/2017,20,4:45,5:00,,23.46,1,24.46,22.46,-1,-47407,89099,136506,41692,0,-12462,0,0,0,,12462,-12462
50,12/13/2017,21,5:00,5:15,47.66,41.5,1,48.66,36.96,2,-86635,62214,148849,-24421,0,-6743,1306,0,0,,8049,-5437
50,12/13/2017,22,5:15,5:30,50.5,,1,51.5,49.5,1,-62663,43706,106369,-18957,0,0,3457,0,0,,3457,3457
50,12/13/2017,23,5:30,5:45,60.4,,1,61.4,59.4,1,-72617,24754,97371,-47863,0,0,30980,0,0,,30980,30980
50,12/13/2017,24,5:45,6:00,116.68,,1,117.68,115.68,1,-77741,21775,99516,-55966,0,0,47808,0,0,,47808,47808
50,12/13/2017,25,6:00,6:15,116.68,-39.92,1,-38.92,-40.92,-1,-57479,102944,160423,45465,0,-19070,10296,0,0,,29366,-8774
50,12/13/2017,26,6:15,6:30,55.54,-39.92,1,56.54,54.54,1,-79572,46423,125995,-33149,0,-870,8539,0,0,,9409,7669
50,12/13/2017,27,6:30,6:45,66.6,,1,67.6,65.6,1,-88773,51768,140541,-37005,0,0,19662,0,0,,19662,19662
50,12/13/2017,28,6:45,7:00,192.9,,1,193.9,191.9,1,-144928,61847,206775,-83081,0,0,21102,0,0,,21102,21102
50,12/13/2017,29,7:00,7:15,40.18,9.86,1,44,8.86,2,-59403,168838,228241,109435,0,-9207,9387,0,0,,18594,180
50,12/13/2017,30,7:15,7:30,54.1,9.86,1,55.1,53.1,1,-49130,80046,129176,30916,0,-626,12558,0,0,,13184,11932
50,12/13/2017,31,7:30,7:45,243.01,,1,244.01,242.01,1,-86034,68254,154288,-17780,0,0,36552,0,0,,36552,36552
50,12/13/2017,32,7:45,8:00,243.01,,1,244.01,242.01,1,-94394,64293,158687,-30101,0,0,77233,0,0,,77233,77233
50,12/13/2017,33,8:00,8:15,243.01,38.5,1,39.5,37.5,-1,-43328,173886,217214,130558,0,-1108,14443,0,0,,15551,13335
50,12/13/2017,34,8:15,8:30,212.2,,1,213.2,211.2,1,-50279,86854,137133,36575,0,0,23982,0,0,,23982,23982
50,12/13/2017,35,8:30,8:45,212.2,,1,213.2,211.2,1,-45409,133069,178478,87660,0,0,46893,1250,0,,48143,48143
50,12/13/2017,36,8:45,9:00,126.53,,1,127.53,125.53,1,-65941,155261,221202,89320,0,0,14616,0,0,,14616,14616
50,12/13/2017,37,9:00,9:15,66.55,,1,67.55,65.55,1,-78310,89217,167527,10907,0,0,30383,0,0,,30383,30383
50,12/13/2017,38,9:15,9:30,66.55,38.09,1,67.55,37.09,2,-63091,80097,143188,17006,0,-719,5113,0,0,,5832,4394
50,12/13/2017,39,9:30,9:45,103.12,,1,104.12,102.12,1,-88359,75497,163856,-12862,0,0,20347,0,0,,20347,20347
50,12/13/2017,40,9:45,10:00,266.08,,1,267.08,265.08,1,-95502,66207,161709,-29295,0,0,46887,0,0,,46887,46887
50,12/13/2017,41,10:00,10:15,124.02,31.23,1,125.02,30.23,2,-62950,122936,185886,59986,0,-4611,29968,0,0,,34579,25357
50,12/13/2017,42,10:15,10:30,48.12,31.23,1,49.12,47.12,1,-90423,78575,168998,-11848,0,-270,3781,0,0,,4051,3511
50,12/13/2017,43,10:30,10:45,49.08,,1,50.08,48.08,1,-75691,62465,138156,-13226,0,0,6728,0,0,,6728,6728
50,12/13/2017,44,10:45,11:00,109.02,,1,110.02,108.02,1,-94370,52966,147336,-41404,0,0,24200,0,0,,24200,24200
50,12/13/2017,45,11:00,11:15,50.68,38.03,1,51.68,37.03,2,-42064,64839,106903,22775,0,-2374,16460,0,0,,18834,14086
50,12/13/2017,46,11:15,11:30,71.2,38.03,1,72.2,70.2,1,-77897,50914,128811,-26983,0,-15,5836,0,0,,5851,5821
50,12/13/2017,47,11:30,11:45,132.02,,1,133.02,131.02,1,-79631,50828,130459,-28803,0,0,25032,0,0,,25032,25032
50,12/13/2017,48,11:45,12:00,71.2,,1,72.2,70.2,1,-108047,56451,164498,-51596,0,0,20263,0,0,,20263,20263
50,12/13/2017,49,12:00,12:15,199.73,,1,200.73,198.73,1,-116006,34867,150873,-81139,0,0,41491,0,0,,41491,41491
50,12/13/2017,50,12:15,12:30,84.02,,1,85.02,83.02,1,-119434,64817,184251,-54617,0,0,47687,0,0,,47687,47687
50,12/13/2017,51,12:30,12:45,132.02,,1,133.02,131.02,1,-136571,76620,213191,-59951,0,0,47780,0,0,,47780,47780
50,12/13/2017,52,12:45,13:00,220.02,,1,221.02,219.02,1,-132224,74898,207122,-57326,0,0,53259,0,0,,53259,53259
50,12/13/2017,53,13:00,13:15,50.02,,1,51.02,49.02,1,-118962,78295,197257,-40667,0,0,14882,0,0,,14882,14882
50,12/13/2017,54,13:15,13:30,276.83,,1,277.83,275.83,1,-131311,60928,192239,-70383,0,0,34852,0,0,,34852,34852
50,12/13/2017,55,13:30,13:45,69.5,,1,70.5,68.5,1,-111983,78201,190184,-33782,0,0,36911,0,0,,36911,36911
50,12/13/2017,56,13:45,14:00,69.5,,1,70.5,68.5,1,-127709,75785,203494,-51924,0,0,28513,0,0,,28513,28513
50,12/13/2017,57,14:00,14:15,259.42,,1,260.42,258.42,1,-129386,55391,184777,-73995,0,0,46879,0,0,,46879,46879
50,12/13/2017,58,14:15,14:30,56.02,,1,57.02,55.02,1,-100567,63201,163768,-37366,0,0,33595,0,0,,33595,33595
50,12/13/2017,59,14:30,14:45,71.22,,1,72.22,70.22,1,-100697,57722,158419,-42975,0,0,29069,0,0,,29069,29069
50,12/13/2017,60,14:45,15:00,53.02,45.6,1,46.6,44.6,-1,-79955,65829,145784,-14126,0,-26,25814,0,0,,25840,25788
50,12/13/2017,61,15:00,15:15,46.73,39.08,1,47.73,38.08,2,-71643,71983,143626,340,0,-1691,2537,0,0,,4228,846
50,12/13/2017,62,15:15,15:30,56.1,,1,57.1,55.1,1,-99652,74772,174424,-24880,0,0,13157,0,0,,13157,13157
50,12/13/2017,63,15:30,15:45,44.88,,1,45.88,43.88,1,-99736,79880,179616,-19856,0,0,8256,0,0,,8256,8256
50,12/13/2017,64,15:45,16:00,44.88,,1,45.88,43.88,1,-90404,82014,172418,-8390,0,0,4398,0,0,,4398,4398
50,12/13/2017,65,16:00,16:15,44.88,39.08,1,40.08,38.08,-1,-58949,150470,209419,91521,0,-2638,279,0,0,,2917,-2359
50,12/13/2017,66,16:15,16:30,,,1,44.12,42.12,0,-54554,110084,164638,55530,0,-678,0,0,0,,678,-678
50,12/13/2017,67,16:30,16:45,,43.89,1,44.89,42.89,-1,-59069,80955,140024,21886,0,-756,0,0,0,,756,-756
50,12/13/2017,68,16:45,17:00,69.02,,1,70.02,68.02,1,-78888,62231,141119,-16657,0,0,3727,0,0,,3727,3727
50,12/13/2017,69,17:00,17:15,126.78,,1,127.78,125.78,1,-67792,40069,107861,-27723,0,0,8731,0,0,,8731,8731
50,12/13/2017,70,17:15,17:30,40.18,,1,41.18,39.18,1,-63164,57173,120337,-5991,0,0,95,0,0,,95,95
50,12/13/2017,71,17:30,17:45,,39.41,1,40.41,38.41,-1,-59121,62983,122104,3862,0,-1165,0,0,0,,1165,-1165
50,12/13/2017,72,17:45,18:00,,34.04,1,35.04,33.04,-1,-41693,65405,107098,23712,0,-6101,0,0,0,,6101,-6101
50,12/13/2017,73,18:00,18:15,,19.71,1,20.71,18.71,-1,-63642,108308,171950,44666,0,-30052,0,0,0,,30052,-30052
50,12/13/2017,74,18:15,18:30,,19.04,1,20.04,18.04,-1,-47746,95104,142850,47358,0,-15409,0,0,0,,15409,-15409
50,12/13/2017,75,18:30,18:45,,9.04,1,10.04,8.04,-1,-47555,94395,141950,46840,0,-32059,0,0,0,,32059,-32059
50,12/13/2017,76,18:45,19:00,,38.03,1,39.03,37.03,-1,-40817,72655,113472,31838,0,-19714,0,0,0,,19714,-19714
50,12/13/2017,77,19:00,19:15,124.88,38.03,1,125.88,123.88,1,-92153,60874,153027,-31279,0,-4168,12322,0,0,,16490,8154
50,12/13/2017,78,19:15,19:30,47.1,-4.12,1,-3.12,-5.12,-1,-38373,78826,117199,40453,0,-9877,8438,0,0,,18315,-1439
50,12/13/2017,79,19:30,19:45,,-5.37,1,-4.37,-6.37,-1,-55262,73893,129155,18631,0,-23786,0,0,0,,23786,-23786
50,12/13/2017,80,19:45,20:00,46.81,43.22,1,47.81,42.14,2,-103049,61542,164591,-41507,0,-3043,1987,0,0,,5030,-1056
50,12/13/2017,81,20:00,20:15,202.16,,1,203.16,201.16,1,-129138,25017,154155,-104121,0,0,20040,0,0,,20040,20040
50,12/13/2017,82,20:15,20:30,156.1,15.55,1,157.1,14.55,2,-87881,74301,162182,-13580,0,-910,45425,0,0,,46335,44515
50,12/13/2017,83,20:30,20:45,73.7,-54.33,1,74.7,-55.33,2,-85663,55619,141282,-30044,0,-14897,4222,0,0,,19119,-10675
50,12/13/2017,84,20:45,21:00,40.18,14.8,1,15.8,13.8,-1,-57960,85644,143604,27684,0,-5144,1200,0,0,,6344,-3944
50,12/13/2017,85,21:00,21:15,40.18,-13.25,1,43.86,-14.25,2,-77906,47324,125230,-30582,0,-11749,178,0,0,,11927,-11571
50,12/13/2017,86,21:15,21:30,40.18,,1,41.18,39.18,1,-138940,52203,191143,-86737,0,0,890,0,0,,890,890
50,12/13/2017,87,21:30,21:45,44.88,,1,45.88,43.88,1,-115813,67439,183252,-48374,0,0,1874,0,0,,1874,1874
50,12/13/2017,88,21:45,22:00,40.18,37.03,1,38.03,36.03,-1,-81942,89903,171845,7961,0,-2108,772,0,0,,2880,-1336
50,12/13/2017,89,22:00,22:15,57.95,16.03,1,58.95,15.03,2,-79143,74044,153187,-5099,0,-9828,2683,0,0,,12511,-7145
50,12/13/2017,90,22:15,22:30,70.45,28.9,1,71.45,27.9,2,-84367,81040,165407,-3327,0,-716,18279,0,0,,18995,17563
50,12/13/2017,91,22:30,22:45,70.45,-3.03,1,-2.03,-4.03,-1,-41784,68634,110418,26850,0,-25942,114,0,0,,26056,-25828
50,12/13/2017,92,22:45,23:00,,29.08,1,30.08,28.08,-1,-61243,87213,148456,25970,0,-11783,0,0,0,,11783,-11783
50,12/13/2017,93,23:00,23:15,,13.03,1,14.03,12.03,-1,-70957,108812,179769,37855,0,-15687,0,0,0,,15687,-15687
50,12/13/2017,94,23:15,23:30,,-9.99,1,-8.99,-10.99,-1,-52918,111891,164809,58973,0,-7805,0,0,0,,7805,-7805
50,12/13/2017,95,23:30,23:45,46.4,-20.2,1,47.4,-21.2,2,-43417,53868,97285,10451,0,-33244,74,0,0,,33318,-33170
50,12/13/2017,96,23:45,0:00,46.4,-8.15,1,47.4,-9.15,2,-24110,101395,125505,77285,0,-16729,34,0,0,,16763,-16695
50,12/14/2017,1,0:00,0:15,126.97,32.78,1,127.97,31.78,2,-117293,40199,157492,-77094,0,-12679,16450,0,0,,29129,3771
50,12/14/2017,2,0:15,0:30,58.86,,1,59.86,57.86,1,-75454,24194,99648,-51260,0,0,30067,0,0,,30067,30067
50,12/14/2017,3,0:30,0:45,60.2,,1,61.2,59.2,1,-92063,28769,120832,-63294,0,0,50209,0,0,,50209,50209
50,12/14/2017,4,0:45,1:00,49.04,,1,50.04,48.04,1,-84424,52729,137153,-31695,0,0,35195,0,0,,35195,35195
50,12/14/2017,5,1:00,1:15,65.18,,1,66.18,64.18,1,-78452,35166,113618,-43286,0,0,21757,0,0,,21757,21757
50,12/14/2017,6,1:15,1:30,47.85,,1,48.85,46.85,1,-87403,49474,136877,-37929,0,0,34926,0,0,,34926,34926
50,12/14/2017,7,1:30,1:45,43.69,33.08,1,34.08,32.08,-1,-65497,58282,123779,-7215,0,-982,14824,0,0,,15806,13842
50,12/14/2017,8,1:45,2:00,48.03,33.08,1,49.03,47.03,1,-84526,54522,139048,-30004,0,-88,5960,0,0,,6048,5872
50,12/14/2017,9,2:00,2:15,126.9,,1,127.9,125.9,1,-154601,53059,207660,-101542,0,0,65162,0,0,,65162,65162
50,12/14/2017,10,2:15,2:30,98.25,,1,99.25,97.25,1,-142707,56307,199014,-86400,0,0,89744,0,0,,89744,89744
50,12/14/2017,11,2:30,2:45,77.12,,1,78.12,76.12,1,-126483,58740,185223,-67743,0,0,68744,0,0,,68744,68744
50,12/14/2017,12,2:45,3:00,70.06,,1,71.06,69.06,1,-137986,71775,209761,-66211,0,0,61562,0,0,,61562,61562
50,12/14/2017,13,3:00,3:15,159.71,,1,160.71,158.71,1,-208231,46259,254490,-161972,0,0,92336,0,0,,92336,92336
50,12/14/2017,14,3:15,3:30,146.7,,1,147.7,145.7,1,-192301,56997,249298,-135304,0,0,108662,0,0,,108662,108662
50,12/14/2017,15,3:30,3:45,67.54,,1,68.54,66.54,1,-167879,69685,237564,-98194,0,0,61440,0,0,,61440,61440
50,12/14/2017,16,3:45,4:00,66.99,,1,67.99,65.99,1,-140273,62104,202377,-78169,0,0,46557,0,0,,46557,46557
50,12/14/2017,17,4:00,4:15,47.85,,1,48.85,46.85,1,-107246,37855,145101,-69391,0,0,28417,0,0,,28417,28417
50,12/14/2017,18,4:15,4:30,43.85,34.08,1,35.08,33.08,-1,-76890,42601,119491,-34289,0,-5,11535,0,0,,11540,11530
50,12/14/2017,19,4:30,4:45,43.85,34.08,1,35.08,33.08,-1,-57679,50347,108026,-7332,0,-51,18,0,0,,69,-33
50,12/14/2017,20,4:45,5:00,47.85,,1,48.85,46.85,1,-84855,57193,142048,-27662,0,0,5416,0,0,,5416,5416
50,12/14/2017,21,5:00,5:15,177.72,,1,178.72,176.72,1,-162037,38386,200423,-123651,0,0,40506,0,0,,40506,40506
50,12/14/2017,22,5:15,5:30,80.12,,1,81.12,79.12,1,-109034,64769,173803,-44265,0,0,35379,0,0,,35379,35379
50,12/14/2017,23,5:30,5:45,177.72,,1,178.72,176.72,1,-136220,46414,182634,-89806,0,0,45737,0,0,,45737,45737
50,12/14/2017,24,5:45,6:00,80.12,,1,81.12,79.12,1,-83376,56434,139810,-26942,0,0,38948,0,0,,38948,38948
50,12/14/2017,25,6:00,6:15,80.12,,1,81.12,79.12,1,-190369,79707,270076,-110662,0,0,29492,0,0,,29492,29492
50,12/14/2017,26,6:15,6:30,124.05,,1,125.05,123.05,1,-177658,64630,242288,-113028,0,0,41249,0,0,,41249,41249
50,12/14/2017,27,6:30,6:45,175.11,,1,176.11,174.11,1,-174207,46719,220926,-127488,0,0,77561,0,0,,77561,77561
50,12/14/2017,28,6:45,7:00,175.11,,1,176.11,174.11,1,-162730,70182,232912,-92548,0,0,64991,0,0,,64991,64991
50,12/14/2017,29,7:00,7:15,175.11,-43.2,1,-42.2,-44.2,-1,-92621,150706,243327,58085,0,-22294,6251,0,0,,28545,-16043
50,12/14/2017,30,7:15,7:30,45.57,23.35,1,46.57,44.57,1,-109696,103930,213626,-5766,0,-19956,432,0,0,,20388,-19524
50,12/14/2017,31,7:30,7:45,139.34,23.35,1,140.34,138.34,1,-124669,46583,171252,-78086,0,-180,40956,0,0,,41136,40776
50,12/14/2017,32,7:45,8:00,139.34,,1,140.34,138.34,1,-186730,44923,231653,-141807,0,0,94616,0,0,,94616,94616
50,12/14/2017,33,8:00,8:15,144.63,,1,145.63,143.63,1,-89845,77019,166864,-12826,0,0,46209,0,0,,46209,46209
50,12/14/2017,34,8:15,8:30,,39.3,1,40.3,38.3,-1,-99435,90557,189992,-8878,0,-10,0,0,0,,10,-10
50,12/14/2017,35,8:30,8:45,41.61,,1,42.61,40.61,1,-84971,62524,147495,-22447,0,0,910,0,0,,910,910
50,12/14/2017,36,8:45,9:00,53.12,,1,54.12,52.12,1,-110039,50708,160747,-59331,0,0,4863,0,0,,4863,4863
50,12/14/2017,37,9:00,9:15,43.32,34.99,1,44.32,33.99,2,-87204,113902,201106,26698,0,-4252,5717,0,0,,9969,1465
50,12/14/2017,38,9:15,9:30,39.5,36.55,1,41.54,35.55,2,-98412,94668,193080,-3744,0,-3860,163,0,0,,4023,-3697
50,12/14/2017,39,9:30,9:45,80.12,,1,81.12,79.12,1,-129441,92864,222305,-36577,0,0,10543,0,0,,10543,10543
50,12/14/2017,40,9:45,10:00,47.55,,1,48.55,46.55,1,-140339,101648,241987,-38691,0,0,27686,0,0,,27686,27686
50,12/14/2017,41,10:00,10:15,82.28,,1,83.28,81.28,1,-111067,51364,162431,-59703,0,0,36401,0,0,,36401,36401
50,12/14/2017,42,10:15,10:30,80.12,,1,81.12,79.12,1,-102511,50248,152759,-52263,0,0,39550,0,0,,39550,39550
50,12/14/2017,43,10:30,10:45,50.27,42.3,1,43.3,41.3,-1,-81766,61346,143112,-20420,0,-1,25567,0,0,,25568,25566
50,12/14/2017,44,10:45,11:00,80.12,42.3,1,81.12,39.9,2,-98043,57111,155154,-40932,0,-36,8966,0,0,,9002,8930
50,12/14/2017,45,11:00,11:15,45.46,,1,46.46,44.46,1,-82771,78855,161626,-3916,0,0,6924,0,0,,6924,6924
50,12/14/2017,46,11:15,11:30,42.26,,1,43.26,41.26,1,-91042,79209,170251,-11833,0,0,906,0,0,,906,906
50,12/14/2017,47,11:30,11:45,41.26,38.86,1,42.26,37.86,2,-82003,73105,155108,-8898,0,-185,948,0,0,,1133,763
50,12/14/2017,48,11:45,12:00,54.58,,1,55.58,53.58,1,-86864,54255,141119,-32609,0,0,8676,0,0,,8676,8676
50,12/14/2017,49,12:00,12:15,45.57,,1,46.57,44.57,1,-82091,62591,144682,-19500,0,0,1475,0,0,,1475,1475
50,12/14/2017,50,12:15,12:30,54.71,,1,55.71,53.71,1,-77391,59528,136919,-17863,0,0,12807,0,0,,12807,12807
50,12/14/2017,51,12:30,12:45,54.71,36.55,1,37.55,35.55,-1,-53863,44547,98410,-9316,0,-708,579,0,0,,1287,-129
50,12/14/2017,52,12:45,13:00,39.5,36.55,1,40.96,35.55,2,-49359,51368,100727,2009,0,-544,53,0,0,,597,-491
50,12/14/2017,53,13:00,13:15,42.06,,1,43.06,41.06,1,-75846,68085,143931,-7761,0,0,1893,0,0,,1893,1893
50,12/14/2017,54,13:15,13:30,74.12,,1,75.12,73.12,1,-82348,57335,139683,-25013,0,0,10653,0,0,,10653,10653
50,12/14/2017,55,13:30,13:45,51.57,,1,52.57,50.57,1,-73952,48745,122697,-25207,0,0,27882,0,0,,27882,27882
50,12/14/2017,56,13:45,14:00,51.57,36.46,1,37.46,35.46,-1,-62140,59746,121886,-2394,0,-4174,7441,0,0,,11615,3267
50,12/14/2017,57,14:00,14:15,,29.86,1,30.86,28.86,-1,-22444,84049,106493,61605,0,-12952,0,0,0,,12952,-12952
50,12/14/2017,58,14:15,14:30,,-49.38,1,-48.38,-50.38,-1,-35975,76190,112165,40215,0,-37070,0,0,0,,37070,-37070
50,12/14/2017,59,14:30,14:45,,32.99,1,33.99,31.99,-1,-39997,80849,120846,40852,0,-6977,0,0,0,,6977,-6977
50,12/14/2017,60,14:45,15:00,54.72,36.55,1,55.72,35.55,2,-63104,54030,117134,-9074,0,-614,1640,0,0,,2254,1026
50,12/14/2017,61,15:00,15:15,179.34,,1,180.34,178.34,1,-94969,28314,123283,-66655,0,0,35745,0,0,,35745,35745
50,12/14/2017,62,15:15,15:30,56.57,,1,57.57,55.57,1,-65514,29976,95490,-35538,0,0,17839,0,0,,17839,17839
50,12/14/2017,63,15:30,15:45,179.34,,1,180.34,178.34,1,-98161,19577,117738,-78584,0,0,46441,0,0,,46441,46441
50,12/14/2017,64,15:45,16:00,253.15,,1,254.15,252.15,1,-92819,24945,117764,-67874,0,0,66819,0,0,,66819,66819
50,12/14/2017,65,16:00,16:15,253.15,-30.74,1,-29.74,-31.74,-1,-21613,174480,196093,152867,0,-38649,12214,0,0,,50863,-26435
50,12/14/2017,66,16:15,16:30,,6.35,1,7.35,5.35,-1,-34269,99984,134253,65715,0,-59983,0,0,0,,59983,-59983
50,12/14/2017,67,16:30,16:45,,34.99,1,35.99,33.99,-1,-42349,84818,127167,42469,0,-37994,0,0,0,,37994,-37994
50,12/14/2017,68,16:45,17:00,253.15,37.78,1,254.15,252.15,1,-70086,50220,120306,-19866,0,-11961,8166,0,0,,20127,-3795
50,12/14/2017,69,17:00,17:15,337.29,37.58,1,338.29,36.58,2,-46777,56628,103405,9851,0,-609,19964,0,0,,20573,19355
50,12/14/2017,70,17:15,17:30,,,1,42.18,40.18,0,-29615,51540,81155,21925,0,0,0,0,0,,0,0
50,12/14/2017,71,17:30,17:45,,37.86,1,38.86,36.86,-1,-36013,53968,89981,17955,0,-512,0,0,0,,512,-512
50,12/14/2017,72,17:45,18:00,40.1,,1,41.1,39.1,1,-49904,57567,107471,7663,0,0,394,0,0,,394,394
50,12/14/2017,73,18:00,18:15,39.5,35.55,1,41.88,34.55,2,-58329,70717,129046,12388,0,-4854,153,0,0,,5007,-4701
50,12/14/2017,74,18:15,18:30,,32.46,1,33.46,31.46,-1,-49307,75386,124693,26079,0,-19650,0,0,0,,19650,-19650
50,12/14/2017,75,18:30,18:45,,34.99,1,35.99,33.99,-1,-49322,72544,121866,23222,0,-24349,0,0,0,,24349,-24349
50,12/14/2017,76,18:45,19:00,,25.1,1,26.1,24.1,-1,-31342,75950,107292,44608,0,-17155,0,0,0,,17155,-17155
50,12/14/2017,77,19:00,19:15,80.12,18.51,1,81.12,17.51,2,-60629,32279,92908,-28350,0,-15352,4794,0,0,,20146,-10558
50,12/14/2017,78,19:15,19:30,39.5,36.55,1,41.88,35.55,2,-43989,50368,94357,6379,0,-579,1889,0,0,,2468,1310
50,12/14/2017,79,19:30,19:45,,32.92,1,33.92,31.92,-1,-43395,48156,91551,4761,0,-13352,0,0,0,,13352,-13352
50,12/14/2017,80,19:45,20:00,39.5,37.78,1,41.88,36.78,2,-45427,53991,99418,8564,0,-1901,11,0,0,,1912,-1890
50,12/14/2017,81,20:00,20:15,181.35,37.78,1,182.35,180.35,1,-90074,15808,105882,-74266,0,-22,24771,0,0,,24793,24749
50,12/14/2017,82,20:15,20:30,79.12,36.72,1,80.12,35.72,2,-44460,27662,72122,-16798,0,-224,39335,0,0,,39559,39111
50,12/14/2017,83,20:30,20:45,79.12,29.36,1,30.36,28.36,-1,-36654,51942,88596,15288,0,-11163,2626,0,0,,13789,-8537
50,12/14/2017,84,20:45,21:00,,33.17,1,34.17,32.17,-1,-42931,73683,116614,30752,0,-22623,0,0,0,,22623,-22623
50,12/14/2017,85,21:00,21:15,201.02,36.78,1,202.02,35.78,2,-112490,70127,182617,-42363,0,-9317,14048,0,0,,23365,4731
50,12/14/2017,86,21:15,21:30,42.41,26.8,1,27.8,25.8,-1,-58958,79429,138387,20471,0,-3098,4951,0,0,,8049,1853
50,12/14/2017,87,21:30,21:45,,22.48,1,23.48,21.48,-1,-45908,89286,135194,43378,0,-23481,0,0,0,,23481,-23481
50,12/14/2017,88,21:45,22:00,,22.48,1,23.48,21.48,-1,-47830,93796,141626,45966,0,-41419,0,0,0,,41419,-41419
50,12/14/2017,89,22:00,22:15,45.57,31.99,1,46.57,44.57,1,-102593,64574,167167,-38019,0,-21456,724,0,0,,22180,-20732
50,12/14/2017,90,22:15,22:30,,,1,40.97,38.97,0,-72639,44902,117541,-27737,0,0,118,0,0,,118,118
50,12/14/2017,91,22:30,22:45,,35.55,1,36.55,34.55,-1,-50263,68929,119192,18666,0,-6685,0,0,0,,6685,-6685
50,12/14/2017,92,22:45,23:00,,36.78,1,37.78,35.78,-1,-55013,92580,147593,37567,0,-13665,0,0,0,,13665,-13665
50,12/14/2017,93,23:00,23:15,173.46,36.55,1,174.46,35.55,2,-82329,12451,94780,-69878,0,-5809,19772,0,0,,25581,13963
50,12/14/2017,94,23:15,23:30,55.89,35.55,1,36.55,34.55,-1,-37722,45522,83244,7800,0,-522,23844,0,0,,24366,23322
50,12/14/2017,95,23:30,23:45,55.89,35.55,1,36.55,34.55,-1,-49051,58357,107408,9306,0,-1371,57,0,0,,1428,-1314
50,12/14/2017,96,23:45,0:00,,7.3,1,8.3,6.3,-1,-40591,89030,129621,48439,0,-18272,0,0,0,,18272,-18272
50,12/15/2017,1,0:00,0:15,66.43,-57.36,1,67.43,-58.36,2,-96590,96873,193463,283,0,-22682,1740,0,0,,24422,-20942
50,12/15/2017,2,0:15,0:30,69.02,36.65,1,70.02,34.19,2,-66786,84996,151782,18210,0,-25,6678,0,0,,6703,6653
50,12/15/2017,3,0:30,0:45,,36.65,1,37.65,35.65,-1,-68296,64498,132794,-3798,0,-252,0,0,0,,252,-252
50,12/15/2017,4,0:45,1:00,,,1,36.21,34.21,0,-110577,72430,183007,-38147,0,0,0,0,0,,0,0
50,12/15/2017,5,1:00,1:15,,37.43,1,38.43,36.43,-1,-55583,57891,113474,2308,0,-486,0,0,0,,486,-486
50,12/15/2017,6,1:15,1:30,39.75,,1,40.75,38.75,1,-40773,54122,94895,13349,0,0,696,0,0,,696,696
50,12/15/2017,7,1:30,1:45,38.83,,1,39.83,37.83,1,-37280,41460,78740,4180,0,0,671,0,0,,671,671
50,12/15/2017,8,1:45,2:00,38.83,36.65,1,37.65,35.65,-1,-30693,51165,81858,20472,0,-48,824,0,0,,872,776
50,12/15/2017,9,2:00,2:15,49.37,34.4,1,50.37,33.4,2,-39446,99731,139177,60285,0,-432,987,0,0,,1419,555
50,12/15/2017,10,2:15,2:30,48.62,,1,49.62,47.62,1,-51749,85368,137117,33619,0,0,3411,0,0,,3411,3411
50,12/15/2017,11,2:30,2:45,,,1,35.78,33.78,0,-38728,73058,111786,34330,0,0,0,0,0,,0,0
50,12/15/2017,12,2:45,3:00,,34.4,1,35.4,33.4,-1,-44837,90759,135596,45922,0,-1722,0,0,0,,1722,-1722
50,12/15/2017,13,3:00,3:15,,31.65,1,32.65,30.65,-1,-47100,116110,163210,69010,0,-3183,0,0,0,,3183,-3183
50,12/15/2017,14,3:15,3:30,,,1,35.84,33.84,0,-61006,110558,171564,49552,0,-6,0,0,0,,6,-6
50,12/15/2017,15,3:30,3:45,,,1,35.31,33.31,0,-54307,102041,156348,47734,0,0,0,0,0,,0,0
50,12/15/2017,16,3:45,4:00,,35.65,1,36.65,34.65,-1,-56820,96483,153303,39663,0,-1126,0,0,0,,1126,-1126
50,12/15/2017,17,4:00,4:15,,36.65,1,37.65,35.65,-1,-29907,94854,124761,64947,0,-680,0,0,0,,680,-680
50,12/15/2017,18,4:15,4:30,,,1,35.08,33.08,0,-30095,81312,111407,51217,0,0,0,0,0,,0,0
50,12/15/2017,19,4:30,4:45,,35.45,1,36.45,34.45,-1,-26696,71107,97803,44411,0,-839,0,0,0,,839,-839
50,12/15/2017,20,4:45,5:00,,,1,35.08,33.08,0,-26834,83094,109928,56260,0,0,0,0,0,,0,0
50,12/15/2017,21,5:00,5:15,,34.03,1,35.03,33.03,-1,-48159,109213,157372,61054,0,-591,0,0,0,,591,-591
50,12/15/2017,22,5:15,5:30,,31.15,1,32.15,30.15,-1,-50408,115730,166138,65322,0,-4077,0,0,0,,4077,-4077
50,12/15/2017,23,5:30,5:45,,,1,35.13,33.13,0,-69737,90202,159939,20465,0,0,0,0,0,,0,0
50,12/15/2017,24,5:45,6:00,41.52,,1,42.52,40.52,1,-77466,94781,172247,17315,0,0,1089,0,0,,1089,1089
50,12/15/2017,25,6:00,6:15,,-47.72,1,-46.72,-48.72,-1,-25722,120067,145789,94345,0,-36645,0,0,0,,36645,-36645
50,12/15/2017,26,6:15,6:30,,17.03,1,18.03,16.03,-1,-65630,125215,190845,59585,0,-54787,0,0,0,,54787,-54787
50,12/15/2017,27,6:30,6:45,,25.99,1,26.99,24.99,-1,-68097,118633,186730,50536,0,-39992,0,0,0,,39992,-39992
50,12/15/2017,28,6:45,7:00,39.45,36.01,1,40.45,38.45,1,-74203,86425,160628,12222,0,-13648,103,0,0,,13751,-13545
50,12/15/2017,29,7:00,7:15,,-36.24,1,-35.24,-37.24,-1,-25278,146622,171900,121344,0,-45217,0,0,0,,45217,-45217
50,12/15/2017,30,7:15,7:30,,7.03,1,8.03,6.03,-1,-61187,97277,158464,36090,0,-55736,0,0,0,,55736,-55736
50,12/15/2017,31,7:30,7:45,38.81,36.03,1,40.44,35.03,2,-86781,81820,168601,-4961,0,-4791,184,0,0,,4975,-4607
50,12/15/2017,32,7:45,8:00,78.02,,1,79.02,77.02,1,-126112,84618,210730,-41494,0,0,13517,0,0,,13517,13517
50,12/15/2017,33,8:00,8:15,78.02,24.79,1,25.79,23.79,-1,-49680,79853,129533,30173,0,-4193,3957,0,0,,8150,-236
50,12/15/2017,34,8:15,8:30,,34.86,1,35.86,33.86,-1,-34824,67471,102295,32647,0,-7503,0,0,0,,7503,-7503
50,12/15/2017,35,8:30,8:45,,35.86,1,36.86,34.86,-1,-48880,74418,123298,25538,0,-10155,0,0,0,,10155,-10155
50,12/15/2017,36,8:45,9:00,,39.61,1,40.61,38.61,-1,-70416,72911,143327,2495,0,-737,0,0,0,,737,-737
50,12/15/2017,37,9:00,9:15,,37.34,1,38.34,36.34,-1,-35797,76732,112529,40935,0,-743,0,0,0,,743,-743
50,12/15/2017,38,9:15,9:30,43.36,,1,44.36,42.36,1,-70470,63566,134036,-6904,0,0,2198,0,0,,2198,2198
50,12/15/2017,39,9:30,9:45,44.84,,1,45.84,43.84,1,-71637,48897,120534,-22740,0,0,10957,0,0,,10957,10957
50,12/15/2017,40,9:45,10:00,77.7,,1,78.7,76.7,1,-93843,35805,129648,-58038,0,0,21497,0,0,,21497,21497
50,12/15/2017,41,10:00,10:15,43.3,,1,44.3,42.3,1,-77227,36978,114205,-40249,0,0,15462,0,0,,15462,15462
50,12/15/2017,42,10:15,10:30,44.84,,1,45.84,43.84,1,-83495,36543,120038,-46952,0,0,7556,0,0,,7556,7556
50,12/15/2017,43,10:30,10:45,,,1,40.85,38.85,0,-103211,26909,130120,-76302,0,0,522,0,0,,522,522
50,12/15/2017,44,10:45,11:00,,,1,40.85,38.85,0,-105735,27999,133734,-77736,0,0,0,0,0,,0,0
50,12/15/2017,45,11:00,11:15,,,1,40.54,38.54,0,-91535,41130,132665,-50405,0,0,0,0,0,,0,0
50,12/15/2017,46,11:15,11:30,38.81,,1,39.81,37.81,1,-104687,39905,144592,-64782,0,0,378,0,0,,378,378
50,12/15/2017,47,11:30,11:45,180.77,,1,181.77,179.77,1,-107252,33313,140565,-73939,0,0,20736,0,0,,20736,20736
50,12/15/2017,48,11:45,12:00,43.42,,1,44.42,42.42,1,-87517,58196,145713,-29321,0,0,14650,0,0,,14650,14650
50,12/15/2017,49,12:00,12:15,37.88,,1,38.88,36.88,1,-85848,28161,114009,-57687,0,0,959,0,0,,959,959
50,12/15/2017,50,12:15,12:30,37.89,,1,38.89,36.89,1,-101660,22582,124242,-79078,0,0,187,0,0,,187,187
50,12/15/2017,51,12:30,12:45,38.42,,1,39.42,37.42,1,-79884,23246,103130,-56638,0,0,388,0,0,,388,388
50,12/15/2017,52,12:45,13:00,38.16,,1,39.16,37.16,1,-86918,24310,111228,-62608,0,0,851,0,0,,851,851
50,12/15/2017,53,13:00,13:15,284.48,,1,285.48,283.48,1,-92902,24816,117718,-68086,0,0,19938,0,0,,19938,19938
50,12/15/2017,54,13:15,13:30,85.13,,1,86.13,84.13,1,-80039,37567,117606,-42472,0,0,32360,0,0,,32360,32360
50,12/15/2017,55,13:30,13:45,90.02,,1,91.02,89.02,1,-99855,30937,130792,-68918,0,0,15059,0,0,,15059,15059
50,12/15/2017,56,13:45,14:00,96.02,,1,97.02,95.02,1,-103001,39437,142438,-63564,0,0,34522,0,0,,34522,34522
50,12/15/2017,57,14:00,14:15,273.77,,1,274.77,272.77,1,-100863,30362,131225,-70501,0,0,54133,0,0,,54133,54133
50,12/15/2017,58,14:15,14:30,132.02,,1,133.02,131.02,1,-74560,46049,120609,-28511,0,0,49353,0,0,,49353,49353
50,12/15/2017,59,14:30,14:45,44.84,,1,45.84,43.84,1,-67460,43507,110967,-23953,0,0,23496,0,0,,23496,23496
50,12/15/2017,60,14:45,15:00,42.19,,1,43.19,41.19,1,-69967,38532,108499,-31435,0,0,11727,0,0,,11727,11727
50,12/15/2017,61,15:00,15:15,47.51,,1,48.51,46.51,1,-84673,42493,127166,-42180,0,0,2016,0,0,,2016,2016
50,12/15/2017,62,15:15,15:30,74.02,,1,75.02,73.02,1,-91036,42411,133447,-48625,0,0,21966,0,0,,21966,21966
50,12/15/2017,63,15:30,15:45,66.45,,1,67.45,65.45,1,-98901,43971,142872,-54930,0,0,8138,0,0,,8138,8138
50,12/15/2017,64,15:45,16:00,188.24,,1,189.24,187.24,1,-102164,34988,137152,-67176,0,0,23162,0,0,,23162,23162
50,12/15/2017,65,16:00,16:15,38.46,8.62,1,40.76,7.62,2,-46450,85562,132012,39112,0,-13429,6863,0,0,,20292,-6566
50,12/15/2017,66,16:15,16:30,44.84,37.29,1,45.84,36.29,2,-57915,58968,116883,1053,0,-603,917,0,0,,1520,314
50,12/15/2017,67,16:30,16:45,47.14,36.78,1,48.14,35.78,2,-85069,70007,155076,-15062,0,-962,1307,0,0,,2269,345
50,12/15/2017,68,16:45,17:00,286.99,,1,287.99,285.99,1,-101737,65942,167679,-35795,0,0,27367,0,0,,27367,27367
50,12/15/2017,69,17:00,17:15,286.99,18.81,1,19.81,17.81,-1,-78584,100369,178953,21785,0,-8495,3866,0,0,,12361,-4629
50,12/15/2017,70,17:15,17:30,,,1,41.06,39.06,0,-68931,76374,145305,7443,0,-1052,0,0,0,,1052,-1052
50,12/15/2017,71,17:30,17:45,,34.86,1,35.86,33.86,-1,-54554,83140,137694,28586,0,-3539,0,0,0,,3539,-3539
50,12/15/2017,72,17:45,18:00,,27.6,1,28.6,26.6,-1,-39461,86602,126063,47141,0,-15657,0,0,0,,15657,-15657
50,12/15/2017,73,18:00,18:15,132.02,3.85,1,133.02,2.85,2,-123207,29769,152976,-93438,0,-32741,952,0,0,,33693,-31789
50,12/15/2017,74,18:15,18:30,191.61,34.86,1,192.61,33.86,2,-75388,69332,144720,-6056,0,-2356,12989,0,0,,15345,10633
50,12/15/2017,75,18:30,18:45,191.61,30.68,1,31.68,29.68,-1,-61408,79639,141047,18231,0,-14904,19,0,0,,14923,-14885
50,12/15/2017,76,18:45,19:00,,33.91,1,34.91,32.91,-1,-45327,72564,117891,27237,0,-20202,0,0,0,,20202,-20202
50,12/15/2017,77,19:00,19:15,172.1,33.91,1,173.1,171.1,1,-158272,60507,218779,-97765,0,-7986,20602,0,0,,28588,12616
50,12/15/2017,78,19:15,19:30,172.1,,1,173.1,171.1,1,-132490,70321,202811,-62169,0,0,66938,0,0,,66938,66938
50,12/15/2017,79,19:30,19:45,38.81,,1,39.81,37.81,1,-121716,101276,222992,-20440,0,0,14550,0,0,,14550,14550
50,12/15/2017,80,19:45,20:00,61.02,39.17,1,62.02,37.82,2,-118442,95153,213595,-23289,0,-208,2141,0,0,,2349,1933
50,12/15/2017,81,20:00,20:15,193.78,,1,194.78,192.78,1,-191070,99066,290136,-92004,0,0,52981,0,0,,52981,52981
50,12/15/2017,82,20:15,20:30,65.02,,1,66.02,64.02,1,-156854,107021,263875,-49833,0,0,40516,0,0,,40516,40516
50,12/15/2017,83,20:30,20:45,66.23,,1,67.23,65.23,1,-152854,91732,244586,-61122,0,0,8806,0,0,,8806,8806
50,12/15/2017,84,20:45,21:00,41.58,,1,42.58,40.58,1,-138386,119662,258048,-18724,0,0,8027,0,0,,8027,8027
50,12/15/2017,85,21:00,21:15,194.87,,1,195.87,193.87,1,-169730,64640,234370,-105090,0,0,27540,0,0,,27540,27540
50,12/15/2017,86,21:15,21:30,161,,1,162,160,1,-129750,56004,185754,-73746,0,0,75529,0,0,,75529,75529
50,12/15/2017,87,21:30,21:45,40.6,25.99,1,26.99,24.99,-1,-91288,94096,185384,2808,0,-2337,18590,0,0,,20927,16253
50,12/15/2017,88,21:45,22:00,,25.99,1,26.99,24.99,-1,-81147,100038,181185,18891,0,-20982,0,0,0,,20982,-20982
50,12/15/2017,89,22:00,22:15,153.29,37.34,1,154.29,152.29,1,-148994,27682,176676,-121312,0,-6461,22303,0,0,,28764,15842
50,12/15/2017,90,22:15,22:30,130.02,,1,131.02,129.02,1,-110988,26456,137444,-84532,0,0,81275,0,0,,81275,81275
50,12/15/2017,91,22:30,22:45,44.84,,1,45.84,43.84,1,-72496,47910,120406,-24586,0,0,15647,0,0,,15647,15647
50,12/15/2017,92,22:45,23:00,131.02,,1,132.02,130.02,1,-90459,46528,136987,-43931,0,0,29976,0,0,,29976,29976
50,12/15/2017,93,23:00,23:15,135.73,,1,136.73,134.73,1,-90617,31717,122334,-58900,0,0,13979,0,0,,13979,13979
50,12/15/2017,94,23:15,23:30,138.02,,1,139.02,137.02,1,-43179,19749,62928,-23430,0,0,22978,0,0,,22978,22978
50,12/15/2017,95,23:30,23:45,41.21,,1,42.21,40.21,1,-51749,30740,82489,-21009,0,0,906,0,0,,906,906
50,12/15/2017,96,23:45,0:00,44.01,39.18,1,45.01,37.32,2,-73889,48292,122181,-25597,0,-14,7009,0,0,,7023,6995
51,12/16/2017,1,0:00,0:15,116.86,35.47,1,117.86,34.47,2,-110701,109674,220375,-1027,0,-127,5020,0,0,,5147,4893
51,12/16/2017,2,0:15,0:30,164.96,,1,165.96,163.96,1,-94772,79815,174587,-14957,0,0,15095,0,0,,15095,15095
51,12/16/2017,3,0:30,0:45,164.96,,1,165.96,163.96,1,-82115,51502,133617,-30613,0,0,19972,0,0,,19972,19972
51,12/16/2017,4,0:45,1:00,40.41,30.47,1,41.41,29.47,2,-45272,76564,121836,31292,0,-5008,6698,0,0,,11706,1690
51,12/16/2017,5,1:00,1:15,156.75,35.47,1,157.75,155.75,1,-138429,86601,225030,-51828,0,-3117,15688,0,0,,18805,12571
51,12/16/2017,6,1:15,1:30,129.12,,1,130.12,128.12,1,-73728,55581,129309,-18147,0,0,41849,0,0,,41849,41849
51,12/16/2017,7,1:30,1:45,38.14,34.47,1,39.88,33.47,2,-58317,61834,120151,3517,0,-239,2294,0,0,,2533,2055
51,12/16/2017,8,1:45,2:00,41.75,,1,42.75,40.75,1,-90188,77407,167595,-12781,0,0,2165,0,0,,2165,2165
51,12/16/2017,9,2:00,2:15,76.52,,1,77.52,75.52,1,-100159,58872,159031,-41287,0,0,12417,0,0,,12417,12417
51,12/16/2017,10,2:15,2:30,44.41,,1,45.41,43.41,1,-73403,53614,127017,-19789,0,0,15041,0,0,,15041,15041
51,12/16/2017,11,2:30,2:45,44.41,32.78,1,33.78,31.78,-1,-39540,52336,91876,12796,0,-1670,694,0,0,,2364,-976
51,12/16/2017,12,2:45,3:00,,21.78,1,22.78,20.78,-1,-37221,65004,102225,27783,0,-27451,0,0,0,,27451,-27451
51,12/16/2017,13,3:00,3:15,136.25,38.71,1,137.25,135.25,1,-98781,55160,153941,-43621,0,-8197,13103,0,0,,21300,4906
51,12/16/2017,14,3:15,3:30,131.66,,1,132.66,130.66,1,-109912,55736,165648,-54176,0,0,60943,0,0,,60943,60943
51,12/16/2017,15,3:30,3:45,44.41,30.47,1,31.47,29.47,-1,-42210,48697,90907,6487,0,-1684,17975,0,0,,19659,16291
51,12/16/2017,16,3:45,4:00,44.41,30.09,1,31.09,29.09,-1,-42881,74600,117481,31719,0,-14895,234,0,0,,15129,-14661
51,12/16/2017,17,4:00,4:15,51.9,35.47,1,52.9,34.46,2,-62209,49400,111609,-12809,0,-6535,4561,0,0,,11096,-1974
51,12/16/2017,18,4:15,4:30,45.19,,1,46.19,44.19,1,-54893,38717,93610,-16176,0,0,1523,0,0,,1523,1523
51,12/16/2017,19,4:30,4:45,87.29,,1,88.29,86.29,1,-95080,39370,134450,-55710,0,0,34384,0,0,,34384,34384
51,12/16/2017,20,4:45,5:00,40.41,33.8,1,34.8,32.8,-1,-68780,46883,115663,-21897,0,-990,10312,0,0,,11302,9322
51,12/16/2017,21,5:00,5:15,,30.23,1,31.23,29.23,-1,-20221,68518,88739,48297,0,-20596,0,0,0,,20596,-20596
51,12/16/2017,22,5:15,5:30,31.54,34.47,1,32.54,30.54,1,-56972,62250,119222,5278,0,-14094,92,0,0,,14186,-14002
51,12/16/2017,23,5:30,5:45,31.57,30.99,1,35.32,29.99,2,-43256,72479,115735,29223,0,-3124,33,0,0,,3157,-3091
51,12/16/2017,24,5:45,6:00,,35.47,1,36.47,34.47,-1,-40007,54215,94222,14208,0,-647,0,0,0,,647,-647
51,12/16/2017,25,6:00,6:15,,-13.3,1,-12.3,-14.3,-1,-36823,89523,126346,52700,0,-26243,0,0,0,,26243,-26243
51,12/16/2017,26,6:15,6:30,,15.56,1,16.56,14.56,-1,-52477,103016,155493,50539,0,-36313,0,0,0,,36313,-36313
51,12/16/2017,27,6:30,6:45,,18.33,1,19.33,17.33,-1,-51044,104250,155294,53206,0,-44028,0,0,0,,44028,-44028
51,12/16/2017,28,6:45,7:00,,,1,36.96,34.96,0,-59461,73073,132534,13612,0,-11854,0,0,0,,11854,-11854
51,12/16/2017,29,7:00,7:15,,-45.55,1,-44.55,-46.55,-1,-26916,100101,127017,73185,0,-30547,0,0,0,,30547,-30547
51,12/16/2017,30,7:15,7:30,,7.84,1,8.84,6.84,-1,-53157,81613,134770,28456,0,-35944,0,0,0,,35944,-35944
51,12/16/2017,31,7:30,7:45,44.98,34.78,1,45.98,33.78,2,-39373,41415,80788,2042,0,-17074,143,0,0,,17217,-16931
51,12/16/2017,32,7:45,8:00,150.48,34.78,1,151.48,149.48,1,-84121,30804,114925,-53317,0,-2234,25640,0,0,,27874,23406
51,12/16/2017,33,8:00,8:15,150.48,-65.99,1,-64.99,-66.99,-1,-36880,191785,228665,154905,0,-38296,5832,0,0,,44128,-32464
51,12/16/2017,34,8:15,8:30,,7.14,1,8.14,6.14,-1,-41812,92373,134185,50561,0,-56509,0,0,0,,56509,-56509
51,12/16/2017,35,8:30,8:45,,34.02,1,35.02,33.02,-1,-29777,81031,110808,51254,0,-9715,0,0,0,,9715,-9715
51,12/16/2017,36,8:45,9:00,,32.98,1,33.98,31.98,-1,-35752,94788,130540,59036,0,-10262,0,0,0,,10262,-10262
51,12/16/2017,37,9:00,9:15,,30.23,1,31.23,29.23,-1,-27544,93008,120552,65464,0,-9389,0,0,0,,9389,-9389
51,12/16/2017,38,9:15,9:30,,34.99,1,35.99,33.99,-1,-35802,98522,134324,62720,0,-13178,0,0,0,,13178,-13178
51,12/16/2017,39,9:30,9:45,,37.78,1,38.78,36.78,-1,-51422,73428,124850,22006,0,-436,0,0,0,,436,-436
51,12/16/2017,40,9:45,10:00,,37.78,1,38.78,36.78,-1,-49439,54797,104236,5358,0,-685,0,0,0,,685,-685
51,12/16/2017,41,10:00,10:15,,36.74,1,37.74,35.74,-1,-31658,56623,88281,24965,0,-695,0,0,0,,695,-695
51,12/16/2017,42,10:15,10:30,,37.07,1,38.07,36.07,-1,-27645,52597,80242,24952,0,-2154,0,0,0,,2154,-2154
51,12/16/2017,43,10:30,10:45,,35.99,1,36.99,34.99,-1,-25070,82284,107354,57214,0,-6969,0,0,0,,6969,-6969
51,12/16/2017,44,10:45,11:00,,35.82,1,36.82,34.82,-1,-34458,75436,109894,40978,0,-9274,0,0,0,,9274,-9274
51,12/16/2017,45,11:00,11:15,,34.99,1,35.99,33.99,-1,-65576,81219,146795,15643,0,-5231,0,0,0,,5231,-5231
51,12/16/2017,46,11:15,11:30,,30.05,1,31.05,29.05,-1,-35789,97513,133302,61724,0,-9061,0,0,0,,9061,-9061
51,12/16/2017,47,11:30,11:45,,35.99,1,36.99,34.99,-1,-44878,107816,152694,62938,0,-10420,0,0,0,,10420,-10420
51,12/16/2017,48,11:45,12:00,,40.23,1,41.23,39.23,-1,-61516,91557,153073,30041,0,-255,0,0,0,,255,-255
51,12/16/2017,49,12:00,12:15,53.69,40.27,1,54.69,38.19,2,-106211,88519,194730,-17692,0,-44,8455,0,0,,8499,8411
51,12/16/2017,50,12:15,12:30,38.94,23.11,1,24.11,22.11,-1,-68338,91310,159648,22972,0,-3487,3671,0,0,,7158,184
51,12/16/2017,51,12:30,12:45,,13.49,1,14.49,12.49,-1,-52468,75513,127981,23045,0,-24738,0,0,0,,24738,-24738
51,12/16/2017,52,12:45,13:00,,35.99,1,36.99,34.99,-1,-56069,74456,130525,18387,0,-6223,0,0,0,,6223,-6223
51,12/16/2017,53,13:00,13:15,84.47,40.02,1,85.47,38.16,2,-105252,67069,172321,-38183,0,-2362,10853,0,0,,13215,8491
51,12/16/2017,54,13:15,13:30,44.98,,1,45.98,43.98,1,-67765,56439,124204,-11326,0,0,17220,0,0,,17220,17220
51,12/16/2017,55,13:30,13:45,41.88,,1,42.88,40.88,1,-84951,78329,163280,-6622,0,0,9703,0,0,,9703,9703
51,12/16/2017,56,13:45,14:00,41.88,34.52,1,35.52,33.52,-1,-99586,98800,198386,-786,0,-4025,178,0,0,,4203,-3847
51,12/16/2017,57,14:00,14:15,,31.01,1,32.01,30.01,-1,-86448,113146,199594,26698,0,-8732,0,0,0,,8732,-8732
51,12/16/2017,58,14:15,14:30,44.98,31.01,1,45.98,43.98,1,-108235,96445,204680,-11790,0,-140,6723,0,0,,6863,6583
51,12/16/2017,59,14:30,14:45,44.98,35.99,1,36.99,34.99,-1,-63085,104563,167648,41478,0,-2098,1058,0,0,,3156,-1040
51,12/16/2017,60,14:45,15:00,,,1,36.67,34.67,0,-80923,101376,182299,20453,0,-61,0,0,0,,61,-61
51,12/16/2017,61,15:00,15:15,46.42,,1,47.42,45.42,1,-123507,52816,176323,-70691,0,0,4044,0,0,,4044,4044
51,12/16/2017,62,15:15,15:30,53.69,,1,54.69,52.69,1,-136193,45948,182141,-90245,0,0,24132,0,0,,24132,24132
51,12/16/2017,63,15:30,15:45,39.62,,1,40.62,38.62,1,-91285,46802,138087,-44483,0,0,8822,0,0,,8822,8822
51,12/16/2017,64,15:45,16:00,38.94,,1,39.94,37.94,1,-59056,43817,102873,-15239,0,0,2315,0,0,,2315,2315
51,12/16/2017,65,16:00,16:15,38.94,-2.58,1,-1.58,-3.58,-1,-51240,107066,158306,55826,0,-21172,9,0,0,,21181,-21163
51,12/16/2017,66,16:15,16:30,,34.99,1,35.99,33.99,-1,-38191,61595,99786,23404,0,-17585,0,0,0,,17585,-17585
51,12/16/2017,67,16:30,16:45,,34.99,1,35.99,33.99,-1,-51815,81754,133569,29939,0,-8967,0,0,0,,8967,-8967
51,12/16/2017,68,16:45,17:00,38.94,40.13,1,39.94,37.94,1,-85814,69333,155147,-16481,0,-2529,207,0,0,,2736,-2322
51,12/16/2017,69,17:00,17:15,38.94,34.99,1,39.94,33.99,2,-50167,73824,123991,23657,0,-3660,47,0,0,,3707,-3613
51,12/16/2017,70,17:15,17:30,40.43,37.83,1,41.43,39.43,1,-88776,70922,159698,-17854,0,-325,69,0,0,,394,-256
51,12/16/2017,71,17:30,17:45,185.6,,1,186.6,184.6,1,-92494,27703,120197,-64791,0,0,23160,0,0,,23160,23160
51,12/16/2017,72,17:45,18:00,44.98,,1,45.98,43.98,1,-63764,31523,95287,-32241,0,0,11994,0,0,,11994,11994
51,12/16/2017,73,18:00,18:15,38.94,,1,39.94,37.94,1,-95803,25808,121611,-69995,0,0,439,0,0,,439,439
51,12/16/2017,74,18:15,18:30,,,1,39.17,37.17,0,-86065,33083,119148,-52982,0,0,0,0,0,,0,0
51,12/16/2017,75,18:30,18:45,,,1,39.16,37.16,0,-71023,48447,119470,-22576,0,0,0,0,0,,0,0
51,12/16/2017,76,18:45,19:00,,,1,40.34,38.34,0,-70497,50253,120750,-20244,0,0,0,0,0,,0,0
51,12/16/2017,77,19:00,19:15,153.29,,1,154.29,152.29,1,-133308,40205,173513,-93103,0,0,19497,0,0,,19497,19497
51,12/16/2017,78,19:15,19:30,153.29,,1,154.29,152.29,1,-149105,60037,209142,-89068,0,0,50623,0,0,,50623,50623
51,12/16/2017,79,19:30,19:45,38.94,,1,39.94,37.94,1,-148857,82081,230938,-66776,0,0,3391,0,0,,3391,3391
51,12/16/2017,80,19:45,20:00,42.56,,1,43.56,41.56,1,-143110,55496,198606,-87614,0,0,2224,0,0,,2224,2224
51,12/16/2017,81,20:00,20:15,136.5,,1,137.5,135.5,1,-104911,61037,165948,-43874,0,0,19078,0,0,,19078,19078
51,12/16/2017,82,20:15,20:30,50.98,,1,51.98,49.98,1,-93305,59160,152465,-34145,0,0,23540,0,0,,23540,23540
51,12/16/2017,83,20:30,20:45,38.94,34.99,1,40.14,33.99,2,-97864,105381,203245,7517,0,-290,2405,0,0,,2695,2115
51,12/16/2017,84,20:45,21:00,,5.05,1,6.05,4.05,-1,-56493,113242,169735,56749,0,-31054,0,0,0,,31054,-31054
51,12/16/2017,85,21:00,21:15,177.69,35.78,1,178.69,34.78,2,-117454,22063,139517,-95391,0,-8692,12129,0,0,,20821,3437
51,12/16/2017,86,21:15,21:30,44.98,,1,45.98,43.98,1,-80300,44430,124730,-35870,0,0,17381,0,0,,17381,17381
51,12/16/2017,87,21:30,21:45,44.98,,1,45.98,43.98,1,-55593,53525,109118,-2068,0,0,9549,0,0,,9549,9549
51,12/16/2017,88,21:45,22:00,44.98,35.99,1,36.99,34.99,-1,-57649,49799,107448,-7850,0,-308,555,0,0,,863,247
51,12/16/2017,89,22:00,22:15,167.89,,1,168.89,166.89,1,-160646,35196,195842,-125450,0,0,22038,0,0,,22038,22038
51,12/16/2017,90,22:15,22:30,167.89,,1,168.89,166.89,1,-122454,40978,163432,-81476,0,0,47818,0,0,,47818,47818
51,12/16/2017,91,22:30,22:45,167.89,,1,168.89,166.89,1,-100816,52587,153403,-48229,0,0,42018,0,0,,42018,42018
51,12/16/2017,92,22:45,23:00,102.12,,1,103.12,101.12,1,-98035,50955,148990,-47080,0,0,19923,0,0,,19923,19923
51,12/16/2017,93,23:00,23:15,46.38,,1,47.38,45.38,1,-125075,35156,160231,-89919,0,0,22660,0,0,,22660,22660
51,12/16/2017,94,23:15,23:30,176.06,,1,177.06,175.06,1,-149057,15881,164938,-133176,0,0,21040,0,0,,21040,21040
51,12/16/2017,95,23:30,23:45,176.06,,1,177.06,175.06,1,-157884,46494,204378,-111390,0,0,63541,0,0,,63541,63541
51,12/16/2017,96,23:45,0:00,43.71,-34.56,1,-33.56,-35.56,-1,-54875,81896,136771,27021,0,-5154,26559,0,0,,31713,21405
51,12/17/2017,1,0:00,0:15,41.44,-45.43,1,42.44,-46.43,2,-85655,141475,227130,55820,0,-16421,130,0,0,,16551,-16291
51,12/17/2017,2,0:15,0:30,41.44,,1,42.44,40.44,1,-89495,100131,189626,10636,0,0,3974,0,0,,3974,3974
51,12/17/2017,3,0:30,0:45,38.54,,1,39.54,37.54,1,-74760,61315,136075,-13445,0,0,750,0,0,,750,750
51,12/17/2017,4,0:45,1:00,38.08,40.04,1,41.04,39.04,-1,-105596,65289,170885,-40307,0,-7,1027,0,0,,1034,1020
51,12/17/2017,5,1:00,1:15,,33.03,1,34.03,32.03,-1,-70527,126081,196608,55554,0,-1587,0,0,0,,1587,-1587
51,12/17/2017,6,1:15,1:30,,-8.34,1,-7.34,-9.34,-1,-60980,134544,195524,73564,0,-22080,0,0,0,,22080,-22080
51,12/17/2017,7,1:30,1:45,,24.5,1,25.5,23.5,-1,-45431,105995,151426,60564,0,-25611,0,0,0,,25611,-25611
51,12/17/2017,8,1:45,2:00,,-8.83,1,-7.83,-9.83,-1,-47706,93521,141227,45815,0,-46933,0,0,0,,46933,-46933
51,12/17/2017,9,2:00,2:15,52.7,32.75,1,53.7,51.7,1,-69250,52324,121574,-16926,0,-17250,2933,0,0,,20183,-14317
51,12/17/2017,10,2:15,2:30,59.02,,1,60.02,58.02,1,-65132,56342,121474,-8790,0,0,14886,0,0,,14886,14886
51,12/17/2017,11,2:30,2:45,59.02,27.98,1,28.98,26.98,-1,-40494,67322,107816,26828,0,-8509,1953,0,0,,10462,-6556
51,12/17/2017,12,2:45,3:00,,28.79,1,29.79,27.79,-1,-41536,79883,121419,38347,0,-30594,0,0,0,,30594,-30594
51,12/17/2017,13,3:00,3:15,143.02,33.11,1,144.02,142.02,1,-59885,37761,97646,-22124,0,-15003,5788,0,0,,20791,-9215
51,12/17/2017,14,3:15,3:30,85.02,,1,86.02,84.02,1,-59233,42253,101486,-16980,0,0,14388,0,0,,14388,14388
51,12/17/2017,15,3:30,3:45,51.44,,1,52.44,50.44,1,-71964,41920,113884,-30044,0,0,14009,0,0,,14009,14009
51,12/17/2017,16,3:45,4:00,41.44,34.11,1,35.11,33.11,-1,-56817,45748,102565,-11069,0,-405,11895,0,0,,12300,11490
51,12/17/2017,17,4:00,4:15,41.44,34.11,1,35.11,33.11,-1,-47135,88496,135631,41361,0,-626,131,0,0,,757,-495
51,12/17/2017,18,4:15,4:30,41.44,,1,42.44,40.44,1,-76680,47223,123903,-29457,0,0,5182,0,0,,5182,5182
51,12/17/2017,19,4:30,4:45,39.48,,1,40.48,38.48,1,-78696,43820,122516,-34876,0,0,3316,0,0,,3316,3316
51,12/17/2017,20,4:45,5:00,,,1,36.45,34.45,0,-62881,41117,103998,-21764,0,0,205,0,0,,205,205
51,12/17/2017,21,5:00,5:15,,39.79,1,40.79,38.79,-1,-33510,56237,89747,22727,0,-305,0,0,0,,305,-305
51,12/17/2017,22,5:15,5:30,,,1,36.5,34.5,0,-47656,72856,120512,25200,0,0,0,0,0,,0,0
51,12/17/2017,23,5:30,5:45,40.4,,1,41.4,39.4,1,-58633,49596,108229,-9037,0,0,1085,0,0,,1085,1085
51,12/17/2017,24,5:45,6:00,43.72,,1,44.72,42.72,1,-54998,44005,99003,-10993,0,0,2906,0,0,,2906,2906
51,12/17/2017,25,6:00,6:15,50.55,,1,51.55,49.55,1,-90195,51177,141372,-39018,0,0,20091,0,0,,20091,20091
51,12/17/2017,26,6:15,6:30,41.46,,1,42.46,40.46,1,-64012,42983,106995,-21029,0,0,14984,0,0,,14984,14984
51,12/17/2017,27,6:30,6:45,37.99,,1,38.99,36.99,1,-69513,52290,121803,-17223,0,0,415,0,0,,415,415
51,12/17/2017,28,6:45,7:00,45.46,,1,46.46,44.46,1,-91398,68030,159428,-23368,0,0,6050,0,0,,6050,6050
51,12/17/2017,29,7:00,7:15,55.02,,1,56.02,54.02,1,-95350,63041,158391,-32309,0,0,27125,0,0,,27125,27125
51,12/17/2017,30,7:15,7:30,55.02,34.86,1,35.86,33.86,-1,-51049,56811,107860,5762,0,-1004,4700,0,0,,5704,3696
51,12/17/2017,31,7:30,7:45,66.94,,1,67.94,65.94,1,-95501,56351,151852,-39150,0,0,13114,0,0,,13114,13114
51,12/17/2017,32,7:45,8:00,72.96,36.72,1,73.96,34.56,2,-75665,67046,142711,-8619,0,-303,21760,0,0,,22063,21457
51,12/17/2017,33,8:00,8:15,72.96,35.45,1,36.45,34.45,-1,-57030,74715,131745,17685,0,-474,83,0,0,,557,-391
51,12/17/2017,34,8:15,8:30,,34.28,1,35.28,33.28,-1,-49779,64056,113835,14277,0,-2172,0,0,0,,2172,-2172
51,12/17/2017,35,8:30,8:45,114.02,,1,115.02,113.02,1,-75555,48532,124087,-27023,0,0,7337,0,0,,7337,7337
51,12/17/2017,36,8:45,9:00,121.57,,1,122.57,120.57,1,-62915,44636,107551,-18279,0,0,20776,0,0,,20776,20776
51,12/17/2017,37,9:00,9:15,41.46,35.44,1,42.46,33.97,2,-54525,53371,107896,-1154,0,-2490,7260,0,0,,9750,4770
51,12/17/2017,38,9:15,9:30,41.46,36.93,1,37.93,35.93,-1,-61373,60534,121907,-839,0,-1057,13,0,0,,1070,-1044
51,12/17/2017,39,9:30,9:45,,,1,35.94,33.94,0,-56244,52217,108461,-4027,0,0,0,0,0,,0,0
51,12/17/2017,40,9:45,10:00,,,1,35.9,33.9,0,-62478,93631,156109,31153,0,0,0,0,0,,0,0
51,12/17/2017,41,10:00,10:15,,,1,35.95,33.95,0,-33525,102695,136220,69170,0,0,0,0,0,,0,0
51,12/17/2017,42,10:15,10:30,,,1,35.94,33.94,0,-45426,92762,138188,47336,0,0,0,0,0,,0,0
51,12/17/2017,43,10:30,10:45,,,1,37.11,35.11,0,-39019,93258,132277,54239,0,0,0,0,0,,0,0
51,12/17/2017,44,10:45,11:00,,,1,36.27,34.27,0,-42655,90567,133222,47912,0,0,0,0,0,,0,0
51,12/17/2017,45,11:00,11:15,,,1,37.11,35.11,0,-24415,93191,117606,68776,0,0,0,0,0,,0,0
51,12/17/2017,46,11:15,11:30,,,1,37.11,35.11,0,-33602,99727,133329,66125,0,0,0,0,0,,0,0
51,12/17/2017,47,11:30,11:45,,,1,37.11,35.11,0,-31245,99212,130457,67967,0,0,0,0,0,,0,0
51,12/17/2017,48,11:45,12:00,,,1,37.11,35.11,0,-37944,96889,134833,58945,0,0,0,0,0,,0,0
51,12/17/2017,49,12:00,12:15,,,1,37.09,35.09,0,-54801,99221,154022,44420,0,0,0,0,0,,0,0
51,12/17/2017,50,12:15,12:30,,23.71,1,24.71,22.71,-1,-62584,92490,155074,29906,0,-14483,0,0,0,,14483,-14483
51,12/17/2017,51,12:30,12:45,,32.03,1,33.03,31.03,-1,-56662,91489,148151,34827,0,-16397,0,0,0,,16397,-16397
51,12/17/2017,52,12:45,13:00,,31.44,1,32.44,30.44,-1,-51553,90494,142047,38941,0,-13848,0,0,0,,13848,-13848
51,12/17/2017,53,13:00,13:15,39.38,36.03,1,40.38,38.38,1,-74870,86622,161492,11752,0,-8892,350,0,0,,9242,-8542
51,12/17/2017,54,13:15,13:30,39.38,36.44,1,37.44,35.44,-1,-48678,76680,125358,28002,0,-501,2,0,0,,503,-499
51,12/17/2017,55,13:30,13:45,,36.44,1,37.44,35.44,-1,-45918,80704,126622,34786,0,-846,0,0,0,,846,-846
51,12/17/2017,56,13:45,14:00,,35.04,1,36.04,34.04,-1,-49054,79004,128058,29950,0,-5732,0,0,0,,5732,-5732
51,12/17/2017,57,14:00,14:15,39.72,35.04,1,40.72,38.72,1,-75333,57524,132857,-17809,0,-1261,1490,0,0,,2751,229
51,12/17/2017,58,14:15,14:30,39.72,,1,40.72,38.72,1,-56794,51644,108438,-5150,0,0,1878,0,0,,1878,1878
51,12/17/2017,59,14:30,14:45,35.02,,1,36.02,34.02,1,-44716,58476,103192,13760,0,0,227,0,0,,227,227
51,12/17/2017,60,14:45,15:00,,,1,37.15,35.15,0,-37223,66415,103638,29192,0,0,0,0,0,,0,0
51,12/17/2017,61,15:00,15:15,45.46,,1,46.46,44.46,1,-65947,33820,99767,-32127,0,0,6456,0,0,,6456,6456
51,12/17/2017,62,15:15,15:30,41.22,,1,42.22,40.22,1,-69701,40362,110063,-29339,0,0,4733,0,0,,4733,4733
51,12/17/2017,63,15:30,15:45,41.22,,1,42.22,40.22,1,-69894,43758,113652,-26136,0,0,5620,0,0,,5620,5620
51,12/17/2017,64,15:45,16:00,,,1,37.15,35.15,0,-63588,53307,116895,-10281,0,0,1502,0,0,,1502,1502
51,12/17/2017,65,16:00,16:15,,24.48,1,25.48,23.48,-1,-30876,82730,113606,51854,0,-11576,0,0,0,,11576,-11576
51,12/17/2017,66,16:15,16:30,,23.93,1,24.93,22.93,-1,-35232,53881,89113,18649,0,-32810,0,0,0,,32810,-32810
51,12/17/2017,67,16:30,16:45,38.32,23.93,1,39.32,37.32,1,-49313,49566,98879,253,0,-2323,308,0,0,,2631,-2015
51,12/17/2017,68,16:45,17:00,39.72,,1,40.72,38.72,1,-94109,63514,157623,-30595,0,0,274,0,0,,274,274
51,12/17/2017,69,17:00,17:15,,36.98,1,37.98,35.98,-1,-50412,49991,100403,-421,0,-839,0,0,0,,839,-839
51,12/17/2017,70,17:15,17:30,,39.87,1,40.87,38.87,-1,-43177,52447,95624,9270,0,-926,0,0,0,,926,-926
51,12/17/2017,71,17:30,17:45,,35.07,1,36.07,34.07,-1,-40659,56212,96871,15553,0,-5379,0,0,0,,5379,-5379
51,12/17/2017,72,17:45,18:00,,36.44,1,37.44,35.44,-1,-31781,63326,95107,31545,0,-4756,0,0,0,,4756,-4756
51,12/17/2017,73,18:00,18:15,,,1,37.08,35.08,0,-74659,24452,99111,-50207,0,0,0,0,0,,0,0
51,12/17/2017,74,18:15,18:30,35.02,,1,36.02,34.02,1,-62876,42369,105245,-20507,0,0,120,0,0,,120,120
51,12/17/2017,75,18:30,18:45,,37.1,1,38.1,36.1,-1,-51180,56859,108039,5679,0,-718,0,0,0,,718,-718
51,12/17/2017,76,18:45,19:00,,36.44,1,37.44,35.44,-1,-65207,77979,143186,12772,0,-2517,0,0,0,,2517,-2517
51,12/17/2017,77,19:00,19:15,148.79,36.44,1,149.79,147.79,1,-74158,9851,84009,-64307,0,-236,19028,0,0,,19264,18792
51,12/17/2017,78,19:15,19:30,52.9,,1,53.9,51.9,1,-56892,32529,89421,-24363,0,0,30829,0,0,,30829,30829
51,12/17/2017,79,19:30,19:45,52.9,33.03,1,34.03,32.03,-1,-42655,48727,91382,6072,0,-1569,6085,0,0,,7654,4516
51,12/17/2017,80,19:45,20:00,50,39.51,1,51,34.77,2,-72982,48518,121500,-24464,0,-76,4999,0,0,,5075,4923
51,12/17/2017,81,20:00,20:15,53.66,-1.29,1,54.66,-2.29,2,-40300,78264,118564,37964,0,-11609,1226,0,0,,12835,-10383
51,12/17/2017,82,20:15,20:30,135.47,,1,136.47,134.47,1,-66488,26352,92840,-40136,0,0,20573,0,0,,20573,20573
51,12/17/2017,83,20:30,20:45,135.47,36.44,1,37.44,35.44,-1,-46637,50680,97317,4043,0,-119,170,0,0,,289,51
51,12/17/2017,84,20:45,21:00,,36.44,1,37.44,35.44,-1,-59800,62041,121841,2241,0,-487,0,0,0,,487,-487
51,12/17/2017,85,21:00,21:15,,35.44,1,36.44,34.44,-1,-29685,57624,87309,27939,0,-3145,0,0,0,,3145,-3145
51,12/17/2017,86,21:15,21:30,,32.23,1,33.23,31.23,-1,-29326,54515,83841,25189,0,-6576,0,0,0,,6576,-6576
51,12/17/2017,87,21:30,21:45,,17.98,1,18.98,16.98,-1,-28542,59993,88535,31451,0,-17586,0,0,0,,17586,-17586
51,12/17/2017,88,21:45,22:00,,17.88,1,18.88,16.88,-1,-43107,53080,96187,9973,0,-26148,0,0,0,,26148,-26148
51,12/17/2017,89,22:00,22:15,39.4,17.88,1,40.4,38.4,1,-52959,51811,104770,-1148,0,-6569,354,0,0,,6923,-6215
51,12/17/2017,90,22:15,22:30,,33.28,1,34.28,32.28,-1,-42524,57806,100330,15282,0,-1043,0,0,0,,1043,-1043
51,12/17/2017,91,22:30,22:45,,32.67,1,33.67,31.67,-1,-26590,77265,103855,50675,0,-5359,0,0,0,,5359,-5359
51,12/17/2017,92,22:45,23:00,,30.62,1,31.62,29.62,-1,-20262,87858,108120,67596,0,-16490,0,0,0,,16490,-16490
51,12/17/2017,93,23:00,23:15,31.62,25.6,1,34.99,24.6,2,-57291,52447,109738,-4844,0,-18515,38,0,0,,18553,-18477
51,12/17/2017,94,23:15,23:30,37.99,25.6,1,38.99,36.99,1,-67746,45850,113596,-21896,0,-488,1488,0,0,,1976,1000
51,12/17/2017,95,23:30,23:45,,,1,35,33,0,-66811,53861,120672,-12950,0,0,29,0,0,,29,29
51,12/17/2017,96,23:45,0:00,,33.28,1,34.28,32.28,-1,-55449,58333,113782,2884,0,-1036,0,0,0,,1036,-1036
51,12/18/2017,1,0:00,0:15,,36.19,1,37.19,35.19,-1,-89206,89124,178330,-82,0,-920,0,0,0,,920,-920
51,12/18/2017,2,0:15,0:30,66.53,36.19,1,67.53,65.53,1,-81382,39077,120459,-42305,0,-38,16805,0,0,,16843,16767
51,12/18/2017,3,0:30,0:45,45.75,,1,46.75,44.75,1,-60955,16237,77192,-44718,0,0,29717,0,0,,29717,29717
51,12/18/2017,4,0:45,1:00,42.79,,1,43.79,41.79,1,-71519,17162,88681,-54357,0,0,23483,0,0,,23483,23483
51,12/18/2017,5,1:00,1:15,132.12,,1,133.12,131.12,1,-103726,27226,130952,-76500,0,0,26947,0,0,,26947,26947
51,12/18/2017,6,1:15,1:30,58.74,,1,59.74,57.74,1,-108778,43663,152441,-65115,0,0,47663,0,0,,47663,47663
51,12/18/2017,7,1:30,1:45,95.83,,1,96.83,94.83,1,-116534,25211,141745,-91323,0,0,59857,0,0,,59857,59857
51,12/18/2017,8,1:45,2:00,92.32,,1,93.32,91.32,1,-148714,40120,188834,-108594,0,0,49788,0,0,,49788,49788
51,12/18/2017,9,2:00,2:15,132.12,,1,133.12,131.12,1,-173190,52050,225240,-121140,0,0,41193,0,0,,41193,41193
51,12/18/2017,10,2:15,2:30,134.67,,1,135.67,133.67,1,-182634,62108,244742,-120526,0,0,107463,0,0,,107463,107463
51,12/18/2017,11,2:30,2:45,92.48,,1,93.48,91.48,1,-177313,54913,232226,-122400,0,0,79578,0,0,,79578,79578
51,12/18/2017,12,2:45,3:00,49.02,,1,50.02,48.02,1,-153939,44232,198171,-109707,0,0,33474,0,0,,33474,33474
51,12/18/2017,13,3:00,3:15,45.46,33.28,1,46.46,44.46,1,-131939,130935,262874,-1004,0,-6,813,0,0,,819,807
51,12/18/2017,14,3:15,3:30,73.97,,1,74.97,72.97,1,-124818,71741,196559,-53077,0,0,31753,0,0,,31753,31753
51,12/18/2017,15,3:30,3:45,41.46,,1,42.46,40.46,1,-86342,76732,163074,-9610,0,0,12497,0,0,,12497,12497
51,12/18/2017,16,3:45,4:00,,,1,36.03,34.03,0,-62171,70451,132622,8280,0,0,10,0,0,,10,10
51,12/18/2017,17,4:00,4:15,,,1,35.83,33.83,0,-56776,98099,154875,41323,0,0,0,0,0,,0,0
51,12/18/2017,18,4:15,4:30,,,1,35.82,33.82,0,-17304,104804,122108,87500,0,0,0,0,0,,0,0
51,12/18/2017,19,4:30,4:45,,37.24,1,38.24,36.24,-1,-12782,122113,134895,109331,0,-186,0,0,0,,186,-186
51,12/18/2017,20,4:45,5:00,,34.28,1,35.28,33.28,-1,-18848,143360,162208,124512,0,-1551,0,0,0,,1551,-1551
51,12/18/2017,21,5:00,5:15,,34.28,1,35.28,33.28,-1,-127625,125216,252841,-2409,0,-789,0,0,0,,789,-789
51,12/18/2017,22,5:15,5:30,,34.28,1,35.28,33.28,-1,-80748,85660,166408,4912,0,-2830,0,0,0,,2830,-2830
51,12/18/2017,23,5:30,5:45,,36.75,1,37.75,35.75,-1,-60649,73455,134104,12806,0,-1064,0,0,0,,1064,-1064
51,12/18/2017,24,5:45,6:00,31.88,38.6,1,35.86,33.86,2,-78568,96054,174622,17486,0,-391,78,0,0,,469,-313
51,12/18/2017,25,6:00,6:15,,-8.86,1,-7.86,-9.86,-1,-45004,73974,118978,28970,0,-12215,0,0,0,,12215,-12215
51,12/18/2017,26,6:15,6:30,39.16,-42.93,1,40.16,-43.93,2,-65976,62263,128239,-3713,0,-33681,53,0,0,,33734,-33628
51,12/18/2017,27,6:30,6:45,40.37,10.63,1,41.37,9.63,2,-55502,87713,143215,32211,0,-7948,163,0,0,,8111,-7785
51,12/18/2017,28,6:45,7:00,,-11.76,1,-10.76,-12.76,-1,-50047,121095,171142,71048,0,-57471,0,0,0,,57471,-57471
51,12/18/2017,29,7:00,7:15,40.2,38.14,1,41.2,34.13,2,-141909,117759,259668,-24150,0,-11634,723,0,0,,12357,-10911
51,12/18/2017,30,7:15,7:30,39.68,,1,40.68,38.68,1,-85035,88462,173497,3427,0,0,131,0,0,,131,131
51,12/18/2017,31,7:30,7:45,232.75,,1,233.75,231.75,1,-144861,77054,221915,-67807,0,0,10127,0,0,,10127,10127
51,12/18/2017,32,7:45,8:00,232.75,,1,233.75,231.75,1,-199287,92788,292075,-106499,0,0,73782,0,0,,73782,73782
51,12/18/2017,33,8:00,8:15,232.75,37.36,1,38.36,36.36,-1,-93745,91508,185253,-2237,0,-538,31347,0,0,,31885,30809
51,12/18/2017,34,8:15,8:30,86.81,,1,87.81,85.81,1,-113494,79822,193316,-33672,0,0,12071,0,0,,12071,12071
51,12/18/2017,35,8:30,8:45,42.79,,1,43.79,41.79,1,-115649,79857,195506,-35792,0,0,7267,0,0,,7267,7267
51,12/18/2017,36,8:45,9:00,73.07,,1,74.07,72.07,1,-144311,75445,219756,-68866,0,0,13904,0,0,,13904,13904
51,12/18/2017,37,9:00,9:15,96.33,28.99,1,97.33,27.99,2,-59914,88452,148366,28538,0,-4870,16106,0,0,,20976,11236
51,12/18/2017,38,9:15,9:30,56.11,28.99,1,57.11,55.11,1,-100900,89652,190552,-11248,0,-7694,4051,0,0,,11745,-3643
51,12/18/2017,39,9:30,9:45,42.46,,1,43.46,41.46,1,-98708,87795,186503,-10913,0,0,9773,0,0,,9773,9773
51,12/18/2017,40,9:45,10:00,56.11,,1,57.11,55.11,1,-105622,87055,192677,-18567,0,0,4470,0,0,,4470,4470
51,12/18/2017,41,10:00,10:15,71.12,,1,72.12,70.12,1,-128039,106186,234225,-21853,0,0,17596,0,0,,17596,17596
51,12/18/2017,42,10:15,10:30,63.57,,1,64.57,62.57,1,-139176,93845,233021,-45331,0,0,23524,0,0,,23524,23524
51,12/18/2017,43,10:30,10:45,138.07,,1,139.07,137.07,1,-148666,83438,232104,-65228,0,0,47792,0,0,,47792,47792
51,12/18/2017,44,10:45,11:00,135.12,,1,136.12,134.12,1,-173878,93210,267088,-80668,0,0,51196,0,0,,51196,51196
51,12/18/2017,45,11:00,11:15,218.91,,1,219.91,217.91,1,-191280,92636,283916,-98644,0,0,60416,0,0,,60416,60416
51,12/18/2017,46,11:15,11:30,93.12,,1,94.12,92.12,1,-195145,92722,287867,-102423,0,0,55287,0,0,,55287,55287
51,12/18/2017,47,11:30,11:45,218.91,,1,219.91,217.91,1,-202188,91367,293555,-110821,0,0,61790,0,0,,61790,61790
51,12/18/2017,48,11:45,12:00,218.91,,1,219.91,217.91,1,-206636,83860,290496,-122776,0,0,69327,0,0,,69327,69327
51,12/18/2017,49,12:00,12:15,215.08,,1,216.08,214.08,1,-217328,76058,293386,-141270,0,0,79390,0,0,,79390,79390
51,12/18/2017,50,12:15,12:30,350.12,,1,351.12,349.12,1,-204789,95844,300633,-108945,0,0,83627,0,0,,83627,83627
51,12/18/2017,51,12:30,12:45,350.12,,1,351.12,349.12,1,-195254,105611,300865,-89643,0,0,70924,0,0,,70924,70924
51,12/18/2017,52,12:45,13:00,370.25,,1,371.25,369.25,1,-199905,84434,284339,-115471,0,0,76055,0,0,,76055,76055
51,12/18/2017,53,13:00,13:15,370.25,,1,371.25,369.25,1,-168864,69475,238339,-99389,0,0,34523,0,0,,34523,34523
51,12/18/2017,54,13:15,13:30,220.23,,1,221.23,219.23,1,-174569,58335,232904,-116234,0,0,77265,0,0,,77265,77265
51,12/18/2017,55,13:30,13:45,370.25,,1,371.25,369.25,1,-179992,59830,239822,-120162,0,0,75039,0,0,,75039,75039
51,12/18/2017,56,13:45,14:00,370.25,,1,371.25,369.25,1,-162471,68750,231221,-93721,0,0,75222,0,0,,75222,75222
51,12/18/2017,57,14:00,14:15,74.25,,1,75.25,73.25,1,-133546,90532,224078,-43014,0,0,17044,0,0,,17044,17044
51,12/18/2017,58,14:15,14:30,370.25,,1,371.25,369.25,1,-134572,83780,218352,-50792,0,0,40037,0,0,,40037,40037
51,12/18/2017,59,14:30,14:45,39.1,,1,40.1,38.1,1,-118569,85795,204364,-32774,0,0,6371,0,0,,6371,6371
51,12/18/2017,60,14:45,15:00,46.57,,1,47.57,45.57,1,-124535,59950,184485,-64585,0,0,3167,0,0,,3167,3167
51,12/18/2017,61,15:00,15:15,42.06,,1,43.06,41.06,1,-117987,71891,189878,-46096,0,0,4453,0,0,,4453,4453
51,12/18/2017,62,15:15,15:30,43.8,,1,44.8,42.8,1,-125398,59181,184579,-66217,0,0,4794,0,0,,4794,4794
51,12/18/2017,63,15:30,15:45,370.25,,1,371.25,369.25,1,-155082,58722,213804,-96360,0,0,14550,0,0,,14550,14550
51,12/18/2017,64,15:45,16:00,370.25,,1,371.25,369.25,1,-116985,58287,175272,-58698,0,0,36236,0,0,,36236,36236
51,12/18/2017,65,16:00,16:15,39.68,36.82,1,41.15,35.82,2,-78426,104223,182649,25797,0,-1156,9722,0,0,,10878,8566
51,12/18/2017,66,16:15,16:30,43.88,,1,44.88,42.88,1,-118361,92176,210537,-26185,0,0,3306,0,0,,3306,3306
51,12/18/2017,67,16:30,16:45,370.25,,1,371.25,369.25,1,-134268,77417,211685,-56851,0,0,18015,0,0,,18015,18015
51,12/18/2017,68,16:45,17:00,370.25,,1,371.25,369.25,1,-179327,79385,258712,-99942,0,0,75138,0,0,,75138,75138
51,12/18/2017,69,17:00,17:15,370.25,,1,371.25,369.25,1,-142026,99566,241592,-42460,0,0,49598,0,0,,49598,49598
51,12/18/2017,70,17:15,17:30,370.25,,1,371.25,369.25,1,-168372,73856,242228,-94516,0,0,21301,0,0,,21301,21301
51,12/18/2017,71,17:30,17:45,370.25,,1,371.25,369.25,1,-148250,86043,234293,-62207,0,0,56685,0,0,,56685,56685
51,12/18/2017,72,17:45,18:00,92.22,,1,93.22,91.22,1,-146174,86245,232419,-59929,0,0,40986,0,0,,40986,40986
51,12/18/2017,73,18:00,18:15,39.79,,1,40.79,38.79,1,-174052,62960,237012,-111092,0,0,18166,0,0,,18166,18166
51,12/18/2017,74,18:15,18:30,45.76,,1,46.76,44.76,1,-145442,45864,191306,-99578,0,0,2553,0,0,,2553,2553
51,12/18/2017,75,18:30,18:45,38.88,,1,39.88,37.88,1,-140422,57158,197580,-83264,0,0,799,0,0,,799,799
51,12/18/2017,76,18:45,19:00,39.68,,1,40.68,38.68,1,-123606,41637,165243,-81969,0,0,1249,0,0,,1249,1249
51,12/18/2017,77,19:00,19:15,370.25,,1,371.25,369.25,1,-134152,47627,181779,-86525,0,0,17058,0,0,,17058,17058
51,12/18/2017,78,19:15,19:30,46.99,,1,47.99,45.99,1,-109885,52927,162812,-56958,0,0,8308,0,0,,8308,8308
51,12/18/2017,79,19:30,19:45,95.25,,1,96.25,94.25,1,-116881,59205,176086,-57676,0,0,11069,0,0,,11069,11069
51,12/18/2017,80,19:45,20:00,,,1,40.46,38.46,0,-98277,63771,162048,-34506,0,0,692,0,0,,692,692
51,12/18/2017,81,20:00,20:15,370.25,,1,371.25,369.25,1,-126248,39594,165842,-86654,0,0,28277,0,0,,28277,28277
51,12/18/2017,82,20:15,20:30,39.79,39.4,1,40.4,38.4,-1,-108039,87954,195993,-20085,0,-44,13331,0,0,,13375,13287
51,12/18/2017,83,20:30,20:45,45.76,,1,46.76,44.76,1,-98117,64661,162778,-33456,0,0,3999,0,0,,3999,3999
51,12/18/2017,84,20:45,21:00,38.63,,1,39.63,37.63,1,-119942,77958,197900,-41984,0,0,1551,0,0,,1551,1551
51,12/18/2017,85,21:00,21:15,370.25,36.72,1,371.25,35.72,2,-77623,38190,115813,-39433,0,-161,9786,0,0,,9947,9625
51,12/18/2017,86,21:15,21:30,370.25,23.12,1,371.25,22.12,2,-55639,53721,109360,-1918,0,-940,28386,0,0,,29326,27446
51,12/18/2017,87,21:30,21:45,38.98,11.78,1,40.08,10.78,2,-86350,52249,138599,-34101,0,-12975,38,0,0,,13013,-12937
51,12/18/2017,88,21:45,22:00,38.83,11.78,1,39.83,37.83,1,-145114,70210,215324,-74904,0,-83,939,0,0,,1022,856
51,12/18/2017,89,22:00,22:15,370.25,,1,371.25,369.25,1,-121099,52421,173520,-68678,0,0,11624,0,0,,11624,11624
51,12/18/2017,90,22:15,22:30,370.25,,1,371.25,369.25,1,-90861,57994,148855,-32867,0,0,23538,0,0,,23538,23538
51,12/18/2017,91,22:30,22:45,,18.04,1,19.04,17.04,-1,-63716,89719,153435,26003,0,-6111,0,0,0,,6111,-6111
51,12/18/2017,92,22:45,23:00,,18.66,1,19.66,17.66,-1,-61618,115612,177230,53994,0,-35531,0,0,0,,35531,-35531
51,12/18/2017,93,23:00,23:15,170.17,31.78,1,171.17,169.17,1,-124601,51628,176229,-72973,0,-18176,11513,0,0,,29689,-6663
51,12/18/2017,94,23:15,23:30,45.76,,1,46.76,44.76,1,-87075,55639,142714,-31436,0,0,19048,0,0,,19048,19048
51,12/18/2017,95,23:30,23:45,,,1,39.72,37.72,0,-68534,55294,123828,-13240,0,0,3752,0,0,,3752,3752
51,12/18/2017,96,23:45,0:00,,31.65,1,32.65,30.65,-1,-55279,86406,141685,31127,0,-3920,0,0,0,,3920,-3920
51,12/19/2017,1,0:00,0:15,228.57,36.72,1,229.57,227.57,1,-98380,50863,149243,-47517,0,-2684,13237,0,0,,15921,10553
51,12/19/2017,2,0:15,0:30,49.74,,1,50.74,48.74,1,-56880,41147,98027,-15733,0,0,27819,0,0,,27819,27819
51,12/19/2017,3,0:30,0:45,49.74,35.72,1,36.72,34.72,-1,-32134,46159,78293,14025,0,-1735,3833,0,0,,5568,2098
51,12/19/2017,4,0:45,1:00,,29.74,1,30.74,28.74,-1,-26642,58700,85342,32058,0,-4961,0,0,0,,4961,-4961
51,12/19/2017,5,1:00,1:15,,10.67,1,11.67,9.67,-1,-25422,50694,76116,25272,0,-25398,0,0,0,,25398,-25398
51,12/19/2017,6,1:15,1:30,38.49,37.91,1,39.87,36.91,2,-27160,38158,65318,10998,0,-4105,113,0,0,,4218,-3992
51,12/19/2017,7,1:30,1:45,,33.29,1,34.29,32.29,-1,-23632,50194,73826,26562,0,-6067,0,0,0,,6067,-6067
51,12/19/2017,8,1:45,2:00,,23.77,1,24.77,22.77,-1,-24055,61728,85783,37673,0,-18693,0,0,0,,18693,-18693
51,12/19/2017,9,2:00,2:15,,35.72,1,36.72,34.72,-1,-23034,43154,66188,20120,0,-14640,0,0,0,,14640,-14640
51,12/19/2017,10,2:15,2:30,,36.72,1,37.72,35.72,-1,-23764,36830,60594,13066,0,-565,0,0,0,,565,-565
51,12/19/2017,11,2:30,2:45,,,1,39.74,37.74,0,-39155,38141,77296,-1014,0,0,0,0,0,,0,0
51,12/19/2017,12,2:45,3:00,,37.92,1,38.92,36.92,-1,-34221,22717,56938,-11504,0,-537,0,0,0,,537,-537
51,12/19/2017,13,3:00,3:15,38.72,36.72,1,39.72,35.72,2,-33955,35725,69680,1770,0,-649,174,0,0,,823,-475
51,12/19/2017,14,3:15,3:30,38.45,,1,39.45,37.45,1,-39999,23753,63752,-16246,0,0,223,0,0,,223,223
51,12/19/2017,15,3:30,3:45,43.13,,1,44.13,42.13,1,-36470,18883,55353,-17587,0,0,4936,0,0,,4936,4936
51,12/19/2017,16,3:45,4:00,38.72,,1,39.72,37.72,1,-46521,25401,71922,-21120,0,0,3654,0,0,,3654,3654
51,12/19/2017,17,4:00,4:15,38.4,,1,39.4,37.4,1,-34958,28158,63116,-6800,0,0,132,0,0,,132,132
51,12/19/2017,18,4:15,4:30,38.43,,1,39.43,37.43,1,-38928,24278,63206,-14650,0,0,172,0,0,,172,172
51,12/19/2017,19,4:30,4:45,43.13,,1,44.13,42.13,1,-48050,19301,67351,-28749,0,0,1918,0,0,,1918,1918
51,12/19/2017,20,4:45,5:00,43.13,,1,44.13,42.13,1,-43527,16762,60289,-26765,0,0,10534,0,0,,10534,10534
51,12/19/2017,21,5:00,5:15,43.13,,1,44.13,42.13,1,-59881,39189,99070,-20692,0,0,4040,0,0,,4040,4040
51,12/19/2017,22,5:15,5:30,43.73,,1,44.73,42.73,1,-44686,26017,70703,-18669,0,0,6529,0,0,,6529,6529
51,12/19/2017,23,5:30,5:45,51.76,,1,52.76,50.76,1,-52227,11818,64045,-40409,0,0,21772,0,0,,21772,21772
51,12/19/2017,24,5:45,6:00,101.02,,1,102.02,100.02,1,-68030,16828,84858,-51202,0,0,37443,0,0,,37443,37443
51,12/19/2017,25,6:00,6:15,38.61,-43.78,1,39.61,-44.78,2,-39369,87105,126474,47736,0,-13825,14328,0,0,,28153,503
51,12/19/2017,26,6:15,6:30,,36.54,1,37.54,35.54,-1,-38485,38121,76606,-364,0,-4434,0,0,0,,4434,-4434
51,12/19/2017,27,6:30,6:45,238.95,,1,239.95,237.95,1,-74566,22466,97032,-52100,0,0,7327,0,0,,7327,7327
51,12/19/2017,28,6:45,7:00,238.95,,1,239.95,237.95,1,-93327,44009,137336,-49318,0,0,54710,0,0,,54710,54710
51,12/19/2017,29,7:00,7:15,238.95,-29.62,1,-28.62,-30.62,-1,-20282,137535,157817,117253,0,-27005,8281,0,0,,35286,-18724
51,12/19/2017,30,7:15,7:30,,30.98,1,31.98,29.98,-1,-58921,81473,140394,22552,0,-10949,0,0,0,,10949,-10949
51,12/19/2017,31,7:30,7:45,42.94,36.54,1,43.94,41.94,1,-84677,68118,152795,-16559,0,-6876,318,0,0,,7194,-6558
51,12/19/2017,32,7:45,8:00,278.03,36.54,1,279.03,277.03,1,-132850,68282,201132,-64568,0,-35,33206,0,0,,33241,33171
51,12/19/2017,33,8:00,8:15,94.17,10.94,1,11.94,9.94,-1,-40331,109655,149986,69324,0,-4706,24746,0,0,,29452,20040
51,12/19/2017,34,8:15,8:30,,10.94,1,11.94,9.94,-1,-80681,91957,172638,11276,0,-11876,0,0,0,,11876,-11876
51,12/19/2017,35,8:30,8:45,,35.54,1,36.54,34.54,-1,-88239,105675,193914,17436,0,-6459,0,0,0,,6459,-6459
51,12/19/2017,36,8:45,9:00,,35.54,1,36.54,34.54,-1,-108580,115692,224272,7112,0,-9585,0,0,0,,9585,-9585
51,12/19/2017,37,9:00,9:15,,35.54,1,36.54,34.54,-1,-84988,111981,196969,26993,0,-4142,0,0,0,,4142,-4142
51,12/19/2017,38,9:15,9:30,,,1,40.28,38.28,0,-84109,102706,186815,18597,0,0,0,0,0,,0,0
51,12/19/2017,39,9:30,9:45,,39.43,1,40.43,38.43,-1,-86193,107475,193668,21282,0,-1457,0,0,0,,1457,-1457
51,12/19/2017,40,9:45,10:00,,36.54,1,37.54,35.54,-1,-82870,104133,187003,21263,0,-2152,0,0,0,,2152,-2152
51,12/19/2017,41,10:00,10:15,,35.54,1,36.54,34.54,-1,-44550,71456,116006,26906,0,-3245,0,0,0,,3245,-3245
51,12/19/2017,42,10:15,10:30,,39.91,1,40.91,38.91,-1,-33427,71162,104589,37735,0,-1598,0,0,0,,1598,-1598
51,12/19/2017,43,10:30,10:45,,,1,40.27,38.27,0,-28939,65985,94924,37046,0,0,0,0,0,,0,0
51,12/19/2017,44,10:45,11:00,,34.28,1,35.28,33.28,-1,-31134,69918,101052,38784,0,-3492,0,0,0,,3492,-3492
51,12/19/2017,45,11:00,11:15,,29.6,1,30.6,28.6,-1,-33486,68240,101726,34754,0,-29491,0,0,0,,29491,-29491
51,12/19/2017,46,11:15,11:30,,35.54,1,36.54,34.54,-1,-31777,49994,81771,18217,0,-19117,0,0,0,,19117,-19117
51,12/19/2017,47,11:30,11:45,,,1,40.27,38.27,0,-68838,57532,126370,-11306,0,-983,0,0,0,,983,-983
51,12/19/2017,48,11:45,12:00,,,1,40.27,38.27,0,-102013,47601,149614,-54412,0,0,0,0,0,,0,0
51,12/19/2017,49,12:00,12:15,,,1,40.26,38.26,0,-55602,39508,95110,-16094,0,0,0,0,0,,0,0
51,12/19/2017,50,12:15,12:30,,,1,40.26,38.26,0,-53265,42242,95507,-11023,0,0,0,0,0,,0,0
51,12/19/2017,51,12:30,12:45,,36.54,1,37.54,35.54,-1,-51433,59157,110590,7724,0,-957,0,0,0,,957,-957
51,12/19/2017,52,12:45,13:00,,39.73,1,40.73,38.73,-1,-63454,44993,108447,-18461,0,-708,0,0,0,,708,-708
51,12/19/2017,53,13:00,13:15,,39.97,1,40.97,38.97,-1,-61647,41827,103474,-19820,0,-60,0,0,0,,60,-60
51,12/19/2017,54,13:15,13:30,,,1,40.25,38.25,0,-80048,31328,111376,-48720,0,0,0,0,0,,0,0
51,12/19/2017,55,13:30,13:45,,,1,40.24,38.24,0,-92062,28519,120581,-63543,0,0,0,0,0,,0,0
51,12/19/2017,56,13:45,14:00,,,1,40.25,38.25,0,-104175,33793,137968,-70382,0,0,0,0,0,,0,0
51,12/19/2017,57,14:00,14:15,38.54,,1,39.54,37.54,1,-51272,54377,105649,3105,0,0,179,0,0,,179,179
51,12/19/2017,58,14:15,14:30,42.94,,1,43.94,41.94,1,-52933,44469,97402,-8464,0,0,4556,0,0,,4556,4556
51,12/19/2017,59,14:30,14:45,42.94,36.54,1,37.54,35.54,-1,-41242,65515,106757,24273,0,-534,51,0,0,,585,-483
51,12/19/2017,60,14:45,15:00,,34.28,1,35.28,33.28,-1,-42585,71421,114006,28836,0,-8852,0,0,0,,8852,-8852
51,12/19/2017,61,15:00,15:15,39.41,34.28,1,40.41,38.41,1,-49437,53410,102847,3973,0,-10694,359,0,0,,11053,-10335
51,12/19/2017,62,15:15,15:30,44.2,34.28,1,45.2,43.2,1,-58357,35080,93437,-23277,0,-50,4362,0,0,,4412,4312
51,12/19/2017,63,15:30,15:45,76.32,,1,77.32,75.32,1,-64510,27878,92388,-36632,0,0,24901,0,0,,24901,24901
51,12/19/2017,64,15:45,16:00,,,1,40.26,38.26,0,-48242,28200,76442,-20042,0,0,5535,0,0,,5535,5535
51,12/19/2017,65,16:00,16:15,,-15.99,1,-14.99,-16.99,-1,-36923,111277,148200,74354,0,-20981,0,0,0,,20981,-20981
51,12/19/2017,66,16:15,16:30,,36.54,1,37.54,35.54,-1,-48615,95169,143784,46554,0,-5880,0,0,0,,5880,-5880
51,12/19/2017,67,16:30,16:45,,19.46,1,20.46,18.46,-1,-40300,99410,139710,59110,0,-15242,0,0,0,,15242,-15242
51,12/19/2017,68,16:45,17:00,,,1,40.26,38.26,0,-76906,91365,168271,14459,0,-2076,0,0,0,,2076,-2076
51,12/19/2017,69,17:00,17:15,,35.54,1,36.54,34.54,-1,-43674,56280,99954,12606,0,-3088,0,0,0,,3088,-3088
51,12/19/2017,70,17:15,17:30,,,1,40.27,38.27,0,-43067,27079,70146,-15988,0,-24,0,0,0,,24,-24
51,12/19/2017,71,17:30,17:45,,,1,40.27,38.27,0,-43590,24150,67740,-19440,0,0,0,0,0,,0,0
51,12/19/2017,72,17:45,18:00,38.54,,1,39.54,37.54,1,-39753,30438,70191,-9315,0,0,821,0,0,,821,821
51,12/19/2017,73,18:00,18:15,44.74,,1,45.74,43.74,1,-91506,18572,110078,-72934,0,0,4287,0,0,,4287,4287
51,12/19/2017,74,18:15,18:30,,,1,40.27,38.27,0,-61758,20242,82000,-41516,0,0,1,0,0,,1,1
51,12/19/2017,75,18:30,18:45,,,1,40.27,38.27,0,-62805,20007,82812,-42798,0,0,0,0,0,,0,0
51,12/19/2017,76,18:45,19:00,42.94,,1,43.94,41.94,1,-51206,23587,74793,-27619,0,0,85,0,0,,85,85
51,12/19/2017,77,19:00,19:15,239.7,,1,240.7,238.7,1,-103303,9431,112734,-93872,0,0,17464,0,0,,17464,17464
51,12/19/2017,78,19:15,19:30,,,1,39.89,37.89,0,-60585,15942,76527,-44643,0,0,893,0,0,,893,893
51,12/19/2017,79,19:30,19:45,,,1,39.86,37.86,0,-54829,26190,81019,-28639,0,0,0,0,0,,0,0
51,12/19/2017,80,19:45,20:00,,35.52,1,36.52,34.52,-1,-40495,43924,84419,3429,0,-7460,0,0,0,,7460,-7460
51,12/19/2017,81,20:00,20:15,43.08,35.52,1,44.08,42.08,1,-75055,57462,132517,-17593,0,-1128,4972,0,0,,6100,3844
51,12/19/2017,82,20:15,20:30,43.08,39.23,1,40.23,38.23,-1,-63637,64712,128349,1075,0,-2,1000,0,0,,1002,998
51,12/19/2017,83,20:30,20:45,,25.04,1,26.04,24.04,-1,-52313,84957,137270,32644,0,-6978,0,0,0,,6978,-6978
51,12/19/2017,84,20:45,21:00,,22.47,1,23.47,21.47,-1,-40008,76197,116205,36189,0,-41026,0,0,0,,41026,-41026
51,12/19/2017,85,21:00,21:15,136.15,32.74,1,137.15,31.74,2,-81133,46812,127945,-34321,0,-21056,7926,0,0,,28982,-13130
51,12/19/2017,86,21:15,21:30,38.16,13.61,1,14.61,12.61,-1,-31049,66509,97558,35460,0,-18614,2978,0,0,,21592,-15636
51,12/19/2017,87,21:30,21:45,,20.54,1,21.54,19.54,-1,-15529,75360,90889,59831,0,-46052,0,0,0,,46052,-46052
51,12/19/2017,88,21:45,22:00,,14.1,1,15.1,13.1,-1,-27984,104480,132464,76496,0,-70235,0,0,0,,70235,-70235
51,12/19/2017,89,22:00,22:15,352.09,13.19,1,353.09,351.09,1,-81294,20632,101926,-60662,0,-37166,5091,0,0,,42257,-32075
51,12/19/2017,90,22:15,22:30,360.09,11.7,1,361.09,10.7,2,-33310,44609,77919,11299,0,-4807,12987,0,0,,17794,8180
51,12/19/2017,91,22:30,22:45,,10.22,1,11.22,9.22,-1,-24789,79517,104306,54728,0,-42038,0,0,0,,42038,-42038
51,12/19/2017,92,22:45,23:00,,10.22,1,11.22,9.22,-1,-22503,103661,126164,81158,0,-63877,0,0,0,,63877,-63877
51,12/19/2017,93,23:00,23:15,42.94,16.2,1,43.94,41.94,1,-66581,50331,116912,-16250,0,-27626,1021,0,0,,28647,-26605
51,12/19/2017,94,23:15,23:30,42.94,30.77,1,31.77,29.77,-1,-50491,64206,114697,13715,0,-2479,135,0,0,,2614,-2344
51,12/19/2017,95,23:30,23:45,,17.38,1,18.38,16.38,-1,-33229,92115,125344,58886,0,-24702,0,0,0,,24702,-24702
51,12/19/2017,96,23:45,0:00,,17.19,1,18.19,16.19,-1,-27175,90381,117556,63206,0,-48936,0,0,0,,48936,-48936
51,12/20/2017,1,0:00,0:15,,7.78,0,7.78,7.78,-1,-54062,115967,170029,61905,0,-56357,0,0,0,,56357,-56357
51,12/20/2017,2,0:15,0:30,,27.26,0,27.26,27.26,-1,-44713,78146,122859,33433,0,-29326,0,0,0,,29326,-29326
51,12/20/2017,3,0:30,0:45,,4.53,0,4.53,4.53,-1,-23331,82315,105646,58984,0,-48431,0,0,0,,48431,-48431
51,12/20/2017,4,0:45,1:00,,13.51,0,13.51,13.51,-1,-37882,109381,147263,71499,0,-52496,0,0,0,,52496,-52496
51,12/20/2017,5,1:00,1:15,49.74,20.78,0,49.74,49.74,1,-35763,26920,62683,-8843,0,-26994,2092,0,0,,29086,-24902
51,12/20/2017,6,1:15,1:30,38.43,,0,38.43,38.43,1,-48181,23866,72047,-24315,0,0,2057,0,0,,2057,2057
51,12/20/2017,7,1:30,1:45,37.85,,0,37.85,37.85,1,-47971,32390,80361,-15581,0,0,306,0,0,,306,306
51,12/20/2017,8,1:45,2:00,,32.52,0,32.52,32.52,-1,-40877,56145,97022,15268,0,-5619,0,0,0,,5619,-5619
51,12/20/2017,9,2:00,2:15,,35.78,0,35.78,35.78,-1,-28669,40579,69248,11910,0,-12469,0,0,0,,12469,-12469
51,12/20/2017,10,2:15,2:30,,35.85,0,35.85,35.85,-1,-31678,42715,74393,11037,0,-12581,0,0,0,,12581,-12581
51,12/20/2017,11,2:30,2:45,37.39,35.85,0,37.39,37.39,1,-50367,44309,94676,-6058,0,-4289,111,0,0,,4400,-4178
51,12/20/2017,12,2:45,3:00,,34.85,0,34.85,34.85,-1,-25774,38101,63875,12327,0,-7017,0,0,0,,7017,-7017
51,12/20/2017,13,3:00,3:15,,35.85,0,35.85,35.85,-1,-23268,26327,49595,3059,0,-9021,0,0,0,,9021,-9021
51,12/20/2017,14,3:15,3:30,,37.16,0,37.16,37.16,-1,-21008,22552,43560,1544,0,-156,0,0,0,,156,-156
51,12/20/2017,15,3:30,3:45,,35.78,0,35.78,35.78,-1,-12653,30158,42811,17505,0,-3440,0,0,0,,3440,-3440
51,12/20/2017,16,3:45,4:00,,17.09,0,17.09,17.09,-1,-12082,41325,53407,29243,0,-19894,0,0,0,,19894,-19894
51,12/20/2017,17,4:00,4:15,,17.78,0,17.78,17.78,-1,-10967,66176,77143,55209,0,-51087,0,0,0,,51087,-51087
51,12/20/2017,18,4:15,4:30,,31.74,0,31.74,31.74,-1,-9124,43491,52615,34367,0,-40997,0,0,0,,40997,-40997
51,12/20/2017,19,4:30,4:45,,35.78,0,35.78,35.78,-1,-13926,26290,40216,12364,0,-17554,0,0,0,,17554,-17554
51,12/20/2017,20,4:45,5:00,,35.85,0,35.85,35.85,-1,-12441,20272,32713,7831,0,-2103,0,0,0,,2103,-2103
51,12/20/2017,21,5:00,5:15,,26.74,0,26.74,26.74,-1,-44541,66983,111524,22442,0,-8175,0,0,0,,8175,-8175
51,12/20/2017,22,5:15,5:30,,25.78,0,25.78,25.78,-1,-35333,52484,87817,17151,0,-25137,0,0,0,,25137,-25137
51,12/20/2017,23,5:30,5:45,38.3,37.39,0,38.3,37.39,2,-38038,16475,54513,-21563,0,-5159,863,0,0,,6022,-4296
51,12/20/2017,24,5:45,6:00,40.02,,0,40.02,40.02,1,-44982,30764,75746,-14218,0,0,919,0,0,,919,919
51,12/20/2017,25,6:00,6:15,37.32,-6.71,0,-6.71,-6.71,-1,-72672,113486,186158,40814,0,-13507,213,0,0,,13720,-13294
51,12/20/2017,26,6:15,6:30,,-9.33,0,-9.33,-9.33,-1,-56666,62884,119550,6218,0,-26469,0,0,0,,26469,-26469
51,12/20/2017,27,6:30,6:45,37.34,-9.33,0,37.34,37.34,1,-69845,30706,100551,-39139,0,-19,131,0,0,,150,112
51,12/20/2017,28,6:45,7:00,38.06,35.34,0,38.58,35.34,2,-128617,21273,149890,-107344,0,-41,670,0,0,,711,629
51,12/20/2017,29,7:00,7:15,,-15.51,0,-15.51,-15.51,-1,-17497,173039,190536,155542,0,-55493,0,0,0,,55493,-55493
51,12/20/2017,30,7:15,7:30,,19.11,0,19.11,19.11,-1,-50278,77152,127430,26874,0,-50900,0,0,0,,50900,-50900
51,12/20/2017,31,7:30,7:45,42.66,19.11,0,42.66,42.66,1,-90148,32117,122265,-58031,0,-3316,583,0,0,,3899,-2733
51,12/20/2017,32,7:45,8:00,322.29,,0,322.29,322.29,1,-147660,25866,173526,-121794,0,0,29823,0,0,,29823,29823
51,12/20/2017,33,8:00,8:15,322.29,5.24,0,5.24,5.24,-1,-20926,74120,95046,53194,0,-8406,14720,0,0,,23126,6314
51,12/20/2017,34,8:15,8:30,37.34,39.81,0,37.34,37.34,1,-58577,50324,108901,-8253,0,-514,3,0,0,,517,-511
51,12/20/2017,35,8:30,8:45,39.4,,0,39.4,39.4,1,-84439,56282,140721,-28157,0,0,2014,0,0,,2014,2014
51,12/20/2017,36,8:45,9:00,49.74,,0,49.74,49.74,1,-95020,46871,141891,-48149,0,0,9291,0,0,,9291,9291
51,12/20/2017,37,9:00,9:15,49.74,37.08,0,37.08,37.08,-1,-62017,77410,139427,15393,0,-486,1404,0,0,,1890,918
51,12/20/2017,38,9:15,9:30,46.69,,0,46.69,46.69,1,-96420,66846,163266,-29574,0,0,1545,0,0,,1545,1545
51,12/20/2017,39,9:30,9:45,46.69,39.44,0,39.44,39.44,-1,-74098,66205,140303,-7893,0,-24,4856,0,0,,4880,4832
51,12/20/2017,40,9:45,10:00,,36.82,0,36.82,36.82,-1,-53714,66966,120680,13252,0,-926,0,0,0,,926,-926
51,12/20/2017,41,10:00,10:15,41,36.82,0,41,41,1,-52089,51433,103522,-656,0,-41,463,0,0,,504,422
51,12/20/2017,42,10:15,10:30,38.87,,0,38.87,38.87,1,-61179,52256,113435,-8923,0,0,710,0,0,,710,710
51,12/20/2017,43,10:30,10:45,38.6,,0,38.6,38.6,1,-63655,48346,112001,-15309,0,0,2676,0,0,,2676,2676
51,12/20/2017,44,10:45,11:00,39.13,,0,39.13,39.13,1,-54547,38748,93295,-15799,0,0,1759,0,0,,1759,1759
51,12/20/2017,45,11:00,11:15,96.12,,0,96.12,96.12,1,-75260,34315,109575,-40945,0,0,22164,0,0,,22164,22164
51,12/20/2017,46,11:15,11:30,46.56,,0,46.56,46.56,1,-64821,36141,100962,-28680,0,0,12660,0,0,,12660,12660
51,12/20/2017,47,11:30,11:45,49.74,,0,49.74,49.74,1,-63287,27274,90561,-36013,0,0,21108,0,0,,21108,21108
51,12/20/2017,48,11:45,12:00,46.56,,0,46.56,46.56,1,-61340,31645,92985,-29695,0,0,24590,0,0,,24590,24590
51,12/20/2017,49,12:00,12:15,229.27,,0,229.27,229.27,1,-95624,17765,113389,-77859,0,0,45087,0,0,,45087,45087
51,12/20/2017,50,12:15,12:30,46.77,38.28,0,38.28,38.28,-1,-76784,61760,138544,-15024,0,-5,18711,0,0,,18716,18706
51,12/20/2017,51,12:30,12:45,37.34,,0,37.34,37.34,1,-76053,74902,150955,-1151,0,0,116,0,0,,116,116
51,12/20/2017,52,12:45,13:00,39.81,,0,39.81,39.81,1,-80967,61032,141999,-19935,0,0,2685,0,0,,2685,2685
51,12/20/2017,53,13:00,13:15,46.03,,0,46.03,46.03,1,-63082,16965,80047,-46117,0,0,2686,0,0,,2686,2686
51,12/20/2017,54,13:15,13:30,39.03,,0,39.03,39.03,1,-81582,13135,94717,-68447,0,0,1156,0,0,,1156,1156
51,12/20/2017,55,13:30,13:45,228.45,,0,228.45,228.45,1,-72651,11876,84527,-60775,0,0,21370,0,0,,21370,21370
51,12/20/2017,56,13:45,14:00,44.74,,0,44.74,44.74,1,-60147,24014,84161,-36133,0,0,13935,0,0,,13935,13935
51,12/20/2017,57,14:00,14:15,44.74,34.11,0,34.11,34.11,-1,-26346,47087,73433,20741,0,-5001,31,0,0,,5032,-4970
51,12/20/2017,58,14:15,14:30,,32,0,32,32,-1,-41047,48401,89448,7354,0,-15518,0,0,0,,15518,-15518
51,12/20/2017,59,14:30,14:45,39.03,38.41,0,39.03,38.41,2,-39717,37974,77691,-1743,0,-2351,736,0,0,,3087,-1615
51,12/20/2017,60,14:45,15:00,,34.34,0,34.34,34.34,-1,-41541,45553,87094,4012,0,-2694,0,0,0,,2694,-2694
51,12/20/2017,61,15:00,15:15,,30,0,30,30,-1,-32880,68804,101684,35924,0,-14557,0,0,0,,14557,-14557
51,12/20/2017,62,15:15,15:30,,29.74,0,29.74,29.74,-1,-34835,56277,91112,21442,0,-26519,0,0,0,,26519,-26519
51,12/20/2017,63,15:30,15:45,,34.34,0,34.34,34.34,-1,-34239,57577,91816,23338,0,-15700,0,0,0,,15700,-15700
51,12/20/2017,64,15:45,16:00,,34.34,0,34.34,34.34,-1,-32454,42998,75452,10544,0,-7323,0,0,0,,7323,-7323
51,12/20/2017,65,16:00,16:15,,-17.92,0,-17.92,-17.92,-1,-52704,94457,147161,41753,0,-41584,0,0,0,,41584,-41584
51,12/20/2017,66,16:15,16:30,,36.78,0,36.78,36.78,-1,-56752,79680,136432,22928,0,-8987,0,0,0,,8987,-8987
51,12/20/2017,67,16:30,16:45,,37.08,0,37.08,37.08,-1,-44543,66090,110633,21547,0,-3190,0,0,0,,3190,-3190
51,12/20/2017,68,16:45,17:00,43.38,37.08,0,43.38,43.38,1,-77216,64094,141310,-13122,0,-15,3113,0,0,,3128,3098
51,12/20/2017,69,17:00,17:15,43.38,24.07,0,24.07,24.07,-1,-45043,77830,122873,32787,0,-9684,975,0,0,,10659,-8709
51,12/20/2017,70,17:15,17:30,,36.23,0,36.23,36.23,-1,-35232,49275,84507,14043,0,-2783,0,0,0,,2783,-2783
51,12/20/2017,71,17:30,17:45,,19.07,0,19.07,19.07,-1,-21600,61185,82785,39585,0,-13018,0,0,0,,13018,-13018
51,12/20/2017,72,17:45,18:00,40.32,17.79,0,40.32,40.32,1,-27241,63872,91113,36631,0,-17447,188,0,0,,17635,-17259
51,12/20/2017,73,18:00,18:15,40.32,38.75,0,38.75,38.75,-1,-63592,16524,80116,-47068,0,-17,7,0,0,,24,-10
51,12/20/2017,74,18:15,18:30,,34.34,0,34.34,34.34,-1,-51062,64742,115804,13680,0,-6845,0,0,0,,6845,-6845
51,12/20/2017,75,18:30,18:45,,5.07,0,5.07,5.07,-1,-36594,89982,126576,53388,0,-31904,0,0,0,,31904,-31904
51,12/20/2017,76,18:45,19:00,,21.2,0,21.2,21.2,-1,-31355,96320,127675,64965,0,-55836,0,0,0,,55836,-55836
51,12/20/2017,77,19:00,19:15,44.74,39.35,0,44.74,38.35,2,-63057,57606,120663,-5451,0,-23105,1074,0,0,,24179,-22031
51,12/20/2017,78,19:15,19:30,44.74,24.11,0,24.11,24.11,-1,-35813,65698,101511,29885,0,-12482,52,0,0,,12534,-12430
51,12/20/2017,79,19:30,19:45,,26.78,0,26.78,26.78,-1,-34559,71353,105912,36794,0,-36051,0,0,0,,36051,-36051
51,12/20/2017,80,19:45,20:00,,29.19,0,29.19,29.19,-1,-40941,93329,134270,52388,0,-36018,0,0,0,,36018,-36018
51,12/20/2017,81,20:00,20:15,151.82,29.19,0,151.82,151.82,1,-63875,22868,86743,-41007,0,-13706,8029,0,0,,21735,-5677
51,12/20/2017,82,20:15,20:30,151.82,35.34,0,35.34,35.34,-1,-43663,53914,97577,10251,0,-2852,2212,0,0,,5064,-640
51,12/20/2017,83,20:30,20:45,,34.34,0,34.34,34.34,-1,-41584,69224,110808,27640,0,-21427,0,0,0,,21427,-21427
51,12/20/2017,84,20:45,21:00,,26.74,0,26.74,26.74,-1,-44409,103510,147919,59101,0,-40828,0,0,0,,40828,-40828
51,12/20/2017,85,21:00,21:15,208.52,34.02,0,208.52,208.52,1,-100755,21896,122651,-78859,0,-18512,11280,0,0,,29792,-7232
51,12/20/2017,86,21:15,21:30,208.52,36.95,0,36.95,36.95,-1,-64804,50975,115779,-13829,0,-36,22640,0,0,,22676,22604
51,12/20/2017,87,21:30,21:45,208.52,28.55,0,28.55,28.55,-1,-44915,87660,132575,42745,0,-5710,151,0,0,,5861,-5559
51,12/20/2017,88,21:45,22:00,,26.74,0,26.74,26.74,-1,-55084,122528,177612,67444,0,-30587,0,0,0,,30587,-30587
51,12/20/2017,89,22:00,22:15,49.7,8.65,0,49.7,8.65,2,-92446,38013,130459,-54433,0,-25003,1647,0,0,,26650,-23356
51,12/20/2017,90,22:15,22:30,49.7,-9.88,0,-9.88,-9.88,-1,-26632,61039,87671,34407,0,-9089,297,0,0,,9386,-8792
51,12/20/2017,91,22:30,22:45,,-8.21,0,-8.21,-8.21,-1,-29619,78417,108036,48798,0,-28602,0,0,0,,28602,-28602
51,12/20/2017,92,22:45,23:00,,17.05,0,17.05,17.05,-1,-57933,118373,176306,60440,0,-28303,0,0,0,,28303,-28303
51,12/20/2017,93,23:00,23:15,183.64,10.78,0,183.64,183.64,1,-107573,50110,157683,-57463,0,-19153,6283,0,0,,25436,-12870
51,12/20/2017,94,23:15,23:30,41.34,,0,41.34,41.34,1,-91905,25716,117621,-66189,0,0,6616,0,0,,6616,6616
51,12/20/2017,95,23:30,23:45,,,0,37.96,37.96,0,-97548,27866,125414,-69682,0,0,0,0,0,,0,0
51,12/20/2017,96,23:45,0:00,,22.76,0,22.76,22.76,-1,-94309,51973,146282,-42336,0,-465,0,0,0,,465,-465
51,12/21/2017,1,0:00,0:15,,-66.91,0,-66.91,-66.91,-1,-17224,178609,195833,161385,0,-35205,0,0,0,,35205,-35205
51,12/21/2017,2,0:15,0:30,31.32,6.85,0,33.23,6.85,2,-32362,46466,78828,14104,0,-4066,8,0,0,,4074,-4058
51,12/21/2017,3,0:30,0:45,,-2.08,0,-2.08,-2.08,-1,-46335,82489,128824,36154,0,-31282,0,0,0,,31282,-31282
51,12/21/2017,4,0:45,1:00,,28.92,0,28.92,28.92,-1,-57859,88182,146041,30323,0,-26045,0,0,0,,26045,-26045
51,12/21/2017,5,1:00,1:15,46.28,17.03,0,46.28,17.03,2,-47782,52486,100268,4704,0,-18269,1240,0,0,,19509,-17029
51,12/21/2017,6,1:15,1:30,46.28,33.9,0,33.9,33.9,-1,-46586,57198,103784,10612,0,-1246,574,0,0,,1820,-672
51,12/21/2017,7,1:30,1:45,,32,0,32,32,-1,-41601,63774,105375,22173,0,-3119,0,0,0,,3119,-3119
51,12/21/2017,8,1:45,2:00,,17.51,0,17.51,17.51,-1,-40498,77766,118264,37268,0,-18364,0,0,0,,18364,-18364
51,12/21/2017,9,2:00,2:15,37.13,29.74,0,37.13,37.13,1,-57202,36275,93477,-20927,0,-16733,496,0,0,,17229,-16237
51,12/21/2017,10,2:15,2:30,,,0,33.2,33.2,0,-38932,33279,72211,-5653,0,0,13,0,0,,13,13
51,12/21/2017,11,2:30,2:45,,,0,33.19,33.19,0,-45463,35137,80600,-10326,0,0,0,0,0,,0,0
51,12/21/2017,12,2:45,3:00,,,0,33.19,33.19,0,-45257,37954,83211,-7303,0,0,0,0,0,,0,0
51,12/21/2017,13,3:00,3:15,,,0,33.17,33.17,0,-40548,37071,77619,-3477,0,0,0,0,0,,0,0
51,12/21/2017,14,3:15,3:30,,,0,33.18,33.18,0,-47676,29570,77246,-18106,0,0,0,0,0,,0,0
51,12/21/2017,15,3:30,3:45,,,0,33.18,33.18,0,-55686,31571,87257,-24115,0,0,0,0,0,,0,0
51,12/21/2017,16,3:45,4:00,,,0,33.19,33.19,0,-57629,39079,96708,-18550,0,0,0,0,0,,0,0
51,12/21/2017,17,4:00,4:15,,35.13,0,35.13,35.13,-1,-43273,48232,91505,4959,0,-923,0,0,0,,923,-923
51,12/21/2017,18,4:15,4:30,,34.13,0,34.13,34.13,-1,-43382,48297,91679,4915,0,-4406,0,0,0,,4406,-4406
51,12/21/2017,19,4:30,4:45,,34.13,0,34.13,34.13,-1,-38278,34316,72594,-3962,0,-3056,0,0,0,,3056,-3056
51,12/21/2017,20,4:45,5:00,,,0,33.21,33.21,0,-45166,35776,80942,-9390,0,0,0,0,0,,0,0
51,12/21/2017,21,5:00,5:15,,4.16,0,4.16,4.16,-1,-50897,97403,148300,46506,0,-18435,0,0,0,,18435,-18435
51,12/21/2017,22,5:15,5:30,,25.03,0,25.03,25.03,-1,-31075,61247,92322,30172,0,-44353,0,0,0,,44353,-44353
51,12/21/2017,23,5:30,5:45,37.13,25.03,0,37.13,37.13,1,-46466,46733,93199,267,0,-9264,192,0,0,,9456,-9072
51,12/21/2017,24,5:45,6:00,39.26,33.47,0,39.26,33.47,2,-37709,40143,77852,2434,0,-213,1705,0,0,,1918,1492
51,12/21/2017,25,6:00,6:15,39.26,-51.03,0,-51.03,-51.03,-1,-29743,113593,143336,83850,0,-45409,17,0,0,,45426,-45392
51,12/21/2017,26,6:15,6:30,,15.44,0,15.44,15.44,-1,-33830,80881,114711,47051,0,-57396,0,0,0,,57396,-57396
51,12/21/2017,27,6:30,6:45,,35.77,0,35.77,35.77,-1,-39673,49113,88786,9440,0,-10473,0,0,0,,10473,-10473
51,12/21/2017,28,6:45,7:00,,30.03,0,30.03,30.03,-1,-26375,99081,125456,72706,0,-904,0,0,0,,904,-904
51,12/21/2017,29,7:00,7:15,,-42.69,0,-42.69,-42.69,-1,-44075,140536,184611,96461,0,-37020,0,0,0,,37020,-37020
51,12/21/2017,30,7:15,7:30,,21.15,0,21.15,21.15,-1,-31301,99278,130579,67977,0,-59029,0,0,0,,59029,-59029
51,12/21/2017,31,7:30,7:45,,33.88,0,33.88,33.88,-1,-21625,58169,79794,36544,0,-34639,0,0,0,,34639,-34639
51,12/21/2017,32,7:45,8:00,41.43,33.88,0,41.43,41.43,1,-77398,44000,121398,-33398,0,-8773,2452,0,0,,11225,-6321
51,12/21/2017,33,8:00,8:15,41.43,26.74,0,26.74,26.74,-1,-31444,64754,96198,33310,0,-11259,323,0,0,,11582,-10936
51,12/21/2017,34,8:15,8:30,36.88,20.61,0,36.88,36.88,1,-64015,49008,113023,-15007,0,-13634,162,0,0,,13796,-13472
51,12/21/2017,35,8:30,8:45,36.88,,0,36.88,36.88,1,-40280,35319,75599,-4961,0,0,874,0,0,,874,874
51,12/21/2017,36,8:45,9:00,,,0,37.69,37.69,0,-44848,25658,70506,-19190,0,0,0,0,0,,0,0
51,12/21/2017,37,9:00,9:15,,37.48,0,37.48,37.48,-1,-61048,61605,122653,557,0,-420,0,0,0,,420,-420
51,12/21/2017,38,9:15,9:30,,35.19,0,35.19,35.19,-1,-41913,47108,89021,5195,0,-1067,0,0,0,,1067,-1067
51,12/21/2017,39,9:30,9:45,,33.88,0,33.88,33.88,-1,-47748,66811,114559,19063,0,-6840,0,0,0,,6840,-6840
51,12/21/2017,40,9:45,10:00,,34.34,0,34.34,34.34,-1,-53492,58272,111764,4780,0,-8881,0,0,0,,8881,-8881
51,12/21/2017,41,10:00,10:15,40.88,34.88,0,40.88,34.88,2,-71435,73068,144503,1633,0,-1484,645,0,0,,2129,-839
51,12/21/2017,42,10:15,10:30,,33.88,0,33.88,33.88,-1,-72238,76453,148691,4215,0,-6349,0,0,0,,6349,-6349
51,12/21/2017,43,10:30,10:45,40.88,,0,40.88,40.88,1,-72514,61977,134491,-10537,0,0,1178,0,0,,1178,1178
51,12/21/2017,44,10:45,11:00,36.88,,0,36.88,36.88,1,-65506,62939,128445,-2567,0,0,127,0,0,,127,127
51,12/21/2017,45,11:00,11:15,,,0,37.7,37.7,0,-56500,65018,121518,8518,0,0,0,0,0,,0,0
51,12/21/2017,46,11:15,11:30,,,0,37.7,37.7,0,-59320,57879,117199,-1441,0,0,0,0,0,,0,0
51,12/21/2017,47,11:30,11:45,38.43,,0,38.43,38.43,1,-62996,58898,121894,-4098,0,0,290,0,0,,290,290
51,12/21/2017,48,11:45,12:00,38.44,,0,38.44,38.44,1,-58703,60307,119010,1604,0,0,2053,0,0,,2053,2053
51,12/21/2017,49,12:00,12:15,37.92,,0,37.92,37.92,1,-65698,67251,132949,1553,0,0,1271,0,0,,1271,1271
51,12/21/2017,50,12:15,12:30,36.88,,0,36.88,36.88,1,-58528,75881,134409,17353,0,0,869,0,0,,869,869
51,12/21/2017,51,12:30,12:45,,,0,37.72,37.72,0,-51114,65112,116226,13998,0,0,0,0,0,,0,0
51,12/21/2017,52,12:45,13:00,,29.81,0,29.81,29.81,-1,-52460,73045,125505,20585,0,-3789,0,0,0,,3789,-3789
51,12/21/2017,53,13:00,13:15,,27.74,0,27.74,27.74,-1,-40522,50800,91322,10278,0,-6446,0,0,0,,6446,-6446
51,12/21/2017,54,13:15,13:30,,36.03,0,36.03,36.03,-1,-38602,40253,78855,1651,0,-1241,0,0,0,,1241,-1241
51,12/21/2017,55,13:30,13:45,,36.39,0,36.39,36.39,-1,-37161,52660,89821,15499,0,-1013,0,0,0,,1013,-1013
51,12/21/2017,56,13:45,14:00,,34.88,0,34.88,34.88,-1,-37634,51335,88969,13701,0,-4863,0,0,0,,4863,-4863
51,12/21/2017,57,14:00,14:15,36.88,38.04,0,36.88,36.88,1,-70401,60696,131097,-9705,0,-1585,33,0,0,,1618,-1552
51,12/21/2017,58,14:15,14:30,,,0,37.69,37.69,0,-53964,58610,112574,4646,0,0,0,0,0,,0,0
51,12/21/2017,59,14:30,14:45,,37.1,0,37.1,37.1,-1,-48126,50989,99115,2863,0,-127,0,0,0,,127,-127
51,12/21/2017,60,14:45,15:00,,36.11,0,36.11,36.11,-1,-46784,67442,114226,20658,0,-1221,0,0,0,,1221,-1221
51,12/21/2017,61,15:00,15:15,,35.3,0,35.3,35.3,-1,-63960,67437,131397,3477,0,-2754,0,0,0,,2754,-2754
51,12/21/2017,62,15:15,15:30,,34.86,0,34.86,34.86,-1,-52144,60581,112725,8437,0,-8166,0,0,0,,8166,-8166
51,12/21/2017,63,15:30,15:45,,37.87,0,37.87,37.87,-1,-48165,55542,103707,7377,0,-978,0,0,0,,978,-978
51,12/21/2017,64,15:45,16:00,,34.88,0,34.88,34.88,-1,-34651,50450,85101,15799,0,-2044,0,0,0,,2044,-2044
51,12/21/2017,65,16:00,16:15,,-42.2,0,-42.2,-42.2,-1,-34014,118100,152114,84086,0,-38811,0,0,0,,38811,-38811
51,12/21/2017,66,16:15,16:30,,29.88,0,29.88,29.88,-1,-46389,85744,132133,39355,0,-34009,0,0,0,,34009,-34009
51,12/21/2017,67,16:30,16:45,,34.03,0,34.03,34.03,-1,-35133,74199,109332,39066,0,-14916,0,0,0,,14916,-14916
51,12/21/2017,68,16:45,17:00,36.88,35.45,0,37.67,35.45,2,-30223,64744,94967,34521,0,-2782,1,0,0,,2783,-2781
51,12/21/2017,69,17:00,17:15,39.55,4.1,0,39.55,4.1,2,-37138,68362,105500,31224,0,-12764,164,0,0,,12928,-12600
51,12/21/2017,70,17:15,17:30,36.88,0.03,0,37.67,0.03,2,-38812,53356,92168,14544,0,-36862,5,0,0,,36867,-36857
51,12/21/2017,71,17:30,17:45,36.88,-12.87,0,37.67,-12.87,2,-9143,65882,75025,56739,0,-18314,232,0,0,,18546,-18082
51,12/21/2017,72,17:45,18:00,,-12.87,0,-12.87,-12.87,-1,-22782,73158,95940,50376,0,-45962,0,0,0,,45962,-45962
51,12/21/2017,73,18:00,18:15,76,24.1,0,76,24.1,2,-39640,46442,86082,6802,0,-9169,1784,0,0,,10953,-7385
51,12/21/2017,74,18:15,18:30,,17.04,0,17.04,17.04,-1,-42253,65443,107696,23190,0,-24093,0,0,0,,24093,-24093
51,12/21/2017,75,18:30,18:45,,31.11,0,31.11,31.11,-1,-46488,76433,122921,29945,0,-18810,0,0,0,,18810,-18810
51,12/21/2017,76,18:45,19:00,,14.1,0,14.1,14.1,-1,-33094,92643,125737,59549,0,-47012,0,0,0,,47012,-47012
51,12/21/2017,77,19:00,19:15,,24.03,0,24.03,24.03,-1,-27277,54555,81832,27278,0,-31340,0,0,0,,31340,-31340
51,12/21/2017,78,19:15,19:30,,24.1,0,24.1,24.1,-1,-20415,44512,64927,24097,0,-4804,0,0,0,,4804,-4804
51,12/21/2017,79,19:30,19:45,,14.1,0,14.1,14.1,-1,-21611,50348,71959,28737,0,-32579,0,0,0,,32579,-32579
51,12/21/2017,80,19:45,20:00,,9.23,0,9.23,9.23,-1,-27266,62272,89538,35006,0,-34620,0,0,0,,34620,-34620
51,12/21/2017,81,20:00,20:15,40.88,-58.37,0,40.88,-58.37,2,-46815,59530,106345,12715,0,-44643,103,0,0,,44746,-44540
51,12/21/2017,82,20:15,20:30,45.02,2.74,0,45.02,2.74,2,-19621,48690,68311,29069,0,-10724,942,0,0,,11666,-9782
51,12/21/2017,83,20:30,20:45,,6.03,0,6.03,6.03,-1,-42023,64721,106744,22698,0,-23838,0,0,0,,23838,-23838
51,12/21/2017,84,20:45,21:00,,10.2,0,10.2,10.2,-1,-36957,84750,121707,47793,0,-46389,0,0,0,,46389,-46389
51,12/21/2017,85,21:00,21:15,106.02,29.74,0,106.02,106.02,1,-74042,49980,124022,-24062,0,-21508,4684,0,0,,26192,-16824
51,12/21/2017,86,21:15,21:30,42.48,22.72,0,22.72,22.72,-1,-29386,42852,72238,13466,0,-3989,6928,0,0,,10917,2939
51,12/21/2017,87,21:30,21:45,42.48,18.41,0,18.41,18.41,-1,-32578,64023,96601,31445,0,-12500,1,0,0,,12501,-12499
51,12/21/2017,88,21:45,22:00,,16.55,0,16.55,16.55,-1,-34265,89919,124184,55654,0,-19559,0,0,0,,19559,-19559
51,12/21/2017,89,22:00,22:15,76.02,34.88,0,76.02,34.88,2,-142774,9359,152133,-133415,0,-7080,3935,0,0,,11015,-3145
51,12/21/2017,90,22:15,22:30,,,0,36.67,36.67,0,-67207,20730,87937,-46477,0,0,48,0,0,,48,48
51,12/21/2017,91,22:30,22:45,38.23,33.88,0,38.23,33.88,2,-40686,43256,83942,2570,0,-299,464,0,0,,763,165
51,12/21/2017,92,22:45,23:00,,8.38,0,8.38,8.38,-1,-33106,96278,129384,63172,0,-10340,0,0,0,,10340,-10340
51,12/21/2017,93,23:00,23:15,58.42,3.09,0,58.42,3.09,2,-113701,6088,119789,-107613,0,-11326,3367,0,0,,14693,-7959
51,12/21/2017,94,23:15,23:30,36.88,,0,36.88,36.88,1,-84631,17493,102124,-67138,0,0,1801,0,0,,1801,1801
51,12/21/2017,95,23:30,23:45,,,0,36.66,36.66,0,-58202,27833,86035,-30369,0,0,21,0,0,,21,21
51,12/21/2017,96,23:45,0:00,,33.88,0,33.88,33.88,-1,-87017,49253,136270,-37764,0,-66,0,0,0,,66,-66
51,12/22/2017,1,0:00,0:15,,25.99,0,25.99,25.99,-1,-67498,134621,202119,67123,0,-2540,0,0,0,,2540,-2540
51,12/22/2017,2,0:15,0:30,37.23,37.59,0,37.23,35.36,2,-55160,51229,106389,-3931,0,-3,792,0,0,,795,789
51,12/22/2017,3,0:30,0:45,,32.78,0,32.78,32.78,-1,-38280,55890,94170,17610,0,-6690,0,0,0,,6690,-6690
51,12/22/2017,4,0:45,1:00,,34.78,0,34.78,34.78,-1,-77904,85319,163223,7415,0,-4980,0,0,0,,4980,-4980
51,12/22/2017,5,1:00,1:15,,16.86,0,16.86,16.86,-1,-37975,55148,93123,17173,0,-16707,0,0,0,,16707,-16707
51,12/22/2017,6,1:15,1:30,36.65,32.74,0,37.09,32.74,2,-59579,47760,107339,-11819,0,-1596,523,0,0,,2119,-1073
51,12/22/2017,7,1:30,1:45,,21.26,0,21.26,21.26,-1,-44491,51682,96173,7191,0,-8059,0,0,0,,8059,-8059
51,12/22/2017,8,1:45,2:00,,33.36,0,33.36,33.36,-1,-58755,64732,123487,5977,0,-2810,0,0,0,,2810,-2810
51,12/22/2017,9,2:00,2:15,37.75,31.78,0,37.75,31.78,2,-42991,57851,100842,14860,0,-4755,458,0,0,,5213,-4297
51,12/22/2017,10,2:15,2:30,37.6,36.45,0,36.45,36.45,-1,-47190,45401,92591,-1789,0,-152,789,0,0,,941,637
51,12/22/2017,11,2:30,2:45,,34.36,0,34.36,34.36,-1,-43301,45237,88538,1936,0,-1121,0,0,0,,1121,-1121
51,12/22/2017,12,2:45,3:00,,32.78,0,32.78,32.78,-1,-41193,48699,89892,7506,0,-4553,0,0,0,,4553,-4553
51,12/22/2017,13,3:00,3:15,,17.78,0,17.78,17.78,-1,-25546,57671,83217,32125,0,-12839,0,0,0,,12839,-12839
51,12/22/2017,14,3:15,3:30,,35.98,0,35.98,35.98,-1,-37775,52310,90085,14535,0,-422,0,0,0,,422,-422
51,12/22/2017,15,3:30,3:45,,21.22,0,21.22,21.22,-1,-16962,53742,70704,36780,0,-19321,0,0,0,,19321,-19321
51,12/22/2017,16,3:45,4:00,,27.33,0,27.33,27.33,-1,-28111,60147,88258,32036,0,-37906,0,0,0,,37906,-37906
51,12/22/2017,17,4:00,4:15,,-13.47,0,-13.47,-13.47,-1,-21226,92945,114171,71719,0,-51707,0,0,0,,51707,-51707
51,12/22/2017,18,4:15,4:30,,14.29,0,14.29,14.29,-1,-26251,63746,89997,37495,0,-22473,0,0,0,,22473,-22473
51,12/22/2017,19,4:30,4:45,,3.52,0,3.52,3.52,-1,-35760,55662,91422,19902,0,-32444,0,0,0,,32444,-32444
51,12/22/2017,20,4:45,5:00,36.65,31.78,0,36.65,31.78,2,-28990,54179,83169,25189,0,-3565,538,0,0,,4103,-3027
51,12/22/2017,21,5:00,5:15,,17.03,0,17.03,17.03,-1,-105028,84599,189627,-20429,0,-2385,0,0,0,,2385,-2385
51,12/22/2017,22,5:15,5:30,,-44.37,0,-44.37,-44.37,-1,-18990,60679,79669,41689,0,-39665,0,0,0,,39665,-39665
51,12/22/2017,23,5:30,5:45,,34.36,0,34.36,34.36,-1,-35931,39512,75443,3581,0,-7839,0,0,0,,7839,-7839
51,12/22/2017,24,5:45,6:00,,-3.42,0,-3.42,-3.42,-1,-22188,80185,102373,57997,0,-11164,0,0,0,,11164,-11164
51,12/22/2017,25,6:00,6:15,,3.2,0,3.2,3.2,-1,-95269,85592,180861,-9677,0,-9720,0,0,0,,9720,-9720
51,12/22/2017,26,6:15,6:30,36.64,-43.75,0,36.64,-43.75,2,-51485,64597,116082,13112,0,-26181,18,0,0,,26199,-26163
51,12/22/2017,27,6:30,6:45,38.12,33.54,0,33.54,33.54,-1,-44880,50478,95358,5598,0,-749,126,0,0,,875,-623
51,12/22/2017,28,6:45,7:00,,33.54,0,33.54,33.54,-1,-47548,49630,97178,2082,0,-7533,0,0,0,,7533,-7533
51,12/22/2017,29,7:00,7:15,,-47.65,0,-47.65,-47.65,-1,-41109,183780,224889,142671,0,-51593,0,0,0,,51593,-51593
51,12/22/2017,30,7:15,7:30,,-16.61,0,-16.61,-16.61,-1,-45453,81564,127017,36111,0,-51374,0,0,0,,51374,-51374
51,12/22/2017,31,7:30,7:45,,33.54,0,33.54,33.54,-1,-29141,40980,70121,11839,0,-4440,0,0,0,,4440,-4440
51,12/22/2017,32,7:45,8:00,39.17,33.54,0,39.17,39.17,1,-72275,25723,97998,-46552,0,-290,213,0,0,,503,-77
51,12/22/2017,33,8:00,8:15,39.03,5.98,0,39.03,5.98,2,-45568,81071,126639,35503,0,-14152,227,0,0,,14379,-13925
51,12/22/2017,34,8:15,8:30,37.55,35.78,0,38.42,35.78,2,-91378,54826,146204,-36552,0,-4842,243,0,0,,5085,-4599
51,12/22/2017,35,8:30,8:45,,,0,38.41,38.41,0,-95534,43687,139221,-51847,0,0,18,0,0,,18,18
51,12/22/2017,36,8:45,9:00,,,0,38.41,38.41,0,-67101,38322,105423,-28779,0,0,0,0,0,,0,0
51,12/22/2017,37,9:00,9:15,,34.54,0,34.54,34.54,-1,-75635,96285,171920,20650,0,-2598,0,0,0,,2598,-2598
51,12/22/2017,38,9:15,9:30,39.93,34.54,0,39.93,39.93,1,-83428,72823,156251,-10605,0,-28,889,0,0,,917,861
51,12/22/2017,39,9:30,9:45,41.33,,0,41.33,41.33,1,-91920,62314,154234,-29606,0,0,3172,0,0,,3172,3172
51,12/22/2017,40,9:45,10:00,51.72,,0,51.72,51.72,1,-97549,50219,147768,-47330,0,0,10376,0,0,,10376,10376
51,12/22/2017,41,10:00,10:15,51.72,10.27,0,10.27,10.27,-1,-38401,88351,126752,49950,0,-8240,1070,0,0,,9310,-7170
51,12/22/2017,42,10:15,10:30,,4.24,0,4.24,4.24,-1,-61078,72066,133144,10988,0,-23854,0,0,0,,23854,-23854
51,12/22/2017,43,10:30,10:45,37.55,29.24,0,38.41,29.24,2,-48099,68644,116743,20545,0,-5352,291,0,0,,5643,-5061
51,12/22/2017,44,10:45,11:00,,28.99,0,28.99,28.99,-1,-69171,75456,144627,6285,0,-9448,0,0,0,,9448,-9448
51,12/22/2017,45,11:00,11:15,,33.54,0,33.54,33.54,-1,-49650,75645,125295,25995,0,-3665,0,0,0,,3665,-3665
51,12/22/2017,46,11:15,11:30,,33.41,0,33.41,33.41,-1,-72338,72693,145031,355,0,-8341,0,0,0,,8341,-8341
51,12/22/2017,47,11:30,11:45,,28.73,0,28.73,28.73,-1,-61729,80245,141974,18516,0,-5159,0,0,0,,5159,-5159
51,12/22/2017,48,11:45,12:00,,25.99,0,25.99,25.99,-1,-75397,89891,165288,14494,0,-19246,0,0,0,,19246,-19246
51,12/22/2017,49,12:00,12:15,39.54,36.26,0,39.54,39.54,1,-67003,73166,140169,6163,0,-6952,1543,0,0,,8495,-5409
51,12/22/2017,50,12:15,12:30,39.54,36.26,0,36.26,36.26,-1,-57303,57112,114415,-191,0,-796,210,0,0,,1006,-586
51,12/22/2017,51,12:30,12:45,,24.24,0,24.24,24.24,-1,-43693,74317,118010,30624,0,-19009,0,0,0,,19009,-19009
51,12/22/2017,52,12:45,13:00,,33.54,0,33.54,33.54,-1,-51597,74181,125778,22584,0,-27355,0,0,0,,27355,-27355
51,12/22/2017,53,13:00,13:15,42.66,33.54,0,42.66,42.66,1,-83701,71521,155222,-12180,0,-4099,2446,0,0,,6545,-1653
51,12/22/2017,54,13:15,13:30,37.55,,0,37.55,37.55,1,-76550,63613,140163,-12937,0,0,1330,0,0,,1330,1330
51,12/22/2017,55,13:30,13:45,,34.54,0,34.54,34.54,-1,-65791,73121,138912,7330,0,-3451,0,0,0,,3451,-3451
51,12/22/2017,56,13:45,14:00,,36.26,0,36.26,36.26,-1,-79096,79806,158902,710,0,-2717,0,0,0,,2717,-2717
51,12/22/2017,57,14:00,14:15,,33.54,0,33.54,33.54,-1,-36049,81053,117102,45004,0,-1871,0,0,0,,1871,-1871
51,12/22/2017,58,14:15,14:30,,28.99,0,28.99,28.99,-1,-43305,83960,127265,40655,0,-15264,0,0,0,,15264,-15264
51,12/22/2017,59,14:30,14:45,,22.16,0,22.16,22.16,-1,-38436,88327,126763,49891,0,-32365,0,0,0,,32365,-32365
51,12/22/2017,60,14:45,15:00,,23.19,0,23.19,23.19,-1,-43922,92212,136134,48290,0,-38402,0,0,0,,38402,-38402
51,12/22/2017,61,15:00,15:15,,33.54,0,33.54,33.54,-1,-47634,80327,127961,32693,0,-21562,0,0,0,,21562,-21562
51,12/22/2017,62,15:15,15:30,,-7.22,0,-7.22,-7.22,-1,-38070,89567,127637,51497,0,-47616,0,0,0,,47616,-47616
51,12/22/2017,63,15:30,15:45,,25.99,0,25.99,25.99,-1,-42360,97622,139982,55262,0,-43052,0,0,0,,43052,-43052
51,12/22/2017,64,15:45,16:00,,34.78,0,34.78,34.78,-1,-60186,89711,149897,29525,0,-14983,0,0,0,,14983,-14983
51,12/22/2017,65,16:00,16:15,,30.99,0,30.99,30.99,-1,-71853,111666,183519,39813,0,-11500,0,0,0,,11500,-11500
51,12/22/2017,66,16:15,16:30,,31.96,0,31.96,31.96,-1,-58489,105971,164460,47482,0,-18549,0,0,0,,18549,-18549
51,12/22/2017,67,16:30,16:45,,8.86,0,8.86,8.86,-1,-44516,100335,144851,55819,0,-35658,0,0,0,,35658,-35658
51,12/22/2017,68,16:45,17:00,37.55,39.26,0,37.55,37.55,1,-64889,73564,138453,8675,0,-9246,31,0,0,,9277,-9215
51,12/22/2017,69,17:00,17:15,,18.59,0,18.59,18.59,-1,-56356,95359,151715,39003,0,-15172,0,0,0,,15172,-15172
51,12/22/2017,70,17:15,17:30,,33.54,0,33.54,33.54,-1,-43971,75526,119497,31555,0,-15761,0,0,0,,15761,-15761
51,12/22/2017,71,17:30,17:45,,9.4,0,9.4,9.4,-1,-29577,90866,120443,61289,0,-31009,0,0,0,,31009,-31009
51,12/22/2017,72,17:45,18:00,,9.4,0,9.4,9.4,-1,-52926,82799,135725,29873,0,-34149,0,0,0,,34149,-34149
51,12/22/2017,73,18:00,18:15,38.22,34.54,0,38.22,34.54,2,-77329,59777,137106,-17552,0,-1335,140,0,0,,1475,-1195
51,12/22/2017,74,18:15,18:30,,28.73,0,28.73,28.73,-1,-41040,69280,110320,28240,0,-12395,0,0,0,,12395,-12395
51,12/22/2017,75,18:30,18:45,,-11.49,0,-11.49,-11.49,-1,-33662,86179,119841,52517,0,-26452,0,0,0,,26452,-26452
51,12/22/2017,76,18:45,19:00,,28.99,0,28.99,28.99,-1,-25731,56906,82637,31175,0,-33507,0,0,0,,33507,-33507
51,12/22/2017,77,19:00,19:15,50.9,34.54,0,50.9,34.54,2,-74366,51704,126070,-22662,0,-10660,2798,0,0,,13458,-7862
51,12/22/2017,78,19:15,19:30,41.55,36.26,0,41.55,36.26,2,-63916,48789,112705,-15127,0,-340,6531,0,0,,6871,6191
51,12/22/2017,79,19:30,19:45,41.55,34.54,0,34.54,34.54,-1,-52855,53676,106531,821,0,-924,68,0,0,,992,-856
51,12/22/2017,80,19:45,20:00,,22.94,0,22.94,22.94,-1,-36712,73179,109891,36467,0,-32863,0,0,0,,32863,-32863
51,12/22/2017,81,20:00,20:15,63.47,33.54,0,63.47,33.54,2,-76760,39872,116632,-36888,0,-16306,1968,0,0,,18274,-14338
51,12/22/2017,82,20:15,20:30,36.82,33.54,0,37.96,33.54,2,-52106,54981,107087,2875,0,-1732,153,0,0,,1885,-1579
51,12/22/2017,83,20:30,20:45,,24.39,0,24.39,24.39,-1,-34480,74267,108747,39787,0,-26418,0,0,0,,26418,-26418
51,12/22/2017,84,20:45,21:00,,6.43,0,6.43,6.43,-1,-21021,98464,119485,77443,0,-60165,0,0,0,,60165,-60165
51,12/22/2017,85,21:00,21:15,46.81,6.43,0,46.81,46.81,1,-90435,36382,126817,-54053,0,-25314,744,0,0,,26058,-24570
51,12/22/2017,86,21:15,21:30,36.82,,0,36.82,36.82,1,-78101,48085,126186,-30016,0,0,166,0,0,,166,166
51,12/22/2017,87,21:30,21:45,,,0,37.81,37.81,0,-70163,61659,131822,-8504,0,0,0,0,0,,0,0
51,12/22/2017,88,21:45,22:00,,34.54,0,34.54,34.54,-1,-57887,96900,154787,39013,0,-502,0,0,0,,502,-502
51,12/22/2017,89,22:00,22:15,,31.5,0,31.5,31.5,-1,-50685,33045,83730,-17640,0,-2954,0,0,0,,2954,-2954
51,12/22/2017,90,22:15,22:30,,34.54,0,34.54,34.54,-1,-40945,22524,63469,-18421,0,-259,0,0,0,,259,-259
51,12/22/2017,91,22:30,22:45,,33.54,0,33.54,33.54,-1,-16376,39932,56308,23556,0,-6604,0,0,0,,6604,-6604
51,12/22/2017,92,22:45,23:00,,34.54,0,34.54,34.54,-1,-26675,65778,92453,39103,0,-17186,0,0,0,,17186,-17186
51,12/22/2017,93,23:00,23:15,87.09,34.78,0,87.09,87.09,1,-90770,31954,122724,-58816,0,-8830,5417,0,0,,14247,-3413
51,12/22/2017,94,23:15,23:30,134.01,34.78,0,134.01,34.78,2,-76002,15826,91828,-60176,0,-188,21560,0,0,,21748,21372
51,12/22/2017,95,23:30,23:45,134.01,33.54,0,33.54,33.54,-1,-29829,39985,69814,10156,0,-4646,333,0,0,,4979,-4313
51,12/22/2017,96,23:45,0:00,,33.54,0,33.54,33.54,-1,-72490,71953,144443,-537,0,-12610,0,0,0,,12610,-12610
52,12/23/2017,1,0:00,0:15,,-39.99,0,-39.99,-39.99,-1,-42250,168709,210959,126459,0,-50488,0,0,0,,50488,-50488
52,12/23/2017,2,0:15,0:30,40.54,-39.99,0,40.54,40.54,1,-54564,35811,90375,-18753,0,-12542,222,0,0,,12764,-12320
52,12/23/2017,3,0:30,0:45,,33.54,0,33.54,33.54,-1,-47591,46883,94474,-708,0,-1396,0,0,0,,1396,-1396
52,12/23/2017,4,0:45,1:00,,32.03,0,32.03,32.03,-1,-67317,60546,127863,-6771,0,-16155,0,0,0,,16155,-16155
52,12/23/2017,5,1:00,1:15,,-52.29,0,-52.29,-52.29,-1,-41234,124327,165561,83093,0,-37155,0,0,0,,37155,-37155
52,12/23/2017,6,1:15,1:30,39.3,34.54,0,39.3,33.98,2,-70225,35602,105827,-34623,0,-6194,502,0,0,,6696,-5692
52,12/23/2017,7,1:30,1:45,,14.68,0,14.68,14.68,-1,-44894,65991,110885,21097,0,-17915,0,0,0,,17915,-17915
52,12/23/2017,8,1:45,2:00,31.12,36.79,0,34.05,34.05,2,-74101,50360,124461,-23741,0,-5469,56,0,0,,5525,-5413
52,12/23/2017,9,2:00,2:15,,33.54,0,33.54,33.54,-1,-51221,68326,119547,17105,0,-1819,0,0,0,,1819,-1819
52,12/23/2017,10,2:15,2:30,,33.54,0,33.54,33.54,-1,-63290,50838,114128,-12452,0,-2343,0,0,0,,2343,-2343
52,12/23/2017,11,2:30,2:45,,34.54,0,34.54,34.54,-1,-81104,68439,149543,-12665,0,-1404,0,0,0,,1404,-1404
52,12/23/2017,12,2:45,3:00,,2.18,0,2.18,2.18,-1,-60613,84771,145384,24158,0,-17399,0,0,0,,17399,-17399
52,12/23/2017,13,3:00,3:15,36.54,27.03,0,36.54,36.54,1,-65520,60821,126341,-4699,0,-16199,146,0,0,,16345,-16053
52,12/23/2017,14,3:15,3:30,36.54,34.54,0,36.54,32.85,2,-67021,58190,125211,-8831,0,-211,351,0,0,,562,140
52,12/23/2017,15,3:30,3:45,,30.07,0,30.07,30.07,-1,-64823,62366,127189,-2457,0,-2620,0,0,0,,2620,-2620
52,12/23/2017,16,3:45,4:00,,27.03,0,27.03,27.03,-1,-52326,71580,123906,19254,0,-16790,0,0,0,,16790,-16790
52,12/23/2017,17,4:00,4:15,,16.01,0,16.01,16.01,-1,-32539,77347,109886,44808,0,-35031,0,0,0,,35031,-35031
52,12/23/2017,18,4:15,4:30,,20.19,0,20.19,20.19,-1,-33646,74690,108336,41044,0,-40868,0,0,0,,40868,-40868
52,12/23/2017,19,4:30,4:45,,23.32,0,23.32,23.32,-1,-39349,77467,116816,38118,0,-39207,0,0,0,,39207,-39207
52,12/23/2017,20,4:45,5:00,,21.23,0,21.23,21.23,-1,-39634,89621,129255,49987,0,-45104,0,0,0,,45104,-45104
52,12/23/2017,21,5:00,5:15,,16.03,0,16.03,16.03,-1,-35529,91213,126742,55684,0,-42927,0,0,0,,42927,-42927
52,12/23/2017,22,5:15,5:30,,-56.72,0,-56.72,-56.72,-1,-39880,86608,126488,46728,0,-51801,0,0,0,,51801,-51801
52,12/23/2017,23,5:30,5:45,,-8.03,0,-8.03,-8.03,-1,-48478,105409,153887,56931,0,-39208,0,0,0,,39208,-39208
52,12/23/2017,24,5:45,6:00,,-17.47,0,-17.47,-17.47,-1,-54114,91790,145904,37676,0,-47190,0,0,0,,47190,-47190
52,12/23/2017,25,6:00,6:15,,27.03,0,27.03,27.03,-1,-62533,96877,159410,34344,0,-32140,0,0,0,,32140,-32140
52,12/23/2017,26,6:15,6:30,,27.03,0,27.03,27.03,-1,-45553,86227,131780,40674,0,-35399,0,0,0,,35399,-35399
52,12/23/2017,27,6:30,6:45,,30,0,30,30,-1,-40110,67903,108013,27793,0,-16260,0,0,0,,16260,-16260
52,12/23/2017,28,6:45,7:00,,29.17,0,29.17,29.17,-1,-38405,68802,107207,30397,0,-2530,0,0,0,,2530,-2530
52,12/23/2017,29,7:00,7:15,,-63.06,0,-63.06,-63.06,-1,-52627,117778,170405,65151,0,-28905,0,0,0,,28905,-28905
52,12/23/2017,30,7:15,7:30,,-53.83,0,-53.83,-53.83,-1,-38922,85563,124485,46641,0,-17060,0,0,0,,17060,-17060
52,12/23/2017,31,7:30,7:45,39.34,-62.86,0,39.34,-62.86,2,-55120,63349,118469,8229,0,-24803,446,0,0,,25249,-24357
52,12/23/2017,32,7:45,8:00,41.1,5.03,0,5.03,5.03,-1,-34691,77202,111893,42511,0,-13331,390,0,0,,13721,-12941
52,12/23/2017,33,8:00,8:15,,8.11,0,8.11,8.11,-1,-52277,106670,158947,54393,0,-50718,0,0,0,,50718,-50718
52,12/23/2017,34,8:15,8:30,97.54,14.66,0,97.54,97.54,1,-85975,72403,158378,-13572,0,-38708,2475,0,0,,41183,-36233
52,12/23/2017,35,8:30,8:45,129.96,-13.45,0,129.96,-13.45,2,-40850,83615,124465,42765,0,-7918,9339,0,0,,17257,1421
52,12/23/2017,36,8:45,9:00,119.65,-37.23,0,119.65,-37.23,2,-70914,49791,120705,-21123,0,-15348,6226,0,0,,21574,-9122
52,12/23/2017,37,9:00,9:15,39.97,,0,39.97,39.97,1,-112061,93281,205342,-18780,0,0,9660,0,0,,9660,9660
52,12/23/2017,38,9:15,9:30,62.97,,0,62.97,62.97,1,-99946,77401,177347,-22545,0,0,13339,0,0,,13339,13339
52,12/23/2017,39,9:30,9:45,65.3,,0,65.3,65.3,1,-90407,67302,157709,-23105,0,0,28208,0,0,,28208,28208
52,12/23/2017,40,9:45,10:00,48.4,,0,48.4,48.4,1,-107668,89255,196923,-18413,0,0,8715,0,0,,8715,8715
52,12/23/2017,41,10:00,10:15,155.59,,0,155.59,155.59,1,-141542,51141,192683,-90401,0,0,55839,0,0,,55839,55839
52,12/23/2017,42,10:15,10:30,72.6,,0,72.6,72.6,1,-104722,57878,162600,-46844,0,0,60524,0,0,,60524,60524
52,12/23/2017,43,10:30,10:45,41.09,,0,41.09,41.09,1,-83948,61673,145621,-22275,0,0,22053,0,0,,22053,22053
52,12/23/2017,44,10:45,11:00,75.11,,0,75.11,75.11,1,-116645,48357,165002,-68288,0,0,30764,0,0,,30764,30764
52,12/23/2017,45,11:00,11:15,66.12,,0,66.12,66.12,1,-85678,56797,142475,-28881,0,0,40872,0,0,,40872,40872
52,12/23/2017,46,11:15,11:30,36.25,,0,36.25,36.25,1,-57211,55696,112907,-1515,0,0,13342,0,0,,13342,13342
52,12/23/2017,47,11:30,11:45,,,0,34.94,34.94,0,-42417,51329,93746,8912,0,0,0,0,0,,0,0
52,12/23/2017,48,11:45,12:00,37.11,,0,37.11,37.11,1,-45909,40724,86633,-5185,0,0,714,0,0,,714,714
52,12/23/2017,49,12:00,12:15,49.18,,0,49.18,49.18,1,-56896,49081,105977,-7815,0,0,7024,0,0,,7024,7024
52,12/23/2017,50,12:15,12:30,49.19,,0,49.19,49.19,1,-60964,41816,102780,-19148,0,0,19636,0,0,,19636,19636
52,12/23/2017,51,12:30,12:45,65.03,,0,65.03,65.03,1,-68887,41046,109933,-27841,0,0,18630,0,0,,18630,18630
52,12/23/2017,52,12:45,13:00,45.46,,0,45.46,45.46,1,-56881,41805,98686,-15076,0,0,24554,0,0,,24554,24554
52,12/23/2017,53,13:00,13:15,62.8,,0,62.8,62.8,1,-84595,40290,124885,-44305,0,0,24638,0,0,,24638,24638
52,12/23/2017,54,13:15,13:30,39.35,,0,39.35,39.35,1,-70518,39402,109920,-31116,0,0,16257,0,0,,16257,16257
52,12/23/2017,55,13:30,13:45,,,0,34.69,34.69,0,-75570,37714,113284,-37856,0,0,319,0,0,,319,319
52,12/23/2017,56,13:45,14:00,,,0,34.69,34.69,0,-61263,41537,102800,-19726,0,0,0,0,0,,0,0
52,12/23/2017,57,14:00,14:15,,37.69,0,37.69,37.69,-1,-57863,59098,116961,1235,0,-85,0,0,0,,85,-85
52,12/23/2017,58,14:15,14:30,,36.9,0,36.9,36.9,-1,-48966,68377,117343,19411,0,-95,0,0,0,,95,-95
52,12/23/2017,59,14:30,14:45,,34.15,0,34.15,34.15,-1,-50374,61070,111444,10696,0,-5258,0,0,0,,5258,-5258
52,12/23/2017,60,14:45,15:00,,34.15,0,34.15,34.15,-1,-53507,45651,99158,-7856,0,-6671,0,0,0,,6671,-6671
52,12/23/2017,61,15:00,15:15,,,0,34.49,34.49,0,-60444,52231,112675,-8213,0,-9,0,0,0,,9,-9
52,12/23/2017,62,15:15,15:30,36.77,,0,36.77,36.77,1,-58873,46821,105694,-12052,0,0,733,0,0,,733,733
52,12/23/2017,63,15:30,15:45,36.92,,0,36.92,36.92,1,-57242,39058,96300,-18184,0,0,889,0,0,,889,889
52,12/23/2017,64,15:45,16:00,36.25,37.62,0,36.25,34.49,2,-43165,57921,101086,14756,0,-3,924,0,0,,927,921
52,12/23/2017,65,16:00,16:15,,10.64,0,10.64,10.64,-1,-34054,118547,152601,84493,0,-13434,0,0,0,,13434,-13434
52,12/23/2017,66,16:15,16:30,,34.15,0,34.15,34.15,-1,-54047,78406,132453,24359,0,-12031,0,0,0,,12031,-12031
52,12/23/2017,67,16:30,16:45,36.25,34.15,0,36.25,36.25,1,-57049,43850,100899,-13199,0,-73,256,0,0,,329,183
52,12/23/2017,68,16:45,17:00,31.94,,0,31.94,31.94,1,-101751,32181,133932,-69570,0,0,291,0,0,,291,291
52,12/23/2017,69,17:00,17:15,,37.95,0,37.95,37.95,-1,-52452,56639,109091,4187,0,-329,0,0,0,,329,-329
52,12/23/2017,70,17:15,17:30,46.97,37.78,0,46.97,46.97,1,-69722,38422,108144,-31300,0,-533,1182,0,0,,1715,649
52,12/23/2017,71,17:30,17:45,63.64,,0,63.64,63.64,1,-63835,29125,92960,-34710,0,0,5470,0,0,,5470,5470
52,12/23/2017,72,17:45,18:00,,,0,35.49,35.49,0,-51390,36372,87762,-15018,0,0,0,0,0,,0,0
52,12/23/2017,73,18:00,18:15,,,0,35.03,35.03,0,-99507,44037,143544,-55470,0,0,0,0,0,,0,0
52,12/23/2017,74,18:15,18:30,,,0,35.05,35.05,0,-86140,47437,133577,-38703,0,0,0,0,0,,0,0
52,12/23/2017,75,18:30,18:45,,35.15,0,35.15,35.15,-1,-67487,63305,130792,-4182,0,-160,0,0,0,,160,-160
52,12/23/2017,76,18:45,19:00,,20.71,0,20.71,20.71,-1,-40173,68093,108266,27920,0,-8542,0,0,0,,8542,-8542
52,12/23/2017,77,19:00,19:15,36.25,13.37,0,36.25,36.25,1,-61875,33452,95327,-28423,0,-10617,186,0,0,,10803,-10431
52,12/23/2017,78,19:15,19:30,36.25,13.37,0,36.25,36.25,1,-54937,30213,85150,-24724,0,-131,1227,0,0,,1358,1096
52,12/23/2017,79,19:30,19:45,,34.15,0,34.15,34.15,-1,-38629,41949,80578,3320,0,-347,0,0,0,,347,-347
52,12/23/2017,80,19:45,20:00,,22.73,0,22.73,22.73,-1,-37052,71677,108729,34625,0,-12184,0,0,0,,12184,-12184
52,12/23/2017,81,20:00,20:15,36.25,34.15,0,36.25,34.15,2,-60081,72335,132416,12254,0,-7615,58,0,0,,7673,-7557
52,12/23/2017,82,20:15,20:30,36.25,34.15,0,36.25,34.15,2,-42028,41172,83200,-856,0,-372,101,0,0,,473,-271
52,12/23/2017,83,20:30,20:45,,32.23,0,32.23,32.23,-1,-36231,60434,96665,24203,0,-4098,0,0,0,,4098,-4098
52,12/23/2017,84,20:45,21:00,,31.46,0,31.46,31.46,-1,-52782,58675,111457,5893,0,-6813,0,0,0,,6813,-6813
52,12/23/2017,85,21:00,21:15,,32.9,0,32.9,32.9,-1,-37793,47225,85018,9432,0,-1674,0,0,0,,1674,-1674
52,12/23/2017,86,21:15,21:30,,19.6,0,19.6,19.6,-1,-41581,50005,91586,8424,0,-10708,0,0,0,,10708,-10708
52,12/23/2017,87,21:30,21:45,,,0,34.31,34.31,0,-66070,52951,119021,-13119,0,-167,0,0,0,,167,-167
52,12/23/2017,88,21:45,22:00,,,0,34.31,34.31,0,-80070,62837,142907,-17233,0,0,0,0,0,,0,0
52,12/23/2017,89,22:00,22:15,,34.15,0,34.15,34.15,-1,-35870,44977,80847,9107,0,-1556,0,0,0,,1556,-1556
52,12/23/2017,90,22:15,22:30,,7.16,0,7.16,7.16,-1,-24534,59079,83613,34545,0,-16505,0,0,0,,16505,-16505
52,12/23/2017,91,22:30,22:45,,-3.97,0,-3.97,-3.97,-1,-34132,68848,102980,34716,0,-38007,0,0,0,,38007,-38007
52,12/23/2017,92,22:45,23:00,,16.85,0,16.85,16.85,-1,-35675,78679,114354,43004,0,-24752,0,0,0,,24752,-24752
52,12/23/2017,93,23:00,23:15,31.87,30.15,0,34.26,30.15,2,-49091,50587,99678,1496,0,-17237,171,0,0,,17408,-17066
52,12/23/2017,94,23:15,23:30,31.87,15.26,0,15.26,15.26,-1,-26599,46069,72668,19470,0,-5318,2,0,0,,5320,-5316
52,12/23/2017,95,23:30,23:45,,10.83,0,10.83,10.83,-1,-36592,77732,114324,41140,0,-37033,0,0,0,,37033,-37033
52,12/23/2017,96,23:45,0:00,,13.71,0,13.71,13.71,-1,-52479,105442,157921,52963,0,-46729,0,0,0,,46729,-46729
52,12/24/2017,1,0:00,0:15,31.5,-54.7,0,34.27,-54.7,2,-50821,61608,112429,10787,0,-35194,25,0,0,,35219,-35169
52,12/24/2017,2,0:15,0:30,36.64,27.94,0,36.64,27.94,2,-45762,64178,109940,18416,0,-3637,585,0,0,,4222,-3052
52,12/24/2017,3,0:30,0:45,,25.43,0,25.43,25.43,-1,-68304,84401,152705,16097,0,-17382,0,0,0,,17382,-17382
52,12/24/2017,4,0:45,1:00,,29.39,0,29.39,29.39,-1,-88132,95534,183666,7402,0,-15091,0,0,0,,15091,-15091
52,12/24/2017,5,1:00,1:15,46.64,-0.26,0,46.64,-0.26,2,-39201,53759,92960,14558,0,-18175,478,0,0,,18653,-17697
52,12/24/2017,6,1:15,1:30,46.64,33.64,0,33.64,33.64,-1,-58701,63549,122250,4848,0,-652,1114,0,0,,1766,462
52,12/24/2017,7,1:30,1:45,,12.66,0,12.66,12.66,-1,-52608,85304,137912,32696,0,-11328,0,0,0,,11328,-11328
52,12/24/2017,8,1:45,2:00,,14.28,0,14.28,14.28,-1,-87786,96201,183987,8415,0,-26623,0,0,0,,26623,-26623
52,12/24/2017,9,2:00,2:15,,33.64,0,33.64,33.64,-1,-36390,87413,123803,51023,0,-10271,0,0,0,,10271,-10271
52,12/24/2017,10,2:15,2:30,,-18.14,0,-18.14,-18.14,-1,-36929,86176,123105,49247,0,-22527,0,0,0,,22527,-22527
52,12/24/2017,11,2:30,2:45,,-66.1,0,-66.1,-66.1,-1,-68122,88904,157026,20782,0,-33051,0,0,0,,33051,-33051
52,12/24/2017,12,2:45,3:00,,-69.17,0,-69.17,-69.17,-1,-63264,110757,174021,47493,0,-26067,0,0,0,,26067,-26067
52,12/24/2017,13,3:00,3:15,,18.09,0,18.09,18.09,-1,-57931,85513,143444,27582,0,-13909,0,0,0,,13909,-13909
52,12/24/2017,14,3:15,3:30,,3.14,0,3.14,3.14,-1,-57992,88045,146037,30053,0,-23403,0,0,0,,23403,-23403
52,12/24/2017,15,3:30,3:45,,28.64,0,28.64,28.64,-1,-66034,85310,151344,19276,0,-20468,0,0,0,,20468,-20468
52,12/24/2017,16,3:45,4:00,,14.23,0,14.23,14.23,-1,-53657,83798,137455,30141,0,-17786,0,0,0,,17786,-17786
52,12/24/2017,17,4:00,4:15,,0.14,0,0.14,0.14,-1,-31907,71329,103236,39422,0,-27068,0,0,0,,27068,-27068
52,12/24/2017,18,4:15,4:30,,17.14,0,17.14,17.14,-1,-30059,68537,98596,38478,0,-28176,0,0,0,,28176,-28176
52,12/24/2017,19,4:30,4:45,,21.31,0,21.31,21.31,-1,-30349,74470,104819,44121,0,-25569,0,0,0,,25569,-25569
52,12/24/2017,20,4:45,5:00,,6.14,0,6.14,6.14,-1,-34363,71710,106073,37347,0,-28259,0,0,0,,28259,-28259
52,12/24/2017,21,5:00,5:15,,3.14,0,3.14,3.14,-1,-46562,91300,137862,44738,0,-41452,0,0,0,,41452,-41452
52,12/24/2017,22,5:15,5:30,,18.88,0,18.88,18.88,-1,-47662,75562,123224,27900,0,-38571,0,0,0,,38571,-38571
52,12/24/2017,23,5:30,5:45,,18.84,0,18.84,18.84,-1,-46788,72304,119092,25516,0,-28148,0,0,0,,28148,-28148
52,12/24/2017,24,5:45,6:00,,18.84,0,18.84,18.84,-1,-49630,79755,129385,30125,0,-36097,0,0,0,,36097,-36097
52,12/24/2017,25,6:00,6:15,,22.43,0,22.43,22.43,-1,-60356,78880,139236,18524,0,-23772,0,0,0,,23772,-23772
52,12/24/2017,26,6:15,6:30,,28.77,0,28.77,28.77,-1,-49381,67532,116913,18151,0,-18531,0,0,0,,18531,-18531
52,12/24/2017,27,6:30,6:45,44.41,32.77,0,44.41,32.77,2,-66246,51485,117731,-14761,0,-8549,2699,0,0,,11248,-5850
52,12/24/2017,28,6:45,7:00,36.77,32.77,0,36.77,36.77,1,-65069,54632,119701,-10437,0,-4,3479,0,0,,3483,3475
52,12/24/2017,29,7:00,7:15,41.39,,0,41.39,41.39,1,-120703,61336,182039,-59367,0,0,9254,0,0,,9254,9254
52,12/24/2017,30,7:15,7:30,67.88,,0,67.88,67.88,1,-102739,46534,149273,-56205,0,0,21747,0,0,,21747,21747
52,12/24/2017,31,7:30,7:45,40.31,28.77,0,28.77,28.77,-1,-65676,31222,96898,-34454,0,-70,10240,0,0,,10310,10170
52,12/24/2017,32,7:45,8:00,,10.45,0,10.45,10.45,-1,-46604,74394,120998,27790,0,-12353,0,0,0,,12353,-12353
52,12/24/2017,33,8:00,8:15,,34.58,0,34.58,34.58,-1,-77250,67771,145021,-9479,0,-3028,0,0,0,,3028,-3028
52,12/24/2017,34,8:15,8:30,,,0,34.71,34.71,0,-53140,36837,89977,-16303,0,0,0,0,0,,0,0
52,12/24/2017,35,8:30,8:45,,,0,34.7,34.7,0,-44614,31606,76220,-13008,0,0,0,0,0,,0,0
52,12/24/2017,36,8:45,9:00,38.75,,0,38.75,38.75,1,-58677,38211,96888,-20466,0,0,281,0,0,,281,281
52,12/24/2017,37,9:00,9:15,36.58,,0,36.58,36.58,1,-48217,43420,91637,-4797,0,0,120,0,0,,120,120
52,12/24/2017,38,9:15,9:30,133.12,,0,133.12,133.12,1,-72747,19140,91887,-53607,0,0,28817,0,0,,28817,28817
52,12/24/2017,39,9:30,9:45,133.12,,0,133.12,133.12,1,-72252,23817,96069,-48435,0,0,56884,0,0,,56884,56884
52,12/24/2017,40,9:45,10:00,50.86,,0,50.86,50.86,1,-94338,46449,140787,-47889,0,0,41104,0,0,,41104,41104
52,12/24/2017,41,10:00,10:15,40.66,29.53,0,29.53,29.53,-1,-54871,61286,116157,6415,0,-1494,20586,0,0,,22080,19092
52,12/24/2017,42,10:15,10:30,110.55,29.53,0,110.55,110.55,1,-77676,35745,113421,-41931,0,-672,11911,0,0,,12583,11239
52,12/24/2017,43,10:30,10:45,133.12,,0,133.12,133.12,1,-79859,39423,119282,-40436,0,0,44630,0,0,,44630,44630
52,12/24/2017,44,10:45,11:00,55.12,,0,55.12,55.12,1,-74497,28939,103436,-45558,0,0,32736,0,0,,32736,32736
52,12/24/2017,45,11:00,11:15,81.17,,0,81.17,81.17,1,-114340,47066,161406,-67274,0,0,42758,0,0,,42758,42758
52,12/24/2017,46,11:15,11:30,51,,0,51,51,1,-84067,50013,134080,-34054,0,0,39150,0,0,,39150,39150
52,12/24/2017,47,11:30,11:45,44.31,,0,44.31,44.31,1,-96000,45084,141084,-50916,0,0,10727,0,0,,10727,10727
52,12/24/2017,48,11:45,12:00,62.68,,0,62.68,62.68,1,-95926,37528,133454,-58398,0,0,30220,0,0,,30220,30220
52,12/24/2017,49,12:00,12:15,143.23,,0,143.23,143.23,1,-103828,34534,138362,-69294,0,0,42489,0,0,,42489,42489
52,12/24/2017,50,12:15,12:30,60.5,,0,60.5,60.5,1,-82548,44030,126578,-38518,0,0,51493,0,0,,51493,51493
52,12/24/2017,51,12:30,12:45,40.66,,0,40.66,40.66,1,-70908,47330,118238,-23578,0,0,26480,0,0,,26480,26480
52,12/24/2017,52,12:45,13:00,54,,0,54,54,1,-75967,38760,114727,-37207,0,0,26691,0,0,,26691,26691
52,12/24/2017,53,13:00,13:15,143.12,,0,143.12,143.12,1,-75297,29901,105198,-45396,0,0,38845,0,0,,38845,38845
52,12/24/2017,54,13:15,13:30,45.41,,0,45.41,45.41,1,-73102,28495,101597,-44607,0,0,33201,0,0,,33201,33201
52,12/24/2017,55,13:30,13:45,133.12,,0,133.12,133.12,1,-89160,34513,123673,-54647,0,0,39833,0,0,,39833,39833
52,12/24/2017,56,13:45,14:00,50.09,36.39,0,36.39,36.39,-1,-67329,47783,115112,-19546,0,-21,25057,0,0,,25078,25036
52,12/24/2017,57,14:00,14:15,50.09,34.58,0,34.58,34.58,-1,-41290,101395,142685,60105,0,-1458,90,0,0,,1548,-1368
52,12/24/2017,58,14:15,14:30,,37.94,0,37.94,37.94,-1,-48793,91978,140771,43185,0,-235,0,0,0,,235,-235
52,12/24/2017,59,14:30,14:45,,,0,35.53,35.53,0,-40333,101604,141937,61271,0,0,0,0,0,,0,0
52,12/24/2017,60,14:45,15:00,,,0,35.52,35.52,0,-45760,94123,139883,48363,0,0,0,0,0,,0,0
52,12/24/2017,61,15:00,15:15,,,0,35.5,35.5,0,-25339,92378,117717,67039,0,0,0,0,0,,0,0
52,12/24/2017,62,15:15,15:30,,,0,35.49,35.49,0,-30856,101893,132749,71037,0,0,0,0,0,,0,0
52,12/24/2017,63,15:30,15:45,,,0,35.5,35.5,0,-27164,112332,139496,85168,0,0,0,0,0,,0,0
52,12/24/2017,64,15:45,16:00,,29.77,0,29.77,29.77,-1,-27905,145871,173776,117966,0,-7145,0,0,0,,7145,-7145
52,12/24/2017,65,16:00,16:15,37.75,-22.78,0,37.75,-22.78,2,-49183,57960,107143,8777,0,-14616,230,0,0,,14846,-14386
52,12/24/2017,66,16:15,16:30,38.08,29.77,0,38.08,29.77,2,-23626,75624,99250,51998,0,-4862,117,0,0,,4979,-4745
52,12/24/2017,67,16:30,16:45,,-9.48,0,-9.48,-9.48,-1,-32060,80213,112273,48153,0,-25047,0,0,0,,25047,-25047
52,12/24/2017,68,16:45,17:00,40.66,-9.48,0,40.66,40.66,1,-74472,66083,140555,-8389,0,-4763,738,0,0,,5501,-4025
52,12/24/2017,69,17:00,17:15,,33.73,0,33.73,33.73,-1,-54224,61683,115907,7459,0,-860,0,0,0,,860,-860
52,12/24/2017,70,17:15,17:30,,14.52,0,14.52,14.52,-1,-61044,76594,137638,15550,0,-14339,0,0,0,,14339,-14339
52,12/24/2017,71,17:30,17:45,36.64,29.77,0,36.64,29.77,2,-53285,78751,132036,25466,0,-4565,16,0,0,,4581,-4549
52,12/24/2017,72,17:45,18:00,,20.89,0,20.89,20.89,-1,-53038,82831,135869,29793,0,-30117,0,0,0,,30117,-30117
52,12/24/2017,73,18:00,18:15,,-22.78,0,-22.78,-22.78,-1,-55048,112995,168043,57947,0,-33399,0,0,0,,33399,-33399
52,12/24/2017,74,18:15,18:30,,20.24,0,20.24,20.24,-1,-53891,95913,149804,42022,0,-36089,0,0,0,,36089,-36089
52,12/24/2017,75,18:30,18:45,,3.9,0,3.9,3.9,-1,-54824,109877,164701,55053,0,-48215,0,0,0,,48215,-48215
52,12/24/2017,76,18:45,19:00,,0.52,0,0.52,0.52,-1,-44116,122982,167098,78866,0,-57336,0,0,0,,57336,-57336
52,12/24/2017,77,19:00,19:15,39.76,-8.2,0,39.76,-8.2,2,-64742,82589,147331,17847,0,-43695,128,0,0,,43823,-43567
52,12/24/2017,78,19:15,19:30,40.09,7.11,0,40.09,7.11,2,-63242,84162,147404,20920,0,-11335,961,0,0,,12296,-10374
52,12/24/2017,79,19:30,19:45,,8.11,0,8.11,8.11,-1,-77819,84402,162221,6583,0,-20162,0,0,0,,20162,-20162
52,12/24/2017,80,19:45,20:00,,16.03,0,16.03,16.03,-1,-91684,104793,196477,13109,0,-9699,0,0,0,,9699,-9699
52,12/24/2017,81,20:00,20:15,,8.96,0,8.96,8.96,-1,-33023,85326,118349,52303,0,-32150,0,0,0,,32150,-32150
52,12/24/2017,82,20:15,20:30,,6.16,0,6.16,6.16,-1,-30857,82353,113210,51496,0,-42518,0,0,0,,42518,-42518
52,12/24/2017,83,20:30,20:45,,6.16,0,6.16,6.16,-1,-39416,81800,121216,42384,0,-49082,0,0,0,,49082,-49082
52,12/24/2017,84,20:45,21:00,,22.24,0,22.24,22.24,-1,-48569,88941,137510,40372,0,-39545,0,0,0,,39545,-39545
52,12/24/2017,85,21:00,21:15,,25.09,0,25.09,25.09,-1,-45082,59892,104974,14810,0,-23610,0,0,0,,23610,-23610
52,12/24/2017,86,21:15,21:30,40.25,29.49,0,40.25,29.49,2,-49285,57996,107281,8711,0,-1039,41,0,0,,1080,-998
52,12/24/2017,87,21:30,21:45,,9.48,0,9.48,9.48,-1,-39019,84789,123808,45770,0,-22347,0,0,0,,22347,-22347
52,12/24/2017,88,21:45,22:00,,9.58,0,9.58,9.58,-1,-45266,90134,135400,44868,0,-38694,0,0,0,,38694,-38694
52,12/24/2017,89,22:00,22:15,,25.09,0,25.09,25.09,-1,-72044,82010,154054,9966,0,-19233,0,0,0,,19233,-19233
52,12/24/2017,90,22:15,22:30,,34.58,0,34.58,34.58,-1,-75162,57609,132771,-17553,0,-3545,0,0,0,,3545,-3545
52,12/24/2017,91,22:30,22:45,,,0,34.21,34.21,0,-61543,68371,129914,6828,0,-18,0,0,0,,18,-18
52,12/24/2017,92,22:45,23:00,,,0,34.24,34.24,0,-57656,59922,117578,2266,0,0,0,0,0,,0,0
52,12/24/2017,93,23:00,23:15,,,0,34.87,34.87,0,-55750,26707,82457,-29043,0,0,0,0,0,,0,0
52,12/24/2017,94,23:15,23:30,,,0,34.86,34.86,0,-59722,30860,90582,-28862,0,0,0,0,0,,0,0
52,12/24/2017,95,23:30,23:45,,,0,34.86,34.86,0,-55487,42731,98218,-12756,0,0,0,0,0,,0,0
52,12/24/2017,96,23:45,0:00,36.58,,0,36.58,36.58,1,-74746,53775,128521,-20971,0,0,420,0,0,,420,420
52,12/25/2017,1,0:00,0:15,,,0,33.15,33.15,0,-77849,61139,138988,-16710,0,0,0,0,0,,0,0
52,12/25/2017,2,0:15,0:30,40.66,,0,40.66,40.66,1,-61751,23027,84778,-38724,0,0,3808,0,0,,3808,3808
52,12/25/2017,3,0:30,0:45,49.06,,0,49.06,49.06,1,-87484,33044,120528,-54440,0,0,13347,0,0,,13347,13347
52,12/25/2017,4,0:45,1:00,,,0,34.29,34.29,0,-129510,60835,190345,-68675,0,0,3327,0,0,,3327,3327
52,12/25/2017,5,1:00,1:15,75.65,,0,75.65,75.65,1,-78068,41708,119776,-36360,0,0,8875,0,0,,8875,8875
52,12/25/2017,6,1:15,1:30,75.24,,0,75.24,75.24,1,-71242,43195,114437,-28047,0,0,34689,0,0,,34689,34689
52,12/25/2017,7,1:30,1:45,75.24,25.63,0,25.63,25.63,-1,-45692,58696,104388,13004,0,-1727,4001,0,0,,5728,2274
52,12/25/2017,8,1:45,2:00,,33.58,0,33.58,33.58,-1,-70425,59265,129690,-11160,0,-876,0,0,0,,876,-876
52,12/25/2017,9,2:00,2:15,124.02,,0,124.02,124.02,1,-83222,28558,111780,-54664,0,0,14443,0,0,,14443,14443
52,12/25/2017,10,2:15,2:30,124.02,,0,124.02,124.02,1,-70435,22902,93337,-47533,0,0,60349,0,0,,60349,60349
52,12/25/2017,11,2:30,2:45,31.49,29.58,0,33.97,29.58,2,-45782,44126,89908,-1656,0,-859,8711,0,0,,9570,7852
52,12/25/2017,12,2:45,3:00,31.47,36.3,0,33.98,33.98,2,-46865,45151,92016,-1714,0,-20,84,0,0,,104,64
52,12/25/2017,13,3:00,3:15,,34.58,0,34.58,34.58,-1,-37314,53011,90325,15697,0,-1535,0,0,0,,1535,-1535
52,12/25/2017,14,3:15,3:30,,36.13,0,36.13,36.13,-1,-47859,52091,99950,4232,0,-225,0,0,0,,225,-225
52,12/25/2017,15,3:30,3:45,,34.58,0,34.58,34.58,-1,-33762,60549,94311,26787,0,-678,0,0,0,,678,-678
52,12/25/2017,16,3:45,4:00,,0.71,0,0.71,0.71,-1,-34499,63131,97630,28632,0,-21669,0,0,0,,21669,-21669
52,12/25/2017,17,4:00,4:15,,26.18,0,26.18,26.18,-1,-50266,54113,104379,3847,0,-16347,0,0,0,,16347,-16347
52,12/25/2017,18,4:15,4:30,,26.17,0,26.17,26.17,-1,-45285,50151,95436,4866,0,-9399,0,0,0,,9399,-9399
52,12/25/2017,19,4:30,4:45,32.58,36.04,0,33.79,33.79,2,-55348,50449,105797,-4899,0,-1714,299,0,0,,2013,-1415
52,12/25/2017,20,4:45,5:00,31.86,,0,31.86,31.86,1,-52306,45427,97733,-6879,0,0,166,0,0,,166,166
52,12/25/2017,21,5:00,5:15,36.58,,0,36.58,36.58,1,-59841,46448,106289,-13393,0,0,3015,0,0,,3015,3015
52,12/25/2017,22,5:15,5:30,31.92,,0,31.92,31.92,1,-41770,43313,85083,1543,0,0,1940,0,0,,1940,1940
52,12/25/2017,23,5:30,5:45,36.58,,0,36.58,36.58,1,-39349,36101,75450,-3248,0,0,1530,0,0,,1530,1530
52,12/25/2017,24,5:45,6:00,43.62,,0,43.62,43.62,1,-55131,31806,86937,-23325,0,0,20984,0,0,,20984,20984
52,12/25/2017,25,6:00,6:15,42.35,,0,42.35,42.35,1,-64133,40136,104269,-23997,0,0,20707,0,0,,20707,20707
52,12/25/2017,26,6:15,6:30,46.77,,0,46.77,46.77,1,-64593,36872,101465,-27721,0,0,22460,0,0,,22460,22460
52,12/25/2017,27,6:30,6:45,40.66,,0,40.66,40.66,1,-57915,37774,95689,-20141,0,0,9988,0,0,,9988,9988
52,12/25/2017,28,6:45,7:00,41.63,,0,41.63,41.63,1,-65647,39848,105495,-25799,0,0,13966,0,0,,13966,13966
52,12/25/2017,29,7:00,7:15,38.32,,0,38.32,38.32,1,-75767,54489,130256,-21278,0,0,8155,0,0,,8155,8155
52,12/25/2017,30,7:15,7:30,31.9,,0,31.9,31.9,1,-52093,39683,91776,-12410,0,0,746,0,0,,746,746
52,12/25/2017,31,7:30,7:45,43.27,,0,43.27,43.27,1,-69955,45549,115504,-24406,0,0,5945,0,0,,5945,5945
52,12/25/2017,32,7:45,8:00,85.25,,0,85.25,85.25,1,-93400,43038,136438,-50362,0,0,22111,0,0,,22111,22111
52,12/25/2017,33,8:00,8:15,85.25,-69.05,0,-69.05,-69.05,-1,-43594,87589,131183,43995,0,-14343,6855,0,0,,21198,-7488
52,12/25/2017,34,8:15,8:30,,34.58,0,34.58,34.58,-1,-42134,51655,93789,9521,0,-5560,0,0,0,,5560,-5560
52,12/25/2017,35,8:30,8:45,40.66,34.58,0,40.66,40.66,1,-60301,46783,107084,-13518,0,-384,4619,0,0,,5003,4235
52,12/25/2017,36,8:45,9:00,49.07,33.58,0,49.07,33.58,2,-73905,54230,128135,-19675,0,-37,17014,0,0,,17051,16977
52,12/25/2017,37,9:00,9:15,49.07,21.1,0,21.1,21.1,-1,-27492,113784,141276,86292,0,-7191,3412,0,0,,10603,-3779
52,12/25/2017,38,9:15,9:30,,26.03,0,26.03,26.03,-1,-27125,71944,99069,44819,0,-9953,0,0,0,,9953,-9953
52,12/25/2017,39,9:30,9:45,,,0,35.07,35.07,0,-41550,47150,88700,5600,0,-538,0,0,0,,538,-538
52,12/25/2017,40,9:45,10:00,40.66,,0,40.66,40.66,1,-55095,45246,100341,-9849,0,0,2283,0,0,,2283,2283
52,12/25/2017,41,10:00,10:15,40.66,38.08,0,38.08,38.08,-1,-40835,52249,93084,11414,0,-99,96,0,0,,195,-3
52,12/25/2017,42,10:15,10:30,,37.1,0,37.1,37.1,-1,-49785,55041,104826,5256,0,-1085,0,0,0,,1085,-1085
52,12/25/2017,43,10:30,10:45,,38.31,0,38.31,38.31,-1,-55579,50673,106252,-4906,0,-66,0,0,0,,66,-66
52,12/25/2017,44,10:45,11:00,36.58,,0,36.58,36.58,1,-57373,53300,110673,-4073,0,0,675,0,0,,675,675
52,12/25/2017,45,11:00,11:15,36.58,33.99,0,33.99,33.99,-1,-46046,65999,112045,19953,0,-2575,7,0,0,,2582,-2568
52,12/25/2017,46,11:15,11:30,,34.58,0,34.58,34.58,-1,-54296,57680,111976,3384,0,-3925,0,0,0,,3925,-3925
52,12/25/2017,47,11:30,11:45,,35.23,0,35.23,35.23,-1,-57610,63549,121159,5939,0,-2506,0,0,0,,2506,-2506
52,12/25/2017,48,11:45,12:00,,34.58,0,34.58,34.58,-1,-53613,64810,118423,11197,0,-1925,0,0,0,,1925,-1925
52,12/25/2017,49,12:00,12:15,,37.95,0,37.95,37.95,-1,-60880,58983,119863,-1897,0,-936,0,0,0,,936,-936
52,12/25/2017,50,12:15,12:30,38.24,,0,38.24,38.24,1,-67642,55265,122907,-12377,0,0,610,0,0,,610,610
52,12/25/2017,51,12:30,12:45,43.91,,0,43.91,43.91,1,-67503,49749,117252,-17754,0,0,9739,0,0,,9739,9739
52,12/25/2017,52,12:45,13:00,40.66,,0,40.66,40.66,1,-74606,43392,117998,-31214,0,0,17945,0,0,,17945,17945
52,12/25/2017,53,13:00,13:15,85.58,,0,85.58,85.58,1,-92663,48225,140888,-44438,0,0,27012,0,0,,27012,27012
52,12/25/2017,54,13:15,13:30,44.22,,0,44.22,44.22,1,-77105,60760,137865,-16345,0,0,30189,0,0,,30189,30189
52,12/25/2017,55,13:30,13:45,,,0,35.17,35.17,0,-65325,60308,125633,-5017,0,0,6493,0,0,,6493,6493
52,12/25/2017,56,13:45,14:00,38.35,35.78,0,38.35,35.16,2,-61338,47178,108516,-14160,0,-29,718,0,0,,747,689
52,12/25/2017,57,14:00,14:15,,33.2,0,33.2,33.2,-1,-35833,58848,94681,23015,0,-1008,0,0,0,,1008,-1008
52,12/25/2017,58,14:15,14:30,,,0,35.17,35.17,0,-51479,52623,104102,1144,0,0,0,0,0,,0,0
52,12/25/2017,59,14:30,14:45,36.58,,0,36.58,36.58,1,-45164,53454,98618,8290,0,0,457,0,0,,457,457
52,12/25/2017,60,14:45,15:00,32.02,34.58,0,34.58,34.58,-1,-41889,48445,90334,6556,0,-1301,30,0,0,,1331,-1271
52,12/25/2017,61,15:00,15:15,,33.58,0,33.58,33.58,-1,-44900,85561,130461,40661,0,-3831,0,0,0,,3831,-3831
52,12/25/2017,62,15:15,15:30,,37.52,0,37.52,37.52,-1,-36805,84284,121089,47479,0,-42,0,0,0,,42,-42
52,12/25/2017,63,15:30,15:45,,34.58,0,34.58,34.58,-1,-34315,85284,119599,50969,0,-183,0,0,0,,183,-183
52,12/25/2017,64,15:45,16:00,,,0,34.93,34.93,0,-33233,79630,112863,46397,0,0,0,0,0,,0,0
52,12/25/2017,65,16:00,16:15,,,0,35.2,35.2,0,-17108,81713,98821,64605,0,0,0,0,0,,0,0
52,12/25/2017,66,16:15,16:30,,,0,35.2,35.2,0,-19236,71323,90559,52087,0,0,0,0,0,,0,0
52,12/25/2017,67,16:30,16:45,,17.36,0,17.36,17.36,-1,-35776,61937,97713,26161,0,-11951,0,0,0,,11951,-11951
52,12/25/2017,68,16:45,17:00,46.77,17.36,0,46.77,46.77,1,-81924,67872,149796,-14052,0,-1136,5009,0,0,,6145,3873
52,12/25/2017,69,17:00,17:15,46.77,18.63,0,18.63,18.63,-1,-51632,99149,150781,47517,0,-13554,970,0,0,,14524,-12584
52,12/25/2017,70,17:15,17:30,,33.58,0,33.58,33.58,-1,-66886,93021,159907,26135,0,-24399,0,0,0,,24399,-24399
52,12/25/2017,71,17:30,17:45,,,0,35.17,35.17,0,-76374,83774,160148,7400,0,-6001,0,0,0,,6001,-6001
52,12/25/2017,72,17:45,18:00,42.96,,0,42.96,42.96,1,-73060,69516,142576,-3544,0,0,1470,0,0,,1470,1470
52,12/25/2017,73,18:00,18:15,50.21,34.48,0,50.21,34.48,2,-63205,58507,121712,-4698,0,-881,4470,0,0,,5351,3589
52,12/25/2017,74,18:15,18:30,,26.03,0,26.03,26.03,-1,-46566,97241,143807,50675,0,-2567,0,0,0,,2567,-2567
52,12/25/2017,75,18:30,18:45,,15.83,0,15.83,15.83,-1,-33641,107921,141562,74280,0,-29649,0,0,0,,29649,-29649
52,12/25/2017,76,18:45,19:00,,22.31,0,22.31,22.31,-1,-49013,123174,172187,74161,0,-40936,0,0,0,,40936,-40936
52,12/25/2017,77,19:00,19:15,,27.6,0,27.6,27.6,-1,-68901,79596,148497,10695,0,-21646,0,0,0,,21646,-21646
52,12/25/2017,78,19:15,19:30,,15.66,0,15.66,15.66,-1,-57352,99490,156842,42138,0,-12315,0,0,0,,12315,-12315
52,12/25/2017,79,19:30,19:45,,16.06,0,16.06,16.06,-1,-53732,110643,164375,56911,0,-39974,0,0,0,,39974,-39974
52,12/25/2017,80,19:45,20:00,,11.99,0,11.99,11.99,-1,-65326,132322,197648,66996,0,-49982,0,0,0,,49982,-49982
52,12/25/2017,81,20:00,20:15,,27.21,0,27.21,27.21,-1,-40057,80249,120306,40192,0,-18002,0,0,0,,18002,-18002
52,12/25/2017,82,20:15,20:30,,12.03,0,12.03,12.03,-1,-51481,78487,129968,27006,0,-23434,0,0,0,,23434,-23434
52,12/25/2017,83,20:30,20:45,,24.44,0,24.44,24.44,-1,-48314,78961,127275,30647,0,-19778,0,0,0,,19778,-19778
52,12/25/2017,84,20:45,21:00,,19.3,0,19.3,19.3,-1,-60371,100760,161131,40389,0,-38638,0,0,0,,38638,-38638
52,12/25/2017,85,21:00,21:15,40.63,29.58,0,40.63,40.63,1,-43772,58795,102567,15023,0,-18414,630,0,0,,19044,-17784
52,12/25/2017,86,21:15,21:30,,,0,35.49,35.49,0,-54808,72865,127673,18057,0,-53,127,0,0,,180,74
52,12/25/2017,87,21:30,21:45,,27.03,0,27.03,27.03,-1,-44666,83458,128124,38792,0,-6538,0,0,0,,6538,-6538
52,12/25/2017,88,21:45,22:00,,15.17,0,15.17,15.17,-1,-59220,89385,148605,30165,0,-31629,0,0,0,,31629,-31629
52,12/25/2017,89,22:00,22:15,46.77,15.17,0,46.77,46.77,1,-67597,31792,99389,-35805,0,-8228,2646,0,0,,10874,-5582
52,12/25/2017,90,22:15,22:30,,,0,35.36,35.36,0,-43804,43700,87504,-104,0,0,67,0,0,,67,67
52,12/25/2017,91,22:30,22:45,,,0,35.39,35.39,0,-38269,75453,113722,37184,0,0,0,0,0,,0,0
52,12/25/2017,92,22:45,23:00,,,0,35.4,35.4,0,-29989,81454,111443,51465,0,0,0,0,0,,0,0
52,12/25/2017,93,23:00,23:15,,,0,34.74,34.74,0,-29945,43807,73752,13862,0,0,0,0,0,,0,0
52,12/25/2017,94,23:15,23:30,,37.04,0,37.04,37.04,-1,-42794,48855,91649,6061,0,-14,0,0,0,,14,-14
52,12/25/2017,95,23:30,23:45,,34.58,0,34.58,34.58,-1,-36818,80274,117092,43456,0,-81,0,0,0,,81,-81
52,12/25/2017,96,23:45,0:00,,,0,34.73,34.73,0,-79746,90938,170684,11192,0,0,0,0,0,,0,0
52,12/26/2017,1,0:00,0:15,,34.58,0,34.58,34.58,-1,-42540,85800,128340,43260,0,-202,0,0,0,,202,-202
52,12/26/2017,2,0:15,0:30,,12.03,0,12.03,12.03,-1,-28049,65217,93266,37168,0,-3135,0,0,0,,3135,-3135
52,12/26/2017,3,0:30,0:45,57.01,-70.27,0,57.01,-70.27,2,-53484,49676,103160,-3808,0,-28693,990,0,0,,29683,-27703
52,12/26/2017,4,0:45,1:00,57.01,-0.08,0,-0.08,-0.08,-1,-69472,98641,168113,29169,0,-19476,498,0,0,,19974,-18978
52,12/26/2017,5,1:00,1:15,,18.32,0,18.32,18.32,-1,-44405,64767,109172,20362,0,-22411,0,0,0,,22411,-22411
52,12/26/2017,6,1:15,1:30,,33.58,0,33.58,33.58,-1,-47510,76771,124281,29261,0,-371,0,0,0,,371,-371
52,12/26/2017,7,1:30,1:45,,21.08,0,21.08,21.08,-1,-37102,74910,112012,37808,0,-6425,0,0,0,,6425,-6425
52,12/26/2017,8,1:45,2:00,,-17.63,0,-17.63,-17.63,-1,-45868,81614,127482,35746,0,-31360,0,0,0,,31360,-31360
52,12/26/2017,9,2:00,2:15,,,0,34.1,34.1,0,-56532,60031,116563,3499,0,-3352,0,0,0,,3352,-3352
52,12/26/2017,10,2:15,2:30,,,0,34.1,34.1,0,-40691,60609,101300,19918,0,0,0,0,0,,0,0
52,12/26/2017,11,2:30,2:45,,,0,34.1,34.1,0,-38360,69279,107639,30919,0,0,0,0,0,,0,0
52,12/26/2017,12,2:45,3:00,,,0,34.1,34.1,0,-32583,76039,108622,43456,0,0,0,0,0,,0,0
52,12/26/2017,13,3:00,3:15,,,0,33.95,33.95,0,-49355,50846,100201,1491,0,0,0,0,0,,0,0
52,12/26/2017,14,3:15,3:30,,,0,33.95,33.95,0,-47673,54062,101735,6389,0,0,0,0,0,,0,0
52,12/26/2017,15,3:30,3:45,32.29,,0,32.29,32.29,1,-44544,55085,99629,10541,0,0,616,0,0,,616,616
52,12/26/2017,16,3:45,4:00,31.39,,0,31.39,31.39,1,-37090,59733,96823,22643,0,0,56,0,0,,56,56
52,12/26/2017,17,4:00,4:15,,,0,33.91,33.91,0,-17986,56367,74353,38381,0,0,0,0,0,,0,0
52,12/26/2017,18,4:15,4:30,,,0,33.91,33.91,0,-22471,55424,77895,32953,0,0,0,0,0,,0,0
52,12/26/2017,19,4:30,4:45,,,0,33.91,33.91,0,-21794,55677,77471,33883,0,0,0,0,0,,0,0
52,12/26/2017,20,4:45,5:00,,,0,33.91,33.91,0,-28091,60695,88786,32604,0,0,0,0,0,,0,0
52,12/26/2017,21,5:00,5:15,,,0,33.94,33.94,0,-16818,93712,110530,76894,0,0,0,0,0,,0,0
52,12/26/2017,22,5:15,5:30,,,0,33.94,33.94,0,-18890,88810,107700,69920,0,0,0,0,0,,0,0
52,12/26/2017,23,5:30,5:45,,,0,33.94,33.94,0,-27166,84424,111590,57258,0,0,0,0,0,,0,0
52,12/26/2017,24,5:45,6:00,,35.8,0,35.8,35.8,-1,-20583,79706,100289,59123,0,-350,0,0,0,,350,-350
52,12/26/2017,25,6:00,6:15,,36.42,0,36.42,36.42,-1,-39952,106054,146006,66102,0,-432,0,0,0,,432,-432
52,12/26/2017,26,6:15,6:30,,,0,34.53,34.53,0,-29094,100132,129226,71038,0,0,0,0,0,,0,0
52,12/26/2017,27,6:30,6:45,,34.58,0,34.58,34.58,-1,-32945,85181,118126,52236,0,-151,0,0,0,,151,-151
52,12/26/2017,28,6:45,7:00,,33.58,0,33.58,33.58,-1,-42229,56652,98881,14423,0,-830,0,0,0,,830,-830
52,12/26/2017,29,7:00,7:15,,6.73,0,6.73,6.73,-1,-71454,93390,164844,21936,0,-9605,0,0,0,,9605,-9605
52,12/26/2017,30,7:15,7:30,,14.72,0,14.72,14.72,-1,-71552,83378,154930,11826,0,-14408,0,0,0,,14408,-14408
52,12/26/2017,31,7:30,7:45,40.66,14.72,0,40.66,40.66,1,-77399,67732,145131,-9667,0,-369,461,0,0,,830,92
52,12/26/2017,32,7:45,8:00,59.96,,0,59.96,59.96,1,-71569,49236,120805,-22333,0,0,21799,0,0,,21799,21799
52,12/26/2017,33,8:00,8:15,40.66,35,0,35,35,-1,-97062,66962,164024,-30100,0,-437,14543,0,0,,14980,14106
52,12/26/2017,34,8:15,8:30,36.58,35,0,36.58,36.58,1,-62678,56567,119245,-6111,0,-163,177,0,0,,340,14
52,12/26/2017,35,8:30,8:45,63.08,,0,63.08,63.08,1,-92335,40107,132442,-52228,0,0,15163,0,0,,15163,15163
52,12/26/2017,36,8:45,9:00,39.27,,0,39.27,39.27,1,-81753,44858,126611,-36895,0,0,11003,0,0,,11003,11003
52,12/26/2017,37,9:00,9:15,63.09,,0,63.09,63.09,1,-136389,53376,189765,-83013,0,0,8530,0,0,,8530,8530
52,12/26/2017,38,9:15,9:30,39.07,,0,39.07,39.07,1,-106179,48064,154243,-58115,0,0,9688,0,0,,9688,9688
52,12/26/2017,39,9:30,9:45,63.09,,0,63.09,63.09,1,-129442,38777,168219,-90665,0,0,5121,0,0,,5121,5121
52,12/26/2017,40,9:45,10:00,276.08,,0,276.08,276.08,1,-138690,44629,183319,-94061,0,0,35925,0,0,,35925,35925
52,12/26/2017,41,10:00,10:15,41.03,,0,41.03,41.03,1,-90457,73311,163768,-17146,0,0,15057,0,0,,15057,15057
52,12/26/2017,42,10:15,10:30,40.52,,0,40.52,40.52,1,-103303,54924,158227,-48379,0,0,18993,0,0,,18993,18993
52,12/26/2017,43,10:30,10:45,143.52,,0,143.52,143.52,1,-119510,51763,171273,-67747,0,0,38349,0,0,,38349,38349
52,12/26/2017,44,10:45,11:00,40.52,,0,40.52,40.52,1,-113350,60639,173989,-52711,0,0,17977,0,0,,17977,17977
52,12/26/2017,45,11:00,11:15,33.06,,0,33.06,33.06,1,-81133,72538,153671,-8595,0,0,126,0,0,,126,126
52,12/26/2017,46,11:15,11:30,,34.58,0,34.58,34.58,-1,-59854,67045,126899,7191,0,-2508,0,0,0,,2508,-2508
52,12/26/2017,47,11:30,11:45,,37.92,0,37.92,37.92,-1,-73864,60189,134053,-13675,0,-736,0,0,0,,736,-736
52,12/26/2017,48,11:45,12:00,35.69,,0,35.69,35.69,1,-82030,64342,146372,-17688,0,0,259,0,0,,259,259
52,12/26/2017,49,12:00,12:15,35.69,,0,35.69,35.69,1,-74574,57003,131577,-17571,0,0,1799,0,0,,1799,1799
52,12/26/2017,50,12:15,12:30,32.66,,0,32.66,32.66,1,-73415,65742,139157,-7673,0,0,1133,0,0,,1133,1133
52,12/26/2017,51,12:30,12:45,,,0,35.42,35.42,0,-71577,68976,140553,-2601,0,0,0,0,0,,0,0
52,12/26/2017,52,12:45,13:00,,24.08,0,24.08,24.08,-1,-62337,81498,143835,19161,0,-5604,0,0,0,,5604,-5604
52,12/26/2017,53,13:00,13:15,63.08,19.37,0,63.08,19.37,2,-64893,48696,113589,-16197,0,-11196,2107,0,0,,13303,-9089
52,12/26/2017,54,13:15,13:30,113.99,28.83,0,113.99,28.83,2,-56406,54659,111065,-1747,0,-1620,9269,0,0,,10889,7649
52,12/26/2017,55,13:30,13:45,35.69,21.72,0,35.69,21.72,2,-62109,62956,125065,847,0,-9881,25,0,0,,9906,-9856
52,12/26/2017,56,13:45,14:00,40.52,21.72,0,40.52,40.52,1,-64114,69812,133926,5698,0,-88,2459,0,0,,2547,2371
52,12/26/2017,57,14:00,14:15,,28.17,0,28.17,28.17,-1,-52130,79862,131992,27732,0,-4911,0,0,0,,4911,-4911
52,12/26/2017,58,14:15,14:30,,,0,35.35,35.35,0,-63462,75540,139002,12078,0,-804,0,0,0,,804,-804
52,12/26/2017,59,14:30,14:45,,,0,35.35,35.35,0,-68108,76172,144280,8064,0,0,0,0,0,,0,0
52,12/26/2017,60,14:45,15:00,,36.58,0,36.58,36.58,-1,-71202,75982,147184,4780,0,-340,0,0,0,,340,-340
52,12/26/2017,61,15:00,15:15,,16.76,0,16.76,16.76,-1,-71763,101171,172934,29408,0,-11543,0,0,0,,11543,-11543
52,12/26/2017,62,15:15,15:30,,32.58,0,32.58,32.58,-1,-74575,99607,174182,25032,0,-21385,0,0,0,,21385,-21385
52,12/26/2017,63,15:30,15:45,,34.58,0,34.58,34.58,-1,-67640,89309,156949,21669,0,-9446,0,0,0,,9446,-9446
52,12/26/2017,64,15:45,16:00,,34.58,0,34.58,34.58,-1,-65003,75917,140920,10914,0,-6502,0,0,0,,6502,-6502
52,12/26/2017,65,16:00,16:15,,15.53,0,15.53,15.53,-1,-47620,108197,155817,60577,0,-20562,0,0,0,,20562,-20562
52,12/26/2017,66,16:15,16:30,,34.52,0,34.52,34.52,-1,-63803,92977,156780,29174,0,-12040,0,0,0,,12040,-12040
52,12/26/2017,67,16:30,16:45,59.06,36.22,0,59.06,59.06,1,-95216,70955,166171,-24261,0,-2877,1587,0,0,,4464,-1290
52,12/26/2017,68,16:45,17:00,238.8,,0,238.8,238.8,1,-159382,51760,211142,-107622,0,0,51070,0,0,,51070,51070
52,12/26/2017,69,17:00,17:15,264.97,-0.34,0,-0.34,-0.34,-1,-63239,103623,166862,40384,0,-5614,35860,0,0,,41474,30246
52,12/26/2017,70,17:15,17:30,39.64,38.12,0,39.64,36.61,2,-63953,64388,128341,435,0,-1447,585,0,0,,2032,-862
52,12/26/2017,71,17:30,17:45,39.88,,0,39.88,39.88,1,-51500,57380,108880,5880,0,0,225,0,0,,225,225
52,12/26/2017,72,17:45,18:00,40.52,,0,40.52,40.52,1,-52682,59428,112110,6746,0,0,2779,0,0,,2779,2779
52,12/26/2017,73,18:00,18:15,40.76,29.58,0,29.58,29.58,-1,-58049,63898,121947,5849,0,-4629,1254,0,0,,5883,-3375
52,12/26/2017,74,18:15,18:30,,25.08,0,25.08,25.08,-1,-59321,67819,127140,8498,0,-14873,0,0,0,,14873,-14873
52,12/26/2017,75,18:30,18:45,,34.58,0,34.58,34.58,-1,-61874,72927,134801,11053,0,-3558,0,0,0,,3558,-3558
52,12/26/2017,76,18:45,19:00,,19.49,0,19.49,19.49,-1,-57279,85189,142468,27910,0,-8788,0,0,0,,8788,-8788
52,12/26/2017,77,19:00,19:15,40.52,19.22,0,40.52,19.22,2,-60737,57894,118631,-2843,0,-10558,518,0,0,,11076,-10040
52,12/26/2017,78,19:15,19:30,,33.58,0,33.58,33.58,-1,-60032,76009,136041,15977,0,-549,0,0,0,,549,-549
52,12/26/2017,79,19:30,19:45,,21.78,0,21.78,21.78,-1,-57403,101464,158867,44061,0,-19092,0,0,0,,19092,-19092
52,12/26/2017,80,19:45,20:00,,28.2,0,28.2,28.2,-1,-55732,92499,148231,36767,0,-27976,0,0,0,,27976,-27976
52,12/26/2017,81,20:00,20:15,115.12,34.58,0,115.12,115.12,1,-63582,46969,110551,-16613,0,-11628,4720,0,0,,16348,-6908
52,12/26/2017,82,20:15,20:30,133.12,37.77,0,133.12,35.64,2,-66470,54779,121249,-11691,0,-3,23360,0,0,,23363,23357
52,12/26/2017,83,20:30,20:45,133.12,33.58,0,33.58,33.58,-1,-61862,65698,127560,3836,0,-1240,2029,0,0,,3269,789
52,12/26/2017,84,20:45,21:00,,28.78,0,28.78,28.78,-1,-57053,72165,129218,15112,0,-2134,0,0,0,,2134,-2134
52,12/26/2017,85,21:00,21:15,60.9,19.57,0,60.9,19.57,2,-72377,49692,122069,-22685,0,-6640,1818,0,0,,8458,-4822
52,12/26/2017,86,21:15,21:30,87.28,,0,87.28,87.28,1,-79989,49590,129579,-30399,0,0,17232,0,0,,17232,17232
52,12/26/2017,87,21:30,21:45,45.44,,0,45.44,45.44,1,-86501,56749,143250,-29752,0,0,8825,0,0,,8825,8825
52,12/26/2017,88,21:45,22:00,38.99,,0,38.99,38.99,1,-84478,57365,141843,-27113,0,0,11090,0,0,,11090,11090
52,12/26/2017,89,22:00,22:15,143.54,,0,143.54,143.54,1,-106430,37113,143543,-69317,0,0,16914,0,0,,16914,16914
52,12/26/2017,90,22:15,22:30,42.2,,0,42.2,42.2,1,-77629,55100,132729,-22529,0,0,17754,0,0,,17754,17754
52,12/26/2017,91,22:30,22:45,65.54,,0,65.54,65.54,1,-89798,68752,158550,-21046,0,0,5218,0,0,,5218,5218
52,12/26/2017,92,22:45,23:00,69.12,,0,69.12,69.12,1,-124567,98003,222570,-26564,0,0,20096,0,0,,20096,20096
52,12/26/2017,93,23:00,23:15,214.47,,0,214.47,214.47,1,-118685,52311,170996,-66374,0,0,31883,0,0,,31883,31883
52,12/26/2017,94,23:15,23:30,214.47,34.73,0,34.73,34.73,-1,-90967,52916,143883,-38051,0,-90,38831,0,0,,38921,38741
52,12/26/2017,95,23:30,23:45,214.47,28.78,0,28.78,28.78,-1,-79923,84404,164327,4481,0,-2572,1574,0,0,,4146,-998
52,12/26/2017,96,23:45,0:00,,2.78,0,2.78,2.78,-1,-71800,84064,155864,12264,0,-26185,0,0,0,,26185,-26185
52,12/27/2017,1,0:00,0:15,,-67.78,0,-67.78,-67.78,-1,-67012,199882,266894,132870,0,-68443,0,0,0,,68443,-68443
52,12/27/2017,2,0:15,0:30,,5.8,0,5.8,5.8,-1,-79531,114969,194500,35438,0,-14416,0,0,0,,14416,-14416
52,12/27/2017,3,0:30,0:45,,-67.78,0,-67.78,-67.78,-1,-65379,83463,148842,18084,0,-23894,0,0,0,,23894,-23894
52,12/27/2017,4,0:45,1:00,,-67.78,0,-67.78,-67.78,-1,-67397,129362,196759,61965,0,-32803,0,0,0,,32803,-32803
52,12/27/2017,5,1:00,1:15,32.13,3.09,0,33.76,3.09,2,-24511,89845,114356,65334,0,-25215,18,0,0,,25233,-25197
52,12/27/2017,6,1:15,1:30,40.02,27.31,0,40.02,27.31,2,-48677,74299,122976,25622,0,-2067,745,0,0,,2812,-1322
52,12/27/2017,7,1:30,1:45,,22.3,0,22.3,22.3,-1,-30348,98723,129071,68375,0,-12720,0,0,0,,12720,-12720
52,12/27/2017,8,1:45,2:00,,-62.3,0,-62.3,-62.3,-1,-63217,115869,179086,52652,0,-29441,0,0,0,,29441,-29441
52,12/27/2017,9,2:00,2:15,,34.16,0,34.16,34.16,-1,-71652,111064,182716,39412,0,-6395,0,0,0,,6395,-6395
52,12/27/2017,10,2:15,2:30,,23.93,0,23.93,23.93,-1,-70244,96193,166437,25949,0,-8825,0,0,0,,8825,-8825
52,12/27/2017,11,2:30,2:45,,13.93,0,13.93,13.93,-1,-65624,103701,169325,38077,0,-21718,0,0,0,,21718,-21718
52,12/27/2017,12,2:45,3:00,,3.49,0,3.49,3.49,-1,-74678,112368,187046,37690,0,-38826,0,0,0,,38826,-38826
52,12/27/2017,13,3:00,3:15,36.58,27.64,0,36.58,36.58,1,-91477,81134,172611,-10343,0,-15625,1345,0,0,,16970,-14280
52,12/27/2017,14,3:15,3:30,36.58,25.62,0,25.62,25.62,-1,-72752,83738,156490,10986,0,-2632,13,0,0,,2645,-2619
52,12/27/2017,15,3:30,3:45,,28.48,0,28.48,28.48,-1,-65924,80854,146778,14930,0,-4031,0,0,0,,4031,-4031
52,12/27/2017,16,3:45,4:00,,26.03,0,26.03,26.03,-1,-65992,87015,153007,21023,0,-6718,0,0,0,,6718,-6718
52,12/27/2017,17,4:00,4:15,,27.74,0,27.74,27.74,-1,-87345,89529,176874,2184,0,-3737,0,0,0,,3737,-3737
52,12/27/2017,18,4:15,4:30,,,0,33.51,33.51,0,-68605,93937,162542,25332,0,-2,0,0,0,,2,-2
52,12/27/2017,19,4:30,4:45,,34.9,0,34.9,34.9,-1,-53045,102545,155590,49500,0,-669,0,0,0,,669,-669
52,12/27/2017,20,4:45,5:00,,26.03,0,26.03,26.03,-1,-65307,94494,159801,29187,0,-3586,0,0,0,,3586,-3586
52,12/27/2017,21,5:00,5:15,,26.03,0,26.03,26.03,-1,-56363,147310,203673,90947,0,-3408,0,0,0,,3408,-3408
52,12/27/2017,22,5:15,5:30,,-86.71,0,-86.71,-86.71,-1,-58884,128453,187337,69569,0,-33921,0,0,0,,33921,-33921
52,12/27/2017,23,5:30,5:45,,6.03,0,6.03,6.03,-1,-73888,94735,168623,20847,0,-27686,0,0,0,,27686,-27686
52,12/27/2017,24,5:45,6:00,,-86.71,0,-86.71,-86.71,-1,-65711,123040,188751,57329,0,-27198,0,0,0,,27198,-27198
52,12/27/2017,25,6:00,6:15,,26.03,0,26.03,26.03,-1,-91465,120037,211502,28572,0,-23477,0,0,0,,23477,-23477
52,12/27/2017,26,6:15,6:30,,24.7,0,24.7,24.7,-1,-83898,108211,192109,24313,0,-22954,0,0,0,,22954,-22954
52,12/27/2017,27,6:30,6:45,,30.03,0,30.03,30.03,-1,-98561,104011,202572,5450,0,-18412,0,0,0,,18412,-18412
52,12/27/2017,28,6:45,7:00,33.58,13.81,0,34.5,13.81,2,-103554,164611,268165,61057,0,-4645,663,0,0,,5308,-3982
52,12/27/2017,29,7:00,7:15,56.77,32.71,0,56.77,32.71,2,-131507,104598,236105,-26909,0,-633,4493,0,0,,5126,3860
52,12/27/2017,30,7:15,7:30,39.1,21.9,0,39.1,21.9,2,-118400,115066,233466,-3334,0,-3664,1095,0,0,,4759,-2569
52,12/27/2017,31,7:30,7:45,,33.79,0,33.79,33.79,-1,-85220,90611,175831,5391,0,-2522,0,0,0,,2522,-2522
52,12/27/2017,32,7:45,8:00,40.79,33.79,0,40.79,40.79,1,-87698,87827,175525,129,0,-18,3159,0,0,,3177,3141
52,12/27/2017,33,8:00,8:15,38.26,-2.98,0,-2.98,-2.98,-1,-63652,88032,151684,24380,0,-6747,3256,0,0,,10003,-3491
52,12/27/2017,34,8:15,8:30,50.26,-33.02,0,50.26,-33.02,2,-100184,103195,203379,3011,0,-27071,1015,0,0,,28086,-26056
52,12/27/2017,35,8:30,8:45,36.05,-33.02,0,36.05,36.05,1,-94126,84839,178965,-9287,0,-2,986,0,0,,988,984
52,12/27/2017,36,8:45,9:00,,,0,35.6,35.6,0,-103399,84241,187640,-19158,0,0,0,0,0,,0,0
52,12/27/2017,37,9:00,9:15,,37.81,0,37.81,37.81,-1,-30730,85389,116119,54659,0,-301,0,0,0,,301,-301
52,12/27/2017,38,9:15,9:30,,37.67,0,37.67,37.67,-1,-51864,89788,141652,37924,0,-578,0,0,0,,578,-578
52,12/27/2017,39,9:30,9:45,,38.16,0,38.16,38.16,-1,-65276,69190,134466,3914,0,-60,0,0,0,,60,-60
52,12/27/2017,40,9:45,10:00,,,0,37.11,37.11,0,-88725,60942,149667,-27783,0,0,0,0,0,,0,0
52,12/27/2017,41,10:00,10:15,,18.94,0,18.94,18.94,-1,-66190,98806,164996,32616,0,-11884,0,0,0,,11884,-11884
52,12/27/2017,42,10:15,10:30,,,0,37.12,37.12,0,-97564,72457,170021,-25107,0,-1337,0,0,0,,1337,-1337
52,12/27/2017,43,10:30,10:45,,,0,37.11,37.11,0,-107860,60375,168235,-47485,0,0,0,0,0,,0,0
52,12/27/2017,44,10:45,11:00,43.62,,0,43.62,43.62,1,-126916,40015,166931,-86901,0,0,3245,0,0,,3245,3245
52,12/27/2017,45,11:00,11:15,56.22,,0,56.22,56.22,1,-103981,50029,154010,-53952,0,0,17491,0,0,,17491,17491
52,12/27/2017,46,11:15,11:30,54.24,,0,54.24,54.24,1,-129391,53526,182917,-75865,0,0,12985,0,0,,12985,12985
52,12/27/2017,47,11:30,11:45,73.92,,0,73.92,73.92,1,-119697,61374,181071,-58323,0,0,26998,0,0,,26998,26998
52,12/27/2017,48,11:45,12:00,50.67,,0,50.67,50.67,1,-129414,66759,196173,-62655,0,0,22187,0,0,,22187,22187
52,12/27/2017,49,12:00,12:15,38.15,,0,38.15,38.15,1,-91276,66563,157839,-24713,0,0,19319,0,0,,19319,19319
52,12/27/2017,50,12:15,12:30,43.26,,0,43.26,43.26,1,-113662,60416,174078,-53246,0,0,18105,0,0,,18105,18105
52,12/27/2017,51,12:30,12:45,49.85,,0,49.85,49.85,1,-115240,62658,177898,-52582,0,0,29674,0,0,,29674,29674
52,12/27/2017,52,12:45,13:00,48.37,,0,48.37,48.37,1,-118526,63208,181734,-55318,0,0,27392,0,0,,27392,27392
52,12/27/2017,53,13:00,13:15,48.37,37.31,0,37.31,37.31,-1,-83510,105115,188625,21605,0,-124,2242,0,0,,2366,2118
52,12/27/2017,54,13:15,13:30,,38.03,0,38.03,38.03,-1,-91073,114601,205674,23528,0,-44,0,0,0,,44,-44
52,12/27/2017,55,13:30,13:45,,38.03,0,38.03,38.03,-1,-93022,103058,196080,10036,0,-427,0,0,0,,427,-427
52,12/27/2017,56,13:45,14:00,,,0,37.11,37.11,0,-95763,99389,195152,3626,0,0,0,0,0,,0,0
52,12/27/2017,57,14:00,14:15,,,0,37.13,37.13,0,-54610,120938,175548,66328,0,0,0,0,0,,0,0
52,12/27/2017,58,14:15,14:30,,,0,37.13,37.13,0,-61821,122631,184452,60810,0,0,0,0,0,,0,0
52,12/27/2017,59,14:30,14:45,,,0,37.1,37.1,0,-85512,114809,200321,29297,0,0,0,0,0,,0,0
52,12/27/2017,60,14:45,15:00,,34.79,0,34.79,34.79,-1,-93034,120137,213171,27103,0,-2556,0,0,0,,2556,-2556
52,12/27/2017,61,15:00,15:15,,35.95,0,35.95,35.95,-1,-83342,83939,167281,597,0,-1681,0,0,0,,1681,-1681
52,12/27/2017,62,15:15,15:30,,34.79,0,34.79,34.79,-1,-78509,81507,160016,2998,0,-3888,0,0,0,,3888,-3888
52,12/27/2017,63,15:30,15:45,36.05,34.79,0,36.05,36.05,1,-92764,75419,168183,-17345,0,-291,78,0,0,,369,-213
52,12/27/2017,64,15:45,16:00,37.25,,0,37.25,37.25,1,-84053,55053,139106,-29000,0,0,2676,0,0,,2676,2676
52,12/27/2017,65,16:00,16:15,36.05,33.79,0,37.13,33.79,2,-70168,99208,169376,29040,0,-5568,196,0,0,,5764,-5372
52,12/27/2017,66,16:15,16:30,,27.58,0,27.58,27.58,-1,-66488,113243,179731,46755,0,-25462,0,0,0,,25462,-25462
52,12/27/2017,67,16:30,16:45,36.61,36.77,0,36.61,36.61,1,-92680,75861,168541,-16819,0,-10423,409,0,0,,10832,-10014
52,12/27/2017,68,16:45,17:00,,,0,37.06,37.06,0,-123439,42990,166429,-80449,0,-65,101,0,0,,166,36
52,12/27/2017,69,17:00,17:15,,2.98,0,2.98,2.98,-1,-59684,126464,186148,66780,0,-25317,0,0,0,,25317,-25317
52,12/27/2017,70,17:15,17:30,,31.03,0,31.03,31.03,-1,-54527,105964,160491,51437,0,-19654,0,0,0,,19654,-19654
52,12/27/2017,71,17:30,17:45,,,0,37.13,37.13,0,-48462,129406,177868,80944,0,-11,0,0,0,,11,-11
52,12/27/2017,72,17:45,18:00,,,0,37.13,37.13,0,-37031,183680,220711,146649,0,0,0,0,0,,0,0
52,12/27/2017,73,18:00,18:15,,33.01,0,33.01,33.01,-1,-69576,77135,146711,7559,0,-2583,0,0,0,,2583,-2583
52,12/27/2017,74,18:15,18:30,,36.01,0,36.01,36.01,-1,-31619,145021,176640,113402,0,-4258,0,0,0,,4258,-4258
52,12/27/2017,75,18:30,18:45,,11.01,0,11.01,11.01,-1,-11067,211504,222571,200437,0,-29830,0,0,0,,29830,-29830
52,12/27/2017,76,18:45,19:00,,3.01,0,3.01,3.01,-1,-7325,249846,257171,242521,0,-71089,0,0,0,,71089,-71089
52,12/27/2017,77,19:00,19:15,,24.78,0,24.78,24.78,-1,-29507,129118,158625,99611,0,-25964,0,0,0,,25964,-25964
52,12/27/2017,78,19:15,19:30,,-0.86,0,-0.86,-0.86,-1,-21235,214348,235583,193113,0,-14529,0,0,0,,14529,-14529
52,12/27/2017,79,19:30,19:45,,-26.95,0,-26.95,-26.95,-1,-27456,216633,244089,189177,0,-62323,0,0,0,,62323,-62323
52,12/27/2017,80,19:45,20:00,,-26.95,0,-26.95,-26.95,-1,-39338,263994,303332,224656,0,-70491,0,0,0,,70491,-70491
52,12/27/2017,81,20:00,20:15,,33.79,0,33.79,33.79,-1,-28514,193490,222004,164976,0,-19476,0,0,0,,19476,-19476
52,12/27/2017,82,20:15,20:30,,-16.61,0,-16.61,-16.61,-1,-11545,215590,227135,204045,0,-45344,0,0,0,,45344,-45344
52,12/27/2017,83,20:30,20:45,,-16.61,0,-16.61,-16.61,-1,-31172,227836,259008,196664,0,-70307,0,0,0,,70307,-70307
52,12/27/2017,84,20:45,21:00,,-25.47,0,-25.47,-25.47,-1,-39935,200416,240351,160481,0,-116658,0,0,0,,116658,-116658
52,12/27/2017,85,21:00,21:15,101.75,-18.03,0,101.75,101.75,1,-85263,42058,127321,-43205,0,-65700,4016,0,0,,69716,-61684
52,12/27/2017,86,21:15,21:30,138.02,-34.55,0,138.02,-34.55,2,-37866,91909,129775,54043,0,-6186,19695,0,0,,25881,13509
52,12/27/2017,87,21:30,21:45,,-17.03,0,-17.03,-17.03,-1,-16367,114977,131344,98610,0,-10318,0,0,0,,10318,-10318
52,12/27/2017,88,21:45,22:00,,-25.47,0,-25.47,-25.47,-1,-22083,119227,141310,97144,0,-36290,0,0,0,,36290,-36290
52,12/27/2017,89,22:00,22:15,40.94,33.99,0,40.94,33.99,2,-125827,14408,140235,-111419,0,-6967,848,0,0,,7815,-6119
52,12/27/2017,90,22:15,22:30,74.68,,0,74.68,74.68,1,-132234,15781,148015,-116453,0,0,19694,0,0,,19694,19694
52,12/27/2017,91,22:30,22:45,54.42,,0,54.42,54.42,1,-83451,25186,108637,-58265,0,0,15312,0,0,,15312,15312
52,12/27/2017,92,22:45,23:00,40.83,,0,40.83,40.83,1,-93241,52829,146070,-40412,0,0,20205,0,0,,20205,20205
52,12/27/2017,93,23:00,23:15,44.94,37.49,0,44.94,36.77,2,-123586,98419,222005,-25167,0,-21,8244,0,0,,8265,8223
52,12/27/2017,94,23:15,23:30,36.14,,0,36.14,36.14,1,-90314,70851,161165,-19463,0,0,3510,0,0,,3510,3510
52,12/27/2017,95,23:30,23:45,,,0,36.8,36.8,0,-72947,46828,119775,-26119,0,0,0,0,0,,0,0
52,12/27/2017,96,23:45,0:00,,33.79,0,33.79,33.79,-1,-96394,40544,136938,-55850,0,-168,0,0,0,,168,-168
52,12/28/2017,1,0:00,0:15,,-68.84,0,-68.84,-68.84,-1,-27986,225282,253268,197296,0,-29359,0,0,0,,29359,-29359
52,12/28/2017,2,0:15,0:30,,,0,34.05,34.05,0,-23604,74603,98207,50999,0,-681,0,0,0,,681,-681
52,12/28/2017,3,0:30,0:45,,,0,34.04,34.04,0,-26781,92510,119291,65729,0,0,0,0,0,,0,0
52,12/28/2017,4,0:45,1:00,,16.76,0,16.76,16.76,-1,-47245,136017,183262,88772,0,-5320,0,0,0,,5320,-5320
52,12/28/2017,5,1:00,1:15,,32.98,0,32.98,32.98,-1,-24195,128900,153095,104705,0,-6031,0,0,0,,6031,-6031
52,12/28/2017,6,1:15,1:30,,,0,34.05,34.05,0,-9222,82887,92109,73665,0,-7,0,0,0,,7,-7
52,12/28/2017,7,1:30,1:45,,27.15,0,27.15,27.15,-1,-2898,117725,120623,114827,0,-3528,0,0,0,,3528,-3528
52,12/28/2017,8,1:45,2:00,,26.78,0,26.78,26.78,-1,-19295,146450,165745,127155,0,-7879,0,0,0,,7879,-7879
52,12/28/2017,9,2:00,2:15,,,0,34.11,34.11,0,-51081,82724,133805,31643,0,0,0,0,0,,0,0
52,12/28/2017,10,2:15,2:30,,-162.92,0,-162.92,-162.92,-1,-18697,93581,112278,74884,0,-4938,0,0,0,,4938,-4938
52,12/28/2017,11,2:30,2:45,,-158.98,0,-158.98,-158.98,-1,-44782,82769,127551,37987,0,-25346,0,0,0,,25346,-25346
52,12/28/2017,12,2:45,3:00,,-151.71,0,-151.71,-151.71,-1,-36323,100975,137298,64652,0,-24240,0,0,0,,24240,-24240
52,12/28/2017,13,3:00,3:15,,26,0,26,26,-1,-29671,98643,128314,68972,0,-10151,0,0,0,,10151,-10151
52,12/28/2017,14,3:15,3:30,,-123.52,0,-123.52,-123.52,-1,-19770,97935,117705,78165,0,-13451,0,0,0,,13451,-13451
52,12/28/2017,15,3:30,3:45,,-124.75,0,-124.75,-124.75,-1,-54545,93847,148392,39302,0,-30368,0,0,0,,30368,-30368
52,12/28/2017,16,3:45,4:00,,21,0,21,21,-1,-25746,105874,131620,80128,0,-14034,0,0,0,,14034,-14034
52,12/28/2017,17,4:00,4:15,40.27,27.55,0,40.27,40.27,1,-56427,56789,113216,362,0,-12012,1378,0,0,,13390,-10634
52,12/28/2017,18,4:15,4:30,,,0,34.06,34.06,0,-44987,54431,99418,9444,0,-2,231,0,0,,233,229
52,12/28/2017,19,4:30,4:45,,,0,34.07,34.07,0,-42331,60207,102538,17876,0,0,0,0,0,,0,0
52,12/28/2017,20,4:45,5:00,,,0,34.08,34.08,0,-37266,82169,119435,44903,0,0,0,0,0,,0,0
52,12/28/2017,21,5:00,5:15,46.24,,0,46.24,46.24,1,-101156,79019,180175,-22137,0,0,6577,0,0,,6577,6577
52,12/28/2017,22,5:15,5:30,40.27,,0,40.27,40.27,1,-98249,73603,171852,-24646,0,0,9657,0,0,,9657,9657
52,12/28/2017,23,5:30,5:45,74.28,,0,74.28,74.28,1,-101228,52980,154208,-48248,0,0,35167,0,0,,35167,35167
52,12/28/2017,24,5:45,6:00,40.27,29.86,0,29.86,29.86,-1,-80954,122722,203676,41768,0,-627,17383,0,0,,18010,16756
52,12/28/2017,25,6:00,6:15,35.54,35.56,0,35.54,34.1,2,-55794,55881,111675,87,0,-254,247,0,0,,501,-7
52,12/28/2017,26,6:15,6:30,,26.78,0,26.78,26.78,-1,-49159,64313,113472,15154,0,-3313,0,0,0,,3313,-3313
52,12/28/2017,27,6:30,6:45,43.75,,0,43.75,43.75,1,-62106,53136,115242,-8970,0,0,1694,0,0,,1694,1694
52,12/28/2017,28,6:45,7:00,48.81,,0,48.81,48.81,1,-72984,53577,126561,-19407,0,0,14617,0,0,,14617,14617
52,12/28/2017,29,7:00,7:15,48.81,-11.51,0,-11.51,-11.51,-1,-91171,112563,203734,21392,0,-8718,6267,0,0,,14985,-2451
52,12/28/2017,30,7:15,7:30,39.12,-23.61,0,39.12,-23.61,2,-76107,78273,154380,2166,0,-18093,839,0,0,,18932,-17254
52,12/28/2017,31,7:30,7:45,39.12,31.43,0,31.43,31.43,-1,-73190,85261,158451,12071,0,-3151,80,0,0,,3231,-3071
52,12/28/2017,32,7:45,8:00,133.76,31.43,0,133.76,133.76,1,-85551,51787,137338,-33764,0,-238,7885,0,0,,8123,7647
52,12/28/2017,33,8:00,8:15,41.14,-46.49,0,-46.49,-46.49,-1,-31581,141844,173425,110263,0,-17201,6969,0,0,,24170,-10232
52,12/28/2017,34,8:15,8:30,41.14,-46.49,0,41.14,-46.49,2,-121063,103127,224190,-17936,0,-28700,864,0,0,,29564,-27836
52,12/28/2017,35,8:30,8:45,41.14,33.88,0,33.88,33.88,-1,-62882,67328,130210,4446,0,-2182,6,0,0,,2188,-2176
52,12/28/2017,36,8:45,9:00,41.65,33.88,0,41.65,41.65,1,-70619,49102,119721,-21517,0,-20,1560,0,0,,1580,1540
52,12/28/2017,37,9:00,9:15,38.32,33.48,0,38.32,33.48,2,-69434,111315,180749,41881,0,-2361,882,0,0,,3243,-1479
52,12/28/2017,38,9:15,9:30,,35.17,0,35.17,35.17,-1,-58844,93294,152138,34450,0,-1856,0,0,0,,1856,-1856
52,12/28/2017,39,9:30,9:45,,,0,37.78,37.78,0,-72713,88305,161018,15592,0,0,0,0,0,,0,0
52,12/28/2017,40,9:45,10:00,,,0,37.78,37.78,0,-74814,87370,162184,12556,0,0,0,0,0,,0,0
52,12/28/2017,41,10:00,10:15,36.88,,0,36.88,36.88,1,-104940,109259,214199,4319,0,0,763,0,0,,763,763
52,12/28/2017,42,10:15,10:30,,33.88,0,33.88,33.88,-1,-87695,118396,206091,30701,0,-2523,0,0,0,,2523,-2523
52,12/28/2017,43,10:30,10:45,,21.05,0,21.05,21.05,-1,-68721,122748,191469,54027,0,-24787,0,0,0,,24787,-24787
52,12/28/2017,44,10:45,11:00,,33.73,0,33.73,33.73,-1,-63904,117633,181537,53729,0,-22025,0,0,0,,22025,-22025
52,12/28/2017,45,11:00,11:15,,22.51,0,22.51,22.51,-1,-78812,123064,201876,44252,0,-9001,0,0,0,,9001,-9001
52,12/28/2017,46,11:15,11:30,,-0.5,0,-0.5,-0.5,-1,-75030,146715,221745,71685,0,-54700,0,0,0,,54700,-54700
52,12/28/2017,47,11:30,11:45,,18.93,0,18.93,18.93,-1,-82028,147766,229794,65738,0,-42274,0,0,0,,42274,-42274
52,12/28/2017,48,11:45,12:00,,-46.49,0,-46.49,-46.49,-1,-76295,178674,254969,102379,0,-43462,0,0,0,,43462,-43462
52,12/28/2017,49,12:00,12:15,,17.51,0,17.51,17.51,-1,-62878,123140,186018,60262,0,-47822,0,0,0,,47822,-47822
52,12/28/2017,50,12:15,12:30,,25.62,0,25.62,25.62,-1,-78139,118969,197108,40830,0,-43028,0,0,0,,43028,-43028
52,12/28/2017,51,12:30,12:45,,16.08,0,16.08,16.08,-1,-74218,137940,212158,63722,0,-55683,0,0,0,,55683,-55683
52,12/28/2017,52,12:45,13:00,,25.62,0,25.62,25.62,-1,-96706,118481,215187,21775,0,-41523,0,0,0,,41523,-41523
52,12/28/2017,53,13:00,13:15,,12.51,0,12.51,12.51,-1,-103325,142527,245852,39202,0,-11799,0,0,0,,11799,-11799
52,12/28/2017,54,13:15,13:30,,10.79,0,10.79,10.79,-1,-92301,122953,215254,30652,0,-30950,0,0,0,,30950,-30950
52,12/28/2017,55,13:30,13:45,,1.08,0,1.08,1.08,-1,-50198,110688,160886,60490,0,-47509,0,0,0,,47509,-47509
52,12/28/2017,56,13:45,14:00,,27.51,0,27.51,27.51,-1,-66001,96323,162324,30322,0,-34684,0,0,0,,34684,-34684
52,12/28/2017,57,14:00,14:15,,16.64,0,16.64,16.64,-1,-88213,136948,225161,48735,0,-39399,0,0,0,,39399,-39399
52,12/28/2017,58,14:15,14:30,,28.23,0,28.23,28.23,-1,-85041,106327,191368,21286,0,-32195,0,0,0,,32195,-32195
52,12/28/2017,59,14:30,14:45,,7.51,0,7.51,7.51,-1,-66287,114428,180715,48141,0,-20367,0,0,0,,20367,-20367
52,12/28/2017,60,14:45,15:00,,3.78,0,3.78,3.78,-1,-75559,108775,184334,33216,0,-41685,0,0,0,,41685,-41685
52,12/28/2017,61,15:00,15:15,,32.44,0,32.44,32.44,-1,-74527,111417,185944,36890,0,-26611,0,0,0,,26611,-26611
52,12/28/2017,62,15:15,15:30,,31.75,0,31.75,31.75,-1,-71384,96051,167435,24667,0,-30861,0,0,0,,30861,-30861
52,12/28/2017,63,15:30,15:45,,33.88,0,33.88,33.88,-1,-63695,90633,154328,26938,0,-16921,0,0,0,,16921,-16921
52,12/28/2017,64,15:45,16:00,,33.88,0,33.88,33.88,-1,-66924,87918,154842,20994,0,-21948,0,0,0,,21948,-21948
52,12/28/2017,65,16:00,16:15,,-8.76,0,-8.76,-8.76,-1,-57494,143038,200532,85544,0,-46291,0,0,0,,46291,-46291
52,12/28/2017,66,16:15,16:30,,26.07,0,26.07,26.07,-1,-61013,111786,172799,50773,0,-24900,0,0,0,,24900,-24900
52,12/28/2017,67,16:30,16:45,36.88,26.07,0,36.88,36.88,1,-76758,91593,168351,14835,0,-7760,2,0,0,,7762,-7758
52,12/28/2017,68,16:45,17:00,350.25,,0,350.25,350.25,1,-107527,48117,155644,-59410,0,0,13248,0,0,,13248,13248
52,12/28/2017,69,17:00,17:15,74.25,33.88,0,74.25,33.88,2,-68618,68462,137080,-156,0,-768,13567,0,0,,14335,12799
52,12/28/2017,70,17:15,17:30,65.25,,0,65.25,65.25,1,-63462,45772,109234,-17690,0,0,10000,0,0,,10000,10000
52,12/28/2017,71,17:30,17:45,47.61,,0,47.61,47.61,1,-64391,44451,108842,-19940,0,0,9299,0,0,,9299,9299
52,12/28/2017,72,17:45,18:00,47.61,33.88,0,47.61,33.88,2,-58958,68740,127698,9782,0,-444,9423,0,0,,9867,8979
52,12/28/2017,73,18:00,18:15,47.61,22.51,0,22.51,22.51,-1,-66269,86586,152855,20317,0,-14315,97,0,0,,14412,-14218
52,12/28/2017,74,18:15,18:30,,26.8,0,26.8,26.8,-1,-58411,93624,152035,35213,0,-26304,0,0,0,,26304,-26304
52,12/28/2017,75,18:30,18:45,,19.25,0,19.25,19.25,-1,-56172,90255,146427,34083,0,-43516,0,0,0,,43516,-43516
52,12/28/2017,76,18:45,19:00,,14.54,0,14.54,14.54,-1,-54590,103112,157702,48522,0,-35461,0,0,0,,35461,-35461
52,12/28/2017,77,19:00,19:15,57.98,-15.68,0,57.98,-15.68,2,-87250,90865,178115,3615,0,-34357,1379,0,0,,35736,-32978
52,12/28/2017,78,19:15,19:30,57.98,-23.46,0,-23.46,-23.46,-1,-44032,89113,133145,45081,0,-22065,474,0,0,,22539,-21591
52,12/28/2017,79,19:30,19:45,,22.51,0,22.51,22.51,-1,-48431,93032,141463,44601,0,-30687,0,0,0,,30687,-30687
52,12/28/2017,80,19:45,20:00,,17.51,0,17.51,17.51,-1,-57213,69095,126308,11882,0,-31968,0,0,0,,31968,-31968
52,12/28/2017,81,20:00,20:15,,29.76,0,29.76,29.76,-1,-73089,96918,170007,23829,0,-18693,0,0,0,,18693,-18693
52,12/28/2017,82,20:15,20:30,,-27.85,0,-27.85,-27.85,-1,-44486,84026,128512,39540,0,-14689,0,0,0,,14689,-14689
52,12/28/2017,83,20:30,20:45,,-16.56,0,-16.56,-16.56,-1,-63813,101669,165482,37856,0,-40953,0,0,0,,40953,-40953
52,12/28/2017,84,20:45,21:00,,10.57,0,10.57,10.57,-1,-76773,125129,201902,48356,0,-46843,0,0,0,,46843,-46843
52,12/28/2017,85,21:00,21:15,130.25,28.25,0,130.25,28.25,2,-65324,26833,92157,-38491,0,-20940,10939,0,0,,31879,-10001
52,12/28/2017,86,21:15,21:30,51.25,,0,51.25,51.25,1,-69883,42535,112418,-27348,0,0,19345,0,0,,19345,19345
52,12/28/2017,87,21:30,21:45,37.25,9.09,0,9.09,9.09,-1,-58488,89888,148376,31400,0,-6233,11290,0,0,,17523,5057
52,12/28/2017,88,21:45,22:00,37.25,0.74,0,0.74,0.74,-1,-57513,109973,167486,52460,0,-49363,34,0,0,,49397,-49329
52,12/28/2017,89,22:00,22:15,39.39,9.48,0,39.39,9.48,2,-53187,67181,120368,13994,0,-36738,147,0,0,,36885,-36591
52,12/28/2017,90,22:15,22:30,38.34,4.97,0,38.34,4.97,2,-35234,61643,96877,26409,0,-10816,319,0,0,,11135,-10497
52,12/28/2017,91,22:30,22:45,,9.25,0,9.25,9.25,-1,-31009,75176,106185,44167,0,-33731,0,0,0,,33731,-33731
52,12/28/2017,92,22:45,23:00,,-34.67,0,-34.67,-34.67,-1,-33849,113300,147149,79451,0,-62382,0,0,0,,62382,-62382
52,12/28/2017,93,23:00,23:15,53.04,4.55,0,53.04,53.04,1,-49770,40043,89813,-9727,0,-28922,1921,0,0,,30843,-27001
52,12/28/2017,94,23:15,23:30,53.04,7.72,0,7.72,7.72,-1,-21189,49742,70931,28553,0,-5233,261,0,0,,5494,-4972
52,12/28/2017,95,23:30,23:45,,2.86,0,2.86,2.86,-1,-21250,76436,97686,55186,0,-18065,0,0,0,,18065,-18065
52,12/28/2017,96,23:45,0:00,,-19.67,0,-19.67,-19.67,-1,-22212,110929,133141,88717,0,-52068,0,0,0,,52068,-52068
52,12/29/2017,1,0:00,0:15,,0.19,0,0.19,0.19,-1,-43289,99158,142447,55869,0,-47223,0,0,0,,47223,-47223
52,12/29/2017,2,0:15,0:30,,5.49,0,5.49,5.49,-1,-23060,73119,96179,50059,0,-23173,0,0,0,,23173,-23173
52,12/29/2017,3,0:30,0:45,,21.48,0,21.48,21.48,-1,-35462,84333,119795,48871,0,-43815,0,0,0,,43815,-43815
52,12/29/2017,4,0:45,1:00,,-6.97,0,-6.97,-6.97,-1,-40142,116330,156472,76188,0,-66897,0,0,0,,66897,-66897
52,12/29/2017,5,1:00,1:15,42.54,4.98,0,42.54,42.54,1,-65628,70876,136504,5248,0,-33759,1585,0,0,,35344,-32174
52,12/29/2017,6,1:15,1:30,42.54,33.76,0,33.76,33.76,-1,-47423,54729,102152,7306,0,-2065,382,0,0,,2447,-1683
52,12/29/2017,7,1:30,1:45,,14.95,0,14.95,14.95,-1,-49118,80314,129432,31196,0,-15525,0,0,0,,15525,-15525
52,12/29/2017,8,1:45,2:00,,22.37,0,22.37,22.37,-1,-40703,73692,114395,32989,0,-33919,0,0,0,,33919,-33919
52,12/29/2017,9,2:00,2:15,36.68,30.61,0,36.68,36.68,1,-57775,68418,126193,10643,0,-12064,185,0,0,,12249,-11879
52,12/29/2017,10,2:15,2:30,36.38,34.76,0,36.38,33.33,2,-43813,50818,94631,7005,0,-522,53,0,0,,575,-469
52,12/29/2017,11,2:30,2:45,36.76,35.29,0,36.76,33.34,2,-55393,48733,104126,-6660,0,-258,626,0,0,,884,368
52,12/29/2017,12,2:45,3:00,39.04,,0,39.04,39.04,1,-52374,61471,113845,9097,0,0,3112,0,0,,3112,3112
52,12/29/2017,13,3:00,3:15,39.76,,0,39.76,39.76,1,-51617,22755,74372,-28862,0,0,5344,0,0,,5344,5344
52,12/29/2017,14,3:15,3:30,36.76,,0,36.76,36.76,1,-52912,29868,82780,-23044,0,0,3679,0,0,,3679,3679
52,12/29/2017,15,3:30,3:45,40.76,,0,40.76,40.76,1,-60901,20117,81018,-40784,0,0,6029,0,0,,6029,6029
52,12/29/2017,16,3:45,4:00,42.1,,0,42.1,42.1,1,-66752,17042,83794,-49710,0,0,13811,0,0,,13811,13811
52,12/29/2017,17,4:00,4:15,42.1,32.93,0,32.93,32.93,-1,-50075,64763,114838,14688,0,-1585,2823,0,0,,4408,1238
52,12/29/2017,18,4:15,4:30,,,0,33.25,33.25,0,-80640,38188,118828,-42452,0,0,0,0,0,,0,0
52,12/29/2017,19,4:30,4:45,31.44,,0,31.44,31.44,1,-83798,34811,118609,-48987,0,0,29,0,0,,29,29
52,12/29/2017,20,4:45,5:00,31.44,33.61,0,33.61,33.61,-1,-59260,50484,109744,-8776,0,-783,37,0,0,,820,-746
52,12/29/2017,21,5:00,5:15,,29.76,0,29.76,29.76,-1,-42045,105094,147139,63049,0,-7535,0,0,0,,7535,-7535
52,12/29/2017,22,5:15,5:30,,8.88,0,8.88,8.88,-1,-60331,81185,141516,20854,0,-12553,0,0,0,,12553,-12553
52,12/29/2017,23,5:30,5:45,40.76,8.88,0,40.76,40.76,1,-74890,54342,129232,-20548,0,-591,3298,0,0,,3889,2707
52,12/29/2017,24,5:45,6:00,36.91,,0,36.91,36.91,1,-75791,52053,127844,-23738,0,0,2500,0,0,,2500,2500
52,12/29/2017,25,6:00,6:15,36.91,-2.44,0,-2.44,-2.44,-1,-22338,113193,135531,90855,0,-19317,403,0,0,,19720,-18914
52,12/29/2017,26,6:15,6:30,,25.39,0,25.39,25.39,-1,-46408,79667,126075,33259,0,-33920,0,0,0,,33920,-33920
52,12/29/2017,27,6:30,6:45,,35.02,0,35.02,35.02,-1,-48568,64957,113525,16389,0,-12239,0,0,0,,12239,-12239
52,12/29/2017,28,6:45,7:00,,35.02,0,35.02,35.02,-1,-55445,56541,111986,1096,0,-391,0,0,0,,391,-391
52,12/29/2017,29,7:00,7:15,,-23.97,0,-23.97,-23.97,-1,-25942,116115,142057,90173,0,-17968,0,0,0,,17968,-17968
52,12/29/2017,30,7:15,7:30,,-23.97,0,-23.97,-23.97,-1,-38094,115984,154078,77890,0,-78620,0,0,0,,78620,-78620
52,12/29/2017,31,7:30,7:45,,-47.82,0,-47.82,-47.82,-1,-33584,82025,115609,48441,0,-45925,0,0,0,,45925,-45925
52,12/29/2017,32,7:45,8:00,350.02,-47.82,0,350.02,350.02,1,-89407,45067,134474,-44340,0,-7999,15490,0,0,,23489,7491
52,12/29/2017,33,8:00,8:15,36.97,-25.54,0,-25.54,-25.54,-1,-35199,174491,209690,139292,0,-40895,3416,0,0,,44311,-37479
52,12/29/2017,34,8:15,8:30,35.8,-25.54,0,35.8,35.8,1,-59896,84609,144505,24713,0,-48316,35,0,0,,48351,-48281
52,12/29/2017,35,8:30,8:45,,-25.54,0,-25.54,-25.54,-1,-37631,95122,132753,57491,0,-30797,0,0,0,,30797,-30797
52,12/29/2017,36,8:45,9:00,,13.47,0,13.47,13.47,-1,-46702,92774,139476,46072,0,-35632,0,0,0,,35632,-35632
52,12/29/2017,37,9:00,9:15,,19.67,0,19.67,19.67,-1,-85785,134186,219971,48401,0,-34235,0,0,0,,34235,-34235
52,12/29/2017,38,9:15,9:30,,32.71,0,32.71,32.71,-1,-90225,113053,203278,22828,0,-25155,0,0,0,,25155,-25155
52,12/29/2017,39,9:30,9:45,36.73,34.03,0,36.73,36.73,1,-80418,94861,175279,14443,0,-7203,71,0,0,,7274,-7132
52,12/29/2017,40,9:45,10:00,,33.8,0,33.8,33.8,-1,-53149,104845,157994,51696,0,-406,0,0,0,,406,-406
52,12/29/2017,41,10:00,10:15,,32.23,0,32.23,32.23,-1,-95490,112532,208022,17042,0,-2710,0,0,0,,2710,-2710
52,12/29/2017,42,10:15,10:30,,18.49,0,18.49,18.49,-1,-75518,128923,204441,53405,0,-18919,0,0,0,,18919,-18919
52,12/29/2017,43,10:30,10:45,,18.49,0,18.49,18.49,-1,-83012,126361,209373,43349,0,-42207,0,0,0,,42207,-42207
52,12/29/2017,44,10:45,11:00,,32.89,0,32.89,32.89,-1,-82270,117696,199966,35426,0,-18415,0,0,0,,18415,-18415
52,12/29/2017,45,11:00,11:15,39.8,34.03,0,39.8,34.03,2,-114364,107247,221611,-7117,0,-7833,2142,0,0,,9975,-5691
52,12/29/2017,46,11:15,11:30,39.8,33.8,0,33.8,33.8,-1,-83586,116928,200514,33342,0,-483,3,0,0,,486,-480
52,12/29/2017,47,11:30,11:45,,32.05,0,32.05,32.05,-1,-74039,115090,189129,41051,0,-9258,0,0,0,,9258,-9258
52,12/29/2017,48,11:45,12:00,,23.56,0,23.56,23.56,-1,-74893,130981,205874,56088,0,-33786,0,0,0,,33786,-33786
52,12/29/2017,49,12:00,12:15,56.1,32.8,0,56.1,32.8,2,-106203,94036,200239,-12167,0,-17520,2006,0,0,,19526,-15514
52,12/29/2017,50,12:15,12:30,56.1,33.8,0,33.8,33.8,-1,-91916,90926,182842,-990,0,-453,2,0,0,,455,-451
52,12/29/2017,51,12:30,12:45,,25.3,0,25.3,25.3,-1,-82632,102453,185085,19821,0,-9481,0,0,0,,9481,-9481
52,12/29/2017,52,12:45,13:00,,23.54,0,23.54,23.54,-1,-84043,117311,201354,33268,0,-25734,0,0,0,,25734,-25734
52,12/29/2017,53,13:00,13:15,37.46,32.03,0,37.46,37.46,1,-78263,83120,161383,4857,0,-21830,94,0,0,,21924,-21736
52,12/29/2017,54,13:15,13:30,39.8,35.33,0,39.8,35.33,2,-70704,69681,140385,-1023,0,-1366,860,0,0,,2226,-506
52,12/29/2017,55,13:30,13:45,,33.8,0,33.8,33.8,-1,-62919,66076,128995,3157,0,-1069,0,0,0,,1069,-1069
52,12/29/2017,56,13:45,14:00,38.52,,0,38.52,38.52,1,-67848,65020,132868,-2828,0,0,1238,0,0,,1238,1238
52,12/29/2017,57,14:00,14:15,108.86,,0,108.86,108.86,1,-104596,59218,163814,-45378,0,0,26341,0,0,,26341,26341
52,12/29/2017,58,14:15,14:30,35.8,33.8,0,35.8,33.8,2,-81737,92075,173812,10338,0,-1063,8701,0,0,,9764,7638
52,12/29/2017,59,14:30,14:45,,,0,35.32,35.32,0,-88030,68505,156535,-19525,0,0,0,0,0,,0,0
52,12/29/2017,60,14:45,15:00,,,0,35.32,35.32,0,-92219,59184,151403,-33035,0,0,0,0,0,,0,0
52,12/29/2017,61,15:00,15:15,,,0,35.39,35.39,0,-49206,76053,125259,26847,0,0,0,0,0,,0,0
52,12/29/2017,62,15:15,15:30,,,0,35.39,35.39,0,-50031,62572,112603,12541,0,0,0,0,0,,0,0
52,12/29/2017,63,15:30,15:45,,,0,35.39,35.39,0,-50232,61256,111488,11024,0,0,0,0,0,,0,0
52,12/29/2017,64,15:45,16:00,,,0,35.39,35.39,0,-57478,63205,120683,5727,0,0,0,0,0,,0,0
52,12/29/2017,65,16:00,16:15,,8.71,0,8.71,8.71,-1,-17371,100984,118355,83613,0,-18280,0,0,0,,18280,-18280
52,12/29/2017,66,16:15,16:30,,33.92,0,33.92,33.92,-1,-19380,99292,118672,79912,0,-5889,0,0,0,,5889,-5889
52,12/29/2017,67,16:30,16:45,,,0,35.58,35.58,0,-25986,90181,116167,64195,0,0,0,0,0,,0,0
52,12/29/2017,68,16:45,17:00,,,0,35.54,35.54,0,-45268,66638,111906,21370,0,0,0,0,0,,0,0
52,12/29/2017,69,17:00,17:15,,35.03,0,35.03,35.03,-1,-36242,101477,137719,65235,0,-209,0,0,0,,209,-209
52,12/29/2017,70,17:15,17:30,,35.03,0,35.03,35.03,-1,-40013,88169,128182,48156,0,-876,0,0,0,,876,-876
52,12/29/2017,71,17:30,17:45,,31.92,0,31.92,31.92,-1,-43008,84143,127151,41135,0,-2921,0,0,0,,2921,-2921
52,12/29/2017,72,17:45,18:00,,33.8,0,33.8,33.8,-1,-43439,103781,147220,60342,0,-2985,0,0,0,,2985,-2985
52,12/29/2017,73,18:00,18:15,,30.72,0,30.72,30.72,-1,-71298,114688,185986,43390,0,-4084,0,0,0,,4084,-4084
52,12/29/2017,74,18:15,18:30,,23.49,0,23.49,23.49,-1,-39691,128653,168344,88962,0,-5845,0,0,0,,5845,-5845
52,12/29/2017,75,18:30,18:45,,17.25,0,17.25,17.25,-1,-32356,156889,189245,124533,0,-16882,0,0,0,,16882,-16882
52,12/29/2017,76,18:45,19:00,,9.71,0,9.71,9.71,-1,-42468,143654,186122,101186,0,-29899,0,0,0,,29899,-29899
52,12/29/2017,77,19:00,19:15,,19.8,0,19.8,19.8,-1,-30677,139075,169752,108398,0,-18535,0,0,0,,18535,-18535
52,12/29/2017,78,19:15,19:30,,,0,33.23,33.23,0,-22445,131672,154117,109227,0,-372,0,0,0,,372,-372
52,12/29/2017,79,19:30,19:45,,16.94,0,16.94,16.94,-1,-14256,161601,175857,147345,0,-13260,0,0,0,,13260,-13260
52,12/29/2017,80,19:45,20:00,,0.55,0,0.55,0.55,-1,-31336,154857,186193,123521,0,-39648,0,0,0,,39648,-39648
52,12/29/2017,81,20:00,20:15,81.35,-40.33,0,81.35,81.35,1,-94415,109232,203647,14817,0,-28631,3197,0,0,,31828,-25434
52,12/29/2017,82,20:15,20:30,81.35,29.11,0,29.11,29.11,-1,-29484,108500,137984,79016,0,-825,657,0,0,,1482,-168
52,12/29/2017,83,20:30,20:45,,23.42,0,23.42,23.42,-1,-25761,137304,163065,111543,0,-8515,0,0,0,,8515,-8515
52,12/29/2017,84,20:45,21:00,,-58.2,0,-58.2,-58.2,-1,-43889,152936,196825,109047,0,-29581,0,0,0,,29581,-29581
52,12/29/2017,85,21:00,21:15,,34.02,0,34.02,34.02,-1,-33199,87974,121173,54775,0,-20583,0,0,0,,20583,-20583
52,12/29/2017,86,21:15,21:30,,-27.55,0,-27.55,-27.55,-1,-11955,132156,144111,120201,0,-5940,0,0,0,,5940,-5940
52,12/29/2017,87,21:30,21:45,,-24.55,0,-24.55,-24.55,-1,-33866,104288,138154,70422,0,-39774,0,0,0,,39774,-39774
52,12/29/2017,88,21:45,22:00,,-57.5,0,-57.5,-57.5,-1,-50892,135210,186102,84318,0,-49656,0,0,0,,49656,-49656
52,12/29/2017,89,22:00,22:15,37.02,-57.5,0,37.02,37.02,1,-56790,66329,123119,9539,0,-8607,16,0,0,,8623,-8591
52,12/29/2017,90,22:15,22:30,,30.02,0,30.02,30.02,-1,-63409,78519,141928,15110,0,-1091,0,0,0,,1091,-1091
52,12/29/2017,91,22:30,22:45,,30.02,0,30.02,30.02,-1,-66510,120119,186629,53609,0,-4000,0,0,0,,4000,-4000
52,12/29/2017,92,22:45,23:00,,11.55,0,11.55,11.55,-1,-82248,166356,248604,84108,0,-18129,0,0,0,,18129,-18129
52,12/29/2017,93,23:00,23:15,37.02,34.02,0,37.02,37.02,1,-87019,81756,168775,-5263,0,-11299,688,0,0,,11987,-10611
52,12/29/2017,94,23:15,23:30,37.02,35.02,0,35.02,35.02,-1,-89488,100716,190204,11228,0,-173,37,0,0,,210,-136
52,12/29/2017,95,23:30,23:45,,34.02,0,34.02,34.02,-1,-89823,109211,199034,19388,0,-1580,0,0,0,,1580,-1580
52,12/29/2017,96,23:45,0:00,,10.44,0,10.44,10.44,-1,-102495,130692,233187,28197,0,-25765,0,0,0,,25765,-25765
1,12/30/2017,1,0:00,0:15,51.09,6.66,0,51.09,51.09,1,-115346,142233,257579,26887,0,-18786,2747,0,0,,21533,-16039
1,12/30/2017,2,0:15,0:30,32.09,,0,32.09,32.09,1,-110235,131415,241650,21180,0,0,1725,0,0,,1725,1725
1,12/30/2017,3,0:30,0:45,,,0,33.97,33.97,0,-113800,139880,253680,26080,0,0,0,0,0,,0,0
1,12/30/2017,4,0:45,1:00,,32.97,0,32.97,32.97,-1,-142137,158832,300969,16695,0,-5819,0,0,0,,5819,-5819
1,12/30/2017,5,1:00,1:15,127.02,32.97,0,127.02,127.02,1,-143763,80291,224054,-63472,0,-1048,17800,0,0,,18848,16752
1,12/30/2017,6,1:15,1:30,127.12,,0,127.12,127.12,1,-125980,67733,193713,-58247,0,0,73880,0,0,,73880,73880
1,12/30/2017,7,1:30,1:45,127.12,34.93,0,34.93,34.93,-1,-100800,107455,208255,6655,0,-633,6250,0,0,,6883,5617
1,12/30/2017,8,1:45,2:00,,33.93,0,33.93,33.93,-1,-87433,112833,200266,25400,0,-469,0,0,0,,469,-469
1,12/30/2017,9,2:00,2:15,,24.78,0,24.78,24.78,-1,-47495,117747,165242,70252,0,-3951,0,0,0,,3951,-3951
1,12/30/2017,10,2:15,2:30,,34.93,0,34.93,34.93,-1,-61539,86395,147934,24856,0,-138,0,0,0,,138,-138
1,12/30/2017,11,2:30,2:45,47.56,36.06,0,47.56,33.77,2,-88275,69006,157281,-19269,0,-173,3724,0,0,,3897,3551
1,12/30/2017,12,2:45,3:00,52.98,33.93,0,52.98,33.77,2,-88787,65618,154405,-23169,0,-29,13149,0,0,,13178,13120
1,12/30/2017,13,3:00,3:15,52.98,33.04,0,33.04,33.04,-1,-74056,138015,212071,63959,0,-387,348,0,0,,735,-39
1,12/30/2017,14,3:15,3:30,,,0,33.78,33.78,0,-102734,91197,193931,-11537,0,0,0,0,0,,0,0
1,12/30/2017,15,3:30,3:45,,,0,33.78,33.78,0,-106926,76809,183735,-30117,0,0,0,0,0,,0,0
1,12/30/2017,16,3:45,4:00,,,0,33.79,33.79,0,-90848,84110,174958,-6738,0,0,0,0,0,,0,0
1,12/30/2017,17,4:00,4:15,39.43,,0,39.43,39.43,1,-92574,94983,187557,2409,0,0,1237,0,0,,1237,1237
1,12/30/2017,18,4:15,4:30,40.93,,0,40.93,40.93,1,-102221,88831,191052,-13390,0,0,4567,0,0,,4567,4567
1,12/30/2017,19,4:30,4:45,,,0,33.7,33.7,0,-112762,83823,196585,-28939,0,0,34,0,0,,34,34
1,12/30/2017,20,4:45,5:00,,,0,33.71,33.71,0,-108061,78969,187030,-29092,0,0,0,0,0,,0,0
1,12/30/2017,21,5:00,5:15,46.93,,0,46.93,46.93,1,-98636,89862,188498,-8774,0,0,6355,0,0,,6355,6355
1,12/30/2017,22,5:15,5:30,,,0,33.68,33.68,0,-38615,89128,127743,50513,0,0,121,0,0,,121,121
1,12/30/2017,23,5:30,5:45,,34.93,0,34.93,34.93,-1,-40545,83657,124202,43112,0,-606,0,0,0,,606,-606
1,12/30/2017,24,5:45,6:00,,34.12,0,34.12,34.12,-1,-28280,76546,104826,48266,0,-1229,0,0,0,,1229,-1229
1,12/30/2017,25,6:00,6:15,,34.87,0,34.87,34.87,-1,-40564,123911,164475,83347,0,-1572,0,0,0,,1572,-1572
1,12/30/2017,26,6:15,6:30,,33.87,0,33.87,33.87,-1,-41995,126240,168235,84245,0,-2365,0,0,0,,2365,-2365
1,12/30/2017,27,6:30,6:45,,,0,34.4,34.4,0,-60988,84909,145897,23921,0,-14,0,0,0,,14,-14
1,12/30/2017,28,6:45,7:00,36.87,,0,36.87,36.87,1,-82134,74205,156339,-7929,0,0,1206,0,0,,1206,1206
1,12/30/2017,29,7:00,7:15,36.87,27.78,0,27.78,27.78,-1,-59687,90845,150532,31158,0,-4923,5,0,0,,4928,-4918
1,12/30/2017,30,7:15,7:30,46.87,27.28,0,46.87,27.28,2,-71556,65751,137307,-5805,0,-10848,2573,0,0,,13421,-8275
1,12/30/2017,31,7:30,7:45,46.87,33.87,0,33.87,33.87,-1,-50683,59586,110269,8903,0,-598,906,0,0,,1504,308
1,12/30/2017,32,7:45,8:00,,33.44,0,33.44,33.44,-1,-41948,57979,99927,16031,0,-797,0,0,0,,797,-797
1,12/30/2017,33,8:00,8:15,,-65.2,0,-65.2,-65.2,-1,-54602,160853,215455,106251,0,-36759,0,0,0,,36759,-36759
1,12/30/2017,34,8:15,8:30,,-65.2,0,-65.2,-65.2,-1,-57065,139408,196473,82343,0,-41318,0,0,0,,41318,-41318
1,12/30/2017,35,8:30,8:45,,13.91,0,13.91,13.91,-1,-65853,106621,172474,40768,0,-31559,0,0,0,,31559,-31559
1,12/30/2017,36,8:45,9:00,,6.93,0,6.93,6.93,-1,-76572,102178,178750,25606,0,-37426,0,0,0,,37426,-37426
1,12/30/2017,37,9:00,9:15,,-62.32,0,-62.32,-62.32,-1,-105415,163970,269385,58555,0,-41086,0,0,0,,41086,-41086
1,12/30/2017,38,9:15,9:30,,29.28,0,29.28,29.28,-1,-103485,142082,245567,38597,0,-7989,0,0,0,,7989,-7989
1,12/30/2017,39,9:30,9:45,36.87,34.87,0,36.87,36.87,1,-112049,112918,224967,869,0,-4366,446,0,0,,4812,-3920
1,12/30/2017,40,9:45,10:00,39.02,,0,39.02,39.02,1,-111922,105329,217251,-6593,0,0,2462,0,0,,2462,2462
1,12/30/2017,41,10:00,10:15,,,0,35.12,35.12,0,-73008,105149,178157,32141,0,0,126,0,0,,126,126
1,12/30/2017,42,10:15,10:30,36.87,,0,36.87,36.87,1,-93758,93282,187040,-476,0,0,1049,0,0,,1049,1049
1,12/30/2017,43,10:30,10:45,,,0,35.12,35.12,0,-90524,108632,199156,18108,0,0,14,0,0,,14,14
1,12/30/2017,44,10:45,11:00,,,0,35.11,35.11,0,-68775,110224,178999,41449,0,0,0,0,0,,0,0
1,12/30/2017,45,11:00,11:15,32.74,,0,32.74,32.74,1,-114985,99293,214278,-15692,0,0,535,0,0,,535,535
1,12/30/2017,46,11:15,11:30,32.7,33.87,0,33.87,33.87,-1,-78474,90741,169215,12267,0,-1355,831,0,0,,2186,-524
1,12/30/2017,47,11:30,11:45,,10.88,0,10.88,10.88,-1,-77657,105139,182796,27482,0,-26816,0,0,0,,26816,-26816
1,12/30/2017,48,11:45,12:00,,33.87,0,33.87,33.87,-1,-78051,113404,191455,35353,0,-15864,0,0,0,,15864,-15864
1,12/30/2017,49,12:00,12:15,40.87,34.87,0,40.87,34.87,2,-110564,77354,187918,-33210,0,-6637,2447,0,0,,9084,-4190
1,12/30/2017,50,12:15,12:30,36.87,34.87,0,36.87,36.87,1,-100788,96839,197627,-3949,0,-2,2837,0,0,,2839,2835
1,12/30/2017,51,12:30,12:45,,,0,35.49,35.49,0,-93485,99205,192690,5720,0,0,134,0,0,,134,134
1,12/30/2017,52,12:45,13:00,,,0,35.49,35.49,0,-98357,106975,205332,8618,0,0,0,0,0,,0,0
1,12/30/2017,53,13:00,13:15,138.05,,0,138.05,138.05,1,-123678,77218,200896,-46460,0,0,19679,0,0,,19679,19679
1,12/30/2017,54,13:15,13:30,40.87,36.36,0,36.36,36.36,-1,-90843,87463,178306,-3380,0,-186,11173,0,0,,11359,10987
1,12/30/2017,55,13:30,13:45,,36.84,0,36.84,36.84,-1,-90736,93321,184057,2585,0,-409,0,0,0,,409,-409
1,12/30/2017,56,13:45,14:00,,34.87,0,34.87,34.87,-1,-116941,114066,231007,-2875,0,-625,0,0,0,,625,-625
1,12/30/2017,57,14:00,14:15,,36.04,0,36.04,36.04,-1,-124005,148138,272143,24133,0,-478,0,0,0,,478,-478
1,12/30/2017,58,14:15,14:30,,,0,34.78,34.78,0,-119097,145375,264472,26278,0,0,0,0,0,,0,0
1,12/30/2017,59,14:30,14:45,,33.87,0,33.87,33.87,-1,-67096,156582,223678,89486,0,-409,0,0,0,,409,-409
1,12/30/2017,60,14:45,15:00,,9.26,0,9.26,9.26,-1,-27281,153951,181232,126670,0,-23713,0,0,0,,23713,-23713
1,12/30/2017,61,15:00,15:15,,18.82,0,18.82,18.82,-1,-23604,171222,194826,147618,0,-33753,0,0,0,,33753,-33753
1,12/30/2017,62,15:15,15:30,,27.78,0,27.78,27.78,-1,-29695,166099,195794,136404,0,-32183,0,0,0,,32183,-32183
1,12/30/2017,63,15:30,15:45,,28.97,0,28.97,28.97,-1,-34389,156759,191148,122370,0,-27844,0,0,0,,27844,-27844
1,12/30/2017,64,15:45,16:00,,31.91,0,31.91,31.91,-1,-32526,148558,181084,116032,0,-11470,0,0,0,,11470,-11470
1,12/30/2017,65,16:00,16:15,,-63.9,0,-63.9,-63.9,-1,-37800,166275,204075,128475,0,-31737,0,0,0,,31737,-31737
1,12/30/2017,66,16:15,16:30,,20.68,0,20.68,20.68,-1,-35416,176643,212059,141227,0,-10293,0,0,0,,10293,-10293
1,12/30/2017,67,16:30,16:45,,7.31,0,7.31,7.31,-1,-44096,150281,194377,106185,0,-26027,0,0,0,,26027,-26027
1,12/30/2017,68,16:45,17:00,,,0,34.89,34.89,0,-66924,134009,200933,67085,0,-1577,0,0,0,,1577,-1577
1,12/30/2017,69,17:00,17:15,,29.14,0,29.14,29.14,-1,-72765,81502,154267,8737,0,-3176,0,0,0,,3176,-3176
1,12/30/2017,70,17:15,17:30,,26.46,0,26.46,26.46,-1,-65307,74376,139683,9069,0,-15933,0,0,0,,15933,-15933
1,12/30/2017,71,17:30,17:45,37.88,26.46,0,37.88,37.88,1,-78089,76682,154771,-1407,0,-968,289,0,0,,1257,-679
1,12/30/2017,72,17:45,18:00,42.07,,0,42.07,42.07,1,-87543,86977,174520,-566,0,0,1507,0,0,,1507,1507
1,12/30/2017,73,18:00,18:15,172.4,,0,172.4,172.4,1,-136638,48607,185245,-88031,0,0,39257,0,0,,39257,39257
1,12/30/2017,74,18:15,18:30,36.97,29.87,0,29.87,29.87,-1,-54036,73784,127820,19748,0,-2926,11752,0,0,,14678,8826
1,12/30/2017,75,18:30,18:45,,28.09,0,28.09,28.09,-1,-50510,82778,133288,32268,0,-14308,0,0,0,,14308,-14308
1,12/30/2017,76,18:45,19:00,,34.87,0,34.87,34.87,-1,-34633,82370,117003,47737,0,-8062,0,0,0,,8062,-8062
1,12/30/2017,77,19:00,19:15,43.95,34.87,0,43.95,43.95,1,-67015,52827,119842,-14188,0,-11,7400,0,0,,7411,7389
1,12/30/2017,78,19:15,19:30,35.81,,0,35.81,35.81,1,-51960,71535,123495,19575,0,0,2257,0,0,,2257,2257
1,12/30/2017,79,19:30,19:45,,,0,35.27,35.27,0,-50220,95985,146205,45765,0,0,0,0,0,,0,0
1,12/30/2017,80,19:45,20:00,,,0,35.27,35.27,0,-48444,92637,141081,44193,0,0,0,0,0,,0,0
1,12/30/2017,81,20:00,20:15,95.28,,0,95.28,95.28,1,-91855,52664,144519,-39191,0,0,11414,0,0,,11414,11414
1,12/30/2017,82,20:15,20:30,40.12,,0,40.12,40.12,1,-67354,52047,119401,-15307,0,0,19502,0,0,,19502,19502
1,12/30/2017,83,20:30,20:45,38.32,,0,38.32,38.32,1,-58496,46993,105489,-11503,0,0,16196,0,0,,16196,16196
1,12/30/2017,84,20:45,21:00,38.32,37.28,0,37.28,37.28,-1,-38740,60190,98930,21450,0,-32,2283,0,0,,2315,2251
1,12/30/2017,85,21:00,21:15,36.87,37.36,0,36.87,35.45,2,-81154,70857,152011,-10297,0,-103,967,0,0,,1070,864
1,12/30/2017,86,21:15,21:30,,,0,35.45,35.45,0,-60032,60725,120757,693,0,0,51,0,0,,51,51
1,12/30/2017,87,21:30,21:45,,,0,35.45,35.45,0,-48046,72835,120881,24789,0,0,0,0,0,,0,0
1,12/30/2017,88,21:45,22:00,,33.87,0,33.87,33.87,-1,-46170,73868,120038,27698,0,-438,0,0,0,,438,-438
1,12/30/2017,89,22:00,22:15,,33.87,0,33.87,33.87,-1,-65657,91990,157647,26333,0,-779,0,0,0,,779,-779
1,12/30/2017,90,22:15,22:30,,,0,35.37,35.37,0,-64697,72841,137538,8144,0,0,0,0,0,,0,0
1,12/30/2017,91,22:30,22:45,,,0,35.37,35.37,0,-59519,73464,132983,13945,0,0,0,0,0,,0,0
1,12/30/2017,92,22:45,23:00,,,0,35.38,35.38,0,-55621,66571,122192,10950,0,0,0,0,0,,0,0
1,12/30/2017,93,23:00,23:15,,,0,35.44,35.44,0,-76071,84991,161062,8920,0,0,0,0,0,,0,0
1,12/30/2017,94,23:15,23:30,35.96,,0,35.96,35.96,1,-68185,66312,134497,-1873,0,0,393,0,0,,393,393
1,12/30/2017,95,23:30,23:45,33.12,,0,33.12,33.12,1,-78521,82684,161205,4163,0,0,11,0,0,,11,11
1,12/30/2017,96,23:45,0:00,36.87,,0,36.87,36.87,1,-80545,77187,157732,-3358,0,0,528,0,0,,528,528
1,12/31/2017,1,0:00,0:15,40.87,,0,40.87,40.87,1,-88097,74210,162307,-13887,0,0,2113,0,0,,2113,2113
1,12/31/2017,2,0:15,0:30,70.58,,0,70.58,70.58,1,-78863,52124,130987,-26739,0,0,20706,0,0,,20706,20706
1,12/31/2017,3,0:30,0:45,153.29,36.62,0,153.29,35.24,2,-86377,29302,115679,-57075,0,-136,10507,0,0,,10643,10371
1,12/31/2017,4,0:45,1:00,167.09,,0,167.09,167.09,1,-82932,31131,114063,-51801,0,0,39196,0,0,,39196,39196
1,12/31/2017,5,1:00,1:15,36.87,33.87,0,36.87,33.19,2,-65206,73009,138215,7803,0,-601,5665,0,0,,6266,5064
1,12/31/2017,6,1:15,1:30,37.85,,0,37.85,37.85,1,-57490,40941,98431,-16549,0,0,2875,0,0,,2875,2875
1,12/31/2017,7,1:30,1:45,36.87,,0,36.87,36.87,1,-48016,51287,99303,3271,0,0,408,0,0,,408,408
1,12/31/2017,8,1:45,2:00,,33.87,0,33.87,33.87,-1,-42516,48718,91234,6202,0,-1625,0,0,0,,1625,-1625
1,12/31/2017,9,2:00,2:15,36.87,33.87,0,36.87,36.87,1,-76191,83626,159817,7435,0,-121,271,0,0,,392,150
1,12/31/2017,10,2:15,2:30,46.87,,0,46.87,46.87,1,-92996,55063,148059,-37933,0,0,13999,0,0,,13999,13999
1,12/31/2017,11,2:30,2:45,37.02,27.37,0,27.37,27.37,-1,-72432,73486,145918,1054,0,-670,13559,0,0,,14229,12889
1,12/31/2017,12,2:45,3:00,43.14,23.42,0,43.14,23.42,2,-70988,57616,128604,-13372,0,-7666,2658,0,0,,10324,-5008
1,12/31/2017,13,3:00,3:15,36.87,23.42,0,36.87,36.87,1,-101839,101645,203484,-194,0,-27,2261,0,0,,2288,2234
1,12/31/2017,14,3:15,3:30,38.4,,0,38.4,38.4,1,-86885,76466,163351,-10419,0,0,531,0,0,,531,531
1,12/31/2017,15,3:30,3:45,42.19,,0,42.19,42.19,1,-75014,52812,127826,-22202,0,0,7018,0,0,,7018,7018
1,12/31/2017,16,3:45,4:00,52.27,,0,52.27,52.27,1,-77818,47919,125737,-29899,0,0,6564,0,0,,6564,6564
1,12/31/2017,17,4:00,4:15,40.02,,0,40.02,40.02,1,-129027,112303,241330,-16724,0,0,9981,0,0,,9981,9981
1,12/31/2017,18,4:15,4:30,70.39,,0,70.39,70.39,1,-139929,90746,230675,-49183,0,0,15300,0,0,,15300,15300
1,12/31/2017,19,4:30,4:45,69.3,,0,69.3,69.3,1,-132820,89309,222129,-43511,0,0,37993,0,0,,37993,37993
1,12/31/2017,20,4:45,5:00,63.49,,0,63.49,63.49,1,-135904,88030,223934,-47874,0,0,15826,0,0,,15826,15826
1,12/31/2017,21,5:00,5:15,86.95,,0,86.95,86.95,1,-130235,91627,221862,-38608,0,0,38105,0,0,,38105,38105
1,12/31/2017,22,5:15,5:30,36.87,25.92,0,36.87,25.92,2,-116551,110774,227325,-5777,0,-780,3524,0,0,,4304,2744
1,12/31/2017,23,5:30,5:45,,,0,33.38,33.38,0,-99162,114717,213879,15555,0,0,109,0,0,,109,109
1,12/31/2017,24,5:45,6:00,,,0,33.38,33.38,0,-79062,117796,196858,38734,0,0,0,0,0,,0,0
1,12/31/2017,25,6:00,6:15,,,0,33.38,33.38,0,-80743,105444,186187,24701,0,0,0,0,0,,0,0
1,12/31/2017,26,6:15,6:30,,30.87,0,30.87,30.87,-1,-53322,101499,154821,48177,0,-1099,0,0,0,,1099,-1099
1,12/31/2017,27,6:30,6:45,,30.84,0,30.84,30.84,-1,-38385,103120,141505,64735,0,-2432,0,0,0,,2432,-2432
1,12/31/2017,28,6:45,7:00,,29.9,0,29.9,29.9,-1,-19724,110712,130436,90988,0,-3485,0,0,0,,3485,-3485
1,12/31/2017,29,7:00,7:15,33.17,-55.76,0,33.64,-55.76,2,-54185,81918,136103,27733,0,-13033,11,0,0,,13044,-13022
1,12/31/2017,30,7:15,7:30,35.15,-49.57,0,35.15,-49.57,2,-44911,76642,121553,31731,0,-5673,272,0,0,,5945,-5401
1,12/31/2017,31,7:30,7:45,52.55,-73.63,0,52.55,-73.63,2,-79280,74046,153326,-5234,0,-14808,732,0,0,,15540,-14076
1,12/31/2017,32,7:45,8:00,,14.99,0,14.99,14.99,-1,-55691,104108,159799,48417,0,-4763,0,0,0,,4763,-4763
1,12/31/2017,33,8:00,8:15,,,0,33.81,33.81,0,-58728,89019,147747,30291,0,-173,0,0,0,,173,-173
1,12/31/2017,34,8:15,8:30,36.62,,0,36.62,36.62,1,-70441,73898,144339,3457,0,0,262,0,0,,262,262
1,12/31/2017,35,8:30,8:45,36.62,,0,36.62,36.62,1,-91991,84066,176057,-7925,0,0,958,0,0,,958,958
1,12/31/2017,36,8:45,9:00,32.17,,0,32.17,32.17,1,-91621,82645,174266,-8976,0,0,244,0,0,,244,244
1,12/31/2017,37,9:00,9:15,,,0,33.93,33.93,0,-50828,103156,153984,52328,0,0,0,0,0,,0,0
1,12/31/2017,38,9:15,9:30,,,0,33.95,33.95,0,-47205,85136,132341,37931,0,0,0,0,0,,0,0
1,12/31/2017,39,9:30,9:45,,,0,33.96,33.96,0,-50222,79531,129753,29309,0,0,0,0,0,,0,0
1,12/31/2017,40,9:45,10:00,36.62,,0,36.62,36.62,1,-75792,66213,142005,-9579,0,0,692,0,0,,692,692
1,12/31/2017,41,10:00,10:15,32.56,,0,32.56,32.56,1,-45780,81171,126951,35391,0,0,117,0,0,,117,117
1,12/31/2017,42,10:15,10:30,,,0,33.97,33.97,0,-51567,77448,129015,25881,0,0,0,0,0,,0,0
1,12/31/2017,43,10:30,10:45,32.83,,0,32.83,32.83,1,-72872,78038,150910,5166,0,0,43,0,0,,43,43
1,12/31/2017,44,10:45,11:00,37.84,,0,37.84,37.84,1,-75112,81077,156189,5965,0,0,1304,0,0,,1304,1304
1,12/31/2017,45,11:00,11:15,32.64,30.22,0,30.22,30.22,-1,-86222,104035,190257,17813,0,-250,338,0,0,,588,88
1,12/31/2017,46,11:15,11:30,,16.28,0,16.28,16.28,-1,-66125,90439,156564,24314,0,-16125,0,0,0,,16125,-16125
1,12/31/2017,47,11:30,11:45,41.17,16.28,0,41.17,41.17,1,-86799,76124,162923,-10675,0,-2859,1894,0,0,,4753,-965
1,12/31/2017,48,11:45,12:00,40.62,,0,40.62,40.62,1,-94450,77774,172224,-16676,0,0,6501,0,0,,6501,6501
1,12/31/2017,49,12:00,12:15,40.62,33.44,0,33.44,33.44,-1,-66341,93643,159984,27302,0,-278,1569,0,0,,1847,1291
1,12/31/2017,50,12:15,12:30,36.62,33.44,0,36.62,33.44,2,-81476,76321,157797,-5155,0,-388,169,0,0,,557,-219
1,12/31/2017,51,12:30,12:45,40.44,,0,40.44,40.44,1,-81285,70938,152223,-10347,0,0,2693,0,0,,2693,2693
1,12/31/2017,52,12:45,13:00,42.2,,0,42.2,42.2,1,-86652,70571,157223,-16081,0,0,12438,0,0,,12438,12438
1,12/31/2017,53,13:00,13:15,55.91,,0,55.91,55.91,1,-100897,52379,153276,-48518,0,0,29297,0,0,,29297,29297
1,12/31/2017,54,13:15,13:30,41.02,,0,41.02,41.02,1,-91909,58166,150075,-33743,0,0,31473,0,0,,31473,31473
1,12/31/2017,55,13:30,13:45,42.63,,0,42.63,42.63,1,-94159,59046,153205,-35113,0,0,28949,0,0,,28949,28949
1,12/31/2017,56,13:45,14:00,94.99,,0,94.99,94.99,1,-104725,42943,147668,-61782,0,0,38125,0,0,,38125,38125
1,12/31/2017,57,14:00,14:15,95.94,,0,95.94,95.94,1,-85919,55064,140983,-30855,0,0,49114,0,0,,49114,49114
1,12/31/2017,58,14:15,14:30,42.46,34.51,0,42.46,33.86,2,-76833,55493,132326,-21340,0,-406,7098,0,0,,7504,6692
1,12/31/2017,59,14:30,14:45,51.02,,0,51.02,51.02,1,-75871,55835,131706,-20036,0,0,15308,0,0,,15308,15308
1,12/31/2017,60,14:45,15:00,37.19,,0,37.19,37.19,1,-75436,58983,134419,-16453,0,0,10506,0,0,,10506,10506
1,12/31/2017,61,15:00,15:15,36.44,,0,36.44,36.44,1,-86652,74909,161561,-11743,0,0,3459,0,0,,3459,3459
1,12/31/2017,62,15:15,15:30,37.75,,0,37.75,37.75,1,-78263,69109,147372,-9154,0,0,990,0,0,,990,990
1,12/31/2017,63,15:30,15:45,46.62,,0,46.62,46.62,1,-87575,63415,150990,-24160,0,0,17946,0,0,,17946,17946
1,12/31/2017,64,15:45,16:00,55.41,,0,55.41,55.41,1,-98996,71643,170639,-27353,0,0,27991,0,0,,27991,27991
1,12/31/2017,65,16:00,16:15,40.51,,0,40.51,40.51,1,-69522,61837,131359,-7685,0,0,16723,0,0,,16723,16723
1,12/31/2017,66,16:15,16:30,159,,0,159,159,1,-84947,43335,128282,-41612,0,0,31153,0,0,,31153,31153
1,12/31/2017,67,16:30,16:45,159,,0,159,159,1,-112117,38943,151060,-73174,0,0,70012,0,0,,70012,70012
1,12/31/2017,68,16:45,17:00,159,,0,159,159,1,-175601,44718,220319,-130883,0,0,79561,0,0,,79561,79561
1,12/31/2017,69,17:00,17:15,194.87,,0,194.87,194.87,1,-169536,100177,269713,-69359,0,0,78383,0,0,,78383,78383
1,12/31/2017,70,17:15,17:30,194.87,,0,194.87,194.87,1,-175890,100078,275968,-75812,0,0,62960,0,0,,62960,62960
1,12/31/2017,71,17:30,17:45,194.87,,0,194.87,194.87,1,-191176,89103,280279,-102073,0,0,82849,0,0,,82849,82849
1,12/31/2017,72,17:45,18:00,341,,0,341,341,1,-177382,113158,290540,-64224,0,0,75612,5000,0,,80612,80612
1,12/31/2017,73,18:00,18:15,133.02,,0,133.02,133.02,1,-199137,101435,300572,-97702,0,0,64932,0,0,,64932,64932
1,12/31/2017,74,18:15,18:30,85.02,,0,85.02,85.02,1,-173355,113187,286542,-60168,0,0,67331,0,0,,67331,67331
1,12/31/2017,75,18:30,18:45,46.44,34.54,0,34.54,34.54,-1,-154606,122053,276659,-32553,0,-37,35346,0,0,,35383,35309
1,12/31/2017,76,18:45,19:00,40.39,34.44,0,40.39,34.01,2,-134163,108527,242690,-25636,0,-370,4283,0,0,,4653,3913
1,12/31/2017,77,19:00,19:15,87.84,,0,87.84,87.84,1,-187383,126825,314208,-60558,0,0,27470,0,0,,27470,27470
1,12/31/2017,78,19:15,19:30,46.77,,0,46.77,46.77,1,-169764,130639,300403,-39125,0,0,39635,0,0,,39635,39635
1,12/31/2017,79,19:30,19:45,39.82,34.45,0,34.45,34.45,-1,-144777,135426,280203,-9351,0,-15,20483,0,0,,20498,20468
1,12/31/2017,80,19:45,20:00,39.82,27.03,0,27.03,27.03,-1,-124654,128693,253347,4039,0,-10743,359,0,0,,11102,-10384
1,12/31/2017,81,20:00,20:15,101.84,27.03,0,101.84,101.84,1,-157707,110888,268595,-46819,0,-2626,17552,0,0,,20178,14926
1,12/31/2017,82,20:15,20:30,40.39,8.05,0,8.05,8.05,-1,-105003,118338,223341,13335,0,-4727,9650,0,0,,14377,4923
1,12/31/2017,83,20:30,20:45,,8.34,0,8.34,8.34,-1,-70023,114427,184450,44404,0,-9224,0,0,0,,9224,-9224
1,12/31/2017,84,20:45,21:00,,-63.02,0,-63.02,-63.02,-1,-40086,110607,150693,70521,0,-40632,0,0,0,,40632,-40632
1,12/31/2017,85,21:00,21:15,,-28.88,0,-28.88,-28.88,-1,-45612,128872,174484,83260,0,-48885,0,0,0,,48885,-48885
1,12/31/2017,86,21:15,21:30,,-21.09,0,-21.09,-21.09,-1,-34585,150982,185567,116397,0,-22859,0,0,0,,22859,-22859
1,12/31/2017,87,21:30,21:45,,-71.9,0,-71.9,-71.9,-1,-44284,160578,204862,116294,0,-37056,0,0,0,,37056,-37056
1,12/31/2017,88,21:45,22:00,,-71.9,0,-71.9,-71.9,-1,-29630,176632,206262,147002,0,-46142,0,0,0,,46142,-46142
1,12/31/2017,89,22:00,22:15,,20.03,0,20.03,20.03,-1,-52588,86325,138913,33737,0,-33739,0,0,0,,33739,-33739
1,12/31/2017,90,22:15,22:30,66.87,34.14,0,66.87,32.88,2,-74263,64032,138295,-10231,0,-5686,6898,0,0,,12584,1212
1,12/31/2017,91,22:30,22:45,66.87,29.44,0,29.44,29.44,-1,-13558,87566,101124,74008,0,-2860,392,0,0,,3252,-2468
1,12/31/2017,92,22:45,23:00,,1.69,0,1.69,1.69,-1,-5622,131739,137361,126117,0,-16962,0,0,0,,16962,-16962
1,12/31/2017,93,23:00,23:15,,-10.3,0,-10.3,-10.3,-1,-60876,122975,183851,62099,0,-29326,0,0,0,,29326,-29326
1,12/31/2017,94,23:15,23:30,,11.69,0,11.69,11.69,-1,-38418,80622,119040,42204,0,-32167,0,0,0,,32167,-32167
1,12/31/2017,95,23:30,23:45,,27.03,0,27.03,27.03,-1,-32254,89181,121435,56927,0,-21011,0,0,0,,21011,-21011
1,12/31/2017,96,23:45,0:00,,4.97,0,4.97,4.97,-1,-23314,126404,149718,103090,0,-3651,0,0,0,,3651,-3651
