week,Date,PTE,period_from,period_until,upward_dispatch_EURMwh,downward_dispatch_kWhPTE,incentive_component_EURMwh,take_from_system_kWhPTE,feed_into_system_EURMwh,Regulation state,purchase_kWhPTE,sell_kWhPTE,absolute_kWhPTE,imbalance_kWhPTE,downward_reserve_kWh_PTE,downward_power_kWh_PTE,upward_power_kWh_PTE,upward_reserve_kWh_PTE,upward_incident_reserve_kWh_PTE,downward_incident_reserve_kWh_PTE,volume_kWhPTE,totals_kWhPTE
1,01-01-18,1,0:00,0:15,58.62,-57.54,0,58.62,-57.54,2,-125886,82717,208603,-43169,0,-6633,8613,0,0,,15246,1980
1,01-01-18,2,0:15,0:30,37.02,-57.54,0,37.02,37.02,1,-76303,108585,184888,32282,0,-36,4790,0,0,,4826,4754
1,01-01-18,3,0:30,0:45,,,0,33.1,33.1,0,-70684,92985,163669,22301,0,0,0,0,0,,0,0
1,01-01-18,4,0:45,1:00,,,0,33.1,33.1,0,-58767,85398,144165,26631,0,0,0,0,0,,0,0
1,01-01-18,5,1:00,1:15,,,0,33.09,33.09,0,-95688,97985,193673,2297,0,0,0,0,0,,0,0
1,01-01-18,6,1:15,1:30,35.19,,0,35.19,35.19,1,-94081,86460,180541,-7621,0,0,755,0,0,,755,755
1,01-01-18,7,1:30,1:45,,,0,33.56,33.56,0,-61056,90737,151793,29681,0,0,0,0,0,,0,0
1,01-01-18,8,1:45,2:00,,26.09,0,26.09,26.09,-1,-46823,95988,142811,49165,0,-3908,0,0,0,,3908,-3908
1,01-01-18,9,2:00,2:15,36.62,33.62,0,36.62,36.62,1,-82492,75807,158299,-6685,0,-2511,1059,0,0,,3570,-1452
1,01-01-18,10,2:15,2:30,32.45,,0,32.45,32.45,1,-77317,72150,149467,-5167,0,0,2039,0,0,,2039,2039
1,01-01-18,11,2:30,2:45,39.54,,0,39.54,39.54,1,-76429,70673,147102,-5756,0,0,8026,0,0,,8026,8026
1,01-01-18,12,2:45,3:00,39.54,31.03,0,31.03,31.03,-1,-62301,82519,144820,20218,0,-4318,1736,0,0,,6054,-2582
1,01-01-18,13,3:00,3:15,52.62,34.63,0,52.62,52.62,1,-93964,67759,161723,-26205,0,-1304,4086,0,0,,5390,2782
1,01-01-18,14,3:15,3:30,52.62,,0,52.62,52.62,1,-86327,65455,151782,-20872,0,0,22858,0,0,,22858,22858
1,01-01-18,15,3:30,3:45,33.82,34.8,0,34.8,34.8,-1,-73419,74723,148142,1304,0,-133,6578,0,0,,6711,6445
1,01-01-18,16,3:45,4:00,,26.91,0,26.91,26.91,-1,-68790,85907,154697,17117,0,-2454,0,0,0,,2454,-2454
1,01-01-18,17,4:00,4:15,41.79,34.53,0,41.79,41.79,1,-84531,79210,163741,-5321,0,-1556,4441,0,0,,5997,2885
1,01-01-18,18,4:15,4:30,36.62,,0,36.62,36.62,1,-77851,77326,155177,-525,0,0,6676,0,0,,6676,6676
1,01-01-18,19,4:30,4:45,32.37,,0,32.37,32.37,1,-78894,79165,158059,271,0,0,517,0,0,,517,517
1,01-01-18,20,4:45,5:00,36.62,,0,36.62,36.62,1,-81276,73779,155055,-7497,0,0,3993,0,0,,3993,3993
1,01-01-18,21,5:00,5:15,32.05,,0,32.05,32.05,1,-71356,88154,159510,16798,0,0,249,0,0,,249,249
1,01-01-18,22,5:15,5:30,,,0,32.82,32.82,0,-74967,89157,164124,14190,0,0,0,0,0,,0,0
1,01-01-18,23,5:30,5:45,36.62,,0,36.62,36.62,1,-81379,76817,158196,-4562,0,0,670,0,0,,670,670
1,01-01-18,24,5:45,6:00,40.62,,0,40.62,40.62,1,-86283,65781,152064,-20502,0,0,11894,0,0,,11894,11894
1,01-01-18,25,6:00,6:15,36.28,,0,36.28,36.28,1,-78504,78299,156803,-205,0,0,7996,0,0,,7996,7996
1,01-01-18,26,6:15,6:30,50.14,,0,50.14,50.14,1,-91782,60851,152633,-30931,0,0,17733,0,0,,17733,17733
1,01-01-18,27,6:30,6:45,44.17,,0,44.17,44.17,1,-100857,67171,168028,-33686,0,0,29747,0,0,,29747,29747
1,01-01-18,28,6:45,7:00,52.28,,0,52.28,52.28,1,-109673,55742,165415,-53931,0,0,36957,0,0,,36957,36957
1,01-01-18,29,7:00,7:15,32.36,,0,32.36,32.36,1,-107189,96753,203942,-10436,0,0,12254,0,0,,12254,12254
1,01-01-18,30,7:15,7:30,43.59,,0,43.59,43.59,1,-114809,91881,206690,-22928,0,0,3940,0,0,,3940,3940
1,01-01-18,31,7:30,7:45,51.59,,0,51.59,51.59,1,-124001,89739,213740,-34262,0,0,26058,0,0,,26058,26058
1,01-01-18,32,7:45,8:00,52.28,,0,52.28,52.28,1,-136424,104892,241316,-31532,0,0,26339,0,0,,26339,26339
1,01-01-18,33,8:00,8:15,47.66,-65.75,0,47.66,-65.75,2,-87344,101309,188653,13965,0,-10629,9910,0,0,,20539,-719
1,01-01-18,34,8:15,8:30,58.94,-65.75,0,58.94,58.94,1,-107686,93535,201221,-14151,0,-21,13022,0,0,,13043,13001
1,01-01-18,35,8:30,8:45,58.94,19.03,0,19.03,19.03,-1,-87682,111799,199481,24117,0,-9155,3013,0,0,,12168,-6142
1,01-01-18,36,8:45,9:00,,15.03,0,15.03,15.03,-1,-86532,117899,204431,31367,0,-30341,0,0,0,,30341,-30341
1,01-01-18,37,9:00,9:15,,-73.62,0,-73.62,-73.62,-1,-77922,184556,262478,106634,0,-57815,0,0,0,,57815,-57815
1,01-01-18,38,9:15,9:30,,-57.51,0,-57.51,-57.51,-1,-76398,145734,222132,69336,0,-54696,0,0,0,,54696,-54696
1,01-01-18,39,9:30,9:45,,2.55,0,2.55,2.55,-1,-89110,146020,235130,56910,0,-55867,0,0,0,,55867,-55867
1,01-01-18,40,9:45,10:00,,-70.17,0,-70.17,-70.17,-1,-83442,150688,234130,67246,0,-55474,0,0,0,,55474,-55474
1,01-01-18,41,10:00,10:15,,14.9,0,14.9,14.9,-1,-86502,136059,222561,49557,0,-40959,0,0,0,,40959,-40959
1,01-01-18,42,10:15,10:30,,14.9,0,14.9,14.9,-1,-75195,127783,202978,52588,0,-44779,0,0,0,,44779,-44779
1,01-01-18,43,10:30,10:45,,26.93,0,26.93,26.93,-1,-73111,151557,224668,78446,0,-34704,0,0,0,,34704,-34704
1,01-01-18,44,10:45,11:00,,30.03,0,30.03,30.03,-1,-69398,138129,207527,68731,0,-17516,0,0,0,,17516,-17516
1,01-01-18,45,11:00,11:15,,35.55,0,35.55,35.55,-1,-127713,130707,258420,2994,0,-121,0,0,0,,121,-121
1,01-01-18,46,11:15,11:30,,33.28,0,33.28,33.28,-1,-62619,120116,182735,57497,0,-1300,0,0,0,,1300,-1300
1,01-01-18,47,11:30,11:45,,,0,33.95,33.95,0,-66472,132217,198689,65745,0,-161,0,0,0,,161,-161
1,01-01-18,48,11:45,12:00,,,0,33.94,33.94,0,-71915,119663,191578,47748,0,0,0,0,0,,0,0
1,01-01-18,49,12:00,12:15,,-62.54,0,-62.54,-62.54,-1,-90996,159428,250424,68432,0,-21841,0,0,0,,21841,-21841
1,01-01-18,50,12:15,12:30,,10.42,0,10.42,10.42,-1,-73561,150024,223585,76463,0,-46433,0,0,0,,46433,-46433
1,01-01-18,51,12:30,12:45,,,0,34.22,34.22,0,-71933,139960,211893,68027,0,-8175,0,0,0,,8175,-8175
1,01-01-18,52,12:45,13:00,,,0,34.23,34.23,0,-80241,105916,186157,25675,0,0,0,0,0,,0,0
1,01-01-18,53,13:00,13:15,,,0,34.03,34.03,0,-90390,115915,206305,25525,0,0,0,0,0,,0,0
1,01-01-18,54,13:15,13:30,42.35,,0,42.35,42.35,1,-105394,102863,208257,-2531,0,0,1213,0,0,,1213,1213
1,01-01-18,55,13:30,13:45,61.6,,0,61.6,61.6,1,-120778,68874,189652,-51904,0,0,38318,0,0,,38318,38318
1,01-01-18,56,13:45,14:00,52.4,,0,52.4,52.4,1,-127471,60167,187638,-67304,0,0,36597,0,0,,36597,36597
1,01-01-18,57,14:00,14:15,52.4,17.53,0,17.53,17.53,-1,-35416,140803,176219,105387,0,-3040,11415,0,0,,14455,8375
1,01-01-18,58,14:15,14:30,,,0,33.83,33.83,0,-53981,79085,133066,25104,0,0,0,0,0,,0,0
1,01-01-18,59,14:30,14:45,,,0,33.83,33.83,0,-78085,74583,152668,-3502,0,0,0,0,0,,0,0
1,01-01-18,60,14:45,15:00,46.31,,0,46.31,46.31,1,-117729,59702,177431,-58027,0,0,8269,0,0,,8269,8269
1,01-01-18,61,15:00,15:15,46.31,35.88,0,35.88,35.88,-1,-41612,85859,127471,44247,0,-52,2815,0,0,,2867,2763
1,01-01-18,62,15:15,15:30,,,0,33.82,33.82,0,-65470,75293,140763,9823,0,0,0,0,0,,0,0
1,01-01-18,63,15:30,15:45,46.05,,0,46.05,46.05,1,-84190,66812,151002,-17378,0,0,5031,0,0,,5031,5031
1,01-01-18,64,15:45,16:00,52.28,,0,52.28,52.28,1,-111397,69122,180519,-42275,0,0,32541,0,0,,32541,32541
1,01-01-18,65,16:00,16:15,52.28,-50.42,0,-50.42,-50.42,-1,-22520,148661,171181,126141,0,-6437,8433,0,0,,14870,1996
1,01-01-18,66,16:15,16:30,,,0,33.95,33.95,0,-44432,99242,143674,54810,0,-66,0,0,0,,66,-66
1,01-01-18,67,16:30,16:45,43.02,,0,43.02,43.02,1,-66946,67206,134152,260,0,0,680,0,0,,680,680
1,01-01-18,68,16:45,17:00,101.45,,0,101.45,101.45,1,-128460,74721,203181,-53739,0,0,31623,0,0,,31623,31623
1,01-01-18,69,17:00,17:15,36.28,29.63,0,36.28,29.63,2,-36166,122731,158897,86565,0,-1808,6379,0,0,,8187,4571
1,01-01-18,70,17:15,17:30,36.28,,0,36.28,36.28,1,-74969,90064,165033,15095,0,0,73,0,0,,73,73
1,01-01-18,71,17:30,17:45,58.28,,0,58.28,58.28,1,-102685,68975,171660,-33710,0,0,20492,0,0,,20492,20492
1,01-01-18,72,17:45,18:00,46.28,,0,46.28,46.28,1,-119415,74724,194139,-44691,0,0,22496,0,0,,22496,22496
1,01-01-18,73,18:00,18:15,33.62,-63.12,0,33.62,-63.12,2,-76524,134978,211502,58454,0,-13380,7914,0,0,,21294,-5466
1,01-01-18,74,18:15,18:30,,33.28,0,33.28,33.28,-1,-99849,118359,218208,18510,0,-4463,0,0,0,,4463,-4463
1,01-01-18,75,18:30,18:45,,-64.13,0,-64.13,-64.13,-1,-89569,143827,233396,54258,0,-12448,0,0,0,,12448,-12448
1,01-01-18,76,18:45,19:00,,-69.5,0,-69.5,-69.5,-1,-90065,113629,203694,23564,0,-33945,0,0,0,,33945,-33945
1,01-01-18,77,19:00,19:15,89.83,-69.5,0,89.83,89.83,1,-106623,50519,157142,-56104,0,-7749,13877,0,0,,21626,6128
1,01-01-18,78,19:15,19:30,54.9,,0,54.9,54.9,1,-95303,47244,142547,-48059,0,0,36128,0,0,,36128,36128
1,01-01-18,79,19:30,19:45,40.37,,0,40.37,40.37,1,-84505,60335,144840,-24170,0,0,22917,0,0,,22917,22917
1,01-01-18,80,19:45,20:00,33.53,34.24,0,33.74,33.74,2,-85712,81894,167606,-3818,0,-228,3292,0,0,,3520,3064
1,01-01-18,81,20:00,20:15,,34.73,0,34.73,34.73,-1,-84205,50776,134981,-33429,0,-258,0,0,0,,258,-258
1,01-01-18,82,20:15,20:30,40.28,,0,40.28,40.28,1,-86555,48602,135157,-37953,0,0,2987,0,0,,2987,2987
1,01-01-18,83,20:30,20:45,40.28,12.87,0,12.87,12.87,-1,-66327,101203,167530,34876,0,-13530,55,0,0,,13585,-13475
1,01-01-18,84,20:45,21:00,,17,0,17,17,-1,-58828,88689,147517,29861,0,-25538,0,0,0,,25538,-25538
1,01-01-18,85,21:00,21:15,,27.34,0,27.34,27.34,-1,-65052,104999,170051,39947,0,-22952,0,0,0,,22952,-22952
1,01-01-18,86,21:15,21:30,,12.34,0,12.34,12.34,-1,-60880,102445,163325,41565,0,-3996,0,0,0,,3996,-3996
1,01-01-18,87,21:30,21:45,,-72.66,0,-72.66,-72.66,-1,-53600,99590,153190,45990,0,-44419,0,0,0,,44419,-44419
1,01-01-18,88,21:45,22:00,,4.94,0,4.94,4.94,-1,-47110,122738,169848,75628,0,-47594,0,0,0,,47594,-47594
1,01-01-18,89,22:00,22:15,46.28,4.94,0,46.28,46.28,1,-71931,55623,127554,-16308,0,-20768,919,0,0,,21687,-19849
1,01-01-18,90,22:15,22:30,47.63,23.73,0,47.63,23.73,2,-61696,58378,120074,-3318,0,-845,8072,0,0,,8917,7227
1,01-01-18,91,22:30,22:45,47.63,-22.6,0,-22.6,-22.6,-1,-56254,88657,144911,32403,0,-33705,36,0,0,,33741,-33669
1,01-01-18,92,22:45,23:00,,22.87,0,22.87,22.87,-1,-45281,110644,155925,65363,0,-30863,0,0,0,,30863,-30863
1,01-01-18,93,23:00,23:15,52.1,23.79,0,52.1,52.1,1,-105047,68028,173075,-37019,0,-17723,1730,0,0,,19453,-15993
1,01-01-18,94,23:15,23:30,34.51,23.79,0,34.51,23.79,2,-78336,74818,153154,-3518,0,-502,2874,0,0,,3376,2372
1,01-01-18,95,23:30,23:45,,-76.21,0,-76.21,-76.21,-1,-36625,117398,154023,80773,0,-46779,0,0,0,,46779,-46779
1,01-01-18,96,23:45,0:00,,-47.37,0,-47.37,-47.37,-1,-69107,157173,226280,88066,0,-83382,0,0,0,,83382,-83382
1,01-02-18,1,0:00,0:15,44.12,-47.37,0,44.12,44.12,1,-99498,88102,187600,-11396,0,-34819,2164,0,0,,36983,-32655
1,01-02-18,2,0:15,0:30,44.12,28.48,0,28.48,28.48,-1,-69332,88535,157867,19203,0,-8050,122,0,0,,8172,-7928
1,01-02-18,3,0:30,0:45,,29.79,0,29.79,29.79,-1,-57880,57607,115487,-273,0,-10613,0,0,0,,10613,-10613
1,01-02-18,4,0:45,1:00,,28.56,0,28.56,28.56,-1,-54775,58202,112977,3427,0,-1703,0,0,0,,1703,-1703
1,01-02-18,5,1:00,1:15,,8.19,0,8.19,8.19,-1,-84799,87781,172580,2982,0,-8980,0,0,0,,8980,-8980
1,01-02-18,6,1:15,1:30,,,0,33.43,33.43,0,-95125,69135,164260,-25990,0,-15,0,0,0,,15,-15
1,01-02-18,7,1:30,1:45,,,0,33.43,33.43,0,-67812,69562,137374,1750,0,0,0,0,0,,0,0
1,01-02-18,8,1:45,2:00,,26.78,0,26.78,26.78,-1,-55324,79923,135247,24599,0,-6536,0,0,0,,6536,-6536
1,01-02-18,9,2:00,2:15,59.42,26.78,0,59.42,59.42,1,-104514,63061,167575,-41453,0,-1630,14179,0,0,,15809,12549
1,01-02-18,10,2:15,2:30,40.28,,0,40.28,40.28,1,-83397,62243,145640,-21154,0,0,8617,0,0,,8617,8617
1,01-02-18,11,2:30,2:45,40.28,,0,40.28,40.28,1,-86028,64847,150875,-21181,0,0,20747,0,0,,20747,20747
1,01-02-18,12,2:45,3:00,40.28,27.03,0,27.03,27.03,-1,-67838,75645,143483,7807,0,-2806,6627,0,0,,9433,3821
1,01-02-18,13,3:00,3:15,33.02,36.11,0,34.12,34.12,2,-83645,71968,155613,-11677,0,-1148,411,0,0,,1559,-737
1,01-02-18,14,3:15,3:30,32.61,28.38,0,28.38,28.38,-1,-67577,83999,151576,16422,0,-3469,108,0,0,,3577,-3361
1,01-02-18,15,3:30,3:45,,28.38,0,28.38,28.38,-1,-74348,91415,165763,17067,0,-8908,0,0,0,,8908,-8908
1,01-02-18,16,3:45,4:00,,5.78,0,5.78,5.78,-1,-49450,99566,149016,50116,0,-28100,0,0,0,,28100,-28100
1,01-02-18,17,4:00,4:15,,19.78,0,19.78,19.78,-1,-55587,106157,161744,50570,0,-32150,0,0,0,,32150,-32150
1,01-02-18,18,4:15,4:30,,26.78,0,26.78,26.78,-1,-66563,108712,175275,42149,0,-7969,0,0,0,,7969,-7969
1,01-02-18,19,4:30,4:45,,9.91,0,9.91,9.91,-1,-46301,123558,169859,77257,0,-35857,0,0,0,,35857,-35857
1,01-02-18,20,4:45,5:00,,24.91,0,24.91,24.91,-1,-59910,108666,168576,48756,0,-26703,0,0,0,,26703,-26703
1,01-02-18,21,5:00,5:15,,30.8,0,30.8,30.8,-1,-63022,130912,193934,67890,0,-5156,0,0,0,,5156,-5156
1,01-02-18,22,5:15,5:30,,33.28,0,33.28,33.28,-1,-90225,117563,207788,27338,0,-2451,0,0,0,,2451,-2451
1,01-02-18,23,5:30,5:45,,33.28,0,33.28,33.28,-1,-92990,98226,191216,5236,0,-1206,0,0,0,,1206,-1206
1,01-02-18,24,5:45,6:00,,,0,33.2,33.2,0,-84120,107681,191801,23561,0,0,0,0,0,,0,0
1,01-02-18,25,6:00,6:15,,22.58,0,22.58,22.58,-1,-96987,132974,229961,35987,0,-7630,0,0,0,,7630,-7630
1,01-02-18,26,6:15,6:30,,,0,33.6,33.6,0,-91946,113207,205153,21261,0,-402,0,0,0,,402,-402
1,01-02-18,27,6:30,6:45,34.69,,0,34.69,34.69,1,-123635,93703,217338,-29932,0,0,199,0,0,,199,199
1,01-02-18,28,6:45,7:00,,32.58,0,32.58,32.58,-1,-119342,104771,224113,-14571,0,-105,0,0,0,,105,-105
1,01-02-18,29,7:00,7:15,,24.01,0,24.01,24.01,-1,-146097,135740,281837,-10357,0,-2387,0,0,0,,2387,-2387
1,01-02-18,30,7:15,7:30,,11.05,0,11.05,11.05,-1,-130192,119221,249413,-10971,0,-21686,0,0,0,,21686,-21686
1,01-02-18,31,7:30,7:45,47.92,11.05,0,47.92,47.92,1,-157753,113021,270774,-44732,0,-819,5395,0,0,,6214,4576
1,01-02-18,32,7:45,8:00,99.48,,0,99.48,99.48,1,-191928,118766,310694,-73162,0,0,48173,0,0,,48173,48173
1,01-02-18,33,8:00,8:15,65.89,15.78,0,15.78,15.78,-1,-119915,94413,214328,-25502,0,-3225,28559,0,0,,31784,25334
1,01-02-18,34,8:15,8:30,,9.78,0,9.78,9.78,-1,-104184,92124,196308,-12060,0,-6788,0,0,0,,6788,-6788
1,01-02-18,35,8:30,8:45,,,0,36.89,36.89,0,-115798,82698,198496,-33100,0,-10,0,0,0,,10,-10
1,01-02-18,36,8:45,9:00,,,0,36.87,36.87,0,-96199,92558,188757,-3641,0,0,0,0,0,,0,0
1,01-02-18,37,9:00,9:15,,-5.98,0,-5.98,-5.98,-1,-48690,108636,157326,59946,0,-17461,0,0,0,,17461,-17461
1,01-02-18,38,9:15,9:30,,32,0,32,32,-1,-67810,105917,173727,38107,0,-27094,0,0,0,,27094,-27094
1,01-02-18,39,9:30,9:45,,32.54,0,32.54,32.54,-1,-81497,93349,174846,11852,0,-19121,0,0,0,,19121,-19121
1,01-02-18,40,9:45,10:00,44.45,32.54,0,44.45,44.45,1,-99544,77580,177124,-21964,0,-1593,1857,0,0,,3450,264
1,01-02-18,41,10:00,10:15,95.12,,0,95.12,95.12,1,-115480,61498,176978,-53982,0,0,36688,0,0,,36688,36688
1,01-02-18,42,10:15,10:30,79.12,,0,79.12,79.12,1,-126211,68773,194984,-57438,0,0,49504,0,0,,49504,49504
1,01-02-18,43,10:30,10:45,45.7,,0,45.7,45.7,1,-122412,88063,210475,-34349,0,0,33786,0,0,,33786,33786
1,01-02-18,44,10:45,11:00,62,,0,62,62,1,-120582,89253,209835,-31329,0,0,21580,0,0,,21580,21580
1,01-02-18,45,11:00,11:15,67.7,,0,67.7,67.7,1,-107405,89635,197040,-17770,0,0,25659,0,0,,25659,25659
1,01-02-18,46,11:15,11:30,37.53,,0,37.53,37.53,1,-109514,112062,221576,2548,0,0,4710,0,0,,4710,4710
1,01-02-18,47,11:30,11:45,36.67,,0,36.67,36.67,1,-114102,122976,237078,8874,0,0,1606,0,0,,1606,1606
1,01-02-18,48,11:45,12:00,39.54,,0,39.54,39.54,1,-123751,121290,245041,-2461,0,0,497,0,0,,497,497
1,01-02-18,49,12:00,12:15,147.12,,0,147.12,147.12,1,-154795,62130,216925,-92665,0,0,36107,0,0,,36107,36107
1,01-02-18,50,12:15,12:30,147.12,,0,147.12,147.12,1,-159031,54598,213629,-104433,0,0,91685,0,0,,91685,91685
1,01-02-18,51,12:30,12:45,121.12,,0,121.12,121.12,1,-161044,63629,224673,-97415,0,0,85398,0,0,,85398,85398
1,01-02-18,52,12:45,13:00,78.56,,0,78.56,78.56,1,-164015,74433,238448,-89582,0,0,67667,0,0,,67667,67667
1,01-02-18,53,13:00,13:15,60.45,,0,60.45,60.45,1,-153977,101501,255478,-52476,0,0,41990,0,0,,41990,41990
1,01-02-18,54,13:15,13:30,,,0,35.9,35.9,0,-161692,89608,251300,-72084,0,0,6553,0,0,,6553,6553
1,01-02-18,55,13:30,13:45,142.12,,0,142.12,142.12,1,-168355,82211,250566,-86144,0,0,28549,0,0,,28549,28549
1,01-02-18,56,13:45,14:00,45.11,,0,45.11,45.11,1,-149869,82549,232418,-67320,0,0,14907,0,0,,14907,14907
1,01-02-18,57,14:00,14:15,71.22,,0,71.22,71.22,1,-159073,89767,248840,-69306,0,0,7807,0,0,,7807,7807
1,01-02-18,58,14:15,14:30,80.12,,0,80.12,80.12,1,-154986,90363,245349,-64623,0,0,25563,0,0,,25563,25563
1,01-02-18,59,14:30,14:45,,,0,35.84,35.84,0,-133140,78967,212107,-54173,0,0,539,0,0,,539,539
1,01-02-18,60,14:45,15:00,,,0,35.84,35.84,0,-138433,72931,211364,-65502,0,0,0,0,0,,0,0
1,01-02-18,61,15:00,15:15,142.12,,0,142.12,142.12,1,-156066,70993,227059,-85073,0,0,28389,0,0,,28389,28389
1,01-02-18,62,15:15,15:30,49.86,,0,49.86,49.86,1,-131946,98325,230271,-33621,0,0,22679,0,0,,22679,22679
1,01-02-18,63,15:30,15:45,46.82,,0,46.82,46.82,1,-113172,89376,202548,-23796,0,0,15591,0,0,,15591,15591
1,01-02-18,64,15:45,16:00,,,0,35.74,35.74,0,-118080,75255,193335,-42825,0,0,1220,0,0,,1220,1220
1,01-02-18,65,16:00,16:15,,,0,36.04,36.04,0,-108953,90651,199604,-18302,0,0,0,0,0,,0,0
1,01-02-18,66,16:15,16:30,,28.54,0,28.54,28.54,-1,-94601,105828,200429,11227,0,-3886,0,0,0,,3886,-3886
1,01-02-18,67,16:30,16:45,,35.4,0,35.4,35.4,-1,-114594,103356,217950,-11238,0,-2435,0,0,0,,2435,-2435
1,01-02-18,68,16:45,17:00,33.34,,0,33.34,33.34,1,-151260,94287,245547,-56973,0,0,42,0,0,,42,42
1,01-02-18,69,17:00,17:15,,,0,36.46,36.46,0,-88562,73718,162280,-14844,0,0,22,0,0,,22,22
1,01-02-18,70,17:15,17:30,,,0,36.47,36.47,0,-111956,65409,177365,-46547,0,0,0,0,0,,0,0
1,01-02-18,71,17:30,17:45,,,0,35.97,35.97,0,-120802,82906,203708,-37896,0,0,0,0,0,,0,0
1,01-02-18,72,17:45,18:00,,,0,35.96,35.96,0,-105343,116269,221612,10926,0,0,0,0,0,,0,0
1,01-02-18,73,18:00,18:15,42.07,,0,42.07,42.07,1,-179706,68491,248197,-111215,0,0,2134,0,0,,2134,2134
1,01-02-18,74,18:15,18:30,,37.3,0,37.3,37.3,-1,-106158,105169,211327,-989,0,-7,0,0,0,,7,-7
1,01-02-18,75,18:30,18:45,,10.88,0,10.88,10.88,-1,-63945,123864,187809,59919,0,-24622,0,0,0,,24622,-24622
1,01-02-18,76,18:45,19:00,,-16.46,0,-16.46,-16.46,-1,-48546,132059,180605,83513,0,-45425,0,0,0,,45425,-45425
1,01-02-18,77,19:00,19:15,45.73,34.09,0,45.73,34.09,2,-85079,77536,162615,-7543,0,-16236,778,0,0,,17014,-15458
1,01-02-18,78,19:15,19:30,,-16.46,0,-16.46,-16.46,-1,-47105,90559,137664,43454,0,-26138,0,0,0,,26138,-26138
1,01-02-18,79,19:30,19:45,,1.94,0,1.94,1.94,-1,-51270,101217,152487,49947,0,-34313,0,0,0,,34313,-34313
1,01-02-18,80,19:45,20:00,,-10.89,0,-10.89,-10.89,-1,-85119,89796,174915,4677,0,-51887,0,0,0,,51887,-51887
1,01-02-18,81,20:00,20:15,,19.78,0,19.78,19.78,-1,-41342,126940,168282,85598,0,-19170,0,0,0,,19170,-19170
1,01-02-18,82,20:15,20:30,,18.54,0,18.54,18.54,-1,-64184,84280,148464,20096,0,-9805,0,0,0,,9805,-9805
1,01-02-18,83,20:30,20:45,,9.64,0,9.64,9.64,-1,-98003,95917,193920,-2086,0,-20802,0,0,0,,20802,-20802
1,01-02-18,84,20:45,21:00,,16.76,0,16.76,16.76,-1,-100657,128103,228760,27446,0,-7666,0,0,0,,7666,-7666
1,01-02-18,85,21:00,21:15,,-74.54,0,-74.54,-74.54,-1,-49355,176458,225813,127103,0,-49769,0,0,0,,49769,-49769
1,01-02-18,86,21:15,21:30,,-74.54,0,-74.54,-74.54,-1,-64484,133769,198253,69285,0,-19117,0,0,0,,19117,-19117
1,01-02-18,87,21:30,21:45,,-74.54,0,-74.54,-74.54,-1,-79247,112286,191533,33039,0,-39693,0,0,0,,39693,-39693
1,01-02-18,88,21:45,22:00,,-71.08,0,-71.08,-71.08,-1,-36681,103498,140179,66817,0,-38966,0,0,0,,38966,-38966
1,01-02-18,89,22:00,22:15,46.8,27.09,0,46.8,27.09,2,-100708,66778,167486,-33930,0,-15420,1988,0,0,,17408,-13432
1,01-02-18,90,22:15,22:30,34.17,,0,34.17,34.17,1,-76992,66395,143387,-10597,0,0,1131,0,0,,1131,1131
1,01-02-18,91,22:30,22:45,,,0,34.03,34.03,0,-43135,93662,136797,50527,0,0,46,0,0,,46,46
1,01-02-18,92,22:45,23:00,,-3.94,0,-3.94,-3.94,-1,-25635,119771,145406,94136,0,-3176,0,0,0,,3176,-3176
1,01-02-18,93,23:00,23:15,50.12,-0.78,0,50.12,-0.78,2,-87690,49453,137143,-38237,0,-4632,5495,0,0,,10127,863
1,01-02-18,94,23:15,23:30,37.12,,0,37.12,37.12,1,-70262,34335,104597,-35927,0,0,5004,0,0,,5004,5004
1,01-02-18,95,23:30,23:45,40.27,,0,40.27,40.27,1,-57544,44274,101818,-13270,0,0,6533,0,0,,6533,6533
1,01-02-18,96,23:45,0:00,40.27,28.51,0,28.51,28.51,-1,-35458,66530,101988,31072,0,-2327,837,0,0,,3164,-1490
1,01-03-18,1,0:00,0:15,,26.03,0,26.03,26.03,-1,-49119,141130,190249,92011,0,-3041,0,0,0,,3041,-3041
1,01-03-18,2,0:15,0:30,,,0,34.85,34.85,0,-56410,95798,152208,39388,0,0,0,0,0,,0,0
1,01-03-18,3,0:30,0:45,,,0,34.86,34.86,0,-45972,90066,136038,44094,0,0,0,0,0,,0,0
1,01-03-18,4,0:45,1:00,,-69.12,0,-69.12,-69.12,-1,-36538,126208,162746,89670,0,-9210,0,0,0,,9210,-9210
1,01-03-18,5,1:00,1:15,42.22,-36.96,0,42.22,-36.96,2,-78132,61534,139666,-16598,0,-10287,782,0,0,,11069,-9505
1,01-03-18,6,1:15,1:30,36.27,,0,36.27,36.27,1,-62492,60463,122955,-2029,0,0,762,0,0,,762,762
1,01-03-18,7,1:30,1:45,,,0,33.43,33.43,0,-54542,73050,127592,18508,0,0,0,0,0,,0,0
1,01-03-18,8,1:45,2:00,,34.83,0,34.83,34.83,-1,-49926,101891,151817,51965,0,-1,0,0,0,,1,-1
1,01-03-18,9,2:00,2:15,,33.98,0,33.98,33.98,-1,-69772,59136,128908,-10636,0,-569,0,0,0,,569,-569
1,01-03-18,10,2:15,2:30,,,0,33.14,33.14,0,-65011,67846,132857,2835,0,0,0,0,0,,0,0
1,01-03-18,11,2:30,2:45,,,0,33.12,33.12,0,-55044,82026,137070,26982,0,0,0,0,0,,0,0
1,01-03-18,12,2:45,3:00,,32.97,0,32.97,32.97,-1,-56179,92115,148294,35936,0,-342,0,0,0,,342,-342
1,01-03-18,13,3:00,3:15,104.33,,0,104.33,104.33,1,-95646,30685,126331,-64961,0,0,20802,0,0,,20802,20802
1,01-03-18,14,3:15,3:30,113.02,,0,113.02,113.02,1,-96487,33152,129639,-63335,0,0,57631,0,0,,57631,57631
1,01-03-18,15,3:30,3:45,45.19,,0,45.19,45.19,1,-90479,49623,140102,-40856,0,0,30380,0,0,,30380,30380
1,01-03-18,16,3:45,4:00,55.17,,0,55.17,55.17,1,-101908,49930,151838,-51978,0,0,19888,0,0,,19888,19888
1,01-03-18,17,4:00,4:15,58.27,,0,58.27,58.27,1,-123177,58530,181707,-64647,0,0,47978,0,0,,47978,47978
1,01-03-18,18,4:15,4:30,46.27,,0,46.27,46.27,1,-116496,59004,175500,-57492,0,0,47302,0,0,,47302,47302
1,01-03-18,19,4:30,4:45,60.55,,0,60.55,60.55,1,-110787,61802,172589,-48985,0,0,52943,0,0,,52943,52943
1,01-03-18,20,4:45,5:00,40.27,,0,40.27,40.27,1,-90575,49749,140324,-40826,0,0,29146,0,0,,29146,29146
1,01-03-18,21,5:00,5:15,40.27,33.33,0,33.33,33.33,-1,-54328,73606,127934,19278,0,-842,5776,0,0,,6618,4934
1,01-03-18,22,5:15,5:30,59.18,,0,59.18,59.18,1,-100274,58860,159134,-41414,0,0,8872,0,0,,8872,8872
1,01-03-18,23,5:30,5:45,72.82,,0,72.82,72.82,1,-123351,82285,205636,-41066,0,0,45523,0,0,,45523,45523
1,01-03-18,24,5:45,6:00,32.29,25.68,0,32.81,25.68,2,-127264,104025,231289,-23239,0,-568,6186,0,0,,6754,5618
1,01-03-18,25,6:00,6:15,32.07,,0,32.07,32.07,1,-55482,124642,180124,69160,0,0,375,0,0,,375,375
1,01-03-18,26,6:15,6:30,32.37,,0,32.37,32.37,1,-55999,80188,136187,24189,0,0,88,0,0,,88,88
1,01-03-18,27,6:30,6:45,81.41,,0,81.41,81.41,1,-123324,59950,183274,-63374,0,0,27011,0,0,,27011,27011
1,01-03-18,28,6:45,7:00,82.72,,0,82.72,82.72,1,-152618,93246,245864,-59372,0,0,66856,0,0,,66856,66856
1,01-03-18,29,7:00,7:15,82.72,-95.06,0,-95.06,-95.06,-1,-62348,137145,199493,74797,0,-22247,8886,0,0,,31133,-13361
1,01-03-18,30,7:15,7:30,,5.42,0,5.42,5.42,-1,-68837,125429,194266,56592,0,-59448,0,0,0,,59448,-59448
1,01-03-18,31,7:30,7:45,46.27,5.42,0,46.27,46.27,1,-119674,121583,241257,1909,0,-10610,1451,0,0,,12061,-9159
1,01-03-18,32,7:45,8:00,58.27,,0,58.27,58.27,1,-162311,126311,288622,-36000,0,0,27336,0,0,,27336,27336
1,01-03-18,33,8:00,8:15,38.67,33.82,0,38.67,33.82,2,-51613,139109,190722,87496,0,-1244,11539,0,0,,12783,10295
1,01-03-18,34,8:15,8:30,,,0,33.83,33.83,0,-61694,130156,191850,68462,0,-2,0,0,0,,2,-2
1,01-03-18,35,8:30,8:45,44.88,,0,44.88,44.88,1,-70418,136479,206897,66061,0,0,3409,0,0,,3409,3409
1,01-03-18,36,8:45,9:00,,,0,33.7,33.7,0,-80065,165157,245222,85092,0,0,65,0,0,,65,65
1,01-03-18,37,9:00,9:15,38.12,,0,38.12,38.12,1,-73034,149822,222856,76788,0,0,549,0,0,,549,549
1,01-03-18,38,9:15,9:30,49.1,,0,49.1,49.1,1,-78286,131912,210198,53626,0,0,10254,0,0,,10254,10254
1,01-03-18,39,9:30,9:45,44.67,,0,44.67,44.67,1,-87881,132891,220772,45010,0,0,13537,0,0,,13537,13537
1,01-03-18,40,9:45,10:00,48.65,,0,48.65,48.65,1,-100661,123368,224029,22707,0,0,23175,0,0,,23175,23175
1,01-03-18,41,10:00,10:15,52.24,,0,52.24,52.24,1,-92054,133354,225408,41300,0,0,28632,0,0,,28632,28632
1,01-03-18,42,10:15,10:30,72.13,,0,72.13,72.13,1,-108698,125961,234659,17263,0,0,22214,0,0,,22214,22214
1,01-03-18,43,10:30,10:45,142.02,,0,142.02,142.02,1,-137619,116438,254057,-21181,0,0,69080,0,0,,69080,69080
1,01-03-18,44,10:45,11:00,142.02,,0,142.02,142.02,1,-150473,113279,263752,-37194,0,0,86602,0,0,,86602,86602
1,01-03-18,45,11:00,11:15,142.02,,0,142.02,142.02,1,-127804,89472,217276,-38332,0,0,95577,0,0,,95577,95577
1,01-03-18,46,11:15,11:30,239.02,,0,239.02,239.02,1,-144036,83312,227348,-60724,0,0,100626,7500,0,,108126,108126
1,01-03-18,47,11:30,11:45,321.02,,0,321.02,321.02,1,-150124,93226,243350,-56898,0,0,107232,10000,0,,117232,117232
1,01-03-18,48,11:45,12:00,350.02,,0,350.02,350.02,1,-166196,96758,262954,-69438,0,0,119325,11250,0,,130575,130575
1,01-03-18,49,12:00,12:15,350.02,,0,350.02,350.02,1,-142907,92900,235807,-50007,0,0,121266,11250,0,,132516,132516
1,01-03-18,50,12:15,12:30,341.4,,0,341.4,341.4,1,-132205,102245,234450,-29960,0,0,94911,11250,0,,106161,106161
1,01-03-18,51,12:30,12:45,191.4,,0,191.4,191.4,1,-114810,109745,224555,-5065,0,0,74109,8750,0,,82859,82859
1,01-03-18,52,12:45,13:00,141.4,,0,141.4,141.4,1,-99192,129802,228994,30610,0,0,45980,7500,0,,53480,53480
1,01-03-18,53,13:00,13:15,350.02,,0,350.02,350.02,1,-125318,103763,229081,-21555,0,0,35958,0,0,,35958,35958
1,01-03-18,54,13:15,13:30,350.02,,0,350.02,350.02,1,-127139,108581,235720,-18558,0,0,77854,0,0,,77854,77854
1,01-03-18,55,13:30,13:45,60.93,,0,60.93,60.93,1,-105857,104189,210046,-1668,0,0,48099,0,0,,48099,48099
1,01-03-18,56,13:45,14:00,101.09,,0,101.09,101.09,1,-110405,94528,204933,-15877,0,0,63170,0,0,,63170,63170
1,01-03-18,57,14:00,14:15,54.02,30.76,0,30.76,30.76,-1,-126909,150577,277486,23668,0,-778,34443,0,0,,35221,33665
1,01-03-18,58,14:15,14:30,,,0,33.5,33.5,0,-112798,157225,270023,44427,0,-558,91,0,0,,649,-467
1,01-03-18,59,14:30,14:45,,25.76,0,25.76,25.76,-1,-118150,154444,272594,36294,0,-5539,0,0,0,,5539,-5539
1,01-03-18,60,14:45,15:00,,35.32,0,35.32,35.32,-1,-98450,142485,240935,44035,0,-158,0,0,0,,158,-158
1,01-03-18,61,15:00,15:15,,35.4,0,35.4,35.4,-1,-156693,159238,315931,2545,0,-142,0,0,0,,142,-142
1,01-03-18,62,15:15,15:30,39.55,,0,39.55,39.55,1,-166989,151193,318182,-15796,0,0,457,0,0,,457,457
1,01-03-18,63,15:30,15:45,44.37,,0,44.37,44.37,1,-159414,145312,304726,-14102,0,0,7537,0,0,,7537,7537
1,01-03-18,64,15:45,16:00,44.37,33.56,0,33.56,33.56,-1,-135577,156661,292238,21084,0,-1700,1445,0,0,,3145,-255
1,01-03-18,65,16:00,16:15,,24.2,0,24.2,24.2,-1,-122295,154391,276686,32096,0,-23558,0,0,0,,23558,-23558
1,01-03-18,66,16:15,16:30,,33.56,0,33.56,33.56,-1,-140383,164744,305127,24361,0,-18810,0,0,0,,18810,-18810
1,01-03-18,67,16:30,16:45,,33.56,0,33.56,33.56,-1,-133536,149648,283184,16112,0,-14139,0,0,0,,14139,-14139
1,01-03-18,68,16:45,17:00,58.26,33.56,0,58.26,58.26,1,-161474,130559,292033,-30915,0,-2594,15548,0,0,,18142,12954
1,01-03-18,69,17:00,17:15,42.58,-15.44,0,44.79,-15.44,2,-103970,148041,252011,44071,0,-14008,10620,0,0,,24628,-3388
1,01-03-18,70,17:15,17:30,49.75,34.56,0,49.75,34.56,2,-147658,131428,279086,-16230,0,-4695,4323,0,0,,9018,-372
1,01-03-18,71,17:30,17:45,37.02,,0,37.02,37.02,1,-157130,157137,314267,7,0,0,2579,0,0,,2579,2579
1,01-03-18,72,17:45,18:00,39.67,,0,39.67,39.67,1,-130726,170069,300795,39343,0,0,1588,0,0,,1588,1588
1,01-03-18,73,18:00,18:15,39.67,33.56,0,33.56,33.56,-1,-119553,128386,247939,8833,0,-344,23,0,0,,367,-321
1,01-03-18,74,18:15,18:30,,7.91,0,7.91,7.91,-1,-88639,133512,222151,44873,0,-3531,0,0,0,,3531,-3531
1,01-03-18,75,18:30,18:45,55.22,-15.44,0,55.22,-15.44,2,-96506,92616,189122,-3890,0,-18298,636,0,0,,18934,-17662
1,01-03-18,76,18:45,19:00,55.06,-15.44,0,55.06,55.06,1,-112756,125780,238536,13024,0,-74,2334,0,0,,2408,2260
1,01-03-18,77,19:00,19:15,57.89,,0,57.89,57.89,1,-96738,99210,195948,2472,0,0,3905,0,0,,3905,3905
1,01-03-18,78,19:15,19:30,64.68,33.82,0,64.68,33.82,2,-86243,82795,169038,-3448,0,-17,22782,0,0,,22799,22765
1,01-03-18,79,19:30,19:45,64.68,33.27,0,33.27,33.27,-1,-50687,97342,148029,46655,0,-1374,665,0,0,,2039,-709
1,01-03-18,80,19:45,20:00,,34.8,0,34.8,34.8,-1,-70672,92713,163385,22041,0,-1642,0,0,0,,1642,-1642
1,01-03-18,81,20:00,20:15,,26.78,0,26.78,26.78,-1,-102183,81486,183669,-20697,0,-1748,0,0,0,,1748,-1748
1,01-03-18,82,20:15,20:30,,19.27,0,19.27,19.27,-1,-113376,78157,191533,-35219,0,-4133,0,0,0,,4133,-4133
1,01-03-18,83,20:30,20:45,,19.27,0,19.27,19.27,-1,-92849,88406,181255,-4443,0,-1066,0,0,0,,1066,-1066
1,01-03-18,84,20:45,21:00,38.9,-0.73,0,38.9,-0.73,2,-122108,81733,203841,-40375,0,-19924,124,0,0,,20048,-19800
1,01-03-18,85,21:00,21:15,106.02,-0.73,0,106.02,106.02,1,-141573,97058,238631,-44515,0,-345,28462,0,0,,28807,28117
1,01-03-18,86,21:15,21:30,42.49,,0,42.49,42.49,1,-95382,79295,174677,-16087,0,0,19588,0,0,,19588,19588
1,01-03-18,87,21:30,21:45,38.02,,0,38.02,38.02,1,-80362,70139,150501,-10223,0,0,5320,0,0,,5320,5320
1,01-03-18,88,21:45,22:00,38.22,,0,38.22,38.22,1,-66794,71412,138206,4618,0,0,759,0,0,,759,759
1,01-03-18,89,22:00,22:15,142.14,,0,142.14,142.14,1,-132316,66025,198341,-66291,0,0,30719,0,0,,30719,30719
1,01-03-18,90,22:15,22:30,44.1,,0,44.1,44.1,1,-86867,76788,163655,-10079,0,0,19500,0,0,,19500,19500
1,01-03-18,91,22:30,22:45,44.1,35.21,0,35.21,35.21,-1,-51740,84653,136393,32913,0,-241,960,0,0,,1201,719
1,01-03-18,92,22:45,23:00,,,0,33.68,33.68,0,-34001,90870,124871,56869,0,0,0,0,0,,0,0
1,01-03-18,93,23:00,23:15,87.01,,0,87.01,87.01,1,-118823,56838,175661,-61985,0,0,19340,0,0,,19340,19340
1,01-03-18,94,23:15,23:30,49.45,,0,49.45,49.45,1,-92619,65679,158298,-26940,0,0,39551,0,0,,39551,39551
1,01-03-18,95,23:30,23:45,49.45,31.93,0,31.93,31.93,-1,-67190,80649,147839,13459,0,-2748,8266,0,0,,11014,5518
1,01-03-18,96,23:45,0:00,,9.57,0,9.57,9.57,-1,-49136,101970,151106,52834,0,-23172,0,0,0,,23172,-23172
1,01-04-18,1,0:00,0:15,77.14,25.78,0,77.14,25.78,2,-88256,67335,155591,-20921,0,-16337,6282,0,0,,22619,-10055
1,01-04-18,2,0:15,0:30,51.27,,0,51.27,51.27,1,-69290,49385,118675,-19905,0,0,17276,0,0,,17276,17276
1,01-04-18,3,0:30,0:45,40.27,,0,40.27,40.27,1,-56593,40731,97324,-15862,0,0,15944,0,0,,15944,15944
1,01-04-18,4,0:45,1:00,37.44,26.79,0,26.79,26.79,-1,-33457,48281,81738,14824,0,-1479,10549,0,0,,12028,9070
1,01-04-18,5,1:00,1:15,58.27,19.95,0,58.27,58.27,1,-54510,49800,104310,-4710,0,-2130,4127,0,0,,6257,1997
1,01-04-18,6,1:15,1:30,71.9,,0,71.9,71.9,1,-63273,41069,104342,-22204,0,0,31060,0,0,,31060,31060
1,01-04-18,7,1:30,1:45,39.79,,0,39.79,39.79,1,-53848,44254,98102,-9594,0,0,7682,0,0,,7682,7682
1,01-04-18,8,1:45,2:00,32.93,31.86,0,33.2,31.86,2,-42152,48581,90733,6429,0,-310,3813,0,0,,4123,3503
1,01-04-18,9,2:00,2:15,51.33,32.24,0,51.33,32.24,2,-70621,53125,123746,-17496,0,-482,4010,0,0,,4492,3528
1,01-04-18,10,2:15,2:30,37.04,,0,37.04,37.04,1,-53346,54543,107889,1197,0,0,6040,0,0,,6040,6040
1,01-04-18,11,2:30,2:45,40,,0,40,40,1,-51097,51294,102391,197,0,0,3176,0,0,,3176,3176
1,01-04-18,12,2:45,3:00,35.27,,0,35.27,35.27,1,-46899,51709,98608,4810,0,0,1511,0,0,,1511,1511
1,01-04-18,13,3:00,3:15,35.27,33.27,0,33.27,33.27,-1,-24489,96638,121127,72149,0,-539,22,0,0,,561,-517
1,01-04-18,14,3:15,3:30,,32.42,0,32.42,32.42,-1,-53197,83777,136974,30580,0,-1249,0,0,0,,1249,-1249
1,01-04-18,15,3:30,3:45,,29.44,0,29.44,29.44,-1,-49779,77337,127116,27558,0,-5966,0,0,0,,5966,-5966
1,01-04-18,16,3:45,4:00,,19.94,0,19.94,19.94,-1,-42200,70292,112492,28092,0,-13750,0,0,0,,13750,-13750
1,01-04-18,17,4:00,4:15,,31.74,0,31.74,31.74,-1,-22039,122631,144670,100592,0,-9871,0,0,0,,9871,-9871
1,01-04-18,18,4:15,4:30,,,0,32.89,32.89,0,-35932,108566,144498,72634,0,-38,0,0,0,,38,-38
1,01-04-18,19,4:30,4:45,,,0,32.92,32.92,0,-36327,98471,134798,62144,0,0,0,0,0,,0,0
1,01-04-18,20,4:45,5:00,,,0,32.91,32.91,0,-37315,98224,135539,60909,0,0,0,0,0,,0,0
1,01-04-18,21,5:00,5:15,,-72.1,0,-72.1,-72.1,-1,-12819,179264,192083,166445,0,-24232,0,0,0,,24232,-24232
1,01-04-18,22,5:15,5:30,,33.35,0,33.35,33.35,-1,-21177,129395,150572,108218,0,-4554,0,0,0,,4554,-4554
1,01-04-18,23,5:30,5:45,,34.27,0,34.27,34.27,-1,-48413,94537,142950,46124,0,-921,0,0,0,,921,-921
1,01-04-18,24,5:45,6:00,,16.17,0,16.17,16.17,-1,-83109,93072,176181,9963,0,-323,0,0,0,,323,-323
1,01-04-18,25,6:00,6:15,,-85.89,0,-85.89,-85.89,-1,-52017,226712,278729,174695,0,-56174,0,0,0,,56174,-56174
1,01-04-18,26,6:15,6:30,,-71.03,0,-71.03,-71.03,-1,-66697,147017,213714,80320,0,-78817,0,0,0,,78817,-78817
1,01-04-18,27,6:30,6:45,,1.78,0,1.78,1.78,-1,-71335,148118,219453,76783,0,-42727,0,0,0,,42727,-42727
1,01-04-18,28,6:45,7:00,,22.78,0,22.78,22.78,-1,-118828,156060,274888,37232,0,-32825,0,0,0,,32825,-32825
1,01-04-18,29,7:00,7:15,,-104.38,0,-104.38,-104.38,-1,-64174,183554,247728,119380,0,-48321,0,0,0,,48321,-48321
1,01-04-18,30,7:15,7:30,,-29.04,0,-29.04,-29.04,-1,-65587,148550,214137,82963,0,-91943,0,0,0,,91943,-91943
1,01-04-18,31,7:30,7:45,,32.11,0,32.11,32.11,-1,-79079,139516,218595,60437,0,-10775,0,0,0,,10775,-10775
1,01-04-18,32,7:45,8:00,,,0,33.44,33.44,0,-109458,127587,237045,18129,0,-190,0,0,0,,190,-190
1,01-04-18,33,8:00,8:15,,-45.05,0,-45.05,-45.05,-1,-76828,151404,228232,74576,0,-14798,0,0,0,,14798,-14798
1,01-04-18,34,8:15,8:30,36.64,32.11,0,36.64,36.64,1,-115255,140384,255639,25129,0,-15493,164,0,0,,15657,-15329
1,01-04-18,35,8:30,8:45,58.45,32.11,0,58.45,58.45,1,-160073,121190,281263,-38883,0,-320,12612,0,0,,12932,12292
1,01-04-18,36,8:45,9:00,55.04,,0,55.04,55.04,1,-156191,112236,268427,-43955,0,0,38374,0,0,,38374,38374
1,01-04-18,37,9:00,9:15,55.04,32.11,0,32.11,32.11,-1,-49659,163402,213061,113743,0,-2225,10849,0,0,,13074,8624
1,01-04-18,38,9:15,9:30,,36.57,0,36.57,36.57,-1,-75456,139070,214526,63614,0,-328,0,0,0,,328,-328
1,01-04-18,39,9:30,9:45,,36.17,0,36.17,36.17,-1,-106886,128443,235329,21557,0,-264,0,0,0,,264,-264
1,01-04-18,40,9:45,10:00,,,0,35.53,35.53,0,-103764,111448,215212,7684,0,0,0,0,0,,0,0
1,01-04-18,41,10:00,10:15,,,0,35.84,35.84,0,-93079,119719,212798,26640,0,0,0,0,0,,0,0
1,01-04-18,42,10:15,10:30,,,0,35.84,35.84,0,-107078,104375,211453,-2703,0,0,0,0,0,,0,0
1,01-04-18,43,10:30,10:45,,,0,35.58,35.58,0,-109796,103285,213081,-6511,0,0,0,0,0,,0,0
1,01-04-18,44,10:45,11:00,,,0,35.55,35.55,0,-108894,99576,208470,-9318,0,0,0,0,0,,0,0
1,01-04-18,45,11:00,11:15,,,0,35.84,35.84,0,-79459,123196,202655,43737,0,0,0,0,0,,0,0
1,01-04-18,46,11:15,11:30,,,0,35.84,35.84,0,-88892,118254,207146,29362,0,0,0,0,0,,0,0
1,01-04-18,47,11:30,11:45,112.42,,0,112.42,112.42,1,-152437,120585,273022,-31852,0,0,3639,0,0,,3639,3639
1,01-04-18,48,11:45,12:00,146.12,,0,146.12,146.12,1,-246065,124328,370393,-121737,0,0,59151,0,0,,59151,59151
1,01-04-18,49,12:00,12:15,292.12,,0,292.12,292.12,1,-206392,103169,309561,-103223,0,0,89030,1250,0,,90280,90280
1,01-04-18,50,12:15,12:30,186.99,,0,186.99,186.99,1,-157001,108252,265253,-48749,0,0,22108,7500,0,,29608,29608
1,01-04-18,51,12:30,12:45,84.12,,0,84.12,84.12,1,-163001,100562,263563,-62439,0,0,4457,0,0,,4457,4457
1,01-04-18,52,12:45,13:00,136.12,,0,136.12,136.12,1,-188954,94059,283013,-94895,0,0,49358,0,0,,49358,49358
1,01-04-18,53,13:00,13:15,39.11,34.23,0,39.11,34.23,2,-105273,105089,210362,-184,0,-244,14490,0,0,,14734,14246
1,01-04-18,54,13:15,13:30,38.56,,0,38.56,38.56,1,-145877,121106,266983,-24771,0,0,2509,0,0,,2509,2509
1,01-04-18,55,13:30,13:45,36.61,,0,36.61,36.61,1,-124198,125520,249718,1322,0,0,1294,0,0,,1294,1294
1,01-04-18,56,13:45,14:00,35.11,,0,35.11,35.11,1,-132462,132947,265409,485,0,0,821,0,0,,821,821
1,01-04-18,57,14:00,14:15,39.11,,0,39.11,39.11,1,-82694,80853,163547,-1841,0,0,773,0,0,,773,773
1,01-04-18,58,14:15,14:30,46.49,,0,46.49,46.49,1,-98878,73151,172029,-25727,0,0,17160,0,0,,17160,17160
1,01-04-18,59,14:30,14:45,38.32,36.66,0,36.66,36.66,-1,-96838,93555,190393,-3283,0,-6,10798,0,0,,10804,10792
1,01-04-18,60,14:45,15:00,38.32,36.66,0,36.66,36.66,-1,-77049,106299,183348,29250,0,-912,51,0,0,,963,-861
1,01-04-18,61,15:00,15:15,39.11,,0,39.11,39.11,1,-99163,88447,187610,-10716,0,0,2083,0,0,,2083,2083
1,01-04-18,62,15:15,15:30,39.11,34.09,0,34.09,34.09,-1,-83618,102706,186324,19088,0,-56,296,0,0,,352,240
1,01-04-18,63,15:30,15:45,,23.27,0,23.27,23.27,-1,-72457,135803,208260,63346,0,-20100,0,0,0,,20100,-20100
1,01-04-18,64,15:45,16:00,,-24.48,0,-24.48,-24.48,-1,-68233,155162,223395,86929,0,-49270,0,0,0,,49270,-49270
1,01-04-18,65,16:00,16:15,,31.78,0,31.78,31.78,-1,-98419,131834,230253,33415,0,-29813,0,0,0,,29813,-29813
1,01-04-18,66,16:15,16:30,,27.02,0,27.02,27.02,-1,-93947,142901,236848,48954,0,-28545,0,0,0,,28545,-28545
1,01-04-18,67,16:30,16:45,,18.11,0,18.11,18.11,-1,-98130,147476,245606,49346,0,-44232,0,0,0,,44232,-44232
1,01-04-18,68,16:45,17:00,36.87,34.09,0,36.87,36.87,1,-131023,145591,276614,14568,0,-14369,12,0,0,,14381,-14357
1,01-04-18,69,17:00,17:15,39.37,,0,39.37,39.37,1,-131513,100275,231788,-31238,0,0,431,0,0,,431,431
1,01-04-18,70,17:15,17:30,,36.42,0,36.42,36.42,-1,-117997,118525,236522,528,0,-98,0,0,0,,98,-98
1,01-04-18,71,17:30,17:45,,32.11,0,32.11,32.11,-1,-101753,145406,247159,43653,0,-1665,0,0,0,,1665,-1665
1,01-04-18,72,17:45,18:00,,31.78,0,31.78,31.78,-1,-82138,177629,259767,95491,0,-1743,0,0,0,,1743,-1743
1,01-04-18,73,18:00,18:15,,36.81,0,36.81,36.81,-1,-147253,128009,275262,-19244,0,-208,0,0,0,,208,-208
1,01-04-18,74,18:15,18:30,,18.11,0,18.11,18.11,-1,-112474,175592,288066,63118,0,-8292,0,0,0,,8292,-8292
1,01-04-18,75,18:30,18:45,,-20.31,0,-20.31,-20.31,-1,-111814,170624,282438,58810,0,-45043,0,0,0,,45043,-45043
1,01-04-18,76,18:45,19:00,,32.11,0,32.11,32.11,-1,-118493,185073,303566,66580,0,-12430,0,0,0,,12430,-12430
1,01-04-18,77,19:00,19:15,,34.48,0,34.48,34.48,-1,-153367,167764,321131,14397,0,-1139,0,0,0,,1139,-1139
1,01-04-18,78,19:15,19:30,,32.11,0,32.11,32.11,-1,-126049,156763,282812,30714,0,-2286,0,0,0,,2286,-2286
1,01-04-18,79,19:30,19:45,,36.81,0,36.81,36.81,-1,-129464,146366,275830,16902,0,-57,0,0,0,,57,-57
1,01-04-18,80,19:45,20:00,,27.43,0,27.43,27.43,-1,-123220,142633,265853,19413,0,-4154,0,0,0,,4154,-4154
1,01-04-18,81,20:00,20:15,,20.75,0,20.75,20.75,-1,-75769,211924,287693,136155,0,-9849,0,0,0,,9849,-9849
1,01-04-18,82,20:15,20:30,,26.23,0,26.23,26.23,-1,-69638,112047,181685,42409,0,-7933,0,0,0,,7933,-7933
1,01-04-18,83,20:30,20:45,,9.1,0,9.1,9.1,-1,-53120,104608,157728,51488,0,-16334,0,0,0,,16334,-16334
1,01-04-18,84,20:45,21:00,,33.16,0,33.16,33.16,-1,-130293,120639,250932,-9654,0,-4441,0,0,0,,4441,-4441
1,01-04-18,85,21:00,21:15,46.16,33.16,0,46.16,46.16,1,-114740,137640,252380,22900,0,-664,1734,0,0,,2398,1070
1,01-04-18,86,21:15,21:30,36.04,26.62,0,26.62,26.62,-1,-78850,154335,233185,75485,0,-490,1994,0,0,,2484,1504
1,01-04-18,87,21:30,21:45,,19.25,0,19.25,19.25,-1,-48066,193842,241908,145776,0,-12803,0,0,0,,12803,-12803
1,01-04-18,88,21:45,22:00,,-29.37,0,-29.37,-29.37,-1,-65880,197133,263013,131253,0,-38437,0,0,0,,38437,-38437
1,01-04-18,89,22:00,22:15,,33.21,0,33.21,33.21,-1,-88785,200111,288896,111326,0,-2638,0,0,0,,2638,-2638
1,01-04-18,90,22:15,22:30,,11.51,0,11.51,11.51,-1,-64867,202418,267285,137551,0,-13925,0,0,0,,13925,-13925
1,01-04-18,91,22:30,22:45,,-9.68,0,-9.68,-9.68,-1,-46717,161458,208175,114741,0,-19856,0,0,0,,19856,-19856
1,01-04-18,92,22:45,23:00,,-10.94,0,-10.94,-10.94,-1,-39819,194153,233972,154334,0,-18512,0,0,0,,18512,-18512
1,01-04-18,93,23:00,23:15,,29.16,0,29.16,29.16,-1,-113464,137041,250505,23577,0,-10864,0,0,0,,10864,-10864
1,01-04-18,94,23:15,23:30,,16.5,0,16.5,16.5,-1,-85730,144133,229863,58403,0,-8181,0,0,0,,8181,-8181
1,01-04-18,95,23:30,23:45,35.72,-11.93,0,35.72,-11.93,2,-91497,118463,209960,26966,0,-11675,340,0,0,,12015,-11335
1,01-04-18,96,23:45,0:00,,15.4,0,15.4,15.4,-1,-57199,162030,219229,104831,0,-5968,0,0,0,,5968,-5968
1,01-05-18,1,0:00,0:15,36.16,32.1,0,36.16,36.16,1,-72516,83793,156309,11277,0,-2509,111,0,0,,2620,-2398
1,01-05-18,2,0:15,0:30,36.16,34.07,0,36.16,33.05,2,-41319,64093,105412,22774,0,-16,1118,0,0,,1134,1102
1,01-05-18,3,0:30,0:45,,30.73,0,30.73,30.73,-1,-29660,65646,95306,35986,0,-799,0,0,0,,799,-799
1,01-05-18,4,0:45,1:00,,17.1,0,17.1,17.1,-1,-31497,82435,113932,50938,0,-8590,0,0,0,,8590,-8590
1,01-05-18,5,1:00,1:15,,21.73,0,21.73,21.73,-1,-32467,61148,93615,28681,0,-21333,0,0,0,,21333,-21333
1,01-05-18,6,1:15,1:30,36.7,21.73,0,36.7,36.7,1,-52488,33400,85888,-19088,0,-4846,796,0,0,,5642,-4050
1,01-05-18,7,1:30,1:45,35.41,,0,35.41,35.41,1,-49925,48177,98102,-1748,0,0,1758,0,0,,1758,1758
1,01-05-18,8,1:45,2:00,35.01,21.73,0,21.73,21.73,-1,-41717,60602,102319,18885,0,-1899,671,0,0,,2570,-1228
1,01-05-18,9,2:00,2:15,,16.86,0,16.86,16.86,-1,-47307,59371,106678,12064,0,-7299,0,0,0,,7299,-7299
1,01-05-18,10,2:15,2:30,42.46,,0,42.46,42.46,1,-51010,44892,95902,-6118,0,0,5298,0,0,,5298,5298
1,01-05-18,11,2:30,2:45,36.26,,0,36.26,36.26,1,-56418,47820,104238,-8598,0,0,2968,0,0,,2968,2968
1,01-05-18,12,2:45,3:00,35.06,,0,35.06,35.06,1,-67829,48556,116385,-19273,0,0,1129,0,0,,1129,1129
1,01-05-18,13,3:00,3:15,,,0,32.57,32.57,0,-42239,91581,133820,49342,0,0,180,0,0,,180,180
1,01-05-18,14,3:15,3:30,,,0,32.56,32.56,0,-48296,74742,123038,26446,0,0,0,0,0,,0,0
1,01-05-18,15,3:30,3:45,40.16,,0,40.16,40.16,1,-70220,65419,135639,-4801,0,0,1788,0,0,,1788,1788
1,01-05-18,16,3:45,4:00,43.4,,0,43.4,43.4,1,-71207,73302,144509,2095,0,0,6239,0,0,,6239,6239
1,01-05-18,17,4:00,4:15,46.16,,0,46.16,46.16,1,-70477,56114,126591,-14363,0,0,5192,0,0,,5192,5192
1,01-05-18,18,4:15,4:30,40.16,,0,40.16,40.16,1,-55416,40955,96371,-14461,0,0,2764,0,0,,2764,2764
1,01-05-18,19,4:30,4:45,132.02,,0,132.02,132.02,1,-91796,18239,110035,-73557,0,0,43815,0,0,,43815,43815
1,01-05-18,20,4:45,5:00,69.73,,0,69.73,69.73,1,-109514,32472,141986,-77042,0,0,78394,0,0,,78394,78394
1,01-05-18,21,5:00,5:15,69.73,27.6,0,27.6,27.6,-1,-56492,112457,168949,55965,0,-2044,21225,0,0,,23269,19181
1,01-05-18,22,5:15,5:30,,,0,33.09,33.09,0,-84946,74304,159250,-10642,0,0,0,0,0,,0,0
1,01-05-18,23,5:30,5:45,91.02,,0,91.02,91.02,1,-107513,40283,147796,-67230,0,0,19132,0,0,,19132,19132
1,01-05-18,24,5:45,6:00,93.61,,0,93.61,93.61,1,-142102,51872,193974,-90230,0,0,75499,0,0,,75499,75499
1,01-05-18,25,6:00,6:15,93.61,-60.06,0,-60.06,-60.06,-1,-65639,138836,204475,73197,0,-7317,26914,0,0,,34231,19597
1,01-05-18,26,6:15,6:30,,33.61,0,33.61,33.61,-1,-77517,86488,164005,8971,0,-3515,0,0,0,,3515,-3515
1,01-05-18,27,6:30,6:45,45.97,,0,45.97,45.97,1,-105522,83082,188604,-22440,0,0,2955,0,0,,2955,2955
1,01-05-18,28,6:45,7:00,78.39,,0,78.39,78.39,1,-120620,73321,193941,-47299,0,0,35987,0,0,,35987,35987
1,01-05-18,29,7:00,7:15,133.02,36.54,0,133.02,34.78,2,-143166,111048,254214,-32118,0,-1,42829,0,0,,42830,42828
1,01-05-18,30,7:15,7:30,133.02,31.8,0,31.8,31.8,-1,-64303,121023,185326,56720,0,-1701,4203,0,0,,5904,2502
1,01-05-18,31,7:30,7:45,53.46,,0,53.46,53.46,1,-115634,94053,209687,-21581,0,0,10135,0,0,,10135,10135
1,01-05-18,32,7:45,8:00,48.02,,0,48.02,48.02,1,-147092,95375,242467,-51717,0,0,30155,0,0,,30155,30155
1,01-05-18,33,8:00,8:15,53.46,,0,53.46,53.46,1,-131936,93177,225113,-38759,0,0,32581,0,0,,32581,32581
1,01-05-18,34,8:15,8:30,47.46,,0,47.46,47.46,1,-117078,74363,191441,-42715,0,0,42818,0,0,,42818,42818
1,01-05-18,35,8:30,8:45,133.02,,0,133.02,133.02,1,-139960,64314,204274,-75646,0,0,53053,0,0,,53053,53053
1,01-05-18,36,8:45,9:00,133.02,,0,133.02,133.02,1,-157260,73271,230531,-83989,0,0,76924,0,0,,76924,76924
1,01-05-18,37,9:00,9:15,133.02,32.18,0,32.18,32.18,-1,-63533,110775,174308,47242,0,-1607,22290,0,0,,23897,20683
1,01-05-18,38,9:15,9:30,37.12,32.18,0,37.12,37.12,1,-91361,88643,180004,-2718,0,-32,485,0,0,,517,453
1,01-05-18,39,9:30,9:45,51.89,,0,51.89,51.89,1,-111388,81038,192426,-30350,0,0,11768,0,0,,11768,11768
1,01-05-18,40,9:45,10:00,54.4,,0,54.4,54.4,1,-127701,76584,204285,-51117,0,0,31896,0,0,,31896,31896
1,01-05-18,41,10:00,10:15,44.02,,0,44.02,44.02,1,-106986,80481,187467,-26505,0,0,31374,0,0,,31374,31374
1,01-05-18,42,10:15,10:30,40.54,,0,40.54,40.54,1,-109551,86027,195578,-23524,0,0,13735,0,0,,13735,13735
1,01-05-18,43,10:30,10:45,42.08,,0,42.08,42.08,1,-119020,88031,207051,-30989,0,0,21317,0,0,,21317,21317
1,01-05-18,44,10:45,11:00,45.34,,0,45.34,45.34,1,-122775,82738,205513,-40037,0,0,25538,0,0,,25538,25538
1,01-05-18,45,11:00,11:15,44.79,,0,44.79,44.79,1,-103426,86624,190050,-16802,0,0,21908,0,0,,21908,21908
1,01-05-18,46,11:15,11:30,38.18,,0,38.18,38.18,1,-108552,86605,195157,-21947,0,0,9915,0,0,,9915,9915
1,01-05-18,47,11:30,11:45,42.85,,0,42.85,42.85,1,-112740,81355,194095,-31385,0,0,14155,0,0,,14155,14155
1,01-05-18,48,11:45,12:00,53.46,,0,53.46,53.46,1,-96694,74942,171636,-21752,0,0,7107,0,0,,7107,7107
1,01-05-18,49,12:00,12:15,133.02,,0,133.02,133.02,1,-142365,27301,169666,-115064,0,0,61827,0,0,,61827,61827
1,01-05-18,50,12:15,12:30,133.02,,0,133.02,133.02,1,-125233,45732,170965,-79501,0,0,92616,0,0,,92616,92616
1,01-05-18,51,12:30,12:45,40.66,,0,40.66,40.66,1,-102165,81632,183797,-20533,0,0,20269,0,0,,20269,20269
1,01-05-18,52,12:45,13:00,40.66,,0,40.66,40.66,1,-112103,78526,190629,-33577,0,0,2369,0,0,,2369,2369
1,01-05-18,53,13:00,13:15,53,,0,53,53,1,-74902,47589,122491,-27313,0,0,1364,0,0,,1364,1364
1,01-05-18,54,13:15,13:30,63.72,,0,63.72,63.72,1,-97262,42178,139440,-55084,0,0,10179,0,0,,10179,10179
1,01-05-18,55,13:30,13:45,,,0,34.63,34.63,0,-100703,41168,141871,-59535,0,0,19,0,0,,19,19
1,01-05-18,56,13:45,14:00,,,0,34.51,34.51,0,-97013,41401,138414,-55612,0,0,0,0,0,,0,0
1,01-05-18,57,14:00,14:15,42.45,,0,42.45,42.45,1,-96323,67719,164042,-28604,0,0,2124,0,0,,2124,2124
1,01-05-18,58,14:15,14:30,42.85,,0,42.85,42.85,1,-99577,72762,172339,-26815,0,0,9484,0,0,,9484,9484
1,01-05-18,59,14:30,14:45,,,0,34.94,34.94,0,-91287,70512,161799,-20775,0,0,1926,0,0,,1926,1926
1,01-05-18,60,14:45,15:00,,,0,34.94,34.94,0,-93920,74527,168447,-19393,0,0,0,0,0,,0,0
1,01-05-18,61,15:00,15:15,42.27,,0,42.27,42.27,1,-95203,37501,132704,-57702,0,0,2536,0,0,,2536,2536
1,01-05-18,62,15:15,15:30,36.02,,0,36.02,36.02,1,-88818,32756,121574,-56062,0,0,287,0,0,,287,287
1,01-05-18,63,15:30,15:45,63.71,,0,63.71,63.71,1,-117859,25760,143619,-92099,0,0,10177,0,0,,10177,10177
1,01-05-18,64,15:45,16:00,143.02,,0,143.02,143.02,1,-134139,34730,168869,-99409,0,0,38769,0,0,,38769,38769
1,01-05-18,65,16:00,16:15,49.74,,0,49.74,49.74,1,-86260,62816,149076,-23444,0,0,18814,0,0,,18814,18814
1,01-05-18,66,16:15,16:30,,,0,34.94,34.94,0,-68630,69997,138627,1367,0,0,0,0,0,,0,0
1,01-05-18,67,16:30,16:45,,,0,34.94,34.94,0,-52603,70435,123038,17832,0,0,0,0,0,,0,0
1,01-05-18,68,16:45,17:00,143.02,,0,143.02,143.02,1,-143130,58385,201515,-84745,0,0,29468,0,0,,29468,29468
1,01-05-18,69,17:00,17:15,49.74,,0,49.74,49.74,1,-81796,74191,155987,-7605,0,0,16242,0,0,,16242,16242
1,01-05-18,70,17:15,17:30,68.35,,0,68.35,68.35,1,-94090,63556,157646,-30534,0,0,7000,0,0,,7000,7000
1,01-05-18,71,17:30,17:45,74.35,,0,74.35,74.35,1,-94696,61485,156181,-33211,0,0,38115,0,0,,38115,38115
1,01-05-18,72,17:45,18:00,37.74,31.74,0,37.74,31.74,2,-78614,109236,187850,30622,0,-999,13368,0,0,,14367,12369
1,01-05-18,73,18:00,18:15,38.1,31.74,0,38.1,38.1,1,-157154,80650,237804,-76504,0,-11,132,0,0,,143,121
1,01-05-18,74,18:15,18:30,,31.74,0,31.74,31.74,-1,-73226,117278,190504,44052,0,-1267,0,0,0,,1267,-1267
1,01-05-18,75,18:30,18:45,,17.74,0,17.74,17.74,-1,-55614,109684,165298,54070,0,-11094,0,0,0,,11094,-11094
1,01-05-18,76,18:45,19:00,,32.55,0,32.55,32.55,-1,-47735,101210,148945,53475,0,-6072,0,0,0,,6072,-6072
1,01-05-18,77,19:00,19:15,,36.18,0,36.18,36.18,-1,-108442,55610,164052,-52832,0,-213,0,0,0,,213,-213
1,01-05-18,78,19:15,19:30,,,0,34.1,34.1,0,-78619,61151,139770,-17468,0,0,0,0,0,,0,0
1,01-05-18,79,19:30,19:45,,31.74,0,31.74,31.74,-1,-61317,86226,147543,24909,0,-182,0,0,0,,182,-182
1,01-05-18,80,19:45,20:00,,24.9,0,24.9,24.9,-1,-66437,114465,180902,48028,0,-16787,0,0,0,,16787,-16787
1,01-05-18,81,20:00,20:15,86.02,31.03,0,86.02,31.03,2,-124693,91159,215852,-33534,0,-11612,7610,0,0,,19222,-4002
1,01-05-18,82,20:15,20:30,41.02,27.74,0,27.74,27.74,-1,-76428,95061,171489,18633,0,-408,8688,0,0,,9096,8280
1,01-05-18,83,20:30,20:45,41.02,-22.49,0,-22.49,-22.49,-1,-46859,123576,170435,76717,0,-12849,123,0,0,,12972,-12726
1,01-05-18,84,20:45,21:00,,-11.03,0,-11.03,-11.03,-1,-80372,109697,190069,29325,0,-28453,0,0,0,,28453,-28453
1,01-05-18,85,21:00,21:15,40.23,31.74,0,40.23,31.74,2,-106279,120011,226290,13732,0,-4753,1279,0,0,,6032,-3474
1,01-05-18,86,21:15,21:30,37.51,,0,37.51,37.51,1,-92489,99580,192069,7091,0,0,264,0,0,,264,264
1,01-05-18,87,21:30,21:45,,,0,33.89,33.89,0,-69597,115356,184953,45759,0,0,0,0,0,,0,0
1,01-05-18,88,21:45,22:00,,,0,33.89,33.89,0,-82531,115616,198147,33085,0,0,0,0,0,,0,0
1,01-05-18,89,22:00,22:15,,34.48,0,34.48,34.48,-1,-76852,112623,189475,35771,0,-69,0,0,0,,69,-69
1,01-05-18,90,22:15,22:30,34.8,,0,34.8,34.8,1,-88301,77545,165846,-10756,0,0,197,0,0,,197,197
1,01-05-18,91,22:30,22:45,,,0,33.73,33.73,0,-88605,97215,185820,8610,0,0,0,0,0,,0,0
1,01-05-18,92,22:45,23:00,,,0,33.75,33.75,0,-73030,124846,197876,51816,0,0,0,0,0,,0,0
1,01-05-18,93,23:00,23:15,40.23,34.33,0,40.23,33.68,2,-64045,91678,155723,27633,0,-22,1192,0,0,,1214,1170
1,01-05-18,94,23:15,23:30,40.23,31.49,0,31.49,31.49,-1,-69560,95015,164575,25455,0,-778,110,0,0,,888,-668
1,01-05-18,95,23:30,23:45,,,0,33.85,33.85,0,-63219,103499,166718,40280,0,-9,0,0,0,,9,-9
1,01-05-18,96,23:45,0:00,,,0,33.85,33.85,0,-69540,118895,188435,49355,0,0,0,0,0,,0,0
2,01-06-18,1,0:00,0:15,,14.45,0,14.45,14.45,-1,-71048,189019,260067,117971,0,-6859,0,0,0,,6859,-6859
2,01-06-18,2,0:15,0:30,36.17,33.17,0,36.17,33.17,2,-73935,80976,154911,7041,0,-27,241,0,0,,268,214
2,01-06-18,3,0:30,0:45,,14.45,0,14.45,14.45,-1,-45595,84197,129792,38602,0,-6180,0,0,0,,6180,-6180
2,01-06-18,4,0:45,1:00,,6.31,0,6.31,6.31,-1,-59866,78196,138062,18330,0,-26191,0,0,0,,26191,-26191
2,01-06-18,5,1:00,1:15,,28.55,0,28.55,28.55,-1,-25639,103569,129208,77930,0,-11527,0,0,0,,11527,-11527
2,01-06-18,6,1:15,1:30,,,0,33.06,33.06,0,-51852,73141,124993,21289,0,-15,0,0,0,,15,-15
2,01-06-18,7,1:30,1:45,,,0,33.05,33.05,0,-41162,79668,120830,38506,0,0,0,0,0,,0,0
2,01-06-18,8,1:45,2:00,,13.55,0,13.55,13.55,-1,-35564,84573,120137,49009,0,-8984,0,0,0,,8984,-8984
2,01-06-18,9,2:00,2:15,74.62,31.83,0,74.62,74.62,1,-66965,31751,98716,-35214,0,-6228,7418,0,0,,13646,1190
2,01-06-18,10,2:15,2:30,44.66,,0,44.66,44.66,1,-49783,37317,87100,-12466,0,0,12416,0,0,,12416,12416
2,01-06-18,11,2:30,2:45,,,0,33.11,33.11,0,-67111,37725,104836,-29386,0,0,1238,0,0,,1238,1238
2,01-06-18,12,2:45,3:00,,,0,33.14,33.14,0,-72032,40516,112548,-31516,0,0,0,0,0,,0,0
2,01-06-18,13,3:00,3:15,40.17,,0,40.17,40.17,1,-52193,46206,98399,-5987,0,0,1155,0,0,,1155,1155
2,01-06-18,14,3:15,3:30,36.17,,0,36.17,36.17,1,-51796,43781,95577,-8015,0,0,716,0,0,,716,716
2,01-06-18,15,3:30,3:45,37.11,,0,37.11,37.11,1,-50691,41580,92271,-9111,0,0,2619,0,0,,2619,2619
2,01-06-18,16,3:45,4:00,,,0,33.17,33.17,0,-47457,46247,93704,-1210,0,0,86,0,0,,86,86
2,01-06-18,17,4:00,4:15,,33.15,0,33.15,33.15,-1,-34540,53766,88306,19226,0,-336,0,0,0,,336,-336
2,01-06-18,18,4:15,4:30,,29.17,0,29.17,29.17,-1,-36857,49659,86516,12802,0,-8078,0,0,0,,8078,-8078
2,01-06-18,19,4:30,4:45,32.13,34.17,0,32.13,32.13,1,-56411,34279,90690,-22132,0,-2110,400,0,0,,2510,-1710
2,01-06-18,20,4:45,5:00,33.14,,0,33.14,33.14,1,-62620,29169,91789,-33451,0,0,726,0,0,,726,726
2,01-06-18,21,5:00,5:15,36.29,,0,36.29,36.29,1,-55551,47648,103199,-7903,0,0,327,0,0,,327,327
2,01-06-18,22,5:15,5:30,32.23,34.17,0,34.17,34.17,-1,-37218,42910,80128,5692,0,-104,58,0,0,,162,-46
2,01-06-18,23,5:30,5:45,,34.17,0,34.17,34.17,-1,-35648,35962,71610,314,0,-343,0,0,0,,343,-343
2,01-06-18,24,5:45,6:00,41.83,,0,41.83,41.83,1,-53391,36362,89753,-17029,0,0,3506,0,0,,3506,3506
2,01-06-18,25,6:00,6:15,41.83,22.09,0,22.09,22.09,-1,-31943,102808,134751,70865,0,-5696,200,0,0,,5896,-5496
2,01-06-18,26,6:15,6:30,,33.09,0,33.09,33.09,-1,-29060,67146,96206,38086,0,-3575,0,0,0,,3575,-3575
2,01-06-18,27,6:30,6:45,41.98,33.09,0,41.98,41.98,1,-61437,43256,104693,-18181,0,-85,3485,0,0,,3570,3400
2,01-06-18,28,6:45,7:00,55.51,,0,55.51,55.51,1,-77692,34649,112341,-43043,0,0,22900,0,0,,22900,22900
2,01-06-18,29,7:00,7:15,55.51,-68.64,0,-68.64,-68.64,-1,-14471,165913,180384,151442,0,-16685,6626,0,0,,23311,-10059
2,01-06-18,30,7:15,7:30,,-68.64,0,-68.64,-68.64,-1,-32816,91677,124493,58861,0,-37215,0,0,0,,37215,-37215
2,01-06-18,31,7:30,7:45,,,0,33.18,33.18,0,-65617,90036,155653,24419,0,-189,0,0,0,,189,-189
2,01-06-18,32,7:45,8:00,,29.09,0,29.09,29.09,-1,-75582,109873,185455,34291,0,-291,0,0,0,,291,-291
2,01-06-18,33,8:00,8:15,,20.01,0,20.01,20.01,-1,-61607,89992,151599,28385,0,-7319,0,0,0,,7319,-7319
2,01-06-18,34,8:15,8:30,,-20.89,0,-20.89,-20.89,-1,-38622,92982,131604,54360,0,-40621,0,0,0,,40621,-40621
2,01-06-18,35,8:30,8:45,,28.17,0,28.17,28.17,-1,-42954,78000,120954,35046,0,-24067,0,0,0,,24067,-24067
2,01-06-18,36,8:45,9:00,39.83,32.22,0,39.83,39.83,1,-53315,66355,119670,13040,0,-13208,398,0,0,,13606,-12810
2,01-06-18,37,9:00,9:15,,,0,34.09,34.09,0,-113624,58999,172623,-54625,0,-27,176,0,0,,203,149
2,01-06-18,38,9:15,9:30,,36.4,0,36.4,36.4,-1,-41646,51846,93492,10200,0,-375,0,0,0,,375,-375
2,01-06-18,39,9:30,9:45,,36.28,0,36.28,36.28,-1,-52019,51662,103681,-357,0,-119,0,0,0,,119,-119
2,01-06-18,40,9:45,10:00,,31.36,0,31.36,31.36,-1,-59678,48145,107823,-11533,0,-1365,0,0,0,,1365,-1365
2,01-06-18,41,10:00,10:15,,17.36,0,17.36,17.36,-1,-31568,72670,104238,41102,0,-17311,0,0,0,,17311,-17311
2,01-06-18,42,10:15,10:30,,26.73,0,26.73,26.73,-1,-34069,54924,88993,20855,0,-32206,0,0,0,,32206,-32206
2,01-06-18,43,10:30,10:45,,30.41,0,30.41,30.41,-1,-38721,59056,97777,20335,0,-28600,0,0,0,,28600,-28600
2,01-06-18,44,10:45,11:00,39.03,30.72,0,39.03,39.03,1,-50173,45251,95424,-4922,0,-16260,340,0,0,,16600,-15920
2,01-06-18,45,11:00,11:15,39.03,27.36,0,27.36,27.36,-1,-45636,84360,129996,38724,0,-5297,123,0,0,,5420,-5174
2,01-06-18,46,11:15,11:30,,27.36,0,27.36,27.36,-1,-42412,83415,125827,41003,0,-13845,0,0,0,,13845,-13845
2,01-06-18,47,11:30,11:45,,30.89,0,30.89,30.89,-1,-49001,95135,144136,46134,0,-8134,0,0,0,,8134,-8134
2,01-06-18,48,11:45,12:00,,30.89,0,30.89,30.89,-1,-38420,97213,135633,58793,0,-12084,0,0,0,,12084,-12084
2,01-06-18,49,12:00,12:15,,31.17,0,31.17,31.17,-1,-31785,70081,101866,38296,0,-5669,0,0,0,,5669,-5669
2,01-06-18,50,12:15,12:30,,30.89,0,30.89,30.89,-1,-48641,67437,116078,18796,0,-4497,0,0,0,,4497,-4497
2,01-06-18,51,12:30,12:45,,30.84,0,30.84,30.84,-1,-48576,83566,132142,34990,0,-5270,0,0,0,,5270,-5270
2,01-06-18,52,12:45,13:00,,31.36,0,31.36,31.36,-1,-50622,92600,143222,41978,0,-377,0,0,0,,377,-377
2,01-06-18,53,13:00,13:15,,31.36,0,31.36,31.36,-1,-44696,75474,120170,30778,0,-524,0,0,0,,524,-524
2,01-06-18,54,13:15,13:30,,17.36,0,17.36,17.36,-1,-36708,79347,116055,42639,0,-3082,0,0,0,,3082,-3082
2,01-06-18,55,13:30,13:45,,10.01,0,10.01,10.01,-1,-36802,92221,129023,55419,0,-30818,0,0,0,,30818,-30818
2,01-06-18,56,13:45,14:00,,14.95,0,14.95,14.95,-1,-31438,96053,127491,64615,0,-39850,0,0,0,,39850,-39850
2,01-06-18,57,14:00,14:15,,1.21,0,1.21,1.21,-1,-42853,60485,103338,17632,0,-30636,0,0,0,,30636,-30636
2,01-06-18,58,14:15,14:30,,18.58,0,18.58,18.58,-1,-28235,88124,116359,59889,0,-1506,0,0,0,,1506,-1506
2,01-06-18,59,14:30,14:45,,-5.09,0,-5.09,-5.09,-1,-27423,92678,120101,65255,0,-22590,0,0,0,,22590,-22590
2,01-06-18,60,14:45,15:00,,2.26,0,2.26,2.26,-1,-25117,104643,129760,79526,0,-47508,0,0,0,,47508,-47508
2,01-06-18,61,15:00,15:15,,,0,36.01,36.01,0,-47325,71309,118634,23984,0,-19113,0,0,0,,19113,-19113
2,01-06-18,62,15:15,15:30,,,0,36.02,36.02,0,-42729,118103,160832,75374,0,0,0,0,0,,0,0
2,01-06-18,63,15:30,15:45,,-17.64,0,-17.64,-17.64,-1,-44420,132433,176853,88013,0,-22659,0,0,0,,22659,-22659
2,01-06-18,64,15:45,16:00,,1.59,0,1.59,1.59,-1,-44124,121111,165235,76987,0,-26654,0,0,0,,26654,-26654
2,01-06-18,65,16:00,16:15,,-20.05,0,-20.05,-20.05,-1,-23155,147029,170184,123874,0,-84745,0,0,0,,84745,-84745
2,01-06-18,66,16:15,16:30,,-2.33,0,-2.33,-2.33,-1,-32081,116326,148407,84245,0,-97024,0,0,0,,97024,-97024
2,01-06-18,67,16:30,16:45,,22.28,0,22.28,22.28,-1,-38722,108929,147651,70207,0,-57912,0,0,0,,57912,-57912
2,01-06-18,68,16:45,17:00,,25.57,0,25.57,25.57,-1,-59628,98820,158448,39192,0,-38984,0,0,0,,38984,-38984
2,01-06-18,69,17:00,17:15,,2.64,0,2.64,2.64,-1,-38365,98959,137324,60594,0,-20761,0,0,0,,20761,-20761
2,01-06-18,70,17:15,17:30,37.05,27.89,0,37.05,37.05,1,-59292,67985,127277,8693,0,-18970,17,0,0,,18987,-18953
2,01-06-18,71,17:30,17:45,37.54,31.36,0,37.54,31.36,2,-57735,85475,143210,27740,0,-480,25,0,0,,505,-455
2,01-06-18,72,17:45,18:00,,27.36,0,27.36,27.36,-1,-49389,96729,146118,47340,0,-13906,0,0,0,,13906,-13906
2,01-06-18,73,18:00,18:15,37.95,27.36,0,37.95,37.95,1,-146546,87670,234216,-58876,0,-2510,344,0,0,,2854,-2166
2,01-06-18,74,18:15,18:30,,36.42,0,36.42,36.42,-1,-110993,103956,214949,-7037,0,-2,0,0,0,,2,-2
2,01-06-18,75,18:30,18:45,,24.61,0,24.61,24.61,-1,-95683,116917,212600,21234,0,-13538,0,0,0,,13538,-13538
2,01-06-18,76,18:45,19:00,,30.16,0,30.16,30.16,-1,-79307,109419,188726,30112,0,-28408,0,0,0,,28408,-28408
2,01-06-18,77,19:00,19:15,39.83,31.36,0,39.83,31.36,2,-138332,80166,218498,-58166,0,-11892,1087,0,0,,12979,-10805
2,01-06-18,78,19:15,19:30,,31.36,0,31.36,31.36,-1,-112267,104208,216475,-8059,0,-517,0,0,0,,517,-517
2,01-06-18,79,19:30,19:45,,31.36,0,31.36,31.36,-1,-95695,94324,190019,-1371,0,-3168,0,0,0,,3168,-3168
2,01-06-18,80,19:45,20:00,,28.02,0,28.02,28.02,-1,-80290,84421,164711,4131,0,-8763,0,0,0,,8763,-8763
2,01-06-18,81,20:00,20:15,,30.89,0,30.89,30.89,-1,-98401,110610,209011,12209,0,-9456,0,0,0,,9456,-9456
2,01-06-18,82,20:15,20:30,,31.36,0,31.36,31.36,-1,-85317,94417,179734,9100,0,-2055,0,0,0,,2055,-2055
2,01-06-18,83,20:30,20:45,,17.36,0,17.36,17.36,-1,-61854,93488,155342,31634,0,-12554,0,0,0,,12554,-12554
2,01-06-18,84,20:45,21:00,,18.35,0,18.35,18.35,-1,-103031,125752,228783,22721,0,-31429,0,0,0,,31429,-31429
2,01-06-18,85,21:00,21:15,,30.89,0,30.89,30.89,-1,-56969,102514,159483,45545,0,-14135,0,0,0,,14135,-14135
2,01-06-18,86,21:15,21:30,,,0,34.54,34.54,0,-83634,100802,184436,17168,0,-46,0,0,0,,46,-46
2,01-06-18,87,21:30,21:45,,,0,34.57,34.57,0,-73895,119988,193883,46093,0,0,0,0,0,,0,0
2,01-06-18,88,21:45,22:00,,24.27,0,24.27,24.27,-1,-77003,131187,208190,54184,0,-903,0,0,0,,903,-903
2,01-06-18,89,22:00,22:15,,-16.78,0,-16.78,-16.78,-1,-95107,85291,180398,-9816,0,-14382,0,0,0,,14382,-14382
2,01-06-18,90,22:15,22:30,,32.22,0,32.22,32.22,-1,-99629,98151,197780,-1478,0,-691,0,0,0,,691,-691
2,01-06-18,91,22:30,22:45,,32.22,0,32.22,32.22,-1,-59824,107741,167565,47917,0,-748,0,0,0,,748,-748
2,01-06-18,92,22:45,23:00,,27.62,0,27.62,27.62,-1,-55457,128325,183782,72868,0,-443,0,0,0,,443,-443
2,01-06-18,93,23:00,23:15,,-70.97,0,-70.97,-70.97,-1,-56222,180838,237060,124616,0,-34050,0,0,0,,34050,-34050
2,01-06-18,94,23:15,23:30,,-57.97,0,-57.97,-57.97,-1,-62769,137874,200643,75105,0,-40932,0,0,0,,40932,-40932
2,01-06-18,95,23:30,23:45,,16.89,0,16.89,16.89,-1,-55509,140084,195593,84575,0,-32260,0,0,0,,32260,-32260
2,01-06-18,96,23:45,0:00,,6.04,0,6.04,6.04,-1,-40412,160706,201118,120294,0,-36117,0,0,0,,36117,-36117
2,01-07-18,1,0:00,0:15,,7.66,0,7.66,7.66,-1,-48190,88662,136852,40472,0,-28190,0,0,0,,28190,-28190
2,01-07-18,2,0:15,0:30,,,0,33.16,33.16,0,-25094,53226,78320,28132,0,-648,0,0,0,,648,-648
2,01-07-18,3,0:30,0:45,,-13.71,0,-13.71,-13.71,-1,-30836,79339,110175,48503,0,-5704,0,0,0,,5704,-5704
2,01-07-18,4,0:45,1:00,,-78.13,0,-78.13,-78.13,-1,-64148,98836,162984,34688,0,-36955,0,0,0,,36955,-36955
2,01-07-18,5,1:00,1:15,34.79,25.98,0,34.79,34.79,1,-29420,71655,101075,42235,0,-10573,212,0,0,,10785,-10361
2,01-07-18,6,1:15,1:30,34.79,32.77,0,32.77,32.77,-1,-32893,48849,81742,15956,0,-138,68,0,0,,206,-70
2,01-07-18,7,1:30,1:45,,30.35,0,30.35,30.35,-1,-16129,91543,107672,75414,0,-2516,0,0,0,,2516,-2516
2,01-07-18,8,1:45,2:00,,-84.02,0,-84.02,-84.02,-1,-26724,103031,129755,76307,0,-27044,0,0,0,,27044,-27044
2,01-07-18,9,2:00,2:15,,7.35,0,7.35,7.35,-1,-15890,80621,96511,64731,0,-17326,0,0,0,,17326,-17326
2,01-07-18,10,2:15,2:30,,15.99,0,15.99,15.99,-1,-13476,114876,128352,101400,0,-791,0,0,0,,791,-791
2,01-07-18,11,2:30,2:45,,-84.01,0,-84.01,-84.01,-1,-18912,108541,127453,89629,0,-32531,0,0,0,,32531,-32531
2,01-07-18,12,2:45,3:00,,-84.01,0,-84.01,-84.01,-1,-34644,120399,155043,85755,0,-58142,0,0,0,,58142,-58142
2,01-07-18,13,3:00,3:15,,,0,31.35,31.35,0,-36075,91336,127411,55261,0,-27292,0,0,0,,27292,-27292
2,01-07-18,14,3:15,3:30,,,0,30.46,30.46,0,-31535,108985,140520,77450,0,0,0,0,0,,0,0
2,01-07-18,15,3:30,3:45,,-4.61,0,-4.61,-4.61,-1,-26303,117580,143883,91277,0,-3401,0,0,0,,3401,-3401
2,01-07-18,16,3:45,4:00,,-7.35,0,-7.35,-7.35,-1,-30702,110950,141652,80248,0,-14689,0,0,0,,14689,-14689
2,01-07-18,17,4:00,4:15,,15.35,0,15.35,15.35,-1,-29535,98676,128211,69141,0,-8009,0,0,0,,8009,-8009
2,01-07-18,18,4:15,4:30,,,0,31.01,31.01,0,-31979,88930,120909,56951,0,-17,0,0,0,,17,-17
2,01-07-18,19,4:30,4:45,,,0,31.01,31.01,0,-36209,86678,122887,50469,0,0,0,0,0,,0,0
2,01-07-18,20,4:45,5:00,,,0,31.02,31.02,0,-48247,86684,134931,38437,0,0,0,0,0,,0,0
2,01-07-18,21,5:00,5:15,,,0,31.01,31.01,0,-61728,85789,147517,24061,0,0,0,0,0,,0,0
2,01-07-18,22,5:15,5:30,,,0,31,31,0,-55747,84231,139978,28484,0,0,0,0,0,,0,0
2,01-07-18,23,5:30,5:45,,,0,31.02,31.02,0,-50682,82436,133118,31754,0,0,0,0,0,,0,0
2,01-07-18,24,5:45,6:00,,,0,31.02,31.02,0,-57249,84087,141336,26838,0,0,0,0,0,,0,0
2,01-07-18,25,6:00,6:15,,22.17,0,22.17,22.17,-1,-17281,107402,124683,90121,0,-1831,0,0,0,,1831,-1831
2,01-07-18,26,6:15,6:30,,4.39,0,4.39,4.39,-1,-25713,110772,136485,85059,0,-6487,0,0,0,,6487,-6487
2,01-07-18,27,6:30,6:45,,-5.03,0,-5.03,-5.03,-1,-55348,71684,127032,16336,0,-9556,0,0,0,,9556,-9556
2,01-07-18,28,6:45,7:00,,-2.65,0,-2.65,-2.65,-1,-53352,84360,137712,31008,0,-680,0,0,0,,680,-680
2,01-07-18,29,7:00,7:15,,-57.27,0,-57.27,-57.27,-1,-20373,112006,132379,91633,0,-31387,0,0,0,,31387,-31387
2,01-07-18,30,7:15,7:30,,-56.57,0,-56.57,-56.57,-1,-34721,99550,134271,64829,0,-40605,0,0,0,,40605,-40605
2,01-07-18,31,7:30,7:45,,-10.08,0,-10.08,-10.08,-1,-42252,120282,162534,78030,0,-16780,0,0,0,,16780,-16780
2,01-07-18,32,7:45,8:00,,-10.08,0,-10.08,-10.08,-1,-56485,97293,153778,40808,0,-8214,0,0,0,,8214,-8214
2,01-07-18,33,8:00,8:15,,-68.25,0,-68.25,-68.25,-1,-48585,104792,153377,56207,0,-34741,0,0,0,,34741,-34741
2,01-07-18,34,8:15,8:30,,9.46,0,9.46,9.46,-1,-55246,106176,161422,50930,0,-9779,0,0,0,,9779,-9779
2,01-07-18,35,8:30,8:45,,26.65,0,26.65,26.65,-1,-59537,84672,144209,25135,0,-19478,0,0,0,,19478,-19478
2,01-07-18,36,8:45,9:00,31.97,34.02,0,31.97,31.97,1,-74128,78167,152295,4039,0,-5372,157,0,0,,5529,-5215
2,01-07-18,37,9:00,9:15,31.76,13.11,0,33.38,13.11,2,-72531,116494,189025,43963,0,-4432,58,0,0,,4490,-4374
2,01-07-18,38,9:15,9:30,40.02,13.11,0,40.02,40.02,1,-87412,80490,167902,-6922,0,-191,2486,0,0,,2677,2295
2,01-07-18,39,9:30,9:45,,,0,35.1,35.1,0,-60814,69520,130334,8706,0,0,560,0,0,,560,560
2,01-07-18,40,9:45,10:00,,,0,35.11,35.11,0,-66384,71261,137645,4877,0,0,0,0,0,,0,0
2,01-07-18,41,10:00,10:15,,-67.74,0,-67.74,-67.74,-1,-47838,140777,188615,92939,0,-8660,0,0,0,,8660,-8660
2,01-07-18,42,10:15,10:30,,-70.26,0,-70.26,-70.26,-1,-45218,87375,132593,42157,0,-34426,0,0,0,,34426,-34426
2,01-07-18,43,10:30,10:45,,29.6,0,29.6,29.6,-1,-62540,95561,158101,33021,0,-4980,0,0,0,,4980,-4980
2,01-07-18,44,10:45,11:00,,33.02,0,33.02,33.02,-1,-59058,104259,163317,45201,0,-44,0,0,0,,44,-44
2,01-07-18,45,11:00,11:15,,28.23,0,28.23,28.23,-1,-24076,152246,176322,128170,0,-2869,0,0,0,,2869,-2869
2,01-07-18,46,11:15,11:30,,27.48,0,27.48,27.48,-1,-31096,158191,189287,127095,0,-6883,0,0,0,,6883,-6883
2,01-07-18,47,11:30,11:45,,21.07,0,21.07,21.07,-1,-34913,147987,182900,113074,0,-11088,0,0,0,,11088,-11088
2,01-07-18,48,11:45,12:00,,24.03,0,24.03,24.03,-1,-34264,131169,165433,96905,0,-13246,0,0,0,,13246,-13246
2,01-07-18,49,12:00,12:15,,-70.09,0,-70.09,-70.09,-1,-30883,145072,175955,114189,0,-17493,0,0,0,,17493,-17493
2,01-07-18,50,12:15,12:30,,-70.09,0,-70.09,-70.09,-1,-27085,102070,129155,74985,0,-70231,0,0,0,,70231,-70231
2,01-07-18,51,12:30,12:45,,-20.09,0,-20.09,-20.09,-1,-33465,119006,152471,85541,0,-53574,0,0,0,,53574,-53574
2,01-07-18,52,12:45,13:00,,-20.09,0,-20.09,-20.09,-1,-36978,112559,149537,75581,0,-65235,0,0,0,,65235,-65235
2,01-07-18,53,13:00,13:15,,4.11,0,4.11,4.11,-1,-40582,118952,159534,78370,0,-34701,0,0,0,,34701,-34701
2,01-07-18,54,13:15,13:30,,,0,33.94,33.94,0,-39124,142576,181700,103452,0,-19,0,0,0,,19,-19
2,01-07-18,55,13:30,13:45,,33.02,0,33.02,33.02,-1,-41089,150110,191199,109021,0,-1362,0,0,0,,1362,-1362
2,01-07-18,56,13:45,14:00,,-70.8,0,-70.8,-70.8,-1,-40559,178319,218878,137760,0,-19209,0,0,0,,19209,-19209
2,01-07-18,57,14:00,14:15,,-70.77,0,-70.77,-70.77,-1,-44719,116668,161387,71949,0,-17749,0,0,0,,17749,-17749
2,01-07-18,58,14:15,14:30,,33.02,0,33.02,33.02,-1,-47926,140336,188262,92410,0,-224,0,0,0,,224,-224
2,01-07-18,59,14:30,14:45,,29.02,0,29.02,29.02,-1,-57029,142487,199516,85458,0,-357,0,0,0,,357,-357
2,01-07-18,60,14:45,15:00,,8.33,0,8.33,8.33,-1,-64144,135985,200129,71841,0,-11515,0,0,0,,11515,-11515
2,01-07-18,61,15:00,15:15,,34.02,0,34.02,34.02,-1,-73064,120543,193607,47479,0,-4276,0,0,0,,4276,-4276
2,01-07-18,62,15:15,15:30,,22.11,0,22.11,22.11,-1,-49763,115460,165223,65697,0,-1806,0,0,0,,1806,-1806
2,01-07-18,63,15:30,15:45,,14.57,0,14.57,14.57,-1,-62325,96989,159314,34664,0,-9759,0,0,0,,9759,-9759
2,01-07-18,64,15:45,16:00,,,0,34.3,34.3,0,-68209,107383,175592,39174,0,-141,0,0,0,,141,-141
2,01-07-18,65,16:00,16:15,,-9.98,0,-9.98,-9.98,-1,-93939,142778,236717,48839,0,-7503,0,0,0,,7503,-7503
2,01-07-18,66,16:15,16:30,,-12.1,0,-12.1,-12.1,-1,-95279,126517,221796,31238,0,-25809,0,0,0,,25809,-25809
2,01-07-18,67,16:30,16:45,,-13.78,0,-13.78,-13.78,-1,-73986,131541,205527,57555,0,-27619,0,0,0,,27619,-27619
2,01-07-18,68,16:45,17:00,43.71,-13.78,0,43.71,43.71,1,-123161,118519,241680,-4642,0,-5343,994,0,0,,6337,-4349
2,01-07-18,69,17:00,17:15,43.71,-6.24,0,-6.24,-6.24,-1,-94790,137620,232410,42830,0,-13892,1,0,0,,13893,-13891
2,01-07-18,70,17:15,17:30,38.67,33.02,0,38.67,33.02,2,-96194,99358,195552,3164,0,-3596,54,0,0,,3650,-3542
2,01-07-18,71,17:30,17:45,48.67,33.02,0,48.67,48.67,1,-108679,88463,197142,-20216,0,-21,7557,0,0,,7578,7536
2,01-07-18,72,17:45,18:00,46.63,,0,46.63,46.63,1,-117110,116336,233446,-774,0,0,17764,0,0,,17764,17764
2,01-07-18,73,18:00,18:15,52.02,33.02,0,33.02,33.02,-1,-122679,58228,180907,-64451,0,-277,8226,0,0,,8503,7949
2,01-07-18,74,18:15,18:30,52.02,29.02,0,29.02,29.02,-1,-68608,93352,161960,24744,0,-3595,33,0,0,,3628,-3562
2,01-07-18,75,18:30,18:45,,33.02,0,33.02,33.02,-1,-55051,110542,165593,55491,0,-1218,0,0,0,,1218,-1218
2,01-07-18,76,18:45,19:00,,29.02,0,29.02,29.02,-1,-63356,127911,191267,64555,0,-392,0,0,0,,392,-392
2,01-07-18,77,19:00,19:15,,,0,33.58,33.58,0,-54201,154191,208392,99990,0,0,0,0,0,,0,0
2,01-07-18,78,19:15,19:30,,33.02,0,33.02,33.02,-1,-57249,162301,219550,105052,0,-661,0,0,0,,661,-661
2,01-07-18,79,19:30,19:45,,34.02,0,34.02,34.02,-1,-53369,146191,199560,92822,0,-1948,0,0,0,,1948,-1948
2,01-07-18,80,19:45,20:00,,,0,33.65,33.65,0,-49654,119759,169413,70105,0,-181,0,0,0,,181,-181
2,01-07-18,81,20:00,20:15,,,0,33.42,33.42,0,-61140,148937,210077,87797,0,0,0,0,0,,0,0
2,01-07-18,82,20:15,20:30,,,0,33.41,33.41,0,-44032,102789,146821,58757,0,0,0,0,0,,0,0
2,01-07-18,83,20:30,20:45,,33.02,0,33.02,33.02,-1,-38326,128056,166382,89730,0,-460,0,0,0,,460,-460
2,01-07-18,84,20:45,21:00,,-18.56,0,-18.56,-18.56,-1,-32164,146647,178811,114483,0,-10744,0,0,0,,10744,-10744
2,01-07-18,85,21:00,21:15,,19.99,0,19.99,19.99,-1,-40428,107262,147690,66834,0,-9744,0,0,0,,9744,-9744
2,01-07-18,86,21:15,21:30,,,0,32.85,32.85,0,-53170,81593,134763,28423,0,0,0,0,0,,0,0
2,01-07-18,87,21:30,21:45,,33.02,0,33.02,33.02,-1,-42733,127383,170116,84650,0,-180,0,0,0,,180,-180
2,01-07-18,88,21:45,22:00,,28.94,0,28.94,28.94,-1,-37913,145023,182936,107110,0,-1809,0,0,0,,1809,-1809
2,01-07-18,89,22:00,22:15,,,0,33.88,33.88,0,-57067,92617,149684,35550,0,-168,0,0,0,,168,-168
2,01-07-18,90,22:15,22:30,,27.65,0,27.65,27.65,-1,-45590,97264,142854,51674,0,-1064,0,0,0,,1064,-1064
2,01-07-18,91,22:30,22:45,,33.02,0,33.02,33.02,-1,-40257,134201,174458,93944,0,-134,0,0,0,,134,-134
2,01-07-18,92,22:45,23:00,,26.35,0,26.35,26.35,-1,-34527,177413,211940,142886,0,-10890,0,0,0,,10890,-10890
2,01-07-18,93,23:00,23:15,,,0,34.04,34.04,0,-59113,62394,121507,3281,0,-1500,0,0,0,,1500,-1500
2,01-07-18,94,23:15,23:30,,33.02,0,33.02,33.02,-1,-43220,75980,119200,32760,0,-15,0,0,0,,15,-15
2,01-07-18,95,23:30,23:45,,32.8,0,32.8,32.8,-1,-47358,100873,148231,53515,0,-102,0,0,0,,102,-102
2,01-07-18,96,23:45,0:00,,25.94,0,25.94,25.94,-1,-55605,119496,175101,63891,0,-3498,0,0,0,,3498,-3498
2,01-08-18,1,0:00,0:15,,13.91,0,13.91,13.91,-1,-79528,88573,168101,9045,0,-5277,0,0,0,,5277,-5277
2,01-08-18,2,0:15,0:30,46.02,,0,46.02,46.02,1,-99575,65131,164706,-34444,0,0,925,0,0,,925,925
2,01-08-18,3,0:30,0:45,,,0,34.02,34.02,0,-86218,74149,160367,-12069,0,0,0,0,0,,0,0
2,01-08-18,4,0:45,1:00,,18.91,0,18.91,18.91,-1,-78323,89231,167554,10908,0,-1581,0,0,0,,1581,-1581
2,01-08-18,5,1:00,1:15,46.12,18.91,0,46.12,46.12,1,-108365,60770,169135,-47595,0,-13,650,0,0,,663,637
2,01-08-18,6,1:15,1:30,46.02,,0,46.02,46.02,1,-95424,63679,159103,-31745,0,0,1159,0,0,,1159,1159
2,01-08-18,7,1:30,1:45,40.02,,0,40.02,40.02,1,-97599,78900,176499,-18699,0,0,1220,0,0,,1220,1220
2,01-08-18,8,1:45,2:00,,,0,32.14,32.14,0,-92193,91630,183823,-563,0,0,552,0,0,,552,552
2,01-08-18,9,2:00,2:15,151.12,,0,151.12,151.12,1,-109344,70531,179875,-38813,0,0,9364,0,0,,9364,9364
2,01-08-18,10,2:15,2:30,40.02,,0,40.02,40.02,1,-89036,81630,170666,-7406,0,0,2542,0,0,,2542,2542
2,01-08-18,11,2:30,2:45,40.02,,0,40.02,40.02,1,-88739,74205,162944,-14534,0,0,635,0,0,,635,635
2,01-08-18,12,2:45,3:00,37.12,,0,37.12,37.12,1,-82834,72949,155783,-9885,0,0,763,0,0,,763,763
2,01-08-18,13,3:00,3:15,,25.12,0,25.12,25.12,-1,-76116,100153,176269,24037,0,-728,0,0,0,,728,-728
2,01-08-18,14,3:15,3:30,,23.42,0,23.42,23.42,-1,-81871,100549,182420,18678,0,-441,0,0,0,,441,-441
2,01-08-18,15,3:30,3:45,,13.42,0,13.42,13.42,-1,-81343,97767,179110,16424,0,-5242,0,0,0,,5242,-5242
2,01-08-18,16,3:45,4:00,,13.42,0,13.42,13.42,-1,-80125,95876,176001,15751,0,-11568,0,0,0,,11568,-11568
2,01-08-18,17,4:00,4:15,,25.12,0,25.12,25.12,-1,-105864,106485,212349,621,0,-3022,0,0,0,,3022,-3022
2,01-08-18,18,4:15,4:30,,,0,31.02,31.02,0,-90035,94286,184321,4251,0,0,0,0,0,,0,0
2,01-08-18,19,4:30,4:45,,,0,31.02,31.02,0,-85918,89236,175154,3318,0,0,0,0,0,,0,0
2,01-08-18,20,4:45,5:00,33.61,,0,33.61,33.61,1,-74833,82311,157144,7478,0,0,292,0,0,,292,292
2,01-08-18,21,5:00,5:15,,,0,34.47,34.47,0,-65316,121108,186424,55792,0,0,0,0,0,,0,0
2,01-08-18,22,5:15,5:30,,,0,34.46,34.46,0,-91135,98714,189849,7579,0,0,0,0,0,,0,0
2,01-08-18,23,5:30,5:45,,33.39,0,33.39,33.39,-1,-69613,84908,154521,15295,0,-735,0,0,0,,735,-735
2,01-08-18,24,5:45,6:00,,27.1,0,27.1,27.1,-1,-80437,139318,219755,58881,0,-1112,0,0,0,,1112,-1112
2,01-08-18,25,6:00,6:15,,28.44,0,28.44,28.44,-1,-71087,121468,192555,50381,0,-2347,0,0,0,,2347,-2347
2,01-08-18,26,6:15,6:30,,28.44,0,28.44,28.44,-1,-76865,88967,165832,12102,0,-4053,0,0,0,,4053,-4053
2,01-08-18,27,6:30,6:45,,,0,33.42,33.42,0,-95842,102421,198263,6579,0,-40,0,0,0,,40,-40
2,01-08-18,28,6:45,7:00,,,0,33.37,33.37,0,-112492,158252,270744,45760,0,0,0,0,0,,0,0
2,01-08-18,29,7:00,7:15,37.43,,0,37.43,37.43,1,-179566,149546,329112,-30020,0,0,499,0,0,,499,499
2,01-08-18,30,7:15,7:30,37.43,28.44,0,37.43,28.44,2,-101587,113004,214591,11417,0,-3069,128,0,0,,3197,-2941
2,01-08-18,31,7:30,7:45,39.87,,0,39.87,39.87,1,-109267,108347,217614,-920,0,0,203,0,0,,203,203
2,01-08-18,32,7:45,8:00,141.65,,0,141.65,141.65,1,-162131,88905,251036,-73226,0,0,16457,0,0,,16457,16457
2,01-08-18,33,8:00,8:15,139.12,,0,139.12,139.12,1,-176549,81940,258489,-94609,0,0,77778,0,0,,77778,77778
2,01-08-18,34,8:15,8:30,139.12,,0,139.12,139.12,1,-177507,81602,259109,-95905,0,0,79810,0,0,,79810,79810
2,01-08-18,35,8:30,8:45,82.4,,0,82.4,82.4,1,-138850,84840,223690,-54010,0,0,69508,0,0,,69508,69508
2,01-08-18,36,8:45,9:00,96.35,,0,96.35,96.35,1,-140897,78120,219017,-62777,0,0,24620,0,0,,24620,24620
2,01-08-18,37,9:00,9:15,139.12,,0,139.12,139.12,1,-141109,79258,220367,-61851,0,0,54547,0,0,,54547,54547
2,01-08-18,38,9:15,9:30,59.12,,0,59.12,59.12,1,-129370,77229,206599,-52141,0,0,32942,0,0,,32942,32942
2,01-08-18,39,9:30,9:45,139.12,,0,139.12,139.12,1,-119129,87062,206191,-32067,0,0,50965,0,0,,50965,50965
2,01-08-18,40,9:45,10:00,139.12,,0,139.12,139.12,1,-64645,107157,171802,42512,0,0,53492,0,0,,53492,53492
2,01-08-18,41,10:00,10:15,145.12,,0,145.12,145.12,1,-108430,80465,188895,-27965,0,0,76268,0,0,,76268,76268
2,01-08-18,42,10:15,10:30,145.12,,0,145.12,145.12,1,-95522,86081,181603,-9441,0,0,88602,0,0,,88602,88602
2,01-08-18,43,10:30,10:45,350,,0,350,350,1,-91959,97679,189638,5720,0,0,64835,5000,0,,69835,69835
2,01-08-18,44,10:45,11:00,350,,0,350,350,1,-64055,109000,173055,44945,0,0,44345,5000,0,,49345,49345
2,01-08-18,45,11:00,11:15,78.51,,0,78.51,78.51,1,-91846,105769,197615,13923,0,0,26306,0,0,,26306,26306
2,01-08-18,46,11:15,11:30,217.12,,0,217.12,217.12,1,-120199,103007,223206,-17192,0,0,62321,0,0,,62321,62321
2,01-08-18,47,11:30,11:45,359.53,32.88,0,32.88,32.88,-1,-96064,123928,219992,27864,0,-19,51372,5000,0,,56391,56353
2,01-08-18,48,11:45,12:00,65.53,24.89,0,65.53,24.89,2,-80067,116671,196738,36604,0,-4907,5491,0,0,,10398,584
2,01-08-18,49,12:00,12:15,139.12,,0,139.12,139.12,1,-126207,73677,199884,-52530,0,0,57036,0,0,,57036,57036
2,01-08-18,50,12:15,12:30,343.8,36.09,0,343.8,35.12,2,-76936,93353,170289,16417,0,-73,57681,5000,0,,62754,62608
2,01-08-18,51,12:30,12:45,77.87,29.55,0,77.87,29.55,2,-59794,92454,152248,32660,0,-1232,7143,0,0,,8375,5911
2,01-08-18,52,12:45,13:00,122.12,,0,122.12,122.12,1,-86598,94603,181201,8005,0,0,42978,0,0,,42978,42978
2,01-08-18,53,13:00,13:15,112.58,,0,112.58,112.58,1,-102538,86319,188857,-16219,0,0,49739,0,0,,49739,49739
2,01-08-18,54,13:15,13:30,344,,0,344,344,1,-96634,78697,175331,-17937,0,0,61819,5000,0,,66819,66819
2,01-08-18,55,13:30,13:45,139.12,,0,139.12,139.12,1,-100697,74397,175094,-26300,0,0,56664,0,0,,56664,56664
2,01-08-18,56,13:45,14:00,139.12,,0,139.12,139.12,1,-115607,69446,185053,-46161,0,0,83605,0,0,,83605,83605
2,01-08-18,57,14:00,14:15,87.12,,0,87.12,87.12,1,-109048,88492,197540,-20556,0,0,68663,0,0,,68663,68663
2,01-08-18,58,14:15,14:30,57.36,,0,57.36,57.36,1,-114903,87525,202428,-27378,0,0,43056,0,0,,43056,43056
2,01-08-18,59,14:30,14:45,80.88,,0,80.88,80.88,1,-123271,89505,212776,-33766,0,0,52002,0,0,,52002,52002
2,01-08-18,60,14:45,15:00,346.61,,0,346.61,346.61,1,-122859,97723,220582,-25136,0,0,45585,5000,0,,50585,50585
2,01-08-18,61,15:00,15:15,340.97,33.32,0,340.97,33.32,2,-94568,100869,195437,6301,0,-621,5849,5000,0,,11470,10228
2,01-08-18,62,15:15,15:30,82.12,,0,82.12,82.12,1,-129234,94533,223767,-34701,0,0,13270,0,0,,13270,13270
2,01-08-18,63,15:30,15:45,107.12,,0,107.12,107.12,1,-113637,80440,194077,-33197,0,0,39691,0,0,,39691,39691
2,01-08-18,64,15:45,16:00,43.71,,0,43.71,43.71,1,-114025,77603,191628,-36422,0,0,12475,0,0,,12475,12475
2,01-08-18,65,16:00,16:15,34.78,16.24,0,34.78,16.24,2,-79310,120745,200055,41435,0,-11472,4458,0,0,,15930,-7014
2,01-08-18,66,16:15,16:30,34.78,31.37,0,31.37,31.37,-1,-103677,117560,221237,13883,0,-14945,19,0,0,,14964,-14926
2,01-08-18,67,16:30,16:45,35.08,31.37,0,35.08,35.08,1,-109022,115819,224841,6797,0,-1584,346,0,0,,1930,-1238
2,01-08-18,68,16:45,17:00,57.31,,0,57.31,57.31,1,-122264,99339,221603,-22925,0,0,5013,0,0,,5013,5013
2,01-08-18,69,17:00,17:15,44.12,37.36,0,44.12,36.08,2,-108715,107018,215733,-1697,0,-133,5151,0,0,,5284,5018
2,01-08-18,70,17:15,17:30,155.12,,0,155.12,155.12,1,-106706,57513,164219,-49193,0,0,15819,0,0,,15819,15819
2,01-08-18,71,17:30,17:45,154.14,,0,154.14,154.14,1,-96658,60739,157397,-35919,0,0,42861,0,0,,42861,42861
2,01-08-18,72,17:45,18:00,46.15,,0,46.15,46.15,1,-95970,72679,168649,-23291,0,0,29897,0,0,,29897,29897
2,01-08-18,73,18:00,18:15,52.38,,0,52.38,52.38,1,-113134,53104,166238,-60030,0,0,29857,0,0,,29857,29857
2,01-08-18,74,18:15,18:30,39.06,33.21,0,39.06,33.21,2,-88867,81789,170656,-7078,0,-1223,11637,0,0,,12860,10414
2,01-08-18,75,18:30,18:45,46.24,33.21,0,46.24,46.24,1,-115556,66386,181942,-49170,0,-10,3348,0,0,,3358,3338
2,01-08-18,76,18:45,19:00,47.86,,0,47.86,47.86,1,-142311,69698,212009,-72613,0,0,29431,0,0,,29431,29431
2,01-08-18,77,19:00,19:15,47.84,,0,47.84,47.84,1,-104017,87925,191942,-16092,0,0,21541,0,0,,21541,21541
2,01-08-18,78,19:15,19:30,34.99,,0,34.99,34.99,1,-110944,73425,184369,-37519,0,0,895,0,0,,895,895
2,01-08-18,79,19:30,19:45,42.07,,0,42.07,42.07,1,-100109,88760,188869,-11349,0,0,5190,0,0,,5190,5190
2,01-08-18,80,19:45,20:00,42.07,31.57,0,31.57,31.57,-1,-90858,97545,188403,6687,0,-1091,983,0,0,,2074,-108
2,01-08-18,81,20:00,20:15,138.12,27.57,0,138.12,138.12,1,-134777,81977,216754,-52800,0,-1480,12675,0,0,,14155,11195
2,01-08-18,82,20:15,20:30,138.12,31.68,0,138.12,31.68,2,-100433,97126,197559,-3307,0,-107,35743,0,0,,35850,35636
2,01-08-18,83,20:30,20:45,48.15,27.57,0,48.15,27.57,2,-79214,70519,149733,-8695,0,-923,1922,0,0,,2845,999
2,01-08-18,84,20:45,21:00,48.52,,0,48.52,48.52,1,-93979,64871,158850,-29108,0,0,11854,0,0,,11854,11854
2,01-08-18,85,21:00,21:15,40.36,32.44,0,40.36,32.44,2,-109408,105088,214496,-4320,0,-1686,598,0,0,,2284,-1088
2,01-08-18,86,21:15,21:30,47.51,,0,47.51,47.51,1,-78484,70525,149009,-7959,0,0,5848,0,0,,5848,5848
2,01-08-18,87,21:30,21:45,47.51,29.05,0,29.05,29.05,-1,-68979,73185,142164,4206,0,-104,377,0,0,,481,273
2,01-08-18,88,21:45,22:00,,-1.14,0,-1.14,-1.14,-1,-70821,82564,153385,11743,0,-17484,0,0,0,,17484,-17484
2,01-08-18,89,22:00,22:15,52.76,-1.14,0,52.76,52.76,1,-101949,52982,154931,-48967,0,-711,8803,0,0,,9514,8092
2,01-08-18,90,22:15,22:30,61.44,,0,61.44,61.44,1,-86698,48163,134861,-38535,0,0,30200,0,0,,30200,30200
2,01-08-18,91,22:30,22:45,40.36,,0,40.36,40.36,1,-74986,60842,135828,-14144,0,0,8416,0,0,,8416,8416
2,01-08-18,92,22:45,23:00,33.86,35.97,0,35.97,35.97,-1,-75268,72691,147959,-2577,0,-21,1602,0,0,,1623,1581
2,01-08-18,93,23:00,23:15,32.88,31.71,0,34.69,31.71,2,-95279,117162,212441,21883,0,-715,26,0,0,,741,-689
2,01-08-18,94,23:15,23:30,35.44,,0,35.44,35.44,1,-106964,67978,174942,-38986,0,0,349,0,0,,349,349
2,01-08-18,95,23:30,23:45,40.36,,0,40.36,40.36,1,-107000,82295,189295,-24705,0,0,4460,0,0,,4460,4460
2,01-08-18,96,23:45,0:00,35.44,36.66,0,36.66,36.66,-1,-99742,107333,207075,7591,0,-71,4093,0,0,,4164,4022
2,01-09-18,1,0:00,0:15,64.02,21.8,0,64.02,21.8,2,-101061,88026,189087,-13035,0,-1235,2654,0,0,,3889,1419
2,01-09-18,2,0:15,0:30,40.36,,0,40.36,40.36,1,-69368,62212,131580,-7156,0,0,1651,0,0,,1651,1651
2,01-09-18,3,0:30,0:45,81.14,,0,81.14,81.14,1,-62411,44953,107364,-17458,0,0,4704,0,0,,4704,4704
2,01-09-18,4,0:45,1:00,89.02,21.8,0,21.8,21.8,-1,-65095,72453,137548,7358,0,-935,6745,0,0,,7680,5810
2,01-09-18,5,1:00,1:15,333.02,1.03,0,333.02,1.03,2,-92959,63990,156949,-28969,0,-4275,3725,0,0,,8000,-550
2,01-09-18,6,1:15,1:30,350.02,-400,0,350.02,-400,2,-65921,77576,143497,11655,0,-887,16244,0,0,,17131,15357
2,01-09-18,7,1:30,1:45,40.36,-400,0,40.36,-400,2,-54616,46322,100938,-8294,0,-11919,200,0,0,,12119,-11719
2,01-09-18,8,1:45,2:00,35.44,,0,35.44,35.44,1,-79019,73172,152191,-5847,0,0,172,0,0,,172,172
2,01-09-18,9,2:00,2:15,53.02,,0,53.02,53.02,1,-64404,57285,121689,-7119,0,0,3527,0,0,,3527,3527
2,01-09-18,10,2:15,2:30,35.44,,0,35.44,35.44,1,-68815,69957,138772,1142,0,0,2205,0,0,,2205,2205
2,01-09-18,11,2:30,2:45,31.02,,0,31.02,31.02,1,-59401,71013,130414,11612,0,0,327,0,0,,327,327
2,01-09-18,12,2:45,3:00,,,0,32.52,32.52,0,-57691,64836,122527,7145,0,0,0,0,0,,0,0
2,01-09-18,13,3:00,3:15,57.46,,0,57.46,57.46,1,-61287,70023,131310,8736,0,0,1430,0,0,,1430,1430
2,01-09-18,14,3:15,3:30,152.02,,0,152.02,152.02,1,-63074,66118,129192,3044,0,0,13241,0,0,,13241,13241
2,01-09-18,15,3:30,3:45,152.02,29.02,0,29.02,29.02,-1,-65657,83741,149398,18084,0,-202,421,0,0,,623,219
2,01-09-18,16,3:45,4:00,,33.02,0,33.02,33.02,-1,-83263,78066,161329,-5197,0,-28,0,0,0,,28,-28
2,01-09-18,17,4:00,4:15,,21.06,0,21.06,21.06,-1,-84957,104247,189204,19290,0,-4253,0,0,0,,4253,-4253
2,01-09-18,18,4:15,4:30,74.45,21.06,0,74.45,74.45,1,-99575,79816,179391,-19759,0,-185,7053,0,0,,7238,6868
2,01-09-18,19,4:30,4:45,242.02,,0,242.02,242.02,1,-108395,72089,180484,-36306,0,0,20396,0,0,,20396,20396
2,01-09-18,20,4:45,5:00,262.02,,0,262.02,262.02,1,-112960,114306,227266,1346,0,0,28219,0,0,,28219,28219
2,01-09-18,21,5:00,5:15,262.02,-400,0,-400,-400,-1,-83905,121535,205440,37630,0,-5877,3514,0,0,,9391,-2363
2,01-09-18,22,5:15,5:30,53.28,33.02,0,53.28,53.28,1,-114071,98341,212412,-15730,0,-417,841,0,0,,1258,424
2,01-09-18,23,5:30,5:45,98.02,,0,98.02,98.02,1,-120819,75626,196445,-45193,0,0,8403,0,0,,8403,8403
2,01-09-18,24,5:45,6:00,281.02,,0,281.02,281.02,1,-122501,99583,222084,-22918,0,0,35397,0,0,,35397,35397
2,01-09-18,25,6:00,6:15,350.02,,0,350.02,350.02,1,-93295,77838,171133,-15457,0,0,36451,0,0,,36451,36451
2,01-09-18,26,6:15,6:30,350.02,,0,350.02,350.02,1,-72475,70005,142480,-2470,0,0,46832,0,0,,46832,46832
2,01-09-18,27,6:30,6:45,276.02,,0,276.02,276.02,1,-78727,115773,194500,37046,0,0,42584,0,0,,42584,42584
2,01-09-18,28,6:45,7:00,140.02,-400,0,140.02,-400,2,-103999,160506,264505,56507,0,-6604,6238,0,0,,12842,-366
2,01-09-18,29,7:00,7:15,350.02,-400,0,350.02,350.02,1,-195496,136649,332145,-58847,0,-3,33877,0,0,,33880,33874
2,01-09-18,30,7:15,7:30,350.02,27.71,0,350.02,27.71,2,-141727,105929,247656,-35798,0,-70,6874,0,0,,6944,6804
2,01-09-18,31,7:30,7:45,350.02,,0,350.02,350.02,1,-191192,99218,290410,-91974,0,0,57595,0,0,,57595,57595
2,01-09-18,32,7:45,8:00,264.02,,0,264.02,264.02,1,-252749,129287,382036,-123462,0,0,91610,0,0,,91610,91610
2,01-09-18,33,8:00,8:15,350.02,-400,0,-400,-400,-1,-118729,173989,292718,55260,0,-2127,50151,0,0,,52278,48024
2,01-09-18,34,8:15,8:30,350.02,-400,0,350.02,-400,2,-144491,67048,211539,-77443,0,-4427,20090,0,0,,24517,15663
2,01-09-18,35,8:30,8:45,350.02,,0,350.02,350.02,1,-154683,91149,245832,-63534,0,0,80385,0,0,,80385,80385
2,01-09-18,36,8:45,9:00,350.02,,0,350.02,350.02,1,-155301,89827,245128,-65474,0,0,67281,0,0,,67281,67281
2,01-09-18,37,9:00,9:15,55.02,32.5,0,55.02,32.5,2,-60399,90522,150921,30123,0,-178,26794,0,0,,26972,26616
2,01-09-18,38,9:15,9:30,350.02,,0,350.02,350.02,1,-93389,68185,161574,-25204,0,0,22989,0,0,,22989,22989
2,01-09-18,39,9:30,9:45,65.84,,0,65.84,65.84,1,-84865,75184,160049,-9681,0,0,17307,0,0,,17307,17307
2,01-09-18,40,9:45,10:00,350.02,,0,350.02,350.02,1,-110234,66028,176262,-44206,0,0,34668,0,0,,34668,34668
2,01-09-18,41,10:00,10:15,170.02,-400,0,-400,-400,-1,-59469,119579,179048,60110,0,-3949,24396,0,0,,28345,20447
2,01-09-18,42,10:15,10:30,331.02,-400,0,331.02,-400,2,-97614,74708,172322,-22906,0,-7882,9090,0,0,,16972,1208
2,01-09-18,43,10:30,10:45,52.02,35.66,0,35.66,35.66,-1,-86532,99133,185665,12601,0,-47,6434,0,0,,6481,6387
2,01-09-18,44,10:45,11:00,58.7,35.66,0,58.7,35.62,2,-88351,89565,177916,1214,0,-44,1223,0,0,,1267,1179
2,01-09-18,45,11:00,11:15,87.23,,0,87.23,87.23,1,-76650,78053,154703,1403,0,0,9615,0,0,,9615,9615
2,01-09-18,46,11:15,11:30,87.23,57.01,0,57.01,57.01,-1,-72364,82316,154680,9952,0,-38,1582,0,0,,1620,1544
2,01-09-18,47,11:30,11:45,40.08,57.01,0,46.3,46.3,2,-81365,91961,173326,10596,0,-9,1160,0,0,,1169,1151
2,01-09-18,48,11:45,12:00,38.52,32.71,0,46.3,32.71,2,-73257,88637,161894,15380,0,-156,205,0,0,,361,49
2,01-09-18,49,12:00,12:15,,27.71,0,27.71,27.71,-1,-65697,96914,162611,31217,0,-5947,0,0,0,,5947,-5947
2,01-09-18,50,12:15,12:30,,27.71,0,27.71,27.71,-1,-55891,84443,140334,28552,0,-12599,0,0,0,,12599,-12599
2,01-09-18,51,12:30,12:45,,23.72,0,23.72,23.72,-1,-50833,83506,134339,32673,0,-20576,0,0,0,,20576,-20576
2,01-09-18,52,12:45,13:00,,32.71,0,32.71,32.71,-1,-60207,70595,130802,10388,0,-7730,0,0,0,,7730,-7730
2,01-09-18,53,13:00,13:15,40.5,31.71,0,45.52,31.71,2,-68974,66529,135503,-2445,0,-2074,997,0,0,,3071,-1077
2,01-09-18,54,13:15,13:30,,32.71,0,32.71,32.71,-1,-47770,68118,115888,20348,0,-637,0,0,0,,637,-637
2,01-09-18,55,13:30,13:45,,57.02,0,57.02,57.02,-1,-51770,60411,112181,8641,0,-30,0,0,0,,30,-30
2,01-09-18,56,13:45,14:00,40.27,,0,40.27,40.27,1,-56539,52856,109395,-3683,0,0,1499,0,0,,1499,1499
2,01-09-18,57,14:00,14:15,40.27,31.71,0,31.71,31.71,-1,-47594,72660,120254,25066,0,-5113,198,0,0,,5311,-4915
2,01-09-18,58,14:15,14:30,,34.78,0,34.78,34.78,-1,-54716,60806,115522,6090,0,-5892,0,0,0,,5892,-5892
2,01-09-18,59,14:30,14:45,,34.66,0,34.66,34.66,-1,-54148,58239,112387,4091,0,-1413,0,0,0,,1413,-1413
2,01-09-18,60,14:45,15:00,,32.71,0,32.71,32.71,-1,-51905,55803,107708,3898,0,-2768,0,0,0,,2768,-2768
2,01-09-18,61,15:00,15:15,,32.71,0,32.71,32.71,-1,-41734,65533,107267,23799,0,-7992,0,0,0,,7992,-7992
2,01-09-18,62,15:15,15:30,,34.19,0,34.19,34.19,-1,-48170,57329,105499,9159,0,-6328,0,0,0,,6328,-6328
2,01-09-18,63,15:30,15:45,,32.32,0,32.32,32.32,-1,-55536,53592,109128,-1944,0,-3663,0,0,0,,3663,-3663
2,01-09-18,64,15:45,16:00,35.93,57.01,0,46.3,46.3,2,-53750,56159,109909,2409,0,-522,668,0,0,,1190,146
2,01-09-18,65,16:00,16:15,,,0,36.43,36.43,0,-109914,97297,207211,-12617,0,0,26,0,0,,26,26
2,01-09-18,66,16:15,16:30,,,0,36.43,36.43,0,-77537,98486,176023,20949,0,0,0,0,0,,0,0
2,01-09-18,67,16:30,16:45,36.37,31.71,0,36.37,31.71,2,-67575,77699,145274,10124,0,-1668,7,0,0,,1675,-1661
2,01-09-18,68,16:45,17:00,148.02,,0,148.02,148.02,1,-114658,53961,168619,-60697,0,0,30871,0,0,,30871,30871
2,01-09-18,69,17:00,17:15,48.9,26.6,0,48.9,26.6,2,-99616,112081,211697,12465,0,-3331,17108,0,0,,20439,13777
2,01-09-18,70,17:15,17:30,121.02,26.6,0,121.02,121.02,1,-105605,71379,176984,-34226,0,-281,10965,0,0,,11246,10684
2,01-09-18,71,17:30,17:45,123.02,,0,123.02,123.02,1,-89121,63096,152217,-26025,0,0,33829,0,0,,33829,33829
2,01-09-18,72,17:45,18:00,44.17,,0,44.17,44.17,1,-79670,67222,146892,-12448,0,0,22168,0,0,,22168,22168
2,01-09-18,73,18:00,18:15,43.57,-43.16,0,46.27,-43.16,2,-70947,102971,173918,32024,0,-7028,12355,0,0,,19383,5327
2,01-09-18,74,18:15,18:30,43.57,-42.03,0,-42.03,-42.03,-1,-76719,109750,186469,33031,0,-28579,236,0,0,,28815,-28343
2,01-09-18,75,18:30,18:45,,24.2,0,24.2,24.2,-1,-56993,123658,180651,66665,0,-28611,0,0,0,,28611,-28611
2,01-09-18,76,18:45,19:00,,25.03,0,25.03,25.03,-1,-48573,149621,198194,101048,0,-40625,0,0,0,,40625,-40625
2,01-09-18,77,19:00,19:15,40.5,26.6,0,40.5,40.5,1,-81998,65394,147392,-16604,0,-20290,527,0,0,,20817,-19763
2,01-09-18,78,19:15,19:30,36.31,,0,36.31,36.31,1,-76197,62464,138661,-13733,0,0,670,0,0,,670,670
2,01-09-18,79,19:30,19:45,36.31,17.17,0,17.17,17.17,-1,-60411,94948,155359,34537,0,-7621,79,0,0,,7700,-7542
2,01-09-18,80,19:45,20:00,,-1.56,0,-1.56,-1.56,-1,-76909,89916,166825,13007,0,-40248,0,0,0,,40248,-40248
2,01-09-18,81,20:00,20:15,,36.94,0,36.94,36.94,-1,-72435,34730,107165,-37705,0,-3961,0,0,0,,3961,-3961
2,01-09-18,82,20:15,20:30,,,0,35.51,35.51,0,-70622,52562,123184,-18060,0,0,0,0,0,,0,0
2,01-09-18,83,20:30,20:45,,31.71,0,31.71,31.71,-1,-46533,58813,105346,12280,0,-2841,0,0,0,,2841,-2841
2,01-09-18,84,20:45,21:00,,37.24,0,37.24,37.24,-1,-78594,55905,134499,-22689,0,-49,0,0,0,,49,-49
2,01-09-18,85,21:00,21:15,66.55,,0,66.55,66.55,1,-104926,84987,189913,-19939,0,0,2604,0,0,,2604,2604
2,01-09-18,86,21:15,21:30,115.43,,0,115.43,115.43,1,-74789,34082,108871,-40707,0,0,27144,0,0,,27144,27144
2,01-09-18,87,21:30,21:45,36.12,34.84,0,34.84,34.84,-1,-64522,67190,131712,2668,0,-469,8089,0,0,,8558,7620
2,01-09-18,88,21:45,22:00,,31.71,0,31.71,31.71,-1,-57885,94461,152346,36576,0,-5197,0,0,0,,5197,-5197
2,01-09-18,89,22:00,22:15,66.64,34.4,0,66.64,66.64,1,-103548,28560,132108,-74988,0,-3585,9114,0,0,,12699,5529
2,01-09-18,90,22:15,22:30,61.61,32.81,0,32.81,32.81,-1,-66563,53732,120295,-12831,0,-106,16659,0,0,,16765,16553
2,01-09-18,91,22:30,22:45,61.61,30.89,0,30.89,30.89,-1,-48684,71682,120366,22998,0,-3109,181,0,0,,3290,-2928
2,01-09-18,92,22:45,23:00,,23.39,0,23.39,23.39,-1,-41788,115080,156868,73292,0,-3127,0,0,0,,3127,-3127
2,01-09-18,93,23:00,23:15,,21.93,0,21.93,21.93,-1,-48230,80102,128332,31872,0,-6046,0,0,0,,6046,-6046
2,01-09-18,94,23:15,23:30,35.48,,0,35.48,35.48,1,-46117,34709,80826,-11408,0,0,304,0,0,,304,304
2,01-09-18,95,23:30,23:45,,31.71,0,31.71,31.71,-1,-58602,73065,131667,14463,0,-578,0,0,0,,578,-578
2,01-09-18,96,23:45,0:00,,23.98,0,23.98,23.98,-1,-88353,77710,166063,-10643,0,-3769,0,0,0,,3769,-3769
2,01-10-18,1,0:00,0:15,,12.67,0,12.67,12.67,-1,-70361,133456,203817,63095,0,-3607,0,0,0,,3607,-3607
2,01-10-18,2,0:15,0:30,39.64,,0,39.64,39.64,1,-72493,74190,146683,1697,0,0,1159,0,0,,1159,1159
2,01-10-18,3,0:30,0:45,39.64,32.64,0,39.64,32.64,2,-81679,64597,146276,-17082,0,-89,339,0,0,,428,250
2,01-10-18,4,0:45,1:00,38.14,32.64,0,38.14,32.64,2,-92102,66201,158303,-25901,0,-47,293,0,0,,340,246
2,01-10-18,5,1:00,1:15,,28.64,0,28.64,28.64,-1,-34938,169523,204461,134585,0,-966,0,0,0,,966,-966
2,01-10-18,6,1:15,1:30,,,0,32.85,32.85,0,-44713,115447,160160,70734,0,0,0,0,0,,0,0
2,01-10-18,7,1:30,1:45,,,0,32.85,32.85,0,-50745,74704,125449,23959,0,0,0,0,0,,0,0
2,01-10-18,8,1:45,2:00,,32.64,0,32.64,32.64,-1,-59764,64142,123906,4378,0,-147,0,0,0,,147,-147
2,01-10-18,9,2:00,2:15,39.64,31.65,0,39.64,39.64,1,-71168,70737,141905,-431,0,-262,793,0,0,,1055,531
2,01-10-18,10,2:15,2:30,39.64,32.64,0,32.64,32.64,-1,-58802,60360,119162,1558,0,-75,2258,0,0,,2333,2183
2,01-10-18,11,2:30,2:45,,32.17,0,32.17,32.17,-1,-65352,61713,127065,-3639,0,-938,0,0,0,,938,-938
2,01-10-18,12,2:45,3:00,,52.33,0,52.33,52.33,-1,-56705,68578,125283,11873,0,-35,0,0,0,,35,-35
2,01-10-18,13,3:00,3:15,36.54,,0,36.54,36.54,1,-71904,68234,140138,-3670,0,0,190,0,0,,190,190
2,01-10-18,14,3:15,3:30,36.26,,0,36.26,36.26,1,-62945,68701,131646,5756,0,0,1760,0,0,,1760,1760
2,01-10-18,15,3:30,3:45,34.8,32.58,0,34.8,32.58,2,-39360,68724,108084,29364,0,-245,682,0,0,,927,437
2,01-10-18,16,3:45,4:00,,23.27,0,23.27,23.27,-1,-55027,89876,144903,34849,0,-8093,0,0,0,,8093,-8093
2,01-10-18,17,4:00,4:15,36.99,32.17,0,36.99,32.17,2,-72856,57111,129967,-15745,0,-5303,365,0,0,,5668,-4938
2,01-10-18,18,4:15,4:30,,,0,33.52,33.52,0,-62643,59152,121795,-3491,0,0,0,0,0,,0,0
2,01-10-18,19,4:30,4:45,40.75,,0,40.75,40.75,1,-69053,54504,123557,-14549,0,0,5332,0,0,,5332,5332
2,01-10-18,20,4:45,5:00,39.64,,0,39.64,39.64,1,-72637,76739,149376,4102,0,0,10108,0,0,,10108,10108
2,01-10-18,21,5:00,5:15,,,0,33.36,33.36,0,-67911,109395,177306,41484,0,0,631,0,0,,631,631
2,01-10-18,22,5:15,5:30,,,0,33.34,33.34,0,-59887,96773,156660,36886,0,0,0,0,0,,0,0
2,01-10-18,23,5:30,5:45,,,0,33.37,33.37,0,-65174,87205,152379,22031,0,0,0,0,0,,0,0
2,01-10-18,24,5:45,6:00,,,0,33.37,33.37,0,-63646,135987,199633,72341,0,0,0,0,0,,0,0
2,01-10-18,25,6:00,6:15,,29.68,0,29.68,29.68,-1,-102564,95288,197852,-7276,0,-2690,0,0,0,,2690,-2690
2,01-10-18,26,6:15,6:30,,,0,33.31,33.31,0,-90232,98552,188784,8320,0,0,0,0,0,,0,0
2,01-10-18,27,6:30,6:45,,31.61,0,31.61,31.61,-1,-65261,98497,163758,33236,0,-1208,0,0,0,,1208,-1208
2,01-10-18,28,6:45,7:00,,,0,34.14,34.14,0,-84907,148361,233268,63454,0,0,0,0,0,,0,0
2,01-10-18,29,7:00,7:15,,,0,34.53,34.53,0,-143793,154041,297834,10248,0,0,0,0,0,,0,0
2,01-10-18,30,7:15,7:30,43.97,,0,43.97,43.97,1,-135605,109719,245324,-25886,0,0,1323,0,0,,1323,1323
2,01-10-18,31,7:30,7:45,105.5,,0,105.5,105.5,1,-178494,102910,281404,-75584,0,0,34978,0,0,,34978,34978
2,01-10-18,32,7:45,8:00,143.12,,0,143.12,143.12,1,-224156,97544,321700,-126612,0,0,79511,0,0,,79511,79511
2,01-10-18,33,8:00,8:15,143.12,-31.36,0,-31.36,-31.36,-1,-65902,205564,271466,139662,0,-5472,27377,0,0,,32849,21905
2,01-10-18,34,8:15,8:30,,31.78,0,31.78,31.78,-1,-94697,147280,241977,52583,0,-1972,0,0,0,,1972,-1972
2,01-10-18,35,8:30,8:45,,27.61,0,27.61,27.61,-1,-102858,152259,255117,49401,0,-7436,0,0,0,,7436,-7436
2,01-10-18,36,8:45,9:00,,20.99,0,20.99,20.99,-1,-113199,164030,277229,50831,0,-24052,0,0,0,,24052,-24052
2,01-10-18,37,9:00,9:15,,31.61,0,31.61,31.61,-1,-120896,174667,295563,53771,0,-14436,0,0,0,,14436,-14436
2,01-10-18,38,9:15,9:30,,,0,34.53,34.53,0,-98329,185901,284230,87572,0,-105,0,0,0,,105,-105
2,01-10-18,39,9:30,9:45,,34.35,0,34.35,34.35,-1,-94136,192266,286402,98130,0,-32,0,0,0,,32,-32
2,01-10-18,40,9:45,10:00,,,0,34.53,34.53,0,-90736,197722,288458,106986,0,0,0,0,0,,0,0
2,01-10-18,41,10:00,10:15,,26.93,0,26.93,26.93,-1,-89842,191039,280881,101197,0,-681,0,0,0,,681,-681
2,01-10-18,42,10:15,10:30,,-37.92,0,-37.92,-37.92,-1,-97731,176666,274397,78935,0,-51321,0,0,0,,51321,-51321
2,01-10-18,43,10:30,10:45,,28.93,0,28.93,28.93,-1,-129107,146597,275704,17490,0,-30637,0,0,0,,30637,-30637
2,01-10-18,44,10:45,11:00,,31.61,0,31.61,31.61,-1,-127635,148319,275954,20684,0,-26723,0,0,0,,26723,-26723
2,01-10-18,45,11:00,11:15,,31.61,0,31.61,31.61,-1,-103011,116789,219800,13778,0,-16507,0,0,0,,16507,-16507
2,01-10-18,46,11:15,11:30,,27.79,0,27.79,27.79,-1,-80429,117680,198109,37251,0,-7706,0,0,0,,7706,-7706
2,01-10-18,47,11:30,11:45,,32.78,0,32.78,32.78,-1,-88178,117666,205844,29488,0,-11042,0,0,0,,11042,-11042
2,01-10-18,48,11:45,12:00,,34.87,0,34.87,34.87,-1,-90922,113128,204050,22206,0,-3091,0,0,0,,3091,-3091
2,01-10-18,49,12:00,12:15,37.36,35.92,0,37.36,34.52,2,-121877,102414,224291,-19463,0,-63,798,0,0,,861,735
2,01-10-18,50,12:15,12:30,34.61,,0,34.61,34.61,1,-122755,113023,235778,-9732,0,0,500,0,0,,500,500
2,01-10-18,51,12:30,12:45,,32.78,0,32.78,32.78,-1,-91326,126820,218146,35494,0,-380,0,0,0,,380,-380
2,01-10-18,52,12:45,13:00,,31.61,0,31.61,31.61,-1,-90191,124523,214714,34332,0,-9140,0,0,0,,9140,-9140
2,01-10-18,53,13:00,13:15,,31.61,0,31.61,31.61,-1,-83971,108619,192590,24648,0,-10495,0,0,0,,10495,-10495
2,01-10-18,54,13:15,13:30,,34.2,0,34.2,34.2,-1,-93741,97030,190771,3289,0,-3719,0,0,0,,3719,-3719
2,01-10-18,55,13:30,13:45,,32.78,0,32.78,32.78,-1,-86855,105551,192406,18696,0,-660,0,0,0,,660,-660
2,01-10-18,56,13:45,14:00,,32.78,0,32.78,32.78,-1,-84175,109782,193957,25607,0,-1375,0,0,0,,1375,-1375
2,01-10-18,57,14:00,14:15,,32.78,0,32.78,32.78,-1,-74597,125912,200509,51315,0,-1158,0,0,0,,1158,-1158
2,01-10-18,58,14:15,14:30,,35.31,0,35.31,35.31,-1,-80473,125613,206086,45140,0,-11,0,0,0,,11,-11
2,01-10-18,59,14:30,14:45,,32.78,0,32.78,32.78,-1,-91837,98481,190318,6644,0,-2288,0,0,0,,2288,-2288
2,01-10-18,60,14:45,15:00,,32.61,0,32.61,32.61,-1,-105302,106483,211785,1181,0,-5089,0,0,0,,5089,-5089
2,01-10-18,61,15:00,15:15,,34.2,0,34.2,34.2,-1,-97307,100989,198296,3682,0,-1176,0,0,0,,1176,-1176
2,01-10-18,62,15:15,15:30,,32.78,0,32.78,32.78,-1,-94922,109838,204760,14916,0,-2065,0,0,0,,2065,-2065
2,01-10-18,63,15:30,15:45,34.52,32.78,0,34.52,34.52,1,-102253,95111,197364,-7142,0,-68,76,0,0,,144,8
2,01-10-18,64,15:45,16:00,34.61,,0,34.61,34.61,1,-101231,97039,198270,-4192,0,0,1803,0,0,,1803,1803
2,01-10-18,65,16:00,16:15,34.61,31.61,0,31.61,31.61,-1,-93650,136794,230444,43144,0,-4631,12,0,0,,4643,-4619
2,01-10-18,66,16:15,16:30,,35.05,0,35.05,35.05,-1,-79571,111297,190868,31726,0,-3318,0,0,0,,3318,-3318
2,01-10-18,67,16:30,16:45,,35.93,0,35.93,35.93,-1,-74521,130222,204743,55701,0,-142,0,0,0,,142,-142
2,01-10-18,68,16:45,17:00,,,0,34.53,34.53,0,-85182,95280,180462,10098,0,-5,0,0,0,,5,-5
2,01-10-18,69,17:00,17:15,,18.78,0,18.78,18.78,-1,-78123,141219,219342,63096,0,-18279,0,0,0,,18279,-18279
2,01-10-18,70,17:15,17:30,,32.61,0,32.61,32.61,-1,-73232,108245,181477,35013,0,-15187,0,0,0,,15187,-15187
2,01-10-18,71,17:30,17:45,,,0,44.5,44.5,0,-69776,102879,172655,33103,0,-1138,0,0,0,,1138,-1138
2,01-10-18,72,17:45,18:00,,,0,44.5,44.5,0,-68725,125544,194269,56819,0,0,0,0,0,,0,0
2,01-10-18,73,18:00,18:15,36.66,33.38,0,44.5,33.38,2,-122379,93115,215494,-29264,0,-94,670,0,0,,764,576
2,01-10-18,74,18:15,18:30,,27.61,0,27.61,27.61,-1,-101971,133460,235431,31489,0,-12127,0,0,0,,12127,-12127
2,01-10-18,75,18:30,18:45,,25.19,0,25.19,25.19,-1,-98168,136009,234177,37841,0,-23893,0,0,0,,23893,-23893
2,01-10-18,76,18:45,19:00,,32.48,0,32.48,32.48,-1,-83932,134853,218785,50921,0,-14245,0,0,0,,14245,-14245
2,01-10-18,77,19:00,19:15,81.75,32.48,0,81.75,81.75,1,-122395,73673,196068,-48722,0,-322,11923,0,0,,12245,11601
2,01-10-18,78,19:15,19:30,34.41,,0,34.41,34.41,1,-89348,93687,183035,4339,0,0,3992,0,0,,3992,3992
2,01-10-18,79,19:30,19:45,34.41,33.04,0,33.04,33.04,-1,-84047,116378,200425,32331,0,-381,240,0,0,,621,-141
2,01-10-18,80,19:45,20:00,,30.14,0,30.14,30.14,-1,-81530,112188,193718,30658,0,-15102,0,0,0,,15102,-15102
2,01-10-18,81,20:00,20:15,39.18,31.61,0,39.18,39.18,1,-103126,97454,200580,-5672,0,-15363,926,0,0,,16289,-14437
2,01-10-18,82,20:15,20:30,39.18,31.61,0,31.61,31.61,-1,-85526,105932,191458,20406,0,-2366,298,0,0,,2664,-2068
2,01-10-18,83,20:30,20:45,,9.39,0,9.39,9.39,-1,-76333,137880,214213,61547,0,-6847,0,0,0,,6847,-6847
2,01-10-18,84,20:45,21:00,,-11.16,0,-11.16,-11.16,-1,-119624,122524,242148,2900,0,-25964,0,0,0,,25964,-25964
2,01-10-18,85,21:00,21:15,45.47,26.78,0,45.47,45.47,1,-85530,132289,217819,46759,0,-5765,769,0,0,,6534,-4996
2,01-10-18,86,21:15,21:30,59.88,26.78,0,59.88,59.88,1,-80312,66083,146395,-14229,0,-42,12491,0,0,,12533,12449
2,01-10-18,87,21:30,21:45,,,0,34.2,34.2,0,-63836,76976,140812,13140,0,0,142,0,0,,142,142
2,01-10-18,88,21:45,22:00,,,0,34.2,34.2,0,-59570,41127,100697,-18443,0,0,0,0,0,,0,0
2,01-10-18,89,22:00,22:15,,,0,33.52,33.52,0,-86264,58076,144340,-28188,0,0,0,0,0,,0,0
2,01-10-18,90,22:15,22:30,,,0,33.52,33.52,0,-74438,35642,110080,-38796,0,0,0,0,0,,0,0
2,01-10-18,91,22:30,22:45,,,0,33.55,33.55,0,-79750,60579,140329,-19171,0,0,0,0,0,,0,0
2,01-10-18,92,22:45,23:00,,32.78,0,32.78,32.78,-1,-67080,74771,141851,7691,0,-1301,0,0,0,,1301,-1301
2,01-10-18,93,23:00,23:15,,32.47,0,32.47,32.47,-1,-82393,54175,136568,-28218,0,-1038,0,0,0,,1038,-1038
2,01-10-18,94,23:15,23:30,,,0,33.54,33.54,0,-84143,59943,144086,-24200,0,0,0,0,0,,0,0
2,01-10-18,95,23:30,23:45,,,0,33.57,33.57,0,-87725,70099,157824,-17626,0,0,0,0,0,,0,0
2,01-10-18,96,23:45,0:00,,6.64,0,6.64,6.64,-1,-77106,87531,164637,10425,0,-4098,0,0,0,,4098,-4098
2,01-11-18,1,0:00,0:15,,-54.52,0,-54.52,-54.52,-1,-23702,95913,119615,72211,0,-14062,0,0,0,,14062,-14062
2,01-11-18,2,0:15,0:30,32.14,-54.52,0,32.14,32.14,1,-28749,67563,96312,38814,0,-2,28,0,0,,30,26
2,01-11-18,3,0:30,0:45,,23.58,0,23.58,23.58,-1,-22171,65651,87822,43480,0,-1079,0,0,0,,1079,-1079
2,01-11-18,4,0:45,1:00,,-1.2,0,-1.2,-1.2,-1,-28053,87072,115125,59019,0,-40820,0,0,0,,40820,-40820
2,01-11-18,5,1:00,1:15,47.87,33.12,0,47.87,33.12,2,-39836,24043,63879,-15793,0,-18341,1177,0,0,,19518,-17164
2,01-11-18,6,1:15,1:30,47.87,34.12,0,34.12,34.12,-1,-37891,42255,80146,4364,0,-454,44,0,0,,498,-410
2,01-11-18,7,1:30,1:45,,34.12,0,34.12,34.12,-1,-20445,53883,74328,33438,0,-2208,0,0,0,,2208,-2208
2,01-11-18,8,1:45,2:00,,22.03,0,22.03,22.03,-1,-21963,69019,90982,47056,0,-21873,0,0,0,,21873,-21873
2,01-11-18,9,2:00,2:15,,24.03,0,24.03,24.03,-1,-16116,45633,61749,29517,0,-17769,0,0,0,,17769,-17769
2,01-11-18,10,2:15,2:30,36.44,24.03,0,36.44,36.44,1,-23191,27271,50462,4080,0,-6,13,0,0,,19,7
2,01-11-18,11,2:30,2:45,,,0,34.19,34.19,0,-17250,28878,46128,11628,0,0,0,0,0,,0,0
2,01-11-18,12,2:45,3:00,,29.12,0,29.12,29.12,-1,-15780,33201,48981,17421,0,-2595,0,0,0,,2595,-2595
2,01-11-18,13,3:00,3:15,,23.51,0,23.51,23.51,-1,-6166,49737,55903,43571,0,-9956,0,0,0,,9956,-9956
2,01-11-18,14,3:15,3:30,,,0,34.16,34.16,0,-14716,49351,64067,34635,0,-40,0,0,0,,40,-40
2,01-11-18,15,3:30,3:45,,,0,34.16,34.16,0,-19126,46159,65285,27033,0,0,0,0,0,,0,0
2,01-11-18,16,3:45,4:00,,33.12,0,33.12,33.12,-1,-14268,50608,64876,36340,0,-284,0,0,0,,284,-284
2,01-11-18,17,4:00,4:15,,,0,34.19,34.19,0,-13618,89058,102676,75440,0,0,0,0,0,,0,0
2,01-11-18,18,4:15,4:30,,,0,34.18,34.18,0,-10315,77867,88182,67552,0,0,0,0,0,,0,0
2,01-11-18,19,4:30,4:45,,,0,34.18,34.18,0,-12056,84302,96358,72246,0,0,0,0,0,,0,0
2,01-11-18,20,4:45,5:00,,,0,34.19,34.19,0,-11329,99682,111011,88353,0,0,0,0,0,,0,0
2,01-11-18,21,5:00,5:15,,7.71,0,7.71,7.71,-1,-41472,97027,138499,55555,0,-18386,0,0,0,,18386,-18386
2,01-11-18,22,5:15,5:30,,12.69,0,12.69,12.69,-1,-24790,61049,85839,36259,0,-40885,0,0,0,,40885,-40885
2,01-11-18,23,5:30,5:45,,35.66,0,35.66,35.66,-1,-32148,37602,69750,5454,0,-7878,0,0,0,,7878,-7878
2,01-11-18,24,5:45,6:00,,33.12,0,33.12,33.12,-1,-34630,47362,81992,12732,0,-276,0,0,0,,276,-276
2,01-11-18,25,6:00,6:15,,18.93,0,18.93,18.93,-1,-53621,141325,194946,87704,0,-17391,0,0,0,,17391,-17391
2,01-11-18,26,6:15,6:30,,31.7,0,31.7,31.7,-1,-44349,103930,148279,59581,0,-9445,0,0,0,,9445,-9445
2,01-11-18,27,6:30,6:45,35.88,31.7,0,35.88,35.88,1,-36202,42623,78825,6421,0,-1312,25,0,0,,1337,-1287
2,01-11-18,28,6:45,7:00,38.47,,0,38.47,38.47,1,-47072,61335,108407,14263,0,0,515,0,0,,515,515
2,01-11-18,29,7:00,7:15,,-0.45,0,-0.45,-0.45,-1,-40758,182013,222771,141255,0,-15428,0,0,0,,15428,-15428
2,01-11-18,30,7:15,7:30,,35.2,0,35.2,35.2,-1,-27628,116473,144101,88845,0,-1774,0,0,0,,1774,-1774
2,01-11-18,31,7:30,7:45,,,0,35.76,35.76,0,-50846,69260,120106,18414,0,0,0,0,0,,0,0
2,01-11-18,32,7:45,8:00,59.07,,0,59.07,59.07,1,-105200,57552,162752,-47648,0,0,6314,0,0,,6314,6314
2,01-11-18,33,8:00,8:15,59.07,24.05,0,24.05,24.05,-1,-32229,137654,169883,105425,0,-9633,450,0,0,,10083,-9183
2,01-11-18,34,8:15,8:30,,31.7,0,31.7,31.7,-1,-42054,91600,133654,49546,0,-19838,0,0,0,,19838,-19838
2,01-11-18,35,8:30,8:45,,32.18,0,32.18,32.18,-1,-48477,79514,127991,31037,0,-20412,0,0,0,,20412,-20412
2,01-11-18,36,8:45,9:00,,32.12,0,32.12,32.12,-1,-68008,77771,145779,9763,0,-11192,0,0,0,,11192,-11192
2,01-11-18,37,9:00,9:15,,0.02,0,0.02,0.02,-1,-39613,113478,153091,73865,0,-41528,0,0,0,,41528,-41528
2,01-11-18,38,9:15,9:30,,27.42,0,27.42,27.42,-1,-48873,98528,147401,49655,0,-39747,0,0,0,,39747,-39747
2,01-11-18,39,9:30,9:45,,32.18,0,32.18,32.18,-1,-53740,110511,164251,56771,0,-19757,0,0,0,,19757,-19757
2,01-11-18,40,9:45,10:00,,24.82,0,24.82,24.82,-1,-58036,117123,175159,59087,0,-25645,0,0,0,,25645,-25645
2,01-11-18,41,10:00,10:15,,29.44,0,29.44,29.44,-1,-68468,105134,173602,36666,0,-16242,0,0,0,,16242,-16242
2,01-11-18,42,10:15,10:30,,18.69,0,18.69,18.69,-1,-68639,107475,176114,38836,0,-27094,0,0,0,,27094,-27094
2,01-11-18,43,10:30,10:45,,28.18,0,28.18,28.18,-1,-68580,120999,189579,52419,0,-18164,0,0,0,,18164,-18164
2,01-11-18,44,10:45,11:00,,18.74,0,18.74,18.74,-1,-73912,136418,210330,62506,0,-17258,0,0,0,,17258,-17258
2,01-11-18,45,11:00,11:15,,7.54,0,7.54,7.54,-1,-61731,116407,178138,54676,0,-44312,0,0,0,,44312,-44312
2,01-11-18,46,11:15,11:30,,27.91,0,27.91,27.91,-1,-74377,110394,184771,36017,0,-34151,0,0,0,,34151,-34151
2,01-11-18,47,11:30,11:45,,28.18,0,28.18,28.18,-1,-72887,110876,183763,37989,0,-32947,0,0,0,,32947,-32947
2,01-11-18,48,11:45,12:00,,31.13,0,31.13,31.13,-1,-77790,106886,184676,29096,0,-17417,0,0,0,,17417,-17417
2,01-11-18,49,12:00,12:15,,28.18,0,28.18,28.18,-1,-81834,82740,164574,906,0,-6740,0,0,0,,6740,-6740
2,01-11-18,50,12:15,12:30,,25.19,0,25.19,25.19,-1,-72308,93562,165870,21254,0,-14695,0,0,0,,14695,-14695
2,01-11-18,51,12:30,12:45,,30.73,0,30.73,30.73,-1,-65499,111027,176526,45528,0,-18525,0,0,0,,18525,-18525
2,01-11-18,52,12:45,13:00,,10.72,0,10.72,10.72,-1,-63474,128514,191988,65040,0,-7561,0,0,0,,7561,-7561
2,01-11-18,53,13:00,13:15,,6.19,0,6.19,6.19,-1,-91257,104280,195537,13023,0,-11179,0,0,0,,11179,-11179
2,01-11-18,54,13:15,13:30,,,0,35.86,35.86,0,-86496,97969,184465,11473,0,0,0,0,0,,0,0
2,01-11-18,55,13:30,13:45,,,0,35.86,35.86,0,-80992,126317,207309,45325,0,0,0,0,0,,0,0
2,01-11-18,56,13:45,14:00,,23.01,0,23.01,23.01,-1,-79790,128655,208445,48865,0,-4706,0,0,0,,4706,-4706
2,01-11-18,57,14:00,14:15,,32.18,0,32.18,32.18,-1,-90351,130685,221036,40334,0,-4626,0,0,0,,4626,-4626
2,01-11-18,58,14:15,14:30,,29.43,0,29.43,29.43,-1,-94177,135587,229764,41410,0,-626,0,0,0,,626,-626
2,01-11-18,59,14:30,14:45,,28.18,0,28.18,28.18,-1,-92863,123526,216389,30663,0,-1366,0,0,0,,1366,-1366
2,01-11-18,60,14:45,15:00,,31.81,0,31.81,31.81,-1,-96268,128016,224284,31748,0,-4113,0,0,0,,4113,-4113
2,01-11-18,61,15:00,15:15,,,0,35.88,35.88,0,-93934,117189,211123,23255,0,-717,0,0,0,,717,-717
2,01-11-18,62,15:15,15:30,,,0,35.89,35.89,0,-78902,111722,190624,32820,0,0,0,0,0,,0,0
2,01-11-18,63,15:30,15:45,,35.16,0,35.16,35.16,-1,-78138,110886,189024,32748,0,-400,0,0,0,,400,-400
2,01-11-18,64,15:45,16:00,,35.54,0,35.54,35.54,-1,-76587,94029,170616,17442,0,-359,0,0,0,,359,-359
2,01-11-18,65,16:00,16:15,,35.58,0,35.58,35.58,-1,-87944,150833,238777,62889,0,-183,0,0,0,,183,-183
2,01-11-18,66,16:15,16:30,,,0,35.94,35.94,0,-83141,137289,220430,54148,0,0,0,0,0,,0,0
2,01-11-18,67,16:30,16:45,,,0,35.96,35.96,0,-60693,113661,174354,52968,0,0,0,0,0,,0,0
2,01-11-18,68,16:45,17:00,,,0,36,36,0,-49536,87895,137431,38359,0,0,0,0,0,,0,0
2,01-11-18,69,17:00,17:15,,-3.75,0,-3.75,-3.75,-1,-66326,145827,212153,79501,0,-19165,0,0,0,,19165,-19165
2,01-11-18,70,17:15,17:30,36.82,33.46,0,36.82,36.82,1,-73847,70041,143888,-3806,0,-3595,399,0,0,,3994,-3196
2,01-11-18,71,17:30,17:45,36.82,,0,36.82,36.82,1,-49863,79659,129522,29796,0,0,486,0,0,,486,486
2,01-11-18,72,17:45,18:00,,35.99,0,35.99,35.99,-1,-42383,110950,153333,68567,0,-80,0,0,0,,80,-80
2,01-11-18,73,18:00,18:15,,,0,36.03,36.03,0,-94561,52360,146921,-42201,0,0,0,0,0,,0,0
2,01-11-18,74,18:15,18:30,,36,0,36,36,-1,-66571,67124,133695,553,0,-7,0,0,0,,7,-7
2,01-11-18,75,18:30,18:45,,29.46,0,29.46,29.46,-1,-63011,85583,148594,22572,0,-9269,0,0,0,,9269,-9269
2,01-11-18,76,18:45,19:00,,35.62,0,35.62,35.62,-1,-53015,88078,141093,35063,0,-2715,0,0,0,,2715,-2715
2,01-11-18,77,19:00,19:15,60.9,,0,60.9,60.9,1,-89342,62186,151528,-27156,0,0,8430,0,0,,8430,8430
2,01-11-18,78,19:15,19:30,35.99,33.18,0,35.99,33.18,2,-53751,83698,137449,29947,0,-196,2298,0,0,,2494,2102
2,01-11-18,79,19:30,19:45,,18.96,0,18.96,18.96,-1,-55513,99486,154999,43973,0,-9986,0,0,0,,9986,-9986
2,01-11-18,80,19:45,20:00,,19.52,0,19.52,19.52,-1,-59329,99448,158777,40119,0,-28794,0,0,0,,28794,-28794
2,01-11-18,81,20:00,20:15,39.18,33.18,0,39.18,33.18,2,-66987,60053,127040,-6934,0,-9465,514,0,0,,9979,-8951
2,01-11-18,82,20:15,20:30,,32.18,0,32.18,32.18,-1,-41971,54613,96584,12642,0,-1406,0,0,0,,1406,-1406
2,01-11-18,83,20:30,20:45,,31.63,0,31.63,31.63,-1,-35565,72589,108154,37024,0,-1515,0,0,0,,1515,-1515
2,01-11-18,84,20:45,21:00,,26.08,0,26.08,26.08,-1,-41333,73362,114695,32029,0,-16941,0,0,0,,16941,-16941
2,01-11-18,85,21:00,21:15,39.18,9.19,0,39.18,9.19,2,-54441,58495,112936,4054,0,-18829,59,0,0,,18888,-18770
2,01-11-18,86,21:15,21:30,49.13,9.19,0,49.13,49.13,1,-42400,42013,84413,-387,0,-732,868,0,0,,1600,136
2,01-11-18,87,21:30,21:45,,23.89,0,23.89,23.89,-1,-25921,60049,85970,34128,0,-8520,0,0,0,,8520,-8520
2,01-11-18,88,21:45,22:00,,29.97,0,29.97,29.97,-1,-46995,77874,124869,30879,0,-17834,0,0,0,,17834,-17834
2,01-11-18,89,22:00,22:15,39.18,15.01,0,39.18,15.01,2,-72061,38509,110570,-33552,0,-14169,391,0,0,,14560,-13778
2,01-11-18,90,22:15,22:30,39.18,15.01,0,39.18,39.18,1,-97529,26718,124247,-70811,0,-925,1533,0,0,,2458,608
2,01-11-18,91,22:30,22:45,,,0,34.5,34.5,0,-67882,62468,130350,-5414,0,0,0,0,0,,0,0
2,01-11-18,92,22:45,23:00,,32.18,0,32.18,32.18,-1,-62639,87547,150186,24908,0,-169,0,0,0,,169,-169
2,01-11-18,93,23:00,23:15,,23.81,0,23.81,23.81,-1,-43214,84643,127857,41429,0,-660,0,0,0,,660,-660
2,01-11-18,94,23:15,23:30,,32.18,0,32.18,32.18,-1,-42410,44677,87087,2267,0,-182,0,0,0,,182,-182
2,01-11-18,95,23:30,23:45,,18.18,0,18.18,18.18,-1,-44203,77664,121867,33461,0,-18440,0,0,0,,18440,-18440
2,01-11-18,96,23:45,0:00,,5.6,0,5.6,5.6,-1,-50643,107348,157991,56705,0,-28555,0,0,0,,28555,-28555
2,01-12-18,1,0:00,0:15,,-23.78,0,-23.78,-23.78,-1,-43122,59812,102934,16690,0,-26535,0,0,0,,26535,-26535
2,01-12-18,2,0:15,0:30,,19.08,0,19.08,19.08,-1,-27063,65532,92595,38469,0,-3198,0,0,0,,3198,-3198
2,01-12-18,3,0:30,0:45,,1.02,0,1.02,1.02,-1,-26112,71330,97442,45218,0,-33424,0,0,0,,33424,-33424
2,01-12-18,4,0:45,1:00,,23.07,0,23.07,23.07,-1,-27625,74212,101837,46587,0,-37882,0,0,0,,37882,-37882
2,01-12-18,5,1:00,1:15,,16.55,0,16.55,16.55,-1,-39397,60702,100099,21305,0,-23406,0,0,0,,23406,-23406
2,01-12-18,6,1:15,1:30,,23.28,0,23.28,23.28,-1,-20116,58450,78566,38334,0,-1940,0,0,0,,1940,-1940
2,01-12-18,7,1:30,1:45,,12.81,0,12.81,12.81,-1,-23917,68787,92704,44870,0,-9873,0,0,0,,9873,-9873
2,01-12-18,8,1:45,2:00,,-59.24,0,-59.24,-59.24,-1,-26550,74819,101369,48269,0,-40567,0,0,0,,40567,-40567
2,01-12-18,9,2:00,2:15,,22.78,0,22.78,22.78,-1,-32030,122360,154390,90330,0,-20359,0,0,0,,20359,-20359
2,01-12-18,10,2:15,2:30,,-20.13,0,-20.13,-20.13,-1,-23141,82059,105200,58918,0,-18684,0,0,0,,18684,-18684
2,01-12-18,11,2:30,2:45,,-19.78,0,-19.78,-19.78,-1,-20228,79262,99490,59034,0,-55052,0,0,0,,55052,-55052
2,01-12-18,12,2:45,3:00,,-4.52,0,-4.52,-4.52,-1,-20559,97645,118204,77086,0,-62861,0,0,0,,62861,-62861
2,01-12-18,13,3:00,3:15,,13.87,0,13.87,13.87,-1,-40938,55042,95980,14104,0,-29744,0,0,0,,29744,-29744
2,01-12-18,14,3:15,3:30,,24.14,0,24.14,24.14,-1,-32161,63733,95894,31572,0,-4050,0,0,0,,4050,-4050
2,01-12-18,15,3:30,3:45,,24.41,0,24.41,24.41,-1,-30825,65769,96594,34944,0,-7537,0,0,0,,7537,-7537
2,01-12-18,16,3:45,4:00,,28.12,0,28.12,28.12,-1,-33558,62743,96301,29185,0,-17344,0,0,0,,17344,-17344
2,01-12-18,17,4:00,4:15,35.12,36.39,0,35.12,34.26,2,-59905,56558,116463,-3347,0,-7071,465,0,0,,7536,-6606
2,01-12-18,18,4:15,4:30,,,0,34.26,34.26,0,-41173,76044,117217,34871,0,0,0,0,0,,0,0
2,01-12-18,19,4:30,4:45,,32.18,0,32.18,32.18,-1,-48247,72678,120925,24431,0,-452,0,0,0,,452,-452
2,01-12-18,20,4:45,5:00,,33.18,0,33.18,33.18,-1,-54183,74087,128270,19904,0,-1722,0,0,0,,1722,-1722
2,01-12-18,21,5:00,5:15,,36.02,0,36.02,36.02,-1,-42323,93658,135981,51335,0,-1562,0,0,0,,1562,-1562
2,01-12-18,22,5:15,5:30,,,0,34.3,34.3,0,-37663,86868,124531,49205,0,-23,0,0,0,,23,-23
2,01-12-18,23,5:30,5:45,,35.43,0,35.43,35.43,-1,-42867,56498,99365,13631,0,-1310,0,0,0,,1310,-1310
2,01-12-18,24,5:45,6:00,51.72,35.43,0,51.72,51.72,1,-58107,36588,94695,-21519,0,-67,6319,0,0,,6386,6252
2,01-12-18,25,6:00,6:15,36.07,34.93,0,36.07,34.74,2,-36934,101243,138177,64309,0,-481,4521,0,0,,5002,4040
2,01-12-18,26,6:15,6:30,,32.47,0,32.47,32.47,-1,-15223,81494,96717,66271,0,-462,0,0,0,,462,-462
2,01-12-18,27,6:30,6:45,,,0,34.74,34.74,0,-25830,56438,82268,30608,0,0,0,0,0,,0,0
2,01-12-18,28,6:45,7:00,,32.27,0,32.27,32.27,-1,-55108,99906,155014,44798,0,-787,0,0,0,,787,-787
2,01-12-18,29,7:00,7:15,,-31.78,0,-31.78,-31.78,-1,-62273,179991,242264,117718,0,-22155,0,0,0,,22155,-22155
2,01-12-18,30,7:15,7:30,,17.28,0,17.28,17.28,-1,-50565,129452,180017,78887,0,-13486,0,0,0,,13486,-13486
2,01-12-18,31,7:30,7:45,40.12,32.78,0,40.12,40.12,1,-56328,74689,131017,18361,0,-11614,174,0,0,,11788,-11440
2,01-12-18,32,7:45,8:00,54.5,32.78,0,54.5,54.5,1,-89687,60403,150090,-29284,0,-500,11443,0,0,,11943,10943
2,01-12-18,33,8:00,8:15,35.68,11.42,0,36.33,11.42,2,-26052,102675,128727,76623,0,-6072,4876,0,0,,10948,-1196
2,01-12-18,34,8:15,8:30,,35.99,0,35.99,35.99,-1,-43786,73531,117317,29745,0,-1813,0,0,0,,1813,-1813
2,01-12-18,35,8:30,8:45,,36.99,0,36.99,36.99,-1,-51857,54668,106525,2811,0,-1077,0,0,0,,1077,-1077
2,01-12-18,36,8:45,9:00,41.85,,0,41.85,41.85,1,-64858,40409,105267,-24449,0,0,741,0,0,,741,741
2,01-12-18,37,9:00,9:15,35.53,,0,35.53,35.53,1,-49624,76283,125907,26659,0,0,703,0,0,,703,703
2,01-12-18,38,9:15,9:30,,,0,47.79,47.79,0,-57077,69137,126214,12060,0,0,0,0,0,,0,0
2,01-12-18,39,9:30,9:45,,,0,47.79,47.79,0,-59786,68208,127994,8422,0,0,0,0,0,,0,0
2,01-12-18,40,9:45,10:00,36.01,,0,36.01,36.01,1,-59633,60792,120425,1159,0,0,749,0,0,,749,749
2,01-12-18,41,10:00,10:15,35.6,,0,35.6,35.6,1,-50842,75394,126236,24552,0,0,530,0,0,,530,530
2,01-12-18,42,10:15,10:30,35.47,,0,35.47,35.47,1,-48874,79255,128129,30381,0,0,47,0,0,,47,47
2,01-12-18,43,10:30,10:45,,,0,47.89,47.89,0,-49553,87764,137317,38211,0,0,0,0,0,,0,0
2,01-12-18,44,10:45,11:00,,,0,47.89,47.89,0,-56026,80985,137011,24959,0,0,0,0,0,,0,0
2,01-12-18,45,11:00,11:15,,,0,47.88,47.88,0,-58609,92284,150893,33675,0,0,0,0,0,,0,0
2,01-12-18,46,11:15,11:30,,,0,47.88,47.88,0,-61166,85761,146927,24595,0,0,0,0,0,,0,0
2,01-12-18,47,11:30,11:45,,,0,47.88,47.88,0,-61445,81187,142632,19742,0,0,0,0,0,,0,0
2,01-12-18,48,11:45,12:00,,32.47,0,32.47,32.47,-1,-64182,86663,150845,22481,0,-815,0,0,0,,815,-815
2,01-12-18,49,12:00,12:15,65,32.47,0,65,65,1,-87727,46522,134249,-41205,0,-19,6578,0,0,,6597,6559
2,01-12-18,50,12:15,12:30,40.12,,0,40.12,40.12,1,-72920,60473,133393,-12447,0,0,13582,0,0,,13582,13582
2,01-12-18,51,12:30,12:45,40.12,34.59,0,34.59,34.59,-1,-70897,82673,153570,11776,0,-772,610,0,0,,1382,-162
2,01-12-18,52,12:45,13:00,,33.54,0,33.54,33.54,-1,-67353,83822,151175,16469,0,-1139,0,0,0,,1139,-1139
2,01-12-18,53,13:00,13:15,40.12,33.54,0,40.12,40.12,1,-75640,62810,138450,-12830,0,-5,1370,0,0,,1375,1365
2,01-12-18,54,13:15,13:30,40.12,,0,40.12,40.12,1,-76256,55485,131741,-20771,0,0,8995,0,0,,8995,8995
2,01-12-18,55,13:30,13:45,40.12,,0,40.12,40.12,1,-78482,57970,136452,-20512,0,0,10363,0,0,,10363,10363
2,01-12-18,56,13:45,14:00,36.28,,0,36.28,36.28,1,-74212,62064,136276,-12148,0,0,5005,0,0,,5005,5005
2,01-12-18,57,14:00,14:15,35.47,,0,35.47,35.47,1,-56071,60850,116921,4779,0,0,272,0,0,,272,272
2,01-12-18,58,14:15,14:30,36.78,,0,36.78,36.78,1,-56861,43135,99996,-13726,0,0,681,0,0,,681,681
2,01-12-18,59,14:30,14:45,35.68,,0,35.68,35.68,1,-53007,54515,107522,1508,0,0,1053,0,0,,1053,1053
2,01-12-18,60,14:45,15:00,,34.99,0,34.99,34.99,-1,-53647,56397,110044,2750,0,-254,0,0,0,,254,-254
2,01-12-18,61,15:00,15:15,35.72,,0,35.72,35.72,1,-51494,45771,97265,-5723,0,0,777,0,0,,777,777
2,01-12-18,62,15:15,15:30,31.72,,0,31.72,31.72,1,-43033,53494,96527,10461,0,0,417,0,0,,417,417
2,01-12-18,63,15:30,15:45,31.73,,0,31.73,31.73,1,-46214,48690,94904,2476,0,0,43,0,0,,43,43
2,01-12-18,64,15:45,16:00,31.74,,0,31.74,31.74,1,-38783,51969,90752,13186,0,0,250,0,0,,250,250
2,01-12-18,65,16:00,16:15,31.86,,0,31.86,31.86,1,-52303,69675,121978,17372,0,0,76,0,0,,76,76
2,01-12-18,66,16:15,16:30,,,0,34.53,34.53,0,-54942,68542,123484,13600,0,0,0,0,0,,0,0
2,01-12-18,67,16:30,16:45,36.63,,0,36.63,36.63,1,-43624,54929,98553,11305,0,0,137,0,0,,137,137
2,01-12-18,68,16:45,17:00,72.12,,0,72.12,72.12,1,-68570,41411,109981,-27159,0,0,17990,0,0,,17990,17990
2,01-12-18,69,17:00,17:15,40.12,-1.45,0,40.12,-1.45,2,-31603,80242,111845,48639,0,-12613,10320,0,0,,22933,-2293
2,01-12-18,70,17:15,17:30,42.03,34.43,0,42.03,42.03,1,-54504,36055,90559,-18449,0,-4173,770,0,0,,4943,-3403
2,01-12-18,71,17:30,17:45,51.36,34.43,0,51.36,51.36,1,-67837,32584,100421,-35253,0,-8,9353,0,0,,9361,9345
2,01-12-18,72,17:45,18:00,40.12,,0,40.12,40.12,1,-61885,53761,115646,-8124,0,0,12471,0,0,,12471,12471
2,01-12-18,73,18:00,18:15,43.08,,0,43.08,43.08,1,-86468,47491,133959,-38977,0,0,5027,0,0,,5027,5027
2,01-12-18,74,18:15,18:30,32.11,,0,32.11,32.11,1,-58480,58942,117422,462,0,0,257,0,0,,257,257
2,01-12-18,75,18:30,18:45,,23.37,0,23.37,23.37,-1,-44245,71067,115312,26822,0,-14496,0,0,0,,14496,-14496
2,01-12-18,76,18:45,19:00,,15.5,0,15.5,15.5,-1,-37149,76291,113440,39142,0,-27363,0,0,0,,27363,-27363
2,01-12-18,77,19:00,19:15,99.31,-3.99,0,99.31,-3.99,2,-88829,40602,129431,-48227,0,-21290,4269,0,0,,25559,-17021
2,01-12-18,78,19:15,19:30,40.12,32.47,0,40.12,32.47,2,-54758,47459,102217,-7299,0,-290,1872,0,0,,2162,1582
2,01-12-18,79,19:30,19:45,,18.9,0,18.9,18.9,-1,-51657,57680,109337,6023,0,-13493,0,0,0,,13493,-13493
2,01-12-18,80,19:45,20:00,,35.45,0,35.45,35.45,-1,-89849,80963,170812,-8886,0,-991,0,0,0,,991,-991
2,01-12-18,81,20:00,20:15,237.12,31.21,0,237.12,31.21,2,-99393,33520,132913,-65873,0,-978,12842,0,0,,13820,11864
2,01-12-18,82,20:15,20:30,237.12,36.32,0,237.12,34.38,2,-76350,49732,126082,-26618,0,-24,50270,0,0,,50294,50246
2,01-12-18,83,20:30,20:45,237.12,19.63,0,19.63,19.63,-1,-43612,56666,100278,13054,0,-8883,869,0,0,,9752,-8014
2,01-12-18,84,20:45,21:00,,-9.89,0,-9.89,-9.89,-1,-49806,98376,148182,48570,0,-14678,0,0,0,,14678,-14678
2,01-12-18,85,21:00,21:15,104.75,-140.07,0,104.75,-140.07,2,-88946,67199,156145,-21747,0,-24005,3142,0,0,,27147,-20863
2,01-12-18,86,21:15,21:30,193.12,-140.07,0,193.12,193.12,1,-83736,44522,128258,-39214,0,-40,33671,0,0,,33711,33631
2,01-12-18,87,21:30,21:45,31.62,25.22,0,25.22,25.22,-1,-38996,58366,97362,19370,0,-2957,3096,0,0,,6053,139
2,01-12-18,88,21:45,22:00,,22.02,0,22.02,22.02,-1,-35020,69921,104941,34901,0,-19306,0,0,0,,19306,-19306
2,01-12-18,89,22:00,22:15,221.12,32.47,0,221.12,221.12,1,-108528,43604,152132,-64924,0,-9575,15769,0,0,,25344,6194
2,01-12-18,90,22:15,22:30,221.12,32.47,0,221.12,221.12,1,-66623,51304,117927,-15319,0,-11,36297,0,0,,36308,36286
2,01-12-18,91,22:30,22:45,221.12,5.59,0,5.59,5.59,-1,-41109,75054,116163,33945,0,-16548,2156,0,0,,18704,-14392
2,01-12-18,92,22:45,23:00,,8.07,0,8.07,8.07,-1,-31089,74717,105806,43628,0,-25946,0,0,0,,25946,-25946
2,01-12-18,93,23:00,23:15,193.12,-16.08,0,193.12,-16.08,2,-100852,58444,159296,-42408,0,-23822,5267,0,0,,29089,-18555
2,01-12-18,94,23:15,23:30,237.12,-16.08,0,237.12,237.12,1,-82688,29259,111947,-53429,0,-93,52412,0,0,,52505,52319
2,01-12-18,95,23:30,23:45,38.12,34.82,0,34.82,34.82,-1,-50457,49914,100371,-543,0,-22,6891,0,0,,6913,6869
2,01-12-18,96,23:45,0:00,,32.47,0,32.47,32.47,-1,-82167,64683,146850,-17484,0,-1673,0,0,0,,1673,-1673
3,01/13/2018,1,0:00,0:15,60.17,33.18,0,60.17,33.18,2,-90420,102318,192738,11898,0,-1137,943,0,0,,2080,-194
3,01/13/2018,2,0:15,0:30,115.97,,0,115.97,115.97,1,-88900,59783,148683,-29117,0,0,24195,0,0,,24195,24195
3,01/13/2018,3,0:30,0:45,68.73,34.61,0,68.73,34.61,2,-91840,48214,140054,-43626,0,-568,4810,0,0,,5378,4242
3,01/13/2018,4,0:45,1:00,101.73,,0,101.73,101.73,1,-138141,72825,210966,-65316,0,0,32921,0,0,,32921,32921
3,01/13/2018,5,1:00,1:15,222.02,35.96,0,222.02,34.74,2,-78559,38141,116700,-40418,0,-50,17094,0,0,,17144,17044
3,01/13/2018,6,1:15,1:30,222.02,,0,222.02,222.02,1,-87665,45892,133557,-41773,0,0,46350,0,0,,46350,46350
3,01/13/2018,7,1:30,1:45,38.36,,0,38.36,38.36,1,-83124,66519,149643,-16605,0,0,2871,0,0,,2871,2871
3,01/13/2018,8,1:45,2:00,32.62,,0,32.62,32.62,1,-85510,75502,161012,-10008,0,0,1104,0,0,,1104,1104
3,01/13/2018,9,2:00,2:15,63.59,,0,63.59,63.59,1,-97394,50876,148270,-46518,0,0,9377,0,0,,9377,9377
3,01/13/2018,10,2:15,2:30,45.98,,0,45.98,45.98,1,-91977,58780,150757,-33197,0,0,19849,0,0,,19849,19849
3,01/13/2018,11,2:30,2:45,39.37,,0,39.37,39.37,1,-79139,63419,142558,-15720,0,0,10781,0,0,,10781,10781
3,01/13/2018,12,2:45,3:00,39.37,33.18,0,33.18,33.18,-1,-80712,75286,155998,-5426,0,-151,661,0,0,,812,510
3,01/13/2018,13,3:00,3:15,,32.14,0,32.14,32.14,-1,-109221,95471,204692,-13750,0,-447,0,0,0,,447,-447
3,01/13/2018,14,3:15,3:30,,,0,34.57,34.57,0,-93453,82790,176243,-10663,0,0,0,0,0,,0,0
3,01/13/2018,15,3:30,3:45,,,0,34.58,34.58,0,-80909,74847,155756,-6062,0,0,0,0,0,,0,0
3,01/13/2018,16,3:45,4:00,,,0,34.58,34.58,0,-81155,73443,154598,-7712,0,0,0,0,0,,0,0
3,01/13/2018,17,4:00,4:15,33.26,,0,33.26,33.26,1,-78273,82167,160440,3894,0,0,23,0,0,,23,23
3,01/13/2018,18,4:15,4:30,40.18,,0,40.18,40.18,1,-92834,81779,174613,-11055,0,0,1694,0,0,,1694,1694
3,01/13/2018,19,4:30,4:45,38.29,,0,38.29,38.29,1,-90555,78157,168712,-12398,0,0,785,0,0,,785,785
3,01/13/2018,20,4:45,5:00,41.57,,0,41.57,41.57,1,-97354,73543,170897,-23811,0,0,2730,0,0,,2730,2730
3,01/13/2018,21,5:00,5:15,32.72,,0,32.72,32.72,1,-71667,78425,150092,6758,0,0,559,0,0,,559,559
3,01/13/2018,22,5:15,5:30,38.26,,0,38.26,38.26,1,-90986,75480,166466,-15506,0,0,2335,0,0,,2335,2335
3,01/13/2018,23,5:30,5:45,46.18,,0,46.18,46.18,1,-97575,59943,157518,-37632,0,0,8152,0,0,,8152,8152
3,01/13/2018,24,5:45,6:00,70.47,,0,70.47,70.47,1,-110199,50961,161160,-59238,0,0,28794,0,0,,28794,28794
3,01/13/2018,25,6:00,6:15,38.51,32.87,0,32.87,32.87,-1,-95206,105475,200681,10269,0,-698,13060,0,0,,13758,12362
3,01/13/2018,26,6:15,6:30,42.85,32.87,0,42.85,42.85,1,-95570,78881,174451,-16689,0,-44,3209,0,0,,3253,3165
3,01/13/2018,27,6:30,6:45,82.98,,0,82.98,82.98,1,-112964,61464,174428,-51500,0,0,38348,0,0,,38348,38348
3,01/13/2018,28,6:45,7:00,54.02,,0,54.02,54.02,1,-95580,60194,155774,-35386,0,0,41705,0,0,,41705,41705
3,01/13/2018,29,7:00,7:15,36.62,33.99,0,36.62,33.99,2,-108607,115938,224545,7331,0,-2077,11573,0,0,,13650,9496
3,01/13/2018,30,7:15,7:30,,33.03,0,33.03,33.03,-1,-72647,86860,159507,14213,0,-5409,0,0,0,,5409,-5409
3,01/13/2018,31,7:30,7:45,33.12,36.81,0,33.12,33.12,1,-71999,74996,146995,2997,0,-2698,33,0,0,,2731,-2665
3,01/13/2018,32,7:45,8:00,65.58,,0,65.58,65.58,1,-87002,90621,177623,3619,0,0,14190,0,0,,14190,14190
3,01/13/2018,33,8:00,8:15,165.02,,0,165.02,165.02,1,-133933,56054,189987,-77879,0,0,27473,0,0,,27473,27473
3,01/13/2018,34,8:15,8:30,238.02,,0,238.02,238.02,1,-107389,34945,142334,-72444,0,0,39827,0,0,,39827,39827
3,01/13/2018,35,8:30,8:45,238.02,,0,238.02,238.02,1,-95148,54598,149746,-40550,0,0,56148,0,0,,56148,56148
3,01/13/2018,36,8:45,9:00,48.4,,0,48.4,48.4,1,-100607,73619,174226,-26988,0,0,18506,0,0,,18506,18506
3,01/13/2018,37,9:00,9:15,39.11,,0,39.11,39.11,1,-55380,56421,111801,1041,0,0,9380,0,0,,9380,9380
3,01/13/2018,38,9:15,9:30,99.02,,0,99.02,99.02,1,-73611,29850,103461,-43761,0,0,18839,0,0,,18839,18839
3,01/13/2018,39,9:30,9:45,133.02,,0,133.02,133.02,1,-99172,30698,129870,-68474,0,0,56913,0,0,,56913,56913
3,01/13/2018,40,9:45,10:00,238.02,,0,238.02,238.02,1,-128158,37538,165696,-90620,0,0,75056,0,0,,75056,75056
3,01/13/2018,41,10:00,10:15,97.7,,0,97.7,97.7,1,-96394,50988,147382,-45406,0,0,62890,0,0,,62890,62890
3,01/13/2018,42,10:15,10:30,74.02,,0,74.02,74.02,1,-100417,44830,145247,-55587,0,0,44558,0,0,,44558,44558
3,01/13/2018,43,10:30,10:45,238.02,,0,238.02,238.02,1,-128442,50668,179110,-77774,0,0,69919,0,0,,69919,69919
3,01/13/2018,44,10:45,11:00,106.5,,0,106.5,106.5,1,-121872,51036,172908,-70836,0,0,69225,0,0,,69225,69225
3,01/13/2018,45,11:00,11:15,61,,0,61,61,1,-117189,71965,189154,-45224,0,0,50064,0,0,,50064,50064
3,01/13/2018,46,11:15,11:30,92.15,,0,92.15,92.15,1,-130669,69247,199916,-61422,0,0,33651,0,0,,33651,33651
3,01/13/2018,47,11:30,11:45,166.02,,0,166.02,166.02,1,-138490,72039,210529,-66451,0,0,61852,0,0,,61852,61852
3,01/13/2018,48,11:45,12:00,64.02,,0,64.02,64.02,1,-132252,71979,204231,-60273,0,0,57849,0,0,,57849,57849
3,01/13/2018,49,12:00,12:15,238.02,,0,238.02,238.02,1,-162640,45547,208187,-117093,0,0,78371,0,0,,78371,78371
3,01/13/2018,50,12:15,12:30,238.02,,0,238.02,238.02,1,-140777,41297,182074,-99480,0,0,96393,0,0,,96393,96393
3,01/13/2018,51,12:30,12:45,147.66,,0,147.66,147.66,1,-120680,41577,162257,-79103,0,0,82471,10000,0,,92471,92471
3,01/13/2018,52,12:45,13:00,46.45,,0,46.45,46.45,1,-96938,48781,145719,-48157,0,0,40690,0,0,,40690,40690
3,01/13/2018,53,13:00,13:15,39.67,,0,39.67,39.67,1,-97308,103209,200517,5901,0,0,16055,0,0,,16055,16055
3,01/13/2018,54,13:15,13:30,52.27,,0,52.27,52.27,1,-104532,78953,183485,-25579,0,0,5777,0,0,,5777,5777
3,01/13/2018,55,13:30,13:45,50.43,,0,50.43,50.43,1,-81783,59964,141747,-21819,0,0,25772,0,0,,25772,25772
3,01/13/2018,56,13:45,14:00,37.74,,0,37.74,37.74,1,-72185,57484,129669,-14701,0,0,12829,0,0,,12829,12829
3,01/13/2018,57,14:00,14:15,40.53,,0,40.53,40.53,1,-96866,81248,178114,-15618,0,0,13795,0,0,,13795,13795
3,01/13/2018,58,14:15,14:30,51.52,,0,51.52,51.52,1,-105475,67958,173433,-37517,0,0,18288,0,0,,18288,18288
3,01/13/2018,59,14:30,14:45,43.28,,0,43.28,43.28,1,-94920,84323,179243,-10597,0,0,24321,0,0,,24321,24321
3,01/13/2018,60,14:45,15:00,45.23,37.77,0,45.23,35.47,2,-97824,75265,173089,-22559,0,-121,4406,0,0,,4527,4285
3,01/13/2018,61,15:00,15:15,222.02,,0,222.02,222.02,1,-122479,68278,190757,-54201,0,0,39391,0,0,,39391,39391
3,01/13/2018,62,15:15,15:30,222.02,33.03,0,33.03,33.03,-1,-79941,88118,168059,8177,0,-1491,14241,0,0,,15732,12750
3,01/13/2018,63,15:30,15:45,,32,0,32,32,-1,-83274,97209,180483,13935,0,-853,0,0,0,,853,-853
3,01/13/2018,64,15:45,16:00,,21.99,0,21.99,21.99,-1,-89272,109500,198772,20228,0,-21233,0,0,0,,21233,-21233
3,01/13/2018,65,16:00,16:15,,32,0,32,32,-1,-59819,84048,143867,24229,0,-4642,0,0,0,,4642,-4642
3,01/13/2018,66,16:15,16:30,,26.27,0,26.27,26.27,-1,-47563,86974,134537,39411,0,-28372,0,0,0,,28372,-28372
3,01/13/2018,67,16:30,16:45,,33.03,0,33.03,33.03,-1,-71322,89466,160788,18144,0,-17433,0,0,0,,17433,-17433
3,01/13/2018,68,16:45,17:00,39.67,33.03,0,39.67,39.67,1,-83130,80820,163950,-2310,0,-1450,2408,0,0,,3858,958
3,01/13/2018,69,17:00,17:15,33.02,18.43,0,35.55,18.43,2,-47591,82184,129775,34593,0,-13544,370,0,0,,13914,-13174
3,01/13/2018,70,17:15,17:30,41.51,18.43,0,41.51,41.51,1,-84495,54688,139183,-29807,0,-3013,3096,0,0,,6109,83
3,01/13/2018,71,17:30,17:45,52.21,,0,52.21,52.21,1,-107501,68900,176401,-38601,0,0,26006,0,0,,26006,26006
3,01/13/2018,72,17:45,18:00,41.23,,0,41.23,41.23,1,-79739,75316,155055,-4423,0,0,27827,0,0,,27827,27827
3,01/13/2018,73,18:00,18:15,257.02,,0,257.02,257.02,1,-169883,34602,204485,-135281,0,0,58706,0,0,,58706,58706
3,01/13/2018,74,18:15,18:30,178.02,,0,178.02,178.02,1,-96612,53052,149664,-43560,0,0,68646,0,0,,68646,68646
3,01/13/2018,75,18:30,18:45,37.52,32,0,32,32,-1,-64759,73474,138233,8715,0,-3199,10461,0,0,,13660,7262
3,01/13/2018,76,18:45,19:00,38.1,30.67,0,38.1,30.67,2,-60195,70842,131037,10647,0,-12554,92,0,0,,12646,-12462
3,01/13/2018,77,19:00,19:15,238.02,30.67,0,238.02,238.02,1,-119814,33351,153165,-86463,0,-965,38087,0,0,,39052,37122
3,01/13/2018,78,19:15,19:30,64.02,,0,64.02,64.02,1,-102837,45659,148496,-57178,0,0,55211,0,0,,55211,55211
3,01/13/2018,79,19:30,19:45,60.9,,0,60.9,60.9,1,-96736,47226,143962,-49510,0,0,51542,0,0,,51542,51542
3,01/13/2018,80,19:45,20:00,47.42,,0,47.42,47.42,1,-103445,58395,161840,-45050,0,0,42643,0,0,,42643,42643
3,01/13/2018,81,20:00,20:15,238.02,,0,238.02,238.02,1,-112449,47469,159918,-64980,0,0,53513,0,0,,53513,53513
3,01/13/2018,82,20:15,20:30,63.31,,0,63.31,63.31,1,-83032,45256,128288,-37776,0,0,51103,0,0,,51103,51103
3,01/13/2018,83,20:30,20:45,63.31,32,0,32,32,-1,-43381,54306,97687,10925,0,-1331,7407,0,0,,8738,6076
3,01/13/2018,84,20:45,21:00,48.53,27.19,0,48.53,27.19,2,-74133,66748,140881,-7385,0,-9321,1258,0,0,,10579,-8063
3,01/13/2018,85,21:00,21:15,56.32,27.19,0,56.32,56.32,1,-129329,80066,209395,-49263,0,-84,4295,0,0,,4379,4211
3,01/13/2018,86,21:15,21:30,60.46,,0,60.46,60.46,1,-100335,74848,175183,-25487,0,0,20684,0,0,,20684,20684
3,01/13/2018,87,21:30,21:45,60.46,38,0,38,38,-1,-71378,84381,155759,13003,0,-79,3366,0,0,,3445,3287
3,01/13/2018,88,21:45,22:00,,33.6,0,33.6,33.6,-1,-70903,96948,167851,26045,0,-385,0,0,0,,385,-385
3,01/13/2018,89,22:00,22:15,,35.07,0,35.07,35.07,-1,-70591,59315,129906,-11276,0,-388,0,0,0,,388,-388
3,01/13/2018,90,22:15,22:30,,33.87,0,33.87,33.87,-1,-58214,57413,115627,-801,0,-342,0,0,0,,342,-342
3,01/13/2018,91,22:30,22:45,,,0,35.32,35.32,0,-61746,66620,128366,4874,0,-148,0,0,0,,148,-148
3,01/13/2018,92,22:45,23:00,,34.05,0,34.05,34.05,-1,-97504,94526,192030,-2978,0,-47,0,0,0,,47,-47
3,01/13/2018,93,23:00,23:15,45.39,37.17,0,45.39,45.39,1,-57428,80546,137974,23118,0,-103,1499,0,0,,1602,1396
3,01/13/2018,94,23:15,23:30,44.02,,0,44.02,44.02,1,-96895,66512,163407,-30383,0,0,4822,0,0,,4822,4822
3,01/13/2018,95,23:30,23:45,69.91,,0,69.91,69.91,1,-107315,64272,171587,-43043,0,0,17664,0,0,,17664,17664
3,01/13/2018,96,23:45,0:00,40.92,32.3,0,32.3,32.3,-1,-132779,89805,222584,-42974,0,-73,18425,0,0,,18498,18352
3,01/14/2018,1,0:00,0:15,70.88,22.95,0,70.88,22.95,2,-75934,98736,174670,22802,0,-887,4500,0,0,,5387,3613
3,01/14/2018,2,0:15,0:30,85.4,,0,85.4,85.4,1,-95749,69122,164871,-26627,0,0,17631,0,0,,17631,17631
3,01/14/2018,3,0:30,0:45,40.52,,0,40.52,40.52,1,-65101,46739,111840,-18362,0,0,2669,0,0,,2669,2669
3,01/14/2018,4,0:45,1:00,32.7,33.52,0,33.52,33.52,-1,-51097,48696,99793,-2401,0,-248,685,0,0,,933,437
3,01/14/2018,5,1:00,1:15,40.52,33.52,0,40.52,32.98,2,-48728,51730,100458,3002,0,-289,2143,0,0,,2432,1854
3,01/14/2018,6,1:15,1:30,33.22,,0,33.22,33.22,1,-43157,62641,105798,19484,0,0,2042,0,0,,2042,2042
3,01/14/2018,7,1:30,1:45,,,0,33.12,33.12,0,-42769,58448,101217,15679,0,0,22,0,0,,22,22
3,01/14/2018,8,1:45,2:00,,23.58,0,23.58,23.58,-1,-46948,76191,123139,29243,0,-10128,0,0,0,,10128,-10128
3,01/14/2018,9,2:00,2:15,40.52,31.75,0,40.52,31.75,2,-49288,40280,89568,-9008,0,-6538,1189,0,0,,7727,-5349
3,01/14/2018,10,2:15,2:30,,,0,33.96,33.96,0,-37549,44430,81979,6881,0,-5,0,0,0,,5,-5
3,01/14/2018,11,2:30,2:45,,30.78,0,30.78,30.78,-1,-41633,60525,102158,18892,0,-3241,0,0,0,,3241,-3241
3,01/14/2018,12,2:45,3:00,,26.06,0,26.06,26.06,-1,-64309,82125,146434,17816,0,-24013,0,0,0,,24013,-24013
3,01/14/2018,13,3:00,3:15,33.34,28.69,0,33.34,28.69,2,-30908,70632,101540,39724,0,-15874,36,0,0,,15910,-15838
3,01/14/2018,14,3:15,3:30,38.83,28.69,0,38.83,38.83,1,-50032,56227,106259,6195,0,-388,1325,0,0,,1713,937
3,01/14/2018,15,3:30,3:45,,33.52,0,33.52,33.52,-1,-46705,66020,112725,19315,0,-760,0,0,0,,760,-760
3,01/14/2018,16,3:45,4:00,,-5.78,0,-5.78,-5.78,-1,-39217,83965,123182,44748,0,-26562,0,0,0,,26562,-26562
3,01/14/2018,17,4:00,4:15,,22.01,0,22.01,22.01,-1,-44820,113952,158772,69132,0,-26942,0,0,0,,26942,-26942
3,01/14/2018,18,4:15,4:30,,12.01,0,12.01,12.01,-1,-51806,101172,152978,49366,0,-3672,0,0,0,,3672,-3672
3,01/14/2018,19,4:30,4:45,,1.78,0,1.78,1.78,-1,-52794,102918,155712,50124,0,-15208,0,0,0,,15208,-15208
3,01/14/2018,20,4:45,5:00,,27.01,0,27.01,27.01,-1,-54407,98927,153334,44520,0,-2961,0,0,0,,2961,-2961
3,01/14/2018,21,5:00,5:15,,26.14,0,26.14,26.14,-1,-55728,95848,151576,40120,0,-5448,0,0,0,,5448,-5448
3,01/14/2018,22,5:15,5:30,,-5.78,0,-5.78,-5.78,-1,-50251,82117,132368,31866,0,-21057,0,0,0,,21057,-21057
3,01/14/2018,23,5:30,5:45,,33.52,0,33.52,33.52,-1,-53772,70622,124394,16850,0,-11720,0,0,0,,11720,-11720
3,01/14/2018,24,5:45,6:00,,27.04,0,27.04,27.04,-1,-46378,81794,128172,35416,0,-6305,0,0,0,,6305,-6305
3,01/14/2018,25,6:00,6:15,,33.54,0,33.54,33.54,-1,-82877,82994,165871,117,0,-7162,0,0,0,,7162,-7162
3,01/14/2018,26,6:15,6:30,,33.61,0,33.61,33.61,-1,-32959,76256,109215,43297,0,-4216,0,0,0,,4216,-4216
3,01/14/2018,27,6:30,6:45,,34.18,0,34.18,34.18,-1,-31031,59522,90553,28491,0,-3035,0,0,0,,3035,-3035
3,01/14/2018,28,6:45,7:00,,,0,32.46,32.46,0,-28948,76667,105615,47719,0,-234,0,0,0,,234,-234
3,01/14/2018,29,7:00,7:15,,27.78,0,27.78,27.78,-1,-81923,126876,208799,44953,0,-4527,0,0,0,,4527,-4527
3,01/14/2018,30,7:15,7:30,,21.51,0,21.51,21.51,-1,-48084,116534,164618,68450,0,-20735,0,0,0,,20735,-20735
3,01/14/2018,31,7:30,7:45,,32.34,0,32.34,32.34,-1,-50369,86997,137366,36628,0,-14455,0,0,0,,14455,-14455
3,01/14/2018,32,7:45,8:00,,34.54,0,34.54,34.54,-1,-57635,80667,138302,23032,0,-5848,0,0,0,,5848,-5848
3,01/14/2018,33,8:00,8:15,33.06,,0,33.06,33.06,1,-77086,70274,147360,-6812,0,0,655,0,0,,655,655
3,01/14/2018,34,8:15,8:30,36.76,,0,36.76,36.76,1,-73955,69141,143096,-4814,0,0,996,0,0,,996,996
3,01/14/2018,35,8:30,8:45,,,0,35.45,35.45,0,-64446,90088,154534,25642,0,0,235,0,0,,235,235
3,01/14/2018,36,8:45,9:00,,,0,35.44,35.44,0,-80852,123037,203889,42185,0,0,0,0,0,,0,0
3,01/14/2018,37,9:00,9:15,,38.08,0,38.08,38.08,-1,-46206,139946,186152,93740,0,-45,0,0,0,,45,-45
3,01/14/2018,38,9:15,9:30,,,0,35.6,35.6,0,-57098,109130,166228,52032,0,0,0,0,0,,0,0
3,01/14/2018,39,9:30,9:45,,,0,35.58,35.58,0,-56734,89612,146346,32878,0,0,0,0,0,,0,0
3,01/14/2018,40,9:45,10:00,33.8,,0,33.8,33.8,1,-72917,72389,145306,-528,0,0,297,0,0,,297,297
3,01/14/2018,41,10:00,10:15,33.42,33.54,0,35.6,33.54,2,-55374,103710,159084,48336,0,-2654,126,0,0,,2780,-2528
3,01/14/2018,42,10:15,10:30,,33.78,0,33.78,33.78,-1,-65713,84530,150243,18817,0,-1446,0,0,0,,1446,-1446
3,01/14/2018,43,10:30,10:45,,,0,35.57,35.57,0,-65105,74526,139631,9421,0,0,0,0,0,,0,0
3,01/14/2018,44,10:45,11:00,37.88,,0,37.88,37.88,1,-72171,70123,142294,-2048,0,0,253,0,0,,253,253
3,01/14/2018,45,11:00,11:15,,36.18,0,36.18,36.18,-1,-80272,85178,165450,4906,0,-297,0,0,0,,297,-297
3,01/14/2018,46,11:15,11:30,,34.54,0,34.54,34.54,-1,-76536,82710,159246,6174,0,-2733,0,0,0,,2733,-2733
3,01/14/2018,47,11:30,11:45,,,0,35.58,35.58,0,-79203,60229,139432,-18974,0,-61,0,0,0,,61,-61
3,01/14/2018,48,11:45,12:00,40.54,,0,40.54,40.54,1,-83476,47597,131073,-35879,0,0,4339,0,0,,4339,4339
3,01/14/2018,49,12:00,12:15,33.26,,0,33.26,33.26,1,-79848,68653,148501,-11195,0,0,2088,0,0,,2088,2088
3,01/14/2018,50,12:15,12:30,33.12,,0,33.12,33.12,1,-90986,58600,149586,-32386,0,0,224,0,0,,224,224
3,01/14/2018,51,12:30,12:45,64.39,,0,64.39,64.39,1,-95194,51246,146440,-43948,0,0,9037,0,0,,9037,9037
3,01/14/2018,52,12:45,13:00,67.16,36.1,0,36.1,36.1,-1,-84223,64351,148574,-19872,0,-36,18509,0,0,,18545,18473
3,01/14/2018,53,13:00,13:15,67.16,36.24,0,36.24,36.24,-1,-60630,76917,137547,16287,0,-337,442,0,0,,779,105
3,01/14/2018,54,13:15,13:30,,33.54,0,33.54,33.54,-1,-58674,77162,135836,18488,0,-2516,0,0,0,,2516,-2516
3,01/14/2018,55,13:30,13:45,,34.54,0,34.54,34.54,-1,-64090,55295,119385,-8795,0,-1439,0,0,0,,1439,-1439
3,01/14/2018,56,13:45,14:00,,,0,35.43,35.43,0,-61811,50695,112506,-11116,0,0,0,0,0,,0,0
3,01/14/2018,57,14:00,14:15,45.74,,0,45.74,45.74,1,-70477,53071,123548,-17406,0,0,2990,0,0,,2990,2990
3,01/14/2018,58,14:15,14:30,46.54,,0,46.54,46.54,1,-57547,51125,108672,-6422,0,0,9815,0,0,,9815,9815
3,01/14/2018,59,14:30,14:45,32.79,,0,32.79,32.79,1,-63892,64373,128265,481,0,0,1319,0,0,,1319,1319
3,01/14/2018,60,14:45,15:00,,,0,35.36,35.36,0,-59079,62656,121735,3577,0,0,0,0,0,,0,0
3,01/14/2018,61,15:00,15:15,32.54,,0,32.54,32.54,1,-66200,60942,127142,-5258,0,0,162,0,0,,162,162
3,01/14/2018,62,15:15,15:30,48.07,,0,48.07,48.07,1,-73420,48569,121989,-24851,0,0,9592,0,0,,9592,9592
3,01/14/2018,63,15:30,15:45,48.02,,0,48.02,48.02,1,-67104,42257,109361,-24847,0,0,23845,0,0,,23845,23845
3,01/14/2018,64,15:45,16:00,,,0,35.31,35.31,0,-82013,30055,112068,-51958,0,0,2347,0,0,,2347,2347
3,01/14/2018,65,16:00,16:15,,34.28,0,34.28,34.28,-1,-58587,72386,130973,13799,0,-16,0,0,0,,16,-16
3,01/14/2018,66,16:15,16:30,,,0,35.1,35.1,0,-66436,58521,124957,-7915,0,0,0,0,0,,0,0
3,01/14/2018,67,16:30,16:45,,,0,35.08,35.08,0,-48007,79453,127460,31446,0,0,0,0,0,,0,0
3,01/14/2018,68,16:45,17:00,40.3,,0,40.3,40.3,1,-73962,65323,139285,-8639,0,0,1140,0,0,,1140,1140
3,01/14/2018,69,17:00,17:15,40.3,7.24,0,7.24,7.24,-1,-111514,175829,287343,64315,0,-12367,39,0,0,,12406,-12328
3,01/14/2018,70,17:15,17:30,,33.03,0,33.03,33.03,-1,-51608,83046,134654,31438,0,-11874,0,0,0,,11874,-11874
3,01/14/2018,71,17:30,17:45,40.43,33.03,0,40.43,40.43,1,-91746,84254,176000,-7492,0,-1499,4107,0,0,,5606,2608
3,01/14/2018,72,17:45,18:00,48.66,,0,48.66,48.66,1,-85678,101956,187634,16278,0,0,5492,0,0,,5492,5492
3,01/14/2018,73,18:00,18:15,271.12,,0,271.12,271.12,1,-140073,60738,200811,-79335,0,0,36715,0,0,,36715,36715
3,01/14/2018,74,18:15,18:30,271.12,34.59,0,34.59,34.59,-1,-43315,95077,138392,51762,0,-61,1935,0,0,,1996,1874
3,01/14/2018,75,18:30,18:45,,32.65,0,32.65,32.65,-1,-43299,126412,169711,83113,0,-2154,0,0,0,,2154,-2154
3,01/14/2018,76,18:45,19:00,,28.31,0,28.31,28.31,-1,-54338,126821,181159,72483,0,-4906,0,0,0,,4906,-4906
3,01/14/2018,77,19:00,19:15,,35.89,0,35.89,35.89,-1,-67633,62142,129775,-5491,0,-720,0,0,0,,720,-720
3,01/14/2018,78,19:15,19:30,38.71,,0,38.71,38.71,1,-82017,73484,155501,-8533,0,0,1416,0,0,,1416,1416
3,01/14/2018,79,19:30,19:45,38.71,34.16,0,34.16,34.16,-1,-65825,82275,148100,16450,0,-580,56,0,0,,636,-524
3,01/14/2018,80,19:45,20:00,,35.78,0,35.78,35.78,-1,-67442,79026,146468,11584,0,-1176,0,0,0,,1176,-1176
3,01/14/2018,81,20:00,20:15,122.59,35.85,0,122.59,35.75,2,-85624,34540,120164,-51084,0,-306,15696,0,0,,16002,15390
3,01/14/2018,82,20:15,20:30,51.12,,0,51.12,51.12,1,-64297,40159,104456,-24138,0,0,34304,0,0,,34304,34304
3,01/14/2018,83,20:30,20:45,51.12,33.03,0,33.03,33.03,-1,-67251,76318,143569,9067,0,-2523,7002,0,0,,9525,4479
3,01/14/2018,84,20:45,21:00,,32.65,0,32.65,32.65,-1,-69033,89851,158884,20818,0,-5850,0,0,0,,5850,-5850
3,01/14/2018,85,21:00,21:15,48.13,34.78,0,48.13,34.78,2,-80547,35097,115644,-45450,0,-4425,2362,0,0,,6787,-2063
3,01/14/2018,86,21:15,21:30,55.22,,0,55.22,55.22,1,-83190,37388,120578,-45802,0,0,10709,0,0,,10709,10709
3,01/14/2018,87,21:30,21:45,55.22,33.78,0,33.78,33.78,-1,-48522,56027,104549,7505,0,-2361,1924,0,0,,4285,-437
3,01/14/2018,88,21:45,22:00,,37.69,0,37.69,37.69,-1,-76732,77118,153850,386,0,-1687,0,0,0,,1687,-1687
3,01/14/2018,89,22:00,22:15,,37.98,0,37.98,37.98,-1,-93330,38545,131875,-54785,0,-50,0,0,0,,50,-50
3,01/14/2018,90,22:15,22:30,,,0,35.45,35.45,0,-52596,35739,88335,-16857,0,0,0,0,0,,0,0
3,01/14/2018,91,22:30,22:45,,29.54,0,29.54,29.54,-1,-30227,52757,82984,22530,0,-1881,0,0,0,,1881,-1881
3,01/14/2018,92,22:45,23:00,,21.24,0,21.24,21.24,-1,-48550,86216,134766,37666,0,-27370,0,0,0,,27370,-27370
3,01/14/2018,93,23:00,23:15,40.97,-21.44,0,40.97,-21.44,2,-76347,35503,111850,-40844,0,-28493,544,0,0,,29037,-27949
3,01/14/2018,94,23:15,23:30,43.12,-21.44,0,43.12,43.12,1,-79549,40487,120036,-39062,0,-547,888,0,0,,1435,341
3,01/14/2018,95,23:30,23:45,,34.54,0,34.54,34.54,-1,-62938,65867,128805,2929,0,-813,0,0,0,,813,-813
3,01/14/2018,96,23:45,0:00,,0.34,0,0.34,0.34,-1,-56875,94340,151215,37465,0,-7406,0,0,0,,7406,-7406
3,01/15/2018,1,0:00,0:15,77.62,-152.55,0,77.62,-152.55,2,-67924,81520,149444,13596,0,-21498,1755,0,0,,23253,-19743
3,01/15/2018,2,0:15,0:30,80.31,-152.55,0,80.31,80.31,1,-56588,52224,108812,-4364,0,-106,7136,0,0,,7242,7030
3,01/15/2018,3,0:30,0:45,,34.27,0,34.27,34.27,-1,-41305,57136,98441,15831,0,-195,0,0,0,,195,-195
3,01/15/2018,4,0:45,1:00,,19.92,0,19.92,19.92,-1,-51120,76404,127524,25284,0,-15603,0,0,0,,15603,-15603
3,01/15/2018,5,1:00,1:15,59.77,33.54,0,59.77,59.77,1,-56818,45479,102297,-11339,0,-11634,1964,0,0,,13598,-9670
3,01/15/2018,6,1:15,1:30,72.79,33.54,0,72.79,72.79,1,-58825,35100,93925,-23725,0,-64,21691,0,0,,21755,21627
3,01/15/2018,7,1:30,1:45,72.79,33.43,0,33.43,33.43,-1,-46051,41943,87994,-4108,0,-885,4494,0,0,,5379,3609
3,01/15/2018,8,1:45,2:00,,33.54,0,33.54,33.54,-1,-47973,43507,91480,-4466,0,-1202,0,0,0,,1202,-1202
3,01/15/2018,9,2:00,2:15,53.47,,0,53.47,53.47,1,-49209,35503,84712,-13706,0,0,5403,0,0,,5403,5403
3,01/15/2018,10,2:15,2:30,64.47,,0,64.47,64.47,1,-59025,26154,85179,-32871,0,0,30092,0,0,,30092,30092
3,01/15/2018,11,2:30,2:45,40.54,,0,40.54,40.54,1,-50706,39259,89965,-11447,0,0,19895,0,0,,19895,19895
3,01/15/2018,12,2:45,3:00,38.79,,0,38.79,38.79,1,-47049,30967,78016,-16082,0,0,9593,0,0,,9593,9593
3,01/15/2018,13,3:00,3:15,,,0,33.28,33.28,0,-48156,60776,108932,12620,0,0,2234,0,0,,2234,2234
3,01/15/2018,14,3:15,3:30,,,0,33.28,33.28,0,-50103,54336,104439,4233,0,0,0,0,0,,0,0
3,01/15/2018,15,3:30,3:45,34.39,,0,34.39,34.39,1,-60994,56913,117907,-4081,0,0,1436,0,0,,1436,1436
3,01/15/2018,16,3:45,4:00,32.84,,0,32.84,32.84,1,-62791,56105,118896,-6686,0,0,2867,0,0,,2867,2867
3,01/15/2018,17,4:00,4:15,32.45,,0,32.45,32.45,1,-65269,75524,140793,10255,0,0,529,0,0,,529,529
3,01/15/2018,18,4:15,4:30,49.7,,0,49.7,49.7,1,-88721,72806,161527,-15915,0,0,8118,0,0,,8118,8118
3,01/15/2018,19,4:30,4:45,50.89,,0,50.89,50.89,1,-87437,74861,162298,-12576,0,0,25839,0,0,,25839,25839
3,01/15/2018,20,4:45,5:00,,,0,33.28,33.28,0,-87065,91668,178733,4603,0,0,4072,0,0,,4072,4072
3,01/15/2018,21,5:00,5:15,,,0,33.28,33.28,0,-70116,82260,152376,12144,0,0,0,0,0,,0,0
3,01/15/2018,22,5:15,5:30,,,0,33.28,33.28,0,-44005,69917,113922,25912,0,0,0,0,0,,0,0
3,01/15/2018,23,5:30,5:45,42.01,,0,42.01,42.01,1,-65992,73412,139404,7420,0,0,534,0,0,,534,534
3,01/15/2018,24,5:45,6:00,67.72,,0,67.72,67.72,1,-84288,72760,157048,-11528,0,0,14236,0,0,,14236,14236
3,01/15/2018,25,6:00,6:15,67.72,10.37,0,10.37,10.37,-1,-82204,161629,243833,79425,0,-7862,1774,0,0,,9636,-6088
3,01/15/2018,26,6:15,6:30,44.04,-12.03,0,44.04,-12.03,2,-47738,75340,123078,27602,0,-21545,763,0,0,,22308,-20782
3,01/15/2018,27,6:30,6:45,44.04,-12.03,0,44.04,44.04,1,-65049,77054,142103,12005,0,-200,912,0,0,,1112,712
3,01/15/2018,28,6:45,7:00,,,0,34.44,34.44,0,-78344,96971,175315,18627,0,0,0,0,0,,0,0
3,01/15/2018,29,7:00,7:15,37.08,33.62,0,37.08,33.62,2,-80269,132429,212698,52160,0,-550,164,0,0,,714,-386
3,01/15/2018,30,7:15,7:30,,18.29,0,18.29,18.29,-1,-41148,134631,175779,93483,0,-13592,0,0,0,,13592,-13592
3,01/15/2018,31,7:30,7:45,,37.72,0,37.72,37.72,-1,-69767,98676,168443,28909,0,-3033,0,0,0,,3033,-3033
3,01/15/2018,32,7:45,8:00,36.36,,0,36.36,36.36,1,-95147,113289,208436,18142,0,0,70,0,0,,70,70
3,01/15/2018,33,8:00,8:15,36.04,,0,36.04,36.04,1,-51692,100622,152314,48930,0,0,466,0,0,,466,466
3,01/15/2018,34,8:15,8:30,,37.23,0,37.23,37.23,-1,-51806,93646,145452,41840,0,-132,0,0,0,,132,-132
3,01/15/2018,35,8:30,8:45,,33.58,0,33.58,33.58,-1,-66238,95843,162081,29605,0,-1146,0,0,0,,1146,-1146
3,01/15/2018,36,8:45,9:00,,36.83,0,36.83,36.83,-1,-73688,93542,167230,19854,0,-207,0,0,0,,207,-207
3,01/15/2018,37,9:00,9:15,,21.42,0,21.42,21.42,-1,-43829,85305,129134,41476,0,-15777,0,0,0,,15777,-15777
3,01/15/2018,38,9:15,9:30,,29.69,0,29.69,29.69,-1,-60966,86832,147798,25866,0,-17596,0,0,0,,17596,-17596
3,01/15/2018,39,9:30,9:45,,31.11,0,31.11,31.11,-1,-63442,101276,164718,37834,0,-26005,0,0,0,,26005,-26005
3,01/15/2018,40,9:45,10:00,,28.72,0,28.72,28.72,-1,-60856,101834,162690,40978,0,-28504,0,0,0,,28504,-28504
3,01/15/2018,41,10:00,10:15,43.77,32.72,0,43.77,43.77,1,-68098,61901,129999,-6197,0,-12143,1148,0,0,,13291,-10995
3,01/15/2018,42,10:15,10:30,,,0,36.13,36.13,0,-75509,86295,161804,10786,0,-2,21,0,0,,23,19
3,01/15/2018,43,10:30,10:45,,35.69,0,35.69,35.69,-1,-75106,95051,170157,19945,0,-32,0,0,0,,32,-32
3,01/15/2018,44,10:45,11:00,,35.1,0,35.1,35.1,-1,-77939,97494,175433,19555,0,-2278,0,0,0,,2278,-2278
3,01/15/2018,45,11:00,11:15,,35.56,0,35.56,35.56,-1,-71332,87477,158809,16145,0,-1036,0,0,0,,1036,-1036
3,01/15/2018,46,11:15,11:30,,,0,36.13,36.13,0,-71309,86743,158052,15434,0,0,0,0,0,,0,0
3,01/15/2018,47,11:30,11:45,,36.17,0,36.17,36.17,-1,-61835,97845,159680,36010,0,-220,0,0,0,,220,-220
3,01/15/2018,48,11:45,12:00,,35.75,0,35.75,35.75,-1,-74885,91144,166029,16259,0,-728,0,0,0,,728,-728
3,01/15/2018,49,12:00,12:15,50.6,35.75,0,50.6,50.6,1,-75400,57174,132574,-18226,0,-53,4771,0,0,,4824,4718
3,01/15/2018,50,12:15,12:30,35.72,,0,35.72,35.72,1,-68947,63961,132908,-4986,0,0,1361,0,0,,1361,1361
3,01/15/2018,51,12:30,12:45,,,0,35.18,35.18,0,-68202,74655,142857,6453,0,0,0,0,0,,0,0
3,01/15/2018,52,12:45,13:00,,,0,35.19,35.19,0,-72751,90490,163241,17739,0,0,0,0,0,,0,0
3,01/15/2018,53,13:00,13:15,50.48,,0,50.48,50.48,1,-77560,64154,141714,-13406,0,0,5775,0,0,,5775,5775
3,01/15/2018,54,13:15,13:30,40.57,,0,40.57,40.57,1,-78263,56861,135124,-21402,0,0,16865,0,0,,16865,16865
3,01/15/2018,55,13:30,13:45,44.73,,0,44.73,44.73,1,-79768,58193,137961,-21575,0,0,20304,0,0,,20304,20304
3,01/15/2018,56,13:45,14:00,40.43,34.96,0,34.96,34.96,-1,-62283,75151,137434,12868,0,-427,9987,0,0,,10414,9560
3,01/15/2018,57,14:00,14:15,40.48,34.96,0,40.48,40.48,1,-77655,62492,140147,-15163,0,-121,1004,0,0,,1125,883
3,01/15/2018,58,14:15,14:30,51.15,,0,51.15,51.15,1,-97420,68638,166058,-28782,0,0,10598,0,0,,10598,10598
3,01/15/2018,59,14:30,14:45,40.48,,0,40.48,40.48,1,-94824,76963,171787,-17861,0,0,16283,0,0,,16283,16283
3,01/15/2018,60,14:45,15:00,40.48,,0,40.48,40.48,1,-88627,66834,155461,-21793,0,0,10919,0,0,,10919,10919
3,01/15/2018,61,15:00,15:15,48.28,,0,48.28,48.28,1,-102863,72042,174905,-30821,0,0,17931,0,0,,17931,17931
3,01/15/2018,62,15:15,15:30,50.93,,0,50.93,50.93,1,-110500,67961,178461,-42539,0,0,30395,0,0,,30395,30395
3,01/15/2018,63,15:30,15:45,44.76,,0,44.76,44.76,1,-116804,64163,180967,-52641,0,0,28594,0,0,,28594,28594
3,01/15/2018,64,15:45,16:00,44.76,37.57,0,37.57,37.57,-1,-119525,65204,184729,-54321,0,-6,7449,0,0,,7455,7443
3,01/15/2018,65,16:00,16:15,41.01,-25.01,0,41.01,-25.01,2,-63079,103467,166546,40388,0,-12110,200,0,0,,12310,-11910
3,01/15/2018,66,16:15,16:30,42.67,-35.86,0,42.67,-35.86,2,-58302,109037,167339,50735,0,-14182,455,0,0,,14637,-13727
3,01/15/2018,67,16:30,16:45,,25,0,25,25,-1,-65362,81325,146687,15963,0,-24824,0,0,0,,24824,-24824
3,01/15/2018,68,16:45,17:00,,32.72,0,32.72,32.72,-1,-67984,86345,154329,18361,0,-6982,0,0,0,,6982,-6982
3,01/15/2018,69,17:00,17:15,,22.28,0,22.28,22.28,-1,-79329,103116,182445,23787,0,-14384,0,0,0,,14384,-14384
3,01/15/2018,70,17:15,17:30,,35.75,0,35.75,35.75,-1,-63369,88151,151520,24782,0,-3329,0,0,0,,3329,-3329
3,01/15/2018,71,17:30,17:45,,29.1,0,29.1,29.1,-1,-57822,85938,143760,28116,0,-7357,0,0,0,,7357,-7357
3,01/15/2018,72,17:45,18:00,,34.02,0,34.02,34.02,-1,-56208,108043,164251,51835,0,-3055,0,0,0,,3055,-3055
3,01/15/2018,73,18:00,18:15,,37.86,0,37.86,37.86,-1,-76729,73856,150585,-2873,0,-270,0,0,0,,270,-270
3,01/15/2018,74,18:15,18:30,,11.25,0,11.25,11.25,-1,-50062,94547,144609,44485,0,-12701,0,0,0,,12701,-12701
3,01/15/2018,75,18:30,18:45,,10.34,0,10.34,10.34,-1,-69132,85543,154675,16411,0,-25438,0,0,0,,25438,-25438
3,01/15/2018,76,18:45,19:00,,28.04,0,28.04,28.04,-1,-65676,100176,165852,34500,0,-16665,0,0,0,,16665,-16665
3,01/15/2018,77,19:00,19:15,,22.28,0,22.28,22.28,-1,-54750,99603,154353,44853,0,-13966,0,0,0,,13966,-13966
3,01/15/2018,78,19:15,19:30,,27.9,0,27.9,27.9,-1,-41389,80547,121936,39158,0,-2759,0,0,0,,2759,-2759
3,01/15/2018,79,19:30,19:45,,19.04,0,19.04,19.04,-1,-56602,109755,166357,53153,0,-14220,0,0,0,,14220,-14220
3,01/15/2018,80,19:45,20:00,,-12.65,0,-12.65,-12.65,-1,-66854,126217,193071,59363,0,-38221,0,0,0,,38221,-38221
3,01/15/2018,81,20:00,20:15,45.97,-12.65,0,45.97,45.97,1,-87854,82341,170195,-5513,0,-14092,2088,0,0,,16180,-12004
3,01/15/2018,82,20:15,20:30,45.97,29.69,0,29.69,29.69,-1,-67127,83007,150134,15880,0,-3991,255,0,0,,4246,-3736
3,01/15/2018,83,20:30,20:45,,11.71,0,11.71,11.71,-1,-59341,102373,161714,43032,0,-13358,0,0,0,,13358,-13358
3,01/15/2018,84,20:45,21:00,,3.4,0,3.4,3.4,-1,-63281,111536,174817,48255,0,-26322,0,0,0,,26322,-26322
3,01/15/2018,85,21:00,21:15,46.24,-8.36,0,46.24,-8.36,2,-98392,86694,185086,-11698,0,-20669,730,0,0,,21399,-19939
3,01/15/2018,86,21:15,21:30,46.53,23.53,0,23.53,23.53,-1,-68082,86114,154196,18032,0,-1375,2378,0,0,,3753,1003
3,01/15/2018,87,21:30,21:45,,18.43,0,18.43,18.43,-1,-63426,84260,147686,20834,0,-7255,0,0,0,,7255,-7255
3,01/15/2018,88,21:45,22:00,,19.59,0,19.59,19.59,-1,-65524,95146,160670,29622,0,-14379,0,0,0,,14379,-14379
3,01/15/2018,89,22:00,22:15,41.5,32.79,0,41.5,32.79,2,-85051,71943,156994,-13108,0,-8751,1224,0,0,,9975,-7527
3,01/15/2018,90,22:15,22:30,41.5,36.75,0,36.75,36.75,-1,-61912,62605,124517,693,0,-58,63,0,0,,121,5
3,01/15/2018,91,22:30,22:45,,34.53,0,34.53,34.53,-1,-67652,86181,153833,18529,0,-437,0,0,0,,437,-437
3,01/15/2018,92,22:45,23:00,,31.11,0,31.11,31.11,-1,-89713,96719,186432,7006,0,-1783,0,0,0,,1783,-1783
3,01/15/2018,93,23:00,23:15,,28.8,0,28.8,28.8,-1,-96881,67741,164622,-29140,0,-2821,0,0,0,,2821,-2821
3,01/15/2018,94,23:15,23:30,,,0,34.7,34.7,0,-115791,55415,171206,-60376,0,-13,0,0,0,,13,-13
3,01/15/2018,95,23:30,23:45,,25.14,0,25.14,25.14,-1,-81020,83273,164293,2253,0,-1078,0,0,0,,1078,-1078
3,01/15/2018,96,23:45,0:00,,-18.55,0,-18.55,-18.55,-1,-79907,97871,177778,17964,0,-27798,0,0,0,,27798,-27798
3,01/16/2018,1,0:00,0:15,,25.1,0,25.1,25.1,-1,-32752,126169,158921,93417,0,-6128,0,0,0,,6128,-6128
3,01/16/2018,2,0:15,0:30,,36.52,0,36.52,36.52,-1,-55791,66788,122579,10997,0,-48,0,0,0,,48,-48
3,01/16/2018,3,0:30,0:45,,-14.49,0,-14.49,-14.49,-1,-42031,67393,109424,25362,0,-15987,0,0,0,,15987,-15987
3,01/16/2018,4,0:45,1:00,,-14.49,0,-14.49,-14.49,-1,-58452,88019,146471,29567,0,-37561,0,0,0,,37561,-37561
3,01/16/2018,5,1:00,1:15,52.77,21.78,0,52.77,52.77,1,-59560,42863,102423,-16697,0,-19319,1018,0,0,,20337,-18301
3,01/16/2018,6,1:15,1:30,50.94,21.78,0,50.94,50.94,1,-63354,51030,114384,-12324,0,-273,3060,0,0,,3333,2787
3,01/16/2018,7,1:30,1:45,32.93,,0,32.93,32.93,1,-53162,51449,104611,-1713,0,0,1412,0,0,,1412,1412
3,01/16/2018,8,1:45,2:00,32.93,17.64,0,17.64,17.64,-1,-43080,61592,104672,18512,0,-7369,44,0,0,,7413,-7325
3,01/16/2018,9,2:00,2:15,69.37,30.92,0,69.37,30.92,2,-66946,31273,98219,-35673,0,-6336,8086,0,0,,14422,1750
3,01/16/2018,10,2:15,2:30,56.59,,0,56.59,56.59,1,-74112,31014,105126,-43098,0,0,27691,0,0,,27691,27691
3,01/16/2018,11,2:30,2:45,42.52,,0,42.52,42.52,1,-57819,42622,100441,-15197,0,0,19499,0,0,,19499,19499
3,01/16/2018,12,2:45,3:00,62.26,,0,62.26,62.26,1,-56618,28622,85240,-27996,0,0,6722,0,0,,6722,6722
3,01/16/2018,13,3:00,3:15,36.12,,0,36.12,36.12,1,-44586,59785,104371,15199,0,0,3894,0,0,,3894,3894
3,01/16/2018,14,3:15,3:30,37.79,,0,37.79,37.79,1,-46686,40369,87055,-6317,0,0,1049,0,0,,1049,1049
3,01/16/2018,15,3:30,3:45,37.99,,0,37.99,37.99,1,-51824,38493,90317,-13331,0,0,3370,0,0,,3370,3370
3,01/16/2018,16,3:45,4:00,42.52,,0,42.52,42.52,1,-61107,30959,92066,-30148,0,0,9584,0,0,,9584,9584
3,01/16/2018,17,4:00,4:15,33.25,,0,33.25,33.25,1,-56383,74351,130734,17968,0,0,4083,0,0,,4083,4083
3,01/16/2018,18,4:15,4:30,,,0,33.82,33.82,0,-55052,52007,107059,-3045,0,0,0,0,0,,0,0
3,01/16/2018,19,4:30,4:45,37.62,,0,37.62,37.62,1,-67987,55540,123527,-12447,0,0,1024,0,0,,1024,1024
3,01/16/2018,20,4:45,5:00,38.52,35.52,0,38.52,33.82,2,-58362,69023,127385,10661,0,-5,2728,0,0,,2733,2723
3,01/16/2018,21,5:00,5:15,38.52,-13.42,0,-13.42,-13.42,-1,-34283,91962,126245,57679,0,-16455,73,0,0,,16528,-16382
3,01/16/2018,22,5:15,5:30,,30.66,0,30.66,30.66,-1,-36318,50646,86964,14328,0,-11952,0,0,0,,11952,-11952
3,01/16/2018,23,5:30,5:45,34.08,30.78,0,34.08,30.78,2,-45697,42824,88521,-2873,0,-4922,47,0,0,,4969,-4875
3,01/16/2018,24,5:45,6:00,47.48,30.78,0,47.48,47.48,1,-70649,58030,128679,-12619,0,-76,8113,0,0,,8189,8037
3,01/16/2018,25,6:00,6:15,32.63,35.73,0,33.93,33.93,2,-137042,162873,299915,25831,0,-258,2722,0,0,,2980,2464
3,01/16/2018,26,6:15,6:30,,28.73,0,28.73,28.73,-1,-61310,92446,153756,31136,0,-2986,0,0,0,,2986,-2986
3,01/16/2018,27,6:30,6:45,,,0,33.93,33.93,0,-69445,84291,153736,14846,0,-75,0,0,0,,75,-75
3,01/16/2018,28,6:45,7:00,33.53,,0,33.53,33.53,1,-90021,113710,203731,23689,0,0,23,0,0,,23,23
3,01/16/2018,29,7:00,7:15,39.6,,0,39.6,39.6,1,-115700,118178,233878,2478,0,0,523,0,0,,523,523
3,01/16/2018,30,7:15,7:30,,,0,33.93,33.93,0,-75641,91221,166862,15580,0,0,0,0,0,,0,0
3,01/16/2018,31,7:30,7:45,104.77,,0,104.77,104.77,1,-135583,104191,239774,-31392,0,0,13348,0,0,,13348,13348
3,01/16/2018,32,7:45,8:00,48.73,,0,48.73,48.73,1,-137810,123809,261619,-14001,0,0,23087,0,0,,23087,23087
3,01/16/2018,33,8:00,8:15,121.16,,0,121.16,121.16,1,-132947,58590,191537,-74357,0,0,31579,0,0,,31579,31579
3,01/16/2018,34,8:15,8:30,121.16,,0,121.16,121.16,1,-165743,59093,224836,-106650,0,0,96267,0,0,,96267,96267
3,01/16/2018,35,8:30,8:45,121.16,,0,121.16,121.16,1,-176853,56917,233770,-119936,0,0,118087,0,0,,118087,118087
3,01/16/2018,36,8:45,9:00,121.16,,0,121.16,121.16,1,-197212,56408,253620,-140804,0,0,120460,0,0,,120460,120460
3,01/16/2018,37,9:00,9:15,152.85,,0,152.85,152.85,1,-199294,51962,251256,-147332,0,0,135464,1250,0,,136714,136714
3,01/16/2018,38,9:15,9:30,152.85,,0,152.85,152.85,1,-197306,58361,255667,-138945,0,0,131783,1250,0,,133033,133033
3,01/16/2018,39,9:30,9:45,152.85,,0,152.85,152.85,1,-89393,99949,189342,10556,0,0,36434,1250,0,,37684,37684
3,01/16/2018,40,9:45,10:00,38.93,,0,38.93,38.93,1,-66670,70959,137629,4289,0,0,116,0,0,,116,116
3,01/16/2018,41,10:00,10:15,89.33,,0,89.33,89.33,1,-102716,81359,184075,-21357,0,0,20699,0,0,,20699,20699
3,01/16/2018,42,10:15,10:30,42.15,35.06,0,35.06,35.06,-1,-87692,110123,197815,22431,0,-335,12196,0,0,,12531,11861
3,01/16/2018,43,10:30,10:45,42.15,35.16,0,35.16,35.16,-1,-58363,117458,175821,59095,0,-346,12,0,0,,358,-334
3,01/16/2018,44,10:45,11:00,,,0,36.5,36.5,0,-47390,140136,187526,92746,0,-17,0,0,0,,17,-17
3,01/16/2018,45,11:00,11:15,,,0,36.51,36.51,0,-36542,131529,168071,94987,0,0,0,0,0,,0,0
3,01/16/2018,46,11:15,11:30,,,0,36.52,36.52,0,-45847,144577,190424,98730,0,0,0,0,0,,0,0
3,01/16/2018,47,11:30,11:45,,-34,0,-34,-34,-1,-56981,172994,229975,116013,0,-8178,0,0,0,,8178,-8178
3,01/16/2018,48,11:45,12:00,,29.16,0,29.16,29.16,-1,-97485,133674,231159,36189,0,-12292,0,0,0,,12292,-12292
3,01/16/2018,49,12:00,12:15,43.73,36.73,0,43.73,36.23,2,-108507,100594,209101,-7913,0,-2206,3034,0,0,,5240,828
3,01/16/2018,50,12:15,12:30,,,0,36.25,36.25,0,-91088,111113,202201,20025,0,0,265,0,0,,265,265
3,01/16/2018,51,12:30,12:45,,,0,36.24,36.24,0,-74174,141574,215748,67400,0,0,0,0,0,,0,0
3,01/16/2018,52,12:45,13:00,,30.72,0,30.72,30.72,-1,-74306,134811,209117,60505,0,-892,0,0,0,,892,-892
3,01/16/2018,53,13:00,13:15,,28.28,0,28.28,28.28,-1,-75441,116495,191936,41054,0,-2110,0,0,0,,2110,-2110
3,01/16/2018,54,13:15,13:30,,36.73,0,36.73,36.73,-1,-76807,111776,188583,34969,0,-5,0,0,0,,5,-5
3,01/16/2018,55,13:30,13:45,,36.73,0,36.73,36.73,-1,-69581,142221,211802,72640,0,-1111,0,0,0,,1111,-1111
3,01/16/2018,56,13:45,14:00,,1.81,0,1.81,1.81,-1,-39071,153817,192888,114746,0,-14632,0,0,0,,14632,-14632
3,01/16/2018,57,14:00,14:15,,30.76,0,30.76,30.76,-1,-23255,143695,166950,120440,0,-8781,0,0,0,,8781,-8781
3,01/16/2018,58,14:15,14:30,,,0,35.18,35.18,0,-33019,148296,181315,115277,0,-47,0,0,0,,47,-47
3,01/16/2018,59,14:30,14:45,,-53.35,0,-53.35,-53.35,-1,-31685,129781,161466,98096,0,-24177,0,0,0,,24177,-24177
3,01/16/2018,60,14:45,15:00,,24.94,0,24.94,24.94,-1,-42186,94062,136248,51876,0,-31113,0,0,0,,31113,-31113
3,01/16/2018,61,15:00,15:15,,29.16,0,29.16,29.16,-1,-40679,138328,179007,97649,0,-21810,0,0,0,,21810,-21810
3,01/16/2018,62,15:15,15:30,,,0,35.07,35.07,0,-39296,123545,162841,84249,0,-950,0,0,0,,950,-950
3,01/16/2018,63,15:30,15:45,,,0,35.08,35.08,0,-50337,87908,138245,37571,0,0,0,0,0,,0,0
3,01/16/2018,64,15:45,16:00,,,0,35.09,35.09,0,-51801,87831,139632,36030,0,0,0,0,0,,0,0
3,01/16/2018,65,16:00,16:15,,,0,35,35,0,-71799,111057,182856,39258,0,0,0,0,0,,0,0
3,01/16/2018,66,16:15,16:30,,34.7,0,34.7,34.7,-1,-66408,84982,151390,18574,0,-489,0,0,0,,489,-489
3,01/16/2018,67,16:30,16:45,,32.17,0,32.17,32.17,-1,-58955,83425,142380,24470,0,-4476,0,0,0,,4476,-4476
3,01/16/2018,68,16:45,17:00,32.77,36.73,0,34.75,34.75,2,-70095,41560,111655,-28535,0,-691,12,0,0,,703,-679
3,01/16/2018,69,17:00,17:15,,-11.16,0,-11.16,-11.16,-1,-33076,131092,164168,98016,0,-16679,0,0,0,,16679,-16679
3,01/16/2018,70,17:15,17:30,105.33,32.96,0,105.33,105.33,1,-76558,34182,110740,-42376,0,-5554,7416,0,0,,12970,1862
3,01/16/2018,71,17:30,17:45,105.33,,0,105.33,105.33,1,-68852,37525,106377,-31327,0,0,36408,0,0,,36408,36408
3,01/16/2018,72,17:45,18:00,64.33,,0,64.33,64.33,1,-80851,60019,140870,-20832,0,0,28003,0,0,,28003,28003
3,01/16/2018,73,18:00,18:15,105.33,,0,105.33,105.33,1,-102366,46917,149283,-55449,0,0,32189,0,0,,32189,32189
3,01/16/2018,74,18:15,18:30,36.63,,0,36.63,36.63,1,-71404,62229,133633,-9175,0,0,8564,0,0,,8564,8564
3,01/16/2018,75,18:30,18:45,59.42,,0,59.42,59.42,1,-92751,50122,142873,-42629,0,0,5475,0,0,,5475,5475
3,01/16/2018,76,18:45,19:00,105.33,,0,105.33,105.33,1,-94480,41670,136150,-52810,0,0,44264,0,0,,44264,44264
3,01/16/2018,77,19:00,19:15,114.61,,0,114.61,114.61,1,-129987,24775,154762,-105212,0,0,74017,0,0,,74017,74017
3,01/16/2018,78,19:15,19:30,105.33,,0,105.33,105.33,1,-87156,45027,132183,-42129,0,0,60690,0,0,,60690,60690
3,01/16/2018,79,19:30,19:45,53.11,,0,53.11,53.11,1,-88524,57912,146436,-30612,0,0,14282,0,0,,14282,14282
3,01/16/2018,80,19:45,20:00,67.33,,0,67.33,67.33,1,-100215,73989,174204,-26226,0,0,29644,0,0,,29644,29644
3,01/16/2018,81,20:00,20:15,57.8,26.86,0,57.8,26.86,2,-124107,99597,223704,-24510,0,-1123,5461,0,0,,6584,4338
3,01/16/2018,82,20:15,20:30,66.01,34.46,0,66.01,34.46,2,-81290,87474,168764,6184,0,-67,6691,0,0,,6758,6624
3,01/16/2018,83,20:30,20:45,,-26.71,0,-26.71,-26.71,-1,-50276,120191,170467,69915,0,-5643,0,0,0,,5643,-5643
3,01/16/2018,84,20:45,21:00,36.31,-55.37,0,36.31,-55.37,2,-59550,60653,120203,1103,0,-22413,85,0,0,,22498,-22328
3,01/16/2018,85,21:00,21:15,76.63,-55.37,0,76.63,76.63,1,-87276,65179,152455,-22097,0,-69,3417,0,0,,3486,3348
3,01/16/2018,86,21:15,21:30,89.33,17.56,0,89.33,17.56,2,-68717,78197,146914,9480,0,-721,16123,0,0,,16844,15402
3,01/16/2018,87,21:30,21:45,55.6,17.51,0,55.6,17.51,2,-80209,52084,132293,-28125,0,-2405,6566,0,0,,8971,4161
3,01/16/2018,88,21:45,22:00,77.33,,0,77.33,77.33,1,-82935,74288,157223,-8647,0,0,25284,0,0,,25284,25284
3,01/16/2018,89,22:00,22:15,105.33,,0,105.33,105.33,1,-102411,47997,150408,-54414,0,0,15020,0,0,,15020,15020
3,01/16/2018,90,22:15,22:30,105.33,,0,105.33,105.33,1,-73317,52215,125532,-21102,0,0,45515,0,0,,45515,45515
3,01/16/2018,91,22:30,22:45,105.33,35.73,0,35.73,35.73,-1,-55300,81063,136363,25763,0,-289,2289,0,0,,2578,2000
3,01/16/2018,92,22:45,23:00,,31.58,0,31.58,31.58,-1,-68898,86908,155806,18010,0,-966,0,0,0,,966,-966
3,01/16/2018,93,23:00,23:15,105.33,28.86,0,105.33,105.33,1,-102651,53786,156437,-48865,0,-1110,17113,0,0,,18223,16003
3,01/16/2018,94,23:15,23:30,105.33,,0,105.33,105.33,1,-90978,64602,155580,-26376,0,0,49291,0,0,,49291,49291
3,01/16/2018,95,23:30,23:45,35.37,10.03,0,10.03,10.03,-1,-67279,100112,167391,32833,0,-3934,5001,0,0,,8935,1067
3,01/16/2018,96,23:45,0:00,,-9.64,0,-9.64,-9.64,-1,-79660,91682,171342,12022,0,-26828,0,0,0,,26828,-26828
3,01/17/2018,1,0:00,0:15,,34.65,0,34.65,34.65,-1,-76620,209451,286071,132831,0,-7607,0,0,0,,7607,-7607
3,01/17/2018,2,0:15,0:30,,-19.71,0,-19.71,-19.71,-1,-57104,128548,185652,71444,0,-2734,0,0,0,,2734,-2734
3,01/17/2018,3,0:30,0:45,,-63.19,0,-63.19,-63.19,-1,-53418,71506,124924,18088,0,-13781,0,0,0,,13781,-13781
3,01/17/2018,4,0:45,1:00,,-7.54,0,-7.54,-7.54,-1,-43075,57893,100968,14818,0,-22701,0,0,0,,22701,-22701
3,01/17/2018,5,1:00,1:15,45.58,33,0,45.58,45.58,1,-78747,81750,160497,3003,0,-9034,1953,0,0,,10987,-7081
3,01/17/2018,6,1:15,1:30,37.13,33,0,37.13,37.13,1,-46606,45507,92113,-1099,0,-5,4048,0,0,,4053,4043
3,01/17/2018,7,1:30,1:45,43.37,,0,43.37,43.37,1,-52830,35102,87932,-17728,0,0,6965,0,0,,6965,6965
3,01/17/2018,8,1:45,2:00,38.3,,0,38.3,38.3,1,-41506,46733,88239,5227,0,0,2431,0,0,,2431,2431
3,01/17/2018,9,2:00,2:15,53.77,,0,53.77,53.77,1,-101105,73543,174648,-27562,0,0,7699,0,0,,7699,7699
3,01/17/2018,10,2:15,2:30,114.02,,0,114.02,114.02,1,-125300,65014,190314,-60286,0,0,35411,0,0,,35411,35411
3,01/17/2018,11,2:30,2:45,60.17,,0,60.17,60.17,1,-123359,75901,199260,-47458,0,0,32205,0,0,,32205,32205
3,01/17/2018,12,2:45,3:00,70.01,,0,70.01,70.01,1,-132372,76741,209113,-55631,0,0,39011,0,0,,39011,39011
3,01/17/2018,13,3:00,3:15,50.95,,0,50.95,50.95,1,-148147,111616,259763,-36531,0,0,38257,0,0,,38257,38257
3,01/17/2018,14,3:15,3:30,41.42,31.45,0,31.45,31.45,-1,-70271,122289,192560,52018,0,-524,15886,0,0,,16410,15362
3,01/17/2018,15,3:30,3:45,41.42,-70.13,0,-70.13,-70.13,-1,-10723,153705,164428,142982,0,-11819,3,0,0,,11822,-11816
3,01/17/2018,16,3:45,4:00,,12.88,0,12.88,12.88,-1,-11630,86280,97910,74650,0,-27087,0,0,0,,27087,-27087
3,01/17/2018,17,4:00,4:15,,33.4,0,33.4,33.4,-1,-32333,110094,142427,77761,0,-10339,0,0,0,,10339,-10339
3,01/17/2018,18,4:15,4:30,,,0,34.34,34.34,0,-27633,84528,112161,56895,0,0,0,0,0,,0,0
3,01/17/2018,19,4:30,4:45,,,0,34.34,34.34,0,-34688,73916,108604,39228,0,0,0,0,0,,0,0
3,01/17/2018,20,4:45,5:00,,,0,34.34,34.34,0,-46265,75449,121714,29184,0,0,0,0,0,,0,0
3,01/17/2018,21,5:00,5:15,,,0,34.34,34.34,0,-57053,85326,142379,28273,0,0,0,0,0,,0,0
3,01/17/2018,22,5:15,5:30,,,0,34.34,34.34,0,-13434,82865,96299,69431,0,0,0,0,0,,0,0
3,01/17/2018,23,5:30,5:45,,,0,34.34,34.34,0,-27311,60470,87781,33159,0,0,0,0,0,,0,0
3,01/17/2018,24,5:45,6:00,41.65,,0,41.65,41.65,1,-83010,70313,153323,-12697,0,0,3043,0,0,,3043,3043
3,01/17/2018,25,6:00,6:15,41.65,-112.03,0,-112.03,-112.03,-1,-90305,162667,252972,72362,0,-15803,315,0,0,,16118,-15488
3,01/17/2018,26,6:15,6:30,39.73,-39.03,0,39.73,-39.03,2,-83002,111022,194024,28020,0,-39710,100,0,0,,39810,-39610
3,01/17/2018,27,6:30,6:45,45.58,-39.03,0,45.58,45.58,1,-102807,129562,232369,26755,0,-1176,848,0,0,,2024,-328
3,01/17/2018,28,6:45,7:00,59.81,,0,59.81,59.81,1,-123457,121501,244958,-1956,0,0,3031,0,0,,3031,3031
3,01/17/2018,29,7:00,7:15,75.67,-108.77,0,75.67,-108.77,2,-109045,142713,251758,33668,0,-9323,5665,0,0,,14988,-3658
3,01/17/2018,30,7:15,7:30,116.43,-108.77,0,116.43,116.43,1,-106919,86971,193890,-19948,0,-1317,13807,0,0,,15124,12490
3,01/17/2018,31,7:30,7:45,36.12,,0,36.12,36.12,1,-98265,117587,215852,19322,0,0,2438,0,0,,2438,2438
3,01/17/2018,32,7:45,8:00,,,0,34.37,34.37,0,-83711,103971,187682,20260,0,0,0,0,0,,0,0
3,01/17/2018,33,8:00,8:15,,33.88,0,33.88,33.88,-1,-22468,99125,121593,76657,0,-927,0,0,0,,927,-927
3,01/17/2018,34,8:15,8:30,,,0,35.39,35.39,0,-52235,74868,127103,22633,0,-42,0,0,0,,42,-42
3,01/17/2018,35,8:30,8:45,,,0,35.39,35.39,0,-49856,95005,144861,45149,0,0,0,0,0,,0,0
3,01/17/2018,36,8:45,9:00,,,0,35.39,35.39,0,-67787,74523,142310,6736,0,0,0,0,0,,0,0
3,01/17/2018,37,9:00,9:15,,33.88,0,33.88,33.88,-1,-40784,75225,116009,34441,0,-854,0,0,0,,854,-854
3,01/17/2018,38,9:15,9:30,40.63,34.76,0,40.63,40.63,1,-67401,66509,133910,-892,0,-456,1198,0,0,,1654,742
3,01/17/2018,39,9:30,9:45,37.12,,0,37.12,37.12,1,-85960,85271,171231,-689,0,0,3221,0,0,,3221,3221
3,01/17/2018,40,9:45,10:00,,,0,34.12,34.12,0,-77648,91060,168708,13412,0,0,344,0,0,,344,344
3,01/17/2018,41,10:00,10:15,,,0,35.31,35.31,0,-85287,103601,188888,18314,0,0,0,0,0,,0,0
3,01/17/2018,42,10:15,10:30,44.48,,0,44.48,44.48,1,-93611,85427,179038,-8184,0,0,1319,0,0,,1319,1319
3,01/17/2018,43,10:30,10:45,46.69,,0,46.69,46.69,1,-82288,72120,154408,-10168,0,0,3964,0,0,,3964,3964
3,01/17/2018,44,10:45,11:00,39.84,,0,39.84,39.84,1,-86087,81150,167237,-4937,0,0,4695,0,0,,4695,4695
3,01/17/2018,45,11:00,11:15,42.48,,0,42.48,42.48,1,-88996,80251,169247,-8745,0,0,5557,0,0,,5557,5557
3,01/17/2018,46,11:15,11:30,39.84,,0,39.84,39.84,1,-98196,83257,181453,-14939,0,0,7807,0,0,,7807,7807
3,01/17/2018,47,11:30,11:45,43,,0,43,43,1,-92853,70526,163379,-22327,0,0,9100,0,0,,9100,9100
3,01/17/2018,48,11:45,12:00,51.74,,0,51.74,51.74,1,-127634,83017,210651,-44617,0,0,18457,0,0,,18457,18457
3,01/17/2018,49,12:00,12:15,238.02,,0,238.02,238.02,1,-121222,53485,174707,-67737,0,0,48380,0,0,,48380,48380
3,01/17/2018,50,12:15,12:30,36.67,33.17,0,36.67,33.17,2,-69289,63130,132419,-6159,0,-447,9729,0,0,,10176,9282
3,01/17/2018,51,12:30,12:45,36,33.23,0,36,36,1,-83783,76214,159997,-7569,0,-582,96,0,0,,678,-486
3,01/17/2018,52,12:45,13:00,52.65,,0,52.65,52.65,1,-93823,67994,161817,-25829,0,0,12869,0,0,,12869,12869
3,01/17/2018,53,13:00,13:15,35.74,,0,35.74,35.74,1,-70859,86839,157698,15980,0,0,3665,0,0,,3665,3665
3,01/17/2018,54,13:15,13:30,,34.59,0,34.59,34.59,-1,-92041,90373,182414,-1668,0,-558,0,0,0,,558,-558
3,01/17/2018,55,13:30,13:45,37.52,,0,37.52,37.52,1,-118281,94345,212626,-23936,0,0,400,0,0,,400,400
3,01/17/2018,56,13:45,14:00,,32.03,0,32.03,32.03,-1,-90111,108796,198907,18685,0,-3743,0,0,0,,3743,-3743
3,01/17/2018,57,14:00,14:15,,31.03,0,31.03,31.03,-1,-73721,88823,162544,15102,0,-4798,0,0,0,,4798,-4798
3,01/17/2018,58,14:15,14:30,,34.4,0,34.4,34.4,-1,-80739,78526,159265,-2213,0,-448,0,0,0,,448,-448
3,01/17/2018,59,14:30,14:45,,7.7,0,7.7,7.7,-1,-53609,88137,141746,34528,0,-7961,0,0,0,,7961,-7961
3,01/17/2018,60,14:45,15:00,35.93,-11.95,0,35.93,-11.95,2,-68151,65944,134095,-2207,0,-22861,52,0,0,,22913,-22809
3,01/17/2018,61,15:00,15:15,35.68,-11.95,0,35.68,35.68,1,-46438,93538,139976,47100,0,-546,141,0,0,,687,-405
3,01/17/2018,62,15:15,15:30,,33.12,0,33.12,33.12,-1,-56414,93398,149812,36984,0,-454,0,0,0,,454,-454
3,01/17/2018,63,15:30,15:45,39.84,34.48,0,39.84,34.48,2,-73077,67203,140280,-5874,0,-1632,352,0,0,,1984,-1280
3,01/17/2018,64,15:45,16:00,42.28,31.97,0,42.28,31.97,2,-58253,79263,137516,21010,0,-1020,2862,0,0,,3882,1842
3,01/17/2018,65,16:00,16:15,,25.65,0,25.65,25.65,-1,-65977,113295,179272,47318,0,-12759,0,0,0,,12759,-12759
3,01/17/2018,66,16:15,16:30,,32.03,0,32.03,32.03,-1,-64553,92789,157342,28236,0,-20707,0,0,0,,20707,-20707
3,01/17/2018,67,16:30,16:45,36.25,32.03,0,36.25,36.25,1,-97201,81436,178637,-15765,0,-4569,142,0,0,,4711,-4427
3,01/17/2018,68,16:45,17:00,42.82,,0,42.82,42.82,1,-123304,66708,190012,-56596,0,0,2043,0,0,,2043,2043
3,01/17/2018,69,17:00,17:15,33.02,12.03,0,33.99,12.03,2,-77562,114930,192492,37368,0,-9451,258,0,0,,9709,-9193
3,01/17/2018,70,17:15,17:30,238.02,32.03,0,238.02,238.02,1,-103296,63511,166807,-39785,0,-5729,7275,0,0,,13004,1546
3,01/17/2018,71,17:30,17:45,254.02,,0,254.02,254.02,1,-92701,60085,152786,-32616,0,0,43831,0,0,,43831,43831
3,01/17/2018,72,17:45,18:00,43.02,,0,43.02,43.02,1,-63672,58844,122516,-4828,0,0,11261,0,0,,11261,11261
3,01/17/2018,73,18:00,18:15,85.02,30.87,0,85.02,30.87,2,-70270,59057,129327,-11213,0,-673,10228,0,0,,10901,9555
3,01/17/2018,74,18:15,18:30,53.03,-23.66,0,53.03,-23.66,2,-46222,54632,100854,8410,0,-15804,769,0,0,,16573,-15035
3,01/17/2018,75,18:30,18:45,50.37,17.97,0,17.97,17.97,-1,-50109,80159,130268,30050,0,-6482,890,0,0,,7372,-5592
3,01/17/2018,76,18:45,19:00,38.5,-8.13,0,38.5,-8.13,2,-49718,53154,102872,3436,0,-20000,128,0,0,,20128,-19872
3,01/17/2018,77,19:00,19:15,37.85,35.6,0,37.85,35.55,2,-83470,87932,171402,4462,0,-132,889,0,0,,1021,757
3,01/17/2018,78,19:15,19:30,39.95,35.64,0,39.95,35.57,2,-77304,65506,142810,-11798,0,-178,2214,0,0,,2392,2036
3,01/17/2018,79,19:30,19:45,39.95,32.97,0,32.97,32.97,-1,-61258,76527,137785,15269,0,-1585,537,0,0,,2122,-1048
3,01/17/2018,80,19:45,20:00,,31.97,0,31.97,31.97,-1,-86854,100976,187830,14122,0,-6166,0,0,0,,6166,-6166
3,01/17/2018,81,20:00,20:15,222.02,13,0,222.02,13,2,-75490,54948,130438,-20542,0,-10810,3507,0,0,,14317,-7303
3,01/17/2018,82,20:15,20:30,222.02,4.51,0,222.02,4.51,2,-53777,77059,130836,23282,0,-4266,12369,0,0,,16635,8103
3,01/17/2018,83,20:30,20:45,,-2.71,0,-2.71,-2.71,-1,-53367,67487,120854,14120,0,-24242,0,0,0,,24242,-24242
3,01/17/2018,84,20:45,21:00,,21.55,0,21.55,21.55,-1,-34430,77084,111514,42654,0,-19818,0,0,0,,19818,-19818
3,01/17/2018,85,21:00,21:15,273.02,27.97,0,273.02,273.02,1,-78265,28893,107158,-49372,0,-15963,3385,0,0,,19348,-12578
3,01/17/2018,86,21:15,21:30,314.02,,0,314.02,314.02,1,-53900,40715,94615,-13185,0,0,17786,0,0,,17786,17786
3,01/17/2018,87,21:30,21:45,314.02,24.8,0,24.8,24.8,-1,-21003,81874,102877,60871,0,-5305,389,0,0,,5694,-4916
3,01/17/2018,88,21:45,22:00,,9.41,0,9.41,9.41,-1,-30383,94988,125371,64605,0,-41546,0,0,0,,41546,-41546
3,01/17/2018,89,22:00,22:15,314.02,20.71,0,314.02,314.02,1,-61354,44144,105498,-17210,0,-23985,5899,0,0,,29884,-18086
3,01/17/2018,90,22:15,22:30,337.02,-46.77,0,337.02,-46.77,2,-35595,72492,108087,36897,0,-5708,13003,0,0,,18711,7295
3,01/17/2018,91,22:30,22:45,,-152.27,0,-152.27,-152.27,-1,-31919,64462,96381,32543,0,-33654,0,0,0,,33654,-33654
3,01/17/2018,92,22:45,23:00,,-33.11,0,-33.11,-33.11,-1,-23018,78740,101758,55722,0,-43422,0,0,0,,43422,-43422
3,01/17/2018,93,23:00,23:15,97.94,-127.03,0,97.94,97.94,1,-73996,46697,120693,-27299,0,-32567,2822,0,0,,35389,-29745
3,01/17/2018,94,23:15,23:30,104.2,31.25,0,31.25,31.25,-1,-44004,48727,92731,4723,0,-306,5328,0,0,,5634,5022
3,01/17/2018,95,23:30,23:45,,30.55,0,30.55,30.55,-1,-30218,61549,91767,31331,0,-1391,0,0,0,,1391,-1391
3,01/17/2018,96,23:45,0:00,,-23.81,0,-23.81,-23.81,-1,-34964,93865,128829,58901,0,-10710,0,0,0,,10710,-10710
3,01/18/2018,1,0:00,0:15,78.47,-400,0,78.47,-400,2,-53589,82696,136285,29107,0,-18196,216,0,0,,18412,-17980
3,01/18/2018,2,0:15,0:30,115.12,25.78,0,115.12,25.78,2,-41101,80016,121117,38915,0,-224,1428,0,0,,1652,1204
3,01/18/2018,3,0:30,0:45,,-400,0,-400,-400,-1,-26423,71020,97443,44597,0,-13760,0,0,0,,13760,-13760
3,01/18/2018,4,0:45,1:00,,9.06,0,9.06,9.06,-1,-35855,57766,93621,21911,0,-20905,0,0,0,,20905,-20905
3,01/18/2018,5,1:00,1:15,36.35,22.78,0,54.44,22.78,2,-57912,85044,142956,27132,0,-14861,195,0,0,,15056,-14666
3,01/18/2018,6,1:15,1:30,38.14,22.78,0,38.14,38.14,1,-36389,77887,114276,41498,0,-300,279,0,0,,579,-21
3,01/18/2018,7,1:30,1:45,,34.46,0,34.46,34.46,-1,-32687,95877,128564,63190,0,-510,0,0,0,,510,-510
3,01/18/2018,8,1:45,2:00,,-150.78,0,-150.78,-150.78,-1,-36298,119745,156043,83447,0,-38430,0,0,0,,38430,-38430
3,01/18/2018,9,2:00,2:15,,22.79,0,22.79,22.79,-1,-26216,82653,108869,56437,0,-21250,0,0,0,,21250,-21250
3,01/18/2018,10,2:15,2:30,,24.11,0,24.11,24.11,-1,-22030,94914,116944,72884,0,-1749,0,0,0,,1749,-1749
3,01/18/2018,11,2:30,2:45,,15.77,0,15.77,15.77,-1,-27868,107321,135189,79453,0,-20433,0,0,0,,20433,-20433
3,01/18/2018,12,2:45,3:00,36.13,-24.03,0,54.93,-24.03,2,-45627,69398,115025,23771,0,-30297,209,0,0,,30506,-30088
3,01/18/2018,13,3:00,3:15,38.01,-24.03,0,38.01,38.01,1,-31484,109826,141310,78342,0,-804,413,0,0,,1217,-391
3,01/18/2018,14,3:15,3:30,,,0,54.14,54.14,0,-26251,109330,135581,83079,0,0,0,0,0,,0,0
3,01/18/2018,15,3:30,3:45,,-150.78,0,-150.78,-150.78,-1,-26623,144121,170744,117498,0,-15856,0,0,0,,15856,-15856
3,01/18/2018,16,3:45,4:00,,-150.78,0,-150.78,-150.78,-1,-38068,116076,154144,78008,0,-61467,0,0,0,,61467,-61467
3,01/18/2018,17,4:00,4:15,,-57.18,0,-57.18,-57.18,-1,-18929,142979,161908,124050,0,-61795,0,0,0,,61795,-61795
3,01/18/2018,18,4:15,4:30,,-133.83,0,-133.83,-133.83,-1,-23938,140343,164281,116405,0,-67302,0,0,0,,67302,-67302
3,01/18/2018,19,4:30,4:45,,-44.87,0,-44.87,-44.87,-1,-29944,127909,157853,97965,0,-65188,0,0,0,,65188,-65188
3,01/18/2018,20,4:45,5:00,,-102.63,0,-102.63,-102.63,-1,-29394,162492,191886,133098,0,-76067,0,0,0,,76067,-76067
3,01/18/2018,21,5:00,5:15,,-15.78,0,-15.78,-15.78,-1,-43727,130771,174498,87044,0,-44288,0,0,0,,44288,-44288
3,01/18/2018,22,5:15,5:30,,-150.78,0,-150.78,-150.78,-1,-45239,152009,197248,106770,0,-34658,0,0,0,,34658,-34658
3,01/18/2018,23,5:30,5:45,,27.18,0,27.18,27.18,-1,-56224,125615,181839,69391,0,-7502,0,0,0,,7502,-7502
3,01/18/2018,24,5:45,6:00,,3.32,0,3.32,3.32,-1,-51831,154127,205958,102296,0,-2209,0,0,0,,2209,-2209
3,01/18/2018,25,6:00,6:15,,-34.13,0,-34.13,-34.13,-1,-60585,103791,164376,43206,0,-24933,0,0,0,,24933,-24933
3,01/18/2018,26,6:15,6:30,,15.6,0,15.6,15.6,-1,-46869,120022,166891,73153,0,-27068,0,0,0,,27068,-27068
3,01/18/2018,27,6:30,6:45,,,0,55.32,55.32,0,-43670,123733,167403,80063,0,-3809,0,0,0,,3809,-3809
3,01/18/2018,28,6:45,7:00,,,0,54.68,54.68,0,-68067,133501,201568,65434,0,0,0,0,0,,0,0
3,01/18/2018,29,7:00,7:15,,31.83,0,31.83,31.83,-1,-99788,222939,322727,123151,0,-111,0,0,0,,111,-111
3,01/18/2018,30,7:15,7:30,,9.78,0,9.78,9.78,-1,-73407,224933,298340,151526,0,-17784,0,0,0,,17784,-17784
3,01/18/2018,31,7:30,7:45,,,0,55.77,55.77,0,-73788,143816,217604,70028,0,-1669,0,0,0,,1669,-1669
3,01/18/2018,32,7:45,8:00,34.66,,0,34.66,34.66,1,-96537,130254,226791,33717,0,0,25,0,0,,25,25
3,01/18/2018,33,8:00,8:15,38.69,18.29,0,56,18.29,2,-69853,114762,184615,44909,0,-2761,569,0,0,,3330,-2192
3,01/18/2018,34,8:15,8:30,238.12,-10.81,0,238.12,-10.81,2,-90511,39148,129659,-51363,0,-7555,9773,0,0,,17328,2218
3,01/18/2018,35,8:30,8:45,238.12,,0,238.12,238.12,1,-91062,37946,129008,-53116,0,0,36160,0,0,,36160,36160
3,01/18/2018,36,8:45,9:00,238.12,,0,238.12,238.12,1,-147554,29002,176556,-118552,0,0,68090,0,0,,68090,68090
3,01/18/2018,37,9:00,9:15,206.12,,0,206.12,206.12,1,-89175,65322,154497,-23853,0,0,60417,0,0,,60417,60417
3,01/18/2018,38,9:15,9:30,238.12,,0,238.12,238.12,1,-130872,54138,185010,-76734,0,0,20114,0,0,,20114,20114
3,01/18/2018,39,9:30,9:45,238.12,,0,238.12,238.12,1,-134994,63362,198356,-71632,0,0,72268,0,0,,72268,72268
3,01/18/2018,40,9:45,10:00,43.04,,0,43.04,43.04,1,-133781,86479,220260,-47302,0,0,32999,0,0,,32999,32999
3,01/18/2018,41,10:00,10:15,41.04,,0,41.04,41.04,1,-145635,131466,277101,-14169,0,0,20836,0,0,,20836,20836
3,01/18/2018,42,10:15,10:30,41.04,34.68,0,34.68,34.68,-1,-114719,154604,269323,39885,0,-353,1544,0,0,,1897,1191
3,01/18/2018,43,10:30,10:45,,,0,34.97,34.97,0,-122367,160363,282730,37996,0,0,0,0,0,,0,0
3,01/18/2018,44,10:45,11:00,,,0,35.2,35.2,0,-132263,189309,321572,57046,0,0,0,0,0,,0,0
3,01/18/2018,45,11:00,11:15,38.69,,0,38.69,38.69,1,-129644,120672,250316,-8972,0,0,1169,0,0,,1169,1169
3,01/18/2018,46,11:15,11:30,35.05,,0,35.05,35.05,1,-106682,113880,220562,7198,0,0,435,0,0,,435,435
3,01/18/2018,47,11:30,11:45,34.69,,0,34.69,34.69,1,-80065,145599,225664,65534,0,0,267,0,0,,267,267
3,01/18/2018,48,11:45,12:00,,-150.78,0,-150.78,-150.78,-1,-46430,219447,265877,173017,0,-24165,0,0,0,,24165,-24165
3,01/18/2018,49,12:00,12:15,,-129.98,0,-129.98,-129.98,-1,-66044,141257,207301,75213,0,-56705,0,0,0,,56705,-56705
3,01/18/2018,50,12:15,12:30,,-136.83,0,-136.83,-136.83,-1,-68968,155479,224447,86511,0,-68825,0,0,0,,68825,-68825
3,01/18/2018,51,12:30,12:45,,-83.83,0,-83.83,-83.83,-1,-63676,150356,214032,86680,0,-80188,0,0,0,,80188,-80188
3,01/18/2018,52,12:45,13:00,,-150.78,0,-150.78,-150.78,-1,-77423,153461,230884,76038,0,-72331,0,0,0,,72331,-72331
3,01/18/2018,53,13:00,13:15,,-77.84,0,-77.84,-77.84,-1,-73381,134716,208097,61335,0,-56854,0,0,0,,56854,-56854
3,01/18/2018,54,13:15,13:30,,-96.76,0,-96.76,-96.76,-1,-68702,138291,206993,69589,0,-48723,0,0,0,,48723,-48723
3,01/18/2018,55,13:30,13:45,,-23.53,0,-23.53,-23.53,-1,-79029,135254,214283,56225,0,-45370,0,0,0,,45370,-45370
3,01/18/2018,56,13:45,14:00,,-21.77,0,-21.77,-21.77,-1,-84196,141856,226052,57660,0,-42574,0,0,0,,42574,-42574
3,01/18/2018,57,14:00,14:15,103.12,-21.77,0,103.12,103.12,1,-107442,76358,183800,-31084,0,-10503,7587,0,0,,18090,-2916
3,01/18/2018,58,14:15,14:30,36.25,31.94,0,36.25,31.94,2,-93118,96962,190080,3844,0,-994,1439,0,0,,2433,445
3,01/18/2018,59,14:30,14:45,48.62,,0,48.62,48.62,1,-118647,98492,217139,-20155,0,0,9907,0,0,,9907,9907
3,01/18/2018,60,14:45,15:00,34.29,-31.48,0,34.81,-31.48,2,-89099,109690,198789,20591,0,-12544,3260,0,0,,15804,-9284
3,01/18/2018,61,15:00,15:15,39.79,31.78,0,39.79,31.78,2,-62421,108403,170824,45982,0,-3694,612,0,0,,4306,-3082
3,01/18/2018,62,15:15,15:30,,31.94,0,31.94,31.94,-1,-71805,127792,199597,55987,0,-3110,0,0,0,,3110,-3110
3,01/18/2018,63,15:30,15:45,,35.38,0,35.38,35.38,-1,-62099,98121,160220,36022,0,-1032,0,0,0,,1032,-1032
3,01/18/2018,64,15:45,16:00,,35.19,0,35.19,35.19,-1,-83156,119117,202273,35961,0,-124,0,0,0,,124,-124
3,01/18/2018,65,16:00,16:15,,-11.15,0,-11.15,-11.15,-1,-41673,120102,161775,78429,0,-14303,0,0,0,,14303,-14303
3,01/18/2018,66,16:15,16:30,34.42,-11.15,0,34.42,34.42,1,-70040,97626,167666,27586,0,-1608,3,0,0,,1611,-1605
3,01/18/2018,67,16:30,16:45,36.42,,0,36.42,36.42,1,-74301,82919,157220,8618,0,0,1363,0,0,,1363,1363
3,01/18/2018,68,16:45,17:00,38.69,,0,38.69,38.69,1,-85137,90126,175263,4989,0,0,2102,0,0,,2102,2102
3,01/18/2018,69,17:00,17:15,,-138.78,0,-138.78,-138.78,-1,-33045,189445,222490,156400,0,-23976,0,0,0,,23976,-23976
3,01/18/2018,70,17:15,17:30,,31.78,0,31.78,31.78,-1,-49265,99540,148805,50275,0,-3774,0,0,0,,3774,-3774
3,01/18/2018,71,17:30,17:45,94.43,,0,94.43,94.43,1,-99732,73836,173568,-25896,0,0,4908,0,0,,4908,4908
3,01/18/2018,72,17:45,18:00,254.12,,0,254.12,254.12,1,-87923,85190,173113,-2733,0,0,35673,0,0,,35673,35673
3,01/18/2018,73,18:00,18:15,35.75,34.91,0,34.91,34.91,-1,-63438,78403,141841,14965,0,-21,3385,0,0,,3406,3364
3,01/18/2018,74,18:15,18:30,254.12,33.98,0,254.12,33.98,2,-102295,55252,157547,-47043,0,-176,10643,0,0,,10819,10467
3,01/18/2018,75,18:30,18:45,254.12,,0,254.12,254.12,1,-87987,38797,126784,-49190,0,0,51358,0,0,,51358,51358
3,01/18/2018,76,18:45,19:00,38.69,35.44,0,38.69,35.07,2,-72992,56206,129198,-16786,0,-64,4610,0,0,,4674,4546
3,01/18/2018,77,19:00,19:15,254.12,,0,254.12,254.12,1,-106386,42480,148866,-63906,0,0,31081,0,0,,31081,31081
3,01/18/2018,78,19:15,19:30,52.36,30.94,0,30.94,30.94,-1,-44554,59783,104337,15229,0,-614,13694,0,0,,14308,13080
3,01/18/2018,79,19:30,19:45,,31.78,0,31.78,31.78,-1,-53744,70081,123825,16337,0,-5029,0,0,0,,5029,-5029
3,01/18/2018,80,19:45,20:00,,31.78,0,31.78,31.78,-1,-43349,47731,91080,4382,0,-10085,0,0,0,,10085,-10085
3,01/18/2018,81,20:00,20:15,237.12,30.94,0,237.12,237.12,1,-131427,61577,193004,-69850,0,-2497,15521,0,0,,18018,13024
3,01/18/2018,82,20:15,20:30,74.33,,0,74.33,74.33,1,-118482,77421,195903,-41061,0,0,33663,0,0,,33663,33663
3,01/18/2018,83,20:30,20:45,39.12,30.94,0,56.51,30.94,2,-77823,80627,158450,2804,0,-228,10737,0,0,,10965,10509
3,01/18/2018,84,20:45,21:00,41.62,22.76,0,56.52,22.76,2,-61981,56307,118288,-5674,0,-5697,935,0,0,,6632,-4762
3,01/18/2018,85,21:00,21:15,46.21,,0,46.21,46.21,1,-106089,95430,201519,-10659,0,0,3867,0,0,,3867,3867
3,01/18/2018,86,21:15,21:30,41,,0,41,41,1,-72668,76847,149515,4179,0,0,5426,0,0,,5426,5426
3,01/18/2018,87,21:30,21:45,41,78.37,0,78.37,78.37,-1,-60337,111140,171477,50803,0,-160,444,0,0,,604,284
3,01/18/2018,88,21:45,22:00,,-150.78,0,-150.78,-150.78,-1,-55395,134881,190276,79486,0,-15378,0,0,0,,15378,-15378
3,01/18/2018,89,22:00,22:15,239.12,-148.78,0,239.12,-148.78,2,-131202,55594,186796,-75608,0,-36082,3805,0,0,,39887,-32277
3,01/18/2018,90,22:15,22:30,276.12,-148.78,0,276.12,276.12,1,-143834,77632,221466,-66202,0,-50,49328,0,0,,49378,49278
3,01/18/2018,91,22:30,22:45,276.12,27.36,0,27.36,27.36,-1,-42073,120861,162934,78788,0,-1705,4633,0,0,,6338,2928
3,01/18/2018,92,22:45,23:00,,33.53,0,33.53,33.53,-1,-22020,122819,144839,100799,0,-23,0,0,0,,23,-23
3,01/18/2018,93,23:00,23:15,41,27.9,0,54.85,27.9,2,-94515,107299,201814,12784,0,-4930,794,0,0,,5724,-4136
3,01/18/2018,94,23:15,23:30,41,,0,41,41,1,-88835,77520,166355,-11315,0,0,1132,0,0,,1132,1132
3,01/18/2018,95,23:30,23:45,,76.92,0,76.92,76.92,-1,-71623,71148,142771,-475,0,-137,0,0,0,,137,-137
3,01/18/2018,96,23:45,0:00,,29.78,0,29.78,29.78,-1,-71695,60087,131782,-11608,0,-2531,0,0,0,,2531,-2531
3,01/19/2018,1,0:00,0:15,40.56,22.03,0,40.56,40.56,1,-45465,125820,171285,80355,0,-905,30,0,0,,935,-875
3,01/19/2018,2,0:15,0:30,109.02,,0,109.02,109.02,1,-84834,50447,135281,-34387,0,0,17687,0,0,,17687,17687
3,01/19/2018,3,0:30,0:45,33.02,,0,33.02,33.02,1,-79691,73871,153562,-5820,0,0,2775,0,0,,2775,2775
3,01/19/2018,4,0:45,1:00,33.02,30.03,0,30.03,30.03,-1,-81696,76248,157944,-5448,0,-497,243,0,0,,740,-254
3,01/19/2018,5,1:00,1:15,36.56,13.03,0,36.56,13.03,2,-83612,121001,204613,37389,0,-2020,187,0,0,,2207,-1833
3,01/19/2018,6,1:15,1:30,40.56,,0,40.56,40.56,1,-68572,95239,163811,26667,0,0,798,0,0,,798,798
3,01/19/2018,7,1:30,1:45,,,0,33.29,33.29,0,-47899,101375,149274,53476,0,0,0,0,0,,0,0
3,01/19/2018,8,1:45,2:00,,,0,33.29,33.29,0,-27219,90174,117393,62955,0,0,0,0,0,,0,0
3,01/19/2018,9,2:00,2:15,,,0,33.29,33.29,0,-79643,109212,188855,29569,0,0,0,0,0,,0,0
3,01/19/2018,10,2:15,2:30,,,0,33.29,33.29,0,-57465,93419,150884,35954,0,0,0,0,0,,0,0
3,01/19/2018,11,2:30,2:45,,,0,33.29,33.29,0,-43938,84156,128094,40218,0,0,0,0,0,,0,0
3,01/19/2018,12,2:45,3:00,,,0,33.29,33.29,0,-49544,85474,135018,35930,0,0,0,0,0,,0,0
3,01/19/2018,13,3:00,3:15,60.95,,0,60.95,60.95,1,-94941,65878,160819,-29063,0,0,11322,0,0,,11322,11322
3,01/19/2018,14,3:15,3:30,46.21,,0,46.21,46.21,1,-89241,64652,153893,-24589,0,0,26810,0,0,,26810,26810
3,01/19/2018,15,3:30,3:45,37.02,,0,37.02,37.02,1,-89874,73922,163796,-15952,0,0,8831,0,0,,8831,8831
3,01/19/2018,16,3:45,4:00,,,0,33.29,33.29,0,-86540,73756,160296,-12784,0,0,562,0,0,,562,562
3,01/19/2018,17,4:00,4:15,39.07,,0,39.07,39.07,1,-86907,67685,154592,-19222,0,0,2830,0,0,,2830,2830
3,01/19/2018,18,4:15,4:30,39.77,,0,39.77,39.77,1,-98746,56960,155706,-41786,0,0,4297,0,0,,4297,4297
3,01/19/2018,19,4:30,4:45,46.52,,0,46.52,46.52,1,-93729,61305,155034,-32424,0,0,10688,0,0,,10688,10688
3,01/19/2018,20,4:45,5:00,39.77,,0,39.77,39.77,1,-87231,74704,161935,-12527,0,0,14645,0,0,,14645,14645
3,01/19/2018,21,5:00,5:15,35.02,34.56,0,34.56,34.56,-1,-58774,85746,144520,26972,0,-28,6890,0,0,,6918,6862
3,01/19/2018,22,5:15,5:30,35.02,34.35,0,34.35,34.35,-1,-53542,87441,140983,33899,0,-1058,39,0,0,,1097,-1019
3,01/19/2018,23,5:30,5:45,67.84,34.35,0,67.84,67.84,1,-75653,48266,123919,-27387,0,-126,6903,0,0,,7029,6777
3,01/19/2018,24,5:45,6:00,67.84,,0,67.84,67.84,1,-83243,104990,188233,21747,0,0,20348,0,0,,20348,20348
3,01/19/2018,25,6:00,6:15,67.84,25.78,0,25.78,25.78,-1,-74609,84016,158625,9407,0,-2956,1138,0,0,,4094,-1818
3,01/19/2018,26,6:15,6:30,,1.61,0,1.61,1.61,-1,-29242,105675,134917,76433,0,-19499,0,0,0,,19499,-19499
3,01/19/2018,27,6:30,6:45,,34.77,0,34.77,34.77,-1,-57109,108909,166018,51800,0,-6127,0,0,0,,6127,-6127
3,01/19/2018,28,6:45,7:00,,34.7,0,34.7,34.7,-1,-59035,145314,204349,86279,0,-348,0,0,0,,348,-348
3,01/19/2018,29,7:00,7:15,,-150.03,0,-150.03,-150.03,-1,-37522,158950,196472,121428,0,-44499,0,0,0,,44499,-44499
3,01/19/2018,30,7:15,7:30,,17.99,0,17.99,17.99,-1,-60332,108972,169304,48640,0,-30543,0,0,0,,30543,-30543
3,01/19/2018,31,7:30,7:45,38.16,17.99,0,38.16,38.16,1,-92873,83586,176459,-9287,0,-2029,2184,0,0,,4213,155
3,01/19/2018,32,7:45,8:00,137.02,,0,137.02,137.02,1,-137767,80741,218508,-57026,0,0,22181,0,0,,22181,22181
3,01/19/2018,33,8:00,8:15,41.02,28.93,0,28.93,28.93,-1,-32868,106815,139683,73947,0,-544,9540,0,0,,10084,8996
3,01/19/2018,34,8:15,8:30,,19.04,0,19.04,19.04,-1,-31053,81452,112505,50399,0,-3832,0,0,0,,3832,-3832
3,01/19/2018,35,8:30,8:45,,32.16,0,32.16,32.16,-1,-47454,119867,167321,72413,0,-1104,0,0,0,,1104,-1104
3,01/19/2018,36,8:45,9:00,,32.89,0,32.89,32.89,-1,-68490,90980,159470,22490,0,-1176,0,0,0,,1176,-1176
3,01/19/2018,37,9:00,9:15,,32.24,0,32.24,32.24,-1,-47387,39785,87172,-7602,0,-799,0,0,0,,799,-799
3,01/19/2018,38,9:15,9:30,,29.99,0,29.99,29.99,-1,-60149,38134,98283,-22015,0,-1111,0,0,0,,1111,-1111
3,01/19/2018,39,9:30,9:45,,-136.21,0,-136.21,-136.21,-1,-61658,42542,104200,-19116,0,-11874,0,0,0,,11874,-11874
3,01/19/2018,40,9:45,10:00,,-136.21,0,-136.21,-136.21,-1,-114820,25819,140639,-89001,0,-25871,0,0,0,,25871,-25871
3,01/19/2018,41,10:00,10:15,,,0,34.42,34.42,0,-114580,23111,137691,-91469,0,-652,0,0,0,,652,-652
3,01/19/2018,42,10:15,10:30,,26.73,0,26.73,26.73,-1,-78047,23774,101821,-54273,0,-376,0,0,0,,376,-376
3,01/19/2018,43,10:30,10:45,,-95.68,0,-95.68,-95.68,-1,-93776,47277,141053,-46499,0,-39483,0,0,0,,39483,-39483
3,01/19/2018,44,10:45,11:00,,-17.79,0,-17.79,-17.79,-1,-117262,37459,154721,-79803,0,-43652,0,0,0,,43652,-43652
3,01/19/2018,45,11:00,11:15,193.02,13.57,0,193.02,193.02,1,-162416,45812,208228,-116604,0,-22875,4501,0,0,,27376,-18374
3,01/19/2018,46,11:15,11:30,36.78,,0,36.78,36.78,1,-101145,119737,220882,18592,0,0,2345,0,0,,2345,2345
3,01/19/2018,47,11:30,11:45,,,0,35.02,35.02,0,-87044,105798,192842,18754,0,0,0,0,0,,0,0
3,01/19/2018,48,11:45,12:00,36.73,,0,36.73,36.73,1,-87420,75387,162807,-12033,0,0,2352,0,0,,2352,2352
3,01/19/2018,49,12:00,12:15,47.72,,0,47.72,47.72,1,-111766,41148,152914,-70618,0,0,4780,0,0,,4780,4780
3,01/19/2018,50,12:15,12:30,33.35,32.01,0,32.01,32.01,-1,-89923,89662,179585,-261,0,-92,479,0,0,,571,387
3,01/19/2018,51,12:30,12:45,,31.16,0,31.16,31.16,-1,-83927,138655,222582,54728,0,-700,0,0,0,,700,-700
3,01/19/2018,52,12:45,13:00,,30.34,0,30.34,30.34,-1,-78870,112711,191581,33841,0,-6378,0,0,0,,6378,-6378
3,01/19/2018,53,13:00,13:15,,32.01,0,32.01,32.01,-1,-81558,84009,165567,2451,0,-4258,0,0,0,,4258,-4258
3,01/19/2018,54,13:15,13:30,,23.09,0,23.09,23.09,-1,-55757,82859,138616,27102,0,-3434,0,0,0,,3434,-3434
3,01/19/2018,55,13:30,13:45,,24.03,0,24.03,24.03,-1,-72020,70171,142191,-1849,0,-7078,0,0,0,,7078,-7078
3,01/19/2018,56,13:45,14:00,,17.84,0,17.84,17.84,-1,-67775,85768,153543,17993,0,-2053,0,0,0,,2053,-2053
3,01/19/2018,57,14:00,14:15,,3.75,0,3.75,3.75,-1,-40370,108712,149082,68342,0,-13809,0,0,0,,13809,-13809
3,01/19/2018,58,14:15,14:30,,25.77,0,25.77,25.77,-1,-21786,126430,148216,104644,0,-3546,0,0,0,,3546,-3546
3,01/19/2018,59,14:30,14:45,,16.64,0,16.64,16.64,-1,-19787,117446,137233,97659,0,-13040,0,0,0,,13040,-13040
3,01/19/2018,60,14:45,15:00,,-27.52,0,-27.52,-27.52,-1,-31134,113568,144702,82434,0,-38720,0,0,0,,38720,-38720
3,01/19/2018,61,15:00,15:15,53.22,-27.52,0,53.22,53.22,1,-82818,63716,146534,-19102,0,-14245,3275,0,0,,17520,-10970
3,01/19/2018,62,15:15,15:30,32.87,,0,32.87,32.87,1,-43064,73727,116791,30663,0,0,844,0,0,,844,844
3,01/19/2018,63,15:30,15:45,,,0,34.33,34.33,0,-38844,79346,118190,40502,0,0,0,0,0,,0,0
3,01/19/2018,64,15:45,16:00,36.29,,0,36.29,36.29,1,-68502,56751,125253,-11751,0,0,597,0,0,,597,597
3,01/19/2018,65,16:00,16:15,,,0,34.46,34.46,0,-65335,90011,155346,24676,0,0,6,0,0,,6,6
3,01/19/2018,66,16:15,16:30,,,0,34.48,34.48,0,-48154,76220,124374,28066,0,0,0,0,0,,0,0
3,01/19/2018,67,16:30,16:45,,,0,33.85,33.85,0,-31700,70338,102038,38638,0,0,0,0,0,,0,0
3,01/19/2018,68,16:45,17:00,,,0,34.53,34.53,0,-49495,65878,115373,16383,0,0,0,0,0,,0,0
3,01/19/2018,69,17:00,17:15,,-95.78,0,-95.78,-95.78,-1,-21403,154369,175772,132966,0,-21153,0,0,0,,21153,-21153
3,01/19/2018,70,17:15,17:30,,31.88,0,31.88,31.88,-1,-39937,74608,114545,34671,0,-6635,0,0,0,,6635,-6635
3,01/19/2018,71,17:30,17:45,,,0,34.42,34.42,0,-45457,75626,121083,30169,0,0,0,0,0,,0,0
3,01/19/2018,72,17:45,18:00,35.72,,0,35.72,35.72,1,-41906,85193,127099,43287,0,0,44,0,0,,44,44
3,01/19/2018,73,18:00,18:15,40.47,,0,40.47,40.47,1,-94658,51955,146613,-42703,0,0,1038,0,0,,1038,1038
3,01/19/2018,74,18:15,18:30,,33.91,0,33.91,33.91,-1,-55151,72370,127521,17219,0,-37,0,0,0,,37,-37
3,01/19/2018,75,18:30,18:45,,9.38,0,9.38,9.38,-1,-32544,72307,104851,39763,0,-15923,0,0,0,,15923,-15923
3,01/19/2018,76,18:45,19:00,,9.38,0,9.38,9.38,-1,-45207,64569,109776,19362,0,-22131,0,0,0,,22131,-22131
3,01/19/2018,77,19:00,19:15,38.16,9.38,0,38.16,38.16,1,-108903,45294,154197,-63609,0,-685,1932,0,0,,2617,1247
3,01/19/2018,78,19:15,19:30,38.16,33.64,0,38.16,33.64,2,-79586,42544,122130,-37042,0,-10,599,0,0,,609,589
3,01/19/2018,79,19:30,19:45,,17.45,0,17.45,17.45,-1,-36089,64945,101034,28856,0,-7564,0,0,0,,7564,-7564
3,01/19/2018,80,19:45,20:00,,22.05,0,22.05,22.05,-1,-65274,46382,111656,-18892,0,-11610,0,0,0,,11610,-11610
3,01/19/2018,81,20:00,20:15,257.02,35.59,0,257.02,34.23,2,-101667,59256,160923,-42411,0,-29,8626,0,0,,8655,8597
3,01/19/2018,82,20:15,20:30,40.04,23.25,0,40.04,23.25,2,-53927,67183,121110,13256,0,-749,4221,0,0,,4970,3472
3,01/19/2018,83,20:30,20:45,35.03,23.79,0,35.03,23.79,2,-74331,39751,114082,-34580,0,-2240,206,0,0,,2446,-2034
3,01/19/2018,84,20:45,21:00,,,0,34.35,34.35,0,-75669,42411,118080,-33258,0,0,0,0,0,,0,0
3,01/19/2018,85,21:00,21:15,55.74,,0,55.74,55.74,1,-56739,99917,156656,43178,0,0,689,0,0,,689,689
3,01/19/2018,86,21:15,21:30,320.02,,0,320.02,320.02,1,-58062,77139,135201,19077,0,0,18645,0,0,,18645,18645
3,01/19/2018,87,21:30,21:45,320.02,31.43,0,31.43,31.43,-1,-25101,131252,156353,106151,0,-484,389,0,0,,873,-95
3,01/19/2018,88,21:45,22:00,,31.16,0,31.16,31.16,-1,-39515,93196,132711,53681,0,-704,0,0,0,,704,-704
3,01/19/2018,89,22:00,22:15,,28.4,0,28.4,28.4,-1,-88613,90509,179122,1896,0,-260,0,0,0,,260,-260
3,01/19/2018,90,22:15,22:30,,,0,34.28,34.28,0,-129417,67571,196988,-61846,0,0,0,0,0,,0,0
3,01/19/2018,91,22:30,22:45,57.97,,0,57.97,57.97,1,-122276,66528,188804,-55748,0,0,7258,0,0,,7258,7258
3,01/19/2018,92,22:45,23:00,36.02,35.52,0,36.02,34.33,2,-90910,83673,174583,-7237,0,-15,3026,0,0,,3041,3011
3,01/19/2018,93,23:00,23:15,51.61,34.22,0,51.61,34.14,2,-126951,118588,245539,-8363,0,-77,1167,0,0,,1244,1090
3,01/19/2018,94,23:15,23:30,123.02,,0,123.02,123.02,1,-129868,80335,210203,-49533,0,0,37168,0,0,,37168,37168
3,01/19/2018,95,23:30,23:45,48.02,35.76,0,35.76,35.76,-1,-93668,81838,175506,-11830,0,-3,30571,0,0,,30574,30568
3,01/19/2018,96,23:45,0:00,48.02,33.45,0,33.45,33.45,-1,-73272,77505,150777,4233,0,-769,2173,0,0,,2942,1404
4,01/20/2018,1,0:00,0:15,209.12,,0,209.12,209.12,1,-125374,60101,185475,-65273,0,0,22521,0,0,,22521,22521
4,01/20/2018,2,0:15,0:30,50.21,,0,50.21,50.21,1,-58634,51220,109854,-7414,0,0,19775,0,0,,19775,19775
4,01/20/2018,3,0:30,0:45,50.21,33.22,0,33.22,33.22,-1,-40941,54295,95236,13354,0,-871,4852,0,0,,5723,3981
4,01/20/2018,4,0:45,1:00,,34.82,0,34.82,34.82,-1,-37431,60127,97558,22696,0,-1642,0,0,0,,1642,-1642
4,01/20/2018,5,1:00,1:15,100.73,34.82,0,100.73,100.73,1,-89272,85016,174288,-4256,0,-113,3477,0,0,,3590,3364
4,01/20/2018,6,1:15,1:30,222.12,,0,222.12,222.12,1,-63472,63990,127462,518,0,0,28512,0,0,,28512,28512
4,01/20/2018,7,1:30,1:45,222.12,33.22,0,33.22,33.22,-1,-37385,81598,118983,44213,0,-47,1100,0,0,,1147,1053
4,01/20/2018,8,1:45,2:00,,5.68,0,5.68,5.68,-1,-40384,73375,113759,32991,0,-15218,0,0,0,,15218,-15218
4,01/20/2018,9,2:00,2:15,110.2,29.78,0,110.2,110.2,1,-53915,46743,100658,-7172,0,-5225,8801,0,0,,14026,3576
4,01/20/2018,10,2:15,2:30,44.12,29.78,0,44.12,44.12,1,-46871,57668,104539,10797,0,-8,11533,0,0,,11541,11525
4,01/20/2018,11,2:30,2:45,44.12,33.22,0,33.22,33.22,-1,-42870,78660,121530,35790,0,-343,162,0,0,,505,-181
4,01/20/2018,12,2:45,3:00,,28.78,0,28.78,28.78,-1,-38020,88071,126091,50051,0,-4301,0,0,0,,4301,-4301
4,01/20/2018,13,3:00,3:15,,27.78,0,27.78,27.78,-1,-58697,114863,173560,56166,0,-3554,0,0,0,,3554,-3554
4,01/20/2018,14,3:15,3:30,,,0,33.22,33.22,0,-69633,81076,150709,11443,0,0,0,0,0,,0,0
4,01/20/2018,15,3:30,3:45,,,0,33.23,33.23,0,-53025,77485,130510,24460,0,0,0,0,0,,0,0
4,01/20/2018,16,3:45,4:00,,,0,33.22,33.22,0,-52180,80506,132686,28326,0,0,0,0,0,,0,0
4,01/20/2018,17,4:00,4:15,,,0,33.22,33.22,0,-53879,64719,118598,10840,0,0,0,0,0,,0,0
4,01/20/2018,18,4:15,4:30,,,0,33.22,33.22,0,-51236,62416,113652,11180,0,0,0,0,0,,0,0
4,01/20/2018,19,4:30,4:45,,,0,33.28,33.28,0,-42414,67195,109609,24781,0,0,0,0,0,,0,0
4,01/20/2018,20,4:45,5:00,,34.22,0,34.22,34.22,-1,-37599,67308,104907,29709,0,-7,0,0,0,,7,-7
4,01/20/2018,21,5:00,5:15,,11.78,0,11.78,11.78,-1,-38041,86314,124355,48273,0,-5971,0,0,0,,5971,-5971
4,01/20/2018,22,5:15,5:30,,-6.78,0,-6.78,-6.78,-1,-43383,56277,99660,12894,0,-19702,0,0,0,,19702,-19702
4,01/20/2018,23,5:30,5:45,43.45,-6.78,0,43.45,43.45,1,-58299,38414,96713,-19885,0,-1293,1083,0,0,,2376,-210
4,01/20/2018,24,5:45,6:00,49.42,,0,49.42,49.42,1,-103290,32645,135935,-70645,0,0,11921,0,0,,11921,11921
4,01/20/2018,25,6:00,6:15,42.98,,0,42.98,42.98,1,-99956,47646,147602,-52310,0,0,11452,0,0,,11452,11452
4,01/20/2018,26,6:15,6:30,183.78,,0,183.78,183.78,1,-129419,50733,180152,-78686,0,0,25408,0,0,,25408,25408
4,01/20/2018,27,6:30,6:45,222.12,,0,222.12,222.12,1,-135934,64538,200472,-71396,0,0,72263,0,0,,72263,72263
4,01/20/2018,28,6:45,7:00,67.73,,0,67.73,67.73,1,-116068,91868,207936,-24200,0,0,46095,0,0,,46095,46095
4,01/20/2018,29,7:00,7:15,67.73,-150.78,0,-150.78,-150.78,-1,-25674,154798,180472,129124,0,-27081,5456,0,0,,32537,-21625
4,01/20/2018,30,7:15,7:30,,4.78,0,4.78,4.78,-1,-22448,111411,133859,88963,0,-34078,0,0,0,,34078,-34078
4,01/20/2018,31,7:30,7:45,49.42,4.78,0,49.42,49.42,1,-60278,63317,123595,3039,0,-1751,1445,0,0,,3196,-306
4,01/20/2018,32,7:45,8:00,49.42,,0,49.42,49.42,1,-91114,80567,171681,-10547,0,0,11709,0,0,,11709,11709
4,01/20/2018,33,8:00,8:15,51.16,-2.29,0,51.16,-2.29,2,-78217,121390,199607,43173,0,-8281,10449,0,0,,18730,2168
4,01/20/2018,34,8:15,8:30,35.32,29.78,0,35.32,35.32,1,-93972,96492,190464,2520,0,-9491,178,0,0,,9669,-9313
4,01/20/2018,35,8:30,8:45,37.22,,0,37.22,37.22,1,-88779,82498,171277,-6281,0,0,1936,0,0,,1936,1936
4,01/20/2018,36,8:45,9:00,35.7,,0,35.7,35.7,1,-58900,102220,161120,43320,0,0,1346,0,0,,1346,1346
4,01/20/2018,37,9:00,9:15,38.45,35.54,0,38.45,34.22,2,-125976,104727,230703,-21249,0,-10,1192,0,0,,1202,1182
4,01/20/2018,38,9:15,9:30,,31.45,0,31.45,31.45,-1,-64503,117766,182269,53263,0,-948,0,0,0,,948,-948
4,01/20/2018,39,9:30,9:45,38.45,,0,38.45,38.45,1,-85547,74240,159787,-11307,0,0,169,0,0,,169,169
4,01/20/2018,40,9:45,10:00,100.62,,0,100.62,100.62,1,-97050,55509,152559,-41541,0,0,26831,0,0,,26831,26831
4,01/20/2018,41,10:00,10:15,45.12,28.27,0,28.27,28.27,-1,-42506,76030,118536,33524,0,-982,15536,0,0,,16518,14554
4,01/20/2018,42,10:15,10:30,45.12,35.77,0,35.77,35.77,-1,-60238,83752,143990,23514,0,-343,8,0,0,,351,-335
4,01/20/2018,43,10:30,10:45,,32.16,0,32.16,32.16,-1,-72796,78009,150805,5213,0,-743,0,0,0,,743,-743
4,01/20/2018,44,10:45,11:00,,35.36,0,35.36,35.36,-1,-76029,57372,133401,-18657,0,-86,0,0,0,,86,-86
4,01/20/2018,45,11:00,11:15,,35.54,0,35.54,35.54,-1,-22327,95988,118315,73661,0,-368,0,0,0,,368,-368
4,01/20/2018,46,11:15,11:30,,35.5,0,35.5,35.5,-1,-28247,81422,109669,53175,0,-859,0,0,0,,859,-859
4,01/20/2018,47,11:30,11:45,,,0,34.25,34.25,0,-49771,70009,119780,20238,0,0,0,0,0,,0,0
4,01/20/2018,48,11:45,12:00,32.79,,0,32.79,32.79,1,-63851,64064,127915,213,0,0,9,0,0,,9,9
4,01/20/2018,49,12:00,12:15,56.12,,0,56.12,56.12,1,-76558,47210,123768,-29348,0,0,12071,0,0,,12071,12071
4,01/20/2018,50,12:15,12:30,36.12,,0,36.12,36.12,1,-75593,43934,119527,-31659,0,0,10224,0,0,,10224,10224
4,01/20/2018,51,12:30,12:45,40.24,,0,40.24,40.24,1,-71765,46891,118656,-24874,0,0,4820,0,0,,4820,4820
4,01/20/2018,52,12:45,13:00,38.45,,0,38.45,38.45,1,-68941,45631,114572,-23310,0,0,11161,0,0,,11161,11161
4,01/20/2018,53,13:00,13:15,,,0,34.06,34.06,0,-50475,53505,103980,3030,0,0,2006,0,0,,2006,2006
4,01/20/2018,54,13:15,13:30,,33.98,0,33.98,33.98,-1,-46562,48875,95437,2313,0,-189,0,0,0,,189,-189
4,01/20/2018,55,13:30,13:45,36.3,33.98,0,36.3,36.3,1,-43110,36512,79622,-6598,0,-413,375,0,0,,788,-38
4,01/20/2018,56,13:45,14:00,38.45,,0,38.45,38.45,1,-53416,31333,84749,-22083,0,0,3111,0,0,,3111,3111
4,01/20/2018,57,14:00,14:15,,,0,34.69,34.69,0,-25980,80061,106041,54081,0,0,279,0,0,,279,279
4,01/20/2018,58,14:15,14:30,,,0,34.69,34.69,0,-48579,65496,114075,16917,0,0,0,0,0,,0,0
4,01/20/2018,59,14:30,14:45,,,0,34.69,34.69,0,-36550,64972,101522,28422,0,0,0,0,0,,0,0
4,01/20/2018,60,14:45,15:00,,32.78,0,32.78,32.78,-1,-35184,79587,114771,44403,0,-5140,0,0,0,,5140,-5140
4,01/20/2018,61,15:00,15:15,,31.78,0,31.78,31.78,-1,-28837,90178,119015,61341,0,-5664,0,0,0,,5664,-5664
4,01/20/2018,62,15:15,15:30,,32.54,0,32.54,32.54,-1,-21024,82489,103513,61465,0,-860,0,0,0,,860,-860
4,01/20/2018,63,15:30,15:45,,32.78,0,32.78,32.78,-1,-22323,88631,110954,66308,0,-3648,0,0,0,,3648,-3648
4,01/20/2018,64,15:45,16:00,,32.78,0,32.78,32.78,-1,-26573,81668,108241,55095,0,-5169,0,0,0,,5169,-5169
4,01/20/2018,65,16:00,16:15,,25.37,0,25.37,25.37,-1,-33167,90826,123993,57659,0,-6832,0,0,0,,6832,-6832
4,01/20/2018,66,16:15,16:30,,28.66,0,28.66,28.66,-1,-31262,79120,110382,47858,0,-12122,0,0,0,,12122,-12122
4,01/20/2018,67,16:30,16:45,34.03,31.78,0,34.38,31.78,2,-48488,51967,100455,3479,0,-10906,6,0,0,,10912,-10900
4,01/20/2018,68,16:45,17:00,66.32,31.78,0,66.32,66.32,1,-84086,43568,127654,-40518,0,-688,14362,0,0,,15050,13674
4,01/20/2018,69,17:00,17:15,38.45,-86.78,0,38.45,-86.78,2,-17087,117385,134472,100298,0,-17967,6599,0,0,,24566,-11368
4,01/20/2018,70,17:15,17:30,,32.78,0,32.78,32.78,-1,-49821,56079,105900,6258,0,-1867,0,0,0,,1867,-1867
4,01/20/2018,71,17:30,17:45,37.94,,0,37.94,37.94,1,-52960,58030,110990,5070,0,0,138,0,0,,138,138
4,01/20/2018,72,17:45,18:00,47.02,,0,47.02,47.02,1,-59305,55947,115252,-3358,0,0,6171,0,0,,6171,6171
4,01/20/2018,73,18:00,18:15,47.02,17.73,0,17.73,17.73,-1,-54644,65198,119842,10554,0,-6040,1076,0,0,,7116,-4964
4,01/20/2018,74,18:15,18:30,,17.73,0,17.73,17.73,-1,-42000,59099,101099,17099,0,-10957,0,0,0,,10957,-10957
4,01/20/2018,75,18:30,18:45,,-21.5,0,-21.5,-21.5,-1,-30376,99573,129949,69197,0,-9938,0,0,0,,9938,-9938
4,01/20/2018,76,18:45,19:00,,31.45,0,31.45,31.45,-1,-34761,133927,168688,99166,0,-10360,0,0,0,,10360,-10360
4,01/20/2018,77,19:00,19:15,,,0,34,34,0,-73917,84207,158124,10290,0,0,0,0,0,,0,0
4,01/20/2018,78,19:15,19:30,,,0,34.03,34.03,0,-51194,51557,102751,363,0,0,0,0,0,,0,0
4,01/20/2018,79,19:30,19:45,,32.78,0,32.78,32.78,-1,-35209,47225,82434,12016,0,-276,0,0,0,,276,-276
4,01/20/2018,80,19:45,20:00,,31.71,0,31.71,31.71,-1,-35530,54395,89925,18865,0,-11312,0,0,0,,11312,-11312
4,01/20/2018,81,20:00,20:15,72.92,31.78,0,72.92,72.92,1,-104900,41744,146644,-63156,0,-7707,3630,0,0,,11337,-4077
4,01/20/2018,82,20:15,20:30,92.12,31.78,0,92.12,92.12,1,-78029,45313,123342,-32716,0,-47,10682,0,0,,10729,10635
4,01/20/2018,83,20:30,20:45,,,0,33.79,33.79,0,-65424,62292,127716,-3132,0,0,20,0,0,,20,20
4,01/20/2018,84,20:45,21:00,,20.03,0,20.03,20.03,-1,-67547,101232,168779,33685,0,-9785,0,0,0,,9785,-9785
4,01/20/2018,85,21:00,21:15,87.92,-9.78,0,87.92,87.92,1,-103791,50789,154580,-53002,0,-14048,2305,0,0,,16353,-11743
4,01/20/2018,86,21:15,21:30,142.12,-9.78,0,142.12,142.12,1,-84036,61161,145197,-22875,0,-39,18520,0,0,,18559,18481
4,01/20/2018,87,21:30,21:45,142.12,33.26,0,33.26,33.26,-1,-68347,84384,152731,16037,0,-346,659,0,0,,1005,313
4,01/20/2018,88,21:45,22:00,,23.31,0,23.31,23.31,-1,-36846,92356,129202,55510,0,-10097,0,0,0,,10097,-10097
4,01/20/2018,89,22:00,22:15,39.55,30.78,0,39.55,39.55,1,-103341,36806,140147,-66535,0,-9454,423,0,0,,9877,-9031
4,01/20/2018,90,22:15,22:30,39.55,30.78,0,39.55,39.55,1,-115048,58751,173799,-56297,0,-45,488,0,0,,533,443
4,01/20/2018,91,22:30,22:45,41.21,,0,41.21,41.21,1,-107112,49777,156889,-57335,0,0,551,0,0,,551,551
4,01/20/2018,92,22:45,23:00,57.38,,0,57.38,57.38,1,-111261,54165,165426,-57096,0,0,12519,0,0,,12519,12519
4,01/20/2018,93,23:00,23:15,222.12,32.55,0,222.12,32.55,2,-142234,97808,240042,-44426,0,-248,14832,0,0,,15080,14584
4,01/20/2018,94,23:15,23:30,222.12,-21.61,0,222.12,-21.61,2,-98671,110609,209280,11938,0,-636,42843,0,0,,43479,42207
4,01/20/2018,95,23:30,23:45,222.12,-65.22,0,-65.22,-65.22,-1,-82028,109573,191601,27545,0,-7083,545,0,0,,7628,-6538
4,01/20/2018,96,23:45,0:00,,24.97,0,24.97,24.97,-1,-109491,108165,217656,-1326,0,-4519,0,0,0,,4519,-4519
4,01/21/2018,1,0:00,0:15,,-150.03,0,-150.03,-150.03,-1,-31851,204728,236579,172877,0,-28709,0,0,0,,28709,-28709
4,01/21/2018,2,0:15,0:30,,35.51,0,35.51,35.51,-1,-30733,90596,121329,59863,0,-1490,0,0,0,,1490,-1490
4,01/21/2018,3,0:30,0:45,,31.65,0,31.65,31.65,-1,-28538,65065,93603,36527,0,-543,0,0,0,,543,-543
4,01/21/2018,4,0:45,1:00,,13.23,0,13.23,13.23,-1,-28133,70994,99127,42861,0,-18221,0,0,0,,18221,-18221
4,01/21/2018,5,1:00,1:15,44.02,32.04,0,44.02,32.04,2,-61872,33209,95081,-28663,0,-7113,1706,0,0,,8819,-5407
4,01/21/2018,6,1:15,1:30,44.02,34.65,0,34.65,34.65,-1,-44566,59467,104033,14901,0,-46,186,0,0,,232,140
4,01/21/2018,7,1:30,1:45,,31.92,0,31.92,31.92,-1,-27466,71844,99310,44378,0,-3244,0,0,0,,3244,-3244
4,01/21/2018,8,1:45,2:00,,12.04,0,12.04,12.04,-1,-43312,99215,142527,55903,0,-23304,0,0,0,,23304,-23304
4,01/21/2018,9,2:00,2:15,44.99,28.03,0,44.99,44.99,1,-86132,75710,161842,-10422,0,-12463,1321,0,0,,13784,-11142
4,01/21/2018,10,2:15,2:30,44.64,28.03,0,44.64,44.64,1,-82395,72826,155221,-9569,0,-48,3085,0,0,,3133,3037
4,01/21/2018,11,2:30,2:45,32.04,,0,32.04,32.04,1,-93045,92219,185264,-826,0,0,885,0,0,,885,885
4,01/21/2018,12,2:45,3:00,,32.51,0,32.51,32.51,-1,-90015,106825,196840,16810,0,-261,0,0,0,,261,-261
4,01/21/2018,13,3:00,3:15,32.6,30.75,0,32.6,32.6,1,-95099,107238,202337,12139,0,-465,190,0,0,,655,-275
4,01/21/2018,14,3:15,3:30,32.55,,0,32.55,32.55,1,-82300,99523,181823,17223,0,0,720,0,0,,720,720
4,01/21/2018,15,3:30,3:45,32.12,34.41,0,34.41,34.41,-1,-67932,101221,169153,33289,0,-16,306,0,0,,322,290
4,01/21/2018,16,3:45,4:00,,33.29,0,33.29,33.29,-1,-57410,114008,171418,56598,0,-933,0,0,0,,933,-933
4,01/21/2018,17,4:00,4:15,,,0,33.17,33.17,0,-51859,108067,159926,56208,0,0,0,0,0,,0,0
4,01/21/2018,18,4:15,4:30,,,0,33.25,33.25,0,-22782,92732,115514,69950,0,0,0,0,0,,0,0
4,01/21/2018,19,4:30,4:45,,,0,33.23,33.23,0,-35328,56095,91423,20767,0,0,0,0,0,,0,0
4,01/21/2018,20,4:45,5:00,32.45,,0,32.45,32.45,1,-28747,57760,86507,29013,0,0,542,0,0,,542,542
4,01/21/2018,21,5:00,5:15,,,0,33.22,33.22,0,-28980,101192,130172,72212,0,0,28,0,0,,28,28
4,01/21/2018,22,5:15,5:30,,27.69,0,27.69,27.69,-1,-39529,109508,149037,69979,0,-127,0,0,0,,127,-127
4,01/21/2018,23,5:30,5:45,,4.52,0,4.52,4.52,-1,-35696,106007,141703,70311,0,-7869,0,0,0,,7869,-7869
4,01/21/2018,24,5:45,6:00,,23.8,0,23.8,23.8,-1,-47537,79226,126763,31689,0,-4331,0,0,0,,4331,-4331
4,01/21/2018,25,6:00,6:15,,27.93,0,27.93,27.93,-1,-34851,102842,137693,67991,0,-3415,0,0,0,,3415,-3415
4,01/21/2018,26,6:15,6:30,,,0,33.39,33.39,0,-29867,97693,127560,67826,0,0,0,0,0,,0,0
4,01/21/2018,27,6:30,6:45,,,0,33.39,33.39,0,-34958,88317,123275,53359,0,0,0,0,0,,0,0
4,01/21/2018,28,6:45,7:00,,,0,33.39,33.39,0,-46477,117542,164019,71065,0,0,0,0,0,,0,0
4,01/21/2018,29,7:00,7:15,,-150.03,0,-150.03,-150.03,-1,-26314,111278,137592,84964,0,-20628,0,0,0,,20628,-20628
4,01/21/2018,30,7:15,7:30,32.44,-150.03,0,33.44,-150.03,2,-29835,42970,72805,13135,0,-36803,22,0,0,,36825,-36781
4,01/21/2018,31,7:30,7:45,37.02,-150.03,0,37.02,37.02,1,-41076,35590,76666,-5486,0,-650,1344,0,0,,1994,694
4,01/21/2018,32,7:45,8:00,,,0,33.58,33.58,0,-29364,73608,102972,44244,0,0,453,0,0,,453,453
4,01/21/2018,33,8:00,8:15,,-50.15,0,-50.15,-50.15,-1,-35954,83388,119342,47434,0,-8211,0,0,0,,8211,-8211
4,01/21/2018,34,8:15,8:30,,-150.03,0,-150.03,-150.03,-1,-22109,46724,68833,24615,0,-32986,0,0,0,,32986,-32986
4,01/21/2018,35,8:30,8:45,,32.71,0,32.71,32.71,-1,-21577,48519,70096,26942,0,-3737,0,0,0,,3737,-3737
4,01/21/2018,36,8:45,9:00,115.02,35.4,0,115.02,115.02,1,-47007,16817,63824,-30190,0,-697,6037,0,0,,6734,5340
4,01/21/2018,37,9:00,9:15,143.02,,0,143.02,143.02,1,-73014,55910,128924,-17104,0,0,15732,0,0,,15732,15732
4,01/21/2018,38,9:15,9:30,143.02,33.92,0,33.92,33.92,-1,-42882,59654,102536,16772,0,-1284,213,0,0,,1497,-1071
4,01/21/2018,39,9:30,9:45,,32.87,0,32.87,32.87,-1,-42630,52750,95380,10120,0,-2810,0,0,0,,2810,-2810
4,01/21/2018,40,9:45,10:00,,,0,33.95,33.95,0,-35060,47836,82896,12776,0,-7,0,0,0,,7,-7
4,01/21/2018,41,10:00,10:15,,28.93,0,28.93,28.93,-1,-34488,69932,104420,35444,0,-1650,0,0,0,,1650,-1650
4,01/21/2018,42,10:15,10:30,,,0,33.93,33.93,0,-36950,55022,91972,18072,0,0,0,0,0,,0,0
4,01/21/2018,43,10:30,10:45,,35.36,0,35.36,35.36,-1,-28660,67472,96132,38812,0,-41,0,0,0,,41,-41
4,01/21/2018,44,10:45,11:00,,35.25,0,35.25,35.25,-1,-32224,72842,105066,40618,0,-279,0,0,0,,279,-279
4,01/21/2018,45,11:00,11:15,,29.3,0,29.3,29.3,-1,-31929,142505,174434,110576,0,-6414,0,0,0,,6414,-6414
4,01/21/2018,46,11:15,11:30,,27.21,0,27.21,27.21,-1,-26898,121936,148834,95038,0,-9974,0,0,0,,9974,-9974
4,01/21/2018,47,11:30,11:45,,35.03,0,35.03,35.03,-1,-26981,120325,147306,93344,0,-1334,0,0,0,,1334,-1334
4,01/21/2018,48,11:45,12:00,,26.11,0,26.11,26.11,-1,-35450,139731,175181,104281,0,-5574,0,0,0,,5574,-5574
4,01/21/2018,49,12:00,12:15,,12.68,0,12.68,12.68,-1,-21780,156309,178089,134529,0,-23072,0,0,0,,23072,-23072
4,01/21/2018,50,12:15,12:30,,-150.03,0,-150.03,-150.03,-1,-26035,159656,185691,133621,0,-58386,0,0,0,,58386,-58386
4,01/21/2018,51,12:30,12:45,,-28.03,0,-28.03,-28.03,-1,-30718,136224,166942,105506,0,-40869,0,0,0,,40869,-40869
4,01/21/2018,52,12:45,13:00,,26.31,0,26.31,26.31,-1,-31703,154330,186033,122627,0,-6790,0,0,0,,6790,-6790
4,01/21/2018,53,13:00,13:15,,22.03,0,22.03,22.03,-1,-46837,149938,196775,103101,0,-14011,0,0,0,,14011,-14011
4,01/21/2018,54,13:15,13:30,,31.65,0,31.65,31.65,-1,-50868,146774,197642,95906,0,-9244,0,0,0,,9244,-9244
4,01/21/2018,55,13:30,13:45,,-18.03,0,-18.03,-18.03,-1,-53459,130459,183918,77000,0,-13084,0,0,0,,13084,-13084
4,01/21/2018,56,13:45,14:00,,-38.03,0,-38.03,-38.03,-1,-61998,87248,149246,25250,0,-29480,0,0,0,,29480,-29480
4,01/21/2018,57,14:00,14:15,35.81,27.89,0,35.81,35.81,1,-59995,74201,134196,14206,0,-15242,14,0,0,,15256,-15228
4,01/21/2018,58,14:15,14:30,37.21,27.89,0,37.21,37.21,1,-62334,36064,98398,-26270,0,-261,187,0,0,,448,-74
4,01/21/2018,59,14:30,14:45,,,0,32.96,32.96,0,-61690,34720,96410,-26970,0,0,0,0,0,,0,0
4,01/21/2018,60,14:45,15:00,,,0,33,33,0,-65430,30187,95617,-35243,0,0,0,0,0,,0,0
4,01/21/2018,61,15:00,15:15,133.02,,0,133.02,133.02,1,-81092,15599,96691,-65493,0,0,14320,0,0,,14320,14320
4,01/21/2018,62,15:15,15:30,51.16,,0,51.16,51.16,1,-76725,32198,108923,-44527,0,0,37772,0,0,,37772,37772
4,01/21/2018,63,15:30,15:45,45.02,,0,45.02,45.02,1,-71651,43610,115261,-28041,0,0,36738,0,0,,36738,36738
4,01/21/2018,64,15:45,16:00,32.14,34.96,0,33.13,33.13,2,-53439,48245,101684,-5194,0,-383,9188,0,0,,9571,8805
4,01/21/2018,65,16:00,16:15,32.11,,0,32.11,32.11,1,-25919,45802,71721,19883,0,0,935,0,0,,935,935
4,01/21/2018,66,16:15,16:30,31.45,,0,31.45,31.45,1,-14215,45884,60099,31669,0,0,182,0,0,,182,182
4,01/21/2018,67,16:30,16:45,,29.84,0,29.84,29.84,-1,-22775,47998,70773,25223,0,-1047,0,0,0,,1047,-1047
4,01/21/2018,68,16:45,17:00,,,0,33.06,33.06,0,-47488,50481,97969,2993,0,0,0,0,0,,0,0
4,01/21/2018,69,17:00,17:15,,-150.03,0,-150.03,-150.03,-1,-6134,123454,129588,117320,0,-20873,0,0,0,,20873,-20873
4,01/21/2018,70,17:15,17:30,38.65,31.03,0,38.65,38.65,1,-54293,39517,93810,-14776,0,-5616,922,0,0,,6538,-4694
4,01/21/2018,71,17:30,17:45,48.81,,0,48.81,48.81,1,-55574,31720,87294,-23854,0,0,6498,0,0,,6498,6498
4,01/21/2018,72,17:45,18:00,38.65,,0,38.65,38.65,1,-47393,58532,105925,11139,0,0,3653,0,0,,3653,3653
4,01/21/2018,73,18:00,18:15,34.65,31.65,0,34.65,31.65,2,-50824,58456,109280,7632,0,-42,1658,0,0,,1700,1616
4,01/21/2018,74,18:15,18:30,,-7.63,0,-7.63,-7.63,-1,-32943,80780,113723,47837,0,-11834,0,0,0,,11834,-11834
4,01/21/2018,75,18:30,18:45,,-56.03,0,-56.03,-56.03,-1,-40058,65181,105239,25123,0,-31677,0,0,0,,31677,-31677
4,01/21/2018,76,18:45,19:00,,-150.03,0,-150.03,-150.03,-1,-25137,102740,127877,77603,0,-33108,0,0,0,,33108,-33108
4,01/21/2018,77,19:00,19:15,,26.9,0,26.9,26.9,-1,-81590,49615,131205,-31975,0,-11952,0,0,0,,11952,-11952
4,01/21/2018,78,19:15,19:30,,29.53,0,29.53,29.53,-1,-55845,70270,126115,14425,0,-6125,0,0,0,,6125,-6125
4,01/21/2018,79,19:30,19:45,,-22.03,0,-22.03,-22.03,-1,-39632,83522,123154,43890,0,-19080,0,0,0,,19080,-19080
4,01/21/2018,80,19:45,20:00,,12.69,0,12.69,12.69,-1,-61170,96359,157529,35189,0,-33220,0,0,0,,33220,-33220
4,01/21/2018,81,20:00,20:15,37.99,32.65,0,37.99,32.65,2,-85397,92593,177990,7196,0,-9066,190,0,0,,9256,-8876
4,01/21/2018,82,20:15,20:30,,27.65,0,27.65,27.65,-1,-57574,97095,154669,39521,0,-953,0,0,0,,953,-953
4,01/21/2018,83,20:30,20:45,,-49.44,0,-49.44,-49.44,-1,-66977,115960,182937,48983,0,-19653,0,0,0,,19653,-19653
4,01/21/2018,84,20:45,21:00,,-5.14,0,-5.14,-5.14,-1,-73811,118629,192440,44818,0,-30111,0,0,0,,30111,-30111
4,01/21/2018,85,21:00,21:15,,7.73,0,7.73,7.73,-1,-81493,101457,182950,19964,0,-24862,0,0,0,,24862,-24862
4,01/21/2018,86,21:15,21:30,,-28.03,0,-28.03,-28.03,-1,-63514,130347,193861,66833,0,-4291,0,0,0,,4291,-4291
4,01/21/2018,87,21:30,21:45,,-150.03,0,-150.03,-150.03,-1,-75434,128634,204068,53200,0,-39066,0,0,0,,39066,-39066
4,01/21/2018,88,21:45,22:00,,-20.03,0,-20.03,-20.03,-1,-63644,149137,212781,85493,0,-53990,0,0,0,,53990,-53990
4,01/21/2018,89,22:00,22:15,95.15,-7.03,0,95.15,95.15,1,-85205,43374,128579,-41831,0,-26440,2011,0,0,,28451,-24429
4,01/21/2018,90,22:15,22:30,86.61,,0,86.61,86.61,1,-63445,56144,119589,-7301,0,0,7083,0,0,,7083,7083
4,01/21/2018,91,22:30,22:45,86.61,24.54,0,24.54,24.54,-1,-57280,84987,142267,27707,0,-4683,178,0,0,,4861,-4505
4,01/21/2018,92,22:45,23:00,,11.54,0,11.54,11.54,-1,-62925,108431,171356,45506,0,-11570,0,0,0,,11570,-11570
4,01/21/2018,93,23:00,23:15,222.02,28.03,0,222.02,222.02,1,-112074,67182,179256,-44892,0,-6166,13896,0,0,,20062,7730
4,01/21/2018,94,23:15,23:30,51.21,,0,51.21,51.21,1,-86272,80539,166811,-5733,0,0,24186,0,0,,24186,24186
4,01/21/2018,95,23:30,23:45,51.21,28.13,0,28.13,28.13,-1,-60343,80382,140725,20039,0,-1860,2705,0,0,,4565,845
4,01/21/2018,96,23:45,0:00,,31.65,0,31.65,31.65,-1,-59838,84164,144002,24326,0,-3126,0,0,0,,3126,-3126
4,01/22/2018,1,0:00,0:15,,27.78,0,27.78,27.78,-1,-55869,142222,198091,86353,0,-2293,0,0,0,,2293,-2293
4,01/22/2018,2,0:15,0:30,,11.83,0,11.83,11.83,-1,-38896,77672,116568,38776,0,-4067,0,0,0,,4067,-4067
4,01/22/2018,3,0:30,0:45,,-22.94,0,-22.94,-22.94,-1,-33063,60469,93532,27406,0,-16178,0,0,0,,16178,-16178
4,01/22/2018,4,0:45,1:00,,32.02,0,32.02,32.02,-1,-37054,71433,108487,34379,0,-3170,0,0,0,,3170,-3170
4,01/22/2018,5,1:00,1:15,,30,0,30,30,-1,-36842,72170,109012,35328,0,-1049,0,0,0,,1049,-1049
4,01/22/2018,6,1:15,1:30,,,0,33.73,33.73,0,-38936,63532,102468,24596,0,0,0,0,0,,0,0
4,01/22/2018,7,1:30,1:45,,31.5,0,31.5,31.5,-1,-32836,62170,95006,29334,0,-996,0,0,0,,996,-996
4,01/22/2018,8,1:45,2:00,,26.78,0,26.78,26.78,-1,-33558,64636,98194,31078,0,-7082,0,0,0,,7082,-7082
4,01/22/2018,9,2:00,2:15,,31.22,0,31.22,31.22,-1,-39816,96122,135938,56306,0,-2871,0,0,0,,2871,-2871
4,01/22/2018,10,2:15,2:30,,,0,33.69,33.69,0,-33857,97765,131622,63908,0,0,0,0,0,,0,0
4,01/22/2018,11,2:30,2:45,,35.38,0,35.38,35.38,-1,-35298,92060,127358,56762,0,-1,0,0,0,,1,-1
4,01/22/2018,12,2:45,3:00,,31.22,0,31.22,31.22,-1,-39295,68000,107295,28705,0,-579,0,0,0,,579,-579
4,01/22/2018,13,3:00,3:15,,28.16,0,28.16,28.16,-1,-32337,90664,123001,58327,0,-371,0,0,0,,371,-371
4,01/22/2018,14,3:15,3:30,,,0,33.57,33.57,0,-31147,74752,105899,43605,0,0,0,0,0,,0,0
4,01/22/2018,15,3:30,3:45,,,0,33.57,33.57,0,-35094,74593,109687,39499,0,0,0,0,0,,0,0
4,01/22/2018,16,3:45,4:00,,28.31,0,28.31,28.31,-1,-43664,63977,107641,20313,0,-776,0,0,0,,776,-776
4,01/22/2018,17,4:00,4:15,,,0,33.61,33.61,0,-36298,76238,112536,39940,0,-278,0,0,0,,278,-278
4,01/22/2018,18,4:15,4:30,,31.27,0,31.27,31.27,-1,-37991,66256,104247,28265,0,-620,0,0,0,,620,-620
4,01/22/2018,19,4:30,4:45,,,0,33.61,33.61,0,-40857,60684,101541,19827,0,0,0,0,0,,0,0
4,01/22/2018,20,4:45,5:00,,,0,33.61,33.61,0,-46320,64107,110427,17787,0,0,0,0,0,,0,0
4,01/22/2018,21,5:00,5:15,,18.63,0,18.63,18.63,-1,-12838,70431,83269,57593,0,-16303,0,0,0,,16303,-16303
4,01/22/2018,22,5:15,5:30,,27.48,0,27.48,27.48,-1,-39820,64718,104538,24898,0,-14230,0,0,0,,14230,-14230
4,01/22/2018,23,5:30,5:45,,34.88,0,34.88,34.88,-1,-49286,52561,101847,3275,0,-1120,0,0,0,,1120,-1120
4,01/22/2018,24,5:45,6:00,,12.48,0,12.48,12.48,-1,-47706,85358,133064,37652,0,-5882,0,0,0,,5882,-5882
4,01/22/2018,25,6:00,6:15,46.2,33.55,0,46.2,33.55,2,-100549,55924,156473,-44625,0,-2773,2741,0,0,,5514,-32
4,01/22/2018,26,6:15,6:30,46.2,18.08,0,18.08,18.08,-1,-55895,141076,196971,85181,0,-12143,19,0,0,,12162,-12124
4,01/22/2018,27,6:30,6:45,,32,0,32,32,-1,-56416,165921,222337,109505,0,-9513,0,0,0,,9513,-9513
4,01/22/2018,28,6:45,7:00,,15.07,0,15.07,15.07,-1,-67898,215326,283224,147428,0,-12332,0,0,0,,12332,-12332
4,01/22/2018,29,7:00,7:15,38.54,35.87,0,38.54,34,2,-217622,138958,356580,-78664,0,-2448,548,0,0,,2996,-1900
4,01/22/2018,30,7:15,7:30,,24.45,0,24.45,24.45,-1,-92558,147415,239973,54857,0,-12778,0,0,0,,12778,-12778
4,01/22/2018,31,7:30,7:45,,34.02,0,34.02,34.02,-1,-84434,96089,180523,11655,0,-3361,0,0,0,,3361,-3361
4,01/22/2018,32,7:45,8:00,93.48,34.02,0,93.48,93.48,1,-150427,72047,222474,-78380,0,-278,8319,0,0,,8597,8041
4,01/22/2018,33,8:00,8:15,39.12,-150.78,0,39.12,-150.78,2,-52600,134477,187077,81877,0,-16100,6262,0,0,,22362,-9838
4,01/22/2018,34,8:15,8:30,,30.41,0,30.41,30.41,-1,-83167,109694,192861,26527,0,-11366,0,0,0,,11366,-11366
4,01/22/2018,35,8:30,8:45,,,0,34.62,34.62,0,-76285,129425,205710,53140,0,-85,0,0,0,,85,-85
4,01/22/2018,36,8:45,9:00,,,0,34.62,34.62,0,-85777,131342,217119,45565,0,0,0,0,0,,0,0
4,01/22/2018,37,9:00,9:15,,34.66,0,34.66,34.66,-1,-24004,166779,190783,142775,0,-1525,0,0,0,,1525,-1525
4,01/22/2018,38,9:15,9:30,,35.22,0,35.22,35.22,-1,-32712,142564,175276,109852,0,-981,0,0,0,,981,-981
4,01/22/2018,39,9:30,9:45,,,0,34.58,34.58,0,-43577,130653,174230,87076,0,-21,0,0,0,,21,-21
4,01/22/2018,40,9:45,10:00,,31.68,0,31.68,31.68,-1,-47119,120379,167498,73260,0,-4158,0,0,0,,4158,-4158
4,01/22/2018,41,10:00,10:15,,30.57,0,30.57,30.57,-1,-61554,89152,150706,27598,0,-3145,0,0,0,,3145,-3145
4,01/22/2018,42,10:15,10:30,,31.8,0,31.8,31.8,-1,-57138,101079,158217,43941,0,-414,0,0,0,,414,-414
4,01/22/2018,43,10:30,10:45,,,0,34.66,34.66,0,-61598,104312,165910,42714,0,0,0,0,0,,0,0
4,01/22/2018,44,10:45,11:00,,,0,34.66,34.66,0,-51723,104228,155951,52505,0,0,0,0,0,,0,0
4,01/22/2018,45,11:00,11:15,33.57,,0,33.57,33.57,1,-93941,80842,174783,-13099,0,0,144,0,0,,144,144
4,01/22/2018,46,11:15,11:30,39.96,,0,39.96,39.96,1,-99920,86442,186362,-13478,0,0,3709,0,0,,3709,3709
4,01/22/2018,47,11:30,11:45,35.72,,0,35.72,35.72,1,-91725,91711,183436,-14,0,0,2254,0,0,,2254,2254
4,01/22/2018,48,11:45,12:00,35.58,,0,35.58,35.58,1,-80179,78519,158698,-1660,0,0,3681,0,0,,3681,3681
4,01/22/2018,49,12:00,12:15,33.57,,0,33.57,33.57,1,-101878,62904,164782,-38974,0,0,1957,0,0,,1957,1957
4,01/22/2018,50,12:15,12:30,33.57,35.22,0,35.22,35.22,-1,-73001,75788,148789,2787,0,-54,35,0,0,,89,-19
4,01/22/2018,51,12:30,12:45,,32.63,0,32.63,32.63,-1,-41069,80132,121201,39063,0,-4434,0,0,0,,4434,-4434
4,01/22/2018,52,12:45,13:00,,30.57,0,30.57,30.57,-1,-42892,84710,127602,41818,0,-13266,0,0,0,,13266,-13266
4,01/22/2018,53,13:00,13:15,37.74,32.62,0,37.74,37.74,1,-58424,67490,125914,9066,0,-8157,329,0,0,,8486,-7828
4,01/22/2018,54,13:15,13:30,38.68,32.62,0,38.68,38.68,1,-78332,52965,131297,-25367,0,-56,4257,0,0,,4313,4201
4,01/22/2018,55,13:30,13:45,33.47,,0,33.47,33.47,1,-66183,55287,121470,-10896,0,0,2454,0,0,,2454,2454
4,01/22/2018,56,13:45,14:00,33.14,,0,33.14,33.14,1,-71220,57508,128728,-13712,0,0,941,0,0,,941,941
4,01/22/2018,57,14:00,14:15,39.24,,0,39.24,39.24,1,-80041,60032,140073,-20009,0,0,2152,0,0,,2152,2152
4,01/22/2018,58,14:15,14:30,33.28,,0,33.28,33.28,1,-74034,67412,141446,-6622,0,0,1420,0,0,,1420,1420
4,01/22/2018,59,14:30,14:45,,,0,34.51,34.51,0,-70508,68242,138750,-2266,0,0,33,0,0,,33,33
4,01/22/2018,60,14:45,15:00,,,0,34.51,34.51,0,-60009,56624,116633,-3385,0,0,0,0,0,,0,0
4,01/22/2018,61,15:00,15:15,,,0,34.4,34.4,0,-50363,43336,93699,-7027,0,0,0,0,0,,0,0
4,01/22/2018,62,15:15,15:30,35.31,,0,35.31,35.31,1,-44223,52470,96693,8247,0,0,351,0,0,,351,351
4,01/22/2018,63,15:30,15:45,36.92,,0,36.92,36.92,1,-46630,47064,93694,434,0,0,486,0,0,,486,486
4,01/22/2018,64,15:45,16:00,,,0,34.4,34.4,0,-44186,43992,88178,-194,0,0,0,0,0,,0,0
4,01/22/2018,65,16:00,16:15,,,0,34.4,34.4,0,-107534,98842,206376,-8692,0,0,0,0,0,,0,0
4,01/22/2018,66,16:15,16:30,,13.83,0,13.83,13.83,-1,-79870,127136,207006,47266,0,-11019,0,0,0,,11019,-11019
4,01/22/2018,67,16:30,16:45,,31.78,0,31.78,31.78,-1,-63557,118298,181855,54741,0,-4811,0,0,0,,4811,-4811
4,01/22/2018,68,16:45,17:00,,26.8,0,26.8,26.8,-1,-75773,103900,179673,28127,0,-7239,0,0,0,,7239,-7239
4,01/22/2018,69,17:00,17:15,,-0.01,0,-0.01,-0.01,-1,-54269,166169,220438,111900,0,-8175,0,0,0,,8175,-8175
4,01/22/2018,70,17:15,17:30,,,0,34.85,34.85,0,-50287,128764,179051,78477,0,-309,0,0,0,,309,-309
4,01/22/2018,71,17:30,17:45,,,0,34.85,34.85,0,-34382,112339,146721,77957,0,0,0,0,0,,0,0
4,01/22/2018,72,17:45,18:00,,,0,34.85,34.85,0,-32584,133171,165755,100587,0,0,0,0,0,,0,0
4,01/22/2018,73,18:00,18:15,,31.8,0,31.8,31.8,-1,-66573,71016,137589,4443,0,-176,0,0,0,,176,-176
4,01/22/2018,74,18:15,18:30,,30.8,0,30.8,30.8,-1,-50796,92517,143313,41721,0,-421,0,0,0,,421,-421
4,01/22/2018,75,18:30,18:45,,,0,34.71,34.71,0,-43286,90122,133408,46836,0,0,0,0,0,,0,0
4,01/22/2018,76,18:45,19:00,,,0,34.71,34.71,0,-38882,99222,138104,60340,0,0,0,0,0,,0,0
4,01/22/2018,77,19:00,19:15,60.05,,0,60.05,60.05,1,-132098,75475,207573,-56623,0,0,8990,0,0,,8990,8990
4,01/22/2018,78,19:15,19:30,34.97,25.79,0,25.79,25.79,-1,-71987,93101,165088,21114,0,-4044,3605,0,0,,7649,-439
4,01/22/2018,79,19:30,19:45,,16.66,0,16.66,16.66,-1,-70492,102349,172841,31857,0,-26550,0,0,0,,26550,-26550
4,01/22/2018,80,19:45,20:00,,30.8,0,30.8,30.8,-1,-83208,116063,199271,32855,0,-18031,0,0,0,,18031,-18031
4,01/22/2018,81,20:00,20:15,,25.78,0,25.78,25.78,-1,-111062,91162,202224,-19900,0,-10329,0,0,0,,10329,-10329
4,01/22/2018,82,20:15,20:30,,,0,34.09,34.09,0,-69853,89391,159244,19538,0,-61,0,0,0,,61,-61
4,01/22/2018,83,20:30,20:45,,32.59,0,32.59,32.59,-1,-82571,100944,183515,18373,0,-111,0,0,0,,111,-111
4,01/22/2018,84,20:45,21:00,,30.95,0,30.95,30.95,-1,-131212,116458,247670,-14754,0,-1109,0,0,0,,1109,-1109
4,01/22/2018,85,21:00,21:15,58.94,-48.38,0,58.94,-48.38,2,-107773,150899,258672,43126,0,-7875,2146,0,0,,10021,-5729
4,01/22/2018,86,21:15,21:30,109.01,,0,109.01,109.01,1,-110700,109199,219899,-1501,0,0,26568,0,0,,26568,26568
4,01/22/2018,87,21:30,21:45,,,0,33.84,33.84,0,-90901,109653,200554,18752,0,0,757,0,0,,757,757
4,01/22/2018,88,21:45,22:00,,26.95,0,26.95,26.95,-1,-115289,112815,228104,-2474,0,-1028,0,0,0,,1028,-1028
4,01/22/2018,89,22:00,22:15,,-25.85,0,-25.85,-25.85,-1,-89354,92587,181941,3233,0,-24134,0,0,0,,24134,-24134
4,01/22/2018,90,22:15,22:30,33.95,30.95,0,33.95,30.95,2,-86935,71623,158558,-15312,0,-685,470,0,0,,1155,-215
4,01/22/2018,91,22:30,22:45,,30.78,0,30.78,30.78,-1,-69493,87551,157044,18058,0,-3394,0,0,0,,3394,-3394
4,01/22/2018,92,22:45,23:00,,30.95,0,30.95,30.95,-1,-93035,121395,214430,28360,0,-2702,0,0,0,,2702,-2702
4,01/22/2018,93,23:00,23:15,32.11,30.95,0,32.11,32.11,1,-103655,84272,187927,-19383,0,-2334,36,0,0,,2370,-2298
4,01/22/2018,94,23:15,23:30,32.12,,0,32.12,32.12,1,-84995,84763,169758,-232,0,0,214,0,0,,214,214
4,01/22/2018,95,23:30,23:45,,,0,33.74,33.74,0,-74748,86121,160869,11373,0,0,0,0,0,,0,0
4,01/22/2018,96,23:45,0:00,,16.95,0,16.95,16.95,-1,-79957,105480,185437,25523,0,-4822,0,0,0,,4822,-4822
4,01/23/2018,1,0:00,0:15,,7.03,0,7.03,7.03,-1,-56059,121584,177643,65525,0,-7893,0,0,0,,7893,-7893
4,01/23/2018,2,0:15,0:30,,30.95,0,30.95,30.95,-1,-46933,85619,132552,38686,0,-1691,0,0,0,,1691,-1691
4,01/23/2018,3,0:30,0:45,,27.51,0,27.51,27.51,-1,-50546,71162,121708,20616,0,-2660,0,0,0,,2660,-2660
4,01/23/2018,4,0:45,1:00,,17.22,0,17.22,17.22,-1,-73835,75092,148927,1257,0,-21579,0,0,0,,21579,-21579
4,01/23/2018,5,1:00,1:15,,31.97,0,31.97,31.97,-1,-39352,50639,89991,11287,0,-2726,0,0,0,,2726,-2726
4,01/23/2018,6,1:15,1:30,32.23,28.81,0,32.87,28.81,2,-41594,48649,90243,7055,0,-292,104,0,0,,396,-188
4,01/23/2018,7,1:30,1:45,,28.89,0,28.89,28.89,-1,-32009,47442,79451,15433,0,-819,0,0,0,,819,-819
4,01/23/2018,8,1:45,2:00,,30.95,0,30.95,30.95,-1,-59906,49450,109356,-10456,0,-1652,0,0,0,,1652,-1652
4,01/23/2018,9,2:00,2:15,,30.95,0,30.95,30.95,-1,-77348,51482,128830,-25866,0,-1582,0,0,0,,1582,-1582
4,01/23/2018,10,2:15,2:30,,,0,32.87,32.87,0,-75698,42873,118571,-32825,0,0,0,0,0,,0,0
4,01/23/2018,11,2:30,2:45,,,0,32.87,32.87,0,-67368,48297,115665,-19071,0,0,0,0,0,,0,0
4,01/23/2018,12,2:45,3:00,,27.42,0,27.42,27.42,-1,-53404,44377,97781,-9027,0,-774,0,0,0,,774,-774
4,01/23/2018,13,3:00,3:15,,27.32,0,27.32,27.32,-1,-24394,61832,86226,37438,0,-480,0,0,0,,480,-480
4,01/23/2018,14,3:15,3:30,,,0,32.28,32.28,0,-20703,82074,102777,61371,0,0,0,0,0,,0,0
4,01/23/2018,15,3:30,3:45,,15.38,0,15.38,15.38,-1,-24058,74516,98574,50458,0,-4865,0,0,0,,4865,-4865
4,01/23/2018,16,3:45,4:00,,12.03,0,12.03,12.03,-1,-39206,61692,100898,22486,0,-30561,0,0,0,,30561,-30561
4,01/23/2018,17,4:00,4:15,,30.36,0,30.36,30.36,-1,-34855,62957,97812,28102,0,-12806,0,0,0,,12806,-12806
4,01/23/2018,18,4:15,4:30,,,0,32.45,32.45,0,-44787,77736,122523,32949,0,-16,0,0,0,,16,-16
4,01/23/2018,19,4:30,4:45,,,0,32.45,32.45,0,-32655,73116,105771,40461,0,0,0,0,0,,0,0
4,01/23/2018,20,4:45,5:00,,,0,32.45,32.45,0,-28688,62187,90875,33499,0,0,0,0,0,,0,0
4,01/23/2018,21,5:00,5:15,,28.96,0,28.96,28.96,-1,-14966,115223,130189,100257,0,-509,0,0,0,,509,-509
4,01/23/2018,22,5:15,5:30,,26.98,0,26.98,26.98,-1,-22882,81647,104529,58765,0,-1628,0,0,0,,1628,-1628
4,01/23/2018,23,5:30,5:45,43.95,30.95,0,43.95,30.95,2,-59467,49644,109111,-9823,0,-386,820,0,0,,1206,434
4,01/23/2018,24,5:45,6:00,49.95,31.95,0,49.95,31.95,2,-49478,93403,142881,43925,0,-153,4560,0,0,,4713,4407
4,01/23/2018,25,6:00,6:15,,27.37,0,27.37,27.37,-1,-54037,90821,144858,36784,0,-3274,0,0,0,,3274,-3274
4,01/23/2018,26,6:15,6:30,,33.65,0,33.65,33.65,-1,-54970,47118,102088,-7852,0,-2534,0,0,0,,2534,-2534
4,01/23/2018,27,6:30,6:45,,34.45,0,34.45,34.45,-1,-74859,38170,113029,-36689,0,-242,0,0,0,,242,-242
4,01/23/2018,28,6:45,7:00,48.46,,0,48.46,48.46,1,-121450,71548,192998,-49902,0,0,2004,0,0,,2004,2004
4,01/23/2018,29,7:00,7:15,48.46,-95.42,0,-95.42,-95.42,-1,-57745,135835,193580,78090,0,-25245,327,0,0,,25572,-24918
4,01/23/2018,30,7:15,7:30,38.4,32.03,0,38.4,38.4,1,-83353,81728,165081,-1625,0,-7258,712,0,0,,7970,-6546
4,01/23/2018,31,7:30,7:45,54.93,,0,54.93,54.93,1,-94488,66107,160595,-28381,0,0,14171,0,0,,14171,14171
4,01/23/2018,32,7:45,8:00,237.02,,0,237.02,237.02,1,-132176,45887,178063,-86289,0,0,25024,0,0,,25024,25024
4,01/23/2018,33,8:00,8:15,40.03,,0,40.03,40.03,1,-31056,81801,112857,50745,0,0,17583,0,0,,17583,17583
4,01/23/2018,34,8:15,8:30,,,0,34.12,34.12,0,-20317,70675,90992,50358,0,0,24,0,0,,24,24
4,01/23/2018,35,8:30,8:45,,35.54,0,35.54,35.54,-1,-27941,71551,99492,43610,0,-3,0,0,0,,3,-3
4,01/23/2018,36,8:45,9:00,,34.68,0,34.68,34.68,-1,-40326,66441,106767,26115,0,-600,0,0,0,,600,-600
4,01/23/2018,37,9:00,9:15,,31.07,0,31.07,31.07,-1,-44582,59936,104518,15354,0,-2536,0,0,0,,2536,-2536
4,01/23/2018,38,9:15,9:30,,28.71,0,28.71,28.71,-1,-54670,67922,122592,13252,0,-11190,0,0,0,,11190,-11190
4,01/23/2018,39,9:30,9:45,,32.71,0,32.71,32.71,-1,-57512,68122,125634,10610,0,-7901,0,0,0,,7901,-7901
4,01/23/2018,40,9:45,10:00,,28.15,0,28.15,28.15,-1,-41993,82128,124121,40135,0,-18300,0,0,0,,18300,-18300
4,01/23/2018,41,10:00,10:15,103.02,33.98,0,103.02,33.98,2,-87512,39034,126546,-48478,0,-7762,10472,0,0,,18234,2710
4,01/23/2018,42,10:15,10:30,37.65,,0,37.65,37.65,1,-81584,71275,152859,-10309,0,0,4286,0,0,,4286,4286
4,01/23/2018,43,10:30,10:45,37.65,34.52,0,34.52,34.52,-1,-77814,86463,164277,8649,0,-14,245,0,0,,259,231
4,01/23/2018,44,10:45,11:00,,32.71,0,32.71,32.71,-1,-74486,91959,166445,17473,0,-2627,0,0,0,,2627,-2627
4,01/23/2018,45,11:00,11:15,58.41,35.52,0,58.41,34.27,2,-86183,34829,121012,-51354,0,-416,12962,0,0,,13378,12546
4,01/23/2018,46,11:15,11:30,41.02,,0,41.02,41.02,1,-86280,54186,140466,-32094,0,0,27848,0,0,,27848,27848
4,01/23/2018,47,11:30,11:45,37.78,32.71,0,32.71,32.71,-1,-71988,69367,141355,-2621,0,-56,13830,0,0,,13886,13774
4,01/23/2018,48,11:45,12:00,37.78,32.71,0,32.71,32.71,-1,-55525,92683,148208,37158,0,-216,269,0,0,,485,53
4,01/23/2018,49,12:00,12:15,,,0,34.12,34.12,0,-58200,71397,129597,13197,0,0,0,0,0,,0,0
4,01/23/2018,50,12:15,12:30,,28.71,0,28.71,28.71,-1,-46317,84413,130730,38096,0,-3360,0,0,0,,3360,-3360
4,01/23/2018,51,12:30,12:45,,31.73,0,31.73,31.73,-1,-36988,99578,136566,62590,0,-2772,0,0,0,,2772,-2772
4,01/23/2018,52,12:45,13:00,,-13.67,0,-13.67,-13.67,-1,-33987,104491,138478,70504,0,-20876,0,0,0,,20876,-20876
4,01/23/2018,53,13:00,13:15,,32.71,0,32.71,32.71,-1,-57973,61576,119549,3603,0,-7616,0,0,0,,7616,-7616
4,01/23/2018,54,13:15,13:30,,32.71,0,32.71,32.71,-1,-62577,67454,130031,4877,0,-725,0,0,0,,725,-725
4,01/23/2018,55,13:30,13:45,,31.03,0,31.03,31.03,-1,-59985,83001,142986,23016,0,-1753,0,0,0,,1753,-1753
4,01/23/2018,56,13:45,14:00,,23.69,0,23.69,23.69,-1,-60014,94003,154017,33989,0,-29317,0,0,0,,29317,-29317
4,01/23/2018,57,14:00,14:15,52.67,19.03,0,52.67,19.03,2,-92475,64172,156647,-28303,0,-23097,1932,0,0,,25029,-21165
4,01/23/2018,58,14:15,14:30,52.67,33.11,0,33.11,33.11,-1,-59871,54721,114592,-5150,0,-295,348,0,0,,643,53
4,01/23/2018,59,14:30,14:45,,35.53,0,35.53,35.53,-1,-54302,54428,108730,126,0,-152,0,0,0,,152,-152
4,01/23/2018,60,14:45,15:00,,32.71,0,32.71,32.71,-1,-51962,58369,110331,6407,0,-899,0,0,0,,899,-899
4,01/23/2018,61,15:00,15:15,,34.79,0,34.79,34.79,-1,-52399,50906,103305,-1493,0,-270,0,0,0,,270,-270
4,01/23/2018,62,15:15,15:30,,,0,34.55,34.55,0,-44836,51785,96621,6949,0,0,0,0,0,,0,0
4,01/23/2018,63,15:30,15:45,36.61,,0,36.61,36.61,1,-42113,43450,85563,1337,0,0,269,0,0,,269,269
4,01/23/2018,64,15:45,16:00,35.81,,0,35.81,35.81,1,-42980,35957,78937,-7023,0,0,315,0,0,,315,315
4,01/23/2018,65,16:00,16:15,,30.54,0,30.54,30.54,-1,-61316,84128,145444,22812,0,-1877,0,0,0,,1877,-1877
4,01/23/2018,66,16:15,16:30,,27.01,0,27.01,27.01,-1,-47057,73029,120086,25972,0,-15156,0,0,0,,15156,-15156
4,01/23/2018,67,16:30,16:45,,18.71,0,18.71,18.71,-1,-41567,70858,112425,29291,0,-24298,0,0,0,,24298,-24298
4,01/23/2018,68,16:45,17:00,,30.49,0,30.49,30.49,-1,-51325,59735,111060,8410,0,-12537,0,0,0,,12537,-12537
4,01/23/2018,69,17:00,17:15,,-98.96,0,-98.96,-98.96,-1,-49082,79729,128811,30647,0,-23670,0,0,0,,23670,-23670
4,01/23/2018,70,17:15,17:30,,33.71,0,33.71,33.71,-1,-56711,39235,95946,-17476,0,-2752,0,0,0,,2752,-2752
4,01/23/2018,71,17:30,17:45,,32.71,0,32.71,32.71,-1,-40828,42461,83289,1633,0,-949,0,0,0,,949,-949
4,01/23/2018,72,17:45,18:00,,,0,34.77,34.77,0,-34684,53690,88374,19006,0,0,0,0,0,,0,0
4,01/23/2018,73,18:00,18:15,38.4,,0,38.4,38.4,1,-78657,41734,120391,-36923,0,0,1005,0,0,,1005,1005
4,01/23/2018,74,18:15,18:30,40.76,,0,40.76,40.76,1,-54233,49314,103547,-4919,0,0,3634,0,0,,3634,3634
4,01/23/2018,75,18:30,18:45,33.02,32.71,0,34.28,32.71,2,-44781,73266,118047,28485,0,-975,930,0,0,,1905,-45
4,01/23/2018,76,18:45,19:00,,34.94,0,34.94,34.94,-1,-49055,91884,140939,42829,0,-162,0,0,0,,162,-162
4,01/23/2018,77,19:00,19:15,42.59,30.03,0,42.59,30.03,2,-62524,52826,115350,-9698,0,-1535,1842,0,0,,3377,307
4,01/23/2018,78,19:15,19:30,38.01,,0,38.01,38.01,1,-56262,58468,114730,2206,0,0,1363,0,0,,1363,1363
4,01/23/2018,79,19:30,19:45,38.01,19.12,0,19.12,19.12,-1,-49547,81092,130639,31545,0,-10560,119,0,0,,10679,-10441
4,01/23/2018,80,19:45,20:00,,18.71,0,18.71,18.71,-1,-42607,72435,115042,29828,0,-28729,0,0,0,,28729,-28729
4,01/23/2018,81,20:00,20:15,166.02,-16.25,0,166.02,-16.25,2,-58728,42384,101112,-16344,0,-24625,4137,0,0,,28762,-20488
4,01/23/2018,82,20:15,20:30,238.02,-16.25,0,238.02,238.02,1,-38428,53549,91977,15121,0,-228,31634,0,0,,31862,31406
4,01/23/2018,83,20:30,20:45,238.02,15.42,0,15.42,15.42,-1,-12818,96569,109387,83751,0,-7484,114,0,0,,7598,-7370
4,01/23/2018,84,20:45,21:00,,1.74,0,1.74,1.74,-1,-46024,71691,117715,25667,0,-34695,0,0,0,,34695,-34695
4,01/23/2018,85,21:00,21:15,,27.03,0,27.03,27.03,-1,-35965,98099,134064,62134,0,-11553,0,0,0,,11553,-11553
4,01/23/2018,86,21:15,21:30,,27.38,0,27.38,27.38,-1,-17408,75189,92597,57781,0,-420,0,0,0,,420,-420
4,01/23/2018,87,21:30,21:45,,8.81,0,8.81,8.81,-1,-22387,96739,119126,74352,0,-15113,0,0,0,,15113,-15113
4,01/23/2018,88,21:45,22:00,,-77.05,0,-77.05,-77.05,-1,-29400,101585,130985,72185,0,-37150,0,0,0,,37150,-37150
4,01/23/2018,89,22:00,22:15,116.46,34.14,0,116.46,116.46,1,-70119,31186,101305,-38933,0,-6992,15635,0,0,,22627,8643
4,01/23/2018,90,22:15,22:30,49.77,19.73,0,19.73,19.73,-1,-35133,63471,98604,28338,0,-1716,13975,0,0,,15691,12259
4,01/23/2018,91,22:30,22:45,,12.79,0,12.79,12.79,-1,-31671,85823,117494,54152,0,-20461,0,0,0,,20461,-20461
4,01/23/2018,92,22:45,23:00,,-18.29,0,-18.29,-18.29,-1,-44495,129713,174208,85218,0,-22462,0,0,0,,22462,-22462
4,01/23/2018,93,23:00,23:15,51.97,20.42,0,51.97,51.97,1,-83479,61537,145016,-21942,0,-16141,2892,0,0,,19033,-13249
4,01/23/2018,94,23:15,23:30,33.56,1.07,0,1.07,1.07,-1,-60001,90097,150098,30096,0,-5548,1641,0,0,,7189,-3907
4,01/23/2018,95,23:30,23:45,,-3.96,0,-3.96,-3.96,-1,-65819,95594,161413,29775,0,-21968,0,0,0,,21968,-21968
4,01/23/2018,96,23:45,0:00,,6.74,0,6.74,6.74,-1,-71258,126768,198026,55510,0,-16101,0,0,0,,16101,-16101
4,01/24/2018,1,0:00,0:15,,-165.75,0,-165.75,-165.75,-1,-36793,109507,146300,72714,0,-44905,0,0,0,,44905,-44905
4,01/24/2018,2,0:15,0:30,33.76,26.78,0,33.76,26.78,2,-61372,87229,148601,25857,0,-3427,364,0,0,,3791,-3063
4,01/24/2018,3,0:30,0:45,,-22.29,0,-22.29,-22.29,-1,-61263,104872,166135,43609,0,-19157,0,0,0,,19157,-19157
4,01/24/2018,4,0:45,1:00,38.03,-21.52,0,38.03,-21.52,2,-116613,105822,222435,-10791,0,-27016,630,0,0,,27646,-26386
4,01/24/2018,5,1:00,1:15,32.86,30.76,0,33.34,30.76,2,-16585,86403,102988,69818,0,-462,65,0,0,,527,-397
4,01/24/2018,6,1:15,1:30,,-28.61,0,-28.61,-28.61,-1,-19481,83176,102657,63695,0,-25690,0,0,0,,25690,-25690
4,01/24/2018,7,1:30,1:45,,-25.98,0,-25.98,-25.98,-1,-27953,57623,85576,29670,0,-37495,0,0,0,,37495,-37495
4,01/24/2018,8,1:45,2:00,,-14.48,0,-14.48,-14.48,-1,-29249,81760,111009,52511,0,-23755,0,0,0,,23755,-23755
4,01/24/2018,9,2:00,2:15,,26.76,0,26.76,26.76,-1,-49788,43380,93168,-6408,0,-11499,0,0,0,,11499,-11499
4,01/24/2018,10,2:15,2:30,32.86,30.76,0,33.24,30.76,2,-48794,53671,102465,4877,0,-78,7,0,0,,85,-71
4,01/24/2018,11,2:30,2:45,,25.78,0,25.78,25.78,-1,-44091,75282,119373,31191,0,-4053,0,0,0,,4053,-4053
4,01/24/2018,12,2:45,3:00,,12.17,0,12.17,12.17,-1,-40940,89354,130294,48414,0,-30145,0,0,0,,30145,-30145
4,01/24/2018,13,3:00,3:15,,9.87,0,9.87,9.87,-1,-27000,79331,106331,52331,0,-28915,0,0,0,,28915,-28915
4,01/24/2018,14,3:15,3:30,,25.78,0,25.78,25.78,-1,-25801,63606,89407,37805,0,-2945,0,0,0,,2945,-2945
4,01/24/2018,15,3:30,3:45,,23.47,0,23.47,23.47,-1,-27291,68042,95333,40751,0,-20449,0,0,0,,20449,-20449
4,01/24/2018,16,3:45,4:00,,24.87,0,24.87,24.87,-1,-32890,69697,102587,36807,0,-23804,0,0,0,,23804,-23804
4,01/24/2018,17,4:00,4:15,,13.13,0,13.13,13.13,-1,-32433,63484,95917,31051,0,-39072,0,0,0,,39072,-39072
4,01/24/2018,18,4:15,4:30,,23.84,0,23.84,23.84,-1,-29136,56777,85913,27641,0,-39427,0,0,0,,39427,-39427
4,01/24/2018,19,4:30,4:45,38.93,25.78,0,38.93,25.78,2,-43902,42990,86892,-912,0,-15107,1100,0,0,,16207,-14007
4,01/24/2018,20,4:45,5:00,38.93,29.06,0,29.06,29.06,-1,-41982,51210,93192,9228,0,-470,177,0,0,,647,-293
4,01/24/2018,21,5:00,5:15,,10.78,0,10.78,10.78,-1,-32783,86965,119748,54182,0,-24260,0,0,0,,24260,-24260
4,01/24/2018,22,5:15,5:30,,33.32,0,33.32,33.32,-1,-42689,65285,107974,22596,0,-6720,0,0,0,,6720,-6720
4,01/24/2018,23,5:30,5:45,38.93,32.84,0,38.93,32.84,2,-53016,40583,93599,-12433,0,-439,526,0,0,,965,87
4,01/24/2018,24,5:45,6:00,,,0,33.44,33.44,0,-62912,38164,101076,-24748,0,0,0,0,0,,0,0
4,01/24/2018,25,6:00,6:15,,27.79,0,27.79,27.79,-1,-51424,134116,185540,82692,0,-2385,0,0,0,,2385,-2385
4,01/24/2018,26,6:15,6:30,,-21.75,0,-21.75,-21.75,-1,-16189,102715,118904,86526,0,-10670,0,0,0,,10670,-10670
4,01/24/2018,27,6:30,6:45,52.38,-62.37,0,52.38,-62.37,2,-67843,28086,95929,-39757,0,-20386,2956,0,0,,23342,-17430
4,01/24/2018,28,6:45,7:00,34.79,26.78,0,26.78,26.78,-1,-52905,79913,132818,27008,0,-1965,1568,0,0,,3533,-397
4,01/24/2018,29,7:00,7:15,,-17.21,0,-17.21,-17.21,-1,-51247,114121,165368,62874,0,-43632,0,0,0,,43632,-43632
4,01/24/2018,30,7:15,7:30,37.11,28.79,0,37.11,37.11,1,-67601,76899,144500,9298,0,-17955,88,0,0,,18043,-17867
4,01/24/2018,31,7:30,7:45,117.12,28.79,0,117.12,117.12,1,-103533,57150,160683,-46383,0,-12,12467,0,0,,12479,12455
4,01/24/2018,32,7:45,8:00,192.12,,0,192.12,192.12,1,-139446,98778,238224,-40668,0,0,36135,0,0,,36135,36135
4,01/24/2018,33,8:00,8:15,43.12,9.78,0,9.78,9.78,-1,-22199,58507,80706,36308,0,-3418,16563,0,0,,19981,13145
4,01/24/2018,34,8:15,8:30,43.12,8.87,0,8.87,8.87,-1,-34481,52943,87424,18462,0,-8682,43,0,0,,8725,-8639
4,01/24/2018,35,8:30,8:45,,29.78,0,29.78,29.78,-1,-37641,61829,99470,24188,0,-8738,0,0,0,,8738,-8738
4,01/24/2018,36,8:45,9:00,39.6,31.79,0,39.6,39.6,1,-64235,59490,123725,-4745,0,-6668,414,0,0,,7082,-6254
4,01/24/2018,37,9:00,9:15,54.47,31.79,0,54.47,54.47,1,-65584,78006,143590,12422,0,-155,5277,0,0,,5432,5122
4,01/24/2018,38,9:15,9:30,,,0,35.38,35.38,0,-30187,78333,108520,48146,0,0,0,0,0,,0,0
4,01/24/2018,39,9:30,9:45,,31.79,0,31.79,31.79,-1,-20235,80797,101032,60562,0,-217,0,0,0,,217,-217
4,01/24/2018,40,9:45,10:00,,8.59,0,8.59,8.59,-1,-27591,82595,110186,55004,0,-22323,0,0,0,,22323,-22323
4,01/24/2018,41,10:00,10:15,,28.58,0,28.58,28.58,-1,-49855,74766,124621,24911,0,-13941,0,0,0,,13941,-13941
4,01/24/2018,42,10:15,10:30,,25.08,0,25.08,25.08,-1,-41029,80657,121686,39628,0,-7833,0,0,0,,7833,-7833
4,01/24/2018,43,10:30,10:45,,28.88,0,28.88,28.88,-1,-43964,82723,126687,38759,0,-23341,0,0,0,,23341,-23341
4,01/24/2018,44,10:45,11:00,,27.79,0,27.79,27.79,-1,-57433,72897,130330,15464,0,-22721,0,0,0,,22721,-22721
4,01/24/2018,45,11:00,11:15,37.12,27.79,0,37.12,37.12,1,-69778,76456,146234,6678,0,-2576,564,0,0,,3140,-2012
4,01/24/2018,46,11:15,11:30,,30.65,0,30.65,30.65,-1,-65769,74586,140355,8817,0,-1978,0,0,0,,1978,-1978
4,01/24/2018,47,11:30,11:45,,31.79,0,31.79,31.79,-1,-70724,73455,144179,2731,0,-3326,0,0,0,,3326,-3326
4,01/24/2018,48,11:45,12:00,,30.84,0,30.84,30.84,-1,-72271,73756,146027,1485,0,-5286,0,0,0,,5286,-5286
4,01/24/2018,49,12:00,12:15,38.58,27.96,0,38.58,27.96,2,-74271,59737,134008,-14534,0,-10622,235,0,0,,10857,-10387
4,01/24/2018,50,12:15,12:30,38.82,27.96,0,38.82,38.82,1,-97646,74420,172066,-23226,0,-542,435,0,0,,977,-107
4,01/24/2018,51,12:30,12:45,,,0,35.38,35.38,0,-86588,82626,169214,-3962,0,0,0,0,0,,0,0
4,01/24/2018,52,12:45,13:00,,31.79,0,31.79,31.79,-1,-77157,79837,156994,2680,0,-959,0,0,0,,959,-959
4,01/24/2018,53,13:00,13:15,39.6,30.83,0,39.6,30.83,2,-74215,65215,139430,-9000,0,-803,1472,0,0,,2275,669
4,01/24/2018,54,13:15,13:30,39.6,,0,39.6,39.6,1,-88216,61216,149432,-27000,0,0,5208,0,0,,5208,5208
4,01/24/2018,55,13:30,13:45,42.12,,0,42.12,42.12,1,-86507,68354,154861,-18153,0,0,6544,0,0,,6544,6544
4,01/24/2018,56,13:45,14:00,37.5,35.72,0,35.72,35.72,-1,-80073,77467,157540,-2606,0,-29,5809,0,0,,5838,5780
4,01/24/2018,57,14:00,14:15,37.5,32.33,0,32.33,32.33,-1,-66364,95238,161602,28874,0,-1620,120,0,0,,1740,-1500
4,01/24/2018,58,14:15,14:30,,35.94,0,35.94,35.94,-1,-79567,87763,167330,8196,0,-419,0,0,0,,419,-419
4,01/24/2018,59,14:30,14:45,,,0,34.73,34.73,0,-69482,87000,156482,17518,0,0,0,0,0,,0,0
4,01/24/2018,60,14:45,15:00,,31.79,0,31.79,31.79,-1,-67923,83298,151221,15375,0,-1109,0,0,0,,1109,-1109
4,01/24/2018,61,15:00,15:15,34.79,31.79,0,34.79,34.79,1,-66750,63153,129903,-3597,0,-1101,465,0,0,,1566,-636
4,01/24/2018,62,15:15,15:30,54.28,,0,54.28,54.28,1,-89450,62912,152362,-26538,0,0,15473,0,0,,15473,15473
4,01/24/2018,63,15:30,15:45,41.92,,0,41.92,41.92,1,-80847,77815,158662,-3032,0,0,14849,0,0,,14849,14849
4,01/24/2018,64,15:45,16:00,41.92,29.78,0,29.78,29.78,-1,-41119,74487,115606,33368,0,-2721,333,0,0,,3054,-2388
4,01/24/2018,65,16:00,16:15,,-22.02,0,-22.02,-22.02,-1,-43836,130947,174783,87111,0,-25896,0,0,0,,25896,-25896
4,01/24/2018,66,16:15,16:30,,27.74,0,27.74,27.74,-1,-40833,101498,142331,60665,0,-26317,0,0,0,,26317,-26317
4,01/24/2018,67,16:30,16:45,,-16.65,0,-16.65,-16.65,-1,-39743,82246,121989,42503,0,-42059,0,0,0,,42059,-42059
4,01/24/2018,68,16:45,17:00,,,0,33.62,33.62,0,-49059,69081,118140,20022,0,-6003,0,0,0,,6003,-6003
4,01/24/2018,69,17:00,17:15,,3.09,0,3.09,3.09,-1,-49045,83081,132126,34036,0,-15133,0,0,0,,15133,-15133
4,01/24/2018,70,17:15,17:30,50.5,3.09,0,50.5,50.5,1,-55919,35588,91507,-20331,0,-1338,5461,0,0,,6799,4123
4,01/24/2018,71,17:30,17:45,54.59,,0,54.59,54.59,1,-72751,37994,110745,-34757,0,0,25819,0,0,,25819,25819
4,01/24/2018,72,17:45,18:00,48.12,,0,48.12,48.12,1,-70762,59347,130109,-11415,0,0,31108,0,0,,31108,31108
4,01/24/2018,73,18:00,18:15,49.3,31.96,0,49.3,31.96,2,-70134,50346,120480,-19788,0,-123,21420,0,0,,21543,21297
4,01/24/2018,74,18:15,18:30,38.34,29.78,0,38.34,29.78,2,-60224,50484,110708,-9740,0,-983,1343,0,0,,2326,360
4,01/24/2018,75,18:30,18:45,39.6,,0,39.6,39.6,1,-64307,45245,109552,-19062,0,0,1017,0,0,,1017,1017
4,01/24/2018,76,18:45,19:00,65,,0,65,65,1,-74924,37030,111954,-37894,0,0,14540,0,0,,14540,14540
4,01/24/2018,77,19:00,19:15,238.12,,0,238.12,238.12,1,-108475,35094,143569,-73381,0,0,62713,0,0,,62713,62713
4,01/24/2018,78,19:15,19:30,54.48,,0,54.48,54.48,1,-92199,33111,125310,-59088,0,0,38375,0,0,,38375,38375
4,01/24/2018,79,19:30,19:45,64.65,,0,64.65,64.65,1,-130529,32177,162706,-98352,0,0,36162,0,0,,36162,36162
4,01/24/2018,80,19:45,20:00,238.12,,0,238.12,238.12,1,-160637,31001,191638,-129636,0,0,78104,0,0,,78104,78104
4,01/24/2018,81,20:00,20:15,75.62,,0,75.62,75.62,1,-132012,97298,229310,-34714,0,0,53676,0,0,,53676,53676
4,01/24/2018,82,20:15,20:30,75.12,,0,75.12,75.12,1,-145813,87263,233076,-58550,0,0,41359,0,0,,41359,41359
4,01/24/2018,83,20:30,20:45,108.12,,0,108.12,108.12,1,-156393,84336,240729,-72057,0,0,54362,0,0,,54362,54362
4,01/24/2018,84,20:45,21:00,144.12,,0,144.12,144.12,1,-168611,94390,263001,-74221,0,0,75381,0,0,,75381,75381
4,01/24/2018,85,21:00,21:15,53.92,32.73,0,53.92,32.73,2,-139962,133435,273397,-6527,0,-56,19764,0,0,,19820,19708
4,01/24/2018,86,21:15,21:30,222.12,,0,222.12,222.12,1,-167283,94846,262129,-72437,0,0,54689,0,0,,54689,54689
4,01/24/2018,87,21:30,21:45,48.12,,0,48.12,48.12,1,-106755,100785,207540,-5970,0,0,21533,0,0,,21533,21533
4,01/24/2018,88,21:45,22:00,48.12,31.15,0,31.15,31.15,-1,-77201,102022,179223,24821,0,-526,40,0,0,,566,-486
4,01/24/2018,89,22:00,22:15,74.3,30.7,0,74.3,74.3,1,-144883,108148,253031,-36735,0,-827,11492,0,0,,12319,10665
4,01/24/2018,90,22:15,22:30,87.12,,0,87.12,87.12,1,-128721,92277,220998,-36444,0,0,50946,0,0,,50946,50946
4,01/24/2018,91,22:30,22:45,87.12,31.08,0,31.08,31.08,-1,-64418,84946,149364,20528,0,-559,9736,0,0,,10295,9177
4,01/24/2018,92,22:45,23:00,32.83,33.81,0,33.32,33.32,2,-44144,78926,123070,34782,0,-3,73,0,0,,76,70
4,01/24/2018,93,23:00,23:15,222.12,32.99,0,222.12,222.12,1,-143230,31407,174637,-111823,0,-58,28926,0,0,,28984,28868
4,01/24/2018,94,23:15,23:30,222.12,,0,222.12,222.12,1,-85306,51158,136464,-34148,0,0,60892,0,0,,60892,60892
4,01/24/2018,95,23:30,23:45,33.12,,0,33.12,33.12,1,-34815,88315,123130,53500,0,0,2070,0,0,,2070,2070
4,01/24/2018,96,23:45,0:00,,-47.07,0,-47.07,-47.07,-1,-34366,111576,145942,77210,0,-14354,0,0,0,,14354,-14354
4,01/25/2018,1,0:00,0:15,,26.81,0,26.81,26.81,-1,-49898,105644,155542,55746,0,-9711,0,0,0,,9711,-9711
4,01/25/2018,2,0:15,0:30,34.72,,0,34.72,34.72,1,-52007,47713,99720,-4294,0,0,286,0,0,,286,286
4,01/25/2018,3,0:30,0:45,,,0,32.98,32.98,0,-56191,63545,119736,7354,0,0,0,0,0,,0,0
4,01/25/2018,4,0:45,1:00,,18.87,0,18.87,18.87,-1,-65688,90264,155952,24576,0,-7206,0,0,0,,7206,-7206
4,01/25/2018,5,1:00,1:15,,31.46,0,31.46,31.46,-1,-50525,75196,125721,24671,0,-5212,0,0,0,,5212,-5212
4,01/25/2018,6,1:15,1:30,,31.46,0,31.46,31.46,-1,-36439,42146,78585,5707,0,-451,0,0,0,,451,-451
4,01/25/2018,7,1:30,1:45,,30.81,0,30.81,30.81,-1,-22300,45439,67739,23139,0,-537,0,0,0,,537,-537
4,01/25/2018,8,1:45,2:00,,,0,32.9,32.9,0,-33431,53354,86785,19923,0,0,0,0,0,,0,0
4,01/25/2018,9,2:00,2:15,33.81,,0,33.81,33.81,1,-48955,52873,101828,3918,0,0,344,0,0,,344,344
4,01/25/2018,10,2:15,2:30,33.1,,0,33.1,33.1,1,-46010,52003,98013,5993,0,0,522,0,0,,522,522
4,01/25/2018,11,2:30,2:45,32.53,,0,32.53,32.53,1,-44915,50171,95086,5256,0,0,42,0,0,,42,42
4,01/25/2018,12,2:45,3:00,35.15,,0,35.15,35.15,1,-45163,43127,88290,-2036,0,0,299,0,0,,299,299
4,01/25/2018,13,3:00,3:15,32.52,,0,32.52,32.52,1,-36428,42693,79121,6265,0,0,108,0,0,,108,108
4,01/25/2018,14,3:15,3:30,32.51,17.91,0,17.91,17.91,-1,-32598,54851,87449,22253,0,-3592,18,0,0,,3610,-3574
4,01/25/2018,15,3:30,3:45,,9.03,0,9.03,9.03,-1,-28567,48703,77270,20136,0,-17768,0,0,0,,17768,-17768
4,01/25/2018,16,3:45,4:00,,28.5,0,28.5,28.5,-1,-32840,48123,80963,15283,0,-6924,0,0,0,,6924,-6924
4,01/25/2018,17,4:00,4:15,,28.41,0,28.41,28.41,-1,-36051,73240,109291,37189,0,-5621,0,0,0,,5621,-5621
4,01/25/2018,18,4:15,4:30,,,0,32.65,32.65,0,-34041,72160,106201,38119,0,-27,0,0,0,,27,-27
4,01/25/2018,19,4:30,4:45,,,0,32.65,32.65,0,-40511,66331,106842,25820,0,0,0,0,0,,0,0
4,01/25/2018,20,4:45,5:00,,30.81,0,30.81,30.81,-1,-45745,65113,110858,19368,0,-737,0,0,0,,737,-737
4,01/25/2018,21,5:00,5:15,,32.53,0,32.53,32.53,-1,-43185,155601,198786,112416,0,-1625,0,0,0,,1625,-1625
4,01/25/2018,22,5:15,5:30,,-20.32,0,-20.32,-20.32,-1,-50332,116990,167322,66658,0,-15187,0,0,0,,15187,-15187
4,01/25/2018,23,5:30,5:45,40.58,19.31,0,40.58,19.31,2,-58714,48690,107404,-10024,0,-11907,1351,0,0,,13258,-10556
4,01/25/2018,24,5:45,6:00,37.81,,0,37.81,37.81,1,-62765,48798,111563,-13967,0,0,2851,0,0,,2851,2851
4,01/25/2018,25,6:00,6:15,37.81,29.16,0,29.16,29.16,-1,-37862,140105,177967,102243,0,-130,106,0,0,,236,-24
4,01/25/2018,26,6:15,6:30,42,-73.59,0,42,-73.59,2,-28721,69588,98309,40867,0,-19513,131,0,0,,19644,-19382
4,01/25/2018,27,6:30,6:45,65.17,-73.59,0,65.17,65.17,1,-44751,45351,90102,600,0,-75,9101,0,0,,9176,9026
4,01/25/2018,28,6:45,7:00,32.6,,0,32.6,32.6,1,-48915,110527,159442,61612,0,0,1068,0,0,,1068,1068
4,01/25/2018,29,7:00,7:15,58.94,30.81,0,58.94,30.81,2,-124502,118962,243464,-5540,0,-604,6303,0,0,,6907,5699
4,01/25/2018,30,7:15,7:30,34.01,28.6,0,34.01,34.01,1,-42527,91089,133616,48562,0,-1827,8,0,0,,1835,-1819
4,01/25/2018,31,7:30,7:45,46.94,,0,46.94,46.94,1,-74739,41372,116111,-33367,0,0,5888,0,0,,5888,5888
4,01/25/2018,32,7:45,8:00,238.02,,0,238.02,238.02,1,-153714,56885,210599,-96829,0,0,52015,0,0,,52015,52015
4,01/25/2018,33,8:00,8:15,94.02,,0,94.02,94.02,1,-161838,64867,226705,-96971,0,0,82475,0,0,,82475,82475
4,01/25/2018,34,8:15,8:30,61.02,,0,61.02,61.02,1,-123554,52373,175927,-71181,0,0,69041,0,0,,69041,69041
4,01/25/2018,35,8:30,8:45,144.02,,0,144.02,144.02,1,-133197,58490,191687,-74707,0,0,43894,0,0,,43894,43894
4,01/25/2018,36,8:45,9:00,238.02,,0,238.02,238.02,1,-165233,57722,222955,-107511,0,0,73883,0,0,,73883,73883
4,01/25/2018,37,9:00,9:15,62.72,,0,62.72,62.72,1,-80960,74173,155133,-6787,0,0,39738,0,0,,39738,39738
4,01/25/2018,38,9:15,9:30,38.01,,0,38.01,38.01,1,-82167,66322,148489,-15845,0,0,4694,0,0,,4694,4694
4,01/25/2018,39,9:30,9:45,47.01,,0,47.01,47.01,1,-94533,69278,163811,-25255,0,0,11730,0,0,,11730,11730
4,01/25/2018,40,9:45,10:00,55.32,,0,55.32,55.32,1,-114026,71273,185299,-42753,0,0,22218,0,0,,22218,22218
4,01/25/2018,41,10:00,10:15,58,35.2,0,58,34.19,2,-70332,102255,172587,31923,0,-5,22409,0,0,,22414,22404
4,01/25/2018,42,10:15,10:30,58,32.11,0,32.11,32.11,-1,-69069,91537,160606,22468,0,-1476,463,0,0,,1939,-1013
4,01/25/2018,43,10:30,10:45,,,0,34.19,34.19,0,-72610,71162,143772,-1448,0,-26,0,0,0,,26,-26
4,01/25/2018,44,10:45,11:00,,,0,34.19,34.19,0,-58994,100533,159527,41539,0,0,0,0,0,,0,0
4,01/25/2018,45,11:00,11:15,,,0,33.77,33.77,0,-75155,93400,168555,18245,0,0,0,0,0,,0,0
4,01/25/2018,46,11:15,11:30,,33.49,0,33.49,33.49,-1,-70143,101217,171360,31074,0,-324,0,0,0,,324,-324
4,01/25/2018,47,11:30,11:45,,,0,33.77,33.77,0,-74935,103412,178347,28477,0,0,0,0,0,,0,0
4,01/25/2018,48,11:45,12:00,,,0,33.77,33.77,0,-81372,104134,185506,22762,0,0,0,0,0,,0,0
4,01/25/2018,49,12:00,12:15,47.9,,0,47.9,47.9,1,-111282,94334,205616,-16948,0,0,10061,0,0,,10061,10061
4,01/25/2018,50,12:15,12:30,32.91,33.45,0,33.45,33.45,-1,-84276,102593,186869,18317,0,-444,2336,0,0,,2780,1892
4,01/25/2018,51,12:30,12:45,,32.01,0,32.01,32.01,-1,-58721,119728,178449,61007,0,-820,0,0,0,,820,-820
4,01/25/2018,52,12:45,13:00,,33.48,0,33.48,33.48,-1,-50162,122568,172730,72406,0,-37,0,0,0,,37,-37
4,01/25/2018,53,13:00,13:15,,31.56,0,31.56,31.56,-1,-50672,145973,196645,95301,0,-155,0,0,0,,155,-155
4,01/25/2018,54,13:15,13:30,,33.46,0,33.46,33.46,-1,-77360,121872,199232,44512,0,-745,0,0,0,,745,-745
4,01/25/2018,55,13:30,13:45,,33.45,0,33.45,33.45,-1,-88289,108730,197019,20441,0,-1369,0,0,0,,1369,-1369
4,01/25/2018,56,13:45,14:00,,,0,34.07,34.07,0,-98636,93653,192289,-4983,0,-3,0,0,0,,3,-3
4,01/25/2018,57,14:00,14:15,34.01,,0,34.01,34.01,1,-77280,97714,174994,20434,0,0,499,0,0,,499,499
4,01/25/2018,58,14:15,14:30,38.01,,0,38.01,38.01,1,-82370,86011,168381,3641,0,0,2034,0,0,,2034,2034
4,01/25/2018,59,14:30,14:45,37.46,,0,37.46,37.46,1,-92477,85250,177727,-7227,0,0,3270,0,0,,3270,3270
4,01/25/2018,60,14:45,15:00,38.01,,0,38.01,38.01,1,-99911,81654,181565,-18257,0,0,4353,0,0,,4353,4353
4,01/25/2018,61,15:00,15:15,38.01,,0,38.01,38.01,1,-76741,74115,150856,-2626,0,0,2678,0,0,,2678,2678
4,01/25/2018,62,15:15,15:30,38.01,,0,38.01,38.01,1,-81809,77133,158942,-4676,0,0,3070,0,0,,3070,3070
4,01/25/2018,63,15:30,15:45,62.98,,0,62.98,62.98,1,-92086,54033,146119,-38053,0,0,27826,0,0,,27826,27826
4,01/25/2018,64,15:45,16:00,57.65,,0,57.65,57.65,1,-100388,49989,150377,-50399,0,0,42465,0,0,,42465,42465
4,01/25/2018,65,16:00,16:15,34.02,31.03,0,34.04,31.03,2,-69830,93371,163201,23541,0,-1096,12295,0,0,,13391,11199
4,01/25/2018,66,16:15,16:30,35.26,31.03,0,35.26,35.26,1,-75949,68402,144351,-7547,0,-21,1111,0,0,,1132,1090
4,01/25/2018,67,16:30,16:45,52.44,,0,52.44,52.44,1,-84759,67734,152493,-17025,0,0,2576,0,0,,2576,2576
4,01/25/2018,68,16:45,17:00,75.07,,0,75.07,75.07,1,-117541,69357,186898,-48184,0,0,30205,0,0,,30205,30205
4,01/25/2018,69,17:00,17:15,37.02,-108.45,0,37.02,-108.45,2,-34728,127416,162144,92688,0,-20326,9495,0,0,,29821,-10831
4,01/25/2018,70,17:15,17:30,,31.03,0,31.03,31.03,-1,-90213,85974,176187,-4239,0,-4562,0,0,0,,4562,-4562
4,01/25/2018,71,17:30,17:45,61.37,31.03,0,61.37,61.37,1,-107056,91196,198252,-15860,0,-40,3840,0,0,,3880,3800
4,01/25/2018,72,17:45,18:00,238.02,,0,238.02,238.02,1,-89366,54810,144176,-34556,0,0,46378,0,0,,46378,46378
4,01/25/2018,73,18:00,18:15,61.02,,0,61.02,61.02,1,-88668,53809,142477,-34859,0,0,39877,0,0,,39877,39877
4,01/25/2018,74,18:15,18:30,61.02,29.55,0,29.55,29.55,-1,-37054,75902,112956,38848,0,-1574,5611,0,0,,7185,4037
4,01/25/2018,75,18:30,18:45,,12.75,0,12.75,12.75,-1,-46032,93025,139057,46993,0,-16525,0,0,0,,16525,-16525
4,01/25/2018,76,18:45,19:00,,30.37,0,30.37,30.37,-1,-59389,98935,158324,39546,0,-17880,0,0,0,,17880,-17880
4,01/25/2018,77,19:00,19:15,46.45,35.18,0,46.45,34.28,2,-113246,88342,201588,-24904,0,-4367,2524,0,0,,6891,-1843
4,01/25/2018,78,19:15,19:30,46.45,35.18,0,35.18,35.18,-1,-88559,110105,198664,21546,0,-2,24,0,0,,26,22
4,01/25/2018,79,19:30,19:45,,6.13,0,6.13,6.13,-1,-72470,129577,202047,57107,0,-19852,0,0,0,,19852,-19852
4,01/25/2018,80,19:45,20:00,,25.4,0,25.4,25.4,-1,-74139,114381,188520,40242,0,-36662,0,0,0,,36662,-36662
4,01/25/2018,81,20:00,20:15,56.28,29.55,0,56.28,29.55,2,-84243,58159,142402,-26084,0,-19395,2415,0,0,,21810,-16980
4,01/25/2018,82,20:15,20:30,56.28,20.29,0,20.29,20.29,-1,-49187,72899,122086,23712,0,-5498,69,0,0,,5567,-5429
4,01/25/2018,83,20:30,20:45,,20.4,0,20.4,20.4,-1,-46095,86417,132512,40322,0,-24373,0,0,0,,24373,-24373
4,01/25/2018,84,20:45,21:00,,-9.37,0,-9.37,-9.37,-1,-47608,110641,158249,63033,0,-26737,0,0,0,,26737,-26737
4,01/25/2018,85,21:00,21:15,54.4,-92.58,0,54.4,-92.58,2,-79733,34780,114513,-44953,0,-24074,1143,0,0,,25217,-22931
4,01/25/2018,86,21:15,21:30,57.98,-92.58,0,57.98,57.98,1,-78039,60475,138514,-17564,0,-30,5808,0,0,,5838,5778
4,01/25/2018,87,21:30,21:45,,,0,33.9,33.9,0,-61440,79164,140604,17724,0,0,26,0,0,,26,26
4,01/25/2018,88,21:45,22:00,,14.36,0,14.36,14.36,-1,-76705,112067,188772,35362,0,-3577,0,0,0,,3577,-3577
4,01/25/2018,89,22:00,22:15,66.63,-7.03,0,66.63,-7.03,2,-116471,56109,172580,-60362,0,-9459,2177,0,0,,11636,-7282
4,01/25/2018,90,22:15,22:30,166.02,,0,166.02,166.02,1,-107744,53122,160866,-54622,0,0,25716,0,0,,25716,25716
4,01/25/2018,91,22:30,22:45,35.83,,0,35.83,35.83,1,-83580,67269,150849,-16311,0,0,917,0,0,,917,917
4,01/25/2018,92,22:45,23:00,36.11,,0,36.11,36.11,1,-71128,63451,134579,-7677,0,0,1407,0,0,,1407,1407
4,01/25/2018,93,23:00,23:15,42.85,,0,42.85,42.85,1,-92108,47360,139468,-44748,0,0,597,0,0,,597,597
4,01/25/2018,94,23:15,23:30,64.63,,0,64.63,64.63,1,-85490,33945,119435,-51545,0,0,20271,0,0,,20271,20271
4,01/25/2018,95,23:30,23:45,64.63,28.3,0,28.3,28.3,-1,-56388,68555,124943,12167,0,-1899,2719,0,0,,4618,820
4,01/25/2018,96,23:45,0:00,,20.32,0,20.32,20.32,-1,-54355,77876,132231,23521,0,-19761,0,0,0,,19761,-19761
4,01/26/2018,1,0:00,0:15,,28.98,0,28.98,28.98,-1,-38249,78555,116804,40306,0,-11403,0,0,0,,11403,-11403
4,01/26/2018,2,0:15,0:30,,32.27,0,32.27,32.27,-1,-32089,61996,94085,29907,0,-810,0,0,0,,810,-810
4,01/26/2018,3,0:30,0:45,,,0,33.66,33.66,0,-83460,52698,136158,-30762,0,0,0,0,0,,0,0
4,01/26/2018,4,0:45,1:00,,32.98,0,32.98,32.98,-1,-79259,71590,150849,-7669,0,-165,0,0,0,,165,-165
4,01/26/2018,5,1:00,1:15,,32.98,0,32.98,32.98,-1,-31959,35717,67676,3758,0,-577,0,0,0,,577,-577
4,01/26/2018,6,1:15,1:30,,31.78,0,31.78,31.78,-1,-37669,41996,79665,4327,0,-2221,0,0,0,,2221,-2221
4,01/26/2018,7,1:30,1:45,,32.98,0,32.98,32.98,-1,-39758,56316,96074,16558,0,-4547,0,0,0,,4547,-4547
4,01/26/2018,8,1:45,2:00,,24.91,0,24.91,24.91,-1,-38793,66808,105601,28015,0,-16543,0,0,0,,16543,-16543
4,01/26/2018,9,2:00,2:15,35.76,30.78,0,35.76,35.76,1,-46658,45239,91897,-1419,0,-14276,364,0,0,,14640,-13912
4,01/26/2018,10,2:15,2:30,35.7,30.78,0,35.7,35.7,1,-44804,61712,106516,16908,0,-242,308,0,0,,550,66
4,01/26/2018,11,2:30,2:45,,,0,33.66,33.66,0,-41635,63976,105611,22341,0,0,0,0,0,,0,0
4,01/26/2018,12,2:45,3:00,,30.88,0,30.88,30.88,-1,-44150,63031,107181,18881,0,-2225,0,0,0,,2225,-2225
4,01/26/2018,13,3:00,3:15,49.68,30.88,0,49.68,49.68,1,-67266,63367,130633,-3899,0,-313,7602,0,0,,7915,7289
4,01/26/2018,14,3:15,3:30,35.73,,0,35.73,35.73,1,-64548,72456,137004,7908,0,0,3555,0,0,,3555,3555
4,01/26/2018,15,3:30,3:45,,,0,33.66,33.66,0,-61245,57237,118482,-4008,0,0,0,0,0,,0,0
4,01/26/2018,16,3:45,4:00,,,0,33.66,33.66,0,-60009,48761,108770,-11248,0,0,0,0,0,,0,0
4,01/26/2018,17,4:00,4:15,,,0,33.75,33.75,0,-29900,61127,91027,31227,0,0,0,0,0,,0,0
4,01/26/2018,18,4:15,4:30,,,0,33.75,33.75,0,-32823,46867,79690,14044,0,0,0,0,0,,0,0
4,01/26/2018,19,4:30,4:45,,,0,33.74,33.74,0,-39190,44951,84141,5761,0,0,0,0,0,,0,0
4,01/26/2018,20,4:45,5:00,,,0,33.74,33.74,0,-30305,58071,88376,27766,0,0,0,0,0,,0,0
4,01/26/2018,21,5:00,5:15,33.27,29.9,0,33.63,29.9,2,-54066,67567,121633,13501,0,-917,143,0,0,,1060,-774
4,01/26/2018,22,5:15,5:30,,27.35,0,27.35,27.35,-1,-19541,63336,82877,43795,0,-13091,0,0,0,,13091,-13091
4,01/26/2018,23,5:30,5:45,,32.98,0,32.98,32.98,-1,-24130,55073,79203,30943,0,-3125,0,0,0,,3125,-3125
4,01/26/2018,24,5:45,6:00,50.66,32.98,0,50.66,50.66,1,-50653,39243,89896,-11410,0,-134,2215,0,0,,2349,2081
4,01/26/2018,25,6:00,6:15,45.94,,0,45.94,45.94,1,-9774,94779,104553,85005,0,0,3297,0,0,,3297,3297
4,01/26/2018,26,6:15,6:30,,,0,33.96,33.96,0,-9230,72089,81319,62859,0,0,0,0,0,,0,0
4,01/26/2018,27,6:30,6:45,39.32,,0,39.32,39.32,1,-47679,55934,103613,8255,0,0,234,0,0,,234,234
4,01/26/2018,28,6:45,7:00,,,0,33.96,33.96,0,-55404,86376,141780,30972,0,0,25,0,0,,25,25
4,01/26/2018,29,7:00,7:15,33.95,-17.78,0,33.95,-17.78,2,-65421,153258,218679,87837,0,-17132,77,0,0,,17209,-17055
4,01/26/2018,30,7:15,7:30,39.32,29.3,0,39.32,39.32,1,-82386,76962,159348,-5424,0,-12440,182,0,0,,12622,-12258
4,01/26/2018,31,7:30,7:45,237.12,29.3,0,237.12,237.12,1,-122872,52892,175764,-69980,0,-92,15746,0,0,,15838,15654
4,01/26/2018,32,7:45,8:00,237.12,,0,237.12,237.12,1,-207653,44307,251960,-163346,0,0,90909,0,0,,90909,90909
4,01/26/2018,33,8:00,8:15,237.12,15.38,0,15.38,15.38,-1,-16507,115244,131751,98737,0,-1840,44306,0,0,,46146,42466
4,01/26/2018,34,8:15,8:30,,32.78,0,32.78,32.78,-1,-46904,76351,123255,29447,0,-1873,0,0,0,,1873,-1873
4,01/26/2018,35,8:30,8:45,,31.78,0,31.78,31.78,-1,-65871,70022,135893,4151,0,-5486,0,0,0,,5486,-5486
4,01/26/2018,36,8:45,9:00,35.06,31.78,0,35.06,35.06,1,-88941,59554,148495,-29387,0,-121,509,0,0,,630,388
4,01/26/2018,37,9:00,9:15,34.92,,0,34.92,34.92,1,-47068,58964,106032,11896,0,0,2486,0,0,,2486,2486
4,01/26/2018,38,9:15,9:30,35.04,,0,35.04,35.04,1,-53994,60265,114259,6271,0,0,1510,0,0,,1510,1510
4,01/26/2018,39,9:30,9:45,33.91,,0,33.91,33.91,1,-62746,57139,119885,-5607,0,0,1253,0,0,,1253,1253
4,01/26/2018,40,9:45,10:00,35.04,,0,35.04,35.04,1,-60758,67177,127935,6419,0,0,458,0,0,,458,458
4,01/26/2018,41,10:00,10:15,72.15,,0,72.15,72.15,1,-81774,51454,133228,-30320,0,0,20438,0,0,,20438,20438
4,01/26/2018,42,10:15,10:30,43.12,,0,43.12,43.12,1,-76971,60553,137524,-16418,0,0,24654,0,0,,24654,24654
4,01/26/2018,43,10:30,10:45,36.29,,0,36.29,36.29,1,-77589,66966,144555,-10623,0,0,8379,0,0,,8379,8379
4,01/26/2018,44,10:45,11:00,50.99,,0,50.99,50.99,1,-73355,59051,132406,-14304,0,0,7491,0,0,,7491,7491
4,01/26/2018,45,11:00,11:15,45.63,,0,45.63,45.63,1,-81720,55857,137577,-25863,0,0,11194,0,0,,11194,11194
4,01/26/2018,46,11:15,11:30,34.85,,0,34.85,34.85,1,-71950,62705,134655,-9245,0,0,4841,0,0,,4841,4841
4,01/26/2018,47,11:30,11:45,42.35,,0,42.35,42.35,1,-76395,57332,133727,-19063,0,0,7509,0,0,,7509,7509
4,01/26/2018,48,11:45,12:00,38.38,,0,38.38,38.38,1,-65951,58792,124743,-7159,0,0,5392,0,0,,5392,5392
4,01/26/2018,49,12:00,12:15,206.12,,0,206.12,206.12,1,-111048,52984,164032,-58064,0,0,27830,0,0,,27830,27830
4,01/26/2018,50,12:15,12:30,45.6,,0,45.6,45.6,1,-101965,60288,162253,-41677,0,0,20185,0,0,,20185,20185
4,01/26/2018,51,12:30,12:45,37.12,,0,37.12,37.12,1,-99334,76788,176122,-22546,0,0,12859,0,0,,12859,12859
4,01/26/2018,52,12:45,13:00,39.79,,0,39.79,39.79,1,-101054,71415,172469,-29639,0,0,5869,0,0,,5869,5869
4,01/26/2018,53,13:00,13:15,88.12,,0,88.12,88.12,1,-114446,73131,187577,-41315,0,0,21338,0,0,,21338,21338
4,01/26/2018,54,13:15,13:30,58,,0,58,58,1,-111800,59887,171687,-51913,0,0,36114,0,0,,36114,36114
4,01/26/2018,55,13:30,13:45,61.2,,0,61.2,61.2,1,-123948,53730,177678,-70218,0,0,27307,0,0,,27307,27307
4,01/26/2018,56,13:45,14:00,44.06,,0,44.06,44.06,1,-130911,66320,197231,-64591,0,0,17147,0,0,,17147,17147
4,01/26/2018,57,14:00,14:15,34.91,,0,34.91,34.91,1,-78916,85912,164828,6996,0,0,291,0,0,,291,291
4,01/26/2018,58,14:15,14:30,34.15,,0,34.15,34.15,1,-76512,81403,157915,4891,0,0,396,0,0,,396,396
4,01/26/2018,59,14:30,14:45,34.95,,0,34.95,34.95,1,-73840,75265,149105,1425,0,0,427,0,0,,427,427
4,01/26/2018,60,14:45,15:00,33.63,,0,33.63,33.63,1,-66822,70395,137217,3573,0,0,213,0,0,,213,213
4,01/26/2018,61,15:00,15:15,34.93,,0,34.93,34.93,1,-76453,83940,160393,7487,0,0,379,0,0,,379,379
4,01/26/2018,62,15:15,15:30,,,0,34.41,34.41,0,-73461,86516,159977,13055,0,0,0,0,0,,0,0
4,01/26/2018,63,15:30,15:45,36.69,,0,36.69,36.69,1,-75187,75184,150371,-3,0,0,1760,0,0,,1760,1760
4,01/26/2018,64,15:45,16:00,36.69,,0,36.69,36.69,1,-71884,73775,145659,1891,0,0,2741,0,0,,2741,2741
4,01/26/2018,65,16:00,16:15,43.82,,0,43.82,43.82,1,-97766,60870,158636,-36896,0,0,9879,0,0,,9879,9879
4,01/26/2018,66,16:15,16:30,39.79,,0,39.79,39.79,1,-93071,53043,146114,-40028,0,0,13414,0,0,,13414,13414
4,01/26/2018,67,16:30,16:45,44.1,,0,44.1,44.1,1,-80587,39666,120253,-40921,0,0,16083,0,0,,16083,16083
4,01/26/2018,68,16:45,17:00,66.25,,0,66.25,66.25,1,-94871,38413,133284,-56458,0,0,30422,0,0,,30422,30422
4,01/26/2018,69,17:00,17:15,37.12,-54.44,0,37.12,-54.44,2,-64228,133002,197230,68774,0,-17127,10742,0,0,,27869,-6385
4,01/26/2018,70,17:15,17:30,,30.56,0,30.56,30.56,-1,-78485,69025,147510,-9460,0,-10165,0,0,0,,10165,-10165
4,01/26/2018,71,17:30,17:45,53.12,30.56,0,53.12,53.12,1,-71064,50233,121297,-20831,0,-13,6400,0,0,,6413,6387
4,01/26/2018,72,17:45,18:00,106.75,,0,106.75,106.75,1,-76008,59691,135699,-16317,0,0,15355,0,0,,15355,15355
4,01/26/2018,73,18:00,18:15,112.7,32.97,0,32.97,32.97,-1,-74842,56312,131154,-18530,0,-47,19842,0,0,,19889,19795
4,01/26/2018,74,18:15,18:30,112.7,32.78,0,32.78,32.78,-1,-42968,89484,132452,46516,0,-853,219,0,0,,1072,-634
4,01/26/2018,75,18:30,18:45,,5.49,0,5.49,5.49,-1,-38786,102733,141519,63947,0,-18721,0,0,0,,18721,-18721
4,01/26/2018,76,18:45,19:00,,32.78,0,32.78,32.78,-1,-29201,104895,134096,75694,0,-11147,0,0,0,,11147,-11147
4,01/26/2018,77,19:00,19:15,,,0,33.94,33.94,0,-40154,66425,106579,26271,0,-57,0,0,0,,57,-57
4,01/26/2018,78,19:15,19:30,,28.97,0,28.97,28.97,-1,-21344,80302,101646,58958,0,-860,0,0,0,,860,-860
4,01/26/2018,79,19:30,19:45,,11.22,0,11.22,11.22,-1,-24103,106636,130739,82533,0,-6914,0,0,0,,6914,-6914
4,01/26/2018,80,19:45,20:00,,1.69,0,1.69,1.69,-1,-28752,89431,118183,60679,0,-32477,0,0,0,,32477,-32477
4,01/26/2018,81,20:00,20:15,55.62,30.55,0,55.62,55.62,1,-46524,41739,88263,-4785,0,-18505,2010,0,0,,20515,-16495
4,01/26/2018,82,20:15,20:30,55.62,32.97,0,32.97,32.97,-1,-22419,58101,80520,35682,0,-325,494,0,0,,819,169
4,01/26/2018,83,20:30,20:45,,-38.01,0,-38.01,-38.01,-1,-22092,95977,118069,73885,0,-41189,0,0,0,,41189,-41189
4,01/26/2018,84,20:45,21:00,,8.99,0,8.99,8.99,-1,-29240,95272,124512,66032,0,-69112,0,0,0,,69112,-69112
4,01/26/2018,85,21:00,21:15,62.53,15.16,0,62.53,62.53,1,-93830,24872,118702,-68958,0,-35696,776,0,0,,36472,-34920
4,01/26/2018,86,21:15,21:30,63.97,32.97,0,32.97,32.97,-1,-31931,26186,58117,-5745,0,-28,2755,0,0,,2783,2727
4,01/26/2018,87,21:30,21:45,63.97,32.97,0,32.97,32.97,-1,-18332,50113,68445,31781,0,-621,16,0,0,,637,-605
4,01/26/2018,88,21:45,22:00,,17.63,0,17.63,17.63,-1,-23553,90308,113861,66755,0,-16643,0,0,0,,16643,-16643
4,01/26/2018,89,22:00,22:15,38.02,28.97,0,38.02,28.97,2,-75457,20049,95506,-55408,0,-14859,484,0,0,,15343,-14375
4,01/26/2018,90,22:15,22:30,,,0,33.83,33.83,0,-26793,22716,49509,-4077,0,-30,0,0,0,,30,-30
4,01/26/2018,91,22:30,22:45,,,0,33.83,33.83,0,-24812,54200,79012,29388,0,0,0,0,0,,0,0
4,01/26/2018,92,22:45,23:00,,28.09,0,28.09,28.09,-1,-47023,68168,115191,21145,0,-676,0,0,0,,676,-676
4,01/26/2018,93,23:00,23:15,,13.03,0,13.03,13.03,-1,-24744,77570,102314,52826,0,-12126,0,0,0,,12126,-12126
4,01/26/2018,94,23:15,23:30,,,0,33.76,33.76,0,-49284,36850,86134,-12434,0,-1281,0,0,0,,1281,-1281
4,01/26/2018,95,23:30,23:45,,34.79,0,34.79,34.79,-1,-39419,42236,81655,2817,0,-6,0,0,0,,6,-6
4,01/26/2018,96,23:45,0:00,,22.54,0,22.54,22.54,-1,-58168,67061,125229,8893,0,-5867,0,0,0,,5867,-5867
5,01/27/2018,1,0:00,0:15,51.97,-16.09,0,51.97,-16.09,2,-20915,89601,110516,68686,0,-10230,1049,0,0,,11279,-9181
5,01/27/2018,2,0:15,0:30,61.92,-16.09,0,61.92,61.92,1,-43969,58863,102832,14894,0,-139,11107,0,0,,11246,10968
5,01/27/2018,3,0:30,0:45,61.92,18.97,0,18.97,18.97,-1,-42895,80187,123082,37292,0,-3462,28,0,0,,3490,-3434
5,01/27/2018,4,0:45,1:00,,18.42,0,18.42,18.42,-1,-77926,59652,137578,-18274,0,-19391,0,0,0,,19391,-19391
5,01/27/2018,5,1:00,1:15,,2.3,0,2.3,2.3,-1,-41318,115832,157150,74514,0,-17733,0,0,0,,17733,-17733
5,01/27/2018,6,1:15,1:30,,30.1,0,30.1,30.1,-1,-33318,51572,84890,18254,0,-3113,0,0,0,,3113,-3113
5,01/27/2018,7,1:30,1:45,,30.85,0,30.85,30.85,-1,-30999,39699,70698,8700,0,-1081,0,0,0,,1081,-1081
5,01/27/2018,8,1:45,2:00,,13.66,0,13.66,13.66,-1,-22702,59897,82599,37195,0,-18515,0,0,0,,18515,-18515
5,01/27/2018,9,2:00,2:15,36.99,28.97,0,36.99,28.97,2,-41169,36173,77342,-4996,0,-12338,455,0,0,,12793,-11883
5,01/27/2018,10,2:15,2:30,,,0,33.56,33.56,0,-16889,43696,60585,26807,0,0,0,0,0,,0,0
5,01/27/2018,11,2:30,2:45,,21.47,0,21.47,21.47,-1,-22630,66118,88748,43488,0,-7702,0,0,0,,7702,-7702
5,01/27/2018,12,2:45,3:00,,16.99,0,16.99,16.99,-1,-37002,80829,117831,43827,0,-35903,0,0,0,,35903,-35903
5,01/27/2018,13,3:00,3:15,,20.03,0,20.03,20.03,-1,-29037,62546,91583,33509,0,-20024,0,0,0,,20024,-20024
5,01/27/2018,14,3:15,3:30,,,0,33.5,33.5,0,-22812,64080,86892,41268,0,0,0,0,0,,0,0
5,01/27/2018,15,3:30,3:45,,,0,33.5,33.5,0,-11933,66087,78020,54154,0,0,0,0,0,,0,0
5,01/27/2018,16,3:45,4:00,,,0,33.5,33.5,0,-9036,69239,78275,60203,0,0,0,0,0,,0,0
5,01/27/2018,17,4:00,4:15,,,0,32.89,32.89,0,-13477,53107,66584,39630,0,0,0,0,0,,0,0
5,01/27/2018,18,4:15,4:30,,,0,32.89,32.89,0,-14049,57504,71553,43455,0,0,0,0,0,,0,0
5,01/27/2018,19,4:30,4:45,,,0,32.89,32.89,0,-17720,62040,79760,44320,0,0,0,0,0,,0,0
5,01/27/2018,20,4:45,5:00,,33.97,0,33.97,33.97,-1,-18629,54932,73561,36303,0,-24,0,0,0,,24,-24
5,01/27/2018,21,5:00,5:15,,28.97,0,28.97,28.97,-1,-4287,72535,76822,68248,0,-2150,0,0,0,,2150,-2150
5,01/27/2018,22,5:15,5:30,,16.79,0,16.79,16.79,-1,-6175,57407,63582,51232,0,-10675,0,0,0,,10675,-10675
5,01/27/2018,23,5:30,5:45,,33.97,0,33.97,33.97,-1,-15782,42832,58614,27050,0,-1882,0,0,0,,1882,-1882
5,01/27/2018,24,5:45,6:00,,,0,32.9,32.9,0,-17889,45479,63368,27590,0,0,0,0,0,,0,0
5,01/27/2018,25,6:00,6:15,,32.65,0,32.65,32.65,-1,-13427,92329,105756,78902,0,-112,0,0,0,,112,-112
5,01/27/2018,26,6:15,6:30,,33.65,0,33.65,33.65,-1,-18597,68049,86646,49452,0,-215,0,0,0,,215,-215
5,01/27/2018,27,6:30,6:45,,,0,32.75,32.75,0,-16595,47248,63843,30653,0,0,0,0,0,,0,0
5,01/27/2018,28,6:45,7:00,,,0,32.78,32.78,0,-21776,41715,63491,19939,0,0,0,0,0,,0,0
5,01/27/2018,29,7:00,7:15,,4.64,0,4.64,4.64,-1,-68142,121904,190046,53762,0,-19198,0,0,0,,19198,-19198
5,01/27/2018,30,7:15,7:30,,25.3,0,25.3,25.3,-1,-66596,93961,160557,27365,0,-31884,0,0,0,,31884,-31884
5,01/27/2018,31,7:30,7:45,36.88,25.3,0,36.88,36.88,1,-55856,59170,115026,3314,0,-2207,243,0,0,,2450,-1964
5,01/27/2018,32,7:45,8:00,35.65,,0,35.65,35.65,1,-57424,65803,123227,8379,0,0,519,0,0,,519,519
5,01/27/2018,33,8:00,8:15,35.65,,0,35.65,35.65,1,-117862,94016,211878,-23846,0,0,246,0,0,,246,246
5,01/27/2018,34,8:15,8:30,,,0,33.62,33.62,0,-75694,82186,157880,6492,0,0,0,0,0,,0,0
5,01/27/2018,35,8:30,8:45,37.33,,0,37.33,37.33,1,-69268,58447,127715,-10821,0,0,734,0,0,,734,734
5,01/27/2018,36,8:45,9:00,55.45,,0,55.45,55.45,1,-78144,44887,123031,-33257,0,0,12582,0,0,,12582,12582
5,01/27/2018,37,9:00,9:15,35.65,34.49,0,34.49,34.49,-1,-27560,103746,131306,76186,0,-166,6672,0,0,,6838,6506
5,01/27/2018,38,9:15,9:30,,34.49,0,34.49,34.49,-1,-41636,88622,130258,46986,0,-931,0,0,0,,931,-931
5,01/27/2018,39,9:30,9:45,,,0,33.68,33.68,0,-35746,64365,100111,28619,0,-5,0,0,0,,5,-5
5,01/27/2018,40,9:45,10:00,,,0,33.68,33.68,0,-26669,54708,81377,28039,0,0,0,0,0,,0,0
5,01/27/2018,41,10:00,10:15,,30.91,0,30.91,30.91,-1,-26580,68374,94954,41794,0,-1202,0,0,0,,1202,-1202
5,01/27/2018,42,10:15,10:30,,18.65,0,18.65,18.65,-1,-29161,68005,97166,38844,0,-19301,0,0,0,,19301,-19301
5,01/27/2018,43,10:30,10:45,,16.53,0,16.53,16.53,-1,-22639,65031,87670,42392,0,-34878,0,0,0,,34878,-34878
5,01/27/2018,44,10:45,11:00,,23.98,0,23.98,23.98,-1,-24071,84321,108392,60250,0,-33879,0,0,0,,33879,-33879
5,01/27/2018,45,11:00,11:15,49.93,30.82,0,49.93,49.93,1,-82007,56255,138262,-25752,0,-15956,3385,0,0,,19341,-12571
5,01/27/2018,46,11:15,11:30,37.02,,0,37.02,37.02,1,-51243,69860,121103,18617,0,0,6403,0,0,,6403,6403
5,01/27/2018,47,11:30,11:45,,,0,33.55,33.55,0,-38142,97239,135381,59097,0,0,9,0,0,,9,9
5,01/27/2018,48,11:45,12:00,,23.69,0,23.69,23.69,-1,-33850,112292,146142,78442,0,-5000,0,0,0,,5000,-5000
5,01/27/2018,49,12:00,12:15,39.65,23.53,0,39.65,23.53,2,-47200,40271,87471,-6929,0,-7620,1508,0,0,,9128,-6112
5,01/27/2018,50,12:15,12:30,,27.76,0,27.76,27.76,-1,-20586,67190,87776,46604,0,-3598,0,0,0,,3598,-3598
5,01/27/2018,51,12:30,12:45,,30.65,0,30.65,30.65,-1,-20165,109469,129634,89304,0,-2057,0,0,0,,2057,-2057
5,01/27/2018,52,12:45,13:00,,-150.03,0,-150.03,-150.03,-1,-17243,150854,168097,133611,0,-27926,0,0,0,,27926,-27926
5,01/27/2018,53,13:00,13:15,,-150.03,0,-150.03,-150.03,-1,-24613,142225,166838,117612,0,-58795,0,0,0,,58795,-58795
5,01/27/2018,54,13:15,13:30,,-0.17,0,-0.17,-0.17,-1,-20933,125629,146562,104696,0,-71289,0,0,0,,71289,-71289
5,01/27/2018,55,13:30,13:45,,-67.14,0,-67.14,-67.14,-1,-28815,164168,192983,135353,0,-70904,0,0,0,,70904,-70904
5,01/27/2018,56,13:45,14:00,,-67.54,0,-67.54,-67.54,-1,-47299,149736,197035,102437,0,-87780,0,0,0,,87780,-87780
5,01/27/2018,57,14:00,14:15,,-12.09,0,-12.09,-12.09,-1,-29827,105340,135167,75513,0,-61045,0,0,0,,61045,-61045
5,01/27/2018,58,14:15,14:30,,11.68,0,11.68,11.68,-1,-31962,105535,137497,73573,0,-3889,0,0,0,,3889,-3889
5,01/27/2018,59,14:30,14:45,,-161.29,0,-161.29,-161.29,-1,-37994,91413,129407,53419,0,-31775,0,0,0,,31775,-31775
5,01/27/2018,60,14:45,15:00,,-162.36,0,-162.36,-162.36,-1,-45816,107032,152848,61216,0,-37058,0,0,0,,37058,-37058
5,01/27/2018,61,15:00,15:15,38.4,28.65,0,38.4,38.4,1,-69190,60779,129969,-8411,0,-13395,411,0,0,,13806,-12984
5,01/27/2018,62,15:15,15:30,39.65,28.65,0,39.65,39.65,1,-54984,73367,128351,18383,0,-108,1735,0,0,,1843,1627
5,01/27/2018,63,15:30,15:45,,,0,33.26,33.26,0,-54067,87831,141898,33764,0,0,37,0,0,,37,37
5,01/27/2018,64,15:45,16:00,,,0,33.26,33.26,0,-48271,95288,143559,47017,0,0,0,0,0,,0,0
5,01/27/2018,65,16:00,16:15,,,0,33.26,33.26,0,-50897,101311,152208,50414,0,0,0,0,0,,0,0
5,01/27/2018,66,16:15,16:30,,,0,33.26,33.26,0,-38919,89805,128724,50886,0,0,0,0,0,,0,0
5,01/27/2018,67,16:30,16:45,,,0,33.27,33.27,0,-36296,90852,127148,54556,0,0,0,0,0,,0,0
5,01/27/2018,68,16:45,17:00,,,0,33.27,33.27,0,-44165,90774,134939,46609,0,0,0,0,0,,0,0
5,01/27/2018,69,17:00,17:15,,-2.43,0,-2.43,-2.43,-1,-73167,113230,186397,40063,0,-12242,0,0,0,,12242,-12242
5,01/27/2018,70,17:15,17:30,,-2.43,0,-2.43,-2.43,-1,-74414,52946,127360,-21468,0,-21918,0,0,0,,21918,-21918
5,01/27/2018,71,17:30,17:45,35.65,-2.43,0,35.65,35.65,1,-71559,48470,120029,-23089,0,-134,293,0,0,,427,159
5,01/27/2018,72,17:45,18:00,35.65,,0,35.65,35.65,1,-54810,57055,111865,2245,0,0,385,0,0,,385,385
5,01/27/2018,73,18:00,18:15,39.65,,0,39.65,39.65,1,-68916,41776,110692,-27140,0,0,695,0,0,,695,695
5,01/27/2018,74,18:15,18:30,,,0,34.4,34.4,0,-50377,63220,113597,12843,0,0,0,0,0,,0,0
5,01/27/2018,75,18:30,18:45,,32.65,0,32.65,32.65,-1,-62259,91938,154197,29679,0,-236,0,0,0,,236,-236
5,01/27/2018,76,18:45,19:00,,32.33,0,32.33,32.33,-1,-49044,116855,165899,67811,0,-656,0,0,0,,656,-656
5,01/27/2018,77,19:00,19:15,,,0,33.55,33.55,0,-47968,57116,105084,9148,0,0,0,0,0,,0,0
5,01/27/2018,78,19:15,19:30,,,0,33.55,33.55,0,-42133,87509,129642,45376,0,0,0,0,0,,0,0
5,01/27/2018,79,19:30,19:45,,22.92,0,22.92,22.92,-1,-49698,117515,167213,67817,0,-4240,0,0,0,,4240,-4240
5,01/27/2018,80,19:45,20:00,,10.71,0,10.71,10.71,-1,-65247,112231,177478,46984,0,-24149,0,0,0,,24149,-24149
5,01/27/2018,81,20:00,20:15,,28.65,0,28.65,28.65,-1,-23485,69501,92986,46016,0,-17430,0,0,0,,17430,-17430
5,01/27/2018,82,20:15,20:30,,29.13,0,29.13,29.13,-1,-39030,71388,110418,32358,0,-14045,0,0,0,,14045,-14045
5,01/27/2018,83,20:30,20:45,,-15.28,0,-15.28,-15.28,-1,-46912,97105,144017,50193,0,-30366,0,0,0,,30366,-30366
5,01/27/2018,84,20:45,21:00,,-0.28,0,-0.28,-0.28,-1,-68573,97331,165904,28758,0,-34837,0,0,0,,34837,-34837
5,01/27/2018,85,21:00,21:15,35.36,16.47,0,35.36,16.47,2,-42616,54951,97567,12335,0,-18340,47,0,0,,18387,-18293
5,01/27/2018,86,21:15,21:30,39.36,28.65,0,39.36,28.65,2,-49670,47810,97480,-1860,0,-1948,439,0,0,,2387,-1509
5,01/27/2018,87,21:30,21:45,,21.33,0,21.33,21.33,-1,-38247,72223,110470,33976,0,-21386,0,0,0,,21386,-21386
5,01/27/2018,88,21:45,22:00,,11.28,0,11.28,11.28,-1,-33220,93605,126825,60385,0,-29255,0,0,0,,29255,-29255
5,01/27/2018,89,22:00,22:15,,-1.61,0,-1.61,-1.61,-1,-21145,44818,65963,23673,0,-19326,0,0,0,,19326,-19326
5,01/27/2018,90,22:15,22:30,,26.82,0,26.82,26.82,-1,-23278,62459,85737,39181,0,-5460,0,0,0,,5460,-5460
5,01/27/2018,91,22:30,22:45,,15,0,15,15,-1,-14205,91443,105648,77238,0,-27970,0,0,0,,27970,-27970
5,01/27/2018,92,22:45,23:00,,-122.66,0,-122.66,-122.66,-1,-38761,90112,128873,51351,0,-50690,0,0,0,,50690,-50690
5,01/27/2018,93,23:00,23:15,34.38,30.83,0,34.38,34.38,1,-69508,55585,125093,-13923,0,-7951,725,0,0,,8676,-7226
5,01/27/2018,94,23:15,23:30,33.87,22.31,0,22.31,22.31,-1,-51879,65770,117649,13891,0,-3182,501,0,0,,3683,-2681
5,01/27/2018,95,23:30,23:45,,20.35,0,20.35,20.35,-1,-67614,74654,142268,7040,0,-15899,0,0,0,,15899,-15899
5,01/27/2018,96,23:45,0:00,,19.5,0,19.5,19.5,-1,-60881,93690,154571,32809,0,-21712,0,0,0,,21712,-21712
5,01/28/2018,1,0:00,0:15,,23.78,0,23.78,23.78,-1,-66324,92395,158719,26071,0,-17230,0,0,0,,17230,-17230
5,01/28/2018,2,0:15,0:30,,22.37,0,22.37,22.37,-1,-38596,75620,114216,37024,0,-11614,0,0,0,,11614,-11614
5,01/28/2018,3,0:30,0:45,,16.64,0,16.64,16.64,-1,-44860,84333,129193,39473,0,-21744,0,0,0,,21744,-21744
5,01/28/2018,4,0:45,1:00,,12.49,0,12.49,12.49,-1,-46182,100986,147168,54804,0,-53819,0,0,0,,53819,-53819
5,01/28/2018,5,1:00,1:15,,3.78,0,3.78,3.78,-1,-37202,92919,130121,55717,0,-35378,0,0,0,,35378,-35378
5,01/28/2018,6,1:15,1:30,,19.79,0,19.79,19.79,-1,-29831,99709,129540,69878,0,-7569,0,0,0,,7569,-7569
5,01/28/2018,7,1:30,1:45,,28.64,0,28.64,28.64,-1,-25318,109727,135045,84409,0,-16080,0,0,0,,16080,-16080
5,01/28/2018,8,1:45,2:00,,-80.86,0,-80.86,-80.86,-1,-30399,91829,122228,61430,0,-29327,0,0,0,,29327,-29327
5,01/28/2018,9,2:00,2:15,,27.78,0,27.78,27.78,-1,-31901,112871,144772,80970,0,-15310,0,0,0,,15310,-15310
5,01/28/2018,10,2:15,2:30,,-98.54,0,-98.54,-98.54,-1,-30415,118560,148975,88145,0,-15283,0,0,0,,15283,-15283
5,01/28/2018,11,2:30,2:45,,-74.21,0,-74.21,-74.21,-1,-35668,95596,131264,59928,0,-52783,0,0,0,,52783,-52783
5,01/28/2018,12,2:45,3:00,,-19.35,0,-19.35,-19.35,-1,-24079,104630,128709,80551,0,-57290,0,0,0,,57290,-57290
5,01/28/2018,13,3:00,3:15,,14.17,0,14.17,14.17,-1,-32122,93708,125830,61586,0,-56262,0,0,0,,56262,-56262
5,01/28/2018,14,3:15,3:30,,14.17,0,14.17,14.17,-1,-44186,102585,146771,58399,0,-54457,0,0,0,,54457,-54457
5,01/28/2018,15,3:30,3:45,,6.13,0,6.13,6.13,-1,-38524,106380,144904,67856,0,-62118,0,0,0,,62118,-62118
5,01/28/2018,16,3:45,4:00,,17.99,0,17.99,17.99,-1,-38635,100740,139375,62105,0,-59334,0,0,0,,59334,-59334
5,01/28/2018,17,4:00,4:15,,26.78,0,26.78,26.78,-1,-49782,115251,165033,65469,0,-34486,0,0,0,,34486,-34486
5,01/28/2018,18,4:15,4:30,,27.6,0,27.6,27.6,-1,-50695,114212,164907,63517,0,-24856,0,0,0,,24856,-24856
5,01/28/2018,19,4:30,4:45,,12.6,0,12.6,12.6,-1,-51242,105208,156450,53966,0,-33268,0,0,0,,33268,-33268
5,01/28/2018,20,4:45,5:00,,26.4,0,26.4,26.4,-1,-56897,85966,142863,29069,0,-35315,0,0,0,,35315,-35315
5,01/28/2018,21,5:00,5:15,,-0.65,0,-0.65,-0.65,-1,-33177,113321,146498,80144,0,-47334,0,0,0,,47334,-47334
5,01/28/2018,22,5:15,5:30,,6.4,0,6.4,6.4,-1,-35744,104275,140019,68531,0,-58371,0,0,0,,58371,-58371
5,01/28/2018,23,5:30,5:45,,3.37,0,3.37,3.37,-1,-47930,95365,143295,47435,0,-63950,0,0,0,,63950,-63950
5,01/28/2018,24,5:45,6:00,,17.12,0,17.12,17.12,-1,-50140,92325,142465,42185,0,-44408,0,0,0,,44408,-44408
5,01/28/2018,25,6:00,6:15,,20.19,0,20.19,20.19,-1,-39039,145954,184993,106915,0,-35153,0,0,0,,35153,-35153
5,01/28/2018,26,6:15,6:30,,,0,33.27,33.27,0,-40431,122756,163187,82325,0,-1402,0,0,0,,1402,-1402
5,01/28/2018,27,6:30,6:45,,,0,33.27,33.27,0,-38878,111464,150342,72586,0,0,0,0,0,,0,0
5,01/28/2018,28,6:45,7:00,,,0,33.27,33.27,0,-49941,107715,157656,57774,0,0,0,0,0,,0,0
5,01/28/2018,29,7:00,7:15,,11.25,0,11.25,11.25,-1,-42822,137831,180653,95009,0,-14938,0,0,0,,14938,-14938
5,01/28/2018,30,7:15,7:30,,30.25,0,30.25,30.25,-1,-46728,125753,172481,79025,0,-16164,0,0,0,,16164,-16164
5,01/28/2018,31,7:30,7:45,,,0,33.48,33.48,0,-54963,86434,141397,31471,0,-2292,0,0,0,,2292,-2292
5,01/28/2018,32,7:45,8:00,,19.52,0,19.52,19.52,-1,-70558,79102,149660,8544,0,-6351,0,0,0,,6351,-6351
5,01/28/2018,33,8:00,8:15,,18.92,0,18.92,18.92,-1,-46031,117631,163662,71600,0,-25887,0,0,0,,25887,-25887
5,01/28/2018,34,8:15,8:30,,29.78,0,29.78,29.78,-1,-48938,95632,144570,46694,0,-18166,0,0,0,,18166,-18166
5,01/28/2018,35,8:30,8:45,,,0,33.6,33.6,0,-52868,91511,144379,38643,0,-2319,0,0,0,,2319,-2319
5,01/28/2018,36,8:45,9:00,,,0,33.6,33.6,0,-73912,79409,153321,5497,0,0,0,0,0,,0,0
5,01/28/2018,37,9:00,9:15,,-102.74,0,-102.74,-102.74,-1,-35858,134856,170714,98998,0,-23686,0,0,0,,23686,-23686
5,01/28/2018,38,9:15,9:30,,32.6,0,32.6,32.6,-1,-55755,86357,142112,30602,0,-4836,0,0,0,,4836,-4836
5,01/28/2018,39,9:30,9:45,,32.6,0,32.6,32.6,-1,-59889,72745,132634,12856,0,-198,0,0,0,,198,-198
5,01/28/2018,40,9:45,10:00,,32.6,0,32.6,32.6,-1,-53801,64577,118378,10776,0,-340,0,0,0,,340,-340
5,01/28/2018,41,10:00,10:15,34.02,33.4,0,34.02,33.4,2,-75911,61389,137300,-14522,0,-119,688,0,0,,807,569
5,01/28/2018,42,10:15,10:30,34.02,-3.49,0,-3.49,-3.49,-1,-40708,78595,119303,37887,0,-8369,49,0,0,,8418,-8320
5,01/28/2018,43,10:30,10:45,,-14.84,0,-14.84,-14.84,-1,-34264,64784,99048,30520,0,-40132,0,0,0,,40132,-40132
5,01/28/2018,44,10:45,11:00,,-80.87,0,-80.87,-80.87,-1,-33558,103188,136746,69630,0,-37734,0,0,0,,37734,-37734
5,01/28/2018,45,11:00,11:15,,-94.9,0,-94.9,-94.9,-1,-66202,69375,135577,3173,0,-33904,0,0,0,,33904,-33904
5,01/28/2018,46,11:15,11:30,,7.35,0,7.35,7.35,-1,-50863,89667,140530,38804,0,-11625,0,0,0,,11625,-11625
5,01/28/2018,47,11:30,11:45,,25.11,0,25.11,25.11,-1,-58251,91459,149710,33208,0,-32267,0,0,0,,32267,-32267
5,01/28/2018,48,11:45,12:00,,28.6,0,28.6,28.6,-1,-69640,93410,163050,23770,0,-33526,0,0,0,,33526,-33526
5,01/28/2018,49,12:00,12:15,48.55,28.6,0,48.55,48.55,1,-60026,45067,105093,-14959,0,-8885,3570,0,0,,12455,-5315
5,01/28/2018,50,12:15,12:30,35.83,33.39,0,35.83,33.39,2,-55747,54925,110672,-822,0,-13,1719,0,0,,1732,1706
5,01/28/2018,51,12:30,12:45,,33.52,0,33.52,33.52,-1,-54413,70178,124591,15765,0,-172,0,0,0,,172,-172
5,01/28/2018,52,12:45,13:00,,26.59,0,26.59,26.59,-1,-48495,74907,123402,26412,0,-4063,0,0,0,,4063,-4063
5,01/28/2018,53,13:00,13:15,,24.83,0,24.83,24.83,-1,-30475,65472,95947,34997,0,-9480,0,0,0,,9480,-9480
5,01/28/2018,54,13:15,13:30,,30.36,0,30.36,30.36,-1,-29692,64889,94581,35197,0,-1827,0,0,0,,1827,-1827
5,01/28/2018,55,13:30,13:45,,25.52,0,25.52,25.52,-1,-28797,70405,99202,41608,0,-11201,0,0,0,,11201,-11201
5,01/28/2018,56,13:45,14:00,,25.44,0,25.44,25.44,-1,-38872,74977,113849,36105,0,-32162,0,0,0,,32162,-32162
5,01/28/2018,57,14:00,14:15,,28.78,0,28.78,28.78,-1,-52505,68936,121441,16431,0,-18887,0,0,0,,18887,-18887
5,01/28/2018,58,14:15,14:30,,32.34,0,32.34,32.34,-1,-46114,71472,117586,25358,0,-1529,0,0,0,,1529,-1529
5,01/28/2018,59,14:30,14:45,,28.78,0,28.78,28.78,-1,-48056,76460,124516,28404,0,-8071,0,0,0,,8071,-8071
5,01/28/2018,60,14:45,15:00,,20.82,0,20.82,20.82,-1,-50771,69291,120062,18520,0,-17813,0,0,0,,17813,-17813
5,01/28/2018,61,15:00,15:15,39.6,20.82,0,39.6,39.6,1,-80166,72496,152662,-7670,0,-3220,2800,0,0,,6020,-420
5,01/28/2018,62,15:15,15:30,34.05,,0,34.05,34.05,1,-50558,57268,107826,6710,0,0,2153,0,0,,2153,2153
5,01/28/2018,63,15:30,15:45,39.6,,0,39.6,39.6,1,-68804,52400,121204,-16404,0,0,5149,0,0,,5149,5149
5,01/28/2018,64,15:45,16:00,45.6,,0,45.6,45.6,1,-57442,55223,112665,-2219,0,0,16263,0,0,,16263,16263
5,01/28/2018,65,16:00,16:15,45.6,32.6,0,32.6,32.6,-1,-91203,119968,211171,28765,0,-1382,2115,0,0,,3497,733
5,01/28/2018,66,16:15,16:30,,34.37,0,34.37,34.37,-1,-73780,111955,185735,38175,0,-1440,0,0,0,,1440,-1440
5,01/28/2018,67,16:30,16:45,,,0,34.12,34.12,0,-64003,101592,165595,37589,0,-50,0,0,0,,50,-50
5,01/28/2018,68,16:45,17:00,,34.79,0,34.79,34.79,-1,-74062,122672,196734,48610,0,-25,0,0,0,,25,-25
5,01/28/2018,69,17:00,17:15,,-150.78,0,-150.78,-150.78,-1,-70694,188105,258799,117411,0,-33944,0,0,0,,33944,-33944
5,01/28/2018,70,17:15,17:30,,10.78,0,10.78,10.78,-1,-54454,100383,154837,45929,0,-29428,0,0,0,,29428,-29428
5,01/28/2018,71,17:30,17:45,,29.79,0,29.79,29.79,-1,-51640,69151,120791,17511,0,-8251,0,0,0,,8251,-8251
5,01/28/2018,72,17:45,18:00,39.6,29.79,0,39.6,39.6,1,-76661,84934,161595,8273,0,-493,997,0,0,,1490,504
5,01/28/2018,73,18:00,18:15,39.6,,0,39.6,39.6,1,-81500,62745,144245,-18755,0,0,1223,0,0,,1223,1223
5,01/28/2018,74,18:15,18:30,,,0,34.49,34.49,0,-38778,81357,120135,42579,0,0,0,0,0,,0,0
5,01/28/2018,75,18:30,18:45,,,0,34.49,34.49,0,-44258,80850,125108,36592,0,0,0,0,0,,0,0
5,01/28/2018,76,18:45,19:00,,,0,34.49,34.49,0,-44497,93400,137897,48903,0,0,0,0,0,,0,0
5,01/28/2018,77,19:00,19:15,,32.6,0,32.6,32.6,-1,-47580,73837,121417,26257,0,-51,0,0,0,,51,-51
5,01/28/2018,78,19:15,19:30,,9.02,0,9.02,9.02,-1,-41580,96325,137905,54745,0,-8676,0,0,0,,8676,-8676
5,01/28/2018,79,19:30,19:45,,9.98,0,9.98,9.98,-1,-68563,102625,171188,34062,0,-29675,0,0,0,,29675,-29675
5,01/28/2018,80,19:45,20:00,,28.6,0,28.6,28.6,-1,-65813,105239,171052,39426,0,-23396,0,0,0,,23396,-23396
5,01/28/2018,81,20:00,20:15,,28.6,0,28.6,28.6,-1,-50538,70347,120885,19809,0,-14329,0,0,0,,14329,-14329
5,01/28/2018,82,20:15,20:30,,17.75,0,17.75,17.75,-1,-52098,84987,137085,32889,0,-7010,0,0,0,,7010,-7010
5,01/28/2018,83,20:30,20:45,,3.2,0,3.2,3.2,-1,-53162,91428,144590,38266,0,-29061,0,0,0,,29061,-29061
5,01/28/2018,84,20:45,21:00,,6.19,0,6.19,6.19,-1,-76105,117581,193686,41476,0,-44259,0,0,0,,44259,-44259
5,01/28/2018,85,21:00,21:15,,-5.11,0,-5.11,-5.11,-1,-52726,106743,159469,54017,0,-45192,0,0,0,,45192,-45192
5,01/28/2018,86,21:15,21:30,,1.44,0,1.44,1.44,-1,-51322,83887,135209,32565,0,-9073,0,0,0,,9073,-9073
5,01/28/2018,87,21:30,21:45,,-17.6,0,-17.6,-17.6,-1,-63233,75580,138813,12347,0,-23342,0,0,0,,23342,-23342
5,01/28/2018,88,21:45,22:00,,7.78,0,7.78,7.78,-1,-77697,126160,203857,48463,0,-19501,0,0,0,,19501,-19501
5,01/28/2018,89,22:00,22:15,33.27,27.21,0,33.27,33.27,1,-80386,61229,141615,-19157,0,-11790,4,0,0,,11794,-11786
5,01/28/2018,90,22:15,22:30,33.23,27.21,0,33.23,33.23,1,-70376,53346,123722,-17030,0,-41,458,0,0,,499,417
5,01/28/2018,91,22:30,22:45,,16.78,0,16.78,16.78,-1,-50544,86797,137341,36253,0,-17110,0,0,0,,17110,-17110
5,01/28/2018,92,22:45,23:00,,18.6,0,18.6,18.6,-1,-65986,105068,171054,39082,0,-35232,0,0,0,,35232,-35232
5,01/28/2018,93,23:00,23:15,34.75,22.01,0,34.75,22.01,2,-76392,69455,145847,-6937,0,-20010,168,0,0,,20178,-19842
5,01/28/2018,94,23:15,23:30,35.6,14.9,0,35.6,14.9,2,-53497,72318,125815,18821,0,-2696,356,0,0,,3052,-2340
5,01/28/2018,95,23:30,23:45,,-10.78,0,-10.78,-10.78,-1,-44501,86058,130559,41557,0,-32393,0,0,0,,32393,-32393
5,01/28/2018,96,23:45,0:00,,-76.28,0,-76.28,-76.28,-1,-58430,126092,184522,67662,0,-53130,0,0,0,,53130,-53130
5,01/29/2018,1,0:00,0:15,,-19.35,0,-19.35,-19.35,-1,-49126,106788,155914,57662,0,-22361,0,0,0,,22361,-22361
5,01/29/2018,2,0:15,0:30,,-13.84,0,-13.84,-13.84,-1,-62667,103387,166054,40720,0,-1818,0,0,0,,1818,-1818
5,01/29/2018,3,0:30,0:45,,-20.03,0,-20.03,-20.03,-1,-78964,78740,157704,-224,0,-14865,0,0,0,,14865,-14865
5,01/29/2018,4,0:45,1:00,,-17.71,0,-17.71,-17.71,-1,-68486,118075,186561,49589,0,-15167,0,0,0,,15167,-15167
5,01/29/2018,5,1:00,1:15,,13.03,0,13.03,13.03,-1,-68023,76795,144818,8772,0,-12663,0,0,0,,12663,-12663
5,01/29/2018,6,1:15,1:30,,,0,33.24,33.24,0,-55187,86260,141447,31073,0,-52,0,0,0,,52,-52
5,01/29/2018,7,1:30,1:45,,,0,33.23,33.23,0,-50174,98765,148939,48591,0,0,0,0,0,,0,0
5,01/29/2018,8,1:45,2:00,,-15.8,0,-15.8,-15.8,-1,-41879,114565,156444,72686,0,-6752,0,0,0,,6752,-6752
5,01/29/2018,9,2:00,2:15,,25.4,0,25.4,25.4,-1,-46445,81185,127630,34740,0,-4761,0,0,0,,4761,-4761
5,01/29/2018,10,2:15,2:30,,,0,33.25,33.25,0,-40074,94502,134576,54428,0,0,0,0,0,,0,0
5,01/29/2018,11,2:30,2:45,,,0,33.25,33.25,0,-39196,94274,133470,55078,0,0,0,0,0,,0,0
5,01/29/2018,12,2:45,3:00,,-74.02,0,-74.02,-74.02,-1,-43694,94262,137956,50568,0,-12945,0,0,0,,12945,-12945
5,01/29/2018,13,3:00,3:15,,17.03,0,17.03,17.03,-1,-30786,95302,126088,64516,0,-12039,0,0,0,,12039,-12039
5,01/29/2018,14,3:15,3:30,,,0,32.47,32.47,0,-27226,114004,141230,86778,0,-329,0,0,0,,329,-329
5,01/29/2018,15,3:30,3:45,,,0,31.96,31.96,0,-22310,121524,143834,99214,0,0,0,0,0,,0,0
5,01/29/2018,16,3:45,4:00,,,0,31.96,31.96,0,-18117,127405,145522,109288,0,0,0,0,0,,0,0
5,01/29/2018,17,4:00,4:15,,24.03,0,24.03,24.03,-1,-30271,137929,168200,107658,0,-1022,0,0,0,,1022,-1022
5,01/29/2018,18,4:15,4:30,,26.3,0,26.3,26.3,-1,-33162,117235,150397,84073,0,-422,0,0,0,,422,-422
5,01/29/2018,19,4:30,4:45,,26.33,0,26.33,26.33,-1,-29669,101882,131551,72213,0,-412,0,0,0,,412,-412
5,01/29/2018,20,4:45,5:00,,,0,32.09,32.09,0,-35886,109323,145209,73437,0,0,0,0,0,,0,0
5,01/29/2018,21,5:00,5:15,,25.03,0,25.03,25.03,-1,-51405,142291,193696,90886,0,-1708,0,0,0,,1708,-1708
5,01/29/2018,22,5:15,5:30,,33.6,0,33.6,33.6,-1,-45231,133989,179220,88758,0,-35,0,0,0,,35,-35
5,01/29/2018,23,5:30,5:45,,,0,33.28,33.28,0,-42523,100621,143144,58098,0,0,0,0,0,,0,0
5,01/29/2018,24,5:45,6:00,,,0,33.3,33.3,0,-46886,106081,152967,59195,0,0,0,0,0,,0,0
5,01/29/2018,25,6:00,6:15,,-150.03,0,-150.03,-150.03,-1,-37937,158636,196573,120699,0,-21815,0,0,0,,21815,-21815
5,01/29/2018,26,6:15,6:30,,24.54,0,24.54,24.54,-1,-39735,117772,157507,78037,0,-6579,0,0,0,,6579,-6579
5,01/29/2018,27,6:30,6:45,,28.15,0,28.15,28.15,-1,-42952,91763,134715,48811,0,-2296,0,0,0,,2296,-2296
5,01/29/2018,28,6:45,7:00,,,0,33.31,33.31,0,-73071,120887,193958,47816,0,-29,0,0,0,,29,-29
5,01/29/2018,29,7:00,7:15,,31.87,0,31.87,31.87,-1,-129565,188319,317884,58754,0,-1290,0,0,0,,1290,-1290
5,01/29/2018,30,7:15,7:30,,16.15,0,16.15,16.15,-1,-43703,115835,159538,72132,0,-7444,0,0,0,,7444,-7444
5,01/29/2018,31,7:30,7:45,,,0,33.32,33.32,0,-55562,80644,136206,25082,0,-596,0,0,0,,596,-596
5,01/29/2018,32,7:45,8:00,,,0,33.32,33.32,0,-79406,76651,156057,-2755,0,0,0,0,0,,0,0
5,01/29/2018,33,8:00,8:15,,31.2,0,31.2,31.2,-1,-65688,70092,135780,4404,0,-826,0,0,0,,826,-826
5,01/29/2018,34,8:15,8:30,,10.27,0,10.27,10.27,-1,-51685,86956,138641,35271,0,-16498,0,0,0,,16498,-16498
5,01/29/2018,35,8:30,8:45,,26.22,0,26.22,26.22,-1,-58555,85545,144100,26990,0,-6016,0,0,0,,6016,-6016
5,01/29/2018,36,8:45,9:00,,30.56,0,30.56,30.56,-1,-73143,82328,155471,9185,0,-4570,0,0,0,,4570,-4570
5,01/29/2018,37,9:00,9:15,,28.91,0,28.91,28.91,-1,-54575,76056,130631,21481,0,-1914,0,0,0,,1914,-1914
5,01/29/2018,38,9:15,9:30,,27.03,0,27.03,27.03,-1,-64659,58958,123617,-5701,0,-3757,0,0,0,,3757,-3757
5,01/29/2018,39,9:30,9:45,33.16,30.9,0,33.16,30.9,2,-60144,64298,124442,4154,0,-384,58,0,0,,442,-326
5,01/29/2018,40,9:45,10:00,,28.94,0,28.94,28.94,-1,-65323,76184,141507,10861,0,-5526,0,0,0,,5526,-5526
5,01/29/2018,41,10:00,10:15,,28.07,0,28.07,28.07,-1,-67913,85671,153584,17758,0,-3031,0,0,0,,3031,-3031
5,01/29/2018,42,10:15,10:30,,28.03,0,28.03,28.03,-1,-74966,87561,162527,12595,0,-5522,0,0,0,,5522,-5522
5,01/29/2018,43,10:30,10:45,,31.04,0,31.04,31.04,-1,-82855,95139,177994,12284,0,-2888,0,0,0,,2888,-2888
5,01/29/2018,44,10:45,11:00,,32.36,0,32.36,32.36,-1,-89295,95479,184774,6184,0,-1676,0,0,0,,1676,-1676
5,01/29/2018,45,11:00,11:15,36.09,32.36,0,36.09,36.09,1,-80537,84803,165340,4266,0,-16,349,0,0,,365,333
5,01/29/2018,46,11:15,11:30,,33.09,0,33.09,33.09,-1,-76534,89232,165766,12698,0,-146,0,0,0,,146,-146
5,01/29/2018,47,11:30,11:45,34.02,33.1,0,34.02,34.02,1,-84937,85650,170587,713,0,-97,299,0,0,,396,202
5,01/29/2018,48,11:45,12:00,34.37,,0,34.37,34.37,1,-81191,89016,170207,7825,0,0,2346,0,0,,2346,2346
5,01/29/2018,49,12:00,12:15,33.87,,0,33.87,33.87,1,-72361,70055,142416,-2306,0,0,1669,0,0,,1669,1669
5,01/29/2018,50,12:15,12:30,33.87,28.94,0,28.94,28.94,-1,-67686,78395,146081,10709,0,-461,40,0,0,,501,-421
5,01/29/2018,51,12:30,12:45,,23.24,0,23.24,23.24,-1,-73979,76072,150051,2093,0,-4382,0,0,0,,4382,-4382
5,01/29/2018,52,12:45,13:00,,30.99,0,30.99,30.99,-1,-68061,78222,146283,10161,0,-1577,0,0,0,,1577,-1577
5,01/29/2018,53,13:00,13:15,,29.1,0,29.1,29.1,-1,-62533,74838,137371,12305,0,-3576,0,0,0,,3576,-3576
5,01/29/2018,54,13:15,13:30,45.13,33.09,0,45.13,45.13,1,-77428,63014,140442,-14414,0,-431,2539,0,0,,2970,2108
5,01/29/2018,55,13:30,13:45,34.07,19.03,0,34.07,19.03,2,-58235,74552,132787,16317,0,-4029,2031,0,0,,6060,-1998
5,01/29/2018,56,13:45,14:00,,19.61,0,19.61,19.61,-1,-73919,83042,156961,9123,0,-10844,0,0,0,,10844,-10844
5,01/29/2018,57,14:00,14:15,,29.03,0,29.03,29.03,-1,-90164,101556,191720,11392,0,-15876,0,0,0,,15876,-15876
5,01/29/2018,58,14:15,14:30,,32.37,0,32.37,32.37,-1,-98886,97168,196054,-1718,0,-4084,0,0,0,,4084,-4084
5,01/29/2018,59,14:30,14:45,,26.46,0,26.46,26.46,-1,-91662,107251,198913,15589,0,-926,0,0,0,,926,-926
5,01/29/2018,60,14:45,15:00,,26.14,0,26.14,26.14,-1,-97916,97142,195058,-774,0,-6068,0,0,0,,6068,-6068
5,01/29/2018,61,15:00,15:15,,,0,33.1,33.1,0,-88120,121369,209489,33249,0,-1000,0,0,0,,1000,-1000
5,01/29/2018,62,15:15,15:30,,,0,33.09,33.09,0,-83793,106921,190714,23128,0,0,0,0,0,,0,0
5,01/29/2018,63,15:30,15:45,37.39,,0,37.39,37.39,1,-82567,83805,166372,1238,0,0,461,0,0,,461,461
5,01/29/2018,64,15:45,16:00,52.37,,0,52.37,52.37,1,-77171,62195,139366,-14976,0,0,14612,0,0,,14612,14612
5,01/29/2018,65,16:00,16:15,33.4,-26.23,0,33.4,-26.23,2,-66067,110671,176738,44604,0,-11673,4879,0,0,,16552,-6794
5,01/29/2018,66,16:15,16:30,,24.84,0,24.84,24.84,-1,-72002,89814,161816,17812,0,-11481,0,0,0,,11481,-11481
5,01/29/2018,67,16:30,16:45,,29.92,0,29.92,29.92,-1,-61532,79867,141399,18335,0,-18666,0,0,0,,18666,-18666
5,01/29/2018,68,16:45,17:00,,22.96,0,22.96,22.96,-1,-47938,73414,121352,25476,0,-18137,0,0,0,,18137,-18137
5,01/29/2018,69,17:00,17:15,,-99.44,0,-99.44,-99.44,-1,-99810,136778,236588,36968,0,-33726,0,0,0,,33726,-33726
5,01/29/2018,70,17:15,17:30,44.84,-99.44,0,44.84,44.84,1,-96072,91709,187781,-4363,0,-3663,1257,0,0,,4920,-2406
5,01/29/2018,71,17:30,17:45,238.02,,0,238.02,238.02,1,-105810,54010,159820,-51800,0,0,45697,0,0,,45697,45697
5,01/29/2018,72,17:45,18:00,238.02,,0,238.02,238.02,1,-120077,74111,194188,-45966,0,0,78077,0,0,,78077,78077
5,01/29/2018,73,18:00,18:15,256.02,31.48,0,256.02,31.48,2,-85109,59729,144838,-25380,0,-86,53901,0,0,,53987,53815
5,01/29/2018,74,18:15,18:30,35.16,28.47,0,35.16,28.47,2,-68272,81281,149553,13009,0,-881,1372,0,0,,2253,491
5,01/29/2018,75,18:30,18:45,37.14,,0,37.14,37.14,1,-62040,62788,124828,748,0,0,1677,0,0,,1677,1677
5,01/29/2018,76,18:45,19:00,35.7,,0,35.7,35.7,1,-68762,63996,132758,-4766,0,0,1119,0,0,,1119,1119
5,01/29/2018,77,19:00,19:15,35.51,24.7,0,35.51,24.7,2,-67383,82422,149805,15039,0,-4095,1434,0,0,,5529,-2661
5,01/29/2018,78,19:15,19:30,,30.5,0,30.5,30.5,-1,-60629,69065,129694,8436,0,-9870,0,0,0,,9870,-9870
5,01/29/2018,79,19:30,19:45,,31.48,0,31.48,31.48,-1,-70748,83884,154632,13136,0,-2646,0,0,0,,2646,-2646
5,01/29/2018,80,19:45,20:00,,22.81,0,22.81,22.81,-1,-72783,92134,164917,19351,0,-9146,0,0,0,,9146,-9146
5,01/29/2018,81,20:00,20:15,53.33,32.41,0,53.33,32.41,2,-99879,70696,170575,-29183,0,-3856,4134,0,0,,7990,278
5,01/29/2018,82,20:15,20:30,33.87,,0,33.87,33.87,1,-63769,34672,98441,-29097,0,0,1133,0,0,,1133,1133
5,01/29/2018,83,20:30,20:45,44.63,,0,44.63,44.63,1,-75381,39048,114429,-36333,0,0,7644,0,0,,7644,7644
5,01/29/2018,84,20:45,21:00,,,0,33.52,33.52,0,-59098,54119,113217,-4979,0,0,421,0,0,,421,421
5,01/29/2018,85,21:00,21:15,105.02,30.31,0,105.02,105.02,1,-94912,57316,152228,-37596,0,-80,8598,0,0,,8678,8518
5,01/29/2018,86,21:15,21:30,113.02,31.14,0,31.14,31.14,-1,-56249,47725,103974,-8524,0,-63,19977,0,0,,20040,19914
5,01/29/2018,87,21:30,21:45,113.02,18.59,0,18.59,18.59,-1,-39342,66611,105953,27269,0,-10647,1104,0,0,,11751,-9543
5,01/29/2018,88,21:45,22:00,,20.08,0,20.08,20.08,-1,-57767,80120,137887,22353,0,-7817,0,0,0,,7817,-7817
5,01/29/2018,89,22:00,22:15,37.48,2.71,0,37.48,37.48,1,-95111,54918,150029,-40193,0,-9248,122,0,0,,9370,-9126
5,01/29/2018,90,22:15,22:30,42.58,2.71,0,42.58,42.58,1,-78707,31623,110330,-47084,0,-67,2824,0,0,,2891,2757
5,01/29/2018,91,22:30,22:45,40.01,,0,40.01,40.01,1,-60950,45082,106032,-15868,0,0,2169,0,0,,2169,2169
5,01/29/2018,92,22:45,23:00,33.48,21.87,0,21.87,21.87,-1,-61932,81377,143309,19445,0,-6471,1893,0,0,,8364,-4578
5,01/29/2018,93,23:00,23:15,300.02,7.03,0,300.02,7.03,2,-95483,38486,133969,-56997,0,-8056,14123,0,0,,22179,6067
5,01/29/2018,94,23:15,23:30,49.31,4.69,0,4.69,4.69,-1,-30703,52415,83118,21712,0,-1861,11515,0,0,,13376,9654
5,01/29/2018,95,23:30,23:45,,-64.13,0,-64.13,-64.13,-1,-25679,65805,91484,40126,0,-21811,0,0,0,,21811,-21811
5,01/29/2018,96,23:45,0:00,,-35.03,0,-35.03,-35.03,-1,-53342,85301,138643,31959,0,-34922,0,0,0,,34922,-34922
5,01/30/2018,1,0:00,0:15,35.97,26.78,0,35.97,35.97,1,-42972,46788,89760,3816,0,-12334,50,0,0,,12384,-12284
5,01/30/2018,2,0:15,0:30,42.75,26.78,0,42.75,42.75,1,-46785,39624,86409,-7161,0,-525,2071,0,0,,2596,1546
5,01/30/2018,3,0:30,0:45,55.13,,0,55.13,55.13,1,-57543,44076,101619,-13467,0,0,8520,0,0,,8520,8520
5,01/30/2018,4,0:45,1:00,32.85,31.92,0,31.92,31.92,-1,-53624,61938,115562,8314,0,-328,2009,0,0,,2337,1681
5,01/30/2018,5,1:00,1:15,139.12,28.78,0,139.12,28.78,2,-60948,25569,86517,-35379,0,-1041,9482,0,0,,10523,8441
5,01/30/2018,6,1:15,1:30,141.12,,0,141.12,141.12,1,-58419,31053,89472,-27366,0,0,30118,0,0,,30118,30118
5,01/30/2018,7,1:30,1:45,54.2,,0,54.2,54.2,1,-67924,46030,113954,-21894,0,0,20512,0,0,,20512,20512
5,01/30/2018,8,1:45,2:00,47.98,,0,47.98,47.98,1,-68703,49099,117802,-19604,0,0,18857,0,0,,18857,18857
5,01/30/2018,9,2:00,2:15,68.52,,0,68.52,68.52,1,-77933,43592,121525,-34341,0,0,22113,0,0,,22113,22113
5,01/30/2018,10,2:15,2:30,79.04,,0,79.04,79.04,1,-83556,42635,126191,-40921,0,0,37237,0,0,,37237,37237
5,01/30/2018,11,2:30,2:45,56.12,,0,56.12,56.12,1,-75129,52131,127260,-22998,0,0,29793,0,0,,29793,29793
5,01/30/2018,12,2:45,3:00,43.72,29.48,0,29.48,29.48,-1,-56934,60568,117502,3634,0,-312,12642,0,0,,12954,12330
5,01/30/2018,13,3:00,3:15,43.72,3.78,0,3.78,3.78,-1,-35255,56219,91474,20964,0,-13763,282,0,0,,14045,-13481
5,01/30/2018,14,3:15,3:30,49.54,18.24,0,49.54,18.24,2,-31950,45661,77611,13711,0,-1514,3316,0,0,,4830,1802
5,01/30/2018,15,3:30,3:45,,-5.54,0,-5.54,-5.54,-1,-30573,40588,71161,10015,0,-13337,0,0,0,,13337,-13337
5,01/30/2018,16,3:45,4:00,,4.7,0,4.7,4.7,-1,-26819,49509,76328,22690,0,-9123,0,0,0,,9123,-9123
5,01/30/2018,17,4:00,4:15,,26.78,0,26.78,26.78,-1,-39585,63790,103375,24205,0,-11366,0,0,0,,11366,-11366
5,01/30/2018,18,4:15,4:30,43.03,21.6,0,43.03,21.6,2,-45408,43138,88546,-2270,0,-5334,661,0,0,,5995,-4673
5,01/30/2018,19,4:30,4:45,56.56,21.6,0,56.56,56.56,1,-57702,35010,92712,-22692,0,-98,13860,0,0,,13958,13762
5,01/30/2018,20,4:45,5:00,49.07,,0,49.07,49.07,1,-45423,30879,76302,-14544,0,0,15988,0,0,,15988,15988
5,01/30/2018,21,5:00,5:15,49.07,-82.78,0,-82.78,-82.78,-1,-30113,86597,116710,56484,0,-21572,4572,0,0,,26144,-17000
5,01/30/2018,22,5:15,5:30,,25.6,0,25.6,25.6,-1,-34782,57373,92155,22591,0,-19665,0,0,0,,19665,-19665
5,01/30/2018,23,5:30,5:45,38.23,29.78,0,38.23,29.78,2,-48401,42994,91395,-5407,0,-8172,1429,0,0,,9601,-6743
5,01/30/2018,24,5:45,6:00,38.23,27.39,0,27.39,27.39,-1,-64275,73141,137416,8866,0,-3777,56,0,0,,3833,-3721
5,01/30/2018,25,6:00,6:15,,24.58,0,24.58,24.58,-1,-22009,82028,104037,60019,0,-10587,0,0,0,,10587,-10587
5,01/30/2018,26,6:15,6:30,36.48,30.49,0,36.48,36.48,1,-39587,49921,89508,10334,0,-4353,216,0,0,,4569,-4137
5,01/30/2018,27,6:30,6:45,56.67,30.49,0,56.67,56.67,1,-73814,39737,113551,-34077,0,-128,9577,0,0,,9705,9449
5,01/30/2018,28,6:45,7:00,65.45,,0,65.45,65.45,1,-50519,75156,125675,24637,0,0,18965,0,0,,18965,18965
5,01/30/2018,29,7:00,7:15,65.45,-150.78,0,-150.78,-150.78,-1,-63854,99042,162896,35188,0,-23172,2259,0,0,,25431,-20913
5,01/30/2018,30,7:15,7:30,146.12,-150.78,0,146.12,146.12,1,-95775,40765,136540,-55010,0,-2277,12979,0,0,,15256,10702
5,01/30/2018,31,7:30,7:45,292.12,,0,292.12,292.12,1,-119516,56018,175534,-63498,0,0,48932,0,0,,48932,48932
5,01/30/2018,32,7:45,8:00,313.12,,0,313.12,313.12,1,-160002,73393,233395,-86609,0,0,58596,0,0,,58596,58596
5,01/30/2018,33,8:00,8:15,36.57,31.08,0,36.57,31.08,2,-78808,92635,171443,13827,0,-88,19610,0,0,,19698,19522
5,01/30/2018,34,8:15,8:30,,,0,33.55,33.55,0,-87278,57758,145036,-29520,0,0,0,0,0,,0,0
5,01/30/2018,35,8:30,8:45,,,0,33.55,33.55,0,-94443,54940,149383,-39503,0,0,0,0,0,,0,0
5,01/30/2018,36,8:45,9:00,36.03,,0,36.03,36.03,1,-91868,62595,154463,-29273,0,0,251,0,0,,251,251
5,01/30/2018,37,9:00,9:15,35.55,,0,35.55,35.55,1,-33906,75024,108930,41118,0,0,1075,0,0,,1075,1075
5,01/30/2018,38,9:15,9:30,,26.67,0,26.67,26.67,-1,-28084,79131,107215,51047,0,-1401,0,0,0,,1401,-1401
5,01/30/2018,39,9:30,9:45,,25.61,0,25.61,25.61,-1,-28217,84855,113072,56638,0,-3624,0,0,0,,3624,-3624
5,01/30/2018,40,9:45,10:00,,21.49,0,21.49,21.49,-1,-37092,83283,120375,46191,0,-5258,0,0,0,,5258,-5258
5,01/30/2018,41,10:00,10:15,,32.2,0,32.2,32.2,-1,-61813,78063,139876,16250,0,-511,0,0,0,,511,-511
5,01/30/2018,42,10:15,10:30,,32.07,0,32.07,32.07,-1,-46083,74450,120533,28367,0,-2784,0,0,0,,2784,-2784
5,01/30/2018,43,10:30,10:45,,27.78,0,27.78,27.78,-1,-59304,80520,139824,21216,0,-6587,0,0,0,,6587,-6587
5,01/30/2018,44,10:45,11:00,,25.38,0,25.38,25.38,-1,-65708,83297,149005,17589,0,-15548,0,0,0,,15548,-15548
5,01/30/2018,45,11:00,11:15,72.81,32.6,0,72.81,32.6,2,-87142,51612,138754,-35530,0,-7746,4053,0,0,,11799,-3693
5,01/30/2018,46,11:15,11:30,72.81,6.52,0,6.52,6.52,-1,-31873,61245,93118,29372,0,-13567,171,0,0,,13738,-13396
5,01/30/2018,47,11:30,11:45,,13.14,0,13.14,13.14,-1,-40123,58482,98605,18359,0,-14613,0,0,0,,14613,-14613
5,01/30/2018,48,11:45,12:00,33.55,14.4,0,34.29,14.4,2,-67030,69684,136714,2654,0,-14628,65,0,0,,14693,-14563
5,01/30/2018,49,12:00,12:15,,12.06,0,12.06,12.06,-1,-50527,74433,124960,23906,0,-14961,0,0,0,,14961,-14961
5,01/30/2018,50,12:15,12:30,,19,0,19,19,-1,-68774,85216,153990,16442,0,-20901,0,0,0,,20901,-20901
5,01/30/2018,51,12:30,12:45,,12.7,0,12.7,12.7,-1,-66611,110401,177012,43790,0,-41529,0,0,0,,41529,-41529
5,01/30/2018,52,12:45,13:00,,18.23,0,18.23,18.23,-1,-66694,105140,171834,38446,0,-42587,0,0,0,,42587,-42587
5,01/30/2018,53,13:00,13:15,,23.78,0,23.78,23.78,-1,-72090,94775,166865,22685,0,-33222,0,0,0,,33222,-33222
5,01/30/2018,54,13:15,13:30,,28.78,0,28.78,28.78,-1,-54745,83922,138667,29177,0,-23071,0,0,0,,23071,-23071
5,01/30/2018,55,13:30,13:45,,13.83,0,13.83,13.83,-1,-45384,96096,141480,50712,0,-26991,0,0,0,,26991,-26991
5,01/30/2018,56,13:45,14:00,,13.78,0,13.78,13.78,-1,-59847,75150,134997,15303,0,-27391,0,0,0,,27391,-27391
5,01/30/2018,57,14:00,14:15,,18.44,0,18.44,18.44,-1,-51203,91595,142798,40392,0,-23009,0,0,0,,23009,-23009
5,01/30/2018,58,14:15,14:30,,31.21,0,31.21,31.21,-1,-62241,76668,138909,14427,0,-18451,0,0,0,,18451,-18451
5,01/30/2018,59,14:30,14:45,,31.84,0,31.84,31.84,-1,-63284,76750,140034,13466,0,-16567,0,0,0,,16567,-16567
5,01/30/2018,60,14:45,15:00,,14.83,0,14.83,14.83,-1,-76859,107427,184286,30568,0,-20280,0,0,0,,20280,-20280
5,01/30/2018,61,15:00,15:15,,15.32,0,15.32,15.32,-1,-42710,80728,123438,38018,0,-20306,0,0,0,,20306,-20306
5,01/30/2018,62,15:15,15:30,,,0,33.78,33.78,0,-37776,80121,117897,42345,0,-904,0,0,0,,904,-904
5,01/30/2018,63,15:30,15:45,36.22,,0,36.22,36.22,1,-41353,72484,113837,31131,0,0,35,0,0,,35,35
5,01/30/2018,64,15:45,16:00,43.03,,0,43.03,43.03,1,-53917,53518,107435,-399,0,0,1058,0,0,,1058,1058
5,01/30/2018,65,16:00,16:15,40.47,,0,40.47,40.47,1,-55672,71433,127105,15761,0,0,2751,0,0,,2751,2751
5,01/30/2018,66,16:15,16:30,,,0,33.76,33.76,0,-56961,69283,126244,12322,0,0,0,0,0,,0,0
5,01/30/2018,67,16:30,16:45,,,0,33.76,33.76,0,-71504,80729,152233,9225,0,0,0,0,0,,0,0
5,01/30/2018,68,16:45,17:00,32.54,,0,32.54,32.54,1,-76482,85031,161513,8549,0,0,246,0,0,,246,246
5,01/30/2018,69,17:00,17:15,32.54,-99.81,0,-99.81,-99.81,-1,-25113,129498,154611,104385,0,-30158,16,0,0,,30174,-30142
5,01/30/2018,70,17:15,17:30,,23.78,0,23.78,23.78,-1,-83651,95051,178702,11400,0,-20006,0,0,0,,20006,-20006
5,01/30/2018,71,17:30,17:45,45.12,23.78,0,45.12,45.12,1,-93341,83695,177036,-9646,0,-281,496,0,0,,777,215
5,01/30/2018,72,17:45,18:00,153.12,,0,153.12,153.12,1,-122854,88804,211658,-34050,0,0,33026,0,0,,33026,33026
5,01/30/2018,73,18:00,18:15,140.12,,0,140.12,140.12,1,-117531,59058,176589,-58473,0,0,35296,0,0,,35296,35296
5,01/30/2018,74,18:15,18:30,,,0,33.97,33.97,0,-78288,63757,142045,-14531,0,0,646,0,0,,646,646
5,01/30/2018,75,18:30,18:45,,30.74,0,30.74,30.74,-1,-77520,70229,147749,-7291,0,-302,0,0,0,,302,-302
5,01/30/2018,76,18:45,19:00,,35.15,0,35.15,35.15,-1,-87210,56228,143438,-30982,0,-250,0,0,0,,250,-250
5,01/30/2018,77,19:00,19:15,47,34.9,0,47,33.81,2,-105899,36486,142385,-69413,0,-35,896,0,0,,931,861
5,01/30/2018,78,19:15,19:30,,,0,33.8,33.8,0,-86876,73594,160470,-13282,0,0,0,0,0,,0,0
5,01/30/2018,79,19:30,19:45,,17,0,17,17,-1,-67710,86192,153902,18482,0,-11805,0,0,0,,11805,-11805
5,01/30/2018,80,19:45,20:00,,30.62,0,30.62,30.62,-1,-78804,83593,162397,4789,0,-13260,0,0,0,,13260,-13260
5,01/30/2018,81,20:00,20:15,47.81,32.43,0,47.81,32.43,2,-127779,37918,165697,-89861,0,-6870,1177,0,0,,8047,-5693
5,01/30/2018,82,20:15,20:30,,34.97,0,34.97,34.97,-1,-112858,83602,196460,-29256,0,-27,0,0,0,,27,-27
5,01/30/2018,83,20:30,20:45,,31.38,0,31.38,31.38,-1,-65085,94355,159440,29270,0,-740,0,0,0,,740,-740
5,01/30/2018,84,20:45,21:00,,-150.78,0,-150.78,-150.78,-1,-33968,111193,145161,77225,0,-16498,0,0,0,,16498,-16498
5,01/30/2018,85,21:00,21:15,149.12,-150.78,0,149.12,-150.78,2,-74640,69766,144406,-4874,0,-27724,3702,0,0,,31426,-24022
5,01/30/2018,86,21:15,21:30,164.12,30.26,0,164.12,30.26,2,-86836,44271,131107,-42565,0,-97,14908,0,0,,15005,14811
5,01/30/2018,87,21:30,21:45,164.12,28.97,0,28.97,28.97,-1,-50450,88395,138845,37945,0,-679,15,0,0,,694,-664
5,01/30/2018,88,21:45,22:00,,15.23,0,15.23,15.23,-1,-98536,124027,222563,25491,0,-12695,0,0,0,,12695,-12695
5,01/30/2018,89,22:00,22:15,350.12,26.78,0,350.12,350.12,1,-113984,65806,179790,-48178,0,-12169,11282,0,0,,23451,-887
5,01/30/2018,90,22:15,22:30,350.12,34.72,0,350.12,33.85,2,-70601,63527,134128,-7074,0,-16,40495,0,0,,40511,40479
5,01/30/2018,91,22:30,22:45,350.12,-40.89,0,-40.89,-40.89,-1,-31314,92910,124224,61596,0,-31353,1590,0,0,,32943,-29763
5,01/30/2018,92,22:45,23:00,,24.5,0,24.5,24.5,-1,-42396,86251,128647,43855,0,-42908,0,0,0,,42908,-42908
5,01/30/2018,93,23:00,23:15,70.02,12.95,0,70.02,12.95,2,-113062,95615,208677,-17447,0,-23665,2589,0,0,,26254,-21076
5,01/30/2018,94,23:15,23:30,70.02,23.15,0,23.15,23.15,-1,-73401,87758,161159,14357,0,-4094,435,0,0,,4529,-3659
5,01/30/2018,95,23:30,23:45,,20.93,0,20.93,20.93,-1,-64806,87916,152722,23110,0,-13225,0,0,0,,13225,-13225
5,01/30/2018,96,23:45,0:00,,5.32,0,5.32,5.32,-1,-51765,106029,157794,54264,0,-42425,0,0,0,,42425,-42425
5,01/31/2018,1,0:00,0:15,,8.03,0,8.03,8.03,-1,-60477,96609,157086,36132,0,-30343,0,0,0,,30343,-30343
5,01/31/2018,2,0:15,0:30,,29.87,0,29.87,29.87,-1,-82786,77367,160153,-5419,0,-2250,0,0,0,,2250,-2250
5,01/31/2018,3,0:30,0:45,,29.87,0,29.87,29.87,-1,-94759,75215,169974,-19544,0,-466,0,0,0,,466,-466
5,01/31/2018,4,0:45,1:00,,27.86,0,27.86,27.86,-1,-127299,100144,227443,-27155,0,-1040,0,0,0,,1040,-1040
5,01/31/2018,5,1:00,1:15,,8.79,0,8.79,8.79,-1,-47513,96185,143698,48672,0,-10585,0,0,0,,10585,-10585
5,01/31/2018,6,1:15,1:30,,1.92,0,1.92,1.92,-1,-23564,65391,88955,41827,0,-7793,0,0,0,,7793,-7793
5,01/31/2018,7,1:30,1:45,,19.81,0,19.81,19.81,-1,-38042,73563,111605,35521,0,-20093,0,0,0,,20093,-20093
5,01/31/2018,8,1:45,2:00,,-26.95,0,-26.95,-26.95,-1,-43559,80203,123762,36644,0,-32154,0,0,0,,32154,-32154
5,01/31/2018,9,2:00,2:15,,22.97,0,22.97,22.97,-1,-35669,77159,112828,41490,0,-11237,0,0,0,,11237,-11237
5,01/31/2018,10,2:15,2:30,,-11.17,0,-11.17,-11.17,-1,-43497,81111,124608,37614,0,-5030,0,0,0,,5030,-5030
5,01/31/2018,11,2:30,2:45,,-18.03,0,-18.03,-18.03,-1,-36720,78279,114999,41559,0,-34696,0,0,0,,34696,-34696
5,01/31/2018,12,2:45,3:00,,-54.35,0,-54.35,-54.35,-1,-54071,89192,143263,35121,0,-45737,0,0,0,,45737,-45737
5,01/31/2018,13,3:00,3:15,,29.2,0,29.2,29.2,-1,-65861,103672,169533,37811,0,-5021,0,0,0,,5021,-5021
5,01/31/2018,14,3:15,3:30,,-17.09,0,-17.09,-17.09,-1,-57220,122202,179422,64982,0,-2044,0,0,0,,2044,-2044
5,01/31/2018,15,3:30,3:45,,-79.92,0,-79.92,-79.92,-1,-42865,101362,144227,58497,0,-32916,0,0,0,,32916,-32916
5,01/31/2018,16,3:45,4:00,,-80.54,0,-80.54,-80.54,-1,-50081,119953,170034,69872,0,-50382,0,0,0,,50382,-50382
5,01/31/2018,17,4:00,4:15,,-13.23,0,-13.23,-13.23,-1,-47056,117073,164129,70017,0,-39457,0,0,0,,39457,-39457
5,01/31/2018,18,4:15,4:30,,-61.75,0,-61.75,-61.75,-1,-47160,138980,186140,91820,0,-23011,0,0,0,,23011,-23011
5,01/31/2018,19,4:30,4:45,,-44.03,0,-44.03,-44.03,-1,-43461,126931,170392,83470,0,-50306,0,0,0,,50306,-50306
5,01/31/2018,20,4:45,5:00,,-38.03,0,-38.03,-38.03,-1,-43959,119990,163949,76031,0,-53015,0,0,0,,53015,-53015
5,01/31/2018,21,5:00,5:15,,-37.03,0,-37.03,-37.03,-1,-49419,132904,182323,83485,0,-36846,0,0,0,,36846,-36846
5,01/31/2018,22,5:15,5:30,,-46.03,0,-46.03,-46.03,-1,-41986,110438,152424,68452,0,-33733,0,0,0,,33733,-33733
5,01/31/2018,23,5:30,5:45,,4.39,0,4.39,4.39,-1,-40065,120437,160502,80372,0,-20530,0,0,0,,20530,-20530
5,01/31/2018,24,5:45,6:00,,-48.08,0,-48.08,-48.08,-1,-35371,142577,177948,107206,0,-10178,0,0,0,,10178,-10178
5,01/31/2018,25,6:00,6:15,,-150.03,0,-150.03,-150.03,-1,-61987,141702,203689,79715,0,-47848,0,0,0,,47848,-47848
5,01/31/2018,26,6:15,6:30,,-17.03,0,-17.03,-17.03,-1,-71218,114527,185745,43309,0,-56819,0,0,0,,56819,-56819
5,01/31/2018,27,6:30,6:45,,26.03,0,26.03,26.03,-1,-66139,109081,175220,42942,0,-20532,0,0,0,,20532,-20532
5,01/31/2018,28,6:45,7:00,32.72,26.03,0,32.72,32.72,1,-65343,115307,180650,49964,0,-2137,194,0,0,,2331,-1943
5,01/31/2018,29,7:00,7:15,,,0,33.54,33.54,0,-136364,158472,294836,22108,0,0,0,0,0,,0,0
5,01/31/2018,30,7:15,7:30,,35,0,35,35,-1,-57547,122382,179929,64835,0,-161,0,0,0,,161,-161
5,01/31/2018,31,7:30,7:45,,30.88,0,30.88,30.88,-1,-67374,120432,187806,53058,0,-204,0,0,0,,204,-204
5,01/31/2018,32,7:45,8:00,,,0,33.61,33.61,0,-84025,137717,221742,53692,0,0,0,0,0,,0,0
5,01/31/2018,33,8:00,8:15,,-2.92,0,-2.92,-2.92,-1,-52862,107477,160339,54615,0,-4712,0,0,0,,4712,-4712
5,01/31/2018,34,8:15,8:30,,-23.69,0,-23.69,-23.69,-1,-66553,94883,161436,28330,0,-12754,0,0,0,,12754,-12754
5,01/31/2018,35,8:30,8:45,,22.41,0,22.41,22.41,-1,-78684,125581,204265,46897,0,-10120,0,0,0,,10120,-10120
5,01/31/2018,36,8:45,9:00,,34.13,0,34.13,34.13,-1,-117508,106873,224381,-10635,0,-2246,0,0,0,,2246,-2246
5,01/31/2018,37,9:00,9:15,,33.26,0,33.26,33.26,-1,-101161,109556,210717,8395,0,-526,0,0,0,,526,-526
5,01/31/2018,38,9:15,9:30,,33.48,0,33.48,33.48,-1,-112875,113001,225876,126,0,-344,0,0,0,,344,-344
5,01/31/2018,39,9:30,9:45,,26.47,0,26.47,26.47,-1,-99246,104872,204118,5626,0,-1389,0,0,0,,1389,-1389
5,01/31/2018,40,9:45,10:00,,23.99,0,23.99,23.99,-1,-110026,86369,196395,-23657,0,-3042,0,0,0,,3042,-3042
5,01/31/2018,41,10:00,10:15,,,0,33.66,33.66,0,-99374,119892,219266,20518,0,0,0,0,0,,0,0
5,01/31/2018,42,10:15,10:30,,34.17,0,34.17,34.17,-1,-105320,112233,217553,6913,0,-129,0,0,0,,129,-129
5,01/31/2018,43,10:30,10:45,,,0,33.63,33.63,0,-110022,131721,241743,21699,0,0,0,0,0,,0,0
5,01/31/2018,44,10:45,11:00,,34.19,0,34.19,34.19,-1,-113929,127580,241509,13651,0,-210,0,0,0,,210,-210
5,01/31/2018,45,11:00,11:15,,34,0,34,34,-1,-87106,160155,247261,73049,0,-1544,0,0,0,,1544,-1544
5,01/31/2018,46,11:15,11:30,,34.02,0,34.02,34.02,-1,-87693,158221,245914,70528,0,-2292,0,0,0,,2292,-2292
5,01/31/2018,47,11:30,11:45,,34.2,0,34.2,34.2,-1,-105711,153323,259034,47612,0,-1842,0,0,0,,1842,-1842
5,01/31/2018,48,11:45,12:00,,,0,34.06,34.06,0,-99134,138152,237286,39018,0,-81,0,0,0,,81,-81
5,01/31/2018,49,12:00,12:15,,,0,33.86,33.86,0,-66707,113562,180269,46855,0,0,0,0,0,,0,0
5,01/31/2018,50,12:15,12:30,,34.2,0,34.2,34.2,-1,-64172,110733,174905,46561,0,-121,0,0,0,,121,-121
5,01/31/2018,51,12:30,12:45,,33.89,0,33.89,33.89,-1,-63417,117814,181231,54397,0,-1587,0,0,0,,1587,-1587
5,01/31/2018,52,12:45,13:00,,35,0,35,35,-1,-63034,102369,165403,39335,0,-425,0,0,0,,425,-425
5,01/31/2018,53,13:00,13:15,37.89,,0,37.89,37.89,1,-100009,111946,211955,11937,0,0,325,0,0,,325,325
5,01/31/2018,54,13:15,13:30,135.02,,0,135.02,135.02,1,-134249,82195,216444,-52054,0,0,30865,0,0,,30865,30865
5,01/31/2018,55,13:30,13:45,55.15,,0,55.15,55.15,1,-111494,91826,203320,-19668,0,0,40036,0,0,,40036,40036
5,01/31/2018,56,13:45,14:00,55.15,31.4,0,31.4,31.4,-1,-70245,91582,161827,21337,0,-827,4931,0,0,,5758,4104
5,01/31/2018,57,14:00,14:15,33.15,,0,33.15,33.15,1,-73443,65517,138960,-7926,0,0,106,0,0,,106,106
5,01/31/2018,58,14:15,14:30,138.02,,0,138.02,138.02,1,-100536,38290,138826,-62246,0,0,21217,0,0,,21217,21217
5,01/31/2018,59,14:30,14:45,140.02,,0,140.02,140.02,1,-140307,49744,190051,-90563,0,0,72725,0,0,,72725,72725
5,01/31/2018,60,14:45,15:00,74.15,,0,74.15,74.15,1,-127431,46187,173618,-81244,0,0,51104,0,0,,51104,51104
5,01/31/2018,61,15:00,15:15,48.02,,0,48.02,48.02,1,-100670,63405,164075,-37265,0,0,37559,0,0,,37559,37559
5,01/31/2018,62,15:15,15:30,33.15,32.76,0,33.77,32.76,2,-81423,75740,157163,-5683,0,-526,13020,0,0,,13546,12494
5,01/31/2018,63,15:30,15:45,135.02,,0,135.02,135.02,1,-93166,44554,137720,-48612,0,0,22795,0,0,,22795,22795
5,01/31/2018,64,15:45,16:00,141.02,,0,141.02,141.02,1,-145971,27322,173293,-118649,0,0,94432,0,0,,94432,94432
5,01/31/2018,65,16:00,16:15,222.02,,0,222.02,222.02,1,-76370,64714,141084,-11656,0,0,43154,0,0,,43154,43154
5,01/31/2018,66,16:15,16:30,48.82,,0,48.82,48.82,1,-75383,57411,132794,-17972,0,0,5315,0,0,,5315,5315
5,01/31/2018,67,16:30,16:45,86.65,,0,86.65,86.65,1,-80533,42952,123485,-37581,0,0,19083,0,0,,19083,19083
5,01/31/2018,68,16:45,17:00,192.02,,0,192.02,192.02,1,-92880,48292,141172,-44588,0,0,46235,0,0,,46235,46235
5,01/31/2018,69,17:00,17:15,44.42,31.89,0,31.89,31.89,-1,-64070,70413,134483,6343,0,-259,19431,0,0,,19690,19172
5,01/31/2018,70,17:15,17:30,104.81,,0,104.81,104.81,1,-63513,33564,97077,-29949,0,0,9769,0,0,,9769,9769
5,01/31/2018,71,17:30,17:45,136.02,,0,136.02,136.02,1,-97706,45557,143263,-52149,0,0,46687,0,0,,46687,46687
5,01/31/2018,72,17:45,18:00,68.12,,0,68.12,68.12,1,-81045,48187,129232,-32858,0,0,44225,0,0,,44225,44225
5,01/31/2018,73,18:00,18:15,83.51,27.55,0,83.51,27.55,2,-104895,97314,202209,-7581,0,-332,29279,0,0,,29611,28947
5,01/31/2018,74,18:15,18:30,83.51,27.95,0,27.95,27.95,-1,-80674,94147,174821,13473,0,-772,633,0,0,,1405,-139
5,01/31/2018,75,18:30,18:45,52.02,,0,52.02,52.02,1,-92292,75506,167798,-16786,0,0,5277,0,0,,5277,5277
5,01/31/2018,76,18:45,19:00,34.68,31.33,0,34.68,31.33,2,-76379,98712,175091,22333,0,-12,3769,0,0,,3781,3757
5,01/31/2018,77,19:00,19:15,34.68,-25.65,0,-25.65,-25.65,-1,-83965,116829,200794,32864,0,-24377,82,0,0,,24459,-24295
5,01/31/2018,78,19:15,19:30,39.16,34.2,0,39.16,39.16,1,-83542,67577,151119,-15965,0,-2043,657,0,0,,2700,-1386
5,01/31/2018,79,19:30,19:45,134.02,,0,134.02,134.02,1,-86265,34945,121210,-51320,0,0,29408,0,0,,29408,29408
5,01/31/2018,80,19:45,20:00,45.02,,0,45.02,45.02,1,-80526,46179,126705,-34347,0,0,34878,0,0,,34878,34878
5,01/31/2018,81,20:00,20:15,36.55,31.01,0,31.01,31.01,-1,-80348,56142,136490,-24206,0,-30,13104,0,0,,13134,13074
5,01/31/2018,82,20:15,20:30,36.55,29.39,0,29.39,29.39,-1,-56832,64996,121828,8164,0,-1704,42,0,0,,1746,-1662
5,01/31/2018,83,20:30,20:45,,15.5,0,15.5,15.5,-1,-58768,84186,142954,25418,0,-20035,0,0,0,,20035,-20035
5,01/31/2018,84,20:45,21:00,,28.06,0,28.06,28.06,-1,-94270,111848,206118,17578,0,-23836,0,0,0,,23836,-23836
5,01/31/2018,85,21:00,21:15,86.83,21.55,0,86.83,86.83,1,-59194,50245,109439,-8949,0,-14574,4229,0,0,,18803,-10345
5,01/31/2018,86,21:15,21:30,85.02,21.55,0,85.02,85.02,1,-45380,63543,108923,18163,0,-118,6647,0,0,,6765,6529
5,01/31/2018,87,21:30,21:45,,26.18,0,26.18,26.18,-1,-44374,89527,133901,45153,0,-1525,0,0,0,,1525,-1525
5,01/31/2018,88,21:45,22:00,,26.23,0,26.23,26.23,-1,-64719,102638,167357,37919,0,-12707,0,0,0,,12707,-12707
5,01/31/2018,89,22:00,22:15,73.46,27.52,0,73.46,27.52,2,-72768,47201,119969,-25567,0,-8808,7382,0,0,,16190,-1426
5,01/31/2018,90,22:15,22:30,35.02,-36.03,0,-36.03,-36.03,-1,-47871,94334,142205,46463,0,-8762,4067,0,0,,12829,-4695
5,01/31/2018,91,22:30,22:45,,-59.1,0,-59.1,-59.1,-1,-58028,81125,139153,23097,0,-22142,0,0,0,,22142,-22142
5,01/31/2018,92,22:45,23:00,,13.83,0,13.83,13.83,-1,-60127,80465,140592,20338,0,-14807,0,0,0,,14807,-14807
5,01/31/2018,93,23:00,23:15,199.02,13.83,0,199.02,199.02,1,-79391,40419,119810,-38972,0,-2643,14753,0,0,,17396,12110
5,01/31/2018,94,23:15,23:30,50.02,,0,50.02,50.02,1,-68291,39403,107694,-28888,0,0,31007,0,0,,31007,31007
5,01/31/2018,95,23:30,23:45,33.64,,0,33.64,33.64,1,-55270,50081,105351,-5189,0,0,11513,0,0,,11513,11513
5,01/31/2018,96,23:45,0:00,33.64,-25.03,0,-25.03,-25.03,-1,-45710,78052,123762,32342,0,-14675,146,0,0,,14821,-14529
5,02-01-18,1,0:00,0:15,40.07,-54.03,0,40.07,-54.03,2,-55077,88042,143119,32965,0,-33443,221,0,0,,33664,-33222
5,02-01-18,2,0:15,0:30,40.07,-54.03,0,40.07,40.07,1,-59489,36198,95687,-23291,0,-422,976,0,0,,1398,554
5,02-01-18,3,0:30,0:45,40.07,,0,40.07,40.07,1,-51935,30371,82306,-21564,0,0,4206,0,0,,4206,4206
5,02-01-18,4,0:45,1:00,40.07,14.03,0,14.03,14.03,-1,-52212,71953,124165,19741,0,-10176,555,0,0,,10731,-9621
5,02-01-18,5,1:00,1:15,42.01,33.07,0,42.01,42.01,1,-32847,40385,73232,7538,0,-6744,1506,0,0,,8250,-5238
5,02-01-18,6,1:15,1:30,41.58,,0,41.58,41.58,1,-51300,36260,87560,-15040,0,0,7202,0,0,,7202,7202
5,02-01-18,7,1:30,1:45,,,0,31.9,31.9,0,-27799,45583,73382,17784,0,0,289,0,0,,289,289
5,02-01-18,8,1:45,2:00,,,0,31.9,31.9,0,-46394,59992,106386,13598,0,0,0,0,0,,0,0
5,02-01-18,9,2:00,2:15,,,0,31.83,31.83,0,-24598,52827,77425,28229,0,0,0,0,0,,0,0
5,02-01-18,10,2:15,2:30,,,0,31.83,31.83,0,-43426,42719,86145,-707,0,0,0,0,0,,0,0
5,02-01-18,11,2:30,2:45,,28.59,0,28.59,28.59,-1,-24829,52202,77031,27373,0,-2172,0,0,0,,2172,-2172
5,02-01-18,12,2:45,3:00,,-0.61,0,-0.61,-0.61,-1,-32080,59427,91507,27347,0,-18641,0,0,0,,18641,-18641
5,02-01-18,13,3:00,3:15,,28.03,0,28.03,28.03,-1,-34016,43970,77986,9954,0,-10536,0,0,0,,10536,-10536
5,02-01-18,14,3:15,3:30,,,0,31.88,31.88,0,-58622,52223,110845,-6399,0,-32,0,0,0,,32,-32
5,02-01-18,15,3:30,3:45,,,0,31.68,31.68,0,-59783,51143,110926,-8640,0,0,0,0,0,,0,0
5,02-01-18,16,3:45,4:00,,28.84,0,28.84,28.84,-1,-56566,54613,111179,-1953,0,-932,0,0,0,,932,-932
5,02-01-18,17,4:00,4:15,,,0,31.88,31.88,0,-61857,70090,131947,8233,0,-122,0,0,0,,122,-122
5,02-01-18,18,4:15,4:30,32.08,,0,32.08,32.08,1,-57145,45239,102384,-11906,0,0,1912,0,0,,1912,1912
5,02-01-18,19,4:30,4:45,33.8,,0,33.8,33.8,1,-68062,36925,104987,-31137,0,0,3227,0,0,,3227,3227
5,02-01-18,20,4:45,5:00,29.83,,0,29.83,29.83,1,-52773,40713,93486,-12060,0,0,585,0,0,,585,585
5,02-01-18,21,5:00,5:15,,14.4,0,14.4,14.4,-1,-37587,65224,102811,27637,0,-12637,0,0,0,,12637,-12637
5,02-01-18,22,5:15,5:30,,29.07,0,29.07,29.07,-1,-52567,38452,91019,-14115,0,-8574,0,0,0,,8574,-8574
5,02-01-18,23,5:30,5:45,46.07,,0,46.07,46.07,1,-58133,38918,97051,-19215,0,0,2075,0,0,,2075,2075
5,02-01-18,24,5:45,6:00,54.68,,0,54.68,54.68,1,-74496,67844,142340,-6652,0,0,11810,0,0,,11810,11810
5,02-01-18,25,6:00,6:15,33.09,30.25,0,33.09,30.25,2,-73465,70060,143525,-3405,0,-1020,2569,0,0,,3589,1549
5,02-01-18,26,6:15,6:30,,,0,31.15,31.15,0,-75270,44963,120233,-30307,0,0,0,0,0,,0,0
5,02-01-18,27,6:30,6:45,49.77,,0,49.77,49.77,1,-91414,24127,115541,-67287,0,0,2287,0,0,,2287,2287
5,02-01-18,28,6:45,7:00,75.97,,0,75.97,75.97,1,-85203,60330,145533,-24873,0,0,24562,0,0,,24562,24562
5,02-01-18,29,7:00,7:15,38.47,22.91,0,38.47,22.91,2,-110390,115610,226000,5220,0,-342,20512,0,0,,20854,20170
5,02-01-18,30,7:15,7:30,38.47,-22.44,0,38.47,-22.44,2,-80434,84192,164626,3758,0,-14105,2529,0,0,,16634,-11576
5,02-01-18,31,7:30,7:45,106.7,-22.44,0,106.7,106.7,1,-107918,64351,172269,-43567,0,-60,28623,0,0,,28683,28563
5,02-01-18,32,7:45,8:00,75.02,,0,75.02,75.02,1,-125737,74969,200706,-50768,0,0,42009,0,0,,42009,42009
5,02-01-18,33,8:00,8:15,42.02,18.08,0,18.08,18.08,-1,-27637,72876,100513,45239,0,-2799,21967,0,0,,24766,19168
5,02-01-18,34,8:15,8:30,42.02,15.05,0,15.05,15.05,-1,-41606,64768,106374,23162,0,-8808,51,0,0,,8859,-8757
5,02-01-18,35,8:30,8:45,38.04,15.05,0,38.04,38.04,1,-72226,61569,133795,-10657,0,-1189,837,0,0,,2026,-352
5,02-01-18,36,8:45,9:00,44.46,,0,44.46,44.46,1,-98538,51785,150323,-46753,0,0,21366,0,0,,21366,21366
5,02-01-18,37,9:00,9:15,238.02,,0,238.02,238.02,1,-110575,48235,158810,-62340,0,0,42255,0,0,,42255,42255
5,02-01-18,38,9:15,9:30,141.02,,0,141.02,141.02,1,-102979,54192,157171,-48787,0,0,56384,0,0,,56384,56384
5,02-01-18,39,9:30,9:45,141.02,31.61,0,31.61,31.61,-1,-60590,60076,120666,-514,0,-390,10177,0,0,,10567,9787
5,02-01-18,40,9:45,10:00,72.97,,0,72.97,72.97,1,-71379,39776,111155,-31603,0,0,8029,0,0,,8029,8029
5,02-01-18,41,10:00,10:15,126.85,,0,126.85,126.85,1,-80579,44477,125056,-36102,0,0,42488,0,0,,42488,42488
5,02-01-18,42,10:15,10:30,35.9,,0,35.9,35.9,1,-82671,71277,153948,-11394,0,0,13437,0,0,,13437,13437
5,02-01-18,43,10:30,10:45,63.97,,0,63.97,63.97,1,-91338,56968,148306,-34370,0,0,20148,0,0,,20148,20148
5,02-01-18,44,10:45,11:00,239.02,,0,239.02,239.02,1,-137856,60476,198332,-77380,0,0,38068,0,0,,38068,38068
5,02-01-18,45,11:00,11:15,247.02,,0,247.02,247.02,1,-122882,50206,173088,-72676,0,0,69634,0,0,,69634,69634
5,02-01-18,46,11:15,11:30,238.02,,0,238.02,238.02,1,-151591,51708,203299,-99883,0,0,51415,0,0,,51415,51415
5,02-01-18,47,11:30,11:45,450,,0,450,450,1,-165645,50739,216384,-114906,0,0,97760,0,0,,97760,97760
5,02-01-18,48,11:45,12:00,350.02,,0,350.02,350.02,1,-143840,50717,194557,-93123,0,0,95902,0,0,,95902,95902
5,02-01-18,49,12:00,12:15,175.02,,0,175.02,175.02,1,-163629,59026,222655,-104603,0,0,102168,0,0,,102168,102168
5,02-01-18,50,12:15,12:30,104.61,,0,104.61,104.61,1,-130844,70572,201416,-60272,0,0,51088,0,0,,51088,51088
5,02-01-18,51,12:30,12:45,134.02,,0,134.02,134.02,1,-118649,68684,187333,-49965,0,0,54612,0,0,,54612,54612
5,02-01-18,52,12:45,13:00,43.71,,0,43.71,43.71,1,-93618,77352,170970,-16266,0,0,37818,0,0,,37818,37818
5,02-01-18,53,13:00,13:15,43.71,32.09,0,32.09,32.09,-1,-69065,100241,169306,31176,0,-544,4262,0,0,,4806,3718
5,02-01-18,54,13:15,13:30,,,0,32.39,32.39,0,-84915,102745,187660,17830,0,0,0,0,0,,0,0
5,02-01-18,55,13:30,13:45,,,0,32.39,32.39,0,-85759,95466,181225,9707,0,0,0,0,0,,0,0
5,02-01-18,56,13:45,14:00,,34.99,0,34.99,34.99,-1,-69870,79412,149282,9542,0,-21,0,0,0,,21,-21
5,02-01-18,57,14:00,14:15,,30.18,0,30.18,30.18,-1,-40897,80105,121002,39208,0,-1459,0,0,0,,1459,-1459
5,02-01-18,58,14:15,14:30,50.35,34.99,0,50.35,32.39,2,-120618,75970,196588,-44648,0,-392,7447,0,0,,7839,7055
5,02-01-18,59,14:30,14:45,51.83,,0,51.83,51.83,1,-125727,82513,208240,-43214,0,0,6591,0,0,,6591,6591
5,02-01-18,60,14:45,15:00,56.58,,0,56.58,56.58,1,-117244,76675,193919,-40569,0,0,16928,0,0,,16928,16928
5,02-01-18,61,15:00,15:15,238.02,,0,238.02,238.02,1,-167573,65149,232722,-102424,0,0,57330,0,0,,57330,57330
5,02-01-18,62,15:15,15:30,43.27,,0,43.27,43.27,1,-129776,90065,219841,-39711,0,0,36729,0,0,,36729,36729
5,02-01-18,63,15:30,15:45,137.02,,0,137.02,137.02,1,-150600,72266,222866,-78334,0,0,52254,0,0,,52254,52254
5,02-01-18,64,15:45,16:00,88.02,,0,88.02,88.02,1,-166004,82121,248125,-83883,0,0,66825,0,0,,66825,66825
5,02-01-18,65,16:00,16:15,54.02,,0,54.02,54.02,1,-137248,94521,231769,-42727,0,0,42825,0,0,,42825,42825
5,02-01-18,66,16:15,16:30,56.92,,0,56.92,56.92,1,-133448,88199,221647,-45249,0,0,41188,0,0,,41188,41188
5,02-01-18,67,16:30,16:45,350.02,,0,350.02,350.02,1,-141506,79529,221035,-61977,0,0,48406,0,0,,48406,48406
5,02-01-18,68,16:45,17:00,350.02,,0,350.02,350.02,1,-158994,116911,275905,-42083,0,0,60904,0,0,,60904,60904
5,02-01-18,69,17:00,17:15,350.02,-140.68,0,-140.68,-140.68,-1,-84328,142569,226897,58241,0,-13843,10538,0,0,,24381,-3305
5,02-01-18,70,17:15,17:30,36.2,-140.68,0,36.2,36.2,1,-134753,112800,247553,-21953,0,-247,280,0,0,,527,33
5,02-01-18,71,17:30,17:45,350.02,,0,350.02,350.02,1,-164564,102650,267214,-61914,0,0,9327,0,0,,9327,9327
5,02-01-18,72,17:45,18:00,350.02,,0,350.02,350.02,1,-164975,119100,284075,-45875,0,0,42088,0,0,,42088,42088
5,02-01-18,73,18:00,18:15,48.64,,0,48.64,48.64,1,-101573,86219,187792,-15354,0,0,21817,0,0,,21817,21817
5,02-01-18,74,18:15,18:30,39.98,,0,39.98,39.98,1,-101957,83735,185692,-18222,0,0,1645,0,0,,1645,1645
5,02-01-18,75,18:30,18:45,34.67,30.28,0,30.28,30.28,-1,-93041,107629,200670,14588,0,-107,2524,0,0,,2631,2417
5,02-01-18,76,18:45,19:00,,30.23,0,30.23,30.23,-1,-90740,102414,193154,11674,0,-822,0,0,0,,822,-822
5,02-01-18,77,19:00,19:15,37.09,30.23,0,37.09,37.09,1,-67954,61336,129290,-6618,0,-130,1585,0,0,,1715,1455
5,02-01-18,78,19:15,19:30,32.48,,0,32.48,32.48,1,-42260,76747,119007,34487,0,0,1075,0,0,,1075,1075
5,02-01-18,79,19:30,19:45,32.48,25.28,0,25.28,25.28,-1,-39271,89453,128724,50182,0,-2585,56,0,0,,2641,-2529
5,02-01-18,80,19:45,20:00,,34.3,0,34.3,34.3,-1,-38127,98392,136519,60265,0,-1937,0,0,0,,1937,-1937
5,02-01-18,81,20:00,20:15,,34.99,0,34.99,34.99,-1,-73156,111150,184306,37994,0,-902,0,0,0,,902,-902
5,02-01-18,82,20:15,20:30,,,0,32.57,32.57,0,-57094,80674,137768,23580,0,0,0,0,0,,0,0
5,02-01-18,83,20:30,20:45,40.56,,0,40.56,40.56,1,-67686,51506,119192,-16180,0,0,2081,0,0,,2081,2081
5,02-01-18,84,20:45,21:00,30.59,23.45,0,23.45,23.45,-1,-97607,92659,190266,-4948,0,-365,926,0,0,,1291,561
5,02-01-18,85,21:00,21:15,350.02,11.58,0,350.02,350.02,1,-84451,80533,164984,-3918,0,-1410,7949,0,0,,9359,6539
5,02-01-18,86,21:15,21:30,41.79,34.99,0,34.99,34.99,-1,-67912,110537,178449,42625,0,-32,9362,0,0,,9394,9330
5,02-01-18,87,21:30,21:45,,17.89,0,17.89,17.89,-1,-35000,110421,145421,75421,0,-1373,0,0,0,,1373,-1373
5,02-01-18,88,21:45,22:00,,13.95,0,13.95,13.95,-1,-18635,112703,131338,94068,0,-17354,0,0,0,,17354,-17354
5,02-01-18,89,22:00,22:15,350.02,7.1,0,350.02,350.02,1,-89244,38625,127869,-50619,0,-13739,5163,0,0,,18902,-8576
5,02-01-18,90,22:15,22:30,350.02,25.98,0,350.02,25.98,2,-71298,72341,143639,1043,0,-646,20676,0,0,,21322,20030
5,02-01-18,91,22:30,22:45,350.02,-9.03,0,-9.03,-9.03,-1,-46553,87875,134428,41322,0,-28457,150,0,0,,28607,-28307
5,02-01-18,92,22:45,23:00,,26.92,0,26.92,26.92,-1,-75229,106047,181276,30818,0,-32517,0,0,0,,32517,-32517
5,02-01-18,93,23:00,23:15,37.09,29.28,0,37.09,37.09,1,-90693,89503,180196,-1190,0,-14137,1060,0,0,,15197,-13077
5,02-01-18,94,23:15,23:30,35.16,29.28,0,35.16,35.16,1,-111444,78756,190200,-32688,0,-9,3915,0,0,,3924,3906
5,02-01-18,95,23:30,23:45,43.09,,0,43.09,43.09,1,-138865,87076,225941,-51789,0,0,13350,0,0,,13350,13350
5,02-01-18,96,23:45,0:00,36.3,,0,36.3,36.3,1,-120667,105242,225909,-15425,0,0,13280,0,0,,13280,13280
5,02-02-18,1,0:00,0:15,49.61,33.48,0,49.61,33.17,2,-99653,76632,176285,-23021,0,-228,5136,0,0,,5364,4908
5,02-02-18,2,0:15,0:30,60.83,,0,60.83,60.83,1,-114788,67552,182340,-47236,0,0,35222,0,0,,35222,35222
5,02-02-18,3,0:30,0:45,36.12,,0,36.12,36.12,1,-105566,94658,200224,-10908,0,0,10501,0,0,,10501,10501
5,02-02-18,4,0:45,1:00,,30.07,0,30.07,30.07,-1,-92936,103931,196867,10995,0,-1613,0,0,0,,1613,-1613
5,02-02-18,5,1:00,1:15,30.88,8.78,0,30.88,30.88,1,-74936,114389,189325,39453,0,-1884,7,0,0,,1891,-1877
5,02-02-18,6,1:15,1:30,36.64,,0,36.64,36.64,1,-76258,101099,177357,24841,0,0,572,0,0,,572,572
5,02-02-18,7,1:30,1:45,,,0,32.8,32.8,0,-86176,104906,191082,18730,0,0,0,0,0,,0,0
5,02-02-18,8,1:45,2:00,36.61,,0,36.61,36.61,1,-91979,74858,166837,-17121,0,0,410,0,0,,410,410
5,02-02-18,9,2:00,2:15,81.76,,0,81.76,81.76,1,-85758,50316,136074,-35442,0,0,20135,0,0,,20135,20135
5,02-02-18,10,2:15,2:30,39.09,,0,39.09,39.09,1,-66179,65538,131717,-641,0,0,10399,0,0,,10399,10399
5,02-02-18,11,2:30,2:45,37.09,,0,37.09,37.09,1,-60524,45734,106258,-14790,0,0,1048,0,0,,1048,1048
5,02-02-18,12,2:45,3:00,35.8,,0,35.8,35.8,1,-58903,56645,115548,-2258,0,0,660,0,0,,660,660
5,02-02-18,13,3:00,3:15,45.8,,0,45.8,45.8,1,-71689,49963,121652,-21726,0,0,2825,0,0,,2825,2825
5,02-02-18,14,3:15,3:30,52,,0,52,52,1,-66855,50834,117689,-16021,0,0,10338,0,0,,10338,10338
5,02-02-18,15,3:30,3:45,30.89,,0,30.89,30.89,1,-75834,48545,124379,-27289,0,0,1115,0,0,,1115,1115
5,02-02-18,16,3:45,4:00,30.88,,0,30.88,30.88,1,-75749,41968,117717,-33781,0,0,52,0,0,,52,52
5,02-02-18,17,4:00,4:15,36.98,,0,36.98,36.98,1,-64218,51390,115608,-12828,0,0,368,0,0,,368,368
5,02-02-18,18,4:15,4:30,,32.65,0,32.65,32.65,-1,-30733,57216,87949,26483,0,-21,0,0,0,,21,-21
5,02-02-18,19,4:30,4:45,,30.07,0,30.07,30.07,-1,-56139,56773,112912,634,0,-1102,0,0,0,,1102,-1102
5,02-02-18,20,4:45,5:00,,31.07,0,31.07,31.07,-1,-56396,52982,109378,-3414,0,-1894,0,0,0,,1894,-1894
5,02-02-18,21,5:00,5:15,,18.7,0,18.7,18.7,-1,-35154,61370,96524,26216,0,-15703,0,0,0,,15703,-15703
5,02-02-18,22,5:15,5:30,35.58,30.07,0,35.58,35.58,1,-55265,56397,111662,1132,0,-13478,133,0,0,,13611,-13345
5,02-02-18,23,5:30,5:45,37.86,30.07,0,37.86,37.86,1,-64939,47494,112433,-17445,0,-319,2197,0,0,,2516,1878
5,02-02-18,24,5:45,6:00,54.72,,0,54.72,54.72,1,-85897,59679,145576,-26218,0,0,19156,0,0,,19156,19156
5,02-02-18,25,6:00,6:15,30.85,5.9,0,33.38,5.9,2,-59852,88073,147925,28221,0,-9085,6536,0,0,,15621,-2549
5,02-02-18,26,6:15,6:30,,28.76,0,28.76,28.76,-1,-55811,66872,122683,11061,0,-7613,0,0,0,,7613,-7613
5,02-02-18,27,6:30,6:45,,,0,33.41,33.41,0,-71116,86846,157962,15730,0,-1026,0,0,0,,1026,-1026
5,02-02-18,28,6:45,7:00,,,0,33.43,33.43,0,-63897,119873,183770,55976,0,0,0,0,0,,0,0
5,02-02-18,29,7:00,7:15,,19.65,0,19.65,19.65,-1,-79479,124449,203928,44970,0,-5832,0,0,0,,5832,-5832
5,02-02-18,30,7:15,7:30,,30.61,0,30.61,30.61,-1,-44844,76538,121382,31694,0,-13084,0,0,0,,13084,-13084
5,02-02-18,31,7:30,7:45,110.09,30.61,0,110.09,110.09,1,-89086,51053,140139,-38033,0,-3143,6648,0,0,,9791,3505
5,02-02-18,32,7:45,8:00,337.09,,0,337.09,337.09,1,-206990,48075,255065,-158915,0,0,68783,0,0,,68783,68783
5,02-02-18,33,8:00,8:15,124.5,-4.78,0,-4.78,-4.78,-1,-55361,103796,159157,48435,0,-2986,44296,0,0,,47282,41310
5,02-02-18,34,8:15,8:30,69.67,-18.89,0,69.67,-18.89,2,-77788,57200,134988,-20588,0,-6477,7416,0,0,,13893,939
5,02-02-18,35,8:30,8:45,37.72,,0,37.72,37.72,1,-67238,58212,125450,-9026,0,0,6137,0,0,,6137,6137
5,02-02-18,36,8:45,9:00,337.09,,0,337.09,337.09,1,-108061,50744,158805,-57317,0,0,23017,0,0,,23017,23017
5,02-02-18,37,9:00,9:15,67.25,-37.27,0,67.25,-37.27,2,-25445,95165,120610,69720,0,-2822,25427,0,0,,28249,22605
5,02-02-18,38,9:15,9:30,179.09,-57.89,0,179.09,-57.89,2,-61567,43655,105222,-17912,0,-9959,5178,0,0,,15137,-4781
5,02-02-18,39,9:30,9:45,238.09,14.48,0,238.09,14.48,2,-37644,51903,89547,14259,0,-1062,20063,0,0,,21125,19001
5,02-02-18,40,9:45,10:00,34.5,-18.07,0,34.5,-18.07,2,-41471,61410,102881,19939,0,-17487,49,0,0,,17536,-17438
5,02-02-18,41,10:00,10:15,55.9,-18.07,0,55.9,55.9,1,-76262,58520,134782,-17742,0,-425,11071,0,0,,11496,10646
5,02-02-18,42,10:15,10:30,68.02,,0,68.02,68.02,1,-91210,56778,147988,-34432,0,0,22894,0,0,,22894,22894
5,02-02-18,43,10:30,10:45,47.09,,0,47.09,47.09,1,-83523,67458,150981,-16065,0,0,30427,0,0,,30427,30427
5,02-02-18,44,10:45,11:00,37.9,15.01,0,37.9,15.01,2,-70448,76649,147097,6201,0,-8544,6066,0,0,,14610,-2478
5,02-02-18,45,11:00,11:15,48.34,15.01,0,48.34,48.34,1,-107834,51797,159631,-56037,0,-398,3713,0,0,,4111,3315
5,02-02-18,46,11:15,11:30,,,0,33.96,33.96,0,-102385,52691,155076,-49694,0,0,194,0,0,,194,194
5,02-02-18,47,11:30,11:45,,,0,33.98,33.98,0,-108611,54456,163067,-54155,0,0,0,0,0,,0,0
5,02-02-18,48,11:45,12:00,34.5,,0,34.5,34.5,1,-98975,61422,160397,-37553,0,0,6,0,0,,6,6
5,02-02-18,49,12:00,12:15,46.61,,0,46.61,46.61,1,-106538,25353,131891,-81185,0,0,7490,0,0,,7490,7490
5,02-02-18,50,12:15,12:30,38.09,,0,38.09,38.09,1,-90405,42825,133230,-47580,0,0,4683,0,0,,4683,4683
5,02-02-18,51,12:30,12:45,39.9,,0,39.9,39.9,1,-60625,62619,123244,1994,0,0,2589,0,0,,2589,2589
5,02-02-18,52,12:45,13:00,,,0,33.72,33.72,0,-64607,63026,127633,-1581,0,0,172,0,0,,172,172
5,02-02-18,53,13:00,13:15,53.32,,0,53.32,53.32,1,-85412,61431,146843,-23981,0,0,5722,0,0,,5722,5722
5,02-02-18,54,13:15,13:30,34.5,,0,34.5,34.5,1,-90574,71207,161781,-19367,0,0,3990,0,0,,3990,3990
5,02-02-18,55,13:30,13:45,34.5,32.2,0,32.2,32.2,-1,-62193,67901,130094,5708,0,-111,227,0,0,,338,116
5,02-02-18,56,13:45,14:00,,24.81,0,24.81,24.81,-1,-47768,91924,139692,44156,0,-4825,0,0,0,,4825,-4825
5,02-02-18,57,14:00,14:15,61.07,34.32,0,61.07,33.56,2,-101336,73490,174826,-27846,0,-2343,7854,0,0,,10197,5511
5,02-02-18,58,14:15,14:30,37.04,,0,37.04,37.04,1,-60167,102593,162760,42426,0,0,3467,0,0,,3467,3467
5,02-02-18,59,14:30,14:45,,,0,33.56,33.56,0,-54878,99483,154361,44605,0,0,0,0,0,,0,0
5,02-02-18,60,14:45,15:00,,30.32,0,30.32,30.32,-1,-43184,84622,127806,41438,0,-2273,0,0,0,,2273,-2273
5,02-02-18,61,15:00,15:15,30.84,36.27,0,30.84,30.84,1,-67345,78543,145888,11198,0,-763,72,0,0,,835,-691
5,02-02-18,62,15:15,15:30,30.86,,0,30.86,30.86,1,-51427,74243,125670,22816,0,0,458,0,0,,458,458
5,02-02-18,63,15:30,15:45,30.86,,0,30.86,30.86,1,-36820,79075,115895,42255,0,0,331,0,0,,331,331
5,02-02-18,64,15:45,16:00,37.71,,0,37.71,37.71,1,-91459,94473,185932,3014,0,0,759,0,0,,759,759
5,02-02-18,65,16:00,16:15,39.06,31.2,0,39.06,31.2,2,-70485,112884,183369,42399,0,-1422,2771,0,0,,4193,1349
5,02-02-18,66,16:15,16:30,,31.2,0,31.2,31.2,-1,-79934,103146,183080,23212,0,-2605,0,0,0,,2605,-2605
5,02-02-18,67,16:30,16:45,,34.04,0,34.04,34.04,-1,-66974,94110,161084,27136,0,-2249,0,0,0,,2249,-2249
5,02-02-18,68,16:45,17:00,,36.17,0,36.17,36.17,-1,-67114,84138,151252,17024,0,-81,0,0,0,,81,-81
5,02-02-18,69,17:00,17:15,,-150.81,0,-150.81,-150.81,-1,-60704,152509,213213,91805,0,-33608,0,0,0,,33608,-33608
5,02-02-18,70,17:15,17:30,,-4.13,0,-4.13,-4.13,-1,-78613,113881,192494,35268,0,-26536,0,0,0,,26536,-26536
5,02-02-18,71,17:30,17:45,46.51,32.58,0,46.51,46.51,1,-97130,92878,190008,-4252,0,-8959,730,0,0,,9689,-8229
5,02-02-18,72,17:45,18:00,51,32.58,0,51,51,1,-110720,104076,214796,-6644,0,-630,2227,0,0,,2857,1597
5,02-02-18,73,18:00,18:15,,,0,33.8,33.8,0,-103168,43283,146451,-59885,0,0,0,0,0,,0,0
5,02-02-18,74,18:15,18:30,39.14,,0,39.14,39.14,1,-73022,25533,98555,-47489,0,0,135,0,0,,135,135
5,02-02-18,75,18:30,18:45,45.22,,0,45.22,45.22,1,-72605,34137,106742,-38468,0,0,3553,0,0,,3553,3553
5,02-02-18,76,18:45,19:00,89.09,,0,89.09,89.09,1,-80737,37599,118336,-43138,0,0,29969,0,0,,29969,29969
5,02-02-18,77,19:00,19:15,58.93,,0,58.93,58.93,1,-113557,36679,150236,-76878,0,0,32825,0,0,,32825,32825
5,02-02-18,78,19:15,19:30,37.16,,0,37.16,37.16,1,-85636,38154,123790,-47482,0,0,9518,0,0,,9518,9518
5,02-02-18,79,19:30,19:45,54.09,,0,54.09,54.09,1,-87118,35678,122796,-51440,0,0,11479,0,0,,11479,11479
5,02-02-18,80,19:45,20:00,34.5,,0,34.5,34.5,1,-95268,47858,143126,-47410,0,0,3488,0,0,,3488,3488
5,02-02-18,81,20:00,20:15,62.09,,0,62.09,62.09,1,-110126,42226,152352,-67900,0,0,8458,0,0,,8458,8458
5,02-02-18,82,20:15,20:30,238.09,,0,238.09,238.09,1,-115226,46420,161646,-68806,0,0,23665,0,0,,23665,23665
5,02-02-18,83,20:30,20:45,66.75,,0,66.75,66.75,1,-82367,24256,106623,-58111,0,0,19567,0,0,,19567,19567
5,02-02-18,84,20:45,21:00,42.51,,0,42.51,42.51,1,-104443,27861,132304,-76582,0,0,18878,0,0,,18878,18878
5,02-02-18,85,21:00,21:15,77.09,,0,77.09,77.09,1,-117568,45999,163567,-71569,0,0,8652,0,0,,8652,8652
5,02-02-18,86,21:15,21:30,238.09,,0,238.09,238.09,1,-101843,46222,148065,-55621,0,0,40988,0,0,,40988,40988
5,02-02-18,87,21:30,21:45,39.06,,0,39.06,39.06,1,-81018,55624,136642,-25394,0,0,10931,0,0,,10931,10931
5,02-02-18,88,21:45,22:00,35.8,34.99,0,35.8,33.69,2,-78924,59588,138512,-19336,0,-102,2722,0,0,,2824,2620
5,02-02-18,89,22:00,22:15,35.8,34.58,0,34.58,34.58,-1,-104087,52191,156278,-51896,0,-309,22,0,0,,331,-287
5,02-02-18,90,22:15,22:30,39.21,,0,39.21,39.21,1,-110739,46904,157643,-63835,0,0,2655,0,0,,2655,2655
5,02-02-18,91,22:30,22:45,44.28,,0,44.28,44.28,1,-102829,46360,149189,-56469,0,0,3828,0,0,,3828,3828
5,02-02-18,92,22:45,23:00,46.09,,0,46.09,46.09,1,-105357,62728,168085,-42629,0,0,5797,0,0,,5797,5797
5,02-02-18,93,23:00,23:15,238.09,,0,238.09,238.09,1,-116210,68080,184290,-48130,0,0,14345,0,0,,14345,14345
5,02-02-18,94,23:15,23:30,222.09,,0,222.09,222.09,1,-81637,78802,160439,-2835,0,0,26411,0,0,,26411,26411
5,02-02-18,95,23:30,23:45,39.06,34.35,0,39.06,33.66,2,-72598,65197,137795,-7401,0,-837,905,0,0,,1742,68
5,02-02-18,96,23:45,0:00,44.43,32.2,0,44.43,32.2,2,-83937,76063,160000,-7874,0,-125,4213,0,0,,4338,4088
6,02-03-18,1,0:00,0:15,105.48,31.63,0,105.48,31.63,2,-112736,78260,190996,-34476,0,-323,10907,0,0,,11230,10584
6,02-03-18,2,0:15,0:30,108.02,,0,108.02,108.02,1,-70612,63311,133923,-7301,0,0,26426,0,0,,26426,26426
6,02-03-18,3,0:30,0:45,36.76,,0,36.76,36.76,1,-74270,51987,126257,-22283,0,0,3207,0,0,,3207,3207
6,02-03-18,4,0:45,1:00,,,0,33.11,33.11,0,-94352,64795,159147,-29557,0,0,36,0,0,,36,36
6,02-03-18,5,1:00,1:15,62.28,,0,62.28,62.28,1,-89117,27762,116879,-61355,0,0,7154,0,0,,7154,7154
6,02-03-18,6,1:15,1:30,36.29,,0,36.29,36.29,1,-98382,35328,133710,-63054,0,0,4098,0,0,,4098,4098
6,02-03-18,7,1:30,1:45,,,0,32.97,32.97,0,-66739,33171,99910,-33568,0,0,0,0,0,,0,0
6,02-03-18,8,1:45,2:00,,,0,32.97,32.97,0,-61083,38948,100031,-22135,0,0,0,0,0,,0,0
6,02-03-18,9,2:00,2:15,60.47,,0,60.47,60.47,1,-74222,29088,103310,-45134,0,0,6141,0,0,,6141,6141
6,02-03-18,10,2:15,2:30,65.02,31.63,0,65.02,31.63,2,-77474,45191,122665,-32283,0,-178,15528,0,0,,15706,15350
6,02-03-18,11,2:30,2:45,65.02,30.74,0,30.74,30.74,-1,-53609,39044,92653,-14565,0,-1253,115,0,0,,1368,-1138
6,02-03-18,12,2:45,3:00,,31.03,0,31.03,31.03,-1,-47850,58774,106624,10924,0,-3116,0,0,0,,3116,-3116
6,02-03-18,13,3:00,3:15,38.63,34.98,0,38.63,38.63,1,-57198,30283,87481,-26915,0,-1126,309,0,0,,1435,-817
6,02-03-18,14,3:15,3:30,44.63,,0,44.63,44.63,1,-48263,35433,83696,-12830,0,0,13301,0,0,,13301,13301
6,02-03-18,15,3:30,3:45,38.63,,0,38.63,38.63,1,-47655,35345,83000,-12310,0,0,9294,0,0,,9294,9294
6,02-03-18,16,3:45,4:00,36.51,,0,36.51,36.51,1,-55299,39421,94720,-15878,0,0,9131,0,0,,9131,9131
6,02-03-18,17,4:00,4:15,,,0,32.85,32.85,0,-40978,54527,95505,13549,0,0,1276,0,0,,1276,1276
6,02-03-18,18,4:15,4:30,34.65,,0,34.65,34.65,1,-55608,35990,91598,-19618,0,0,1116,0,0,,1116,1116
6,02-03-18,19,4:30,4:45,30.63,,0,30.63,30.63,1,-42876,35481,78357,-7395,0,0,222,0,0,,222,222
6,02-03-18,20,4:45,5:00,,28.79,0,28.79,28.79,-1,-39964,52458,92422,12494,0,-3431,0,0,0,,3431,-3431
6,02-03-18,21,5:00,5:15,,20.36,0,20.36,20.36,-1,-30029,72840,102869,42811,0,-32200,0,0,0,,32200,-32200
6,02-03-18,22,5:15,5:30,,27.94,0,27.94,27.94,-1,-33199,68253,101452,35054,0,-30833,0,0,0,,30833,-30833
6,02-03-18,23,5:30,5:45,,25.27,0,25.27,25.27,-1,-49309,61810,111119,12501,0,-24857,0,0,0,,24857,-24857
6,02-03-18,24,5:45,6:00,30.65,25.27,0,30.65,30.65,1,-46308,52643,98951,6335,0,-1342,83,0,0,,1425,-1259
6,02-03-18,25,6:00,6:15,,33.11,0,33.11,33.11,-1,-5447,80932,86379,75485,0,-547,0,0,0,,547,-547
6,02-03-18,26,6:15,6:30,,35.26,0,35.26,35.26,-1,-13423,65558,78981,52135,0,-207,0,0,0,,207,-207
6,02-03-18,27,6:30,6:45,,,0,32.93,32.93,0,-28054,41023,69077,12969,0,0,0,0,0,,0,0
6,02-03-18,28,6:45,7:00,,,0,32.93,32.93,0,-33538,37879,71417,4341,0,0,0,0,0,,0,0
6,02-03-18,29,7:00,7:15,30.59,,0,30.59,30.59,1,-52910,50663,103573,-2247,0,0,25,0,0,,25,25
6,02-03-18,30,7:15,7:30,30.59,,0,30.59,30.59,1,-57058,60950,118008,3892,0,0,45,0,0,,45,45
6,02-03-18,31,7:30,7:45,47.45,,0,47.45,47.45,1,-88293,56657,144950,-31636,0,0,4327,0,0,,4327,4327
6,02-03-18,32,7:45,8:00,222.02,,0,222.02,222.02,1,-97044,42074,139118,-54970,0,0,47053,0,0,,47053,47053
6,02-03-18,33,8:00,8:15,34.86,-26.76,0,-26.76,-26.76,-1,-39686,124740,164426,85054,0,-8673,11184,0,0,,19857,2511
6,02-03-18,34,8:15,8:30,,-150.03,0,-150.03,-150.03,-1,-39787,71778,111565,31991,0,-41486,0,0,0,,41486,-41486
6,02-03-18,35,8:30,8:45,,32.87,0,32.87,32.87,-1,-62888,46241,109129,-16647,0,-1474,0,0,0,,1474,-1474
6,02-03-18,36,8:45,9:00,,,0,32.95,32.95,0,-99848,39979,139827,-59869,0,0,0,0,0,,0,0
6,02-03-18,37,9:00,9:15,,6.1,0,6.1,6.1,-1,-6318,98026,104344,91708,0,-15508,0,0,0,,15508,-15508
6,02-03-18,38,9:15,9:30,,31.72,0,31.72,31.72,-1,-37586,61917,99503,24331,0,-6787,0,0,0,,6787,-6787
6,02-03-18,39,9:30,9:45,,,0,33.39,33.39,0,-51711,50961,102672,-750,0,0,0,0,0,,0,0
6,02-03-18,40,9:45,10:00,38.51,,0,38.51,38.51,1,-66474,49828,116302,-16646,0,0,2780,0,0,,2780,2780
6,02-03-18,41,10:00,10:15,38.21,,0,38.21,38.21,1,-30229,62241,92470,32012,0,0,3223,0,0,,3223,3223
6,02-03-18,42,10:15,10:30,,,0,33.48,33.48,0,-34152,70585,104737,36433,0,0,0,0,0,,0,0
6,02-03-18,43,10:30,10:45,,,0,33.48,33.48,0,-35021,70753,105774,35732,0,0,0,0,0,,0,0
6,02-03-18,44,10:45,11:00,,,0,33.48,33.48,0,-44111,61781,105892,17670,0,0,0,0,0,,0,0
6,02-03-18,45,11:00,11:15,,,0,33.4,33.4,0,-32605,46310,78915,13705,0,0,0,0,0,,0,0
6,02-03-18,46,11:15,11:30,,,0,33.39,33.39,0,-33545,48524,82069,14979,0,0,0,0,0,,0,0
6,02-03-18,47,11:30,11:45,,,0,33.4,33.4,0,-29815,56449,86264,26634,0,0,0,0,0,,0,0
6,02-03-18,48,11:45,12:00,,35.59,0,35.59,35.59,-1,-36961,53215,90176,16254,0,-325,0,0,0,,325,-325
6,02-03-18,49,12:00,12:15,35.3,35.59,0,35.3,35.3,1,-80325,41247,121572,-39078,0,-83,358,0,0,,441,275
6,02-03-18,50,12:15,12:30,,,0,33.49,33.49,0,-74308,44696,119004,-29612,0,0,0,0,0,,0,0
6,02-03-18,51,12:30,12:45,36.47,,0,36.47,36.47,1,-58969,47574,106543,-11395,0,0,1120,0,0,,1120,1120
6,02-03-18,52,12:45,13:00,33.98,,0,33.98,33.98,1,-56025,59288,115313,3263,0,0,911,0,0,,911,911
6,02-03-18,53,13:00,13:15,56.22,,0,56.22,56.22,1,-78203,52121,130324,-26082,0,0,10775,0,0,,10775,10775
6,02-03-18,54,13:15,13:30,36.88,,0,36.88,36.88,1,-67169,57553,124722,-9616,0,0,8626,0,0,,8626,8626
6,02-03-18,55,13:30,13:45,,,0,33.29,33.29,0,-64942,50058,115000,-14884,0,0,49,0,0,,49,49
6,02-03-18,56,13:45,14:00,,35.4,0,35.4,35.4,-1,-67179,57863,125042,-9316,0,-63,0,0,0,,63,-63
6,02-03-18,57,14:00,14:15,,34.58,0,34.58,34.58,-1,-46324,53729,100053,7405,0,-893,0,0,0,,893,-893
6,02-03-18,58,14:15,14:30,,,0,32.9,32.9,0,-40397,56873,97270,16476,0,0,0,0,0,,0,0
6,02-03-18,59,14:30,14:45,,,0,32.91,32.91,0,-29675,75982,105657,46307,0,0,0,0,0,,0,0
6,02-03-18,60,14:45,15:00,,34.65,0,34.65,34.65,-1,-30109,64907,95016,34798,0,-397,0,0,0,,397,-397
6,02-03-18,61,15:00,15:15,,35.3,0,35.3,35.3,-1,-32550,72976,105526,40426,0,-1312,0,0,0,,1312,-1312
6,02-03-18,62,15:15,15:30,,,0,33.15,33.15,0,-36030,73273,109303,37243,0,-77,0,0,0,,77,-77
6,02-03-18,63,15:30,15:45,,,0,33.15,33.15,0,-35682,71073,106755,35391,0,0,0,0,0,,0,0
6,02-03-18,64,15:45,16:00,,,0,33.15,33.15,0,-37120,67945,105065,30825,0,0,0,0,0,,0,0
6,02-03-18,65,16:00,16:15,,35.77,0,35.77,35.77,-1,-65287,60661,125948,-4626,0,-200,0,0,0,,200,-200
6,02-03-18,66,16:15,16:30,,35.77,0,35.77,35.77,-1,-50497,70980,121477,20483,0,-880,0,0,0,,880,-880
6,02-03-18,67,16:30,16:45,,,0,33.22,33.22,0,-62173,76065,138238,13892,0,-128,0,0,0,,128,-128
6,02-03-18,68,16:45,17:00,,,0,33.22,33.22,0,-78583,76222,154805,-2361,0,0,0,0,0,,0,0
6,02-03-18,69,17:00,17:15,,-9.75,0,-9.75,-9.75,-1,-40081,96647,136728,56566,0,-23999,0,0,0,,23999,-23999
6,02-03-18,70,17:15,17:30,,31.03,0,31.03,31.03,-1,-70511,73652,144163,3141,0,-13372,0,0,0,,13372,-13372
6,02-03-18,71,17:30,17:45,,,0,32.89,32.89,0,-77116,66752,143868,-10364,0,-926,0,0,0,,926,-926
6,02-03-18,72,17:45,18:00,57.02,,0,57.02,57.02,1,-108011,67149,175160,-40862,0,0,14372,0,0,,14372,14372
6,02-03-18,73,18:00,18:15,56.54,33.78,0,33.78,33.78,-1,-79512,46282,125794,-33230,0,-80,15873,0,0,,15953,15793
6,02-03-18,74,18:15,18:30,56.54,33.88,0,33.88,33.88,-1,-50484,54615,105099,4131,0,-318,136,0,0,,454,-182
6,02-03-18,75,18:30,18:45,,26.72,0,26.72,26.72,-1,-42410,71118,113528,28708,0,-13892,0,0,0,,13892,-13892
6,02-03-18,76,18:45,19:00,,30.72,0,30.72,30.72,-1,-38882,82556,121438,43674,0,-19572,0,0,0,,19572,-19572
6,02-03-18,77,19:00,19:15,34.66,31.88,0,34.66,34.66,1,-77056,28577,105633,-48479,0,-10663,347,0,0,,11010,-10316
6,02-03-18,78,19:15,19:30,,,0,33.35,33.35,0,-65673,35692,101365,-29981,0,-62,146,0,0,,208,84
6,02-03-18,79,19:30,19:45,,21.19,0,21.19,21.19,-1,-34093,50649,84742,16556,0,-11052,0,0,0,,11052,-11052
6,02-03-18,80,19:45,20:00,30.91,23.69,0,30.91,30.91,1,-55717,58015,113732,2298,0,-15751,6,0,0,,15757,-15745
6,02-03-18,81,20:00,20:15,33.98,23.69,0,33.98,33.98,1,-87508,42200,129708,-45308,0,-149,1246,0,0,,1395,1097
6,02-03-18,82,20:15,20:30,30.63,,0,30.63,30.63,1,-65563,46499,112062,-19064,0,0,299,0,0,,299,299
6,02-03-18,83,20:30,20:45,,24.27,0,24.27,24.27,-1,-44053,59861,103914,15808,0,-2440,0,0,0,,2440,-2440
6,02-03-18,84,20:45,21:00,,9,0,9,9,-1,-26824,81311,108135,54487,0,-35081,0,0,0,,35081,-35081
6,02-03-18,85,21:00,21:15,222.02,9,0,222.02,222.02,1,-111345,41679,153024,-69666,0,-10902,15367,0,0,,26269,4465
6,02-03-18,86,21:15,21:30,42.02,32.03,0,32.03,32.03,-1,-49279,64661,113940,15382,0,-306,12121,0,0,,12427,11815
6,02-03-18,87,21:30,21:45,42.02,31.72,0,31.72,31.72,-1,-41527,76849,118376,35322,0,-763,49,0,0,,812,-714
6,02-03-18,88,21:45,22:00,,3.2,0,3.2,3.2,-1,-34139,94156,128295,60017,0,-35002,0,0,0,,35002,-35002
6,02-03-18,89,22:00,22:15,,31.03,0,31.03,31.03,-1,-94198,77897,172095,-16301,0,-13632,0,0,0,,13632,-13632
6,02-03-18,90,22:15,22:30,,-28.16,0,-28.16,-28.16,-1,-64987,105826,170813,40839,0,-25291,0,0,0,,25291,-25291
6,02-03-18,91,22:30,22:45,,26.72,0,26.72,26.72,-1,-63250,112571,175821,49321,0,-28531,0,0,0,,28531,-28531
6,02-03-18,92,22:45,23:00,,11.67,0,11.67,11.67,-1,-45004,145107,190111,100103,0,-39710,0,0,0,,39710,-39710
6,02-03-18,93,23:00,23:15,,-15.4,0,-15.4,-15.4,-1,-72451,120863,193314,48412,0,-34243,0,0,0,,34243,-34243
6,02-03-18,94,23:15,23:30,,-29.6,0,-29.6,-29.6,-1,-53704,119469,173173,65765,0,-45170,0,0,0,,45170,-45170
6,02-03-18,95,23:30,23:45,,18.26,0,18.26,18.26,-1,-46344,114396,160740,68052,0,-61566,0,0,0,,61566,-61566
6,02-03-18,96,23:45,0:00,,-6.51,0,-6.51,-6.51,-1,-61716,138260,199976,76544,0,-70429,0,0,0,,70429,-70429
6,02-04-18,1,0:00,0:15,,-11.05,0,-11.05,-11.05,-1,-53667,136871,190538,83204,0,-41511,0,0,0,,41511,-41511
6,02-04-18,2,0:15,0:30,,30.33,0,30.33,30.33,-1,-51932,124440,176372,72508,0,-286,0,0,0,,286,-286
6,02-04-18,3,0:30,0:45,,-19.32,0,-19.32,-19.32,-1,-57266,139368,196634,82102,0,-5710,0,0,0,,5710,-5710
6,02-04-18,4,0:45,1:00,,-117.78,0,-117.78,-117.78,-1,-79805,105720,185525,25915,0,-26962,0,0,0,,26962,-26962
6,02-04-18,5,1:00,1:15,69.12,32.21,0,69.12,69.12,1,-84062,66755,150817,-17307,0,-6962,5148,0,0,,12110,-1814
6,02-04-18,6,1:15,1:30,107.12,32.21,0,107.12,107.12,1,-89368,50100,139468,-39268,0,-6,34298,0,0,,34304,34292
6,02-04-18,7,1:30,1:45,107.12,31.21,0,31.21,31.21,-1,-77799,78059,155858,260,0,-1845,2087,0,0,,3932,242
6,02-04-18,8,1:45,2:00,,31.78,0,31.78,31.78,-1,-59080,70271,129351,11191,0,-8133,0,0,0,,8133,-8133
6,02-04-18,9,2:00,2:15,,31.21,0,31.21,31.21,-1,-63477,80568,144045,17091,0,-6650,0,0,0,,6650,-6650
6,02-04-18,10,2:15,2:30,,30.22,0,30.22,30.22,-1,-49017,68471,117488,19454,0,-4505,0,0,0,,4505,-4505
6,02-04-18,11,2:30,2:45,,30.51,0,30.51,30.51,-1,-49355,79412,128767,30057,0,-6400,0,0,0,,6400,-6400
6,02-04-18,12,2:45,3:00,,27.82,0,27.82,27.82,-1,-39551,85116,124667,45565,0,-15132,0,0,0,,15132,-15132
6,02-04-18,13,3:00,3:15,,26.87,0,26.87,26.87,-1,-26966,106390,133356,79424,0,-15282,0,0,0,,15282,-15282
6,02-04-18,14,3:15,3:30,,20.85,0,20.85,20.85,-1,-19029,118933,137962,99904,0,-2072,0,0,0,,2072,-2072
6,02-04-18,15,3:30,3:45,,15.7,0,15.7,15.7,-1,-21920,127575,149495,105655,0,-9517,0,0,0,,9517,-9517
6,02-04-18,16,3:45,4:00,,34.09,0,34.09,34.09,-1,-23161,108082,131243,84921,0,-1755,0,0,0,,1755,-1755
6,02-04-18,17,4:00,4:15,,35.12,0,35.12,35.12,-1,-25550,64947,90497,39397,0,-214,0,0,0,,214,-214
6,02-04-18,18,4:15,4:30,,,0,33.44,33.44,0,-32134,63091,95225,30957,0,0,0,0,0,,0,0
6,02-04-18,19,4:30,4:45,,,0,33.43,33.43,0,-35911,52751,88662,16840,0,0,0,0,0,,0,0
6,02-04-18,20,4:45,5:00,,32.21,0,32.21,32.21,-1,-30242,46101,76343,15859,0,-208,0,0,0,,208,-208
6,02-04-18,21,5:00,5:15,38.21,32.21,0,38.21,32.21,2,-45636,35054,80690,-10582,0,-644,683,0,0,,1327,39
6,02-04-18,22,5:15,5:30,38.21,,0,38.21,38.21,1,-51814,34015,85829,-17799,0,0,3310,0,0,,3310,3310
6,02-04-18,23,5:30,5:45,32.35,,0,32.35,32.35,1,-52535,34473,87008,-18062,0,0,2774,0,0,,2774,2774
6,02-04-18,24,5:45,6:00,31.97,,0,31.97,31.97,1,-53357,49155,102512,-4202,0,0,2153,0,0,,2153,2153
6,02-04-18,25,6:00,6:15,34.62,,0,34.62,34.62,1,-68448,32115,100563,-36333,0,0,1746,0,0,,1746,1746
6,02-04-18,26,6:15,6:30,31.86,32.14,0,32.14,32.14,-1,-34778,34292,69070,-486,0,-175,874,0,0,,1049,699
6,02-04-18,27,6:30,6:45,,,0,33.62,33.62,0,-37147,33143,70290,-4004,0,-105,0,0,0,,105,-105
6,02-04-18,28,6:45,7:00,,,0,33.62,33.62,0,-42314,36328,78642,-5986,0,0,0,0,0,,0,0
6,02-04-18,29,7:00,7:15,,,0,33.16,33.16,0,-55286,27164,82450,-28122,0,0,0,0,0,,0,0
6,02-04-18,30,7:15,7:30,,32.14,0,32.14,32.14,-1,-50791,44788,95579,-6003,0,-1011,0,0,0,,1011,-1011
6,02-04-18,31,7:30,7:45,,,0,33.16,33.16,0,-81582,41458,123040,-40124,0,-13,0,0,0,,13,-13
6,02-04-18,32,7:45,8:00,,,0,33.16,33.16,0,-119481,45382,164863,-74099,0,0,0,0,0,,0,0
6,02-04-18,33,8:00,8:15,,,0,33.25,33.25,0,-63710,53342,117052,-10368,0,0,0,0,0,,0,0
6,02-04-18,34,8:15,8:30,,,0,33.25,33.25,0,-75979,63146,139125,-12833,0,0,0,0,0,,0,0
6,02-04-18,35,8:30,8:45,34.14,,0,34.14,34.14,1,-84184,50472,134656,-33712,0,0,147,0,0,,147,147
6,02-04-18,36,8:45,9:00,70.11,,0,70.11,70.11,1,-85862,46524,132386,-39338,0,0,14750,0,0,,14750,14750
6,02-04-18,37,9:00,9:15,34.87,31.78,0,31.78,31.78,-1,-36397,90222,126619,53825,0,-687,7961,0,0,,8648,7274
6,02-04-18,38,9:15,9:30,,,0,33.28,33.28,0,-35414,86617,122031,51203,0,0,0,0,0,,0,0
6,02-04-18,39,9:30,9:45,,32.14,0,32.14,32.14,-1,-40025,95658,135683,55633,0,-1600,0,0,0,,1600,-1600
6,02-04-18,40,9:45,10:00,,32.14,0,32.14,32.14,-1,-52807,81932,134739,29125,0,-1300,0,0,0,,1300,-1300
6,02-04-18,41,10:00,10:15,,30.72,0,30.72,30.72,-1,-20116,126465,146581,106349,0,-9400,0,0,0,,9400,-9400
6,02-04-18,42,10:15,10:30,,31.14,0,31.14,31.14,-1,-22608,120341,142949,97733,0,-11702,0,0,0,,11702,-11702
6,02-04-18,43,10:30,10:45,,14.16,0,14.16,14.16,-1,-26083,132667,158750,106584,0,-28974,0,0,0,,28974,-28974
6,02-04-18,44,10:45,11:00,,26.78,0,26.78,26.78,-1,-42875,127278,170153,84403,0,-35761,0,0,0,,35761,-35761
6,02-04-18,45,11:00,11:15,,-1.43,0,-1.43,-1.43,-1,-36370,104992,141362,68622,0,-52509,0,0,0,,52509,-52509
6,02-04-18,46,11:15,11:30,,21.81,0,21.81,21.81,-1,-67607,107099,174706,39492,0,-41303,0,0,0,,41303,-41303
6,02-04-18,47,11:30,11:45,,21.04,0,21.04,21.04,-1,-61671,120522,182193,58851,0,-37103,0,0,0,,37103,-37103
6,02-04-18,48,11:45,12:00,,-2.89,0,-2.89,-2.89,-1,-60323,145813,206136,85490,0,-49103,0,0,0,,49103,-49103
6,02-04-18,49,12:00,12:15,,-8.78,0,-8.78,-8.78,-1,-74142,89056,163198,14914,0,-37684,0,0,0,,37684,-37684
6,02-04-18,50,12:15,12:30,,31.78,0,31.78,31.78,-1,-64644,102924,167568,38280,0,-5558,0,0,0,,5558,-5558
6,02-04-18,51,12:30,12:45,,26.44,0,26.44,26.44,-1,-56505,105895,162400,49390,0,-12289,0,0,0,,12289,-12289
6,02-04-18,52,12:45,13:00,,26.44,0,26.44,26.44,-1,-50250,101576,151826,51326,0,-16222,0,0,0,,16222,-16222
6,02-04-18,53,13:00,13:15,,31.89,0,31.89,31.89,-1,-19516,97087,116603,77571,0,-11840,0,0,0,,11840,-11840
6,02-04-18,54,13:15,13:30,,20.33,0,20.33,20.33,-1,-19960,92678,112638,72718,0,-16085,0,0,0,,16085,-16085
6,02-04-18,55,13:30,13:45,,31.78,0,31.78,31.78,-1,-31302,87049,118351,55747,0,-14883,0,0,0,,14883,-14883
6,02-04-18,56,13:45,14:00,,31.14,0,31.14,31.14,-1,-34310,69064,103374,34754,0,-2126,0,0,0,,2126,-2126
6,02-04-18,57,14:00,14:15,,27.34,0,27.34,27.34,-1,-32177,114325,146502,82148,0,-3322,0,0,0,,3322,-3322
6,02-04-18,58,14:15,14:30,,34.2,0,34.2,34.2,-1,-30724,95828,126552,65104,0,-1364,0,0,0,,1364,-1364
6,02-04-18,59,14:30,14:45,,31.14,0,31.14,31.14,-1,-45548,72914,118462,27366,0,-6188,0,0,0,,6188,-6188
6,02-04-18,60,14:45,15:00,,33.68,0,33.68,33.68,-1,-53629,53997,107626,368,0,-3480,0,0,0,,3480,-3480
6,02-04-18,61,15:00,15:15,,35.48,0,35.48,35.48,-1,-52638,42696,95334,-9942,0,-1529,0,0,0,,1529,-1529
6,02-04-18,62,15:15,15:30,,,0,33.13,33.13,0,-59942,33409,93351,-26533,0,-12,0,0,0,,12,-12
6,02-04-18,63,15:30,15:45,45.33,,0,45.33,45.33,1,-83815,29252,113067,-54563,0,0,1377,0,0,,1377,1377
6,02-04-18,64,15:45,16:00,62.72,,0,62.72,62.72,1,-88995,31612,120607,-57383,0,0,13663,0,0,,13663,13663
6,02-04-18,65,16:00,16:15,35.12,,0,35.12,35.12,1,-62359,50121,112480,-12238,0,0,6154,0,0,,6154,6154
6,02-04-18,66,16:15,16:30,57.12,,0,57.12,57.12,1,-76465,30548,107013,-45917,0,0,19658,0,0,,19658,19658
6,02-04-18,67,16:30,16:45,54.99,,0,54.99,54.99,1,-90183,35031,125214,-55152,0,0,41759,0,0,,41759,41759
6,02-04-18,68,16:45,17:00,60.96,,0,60.96,60.96,1,-82654,49816,132470,-32838,0,0,38936,0,0,,38936,38936
6,02-04-18,69,17:00,17:15,60.96,-111.55,0,-111.55,-111.55,-1,-71835,122471,194306,50636,0,-18107,8784,0,0,,26891,-9323
6,02-04-18,70,17:15,17:30,,31.14,0,31.14,31.14,-1,-61927,83514,145441,21587,0,-8715,0,0,0,,8715,-8715
6,02-04-18,71,17:30,17:45,,,0,32.41,32.41,0,-109979,71975,181954,-38004,0,-1734,0,0,0,,1734,-1734
6,02-04-18,72,17:45,18:00,76.12,,0,76.12,76.12,1,-118134,64316,182450,-53818,0,0,11039,0,0,,11039,11039
6,02-04-18,73,18:00,18:15,38.25,,0,38.25,38.25,1,-69866,29520,99386,-40346,0,0,6451,0,0,,6451,6451
6,02-04-18,74,18:15,18:30,,,0,33.56,33.56,0,-59344,43373,102717,-15971,0,0,0,0,0,,0,0
6,02-04-18,75,18:30,18:45,,,0,33.59,33.59,0,-68306,58588,126894,-9718,0,0,0,0,0,,0,0
6,02-04-18,76,18:45,19:00,,,0,32.56,32.56,0,-76838,69454,146292,-7384,0,0,0,0,0,,0,0
6,02-04-18,77,19:00,19:15,45.88,,0,45.88,45.88,1,-80128,38165,118293,-41963,0,0,5685,0,0,,5685,5685
6,02-04-18,78,19:15,19:30,39.4,,0,39.4,39.4,1,-63819,57927,121746,-5892,0,0,12495,0,0,,12495,12495
6,02-04-18,79,19:30,19:45,,,0,33.68,33.68,0,-58998,74904,133902,15906,0,0,1784,0,0,,1784,1784
6,02-04-18,80,19:45,20:00,,33.57,0,33.57,33.57,-1,-50929,84273,135202,33344,0,-33,0,0,0,,33,-33
6,02-04-18,81,20:00,20:15,,33.24,0,33.24,33.24,-1,-74499,57367,131866,-17132,0,-558,0,0,0,,558,-558
6,02-04-18,82,20:15,20:30,,32.48,0,32.48,32.48,-1,-64171,63657,127828,-514,0,-647,0,0,0,,647,-647
6,02-04-18,83,20:30,20:45,,32.48,0,32.48,32.48,-1,-32163,81242,113405,49079,0,-575,0,0,0,,575,-575
6,02-04-18,84,20:45,21:00,,22.4,0,22.4,22.4,-1,-29662,121307,150969,91645,0,-3613,0,0,0,,3613,-3613
6,02-04-18,85,21:00,21:15,34.48,-0.42,0,34.48,-0.42,2,-75896,79027,154923,3131,0,-8407,31,0,0,,8438,-8376
6,02-04-18,86,21:15,21:30,35.03,-0.42,0,35.03,35.03,1,-50580,62017,112597,11437,0,-66,309,0,0,,375,243
6,02-04-18,87,21:30,21:45,,,0,33.26,33.26,0,-31429,90962,122391,59533,0,0,0,0,0,,0,0
6,02-04-18,88,21:45,22:00,,31.48,0,31.48,31.48,-1,-33820,110573,144393,76753,0,-238,0,0,0,,238,-238
6,02-04-18,89,22:00,22:15,,30.98,0,30.98,30.98,-1,-91094,58388,149482,-32706,0,-471,0,0,0,,471,-471
6,02-04-18,90,22:15,22:30,,,0,33.28,33.28,0,-78678,54287,132965,-24391,0,0,0,0,0,,0,0
6,02-04-18,91,22:30,22:45,,35.73,0,35.73,35.73,-1,-63287,68081,131368,4794,0,-47,0,0,0,,47,-47
6,02-04-18,92,22:45,23:00,,34.31,0,34.31,34.31,-1,-58528,86538,145066,28010,0,-495,0,0,0,,495,-495
6,02-04-18,93,23:00,23:15,238.12,34.31,0,238.12,238.12,1,-116557,30264,146821,-86293,0,-99,23000,0,0,,23099,22901
6,02-04-18,94,23:15,23:30,238.12,30.87,0,238.12,30.87,2,-72047,60771,132818,-11276,0,-152,41365,0,0,,41517,41213
6,02-04-18,95,23:30,23:45,238.12,30.78,0,30.78,30.78,-1,-63382,85978,149360,22596,0,-1569,393,0,0,,1962,-1176
6,02-04-18,96,23:45,0:00,,30.78,0,30.78,30.78,-1,-80679,106571,187250,25892,0,-7108,0,0,0,,7108,-7108
6,02-05-18,1,0:00,0:15,,32.14,0,32.14,32.14,-1,-36852,150448,187300,113596,0,-4180,0,0,0,,4180,-4180
6,02-05-18,2,0:15,0:30,,,0,32.82,32.82,0,-56206,99900,156106,43694,0,0,0,0,0,,0,0
6,02-05-18,3,0:30,0:45,,,0,32.82,32.82,0,-60113,79342,139455,19229,0,0,0,0,0,,0,0
6,02-05-18,4,0:45,1:00,,31.14,0,31.14,31.14,-1,-63059,99239,162298,36180,0,-1031,0,0,0,,1031,-1031
6,02-05-18,5,1:00,1:15,,,0,32.76,32.76,0,-63744,74834,138578,11090,0,-22,0,0,0,,22,-22
6,02-05-18,6,1:15,1:30,,,0,32.76,32.76,0,-50723,66080,116803,15357,0,0,0,0,0,,0,0
6,02-05-18,7,1:30,1:45,,,0,32.76,32.76,0,-48235,64222,112457,15987,0,0,0,0,0,,0,0
6,02-05-18,8,1:45,2:00,,,0,32.76,32.76,0,-58454,69925,128379,11471,0,0,0,0,0,,0,0
6,02-05-18,9,2:00,2:15,,,0,32.29,32.29,0,-51479,83347,134826,31868,0,0,0,0,0,,0,0
6,02-05-18,10,2:15,2:30,,,0,32.29,32.29,0,-48320,60499,108819,12179,0,0,0,0,0,,0,0
6,02-05-18,11,2:30,2:45,31.85,,0,31.85,31.85,1,-60988,57228,118216,-3760,0,0,280,0,0,,280,280
6,02-05-18,12,2:45,3:00,35.56,30.22,0,35.56,30.22,2,-60792,67105,127897,6313,0,-837,1590,0,0,,2427,753
6,02-05-18,13,3:00,3:15,,27.03,0,27.03,27.03,-1,-65443,70357,135800,4914,0,-4173,0,0,0,,4173,-4173
6,02-05-18,14,3:15,3:30,,,0,32.13,32.13,0,-61891,62995,124886,1104,0,0,0,0,0,,0,0
6,02-05-18,15,3:30,3:45,35.56,,0,35.56,35.56,1,-55150,58019,113169,2869,0,0,401,0,0,,401,401
6,02-05-18,16,3:45,4:00,,,0,32.13,32.13,0,-42347,59635,101982,17288,0,0,0,0,0,,0,0
6,02-05-18,17,4:00,4:15,,,0,32.08,32.08,0,-25634,53745,79379,28111,0,0,0,0,0,,0,0
6,02-05-18,18,4:15,4:30,,31.14,0,31.14,31.14,-1,-25377,55260,80637,29883,0,-1754,0,0,0,,1754,-1754
6,02-05-18,19,4:30,4:45,,31.14,0,31.14,31.14,-1,-38948,49808,88756,10860,0,-3441,0,0,0,,3441,-3441
6,02-05-18,20,4:45,5:00,,33.36,0,33.36,33.36,-1,-41668,70947,112615,29279,0,-50,0,0,0,,50,-50
6,02-05-18,21,5:00,5:15,,31.14,0,31.14,31.14,-1,-96122,105063,201185,8941,0,-163,0,0,0,,163,-163
6,02-05-18,22,5:15,5:30,,3.84,0,3.84,3.84,-1,-26523,84081,110604,57558,0,-28070,0,0,0,,28070,-28070
6,02-05-18,23,5:30,5:45,,30.7,0,30.7,30.7,-1,-9660,53507,63167,43847,0,-10507,0,0,0,,10507,-10507
6,02-05-18,24,5:45,6:00,,25.29,0,25.29,25.29,-1,-9520,127328,136848,117808,0,-4733,0,0,0,,4733,-4733
6,02-05-18,25,6:00,6:15,,28.6,0,28.6,28.6,-1,-110344,92127,202471,-18217,0,-5327,0,0,0,,5327,-5327
6,02-05-18,26,6:15,6:30,,4.68,0,4.68,4.68,-1,-71235,92145,163380,20910,0,-35086,0,0,0,,35086,-35086
6,02-05-18,27,6:30,6:45,30.78,33.24,0,30.78,30.78,1,-131942,80921,212863,-51021,0,-4495,257,0,0,,4752,-4238
6,02-05-18,28,6:45,7:00,70.28,,0,70.28,70.28,1,-140741,103229,243970,-37512,0,0,7697,0,0,,7697,7697
6,02-05-18,29,7:00,7:15,34.23,-107.52,0,34.23,-107.52,2,-92254,211935,304189,119681,0,-26659,2388,0,0,,29047,-24271
6,02-05-18,30,7:15,7:30,,31.03,0,31.03,31.03,-1,-141203,180140,321343,38937,0,-15478,0,0,0,,15478,-15478
6,02-05-18,31,7:30,7:45,,31.65,0,31.65,31.65,-1,-143713,151272,294985,7559,0,-5035,0,0,0,,5035,-5035
6,02-05-18,32,7:45,8:00,35.79,31.65,0,35.79,35.79,1,-208904,127361,336265,-81543,0,-105,8429,0,0,,8534,8324
6,02-05-18,33,8:00,8:15,32.02,-111.55,0,33.12,-111.55,2,-39397,183237,222634,143840,0,-29028,1582,0,0,,30610,-27446
6,02-05-18,34,8:15,8:30,,-7.32,0,-7.32,-7.32,-1,-45261,183963,229224,138702,0,-50517,0,0,0,,50517,-50517
6,02-05-18,35,8:30,8:45,,27.14,0,27.14,27.14,-1,-47011,155962,202973,108951,0,-29654,0,0,0,,29654,-29654
6,02-05-18,36,8:45,9:00,,32.14,0,32.14,32.14,-1,-61008,155218,216226,94210,0,-124,0,0,0,,124,-124
6,02-05-18,37,9:00,9:15,,34.99,0,34.99,34.99,-1,-39746,157471,197217,117725,0,-1086,0,0,0,,1086,-1086
6,02-05-18,38,9:15,9:30,,,0,33.24,33.24,0,-35719,136143,171862,100424,0,-8,0,0,0,,8,-8
6,02-05-18,39,9:30,9:45,,,0,33.24,33.24,0,-28939,127211,156150,98272,0,0,0,0,0,,0,0
6,02-05-18,40,9:45,10:00,,,0,33.24,33.24,0,-25843,125125,150968,99282,0,0,0,0,0,,0,0
6,02-05-18,41,10:00,10:15,,,0,33.31,33.31,0,-90708,109252,199960,18544,0,0,0,0,0,,0,0
6,02-05-18,42,10:15,10:30,,34.99,0,34.99,34.99,-1,-80996,136977,217973,55981,0,-42,0,0,0,,42,-42
6,02-05-18,43,10:30,10:45,,31.14,0,31.14,31.14,-1,-92719,144915,237634,52196,0,-3776,0,0,0,,3776,-3776
6,02-05-18,44,10:45,11:00,,30.89,0,30.89,30.89,-1,-71279,163898,235177,92619,0,-11186,0,0,0,,11186,-11186
6,02-05-18,45,11:00,11:15,,34.99,0,34.99,34.99,-1,-87553,159200,246753,71647,0,-1107,0,0,0,,1107,-1107
6,02-05-18,46,11:15,11:30,,34.99,0,34.99,34.99,-1,-56903,181929,238832,125026,0,-577,0,0,0,,577,-577
6,02-05-18,47,11:30,11:45,,34.99,0,34.99,34.99,-1,-56964,201348,258312,144384,0,-1383,0,0,0,,1383,-1383
6,02-05-18,48,11:45,12:00,,27.14,0,27.14,27.14,-1,-33388,213723,247111,180335,0,-8591,0,0,0,,8591,-8591
6,02-05-18,49,12:00,12:15,,31.14,0,31.14,31.14,-1,-59255,182307,241562,123052,0,-9066,0,0,0,,9066,-9066
6,02-05-18,50,12:15,12:30,,-26.41,0,-26.41,-26.41,-1,-64511,142692,207203,78181,0,-35867,0,0,0,,35867,-35867
6,02-05-18,51,12:30,12:45,,31.03,0,31.03,31.03,-1,-57962,152009,209971,94047,0,-15804,0,0,0,,15804,-15804
6,02-05-18,52,12:45,13:00,,-8.67,0,-8.67,-8.67,-1,-44795,167178,211973,122383,0,-4664,0,0,0,,4664,-4664
6,02-05-18,53,13:00,13:15,,-24.67,0,-24.67,-24.67,-1,-66503,130299,196802,63796,0,-18124,0,0,0,,18124,-18124
6,02-05-18,54,13:15,13:30,,6.93,0,6.93,6.93,-1,-78257,131514,209771,53257,0,-38968,0,0,0,,38968,-38968
6,02-05-18,55,13:30,13:45,,31.03,0,31.03,31.03,-1,-83855,131057,214912,47202,0,-24744,0,0,0,,24744,-24744
6,02-05-18,56,13:45,14:00,,31.14,0,31.14,31.14,-1,-87434,121467,208901,34033,0,-2589,0,0,0,,2589,-2589
6,02-05-18,57,14:00,14:15,,34.22,0,34.22,34.22,-1,-92380,99422,191802,7042,0,-1582,0,0,0,,1582,-1582
6,02-05-18,58,14:15,14:30,35.16,,0,35.16,35.16,1,-96125,83570,179695,-12555,0,0,674,0,0,,674,674
6,02-05-18,59,14:30,14:45,35.24,,0,35.24,35.24,1,-97729,80259,177988,-17470,0,0,4140,0,0,,4140,4140
6,02-05-18,60,14:45,15:00,34.19,,0,34.19,34.19,1,-88517,78003,166520,-10514,0,0,1645,0,0,,1645,1645
6,02-05-18,61,15:00,15:15,30.73,,0,30.73,30.73,1,-85228,106493,191721,21265,0,0,514,0,0,,514,514
6,02-05-18,62,15:15,15:30,34.46,,0,34.46,34.46,1,-95679,102299,197978,6620,0,0,163,0,0,,163,163
6,02-05-18,63,15:30,15:45,38.21,,0,38.21,38.21,1,-99429,93081,192510,-6348,0,0,3979,0,0,,3979,3979
6,02-05-18,64,15:45,16:00,48.44,,0,48.44,48.44,1,-108285,96046,204331,-12239,0,0,6274,0,0,,6274,6274
6,02-05-18,65,16:00,16:15,48.44,31.14,0,31.14,31.14,-1,-67191,130495,197686,63304,0,-637,2009,0,0,,2646,1372
6,02-05-18,66,16:15,16:30,,31.78,0,31.78,31.78,-1,-59855,110527,170382,50672,0,-1756,0,0,0,,1756,-1756
6,02-05-18,67,16:30,16:45,,31.14,0,31.14,31.14,-1,-64935,103629,168564,38694,0,-5529,0,0,0,,5529,-5529
6,02-05-18,68,16:45,17:00,,33.54,0,33.54,33.54,-1,-79942,102573,182515,22631,0,-536,0,0,0,,536,-536
6,02-05-18,69,17:00,17:15,,-0.73,0,-0.73,-0.73,-1,-52859,113520,166379,60661,0,-21953,0,0,0,,21953,-21953
6,02-05-18,70,17:15,17:30,,31.52,0,31.52,31.52,-1,-70957,80052,151009,9095,0,-5660,0,0,0,,5660,-5660
6,02-05-18,71,17:30,17:45,,,0,34.54,34.54,0,-52045,104104,156149,52059,0,0,0,0,0,,0,0
6,02-05-18,72,17:45,18:00,51.93,,0,51.93,51.93,1,-96071,100245,196316,4174,0,0,1948,0,0,,1948,1948
6,02-05-18,73,18:00,18:15,64.99,,0,64.99,64.99,1,-104486,44481,148967,-60005,0,0,10163,0,0,,10163,10163
6,02-05-18,74,18:15,18:30,76.99,,0,76.99,76.99,1,-86353,60122,146475,-26231,0,0,18246,0,0,,18246,18246
6,02-05-18,75,18:30,18:45,37.27,32.72,0,32.72,32.72,-1,-72547,72582,145129,35,0,-251,7678,0,0,,7929,7427
6,02-05-18,76,18:45,19:00,,31.73,0,31.73,31.73,-1,-59183,74375,133558,15192,0,-2087,0,0,0,,2087,-2087
6,02-05-18,77,19:00,19:15,40.44,31.73,0,40.44,40.44,1,-71918,55129,127047,-16789,0,-276,3223,0,0,,3499,2947
6,02-05-18,78,19:15,19:30,35.8,,0,35.8,35.8,1,-69682,75204,144886,5522,0,0,2441,0,0,,2441,2441
6,02-05-18,79,19:30,19:45,,31.14,0,31.14,31.14,-1,-53963,84835,138798,30872,0,-1409,0,0,0,,1409,-1409
6,02-05-18,80,19:45,20:00,,27.99,0,27.99,27.99,-1,-50553,95423,145976,44870,0,-17746,0,0,0,,17746,-17746
6,02-05-18,81,20:00,20:15,,31.14,0,31.14,31.14,-1,-76325,64868,141193,-11457,0,-10377,0,0,0,,10377,-10377
6,02-05-18,82,20:15,20:30,,,0,32.65,32.65,0,-47680,57253,104933,9573,0,-82,0,0,0,,82,-82
6,02-05-18,83,20:30,20:45,,30.14,0,30.14,30.14,-1,-32416,84363,116779,51947,0,-360,0,0,0,,360,-360
6,02-05-18,84,20:45,21:00,,7.37,0,7.37,7.37,-1,-25143,118165,143308,93022,0,-41369,0,0,0,,41369,-41369
6,02-05-18,85,21:00,21:15,225.02,19.82,0,225.02,225.02,1,-78887,40935,119822,-37952,0,-29966,6275,0,0,,36241,-23691
6,02-05-18,86,21:15,21:30,42.21,28.71,0,28.71,28.71,-1,-54824,68434,123258,13610,0,-1252,9182,0,0,,10434,7930
6,02-05-18,87,21:30,21:45,,27.17,0,27.17,27.17,-1,-37948,63417,101365,25469,0,-7600,0,0,0,,7600,-7600
6,02-05-18,88,21:45,22:00,,-17.86,0,-17.86,-17.86,-1,-20295,83378,103673,63083,0,-12396,0,0,0,,12396,-12396
6,02-05-18,89,22:00,22:15,,-72.19,0,-72.19,-72.19,-1,-104122,47118,151240,-57004,0,-22885,0,0,0,,22885,-22885
6,02-05-18,90,22:15,22:30,35.24,33.16,0,35.24,32.01,2,-112275,53021,165296,-59254,0,-26,73,0,0,,99,47
6,02-05-18,91,22:30,22:45,,29.05,0,29.05,29.05,-1,-31009,74349,105358,43340,0,-3234,0,0,0,,3234,-3234
6,02-05-18,92,22:45,23:00,,32.14,0,32.14,32.14,-1,-46883,101274,148157,54391,0,-2358,0,0,0,,2358,-2358
6,02-05-18,93,23:00,23:15,,31.14,0,31.14,31.14,-1,-73827,92504,166331,18677,0,-1447,0,0,0,,1447,-1447
6,02-05-18,94,23:15,23:30,,31.14,0,31.14,31.14,-1,-50835,68745,119580,17910,0,-872,0,0,0,,872,-872
6,02-05-18,95,23:30,23:45,,31.14,0,31.14,31.14,-1,-32439,46840,79279,14401,0,-5911,0,0,0,,5911,-5911
6,02-05-18,96,23:45,0:00,,30.99,0,30.99,30.99,-1,-42395,58973,101368,16578,0,-4657,0,0,0,,4657,-4657
6,02-06-18,1,0:00,0:15,,26.9,0,26.9,26.9,-1,-58176,106472,164648,48296,0,-8588,0,0,0,,8588,-8588
6,02-06-18,2,0:15,0:30,,22.1,0,22.1,22.1,-1,-52492,66245,118737,13753,0,-9394,0,0,0,,9394,-9394
6,02-06-18,3,0:30,0:45,,,0,33.16,33.16,0,-67436,57672,125108,-9764,0,-192,0,0,0,,192,-192
6,02-06-18,4,0:45,1:00,,,0,33.19,33.19,0,-94546,73141,167687,-21405,0,0,0,0,0,,0,0
6,02-06-18,5,1:00,1:15,50.96,,0,50.96,50.96,1,-70017,46324,116341,-23693,0,0,6267,0,0,,6267,6267
6,02-06-18,6,1:15,1:30,36.68,,0,36.68,36.68,1,-66908,48731,115639,-18177,0,0,14165,0,0,,14165,14165
6,02-06-18,7,1:30,1:45,33.79,,0,33.79,33.79,1,-76177,59685,135862,-16492,0,0,3679,0,0,,3679,3679
6,02-06-18,8,1:45,2:00,31.38,32.14,0,33.17,32.14,2,-53310,62006,115316,8696,0,-796,201,0,0,,997,-595
6,02-06-18,9,2:00,2:15,,34.6,0,34.6,34.6,-1,-46369,65416,111785,19047,0,-1207,0,0,0,,1207,-1207
6,02-06-18,10,2:15,2:30,,34.85,0,34.85,34.85,-1,-53123,62138,115261,9015,0,-141,0,0,0,,141,-141
6,02-06-18,11,2:30,2:45,,33.99,0,33.99,33.99,-1,-50489,53523,104012,3034,0,-1236,0,0,0,,1236,-1236
6,02-06-18,12,2:45,3:00,,32.14,0,32.14,32.14,-1,-52686,56632,109318,3946,0,-1439,0,0,0,,1439,-1439
6,02-06-18,13,3:00,3:15,,31.78,0,31.78,31.78,-1,-37896,66293,104189,28397,0,-7792,0,0,0,,7792,-7792
6,02-06-18,14,3:15,3:30,,32.1,0,32.1,32.1,-1,-48033,57378,105411,9345,0,-6534,0,0,0,,6534,-6534
6,02-06-18,15,3:30,3:45,,31.78,0,31.78,31.78,-1,-48120,61172,109292,13052,0,-8115,0,0,0,,8115,-8115
6,02-06-18,16,3:45,4:00,,32.06,0,32.06,32.06,-1,-50699,55294,105993,4595,0,-13922,0,0,0,,13922,-13922
6,02-06-18,17,4:00,4:15,,32.14,0,32.14,32.14,-1,-46172,60211,106383,14039,0,-12758,0,0,0,,12758,-12758
6,02-06-18,18,4:15,4:30,,32.14,0,32.14,32.14,-1,-40244,53918,94162,13674,0,-11257,0,0,0,,11257,-11257
6,02-06-18,19,4:30,4:45,,32.14,0,32.14,32.14,-1,-39031,48800,87831,9769,0,-11506,0,0,0,,11506,-11506
6,02-06-18,20,4:45,5:00,,34.32,0,34.32,34.32,-1,-44056,55270,99326,11214,0,-3926,0,0,0,,3926,-3926
6,02-06-18,21,5:00,5:15,,28.58,0,28.58,28.58,-1,-52755,68291,121046,15536,0,-15213,0,0,0,,15213,-15213
6,02-06-18,22,5:15,5:30,,31.14,0,31.14,31.14,-1,-48461,57310,105771,8849,0,-18229,0,0,0,,18229,-18229
6,02-06-18,23,5:30,5:45,,32.05,0,32.05,32.05,-1,-40249,51873,92122,11624,0,-9862,0,0,0,,9862,-9862
6,02-06-18,24,5:45,6:00,,12.81,0,12.81,12.81,-1,-49045,90127,139172,41082,0,-22671,0,0,0,,22671,-22671
6,02-06-18,25,6:00,6:15,,11.34,0,11.34,11.34,-1,-70371,145164,215535,74793,0,-22132,0,0,0,,22132,-22132
6,02-06-18,26,6:15,6:30,,28.6,0,28.6,28.6,-1,-56842,99176,156018,42334,0,-27545,0,0,0,,27545,-27545
6,02-06-18,27,6:30,6:45,39.87,31.14,0,39.87,39.87,1,-83064,65166,148230,-17898,0,-16629,483,0,0,,17112,-16146
6,02-06-18,28,6:45,7:00,238.12,31.14,0,238.12,238.12,1,-124494,34716,159210,-89778,0,-398,21723,0,0,,22121,21325
6,02-06-18,29,7:00,7:15,238.12,-90.52,0,-90.52,-90.52,-1,-42960,186714,229674,143754,0,-43411,902,0,0,,44313,-42509
6,02-06-18,30,7:15,7:30,,31.14,0,31.14,31.14,-1,-69408,94393,163801,24985,0,-16993,0,0,0,,16993,-16993
6,02-06-18,31,7:30,7:45,37.8,31.14,0,37.8,37.8,1,-104229,69986,174215,-34243,0,-1783,446,0,0,,2229,-1337
6,02-06-18,32,7:45,8:00,53.77,,0,53.77,53.77,1,-153083,61921,215004,-91162,0,0,9673,0,0,,9673,9673
6,02-06-18,33,8:00,8:15,33.8,-107.91,0,46.88,-107.91,2,-6180,108470,114650,102290,0,-26099,4161,0,0,,30260,-21938
6,02-06-18,34,8:15,8:30,,28.88,0,28.88,28.88,-1,-35476,78798,114274,43322,0,-36535,0,0,0,,36535,-36535
6,02-06-18,35,8:30,8:45,,32.14,0,32.14,32.14,-1,-59445,72764,132209,13319,0,-19462,0,0,0,,19462,-19462
6,02-06-18,36,8:45,9:00,34.59,32.14,0,34.59,34.59,1,-70006,69960,139966,-46,0,-862,1118,0,0,,1980,256
6,02-06-18,37,9:00,9:15,37.4,,0,37.4,37.4,1,-29669,44796,74465,15127,0,0,3947,0,0,,3947,3947
6,02-06-18,38,9:15,9:30,35,,0,35,35,1,-44854,49101,93955,4247,0,0,2613,0,0,,2613,2613
6,02-06-18,39,9:30,9:45,,,0,46.87,46.87,0,-39070,64661,103731,25591,0,0,136,0,0,,136,136
6,02-06-18,40,9:45,10:00,,,0,46.87,46.87,0,-37042,71227,108269,34185,0,0,0,0,0,,0,0
6,02-06-18,41,10:00,10:15,,,0,33.95,33.95,0,-56157,64207,120364,8050,0,0,0,0,0,,0,0
6,02-06-18,42,10:15,10:30,,31.14,0,31.14,31.14,-1,-41614,72942,114556,31328,0,-1522,0,0,0,,1522,-1522
6,02-06-18,43,10:30,10:45,,26.47,0,26.47,26.47,-1,-47251,92257,139508,45006,0,-19609,0,0,0,,19609,-19609
6,02-06-18,44,10:45,11:00,,31.14,0,31.14,31.14,-1,-49975,106223,156198,56248,0,-17262,0,0,0,,17262,-17262
6,02-06-18,45,11:00,11:15,,30.54,0,30.54,30.54,-1,-46628,88041,134669,41413,0,-16826,0,0,0,,16826,-16826
6,02-06-18,46,11:15,11:30,,24.02,0,24.02,24.02,-1,-43910,98763,142673,54853,0,-22576,0,0,0,,22576,-22576
6,02-06-18,47,11:30,11:45,,17.3,0,17.3,17.3,-1,-49817,112441,162258,62624,0,-33869,0,0,0,,33869,-33869
6,02-06-18,48,11:45,12:00,,27.14,0,27.14,27.14,-1,-39015,136547,175562,97532,0,-25001,0,0,0,,25001,-25001
6,02-06-18,49,12:00,12:15,,20.63,0,20.63,20.63,-1,-64476,80683,145159,16207,0,-18719,0,0,0,,18719,-18719
6,02-06-18,50,12:15,12:30,,29.95,0,29.95,29.95,-1,-58293,102520,160813,44227,0,-7915,0,0,0,,7915,-7915
6,02-06-18,51,12:30,12:45,,28.37,0,28.37,28.37,-1,-46666,129353,176019,82687,0,-18591,0,0,0,,18591,-18591
6,02-06-18,52,12:45,13:00,,-95.69,0,-95.69,-95.69,-1,-42952,146981,189933,104029,0,-38110,0,0,0,,38110,-38110
6,02-06-18,53,13:00,13:15,,17.04,0,17.04,17.04,-1,-70056,123869,193925,53813,0,-41035,0,0,0,,41035,-41035
6,02-06-18,54,13:15,13:30,,5.98,0,5.98,5.98,-1,-66747,122386,189133,55639,0,-50034,0,0,0,,50034,-50034
6,02-06-18,55,13:30,13:45,,25.28,0,25.28,25.28,-1,-71926,121788,193714,49862,0,-43004,0,0,0,,43004,-43004
6,02-06-18,56,13:45,14:00,,27.21,0,27.21,27.21,-1,-76365,122193,198558,45828,0,-35965,0,0,0,,35965,-35965
6,02-06-18,57,14:00,14:15,,18.56,0,18.56,18.56,-1,-75573,102424,177997,26851,0,-37701,0,0,0,,37701,-37701
6,02-06-18,58,14:15,14:30,,31.14,0,31.14,31.14,-1,-71559,93669,165228,22110,0,-8294,0,0,0,,8294,-8294
6,02-06-18,59,14:30,14:45,,29.22,0,29.22,29.22,-1,-74938,81211,156149,6273,0,-10058,0,0,0,,10058,-10058
6,02-06-18,60,14:45,15:00,,33.78,0,33.78,33.78,-1,-69993,71415,141408,1422,0,-3600,0,0,0,,3600,-3600
6,02-06-18,61,15:00,15:15,,33.18,0,33.18,33.18,-1,-68251,81767,150018,13516,0,-1518,0,0,0,,1518,-1518
6,02-06-18,62,15:15,15:30,,32.78,0,32.78,32.78,-1,-73834,64772,138606,-9062,0,-619,0,0,0,,619,-619
6,02-06-18,63,15:30,15:45,,,0,32.34,32.34,0,-85419,49369,134788,-36050,0,0,0,0,0,,0,0
6,02-06-18,64,15:45,16:00,69.96,,0,69.96,69.96,1,-90661,39884,130545,-50777,0,0,11353,0,0,,11353,11353
6,02-06-18,65,16:00,16:15,69.96,28.88,0,28.88,28.88,-1,-63747,79378,143125,15631,0,-4391,3134,0,0,,7525,-1257
6,02-06-18,66,16:15,16:30,,33.22,0,33.22,33.22,-1,-64781,75351,140132,10570,0,-451,0,0,0,,451,-451
6,02-06-18,67,16:30,16:45,,32.14,0,32.14,32.14,-1,-51536,58907,110443,7371,0,-1485,0,0,0,,1485,-1485
6,02-06-18,68,16:45,17:00,33.8,33.78,0,33.8,33.8,1,-69316,51327,120643,-17989,0,-510,215,0,0,,725,-295
6,02-06-18,69,17:00,17:15,33.8,3.37,0,33.93,3.37,2,-39877,96056,135933,56179,0,-19551,117,0,0,,19668,-19434
6,02-06-18,70,17:15,17:30,,32.14,0,32.14,32.14,-1,-45072,60763,105835,15691,0,-8291,0,0,0,,8291,-8291
6,02-06-18,71,17:30,17:45,,,0,33.95,33.95,0,-57797,85013,142810,27216,0,-331,0,0,0,,331,-331
6,02-06-18,72,17:45,18:00,50.33,,0,50.33,50.33,1,-94186,76373,170559,-17813,0,0,5376,0,0,,5376,5376
6,02-06-18,73,18:00,18:15,33.8,32.68,0,46.94,32.68,2,-138335,43347,181682,-94988,0,-252,1420,0,0,,1672,1168
6,02-06-18,74,18:15,18:30,43.94,,0,43.94,43.94,1,-112119,55686,167805,-56433,0,0,1658,0,0,,1658,1658
6,02-06-18,75,18:30,18:45,33.8,,0,33.8,33.8,1,-98821,59368,158189,-39453,0,0,1559,0,0,,1559,1559
6,02-06-18,76,18:45,19:00,33.8,,0,33.8,33.8,1,-92132,62653,154785,-29479,0,0,100,0,0,,100,100
6,02-06-18,77,19:00,19:15,43.66,,0,43.66,43.66,1,-66474,36668,103142,-29806,0,0,10305,0,0,,10305,10305
6,02-06-18,78,19:15,19:30,37.31,,0,37.31,37.31,1,-66859,42828,109687,-24031,0,0,15898,0,0,,15898,15898
6,02-06-18,79,19:30,19:45,37.31,32.14,0,32.14,32.14,-1,-51984,54174,106158,2190,0,-1552,4440,0,0,,5992,2888
6,02-06-18,80,19:45,20:00,,32.78,0,32.78,32.78,-1,-42579,61317,103896,18738,0,-2524,0,0,0,,2524,-2524
6,02-06-18,81,20:00,20:15,237.12,32.78,0,237.12,237.12,1,-144811,24999,169810,-119812,0,-123,25280,0,0,,25403,25157
6,02-06-18,82,20:15,20:30,37.8,,0,37.8,37.8,1,-99525,37727,137252,-61798,0,0,8776,0,0,,8776,8776
6,02-06-18,83,20:30,20:45,,,0,32.47,32.47,0,-69090,48395,117485,-20695,0,0,14,0,0,,14,14
6,02-06-18,84,20:45,21:00,,32.14,0,32.14,32.14,-1,-65699,59252,124951,-6447,0,-494,0,0,0,,494,-494
6,02-06-18,85,21:00,21:15,39.91,30.78,0,39.91,39.91,1,-58777,85997,144774,27220,0,-1006,899,0,0,,1905,-107
6,02-06-18,86,21:15,21:30,44.68,31.14,0,44.68,31.14,2,-44695,90537,135232,45842,0,-159,5527,0,0,,5686,5368
6,02-06-18,87,21:30,21:45,,16.13,0,16.13,16.13,-1,-20482,100088,120570,79606,0,-3450,0,0,0,,3450,-3450
6,02-06-18,88,21:45,22:00,,3.56,0,3.56,3.56,-1,-46679,114117,160796,67438,0,-35673,0,0,0,,35673,-35673
6,02-06-18,89,22:00,22:15,39.91,29.78,0,39.91,29.78,2,-84594,71117,155711,-13477,0,-15021,1377,0,0,,16398,-13644
6,02-06-18,90,22:15,22:30,39.91,4.38,0,4.38,4.38,-1,-43958,85251,129209,41293,0,-13988,215,0,0,,14203,-13773
6,02-06-18,91,22:30,22:45,,6.99,0,6.99,6.99,-1,-25681,98339,124020,72658,0,-51418,0,0,0,,51418,-51418
6,02-06-18,92,22:45,23:00,,-31.84,0,-31.84,-31.84,-1,-31470,122938,154408,91468,0,-86414,0,0,0,,86414,-86414
6,02-06-18,93,23:00,23:15,,1.96,0,1.96,1.96,-1,-43794,65509,109303,21715,0,-58445,0,0,0,,58445,-58445
6,02-06-18,94,23:15,23:30,36.38,31.14,0,36.38,31.14,2,-37719,39418,77137,1699,0,-3511,430,0,0,,3941,-3081
6,02-06-18,95,23:30,23:45,,28.78,0,28.78,28.78,-1,-39062,50694,89756,11632,0,-9559,0,0,0,,9559,-9559
6,02-06-18,96,23:45,0:00,,16,0,16,16,-1,-39981,92955,132936,52974,0,-20887,0,0,0,,20887,-20887
6,02-07-18,1,0:00,0:15,30.92,28.25,0,30.92,30.92,1,-78162,75330,153492,-2832,0,-15604,98,0,0,,15702,-15506
6,02-07-18,2,0:15,0:30,,31.13,0,31.13,31.13,-1,-45041,66570,111611,21529,0,-785,0,0,0,,785,-785
6,02-07-18,3,0:30,0:45,,32.71,0,32.71,32.71,-1,-78680,74486,153166,-4194,0,-921,0,0,0,,921,-921
6,02-07-18,4,0:45,1:00,,30.13,0,30.13,30.13,-1,-74724,94468,169192,19744,0,-10702,0,0,0,,10702,-10702
6,02-07-18,5,1:00,1:15,,29.03,0,29.03,29.03,-1,-51545,93319,144864,41774,0,-30138,0,0,0,,30138,-30138
6,02-07-18,6,1:15,1:30,,22.19,0,22.19,22.19,-1,-37967,89213,127180,51246,0,-43918,0,0,0,,43918,-43918
6,02-07-18,7,1:30,1:45,,16.66,0,16.66,16.66,-1,-38205,97840,136045,59635,0,-48346,0,0,0,,48346,-48346
6,02-07-18,8,1:45,2:00,,16.66,0,16.66,16.66,-1,-42607,97666,140273,55059,0,-55728,0,0,0,,55728,-55728
6,02-07-18,9,2:00,2:15,,25.03,0,25.03,25.03,-1,-51325,86821,138146,35496,0,-43645,0,0,0,,43645,-43645
6,02-07-18,10,2:15,2:30,,20.64,0,20.64,20.64,-1,-39286,86872,126158,47586,0,-31943,0,0,0,,31943,-31943
6,02-07-18,11,2:30,2:45,,28.24,0,28.24,28.24,-1,-40536,72196,112732,31660,0,-30386,0,0,0,,30386,-30386
6,02-07-18,12,2:45,3:00,,29.35,0,29.35,29.35,-1,-47307,74400,121707,27093,0,-27118,0,0,0,,27118,-27118
6,02-07-18,13,3:00,3:15,,30.54,0,30.54,30.54,-1,-56619,76095,132714,19476,0,-15542,0,0,0,,15542,-15542
6,02-07-18,14,3:15,3:30,,30.13,0,30.13,30.13,-1,-56288,76761,133049,20473,0,-16462,0,0,0,,16462,-16462
6,02-07-18,15,3:30,3:45,,30.13,0,30.13,30.13,-1,-54599,75852,130451,21253,0,-19051,0,0,0,,19051,-19051
6,02-07-18,16,3:45,4:00,,30.55,0,30.55,30.55,-1,-63735,76470,140205,12735,0,-13842,0,0,0,,13842,-13842
6,02-07-18,17,4:00,4:15,34.86,30.55,0,34.86,34.86,1,-68801,59580,128381,-9221,0,-997,1300,0,0,,2297,303
6,02-07-18,18,4:15,4:30,34.86,,0,34.86,34.86,1,-73051,55878,128929,-17173,0,0,3144,0,0,,3144,3144
6,02-07-18,19,4:30,4:45,34.86,,0,34.86,34.86,1,-61662,50078,111740,-11584,0,0,4170,0,0,,4170,4170
6,02-07-18,20,4:45,5:00,39.72,,0,39.72,39.72,1,-67133,51584,118717,-15549,0,0,14397,0,0,,14397,14397
6,02-07-18,21,5:00,5:15,34.28,30.13,0,34.28,30.13,2,-83176,70131,153307,-13045,0,-1314,7263,0,0,,8577,5949
6,02-07-18,22,5:15,5:30,34.94,30.13,0,34.94,34.94,1,-84949,45319,130268,-39630,0,-30,724,0,0,,754,694
6,02-07-18,23,5:30,5:45,30.96,,0,30.96,30.96,1,-76242,37409,113651,-38833,0,0,54,0,0,,54,54
6,02-07-18,24,5:45,6:00,87.02,,0,87.02,87.02,1,-102358,31584,133942,-70774,0,0,17934,0,0,,17934,17934
6,02-07-18,25,6:00,6:15,87.02,-150.03,0,-150.03,-150.03,-1,-28358,117894,146252,89536,0,-24645,5898,0,0,,30543,-18747
6,02-07-18,26,6:15,6:30,,20.22,0,20.22,20.22,-1,-70546,56800,127346,-13746,0,-22913,0,0,0,,22913,-22913
6,02-07-18,27,6:30,6:45,39.66,20.22,0,39.66,39.66,1,-79554,48479,128033,-31075,0,-46,3253,0,0,,3299,3207
6,02-07-18,28,6:45,7:00,206.02,,0,206.02,206.02,1,-107875,57268,165143,-50607,0,0,41959,0,0,,41959,41959
6,02-07-18,29,7:00,7:15,206.02,-95.78,0,-95.78,-95.78,-1,-76312,163392,239704,87080,0,-20593,14915,0,0,,35508,-5678
6,02-07-18,30,7:15,7:30,44.28,32.52,0,46.5,32.52,2,-117033,85026,202059,-32007,0,-1008,9758,0,0,,10766,8750
6,02-07-18,31,7:30,7:45,169.41,,0,169.41,169.41,1,-156276,63490,219766,-92786,0,0,51904,0,0,,51904,51904
6,02-07-18,32,7:45,8:00,169.41,,0,169.41,169.41,1,-211675,64382,276057,-147293,0,0,119695,0,0,,119695,119695
6,02-07-18,33,8:00,8:15,169.41,17.03,0,17.03,17.03,-1,-66973,134674,201647,67701,0,-1778,36864,0,0,,38642,35086
6,02-07-18,34,8:15,8:30,34.12,32.52,0,46.5,32.52,2,-90692,97880,188572,7188,0,-1546,202,0,0,,1748,-1344
6,02-07-18,35,8:30,8:45,35.26,32.52,0,35.26,35.26,1,-80522,82174,162696,1652,0,-35,1422,0,0,,1457,1387
6,02-07-18,36,8:45,9:00,140.02,,0,140.02,140.02,1,-95690,62995,158685,-32695,0,0,23565,0,0,,23565,23565
6,02-07-18,37,9:00,9:15,140.02,31.59,0,31.59,31.59,-1,-37804,89453,127257,51649,0,-96,24169,0,0,,24265,24073
6,02-07-18,38,9:15,9:30,,31.61,0,31.61,31.61,-1,-49955,66849,116804,16894,0,-106,0,0,0,,106,-106
6,02-07-18,39,9:30,9:45,,,0,46.5,46.5,0,-49116,75815,124931,26699,0,0,0,0,0,,0,0
6,02-07-18,40,9:45,10:00,33.07,31.07,0,46.51,31.07,2,-40722,86199,126921,45477,0,-2109,28,0,0,,2137,-2081
6,02-07-18,41,10:00,10:15,37.15,30.07,0,46.05,30.07,2,-56909,54456,111365,-2453,0,-361,761,0,0,,1122,400
6,02-07-18,42,10:15,10:30,,30.07,0,30.07,30.07,-1,-39895,52850,92745,12955,0,-1514,0,0,0,,1514,-1514
6,02-07-18,43,10:30,10:45,,14.61,0,14.61,14.61,-1,-34270,79708,113978,45438,0,-30072,0,0,0,,30072,-30072
6,02-07-18,44,10:45,11:00,,24.03,0,24.03,24.03,-1,-47533,74761,122294,27228,0,-39241,0,0,0,,39241,-39241
6,02-07-18,45,11:00,11:15,,31.02,0,31.02,31.02,-1,-46351,71869,118220,25518,0,-11058,0,0,0,,11058,-11058
6,02-07-18,46,11:15,11:30,,,0,33.21,33.21,0,-44668,90230,134898,45562,0,-10,0,0,0,,10,-10
6,02-07-18,47,11:30,11:45,,25.13,0,25.13,25.13,-1,-28144,123249,151393,95105,0,-9749,0,0,0,,9749,-9749
6,02-07-18,48,11:45,12:00,,6.68,0,6.68,6.68,-1,-20167,138362,158529,118195,0,-34838,0,0,0,,34838,-34838
6,02-07-18,49,12:00,12:15,36.14,-5.56,0,36.14,36.14,1,-89423,64241,153664,-25182,0,-24341,570,0,0,,24911,-23771
6,02-07-18,50,12:15,12:30,36.14,22.19,0,22.19,22.19,-1,-72430,95192,167622,22762,0,-7341,156,0,0,,7497,-7185
6,02-07-18,51,12:30,12:45,,30.07,0,30.07,30.07,-1,-56107,105853,161960,49746,0,-22819,0,0,0,,22819,-22819
6,02-07-18,52,12:45,13:00,,14.14,0,14.14,14.14,-1,-57230,117829,175059,60599,0,-38186,0,0,0,,38186,-38186
6,02-07-18,53,13:00,13:15,,-6.61,0,-6.61,-6.61,-1,-55218,134661,189879,79443,0,-69564,0,0,0,,69564,-69564
6,02-07-18,54,13:15,13:30,,22.31,0,22.31,22.31,-1,-77552,126572,204124,49020,0,-48229,0,0,0,,48229,-48229
6,02-07-18,55,13:30,13:45,,12.54,0,12.54,12.54,-1,-64580,124225,188805,59645,0,-53112,0,0,0,,53112,-53112
6,02-07-18,56,13:45,14:00,,19.27,0,19.27,19.27,-1,-66895,123285,190180,56390,0,-51579,0,0,0,,51579,-51579
6,02-07-18,57,14:00,14:15,,25.13,0,25.13,25.13,-1,-86516,140101,226617,53585,0,-49915,0,0,0,,49915,-49915
6,02-07-18,58,14:15,14:30,,20.17,0,20.17,20.17,-1,-86766,132849,219615,46083,0,-50152,0,0,0,,50152,-50152
6,02-07-18,59,14:30,14:45,,26.07,0,26.07,26.07,-1,-90203,126984,217187,36781,0,-43151,0,0,0,,43151,-43151
6,02-07-18,60,14:45,15:00,,28.22,0,28.22,28.22,-1,-94379,109779,204158,15400,0,-31964,0,0,0,,31964,-31964
6,02-07-18,61,15:00,15:15,,27.49,0,27.49,27.49,-1,-73070,109459,182529,36389,0,-20976,0,0,0,,20976,-20976
6,02-07-18,62,15:15,15:30,,30.61,0,30.61,30.61,-1,-81352,84994,166346,3642,0,-18545,0,0,0,,18545,-18545
6,02-07-18,63,15:30,15:45,34.05,30.61,0,34.05,34.05,1,-94956,59305,154261,-35651,0,-1931,675,0,0,,2606,-1256
6,02-07-18,64,15:45,16:00,,,0,33.07,33.07,0,-105304,43643,148947,-61661,0,0,0,0,0,,0,0
6,02-07-18,65,16:00,16:15,,31.07,0,31.07,31.07,-1,-106280,73744,180024,-32536,0,-253,0,0,0,,253,-253
6,02-07-18,66,16:15,16:30,,,0,33.11,33.11,0,-135126,55212,190338,-79914,0,0,0,0,0,,0,0
6,02-07-18,67,16:30,16:45,,,0,33.11,33.11,0,-151404,45090,196494,-106314,0,0,0,0,0,,0,0
6,02-07-18,68,16:45,17:00,37.15,,0,37.15,37.15,1,-178132,43067,221199,-135065,0,0,3659,0,0,,3659,3659
6,02-07-18,69,17:00,17:15,,,0,33.25,33.25,0,-85468,89231,174699,3763,0,0,601,0,0,,601,601
6,02-07-18,70,17:15,17:30,,,0,33.25,33.25,0,-78664,58247,136911,-20417,0,0,0,0,0,,0,0
6,02-07-18,71,17:30,17:45,42.96,,0,42.96,42.96,1,-103589,50916,154505,-52673,0,0,687,0,0,,687,687
6,02-07-18,72,17:45,18:00,258.61,,0,258.61,258.61,1,-134888,50824,185712,-84064,0,0,59818,0,0,,59818,59818
6,02-07-18,73,18:00,18:15,258.61,31.07,0,31.07,31.07,-1,-68167,69326,137493,1159,0,-530,29453,0,0,,29983,28923
6,02-07-18,74,18:15,18:30,,33.61,0,33.61,33.61,-1,-54577,85568,140145,30991,0,-368,0,0,0,,368,-368
6,02-07-18,75,18:30,18:45,,33.61,0,33.61,33.61,-1,-55731,82046,137777,26315,0,-388,0,0,0,,388,-388
6,02-07-18,76,18:45,19:00,,,0,33.29,33.29,0,-55020,78848,133868,23828,0,0,0,0,0,,0,0
6,02-07-18,77,19:00,19:15,37.15,,0,37.15,37.15,1,-78534,61460,139994,-17074,0,0,4221,0,0,,4221,4221
6,02-07-18,78,19:15,19:30,32.31,,0,32.31,32.31,1,-66825,68122,134947,1297,0,0,583,0,0,,583,583
6,02-07-18,79,19:30,19:45,,30.07,0,30.07,30.07,-1,-55695,70357,126052,14662,0,-1580,0,0,0,,1580,-1580
6,02-07-18,80,19:45,20:00,,25.78,0,25.78,25.78,-1,-43461,75538,118999,32077,0,-28239,0,0,0,,28239,-28239
6,02-07-18,81,20:00,20:15,65.09,27.26,0,65.09,27.26,2,-89609,60573,150182,-29036,0,-16640,4232,0,0,,20872,-12408
6,02-07-18,82,20:15,20:30,62.17,22.91,0,22.91,22.91,-1,-50373,72480,122853,22107,0,-4964,8116,0,0,,13080,3152
6,02-07-18,83,20:30,20:45,,20.34,0,20.34,20.34,-1,-41059,85039,126098,43980,0,-28738,0,0,0,,28738,-28738
6,02-07-18,84,20:45,21:00,,9.26,0,9.26,9.26,-1,-34552,110970,145522,76418,0,-45756,0,0,0,,45756,-45756
6,02-07-18,85,21:00,21:15,59.55,16.19,0,59.55,16.19,2,-97774,49057,146831,-48717,0,-29992,2945,0,0,,32937,-27047
6,02-07-18,86,21:15,21:30,32.45,10.88,0,10.88,10.88,-1,-49233,72862,122095,23629,0,-4449,1508,0,0,,5957,-2941
6,02-07-18,87,21:30,21:45,,4.68,0,4.68,4.68,-1,-43041,70269,113310,27228,0,-24963,0,0,0,,24963,-24963
6,02-07-18,88,21:45,22:00,,4.68,0,4.68,4.68,-1,-42692,81945,124637,39253,0,-33092,0,0,0,,33092,-33092
6,02-07-18,89,22:00,22:15,51.95,29.61,0,51.95,51.95,1,-76253,69161,145414,-7092,0,-14918,1979,0,0,,16897,-12939
6,02-07-18,90,22:15,22:30,68.6,30.07,0,68.6,30.07,2,-72234,69985,142219,-2249,0,-287,22573,0,0,,22860,22286
6,02-07-18,91,22:30,22:45,68.6,-22.45,0,-22.45,-22.45,-1,-23489,107292,130781,83803,0,-46291,258,0,0,,46549,-46033
6,02-07-18,92,22:45,23:00,,11.15,0,11.15,11.15,-1,-49619,122977,172596,73358,0,-78357,0,0,0,,78357,-78357
6,02-07-18,93,23:00,23:15,,14.44,0,14.44,14.44,-1,-82503,116290,198793,33787,0,-46580,0,0,0,,46580,-46580
6,02-07-18,94,23:15,23:30,,1.81,0,1.81,1.81,-1,-64158,105172,169330,41014,0,-13958,0,0,0,,13958,-13958
6,02-07-18,95,23:30,23:45,,2.66,0,2.66,2.66,-1,-52312,93184,145496,40872,0,-40396,0,0,0,,40396,-40396
6,02-07-18,96,23:45,0:00,,28.29,0,28.29,28.29,-1,-61845,116363,178208,54518,0,-38092,0,0,0,,38092,-38092
6,02-08-18,1,0:00,0:15,,-47.6,0,-47.6,-47.6,-1,-83287,137876,221163,54589,0,-45077,0,0,0,,45077,-45077
6,02-08-18,2,0:15,0:30,,26.06,0,26.06,26.06,-1,-73868,92221,166089,18353,0,-32346,0,0,0,,32346,-32346
6,02-08-18,3,0:30,0:45,33.06,26.06,0,33.16,26.06,2,-75021,94324,169345,19303,0,-4885,494,0,0,,5379,-4391
6,02-08-18,4,0:45,1:00,,18.03,0,18.03,18.03,-1,-66357,105532,171889,39175,0,-31073,0,0,0,,31073,-31073
6,02-08-18,5,1:00,1:15,,30.06,0,30.06,30.06,-1,-59353,69145,128498,9792,0,-20907,0,0,0,,20907,-20907
6,02-08-18,6,1:15,1:30,,29.03,0,29.03,29.03,-1,-55204,73323,128527,18119,0,-5650,0,0,0,,5650,-5650
6,02-08-18,7,1:30,1:45,,15.15,0,15.15,15.15,-1,-56213,104430,160643,48217,0,-40378,0,0,0,,40378,-40378
6,02-08-18,8,1:45,2:00,,26.06,0,26.06,26.06,-1,-74400,125665,200065,51265,0,-48172,0,0,0,,48172,-48172
6,02-08-18,9,2:00,2:15,,24.87,0,24.87,24.87,-1,-63564,109858,173422,46294,0,-45973,0,0,0,,45973,-45973
6,02-08-18,10,2:15,2:30,,14.03,0,14.03,14.03,-1,-56301,111197,167498,54896,0,-44467,0,0,0,,44467,-44467
6,02-08-18,11,2:30,2:45,,12.61,0,12.61,12.61,-1,-55421,116394,171815,60973,0,-50172,0,0,0,,50172,-50172
6,02-08-18,12,2:45,3:00,,10.8,0,10.8,10.8,-1,-60791,119817,180608,59026,0,-58524,0,0,0,,58524,-58524
6,02-08-18,13,3:00,3:15,,27.79,0,27.79,27.79,-1,-92176,111899,204075,19723,0,-32602,0,0,0,,32602,-32602
6,02-08-18,14,3:15,3:30,,8.47,0,8.47,8.47,-1,-65120,115589,180709,50469,0,-24587,0,0,0,,24587,-24587
6,02-08-18,15,3:30,3:45,,26.06,0,26.06,26.06,-1,-62925,106839,169764,43914,0,-35287,0,0,0,,35287,-35287
6,02-08-18,16,3:45,4:00,,25.48,0,25.48,25.48,-1,-65407,111610,177017,46203,0,-37675,0,0,0,,37675,-37675
6,02-08-18,17,4:00,4:15,,28.79,0,28.79,28.79,-1,-84038,108888,192926,24850,0,-27581,0,0,0,,27581,-27581
6,02-08-18,18,4:15,4:30,,29.07,0,29.07,29.07,-1,-72552,94028,166580,21476,0,-17754,0,0,0,,17754,-17754
6,02-08-18,19,4:30,4:45,,28.98,0,28.98,28.98,-1,-66863,88633,155496,21770,0,-19804,0,0,0,,19804,-19804
6,02-08-18,20,4:45,5:00,32.18,32.38,0,32.18,32.18,1,-89279,91674,180953,2395,0,-4519,303,0,0,,4822,-4216
6,02-08-18,21,5:00,5:15,32.18,12.67,0,12.67,12.67,-1,-51851,90299,142150,38448,0,-13778,104,0,0,,13882,-13674
6,02-08-18,22,5:15,5:30,,15.18,0,15.18,15.18,-1,-56616,97386,154002,40770,0,-25533,0,0,0,,25533,-25533
6,02-08-18,23,5:30,5:45,,13.3,0,13.3,13.3,-1,-70211,96427,166638,26216,0,-40618,0,0,0,,40618,-40618
6,02-08-18,24,5:45,6:00,36.06,31.06,0,36.06,31.06,2,-95641,93939,189580,-1702,0,-5336,1499,0,0,,6835,-3837
6,02-08-18,25,6:00,6:15,36.06,-29.15,0,-29.15,-29.15,-1,-20972,96856,117828,75884,0,-31684,37,0,0,,31721,-31647
6,02-08-18,26,6:15,6:30,,23.49,0,23.49,23.49,-1,-70499,92008,162507,21509,0,-38576,0,0,0,,38576,-38576
6,02-08-18,27,6:30,6:45,37.67,23.49,0,37.67,37.67,1,-86998,77569,164567,-9429,0,-5591,2695,0,0,,8286,-2896
6,02-08-18,28,6:45,7:00,42.57,,0,42.57,42.57,1,-120791,96066,216857,-24725,0,0,8615,0,0,,8615,8615
6,02-08-18,29,7:00,7:15,42.57,-48.31,0,-48.31,-48.31,-1,-30574,141573,172147,110999,0,-32475,2453,0,0,,34928,-30022
6,02-08-18,30,7:15,7:30,33.67,28.52,0,33.67,28.52,2,-60599,67674,128273,7075,0,-13256,34,0,0,,13290,-13222
6,02-08-18,31,7:30,7:45,111.02,28.52,0,111.02,111.02,1,-118558,68597,187155,-49961,0,-319,23110,0,0,,23429,22791
6,02-08-18,32,7:45,8:00,137.02,,0,137.02,137.02,1,-149377,84906,234283,-64471,0,0,57887,0,0,,57887,57887
6,02-08-18,33,8:00,8:15,137.02,13.2,0,13.2,13.2,-1,-71873,100192,172065,28319,0,-9044,15637,0,0,,24681,6593
6,02-08-18,34,8:15,8:30,,31.67,0,31.67,31.67,-1,-82549,86983,169532,4434,0,-4774,0,0,0,,4774,-4774
6,02-08-18,35,8:30,8:45,37.96,31.67,0,37.96,37.96,1,-101301,69096,170397,-32205,0,-247,5627,0,0,,5874,5380
6,02-08-18,36,8:45,9:00,70.61,,0,70.61,70.61,1,-115008,71212,186220,-43796,0,0,24934,0,0,,24934,24934
6,02-08-18,37,9:00,9:15,37.96,,0,37.96,37.96,1,-64732,48894,113626,-15838,0,0,19235,0,0,,19235,19235
6,02-08-18,38,9:15,9:30,46.93,,0,46.93,46.93,1,-68282,43636,111918,-24646,0,0,15924,0,0,,15924,15924
6,02-08-18,39,9:30,9:45,36.54,,0,36.54,36.54,1,-56373,48478,104851,-7895,0,0,10799,0,0,,10799,10799
6,02-08-18,40,9:45,10:00,,,0,46.81,46.81,0,-47718,53673,101391,5955,0,0,91,0,0,,91,91
6,02-08-18,41,10:00,10:15,36.79,,0,36.79,36.79,1,-55360,34528,89888,-20832,0,0,705,0,0,,705,705
6,02-08-18,42,10:15,10:30,,,0,34.15,34.15,0,-50232,41506,91738,-8726,0,0,0,0,0,,0,0
6,02-08-18,43,10:30,10:45,,30.67,0,30.67,30.67,-1,-44662,58335,102997,13673,0,-3361,0,0,0,,3361,-3361
6,02-08-18,44,10:45,11:00,,23.61,0,23.61,23.61,-1,-37577,75702,113279,38125,0,-32671,0,0,0,,32671,-32671
6,02-08-18,45,11:00,11:15,38.07,31.67,0,38.07,31.67,2,-56446,48635,105081,-7811,0,-12127,1200,0,0,,13327,-10927
6,02-08-18,46,11:15,11:30,,22.41,0,22.41,22.41,-1,-44692,70093,114785,25401,0,-7091,0,0,0,,7091,-7091
6,02-08-18,47,11:30,11:45,,17.49,0,17.49,17.49,-1,-50426,77728,128154,27302,0,-32205,0,0,0,,32205,-32205
6,02-08-18,48,11:45,12:00,,17.49,0,17.49,17.49,-1,-38994,84967,123961,45973,0,-22423,0,0,0,,22423,-22423
6,02-08-18,49,12:00,12:15,,13.04,0,13.04,13.04,-1,-42616,53276,95892,10660,0,-23421,0,0,0,,23421,-23421
6,02-08-18,50,12:15,12:30,,-5.5,0,-5.5,-5.5,-1,-30530,87952,118482,57422,0,-35904,0,0,0,,35904,-35904
6,02-08-18,51,12:30,12:45,,17.49,0,17.49,17.49,-1,-39792,88035,127827,48243,0,-44590,0,0,0,,44590,-44590
6,02-08-18,52,12:45,13:00,,2.22,0,2.22,2.22,-1,-39669,114767,154436,75098,0,-71373,0,0,0,,71373,-71373
6,02-08-18,53,13:00,13:15,,18.61,0,18.61,18.61,-1,-43382,74830,118212,31448,0,-42158,0,0,0,,42158,-42158
6,02-08-18,54,13:15,13:30,,21.61,0,21.61,21.61,-1,-42277,88533,130810,46256,0,-33642,0,0,0,,33642,-33642
6,02-08-18,55,13:30,13:45,,26.58,0,26.58,26.58,-1,-43545,95606,139151,52061,0,-42535,0,0,0,,42535,-42535
6,02-08-18,56,13:45,14:00,,26.64,0,26.64,26.64,-1,-42796,95475,138271,52679,0,-44798,0,0,0,,44798,-44798
6,02-08-18,57,14:00,14:15,,8.61,0,8.61,8.61,-1,-48595,112874,161469,64279,0,-50024,0,0,0,,50024,-50024
6,02-08-18,58,14:15,14:30,,20.61,0,20.61,20.61,-1,-64836,96139,160975,31303,0,-47306,0,0,0,,47306,-47306
6,02-08-18,59,14:30,14:45,,17.49,0,17.49,17.49,-1,-49522,99441,148963,49919,0,-26195,0,0,0,,26195,-26195
6,02-08-18,60,14:45,15:00,,17.49,0,17.49,17.49,-1,-60509,88650,149159,28141,0,-33551,0,0,0,,33551,-33551
6,02-08-18,61,15:00,15:15,,15.69,0,15.69,15.69,-1,-51839,111179,163018,59340,0,-33675,0,0,0,,33675,-33675
6,02-08-18,62,15:15,15:30,,26.67,0,26.67,26.67,-1,-61186,84763,145949,23577,0,-36755,0,0,0,,36755,-36755
6,02-08-18,63,15:30,15:45,,30.67,0,30.67,30.67,-1,-60318,80630,140948,20312,0,-9276,0,0,0,,9276,-9276
6,02-08-18,64,15:45,16:00,,26.67,0,26.67,26.67,-1,-71081,81757,152838,10676,0,-18941,0,0,0,,18941,-18941
6,02-08-18,65,16:00,16:15,33.67,26.67,0,33.67,33.67,1,-97446,89140,186586,-8306,0,-3311,1154,0,0,,4465,-2157
6,02-08-18,66,16:15,16:30,,,0,32.94,32.94,0,-94400,81126,175526,-13274,0,0,39,0,0,,39,39
6,02-08-18,67,16:30,16:45,33.67,,0,33.67,33.67,1,-72915,50339,123254,-22576,0,0,1,0,0,,1,1
6,02-08-18,68,16:45,17:00,45.28,,0,45.28,45.28,1,-94086,49618,143704,-44468,0,0,7954,0,0,,7954,7954
6,02-08-18,69,17:00,17:15,33.67,30.67,0,46.89,30.67,2,-81877,81956,163833,79,0,-1742,2992,0,0,,4734,1250
6,02-08-18,70,17:15,17:30,,30.67,0,30.67,30.67,-1,-72048,74570,146618,2522,0,-4319,0,0,0,,4319,-4319
6,02-08-18,71,17:30,17:45,,28.67,0,28.67,28.67,-1,-68156,87106,155262,18950,0,-11663,0,0,0,,11663,-11663
6,02-08-18,72,17:45,18:00,33.67,33.51,0,33.67,33.67,1,-89079,96677,185756,7598,0,-4590,68,0,0,,4658,-4522
6,02-08-18,73,18:00,18:15,32.05,28.03,0,33.3,28.03,2,-63689,78502,142191,14813,0,-3601,54,0,0,,3655,-3547
6,02-08-18,74,18:15,18:30,,25.79,0,25.79,25.79,-1,-59285,90119,149404,30834,0,-16571,0,0,0,,16571,-16571
6,02-08-18,75,18:30,18:45,,21.76,0,21.76,21.76,-1,-49555,92114,141669,42559,0,-34063,0,0,0,,34063,-34063
6,02-08-18,76,18:45,19:00,,27.83,0,27.83,27.83,-1,-56551,101092,157643,44541,0,-44022,0,0,0,,44022,-44022
6,02-08-18,77,19:00,19:15,40.5,26.16,0,40.5,40.5,1,-68015,59631,127646,-8384,0,-27151,2011,0,0,,29162,-25140
6,02-08-18,78,19:15,19:30,40.5,1.04,0,1.04,1.04,-1,-43990,96530,140520,52540,0,-12806,584,0,0,,13390,-12222
6,02-08-18,79,19:30,19:45,,-13.19,0,-13.19,-13.19,-1,-58685,74714,133399,16029,0,-38099,0,0,0,,38099,-38099
6,02-08-18,80,19:45,20:00,,-6.03,0,-6.03,-6.03,-1,-52083,96021,148104,43938,0,-35005,0,0,0,,35005,-35005
6,02-08-18,81,20:00,20:15,,-164.48,0,-164.48,-164.48,-1,-88076,112230,200306,24154,0,-53480,0,0,0,,53480,-53480
6,02-08-18,82,20:15,20:30,33.67,-150.03,0,33.67,-150.03,2,-58250,110351,168601,52101,0,-16822,89,0,0,,16911,-16733
6,02-08-18,83,20:30,20:45,,-120.69,0,-120.69,-120.69,-1,-71815,83300,155115,11485,0,-34780,0,0,0,,34780,-34780
6,02-08-18,84,20:45,21:00,,-67.14,0,-67.14,-67.14,-1,-56379,123477,179856,67098,0,-40306,0,0,0,,40306,-40306
6,02-08-18,85,21:00,21:15,56.22,28.67,0,56.22,28.67,2,-172766,83446,256212,-89320,0,-10145,4879,0,0,,15024,-5266
6,02-08-18,86,21:15,21:30,64.3,,0,64.3,64.3,1,-123465,64449,187914,-59016,0,0,16763,0,0,,16763,16763
6,02-08-18,87,21:30,21:45,36.02,,0,36.02,36.02,1,-110097,74322,184419,-35775,0,0,9895,0,0,,9895,9895
6,02-08-18,88,21:45,22:00,36.02,35.19,0,35.19,35.19,-1,-118031,106319,224350,-11712,0,-21,587,0,0,,608,566
6,02-08-18,89,22:00,22:15,,34.85,0,34.85,34.85,-1,-125799,76673,202472,-49126,0,-137,0,0,0,,137,-137
6,02-08-18,90,22:15,22:30,,30.67,0,30.67,30.67,-1,-90763,86275,177038,-4488,0,-464,0,0,0,,464,-464
6,02-08-18,91,22:30,22:45,,24.22,0,24.22,24.22,-1,-73696,114670,188366,40974,0,-26013,0,0,0,,26013,-26013
6,02-08-18,92,22:45,23:00,,2.8,0,2.8,2.8,-1,-85559,136703,222262,51144,0,-30533,0,0,0,,30533,-30533
6,02-08-18,93,23:00,23:15,37.67,-140.91,0,37.67,-140.91,2,-97760,112228,209988,14468,0,-43396,69,0,0,,43465,-43327
6,02-08-18,94,23:15,23:30,37.96,-140.91,0,37.96,37.96,1,-99720,78732,178452,-20988,0,-1137,1514,0,0,,2651,377
6,02-08-18,95,23:30,23:45,,31.67,0,31.67,31.67,-1,-88425,90399,178824,1974,0,-649,0,0,0,,649,-649
6,02-08-18,96,23:45,0:00,,31.67,0,31.67,31.67,-1,-113132,109520,222652,-3612,0,-3435,0,0,0,,3435,-3435
6,02-09-18,1,0:00,0:15,48.7,31.67,0,48.7,48.7,1,-63905,45198,109103,-18707,0,-736,5546,0,0,,6282,4810
6,02-09-18,2,0:15,0:30,46.53,,0,46.53,46.53,1,-70695,38190,108885,-32505,0,0,30382,0,0,,30382,30382
6,02-09-18,3,0:30,0:45,35.27,,0,35.27,35.27,1,-74760,55385,130145,-19375,0,0,12911,0,0,,12911,12911
6,02-09-18,4,0:45,1:00,,,0,32.57,32.57,0,-76305,55401,131706,-20904,0,0,550,0,0,,550,550
6,02-09-18,5,1:00,1:15,35.47,,0,35.47,35.47,1,-58591,27789,86380,-30802,0,0,363,0,0,,363,363
6,02-09-18,6,1:15,1:30,,,0,32.3,32.3,0,-50072,38098,88170,-11974,0,0,65,0,0,,65,65
6,02-09-18,7,1:30,1:45,31.43,,0,31.43,31.43,1,-56076,40896,96972,-15180,0,0,264,0,0,,264,264
6,02-09-18,8,1:45,2:00,31.43,,0,31.43,31.43,1,-60130,43889,104019,-16241,0,0,589,0,0,,589,589
6,02-09-18,9,2:00,2:15,103.85,,0,103.85,103.85,1,-93087,39034,132121,-54053,0,0,14263,0,0,,14263,14263
6,02-09-18,10,2:15,2:30,57.26,,0,57.26,57.26,1,-99838,31935,131773,-67903,0,0,41619,0,0,,41619,41619
6,02-09-18,11,2:30,2:45,44.03,,0,44.03,44.03,1,-97995,30073,128068,-67922,0,0,27081,0,0,,27081,27081
6,02-09-18,12,2:45,3:00,34.02,,0,34.02,34.02,1,-90169,27796,117965,-62373,0,0,8789,0,0,,8789,8789
6,02-09-18,13,3:00,3:15,,,0,32.21,32.21,0,-68572,20830,89402,-47742,0,0,0,0,0,,0,0
6,02-09-18,14,3:15,3:30,,,0,32.21,32.21,0,-85469,32180,117649,-53289,0,0,0,0,0,,0,0
6,02-09-18,15,3:30,3:45,,,0,32.22,32.22,0,-88360,35410,123770,-52950,0,0,0,0,0,,0,0
6,02-09-18,16,3:45,4:00,35.47,,0,35.47,35.47,1,-95393,36653,132046,-58740,0,0,550,0,0,,550,550
6,02-09-18,17,4:00,4:15,46.53,,0,46.53,46.53,1,-99394,44951,144345,-54443,0,0,9320,0,0,,9320,9320
6,02-09-18,18,4:15,4:30,40.53,,0,40.53,40.53,1,-89327,43850,133177,-45477,0,0,29229,0,0,,29229,29229
6,02-09-18,19,4:30,4:45,38.84,,0,38.84,38.84,1,-80545,45481,126026,-35064,0,0,24115,0,0,,24115,24115
6,02-09-18,20,4:45,5:00,40.53,,0,40.53,40.53,1,-74276,45085,119361,-29191,0,0,13802,0,0,,13802,13802
6,02-09-18,21,5:00,5:15,40.53,30.35,0,30.35,30.35,-1,-49019,57219,106238,8200,0,-825,4114,0,0,,4939,3289
6,02-09-18,22,5:15,5:30,,31.35,0,31.35,31.35,-1,-61338,54614,115952,-6724,0,-431,0,0,0,,431,-431
6,02-09-18,23,5:30,5:45,,,0,31.67,31.67,0,-68795,50886,119681,-17909,0,0,0,0,0,,0,0
6,02-09-18,24,5:45,6:00,,30.93,0,30.93,30.93,-1,-80029,54397,134426,-25632,0,-130,0,0,0,,130,-130
6,02-09-18,25,6:00,6:15,,14.61,0,14.61,14.61,-1,-48082,81551,129633,33469,0,-4742,0,0,0,,4742,-4742
6,02-09-18,26,6:15,6:30,,5.03,0,5.03,5.03,-1,-85112,88141,173253,3029,0,-16897,0,0,0,,16897,-16897
6,02-09-18,27,6:30,6:45,,30.62,0,30.62,30.62,-1,-69208,80868,150076,11660,0,-434,0,0,0,,434,-434
6,02-09-18,28,6:45,7:00,,24.41,0,24.41,24.41,-1,-67286,131120,198406,63834,0,-9111,0,0,0,,9111,-9111
6,02-09-18,29,7:00,7:15,,18.98,0,18.98,18.98,-1,-107845,124571,232416,16726,0,-3686,0,0,0,,3686,-3686
6,02-09-18,30,7:15,7:30,34.94,-8.32,0,34.94,-8.32,2,-69194,76685,145879,7491,0,-18541,42,0,0,,18583,-18499
6,02-09-18,31,7:30,7:45,50.35,-8.32,0,50.35,50.35,1,-104389,80161,184550,-24228,0,-343,5725,0,0,,6068,5382
6,02-09-18,32,7:45,8:00,109.78,,0,109.78,109.78,1,-143530,75725,219255,-67805,0,0,45447,0,0,,45447,45447
6,02-09-18,33,8:00,8:15,109.78,-150.03,0,-150.03,-150.03,-1,-34664,141573,176237,106909,0,-26602,17584,0,0,,44186,-9018
6,02-09-18,34,8:15,8:30,,10.96,0,10.96,10.96,-1,-63307,81980,145287,18673,0,-32780,0,0,0,,32780,-32780
6,02-09-18,35,8:30,8:45,,30.62,0,30.62,30.62,-1,-76226,92677,168903,16451,0,-5475,0,0,0,,5475,-5475
6,02-09-18,36,8:45,9:00,,27.92,0,27.92,27.92,-1,-66534,89328,155862,22794,0,-20189,0,0,0,,20189,-20189
6,02-09-18,37,9:00,9:15,,15.69,0,15.69,15.69,-1,-52415,98880,151295,46465,0,-28332,0,0,0,,28332,-28332
6,02-09-18,38,9:15,9:30,,30.62,0,30.62,30.62,-1,-63599,69459,133058,5860,0,-19441,0,0,0,,19441,-19441
6,02-09-18,39,9:30,9:45,,31.62,0,31.62,31.62,-1,-62161,71709,133870,9548,0,-2813,0,0,0,,2813,-2813
6,02-09-18,40,9:45,10:00,,29.84,0,29.84,29.84,-1,-57764,95373,153137,37609,0,-17688,0,0,0,,17688,-17688
6,02-09-18,41,10:00,10:15,,27.92,0,27.92,27.92,-1,-50628,96106,146734,45478,0,-34260,0,0,0,,34260,-34260
6,02-09-18,42,10:15,10:30,,23.44,0,23.44,23.44,-1,-43092,102939,146031,59847,0,-42316,0,0,0,,42316,-42316
6,02-09-18,43,10:30,10:45,,26.62,0,26.62,26.62,-1,-39783,93419,133202,53636,0,-47320,0,0,0,,47320,-47320
6,02-09-18,44,10:45,11:00,,17.54,0,17.54,17.54,-1,-53075,93284,146359,40209,0,-49647,0,0,0,,49647,-49647
6,02-09-18,45,11:00,11:15,,27.91,0,27.91,27.91,-1,-40841,103694,144535,62853,0,-24927,0,0,0,,24927,-24927
6,02-09-18,46,11:15,11:30,,24.94,0,24.94,24.94,-1,-43947,135133,179080,91186,0,-28143,0,0,0,,28143,-28143
6,02-09-18,47,11:30,11:45,,26.62,0,26.62,26.62,-1,-50054,121807,171861,71753,0,-37485,0,0,0,,37485,-37485
6,02-09-18,48,11:45,12:00,,6.85,0,6.85,6.85,-1,-45004,120841,165845,75837,0,-51929,0,0,0,,51929,-51929
6,02-09-18,49,12:00,12:15,,5.57,0,5.57,5.57,-1,-69155,80481,149636,11326,0,-50182,0,0,0,,50182,-50182
6,02-09-18,50,12:15,12:30,,0.75,0,0.75,0.75,-1,-57979,88864,146843,30885,0,-33491,0,0,0,,33491,-33491
6,02-09-18,51,12:30,12:45,,4.93,0,4.93,4.93,-1,-77891,90298,168189,12407,0,-45433,0,0,0,,45433,-45433
6,02-09-18,52,12:45,13:00,,-0.75,0,-0.75,-0.75,-1,-53854,92963,146817,39109,0,-12550,0,0,0,,12550,-12550
6,02-09-18,53,13:00,13:15,,3.3,0,3.3,3.3,-1,-61980,101472,163452,39492,0,-41364,0,0,0,,41364,-41364
6,02-09-18,54,13:15,13:30,,23.58,0,23.58,23.58,-1,-60005,96125,156130,36120,0,-28908,0,0,0,,28908,-28908
6,02-09-18,55,13:30,13:45,,29.92,0,29.92,29.92,-1,-59817,97373,157190,37556,0,-36044,0,0,0,,36044,-36044
6,02-09-18,56,13:45,14:00,,26.62,0,26.62,26.62,-1,-57023,93563,150586,36540,0,-36148,0,0,0,,36148,-36148
6,02-09-18,57,14:00,14:15,,31.99,0,31.99,31.99,-1,-82258,92872,175130,10614,0,-9586,0,0,0,,9586,-9586
6,02-09-18,58,14:15,14:30,,31.62,0,31.62,31.62,-1,-96166,93329,189495,-2837,0,-2020,0,0,0,,2020,-2020
6,02-09-18,59,14:30,14:45,38,,0,38,38,1,-88920,85030,173950,-3890,0,0,6393,0,0,,6393,6393
6,02-09-18,60,14:45,15:00,35.38,,0,35.38,35.38,1,-100051,78768,178819,-21283,0,0,9780,0,0,,9780,9780
6,02-09-18,61,15:00,15:15,35,,0,35,35,1,-104916,100357,205273,-4559,0,0,6701,0,0,,6701,6701
6,02-09-18,62,15:15,15:30,61.94,,0,61.94,61.94,1,-94229,84072,178301,-10157,0,0,513,0,0,,513,513
6,02-09-18,63,15:30,15:45,35,,0,35,35,1,-105330,90466,195796,-14864,0,0,352,0,0,,352,352
6,02-09-18,64,15:45,16:00,31.34,,0,31.34,31.34,1,-114983,81377,196360,-33606,0,0,170,0,0,,170,170
6,02-09-18,65,16:00,16:15,,,0,32.75,32.75,0,-80043,114237,194280,34194,0,0,0,0,0,,0,0
6,02-09-18,66,16:15,16:30,,,0,32.75,32.75,0,-91041,119582,210623,28541,0,0,0,0,0,,0,0
6,02-09-18,67,16:30,16:45,,33.23,0,33.23,33.23,-1,-89532,113434,202966,23902,0,-66,0,0,0,,66,-66
6,02-09-18,68,16:45,17:00,35,,0,35,35,1,-103673,105112,208785,1439,0,0,642,0,0,,642,642
6,02-09-18,69,17:00,17:15,34.87,8.87,0,34.87,8.87,2,-57156,124879,182035,67723,0,-18046,161,0,0,,18207,-17885
6,02-09-18,70,17:15,17:30,,31.62,0,31.62,31.62,-1,-89789,81567,171356,-8222,0,-11262,0,0,0,,11262,-11262
6,02-09-18,71,17:30,17:45,,31.62,0,31.62,31.62,-1,-93119,103811,196930,10692,0,-411,0,0,0,,411,-411
6,02-09-18,72,17:45,18:00,,,0,33.04,33.04,0,-118297,90697,208994,-27600,0,0,0,0,0,,0,0
6,02-09-18,73,18:00,18:15,,,0,32.97,32.97,0,-133423,87228,220651,-46195,0,0,0,0,0,,0,0
6,02-09-18,74,18:15,18:30,,,0,32.97,32.97,0,-108233,86844,195077,-21389,0,0,0,0,0,,0,0
6,02-09-18,75,18:30,18:45,,30.62,0,30.62,30.62,-1,-86526,100200,186726,13674,0,-1652,0,0,0,,1652,-1652
6,02-09-18,76,18:45,19:00,,28.62,0,28.62,28.62,-1,-91994,108697,200691,16703,0,-17583,0,0,0,,17583,-17583
6,02-09-18,77,19:00,19:15,65.33,28.62,0,65.33,65.33,1,-107586,64951,172537,-42635,0,-4003,8011,0,0,,12014,4008
6,02-09-18,78,19:15,19:30,31.81,,0,31.81,31.81,1,-97355,72175,169530,-25180,0,0,1495,0,0,,1495,1495
6,02-09-18,79,19:30,19:45,34.28,33.38,0,34.28,32.8,2,-58854,59824,118678,970,0,-9,855,0,0,,864,846
6,02-09-18,80,19:45,20:00,,31.29,0,31.29,31.29,-1,-70325,90531,160856,20206,0,-6526,0,0,0,,6526,-6526
6,02-09-18,81,20:00,20:15,239.02,28.38,0,239.02,28.38,2,-88585,38946,127531,-49639,0,-7153,14164,0,0,,21317,7011
6,02-09-18,82,20:15,20:30,239.02,28.38,0,239.02,239.02,1,-80875,61634,142509,-19241,0,-19,30836,0,0,,30855,30817
6,02-09-18,83,20:30,20:45,239.02,26.62,0,26.62,26.62,-1,-48109,69895,118004,21786,0,-2251,599,0,0,,2850,-1652
6,02-09-18,84,20:45,21:00,,12.01,0,12.01,12.01,-1,-44675,94225,138900,49550,0,-28376,0,0,0,,28376,-28376
6,02-09-18,85,21:00,21:15,221.02,30.03,0,221.02,221.02,1,-113388,80014,193402,-33374,0,-11744,8327,0,0,,20071,-3417
6,02-09-18,86,21:15,21:30,163.02,30.03,0,163.02,163.02,1,-67463,74166,141629,6703,0,-5,14478,0,0,,14483,14473
6,02-09-18,87,21:30,21:45,163.02,30.62,0,30.62,30.62,-1,-22427,72577,95004,50150,0,-579,144,0,0,,723,-435
6,02-09-18,88,21:45,22:00,,28.62,0,28.62,28.62,-1,-40637,90972,131609,50335,0,-6216,0,0,0,,6216,-6216
6,02-09-18,89,22:00,22:15,,5.03,0,5.03,5.03,-1,-65364,79991,145355,14627,0,-13858,0,0,0,,13858,-13858
6,02-09-18,90,22:15,22:30,,,0,33.19,33.19,0,-81881,73962,155843,-7919,0,-844,0,0,0,,844,-844
6,02-09-18,91,22:30,22:45,35,,0,35,35,1,-67600,82755,150355,15155,0,0,585,0,0,,585,585
6,02-09-18,92,22:45,23:00,34.65,,0,34.65,34.65,1,-41806,79938,121744,38132,0,0,654,0,0,,654,654
6,02-09-18,93,23:00,23:15,35,,0,35,35,1,-84442,83818,168260,-624,0,0,1314,0,0,,1314,1314
6,02-09-18,94,23:15,23:30,44.09,,0,44.09,44.09,1,-82458,58445,140903,-24013,0,0,6531,0,0,,6531,6531
6,02-09-18,95,23:30,23:45,57.34,,0,57.34,57.34,1,-88799,54975,143774,-33824,0,0,16456,0,0,,16456,16456
6,02-09-18,96,23:45,0:00,42.05,,0,42.05,42.05,1,-97087,68030,165117,-29057,0,0,24070,0,0,,24070,24070
7,02-10-18,1,0:00,0:15,42.05,30.78,0,30.78,30.78,-1,-79173,114966,194139,35793,0,-1430,3318,0,0,,4748,1888
7,02-10-18,2,0:15,0:30,,,0,33.38,33.38,0,-77302,88793,166095,11491,0,0,0,0,0,,0,0
7,02-10-18,3,0:30,0:45,,,0,33.39,33.39,0,-52705,75375,128080,22670,0,0,0,0,0,,0,0
7,02-10-18,4,0:45,1:00,35.12,,0,35.12,35.12,1,-134191,88769,222960,-45422,0,0,1681,0,0,,1681,1681
7,02-10-18,5,1:00,1:15,48.63,,0,48.63,48.63,1,-96921,74415,171336,-22506,0,0,11065,0,0,,11065,11065
7,02-10-18,6,1:15,1:30,40.12,,0,40.12,40.12,1,-89222,80950,170172,-8272,0,0,19199,0,0,,19199,19199
7,02-10-18,7,1:30,1:45,40.12,33.68,0,33.68,33.68,-1,-66996,78214,145210,11218,0,-297,2361,0,0,,2658,2064
7,02-10-18,8,1:45,2:00,,,0,33.28,33.28,0,-66219,70997,137216,4778,0,0,0,0,0,,0,0
7,02-10-18,9,2:00,2:15,60.28,,0,60.28,60.28,1,-91447,48582,140029,-42865,0,0,14104,0,0,,14104,14104
7,02-10-18,10,2:15,2:30,41.49,,0,41.49,41.49,1,-76212,45071,121283,-31141,0,0,31362,0,0,,31362,31362
7,02-10-18,11,2:30,2:45,40.14,,0,40.14,40.14,1,-68005,43901,111906,-24104,0,0,28670,0,0,,28670,28670
7,02-10-18,12,2:45,3:00,35.44,,0,35.44,35.44,1,-62327,45583,107910,-16744,0,0,13368,0,0,,13368,13368
7,02-10-18,13,3:00,3:15,48.28,,0,48.28,48.28,1,-81036,53874,134910,-27162,0,0,17509,0,0,,17509,17509
7,02-10-18,14,3:15,3:30,41.85,,0,41.85,41.85,1,-63860,47605,111465,-16255,0,0,28427,0,0,,28427,28427
7,02-10-18,15,3:30,3:45,40.08,,0,40.08,40.08,1,-60206,50448,110654,-9758,0,0,10158,0,0,,10158,10158
7,02-10-18,16,3:45,4:00,33.16,,0,33.16,33.16,1,-62782,57551,120333,-5231,0,0,3476,0,0,,3476,3476
7,02-10-18,17,4:00,4:15,41.85,,0,41.85,41.85,1,-145851,132971,278822,-12880,0,0,6175,0,0,,6175,6175
7,02-10-18,18,4:15,4:30,38.97,,0,38.97,38.97,1,-144244,129582,273826,-14662,0,0,10090,0,0,,10090,10090
7,02-10-18,19,4:30,4:45,40.14,,0,40.14,40.14,1,-150367,130800,281167,-19567,0,0,13672,0,0,,13672,13672
7,02-10-18,20,4:45,5:00,36.67,,0,36.67,36.67,1,-146281,132115,278396,-14166,0,0,16435,0,0,,16435,16435
7,02-10-18,21,5:00,5:15,33.01,34.46,0,34.46,34.46,-1,-52314,71129,123443,18815,0,-106,5478,0,0,,5584,5372
7,02-10-18,22,5:15,5:30,,34.46,0,34.46,34.46,-1,-58469,66731,125200,8262,0,-772,0,0,0,,772,-772
7,02-10-18,23,5:30,5:45,35.8,,0,35.8,35.8,1,-66271,60334,126605,-5937,0,0,902,0,0,,902,902
7,02-10-18,24,5:45,6:00,40.14,,0,40.14,40.14,1,-63968,64254,128222,286,0,0,7187,0,0,,7187,7187
7,02-10-18,25,6:00,6:15,,,0,32.87,32.87,0,-44334,69031,113365,24697,0,0,874,0,0,,874,874
7,02-10-18,26,6:15,6:30,,,0,32.85,32.85,0,-55661,73019,128680,17358,0,0,0,0,0,,0,0
7,02-10-18,27,6:30,6:45,39.86,,0,39.86,39.86,1,-82892,70719,153611,-12173,0,0,2056,0,0,,2056,2056
7,02-10-18,28,6:45,7:00,32.98,,0,32.98,32.98,1,-81884,91632,173516,9748,0,0,3366,0,0,,3366,3366
7,02-10-18,29,7:00,7:15,32.08,30.78,0,33.54,30.78,2,-63821,74417,138238,10596,0,-1345,389,0,0,,1734,-956
7,02-10-18,30,7:15,7:30,,30.78,0,30.78,30.78,-1,-66124,72401,138525,6277,0,-719,0,0,0,,719,-719
7,02-10-18,31,7:30,7:45,36.67,28.09,0,36.67,28.09,2,-66461,63139,129600,-3322,0,-4665,436,0,0,,5101,-4229
7,02-10-18,32,7:45,8:00,48.72,28.09,0,48.72,48.72,1,-92240,71460,163700,-20780,0,-28,11694,0,0,,11722,11666
7,02-10-18,33,8:00,8:15,48.72,-11.91,0,-11.91,-11.91,-1,-26245,119537,145782,93292,0,-16298,3050,0,0,,19348,-13248
7,02-10-18,34,8:15,8:30,,30.25,0,30.25,30.25,-1,-46915,71184,118099,24269,0,-12807,0,0,0,,12807,-12807
7,02-10-18,35,8:30,8:45,36.35,30.25,0,36.35,36.35,1,-81259,71698,152957,-9561,0,-390,446,0,0,,836,56
7,02-10-18,36,8:45,9:00,82.44,,0,82.44,82.44,1,-120081,57973,178054,-62108,0,0,24865,0,0,,24865,24865
7,02-10-18,37,9:00,9:15,47.36,27.89,0,27.89,27.89,-1,-35824,91968,127792,56144,0,-2006,20187,0,0,,22193,18181
7,02-10-18,38,9:15,9:30,35.78,27.89,0,35.78,35.78,1,-87736,74107,161843,-13629,0,-256,1072,0,0,,1328,816
7,02-10-18,39,9:30,9:45,,,0,33.99,33.99,0,-104889,71498,176387,-33391,0,0,107,0,0,,107,107
7,02-10-18,40,9:45,10:00,33.18,,0,33.18,33.18,1,-125128,65357,190485,-59771,0,0,368,0,0,,368,368
7,02-10-18,41,10:00,10:15,,,0,33.99,33.99,0,-98383,73333,171716,-25050,0,0,2,0,0,,2,2
7,02-10-18,42,10:15,10:30,,,0,33.98,33.98,0,-105096,76087,181183,-29009,0,0,0,0,0,,0,0
7,02-10-18,43,10:30,10:45,,,0,33.98,33.98,0,-123608,74272,197880,-49336,0,0,0,0,0,,0,0
7,02-10-18,44,10:45,11:00,,,0,33.96,33.96,0,-101601,72989,174590,-28612,0,0,0,0,0,,0,0
7,02-10-18,45,11:00,11:15,32.71,,0,32.71,32.71,1,-126825,57044,183869,-69781,0,0,177,0,0,,177,177
7,02-10-18,46,11:15,11:30,32.66,,0,32.66,32.66,1,-99522,72263,171785,-27259,0,0,393,0,0,,393,393
7,02-10-18,47,11:30,11:45,,,0,33.81,33.81,0,-82880,81746,164626,-1134,0,0,0,0,0,,0,0
7,02-10-18,48,11:45,12:00,,,0,33.81,33.81,0,-84424,96284,180708,11860,0,0,0,0,0,,0,0
7,02-10-18,49,12:00,12:15,,,0,33.48,33.48,0,-116073,95212,211285,-20861,0,0,0,0,0,,0,0
7,02-10-18,50,12:15,12:30,,34.92,0,34.92,34.92,-1,-98729,103898,202627,5169,0,-12,0,0,0,,12,-12
7,02-10-18,51,12:30,12:45,,33.87,0,33.87,33.87,-1,-56123,117040,173163,60917,0,-98,0,0,0,,98,-98
7,02-10-18,52,12:45,13:00,,0.01,0,0.01,0.01,-1,-45259,135420,180679,90161,0,-14050,0,0,0,,14050,-14050
7,02-10-18,53,13:00,13:15,,-7.51,0,-7.51,-7.51,-1,-77422,86667,164089,9245,0,-17720,0,0,0,,17720,-17720
7,02-10-18,54,13:15,13:30,,30.9,0,30.9,30.9,-1,-47644,110686,158330,63042,0,-648,0,0,0,,648,-648
7,02-10-18,55,13:30,13:45,,3.57,0,3.57,3.57,-1,-24482,144529,169011,120047,0,-4170,0,0,0,,4170,-4170
7,02-10-18,56,13:45,14:00,,-53.04,0,-53.04,-53.04,-1,-28090,148655,176745,120565,0,-76601,0,0,0,,76601,-76601
7,02-10-18,57,14:00,14:15,,15.98,0,15.98,15.98,-1,-36262,114024,150286,77762,0,-32010,0,0,0,,32010,-32010
7,02-10-18,58,14:15,14:30,,22.35,0,22.35,22.35,-1,-20722,134219,154941,113497,0,-1627,0,0,0,,1627,-1627
7,02-10-18,59,14:30,14:45,,-10.62,0,-10.62,-10.62,-1,-21231,161239,182470,140008,0,-45816,0,0,0,,45816,-45816
7,02-10-18,60,14:45,15:00,,-18.75,0,-18.75,-18.75,-1,-31714,167393,199107,135679,0,-88081,0,0,0,,88081,-88081
7,02-10-18,61,15:00,15:15,,8.16,0,8.16,8.16,-1,-41391,151603,192994,110212,0,-49892,0,0,0,,49892,-49892
7,02-10-18,62,15:15,15:30,,30.89,0,30.89,30.89,-1,-43850,162814,206664,118964,0,-434,0,0,0,,434,-434
7,02-10-18,63,15:30,15:45,,23.14,0,23.14,23.14,-1,-42297,175274,217571,132977,0,-14165,0,0,0,,14165,-14165
7,02-10-18,64,15:45,16:00,,-32.21,0,-32.21,-32.21,-1,-49702,158524,208226,108822,0,-43230,0,0,0,,43230,-43230
7,02-10-18,65,16:00,16:15,,26.89,0,26.89,26.89,-1,-79618,131127,210745,51509,0,-18684,0,0,0,,18684,-18684
7,02-10-18,66,16:15,16:30,,,0,33.15,33.15,0,-72624,140433,213057,67809,0,-19,0,0,0,,19,-19
7,02-10-18,67,16:30,16:45,,33.06,0,33.06,33.06,-1,-82268,123289,205557,41021,0,-526,0,0,0,,526,-526
7,02-10-18,68,16:45,17:00,,30.78,0,30.78,30.78,-1,-101897,128435,230332,26538,0,-2716,0,0,0,,2716,-2716
7,02-10-18,69,17:00,17:15,,-97.41,0,-97.41,-97.41,-1,-86844,168317,255161,81473,0,-36122,0,0,0,,36122,-36122
7,02-10-18,70,17:15,17:30,,14.97,0,14.97,14.97,-1,-112468,166129,278597,53661,0,-46295,0,0,0,,46295,-46295
7,02-10-18,71,17:30,17:45,33.82,13.07,0,33.82,13.07,2,-116101,127408,243509,11307,0,-40829,9,0,0,,40838,-40820
7,02-10-18,72,17:45,18:00,35.58,34.56,0,35.58,33.32,2,-107890,114704,222594,6814,0,-1309,421,0,0,,1730,-888
7,02-10-18,73,18:00,18:15,,34.95,0,34.95,34.95,-1,-121210,73245,194455,-47965,0,-250,0,0,0,,250,-250
7,02-10-18,74,18:15,18:30,,34.98,0,34.98,34.98,-1,-93729,87664,181393,-6065,0,-100,0,0,0,,100,-100
7,02-10-18,75,18:30,18:45,,27.25,0,27.25,27.25,-1,-84827,111980,196807,27153,0,-3338,0,0,0,,3338,-3338
7,02-10-18,76,18:45,19:00,,22.69,0,22.69,22.69,-1,-85186,134916,220102,49730,0,-29100,0,0,0,,29100,-29100
7,02-10-18,77,19:00,19:15,37.25,28.25,0,37.25,37.25,1,-193416,162648,356064,-30768,0,-15072,617,0,0,,15689,-14455
7,02-10-18,78,19:15,19:30,37.25,15.52,0,15.52,15.52,-1,-170336,183467,353803,13131,0,-3499,15,0,0,,3514,-3484
7,02-10-18,79,19:30,19:45,,2.49,0,2.49,2.49,-1,-138710,191526,330236,52816,0,-43399,0,0,0,,43399,-43399
7,02-10-18,80,19:45,20:00,33.09,28.09,0,33.09,33.09,1,-213084,204043,417127,-9041,0,-22414,235,0,0,,22649,-22179
7,02-10-18,81,20:00,20:15,33.09,28.09,0,33.09,33.09,1,-151595,182073,333668,30478,0,-339,855,0,0,,1194,516
7,02-10-18,82,20:15,20:30,,,0,32.98,32.98,0,-155411,181897,337308,26486,0,0,27,0,0,,27,27
7,02-10-18,83,20:30,20:45,,23.96,0,23.96,23.96,-1,-147961,204881,352842,56920,0,-4263,0,0,0,,4263,-4263
7,02-10-18,84,20:45,21:00,,-32.45,0,-32.45,-32.45,-1,-144929,230074,375003,85145,0,-41620,0,0,0,,41620,-41620
7,02-10-18,85,21:00,21:15,,2.89,0,2.89,2.89,-1,-64365,77179,141544,12814,0,-28281,0,0,0,,28281,-28281
7,02-10-18,86,21:15,21:30,33.09,34.34,0,33.09,32.85,2,-56823,76507,133330,19684,0,-3,437,0,0,,440,434
7,02-10-18,87,21:30,21:45,,27.09,0,27.09,27.09,-1,-41159,81956,123115,40797,0,-11633,0,0,0,,11633,-11633
7,02-10-18,88,21:45,22:00,,6.11,0,6.11,6.11,-1,-28450,103183,131633,74733,0,-30296,0,0,0,,30296,-30296
7,02-10-18,89,22:00,22:15,55.09,21.89,0,55.09,55.09,1,-106729,72181,178910,-34548,0,-22272,1649,0,0,,23921,-20623
7,02-10-18,90,22:15,22:30,58.38,28.09,0,58.38,28.09,2,-71217,62292,133509,-8925,0,-643,9408,0,0,,10051,8765
7,02-10-18,91,22:30,22:45,,27.09,0,27.09,27.09,-1,-41820,72429,114249,30609,0,-5227,0,0,0,,5227,-5227
7,02-10-18,92,22:45,23:00,,25.69,0,25.69,25.69,-1,-39467,94924,134391,55457,0,-21922,0,0,0,,21922,-21922
7,02-10-18,93,23:00,23:15,,28.09,0,28.09,28.09,-1,-69671,92610,162281,22939,0,-10661,0,0,0,,10661,-10661
7,02-10-18,94,23:15,23:30,,19.78,0,19.78,19.78,-1,-60340,94464,154804,34124,0,-9863,0,0,0,,9863,-9863
7,02-10-18,95,23:30,23:45,,17.89,0,17.89,17.89,-1,-50623,92451,143074,41828,0,-41162,0,0,0,,41162,-41162
7,02-10-18,96,23:45,0:00,,10.66,0,10.66,10.66,-1,-74370,131035,205405,56665,0,-47292,0,0,0,,47292,-47292
7,02-11-18,1,0:00,0:15,63.4,30.08,0,63.4,30.08,2,-71852,61319,133171,-10533,0,-22229,1606,0,0,,23835,-20623
7,02-11-18,2,0:15,0:30,77.45,22.23,0,77.45,22.23,2,-40961,51737,92698,10776,0,-1190,16372,0,0,,17562,15182
7,02-11-18,3,0:30,0:45,34.34,-106.78,0,34.34,-106.78,2,-59559,69277,128836,9718,0,-25388,185,0,0,,25573,-25203
7,02-11-18,4,0:45,1:00,37.09,28.09,0,37.09,28.09,2,-59985,73100,133085,13115,0,-3728,1118,0,0,,4846,-2610
7,02-11-18,5,1:00,1:15,94.39,26.09,0,94.39,26.09,2,-77694,41195,118889,-36499,0,-5165,8088,0,0,,13253,2923
7,02-11-18,6,1:15,1:30,90.02,,0,90.02,90.02,1,-66043,48075,114118,-17968,0,0,21605,0,0,,21605,21605
7,02-11-18,7,1:30,1:45,90.02,24.96,0,24.96,24.96,-1,-42229,54452,96681,12223,0,-10487,1910,0,0,,12397,-8577
7,02-11-18,8,1:45,2:00,,17.03,0,17.03,17.03,-1,-40871,76644,117515,35773,0,-22733,0,0,0,,22733,-22733
7,02-11-18,9,2:00,2:15,52.85,25.03,0,52.85,52.85,1,-67150,45407,112557,-21743,0,-13212,3062,0,0,,16274,-10150
7,02-11-18,10,2:15,2:30,50.02,,0,50.02,50.02,1,-57061,48124,105185,-8937,0,0,9903,0,0,,9903,9903
7,02-11-18,11,2:30,2:45,,,0,31.61,31.61,0,-57375,54889,112264,-2486,0,0,1316,0,0,,1316,1316
7,02-11-18,12,2:45,3:00,,,0,31.62,31.62,0,-53270,58548,111818,5278,0,0,0,0,0,,0,0
7,02-11-18,13,3:00,3:15,37.13,,0,37.13,37.13,1,-67096,46908,114004,-20188,0,0,4102,0,0,,4102,4102
7,02-11-18,14,3:15,3:30,37.09,,0,37.09,37.09,1,-56733,51095,107828,-5638,0,0,6205,0,0,,6205,6205
7,02-11-18,15,3:30,3:45,39.93,,0,39.93,39.93,1,-64145,50531,114676,-13614,0,0,7055,0,0,,7055,7055
7,02-11-18,16,3:45,4:00,31.99,,0,31.99,31.99,1,-50035,56397,106432,6362,0,0,1811,0,0,,1811,1811
7,02-11-18,17,4:00,4:15,47.48,,0,47.48,47.48,1,-69331,43360,112691,-25971,0,0,4535,0,0,,4535,4535
7,02-11-18,18,4:15,4:30,48.11,,0,48.11,48.11,1,-61385,48275,109660,-13110,0,0,15912,0,0,,15912,15912
7,02-11-18,19,4:30,4:45,33.09,32.11,0,33.09,31.57,2,-57413,46267,103680,-11146,0,-54,2025,0,0,,2079,1971
7,02-11-18,20,4:45,5:00,33.09,30.09,0,30.09,30.09,-1,-46897,48804,95701,1907,0,-411,3,0,0,,414,-408
7,02-11-18,21,5:00,5:15,,27.32,0,27.32,27.32,-1,-59699,78895,138594,19196,0,-6934,0,0,0,,6934,-6934
7,02-11-18,22,5:15,5:30,,30.09,0,30.09,30.09,-1,-60439,66544,126983,6105,0,-8743,0,0,0,,8743,-8743
7,02-11-18,23,5:30,5:45,34.64,30.09,0,34.64,34.64,1,-64742,52825,117567,-11917,0,-1706,1031,0,0,,2737,-675
7,02-11-18,24,5:45,6:00,34.98,,0,34.98,34.98,1,-64692,48061,112753,-16631,0,0,3956,0,0,,3956,3956
7,02-11-18,25,6:00,6:15,31.02,32.38,0,31.7,31.7,2,-51852,54308,106160,2456,0,-27,1047,0,0,,1074,1020
7,02-11-18,26,6:15,6:30,39.72,,0,39.72,39.72,1,-65288,45535,110823,-19753,0,0,3327,0,0,,3327,3327
7,02-11-18,27,6:30,6:45,51.18,,0,51.18,51.18,1,-80610,48026,128636,-32584,0,0,23780,0,0,,23780,23780
7,02-11-18,28,6:45,7:00,55.07,,0,55.07,55.07,1,-100604,45509,146113,-55095,0,0,32025,0,0,,32025,32025
7,02-11-18,29,7:00,7:15,35.88,30.25,0,35.88,30.25,2,-64394,87893,152287,23499,0,-820,14416,0,0,,15236,13596
7,02-11-18,30,7:15,7:30,36.68,30.25,0,36.68,36.68,1,-99597,80806,180403,-18791,0,-27,6201,0,0,,6228,6174
7,02-11-18,31,7:30,7:45,68.81,,0,68.81,68.81,1,-113520,67349,180869,-46171,0,0,21725,0,0,,21725,21725
7,02-11-18,32,7:45,8:00,84.3,,0,84.3,84.3,1,-127595,73056,200651,-54539,0,0,54282,0,0,,54282,54282
7,02-11-18,33,8:00,8:15,84.3,-29.26,0,-29.26,-29.26,-1,-62624,96368,158992,33744,0,-5843,22810,0,0,,28653,16967
7,02-11-18,34,8:15,8:30,99.12,30.68,0,99.12,99.12,1,-106311,64923,171234,-41388,0,-4847,10362,0,0,,15209,5515
7,02-11-18,35,8:30,8:45,161,,0,161,161,1,-112283,81160,193443,-31123,0,0,46464,0,0,,46464,46464
7,02-11-18,36,8:45,9:00,54.68,,0,54.68,54.68,1,-128994,85220,214214,-43774,0,0,15705,0,0,,15705,15705
7,02-11-18,37,9:00,9:15,38.02,31.22,0,31.22,31.22,-1,-91322,87168,178490,-4154,0,-405,13898,0,0,,14303,13493
7,02-11-18,38,9:15,9:30,32.68,30.39,0,33.39,30.39,2,-94293,68900,163193,-25393,0,-421,1071,0,0,,1492,650
7,02-11-18,39,9:30,9:45,32.68,34.75,0,34.75,34.75,-1,-77910,69423,147333,-8487,0,-148,410,0,0,,558,262
7,02-11-18,40,9:45,10:00,,30.68,0,30.68,30.68,-1,-76284,82056,158340,5772,0,-1866,0,0,0,,1866,-1866
7,02-11-18,41,10:00,10:15,,27.68,0,27.68,27.68,-1,-70627,90066,160693,19439,0,-6527,0,0,0,,6527,-6527
7,02-11-18,42,10:15,10:30,,34.2,0,34.2,34.2,-1,-75351,79069,154420,3718,0,-2484,0,0,0,,2484,-2484
7,02-11-18,43,10:30,10:45,,30.68,0,30.68,30.68,-1,-81988,74831,156819,-7157,0,-2137,0,0,0,,2137,-2137
7,02-11-18,44,10:45,11:00,,29.68,0,29.68,29.68,-1,-83278,80546,163824,-2732,0,-604,0,0,0,,604,-604
7,02-11-18,45,11:00,11:15,,30.68,0,30.68,30.68,-1,-83668,89495,173163,5827,0,-1247,0,0,0,,1247,-1247
7,02-11-18,46,11:15,11:30,,29.68,0,29.68,29.68,-1,-74618,90457,165075,15839,0,-5022,0,0,0,,5022,-5022
7,02-11-18,47,11:30,11:45,,,0,33.39,33.39,0,-77652,77345,154997,-307,0,-90,0,0,0,,90,-90
7,02-11-18,48,11:45,12:00,,,0,33.38,33.38,0,-65500,72605,138105,7105,0,0,0,0,0,,0,0
7,02-11-18,49,12:00,12:15,,,0,33.39,33.39,0,-57661,86015,143676,28354,0,0,0,0,0,,0,0
7,02-11-18,50,12:15,12:30,,12.53,0,12.53,12.53,-1,-47855,88916,136771,41061,0,-11856,0,0,0,,11856,-11856
7,02-11-18,51,12:30,12:45,,13.03,0,13.03,13.03,-1,-50363,74438,124801,24075,0,-19662,0,0,0,,19662,-19662
7,02-11-18,52,12:45,13:00,,9.44,0,9.44,9.44,-1,-56855,90598,147453,33743,0,-16512,0,0,0,,16512,-16512
7,02-11-18,53,13:00,13:15,,7.03,0,7.03,7.03,-1,-55260,91706,146966,36446,0,-19689,0,0,0,,19689,-19689
7,02-11-18,54,13:15,13:30,,,0,32.84,32.84,0,-41194,93560,134754,52366,0,-39,0,0,0,,39,-39
7,02-11-18,55,13:30,13:45,,,0,32.84,32.84,0,-39142,97791,136933,58649,0,0,0,0,0,,0,0
7,02-11-18,56,13:45,14:00,,28.03,0,28.03,28.03,-1,-39536,101168,140704,61632,0,-1956,0,0,0,,1956,-1956
7,02-11-18,57,14:00,14:15,,27.68,0,27.68,27.68,-1,-26523,108871,135394,82348,0,-3265,0,0,0,,3265,-3265
7,02-11-18,58,14:15,14:30,,16.68,0,16.68,16.68,-1,-29907,92662,122569,62755,0,-8111,0,0,0,,8111,-8111
7,02-11-18,59,14:30,14:45,,29.68,0,29.68,29.68,-1,-32987,99402,132389,66415,0,-2857,0,0,0,,2857,-2857
7,02-11-18,60,14:45,15:00,,16.68,0,16.68,16.68,-1,-31942,93650,125592,61708,0,-8292,0,0,0,,8292,-8292
7,02-11-18,61,15:00,15:15,,13.03,0,13.03,13.03,-1,-28874,142479,171353,113605,0,-13579,0,0,0,,13579,-13579
7,02-11-18,62,15:15,15:30,,,0,33.23,33.23,0,-35579,122302,157881,86723,0,-186,0,0,0,,186,-186
7,02-11-18,63,15:30,15:45,,,0,33.23,33.23,0,-35342,109030,144372,73688,0,0,0,0,0,,0,0
7,02-11-18,64,15:45,16:00,,,0,33.23,33.23,0,-34820,91754,126574,56934,0,0,0,0,0,,0,0
7,02-11-18,65,16:00,16:15,,,0,33.46,33.46,0,-101816,106601,208417,4785,0,0,0,0,0,,0,0
7,02-11-18,66,16:15,16:30,39.18,,0,39.18,39.18,1,-97737,86364,184101,-11373,0,0,3711,0,0,,3711,3711
7,02-11-18,67,16:30,16:45,35.13,31.21,0,35.13,31.21,2,-63684,58100,121784,-5584,0,-398,1900,0,0,,2298,1502
7,02-11-18,68,16:45,17:00,222.02,,0,222.02,222.02,1,-92945,36724,129669,-56221,0,0,32509,0,0,,32509,32509
7,02-11-18,69,17:00,17:15,222.02,-150.03,0,-150.03,-150.03,-1,-52514,150319,202833,97805,0,-14280,10725,0,0,,25005,-3555
7,02-11-18,70,17:15,17:30,,28.97,0,28.97,28.97,-1,-55500,87267,142767,31767,0,-11064,0,0,0,,11064,-11064
7,02-11-18,71,17:30,17:45,45.67,28.97,0,45.67,45.67,1,-56870,46865,103735,-10005,0,-2808,1640,0,0,,4448,-1168
7,02-11-18,72,17:45,18:00,68.69,,0,68.69,68.69,1,-61463,30679,92142,-30784,0,0,32072,0,0,,32072,32072
7,02-11-18,73,18:00,18:15,87.2,,0,87.2,87.2,1,-81401,35243,116644,-46158,0,0,35156,0,0,,35156,35156
7,02-11-18,74,18:15,18:30,85.5,,0,85.5,85.5,1,-65159,32531,97690,-32628,0,0,26843,0,0,,26843,26843
7,02-11-18,75,18:30,18:45,56.6,,0,56.6,56.6,1,-64543,31314,95857,-33229,0,0,34659,0,0,,34659,34659
7,02-11-18,76,18:45,19:00,63.09,,0,63.09,63.09,1,-67022,34767,101789,-32255,0,0,34971,0,0,,34971,34971
7,02-11-18,77,19:00,19:15,86.36,,0,86.36,86.36,1,-84782,40808,125590,-43974,0,0,38798,0,0,,38798,38798
7,02-11-18,78,19:15,19:30,40.04,27.68,0,27.68,27.68,-1,-48071,49145,97216,1074,0,-1334,15285,0,0,,16619,13951
7,02-11-18,79,19:30,19:45,52.86,27.68,0,52.86,27.68,2,-67970,42454,110424,-25516,0,-2642,3149,0,0,,5791,507
7,02-11-18,80,19:45,20:00,38.82,,0,38.82,38.82,1,-80255,57716,137971,-22539,0,0,6810,0,0,,6810,6810
7,02-11-18,81,20:00,20:15,40.22,32.82,0,40.22,32.82,2,-57746,52316,110062,-5430,0,-191,2036,0,0,,2227,1845
7,02-11-18,82,20:15,20:30,44.02,31.51,0,44.02,31.51,2,-49634,40571,90205,-9063,0,-69,12938,0,0,,13007,12869
7,02-11-18,83,20:30,20:45,37.85,25.74,0,37.85,25.74,2,-51964,51001,102965,-963,0,-10386,556,0,0,,10942,-9830
7,02-11-18,84,20:45,21:00,47.4,2.37,0,47.4,2.37,2,-30874,64758,95632,33884,0,-3258,4140,0,0,,7398,882
7,02-11-18,85,21:00,21:15,,4.78,0,4.78,4.78,-1,-49379,113193,162572,63814,0,-4806,0,0,0,,4806,-4806
7,02-11-18,86,21:15,21:30,,30.68,0,30.68,30.68,-1,-41085,85063,126148,43978,0,-853,0,0,0,,853,-853
7,02-11-18,87,21:30,21:45,,30.68,0,30.68,30.68,-1,-30378,125403,155781,95025,0,-1179,0,0,0,,1179,-1179
7,02-11-18,88,21:45,22:00,,-123.66,0,-123.66,-123.66,-1,-29746,148266,178012,118520,0,-7212,0,0,0,,7212,-7212
7,02-11-18,89,22:00,22:15,,-165.78,0,-165.78,-165.78,-1,-63344,81694,145038,18350,0,-9786,0,0,0,,9786,-9786
7,02-11-18,90,22:15,22:30,,-150.4,0,-150.4,-150.4,-1,-44882,106192,151074,61310,0,-14227,0,0,0,,14227,-14227
7,02-11-18,91,22:30,22:45,,22.88,0,22.88,22.88,-1,-47750,119236,166986,71486,0,-31133,0,0,0,,31133,-31133
7,02-11-18,92,22:45,23:00,,-6.03,0,-6.03,-6.03,-1,-50304,124707,175011,74403,0,-50908,0,0,0,,50908,-50908
7,02-11-18,93,23:00,23:15,222.02,-6.03,0,222.02,222.02,1,-116179,53688,169867,-62491,0,-15718,18177,0,0,,33895,2459
7,02-11-18,94,23:15,23:30,42.68,29.68,0,29.68,29.68,-1,-47548,43555,91103,-3993,0,-411,14185,0,0,,14596,13774
7,02-11-18,95,23:30,23:45,42.68,28.69,0,28.69,28.69,-1,-34132,66474,100606,32342,0,-11983,54,0,0,,12037,-11929
7,02-11-18,96,23:45,0:00,,-19.84,0,-19.84,-19.84,-1,-42923,119968,162891,77045,0,-38148,0,0,0,,38148,-38148
7,02-12-18,1,0:00,0:15,36.62,7.89,0,36.62,36.62,1,-57778,59998,117776,2220,0,-29307,293,0,0,,29600,-29014
7,02-12-18,2,0:15,0:30,36.68,28.12,0,28.12,28.12,-1,-49526,69327,118853,19801,0,-271,253,0,0,,524,-18
7,02-12-18,3,0:30,0:45,32.68,27.86,0,32.68,27.86,2,-49929,52378,102307,2449,0,-2351,133,0,0,,2484,-2218
7,02-12-18,4,0:45,1:00,35.18,,0,35.18,35.18,1,-67041,43760,110801,-23281,0,0,2658,0,0,,2658,2658
7,02-12-18,5,1:00,1:15,134.34,,0,134.34,134.34,1,-73630,33125,106755,-40505,0,0,13298,0,0,,13298,13298
7,02-12-18,6,1:15,1:30,173.69,,0,173.69,173.69,1,-73846,26876,100722,-46970,0,0,48146,0,0,,48146,48146
7,02-12-18,7,1:30,1:45,35.12,,0,35.12,35.12,1,-41877,31969,73846,-9908,0,0,10311,0,0,,10311,10311
7,02-12-18,8,1:45,2:00,31.44,,0,31.44,31.44,1,-56633,43750,100383,-12883,0,0,1195,0,0,,1195,1195
7,02-12-18,9,2:00,2:15,31.54,22.37,0,32.3,22.37,2,-35661,59251,94912,23590,0,-1104,120,0,0,,1224,-984
7,02-12-18,10,2:15,2:30,,2.78,0,2.78,2.78,-1,-39400,77093,116493,37693,0,-22807,0,0,0,,22807,-22807
7,02-12-18,11,2:30,2:45,,29.68,0,29.68,29.68,-1,-45374,73591,118965,28217,0,-16090,0,0,0,,16090,-16090
7,02-12-18,12,2:45,3:00,,23.08,0,23.08,23.08,-1,-46001,92268,138269,46267,0,-14224,0,0,0,,14224,-14224
7,02-12-18,13,3:00,3:15,37.82,5.1,0,37.82,5.1,2,-41017,59247,100264,18230,0,-20301,160,0,0,,20461,-20141
7,02-12-18,14,3:15,3:30,62.12,5.1,0,62.12,62.12,1,-54931,53919,108850,-1012,0,-1509,9740,0,0,,11249,8231
7,02-12-18,15,3:30,3:45,34.29,,0,34.29,34.29,1,-55852,58125,113977,2273,0,0,1046,0,0,,1046,1046
7,02-12-18,16,3:45,4:00,34.29,15.29,0,15.29,15.29,-1,-41671,72986,114657,31315,0,-7097,6,0,0,,7103,-7091
7,02-12-18,17,4:00,4:15,32.39,11.26,0,32.39,11.26,2,-49489,62942,112431,13453,0,-21888,53,0,0,,21941,-21835
7,02-12-18,18,4:15,4:30,36.22,-20.15,0,36.22,-20.15,2,-40498,77305,117803,36807,0,-9966,545,0,0,,10511,-9421
7,02-12-18,19,4:30,4:45,,-56.74,0,-56.74,-56.74,-1,-42090,57961,100051,15871,0,-30569,0,0,0,,30569,-30569
7,02-12-18,20,4:45,5:00,,15.38,0,15.38,15.38,-1,-32017,54248,86265,22231,0,-14121,0,0,0,,14121,-14121
7,02-12-18,21,5:00,5:15,,30.68,0,30.68,30.68,-1,-45591,82073,127664,36482,0,-6487,0,0,0,,6487,-6487
7,02-12-18,22,5:15,5:30,,30.68,0,30.68,30.68,-1,-45617,48043,93660,2426,0,-5882,0,0,0,,5882,-5882
7,02-12-18,23,5:30,5:45,74.34,30.68,0,74.34,74.34,1,-85250,35392,120642,-49858,0,-890,13709,0,0,,14599,12819
7,02-12-18,24,5:45,6:00,59.47,,0,59.47,59.47,1,-116627,71365,187992,-45262,0,0,35055,0,0,,35055,35055
7,02-12-18,25,6:00,6:15,39.12,-6.72,0,-6.72,-6.72,-1,-68969,111006,179975,42037,0,-4498,18162,0,0,,22660,13664
7,02-12-18,26,6:15,6:30,,29.53,0,29.53,29.53,-1,-54802,88074,142876,33272,0,-12405,0,0,0,,12405,-12405
7,02-12-18,27,6:30,6:45,,27.68,0,27.68,27.68,-1,-48961,74474,123435,25513,0,-14749,0,0,0,,14749,-14749
7,02-12-18,28,6:45,7:00,,28.78,0,28.78,28.78,-1,-50801,93524,144325,42723,0,-4242,0,0,0,,4242,-4242
7,02-12-18,29,7:00,7:15,,-125.71,0,-125.71,-125.71,-1,-89016,146245,235261,57229,0,-27837,0,0,0,,27837,-27837
7,02-12-18,30,7:15,7:30,,25.68,0,25.68,25.68,-1,-83058,103287,186345,20229,0,-29450,0,0,0,,29450,-29450
7,02-12-18,31,7:30,7:45,33.69,29.78,0,33.69,29.78,2,-75351,91252,166603,15901,0,-4451,192,0,0,,4643,-4259
7,02-12-18,32,7:45,8:00,43.5,27.26,0,43.5,27.26,2,-91445,82280,173725,-9165,0,-6209,1055,0,0,,7264,-5154
7,02-12-18,33,8:00,8:15,34.83,31.31,0,31.31,31.31,-1,-69285,79494,148779,10209,0,-1062,417,0,0,,1479,-645
7,02-12-18,34,8:15,8:30,,26.68,0,26.68,26.68,-1,-55880,85666,141546,29786,0,-12635,0,0,0,,12635,-12635
7,02-12-18,35,8:30,8:45,39.42,32.44,0,39.42,39.42,1,-71775,63278,135053,-8497,0,-5960,1417,0,0,,7377,-4543
7,02-12-18,36,8:45,9:00,54.17,,0,54.17,54.17,1,-82100,62057,144157,-20043,0,0,15546,0,0,,15546,15546
7,02-12-18,37,9:00,9:15,54.17,30.31,0,30.31,30.31,-1,-47397,104387,151784,56990,0,-1391,5110,0,0,,6501,3719
7,02-12-18,38,9:15,9:30,,24.01,0,24.01,24.01,-1,-44957,91395,136352,46438,0,-10273,0,0,0,,10273,-10273
7,02-12-18,39,9:30,9:45,,31.31,0,31.31,31.31,-1,-54811,89802,144613,34991,0,-18293,0,0,0,,18293,-18293
7,02-12-18,40,9:45,10:00,,29.44,0,29.44,29.44,-1,-54259,85504,139763,31245,0,-27303,0,0,0,,27303,-27303
7,02-12-18,41,10:00,10:15,,31.34,0,31.34,31.34,-1,-44092,69221,113313,25129,0,-17236,0,0,0,,17236,-17236
7,02-12-18,42,10:15,10:30,,-12.86,0,-12.86,-12.86,-1,-37795,93739,131534,55944,0,-37193,0,0,0,,37193,-37193
7,02-12-18,43,10:30,10:45,,4.05,0,4.05,4.05,-1,-47479,106971,154450,59492,0,-44401,0,0,0,,44401,-44401
7,02-12-18,44,10:45,11:00,,-7.51,0,-7.51,-7.51,-1,-52891,111658,164549,58767,0,-52631,0,0,0,,52631,-52631
7,02-12-18,45,11:00,11:15,,20.53,0,20.53,20.53,-1,-80390,113535,193925,33145,0,-36743,0,0,0,,36743,-36743
7,02-12-18,46,11:15,11:30,,28.97,0,28.97,28.97,-1,-68984,113451,182435,44467,0,-19965,0,0,0,,19965,-19965
7,02-12-18,47,11:30,11:45,,17.73,0,17.73,17.73,-1,-65702,115855,181557,50153,0,-35266,0,0,0,,35266,-35266
7,02-12-18,48,11:45,12:00,,9.57,0,9.57,9.57,-1,-63499,127075,190574,63576,0,-36960,0,0,0,,36960,-36960
7,02-12-18,49,12:00,12:15,35.28,19.66,0,35.28,35.28,1,-90480,96805,187285,6325,0,-26275,393,0,0,,26668,-25882
7,02-12-18,50,12:15,12:30,35.28,32.74,0,32.74,32.74,-1,-105222,111733,216955,6511,0,-587,233,0,0,,820,-354
7,02-12-18,51,12:30,12:45,,31.31,0,31.31,31.31,-1,-99263,117719,216982,18456,0,-5424,0,0,0,,5424,-5424
7,02-12-18,52,12:45,13:00,,31.31,0,31.31,31.31,-1,-86920,108056,194976,21136,0,-8519,0,0,0,,8519,-8519
7,02-12-18,53,13:00,13:15,,12.46,0,12.46,12.46,-1,-64463,99625,164088,35162,0,-25856,0,0,0,,25856,-25856
7,02-12-18,54,13:15,13:30,,30.31,0,30.31,30.31,-1,-67297,102850,170147,35553,0,-19426,0,0,0,,19426,-19426
7,02-12-18,55,13:30,13:45,,32.78,0,32.78,32.78,-1,-67091,85562,152653,18471,0,-8559,0,0,0,,8559,-8559
7,02-12-18,56,13:45,14:00,,-15.54,0,-15.54,-15.54,-1,-57002,108458,165460,51456,0,-18798,0,0,0,,18798,-18798
7,02-12-18,57,14:00,14:15,39.92,25.51,0,39.92,25.51,2,-104004,94225,198229,-9779,0,-15682,1064,0,0,,16746,-14618
7,02-12-18,58,14:15,14:30,,15.28,0,15.28,15.28,-1,-61604,106739,168343,45135,0,-10306,0,0,0,,10306,-10306
7,02-12-18,59,14:30,14:45,,12.01,0,12.01,12.01,-1,-65751,109480,175231,43729,0,-31898,0,0,0,,31898,-31898
7,02-12-18,60,14:45,15:00,,-4.73,0,-4.73,-4.73,-1,-70027,106201,176228,36174,0,-39409,0,0,0,,39409,-39409
7,02-12-18,61,15:00,15:15,,15.31,0,15.31,15.31,-1,-95081,131129,226210,36048,0,-21502,0,0,0,,21502,-21502
7,02-12-18,62,15:15,15:30,,29.53,0,29.53,29.53,-1,-109628,102340,211968,-7288,0,-19013,0,0,0,,19013,-19013
7,02-12-18,63,15:30,15:45,35.98,29.53,0,35.98,35.98,1,-121476,96224,217700,-25252,0,-270,846,0,0,,1116,576
7,02-12-18,64,15:45,16:00,70.58,,0,70.58,70.58,1,-128174,85322,213496,-42852,0,0,17763,0,0,,17763,17763
7,02-12-18,65,16:00,16:15,37.22,31.4,0,37.22,31.4,2,-73161,128710,201871,55549,0,-1355,9419,0,0,,10774,8064
7,02-12-18,66,16:15,16:30,,,0,33.39,33.39,0,-74285,101703,175988,27418,0,-47,0,0,0,,47,-47
7,02-12-18,67,16:30,16:45,,33.39,0,33.39,33.39,-1,-68655,86910,155565,18255,0,-894,0,0,0,,894,-894
7,02-12-18,68,16:45,17:00,,34.22,0,34.22,34.22,-1,-55622,67531,123153,11909,0,-953,0,0,0,,953,-953
7,02-12-18,69,17:00,17:15,,-24.66,0,-24.66,-24.66,-1,-64770,107917,172687,43147,0,-18688,0,0,0,,18688,-18688
7,02-12-18,70,17:15,17:30,65.39,-24.66,0,65.39,65.39,1,-81949,55032,136981,-26917,0,-1530,6492,0,0,,8022,4962
7,02-12-18,71,17:30,17:45,65.39,32.89,0,32.89,32.89,-1,-47630,83386,131016,35756,0,-111,554,0,0,,665,443
7,02-12-18,72,17:45,18:00,65.78,,0,65.78,65.78,1,-86375,70244,156619,-16131,0,0,6628,0,0,,6628,6628
7,02-12-18,73,18:00,18:15,40.53,22.99,0,22.99,22.99,-1,-69517,72344,141861,2827,0,-3434,6331,0,0,,9765,2897
7,02-12-18,74,18:15,18:30,46.89,22.69,0,46.89,22.69,2,-83236,54849,138085,-28387,0,-5286,1930,0,0,,7216,-3356
7,02-12-18,75,18:30,18:45,,,0,34.01,34.01,0,-70567,55253,125820,-15314,0,0,151,0,0,,151,151
7,02-12-18,76,18:45,19:00,,,0,34.01,34.01,0,-58015,59470,117485,1455,0,0,0,0,0,,0,0
7,02-12-18,77,19:00,19:15,,24.38,0,24.38,24.38,-1,-36051,46169,82220,10118,0,-3212,0,0,0,,3212,-3212
7,02-12-18,78,19:15,19:30,,12.17,0,12.17,12.17,-1,-46726,63960,110686,17234,0,-26592,0,0,0,,26592,-26592
7,02-12-18,79,19:30,19:45,,-3.11,0,-3.11,-3.11,-1,-40923,93977,134900,53054,0,-32644,0,0,0,,32644,-32644
7,02-12-18,80,19:45,20:00,,20.3,0,20.3,20.3,-1,-46457,96408,142865,49951,0,-43050,0,0,0,,43050,-43050
7,02-12-18,81,20:00,20:15,34.5,22.54,0,34.5,34.5,1,-64146,48063,112209,-16083,0,-21506,461,0,0,,21967,-21045
7,02-12-18,82,20:15,20:30,34.5,-5.62,0,-5.62,-5.62,-1,-31772,81405,113177,49633,0,-19889,12,0,0,,19901,-19877
7,02-12-18,83,20:30,20:45,,12.33,0,12.33,12.33,-1,-47709,91268,138977,43559,0,-25792,0,0,0,,25792,-25792
7,02-12-18,84,20:45,21:00,,4.58,0,4.58,4.58,-1,-85216,122315,207531,37099,0,-39748,0,0,0,,39748,-39748
7,02-12-18,85,21:00,21:15,35.2,6.11,0,35.2,6.11,2,-94008,67344,161352,-26664,0,-21900,81,0,0,,21981,-21819
7,02-12-18,86,21:15,21:30,41.04,31.31,0,41.04,31.31,2,-57149,72451,129600,15302,0,-178,1806,0,0,,1984,1628
7,02-12-18,87,21:30,21:45,,18.11,0,18.11,18.11,-1,-39026,98261,137287,59235,0,-2782,0,0,0,,2782,-2782
7,02-12-18,88,21:45,22:00,,-35.35,0,-35.35,-35.35,-1,-50881,106194,157075,55313,0,-48336,0,0,0,,48336,-48336
7,02-12-18,89,22:00,22:15,81.55,29.11,0,81.55,29.11,2,-95167,36131,131298,-59036,0,-7372,7059,0,0,,14431,-313
7,02-12-18,90,22:15,22:30,34.86,14.44,0,14.44,14.44,-1,-63009,83727,146736,20718,0,-2977,4181,0,0,,7158,1204
7,02-12-18,91,22:30,22:45,,-0.98,0,-0.98,-0.98,-1,-44926,86964,131890,42038,0,-38225,0,0,0,,38225,-38225
7,02-12-18,92,22:45,23:00,,-5.4,0,-5.4,-5.4,-1,-35544,97214,132758,61670,0,-56456,0,0,0,,56456,-56456
7,02-12-18,93,23:00,23:15,71.36,-5.4,0,71.36,71.36,1,-103141,85724,188865,-17417,0,-14945,4218,0,0,,19163,-10727
7,02-12-18,94,23:15,23:30,71.36,-14.73,0,-14.73,-14.73,-1,-64469,111129,175598,46660,0,-13152,506,0,0,,13658,-12646
7,02-12-18,95,23:30,23:45,,-11.31,0,-11.31,-11.31,-1,-53116,97157,150273,44041,0,-55807,0,0,0,,55807,-55807
7,02-12-18,96,23:45,0:00,,-13.28,0,-13.28,-13.28,-1,-41932,105173,147105,63241,0,-63894,0,0,0,,63894,-63894
7,02/13/2018,1,0:00,0:15,70.6,-13.28,0,70.6,70.6,1,-98139,61747,159886,-36392,0,-14412,4205,0,0,,18617,-10207
7,02/13/2018,2,0:15,0:30,31.47,,0,31.47,31.47,1,-67387,86449,153836,19062,0,0,1078,0,0,,1078,1078
7,02/13/2018,3,0:30,0:45,45.89,,0,45.89,45.89,1,-82432,63001,145433,-19431,0,0,9149,0,0,,9149,9149
7,02/13/2018,4,0:45,1:00,35.89,34.98,0,34.98,34.98,-1,-115472,73824,189296,-41648,0,-9,7950,0,0,,7959,7941
7,02/13/2018,5,1:00,1:15,35.89,34.27,0,35.89,33.08,2,-44716,55899,100615,11183,0,-161,404,0,0,,565,243
7,02/13/2018,6,1:15,1:30,,,0,33.07,33.07,0,-46540,75653,122193,29113,0,0,0,0,0,,0,0
7,02/13/2018,7,1:30,1:45,,,0,33.06,33.06,0,-34497,91582,126079,57085,0,0,0,0,0,,0,0
7,02/13/2018,8,1:45,2:00,,,0,33.06,33.06,0,-24537,101324,125861,76787,0,0,0,0,0,,0,0
7,02/13/2018,9,2:00,2:15,,,0,33.03,33.03,0,-44712,85223,129935,40511,0,0,0,0,0,,0,0
7,02/13/2018,10,2:15,2:30,,,0,33,33,0,-45573,77648,123221,32075,0,0,0,0,0,,0,0
7,02/13/2018,11,2:30,2:45,,,0,33.02,33.02,0,-47175,71407,118582,24232,0,0,0,0,0,,0,0
7,02/13/2018,12,2:45,3:00,,,0,33,33,0,-40743,58311,99054,17568,0,0,0,0,0,,0,0
7,02/13/2018,13,3:00,3:15,35.94,,0,35.94,35.94,1,-39298,34987,74285,-4311,0,0,856,0,0,,856,856
7,02/13/2018,14,3:15,3:30,35.89,,0,35.89,35.89,1,-55360,34842,90202,-20518,0,0,5798,0,0,,5798,5798
7,02/13/2018,15,3:30,3:45,39.89,,0,39.89,39.89,1,-61433,28155,89588,-33278,0,0,8308,0,0,,8308,8308
7,02/13/2018,16,3:45,4:00,31.35,,0,31.35,31.35,1,-51584,39010,90594,-12574,0,0,3129,0,0,,3129,3129
7,02/13/2018,17,4:00,4:15,46.13,,0,46.13,46.13,1,-62683,25892,88575,-36791,0,0,5531,0,0,,5531,5531
7,02/13/2018,18,4:15,4:30,35.02,,0,35.02,35.02,1,-71442,26473,97915,-44969,0,0,3289,0,0,,3289,3289
7,02/13/2018,19,4:30,4:45,35.89,,0,35.89,35.89,1,-78478,30540,109018,-47938,0,0,2752,0,0,,2752,2752
7,02/13/2018,20,4:45,5:00,,,0,32.42,32.42,0,-90122,44748,134870,-45374,0,0,418,0,0,,418,418
7,02/13/2018,21,5:00,5:15,,,0,32.95,32.95,0,-81689,65915,147604,-15774,0,0,0,0,0,,0,0
7,02/13/2018,22,5:15,5:30,,,0,32.95,32.95,0,-68650,47804,116454,-20846,0,0,0,0,0,,0,0
7,02/13/2018,23,5:30,5:45,,,0,32.94,32.94,0,-67320,46940,114260,-20380,0,0,0,0,0,,0,0
7,02/13/2018,24,5:45,6:00,31.79,33.39,0,32.28,32.28,2,-48191,60175,108366,11984,0,-1,88,0,0,,89,87
7,02/13/2018,25,6:00,6:15,,22.67,0,22.67,22.67,-1,-47769,62845,110614,15076,0,-11440,0,0,0,,11440,-11440
7,02/13/2018,26,6:15,6:30,,31.83,0,31.83,31.83,-1,-75746,72204,147950,-3542,0,-6340,0,0,0,,6340,-6340
7,02/13/2018,27,6:30,6:45,48.1,31.83,0,48.1,48.1,1,-116680,58579,175259,-58101,0,-37,718,0,0,,755,681
7,02/13/2018,28,6:45,7:00,275.02,,0,275.02,275.02,1,-134388,48023,182411,-86365,0,0,29134,0,0,,29134,29134
7,02/13/2018,29,7:00,7:15,275.02,-144.62,0,-144.62,-144.62,-1,-15999,99165,115164,83166,0,-16405,9289,0,0,,25694,-7116
7,02/13/2018,30,7:15,7:30,,33.45,0,33.45,33.45,-1,-95707,59781,155488,-35926,0,-1168,0,0,0,,1168,-1168
7,02/13/2018,31,7:30,7:45,,,0,32.59,32.59,0,-128302,55383,183685,-72919,0,0,0,0,0,,0,0
7,02/13/2018,32,7:45,8:00,,,0,32.59,32.59,0,-169424,67124,236548,-102300,0,0,0,0,0,,0,0
7,02/13/2018,33,8:00,8:15,35.86,33.08,0,35.86,32.77,2,-95469,46764,142233,-48705,0,-355,66,0,0,,421,-289
7,02/13/2018,34,8:15,8:30,119.02,,0,119.02,119.02,1,-124029,52942,176971,-71087,0,0,10704,0,0,,10704,10704
7,02/13/2018,35,8:30,8:45,118.02,,0,118.02,118.02,1,-123008,50497,173505,-72511,0,0,45150,0,0,,45150,45150
7,02/13/2018,36,8:45,9:00,76.25,,0,76.25,76.25,1,-129179,50510,179689,-78669,0,0,40540,0,0,,40540,40540
7,02/13/2018,37,9:00,9:15,53.95,,0,53.95,53.95,1,-94815,43186,138001,-51629,0,0,33636,0,0,,33636,33636
7,02/13/2018,38,9:15,9:30,44.02,,0,44.02,44.02,1,-78761,41466,120227,-37295,0,0,26214,0,0,,26214,26214
7,02/13/2018,39,9:30,9:45,32.02,,0,32.02,32.02,1,-72032,44410,116442,-27622,0,0,6610,0,0,,6610,6610
7,02/13/2018,40,9:45,10:00,45.85,,0,45.85,45.85,1,-64854,56304,121158,-8550,0,0,1157,0,0,,1157,1157
7,02/13/2018,41,10:00,10:15,237.02,,0,237.02,237.02,1,-103048,55689,158737,-47359,0,0,39351,0,0,,39351,39351
7,02/13/2018,42,10:15,10:30,237.02,27.82,0,27.82,27.82,-1,-55558,70845,126403,15287,0,-1811,7250,0,0,,9061,5439
7,02/13/2018,43,10:30,10:45,,17.03,0,17.03,17.03,-1,-49207,74776,123983,25569,0,-6965,0,0,0,,6965,-6965
7,02/13/2018,44,10:45,11:00,,9.38,0,9.38,9.38,-1,-46881,76419,123300,29538,0,-28036,0,0,0,,28036,-28036
7,02/13/2018,45,11:00,11:15,38.65,32.08,0,38.65,32.08,2,-50932,48828,99760,-2104,0,-6011,500,0,0,,6511,-5511
7,02/13/2018,46,11:15,11:30,,-2.5,0,-2.5,-2.5,-1,-36741,72213,108954,35472,0,-25279,0,0,0,,25279,-25279
7,02/13/2018,47,11:30,11:45,,-13.78,0,-13.78,-13.78,-1,-27528,71843,99371,44315,0,-14383,0,0,0,,14383,-14383
7,02/13/2018,48,11:45,12:00,,-38.49,0,-38.49,-38.49,-1,-55568,76273,131841,20705,0,-27859,0,0,0,,27859,-27859
7,02/13/2018,49,12:00,12:15,,-39.76,0,-39.76,-39.76,-1,-27838,84541,112379,56703,0,-12351,0,0,0,,12351,-12351
7,02/13/2018,50,12:15,12:30,,-37.49,0,-37.49,-37.49,-1,-39500,76402,115902,36902,0,-31915,0,0,0,,31915,-31915
7,02/13/2018,51,12:30,12:45,,-107.08,0,-107.08,-107.08,-1,-26149,113770,139919,87621,0,-48437,0,0,0,,48437,-48437
7,02/13/2018,52,12:45,13:00,,-17.75,0,-17.75,-17.75,-1,-47479,123516,170995,76037,0,-56084,0,0,0,,56084,-56084
7,02/13/2018,53,13:00,13:15,36.85,29.48,0,36.85,29.48,2,-83071,82581,165652,-490,0,-19524,260,0,0,,19784,-19264
7,02/13/2018,54,13:15,13:30,,-6.99,0,-6.99,-6.99,-1,-59357,117047,176404,57690,0,-21809,0,0,0,,21809,-21809
7,02/13/2018,55,13:30,13:45,,7.19,0,7.19,7.19,-1,-64030,119704,183734,55674,0,-19623,0,0,0,,19623,-19623
7,02/13/2018,56,13:45,14:00,,2.8,0,2.8,2.8,-1,-62801,114081,176882,51280,0,-32638,0,0,0,,32638,-32638
7,02/13/2018,57,14:00,14:15,,29.7,0,29.7,29.7,-1,-94961,116153,211114,21192,0,-16536,0,0,0,,16536,-16536
7,02/13/2018,58,14:15,14:30,,13.03,0,13.03,13.03,-1,-92511,105544,198055,13033,0,-25821,0,0,0,,25821,-25821
7,02/13/2018,59,14:30,14:45,34.52,13.03,0,34.52,34.52,1,-105962,92894,198856,-13068,0,-4603,404,0,0,,5007,-4199
7,02/13/2018,60,14:45,15:00,30.81,29.85,0,29.85,29.85,-1,-102347,98578,200925,-3769,0,-695,187,0,0,,882,-508
7,02/13/2018,61,15:00,15:15,,-28.14,0,-28.14,-28.14,-1,-75167,121644,196811,46477,0,-27395,0,0,0,,27395,-27395
7,02/13/2018,62,15:15,15:30,,33.08,0,33.08,33.08,-1,-90443,108117,198560,17674,0,-6117,0,0,0,,6117,-6117
7,02/13/2018,63,15:30,15:45,41.28,,0,41.28,41.28,1,-111940,85491,197431,-26449,0,0,1031,0,0,,1031,1031
7,02/13/2018,64,15:45,16:00,62.01,,0,62.01,62.01,1,-142671,60513,203184,-82158,0,0,20042,0,0,,20042,20042
7,02/13/2018,65,16:00,16:15,38.02,32.03,0,38.02,32.03,2,-90061,103558,193619,13497,0,-1099,11186,0,0,,12285,10087
7,02/13/2018,66,16:15,16:30,72.76,32.03,0,72.76,72.76,1,-138577,90939,229516,-47638,0,-39,3141,0,0,,3180,3102
7,02/13/2018,67,16:30,16:45,206.02,,0,206.02,206.02,1,-128088,83802,211890,-44286,0,0,33738,0,0,,33738,33738
7,02/13/2018,68,16:45,17:00,221.02,,0,221.02,221.02,1,-128880,60033,188913,-68847,0,0,46932,0,0,,46932,46932
7,02/13/2018,69,17:00,17:15,221.02,-4.53,0,-4.53,-4.53,-1,-98427,135943,234370,37516,0,-4578,17968,0,0,,22546,13390
7,02/13/2018,70,17:15,17:30,35.41,-4.53,0,35.41,35.41,1,-114729,90789,205518,-23940,0,-195,51,0,0,,246,-144
7,02/13/2018,71,17:30,17:45,64.81,,0,64.81,64.81,1,-99685,61945,161630,-37740,0,0,5100,0,0,,5100,5100
7,02/13/2018,72,17:45,18:00,237.02,,0,237.02,237.02,1,-118379,54936,173315,-63443,0,0,34258,0,0,,34258,34258
7,02/13/2018,73,18:00,18:15,63.02,,0,63.02,63.02,1,-97857,65569,163426,-32288,0,0,22512,0,0,,22512,22512
7,02/13/2018,74,18:15,18:30,237.02,,0,237.02,237.02,1,-118877,62483,181360,-56394,0,0,16006,0,0,,16006,16006
7,02/13/2018,75,18:30,18:45,64.72,,0,64.72,64.72,1,-109370,45498,154868,-63872,0,0,29741,0,0,,29741,29741
7,02/13/2018,76,18:45,19:00,37.79,,0,37.79,37.79,1,-89062,55394,144456,-33668,0,0,1094,0,0,,1094,1094
7,02/13/2018,77,19:00,19:15,238.02,,0,238.02,238.02,1,-80320,59108,139428,-21212,0,0,17460,0,0,,17460,17460
7,02/13/2018,78,19:15,19:30,37.73,,0,37.73,37.73,1,-55614,70085,125699,14471,0,0,4338,0,0,,4338,4338
7,02/13/2018,79,19:30,19:45,,31.83,0,31.83,31.83,-1,-59699,85000,144699,25301,0,-613,0,0,0,,613,-613
7,02/13/2018,80,19:45,20:00,,30.03,0,30.03,30.03,-1,-80042,100593,180635,20551,0,-5475,0,0,0,,5475,-5475
7,02/13/2018,81,20:00,20:15,,30.49,0,30.49,30.49,-1,-82662,62885,145547,-19777,0,-4908,0,0,0,,4908,-4908
7,02/13/2018,82,20:15,20:30,,31.83,0,31.83,31.83,-1,-50859,68172,119031,17313,0,-522,0,0,0,,522,-522
7,02/13/2018,83,20:30,20:45,,31.12,0,31.12,31.12,-1,-78914,87027,165941,8113,0,-800,0,0,0,,800,-800
7,02/13/2018,84,20:45,21:00,,16.38,0,16.38,16.38,-1,-79609,98388,177997,18779,0,-12815,0,0,0,,12815,-12815
7,02/13/2018,85,21:00,21:15,34.52,29.87,0,34.52,34.52,1,-78975,86003,164978,7028,0,-9739,194,0,0,,9933,-9545
7,02/13/2018,86,21:15,21:30,108.38,29.87,0,108.38,108.38,1,-91529,46987,138516,-44542,0,-23,20363,0,0,,20386,20340
7,02/13/2018,87,21:30,21:45,40.94,31.83,0,31.83,31.83,-1,-32565,56332,88897,23767,0,-304,12236,0,0,,12540,11932
7,02/13/2018,88,21:45,22:00,40.94,0.86,0,0.86,0.86,-1,-38719,83606,122325,44887,0,-21563,84,0,0,,21647,-21479
7,02/13/2018,89,22:00,22:15,37.18,33.08,0,37.18,33.08,2,-66505,40952,107457,-25553,0,-5599,1387,0,0,,6986,-4212
7,02/13/2018,90,22:15,22:30,35.58,,0,35.58,35.58,1,-60531,39887,100418,-20644,0,0,741,0,0,,741,741
7,02/13/2018,91,22:30,22:45,40.4,,0,40.4,40.4,1,-66870,47589,114459,-19281,0,0,2032,0,0,,2032,2032
7,02/13/2018,92,22:45,23:00,37.02,,0,37.02,37.02,1,-41883,54979,96862,13096,0,0,6754,0,0,,6754,6754
7,02/13/2018,93,23:00,23:15,39.58,,0,39.58,39.58,1,-133081,25497,158578,-107584,0,0,1316,0,0,,1316,1316
7,02/13/2018,94,23:15,23:30,,,0,32.97,32.97,0,-109804,31060,140864,-78744,0,0,0,0,0,,0,0
7,02/13/2018,95,23:30,23:45,66.6,,0,66.6,66.6,1,-91553,40639,132192,-50914,0,0,11058,0,0,,11058,11058
7,02/13/2018,96,23:45,0:00,37.02,30.02,0,30.02,30.02,-1,-55415,65839,121254,10424,0,-602,8176,0,0,,8778,7574
7,02/14/2018,1,0:00,0:15,46.87,-17.93,1,47.87,-18.93,2,-71830,96581,168411,24751,0,-9459,1026,0,0,,10485,-8433
7,02/14/2018,2,0:15,0:30,45.11,21.35,1,22.35,20.35,-1,-62130,83666,145796,21536,0,-3599,1766,0,0,,5365,-1833
7,02/14/2018,3,0:30,0:45,,18.51,1,19.51,17.51,-1,-58641,80794,139435,22153,0,-19034,0,0,0,,19034,-19034
7,02/14/2018,4,0:45,1:00,,9.63,1,10.63,8.63,-1,-50585,98966,149551,48381,0,-37771,0,0,0,,37771,-37771
7,02/14/2018,5,1:00,1:15,59.5,24.51,1,60.5,23.51,2,-69177,59426,128603,-9751,0,-17838,2484,0,0,,20322,-15354
7,02/14/2018,6,1:15,1:30,59.5,12.74,1,13.74,11.74,-1,-48557,78711,127268,30154,0,-5760,51,0,0,,5811,-5709
7,02/14/2018,7,1:30,1:45,,14.8,1,15.8,13.8,-1,-45477,71561,117038,26084,0,-23225,0,0,0,,23225,-23225
7,02/14/2018,8,1:45,2:00,,30.15,1,31.15,29.15,-1,-37710,80604,118314,42894,0,-18773,0,0,0,,18773,-18773
7,02/14/2018,9,2:00,2:15,40.01,30.67,1,41.01,39.01,1,-58994,52742,111736,-6252,0,-8464,628,0,0,,9092,-7836
7,02/14/2018,10,2:15,2:30,31.64,30.67,1,32.64,30.64,1,-54761,60060,114821,5299,0,-8,31,0,0,,39,23
7,02/14/2018,11,2:30,2:45,33.53,,1,34.53,32.53,1,-55563,60426,115989,4863,0,0,627,0,0,,627,627
7,02/14/2018,12,2:45,3:00,31.61,,1,32.61,30.61,1,-55041,54069,109110,-972,0,0,46,0,0,,46,46
7,02/14/2018,13,3:00,3:15,33.53,,1,34.53,32.53,1,-50800,49532,100332,-1268,0,0,528,0,0,,528,528
7,02/14/2018,14,3:15,3:30,53.34,,1,54.34,52.34,1,-73546,50585,124131,-22961,0,0,12427,0,0,,12427,12427
7,02/14/2018,15,3:30,3:45,36.12,,1,37.12,35.12,1,-66432,53674,120106,-12758,0,0,13130,0,0,,13130,13130
7,02/14/2018,16,3:45,4:00,31.53,,1,32.53,30.53,1,-62715,52786,115501,-9929,0,0,4395,0,0,,4395,4395
7,02/14/2018,17,4:00,4:15,31.67,,1,32.67,30.67,1,-80927,64946,145873,-15981,0,0,1109,0,0,,1109,1109
7,02/14/2018,18,4:15,4:30,31.67,,1,32.67,30.67,1,-71960,62790,134750,-9170,0,0,222,0,0,,222,222
7,02/14/2018,19,4:30,4:45,,,1,34.35,32.35,0,-68361,61951,130312,-6410,0,0,0,0,0,,0,0
7,02/14/2018,20,4:45,5:00,,34.86,1,35.86,33.86,-1,-64902,60859,125761,-4043,0,-42,0,0,0,,42,-42
7,02/14/2018,21,5:00,5:15,,-32.39,1,-31.39,-33.39,-1,-39488,103550,143038,64062,0,-28488,0,0,0,,28488,-28488
7,02/14/2018,22,5:15,5:30,,26.78,1,27.78,25.78,-1,-60266,101367,161633,41101,0,-39233,0,0,0,,39233,-39233
7,02/14/2018,23,5:30,5:45,,13.01,1,14.01,12.01,-1,-63258,84281,147539,21023,0,-39155,0,0,0,,39155,-39155
7,02/14/2018,24,5:45,6:00,32.51,31.4,1,33.51,31.51,1,-75329,68536,143865,-6793,0,-12641,338,0,0,,12979,-12303
7,02/14/2018,25,6:00,6:15,,-20.57,1,-19.57,-21.57,-1,-53472,112929,166401,59457,0,-21574,0,0,0,,21574,-21574
7,02/14/2018,26,6:15,6:30,,24.44,1,25.44,23.44,-1,-57172,86458,143630,29286,0,-19344,0,0,0,,19344,-19344
7,02/14/2018,27,6:30,6:45,31.6,31.78,1,32.6,30.6,1,-69330,50138,119468,-19192,0,-10967,14,0,0,,10981,-10953
7,02/14/2018,28,6:45,7:00,32.62,31.33,1,33.62,30.33,2,-104905,55312,160217,-49593,0,-438,769,0,0,,1207,331
7,02/14/2018,29,7:00,7:15,,-143.63,1,-142.63,-144.63,-1,-35401,148826,184227,113425,0,-35300,0,0,0,,35300,-35300
7,02/14/2018,30,7:15,7:30,,32.33,1,33.33,31.33,-1,-61773,56100,117873,-5673,0,-9876,0,0,0,,9876,-9876
7,02/14/2018,31,7:30,7:45,,,1,34.35,32.35,0,-101314,56939,158253,-44375,0,-301,0,0,0,,301,-301
7,02/14/2018,32,7:45,8:00,55.81,,1,56.81,54.81,1,-140910,68011,208921,-72899,0,0,2936,0,0,,2936,2936
7,02/14/2018,33,8:00,8:15,35.76,,1,36.76,34.76,1,-57580,86358,143938,28778,0,0,2898,0,0,,2898,2898
7,02/14/2018,34,8:15,8:30,37.07,,1,38.07,36.07,1,-66532,69552,136084,3020,0,0,3028,0,0,,3028,3028
7,02/14/2018,35,8:30,8:45,35.28,,1,36.28,34.28,1,-79806,70811,150617,-8995,0,0,2921,0,0,,2921,2921
7,02/14/2018,36,8:45,9:00,,,1,34.52,32.52,0,-88789,74548,163337,-14241,0,0,434,0,0,,434,434
7,02/14/2018,37,9:00,9:15,73.12,,1,74.12,72.12,1,-91210,47211,138421,-43999,0,0,7734,0,0,,7734,7734
7,02/14/2018,38,9:15,9:30,41.02,,1,42.02,40.02,1,-89809,51084,140893,-38725,0,0,22292,0,0,,22292,22292
7,02/14/2018,39,9:30,9:45,36.87,,1,37.87,35.87,1,-79686,63828,143514,-15858,0,0,14702,0,0,,14702,14702
7,02/14/2018,40,9:45,10:00,35.91,,1,36.91,34.91,1,-71900,83687,155587,11787,0,0,1675,0,0,,1675,1675
7,02/14/2018,41,10:00,10:15,237.12,,1,238.12,236.12,1,-137270,62361,199631,-74909,0,0,34920,0,0,,34920,34920
7,02/14/2018,42,10:15,10:30,47.45,,1,48.45,46.45,1,-93011,89834,182845,-3177,0,0,18760,0,0,,18760,18760
7,02/14/2018,43,10:30,10:45,47.45,33.78,1,34.78,32.78,-1,-72179,96077,168256,23898,0,-186,140,0,0,,326,-46
7,02/14/2018,44,10:45,11:00,,22.72,1,23.72,21.72,-1,-66608,113800,180408,47192,0,-21027,0,0,0,,21027,-21027
7,02/14/2018,45,11:00,11:15,,32.78,1,33.78,31.78,-1,-69327,75392,144719,6065,0,-13604,0,0,0,,13604,-13604
7,02/14/2018,46,11:15,11:30,,-6.27,1,-5.27,-7.27,-1,-54285,93766,148051,39481,0,-23437,0,0,0,,23437,-23437
7,02/14/2018,47,11:30,11:45,,18.98,1,19.98,17.98,-1,-59644,97569,157213,37925,0,-8544,0,0,0,,8544,-8544
7,02/14/2018,48,11:45,12:00,,-17.38,1,-16.38,-18.38,-1,-56207,111255,167462,55048,0,-42851,0,0,0,,42851,-42851
7,02/14/2018,49,12:00,12:15,,27.33,1,28.33,26.33,-1,-56813,95834,152647,39021,0,-27079,0,0,0,,27079,-27079
7,02/14/2018,50,12:15,12:30,,6.78,1,7.78,5.78,-1,-44017,97145,141162,53128,0,-44233,0,0,0,,44233,-44233
7,02/14/2018,51,12:30,12:45,,-33.88,1,-32.88,-34.88,-1,-46108,114119,160227,68011,0,-53788,0,0,0,,53788,-53788
7,02/14/2018,52,12:45,13:00,,-2.9,1,-1.9,-3.9,-1,-48210,124373,172583,76163,0,-54723,0,0,0,,54723,-54723
7,02/14/2018,53,13:00,13:15,,27.33,1,28.33,26.33,-1,-63239,99193,162432,35954,0,-31886,0,0,0,,31886,-31886
7,02/14/2018,54,13:15,13:30,,24.16,1,25.16,23.16,-1,-53374,95222,148596,41848,0,-13058,0,0,0,,13058,-13058
7,02/14/2018,55,13:30,13:45,,-17.67,1,-16.67,-18.67,-1,-65934,99370,165304,33436,0,-40107,0,0,0,,40107,-40107
7,02/14/2018,56,13:45,14:00,,7.64,1,8.64,6.64,-1,-68847,106631,175478,37784,0,-15634,0,0,0,,15634,-15634
7,02/14/2018,57,14:00,14:15,,5.55,1,6.55,4.55,-1,-73626,109199,182825,35573,0,-37379,0,0,0,,37379,-37379
7,02/14/2018,58,14:15,14:30,,31.78,1,32.78,30.78,-1,-78767,106723,185490,27956,0,-19045,0,0,0,,19045,-19045
7,02/14/2018,59,14:30,14:45,,31.78,1,32.78,30.78,-1,-73466,102583,176049,29117,0,-23449,0,0,0,,23449,-23449
7,02/14/2018,60,14:45,15:00,,31.33,1,32.33,30.33,-1,-75329,95605,170934,20276,0,-21852,0,0,0,,21852,-21852
7,02/14/2018,61,15:00,15:15,,1.38,1,2.38,0.38,-1,-76267,122568,198835,46301,0,-25890,0,0,0,,25890,-25890
7,02/14/2018,62,15:15,15:30,35.28,31.78,1,36.28,34.28,1,-104677,96895,201572,-7782,0,-11290,61,0,0,,11351,-11229
7,02/14/2018,63,15:30,15:45,35.28,31.78,1,36.28,34.28,1,-104073,84041,188114,-20032,0,-9,1232,0,0,,1241,1223
7,02/14/2018,64,15:45,16:00,35.71,,1,36.71,34.71,1,-143719,77018,220737,-66701,0,0,819,0,0,,819,819
7,02/14/2018,65,16:00,16:15,39.45,,1,40.45,38.45,1,-107669,94883,202552,-12786,0,0,4425,0,0,,4425,4425
7,02/14/2018,66,16:15,16:30,127.12,,1,128.12,126.12,1,-129325,80152,209477,-49173,0,0,23535,0,0,,23535,23535
7,02/14/2018,67,16:30,16:45,146.12,,1,147.12,145.12,1,-103449,74866,178315,-28583,0,0,39114,0,0,,39114,39114
7,02/14/2018,68,16:45,17:00,63.17,,1,64.17,62.17,1,-99940,64624,164564,-35316,0,0,36163,0,0,,36163,36163
7,02/14/2018,69,17:00,17:15,36.12,31.36,1,37.12,30.36,2,-78493,104286,182779,25793,0,-1955,11802,0,0,,13757,9847
7,02/14/2018,70,17:15,17:30,37.45,31.36,1,38.45,36.45,1,-56407,65017,121424,8610,0,-102,524,0,0,,626,422
7,02/14/2018,71,17:30,17:45,38.75,,1,39.75,37.75,1,-61407,78593,140000,17186,0,0,1070,0,0,,1070,1070
7,02/14/2018,72,17:45,18:00,50.15,,1,51.15,49.15,1,-67285,71802,139087,4517,0,0,2435,0,0,,2435,2435
7,02/14/2018,73,18:00,18:15,59.84,33.29,1,60.84,32.29,2,-61370,52488,113858,-8882,0,-17,10657,0,0,,10674,10640
7,02/14/2018,74,18:15,18:30,59.84,24.01,1,25.01,23.01,-1,-51836,83747,135583,31911,0,-12416,707,0,0,,13123,-11709
7,02/14/2018,75,18:30,18:45,,25.14,1,26.14,24.14,-1,-54160,90641,144801,36481,0,-26181,0,0,0,,26181,-26181
7,02/14/2018,76,18:45,19:00,,14.95,1,15.95,13.95,-1,-53819,117022,170841,63203,0,-37380,0,0,0,,37380,-37380
7,02/14/2018,77,19:00,19:15,39.99,31.78,1,40.99,30.78,2,-51457,45032,96489,-6425,0,-16493,834,0,0,,17327,-15659
7,02/14/2018,78,19:15,19:30,,23.47,1,24.47,22.47,-1,-30636,75567,106203,44931,0,-9278,0,0,0,,9278,-9278
7,02/14/2018,79,19:30,19:45,,-18.52,1,-17.52,-19.52,-1,-44134,75866,120000,31732,0,-34225,0,0,0,,34225,-34225
7,02/14/2018,80,19:45,20:00,,-105.27,1,-104.27,-106.27,-1,-29559,99248,128807,69689,0,-39880,0,0,0,,39880,-39880
7,02/14/2018,81,20:00,20:15,44.28,2.06,1,45.28,1.06,2,-82318,86056,168374,3738,0,-43018,138,0,0,,43156,-42880
7,02/14/2018,82,20:15,20:30,192.12,11.47,1,193.12,10.47,2,-51650,56870,108520,5220,0,-3049,11791,0,0,,14840,8742
7,02/14/2018,83,20:30,20:45,35.5,-32.13,1,36.5,-33.13,2,-49338,59568,108906,10230,0,-18251,178,0,0,,18429,-18073
7,02/14/2018,84,20:45,21:00,,-32.97,1,-31.97,-33.97,-1,-73238,100259,173497,27021,0,-21914,0,0,0,,21914,-21914
7,02/14/2018,85,21:00,21:15,238.12,-32.97,1,239.12,237.12,1,-72476,36935,109411,-35541,0,-2532,14221,0,0,,16753,11689
7,02/14/2018,86,21:15,21:30,221.12,35.02,1,36.02,34.02,-1,-36215,64522,100737,28307,0,-66,22326,0,0,,22392,22260
7,02/14/2018,87,21:30,21:45,221.12,32.41,1,33.41,31.41,-1,-24704,97347,122051,72643,0,-471,55,0,0,,526,-416
7,02/14/2018,88,21:45,22:00,,-19.96,1,-18.96,-20.96,-1,-28433,120439,148872,92006,0,-11066,0,0,0,,11066,-11066
7,02/14/2018,89,22:00,22:15,59.12,21.77,1,60.12,20.77,2,-63465,56357,119822,-7108,0,-12965,3792,0,0,,16757,-9173
7,02/14/2018,90,22:15,22:30,31.41,2.3,1,3.3,1.3,-1,-33959,69292,103251,35333,0,-8204,1225,0,0,,9429,-6979
7,02/14/2018,91,22:30,22:45,,3.29,1,4.29,2.29,-1,-37234,86815,124049,49581,0,-44618,0,0,0,,44618,-44618
7,02/14/2018,92,22:45,23:00,,-13.1,1,-12.1,-14.1,-1,-33899,104072,137971,70173,0,-59108,0,0,0,,59108,-59108
7,02/14/2018,93,23:00,23:15,37.33,23.78,1,38.33,22.78,2,-54174,62216,116390,8042,0,-19819,455,0,0,,20274,-19364
7,02/14/2018,94,23:15,23:30,,-20.96,1,-19.96,-21.96,-1,-35215,80129,115344,44914,0,-24462,0,0,0,,24462,-24462
7,02/14/2018,95,23:30,23:45,,-19.36,1,-18.36,-20.36,-1,-33158,106003,139161,72845,0,-52360,0,0,0,,52360,-52360
7,02/14/2018,96,23:45,0:00,,-26.51,1,-25.51,-27.51,-1,-39590,133705,173295,94115,0,-68604,0,0,0,,68604,-68604
7,02/15/2018,1,0:00,0:15,,5.03,1,6.03,4.03,-1,-66577,105845,172422,39268,0,-29650,0,0,0,,29650,-29650
7,02/15/2018,2,0:15,0:30,,35.02,1,36.02,34.02,-1,-56859,87003,143862,30144,0,-510,0,0,0,,510,-510
7,02/15/2018,3,0:30,0:45,,28.98,1,29.98,27.98,-1,-53766,107669,161435,53903,0,-1797,0,0,0,,1797,-1797
7,02/15/2018,4,0:45,1:00,,10.57,1,11.57,9.57,-1,-48074,129639,177713,81565,0,-22440,0,0,0,,22440,-22440
7,02/15/2018,5,1:00,1:15,32.27,26.03,1,33.27,31.27,1,-72107,75139,147246,3032,0,-20579,13,0,0,,20592,-20566
7,02/15/2018,6,1:15,1:30,32.27,23.26,1,34.57,22.26,2,-61617,81117,142734,19500,0,-3880,22,0,0,,3902,-3858
7,02/15/2018,7,1:30,1:45,,15.72,1,16.72,14.72,-1,-61541,80038,141579,18497,0,-19814,0,0,0,,19814,-19814
7,02/15/2018,8,1:45,2:00,,20.64,1,21.64,19.64,-1,-53094,83989,137083,30895,0,-17903,0,0,0,,17903,-17903
7,02/15/2018,9,2:00,2:15,50.21,29.03,1,51.21,49.21,1,-85560,63409,148969,-22151,0,-12433,2527,0,0,,14960,-9906
7,02/15/2018,10,2:15,2:30,54.15,29.03,1,55.15,53.15,1,-93208,53914,147122,-39294,0,-147,25548,0,0,,25695,25401
7,02/15/2018,11,2:30,2:45,43.02,,1,44.02,42.02,1,-89633,42960,132593,-46673,0,0,31168,0,0,,31168,31168
7,02/15/2018,12,2:45,3:00,43.02,34.02,1,35.02,33.02,-1,-71935,42357,114292,-29578,0,-4,6315,0,0,,6319,6311
7,02/15/2018,13,3:00,3:15,33.16,34.02,1,34.16,32.16,1,-44685,42205,86890,-2480,0,-74,97,0,0,,171,23
7,02/15/2018,14,3:15,3:30,37.02,,1,38.02,36.02,1,-45996,33511,79507,-12485,0,0,5328,0,0,,5328,5328
7,02/15/2018,15,3:30,3:45,46.93,,1,47.93,45.93,1,-59766,33232,92998,-26534,0,0,20084,0,0,,20084,20084
7,02/15/2018,16,3:45,4:00,44.03,,1,45.03,43.03,1,-66234,32093,98327,-34141,0,0,25989,0,0,,25989,25989
7,02/15/2018,17,4:00,4:15,41.02,,1,42.02,40.02,1,-65786,41264,107050,-24522,0,0,25892,0,0,,25892,25892
7,02/15/2018,18,4:15,4:30,58.03,,1,59.03,57.03,1,-79090,38726,117816,-40364,0,0,29520,0,0,,29520,29520
7,02/15/2018,19,4:30,4:45,58.02,,1,59.02,57.02,1,-85383,36688,122071,-48695,0,0,44049,0,0,,44049,44049
7,02/15/2018,20,4:45,5:00,51.98,,1,52.98,50.98,1,-84783,51501,136284,-33282,0,0,43596,0,0,,43596,43596
7,02/15/2018,21,5:00,5:15,32.14,34.35,1,34.58,32.58,2,-44980,67454,112434,22474,0,-663,10784,0,0,,11447,10121
7,02/15/2018,22,5:15,5:30,44.03,,1,45.03,43.03,1,-66019,38834,104853,-27185,0,0,5226,0,0,,5226,5226
7,02/15/2018,23,5:30,5:45,53.79,,1,54.79,52.79,1,-88608,49137,137745,-39471,0,0,33067,0,0,,33067,33067
7,02/15/2018,24,5:45,6:00,67.31,,1,68.31,66.31,1,-113070,64810,177880,-48260,0,0,39063,0,0,,39063,39063
7,02/15/2018,25,6:00,6:15,32.02,33.11,1,34.87,32.11,2,-70317,78786,149103,8469,0,-302,8304,0,0,,8606,8002
7,02/15/2018,26,6:15,6:30,37.57,,1,38.57,36.57,1,-76666,44839,121505,-31827,0,0,552,0,0,,552,552
7,02/15/2018,27,6:30,6:45,222.02,,1,223.02,221.02,1,-133977,40453,174430,-93524,0,0,29275,0,0,,29275,29275
7,02/15/2018,28,6:45,7:00,222.02,,1,223.02,221.02,1,-170025,65000,235025,-105025,0,0,79064,0,0,,79064,79064
7,02/15/2018,29,7:00,7:15,222.02,-161.67,1,-160.67,-162.67,-1,-49039,114454,163493,65415,0,-12154,20517,0,0,,32671,8363
7,02/15/2018,30,7:15,7:30,57.82,34.01,1,58.82,56.82,1,-84925,52561,137486,-32364,0,-682,4321,0,0,,5003,3639
7,02/15/2018,31,7:30,7:45,222.02,,1,223.02,221.02,1,-129368,47094,176462,-82274,0,0,56089,0,0,,56089,56089
7,02/15/2018,32,7:45,8:00,114.02,,1,115.02,113.02,1,-116176,54033,170209,-62143,0,0,72332,0,0,,72332,72332
7,02/15/2018,33,8:00,8:15,67.02,23.87,1,24.87,22.87,-1,-40534,45788,86322,5254,0,-1464,33663,0,0,,35127,32199
7,02/15/2018,34,8:15,8:30,237.02,23.87,1,238.02,236.02,1,-96464,27000,123464,-69464,0,-281,22243,0,0,,22524,21962
7,02/15/2018,35,8:30,8:45,237.02,,1,238.02,236.02,1,-131990,29277,161267,-102713,0,0,68096,0,0,,68096,68096
7,02/15/2018,36,8:45,9:00,237.02,,1,238.02,236.02,1,-146211,27011,173222,-119200,0,0,89919,0,0,,89919,89919
7,02/15/2018,37,9:00,9:15,207.02,,1,208.02,206.02,1,-80807,45810,126617,-34997,0,0,49690,0,0,,49690,49690
7,02/15/2018,38,9:15,9:30,254.02,,1,255.02,253.02,1,-110857,34049,144906,-76808,0,0,42699,0,0,,42699,42699
7,02/15/2018,39,9:30,9:45,254.02,,1,255.02,253.02,1,-124742,24173,148915,-100569,0,0,74079,0,0,,74079,74079
7,02/15/2018,40,9:45,10:00,254.02,,1,255.02,253.02,1,-141159,26959,168118,-114200,0,0,90464,0,0,,90464,90464
7,02/15/2018,41,10:00,10:15,146.02,,1,147.02,145.02,1,-138284,73470,211754,-64814,0,0,64593,0,0,,64593,64593
7,02/15/2018,42,10:15,10:30,237.02,,1,238.02,236.02,1,-136834,59504,196338,-77330,0,0,76991,0,0,,76991,76991
7,02/15/2018,43,10:30,10:45,237.02,,1,238.02,236.02,1,-140714,52123,192837,-88591,0,0,75054,0,0,,75054,75054
7,02/15/2018,44,10:45,11:00,237.02,,1,238.02,236.02,1,-144705,53389,198094,-91316,0,0,86741,0,0,,86741,86741
7,02/15/2018,45,11:00,11:15,49.42,,1,50.42,48.42,1,-122094,95012,217106,-27082,0,0,39099,0,0,,39099,39099
7,02/15/2018,46,11:15,11:30,237.02,,1,238.02,236.02,1,-152440,85784,238224,-66656,0,0,43161,0,0,,43161,43161
7,02/15/2018,47,11:30,11:45,47.61,,1,48.61,46.61,1,-128630,94246,222876,-34384,0,0,39353,0,0,,39353,39353
7,02/15/2018,48,11:45,12:00,73.02,,1,74.02,72.02,1,-157040,101376,258416,-55664,0,0,44041,0,0,,44041,44041
7,02/15/2018,49,12:00,12:15,237.02,,1,238.02,236.02,1,-214451,132138,346589,-82313,0,0,68874,0,0,,68874,68874
7,02/15/2018,50,12:15,12:30,78.02,,1,79.02,77.02,1,-186866,131999,318865,-54867,0,0,56457,0,0,,56457,56457
7,02/15/2018,51,12:30,12:45,44.13,,1,45.13,43.13,1,-157410,134799,292209,-22611,0,0,29585,0,0,,29585,29585
7,02/15/2018,52,12:45,13:00,35.37,,1,36.37,34.37,1,-149063,132599,281662,-16464,0,0,8085,0,0,,8085,8085
7,02/15/2018,53,13:00,13:15,237.02,,1,238.02,236.02,1,-151512,85090,236602,-66422,0,0,22538,0,0,,22538,22538
7,02/15/2018,54,13:15,13:30,52.02,,1,53.02,51.02,1,-105630,97554,203184,-8076,0,0,20387,0,0,,20387,20387
7,02/15/2018,55,13:30,13:45,,,1,36.15,34.15,0,-92265,98792,191057,6527,0,0,640,0,0,,640,640
7,02/15/2018,56,13:45,14:00,,30.46,1,31.46,29.46,-1,-61977,105534,167511,43557,0,-1210,0,0,0,,1210,-1210
7,02/15/2018,57,14:00,14:15,,29.33,1,30.33,28.33,-1,-107188,127147,234335,19959,0,-1406,0,0,0,,1406,-1406
7,02/15/2018,58,14:15,14:30,,,1,36.2,34.2,0,-114400,130857,245257,16457,0,0,0,0,0,,0,0
7,02/15/2018,59,14:30,14:45,,,1,36.19,34.19,0,-120804,129152,249956,8348,0,0,0,0,0,,0,0
7,02/15/2018,60,14:45,15:00,,31.93,1,32.93,30.93,-1,-100878,131174,232052,30296,0,-1237,0,0,0,,1237,-1237
7,02/15/2018,61,15:00,15:15,,31.93,1,32.93,30.93,-1,-73363,96130,169493,22767,0,-3881,0,0,0,,3881,-3881
7,02/15/2018,62,15:15,15:30,,31.25,1,32.25,30.25,-1,-61578,81512,143090,19934,0,-4563,0,0,0,,4563,-4563
7,02/15/2018,63,15:30,15:45,,,1,36.36,34.36,0,-64844,89432,154276,24588,0,-76,0,0,0,,76,-76
7,02/15/2018,64,15:45,16:00,,,1,36.39,34.39,0,-61706,85680,147386,23974,0,0,0,0,0,,0,0
7,02/15/2018,65,16:00,16:15,,22.76,1,23.76,21.76,-1,-52365,120848,173213,68483,0,-4566,0,0,0,,4566,-4566
7,02/15/2018,66,16:15,16:30,,33.59,1,34.59,32.59,-1,-73608,116376,189984,42768,0,-1672,0,0,0,,1672,-1672
7,02/15/2018,67,16:30,16:45,,35.83,1,36.83,34.83,-1,-69194,96383,165577,27189,0,-1047,0,0,0,,1047,-1047
7,02/15/2018,68,16:45,17:00,,,1,36.45,34.45,0,-75093,79525,154618,4432,0,-58,0,0,0,,58,-58
7,02/15/2018,69,17:00,17:15,,31.93,1,32.93,30.93,-1,-42139,103305,145444,61166,0,-1387,0,0,0,,1387,-1387
7,02/15/2018,70,17:15,17:30,,,1,36.5,34.5,0,-67523,83923,151446,16400,0,0,0,0,0,,0,0
7,02/15/2018,71,17:30,17:45,,,1,36.5,34.5,0,-58785,83837,142622,25052,0,0,0,0,0,,0,0
7,02/15/2018,72,17:45,18:00,,,1,36.45,34.45,0,-67042,81239,148281,14197,0,0,0,0,0,,0,0
7,02/15/2018,73,18:00,18:15,34.87,,1,35.87,33.87,1,-89216,77698,166914,-11518,0,0,1,0,0,,1,1
7,02/15/2018,74,18:15,18:30,53.87,,1,54.87,52.87,1,-99567,84964,184531,-14603,0,0,12243,0,0,,12243,12243
7,02/15/2018,75,18:30,18:45,36.73,,1,37.73,35.73,1,-78751,82893,161644,4142,0,0,6265,0,0,,6265,6265
7,02/15/2018,76,18:45,19:00,36.04,,1,37.04,35.04,1,-69157,77846,147003,8689,0,0,2562,0,0,,2562,2562
7,02/15/2018,77,19:00,19:15,38.43,,1,39.43,37.43,1,-68179,74162,142341,5983,0,0,517,0,0,,517,517
7,02/15/2018,78,19:15,19:30,,,1,36.32,34.32,0,-44727,100223,144950,55496,0,0,0,0,0,,0,0
7,02/15/2018,79,19:30,19:45,,16.44,1,17.44,15.44,-1,-33931,129980,163911,96049,0,-1333,0,0,0,,1333,-1333
7,02/15/2018,80,19:45,20:00,,-4.52,1,-3.52,-5.52,-1,-59931,114040,173971,54109,0,-24136,0,0,0,,24136,-24136
7,02/15/2018,81,20:00,20:15,35.99,31.93,1,36.99,34.99,1,-100032,70922,170954,-29110,0,-10237,570,0,0,,10807,-9667
7,02/15/2018,82,20:15,20:30,35.99,31.93,1,32.93,30.93,-1,-76523,89858,166381,13335,0,-29,143,0,0,,172,114
7,02/15/2018,83,20:30,20:45,,30.93,1,31.93,29.93,-1,-76725,100429,177154,23704,0,-523,0,0,0,,523,-523
7,02/15/2018,84,20:45,21:00,,30.25,1,31.25,29.25,-1,-75330,99928,175258,24598,0,-7865,0,0,0,,7865,-7865
7,02/15/2018,85,21:00,21:15,61.66,30.32,1,62.66,60.66,1,-113617,54716,168333,-58901,0,-7171,2388,0,0,,9559,-4783
7,02/15/2018,86,21:15,21:30,71.82,30.32,1,72.82,70.82,1,-109763,58175,167938,-51588,0,-58,9412,0,0,,9470,9354
7,02/15/2018,87,21:30,21:45,31.89,35.65,1,34.96,32.96,2,-76163,74474,150637,-1689,0,-12,265,0,0,,277,253
7,02/15/2018,88,21:45,22:00,,1.23,1,2.23,0.23,-1,-65542,124529,190071,58987,0,-9888,0,0,0,,9888,-9888
7,02/15/2018,89,22:00,22:15,237.15,-11.25,1,238.15,236.15,1,-131838,53047,184885,-78791,0,-13175,15896,0,0,,29071,2721
7,02/15/2018,90,22:15,22:30,237.15,19.69,1,238.15,18.69,2,-69573,63290,132863,-6283,0,-665,44978,0,0,,45643,44313
7,02/15/2018,91,22:30,22:45,237.15,-34.12,1,-33.12,-35.12,-1,-47497,87262,134759,39765,0,-22387,76,0,0,,22463,-22311
7,02/15/2018,92,22:45,23:00,,-35.15,1,-34.15,-36.15,-1,-34588,115255,149843,80667,0,-46595,0,0,0,,46595,-46595
7,02/15/2018,93,23:00,23:15,66.96,10.18,1,67.96,65.96,1,-99815,83568,183383,-16247,0,-24942,1722,0,0,,26664,-23220
7,02/15/2018,94,23:15,23:30,77.51,10.18,1,78.51,76.51,1,-91255,75751,167006,-15504,0,-2,23143,0,0,,23145,23141
7,02/15/2018,95,23:30,23:45,77.51,-15.93,1,-14.93,-16.93,-1,-69431,116808,186239,47377,0,-21978,1479,0,0,,23457,-20499
7,02/15/2018,96,23:45,0:00,,-13.25,1,-12.25,-14.25,-1,-69922,107894,177816,37972,0,-45177,0,0,0,,45177,-45177
7,02/16/2018,1,0:00,0:15,83.12,33.59,1,84.12,32.36,2,-75936,47245,123181,-28691,0,-9818,6062,0,0,,15880,-3756
7,02/16/2018,2,0:15,0:30,83.12,34.37,1,35.37,33.37,-1,-54488,58962,113450,4474,0,-798,1169,0,0,,1967,371
7,02/16/2018,3,0:30,0:45,36.31,34.59,1,37.31,32.33,2,-81370,71215,152585,-10155,0,-524,705,0,0,,1229,181
7,02/16/2018,4,0:45,1:00,36.31,33.15,1,34.15,32.15,-1,-89184,102991,192175,13807,0,-1291,25,0,0,,1316,-1266
7,02/16/2018,5,1:00,1:15,41.09,33.15,1,42.09,40.09,1,-91177,65456,156633,-25721,0,-321,1653,0,0,,1974,1332
7,02/16/2018,6,1:15,1:30,34.6,30.93,1,35.6,29.93,2,-52999,59377,112376,6378,0,-108,1798,0,0,,1906,1690
7,02/16/2018,7,1:30,1:45,34.6,30.93,1,31.93,29.93,-1,-53141,72527,125668,19386,0,-1844,41,0,0,,1885,-1803
7,02/16/2018,8,1:45,2:00,,-14.19,1,-13.19,-15.19,-1,-39798,86099,125897,46301,0,-26460,0,0,0,,26460,-26460
7,02/16/2018,9,2:00,2:15,,10.78,1,11.78,9.78,-1,-37902,73310,111212,35408,0,-22432,0,0,0,,22432,-22432
7,02/16/2018,10,2:15,2:30,,22.97,1,23.97,21.97,-1,-28202,64340,92542,36138,0,-5366,0,0,0,,5366,-5366
7,02/16/2018,11,2:30,2:45,,22.02,1,23.02,21.02,-1,-42570,66084,108654,23514,0,-15381,0,0,0,,15381,-15381
7,02/16/2018,12,2:45,3:00,,25.93,1,26.93,24.93,-1,-53736,69482,123218,15746,0,-6718,0,0,0,,6718,-6718
7,02/16/2018,13,3:00,3:15,,16.78,1,17.78,15.78,-1,-52277,74731,127008,22454,0,-9507,0,0,0,,9507,-9507
7,02/16/2018,14,3:15,3:30,,21.79,1,22.79,20.79,-1,-39234,82474,121708,43240,0,-8418,0,0,0,,8418,-8418
7,02/16/2018,15,3:30,3:45,,28.19,1,29.19,27.19,-1,-42613,59257,101870,16644,0,-17053,0,0,0,,17053,-17053
7,02/16/2018,16,3:45,4:00,,30.93,1,31.93,29.93,-1,-41349,60304,101653,18955,0,-7163,0,0,0,,7163,-7163
7,02/16/2018,17,4:00,4:15,,31.93,1,32.93,30.93,-1,-37089,47824,84913,10735,0,-3814,0,0,0,,3814,-3814
7,02/16/2018,18,4:15,4:30,,,1,34.33,32.33,0,-36792,42403,79195,5611,0,-19,0,0,0,,19,-19
7,02/16/2018,19,4:30,4:45,36.59,,1,37.59,35.59,1,-50045,40047,90092,-9998,0,0,1046,0,0,,1046,1046
7,02/16/2018,20,4:45,5:00,36.59,,1,37.59,35.59,1,-48934,44427,93361,-4507,0,0,983,0,0,,983,983
7,02/16/2018,21,5:00,5:15,,30.93,1,31.93,29.93,-1,-55197,101426,156623,46229,0,-1086,0,0,0,,1086,-1086
7,02/16/2018,22,5:15,5:30,,28.91,1,29.91,27.91,-1,-38022,85912,123934,47890,0,-3825,0,0,0,,3825,-3825
7,02/16/2018,23,5:30,5:45,,32.51,1,33.51,31.51,-1,-49625,55143,104768,5518,0,-648,0,0,0,,648,-648
7,02/16/2018,24,5:45,6:00,54.19,,1,55.19,53.19,1,-54899,45279,100178,-9620,0,0,10916,0,0,,10916,10916
7,02/16/2018,25,6:00,6:15,,,1,35.38,33.38,0,-54711,91989,146700,37278,0,0,1070,0,0,,1070,1070
7,02/16/2018,26,6:15,6:30,,35.02,1,36.02,34.02,-1,-60833,73353,134186,12520,0,-177,0,0,0,,177,-177
7,02/16/2018,27,6:30,6:45,,,1,35.41,33.41,0,-47126,45898,93024,-1228,0,0,0,0,0,,0,0
7,02/16/2018,28,6:45,7:00,44.85,,1,45.85,43.85,1,-83658,72941,156599,-10717,0,0,3165,0,0,,3165,3165
7,02/16/2018,29,7:00,7:15,44.85,-28.76,1,-27.76,-29.76,-1,-37817,140875,178692,103058,0,-22769,162,0,0,,22931,-22607
7,02/16/2018,30,7:15,7:30,,30.78,1,31.78,29.78,-1,-61276,69083,130359,7807,0,-10314,0,0,0,,10314,-10314
7,02/16/2018,31,7:30,7:45,33.97,35.42,1,35.7,33.7,2,-81748,67665,149413,-14083,0,-277,23,0,0,,300,-254
7,02/16/2018,32,7:45,8:00,85.01,,1,86.01,84.01,1,-120882,56825,177707,-64057,0,0,10683,0,0,,10683,10683
7,02/16/2018,33,8:00,8:15,35.96,31.52,1,36.96,30.52,2,-10696,80391,91087,69695,0,-987,5246,0,0,,6233,4259
7,02/16/2018,34,8:15,8:30,,35.49,1,36.49,34.49,-1,-25481,61753,87234,36272,0,-7,0,0,0,,7,-7
7,02/16/2018,35,8:30,8:45,,35.48,1,36.48,34.48,-1,-51680,48298,99978,-3382,0,-190,0,0,0,,190,-190
7,02/16/2018,36,8:45,9:00,,,1,35.92,33.92,0,-77388,48259,125647,-29129,0,0,0,0,0,,0,0
7,02/16/2018,37,9:00,9:15,,35.49,1,36.49,34.49,-1,-52810,64068,116878,11258,0,-397,0,0,0,,397,-397
7,02/16/2018,38,9:15,9:30,,32.57,1,33.57,31.57,-1,-58530,72068,130598,13538,0,-1499,0,0,0,,1499,-1499
7,02/16/2018,39,9:30,9:45,,30.36,1,31.36,29.36,-1,-49608,65514,115122,15906,0,-4348,0,0,0,,4348,-4348
7,02/16/2018,40,9:45,10:00,,29.52,1,30.52,28.52,-1,-37450,83950,121400,46500,0,-11838,0,0,0,,11838,-11838
7,02/16/2018,41,10:00,10:15,,16.26,1,17.26,15.26,-1,-43110,76816,119926,33706,0,-18960,0,0,0,,18960,-18960
7,02/16/2018,42,10:15,10:30,,12.39,1,13.39,11.39,-1,-41157,64863,106020,23706,0,-35651,0,0,0,,35651,-35651
7,02/16/2018,43,10:30,10:45,,-0.1,1,0.9,-1.1,-1,-30721,80138,110859,49417,0,-18400,0,0,0,,18400,-18400
7,02/16/2018,44,10:45,11:00,,12.39,1,13.39,11.39,-1,-25223,92259,117482,67036,0,-36451,0,0,0,,36451,-36451
7,02/16/2018,45,11:00,11:15,34.56,31.78,1,35.56,33.56,1,-119122,81131,200253,-37991,0,-16087,240,0,0,,16327,-15847
7,02/16/2018,46,11:15,11:30,,,1,35.83,33.83,0,-87233,63523,150756,-23710,0,0,1,0,0,,1,1
7,02/16/2018,47,11:30,11:45,,,1,35.83,33.83,0,-85051,39089,124140,-45962,0,0,0,0,0,,0,0
7,02/16/2018,48,11:45,12:00,,35.23,1,36.23,34.23,-1,-65870,58506,124376,-7364,0,-211,0,0,0,,211,-211
7,02/16/2018,49,12:00,12:15,,35.23,1,36.23,34.23,-1,-79859,59268,139127,-20591,0,-419,0,0,0,,419,-419
7,02/16/2018,50,12:15,12:30,,25.64,1,26.64,24.64,-1,-57864,64157,122021,6293,0,-3234,0,0,0,,3234,-3234
7,02/16/2018,51,12:30,12:45,,25.71,1,26.71,24.71,-1,-75355,77529,152884,2174,0,-9020,0,0,0,,9020,-9020
7,02/16/2018,52,12:45,13:00,,32.6,1,33.6,31.6,-1,-70260,47372,117632,-22888,0,-1639,0,0,0,,1639,-1639
7,02/16/2018,53,13:00,13:15,,1.58,1,2.58,0.58,-1,-47422,103679,151101,56257,0,-14446,0,0,0,,14446,-14446
7,02/16/2018,54,13:15,13:30,,1.58,1,2.58,0.58,-1,-64687,83882,148569,19195,0,-37211,0,0,0,,37211,-37211
7,02/16/2018,55,13:30,13:45,,29.52,1,30.52,28.52,-1,-67315,89380,156695,22065,0,-18739,0,0,0,,18739,-18739
7,02/16/2018,56,13:45,14:00,,26.07,1,27.07,25.07,-1,-76336,82608,158944,6272,0,-15493,0,0,0,,15493,-15493
7,02/16/2018,57,14:00,14:15,,35.44,1,36.44,34.44,-1,-47305,96801,144106,49496,0,-2077,0,0,0,,2077,-2077
7,02/16/2018,58,14:15,14:30,,25.68,1,26.68,24.68,-1,-58114,92628,150742,34514,0,-3349,0,0,0,,3349,-3349
7,02/16/2018,59,14:30,14:45,,15.21,1,16.21,14.21,-1,-67943,80441,148384,12498,0,-14491,0,0,0,,14491,-14491
7,02/16/2018,60,14:45,15:00,,32.38,1,33.38,31.38,-1,-74906,88128,163034,13222,0,-2071,0,0,0,,2071,-2071
7,02/16/2018,61,15:00,15:15,,32.78,1,33.78,31.78,-1,-70685,104612,175297,33927,0,-3031,0,0,0,,3031,-3031
7,02/16/2018,62,15:15,15:30,,31.02,1,32.02,30.02,-1,-74353,109276,183629,34923,0,-8561,0,0,0,,8561,-8561
7,02/16/2018,63,15:30,15:45,35.07,35.39,1,36.07,33.79,2,-87818,76370,164188,-11448,0,-2174,251,0,0,,2425,-1923
7,02/16/2018,64,15:45,16:00,,,1,35.81,33.81,0,-96419,48193,144612,-48226,0,0,0,0,0,,0,0
7,02/16/2018,65,16:00,16:15,,32.84,1,33.84,31.84,-1,-64866,75981,140847,11115,0,-749,0,0,0,,749,-749
7,02/16/2018,66,16:15,16:30,,35.42,1,36.42,34.42,-1,-63839,46468,110307,-17371,0,-89,0,0,0,,89,-89
7,02/16/2018,67,16:30,16:45,,,1,35.83,33.83,0,-89966,41970,131936,-47996,0,0,0,0,0,,0,0
7,02/16/2018,68,16:45,17:00,,,1,35.86,33.86,0,-122501,44006,166507,-78495,0,0,0,0,0,,0,0
7,02/16/2018,69,17:00,17:15,,13.51,1,14.51,12.51,-1,-68214,96972,165186,28758,0,-11166,0,0,0,,11166,-11166
7,02/16/2018,70,17:15,17:30,,35.14,1,36.14,34.14,-1,-67402,67495,134897,93,0,-1994,0,0,0,,1994,-1994
7,02/16/2018,71,17:30,17:45,,35.36,1,36.36,34.36,-1,-74908,70911,145819,-3997,0,-222,0,0,0,,222,-222
7,02/16/2018,72,17:45,18:00,,,1,35.87,33.87,0,-103038,75013,178051,-28025,0,0,0,0,0,,0,0
7,02/16/2018,73,18:00,18:15,,22.91,1,23.91,21.91,-1,-51697,91233,142930,39536,0,-8656,0,0,0,,8656,-8656
7,02/16/2018,74,18:15,18:30,,32.78,1,33.78,31.78,-1,-58178,72646,130824,14468,0,-4843,0,0,0,,4843,-4843
7,02/16/2018,75,18:30,18:45,,,1,35.91,33.91,0,-60180,76113,136293,15933,0,0,0,0,0,,0,0
7,02/16/2018,76,18:45,19:00,,,1,35.54,33.54,0,-61117,82472,143589,21355,0,0,0,0,0,,0,0
7,02/16/2018,77,19:00,19:15,39.94,,1,40.94,38.94,1,-81315,72040,153355,-9275,0,0,925,0,0,,925,925
7,02/16/2018,78,19:15,19:30,,32.78,1,33.78,31.78,-1,-63849,75943,139792,12094,0,-2770,0,0,0,,2770,-2770
7,02/16/2018,79,19:30,19:45,,31.78,1,32.78,30.78,-1,-55004,73380,128384,18376,0,-6325,0,0,0,,6325,-6325
7,02/16/2018,80,19:45,20:00,,30.52,1,31.52,29.52,-1,-45851,69698,115549,23847,0,-14585,0,0,0,,14585,-14585
7,02/16/2018,81,20:00,20:15,35.56,34.63,1,36.56,33.63,2,-122740,30699,153439,-92041,0,-5183,518,0,0,,5701,-4665
7,02/16/2018,82,20:15,20:30,34.12,,1,35.12,33.12,1,-93505,28874,122379,-64631,0,0,194,0,0,,194,194
7,02/16/2018,83,20:30,20:45,,,1,35.72,33.72,0,-66297,33098,99395,-33199,0,0,0,0,0,,0,0
7,02/16/2018,84,20:45,21:00,,32.78,1,33.78,31.78,-1,-49026,64208,113234,15182,0,-312,0,0,0,,312,-312
7,02/16/2018,85,21:00,21:15,,29.78,1,30.78,28.78,-1,-103923,34265,138188,-69658,0,-1030,0,0,0,,1030,-1030
7,02/16/2018,86,21:15,21:30,,,1,34.76,32.76,0,-71421,37420,108841,-34001,0,0,0,0,0,,0,0
7,02/16/2018,87,21:30,21:45,,35.05,1,36.05,34.05,-1,-54321,53687,108008,-634,0,-365,0,0,0,,365,-365
7,02/16/2018,88,21:45,22:00,,30.65,1,31.65,29.65,-1,-45439,74009,119448,28570,0,-5834,0,0,0,,5834,-5834
7,02/16/2018,89,22:00,22:15,40.15,14.78,1,41.15,39.15,1,-102517,39910,142427,-62607,0,-7621,322,0,0,,7943,-7299
7,02/16/2018,90,22:15,22:30,47.39,14.78,1,48.39,46.39,1,-113687,40935,154622,-72752,0,-80,3729,0,0,,3809,3649
7,02/16/2018,91,22:30,22:45,,,1,35.6,33.6,0,-60517,54934,115451,-5583,0,0,140,0,0,,140,140
7,02/16/2018,92,22:45,23:00,,30.91,1,31.91,29.91,-1,-46752,64760,111512,18008,0,-369,0,0,0,,369,-369
7,02/16/2018,93,23:00,23:15,,24.73,1,25.73,23.73,-1,-57763,49364,107127,-8399,0,-1628,0,0,0,,1628,-1628
7,02/16/2018,94,23:15,23:30,,,1,34.61,32.61,0,-57780,33684,91464,-24096,0,0,0,0,0,,0,0
7,02/16/2018,95,23:30,23:45,,,1,34.61,32.61,0,-64464,28295,92759,-36169,0,0,0,0,0,,0,0
7,02/16/2018,96,23:45,0:00,,33.88,1,34.88,32.88,-1,-110526,37659,148185,-72867,0,-20,0,0,0,,20,-20
8,02/17/2018,1,0:00,0:15,,31.52,1,32.52,30.52,-1,-55171,125428,180599,70257,0,-98,0,0,0,,98,-98
8,02/17/2018,2,0:15,0:30,,,1,34.81,32.81,0,-33985,57384,91369,23399,0,0,0,0,0,,0,0
8,02/17/2018,3,0:30,0:45,,,1,34.81,32.81,0,-27787,48931,76718,21144,0,0,0,0,0,,0,0
8,02/17/2018,4,0:45,1:00,,24.22,1,25.22,23.22,-1,-42896,69807,112703,26911,0,-13701,0,0,0,,13701,-13701
8,02/17/2018,5,1:00,1:15,34.52,25.45,1,35.52,33.52,1,-52764,45238,98002,-7526,0,-13571,265,0,0,,13836,-13306
8,02/17/2018,6,1:15,1:30,,,1,34.8,32.8,0,-67966,51552,119518,-16414,0,-48,91,0,0,,139,43
8,02/17/2018,7,1:30,1:45,,,1,34.79,32.79,0,-53767,55449,109216,1682,0,0,0,0,0,,0,0
8,02/17/2018,8,1:45,2:00,,32.52,1,33.52,31.52,-1,-44753,72832,117585,28079,0,-2594,0,0,0,,2594,-2594
8,02/17/2018,9,2:00,2:15,145.21,34.49,1,146.21,144.21,1,-64425,16743,81168,-47682,0,-880,12613,0,0,,13493,11733
8,02/17/2018,10,2:15,2:30,206.21,,1,207.21,205.21,1,-67609,34551,102160,-33058,0,0,40323,0,0,,40323,40323
8,02/17/2018,11,2:30,2:45,206.21,32.99,1,33.99,31.99,-1,-29847,44578,74425,14731,0,-478,5717,0,0,,6195,5239
8,02/17/2018,12,2:45,3:00,,24.79,1,25.79,23.79,-1,-30778,83267,114045,52489,0,-3199,0,0,0,,3199,-3199
8,02/17/2018,13,3:00,3:15,,22.69,1,23.69,21.69,-1,-46726,45865,92591,-861,0,-5497,0,0,0,,5497,-5497
8,02/17/2018,14,3:15,3:30,,,1,34.64,32.64,0,-23628,52469,76097,28841,0,0,0,0,0,,0,0
8,02/17/2018,15,3:30,3:45,,,1,34.64,32.64,0,-26380,85889,112269,59509,0,0,0,0,0,,0,0
8,02/17/2018,16,3:45,4:00,,,1,34.64,32.64,0,-21178,100390,121568,79212,0,0,0,0,0,,0,0
8,02/17/2018,17,4:00,4:15,,,1,34.6,32.6,0,-22567,100404,122971,77837,0,0,0,0,0,,0,0
8,02/17/2018,18,4:15,4:30,,,1,34.6,32.6,0,-28100,96901,125001,68801,0,0,0,0,0,,0,0
8,02/17/2018,19,4:30,4:45,,,1,34.6,32.6,0,-28311,94681,122992,66370,0,0,0,0,0,,0,0
8,02/17/2018,20,4:45,5:00,,,1,34.6,32.6,0,-29494,98739,128233,69245,0,0,0,0,0,,0,0
8,02/17/2018,21,5:00,5:15,,,1,34.65,32.65,0,-15988,106440,122428,90452,0,0,0,0,0,,0,0
8,02/17/2018,22,5:15,5:30,,,1,34.65,32.65,0,-18831,89144,107975,70313,0,0,0,0,0,,0,0
8,02/17/2018,23,5:30,5:45,,,1,34.65,32.65,0,-26140,77765,103905,51625,0,0,0,0,0,,0,0
8,02/17/2018,24,5:45,6:00,,,1,34.64,32.64,0,-34437,76026,110463,41589,0,0,0,0,0,,0,0
8,02/17/2018,25,6:00,6:15,,31.66,1,32.66,30.66,-1,-18694,99188,117882,80494,0,-1038,0,0,0,,1038,-1038
8,02/17/2018,26,6:15,6:30,,35.25,1,36.25,34.25,-1,-23650,70262,93912,46612,0,-250,0,0,0,,250,-250
8,02/17/2018,27,6:30,6:45,,35.2,1,36.2,34.2,-1,-25210,38215,63425,13005,0,-741,0,0,0,,741,-741
8,02/17/2018,28,6:45,7:00,32.87,,1,33.87,31.87,1,-31682,40828,72510,9146,0,0,603,0,0,,603,603
8,02/17/2018,29,7:00,7:15,37.66,,1,38.66,36.66,1,-110439,83449,193888,-26990,0,0,1102,0,0,,1102,1102
8,02/17/2018,30,7:15,7:30,51.1,,1,52.1,50.1,1,-120443,53915,174358,-66528,0,0,25786,0,0,,25786,25786
8,02/17/2018,31,7:30,7:45,168.21,,1,169.21,167.21,1,-118256,58361,176617,-59895,0,0,53047,0,0,,53047,53047
8,02/17/2018,32,7:45,8:00,238.01,32.15,1,33.15,31.15,-1,-131157,120957,252114,-10200,0,-36,24228,13750,0,,38014,37942
8,02/17/2018,33,8:00,8:15,238.01,28.89,1,29.89,27.89,-1,-100438,155589,256027,55151,0,-8207,822,0,0,,9029,-7385
8,02/17/2018,34,8:15,8:30,,,1,35.11,33.11,0,-45659,82952,128611,37293,0,-1239,0,0,0,,1239,-1239
8,02/17/2018,35,8:30,8:45,,,1,35.13,33.13,0,-41247,47361,88608,6114,0,0,0,0,0,,0,0
8,02/17/2018,36,8:45,9:00,68.02,,1,69.02,67.02,1,-85486,32580,118066,-52906,0,0,8585,0,0,,8585,8585
8,02/17/2018,37,9:00,9:15,36.32,,1,37.32,35.32,1,-11044,91699,102743,80655,0,0,4334,0,0,,4334,4334
8,02/17/2018,38,9:15,9:30,,,1,35.62,33.62,0,-32103,58875,90978,26772,0,0,10,0,0,,10,10
8,02/17/2018,39,9:30,9:45,35.18,,1,36.18,34.18,1,-58377,49942,108319,-8435,0,0,282,0,0,,282,282
8,02/17/2018,40,9:45,10:00,37.03,,1,38.03,36.03,1,-74145,52616,126761,-21529,0,0,1968,0,0,,1968,1968
8,02/17/2018,41,10:00,10:15,39.83,,1,40.83,38.83,1,-90979,44170,135149,-46809,0,0,1898,0,0,,1898,1898
8,02/17/2018,42,10:15,10:30,33.66,,1,34.66,32.66,1,-86448,44151,130599,-42297,0,0,342,0,0,,342,342
8,02/17/2018,43,10:30,10:45,36.42,,1,37.42,35.42,1,-83955,43217,127172,-40738,0,0,660,0,0,,660,660
8,02/17/2018,44,10:45,11:00,41.52,,1,42.52,40.52,1,-73809,43670,117479,-30139,0,0,2561,0,0,,2561,2561
8,02/17/2018,45,11:00,11:15,237.02,,1,238.02,236.02,1,-169363,15845,185208,-153518,0,0,49769,0,0,,49769,49769
8,02/17/2018,46,11:15,11:30,347.4,,1,348.4,346.4,1,-117588,16433,134021,-101155,0,0,80804,17500,0,,98304,98304
8,02/17/2018,47,11:30,11:45,42.4,,1,43.4,41.4,1,-67847,35352,103199,-32495,0,0,30133,0,0,,30133,30133
8,02/17/2018,48,11:45,12:00,64.42,,1,65.42,63.42,1,-79010,30133,109143,-48877,0,0,25546,0,0,,25546,25546
8,02/17/2018,49,12:00,12:15,237.02,,1,238.02,236.02,1,-125820,21981,147801,-103839,0,0,64047,0,0,,64047,64047
8,02/17/2018,50,12:15,12:30,99.59,,1,100.59,98.59,1,-87684,39891,127575,-47793,0,0,50141,0,0,,50141,50141
8,02/17/2018,51,12:30,12:45,35.85,31.69,1,36.85,30.69,2,-55128,49578,104706,-5550,0,-5,1594,0,0,,1599,1589
8,02/17/2018,52,12:45,13:00,33.66,,1,34.66,32.66,1,-42633,52017,94650,9384,0,0,492,0,0,,492,492
8,02/17/2018,53,13:00,13:15,,35.45,1,36.45,34.45,-1,-57203,76929,134132,19726,0,-586,0,0,0,,586,-586
8,02/17/2018,54,13:15,13:30,,,1,34.8,32.8,0,-66539,64444,130983,-2095,0,0,0,0,0,,0,0
8,02/17/2018,55,13:30,13:45,,,1,34.8,32.8,0,-51687,61617,113304,9930,0,0,0,0,0,,0,0
8,02/17/2018,56,13:45,14:00,,31.66,1,32.66,30.66,-1,-49161,67271,116432,18110,0,-856,0,0,0,,856,-856
8,02/17/2018,57,14:00,14:15,,31.66,1,32.66,30.66,-1,-38336,91515,129851,53179,0,-1254,0,0,0,,1254,-1254
8,02/17/2018,58,14:15,14:30,,27.84,1,28.84,26.84,-1,-31112,126131,157243,95019,0,-1068,0,0,0,,1068,-1068
8,02/17/2018,59,14:30,14:45,,35.37,1,36.37,34.37,-1,-29127,127616,156743,98489,0,-1128,0,0,0,,1128,-1128
8,02/17/2018,60,14:45,15:00,,12.03,1,13.03,11.03,-1,-26574,117838,144412,91264,0,-4902,0,0,0,,4902,-4902
8,02/17/2018,61,15:00,15:15,,3.88,1,4.88,2.88,-1,-52223,96076,148299,43853,0,-18241,0,0,0,,18241,-18241
8,02/17/2018,62,15:15,15:30,,,1,34.64,32.64,0,-66746,83335,150081,16589,0,-350,0,0,0,,350,-350
8,02/17/2018,63,15:30,15:45,,,1,34.64,32.64,0,-61748,77796,139544,16048,0,0,0,0,0,,0,0
8,02/17/2018,64,15:45,16:00,32.03,,1,33.03,31.03,1,-70644,68955,139599,-1689,0,0,186,0,0,,186,186
8,02/17/2018,65,16:00,16:15,,30.66,1,31.66,29.66,-1,-56912,107570,164482,50658,0,-1818,0,0,0,,1818,-1818
8,02/17/2018,66,16:15,16:30,,35.44,1,36.44,34.44,-1,-45405,71244,116649,25839,0,-1507,0,0,0,,1507,-1507
8,02/17/2018,67,16:30,16:45,,,1,34.76,32.76,0,-53147,37108,90255,-16039,0,-282,0,0,0,,282,-282
8,02/17/2018,68,16:45,17:00,,,1,34.76,32.76,0,-74454,25390,99844,-49064,0,0,0,0,0,,0,0
8,02/17/2018,69,17:00,17:15,,18,1,19,17,-1,-58458,119037,177495,60579,0,-10265,0,0,0,,10265,-10265
8,02/17/2018,70,17:15,17:30,,33.45,1,34.45,32.45,-1,-50997,59900,110897,8903,0,-4644,0,0,0,,4644,-4644
8,02/17/2018,71,17:30,17:45,,30.66,1,31.66,29.66,-1,-49553,67683,117236,18130,0,-958,0,0,0,,958,-958
8,02/17/2018,72,17:45,18:00,53.18,,1,54.18,52.18,1,-69799,62983,132782,-6816,0,0,5527,0,0,,5527,5527
8,02/17/2018,73,18:00,18:15,53.18,-25.31,1,-24.31,-26.31,-1,-20709,121259,141968,100550,0,-15057,301,0,0,,15358,-14756
8,02/17/2018,74,18:15,18:30,,33.56,1,34.56,32.56,-1,-49365,77388,126753,28023,0,-1424,0,0,0,,1424,-1424
8,02/17/2018,75,18:30,18:45,,30.66,1,31.66,29.66,-1,-50290,82228,132518,31938,0,-2138,0,0,0,,2138,-2138
8,02/17/2018,76,18:45,19:00,,27.03,1,28.03,26.03,-1,-50781,93843,144624,43062,0,-7690,0,0,0,,7690,-7690
8,02/17/2018,77,19:00,19:15,33.66,27.03,1,34.66,32.66,1,-56281,62526,118807,6245,0,-33,33,0,0,,66,0
8,02/17/2018,78,19:15,19:30,,,1,35.62,33.62,0,-39761,73703,113464,33942,0,0,0,0,0,,0,0
8,02/17/2018,79,19:30,19:45,,18.26,1,19.26,17.26,-1,-35351,94091,129442,58740,0,-2139,0,0,0,,2139,-2139
8,02/17/2018,80,19:45,20:00,,19.89,1,20.89,18.89,-1,-48260,70993,119253,22733,0,-9145,0,0,0,,9145,-9145
8,02/17/2018,81,20:00,20:15,36.99,19.89,1,37.99,35.99,1,-107919,17969,125888,-89950,0,-1948,269,0,0,,2217,-1679
8,02/17/2018,82,20:15,20:30,,,1,34.91,32.91,0,-83146,20017,103163,-63129,0,0,0,0,0,,0,0
8,02/17/2018,83,20:30,20:45,,,1,34.91,32.91,0,-57953,33338,91291,-24615,0,0,0,0,0,,0,0
8,02/17/2018,84,20:45,21:00,,27.03,1,28.03,26.03,-1,-45108,70032,115140,24924,0,-5738,0,0,0,,5738,-5738
8,02/17/2018,85,21:00,21:15,,32.55,1,33.55,31.55,-1,-77878,45065,122943,-32813,0,-2247,0,0,0,,2247,-2247
8,02/17/2018,86,21:15,21:30,,,1,33.99,31.99,0,-44496,54644,99140,10148,0,0,0,0,0,,0,0
8,02/17/2018,87,21:30,21:45,,35.38,1,36.38,34.38,-1,-40085,81571,121656,41486,0,-283,0,0,0,,283,-283
8,02/17/2018,88,21:45,22:00,,4.99,1,5.99,3.99,-1,-39251,103922,143173,64671,0,-12226,0,0,0,,12226,-12226
8,02/17/2018,89,22:00,22:15,40.71,30.66,1,41.71,29.66,2,-92727,24041,116768,-68686,0,-9527,1101,0,0,,10628,-8426
8,02/17/2018,90,22:15,22:30,33.66,30.66,1,34.66,32.66,1,-36764,27169,63933,-9595,0,-2,941,0,0,,943,939
8,02/17/2018,91,22:30,22:45,,,1,35.51,33.51,0,-26859,55523,82382,28664,0,0,0,0,0,,0,0
8,02/17/2018,92,22:45,23:00,,35.42,1,36.42,34.42,-1,-22194,88391,110585,66197,0,-9,0,0,0,,9,-9
8,02/17/2018,93,23:00,23:15,55.34,35.28,1,56.34,33.47,2,-76789,20145,96934,-56644,0,-74,4542,0,0,,4616,4468
8,02/17/2018,94,23:15,23:30,33.66,,1,34.66,32.66,1,-51444,30498,81942,-20946,0,0,1841,0,0,,1841,1841
8,02/17/2018,95,23:30,23:45,,,1,35.47,33.47,0,-40310,42715,83025,2405,0,0,0,0,0,,0,0
8,02/17/2018,96,23:45,0:00,,29.99,1,30.99,28.99,-1,-73005,63305,136310,-9700,0,-971,0,0,0,,971,-971
8,02/18/2018,1,0:00,0:15,,18.38,1,19.38,17.38,-1,-19530,167463,186993,147933,0,-1722,0,0,0,,1722,-1722
8,02/18/2018,2,0:15,0:30,,23.68,1,24.68,22.68,-1,-10903,114049,124952,103146,0,-1146,0,0,0,,1146,-1146
8,02/18/2018,3,0:30,0:45,,-10.78,1,-9.78,-11.78,-1,-27625,63433,91058,35808,0,-22719,0,0,0,,22719,-22719
8,02/18/2018,4,0:45,1:00,,18.42,1,19.42,17.42,-1,-25247,82637,107884,57390,0,-28927,0,0,0,,28927,-28927
8,02/18/2018,5,1:00,1:15,32.36,-39.83,1,34.62,-40.83,2,-16384,91388,107772,75004,0,-26193,11,0,0,,26204,-26182
8,02/18/2018,6,1:15,1:30,37.32,29.78,1,38.32,28.78,2,-33839,60072,93911,26233,0,-710,751,0,0,,1461,41
8,02/18/2018,7,1:30,1:45,,25.11,1,26.11,24.11,-1,-13375,80253,93628,66878,0,-4084,0,0,0,,4084,-4084
8,02/18/2018,8,1:45,2:00,,13.01,1,14.01,12.01,-1,-17034,76662,93696,59628,0,-27540,0,0,0,,27540,-27540
8,02/18/2018,9,2:00,2:15,,9.78,1,10.78,8.78,-1,-26834,82549,109383,55715,0,-32936,0,0,0,,32936,-32936
8,02/18/2018,10,2:15,2:30,,,1,34.57,32.57,0,-36666,74273,110939,37607,0,-1018,0,0,0,,1018,-1018
8,02/18/2018,11,2:30,2:45,,-2.99,1,-1.99,-3.99,-1,-32444,79851,112295,47407,0,-20855,0,0,0,,20855,-20855
8,02/18/2018,12,2:45,3:00,,24.72,1,25.72,23.72,-1,-28658,78022,106680,49364,0,-26382,0,0,0,,26382,-26382
8,02/18/2018,13,3:00,3:15,,31.32,1,32.32,30.32,-1,-39568,71538,111106,31970,0,-10076,0,0,0,,10076,-10076
8,02/18/2018,14,3:15,3:30,,,1,34.51,32.51,0,-35754,67320,103074,31566,0,0,0,0,0,,0,0
8,02/18/2018,15,3:30,3:45,,,1,34.51,32.51,0,-31805,61704,93509,29899,0,0,0,0,0,,0,0
8,02/18/2018,16,3:45,4:00,,,1,34.51,32.51,0,-31897,61463,93360,29566,0,0,0,0,0,,0,0
8,02/18/2018,17,4:00,4:15,,,1,34.51,32.51,0,-34035,77281,111316,43246,0,0,0,0,0,,0,0
8,02/18/2018,18,4:15,4:30,,,1,34.51,32.51,0,-36810,79209,116019,42399,0,0,0,0,0,,0,0
8,02/18/2018,19,4:30,4:45,,,1,34.51,32.51,0,-38521,71609,110130,33088,0,0,0,0,0,,0,0
8,02/18/2018,20,4:45,5:00,,,1,34.53,32.53,0,-39500,74029,113529,34529,0,0,0,0,0,,0,0
8,02/18/2018,21,5:00,5:15,,,1,34.42,32.42,0,-27874,72800,100674,44926,0,0,0,0,0,,0,0
8,02/18/2018,22,5:15,5:30,,,1,34.42,32.42,0,-27322,75939,103261,48617,0,0,0,0,0,,0,0
8,02/18/2018,23,5:30,5:45,,,1,34.41,32.41,0,-33556,88807,122363,55251,0,0,0,0,0,,0,0
8,02/18/2018,24,5:45,6:00,,,1,34.41,32.41,0,-30146,87039,117185,56893,0,0,0,0,0,,0,0
8,02/18/2018,25,6:00,6:15,,31.3,1,32.3,30.3,-1,-24403,97588,121991,73185,0,-383,0,0,0,,383,-383
8,02/18/2018,26,6:15,6:30,,34.88,1,35.88,33.88,-1,-19115,107388,126503,88273,0,-894,0,0,0,,894,-894
8,02/18/2018,27,6:30,6:45,,35.13,1,36.13,34.13,-1,-22765,82071,104836,59306,0,-849,0,0,0,,849,-849
8,02/18/2018,28,6:45,7:00,,32.16,1,33.16,31.16,-1,-27072,82034,109106,54962,0,-1513,0,0,0,,1513,-1513
8,02/18/2018,29,7:00,7:15,,31.3,1,32.3,30.3,-1,-26660,105585,132245,78925,0,-1928,0,0,0,,1928,-1928
8,02/18/2018,30,7:15,7:30,,,1,34.77,32.77,0,-31977,83003,114980,51026,0,0,0,0,0,,0,0
8,02/18/2018,31,7:30,7:45,,,1,34.74,32.74,0,-28456,94453,122909,65997,0,0,0,0,0,,0,0
8,02/18/2018,32,7:45,8:00,,30.03,1,31.03,29.03,-1,-25646,88324,113970,62678,0,-1692,0,0,0,,1692,-1692
8,02/18/2018,33,8:00,8:15,,,1,33.94,31.94,0,-47989,124147,172136,76158,0,-301,0,0,0,,301,-301
8,02/18/2018,34,8:15,8:30,,,1,33.91,31.91,0,-19063,96869,115932,77806,0,0,0,0,0,,0,0
8,02/18/2018,35,8:30,8:45,,33.56,1,34.56,32.56,-1,-26058,78710,104768,52652,0,-110,0,0,0,,110,-110
8,02/18/2018,36,8:45,9:00,,33.47,1,34.47,32.47,-1,-35980,71407,107387,35427,0,-461,0,0,0,,461,-461
8,02/18/2018,37,9:00,9:15,,31.92,1,32.92,30.92,-1,-25962,83858,109820,57896,0,-1332,0,0,0,,1332,-1332
8,02/18/2018,38,9:15,9:30,,33.59,1,34.59,32.59,-1,-21834,93742,115576,71908,0,-228,0,0,0,,228,-228
8,02/18/2018,39,9:30,9:45,,,1,33.94,31.94,0,-24079,100298,124377,76219,0,0,0,0,0,,0,0
8,02/18/2018,40,9:45,10:00,,,1,35.01,33.01,0,-25023,107382,132405,82359,0,0,0,0,0,,0,0
8,02/18/2018,41,10:00,10:15,,35.57,1,36.57,34.57,-1,-14920,131531,146451,116611,0,-538,0,0,0,,538,-538
8,02/18/2018,42,10:15,10:30,,30.49,1,31.49,29.49,-1,-15027,153204,168231,138177,0,-1731,0,0,0,,1731,-1731
8,02/18/2018,43,10:30,10:45,,35.03,1,36.03,34.03,-1,-12880,168053,180933,155173,0,-115,0,0,0,,115,-115
8,02/18/2018,44,10:45,11:00,,23.44,1,24.44,22.44,-1,-14019,201046,215065,187027,0,-16163,0,0,0,,16163,-16163
8,02/18/2018,45,11:00,11:15,,30.3,1,31.3,29.3,-1,-17979,146973,164952,128994,0,-17783,0,0,0,,17783,-17783
8,02/18/2018,46,11:15,11:30,,24.8,1,25.8,23.8,-1,-15564,135736,151300,120172,0,-29742,0,0,0,,29742,-29742
8,02/18/2018,47,11:30,11:45,,23.8,1,24.8,22.8,-1,-11845,140499,152344,128654,0,-24625,0,0,0,,24625,-24625
8,02/18/2018,48,11:45,12:00,,-90.35,1,-89.35,-91.35,-1,-19057,114980,134037,95923,0,-53766,0,0,0,,53766,-53766
8,02/18/2018,49,12:00,12:15,,30.3,1,31.3,29.3,-1,-55743,119310,175053,63567,0,-9904,0,0,0,,9904,-9904
8,02/18/2018,50,12:15,12:30,,-55.68,1,-54.68,-56.68,-1,-61446,118028,179474,56582,0,-36190,0,0,0,,36190,-36190
8,02/18/2018,51,12:30,12:45,,30.78,1,31.78,29.78,-1,-66110,105389,171499,39279,0,-15937,0,0,0,,15937,-15937
8,02/18/2018,52,12:45,13:00,,-4.41,1,-3.41,-5.41,-1,-60731,108633,169364,47902,0,-29936,0,0,0,,29936,-29936
8,02/18/2018,53,13:00,13:15,,30.3,1,31.3,29.3,-1,-65781,106749,172530,40968,0,-12702,0,0,0,,12702,-12702
8,02/18/2018,54,13:15,13:30,,10.05,1,11.05,9.05,-1,-70571,133054,203625,62483,0,-3220,0,0,0,,3220,-3220
8,02/18/2018,55,13:30,13:45,,-87.88,1,-86.88,-88.88,-1,-81274,137150,218424,55876,0,-40581,0,0,0,,40581,-40581
8,02/18/2018,56,13:45,14:00,,31.25,1,32.25,30.25,-1,-83460,114812,198272,31352,0,-15211,0,0,0,,15211,-15211
8,02/18/2018,57,14:00,14:15,,30.3,1,31.3,29.3,-1,-66086,122972,189058,56886,0,-4564,0,0,0,,4564,-4564
8,02/18/2018,58,14:15,14:30,,31.12,1,32.12,30.12,-1,-66981,105076,172057,38095,0,-200,0,0,0,,200,-200
8,02/18/2018,59,14:30,14:45,,27.81,1,28.81,26.81,-1,-68906,102627,171533,33721,0,-14090,0,0,0,,14090,-14090
8,02/18/2018,60,14:45,15:00,,31.42,1,32.42,30.42,-1,-71172,110066,181238,38894,0,-16059,0,0,0,,16059,-16059
8,02/18/2018,61,15:00,15:15,,31.78,1,32.78,30.78,-1,-69172,103626,172798,34454,0,-8241,0,0,0,,8241,-8241
8,02/18/2018,62,15:15,15:30,34.92,31.78,1,35.92,33.92,1,-76686,88047,164733,11361,0,-8,776,0,0,,784,768
8,02/18/2018,63,15:30,15:45,34.92,,1,35.92,33.92,1,-78772,84981,163753,6209,0,0,287,0,0,,287,287
8,02/18/2018,64,15:45,16:00,37.82,,1,38.82,36.82,1,-81166,70801,151967,-10365,0,0,1430,0,0,,1430,1430
8,02/18/2018,65,16:00,16:15,,17.82,1,18.82,16.82,-1,-28639,115837,144476,87198,0,-7898,0,0,0,,7898,-7898
8,02/18/2018,66,16:15,16:30,,31.3,1,32.3,30.3,-1,-48522,88910,137432,40388,0,-5626,0,0,0,,5626,-5626
8,02/18/2018,67,16:30,16:45,34.74,31.3,1,35.74,30.3,2,-63197,66595,129792,3398,0,-1983,67,0,0,,2050,-1916
8,02/18/2018,68,16:45,17:00,54.61,31.3,1,55.61,53.61,1,-90950,43093,134043,-47857,0,-12,11883,0,0,,11895,11871
8,02/18/2018,69,17:00,17:15,38.12,31.78,1,39.12,30.78,2,-74295,69125,143420,-5170,0,-624,10443,0,0,,11067,9819
8,02/18/2018,70,17:15,17:30,38.12,34.57,1,35.57,33.57,-1,-53754,44305,98059,-9449,0,-242,182,0,0,,424,-60
8,02/18/2018,71,17:30,17:45,94.37,,1,95.37,93.37,1,-81602,34037,115639,-47565,0,0,4431,0,0,,4431,4431
8,02/18/2018,72,17:45,18:00,239.12,,1,240.12,238.12,1,-99560,65791,165351,-33769,0,0,31668,0,0,,31668,31668
8,02/18/2018,73,18:00,18:15,38.12,-138.27,1,-137.27,-139.27,-1,-67031,122901,189932,55870,0,-12583,11127,0,0,,23710,-1456
8,02/18/2018,74,18:15,18:30,,26.66,1,27.66,25.66,-1,-44726,59415,104141,14689,0,-11184,0,0,0,,11184,-11184
8,02/18/2018,75,18:30,18:45,,32.98,1,33.98,31.98,-1,-39750,73488,113238,33738,0,-842,0,0,0,,842,-842
8,02/18/2018,76,18:45,19:00,,32.97,1,33.97,31.97,-1,-45061,73337,118398,28276,0,-644,0,0,0,,644,-644
8,02/18/2018,77,19:00,19:15,,,1,34.72,32.72,0,-42104,65062,107166,22958,0,0,0,0,0,,0,0
8,02/18/2018,78,19:15,19:30,,32.78,1,33.78,31.78,-1,-23419,73059,96478,49640,0,-173,0,0,0,,173,-173
8,02/18/2018,79,19:30,19:45,,14.97,1,15.97,13.97,-1,-17527,87240,104767,69713,0,-6109,0,0,0,,6109,-6109
8,02/18/2018,80,19:45,20:00,,-6.78,1,-5.78,-7.78,-1,-39664,78174,117838,38510,0,-34636,0,0,0,,34636,-34636
8,02/18/2018,81,20:00,20:15,35.7,32.6,1,36.7,34.7,1,-61814,38056,99870,-23758,0,-9443,649,0,0,,10092,-8794
8,02/18/2018,82,20:15,20:30,35.7,22.2,1,23.2,21.2,-1,-34942,61865,96807,26923,0,-3156,43,0,0,,3199,-3113
8,02/18/2018,83,20:30,20:45,,9.53,1,10.53,8.53,-1,-23718,82156,105874,58438,0,-36771,0,0,0,,36771,-36771
8,02/18/2018,84,20:45,21:00,,-2.27,1,-1.27,-3.27,-1,-42769,121129,163898,78360,0,-50151,0,0,0,,50151,-50151
8,02/18/2018,85,21:00,21:15,,-58.98,1,-57.98,-59.98,-1,-45248,55036,100284,9788,0,-32443,0,0,0,,32443,-32443
8,02/18/2018,86,21:15,21:30,,,1,34.65,32.65,0,-20091,111236,131327,91145,0,0,0,0,0,,0,0
8,02/18/2018,87,21:30,21:45,,30.66,1,31.66,29.66,-1,-15072,136112,151184,121040,0,-1114,0,0,0,,1114,-1114
8,02/18/2018,88,21:45,22:00,,-48.74,1,-47.74,-49.74,-1,-17167,135284,152451,118117,0,-45141,0,0,0,,45141,-45141
8,02/18/2018,89,22:00,22:15,,20.23,1,21.23,19.23,-1,-47925,34404,82329,-13521,0,-20083,0,0,0,,20083,-20083
8,02/18/2018,90,22:15,22:30,,31.66,1,32.66,30.66,-1,-30597,64037,94634,33440,0,-913,0,0,0,,913,-913
8,02/18/2018,91,22:30,22:45,,31.78,1,32.78,30.78,-1,-24089,75598,99687,51509,0,-2013,0,0,0,,2013,-2013
8,02/18/2018,92,22:45,23:00,,31.87,1,32.87,30.87,-1,-16979,114740,131719,97761,0,-799,0,0,0,,799,-799
8,02/18/2018,93,23:00,23:15,,31.66,1,32.66,30.66,-1,-79874,43305,123179,-36569,0,-621,0,0,0,,621,-621
8,02/18/2018,94,23:15,23:30,,28.33,1,29.33,27.33,-1,-49077,51805,100882,2728,0,-2423,0,0,0,,2423,-2423
8,02/18/2018,95,23:30,23:45,,28.64,1,29.64,27.64,-1,-52974,80668,133642,27694,0,-9438,0,0,0,,9438,-9438
8,02/18/2018,96,23:45,0:00,,28.64,1,29.64,27.64,-1,-90254,90118,180372,-136,0,-15256,0,0,0,,15256,-15256
8,02/19/2018,1,0:00,0:15,,-156.9,1,-155.9,-157.9,-1,-41105,139279,180384,98174,0,-38479,0,0,0,,38479,-38479
8,02/19/2018,2,0:15,0:30,,-108.36,1,-107.36,-109.36,-1,-39558,145128,184686,105570,0,-52502,0,0,0,,52502,-52502
8,02/19/2018,3,0:30,0:45,,-106.43,1,-105.43,-107.43,-1,-49734,140985,190719,91251,0,-101448,0,0,0,,101448,-101448
8,02/19/2018,4,0:45,1:00,,12.07,1,13.07,11.07,-1,-78846,96816,175662,17970,0,-55501,0,0,0,,55501,-55501
8,02/19/2018,5,1:00,1:15,,8.07,1,9.07,7.07,-1,-44324,91536,135860,47212,0,-9095,0,0,0,,9095,-9095
8,02/19/2018,6,1:15,1:30,,9.35,1,10.35,8.35,-1,-45010,91272,136282,46262,0,-34089,0,0,0,,34089,-34089
8,02/19/2018,7,1:30,1:45,,23.54,1,24.54,22.54,-1,-31881,74734,106615,42853,0,-36490,0,0,0,,36490,-36490
8,02/19/2018,8,1:45,2:00,,24.5,1,25.5,23.5,-1,-37153,77576,114729,40423,0,-35289,0,0,0,,35289,-35289
8,02/19/2018,9,2:00,2:15,,6.5,1,7.5,5.5,-1,-56123,112759,168882,56636,0,-38057,0,0,0,,38057,-38057
8,02/19/2018,10,2:15,2:30,,5.03,1,6.03,4.03,-1,-64869,111040,175909,46171,0,-49298,0,0,0,,49298,-49298
8,02/19/2018,11,2:30,2:45,,30.3,1,31.3,29.3,-1,-65076,105923,170999,40847,0,-20587,0,0,0,,20587,-20587
8,02/19/2018,12,2:45,3:00,,26.3,1,27.3,25.3,-1,-64218,97291,161509,33073,0,-20229,0,0,0,,20229,-20229
8,02/19/2018,13,3:00,3:15,,26.46,1,27.46,25.46,-1,-41067,88004,129071,46937,0,-23867,0,0,0,,23867,-23867
8,02/19/2018,14,3:15,3:30,,,1,34.58,32.58,0,-42127,64997,107124,22870,0,-2187,0,0,0,,2187,-2187
8,02/19/2018,15,3:30,3:45,,33.99,1,34.99,32.99,-1,-45696,91662,137358,45966,0,-250,0,0,0,,250,-250
8,02/19/2018,16,3:45,4:00,,23.83,1,24.83,22.83,-1,-47539,99907,147446,52368,0,-9554,0,0,0,,9554,-9554
8,02/19/2018,17,4:00,4:15,,31.3,1,32.3,30.3,-1,-56681,36521,93202,-20160,0,-5616,0,0,0,,5616,-5616
8,02/19/2018,18,4:15,4:30,,,1,34.36,32.36,0,-53934,46924,100858,-7010,0,-38,0,0,0,,38,-38
8,02/19/2018,19,4:30,4:45,,29.49,1,30.49,28.49,-1,-45146,72381,117527,27235,0,-6532,0,0,0,,6532,-6532
8,02/19/2018,20,4:45,5:00,,31.3,1,32.3,30.3,-1,-41697,72421,114118,30724,0,-7070,0,0,0,,7070,-7070
8,02/19/2018,21,5:00,5:15,,-37.08,1,-36.08,-38.08,-1,-46053,107897,153950,61844,0,-14520,0,0,0,,14520,-14520
8,02/19/2018,22,5:15,5:30,,-36.03,1,-35.03,-37.03,-1,-45481,78488,123969,33007,0,-39154,0,0,0,,39154,-39154
8,02/19/2018,23,5:30,5:45,33.3,-36.03,1,34.3,32.3,1,-39003,39026,78029,23,0,-5005,199,0,0,,5204,-4806
8,02/19/2018,24,5:45,6:00,,34.34,1,35.34,33.34,-1,-54885,62879,117764,7994,0,-358,0,0,0,,358,-358
8,02/19/2018,25,6:00,6:15,,31.3,1,32.3,30.3,-1,-33462,95891,129353,62429,0,-1653,0,0,0,,1653,-1653
8,02/19/2018,26,6:15,6:30,,33.23,1,34.23,32.23,-1,-34377,72808,107185,38431,0,-744,0,0,0,,744,-744
8,02/19/2018,27,6:30,6:45,,35.35,1,36.35,34.35,-1,-54637,40908,95545,-13729,0,-805,0,0,0,,805,-805
8,02/19/2018,28,6:45,7:00,,,1,34.87,32.87,0,-104160,21244,125404,-82916,0,0,0,0,0,,0,0
8,02/19/2018,29,7:00,7:15,,-35.88,1,-34.88,-36.88,-1,-43714,126886,170600,83172,0,-17210,0,0,0,,17210,-17210
8,02/19/2018,30,7:15,7:30,,33.51,1,34.51,32.51,-1,-52958,31865,84823,-21093,0,-1102,0,0,0,,1102,-1102
8,02/19/2018,31,7:30,7:45,,,1,34.52,32.52,0,-72812,35422,108234,-37390,0,0,0,0,0,,0,0
8,02/19/2018,32,7:45,8:00,,,1,34.53,32.53,0,-108561,27714,136275,-80847,0,0,0,0,0,,0,0
8,02/19/2018,33,8:00,8:15,,14.95,1,15.95,13.95,-1,-30617,85776,116393,55159,0,-13843,0,0,0,,13843,-13843
8,02/19/2018,34,8:15,8:30,,31.59,1,32.59,30.59,-1,-46451,58026,104477,11575,0,-13841,0,0,0,,13841,-13841
8,02/19/2018,35,8:30,8:45,,33.64,1,34.64,32.64,-1,-66534,42119,108653,-24415,0,-3246,0,0,0,,3246,-3246
8,02/19/2018,36,8:45,9:00,56.28,,1,57.28,55.28,1,-89524,35595,125119,-53929,0,0,910,0,0,,910,910
8,02/19/2018,37,9:00,9:15,254.02,,1,255.02,253.02,1,-112227,37287,149514,-74940,0,0,41620,0,0,,41620,41620
8,02/19/2018,38,9:15,9:30,49.64,,1,50.64,48.64,1,-90223,49424,139647,-40799,0,0,36407,0,0,,36407,36407
8,02/19/2018,39,9:30,9:45,39.56,,1,40.56,38.56,1,-110252,57355,167607,-52897,0,0,23874,0,0,,23874,23874
8,02/19/2018,40,9:45,10:00,37.48,,1,38.48,36.48,1,-111338,54452,165790,-56886,0,0,17916,0,0,,17916,17916
8,02/19/2018,41,10:00,10:15,128.86,,1,129.86,127.86,1,-96669,40606,137275,-56063,0,0,26846,0,0,,26846,26846
8,02/19/2018,42,10:15,10:30,45.23,,1,46.23,44.23,1,-93284,44470,137754,-48814,0,0,29890,0,0,,29890,29890
8,02/19/2018,43,10:30,10:45,97.02,,1,98.02,96.02,1,-98335,30921,129256,-67414,0,0,38519,0,0,,38519,38519
8,02/19/2018,44,10:45,11:00,77.67,,1,78.67,76.67,1,-103998,38448,142446,-65550,0,0,47434,0,0,,47434,47434
8,02/19/2018,45,11:00,11:15,53.11,,1,54.11,52.11,1,-79269,31667,110936,-47602,0,0,36668,0,0,,36668,36668
8,02/19/2018,46,11:15,11:30,34.66,,1,35.66,33.66,1,-74825,57726,132551,-17099,0,0,8878,0,0,,8878,8878
8,02/19/2018,47,11:30,11:45,103.02,,1,104.02,102.02,1,-87186,39386,126572,-47800,0,0,18445,0,0,,18445,18445
8,02/19/2018,48,11:45,12:00,84.02,,1,85.02,83.02,1,-87305,28100,115405,-59205,0,0,37894,0,0,,37894,37894
8,02/19/2018,49,12:00,12:15,254.02,,1,255.02,253.02,1,-154312,23179,177491,-131133,0,0,66136,0,0,,66136,66136
8,02/19/2018,50,12:15,12:30,96.02,,1,97.02,95.02,1,-161898,27846,189744,-134052,0,0,55097,0,0,,55097,55097
8,02/19/2018,51,12:30,12:45,254.02,,1,255.02,253.02,1,-159422,33491,192913,-125931,0,0,52936,0,0,,52936,52936
8,02/19/2018,52,12:45,13:00,237.02,,1,238.02,236.02,1,-154087,41287,195374,-112800,0,0,68926,0,0,,68926,68926
8,02/19/2018,53,13:00,13:15,39.02,34.05,1,40.02,33.05,2,-62106,71709,133815,9603,0,-201,11379,0,0,,11580,11178
8,02/19/2018,54,13:15,13:30,39.33,,1,40.33,38.33,1,-76443,63067,139510,-13376,0,0,3351,0,0,,3351,3351
8,02/19/2018,55,13:30,13:45,39.56,,1,40.56,38.56,1,-74334,59916,134250,-14418,0,0,3864,0,0,,3864,3864
8,02/19/2018,56,13:45,14:00,115.59,,1,116.59,114.59,1,-94166,31014,125180,-63152,0,0,27033,0,0,,27033,27033
8,02/19/2018,57,14:00,14:15,37.56,,1,38.56,36.56,1,-75682,57656,133338,-18026,0,0,9872,0,0,,9872,9872
8,02/19/2018,58,14:15,14:30,34.66,,1,35.66,33.66,1,-67795,54362,122157,-13433,0,0,564,0,0,,564,564
8,02/19/2018,59,14:30,14:45,,,1,35.65,33.65,0,-61250,54923,116173,-6327,0,0,78,0,0,,78,78
8,02/19/2018,60,14:45,15:00,,,1,35.65,33.65,0,-62685,61711,124396,-974,0,0,0,0,0,,0,0
8,02/19/2018,61,15:00,15:15,,,1,35.84,33.84,0,-58013,89217,147230,31204,0,0,0,0,0,,0,0
8,02/19/2018,62,15:15,15:30,,,1,35.84,33.84,0,-60438,74159,134597,13721,0,0,0,0,0,,0,0
8,02/19/2018,63,15:30,15:45,34.66,,1,35.66,33.66,1,-62724,68463,131187,5739,0,0,39,0,0,,39,39
8,02/19/2018,64,15:45,16:00,35.2,,1,36.2,34.2,1,-66463,74813,141276,8350,0,0,750,0,0,,750,750
8,02/19/2018,65,16:00,16:15,,,1,35.85,33.85,0,-58426,77111,135537,18685,0,0,0,0,0,,0,0
8,02/19/2018,66,16:15,16:30,,,1,35.86,33.86,0,-58256,80094,138350,21838,0,0,0,0,0,,0,0
8,02/19/2018,67,16:30,16:45,,,1,35.86,33.86,0,-61620,74772,136392,13152,0,0,0,0,0,,0,0
8,02/19/2018,68,16:45,17:00,50.7,,1,51.7,49.7,1,-75183,53301,128484,-21882,0,0,9391,0,0,,9391,9391
8,02/19/2018,69,17:00,17:15,35.17,,1,36.17,34.17,1,-78575,36848,115423,-41727,0,0,6119,0,0,,6119,6119
8,02/19/2018,70,17:15,17:30,34.66,,1,35.66,33.66,1,-103335,38174,141509,-65161,0,0,3,0,0,,3,3
8,02/19/2018,71,17:30,17:45,108.88,,1,109.88,107.88,1,-114320,49240,163560,-65080,0,0,6203,0,0,,6203,6203
8,02/19/2018,72,17:45,18:00,254.02,,1,255.02,253.02,1,-86510,68305,154815,-18205,0,0,43568,0,0,,43568,43568
8,02/19/2018,73,18:00,18:15,39.07,,1,40.07,38.07,1,-108702,53743,162445,-54959,0,0,9898,0,0,,9898,9898
8,02/19/2018,74,18:15,18:30,62.84,,1,63.84,61.84,1,-120474,44586,165060,-75888,0,0,823,0,0,,823,823
8,02/19/2018,75,18:30,18:45,62.84,,1,63.84,61.84,1,-104437,44682,149119,-59755,0,0,3426,0,0,,3426,3426
8,02/19/2018,76,18:45,19:00,62.84,,1,63.84,61.84,1,-97936,41902,139838,-56034,0,0,7039,0,0,,7039,7039
8,02/19/2018,77,19:00,19:15,254.02,,1,255.02,253.02,1,-83312,38892,122204,-44420,0,0,31658,0,0,,31658,31658
8,02/19/2018,78,19:15,19:30,36.55,33.04,1,34.04,32.04,-1,-58588,60328,118916,1740,0,-142,9506,0,0,,9648,9364
8,02/19/2018,79,19:30,19:45,36.55,31.81,1,32.81,30.81,-1,-46974,66852,113826,19878,0,-2034,11,0,0,,2045,-2023
8,02/19/2018,80,19:45,20:00,,30.81,1,31.81,29.81,-1,-41545,65633,107178,24088,0,-6012,0,0,0,,6012,-6012
8,02/19/2018,81,20:00,20:15,54.9,30.81,1,55.9,53.9,1,-120311,38994,159305,-81317,0,-1079,2849,0,0,,3928,1770
8,02/19/2018,82,20:15,20:30,77.9,,1,78.9,76.9,1,-74166,38471,112637,-35695,0,0,9608,0,0,,9608,9608
8,02/19/2018,83,20:30,20:45,77.9,22.86,1,23.86,21.86,-1,-37440,60725,98165,23285,0,-4237,223,0,0,,4460,-4014
8,02/19/2018,84,20:45,21:00,,26.11,1,27.11,25.11,-1,-44698,72976,117674,28278,0,-15285,0,0,0,,15285,-15285
8,02/19/2018,85,21:00,21:15,127.02,31.03,1,128.02,30.03,2,-98048,58453,156501,-39595,0,-8470,8490,0,0,,16960,20
8,02/19/2018,86,21:15,21:30,39.56,,1,40.56,38.56,1,-51126,59040,110166,7914,0,0,6595,0,0,,6595,6595
8,02/19/2018,87,21:30,21:45,,,1,35.92,33.92,0,-17674,71757,89431,54083,0,0,97,0,0,,97,97
8,02/19/2018,88,21:45,22:00,,8.68,1,9.68,7.68,-1,-25168,93729,118897,68561,0,-6049,0,0,0,,6049,-6049
8,02/19/2018,89,22:00,22:15,101.52,30.81,1,102.52,29.81,2,-85781,44210,129991,-41571,0,-6144,7143,0,0,,13287,999
8,02/19/2018,90,22:15,22:30,34.66,35.54,1,36.54,34.54,-1,-37214,67568,104782,30354,0,-2,1245,0,0,,1247,1243
8,02/19/2018,91,22:30,22:45,,30.81,1,31.81,29.81,-1,-22124,93125,115249,71001,0,-769,0,0,0,,769,-769
8,02/19/2018,92,22:45,23:00,,12.18,1,13.18,11.18,-1,-18679,130110,148789,111431,0,-4297,0,0,0,,4297,-4297
8,02/19/2018,93,23:00,23:15,36.97,-4.03,1,37.97,-5.03,2,-58402,87712,146114,29310,0,-6458,559,0,0,,7017,-5899
8,02/19/2018,94,23:15,23:30,,15.93,1,16.93,14.93,-1,-32320,64666,96986,32346,0,-4223,0,0,0,,4223,-4223
8,02/19/2018,95,23:30,23:45,,6.96,1,7.96,5.96,-1,-28288,59151,87439,30863,0,-14922,0,0,0,,14922,-14922
8,02/19/2018,96,23:45,0:00,,-1.29,1,-0.29,-2.29,-1,-34142,87719,121861,53577,0,-14483,0,0,0,,14483,-14483
8,02/20/2018,1,0:00,0:15,254.12,-45.88,1,255.12,-46.88,2,-80302,29187,109489,-51115,0,-15422,8139,0,0,,23561,-7283
8,02/20/2018,2,0:15,0:30,181.12,31.81,1,32.81,30.81,-1,-30024,27021,57045,-3003,0,-342,17929,0,0,,18271,17587
8,02/20/2018,3,0:30,0:45,181.12,16.87,1,17.87,15.87,-1,-31053,55784,86837,24731,0,-20173,169,0,0,,20342,-20004
8,02/20/2018,4,0:45,1:00,,30.81,1,31.81,29.81,-1,-33255,61514,94769,28259,0,-17002,0,0,0,,17002,-17002
8,02/20/2018,5,1:00,1:15,34.66,21.78,1,35.66,20.78,2,-72917,9855,82772,-63062,0,-15814,77,0,0,,15891,-15737
8,02/20/2018,6,1:15,1:30,34.82,21.78,1,35.82,33.82,1,-62359,13448,75807,-48911,0,-375,374,0,0,,749,-1
8,02/20/2018,7,1:30,1:45,,,1,34.51,32.51,0,-48359,15078,63437,-33281,0,0,0,0,0,,0,0
8,02/20/2018,8,1:45,2:00,,,1,34.51,32.51,0,-59398,19546,78944,-39852,0,0,0,0,0,,0,0
8,02/20/2018,9,2:00,2:15,54.52,,1,55.52,53.52,1,-50461,22423,72884,-28038,0,0,8713,0,0,,8713,8713
8,02/20/2018,10,2:15,2:30,40.12,,1,41.12,39.12,1,-53913,18148,72061,-35765,0,0,13114,0,0,,13114,13114
8,02/20/2018,11,2:30,2:45,,,1,34.53,32.53,0,-51577,17186,68763,-34391,0,0,106,0,0,,106,106
8,02/20/2018,12,2:45,3:00,,,1,34.53,32.53,0,-50830,17324,68154,-33506,0,0,0,0,0,,0,0
8,02/20/2018,13,3:00,3:15,34.66,34.67,1,35.66,32.5,2,-35406,35634,71040,228,0,-249,137,0,0,,386,-112
8,02/20/2018,14,3:15,3:30,34.66,,1,35.66,33.66,1,-36322,21368,57690,-14954,0,0,2186,0,0,,2186,2186
8,02/20/2018,15,3:30,3:45,38.93,,1,39.93,37.93,1,-44616,20367,64983,-24249,0,0,1963,0,0,,1963,1963
8,02/20/2018,16,3:45,4:00,,,1,34.5,32.5,0,-47803,23168,70971,-24635,0,0,38,0,0,,38,38
8,02/20/2018,17,4:00,4:15,,,1,34.51,32.51,0,-50155,42356,92511,-7799,0,0,0,0,0,,0,0
8,02/20/2018,18,4:15,4:30,,,1,34.51,32.51,0,-57425,40741,98166,-16684,0,0,0,0,0,,0,0
8,02/20/2018,19,4:30,4:45,,,1,34.51,32.51,0,-73804,39984,113788,-33820,0,0,0,0,0,,0,0
8,02/20/2018,20,4:45,5:00,,,1,34.51,32.51,0,-71340,43463,114803,-27877,0,0,0,0,0,,0,0
8,02/20/2018,21,5:00,5:15,,,1,34.56,32.56,0,-75378,46821,122199,-28557,0,0,0,0,0,,0,0
8,02/20/2018,22,5:15,5:30,40.46,,1,41.46,39.46,1,-80841,32296,113137,-48545,0,0,1081,0,0,,1081,1081
8,02/20/2018,23,5:30,5:45,31.98,,1,32.98,30.98,1,-76575,9586,86161,-66989,0,0,670,0,0,,670,670
8,02/20/2018,24,5:45,6:00,35.21,,1,36.21,34.21,1,-91072,8442,99514,-82630,0,0,605,0,0,,605,605
8,02/20/2018,25,6:00,6:15,35.07,25.52,1,36.07,24.52,2,-65261,110133,175394,44872,0,-3557,704,0,0,,4261,-2853
8,02/20/2018,26,6:15,6:30,,30.96,1,31.96,29.96,-1,-65700,64003,129703,-1697,0,-6226,0,0,0,,6226,-6226
8,02/20/2018,27,6:30,6:45,123.55,30.96,1,124.55,122.55,1,-88476,27772,116248,-60704,0,-73,8529,0,0,,8602,8456
8,02/20/2018,28,6:45,7:00,237.12,,1,238.12,236.12,1,-128111,17652,145763,-110459,0,0,74882,0,0,,74882,74882
8,02/20/2018,29,7:00,7:15,237.12,-61.78,1,-60.78,-62.78,-1,-52115,220699,272814,168584,0,-25468,22127,0,0,,47595,-3341
8,02/20/2018,30,7:15,7:30,,30.34,1,31.34,29.34,-1,-88628,113134,201762,24506,0,-18077,0,0,0,,18077,-18077
8,02/20/2018,31,7:30,7:45,,34.78,1,35.78,33.78,-1,-92354,63586,155940,-28768,0,-2054,0,0,0,,2054,-2054
8,02/20/2018,32,7:45,8:00,193.12,,1,194.12,192.12,1,-116688,41685,158373,-75003,0,0,14565,0,0,,14565,14565
8,02/20/2018,33,8:00,8:15,39.08,32.78,1,40.08,31.78,2,-39492,143766,183258,104274,0,-468,6791,0,0,,7259,6323
8,02/20/2018,34,8:15,8:30,,,1,35.11,33.11,0,-51342,126641,177983,75299,0,0,0,0,0,,0,0
8,02/20/2018,35,8:30,8:45,,,1,35.11,33.11,0,-63105,96329,159434,33224,0,0,0,0,0,,0,0
8,02/20/2018,36,8:45,9:00,39.57,,1,40.57,38.57,1,-77706,60289,137995,-17417,0,0,3602,0,0,,3602,3602
8,02/20/2018,37,9:00,9:15,56.04,,1,57.04,55.04,1,-73803,30984,104787,-42819,0,0,5558,0,0,,5558,5558
8,02/20/2018,38,9:15,9:30,56.85,,1,57.85,55.85,1,-73551,30120,103671,-43431,0,0,13901,0,0,,13901,13901
8,02/20/2018,39,9:30,9:45,39.08,,1,40.08,38.08,1,-79763,33191,112954,-46572,0,0,13570,0,0,,13570,13570
8,02/20/2018,40,9:45,10:00,35.07,,1,36.07,34.07,1,-79714,39412,119126,-40302,0,0,2977,0,0,,2977,2977
8,02/20/2018,41,10:00,10:15,253.12,,1,254.12,252.12,1,-137305,20160,157465,-117145,0,0,22651,0,0,,22651,22651
8,02/20/2018,42,10:15,10:30,39.67,,1,40.67,38.67,1,-105574,38092,143666,-67482,0,0,11364,0,0,,11364,11364
8,02/20/2018,43,10:30,10:45,106.12,,1,107.12,105.12,1,-112026,38964,150990,-73062,0,0,15028,0,0,,15028,15028
8,02/20/2018,44,10:45,11:00,38.26,,1,39.26,37.26,1,-117829,43398,161227,-74431,0,0,4582,0,0,,4582,4582
8,02/20/2018,45,11:00,11:15,61.12,,1,62.12,60.12,1,-180533,59087,239620,-121446,0,0,12477,0,0,,12477,12477
8,02/20/2018,46,11:15,11:30,38.12,,1,39.12,37.12,1,-155070,60746,215816,-94324,0,0,8682,0,0,,8682,8682
8,02/20/2018,47,11:30,11:45,,,1,36.23,34.23,0,-137834,57619,195453,-80215,0,0,216,0,0,,216,216
8,02/20/2018,48,11:45,12:00,,,1,36.23,34.23,0,-131683,61637,193320,-70046,0,0,0,0,0,,0,0
8,02/20/2018,49,12:00,12:15,48.38,,1,49.38,47.38,1,-149852,32371,182223,-117481,0,0,7271,0,0,,7271,7271
8,02/20/2018,50,12:15,12:30,49.54,,1,50.54,48.54,1,-140106,31104,171210,-109002,0,0,19283,0,0,,19283,19283
8,02/20/2018,51,12:30,12:45,39.08,,1,40.08,38.08,1,-132841,34313,167154,-98528,0,0,9283,0,0,,9283,9283
8,02/20/2018,52,12:45,13:00,48.38,,1,49.38,47.38,1,-132059,19798,151857,-112261,0,0,12921,0,0,,12921,12921
8,02/20/2018,53,13:00,13:15,237.12,,1,238.12,236.12,1,-166027,12921,178948,-153106,0,0,52847,0,0,,52847,52847
8,02/20/2018,54,13:15,13:30,237.12,,1,238.12,236.12,1,-143960,12111,156071,-131849,0,0,79473,0,0,,79473,79473
8,02/20/2018,55,13:30,13:45,237.12,,1,238.12,236.12,1,-139848,18232,158080,-121616,0,0,47538,0,0,,47538,47538
8,02/20/2018,56,13:45,14:00,67.33,,1,68.33,66.33,1,-136356,21661,158017,-114695,0,0,32943,0,0,,32943,32943
8,02/20/2018,57,14:00,14:15,237.12,,1,238.12,236.12,1,-169774,15456,185230,-154318,0,0,46378,0,0,,46378,46378
8,02/20/2018,58,14:15,14:30,237.12,,1,238.12,236.12,1,-137845,30701,168546,-107144,0,0,86352,0,0,,86352,86352
8,02/20/2018,59,14:30,14:45,221.12,,1,222.12,220.12,1,-130251,30320,160571,-99931,0,0,59582,0,0,,59582,59582
8,02/20/2018,60,14:45,15:00,36.33,,1,37.33,35.33,1,-145503,42350,187853,-103153,0,0,18625,0,0,,18625,18625
8,02/20/2018,61,15:00,15:15,39.08,,1,40.08,38.08,1,-104727,64170,168897,-40557,0,0,770,0,0,,770,770
8,02/20/2018,62,15:15,15:30,54.87,,1,55.87,53.87,1,-122604,54364,176968,-68240,0,0,4907,0,0,,4907,4907
8,02/20/2018,63,15:30,15:45,194.12,,1,195.12,193.12,1,-115044,46737,161781,-68307,0,0,36271,0,0,,36271,36271
8,02/20/2018,64,15:45,16:00,65.19,,1,66.19,64.19,1,-123980,50079,174059,-73901,0,0,49841,0,0,,49841,49841
8,02/20/2018,65,16:00,16:15,,,1,36.14,34.14,0,-85190,74127,159317,-11063,0,0,13578,0,0,,13578,13578
8,02/20/2018,66,16:15,16:30,40.28,,1,41.28,39.28,1,-86274,60861,147135,-25413,0,0,2441,0,0,,2441,2441
8,02/20/2018,67,16:30,16:45,54.12,,1,55.12,53.12,1,-89504,56929,146433,-32575,0,0,17136,0,0,,17136,17136
8,02/20/2018,68,16:45,17:00,53.69,,1,54.69,52.69,1,-93923,60836,154759,-33087,0,0,27909,0,0,,27909,27909
8,02/20/2018,69,17:00,17:15,53.69,28.06,1,29.06,27.06,-1,-69639,75665,145304,6026,0,-4018,5427,0,0,,9445,1409
8,02/20/2018,70,17:15,17:30,,,1,36.31,34.31,0,-76044,53556,129600,-22488,0,-37,0,0,0,,37,-37
8,02/20/2018,71,17:30,17:45,,,1,36.31,34.31,0,-75097,66944,142041,-8153,0,0,0,0,0,,0,0
8,02/20/2018,72,17:45,18:00,,,1,36.32,34.32,0,-79549,98270,177819,18721,0,0,0,0,0,,0,0
8,02/20/2018,73,18:00,18:15,,14.86,1,15.86,13.86,-1,-86477,41729,128206,-44748,0,-7468,0,0,0,,7468,-7468
8,02/20/2018,74,18:15,18:30,55.48,14.86,1,56.48,54.48,1,-90863,29160,120023,-61703,0,-180,3243,0,0,,3423,3063
8,02/20/2018,75,18:30,18:45,55.48,,1,56.48,54.48,1,-89120,32682,121802,-56438,0,0,4454,0,0,,4454,4454
8,02/20/2018,76,18:45,19:00,36.92,,1,37.92,35.92,1,-86651,49948,136599,-36703,0,0,72,0,0,,72,72
8,02/20/2018,77,19:00,19:15,253.12,,1,254.12,252.12,1,-95877,9178,105055,-86699,0,0,37842,0,0,,37842,37842
8,02/20/2018,78,19:15,19:30,106.12,,1,107.12,105.12,1,-65358,49476,114834,-15882,0,0,40340,0,0,,40340,40340
8,02/20/2018,79,19:30,19:45,106.12,33.73,1,34.73,32.73,-1,-60747,79185,139932,18438,0,-835,1473,0,0,,2308,638
8,02/20/2018,80,19:45,20:00,,28.3,1,29.3,27.3,-1,-56003,88507,144510,32504,0,-7305,0,0,0,,7305,-7305
8,02/20/2018,81,20:00,20:15,,32.78,1,33.78,31.78,-1,-78183,47759,125942,-30424,0,-5161,0,0,0,,5161,-5161
8,02/20/2018,82,20:15,20:30,,31.96,1,32.96,30.96,-1,-71849,79000,150849,7151,0,-1313,0,0,0,,1313,-1313
8,02/20/2018,83,20:30,20:45,,22.53,1,23.53,21.53,-1,-66160,105154,171314,38994,0,-12567,0,0,0,,12567,-12567
8,02/20/2018,84,20:45,21:00,,22.63,1,23.63,21.63,-1,-64946,122237,187183,57291,0,-38000,0,0,0,,38000,-38000
8,02/20/2018,85,21:00,21:15,191.12,11.78,1,192.12,190.12,1,-101667,30043,131710,-71624,0,-22080,3508,0,0,,25588,-18572
8,02/20/2018,86,21:15,21:30,237.12,,1,238.12,236.12,1,-66651,76367,143018,9716,0,0,26479,0,0,,26479,26479
8,02/20/2018,87,21:30,21:45,237.12,35.47,1,36.47,34.47,-1,-52944,112074,165018,59130,0,-8,335,0,0,,343,327
8,02/20/2018,88,21:45,22:00,,4.79,1,5.79,3.79,-1,-51228,150371,201599,99143,0,-27840,0,0,0,,27840,-27840
8,02/20/2018,89,22:00,22:15,71.99,-31.09,1,72.99,-32.09,2,-103411,48984,152395,-54427,0,-34039,1636,0,0,,35675,-32403
8,02/20/2018,90,22:15,22:30,35.31,-35.92,1,-34.92,-36.92,-1,-49674,99128,148802,49454,0,-6961,1444,0,0,,8405,-5517
8,02/20/2018,91,22:30,22:45,,-27.73,1,-26.73,-28.73,-1,-46035,99504,145539,53469,0,-40460,0,0,0,,40460,-40460
8,02/20/2018,92,22:45,23:00,,-58.95,1,-57.95,-59.95,-1,-45893,129111,175004,83218,0,-59255,0,0,0,,59255,-59255
8,02/20/2018,93,23:00,23:15,36.23,9.87,1,37.23,35.23,1,-101444,80948,182392,-20496,0,-26758,290,0,0,,27048,-26468
8,02/20/2018,94,23:15,23:30,36.23,31.96,1,32.96,30.96,-1,-69485,70572,140057,1087,0,-736,12,0,0,,748,-724
8,02/20/2018,95,23:30,23:45,,28.64,1,29.64,27.64,-1,-57522,101052,158574,43530,0,-24120,0,0,0,,24120,-24120
8,02/20/2018,96,23:45,0:00,,21.43,1,22.43,20.43,-1,-53733,116206,169939,62473,0,-35798,0,0,0,,35798,-35798
8,02/21/2018,1,0:00,0:15,,29.03,3,32.03,26.03,-1,-75882,84285,160167,8403,0,-21309,0,0,0,,21309,-21309
8,02/21/2018,2,0:15,0:30,,32.81,3,35.81,29.81,-1,-32325,75903,108228,43578,0,-9569,0,0,0,,9569,-9569
8,02/21/2018,3,0:30,0:45,,34.03,3,37.03,31.03,-1,-28582,74994,103576,46412,0,-9250,0,0,0,,9250,-9250
8,02/21/2018,4,0:45,1:00,,17.33,3,20.33,14.33,-1,-31164,95111,126275,63947,0,-21363,0,0,0,,21363,-21363
8,02/21/2018,5,1:00,1:15,37.66,27.86,3,40.66,34.66,1,-61451,56220,117671,-5231,0,-19661,96,0,0,,19757,-19565
8,02/21/2018,6,1:15,1:30,37.66,31.04,3,40.66,28.04,2,-33470,59868,93338,26398,0,-3145,313,0,0,,3458,-2832
8,02/21/2018,7,1:30,1:45,,32.08,3,35.08,29.08,-1,-29773,68018,97791,38245,0,-24136,0,0,0,,24136,-24136
8,02/21/2018,8,1:45,2:00,,34.03,3,37.03,31.03,-1,-31471,60376,91847,28905,0,-21774,0,0,0,,21774,-21774
8,02/21/2018,9,2:00,2:15,57.68,33.81,3,60.68,54.68,1,-48764,38950,87714,-9814,0,-10394,6313,0,0,,16707,-4081
8,02/21/2018,10,2:15,2:30,55.69,33.81,3,58.69,52.69,1,-32680,29366,62046,-3314,0,-81,14213,0,0,,14294,14132
8,02/21/2018,11,2:30,2:45,32.02,,3,35.02,29.02,1,-26564,29320,55884,2756,0,0,366,0,0,,366,366
8,02/21/2018,12,2:45,3:00,31.83,38.35,3,41.35,35.35,-1,-28971,30116,59087,1145,0,-62,520,0,0,,582,458
8,02/21/2018,13,3:00,3:15,42.62,,3,45.62,39.62,1,-80021,19176,99197,-60845,0,0,2797,0,0,,2797,2797
8,02/21/2018,14,3:15,3:30,,,3,37.85,31.85,0,-48735,20633,69368,-28102,0,0,165,0,0,,165,165
8,02/21/2018,15,3:30,3:45,48.62,,3,51.62,45.62,1,-56120,18386,74506,-37734,0,0,6841,0,0,,6841,6841
8,02/21/2018,16,3:45,4:00,37.66,,3,40.66,34.66,1,-51455,31078,82533,-20377,0,0,4354,0,0,,4354,4354
8,02/21/2018,17,4:00,4:15,,,3,37.87,31.87,0,-59811,32627,92438,-27184,0,0,0,0,0,,0,0
8,02/21/2018,18,4:15,4:30,,,3,37.87,31.87,0,-41389,32255,73644,-9134,0,0,0,0,0,,0,0
8,02/21/2018,19,4:30,4:45,,,3,37.87,31.87,0,-49999,32304,82303,-17695,0,0,0,0,0,,0,0
8,02/21/2018,20,4:45,5:00,,,3,37.86,31.86,0,-47102,22189,69291,-24913,0,0,0,0,0,,0,0
8,02/21/2018,21,5:00,5:15,,,3,37.96,31.96,0,-83573,70099,153672,-13474,0,0,0,0,0,,0,0
8,02/21/2018,22,5:15,5:30,,,3,37.95,31.95,0,-43989,41734,85723,-2255,0,0,0,0,0,,0,0
8,02/21/2018,23,5:30,5:45,,,3,37.94,31.94,0,-51965,15597,67562,-36368,0,0,0,0,0,,0,0
8,02/21/2018,24,5:45,6:00,,38.15,3,41.15,35.15,-1,-87529,7718,95247,-79811,0,-29,0,0,0,,29,-29
8,02/21/2018,25,6:00,6:15,,-11.77,3,-8.77,-14.77,-1,-9696,125503,135199,115807,0,-17311,0,0,0,,17311,-17311
8,02/21/2018,26,6:15,6:30,,36.62,3,39.62,33.62,-1,-38164,34332,72496,-3832,0,-1667,0,0,0,,1667,-1667
8,02/21/2018,27,6:30,6:45,81.19,,3,84.19,78.19,1,-67187,12270,79457,-54917,0,0,2925,0,0,,2925,2925
8,02/21/2018,28,6:45,7:00,239.02,,3,242.02,236.02,1,-133945,21167,155112,-112778,0,0,72725,0,0,,72725,72725
8,02/21/2018,29,7:00,7:15,239.02,-18.66,3,-15.66,-21.66,-1,-49715,154861,204576,105146,0,-5545,40130,0,0,,45675,34585
8,02/21/2018,30,7:15,7:30,40.54,34.46,3,43.54,31.45,2,-28171,35179,63350,7008,0,-2898,1395,0,0,,4293,-1503
8,02/21/2018,31,7:30,7:45,64.13,,3,67.13,61.13,1,-59681,34484,94165,-25197,0,0,8884,0,0,,8884,8884
8,02/21/2018,32,7:45,8:00,79.6,,3,82.6,76.6,1,-110905,25711,136616,-85194,0,0,46033,0,0,,46033,46033
8,02/21/2018,33,8:00,8:15,,,3,37.57,31.57,0,-39641,60138,99779,20497,0,0,22033,0,0,,22033,22033
8,02/21/2018,34,8:15,8:30,42.67,,3,45.67,39.67,1,-53734,44141,97875,-9593,0,0,865,0,0,,865,865
8,02/21/2018,35,8:30,8:45,49.56,,3,52.56,46.56,1,-63579,32620,96199,-30959,0,0,18842,0,0,,18842,18842
8,02/21/2018,36,8:45,9:00,222.02,,3,225.02,219.02,1,-89525,33074,122599,-56451,0,0,30621,0,0,,30621,30621
8,02/21/2018,37,9:00,9:15,253.02,,3,256.02,250.02,1,-55980,44060,100040,-11920,0,0,47794,0,0,,47794,47794
8,02/21/2018,38,9:15,9:30,40.38,,3,43.38,37.38,1,-38494,31243,69737,-7251,0,0,3160,0,0,,3160,3160
8,02/21/2018,39,9:30,9:45,40.38,36.57,3,39.57,33.57,-1,-38159,56509,94668,18350,0,-24,277,0,0,,301,253
8,02/21/2018,40,9:45,10:00,,36.39,3,39.39,33.39,-1,-32098,68223,100321,36125,0,-248,0,0,0,,248,-248
8,02/21/2018,41,10:00,10:15,,36.21,3,39.21,33.21,-1,-69154,18657,87811,-50497,0,-753,0,0,0,,753,-753
8,02/21/2018,42,10:15,10:30,,34.18,3,37.18,31.18,-1,-35872,35155,71027,-717,0,-1149,0,0,0,,1149,-1149
8,02/21/2018,43,10:30,10:45,,26.5,3,29.5,23.5,-1,-36861,77030,113891,40169,0,-5439,0,0,0,,5439,-5439
8,02/21/2018,44,10:45,11:00,,27.46,3,30.46,24.46,-1,-30560,100778,131338,70218,0,-19116,0,0,0,,19116,-19116
8,02/21/2018,45,11:00,11:15,38.04,35.03,3,41.04,35.04,1,-56192,44094,100286,-12098,0,-8848,66,0,0,,8914,-8782
8,02/21/2018,46,11:15,11:30,,34.18,3,37.18,31.18,-1,-34369,74083,108452,39714,0,-2374,0,0,0,,2374,-2374
8,02/21/2018,47,11:30,11:45,,26.2,3,29.2,23.2,-1,-47780,94011,141791,46231,0,-22651,0,0,0,,22651,-22651
8,02/21/2018,48,11:45,12:00,,23.03,3,26.03,20.03,-1,-53594,101770,155364,48176,0,-39728,0,0,0,,39728,-39728
8,02/21/2018,49,12:00,12:15,,32.18,3,35.18,29.18,-1,-66773,79370,146143,12597,0,-19606,0,0,0,,19606,-19606
8,02/21/2018,50,12:15,12:30,,13.55,3,16.55,10.55,-1,-51846,85944,137790,34098,0,-22604,0,0,0,,22604,-22604
8,02/21/2018,51,12:30,12:45,,15.59,3,18.59,12.59,-1,-47242,103699,150941,56457,0,-35292,0,0,0,,35292,-35292
8,02/21/2018,52,12:45,13:00,,23.11,3,26.11,20.11,-1,-50931,101478,152409,50547,0,-47031,0,0,0,,47031,-47031
8,02/21/2018,53,13:00,13:15,40.06,25.86,3,43.06,37.06,1,-61205,60593,121798,-612,0,-26037,265,0,0,,26302,-25772
8,02/21/2018,54,13:15,13:30,40.06,34.18,3,37.18,31.18,-1,-55788,69244,125032,13456,0,-1414,144,0,0,,1558,-1270
8,02/21/2018,55,13:30,13:45,,30.03,3,33.03,27.03,-1,-57298,74039,131337,16741,0,-12797,0,0,0,,12797,-12797
8,02/21/2018,56,13:45,14:00,,30.18,3,33.18,27.18,-1,-55221,82605,137826,27384,0,-11919,0,0,0,,11919,-11919
8,02/21/2018,57,14:00,14:15,207.02,37.15,3,210.02,32.21,2,-118563,49091,167654,-69472,0,-5720,12515,0,0,,18235,6795
8,02/21/2018,58,14:15,14:30,43.01,,3,46.01,40.01,1,-79582,69047,148629,-10535,0,0,8432,0,0,,8432,8432
8,02/21/2018,59,14:30,14:45,,,3,38.21,32.21,0,-80133,68776,148909,-11357,0,0,0,0,0,,0,0
8,02/21/2018,60,14:45,15:00,43.01,,3,46.01,40.01,1,-89255,55596,144851,-33659,0,0,649,0,0,,649,649
8,02/21/2018,61,15:00,15:15,43.01,36,3,39,33,-1,-37123,118145,155268,81022,0,-524,9,0,0,,533,-515
8,02/21/2018,62,15:15,15:30,38.04,39.14,3,41.04,32.22,2,-43508,61588,105096,18080,0,-224,85,0,0,,309,-139
8,02/21/2018,63,15:30,15:45,53.26,,3,56.26,50.26,1,-55317,41787,97104,-13530,0,0,13824,0,0,,13824,13824
8,02/21/2018,64,15:45,16:00,43.01,,3,46.01,40.01,1,-71659,49249,120908,-22410,0,0,16163,0,0,,16163,16163
8,02/21/2018,65,16:00,16:15,43.01,-130.95,3,-127.95,-133.95,-1,-19728,138013,157741,118285,0,-33244,5790,0,0,,39034,-27454
8,02/21/2018,66,16:15,16:30,,31.02,3,34.02,28.02,-1,-32667,75905,108572,43238,0,-21077,0,0,0,,21077,-21077
8,02/21/2018,67,16:30,16:45,,33.98,3,36.98,30.98,-1,-15094,52280,67374,37186,0,-20881,0,0,0,,20881,-20881
8,02/21/2018,68,16:45,17:00,45.62,33.98,3,48.62,42.62,1,-44929,41038,85967,-3891,0,-5250,1527,0,0,,6777,-3723
8,02/21/2018,69,17:00,17:15,45.62,29.61,3,32.61,26.61,-1,-52684,75871,128555,23187,0,-1821,129,0,0,,1950,-1692
8,02/21/2018,70,17:15,17:30,,,3,40.32,34.32,0,-55908,60569,116477,4661,0,0,0,0,0,,0,0
8,02/21/2018,71,17:30,17:45,,,3,40.33,34.33,0,-51714,74089,125803,22375,0,0,0,0,0,,0,0
8,02/21/2018,72,17:45,18:00,,,3,40.27,34.27,0,-64753,97806,162559,33053,0,0,0,0,0,,0,0
8,02/21/2018,73,18:00,18:15,,12.34,3,15.34,9.34,-1,-53687,77444,131131,23757,0,-11508,0,0,0,,11508,-11508
8,02/21/2018,74,18:15,18:30,,34.18,3,37.18,31.18,-1,-83287,58359,141646,-24928,0,-6563,0,0,0,,6563,-6563
8,02/21/2018,75,18:30,18:45,38.04,,3,41.04,35.04,1,-76645,57439,134084,-19206,0,0,9,0,0,,9,9
8,02/21/2018,76,18:45,19:00,43.01,,3,46.01,40.01,1,-67967,59149,127116,-8818,0,0,4793,0,0,,4793,4793
8,02/21/2018,77,19:00,19:15,64.02,,3,67.02,61.02,1,-69717,50042,119759,-19675,0,0,14321,0,0,,14321,14321
8,02/21/2018,78,19:15,19:30,64.02,33.82,3,36.82,30.82,-1,-52806,67029,119835,14223,0,-1280,3239,0,0,,4519,1959
8,02/21/2018,79,19:30,19:45,,30.18,3,33.18,27.18,-1,-53168,71344,124512,18176,0,-3649,0,0,0,,3649,-3649
8,02/21/2018,80,19:45,20:00,,32.18,3,35.18,29.18,-1,-56941,92455,149396,35514,0,-19525,0,0,0,,19525,-19525
8,02/21/2018,81,20:00,20:15,113.16,20.3,3,116.16,17.3,2,-113764,40328,154092,-73436,0,-16283,3618,0,0,,19901,-12665
8,02/21/2018,82,20:15,20:30,38.04,36.88,3,39.88,33.88,-1,-68722,43921,112643,-24801,0,-226,2250,0,0,,2476,2024
8,02/21/2018,83,20:30,20:45,,20.16,3,23.16,17.16,-1,-40027,71869,111896,31842,0,-2767,0,0,0,,2767,-2767
8,02/21/2018,84,20:45,21:00,,26.87,3,29.87,23.87,-1,-60566,92123,152689,31557,0,-16740,0,0,0,,16740,-16740
8,02/21/2018,85,21:00,21:15,49.78,34.27,3,52.78,31.09,2,-140988,55357,196345,-85631,0,-6586,2980,0,0,,9566,-3606
8,02/21/2018,86,21:15,21:30,43.01,34.27,3,46.01,40.01,1,-89410,66190,155600,-23220,0,-11,5720,0,0,,5731,5709
8,02/21/2018,87,21:30,21:45,43.01,34.03,3,37.03,31.03,-1,-75228,86407,161635,11179,0,-1336,932,0,0,,2268,-404
8,02/21/2018,88,21:45,22:00,,26.45,3,29.45,23.45,-1,-75110,105895,181005,30785,0,-25222,0,0,0,,25222,-25222
8,02/21/2018,89,22:00,22:15,39.46,34.03,3,42.46,31.03,2,-87184,63398,150582,-23786,0,-11004,613,0,0,,11617,-10391
8,02/21/2018,90,22:15,22:30,,38.74,3,41.74,35.74,-1,-77968,70745,148713,-7223,0,-3,0,0,0,,3,-3
8,02/21/2018,91,22:30,22:45,,15.42,3,18.42,12.42,-1,-53813,96246,150059,42433,0,-7683,0,0,0,,7683,-7683
8,02/21/2018,92,22:45,23:00,,13.58,3,16.58,10.58,-1,-55241,109028,164269,53787,0,-29338,0,0,0,,29338,-29338
8,02/21/2018,93,23:00,23:15,70.41,24.03,3,73.41,67.41,1,-89530,72856,162386,-16674,0,-21715,2301,0,0,,24016,-19414
8,02/21/2018,94,23:15,23:30,86.7,13.84,3,89.7,10.84,2,-74494,84778,159272,10284,0,-904,19456,0,0,,20360,18552
8,02/21/2018,95,23:30,23:45,86.7,-15.72,3,-12.72,-18.72,-1,-34542,81179,115721,46637,0,-28623,157,0,0,,28780,-28466
8,02/21/2018,96,23:45,0:00,,14.14,3,17.14,11.14,-1,-45413,119380,164793,73967,0,-42312,0,0,0,,42312,-42312
8,02/22/2018,1,0:00,0:15,,17.66,3,20.66,14.66,-1,-49053,77342,126395,28289,0,-46355,0,0,0,,46355,-46355
8,02/22/2018,2,0:15,0:30,,34.45,3,37.45,31.45,-1,-51359,82517,133876,31158,0,-27475,0,0,0,,27475,-27475
8,02/22/2018,3,0:30,0:45,,29.78,3,32.78,26.78,-1,-52801,92163,144964,39362,0,-32462,0,0,0,,32462,-32462
8,02/22/2018,4,0:45,1:00,,25.94,3,28.94,22.94,-1,-49905,98063,147968,48158,0,-45669,0,0,0,,45669,-45669
8,02/22/2018,5,1:00,1:15,48.27,33.09,3,51.27,45.27,1,-59899,57617,117516,-2282,0,-22141,1320,0,0,,23461,-20821
8,02/22/2018,6,1:15,1:30,45.18,4.46,3,7.46,1.46,-1,-37902,76677,114579,38775,0,-9862,1839,0,0,,11701,-8023
8,02/22/2018,7,1:30,1:45,,4.46,3,7.46,1.46,-1,-41807,63341,105148,21534,0,-32098,0,0,0,,32098,-32098
8,02/22/2018,8,1:45,2:00,,17.42,3,20.42,14.42,-1,-47632,93291,140923,45659,0,-24967,0,0,0,,24967,-24967
8,02/22/2018,9,2:00,2:15,,-19.42,3,-16.42,-22.42,-1,-53437,82796,136233,29359,0,-37869,0,0,0,,37869,-37869
8,02/22/2018,10,2:15,2:30,,22.21,3,25.21,19.21,-1,-52340,81079,133419,28739,0,-20537,0,0,0,,20537,-20537
8,02/22/2018,11,2:30,2:45,,15.78,3,18.78,12.78,-1,-54342,84493,138835,30151,0,-39912,0,0,0,,39912,-39912
8,02/22/2018,12,2:45,3:00,,25.12,3,28.12,22.12,-1,-55937,96229,152166,40292,0,-40658,0,0,0,,40658,-40658
8,02/22/2018,13,3:00,3:15,,29.78,3,32.78,26.78,-1,-55967,81825,137792,25858,0,-33400,0,0,0,,33400,-33400
8,02/22/2018,14,3:15,3:30,,33.09,3,36.09,30.09,-1,-57129,77401,134530,20272,0,-21074,0,0,0,,21074,-21074
8,02/22/2018,15,3:30,3:45,,28.68,3,31.68,25.68,-1,-60389,77279,137668,16890,0,-29952,0,0,0,,29952,-29952
8,02/22/2018,16,3:45,4:00,,30.5,3,33.5,27.5,-1,-57952,91016,148968,33064,0,-24284,0,0,0,,24284,-24284
8,02/22/2018,17,4:00,4:15,,30.62,3,33.62,27.62,-1,-67608,85459,153067,17851,0,-27975,0,0,0,,27975,-27975
8,02/22/2018,18,4:15,4:30,,30.45,3,33.45,27.45,-1,-69411,92437,161848,23026,0,-14322,0,0,0,,14322,-14322
8,02/22/2018,19,4:30,4:45,,35.45,3,38.45,32.45,-1,-71426,78242,149668,6816,0,-16430,0,0,0,,16430,-16430
8,02/22/2018,20,4:45,5:00,,,3,38.84,32.84,0,-63382,74788,138170,11406,0,-721,0,0,0,,721,-721
8,02/22/2018,21,5:00,5:15,,28.88,3,31.88,25.88,-1,-67489,112737,180226,45248,0,-10600,0,0,0,,10600,-10600
8,02/22/2018,22,5:15,5:30,,11.5,3,14.5,8.5,-1,-57058,88526,145584,31468,0,-40859,0,0,0,,40859,-40859
8,02/22/2018,23,5:30,5:45,,36.78,3,39.78,33.78,-1,-59999,57957,117956,-2042,0,-8347,0,0,0,,8347,-8347
8,02/22/2018,24,5:45,6:00,,,3,38.95,32.95,0,-64443,60101,124544,-4342,0,0,0,0,0,,0,0
8,02/22/2018,25,6:00,6:15,,-116.41,3,-113.41,-119.41,-1,-45047,165748,210795,120701,0,-29114,0,0,0,,29114,-29114
8,02/22/2018,26,6:15,6:30,,36.78,3,39.78,33.78,-1,-42890,98516,141406,55626,0,-13472,0,0,0,,13472,-13472
8,02/22/2018,27,6:30,6:45,,36.78,3,39.78,33.78,-1,-56350,85761,142111,29411,0,-772,0,0,0,,772,-772
8,02/22/2018,28,6:45,7:00,77.54,,3,80.54,74.54,1,-112962,71639,184601,-41323,0,0,8216,0,0,,8216,8216
8,02/22/2018,29,7:00,7:15,40.28,-108.71,3,-105.71,-111.71,-1,-31144,174601,205745,143457,0,-38848,3550,0,0,,42398,-35298
8,02/22/2018,30,7:15,7:30,,28.98,3,31.98,25.98,-1,-39990,89140,129130,49150,0,-43634,0,0,0,,43634,-43634
8,02/22/2018,31,7:30,7:45,,36.14,3,39.14,33.14,-1,-44919,71505,116424,26586,0,-21472,0,0,0,,21472,-21472
8,02/22/2018,32,7:45,8:00,41.47,36.14,3,44.47,38.47,1,-90655,57970,148625,-32685,0,-3871,678,0,0,,4549,-3193
8,02/22/2018,33,8:00,8:15,,37.01,3,40.01,34.01,-1,-11061,101138,112199,90077,0,-1055,0,0,0,,1055,-1055
8,02/22/2018,34,8:15,8:30,,,3,39.12,33.12,0,-21246,80642,101888,59396,0,0,0,0,0,,0,0
8,02/22/2018,35,8:30,8:45,,37.78,3,40.78,34.78,-1,-29825,55403,85228,25578,0,-391,0,0,0,,391,-391
8,02/22/2018,36,8:45,9:00,,37.33,3,40.33,34.33,-1,-41873,68052,109925,26179,0,-748,0,0,0,,748,-748
8,02/22/2018,37,9:00,9:15,40.66,,3,43.66,37.66,1,-51988,50120,102108,-1868,0,0,654,0,0,,654,654
8,02/22/2018,38,9:15,9:30,,,3,39.17,33.17,0,-46542,48807,95349,2265,0,0,62,0,0,,62,62
8,02/22/2018,39,9:30,9:45,,28.06,3,31.06,25.06,-1,-39745,74320,114065,34575,0,-8878,0,0,0,,8878,-8878
8,02/22/2018,40,9:45,10:00,,28.13,3,31.13,25.13,-1,-52095,92996,145091,40901,0,-28485,0,0,0,,28485,-28485
8,02/22/2018,41,10:00,10:15,,36.14,3,39.14,33.14,-1,-46517,61572,108089,15055,0,-18374,0,0,0,,18374,-18374
8,02/22/2018,42,10:15,10:30,,14.05,3,17.05,11.05,-1,-33056,79669,112725,46613,0,-32719,0,0,0,,32719,-32719
8,02/22/2018,43,10:30,10:45,,-12.86,3,-9.86,-15.86,-1,-32879,110294,143173,77415,0,-49580,0,0,0,,49580,-49580
8,02/22/2018,44,10:45,11:00,,-13.71,3,-10.71,-16.71,-1,-40221,116585,156806,76364,0,-72775,0,0,0,,72775,-72775
8,02/22/2018,45,11:00,11:15,40.82,24.87,3,43.82,37.82,1,-78869,73252,152121,-5617,0,-32865,151,0,0,,33016,-32714
8,02/22/2018,46,11:15,11:30,40.82,12.44,3,15.44,9.44,-1,-35064,74213,109277,39149,0,-9793,39,0,0,,9832,-9754
8,02/22/2018,47,11:30,11:45,,-4.79,3,-1.79,-7.79,-1,-46331,70217,116548,23886,0,-33110,0,0,0,,33110,-33110
8,02/22/2018,48,11:45,12:00,,10.1,3,13.1,7.1,-1,-46709,106503,153212,59794,0,-27888,0,0,0,,27888,-27888
8,02/22/2018,49,12:00,12:15,40.38,34.14,3,43.38,37.38,1,-87651,55584,143235,-32067,0,-15407,593,0,0,,16000,-14814
8,02/22/2018,50,12:15,12:30,40.38,36.14,3,39.14,33.14,-1,-70635,83557,154192,12922,0,-2553,68,0,0,,2621,-2485
8,02/22/2018,51,12:30,12:45,,18.04,3,21.04,15.04,-1,-54370,101282,155652,46912,0,-33083,0,0,0,,33083,-33083
8,02/22/2018,52,12:45,13:00,,27.78,3,30.78,24.78,-1,-57528,106862,164390,49334,0,-43397,0,0,0,,43397,-43397
8,02/22/2018,53,13:00,13:15,,32.14,3,35.14,29.14,-1,-51673,91205,142878,39532,0,-40796,0,0,0,,40796,-40796
8,02/22/2018,54,13:15,13:30,,37.78,3,40.78,34.78,-1,-51986,75310,127296,23324,0,-16683,0,0,0,,16683,-16683
8,02/22/2018,55,13:30,13:45,,34.14,3,37.14,31.14,-1,-44196,76476,120672,32280,0,-17554,0,0,0,,17554,-17554
8,02/22/2018,56,13:45,14:00,,15.16,3,18.16,12.16,-1,-39125,87508,126633,48383,0,-28295,0,0,0,,28295,-28295
8,02/22/2018,57,14:00,14:15,,18.04,3,21.04,15.04,-1,-45090,66671,111761,21581,0,-28807,0,0,0,,28807,-28807
8,02/22/2018,58,14:15,14:30,,8.01,3,11.01,5.01,-1,-25749,87478,113227,61729,0,-32363,0,0,0,,32363,-32363
8,02/22/2018,59,14:30,14:45,,14.27,3,17.27,11.27,-1,-31768,96847,128615,65079,0,-37299,0,0,0,,37299,-37299
8,02/22/2018,60,14:45,15:00,,14.68,3,17.68,11.68,-1,-41570,80341,121911,38771,0,-41757,0,0,0,,41757,-41757
8,02/22/2018,61,15:00,15:15,,38.54,3,41.54,35.54,-1,-68051,113385,181436,45334,0,-14856,0,0,0,,14856,-14856
8,02/22/2018,62,15:15,15:30,,32.14,3,35.14,29.14,-1,-54258,112051,166309,57793,0,-9271,0,0,0,,9271,-9271
8,02/22/2018,63,15:30,15:45,,40.4,3,43.4,37.4,-1,-47744,85619,133363,37875,0,-3246,0,0,0,,3246,-3246
8,02/22/2018,64,15:45,16:00,,,3,39.33,33.33,0,-51323,55646,106969,4323,0,0,0,0,0,,0,0
8,02/22/2018,65,16:00,16:15,,25.9,3,28.9,22.9,-1,-30605,113766,144371,83161,0,-6762,0,0,0,,6762,-6762
8,02/22/2018,66,16:15,16:30,,40.83,3,43.83,37.83,-1,-29733,69091,98824,39358,0,-191,0,0,0,,191,-191
8,02/22/2018,67,16:30,16:45,45.8,40.79,3,48.8,36.77,2,-49917,45112,95029,-4805,0,-422,740,0,0,,1162,318
8,02/22/2018,68,16:45,17:00,79.12,,3,82.12,76.12,1,-79122,53491,132613,-25631,0,0,20645,0,0,,20645,20645
8,02/22/2018,69,17:00,17:15,39.14,34.14,3,42.97,31.14,2,-24055,88839,112894,64784,0,-2092,4829,0,0,,6921,2737
8,02/22/2018,70,17:15,17:30,39.45,,3,42.45,36.45,1,-54914,64009,118923,9095,0,0,168,0,0,,168,168
8,02/22/2018,71,17:30,17:45,40.53,,3,43.53,37.53,1,-69821,82139,151960,12318,0,0,248,0,0,,248,248
8,02/22/2018,72,17:45,18:00,,,3,42.46,36.46,0,-77812,98919,176731,21107,0,0,0,0,0,,0,0
8,02/22/2018,73,18:00,18:15,,-15.85,3,-12.85,-18.85,-1,-21688,104034,125722,82346,0,-19038,0,0,0,,19038,-19038
8,02/22/2018,74,18:15,18:30,,37.01,3,40.01,34.01,-1,-42138,71993,114131,29855,0,-6578,0,0,0,,6578,-6578
8,02/22/2018,75,18:30,18:45,39.47,37.01,3,42.47,36.47,1,-72389,71936,144325,-453,0,-112,513,0,0,,625,401
8,02/22/2018,76,18:45,19:00,39.14,38.16,3,42.46,35.16,2,-74480,84171,158651,9691,0,-33,411,0,0,,444,378
8,02/22/2018,77,19:00,19:15,,36.42,3,39.42,33.42,-1,-54975,110230,165205,55255,0,-252,0,0,0,,252,-252
8,02/22/2018,78,19:15,19:30,,19.23,3,22.23,16.23,-1,-42458,94572,137030,52114,0,-9852,0,0,0,,9852,-9852
8,02/22/2018,79,19:30,19:45,,13.54,3,16.54,10.54,-1,-37184,105865,143049,68681,0,-29060,0,0,0,,29060,-29060
8,02/22/2018,80,19:45,20:00,,-7.2,3,-4.2,-10.2,-1,-28102,98689,126791,70587,0,-60685,0,0,0,,60685,-60685
8,02/22/2018,81,20:00,20:15,154.12,19.62,3,157.12,16.62,2,-88412,28769,117181,-59643,0,-28044,4712,0,0,,32756,-23332
8,02/22/2018,82,20:15,20:30,41.39,32.14,3,35.14,29.14,-1,-58605,52316,110921,-6289,0,-2807,5147,0,0,,7954,2340
8,02/22/2018,83,20:30,20:45,,29.29,3,32.29,26.29,-1,-50500,50055,100555,-445,0,-7740,0,0,0,,7740,-7740
8,02/22/2018,84,20:45,21:00,,36.94,3,39.94,33.94,-1,-61337,67555,128892,6218,0,-1099,0,0,0,,1099,-1099
8,02/22/2018,85,21:00,21:15,43.87,36.5,3,46.87,40.87,1,-72366,84376,156742,12010,0,-558,135,0,0,,693,-423
8,02/22/2018,86,21:15,21:30,45.11,34.14,3,48.11,31.14,2,-53584,84831,138415,31247,0,-180,1396,0,0,,1576,1216
8,02/22/2018,87,21:30,21:45,,26.9,3,29.9,23.9,-1,-64121,102405,166526,38284,0,-5404,0,0,0,,5404,-5404
8,02/22/2018,88,21:45,22:00,,24.25,3,27.25,21.25,-1,-54295,93679,147974,39384,0,-25158,0,0,0,,25158,-25158
8,02/22/2018,89,22:00,22:15,57.81,30.95,3,60.81,54.81,1,-68741,78650,147391,9909,0,-17653,1683,0,0,,19336,-15970
8,02/22/2018,90,22:15,22:30,32.15,20.86,3,23.86,17.86,-1,-29802,78178,107980,48376,0,-4787,1024,0,0,,5811,-3763
8,02/22/2018,91,22:30,22:45,,17.52,3,20.52,14.52,-1,-22449,72741,95190,50292,0,-15605,0,0,0,,15605,-15605
8,02/22/2018,92,22:45,23:00,,25.55,3,28.55,22.55,-1,-8370,92239,100609,83869,0,-16711,0,0,0,,16711,-16711
8,02/22/2018,93,23:00,23:15,,32.14,3,35.14,29.14,-1,-75582,87828,163410,12246,0,-12147,0,0,0,,12147,-12147
8,02/22/2018,94,23:15,23:30,,21.39,3,24.39,18.39,-1,-39563,68565,108128,29002,0,-9218,0,0,0,,9218,-9218
8,02/22/2018,95,23:30,23:45,,17.66,3,20.66,14.66,-1,-33865,56449,90314,22584,0,-27579,0,0,0,,27579,-27579
8,02/22/2018,96,23:45,0:00,,-43.08,3,-40.08,-46.08,-1,-25875,99013,124888,73138,0,-31941,0,0,0,,31941,-31941
8,02/23/2018,1,0:00,0:15,98.02,-43.08,3,101.02,95.02,1,-75793,56763,132556,-19030,0,-12639,3479,0,0,,16118,-9160
8,02/23/2018,2,0:15,0:30,,,3,40.77,34.77,0,-44011,57012,101023,13001,0,0,1,0,0,,1,1
8,02/23/2018,3,0:30,0:45,,37.28,3,40.28,34.28,-1,-46152,65948,112100,19796,0,-264,0,0,0,,264,-264
8,02/23/2018,4,0:45,1:00,,25.25,3,28.25,22.25,-1,-47855,86481,134336,38626,0,-23852,0,0,0,,23852,-23852
8,02/23/2018,5,1:00,1:15,,37.33,3,40.33,34.33,-1,-41758,48202,89960,6444,0,-8797,0,0,0,,8797,-8797
8,02/23/2018,6,1:15,1:30,,,3,40.77,34.77,0,-31081,77707,108788,46626,0,0,0,0,0,,0,0
8,02/23/2018,7,1:30,1:45,,,3,40.77,34.77,0,-27460,68263,95723,40803,0,0,0,0,0,,0,0
8,02/23/2018,8,1:45,2:00,,39.37,3,42.37,36.37,-1,-20960,80204,101164,59244,0,-302,0,0,0,,302,-302
8,02/23/2018,9,2:00,2:15,,,3,40.77,34.77,0,-33723,57685,91408,23962,0,0,0,0,0,,0,0
8,02/23/2018,10,2:15,2:30,,,3,40.77,34.77,0,-37682,50608,88290,12926,0,0,0,0,0,,0,0
8,02/23/2018,11,2:30,2:45,,,3,40.77,34.77,0,-38913,54712,93625,15799,0,0,0,0,0,,0,0
8,02/23/2018,12,2:45,3:00,,,3,40.77,34.77,0,-41041,47038,88079,5997,0,0,0,0,0,,0,0
8,02/23/2018,13,3:00,3:15,41.76,,3,44.76,38.76,1,-70700,52721,123421,-17979,0,0,1621,0,0,,1621,1621
8,02/23/2018,14,3:15,3:30,43.28,,3,46.28,40.28,1,-50987,37627,88614,-13360,0,0,11507,0,0,,11507,11507
8,02/23/2018,15,3:30,3:45,,,3,40.77,34.77,0,-55270,53972,109242,-1298,0,0,618,0,0,,618,618
8,02/23/2018,16,3:45,4:00,,,3,40.77,34.77,0,-55263,49875,105138,-5388,0,0,0,0,0,,0,0
8,02/23/2018,17,4:00,4:15,,,3,40.77,34.77,0,-62611,53502,116113,-9109,0,0,0,0,0,,0,0
8,02/23/2018,18,4:15,4:30,,,3,40.77,34.77,0,-62237,54659,116896,-7578,0,0,0,0,0,,0,0
8,02/23/2018,19,4:30,4:45,,,3,40.77,34.77,0,-69351,47431,116782,-21920,0,0,0,0,0,,0,0
8,02/23/2018,20,4:45,5:00,,,3,40.77,34.77,0,-76946,37037,113983,-39909,0,0,0,0,0,,0,0
8,02/23/2018,21,5:00,5:15,,,3,40.77,34.77,0,-82262,58487,140749,-23775,0,0,0,0,0,,0,0
8,02/23/2018,22,5:15,5:30,,,3,40.77,34.77,0,-85077,53353,138430,-31724,0,0,0,0,0,,0,0
8,02/23/2018,23,5:30,5:45,48.02,,3,51.02,45.02,1,-87365,51797,139162,-35568,0,0,5785,0,0,,5785,5785
8,02/23/2018,24,5:45,6:00,40.02,,3,43.02,37.02,1,-109547,77280,186827,-32267,0,0,7405,0,0,,7405,7405
8,02/23/2018,25,6:00,6:15,40.02,-10.36,3,-7.36,-13.36,-1,-35721,122358,158079,86637,0,-15405,778,0,0,,16183,-14627
8,02/23/2018,26,6:15,6:30,,37.65,3,40.65,34.65,-1,-42316,72797,115113,30481,0,-13762,0,0,0,,13762,-13762
8,02/23/2018,27,6:30,6:45,41.64,37.65,3,44.64,38.64,1,-99403,69134,168537,-30269,0,-2158,501,0,0,,2659,-1657
8,02/23/2018,28,6:45,7:00,45.64,,3,48.64,42.64,1,-136291,67676,203967,-68615,0,0,4975,0,0,,4975,4975
8,02/23/2018,29,7:00,7:15,45.64,-23.05,3,-20.05,-26.05,-1,-54124,147678,201802,93554,0,-22452,731,0,0,,23183,-21721
8,02/23/2018,30,7:15,7:30,,30.1,3,33.1,27.1,-1,-35096,58664,93760,23568,0,-24640,0,0,0,,24640,-24640
8,02/23/2018,31,7:30,7:45,,39.03,3,42.03,36.03,-1,-56879,61745,118624,4866,0,-10541,0,0,0,,10541,-10541
8,02/23/2018,32,7:45,8:00,39.81,39.03,3,42.81,36.81,1,-87352,43287,130639,-44065,0,-965,312,0,0,,1277,-653
8,02/23/2018,33,8:00,8:15,,,3,41.59,35.59,0,-20738,71729,92467,50991,0,0,0,0,0,,0,0
8,02/23/2018,34,8:15,8:30,,,3,41.59,35.59,0,-35714,60798,96512,25084,0,0,0,0,0,,0,0
8,02/23/2018,35,8:30,8:45,41.64,,3,44.64,38.64,1,-53353,53778,107131,425,0,0,248,0,0,,248,248
8,02/23/2018,36,8:45,9:00,56.68,,3,59.68,53.68,1,-69917,52496,122413,-17421,0,0,8866,0,0,,8866,8866
8,02/23/2018,37,9:00,9:15,56.02,,3,59.02,53.02,1,-54032,27367,81399,-26665,0,0,26495,0,0,,26495,26495
8,02/23/2018,38,9:15,9:30,45.64,,3,48.64,42.64,1,-56817,33578,90395,-23239,0,0,22823,0,0,,22823,22823
8,02/23/2018,39,9:30,9:45,41.89,39.03,3,42.03,36.03,-1,-47830,49813,97643,1983,0,-179,11380,0,0,,11559,11201
8,02/23/2018,40,9:45,10:00,41.89,36.25,3,39.25,33.25,-1,-37016,67550,104566,30534,0,-8858,106,0,0,,8964,-8752
8,02/23/2018,41,10:00,10:15,252.02,36.25,3,255.02,249.02,1,-110468,27295,137763,-83173,0,-2197,17913,0,0,,20110,15716
8,02/23/2018,42,10:15,10:30,45.14,36.64,3,39.64,33.64,-1,-63364,68376,131740,5012,0,-744,7146,0,0,,7890,6402
8,02/23/2018,43,10:30,10:45,,14.87,3,17.87,11.87,-1,-49461,89715,139176,40254,0,-30298,0,0,0,,30298,-30298
8,02/23/2018,44,10:45,11:00,,-65.48,3,-62.48,-68.48,-1,-44827,127568,172395,82741,0,-54507,0,0,0,,54507,-54507
8,02/23/2018,45,11:00,11:15,191.02,15.03,3,194.02,188.02,1,-101009,36847,137856,-64162,0,-30964,4315,0,0,,35279,-26649
8,02/23/2018,46,11:15,11:30,237.02,-33.93,3,240.02,-36.93,2,-52201,98836,151037,46635,0,-8088,12888,0,0,,20976,4800
8,02/23/2018,47,11:30,11:45,,-56.1,3,-53.1,-59.1,-1,-65691,96125,161816,30434,0,-36124,0,0,0,,36124,-36124
8,02/23/2018,48,11:45,12:00,,-25.99,3,-22.99,-28.99,-1,-53885,129581,183466,75696,0,-41495,0,0,0,,41495,-41495
8,02/23/2018,49,12:00,12:15,,23.6,3,26.6,20.6,-1,-52785,93399,146184,40614,0,-26441,0,0,0,,26441,-26441
8,02/23/2018,50,12:15,12:30,,7.89,3,10.89,4.89,-1,-39126,99672,138798,60546,0,-44001,0,0,0,,44001,-44001
8,02/23/2018,51,12:30,12:45,,8.28,3,11.28,5.28,-1,-42461,124504,166965,82043,0,-56346,0,0,0,,56346,-56346
8,02/23/2018,52,12:45,13:00,,15.08,3,18.08,12.08,-1,-56126,121081,177207,64955,0,-66199,0,0,0,,66199,-66199
8,02/23/2018,53,13:00,13:15,41.31,22.7,3,44.31,38.31,1,-75125,89784,164909,14659,0,-29249,127,0,0,,29376,-29122
8,02/23/2018,54,13:15,13:30,,24.52,3,27.52,21.52,-1,-64151,95435,159586,31284,0,-5078,0,0,0,,5078,-5078
8,02/23/2018,55,13:30,13:45,,6.03,3,9.03,3.03,-1,-53636,109684,163320,56048,0,-46226,0,0,0,,46226,-46226
8,02/23/2018,56,13:45,14:00,,-6.08,3,-3.08,-9.08,-1,-49668,125072,174740,75404,0,-54790,0,0,0,,54790,-54790
8,02/23/2018,57,14:00,14:15,39.22,41.86,3,42.22,33.94,2,-124983,107039,232022,-17944,0,-20695,59,0,0,,20754,-20636
8,02/23/2018,58,14:15,14:30,,27.46,3,30.46,24.46,-1,-92061,119266,211327,27205,0,-6556,0,0,0,,6556,-6556
8,02/23/2018,59,14:30,14:45,,11.85,3,14.85,8.85,-1,-83895,119622,203517,35727,0,-35294,0,0,0,,35294,-35294
8,02/23/2018,60,14:45,15:00,,28.42,3,31.42,25.42,-1,-71087,129120,200207,58033,0,-32564,0,0,0,,32564,-32564
8,02/23/2018,61,15:00,15:15,,-75.48,3,-72.48,-78.48,-1,-57296,155166,212462,97870,0,-52635,0,0,0,,52635,-52635
8,02/23/2018,62,15:15,15:30,,13.39,3,16.39,10.39,-1,-76280,147463,223743,71183,0,-35606,0,0,0,,35606,-35606
8,02/23/2018,63,15:30,15:45,,4.01,3,7.01,1.01,-1,-86799,121612,208411,34813,0,-34369,0,0,0,,34369,-34369
8,02/23/2018,64,15:45,16:00,39.63,34.64,3,42.63,31.64,2,-72126,96774,168900,24648,0,-2785,48,0,0,,2833,-2737
8,02/23/2018,65,16:00,16:15,,1.26,3,4.26,-1.74,-1,-38793,112838,151631,74045,0,-18826,0,0,0,,18826,-18826
8,02/23/2018,66,16:15,16:30,,38.64,3,41.64,35.64,-1,-52032,81644,133676,29612,0,-15518,0,0,0,,15518,-15518
8,02/23/2018,67,16:30,16:45,49.28,38.64,3,52.28,46.28,1,-79840,55383,135223,-24457,0,-1882,2091,0,0,,3973,209
8,02/23/2018,68,16:45,17:00,98.55,,3,101.55,95.55,1,-100500,44666,145166,-55834,0,0,38157,0,0,,38157,38157
8,02/23/2018,69,17:00,17:15,98.55,16.88,3,19.88,13.88,-1,-45962,88612,134574,42650,0,-5838,13402,0,0,,19240,7564
8,02/23/2018,70,17:15,17:30,,38.21,3,41.21,35.21,-1,-54377,68912,123289,14535,0,-2721,0,0,0,,2721,-2721
8,02/23/2018,71,17:30,17:45,,37.03,3,40.03,34.03,-1,-55602,70292,125894,14690,0,-3030,0,0,0,,3030,-3030
8,02/23/2018,72,17:45,18:00,,39.03,3,42.03,36.03,-1,-60134,83697,143831,23563,0,-1456,0,0,0,,1456,-1456
8,02/23/2018,73,18:00,18:15,,35.61,3,38.61,32.61,-1,-47514,63460,110974,15946,0,-5888,0,0,0,,5888,-5888
8,02/23/2018,74,18:15,18:30,,38.64,3,41.64,35.64,-1,-48159,61155,109314,12996,0,-3012,0,0,0,,3012,-3012
8,02/23/2018,75,18:30,18:45,56.87,38.64,3,59.87,53.87,1,-83897,39785,123682,-44112,0,-38,4330,0,0,,4368,4292
8,02/23/2018,76,18:45,19:00,56.87,,3,59.87,53.87,1,-73759,50908,124667,-22851,0,0,8497,0,0,,8497,8497
8,02/23/2018,77,19:00,19:15,57.3,,3,60.3,54.3,1,-48343,26990,75333,-21353,0,0,14973,0,0,,14973,14973
8,02/23/2018,78,19:15,19:30,32.77,34.64,3,37.64,31.64,-1,-34450,54865,89315,20415,0,-1431,5315,0,0,,6746,3884
8,02/23/2018,79,19:30,19:45,,26.67,3,29.67,23.67,-1,-42079,74610,116689,32531,0,-17543,0,0,0,,17543,-17543
8,02/23/2018,80,19:45,20:00,42.38,36.64,3,45.38,32.53,2,-83159,67794,150953,-15365,0,-14226,786,0,0,,15012,-13440
8,02/23/2018,81,20:00,20:15,239.02,36.64,3,242.02,236.02,1,-81656,16492,98148,-65164,0,-144,14845,0,0,,14989,14701
8,02/23/2018,82,20:15,20:30,53.14,,3,56.14,50.14,1,-69514,23703,93217,-45811,0,0,26810,0,0,,26810,26810
8,02/23/2018,83,20:30,20:45,35.02,37.82,3,40.82,34.82,-1,-45399,39475,84874,-5924,0,-67,5083,0,0,,5150,5016
8,02/23/2018,84,20:45,21:00,,25.52,3,28.52,22.52,-1,-39382,84145,123527,44763,0,-22816,0,0,0,,22816,-22816
8,02/23/2018,85,21:00,21:15,321.02,34.03,3,324.02,318.02,1,-150382,55253,205635,-95129,0,-14260,3724,0,0,,17984,-10536
8,02/23/2018,86,21:15,21:30,346.02,34.03,3,349.02,343.02,1,-100050,67592,167642,-32458,0,-11,40417,0,0,,40428,40406
8,02/23/2018,87,21:30,21:45,346.02,-7.49,3,-4.49,-10.49,-1,-46004,90285,136289,44281,0,-20925,994,0,0,,21919,-19931
8,02/23/2018,88,21:45,22:00,,3.52,3,6.52,0.52,-1,-38679,91088,129767,52409,0,-24829,0,0,0,,24829,-24829
8,02/23/2018,89,22:00,22:15,45.64,16.02,3,48.64,42.64,1,-64147,40311,104458,-23836,0,-20945,387,0,0,,21332,-20558
8,02/23/2018,90,22:15,22:30,50.84,39.8,3,53.84,33.14,2,-53995,46691,100686,-7304,0,-170,1532,0,0,,1702,1362
8,02/23/2018,91,22:30,22:45,,32.03,3,35.03,29.03,-1,-50541,73061,123602,22520,0,-9057,0,0,0,,9057,-9057
8,02/23/2018,92,22:45,23:00,,34.64,3,37.64,31.64,-1,-53390,72323,125713,18933,0,-11673,0,0,0,,11673,-11673
8,02/23/2018,93,23:00,23:15,,34.64,3,37.64,31.64,-1,-87737,70106,157843,-17631,0,-9072,0,0,0,,9072,-9072
8,02/23/2018,94,23:15,23:30,32.62,36.64,3,39.07,33.07,2,-64169,65321,129490,1152,0,-316,165,0,0,,481,-151
8,02/23/2018,95,23:30,23:45,,26.22,3,29.22,23.22,-1,-49984,73705,123689,23721,0,-12342,0,0,0,,12342,-12342
8,02/23/2018,96,23:45,0:00,,14.43,3,17.43,11.43,-1,-49551,104451,154002,54900,0,-25167,0,0,0,,25167,-25167
9,02/24/2018,1,0:00,0:15,40.68,31.43,3,43.68,37.68,1,-104918,98493,203411,-6425,0,-19055,420,0,0,,19475,-18635
9,02/24/2018,2,0:15,0:30,40.68,35.65,3,38.65,32.65,-1,-58994,88037,147031,29043,0,-2907,38,0,0,,2945,-2869
9,02/24/2018,3,0:30,0:45,,21.93,3,24.93,18.93,-1,-56791,63338,120129,6547,0,-19167,0,0,0,,19167,-19167
9,02/24/2018,4,0:45,1:00,32.12,21.93,3,35.12,29.12,1,-75330,74490,149820,-840,0,-2002,34,0,0,,2036,-1968
9,02/24/2018,5,1:00,1:15,38.75,44.78,3,41.95,35.95,2,-67562,67173,134735,-389,0,-38,137,0,0,,175,99
9,02/24/2018,6,1:15,1:30,40.77,,3,43.77,37.77,1,-52970,60586,113556,7616,0,0,383,0,0,,383,383
9,02/24/2018,7,1:30,1:45,,39.38,3,42.38,36.38,-1,-48774,62698,111472,13924,0,-3327,0,0,0,,3327,-3327
9,02/24/2018,8,1:45,2:00,,36.78,3,39.78,33.78,-1,-44640,66300,110940,21660,0,-10855,0,0,0,,10855,-10855
9,02/24/2018,9,2:00,2:15,42.99,40.78,3,45.99,35.95,2,-60712,53693,114405,-7019,0,-5824,1219,0,0,,7043,-4605
9,02/24/2018,10,2:15,2:30,41.38,,3,44.38,38.38,1,-64219,38724,102943,-25495,0,0,1882,0,0,,1882,1882
9,02/24/2018,11,2:30,2:45,64.4,,3,67.4,61.4,1,-73352,39444,112796,-33908,0,0,8594,0,0,,8594,8594
9,02/24/2018,12,2:45,3:00,41.57,26.91,3,29.91,23.91,-1,-28495,47972,76467,19477,0,-7729,5293,0,0,,13022,-2436
9,02/24/2018,13,3:00,3:15,41.38,37.78,3,44.38,33.39,2,-37662,41080,78742,3418,0,-10896,561,0,0,,11457,-10335
9,02/24/2018,14,3:15,3:30,41.38,38.22,3,41.22,35.22,-1,-36379,51803,88182,15424,0,-2172,5,0,0,,2177,-2167
9,02/24/2018,15,3:30,3:45,,31.25,3,34.25,28.25,-1,-36016,58034,94050,22018,0,-12402,0,0,0,,12402,-12402
9,02/24/2018,16,3:45,4:00,,31.25,3,34.25,28.25,-1,-35712,67214,102926,31502,0,-22014,0,0,0,,22014,-22014
9,02/24/2018,17,4:00,4:15,,35.38,3,38.38,32.38,-1,-34645,63338,97983,28693,0,-25803,0,0,0,,25803,-25803
9,02/24/2018,18,4:15,4:30,,37.64,3,40.64,34.64,-1,-35274,49127,84401,13853,0,-22021,0,0,0,,22021,-22021
9,02/24/2018,19,4:30,4:45,,38.38,3,41.38,35.38,-1,-34650,46675,81325,12025,0,-4267,0,0,0,,4267,-4267
9,02/24/2018,20,4:45,5:00,,38.38,3,41.38,35.38,-1,-34176,49191,83367,15015,0,-6086,0,0,0,,6086,-6086
9,02/24/2018,21,5:00,5:15,,27.51,3,30.51,24.51,-1,-31126,57383,88509,26257,0,-18962,0,0,0,,18962,-18962
9,02/24/2018,22,5:15,5:30,,37.26,3,40.26,34.26,-1,-29755,52244,81999,22489,0,-17698,0,0,0,,17698,-17698
9,02/24/2018,23,5:30,5:45,,30.78,3,33.78,27.78,-1,-30132,50152,80284,20020,0,-23013,0,0,0,,23013,-23013
9,02/24/2018,24,5:45,6:00,,36.75,3,39.75,33.75,-1,-38008,44400,82408,6392,0,-8757,0,0,0,,8757,-8757
9,02/24/2018,25,6:00,6:15,,-33.29,3,-30.29,-36.29,-1,-29166,69501,98667,40335,0,-31055,0,0,0,,31055,-31055
9,02/24/2018,26,6:15,6:30,45.68,36.46,3,48.68,33.46,2,-29203,41412,70615,12209,0,-4713,888,0,0,,5601,-3825
9,02/24/2018,27,6:30,6:45,47.97,42.68,3,50.97,35.35,2,-46499,38205,84704,-8294,0,-2304,1118,0,0,,3422,-1186
9,02/24/2018,28,6:45,7:00,69.12,,3,72.12,66.12,1,-70714,44428,115142,-26286,0,0,18789,0,0,,18789,18789
9,02/24/2018,29,7:00,7:15,69.12,14.14,3,17.14,11.14,-1,-31721,63787,95508,32066,0,-10756,3254,0,0,,14010,-7502
9,02/24/2018,30,7:15,7:30,42.18,42.68,3,45.18,35.36,2,-53095,53888,106983,793,0,-1067,1181,0,0,,2248,114
9,02/24/2018,31,7:30,7:45,,25.92,3,28.92,22.92,-1,-61247,78312,139559,17065,0,-10938,0,0,0,,10938,-10938
9,02/24/2018,32,7:45,8:00,39.44,42.68,3,42.44,35.5,2,-76372,86722,163094,10350,0,-1624,29,0,0,,1653,-1595
9,02/24/2018,33,8:00,8:15,49.68,,3,52.68,46.68,1,-72659,55760,128419,-16899,0,0,6883,0,0,,6883,6883
9,02/24/2018,34,8:15,8:30,75.12,,3,78.12,72.12,1,-71338,43941,115279,-27397,0,0,7942,0,0,,7942,7942
9,02/24/2018,35,8:30,8:45,101.12,,3,104.12,98.12,1,-97695,60206,157901,-37489,0,0,37885,0,0,,37885,37885
9,02/24/2018,36,8:45,9:00,57.18,,3,60.18,54.18,1,-114853,74903,189756,-39950,0,0,35938,0,0,,35938,35938
9,02/24/2018,37,9:00,9:15,57.18,23.07,3,26.07,20.07,-1,-64493,87915,152408,23422,0,-4512,13998,0,0,,18510,9486
9,02/24/2018,38,9:15,9:30,,36.39,3,39.39,33.39,-1,-63208,86507,149715,23299,0,-9691,0,0,0,,9691,-9691
9,02/24/2018,39,9:30,9:45,,14.01,3,17.01,11.01,-1,-51475,89565,141040,38090,0,-33046,0,0,0,,33046,-33046
9,02/24/2018,40,9:45,10:00,,18.78,3,21.78,15.78,-1,-42214,75572,117786,33358,0,-40673,0,0,0,,40673,-40673
9,02/24/2018,41,10:00,10:15,,22.68,3,25.68,19.68,-1,-39239,99163,138402,59924,0,-38869,0,0,0,,38869,-38869
9,02/24/2018,42,10:15,10:30,,-10,3,-7,-13,-1,-51816,86131,137947,34315,0,-44516,0,0,0,,44516,-44516
9,02/24/2018,43,10:30,10:45,,-78.74,3,-75.74,-81.74,-1,-48948,109265,158213,60317,0,-37280,0,0,0,,37280,-37280
9,02/24/2018,44,10:45,11:00,,-23.51,3,-20.51,-26.51,-1,-59627,114086,173713,54459,0,-57285,0,0,0,,57285,-57285
9,02/24/2018,45,11:00,11:15,45.68,42.68,3,48.68,35.32,2,-76067,57049,133116,-19018,0,-10253,1086,0,0,,11339,-9167
9,02/24/2018,46,11:15,11:30,,11.69,3,14.69,8.69,-1,-50176,90638,140814,40462,0,-22430,0,0,0,,22430,-22430
9,02/24/2018,47,11:30,11:45,,37.78,3,40.78,34.78,-1,-54086,118131,172217,64045,0,-21967,0,0,0,,21967,-21967
9,02/24/2018,48,11:45,12:00,,-7.1,3,-4.1,-10.1,-1,-39253,131098,170351,91845,0,-6262,0,0,0,,6262,-6262
9,02/24/2018,49,12:00,12:15,,-60.97,3,-57.97,-63.97,-1,-60313,63589,123902,3276,0,-20219,0,0,0,,20219,-20219
9,02/24/2018,50,12:15,12:30,,-20.78,3,-17.78,-23.78,-1,-39311,91632,130943,52321,0,-18354,0,0,0,,18354,-18354
9,02/24/2018,51,12:30,12:45,,30.32,3,33.32,27.32,-1,-43779,97432,141211,53653,0,-14882,0,0,0,,14882,-14882
9,02/24/2018,52,12:45,13:00,,-26.78,3,-23.78,-29.78,-1,-45184,95657,140841,50473,0,-32302,0,0,0,,32302,-32302
9,02/24/2018,53,13:00,13:15,,38.42,3,41.42,35.42,-1,-64222,106645,170867,42423,0,-12247,0,0,0,,12247,-12247
9,02/24/2018,54,13:15,13:30,,22.78,3,25.78,19.78,-1,-63187,109028,172215,45841,0,-19561,0,0,0,,19561,-19561
9,02/24/2018,55,13:30,13:45,,12.78,3,15.78,9.78,-1,-70147,107220,177367,37073,0,-34309,0,0,0,,34309,-34309
9,02/24/2018,56,13:45,14:00,52.12,38.78,3,55.12,49.12,1,-96420,78457,174877,-17963,0,-11438,4048,0,0,,15486,-7390
9,02/24/2018,57,14:00,14:15,58.93,38.78,3,61.93,55.93,1,-100928,62259,163187,-38669,0,-85,7270,0,0,,7355,7185
9,02/24/2018,58,14:15,14:30,59.38,,3,62.38,56.38,1,-136132,50931,187063,-85201,0,0,8873,0,0,,8873,8873
9,02/24/2018,59,14:30,14:45,67.4,,3,70.4,64.4,1,-150905,59113,210018,-91792,0,0,7688,0,0,,7688,7688
9,02/24/2018,60,14:45,15:00,44.44,,3,47.44,41.44,1,-137786,65482,203268,-72304,0,0,5275,0,0,,5275,5275
9,02/24/2018,61,15:00,15:15,44.44,-147.08,3,-144.08,-150.08,-1,-48815,135489,184304,86674,0,-23277,59,0,0,,23336,-23218
9,02/24/2018,62,15:15,15:30,,34.18,3,37.18,31.18,-1,-69047,95368,164415,26321,0,-15432,0,0,0,,15432,-15432
9,02/24/2018,63,15:30,15:45,41.8,34.18,3,44.8,38.8,1,-81098,93969,175067,12871,0,-3531,328,0,0,,3859,-3203
9,02/24/2018,64,15:45,16:00,,27.57,3,30.57,24.57,-1,-58658,101388,160046,42730,0,-2407,0,0,0,,2407,-2407
9,02/24/2018,65,16:00,16:15,96.12,27.57,3,99.12,93.12,1,-107211,71084,178295,-36127,0,-251,14647,0,0,,14898,14396
9,02/24/2018,66,16:15,16:30,49.68,,3,52.68,46.68,1,-89362,67039,156401,-22323,0,0,23527,0,0,,23527,23527
9,02/24/2018,67,16:30,16:45,138.12,,3,141.12,135.12,1,-102631,50595,153226,-52036,0,0,37479,0,0,,37479,37479
9,02/24/2018,68,16:45,17:00,222.12,,3,225.12,219.12,1,-117606,62293,179899,-55313,0,0,64238,0,0,,64238,64238
9,02/24/2018,69,17:00,17:15,49.68,40.13,3,43.13,37.13,-1,-86218,84225,170443,-1993,0,-3,18949,0,0,,18952,18946
9,02/24/2018,70,17:15,17:30,254.12,,3,257.12,251.12,1,-104977,46336,151313,-58641,0,0,19686,0,0,,19686,19686
9,02/24/2018,71,17:30,17:45,254.12,,3,257.12,251.12,1,-144842,39490,184332,-105352,0,0,88669,0,0,,88669,88669
9,02/24/2018,72,17:45,18:00,254.12,,3,257.12,251.12,1,-157761,46088,203849,-111673,0,0,105855,0,0,,105855,105855
9,02/24/2018,73,18:00,18:15,274.22,-113.14,3,-110.14,-116.14,-1,-57072,83082,140154,26010,0,-5038,52855,17500,0,,75393,65317
9,02/24/2018,74,18:15,18:30,269.12,-117.32,3,272.12,-120.32,2,-106884,38748,145632,-68136,0,-14468,11079,0,0,,25547,-3389
9,02/24/2018,75,18:30,18:45,269.12,,3,272.12,266.12,1,-131708,55612,187320,-76096,0,0,75343,0,0,,75343,75343
9,02/24/2018,76,18:45,19:00,80.22,,3,83.22,77.22,1,-97134,56602,153736,-40532,0,0,42176,0,0,,42176,42176
9,02/24/2018,77,19:00,19:15,49.82,36.5,3,39.5,33.5,-1,-72641,75250,147891,2609,0,-240,20882,0,0,,21122,20642
9,02/24/2018,78,19:15,19:30,45.68,35.69,3,48.68,32.69,2,-74734,67640,142374,-7094,0,-910,1774,0,0,,2684,864
9,02/24/2018,79,19:30,19:45,42.81,,3,45.81,39.81,1,-73462,68482,141944,-4980,0,0,1720,0,0,,1720,1720
9,02/24/2018,80,19:45,20:00,40.32,42.68,3,43.32,35.49,2,-60683,76263,136946,15580,0,-455,352,0,0,,807,-103
9,02/24/2018,81,20:00,20:15,248.12,43.68,3,251.12,245.12,1,-120512,59052,179564,-61460,0,-263,18330,0,0,,18593,18067
9,02/24/2018,82,20:15,20:30,71.1,,3,74.1,68.1,1,-83357,75199,158556,-8158,0,0,23938,0,0,,23938,23938
9,02/24/2018,83,20:30,20:45,71.1,36.69,3,39.69,33.69,-1,-53907,70361,124268,16454,0,-3936,467,0,0,,4403,-3469
9,02/24/2018,84,20:45,21:00,,10.12,3,13.12,7.12,-1,-47706,76616,124322,28910,0,-24585,0,0,0,,24585,-24585
9,02/24/2018,85,21:00,21:15,41.82,36.5,3,44.82,38.82,1,-67176,69467,136643,2291,0,-11518,546,0,0,,12064,-10972
9,02/24/2018,86,21:15,21:30,,,3,41.27,35.27,0,-53875,62451,116326,8576,0,0,1,0,0,,1,1
9,02/24/2018,87,21:30,21:45,,35.65,3,38.65,32.65,-1,-49686,74228,123914,24542,0,-1572,0,0,0,,1572,-1572
9,02/24/2018,88,21:45,22:00,,30.3,3,33.3,27.3,-1,-40368,84425,124793,44057,0,-22426,0,0,0,,22426,-22426
9,02/24/2018,89,22:00,22:15,232.12,36.49,3,235.12,229.12,1,-91396,31683,123079,-59713,0,-12926,12175,0,0,,25101,-751
9,02/24/2018,90,22:15,22:30,232.12,,3,235.12,229.12,1,-64282,51701,115983,-12581,0,0,33945,0,0,,33945,33945
9,02/24/2018,91,22:30,22:45,232.12,17.65,3,20.65,14.65,-1,-50222,63482,113704,13260,0,-10640,787,0,0,,11427,-9853
9,02/24/2018,92,22:45,23:00,47.11,39.43,3,50.11,35.24,2,-42716,51818,94534,9102,0,-1319,1835,0,0,,3154,516
9,02/24/2018,93,23:00,23:15,,28.78,3,31.78,25.78,-1,-59222,72348,131570,13126,0,-11443,0,0,0,,11443,-11443
9,02/24/2018,94,23:15,23:30,,38.6,3,41.6,35.6,-1,-44941,59209,104150,14268,0,-8251,0,0,0,,8251,-8251
9,02/24/2018,95,23:30,23:45,,34.42,3,37.42,31.42,-1,-29797,56275,86072,26478,0,-14590,0,0,0,,14590,-14590
9,02/24/2018,96,23:45,0:00,,25.6,3,28.6,22.6,-1,-30108,51822,81930,21714,0,-20462,0,0,0,,20462,-20462
9,02/25/2018,1,0:00,0:15,,-9.36,3,-6.36,-12.36,-1,-67899,112614,180513,44715,0,-24516,0,0,0,,24516,-24516
9,02/25/2018,2,0:15,0:30,,,3,41.02,35.02,0,-45551,65340,110891,19789,0,-2301,0,0,0,,2301,-2301
9,02/25/2018,3,0:30,0:45,,42.03,3,45.03,39.03,-1,-31439,53537,84976,22098,0,-2143,0,0,0,,2143,-2143
9,02/25/2018,4,0:45,1:00,,29.65,3,32.65,26.65,-1,-27856,64405,92261,36549,0,-12817,0,0,0,,12817,-12817
9,02/25/2018,5,1:00,1:15,53.45,39.51,3,56.45,35.28,2,-86578,46648,133226,-39930,0,-8271,2497,0,0,,10768,-5774
9,02/25/2018,6,1:15,1:30,36.46,39.51,3,39.46,33.46,1,-63658,53829,117487,-9829,0,-11,859,0,0,,870,848
9,02/25/2018,7,1:30,1:45,46.02,,3,49.02,43.02,1,-53366,52360,105726,-1006,0,0,1705,0,0,,1705,1705
9,02/25/2018,8,1:45,2:00,32.46,,3,35.46,29.46,1,-50907,48960,99867,-1947,0,0,5,0,0,,5,5
9,02/25/2018,9,2:00,2:15,,30.24,3,33.24,27.24,-1,-43624,59365,102989,15741,0,-5415,0,0,0,,5415,-5415
9,02/25/2018,10,2:15,2:30,42.28,44.02,3,45.28,39.28,1,-56778,42463,99241,-14315,0,-615,182,0,0,,797,-433
9,02/25/2018,11,2:30,2:45,33.33,39.51,3,42.51,36.51,-1,-45648,53065,98713,7417,0,-648,246,0,0,,894,-402
9,02/25/2018,12,2:45,3:00,,39.55,3,42.55,36.55,-1,-46548,50296,96844,3748,0,-1963,0,0,0,,1963,-1963
9,02/25/2018,13,3:00,3:15,,43.02,3,46.02,40.02,-1,-47683,67208,114891,19525,0,-100,0,0,0,,100,-100
9,02/25/2018,14,3:15,3:30,,,3,41.32,35.32,0,-41554,50716,92270,9162,0,0,0,0,0,,0,0
9,02/25/2018,15,3:30,3:45,,44.02,3,47.02,41.02,-1,-38772,54688,93460,15916,0,-619,0,0,0,,619,-619
9,02/25/2018,16,3:45,4:00,,44.02,3,47.02,41.02,-1,-35162,47095,82257,11933,0,-143,0,0,0,,143,-143
9,02/25/2018,17,4:00,4:15,,44.02,3,47.02,41.02,-1,-36061,100166,136227,64105,0,-1404,0,0,0,,1404,-1404
9,02/25/2018,18,4:15,4:30,,44.02,3,47.02,41.02,-1,-38673,98984,137657,60311,0,-45,0,0,0,,45,-45
9,02/25/2018,19,4:30,4:45,,,3,41.35,35.35,0,-39585,85934,125519,46349,0,0,0,0,0,,0,0
9,02/25/2018,20,4:45,5:00,,,3,41.35,35.35,0,-40339,97517,137856,57178,0,0,0,0,0,,0,0
9,02/25/2018,21,5:00,5:15,,,3,41.36,35.36,0,-32924,105684,138608,72760,0,0,0,0,0,,0,0
9,02/25/2018,22,5:15,5:30,,,3,41.37,35.37,0,-32293,94086,126379,61793,0,0,0,0,0,,0,0
9,02/25/2018,23,5:30,5:45,,,3,41.37,35.37,0,-35842,91525,127367,55683,0,0,0,0,0,,0,0
9,02/25/2018,24,5:45,6:00,,,3,41.35,35.35,0,-43743,72875,116618,29132,0,0,0,0,0,,0,0
9,02/25/2018,25,6:00,6:15,,31.8,3,34.8,28.8,-1,-30559,126359,156918,95800,0,-2131,0,0,0,,2131,-2131
9,02/25/2018,26,6:15,6:30,,17.17,3,20.17,14.17,-1,-37679,95745,133424,58066,0,-8079,0,0,0,,8079,-8079
9,02/25/2018,27,6:30,6:45,,44.04,3,47.04,41.04,-1,-60255,64184,124439,3929,0,-817,0,0,0,,817,-817
9,02/25/2018,28,6:45,7:00,,,3,41.42,35.42,0,-78392,58499,136891,-19893,0,0,0,0,0,,0,0
9,02/25/2018,29,7:00,7:15,33.44,,3,36.44,30.44,1,-74900,67870,142770,-7030,0,0,88,0,0,,88,88
9,02/25/2018,30,7:15,7:30,35.12,,3,38.12,32.12,1,-81346,68566,149912,-12780,0,0,802,0,0,,802,802
9,02/25/2018,31,7:30,7:45,43.46,,3,46.46,40.46,1,-97315,58166,155481,-39149,0,0,2006,0,0,,2006,2006
9,02/25/2018,32,7:45,8:00,99.43,,3,102.43,96.43,1,-109024,55924,164948,-53100,0,0,12875,0,0,,12875,12875
9,02/25/2018,33,8:00,8:15,,,3,41.39,35.39,0,-50511,89181,139692,38670,0,0,1927,0,0,,1927,1927
9,02/25/2018,34,8:15,8:30,,,3,41.41,35.41,0,-71275,70760,142035,-515,0,0,0,0,0,,0,0
9,02/25/2018,35,8:30,8:45,,,3,41.44,35.44,0,-83362,66064,149426,-17298,0,0,0,0,0,,0,0
9,02/25/2018,36,8:45,9:00,40.35,,3,43.35,37.35,1,-82649,65681,148330,-16968,0,0,1222,0,0,,1222,1222
9,02/25/2018,37,9:00,9:15,,,3,41.41,35.41,0,-94555,61721,156276,-32834,0,0,0,0,0,,0,0
9,02/25/2018,38,9:15,9:30,32.83,,3,35.83,29.83,1,-95672,63633,159305,-32039,0,0,95,0,0,,95,95
9,02/25/2018,39,9:30,9:45,32.89,,3,35.89,29.89,1,-101370,47972,149342,-53398,0,0,218,0,0,,218,218
9,02/25/2018,40,9:45,10:00,32.88,,3,35.88,29.88,1,-96984,61571,158555,-35413,0,0,16,0,0,,16,16
9,02/25/2018,41,10:00,10:15,32.82,,3,35.82,29.82,1,-120144,52226,172370,-67918,0,0,95,0,0,,95,95
9,02/25/2018,42,10:15,10:30,32.85,,3,35.85,29.85,1,-97499,57104,154603,-40395,0,0,47,0,0,,47,47
9,02/25/2018,43,10:30,10:45,,43.04,3,46.04,40.04,-1,-79967,84769,164736,4802,0,-418,0,0,0,,418,-418
9,02/25/2018,44,10:45,11:00,,19.51,3,22.51,16.51,-1,-71423,110230,181653,38807,0,-19402,0,0,0,,19402,-19402
9,02/25/2018,45,11:00,11:15,42.28,39.04,3,45.28,39.28,1,-86937,72443,159380,-14494,0,-10287,549,0,0,,10836,-9738
9,02/25/2018,46,11:15,11:30,34.41,44.04,3,47.04,41.04,-1,-80760,90879,171639,10119,0,-8,700,0,0,,708,692
9,02/25/2018,47,11:30,11:45,,43.04,3,46.04,40.04,-1,-88988,94666,183654,5678,0,-1511,0,0,0,,1511,-1511
9,02/25/2018,48,11:45,12:00,,44.04,3,47.04,41.04,-1,-97244,90992,188236,-6252,0,-538,0,0,0,,538,-538
9,02/25/2018,49,12:00,12:15,94.11,44.04,3,97.11,91.11,1,-107641,81780,189421,-25861,0,-158,10119,0,0,,10277,9961
9,02/25/2018,50,12:15,12:30,95.11,,3,98.11,92.11,1,-108592,88430,197022,-20162,0,0,29851,0,0,,29851,29851
9,02/25/2018,51,12:30,12:45,95.11,43.04,3,46.04,40.04,-1,-106517,112741,219258,6224,0,-188,5154,0,0,,5342,4966
9,02/25/2018,52,12:45,13:00,,43.04,3,46.04,40.04,-1,-107493,112349,219842,4856,0,-49,0,0,0,,49,-49
9,02/25/2018,53,13:00,13:15,,27.22,3,30.22,24.22,-1,-86189,117287,203476,31098,0,-5024,0,0,0,,5024,-5024
9,02/25/2018,54,13:15,13:30,,36.51,3,39.51,33.51,-1,-82425,109037,191462,26612,0,-13644,0,0,0,,13644,-13644
9,02/25/2018,55,13:30,13:45,,24.68,3,27.68,21.68,-1,-69625,117577,187202,47952,0,-8169,0,0,0,,8169,-8169
9,02/25/2018,56,13:45,14:00,,-57.24,3,-54.24,-60.24,-1,-71012,94014,165026,23002,0,-26543,0,0,0,,26543,-26543
9,02/25/2018,57,14:00,14:15,,-160.51,3,-157.51,-163.51,-1,-59622,116944,176566,57322,0,-24730,0,0,0,,24730,-24730
9,02/25/2018,58,14:15,14:30,,25.51,3,28.51,22.51,-1,-83926,115463,199389,31537,0,-8099,0,0,0,,8099,-8099
9,02/25/2018,59,14:30,14:45,,-5.27,3,-2.27,-8.27,-1,-90410,106049,196459,15639,0,-19144,0,0,0,,19144,-19144
9,02/25/2018,60,14:45,15:00,,38.7,3,41.7,35.7,-1,-87719,103956,191675,16237,0,-1669,0,0,0,,1669,-1669
9,02/25/2018,61,15:00,15:15,,30.7,3,33.7,27.7,-1,-74119,100945,175064,26826,0,-1740,0,0,0,,1740,-1740
9,02/25/2018,62,15:15,15:30,,44.04,3,47.04,41.04,-1,-80306,107207,187513,26901,0,-1846,0,0,0,,1846,-1846
9,02/25/2018,63,15:30,15:45,,35.63,3,38.63,32.63,-1,-70378,116567,186945,46189,0,-5028,0,0,0,,5028,-5028
9,02/25/2018,64,15:45,16:00,,43.04,3,46.04,40.04,-1,-65814,88869,154683,23055,0,-3235,0,0,0,,3235,-3235
9,02/25/2018,65,16:00,16:15,,-160.51,3,-157.51,-163.51,-1,-19826,181327,201153,161501,0,-30358,0,0,0,,30358,-30358
9,02/25/2018,66,16:15,16:30,,3.29,3,6.29,0.29,-1,-60949,117649,178598,56700,0,-44903,0,0,0,,44903,-44903
9,02/25/2018,67,16:30,16:45,34.82,3.29,3,37.82,31.82,1,-70362,73376,143738,3014,0,-5096,11,0,0,,5107,-5085
9,02/25/2018,68,16:45,17:00,36.1,,3,39.1,33.1,1,-83367,91929,175296,8562,0,0,618,0,0,,618,618
9,02/25/2018,69,17:00,17:15,,30.98,3,33.98,27.98,-1,-98909,114845,213754,15936,0,-4992,0,0,0,,4992,-4992
9,02/25/2018,70,17:15,17:30,,34.65,3,37.65,31.65,-1,-96949,126183,223132,29234,0,-10121,0,0,0,,10121,-10121
9,02/25/2018,71,17:30,17:45,,38.51,3,41.51,35.51,-1,-101271,125640,226911,24369,0,-5191,0,0,0,,5191,-5191
9,02/25/2018,72,17:45,18:00,,,3,41.2,35.2,0,-87737,114952,202689,27215,0,-181,0,0,0,,181,-181
9,02/25/2018,73,18:00,18:15,,-25.74,3,-22.74,-28.74,-1,-43742,96979,140721,53237,0,-18229,0,0,0,,18229,-18229
9,02/25/2018,74,18:15,18:30,,36.51,3,39.51,33.51,-1,-64750,82717,147467,17967,0,-13275,0,0,0,,13275,-13275
9,02/25/2018,75,18:30,18:45,44.63,36.51,3,47.63,41.63,1,-88013,62682,150695,-25331,0,-178,428,0,0,,606,250
9,02/25/2018,76,18:45,19:00,112.97,,3,115.97,109.97,1,-75780,51661,127441,-24119,0,0,19227,0,0,,19227,19227
9,02/25/2018,77,19:00,19:15,42.07,44.04,3,47.04,41.04,-1,-69562,72752,142314,3190,0,-62,8040,0,0,,8102,7978
9,02/25/2018,78,19:15,19:30,42.07,44.04,3,47.04,41.04,-1,-52840,101156,153996,48316,0,-1268,28,0,0,,1296,-1240
9,02/25/2018,79,19:30,19:45,,44.04,3,47.04,41.04,-1,-47116,127751,174867,80635,0,-61,0,0,0,,61,-61
9,02/25/2018,80,19:45,20:00,,14.78,3,17.78,11.78,-1,-45406,125549,170955,80143,0,-8606,0,0,0,,8606,-8606
9,02/25/2018,81,20:00,20:15,,36.56,3,39.56,33.56,-1,-70165,54014,124179,-16151,0,-7761,0,0,0,,7761,-7761
9,02/25/2018,82,20:15,20:30,,32.77,3,35.77,29.77,-1,-52089,76145,128234,24056,0,-1730,0,0,0,,1730,-1730
9,02/25/2018,83,20:30,20:45,,11.81,3,14.81,8.81,-1,-45953,101210,147163,55257,0,-17475,0,0,0,,17475,-17475
9,02/25/2018,84,20:45,21:00,,6.95,3,9.95,3.95,-1,-48329,107010,155339,58681,0,-43256,0,0,0,,43256,-43256
9,02/25/2018,85,21:00,21:15,38.37,32.05,3,41.37,35.37,1,-72265,58231,130496,-14034,0,-19599,55,0,0,,19654,-19544
9,02/25/2018,86,21:15,21:30,,,3,41.03,35.03,0,-63603,62811,126414,-792,0,-8,1,0,0,,9,-7
9,02/25/2018,87,21:30,21:45,,,3,40.97,34.97,0,-51193,73152,124345,21959,0,0,0,0,0,,0,0
9,02/25/2018,88,21:45,22:00,,36.99,3,39.99,33.99,-1,-42301,90843,133144,48542,0,-270,0,0,0,,270,-270
9,02/25/2018,89,22:00,22:15,,36.3,3,39.3,33.3,-1,-91872,59812,151684,-32060,0,-661,0,0,0,,661,-661
9,02/25/2018,90,22:15,22:30,,,3,41.01,35.01,0,-72061,68610,140671,-3451,0,0,0,0,0,,0,0
9,02/25/2018,91,22:30,22:45,,,3,41.01,35.01,0,-56871,97039,153910,40168,0,0,0,0,0,,0,0
9,02/25/2018,92,22:45,23:00,,37,3,40,34,-1,-59059,127945,187004,68886,0,-519,0,0,0,,519,-519
9,02/25/2018,93,23:00,23:15,,24.94,3,27.94,21.94,-1,-61143,86694,147837,25551,0,-12414,0,0,0,,12414,-12414
9,02/25/2018,94,23:15,23:30,,14.54,3,17.54,11.54,-1,-56309,90516,146825,34207,0,-20408,0,0,0,,20408,-20408
9,02/25/2018,95,23:30,23:45,,-15.51,3,-12.51,-18.51,-1,-63759,86494,150253,22735,0,-36870,0,0,0,,36870,-36870
9,02/25/2018,96,23:45,0:00,,-5.96,3,-2.96,-8.96,-1,-60623,105182,165805,44559,0,-20060,0,0,0,,20060,-20060
9,02/26/2018,1,0:00,0:15,350.12,-49.78,3,353.12,-52.78,2,-104322,69676,173998,-34646,0,-22413,4325,0,0,,26738,-18088
9,02/26/2018,2,0:15,0:30,41.09,-49.78,3,44.09,38.09,1,-112077,86390,198467,-25687,0,-76,6326,0,0,,6402,6250
9,02/26/2018,3,0:30,0:45,,,3,40.86,34.86,0,-101692,99458,201150,-2234,0,0,2,0,0,,2,2
9,02/26/2018,4,0:45,1:00,,33.34,3,36.34,30.34,-1,-107236,119434,226670,12198,0,-708,0,0,0,,708,-708
9,02/26/2018,5,1:00,1:15,,26.74,3,29.74,23.74,-1,-85951,91644,177595,5693,0,-3770,0,0,0,,3770,-3770
9,02/26/2018,6,1:15,1:30,,37.43,3,40.43,34.43,-1,-77496,89598,167094,12102,0,-6399,0,0,0,,6399,-6399
9,02/26/2018,7,1:30,1:45,37.6,43.04,3,40.6,34.6,1,-81748,75649,157397,-6099,0,-3227,133,0,0,,3360,-3094
9,02/26/2018,8,1:45,2:00,37.6,,3,40.6,34.6,1,-88272,73460,161732,-14812,0,0,1566,0,0,,1566,1566
9,02/26/2018,9,2:00,2:15,163.12,,3,166.12,160.12,1,-98334,56042,154376,-42292,0,0,17539,0,0,,17539,17539
9,02/26/2018,10,2:15,2:30,46.04,,3,49.04,43.04,1,-78730,48996,127726,-29734,0,0,18072,0,0,,18072,18072
9,02/26/2018,11,2:30,2:45,,,3,40.85,34.85,0,-87318,52627,139945,-34691,0,0,666,0,0,,666,666
9,02/26/2018,12,2:45,3:00,,,3,40.85,34.85,0,-96311,44465,140776,-51846,0,0,0,0,0,,0,0
9,02/26/2018,13,3:00,3:15,350.12,,3,353.12,347.12,1,-104689,47732,152421,-56957,0,0,17136,0,0,,17136,17136
9,02/26/2018,14,3:15,3:30,46.04,,3,49.04,43.04,1,-77614,52168,129782,-25446,0,0,21803,0,0,,21803,21803
9,02/26/2018,15,3:30,3:45,48.86,,3,51.86,45.86,1,-76749,42131,118880,-34618,0,0,11968,0,0,,11968,11968
9,02/26/2018,16,3:45,4:00,38.56,,3,41.56,35.56,1,-77549,45164,122713,-32385,0,0,9690,0,0,,9690,9690
9,02/26/2018,17,4:00,4:15,31.81,,3,34.81,28.81,1,-95426,33036,128462,-62390,0,0,2379,0,0,,2379,2379
9,02/26/2018,18,4:15,4:30,31.81,,3,34.81,28.81,1,-87659,24274,111933,-63385,0,0,588,0,0,,588,588
9,02/26/2018,19,4:30,4:45,31.67,,3,34.67,28.67,1,-104392,39656,144048,-64736,0,0,205,0,0,,205,205
9,02/26/2018,20,4:45,5:00,,,3,40.86,34.86,0,-108805,64527,173332,-44278,0,0,0,0,0,,0,0
9,02/26/2018,21,5:00,5:15,,,3,41.23,35.23,0,-109970,89094,199064,-20876,0,0,0,0,0,,0,0
9,02/26/2018,22,5:15,5:30,38.02,,3,41.02,35.02,1,-76656,70411,147067,-6245,0,0,469,0,0,,469,469
9,02/26/2018,23,5:30,5:45,38.02,43.04,3,46.04,40.04,-1,-47973,71542,119515,23569,0,-1007,242,0,0,,1249,-765
9,02/26/2018,24,5:45,6:00,,43.04,3,46.04,40.04,-1,-81024,82175,163199,1151,0,-1360,0,0,0,,1360,-1360
9,02/26/2018,25,6:00,6:15,,-31.69,3,-28.69,-34.69,-1,-103552,158678,262230,55126,0,-21810,0,0,0,,21810,-21810
9,02/26/2018,26,6:15,6:30,,34.46,3,37.46,31.46,-1,-97308,104758,202066,7450,0,-14757,0,0,0,,14757,-14757
9,02/26/2018,27,6:30,6:45,38.19,34.46,3,41.19,35.19,1,-107081,85995,193076,-21086,0,-3154,470,0,0,,3624,-2684
9,02/26/2018,28,6:45,7:00,80.11,,3,83.11,77.11,1,-117693,76666,194359,-41027,0,0,7479,0,0,,7479,7479
9,02/26/2018,29,7:00,7:15,40.66,-119.97,3,44.76,-122.97,2,-79285,164545,243830,85260,0,-19235,4677,0,0,,23912,-14558
9,02/26/2018,30,7:15,7:30,,28.85,3,31.85,25.85,-1,-50493,106498,156991,56005,0,-17587,0,0,0,,17587,-17587
9,02/26/2018,31,7:30,7:45,,24.62,3,27.62,21.62,-1,-49745,66460,116205,16715,0,-20853,0,0,0,,20853,-20853
9,02/26/2018,32,7:45,8:00,39.85,24.62,3,42.85,36.85,1,-91878,39999,131877,-51879,0,-2408,608,0,0,,3016,-1800
9,02/26/2018,33,8:00,8:15,38.1,24.62,3,45.12,21.62,2,-49792,74973,124765,25181,0,-5976,28,0,0,,6004,-5948
9,02/26/2018,34,8:15,8:30,68.11,24.62,3,71.11,65.11,1,-73683,47752,121435,-25931,0,-53,12879,0,0,,12932,12826
9,02/26/2018,35,8:30,8:45,52.14,,3,55.14,49.14,1,-71438,41224,112662,-30214,0,0,29153,0,0,,29153,29153
9,02/26/2018,36,8:45,9:00,42.35,,3,45.35,39.35,1,-73581,55891,129472,-17690,0,0,18143,0,0,,18143,18143
9,02/26/2018,37,9:00,9:15,173.11,,3,176.11,170.11,1,-113000,42308,155308,-70692,0,0,23702,0,0,,23702,23702
9,02/26/2018,38,9:15,9:30,44.56,24.96,3,27.96,21.96,-1,-64521,74495,139016,9974,0,-3154,11474,0,0,,14628,8320
9,02/26/2018,39,9:30,9:45,44.56,20.13,3,23.13,17.13,-1,-56698,90615,147313,33917,0,-24256,29,0,0,,24285,-24227
9,02/26/2018,40,9:45,10:00,,20.13,3,23.13,17.13,-1,-56854,119515,176369,62661,0,-40356,0,0,0,,40356,-40356
9,02/26/2018,41,10:00,10:15,,14.48,3,17.48,11.48,-1,-59740,102671,162411,42931,0,-46946,0,0,0,,46946,-46946
9,02/26/2018,42,10:15,10:30,,13.54,3,16.54,10.54,-1,-64076,129942,194018,65866,0,-53751,0,0,0,,53751,-53751
9,02/26/2018,43,10:30,10:45,,-118.25,3,-115.25,-121.25,-1,-65740,157256,222996,91516,0,-69170,0,0,0,,69170,-69170
9,02/26/2018,44,10:45,11:00,,-34.07,3,-31.07,-37.07,-1,-82075,160578,242653,78503,0,-70941,0,0,0,,70941,-70941
9,02/26/2018,45,11:00,11:15,,10.38,3,13.38,7.38,-1,-52521,106692,159213,54171,0,-39832,0,0,0,,39832,-39832
9,02/26/2018,46,11:15,11:30,,-15.06,3,-12.06,-18.06,-1,-50748,115673,166421,64925,0,-60175,0,0,0,,60175,-60175
9,02/26/2018,47,11:30,11:45,,-16.41,3,-13.41,-19.41,-1,-47710,132667,180377,84957,0,-56650,0,0,0,,56650,-56650
9,02/26/2018,48,11:45,12:00,,-27.14,3,-24.14,-30.14,-1,-71662,111427,183089,39765,0,-53932,0,0,0,,53932,-53932
9,02/26/2018,49,12:00,12:15,,32.52,3,35.52,29.52,-1,-98503,116671,215174,18168,0,-27015,0,0,0,,27015,-27015
9,02/26/2018,50,12:15,12:30,,36.82,3,39.82,33.82,-1,-88267,102678,190945,14411,0,-10877,0,0,0,,10877,-10877
9,02/26/2018,51,12:30,12:45,,28.71,3,31.71,25.71,-1,-88282,124760,213042,36478,0,-22953,0,0,0,,22953,-22953
9,02/26/2018,52,12:45,13:00,,33.22,3,36.22,30.22,-1,-99450,118742,218192,19292,0,-26474,0,0,0,,26474,-26474
9,02/26/2018,53,13:00,13:15,37.93,33.22,3,40.93,34.93,1,-106990,108896,215886,1906,0,-5378,185,0,0,,5563,-5193
9,02/26/2018,54,13:15,13:30,40.24,,3,43.24,37.24,1,-102357,89575,191932,-12782,0,0,2670,0,0,,2670,2670
9,02/26/2018,55,13:30,13:45,40.54,,3,43.54,37.54,1,-101552,82006,183558,-19546,0,0,3406,0,0,,3406,3406
9,02/26/2018,56,13:45,14:00,38.28,,3,41.28,35.28,1,-88819,82238,171057,-6581,0,0,2630,0,0,,2630,2630
9,02/26/2018,57,14:00,14:15,38.28,46.14,3,49.14,43.14,-1,-79329,80116,159445,787,0,-203,486,0,0,,689,283
9,02/26/2018,58,14:15,14:30,,40.65,3,43.65,37.65,-1,-77147,71775,148922,-5372,0,-1008,0,0,0,,1008,-1008
9,02/26/2018,59,14:30,14:45,,,3,42.12,36.12,0,-72652,66146,138798,-6506,0,0,0,0,0,,0,0
9,02/26/2018,60,14:45,15:00,40.48,,3,43.48,37.48,1,-78670,68184,146854,-10486,0,0,226,0,0,,226,226
9,02/26/2018,61,15:00,15:15,38.47,45.14,3,48.14,42.14,-1,-58079,92816,150895,34737,0,-689,522,0,0,,1211,-167
9,02/26/2018,62,15:15,15:30,,40.66,3,43.66,37.66,-1,-61395,84840,146235,23445,0,-986,0,0,0,,986,-986
9,02/26/2018,63,15:30,15:45,,,3,42.15,36.15,0,-68259,66422,134681,-1837,0,0,0,0,0,,0,0
9,02/26/2018,64,15:45,16:00,,,3,42.15,36.15,0,-98866,75652,174518,-23214,0,0,0,0,0,,0,0
9,02/26/2018,65,16:00,16:15,,,3,42.13,36.13,0,-84795,70106,154901,-14689,0,0,0,0,0,,0,0
9,02/26/2018,66,16:15,16:30,,,3,42.13,36.13,0,-91251,62889,154140,-28362,0,0,0,0,0,,0,0
9,02/26/2018,67,16:30,16:45,48.14,,3,51.14,45.14,1,-105656,35365,141021,-70291,0,0,545,0,0,,545,545
9,02/26/2018,68,16:45,17:00,251.11,,3,254.11,248.11,1,-122920,31163,154083,-91757,0,0,41675,0,0,,41675,41675
9,02/26/2018,69,17:00,17:15,251.11,36.1,3,39.1,33.1,-1,-70684,64297,134981,-6387,0,-57,14867,0,0,,14924,14810
9,02/26/2018,70,17:15,17:30,,,3,42.37,36.37,0,-78582,43442,122024,-35140,0,0,0,0,0,,0,0
9,02/26/2018,71,17:30,17:45,,,3,42.37,36.37,0,-68461,53671,122132,-14790,0,0,0,0,0,,0,0
9,02/26/2018,72,17:45,18:00,43,,3,46,40,1,-76499,75404,151903,-1095,0,0,1287,0,0,,1287,1287
9,02/26/2018,73,18:00,18:15,43,45.14,3,48.14,42.14,-1,-78127,67140,145267,-10987,0,-459,283,0,0,,742,-176
9,02/26/2018,74,18:15,18:30,40.69,30.67,3,43.69,27.67,2,-60260,76663,136923,16403,0,-7769,28,0,0,,7797,-7741
9,02/26/2018,75,18:30,18:45,54.58,30.67,3,57.58,51.58,1,-71982,52525,124507,-19457,0,-445,7487,0,0,,7932,7042
9,02/26/2018,76,18:45,19:00,57.26,,3,60.26,54.26,1,-79063,54443,133506,-24620,0,0,11479,0,0,,11479,11479
9,02/26/2018,77,19:00,19:15,57.26,32.91,3,35.91,29.91,-1,-60850,81812,142662,20962,0,-2874,2038,0,0,,4912,-836
9,02/26/2018,78,19:15,19:30,49.23,32.91,3,52.23,29.91,2,-61392,50020,111412,-11372,0,-5815,2531,0,0,,8346,-3284
9,02/26/2018,79,19:30,19:45,40.18,,3,43.18,37.18,1,-60953,52186,113139,-8767,0,0,4192,0,0,,4192,4192
9,02/26/2018,80,19:45,20:00,38.22,,3,41.22,35.22,1,-69734,54805,124539,-14929,0,0,1604,0,0,,1604,1604
9,02/26/2018,81,20:00,20:15,136.11,,3,139.11,133.11,1,-82661,36829,119490,-45832,0,0,18466,0,0,,18466,18466
9,02/26/2018,82,20:15,20:30,49.21,46.14,3,49.14,43.14,-1,-66381,52779,119160,-13602,0,-64,9682,0,0,,9746,9618
9,02/26/2018,83,20:30,20:45,,45.14,3,48.14,42.14,-1,-62956,29809,92765,-33147,0,-561,0,0,0,,561,-561
9,02/26/2018,84,20:45,21:00,,46.14,3,49.14,43.14,-1,-71231,47848,119079,-23383,0,-583,0,0,0,,583,-583
9,02/26/2018,85,21:00,21:15,,46.14,3,49.14,43.14,-1,-84461,33369,117830,-51092,0,-445,0,0,0,,445,-445
9,02/26/2018,86,21:15,21:30,52.14,,3,55.14,49.14,1,-60397,40445,100842,-19952,0,0,5085,0,0,,5085,5085
9,02/26/2018,87,21:30,21:45,39.46,36.62,3,39.62,33.62,-1,-51980,57167,109147,5187,0,-420,3402,0,0,,3822,2982
9,02/26/2018,88,21:45,22:00,,28.64,3,31.64,25.64,-1,-47892,84017,131909,36125,0,-19818,0,0,0,,19818,-19818
9,02/26/2018,89,22:00,22:15,41.27,17.52,3,44.69,14.52,2,-85857,41282,127139,-44575,0,-21412,156,0,0,,21568,-21256
9,02/26/2018,90,22:15,22:30,44.08,-32.8,3,47.08,-35.8,2,-50355,69807,120162,19452,0,-5257,670,0,0,,5927,-4587
9,02/26/2018,91,22:30,22:45,,-87.52,3,-84.52,-90.52,-1,-55474,98080,153554,42606,0,-32775,0,0,0,,32775,-32775
9,02/26/2018,92,22:45,23:00,,7.52,3,10.52,4.52,-1,-66118,128655,194773,62537,0,-40303,0,0,0,,40303,-40303
9,02/26/2018,93,23:00,23:15,49.38,7.52,3,52.38,46.38,1,-100514,49417,149931,-51097,0,-12768,1138,0,0,,13906,-11630
9,02/26/2018,94,23:15,23:30,,,3,44.66,38.66,0,-96546,68727,165273,-27819,0,0,0,0,0,,0,0
9,02/26/2018,95,23:30,23:45,,32.87,3,35.87,29.87,-1,-93257,102604,195861,9347,0,-1681,0,0,0,,1681,-1681
9,02/26/2018,96,23:45,0:00,,28.28,3,31.28,25.28,-1,-94845,122772,217617,27927,0,-13088,0,0,0,,13088,-13088
9,02/27/2018,1,0:00,0:15,292.02,28.28,3,295.02,289.02,1,-107597,41892,149489,-65705,0,-2667,19151,0,0,,21818,16484
9,02/27/2018,2,0:15,0:30,50.91,,3,53.91,47.91,1,-72399,54304,126703,-18095,0,0,16988,0,0,,16988,16988
9,02/27/2018,3,0:30,0:45,53.26,,3,56.26,50.26,1,-83645,55345,138990,-28300,0,0,18317,0,0,,18317,18317
9,02/27/2018,4,0:45,1:00,69.16,,3,72.16,66.16,1,-102672,56361,159033,-46311,0,0,26727,0,0,,26727,26727
9,02/27/2018,5,1:00,1:15,32.02,39.09,3,42.62,36.09,2,-72202,99935,172137,27733,0,-1021,10877,0,0,,11898,9856
9,02/27/2018,6,1:15,1:30,48.89,44.23,3,51.89,36.62,2,-68278,65079,133357,-3199,0,-331,559,0,0,,890,228
9,02/27/2018,7,1:30,1:45,48.89,34.33,3,37.33,31.33,-1,-63964,85733,149697,21769,0,-4724,340,0,0,,5064,-4384
9,02/27/2018,8,1:45,2:00,,42.75,3,45.75,39.75,-1,-72353,86295,158648,13942,0,-16243,0,0,0,,16243,-16243
9,02/27/2018,9,2:00,2:15,,26.99,3,29.99,23.99,-1,-53839,82386,136225,28547,0,-20638,0,0,0,,20638,-20638
9,02/27/2018,10,2:15,2:30,59.24,26.99,3,62.24,56.24,1,-88045,80181,168226,-7864,0,-3620,4723,0,0,,8343,1103
9,02/27/2018,11,2:30,2:45,53.23,,3,56.23,50.23,1,-97408,86453,183861,-10955,0,0,2485,0,0,,2485,2485
9,02/27/2018,12,2:45,3:00,53.23,42.5,3,56.23,36.63,2,-81665,91054,172719,9389,0,-1570,3446,0,0,,5016,1876
9,02/27/2018,13,3:00,3:15,82.74,47.23,3,85.74,36.62,2,-103586,67594,171180,-35992,0,-143,11832,0,0,,11975,11689
9,02/27/2018,14,3:15,3:30,49.23,44.44,3,47.44,41.44,-1,-62974,64872,127846,1898,0,-195,8398,0,0,,8593,8203
9,02/27/2018,15,3:30,3:45,51.43,44.23,3,54.43,36.62,2,-67861,59001,126862,-8860,0,-588,1465,0,0,,2053,877
9,02/27/2018,16,3:45,4:00,53.23,42.03,3,56.23,36.62,2,-67433,75334,142767,7901,0,-857,6595,0,0,,7452,5738
9,02/27/2018,17,4:00,4:15,,41.03,3,44.03,38.03,-1,-71024,88392,159416,17368,0,-8525,0,0,0,,8525,-8525
9,02/27/2018,18,4:15,4:30,,43.44,3,46.44,40.44,-1,-68179,81120,149299,12941,0,-11173,0,0,0,,11173,-11173
9,02/27/2018,19,4:30,4:45,,44.07,3,47.07,41.07,-1,-59723,70510,130233,10787,0,-4468,0,0,0,,4468,-4468
9,02/27/2018,20,4:45,5:00,,30.03,3,33.03,27.03,-1,-46098,73313,119411,27215,0,-12786,0,0,0,,12786,-12786
9,02/27/2018,21,5:00,5:15,,41.81,3,44.81,38.81,-1,-69844,87451,157295,17607,0,-23431,0,0,0,,23431,-23431
9,02/27/2018,22,5:15,5:30,46.59,41.81,3,49.59,43.59,1,-79538,73445,152983,-6093,0,-6264,820,0,0,,7084,-5444
9,02/27/2018,23,5:30,5:45,53.23,,3,56.23,50.23,1,-77459,48358,125817,-29101,0,0,1413,0,0,,1413,1413
9,02/27/2018,24,5:45,6:00,85.3,39.75,3,88.3,36.75,2,-64212,43673,107885,-20539,0,-125,12622,0,0,,12747,12497
9,02/27/2018,25,6:00,6:15,85.3,-10.47,3,-7.47,-13.47,-1,-74140,102671,176811,28531,0,-24412,158,0,0,,24570,-24254
9,02/27/2018,26,6:15,6:30,,44.98,3,47.98,41.98,-1,-102018,71087,173105,-30931,0,-1916,0,0,0,,1916,-1916
9,02/27/2018,27,6:30,6:45,,42.91,3,45.91,39.91,-1,-84597,94355,178952,9758,0,-782,0,0,0,,782,-782
9,02/27/2018,28,6:45,7:00,183.02,42.91,3,186.02,180.02,1,-126680,70865,197545,-55815,0,-279,7064,0,0,,7343,6785
9,02/27/2018,29,7:00,7:15,49.08,-26.85,3,52.08,-29.85,2,-83549,157972,241521,74423,0,-18765,2929,0,0,,21694,-15836
9,02/27/2018,30,7:15,7:30,,34.2,3,37.2,31.2,-1,-64422,110994,175416,46572,0,-41502,0,0,0,,41502,-41502
9,02/27/2018,31,7:30,7:45,,41.03,3,44.03,38.03,-1,-58851,80515,139366,21664,0,-26921,0,0,0,,26921,-26921
9,02/27/2018,32,7:45,8:00,52.81,45.49,3,55.81,42.49,2,-83388,56629,140017,-26759,0,-6713,1910,0,0,,8623,-4803
9,02/27/2018,33,8:00,8:15,52.81,-109.12,3,-106.12,-112.12,-1,-35780,113065,148845,77285,0,-26109,617,0,0,,26726,-25492
9,02/27/2018,34,8:15,8:30,,37.7,3,40.7,34.7,-1,-37992,70580,108572,32588,0,-17155,0,0,0,,17155,-17155
9,02/27/2018,35,8:30,8:45,46.98,42.91,3,49.98,43.98,1,-40991,46721,87712,5730,0,-11134,484,0,0,,11618,-10650
9,02/27/2018,36,8:45,9:00,47.14,44.83,3,50.14,41.83,2,-51049,49259,100308,-1790,0,-81,345,0,0,,426,264
9,02/27/2018,37,9:00,9:15,49.36,44.67,3,52.36,41.67,2,-52920,44256,97176,-8664,0,-137,3433,0,0,,3570,3296
9,02/27/2018,38,9:15,9:30,44.91,41.79,3,48.24,38.79,2,-42016,53042,95058,11026,0,-2787,1133,0,0,,3920,-1654
9,02/27/2018,39,9:30,9:45,,39.91,3,42.91,36.91,-1,-54435,73307,127742,18872,0,-9739,0,0,0,,9739,-9739
9,02/27/2018,40,9:45,10:00,,24.03,3,27.03,21.03,-1,-59441,107541,166982,48100,0,-42891,0,0,0,,42891,-42891
9,02/27/2018,41,10:00,10:15,,40.91,3,43.91,37.91,-1,-56834,67463,124297,10629,0,-17770,0,0,0,,17770,-17770
9,02/27/2018,42,10:15,10:30,,24.87,3,27.87,21.87,-1,-49927,75655,125582,25728,0,-22234,0,0,0,,22234,-22234
9,02/27/2018,43,10:30,10:45,,16.76,3,19.76,13.76,-1,-57957,111722,169679,53765,0,-31625,0,0,0,,31625,-31625
9,02/27/2018,44,10:45,11:00,,-7.03,3,-4.03,-10.03,-1,-42508,115299,157807,72791,0,-55980,0,0,0,,55980,-55980
9,02/27/2018,45,11:00,11:15,,13.03,3,16.03,10.03,-1,-72395,126580,198975,54185,0,-59189,0,0,0,,59189,-59189
9,02/27/2018,46,11:15,11:30,,27.03,3,30.03,24.03,-1,-80665,136115,216780,55450,0,-52251,0,0,0,,52251,-52251
9,02/27/2018,47,11:30,11:45,,22.51,3,25.51,19.51,-1,-88647,145360,234007,56713,0,-49430,0,0,0,,49430,-49430
9,02/27/2018,48,11:45,12:00,,19.09,3,22.09,16.09,-1,-108487,145088,253575,36601,0,-52661,0,0,0,,52661,-52661
9,02/27/2018,49,12:00,12:15,44.91,42.36,3,47.91,35.85,2,-97743,88859,186602,-8884,0,-12793,546,0,0,,13339,-12247
9,02/27/2018,50,12:15,12:30,32.67,13.52,3,16.52,10.52,-1,-78631,109179,187810,30548,0,-8046,310,0,0,,8356,-7736
9,02/27/2018,51,12:30,12:45,,10.71,3,13.71,7.71,-1,-57131,114395,171526,57264,0,-42856,0,0,0,,42856,-42856
9,02/27/2018,52,12:45,13:00,,16.12,3,19.12,13.12,-1,-50094,111143,161237,61049,0,-56124,0,0,0,,56124,-56124
9,02/27/2018,53,13:00,13:15,,24.03,3,27.03,21.03,-1,-55660,107025,162685,51365,0,-50126,0,0,0,,50126,-50126
9,02/27/2018,54,13:15,13:30,,29.21,3,32.21,26.21,-1,-51609,96792,148401,45183,0,-47060,0,0,0,,47060,-47060
9,02/27/2018,55,13:30,13:45,,29.38,3,32.38,26.38,-1,-59346,104538,163884,45192,0,-39963,0,0,0,,39963,-39963
9,02/27/2018,56,13:45,14:00,,21.62,3,24.62,18.62,-1,-57219,111858,169077,54639,0,-50829,0,0,0,,50829,-50829
9,02/27/2018,57,14:00,14:15,,34.85,3,37.85,31.85,-1,-73231,109116,182347,35885,0,-37668,0,0,0,,37668,-37668
9,02/27/2018,58,14:15,14:30,,42.44,3,45.44,39.44,-1,-81919,101670,183589,19751,0,-5958,0,0,0,,5958,-5958
9,02/27/2018,59,14:30,14:45,,23.19,3,26.19,20.19,-1,-68181,109872,178053,41691,0,-19594,0,0,0,,19594,-19594
9,02/27/2018,60,14:45,15:00,,41.03,3,44.03,38.03,-1,-87749,102397,190146,14648,0,-14834,0,0,0,,14834,-14834
9,02/27/2018,61,15:00,15:15,,42.03,3,45.03,39.03,-1,-83304,77520,160824,-5784,0,-4667,0,0,0,,4667,-4667
9,02/27/2018,62,15:15,15:30,48.91,42.03,3,51.91,45.91,1,-82991,66417,149408,-16574,0,-368,3964,0,0,,4332,3596
9,02/27/2018,63,15:30,15:45,58.87,,3,61.87,55.87,1,-84198,62886,147084,-21312,0,0,6931,0,0,,6931,6931
9,02/27/2018,64,15:45,16:00,76.88,,3,79.88,73.88,1,-92237,53851,146088,-38386,0,0,36948,0,0,,36948,36948
9,02/27/2018,65,16:00,16:15,63.02,45.07,3,48.07,42.07,-1,-67815,53163,120978,-14652,0,-23,31026,0,0,,31049,31003
9,02/27/2018,66,16:15,16:30,63.02,41.03,3,44.03,38.03,-1,-45780,45168,90948,-612,0,-1966,1415,0,0,,3381,-551
9,02/27/2018,67,16:30,16:45,109.02,41.03,3,112.02,106.02,1,-70318,35092,105410,-35226,0,-31,14612,0,0,,14643,14581
9,02/27/2018,68,16:45,17:00,252.02,,3,255.02,249.02,1,-123593,47715,171308,-75878,0,0,67783,0,0,,67783,67783
9,02/27/2018,69,17:00,17:15,85.02,,3,88.02,82.02,1,-72794,33283,106077,-39511,0,0,35246,0,0,,35246,35246
9,02/27/2018,70,17:15,17:30,156.02,,3,159.02,153.02,1,-126460,19642,146102,-106818,0,0,4600,0,0,,4600,4600
9,02/27/2018,71,17:30,17:45,267.02,,3,270.02,264.02,1,-99914,34779,134693,-65135,0,0,41742,0,0,,41742,41742
9,02/27/2018,72,17:45,18:00,68.09,,3,71.09,65.09,1,-88284,55790,144074,-32494,0,0,16355,0,0,,16355,16355
9,02/27/2018,73,18:00,18:15,74.64,,3,77.64,71.64,1,-139960,51729,191689,-88231,0,0,10744,0,0,,10744,10744
9,02/27/2018,74,18:15,18:30,50.59,,3,53.59,47.59,1,-108036,54079,162115,-53957,0,0,291,0,0,,291,291
9,02/27/2018,75,18:30,18:45,267.02,,3,270.02,264.02,1,-147259,29136,176395,-118123,0,0,43257,0,0,,43257,43257
9,02/27/2018,76,18:45,19:00,267.02,,3,270.02,264.02,1,-132910,24822,157732,-108088,0,0,61184,0,0,,61184,61184
9,02/27/2018,77,19:00,19:15,91.02,40.63,3,43.63,37.63,-1,-63410,72748,136158,9338,0,-373,33219,0,0,,33592,32846
9,02/27/2018,78,19:15,19:30,61.92,39.91,3,64.92,36.44,2,-83777,69935,153712,-13842,0,-1585,2508,0,0,,4093,923
9,02/27/2018,79,19:30,19:45,55.77,43.27,3,58.77,36.46,2,-82228,73055,155283,-9173,0,-66,11973,0,0,,12039,11907
9,02/27/2018,80,19:45,20:00,52.25,39.12,3,55.25,36.12,2,-77429,76226,153655,-1203,0,-4694,1552,0,0,,6246,-3142
9,02/27/2018,81,20:00,20:15,237.02,39.12,3,240.02,234.02,1,-147327,22627,169954,-124700,0,-23,46083,0,0,,46106,46060
9,02/27/2018,82,20:15,20:30,237.02,,3,240.02,234.02,1,-121951,63965,185916,-57986,0,0,74946,0,0,,74946,74946
9,02/27/2018,83,20:30,20:45,62.81,,3,65.81,59.81,1,-123471,86884,210355,-36587,0,0,37388,0,0,,37388,37388
9,02/27/2018,84,20:45,21:00,44.91,-2.03,3,0.97,-5.03,-1,-89464,115059,204523,25595,0,-11321,9723,0,0,,21044,-1598
9,02/27/2018,85,21:00,21:15,237.02,-23.93,3,240.02,234.02,1,-172260,76856,249116,-95404,0,-14695,14145,0,0,,28840,-550
9,02/27/2018,86,21:15,21:30,237.02,19.27,3,240.02,16.27,2,-81766,77702,159468,-4064,0,-651,41249,0,0,,41900,40598
9,02/27/2018,87,21:30,21:45,46.78,1.02,3,49.78,-1.98,2,-85049,88425,173474,3376,0,-13643,276,0,0,,13919,-13367
9,02/27/2018,88,21:45,22:00,46.78,-25.88,3,-22.88,-28.88,-1,-79367,143563,222930,64196,0,-20285,100,0,0,,20385,-20185
9,02/27/2018,89,22:00,22:15,237.02,-25.88,3,240.02,234.02,1,-116744,37182,153926,-79562,0,-5120,21781,0,0,,26901,16661
9,02/27/2018,90,22:15,22:30,62.26,23.39,3,26.39,20.39,-1,-66013,81995,148008,15982,0,-1796,16162,0,0,,17958,14366
9,02/27/2018,91,22:30,22:45,,14.03,3,17.03,11.03,-1,-58897,107027,165924,48130,0,-38453,0,0,0,,38453,-38453
9,02/27/2018,92,22:45,23:00,,-9.52,3,-6.52,-12.52,-1,-58342,134156,192498,75814,0,-54726,0,0,0,,54726,-54726
9,02/27/2018,93,23:00,23:15,223.02,13.41,3,226.02,220.02,1,-117951,74041,191992,-43910,0,-27699,7751,0,0,,35450,-19948
9,02/27/2018,94,23:15,23:30,223.02,29.92,3,32.92,26.92,-1,-63787,84076,147863,20289,0,-3453,10628,0,0,,14081,7175
9,02/27/2018,95,23:30,23:45,,-1.74,3,1.26,-4.74,-1,-73381,113448,186829,40067,0,-40997,0,0,0,,40997,-40997
9,02/27/2018,96,23:45,0:00,,-22.33,3,-19.33,-25.33,-1,-78306,126988,205294,48682,0,-25763,0,0,0,,25763,-25763
9,02/28/2018,1,0:00,0:15,47.72,-150.78,0,47.72,-150.78,2,-83722,114430,198152,30708,0,-37523,31,0,0,,37554,-37492
9,02/28/2018,2,0:15,0:30,53.03,37.33,0,53.03,37.33,2,-71333,84912,156245,13579,0,-2658,2677,0,0,,5335,19
9,02/28/2018,3,0:30,0:45,,17.85,0,17.85,17.85,-1,-86552,91577,178129,5025,0,-17397,0,0,0,,17397,-17397
9,02/28/2018,4,0:45,1:00,48.4,42.33,0,48.4,39.14,2,-102959,109177,212136,6218,0,-1200,1487,0,0,,2687,287
9,02/28/2018,5,1:00,1:15,47.08,42.33,0,47.08,39.01,2,-81234,72433,153667,-8801,0,-890,766,0,0,,1656,-124
9,02/28/2018,6,1:15,1:30,47.08,44.27,0,44.27,44.27,-1,-64043,66818,130861,2775,0,-415,21,0,0,,436,-394
9,02/28/2018,7,1:30,1:45,,44.27,0,44.27,44.27,-1,-71588,75529,147117,3941,0,-1440,0,0,0,,1440,-1440
9,02/28/2018,8,1:45,2:00,,42.33,0,42.33,42.33,-1,-75738,88111,163849,12373,0,-5351,0,0,0,,5351,-5351
9,02/28/2018,9,2:00,2:15,32.03,37.33,0,40.59,37.33,2,-76897,82450,159347,5553,0,-8481,5,0,0,,8486,-8476
9,02/28/2018,10,2:15,2:30,48.4,42.33,0,48.4,40.59,2,-77574,74684,152258,-2890,0,-387,2204,0,0,,2591,1817
9,02/28/2018,11,2:30,2:45,,41.78,0,41.78,41.78,-1,-67450,82869,150319,15419,0,-4496,0,0,0,,4496,-4496
9,02/28/2018,12,2:45,3:00,,27.46,0,27.46,27.46,-1,-62072,96435,158507,34363,0,-23605,0,0,0,,23605,-23605
9,02/28/2018,13,3:00,3:15,,40.36,0,40.36,40.36,-1,-58928,80588,139516,21660,0,-27807,0,0,0,,27807,-27807
9,02/28/2018,14,3:15,3:30,,41.78,0,41.78,41.78,-1,-62763,78907,141670,16144,0,-12215,0,0,0,,12215,-12215
9,02/28/2018,15,3:30,3:45,,37.33,0,37.33,37.33,-1,-61023,81794,142817,20771,0,-18794,0,0,0,,18794,-18794
9,02/28/2018,16,3:45,4:00,,42.33,0,42.33,42.33,-1,-58253,81815,140068,23562,0,-15539,0,0,0,,15539,-15539
9,02/28/2018,17,4:00,4:15,,42.33,0,42.33,42.33,-1,-66081,72342,138423,6261,0,-13867,0,0,0,,13867,-13867
9,02/28/2018,18,4:15,4:30,53.49,42.33,0,53.49,53.49,1,-77890,57711,135601,-20179,0,-3374,5834,0,0,,9208,2460
9,02/28/2018,19,4:30,4:45,56.19,,0,56.19,56.19,1,-79372,53765,133137,-25607,0,0,22418,0,0,,22418,22418
9,02/28/2018,20,4:45,5:00,50.12,,0,50.12,50.12,1,-85791,63595,149386,-22196,0,0,22094,0,0,,22094,22094
9,02/28/2018,21,5:00,5:15,37.12,28.21,0,39.06,28.21,2,-57675,62352,120027,4677,0,-4214,6005,0,0,,10219,1791
9,02/28/2018,22,5:15,5:30,76.62,28.21,0,76.62,76.62,1,-78226,39412,117638,-38814,0,-312,21811,0,0,,22123,21499
9,02/28/2018,23,5:30,5:45,239.12,,0,239.12,239.12,1,-97726,30583,128309,-67143,0,0,38688,0,0,,38688,38688
9,02/28/2018,24,5:45,6:00,239.12,,0,239.12,239.12,1,-92265,49349,141614,-42916,0,0,62264,0,0,,62264,62264
9,02/28/2018,25,6:00,6:15,239.12,21.57,0,21.57,21.57,-1,-91441,106031,197472,14590,0,-5357,11760,0,0,,17117,6403
9,02/28/2018,26,6:15,6:30,,39.46,0,39.46,39.46,-1,-53401,70183,123584,16782,0,-9126,0,0,0,,9126,-9126
9,02/28/2018,27,6:30,6:45,,11.67,0,11.67,11.67,-1,-65867,88268,154135,22401,0,-26110,0,0,0,,26110,-26110
9,02/28/2018,28,6:45,7:00,222.12,11.67,0,222.12,222.12,1,-129877,88126,218003,-41751,0,-5159,13763,0,0,,18922,8604
9,02/28/2018,29,7:00,7:15,52.12,-83.6,0,52.12,-83.6,2,-87653,153343,240996,65690,0,-18175,7392,0,0,,25567,-10783
9,02/28/2018,30,7:15,7:30,,31.56,0,31.56,31.56,-1,-76421,82960,159381,6539,0,-13441,0,0,0,,13441,-13441
9,02/28/2018,31,7:30,7:45,,41.39,0,41.39,41.39,-1,-77981,91553,169534,13572,0,-9164,0,0,0,,9164,-9164
9,02/28/2018,32,7:45,8:00,113.45,41.39,0,113.45,113.45,1,-109552,68121,177673,-41431,0,-2650,11398,0,0,,14048,8748
9,02/28/2018,33,8:00,8:15,113.45,-23.36,0,-23.36,-23.36,-1,-57470,105932,163402,48462,0,-13186,4506,0,0,,17692,-8680
9,02/28/2018,34,8:15,8:30,,43.78,0,43.78,43.78,-1,-84527,94133,178660,9606,0,-6438,0,0,0,,6438,-6438
9,02/28/2018,35,8:30,8:45,52.18,44.46,0,52.18,52.18,1,-91848,83418,175266,-8430,0,-3826,255,0,0,,4081,-3571
9,02/28/2018,36,8:45,9:00,64.62,44.46,0,64.62,64.62,1,-111221,77045,188266,-34176,0,-265,6778,0,0,,7043,6513
9,02/28/2018,37,9:00,9:15,267.12,,0,267.12,267.12,1,-112017,59882,171899,-52135,0,0,26411,0,0,,26411,26411
9,02/28/2018,38,9:15,9:30,60,,0,60,60,1,-94269,71773,166042,-22496,0,0,21517,0,0,,21517,21517
9,02/28/2018,39,9:30,9:45,60,44.46,0,44.46,44.46,-1,-75846,82616,158462,6770,0,-1634,1098,0,0,,2732,-536
9,02/28/2018,40,9:45,10:00,,45.99,0,45.99,45.99,-1,-76632,76451,153083,-181,0,-2843,0,0,0,,2843,-2843
9,02/28/2018,41,10:00,10:15,238.12,45.1,0,238.12,39.58,2,-102115,48915,151030,-53200,0,-1087,13285,0,0,,14372,12198
9,02/28/2018,42,10:15,10:30,60.23,44.78,0,44.78,44.78,-1,-60309,39283,99592,-21026,0,-85,13174,0,0,,13259,13089
9,02/28/2018,43,10:30,10:45,,36.78,0,36.78,36.78,-1,-49989,66767,116756,16778,0,-10978,0,0,0,,10978,-10978
9,02/28/2018,44,10:45,11:00,,31.78,0,31.78,31.78,-1,-58631,72169,130800,13538,0,-19623,0,0,0,,19623,-19623
9,02/28/2018,45,11:00,11:15,68.46,44.46,0,68.46,68.46,1,-64680,40603,105283,-24077,0,-7888,1612,0,0,,9500,-6276
9,02/28/2018,46,11:15,11:30,83.12,44.46,0,83.12,83.12,1,-86637,31837,118474,-54800,0,-27,29897,0,0,,29924,29870
9,02/28/2018,47,11:30,11:45,52.46,,0,52.46,52.46,1,-78686,41892,120578,-36794,0,0,19800,0,0,,19800,19800
9,02/28/2018,48,11:45,12:00,82.47,,0,82.47,82.47,1,-119730,48798,168528,-70932,0,0,6906,0,0,,6906,6906
9,02/28/2018,49,12:00,12:15,237.12,,0,237.12,237.12,1,-153229,29251,182480,-123978,0,0,70454,0,0,,70454,70454
9,02/28/2018,50,12:15,12:30,175.12,,0,175.12,175.12,1,-101304,60933,162237,-40371,0,0,56006,0,0,,56006,56006
9,02/28/2018,51,12:30,12:45,51.77,,0,51.77,51.77,1,-94421,61368,155789,-33053,0,0,23206,0,0,,23206,23206
9,02/28/2018,52,12:45,13:00,50.96,,0,50.96,50.96,1,-93424,70355,163779,-23069,0,0,21697,0,0,,21697,21697
9,02/28/2018,53,13:00,13:15,223.12,30.6,0,223.12,30.6,2,-84285,38545,122830,-45740,0,-1219,9001,0,0,,10220,7782
9,02/28/2018,54,13:15,13:30,223.12,,0,223.12,223.12,1,-115390,45700,161090,-69690,0,0,56502,0,0,,56502,56502
9,02/28/2018,55,13:30,13:45,48.71,,0,48.71,48.71,1,-63819,52709,116528,-11110,0,0,7296,0,0,,7296,7296
9,02/28/2018,56,13:45,14:00,44.12,,0,44.12,44.12,1,-85529,50717,136246,-34812,0,0,1183,0,0,,1183,1183
9,02/28/2018,57,14:00,14:15,32.68,-87.27,0,38.36,-87.27,2,-63890,122501,186391,58611,0,-17523,635,0,0,,18158,-16888
9,02/28/2018,58,14:15,14:30,,22,0,22,22,-1,-83754,110398,194152,26644,0,-21074,0,0,0,,21074,-21074
9,02/28/2018,59,14:30,14:45,,25.15,0,25.15,25.15,-1,-78031,115338,193369,37307,0,-31208,0,0,0,,31208,-31208
9,02/28/2018,60,14:45,15:00,,24.6,0,24.6,24.6,-1,-81684,125659,207343,43975,0,-32891,0,0,0,,32891,-32891
9,02/28/2018,61,15:00,15:15,154.12,24.6,0,154.12,154.12,1,-133554,75897,209451,-57657,0,-11163,6864,0,0,,18027,-4299
9,02/28/2018,62,15:15,15:30,,,0,38.51,38.51,0,-93376,77021,170397,-16355,0,0,228,0,0,,228,228
9,02/28/2018,63,15:30,15:45,58.12,,0,58.12,58.12,1,-104426,86458,190884,-17968,0,0,5980,0,0,,5980,5980
9,02/28/2018,64,15:45,16:00,50.96,42.78,0,50.96,38.53,2,-89742,87766,177508,-1976,0,-63,12186,0,0,,12249,12123
9,02/28/2018,65,16:00,16:15,50.96,39.46,0,39.46,39.46,-1,-103183,118934,222117,15751,0,-503,694,0,0,,1197,191
9,02/28/2018,66,16:15,16:30,,44.46,0,44.46,44.46,-1,-95520,114565,210085,19045,0,-784,0,0,0,,784,-784
9,02/28/2018,67,16:30,16:45,,44.46,0,44.46,44.46,-1,-92670,100943,193613,8273,0,-2341,0,0,0,,2341,-2341
9,02/28/2018,68,16:45,17:00,54.47,44.46,0,54.47,54.47,1,-101533,81855,183388,-19678,0,-28,2371,0,0,,2399,2343
9,02/28/2018,69,17:00,17:15,47.83,18.78,0,47.83,18.78,2,-76874,115962,192836,39088,0,-9692,635,0,0,,10327,-9057
9,02/28/2018,70,17:15,17:30,51.93,43.78,0,51.93,51.93,1,-97216,86046,183262,-11170,0,-3933,523,0,0,,4456,-3410
9,02/28/2018,71,17:30,17:45,57.82,,0,57.82,57.82,1,-75304,81702,157006,6398,0,0,4681,0,0,,4681,4681
9,02/28/2018,72,17:45,18:00,57.82,44.46,0,44.46,44.46,-1,-62141,107604,169745,45463,0,-888,20,0,0,,908,-868
9,02/28/2018,73,18:00,18:15,,-27.78,0,-27.78,-27.78,-1,-87912,127006,214918,39094,0,-24677,0,0,0,,24677,-24677
9,02/28/2018,74,18:15,18:30,,31.7,0,31.7,31.7,-1,-96844,124699,221543,27855,0,-22860,0,0,0,,22860,-22860
9,02/28/2018,75,18:30,18:45,50.96,41.35,0,50.96,50.96,1,-104700,103444,208144,-1256,0,-12753,176,0,0,,12929,-12577
9,02/28/2018,76,18:45,19:00,93,41.35,0,93,93,1,-109436,84913,194349,-24523,0,-230,15056,0,0,,15286,14826
9,02/28/2018,77,19:00,19:15,93,-127.26,0,-127.26,-127.26,-1,-60976,110179,171155,49203,0,-19960,1975,0,0,,21935,-17985
9,02/28/2018,78,19:15,19:30,,23.66,0,23.66,23.66,-1,-69176,91431,160607,22255,0,-10340,0,0,0,,10340,-10340
9,02/28/2018,79,19:30,19:45,,25.54,0,25.54,25.54,-1,-74249,103270,177519,29021,0,-22522,0,0,0,,22522,-22522
9,02/28/2018,80,19:45,20:00,50.9,-17.94,0,50.9,-17.94,2,-74096,66931,141027,-7165,0,-35023,162,0,0,,35185,-34861
9,02/28/2018,81,20:00,20:15,257.12,-17.94,0,257.12,257.12,1,-121151,45232,166383,-75919,0,-1786,33563,0,0,,35349,31777
9,02/28/2018,82,20:15,20:30,98.12,43.78,0,43.78,43.78,-1,-76270,62815,139085,-13455,0,-98,39727,0,0,,39825,39629
9,02/28/2018,83,20:30,20:45,98.12,29.65,0,29.65,29.65,-1,-71222,84418,155640,13196,0,-2170,298,0,0,,2468,-1872
9,02/28/2018,84,20:45,21:00,,25.42,0,25.42,25.42,-1,-71551,106864,178415,35313,0,-23952,0,0,0,,23952,-23952
9,02/28/2018,85,21:00,21:15,206.12,25.42,0,206.12,206.12,1,-100306,39436,139742,-60870,0,-11028,12670,0,0,,23698,1642
9,02/28/2018,86,21:15,21:30,53.81,,0,53.81,53.81,1,-74894,50084,124978,-24810,0,0,22404,0,0,,22404,22404
9,02/28/2018,87,21:30,21:45,47.12,27.89,0,27.89,27.89,-1,-64477,68645,133122,4168,0,-2068,6381,0,0,,8449,4313
9,02/28/2018,88,21:45,22:00,49.84,22.76,0,49.84,22.76,2,-77498,73667,151165,-3831,0,-10956,272,0,0,,11228,-10684
9,02/28/2018,89,22:00,22:15,73.35,,0,73.35,73.35,1,-107365,74335,181700,-33030,0,0,21040,0,0,,21040,21040
9,02/28/2018,90,22:15,22:30,52.99,,0,52.99,52.99,1,-76011,55744,131755,-20267,0,0,29960,0,0,,29960,29960
9,02/28/2018,91,22:30,22:45,52.99,31.05,0,31.05,31.05,-1,-74112,80289,154401,6177,0,-1484,7147,0,0,,8631,5663
9,02/28/2018,92,22:45,23:00,,30.92,0,30.92,30.92,-1,-71806,94492,166298,22686,0,-8152,0,0,0,,8152,-8152
9,02/28/2018,93,23:00,23:15,239.12,30.92,0,239.12,239.12,1,-109992,45318,155310,-64674,0,-2178,21866,0,0,,24044,19688
9,02/28/2018,94,23:15,23:30,53.35,39.46,0,39.46,39.46,-1,-70733,68792,139525,-1941,0,-131,20317,0,0,,20448,20186
9,02/28/2018,95,23:30,23:45,53.35,29.94,0,29.94,29.94,-1,-50646,70967,121613,20321,0,-12232,664,0,0,,12896,-11568
9,02/28/2018,96,23:45,0:00,,-17.92,0,-17.92,-17.92,-1,-60024,108526,168550,48502,0,-33046,0,0,0,,33046,-33046
9,03-01-18,1,0:00,0:15,173.02,15.34,0,173.02,173.02,1,-140012,125429,265441,-14583,0,-12646,1147,0,0,,13793,-11499
9,03-01-18,2,0:15,0:30,450,15.34,0,450,450,1,-137935,72384,210319,-65551,0,-112,52093,0,0,,52205,51981
9,03-01-18,3,0:30,0:45,450,7.92,0,7.92,7.92,-1,-117614,120065,237679,2451,0,-776,18331,0,0,,19107,17555
9,03-01-18,4,0:45,1:00,76.86,7.92,0,76.86,76.86,1,-121518,103176,224694,-18342,0,-6,7023,0,0,,7029,7017
9,03-01-18,5,1:00,1:15,68.02,,0,68.02,68.02,1,-79236,66973,146209,-12263,0,0,11633,0,0,,11633,11633
9,03-01-18,6,1:15,1:30,68.02,12.54,0,12.54,12.54,-1,-61070,67021,128091,5951,0,-271,3402,0,0,,3673,3131
9,03-01-18,7,1:30,1:45,,32.01,0,32.01,32.01,-1,-74790,73516,148306,-1274,0,-287,0,0,0,,287,-287
9,03-01-18,8,1:45,2:00,,-17.99,0,-17.99,-17.99,-1,-84921,89321,174242,4400,0,-1369,0,0,0,,1369,-1369
9,03-01-18,9,2:00,2:15,,-150.03,0,-150.03,-150.03,-1,-74567,100060,174627,25493,0,-5996,0,0,0,,5996,-5996
9,03-01-18,10,2:15,2:30,,-150.03,0,-150.03,-150.03,-1,-76963,110301,187264,33338,0,-6068,0,0,0,,6068,-6068
9,03-01-18,11,2:30,2:45,,-0.03,0,-0.03,-0.03,-1,-94822,102343,197165,7521,0,-8422,0,0,0,,8422,-8422
9,03-01-18,12,2:45,3:00,,-17.99,0,-17.99,-17.99,-1,-72595,124953,197548,52358,0,-6253,0,0,0,,6253,-6253
9,03-01-18,13,3:00,3:15,215.02,31.01,0,215.02,215.02,1,-95015,61687,156702,-33328,0,-4164,7383,0,0,,11547,3219
9,03-01-18,14,3:15,3:30,58.02,,0,58.02,58.02,1,-75049,72065,147114,-2984,0,0,9179,0,0,,9179,9179
9,03-01-18,15,3:30,3:45,,,0,48.03,48.03,0,-71381,77523,148904,6142,0,0,0,0,0,,0,0
9,03-01-18,16,3:45,4:00,,23.03,0,23.03,23.03,-1,-51494,89024,140518,37530,0,-598,0,0,0,,598,-598
9,03-01-18,17,4:00,4:15,83.25,25.95,0,83.25,83.25,1,-80077,60176,140253,-19901,0,-311,3068,0,0,,3379,2757
9,03-01-18,18,4:15,4:30,45.54,,0,45.54,45.54,1,-70592,59145,129737,-11447,0,0,7540,0,0,,7540,7540
9,03-01-18,19,4:30,4:45,64.28,,0,64.28,64.28,1,-68074,53480,121554,-14594,0,0,4473,0,0,,4473,4473
9,03-01-18,20,4:45,5:00,76.38,31.01,0,76.38,31.01,2,-67394,64827,132221,-2567,0,-3,8059,0,0,,8062,8056
9,03-01-18,21,5:00,5:15,108.02,10.13,0,108.02,10.13,2,-66459,48044,114503,-18415,0,-357,3914,0,0,,4271,3557
9,03-01-18,22,5:15,5:30,215.02,,0,215.02,215.02,1,-85378,40948,126326,-44430,0,0,35112,0,0,,35112,35112
9,03-01-18,23,5:30,5:45,229.02,,0,229.02,229.02,1,-103430,45073,148503,-58357,0,0,48564,0,0,,48564,48564
9,03-01-18,24,5:45,6:00,222.02,,0,222.02,222.02,1,-116404,63555,179959,-52849,0,0,53431,0,0,,53431,53431
9,03-01-18,25,6:00,6:15,222.02,-400,0,-400,-400,-1,-9186,177774,186960,168588,0,-28824,12613,0,0,,41437,-16211
9,03-01-18,26,6:15,6:30,73.02,-150.03,0,73.02,73.02,1,-50740,41253,91993,-9487,0,-16475,864,0,0,,17339,-15611
9,03-01-18,27,6:30,6:45,68.02,-52.03,0,68.02,-52.03,2,-70452,76876,147328,6424,0,-1308,1400,0,0,,2708,92
9,03-01-18,28,6:45,7:00,78.02,,0,78.02,78.02,1,-96258,81728,177986,-14530,0,0,5815,0,0,,5815,5815
9,03-01-18,29,7:00,7:15,125.56,-150.03,0,125.56,-150.03,2,-95743,96980,192723,1237,0,-4628,1155,0,0,,5783,-3473
9,03-01-18,30,7:15,7:30,232.02,,0,232.02,232.02,1,-83418,69039,152457,-14379,0,0,7716,0,0,,7716,7716
9,03-01-18,31,7:30,7:45,450,,0,450,450,1,-99622,40883,140505,-58739,0,0,21885,0,0,,21885,21885
9,03-01-18,32,7:45,8:00,450,,0,450,450,1,-116871,35063,151934,-81808,0,0,74740,0,0,,74740,74740
9,03-01-18,33,8:00,8:15,125.47,-150.03,0,125.47,-150.03,2,-63387,68283,131670,4896,0,-2114,25715,0,0,,27829,23601
9,03-01-18,34,8:15,8:30,307.02,,0,307.02,307.02,1,-101756,39016,140772,-62740,0,0,14950,0,0,,14950,14950
9,03-01-18,35,8:30,8:45,245.02,,0,245.02,245.02,1,-117838,50271,168109,-67567,0,0,21018,0,0,,21018,21018
9,03-01-18,36,8:45,9:00,450,,0,450,450,1,-137787,36026,173813,-101761,0,0,62269,0,0,,62269,62269
9,03-01-18,37,9:00,9:15,344.02,,0,344.02,344.02,1,-156803,64514,221317,-92289,0,0,86430,0,0,,86430,86430
9,03-01-18,38,9:15,9:30,344.02,,0,344.02,344.02,1,-151125,72434,223559,-78691,0,0,83530,0,0,,83530,83530
9,03-01-18,39,9:30,9:45,301.02,,0,301.02,301.02,1,-126408,89771,216179,-36637,0,0,58917,0,0,,58917,58917
9,03-01-18,40,9:45,10:00,196.02,17.25,0,196.02,17.25,2,-114304,98257,212561,-16047,0,-206,7893,0,0,,8099,7687
9,03-01-18,41,10:00,10:15,344.02,,0,344.02,344.02,1,-143898,55181,199079,-88717,0,0,49742,0,0,,49742,49742
9,03-01-18,42,10:15,10:30,271.02,,0,271.02,271.02,1,-99440,62382,161822,-37058,0,0,49843,0,0,,49843,49843
9,03-01-18,43,10:30,10:45,117.02,,0,117.02,117.02,1,-75682,67860,143542,-7822,0,0,16779,0,0,,16779,16779
9,03-01-18,44,10:45,11:00,117.02,42.29,0,42.29,42.29,-1,-88244,85973,174217,-2271,0,-393,612,0,0,,1005,219
9,03-01-18,45,11:00,11:15,322.25,27.15,0,322.25,27.15,2,-109290,82164,191454,-27126,0,-730,8507,0,0,,9237,7777
9,03-01-18,46,11:15,11:30,75.1,,0,75.1,75.1,1,-108736,94493,203229,-14243,0,0,10359,0,0,,10359,10359
9,03-01-18,47,11:30,11:45,71.88,,0,71.88,71.88,1,-127536,103592,231128,-23944,0,0,564,0,0,,564,564
9,03-01-18,48,11:45,12:00,137.02,,0,137.02,137.02,1,-150471,82161,232632,-68310,0,0,28055,0,0,,28055,28055
9,03-01-18,49,12:00,12:15,268.25,,0,268.25,268.25,1,-192973,55266,248239,-137707,0,0,73958,0,0,,73958,73958
9,03-01-18,50,12:15,12:30,268.25,,0,268.25,268.25,1,-162495,60556,223051,-101939,0,0,110378,0,0,,110378,110378
9,03-01-18,51,12:30,12:45,152.25,,0,152.25,152.25,1,-143999,85800,229799,-58199,0,0,76017,0,0,,76017,76017
9,03-01-18,52,12:45,13:00,168.25,,0,168.25,168.25,1,-144926,73510,218436,-71416,0,0,50669,0,0,,50669,50669
9,03-01-18,53,13:00,13:15,174.25,,0,174.25,174.25,1,-177601,99784,277385,-77817,0,0,63987,0,0,,63987,63987
9,03-01-18,54,13:15,13:30,263.25,,0,263.25,263.25,1,-176292,57158,233450,-119134,0,0,85301,0,0,,85301,85301
9,03-01-18,55,13:30,13:45,259.32,,0,259.32,259.32,1,-160546,49110,209656,-111436,0,0,96852,0,0,,96852,96852
9,03-01-18,56,13:45,14:00,217.32,,0,217.32,217.32,1,-152506,65706,218212,-86800,0,0,85196,0,0,,85196,85196
9,03-01-18,57,14:00,14:15,268.25,,0,268.25,268.25,1,-156214,53889,210103,-102325,0,0,61271,0,0,,61271,61271
9,03-01-18,58,14:15,14:30,268.25,,0,268.25,268.25,1,-136092,62519,198611,-73573,0,0,53955,0,0,,53955,53955
9,03-01-18,59,14:30,14:45,116.22,,0,116.22,116.22,1,-119544,57020,176564,-62524,0,0,3630,0,0,,3630,3630
9,03-01-18,60,14:45,15:00,131.49,,0,131.49,131.49,1,-117612,38142,155754,-79470,0,0,31666,0,0,,31666,31666
9,03-01-18,61,15:00,15:15,75.1,31.88,0,31.88,31.88,-1,-100436,91896,192332,-8540,0,-28,14318,0,0,,14346,14290
9,03-01-18,62,15:15,15:30,172.68,31.88,0,172.68,31.88,2,-124763,70436,195199,-54327,0,-32,12119,0,0,,12151,12087
9,03-01-18,63,15:30,15:45,199.75,,0,199.75,199.75,1,-141882,70087,211969,-71795,0,0,42743,0,0,,42743,42743
9,03-01-18,64,15:45,16:00,179.14,,0,179.14,179.14,1,-125648,73752,199400,-51896,0,0,45488,0,0,,45488,45488
9,03-01-18,65,16:00,16:15,179.14,27.33,0,27.33,27.33,-1,-102497,108591,211088,6094,0,-2129,13016,0,0,,15145,10887
9,03-01-18,66,16:15,16:30,172.09,,0,172.09,172.09,1,-135866,70932,206798,-64934,0,0,7603,0,0,,7603,7603
9,03-01-18,67,16:30,16:45,186.59,,0,186.59,186.59,1,-131594,67052,198646,-64542,0,0,38224,0,0,,38224,38224
9,03-01-18,68,16:45,17:00,170.98,,0,170.98,170.98,1,-127016,62884,189900,-64132,0,0,33619,0,0,,33619,33619
9,03-01-18,69,17:00,17:15,187.4,28.62,0,187.4,28.62,2,-95388,104796,200184,9408,0,-1286,14901,0,0,,16187,13615
9,03-01-18,70,17:15,17:30,99.9,24.03,0,99.9,24.03,2,-107625,50179,157804,-57446,0,-3667,54,0,0,,3721,-3613
9,03-01-18,71,17:30,17:45,,20.72,0,20.72,20.72,-1,-129500,50185,179685,-79315,0,-14122,0,0,0,,14122,-14122
9,03-01-18,72,17:45,18:00,,,0,62.89,62.89,0,-115109,53695,168804,-61414,0,-2646,0,0,0,,2646,-2646
9,03-01-18,73,18:00,18:15,188.25,-92.7,0,188.25,-92.7,2,-183769,82001,265770,-101768,0,-13690,46,0,0,,13736,-13644
9,03-01-18,74,18:15,18:30,190.21,-16.75,0,190.21,-16.75,2,-152951,71624,224575,-81327,0,-5470,1051,0,0,,6521,-4419
9,03-01-18,75,18:30,18:45,207.59,33.7,0,207.59,207.59,1,-178074,44084,222158,-133990,0,-1122,3218,0,0,,4340,2096
9,03-01-18,76,18:45,19:00,145.34,,0,145.34,145.34,1,-154564,44447,199011,-110117,0,0,3429,0,0,,3429,3429
9,03-01-18,77,19:00,19:15,,32.25,0,32.25,32.25,-1,-138193,52601,190794,-85592,0,-773,0,0,0,,773,-773
9,03-01-18,78,19:15,19:30,,19.12,0,19.12,19.12,-1,-137781,62671,200452,-75110,0,-2050,0,0,0,,2050,-2050
9,03-01-18,79,19:30,19:45,,-89.05,0,-89.05,-89.05,-1,-181568,43659,225227,-137909,0,-25178,0,0,0,,25178,-25178
9,03-01-18,80,19:45,20:00,,-33.06,0,-33.06,-33.06,-1,-211118,44082,255200,-167036,0,-50237,0,0,0,,50237,-50237
9,03-01-18,81,20:00,20:15,267.25,-25.7,0,267.25,-25.7,2,-275411,35791,311202,-239620,0,-30245,7331,0,0,,37576,-22914
9,03-01-18,82,20:15,20:30,291.25,-68.53,0,291.25,-68.53,2,-196378,73064,269442,-123314,0,-2180,31235,0,0,,33415,29055
9,03-01-18,83,20:30,20:45,143.13,-94.27,0,143.13,-94.27,2,-184701,65736,250437,-118965,0,-10116,580,0,0,,10696,-9536
9,03-01-18,84,20:45,21:00,,-0.7,0,-0.7,-0.7,-1,-166353,86239,252592,-80114,0,-22758,0,0,0,,22758,-22758
9,03-01-18,85,21:00,21:15,236.25,30.02,0,236.25,236.25,1,-156345,138187,294532,-18158,0,-6589,4972,0,0,,11561,-1617
9,03-01-18,86,21:15,21:30,137.29,-100.54,0,-100.54,-100.54,-1,-118381,158727,277108,40346,0,-3907,4559,0,0,,8466,652
9,03-01-18,87,21:30,21:45,153.12,-94.48,0,153.12,-94.48,2,-148209,139395,287604,-8814,0,-14908,2296,0,0,,17204,-12612
9,03-01-18,88,21:45,22:00,153.12,-68.68,0,-68.68,-68.68,-1,-126922,168539,295461,41617,0,-14937,14,0,0,,14951,-14923
9,03-01-18,89,22:00,22:15,310.25,-68.68,0,310.25,310.25,1,-210308,73876,284184,-136432,0,-1624,33071,0,0,,34695,31447
9,03-01-18,90,22:15,22:30,268.25,,0,268.25,268.25,1,-146856,93578,240434,-53278,0,0,69467,0,0,,69467,69467
9,03-01-18,91,22:30,22:45,104.1,28.79,0,104.1,28.79,2,-109808,119577,229385,9769,0,-2122,11661,0,0,,13783,9539
9,03-01-18,92,22:45,23:00,123.68,47.7,0,123.68,47.7,2,-112427,110121,222548,-2306,0,-1109,687,0,0,,1796,-422
9,03-01-18,93,23:00,23:15,151.2,,0,151.2,151.2,1,-131472,107745,239217,-23727,0,0,9688,0,0,,9688,9688
9,03-01-18,94,23:15,23:30,151.2,18.7,0,18.7,18.7,-1,-111589,129773,241362,18184,0,-4809,1997,0,0,,6806,-2812
9,03-01-18,95,23:30,23:45,,7.89,0,7.89,7.89,-1,-119987,129008,248995,9021,0,-20744,0,0,0,,20744,-20744
9,03-01-18,96,23:45,0:00,109.83,-79.9,0,109.83,-79.9,2,-130086,162360,292446,32274,0,-7718,460,0,0,,8178,-7258
9,03-02-18,1,0:00,0:15,350.12,-149.78,0,350.12,-149.78,2,-106767,91219,197986,-15548,0,-13378,8277,0,0,,21655,-5101
9,03-02-18,2,0:15,0:30,70.74,-149.78,0,70.74,70.74,1,-106755,113306,220061,6551,0,-14,11129,0,0,,11143,11115
9,03-02-18,3,0:30,0:45,70.74,25.33,0,25.33,25.33,-1,-100266,127793,228059,27527,0,-9059,1242,0,0,,10301,-7817
9,03-02-18,4,0:45,1:00,,27.49,0,27.49,27.49,-1,-105429,136005,241434,30576,0,-19441,0,0,0,,19441,-19441
9,03-02-18,5,1:00,1:15,49.12,28.97,0,49.12,49.12,1,-87225,110135,197360,22910,0,-10457,231,0,0,,10688,-10226
9,03-02-18,6,1:15,1:30,,-21.5,0,-21.5,-21.5,-1,-78686,125807,204493,47121,0,-18489,0,0,0,,18489,-18489
9,03-02-18,7,1:30,1:45,,29.11,0,29.11,29.11,-1,-108187,132359,240546,24172,0,-9746,0,0,0,,9746,-9746
9,03-02-18,8,1:45,2:00,,-19.57,0,-19.57,-19.57,-1,-81981,135861,217842,53880,0,-32980,0,0,0,,32980,-32980
9,03-02-18,9,2:00,2:15,,26.61,0,26.61,26.61,-1,-95067,116600,211667,21533,0,-28434,0,0,0,,28434,-28434
9,03-02-18,10,2:15,2:30,,19.46,0,19.46,19.46,-1,-81429,107871,189300,26442,0,-6848,0,0,0,,6848,-6848
9,03-02-18,11,2:30,2:45,57.31,-16.75,0,63.95,-16.75,2,-83060,89538,172598,6478,0,-17869,90,0,0,,17959,-17779
9,03-02-18,12,2:45,3:00,57.31,22.74,0,22.74,22.74,-1,-83162,110270,193432,27108,0,-8655,106,0,0,,8761,-8549
9,03-02-18,13,3:00,3:15,,20.14,0,20.14,20.14,-1,-86234,117092,203326,30858,0,-20357,0,0,0,,20357,-20357
9,03-02-18,14,3:15,3:30,,18.91,0,18.91,18.91,-1,-87516,103083,190599,15567,0,-21858,0,0,0,,21858,-21858
9,03-02-18,15,3:30,3:45,,88.78,0,88.78,88.78,-1,-92893,98595,191488,5702,0,-3742,0,0,0,,3742,-3742
9,03-02-18,16,3:45,4:00,,29.51,0,29.51,29.51,-1,-82726,96624,179350,13898,0,-1739,0,0,0,,1739,-1739
9,03-02-18,17,4:00,4:15,,-95.54,0,-95.54,-95.54,-1,-122613,71855,194468,-50758,0,-26872,0,0,0,,26872,-26872
9,03-02-18,18,4:15,4:30,,-150.78,0,-150.78,-150.78,-1,-164320,29125,193445,-135195,0,-64998,0,0,0,,64998,-64998
9,03-02-18,19,4:30,4:45,,-95.45,0,-95.45,-95.45,-1,-181053,27106,208159,-153947,0,-59213,0,0,0,,59213,-59213
9,03-02-18,20,4:45,5:00,,29.97,0,29.97,29.97,-1,-146573,62674,209247,-83899,0,-22429,0,0,0,,22429,-22429
9,03-02-18,21,5:00,5:15,,73.78,0,73.78,73.78,-1,-90944,107552,198496,16608,0,-6160,0,0,0,,6160,-6160
9,03-02-18,22,5:15,5:30,,30.84,0,30.84,30.84,-1,-90657,101460,192117,10803,0,-2605,0,0,0,,2605,-2605
9,03-02-18,23,5:30,5:45,71.72,30.59,0,71.72,30.59,2,-86968,83335,170303,-3633,0,-2579,227,0,0,,2806,-2352
9,03-02-18,24,5:45,6:00,133.12,30.59,0,133.12,133.12,1,-108281,89158,197439,-19123,0,-192,11782,0,0,,11974,11590
9,03-02-18,25,6:00,6:15,133.12,-20.21,0,-20.21,-20.21,-1,-101566,115795,217361,14229,0,-9071,1856,0,0,,10927,-7215
9,03-02-18,26,6:15,6:30,164.63,30.35,0,164.63,30.35,2,-85253,88059,173312,2806,0,-506,7002,0,0,,7508,6496
9,03-02-18,27,6:30,6:45,350.12,24.45,0,350.12,24.45,2,-90464,63294,153758,-27170,0,-3428,4715,0,0,,8143,1287
9,03-02-18,28,6:45,7:00,182.39,,0,182.39,182.39,1,-104645,69688,174333,-34957,0,0,40967,0,0,,40967,40967
9,03-02-18,29,7:00,7:15,65.12,26.55,0,66.45,26.55,2,-106375,109713,216088,3338,0,-973,5334,0,0,,6307,4361
9,03-02-18,30,7:15,7:30,269.12,,0,269.12,269.12,1,-125573,107321,232894,-18252,0,0,13279,0,0,,13279,13279
9,03-02-18,31,7:30,7:45,162.74,24.64,0,162.74,24.64,2,-124313,122238,246551,-2075,0,-930,2015,0,0,,2945,1085
9,03-02-18,32,7:45,8:00,203.12,,0,203.12,203.12,1,-174894,130030,304924,-44864,0,0,31611,0,0,,31611,31611
9,03-02-18,33,8:00,8:15,226.25,,0,226.25,226.25,1,-172558,165995,338553,-6563,0,0,31235,0,0,,31235,31235
9,03-02-18,34,8:15,8:30,161.25,42.27,0,161.25,42.27,2,-139256,138225,277481,-1031,0,-58,1331,0,0,,1389,1273
9,03-02-18,35,8:30,8:45,224.25,,0,224.25,224.25,1,-148118,122372,270490,-25746,0,0,12077,0,0,,12077,12077
9,03-02-18,36,8:45,9:00,251.25,,0,251.25,251.25,1,-163646,108858,272504,-54788,0,0,40946,0,0,,40946,40946
9,03-02-18,37,9:00,9:15,320.25,,0,320.25,320.25,1,-212982,100155,313137,-112827,0,0,75689,0,0,,75689,75689
9,03-02-18,38,9:15,9:30,320.25,,0,320.25,320.25,1,-219463,102722,322185,-116741,0,0,109051,0,0,,109051,109051
9,03-02-18,39,9:30,9:45,314.25,,0,314.25,314.25,1,-211525,120828,332353,-90697,0,0,92911,0,0,,92911,92911
9,03-02-18,40,9:45,10:00,265.25,,0,265.25,265.25,1,-225715,152775,378490,-72940,0,0,74022,0,0,,74022,74022
9,03-02-18,41,10:00,10:15,260.32,,0,260.32,260.32,1,-172245,85587,257832,-86658,0,0,76244,0,0,,76244,76244
9,03-02-18,42,10:15,10:30,256.32,,0,256.32,256.32,1,-158102,99452,257554,-58650,0,0,67841,0,0,,67841,67841
9,03-02-18,43,10:30,10:45,117.94,31.61,0,117.94,31.61,2,-95781,116268,212049,20487,0,-72,22260,0,0,,22332,22188
9,03-02-18,44,10:45,11:00,,91.27,0,91.27,91.27,-1,-75281,105110,180391,29829,0,-178,0,0,0,,178,-178
9,03-02-18,45,11:00,11:15,,88.27,0,88.27,88.27,-1,-107579,128856,236435,21277,0,-1775,0,0,0,,1775,-1775
9,03-02-18,46,11:15,11:30,154.12,88.27,0,154.12,88.27,2,-143043,115429,258472,-27614,0,-826,4538,0,0,,5364,3712
9,03-02-18,47,11:30,11:45,303.12,,0,303.12,303.12,1,-202297,125725,328022,-76572,0,0,48677,0,0,,48677,48677
9,03-02-18,48,11:45,12:00,243.12,,0,243.12,243.12,1,-186450,143606,330056,-42844,0,0,60169,0,0,,60169,60169
9,03-02-18,49,12:00,12:15,128.31,,0,128.31,128.31,1,-170291,146808,317099,-23483,0,0,22807,0,0,,22807,22807
9,03-02-18,50,12:15,12:30,124.94,,0,124.94,124.94,1,-145545,148574,294119,3029,0,0,17022,0,0,,17022,17022
9,03-02-18,51,12:30,12:45,124.94,32.16,0,32.16,32.16,-1,-96448,169507,265955,73059,0,-497,1394,0,0,,1891,897
9,03-02-18,52,12:45,13:00,,21.22,0,21.22,21.22,-1,-86881,166665,253546,79784,0,-4351,0,0,0,,4351,-4351
9,03-02-18,53,13:00,13:15,,32.22,0,32.22,32.22,-1,-106175,130623,236798,24448,0,-6427,0,0,0,,6427,-6427
9,03-02-18,54,13:15,13:30,,31.71,0,31.71,31.71,-1,-121332,154635,275967,33303,0,-4102,0,0,0,,4102,-4102
9,03-02-18,55,13:30,13:45,98,86.21,0,98,98,1,-134916,130351,265267,-4565,0,-1448,70,0,0,,1518,-1378
9,03-02-18,56,13:45,14:00,104.07,,0,104.07,104.07,1,-131172,133786,264958,2614,0,0,1229,0,0,,1229,1229
9,03-02-18,57,14:00,14:15,107.57,,0,107.57,107.57,1,-132186,111942,244128,-20244,0,0,3152,0,0,,3152,3152
9,03-02-18,58,14:15,14:30,104.5,,0,104.5,104.5,1,-129355,95179,224534,-34176,0,0,2714,0,0,,2714,2714
9,03-02-18,59,14:30,14:45,123.32,,0,123.32,123.32,1,-124035,95825,219860,-28210,0,0,2276,0,0,,2276,2276
9,03-02-18,60,14:45,15:00,99,,0,99,99,1,-126559,88291,214850,-38268,0,0,2402,0,0,,2402,2402
9,03-02-18,61,15:00,15:15,202.44,-93.64,0,202.44,-93.64,2,-88874,132536,221410,43662,0,-14701,1038,0,0,,15739,-13663
9,03-02-18,62,15:15,15:30,314.15,,0,314.15,314.15,1,-112011,120335,232346,8324,0,0,7742,0,0,,7742,7742
9,03-02-18,63,15:30,15:45,,86.21,0,86.21,86.21,-1,-92375,132978,225353,40603,0,-612,0,0,0,,612,-612
9,03-02-18,64,15:45,16:00,,31.06,0,31.06,31.06,-1,-97948,105374,203322,7426,0,-692,0,0,0,,692,-692
9,03-02-18,65,16:00,16:15,,-67.74,0,-67.74,-67.74,-1,-67344,197800,265144,130456,0,-26466,0,0,0,,26466,-26466
9,03-02-18,66,16:15,16:30,,32.25,0,32.25,32.25,-1,-93486,143865,237351,50379,0,-7925,0,0,0,,7925,-7925
9,03-02-18,67,16:30,16:45,,31.35,0,31.35,31.35,-1,-101664,121625,223289,19961,0,-4427,0,0,0,,4427,-4427
9,03-02-18,68,16:45,17:00,98,21.9,0,98,21.9,2,-100409,130841,231250,30432,0,-5172,2,0,0,,5174,-5170
9,03-02-18,69,17:00,17:15,308.15,32.04,0,308.15,32.04,2,-126654,86542,213196,-40112,0,-1270,8254,0,0,,9524,6984
9,03-02-18,70,17:15,17:30,,5.98,0,5.98,5.98,-1,-102731,129090,231821,26359,0,-14501,0,0,0,,14501,-14501
9,03-02-18,71,17:30,17:45,,30.12,0,30.12,30.12,-1,-98987,115275,214262,16288,0,-8109,0,0,0,,8109,-8109
9,03-02-18,72,17:45,18:00,,25.71,0,25.71,25.71,-1,-79739,109242,188981,29503,0,-7952,0,0,0,,7952,-7952
9,03-02-18,73,18:00,18:15,,-20.23,0,-20.23,-20.23,-1,-107487,142644,250131,35157,0,-32314,0,0,0,,32314,-32314
9,03-02-18,74,18:15,18:30,,32.03,0,32.03,32.03,-1,-112529,142353,254882,29824,0,-20614,0,0,0,,20614,-20614
9,03-02-18,75,18:30,18:45,98,32.03,0,98,98,1,-119618,122443,242061,2825,0,-3502,65,0,0,,3567,-3437
9,03-02-18,76,18:45,19:00,98,,0,98,98,1,-106931,118374,225305,11443,0,0,521,0,0,,521,521
9,03-02-18,77,19:00,19:15,,32.2,0,32.2,32.2,-1,-103489,113274,216763,9785,0,-539,0,0,0,,539,-539
9,03-02-18,78,19:15,19:30,,28.42,0,28.42,28.42,-1,-116103,131325,247428,15222,0,-9855,0,0,0,,9855,-9855
9,03-02-18,79,19:30,19:45,,-10.69,0,-10.69,-10.69,-1,-116558,145735,262293,29177,0,-6944,0,0,0,,6944,-6944
9,03-02-18,80,19:45,20:00,170.86,-15.06,0,170.86,-15.06,2,-148147,133792,281939,-14355,0,-18220,247,0,0,,18467,-17973
9,03-02-18,81,20:00,20:15,162.08,88.21,0,162.08,88.21,2,-133820,140318,274138,6498,0,-154,724,0,0,,878,570
9,03-02-18,82,20:15,20:30,,30.09,0,30.09,30.09,-1,-114559,140986,255545,26427,0,-7155,0,0,0,,7155,-7155
9,03-02-18,83,20:30,20:45,,20.68,0,20.68,20.68,-1,-116597,157189,273786,40592,0,-30384,0,0,0,,30384,-30384
9,03-02-18,84,20:45,21:00,,26.49,0,26.49,26.49,-1,-113760,175149,288909,61389,0,-46223,0,0,0,,46223,-46223
9,03-02-18,85,21:00,21:15,392.15,30.56,0,392.15,392.15,1,-186189,124308,310497,-61881,0,-19003,7583,0,0,,26586,-11420
9,03-02-18,86,21:15,21:30,210.75,,0,210.75,210.75,1,-134259,112780,247039,-21479,0,0,21478,0,0,,21478,21478
9,03-02-18,87,21:30,21:45,161.93,26.42,0,161.93,26.42,2,-121312,121761,243073,449,0,-2426,3301,0,0,,5727,875
9,03-02-18,88,21:45,22:00,221.15,,0,221.15,221.15,1,-128941,109755,238696,-19186,0,0,12737,0,0,,12737,12737
9,03-02-18,89,22:00,22:15,126.35,-14.56,0,126.35,-14.56,2,-101570,135890,237460,34320,0,-8260,4084,0,0,,12344,-4176
9,03-02-18,90,22:15,22:30,515.15,112.46,0,515.15,105.08,2,-85777,76561,162338,-9216,0,-226,17832,0,0,,18058,17606
9,03-02-18,91,22:30,22:45,515.15,10.09,0,10.09,10.09,-1,-71243,93367,164610,22124,0,-16631,228,0,0,,16859,-16403
9,03-02-18,92,22:45,23:00,68.48,62.58,0,80.1,62.58,2,-83904,90610,174514,6706,0,-2343,332,0,0,,2675,-2011
9,03-02-18,93,23:00,23:15,515.15,-87.2,0,515.15,-87.2,2,-98262,81516,179778,-16746,0,-16048,4261,0,0,,20309,-11787
9,03-02-18,94,23:15,23:30,515.15,11.28,0,515.15,11.28,2,-91513,111809,203322,20296,0,-1626,29664,0,0,,31290,28038
9,03-02-18,95,23:30,23:45,67.52,-43.12,0,78.13,-43.12,2,-90581,111580,202161,20999,0,-15195,221,0,0,,15416,-14974
9,03-02-18,96,23:45,0:00,70.82,65.55,0,78.13,65.55,2,-100982,95622,196604,-5360,0,-18,1599,0,0,,1617,1581
10,03-03-18,1,0:00,0:15,70.82,31.03,0,31.03,31.03,-1,-81927,107817,189744,25890,0,-167,85,0,0,,252,-82
10,03-03-18,2,0:15,0:30,71.99,,0,71.99,71.99,1,-98724,77487,176211,-21237,0,0,7178,0,0,,7178,7178
10,03-03-18,3,0:30,0:45,53.62,,0,53.62,53.62,1,-95416,83384,178800,-12032,0,0,9994,0,0,,9994,9994
10,03-03-18,4,0:45,1:00,53.2,,0,53.2,53.2,1,-111360,98168,209528,-13192,0,0,1832,0,0,,1832,1832
10,03-03-18,5,1:00,1:15,103.02,,0,103.02,103.02,1,-94577,66044,160621,-28533,0,0,23057,0,0,,23057,23057
10,03-03-18,6,1:15,1:30,58.02,,0,58.02,58.02,1,-82505,62721,145226,-19784,0,0,18830,0,0,,18830,18830
10,03-03-18,7,1:30,1:45,52.79,,0,52.79,52.79,1,-84989,67138,152127,-17851,0,0,11857,0,0,,11857,11857
10,03-03-18,8,1:45,2:00,44.02,,0,44.02,44.02,1,-79499,72668,152167,-6831,0,0,4386,0,0,,4386,4386
10,03-03-18,9,2:00,2:15,71.7,78.03,0,71.7,54.53,2,-92346,68466,160812,-23880,0,-72,4976,0,0,,5048,4904
10,03-03-18,10,2:15,2:30,73.3,,0,73.3,73.3,1,-92126,65319,157445,-26807,0,0,26199,0,0,,26199,26199
10,03-03-18,11,2:30,2:45,61.67,,0,61.67,61.67,1,-97684,56385,154069,-41299,0,0,24658,0,0,,24658,24658
10,03-03-18,12,2:45,3:00,54.22,,0,54.22,54.22,1,-98435,61811,160246,-36624,0,0,20184,0,0,,20184,20184
10,03-03-18,13,3:00,3:15,116.6,,0,116.6,116.6,1,-124027,45703,169730,-78324,0,0,33882,0,0,,33882,33882
10,03-03-18,14,3:15,3:30,93.33,,0,93.33,93.33,1,-119550,38162,157712,-81388,0,0,46055,0,0,,46055,46055
10,03-03-18,15,3:30,3:45,99.1,,0,99.1,99.1,1,-106347,47386,153733,-58961,0,0,48116,0,0,,48116,48116
10,03-03-18,16,3:45,4:00,64.72,,0,64.72,64.72,1,-97894,43484,141378,-54410,0,0,43020,0,0,,43020,43020
10,03-03-18,17,4:00,4:15,60.02,,0,60.02,60.02,1,-104696,62165,166861,-42531,0,0,36139,0,0,,36139,36139
10,03-03-18,18,4:15,4:30,61.8,,0,61.8,61.8,1,-102069,57758,159827,-44311,0,0,35679,0,0,,35679,35679
10,03-03-18,19,4:30,4:45,59.67,,0,59.67,59.67,1,-92473,55637,148110,-36836,0,0,31228,0,0,,31228,31228
10,03-03-18,20,4:45,5:00,38.03,,0,38.03,38.03,1,-68707,54414,123121,-14293,0,0,9929,0,0,,9929,9929
10,03-03-18,21,5:00,5:15,93.11,,0,93.11,93.11,1,-100146,50585,150731,-49561,0,0,12152,0,0,,12152,12152
10,03-03-18,22,5:15,5:30,56.49,,0,56.49,56.49,1,-121890,58397,180287,-63493,0,0,20612,0,0,,20612,20612
10,03-03-18,23,5:30,5:45,54.02,,0,54.02,54.02,1,-100107,63708,163815,-36399,0,0,21309,0,0,,21309,21309
10,03-03-18,24,5:45,6:00,49.02,,0,49.02,49.02,1,-82810,69568,152378,-13242,0,0,8500,0,0,,8500,8500
10,03-03-18,25,6:00,6:15,,29.54,0,29.54,29.54,-1,-76258,78146,154404,1888,0,-1170,0,0,0,,1170,-1170
10,03-03-18,26,6:15,6:30,37.54,69.03,0,37.54,37.54,1,-80229,60408,140637,-19821,0,-250,73,0,0,,323,-177
10,03-03-18,27,6:30,6:45,350.02,,0,350.02,350.02,1,-103212,47028,150240,-56184,0,0,25478,0,0,,25478,25478
10,03-03-18,28,6:45,7:00,77.02,,0,77.02,77.02,1,-106278,76217,182495,-30061,0,0,37450,0,0,,37450,37450
10,03-03-18,29,7:00,7:15,33.54,49.84,0,56.03,49.84,2,-53308,95178,148486,41870,0,-915,8811,0,0,,9726,7896
10,03-03-18,30,7:15,7:30,,55.4,0,55.4,55.4,-1,-43119,96170,139289,53051,0,-115,0,0,0,,115,-115
10,03-03-18,31,7:30,7:45,,51.85,0,51.85,51.85,-1,-53728,81166,134894,27438,0,-952,0,0,0,,952,-952
10,03-03-18,32,7:45,8:00,,54.03,0,54.03,54.03,-1,-74671,61491,136162,-13180,0,-1028,0,0,0,,1028,-1028
10,03-03-18,33,8:00,8:15,,-125.03,0,-125.03,-125.03,-1,-29178,121299,150477,92121,0,-17620,0,0,0,,17620,-17620
10,03-03-18,34,8:15,8:30,,51.15,0,51.15,51.15,-1,-51615,97978,149593,46363,0,-3052,0,0,0,,3052,-3052
10,03-03-18,35,8:30,8:45,,63.03,0,63.03,63.03,-1,-63357,83243,146600,19886,0,-1768,0,0,0,,1768,-1768
10,03-03-18,36,8:45,9:00,59.69,63.03,0,59.69,59.69,1,-82656,62463,145119,-20193,0,-447,2378,0,0,,2825,1931
10,03-03-18,37,9:00,9:15,56.82,,0,56.82,56.82,1,-87157,88363,175520,1206,0,0,2750,0,0,,2750,2750
10,03-03-18,38,9:15,9:30,62.48,,0,62.48,62.48,1,-94451,75413,169864,-19038,0,0,7258,0,0,,7258,7258
10,03-03-18,39,9:30,9:45,115.02,,0,115.02,115.02,1,-102174,62015,164189,-40159,0,0,27515,0,0,,27515,27515
10,03-03-18,40,9:45,10:00,137.02,,0,137.02,137.02,1,-112879,65203,178082,-47676,0,0,37956,0,0,,37956,37956
10,03-03-18,41,10:00,10:15,350.02,,0,350.02,350.02,1,-147996,40455,188451,-107541,0,0,63649,0,0,,63649,63649
10,03-03-18,42,10:15,10:30,350.02,,0,350.02,350.02,1,-136761,74516,211277,-62245,0,0,65840,0,0,,65840,65840
10,03-03-18,43,10:30,10:45,125.36,,0,125.36,125.36,1,-115937,88716,204653,-27221,0,0,32670,0,0,,32670,32670
10,03-03-18,44,10:45,11:00,53.61,,0,53.61,53.61,1,-116050,95880,211930,-20170,0,0,7392,0,0,,7392,7392
10,03-03-18,45,11:00,11:15,350.02,,0,350.02,350.02,1,-145981,70776,216757,-75205,0,0,15436,0,0,,15436,15436
10,03-03-18,46,11:15,11:30,350.02,,0,350.02,350.02,1,-135503,90569,226072,-44934,0,0,44039,0,0,,44039,44039
10,03-03-18,47,11:30,11:45,127.33,,0,127.33,127.33,1,-141771,91403,233174,-50368,0,0,21508,0,0,,21508,21508
10,03-03-18,48,11:45,12:00,179.73,,0,179.73,179.73,1,-144423,89848,234271,-54575,0,0,45030,0,0,,45030,45030
10,03-03-18,49,12:00,12:15,339.02,,0,339.02,339.02,1,-152398,79970,232368,-72428,0,0,40670,0,0,,40670,40670
10,03-03-18,50,12:15,12:30,340.02,,0,340.02,340.02,1,-138014,84297,222311,-53717,0,0,52609,0,0,,52609,52609
10,03-03-18,51,12:30,12:45,72.03,,0,72.03,72.03,1,-128084,77178,205262,-50906,0,0,41505,0,0,,41505,41505
10,03-03-18,52,12:45,13:00,61.41,,0,61.41,61.41,1,-122613,80660,203273,-41953,0,0,34848,0,0,,34848,34848
10,03-03-18,53,13:00,13:15,252.02,,0,252.02,252.02,1,-148557,83088,231645,-65469,0,0,36366,0,0,,36366,36366
10,03-03-18,54,13:15,13:30,239.02,,0,239.02,239.02,1,-133860,71322,205182,-62538,0,0,63513,0,0,,63513,63513
10,03-03-18,55,13:30,13:45,64.03,,0,64.03,64.03,1,-124967,78723,203690,-46244,0,0,42814,0,0,,42814,42814
10,03-03-18,56,13:45,14:00,76.41,,0,76.41,76.41,1,-131820,76288,208108,-55532,0,0,39048,0,0,,39048,39048
10,03-03-18,57,14:00,14:15,67.78,,0,67.78,67.78,1,-108460,61705,170165,-46755,0,0,32716,0,0,,32716,32716
10,03-03-18,58,14:15,14:30,59.02,,0,59.02,59.02,1,-101185,66916,168101,-34269,0,0,33584,0,0,,33584,33584
10,03-03-18,59,14:30,14:45,59.02,49.89,0,49.89,49.89,-1,-91423,75590,167013,-15833,0,-10,6778,0,0,,6788,6768
10,03-03-18,60,14:45,15:00,,50.2,0,50.2,50.2,-1,-88048,88588,176636,540,0,-174,0,0,0,,174,-174
10,03-03-18,61,15:00,15:15,,23.19,0,23.19,23.19,-1,-50296,156334,206630,106038,0,-3012,0,0,0,,3012,-3012
10,03-03-18,62,15:15,15:30,,59.03,0,59.03,59.03,-1,-52265,141812,194077,89547,0,-2381,0,0,0,,2381,-2381
10,03-03-18,63,15:30,15:45,,47.58,0,47.58,47.58,-1,-52589,151449,204038,98860,0,-3144,0,0,0,,3144,-3144
10,03-03-18,64,15:45,16:00,,18.25,0,18.25,18.25,-1,-56405,142220,198625,85815,0,-6102,0,0,0,,6102,-6102
10,03-03-18,65,16:00,16:15,,53.11,0,53.11,53.11,-1,-65208,101959,167167,36751,0,-5646,0,0,0,,5646,-5646
10,03-03-18,66,16:15,16:30,33.54,52.94,0,33.54,33.54,1,-79027,82870,161897,3843,0,-2880,17,0,0,,2897,-2863
10,03-03-18,67,16:30,16:45,122.02,,0,122.02,122.02,1,-97347,67848,165195,-29499,0,0,8176,0,0,,8176,8176
10,03-03-18,68,16:45,17:00,350.02,,0,350.02,350.02,1,-123804,50366,174170,-73438,0,0,56664,0,0,,56664,56664
10,03-03-18,69,17:00,17:15,350.02,27.99,0,27.99,27.99,-1,-54350,158183,212533,103833,0,-2046,17578,0,0,,19624,15532
10,03-03-18,70,17:15,17:30,,72.03,0,72.03,72.03,-1,-60737,94830,155567,34093,0,-90,0,0,0,,90,-90
10,03-03-18,71,17:30,17:45,,54.83,0,54.83,54.83,-1,-69791,82731,152522,12940,0,-1215,0,0,0,,1215,-1215
10,03-03-18,72,17:45,18:00,59.2,54.83,0,59.2,59.2,1,-92380,91550,183930,-830,0,-35,725,0,0,,760,690
10,03-03-18,73,18:00,18:15,146.68,,0,146.68,146.68,1,-74481,51650,126131,-22831,0,0,9470,0,0,,9470,9470
10,03-03-18,74,18:15,18:30,59.22,51.43,0,59.22,51.43,2,-64816,56412,121228,-8404,0,-80,2262,0,0,,2342,2182
10,03-03-18,75,18:30,18:45,344.02,,0,344.02,344.02,1,-88936,40423,129359,-48513,0,0,31585,0,0,,31585,31585
10,03-03-18,76,18:45,19:00,348.02,,0,348.02,348.02,1,-91619,46697,138316,-44922,0,0,55806,0,0,,55806,55806
10,03-03-18,77,19:00,19:15,350.02,,0,350.02,350.02,1,-125244,33262,158506,-91982,0,0,60702,0,0,,60702,60702
10,03-03-18,78,19:15,19:30,350.02,,0,350.02,350.02,1,-109786,48462,158248,-61324,0,0,65579,0,0,,65579,65579
10,03-03-18,79,19:30,19:45,76.1,,0,76.1,76.1,1,-92820,63174,155994,-29646,0,0,22968,0,0,,22968,22968
10,03-03-18,80,19:45,20:00,86.1,,0,86.1,86.1,1,-86174,60053,146227,-26121,0,0,14441,0,0,,14441,14441
10,03-03-18,81,20:00,20:15,139,,0,139,139,1,-89861,59759,149620,-30102,0,0,12450,0,0,,12450,12450
10,03-03-18,82,20:15,20:30,89.04,,0,89.04,89.04,1,-77119,38274,115393,-38845,0,0,22745,0,0,,22745,22745
10,03-03-18,83,20:30,20:45,62.02,,0,62.02,62.02,1,-69137,45918,115055,-23219,0,0,23689,0,0,,23689,23689
10,03-03-18,84,20:45,21:00,62.02,32.28,0,32.28,32.28,-1,-64876,71737,136613,6861,0,-4652,5085,0,0,,9737,433
10,03-03-18,85,21:00,21:15,350.02,32.28,0,350.02,350.02,1,-110197,34818,145015,-75379,0,-419,22654,0,0,,23073,22235
10,03-03-18,86,21:15,21:30,118.82,55.31,0,118.82,55.03,2,-70610,67710,138320,-2900,0,-2,32812,0,0,,32814,32810
10,03-03-18,87,21:30,21:45,118.82,46.86,0,46.86,46.86,-1,-68594,90550,159144,21956,0,-243,602,0,0,,845,359
10,03-03-18,88,21:45,22:00,37.54,65.03,0,55.03,55.03,2,-63191,53813,117004,-9378,0,-166,376,0,0,,542,210
10,03-03-18,89,22:00,22:15,60.48,,0,60.48,60.48,1,-88676,69030,157706,-19646,0,0,1615,0,0,,1615,1615
10,03-03-18,90,22:15,22:30,62.08,,0,62.08,62.08,1,-82763,45090,127853,-37673,0,0,3839,0,0,,3839,3839
10,03-03-18,91,22:30,22:45,59.75,,0,59.75,59.75,1,-71612,51298,122910,-20314,0,0,5038,0,0,,5038,5038
10,03-03-18,92,22:45,23:00,53.8,,0,53.8,53.8,1,-66906,62814,129720,-4092,0,0,10857,0,0,,10857,10857
10,03-03-18,93,23:00,23:15,,,0,55.03,55.03,0,-118919,39678,158597,-79241,0,0,1344,0,0,,1344,1344
10,03-03-18,94,23:15,23:30,,,0,55.03,55.03,0,-106980,52706,159686,-54274,0,0,0,0,0,,0,0
10,03-03-18,95,23:30,23:45,,,0,55.03,55.03,0,-109022,62674,171696,-46348,0,0,0,0,0,,0,0
10,03-03-18,96,23:45,0:00,,,0,55.03,55.03,0,-91562,74910,166472,-16652,0,0,0,0,0,,0,0
10,03-04-18,1,0:00,0:15,294.12,,0,294.12,294.12,1,-107857,53228,161085,-54629,0,0,6846,0,0,,6846,6846
10,03-04-18,2,0:15,0:30,294.12,,0,294.12,294.12,1,-89124,33994,123118,-55130,0,0,48847,0,0,,48847,48847
10,03-04-18,3,0:30,0:45,56.34,,0,56.34,56.34,1,-60386,35810,96196,-24576,0,0,21885,0,0,,21885,21885
10,03-04-18,4,0:45,1:00,63.12,,0,63.12,63.12,1,-81508,44531,126039,-36977,0,0,13064,0,0,,13064,13064
10,03-04-18,5,1:00,1:15,54.77,,0,54.77,54.77,1,-67026,68151,135177,1125,0,0,5527,0,0,,5527,5527
10,03-04-18,6,1:15,1:30,57.67,,0,57.67,57.67,1,-56604,44666,101270,-11938,0,0,4604,0,0,,4604,4604
10,03-04-18,7,1:30,1:45,55.26,,0,55.26,55.26,1,-68156,41447,109603,-26709,0,0,821,0,0,,821,821
10,03-04-18,8,1:45,2:00,33.54,,0,33.54,33.54,1,-86841,45509,132350,-41332,0,0,838,0,0,,838,838
10,03-04-18,9,2:00,2:15,57.17,,0,57.17,57.17,1,-72350,55037,127387,-17313,0,0,4865,0,0,,4865,4865
10,03-04-18,10,2:15,2:30,40.12,,0,40.12,40.12,1,-69343,48638,117981,-20705,0,0,4057,0,0,,4057,4057
10,03-04-18,11,2:30,2:45,64.6,,0,64.6,64.6,1,-80096,40507,120603,-39589,0,0,6087,0,0,,6087,6087
10,03-04-18,12,2:45,3:00,,,0,43.04,43.04,0,-69177,39570,108747,-29607,0,0,463,0,0,,463,463
10,03-04-18,13,3:00,3:15,66.5,,0,66.5,66.5,1,-91078,46062,137140,-45016,0,0,3553,0,0,,3553,3553
10,03-04-18,14,3:15,3:30,99.62,,0,99.62,99.62,1,-93261,47665,140926,-45596,0,0,29461,0,0,,29461,29461
10,03-04-18,15,3:30,3:45,35.12,,0,35.12,35.12,1,-66326,46757,113083,-19569,0,0,8077,0,0,,8077,8077
10,03-04-18,16,3:45,4:00,,,0,42.95,42.95,0,-70553,51311,121864,-19242,0,0,0,0,0,,0,0
10,03-04-18,17,4:00,4:15,54.1,,0,54.1,54.1,1,-89230,68833,158063,-20397,0,0,362,0,0,,362,362
10,03-04-18,18,4:15,4:30,69.84,,0,69.84,69.84,1,-93426,67061,160487,-26365,0,0,20284,0,0,,20284,20284
10,03-04-18,19,4:30,4:45,33.54,50.6,0,42.87,42.87,2,-55510,68595,124105,13085,0,-734,6609,0,0,,7343,5875
10,03-04-18,20,4:45,5:00,,47.78,0,47.78,47.78,-1,-81694,101658,183352,19964,0,-1380,0,0,0,,1380,-1380
10,03-04-18,21,5:00,5:15,54.09,50.8,0,54.09,43.03,2,-79256,62891,142147,-16365,0,-1625,211,0,0,,1836,-1414
10,03-04-18,22,5:15,5:30,60.77,,0,60.77,60.77,1,-90632,65632,156264,-25000,0,0,17183,0,0,,17183,17183
10,03-04-18,23,5:30,5:45,58.81,,0,58.81,58.81,1,-93944,66703,160647,-27241,0,0,16625,0,0,,16625,16625
10,03-04-18,24,5:45,6:00,76.83,,0,76.83,76.83,1,-101352,72457,173809,-28895,0,0,33345,0,0,,33345,33345
10,03-04-18,25,6:00,6:15,76.83,52.78,0,52.78,52.78,-1,-87858,98780,186638,10922,0,-1123,8066,0,0,,9189,6943
10,03-04-18,26,6:15,6:30,33.36,,0,33.36,33.36,1,-90711,75994,166705,-14717,0,0,104,0,0,,104,104
10,03-04-18,27,6:30,6:45,39.36,,0,39.36,39.36,1,-98917,71977,170894,-26940,0,0,78,0,0,,78,78
10,03-04-18,28,6:45,7:00,133.12,,0,133.12,133.12,1,-98694,61881,160575,-36813,0,0,23502,0,0,,23502,23502
10,03-04-18,29,7:00,7:15,54.22,-34.78,0,-34.78,-34.78,-1,-56684,117569,174253,60885,0,-9571,9314,0,0,,18885,-257
10,03-04-18,30,7:15,7:30,,-41.78,0,-41.78,-41.78,-1,-64145,100390,164535,36245,0,-25653,0,0,0,,25653,-25653
10,03-04-18,31,7:30,7:45,,23.28,0,23.28,23.28,-1,-55243,94130,149373,38887,0,-19303,0,0,0,,19303,-19303
10,03-04-18,32,7:45,8:00,,40.78,0,40.78,40.78,-1,-64680,94476,159156,29796,0,-8575,0,0,0,,8575,-8575
10,03-04-18,33,8:00,8:15,,-89.78,0,-89.78,-89.78,-1,-39709,108063,147772,68354,0,-23398,0,0,0,,23398,-23398
10,03-04-18,34,8:15,8:30,58.06,30.36,0,58.06,58.06,1,-80295,71608,151903,-8687,0,-8205,497,0,0,,8702,-7708
10,03-04-18,35,8:30,8:45,134.12,30.36,0,134.12,134.12,1,-109694,62741,172435,-46953,0,-48,30986,0,0,,31034,30938
10,03-04-18,36,8:45,9:00,65.89,,0,65.89,65.89,1,-93376,57545,150921,-35831,0,0,37524,0,0,,37524,37524
10,03-04-18,37,9:00,9:15,65.4,,0,65.4,65.4,1,-85246,64697,149943,-20549,0,0,27017,0,0,,27017,27017
10,03-04-18,38,9:15,9:30,99.12,,0,99.12,99.12,1,-83708,49637,133345,-34071,0,0,12348,0,0,,12348,12348
10,03-04-18,39,9:30,9:45,73,,0,73,73,1,-87285,48353,135638,-38932,0,0,30690,0,0,,30690,30690
10,03-04-18,40,9:45,10:00,60.58,,0,60.58,60.58,1,-78198,63341,141539,-14857,0,0,26884,0,0,,26884,26884
10,03-04-18,41,10:00,10:15,60.58,55.46,0,55.46,55.46,-1,-73902,62475,136377,-11427,0,-151,3640,0,0,,3791,3489
10,03-04-18,42,10:15,10:30,58.77,,0,58.77,58.77,1,-77550,58818,136368,-18732,0,0,8148,0,0,,8148,8148
10,03-04-18,43,10:30,10:45,57.72,,0,57.72,57.72,1,-80791,53747,134538,-27044,0,0,18117,0,0,,18117,18117
10,03-04-18,44,10:45,11:00,68.12,,0,68.12,68.12,1,-82382,59073,141455,-23309,0,0,20704,0,0,,20704,20704
10,03-04-18,45,11:00,11:15,89.49,-20.78,0,89.49,-20.78,2,-77407,92104,169511,14697,0,-9739,6866,0,0,,16605,-2873
10,03-04-18,46,11:15,11:30,133.12,21.07,0,133.12,21.07,2,-71779,96946,168725,25167,0,-1676,15612,0,0,,17288,13936
10,03-04-18,47,11:30,11:45,,12.35,0,12.35,12.35,-1,-65671,106301,171972,40630,0,-23624,0,0,0,,23624,-23624
10,03-04-18,48,11:45,12:00,,-5.56,0,-5.56,-5.56,-1,-61903,121125,183028,59222,0,-41764,0,0,0,,41764,-41764
10,03-04-18,49,12:00,12:15,,-4.35,0,-4.35,-4.35,-1,-56885,126068,182953,69183,0,-52184,0,0,0,,52184,-52184
10,03-04-18,50,12:15,12:30,,-18.64,0,-18.64,-18.64,-1,-60388,148444,208832,88056,0,-66274,0,0,0,,66274,-66274
10,03-04-18,51,12:30,12:45,,4.78,0,4.78,4.78,-1,-56255,142803,199058,86548,0,-71207,0,0,0,,71207,-71207
10,03-04-18,52,12:45,13:00,,-65.78,0,-65.78,-65.78,-1,-59625,153966,213591,94341,0,-79039,0,0,0,,79039,-79039
10,03-04-18,53,13:00,13:15,,-31.78,0,-31.78,-31.78,-1,-71399,204145,275544,132746,0,-90098,0,0,0,,90098,-90098
10,03-04-18,54,13:15,13:30,,-145.78,0,-145.78,-145.78,-1,-84236,179803,264039,95567,0,-92759,0,0,0,,92759,-92759
10,03-04-18,55,13:30,13:45,,11.5,0,11.5,11.5,-1,-71316,144803,216119,73487,0,-64170,0,0,0,,64170,-64170
10,03-04-18,56,13:45,14:00,,-41.78,0,-41.78,-41.78,-1,-77275,142839,220114,65564,0,-69599,0,0,0,,69599,-69599
10,03-04-18,57,14:00,14:15,,19.72,0,19.72,19.72,-1,-60933,129472,190405,68539,0,-34049,0,0,0,,34049,-34049
10,03-04-18,58,14:15,14:30,,-150.78,0,-150.78,-150.78,-1,-43081,144981,188062,101900,0,-16938,0,0,0,,16938,-16938
10,03-04-18,59,14:30,14:45,,26.34,0,26.34,26.34,-1,-55830,119024,174854,63194,0,-25786,0,0,0,,25786,-25786
10,03-04-18,60,14:45,15:00,,22.38,0,22.38,22.38,-1,-61380,97052,158432,35672,0,-30938,0,0,0,,30938,-30938
10,03-04-18,61,15:00,15:15,,47.78,0,47.78,47.78,-1,-59704,58231,117935,-1473,0,-11395,0,0,0,,11395,-11395
10,03-04-18,62,15:15,15:30,,47.85,0,47.85,47.85,-1,-55668,64162,119830,8494,0,-1772,0,0,0,,1772,-1772
10,03-04-18,63,15:30,15:45,,54.6,0,54.6,54.6,-1,-62340,51640,113980,-10700,0,-3719,0,0,0,,3719,-3719
10,03-04-18,64,15:45,16:00,,54.99,0,54.99,54.99,-1,-72971,40520,113491,-32451,0,-2009,0,0,0,,2009,-2009
10,03-04-18,65,16:00,16:15,,53.45,0,53.45,53.45,-1,-51272,44335,95607,-6937,0,-1685,0,0,0,,1685,-1685
10,03-04-18,66,16:15,16:30,,54.42,0,54.42,54.42,-1,-54333,33335,87668,-20998,0,-265,0,0,0,,265,-265
10,03-04-18,67,16:30,16:45,58.15,54.4,0,58.15,58.15,1,-70973,31333,102306,-39640,0,-81,955,0,0,,1036,874
10,03-04-18,68,16:45,17:00,123.12,,0,123.12,123.12,1,-80394,34207,114601,-46187,0,0,24894,0,0,,24894,24894
10,03-04-18,69,17:00,17:15,123.12,17.48,0,17.48,17.48,-1,-68030,77261,145291,9231,0,-5445,8895,0,0,,14340,3450
10,03-04-18,70,17:15,17:30,50.12,55.45,0,50.12,43.79,2,-68928,59960,128888,-8968,0,-411,592,0,0,,1003,181
10,03-04-18,71,17:30,17:45,,,0,43.79,43.79,0,-59816,63747,123563,3931,0,0,0,0,0,,0,0
10,03-04-18,72,17:45,18:00,57.81,,0,57.81,57.81,1,-67766,60333,128099,-7433,0,0,6579,0,0,,6579,6579
10,03-04-18,73,18:00,18:15,50.12,-44.78,0,50.12,-44.78,2,-41233,74087,115320,32854,0,-12540,4636,0,0,,17176,-7904
10,03-04-18,74,18:15,18:30,59.31,28.87,0,59.31,59.31,1,-70839,59128,129967,-11711,0,-12622,1912,0,0,,14534,-10710
10,03-04-18,75,18:30,18:45,64.94,28.87,0,64.94,64.94,1,-60453,54736,115189,-5717,0,-74,7141,0,0,,7215,7067
10,03-04-18,76,18:45,19:00,60.94,,0,60.94,60.94,1,-61994,49612,111606,-12382,0,0,743,0,0,,743,743
10,03-04-18,77,19:00,19:15,142.12,,0,142.12,142.12,1,-101762,43486,145248,-58276,0,0,34123,0,0,,34123,34123
10,03-04-18,78,19:15,19:30,61.37,22.62,0,22.62,22.62,-1,-64189,73276,137465,9087,0,-1522,14351,0,0,,15873,12829
10,03-04-18,79,19:30,19:45,61.37,15.78,0,15.78,15.78,-1,-70036,69711,139747,-325,0,-9159,26,0,0,,9185,-9133
10,03-04-18,80,19:45,20:00,,6,0,6,6,-1,-51477,87810,139287,36333,0,-12531,0,0,0,,12531,-12531
10,03-04-18,81,20:00,20:15,69.42,44.78,0,69.42,43.75,2,-76179,52708,128887,-23471,0,-6443,2002,0,0,,8445,-4441
10,03-04-18,82,20:15,20:30,,14.78,0,14.78,14.78,-1,-62196,81009,143205,18813,0,-2932,0,0,0,,2932,-2932
10,03-04-18,83,20:30,20:45,,7.46,0,7.46,7.46,-1,-75866,102313,178179,26447,0,-24515,0,0,0,,24515,-24515
10,03-04-18,84,20:45,21:00,,22.61,0,22.61,22.61,-1,-86208,126674,212882,40466,0,-29691,0,0,0,,29691,-29691
10,03-04-18,85,21:00,21:15,,29.72,0,29.72,29.72,-1,-71001,76715,147716,5714,0,-16505,0,0,0,,16505,-16505
10,03-04-18,86,21:15,21:30,59.95,29.72,0,59.95,59.95,1,-78036,75631,153667,-2405,0,-215,2721,0,0,,2936,2506
10,03-04-18,87,21:30,21:45,,55.02,0,55.02,55.02,-1,-57487,109708,167195,52221,0,-75,0,0,0,,75,-75
10,03-04-18,88,21:45,22:00,,-115.78,0,-115.78,-115.78,-1,-56323,158650,214973,102327,0,-19849,0,0,0,,19849,-19849
10,03-04-18,89,22:00,22:15,42.64,25.14,0,43.73,25.14,2,-82353,54422,136775,-27931,0,-9719,50,0,0,,9769,-9669
10,03-04-18,90,22:15,22:30,,-76.91,0,-76.91,-76.91,-1,-62941,110715,173656,47774,0,-20788,0,0,0,,20788,-20788
10,03-04-18,91,22:30,22:45,,21.06,0,21.06,21.06,-1,-62363,137328,199691,74965,0,-34241,0,0,0,,34241,-34241
10,03-04-18,92,22:45,23:00,,-65.54,0,-65.54,-65.54,-1,-56196,167004,223200,110808,0,-12254,0,0,0,,12254,-12254
10,03-04-18,93,23:00,23:15,,-107.78,0,-107.78,-107.78,-1,-65199,80648,145847,15449,0,-22103,0,0,0,,22103,-22103
10,03-04-18,94,23:15,23:30,,-92.78,0,-92.78,-92.78,-1,-76324,142206,218530,65882,0,-35019,0,0,0,,35019,-35019
10,03-04-18,95,23:30,23:45,,-32.78,0,-32.78,-32.78,-1,-89837,148452,238289,58615,0,-45601,0,0,0,,45601,-45601
10,03-04-18,96,23:45,0:00,,-91.78,0,-91.78,-91.78,-1,-79908,173576,253484,93668,0,-61310,0,0,0,,61310,-61310
10,03-05-18,1,0:00,0:15,,-39.03,0,-39.03,-39.03,-1,-43100,101118,144218,58018,0,-30463,0,0,0,,30463,-30463
10,03-05-18,2,0:15,0:30,,-150.03,0,-150.03,-150.03,-1,-34814,141287,176101,106473,0,-26651,0,0,0,,26651,-26651
10,03-05-18,3,0:30,0:45,,-28.03,0,-28.03,-28.03,-1,-64219,121820,186039,57601,0,-57157,0,0,0,,57157,-57157
10,03-05-18,4,0:45,1:00,,-34.03,0,-34.03,-34.03,-1,-79347,149688,229035,70341,0,-54609,0,0,0,,54609,-54609
10,03-05-18,5,1:00,1:15,,-10.03,0,-10.03,-10.03,-1,-52380,90565,142945,38185,0,-42467,0,0,0,,42467,-42467
10,03-05-18,6,1:15,1:30,,-18.64,0,-18.64,-18.64,-1,-43284,101505,144789,58221,0,-40002,0,0,0,,40002,-40002
10,03-05-18,7,1:30,1:45,,3.8,0,3.8,3.8,-1,-41705,98095,139800,56390,0,-47845,0,0,0,,47845,-47845
10,03-05-18,8,1:45,2:00,,-11.26,0,-11.26,-11.26,-1,-58313,97551,155864,39238,0,-49005,0,0,0,,49005,-49005
10,03-05-18,9,2:00,2:15,,15.96,0,15.96,15.96,-1,-54844,122816,177660,67972,0,-29127,0,0,0,,29127,-29127
10,03-05-18,10,2:15,2:30,,-1.03,0,-1.03,-1.03,-1,-53702,99959,153661,46257,0,-18381,0,0,0,,18381,-18381
10,03-05-18,11,2:30,2:45,,29.36,0,29.36,29.36,-1,-55137,97422,152559,42285,0,-4562,0,0,0,,4562,-4562
10,03-05-18,12,2:45,3:00,,13.03,0,13.03,13.03,-1,-56553,98483,155036,41930,0,-8231,0,0,0,,8231,-8231
10,03-05-18,13,3:00,3:15,,-22.89,0,-22.89,-22.89,-1,-44826,89532,134358,44706,0,-36315,0,0,0,,36315,-36315
10,03-05-18,14,3:15,3:30,,10.03,0,10.03,10.03,-1,-35052,100612,135664,65560,0,-31014,0,0,0,,31014,-31014
10,03-05-18,15,3:30,3:45,,19.43,0,19.43,19.43,-1,-42929,107869,150798,64940,0,-21955,0,0,0,,21955,-21955
10,03-05-18,16,3:45,4:00,,-18.64,0,-18.64,-18.64,-1,-50509,126760,177269,76251,0,-40486,0,0,0,,40486,-40486
10,03-05-18,17,4:00,4:15,,-18.64,0,-18.64,-18.64,-1,-43344,151940,195284,108596,0,-40727,0,0,0,,40727,-40727
10,03-05-18,18,4:15,4:30,,-24.61,0,-24.61,-24.61,-1,-57531,110995,168526,53464,0,-51047,0,0,0,,51047,-51047
10,03-05-18,19,4:30,4:45,,-18.64,0,-18.64,-18.64,-1,-50954,118118,169072,67164,0,-40982,0,0,0,,40982,-40982
10,03-05-18,20,4:45,5:00,,26.54,0,26.54,26.54,-1,-53972,134754,188726,80782,0,-12816,0,0,0,,12816,-12816
10,03-05-18,21,5:00,5:15,,-9.47,0,-9.47,-9.47,-1,-57544,162325,219869,104781,0,-21335,0,0,0,,21335,-21335
10,03-05-18,22,5:15,5:30,,2.03,0,2.03,2.03,-1,-60685,123180,183865,62495,0,-38200,0,0,0,,38200,-38200
10,03-05-18,23,5:30,5:45,,29.36,0,29.36,29.36,-1,-62622,114279,176901,51657,0,-13255,0,0,0,,13255,-13255
10,03-05-18,24,5:45,6:00,,7.92,0,7.92,7.92,-1,-70822,150539,221361,79717,0,-6934,0,0,0,,6934,-6934
10,03-05-18,25,6:00,6:15,,-150.03,0,-150.03,-150.03,-1,-33042,157917,190959,124875,0,-67592,0,0,0,,67592,-67592
10,03-05-18,26,6:15,6:30,,12.03,0,12.03,12.03,-1,-52131,102323,154454,50192,0,-46595,0,0,0,,46595,-46595
10,03-05-18,27,6:30,6:45,,34.03,0,34.03,34.03,-1,-69645,121700,191345,52055,0,-7402,0,0,0,,7402,-7402
10,03-05-18,28,6:45,7:00,,48.42,0,48.42,48.42,-1,-110061,143272,253333,33211,0,-2213,0,0,0,,2213,-2213
10,03-05-18,29,7:00,7:15,,-94.03,0,-94.03,-94.03,-1,-29739,109937,139676,80198,0,-31319,0,0,0,,31319,-31319
10,03-05-18,30,7:15,7:30,,14.03,0,14.03,14.03,-1,-43472,86823,130295,43351,0,-34417,0,0,0,,34417,-34417
10,03-05-18,31,7:30,7:45,35.47,30.97,0,35.47,35.47,1,-74605,59336,133941,-15269,0,-10300,147,0,0,,10447,-10153
10,03-05-18,32,7:45,8:00,104.21,,0,104.21,104.21,1,-101784,66109,167893,-35675,0,0,9093,0,0,,9093,9093
10,03-05-18,33,8:00,8:15,58.15,29.86,0,58.15,29.86,2,-63648,125595,189243,61947,0,-1783,7304,0,0,,9087,5521
10,03-05-18,34,8:15,8:30,,43.63,0,43.63,43.63,-1,-71237,112581,183818,41344,0,-4171,0,0,0,,4171,-4171
10,03-05-18,35,8:30,8:45,,55.74,0,55.74,55.74,-1,-89287,102711,191998,13424,0,-2005,0,0,0,,2005,-2005
10,03-05-18,36,8:45,9:00,,54.74,0,54.74,54.74,-1,-111406,104242,215648,-7164,0,-757,0,0,0,,757,-757
10,03-05-18,37,9:00,9:15,,18.05,0,18.05,18.05,-1,-32009,153170,185179,121161,0,-13840,0,0,0,,13840,-13840
10,03-05-18,38,9:15,9:30,,6.15,0,6.15,6.15,-1,-40467,128100,168567,87633,0,-46827,0,0,0,,46827,-46827
10,03-05-18,39,9:30,9:45,,-40.14,0,-40.14,-40.14,-1,-32898,140527,173425,107629,0,-63056,0,0,0,,63056,-63056
10,03-05-18,40,9:45,10:00,,-35.15,0,-35.15,-35.15,-1,-46212,98044,144256,51832,0,-52848,0,0,0,,52848,-52848
10,03-05-18,41,10:00,10:15,,29.1,0,29.1,29.1,-1,-56490,86320,142810,29830,0,-18217,0,0,0,,18217,-18217
10,03-05-18,42,10:15,10:30,,-41.15,0,-41.15,-41.15,-1,-46547,134693,181240,88146,0,-15338,0,0,0,,15338,-15338
10,03-05-18,43,10:30,10:45,,-51.15,0,-51.15,-51.15,-1,-55638,118701,174339,63063,0,-54420,0,0,0,,54420,-54420
10,03-05-18,44,10:45,11:00,,11.46,0,11.46,11.46,-1,-78823,142494,221317,63671,0,-55531,0,0,0,,55531,-55531
10,03-05-18,45,11:00,11:15,,7.74,0,7.74,7.74,-1,-88623,131136,219759,42513,0,-38710,0,0,0,,38710,-38710
10,03-05-18,46,11:15,11:30,,-24.77,0,-24.77,-24.77,-1,-78647,110789,189436,32142,0,-53993,0,0,0,,53993,-53993
10,03-05-18,47,11:30,11:45,,8.17,0,8.17,8.17,-1,-100775,151226,252001,50451,0,-49491,0,0,0,,49491,-49491
10,03-05-18,48,11:45,12:00,,0.33,0,0.33,0.33,-1,-98904,132264,231168,33360,0,-57814,0,0,0,,57814,-57814
10,03-05-18,49,12:00,12:15,49.88,55.74,0,52.3,52.3,2,-126496,99028,225524,-27468,0,-18071,165,0,0,,18236,-17906
10,03-05-18,50,12:15,12:30,49.88,39.11,0,39.11,39.11,-1,-95021,120123,215144,25102,0,-8086,2,0,0,,8088,-8084
10,03-05-18,51,12:30,12:45,,34.15,0,34.15,34.15,-1,-95772,133556,229328,37784,0,-28459,0,0,0,,28459,-28459
10,03-05-18,52,12:45,13:00,,45.19,0,45.19,45.19,-1,-109280,120036,229316,10756,0,-16892,0,0,0,,16892,-16892
10,03-05-18,53,13:00,13:15,,50,0,50,50,-1,-99800,135956,235756,36156,0,-4121,0,0,0,,4121,-4121
10,03-05-18,54,13:15,13:30,,49.59,0,49.59,49.59,-1,-99288,120737,220025,21449,0,-7421,0,0,0,,7421,-7421
10,03-05-18,55,13:30,13:45,,55.74,0,55.74,55.74,-1,-110235,107131,217366,-3104,0,-3153,0,0,0,,3153,-3153
10,03-05-18,56,13:45,14:00,,38.92,0,38.92,38.92,-1,-117533,102090,219623,-15443,0,-1796,0,0,0,,1796,-1796
10,03-05-18,57,14:00,14:15,,-87.15,0,-87.15,-87.15,-1,-35626,171122,206748,135496,0,-13619,0,0,0,,13619,-13619
10,03-05-18,58,14:15,14:30,,-19.15,0,-19.15,-19.15,-1,-56150,127958,184108,71808,0,-41050,0,0,0,,41050,-41050
10,03-05-18,59,14:30,14:45,,40.48,0,40.48,40.48,-1,-67273,110584,177857,43311,0,-37959,0,0,0,,37959,-37959
10,03-05-18,60,14:45,15:00,,30.36,0,30.36,30.36,-1,-75891,89312,165203,13421,0,-25805,0,0,0,,25805,-25805
10,03-05-18,61,15:00,15:15,,-90.11,0,-90.11,-90.11,-1,-32530,154513,187043,121983,0,-54441,0,0,0,,54441,-54441
10,03-05-18,62,15:15,15:30,,4.14,0,4.14,4.14,-1,-38511,99251,137762,60740,0,-62612,0,0,0,,62612,-62612
10,03-05-18,63,15:30,15:45,37.36,31.36,0,37.36,37.36,1,-60633,68038,128671,7405,0,-20623,25,0,0,,20648,-20598
10,03-05-18,64,15:45,16:00,37.36,,0,37.36,37.36,1,-59986,54575,114561,-5411,0,0,689,0,0,,689,689
10,03-05-18,65,16:00,16:15,,21.58,0,21.58,21.58,-1,-56110,78828,134938,22718,0,-11909,0,0,0,,11909,-11909
10,03-05-18,66,16:15,16:30,,48.57,0,48.57,48.57,-1,-62354,57254,119608,-5100,0,-4642,0,0,0,,4642,-4642
10,03-05-18,67,16:30,16:45,33.36,47.53,0,41.42,41.42,2,-68673,54976,123649,-13697,0,-2051,15,0,0,,2066,-2036
10,03-05-18,68,16:45,17:00,53.83,47.53,0,53.83,53.83,1,-96803,56102,152905,-40701,0,-59,2450,0,0,,2509,2391
10,03-05-18,69,17:00,17:15,,49.57,0,49.57,49.57,-1,-84978,76588,161566,-8390,0,-157,0,0,0,,157,-157
10,03-05-18,70,17:15,17:30,,49.43,0,49.43,49.43,-1,-80338,70070,150408,-10268,0,-552,0,0,0,,552,-552
10,03-05-18,71,17:30,17:45,,50.02,0,50.02,50.02,-1,-75544,73050,148594,-2494,0,-112,0,0,0,,112,-112
10,03-05-18,72,17:45,18:00,96.7,,0,96.7,96.7,1,-83493,62018,145511,-21475,0,0,11709,0,0,,11709,11709
10,03-05-18,73,18:00,18:15,114.17,43.53,0,43.53,43.53,-1,-96075,59630,155705,-36445,0,-452,14419,0,0,,14871,13967
10,03-05-18,74,18:15,18:30,114.17,43.15,0,43.15,43.15,-1,-67886,38116,106002,-29770,0,-771,9,0,0,,780,-762
10,03-05-18,75,18:30,18:45,161.16,,0,161.16,161.16,1,-81674,13336,95010,-68338,0,0,2060,0,0,,2060,2060
10,03-05-18,76,18:45,19:00,282.15,,0,282.15,282.15,1,-119115,11334,130449,-107781,0,0,64632,0,0,,64632,64632
10,03-05-18,77,19:00,19:15,282.15,,0,282.15,282.15,1,-82320,22019,104339,-60301,0,0,64073,0,0,,64073,64073
10,03-05-18,78,19:15,19:30,282.15,29.13,0,29.13,29.13,-1,-51501,36538,88039,-14963,0,-1299,1765,0,0,,3064,466
10,03-05-18,79,19:30,19:45,,43.15,0,43.15,43.15,-1,-48499,38839,87338,-9660,0,-958,0,0,0,,958,-958
10,03-05-18,80,19:45,20:00,,27.86,0,27.86,27.86,-1,-45420,54297,99717,8877,0,-10907,0,0,0,,10907,-10907
10,03-05-18,81,20:00,20:15,252.15,27.86,0,252.15,252.15,1,-122399,16564,138963,-105835,0,-1290,30063,0,0,,31353,28773
10,03-05-18,82,20:15,20:30,129.15,45.11,0,45.11,45.11,-1,-56896,36330,93226,-20566,0,-40,44214,0,0,,44254,44174
10,03-05-18,83,20:30,20:45,129.15,40.81,0,40.81,40.81,-1,-37074,62994,100068,25920,0,-1300,561,0,0,,1861,-739
10,03-05-18,84,20:45,21:00,,-96.15,0,-96.15,-96.15,-1,-58303,91808,150111,33505,0,-32212,0,0,0,,32212,-32212
10,03-05-18,85,21:00,21:15,282.15,-96.15,0,282.15,282.15,1,-185513,44784,230297,-140729,0,-3571,33131,0,0,,36702,29560
10,03-05-18,86,21:15,21:30,282.15,,0,282.15,282.15,1,-92607,27052,119659,-65555,0,0,80186,0,0,,80186,80186
10,03-05-18,87,21:30,21:45,282.15,41.46,0,41.46,41.46,-1,-49329,82741,132070,33412,0,-612,10707,0,0,,11319,10095
10,03-05-18,88,21:45,22:00,,20.65,0,20.65,20.65,-1,-56478,106500,162978,50022,0,-19234,0,0,0,,19234,-19234
10,03-05-18,89,22:00,22:15,33.36,31.36,0,33.36,33.36,1,-101555,41237,142792,-60318,0,-16939,36,0,0,,16975,-16903
10,03-05-18,90,22:15,22:30,33.36,31.36,0,33.36,33.36,1,-100110,46344,146454,-53766,0,-113,613,0,0,,726,500
10,03-05-18,91,22:30,22:45,,48.96,0,48.96,48.96,-1,-65738,72276,138014,6538,0,-453,0,0,0,,453,-453
10,03-05-18,92,22:45,23:00,,31.36,0,31.36,31.36,-1,-57611,114700,172311,57089,0,-6105,0,0,0,,6105,-6105
10,03-05-18,93,23:00,23:15,,41.32,0,41.32,41.32,-1,-81969,34009,115978,-47960,0,-5508,0,0,0,,5508,-5508
10,03-05-18,94,23:15,23:30,,43.29,0,43.29,43.29,-1,-70730,48880,119610,-21850,0,-167,0,0,0,,167,-167
10,03-05-18,95,23:30,23:45,,26.84,0,26.84,26.84,-1,-60630,92549,153179,31919,0,-14453,0,0,0,,14453,-14453
10,03-05-18,96,23:45,0:00,,21.7,0,21.7,21.7,-1,-65329,103328,168657,37999,0,-25818,0,0,0,,25818,-25818
10,03-06-18,1,0:00,0:15,,-10.62,0,-10.62,-10.62,-1,-29207,112408,141615,83201,0,-24416,0,0,0,,24416,-24416
10,03-06-18,2,0:15,0:30,,-35.78,0,-35.78,-35.78,-1,-24482,94091,118573,69609,0,-41659,0,0,0,,41659,-41659
10,03-06-18,3,0:30,0:45,,29.78,0,29.78,29.78,-1,-24606,104409,129015,79803,0,-31444,0,0,0,,31444,-31444
10,03-06-18,4,0:45,1:00,,34.78,0,34.78,34.78,-1,-19715,125759,145474,106044,0,-33254,0,0,0,,33254,-33254
10,03-06-18,5,1:00,1:15,,33.78,0,33.78,33.78,-1,-48812,79934,128746,31122,0,-16590,0,0,0,,16590,-16590
10,03-06-18,6,1:15,1:30,,,0,44.91,44.91,0,-25207,71884,97091,46677,0,-21,0,0,0,,21,-21
10,03-06-18,7,1:30,1:45,,53.1,0,53.1,53.1,-1,-15442,92145,107587,76703,0,-376,0,0,0,,376,-376
10,03-06-18,8,1:45,2:00,,53.1,0,53.1,53.1,-1,-21082,114819,135901,93737,0,-2628,0,0,0,,2628,-2628
10,03-06-18,9,2:00,2:15,,52.39,0,52.39,52.39,-1,-35251,67991,103242,32740,0,-2516,0,0,0,,2516,-2516
10,03-06-18,10,2:15,2:30,,52.39,0,52.39,52.39,-1,-38365,73846,112211,35481,0,-2397,0,0,0,,2397,-2397
10,03-06-18,11,2:30,2:45,,52.39,0,52.39,52.39,-1,-41551,80251,121802,38700,0,-2443,0,0,0,,2443,-2443
10,03-06-18,12,2:45,3:00,,52.39,0,52.39,52.39,-1,-43833,85457,129290,41624,0,-2418,0,0,0,,2418,-2418
10,03-06-18,13,3:00,3:15,,51.61,0,51.61,51.61,-1,-30300,79630,109930,49330,0,-2507,0,0,0,,2507,-2507
10,03-06-18,14,3:15,3:30,,51.61,0,51.61,51.61,-1,-31240,77971,109211,46731,0,-2472,0,0,0,,2472,-2472
10,03-06-18,15,3:30,3:45,,51.61,0,51.61,51.61,-1,-33088,75501,108589,42413,0,-2661,0,0,0,,2661,-2661
10,03-06-18,16,3:45,4:00,,46.61,0,46.61,46.61,-1,-32737,70733,103470,37996,0,-3750,0,0,0,,3750,-3750
10,03-06-18,17,4:00,4:15,,33.08,0,33.08,33.08,-1,-25740,73972,99712,48232,0,-5389,0,0,0,,5389,-5389
10,03-06-18,18,4:15,4:30,,46.91,0,46.91,46.91,-1,-21863,48131,69994,26268,0,-3968,0,0,0,,3968,-3968
10,03-06-18,19,4:30,4:45,,35.22,0,35.22,35.22,-1,-28657,51414,80071,22757,0,-7364,0,0,0,,7364,-7364
10,03-06-18,20,4:45,5:00,,46.91,0,46.91,46.91,-1,-30308,40476,70784,10168,0,-6873,0,0,0,,6873,-6873
10,03-06-18,21,5:00,5:15,,36.71,0,36.71,36.71,-1,-32409,62459,94868,30050,0,-4408,0,0,0,,4408,-4408
10,03-06-18,22,5:15,5:30,36.72,48.76,0,45.24,45.24,2,-33846,39311,73157,5465,0,-4270,6,0,0,,4276,-4264
10,03-06-18,23,5:30,5:45,65.03,48.76,0,65.03,65.03,1,-58293,40905,99198,-17388,0,-163,11511,0,0,,11674,11348
10,03-06-18,24,5:45,6:00,43.14,,0,43.14,43.14,1,-81615,64772,146387,-16843,0,0,2695,0,0,,2695,2695
10,03-06-18,25,6:00,6:15,43.14,16.16,0,16.16,16.16,-1,-25274,124411,149685,99137,0,-8671,101,0,0,,8772,-8570
10,03-06-18,26,6:15,6:30,,37.15,0,37.15,37.15,-1,-14890,62952,77842,48062,0,-2389,0,0,0,,2389,-2389
10,03-06-18,27,6:30,6:45,,35.15,0,35.15,35.15,-1,-57626,38250,95876,-19376,0,-2848,0,0,0,,2848,-2848
10,03-06-18,28,6:45,7:00,102.62,35.15,0,102.62,102.62,1,-119721,27520,147241,-92201,0,-82,6396,0,0,,6478,6314
10,03-06-18,29,7:00,7:15,37.45,34.78,0,39.07,34.78,2,-32225,152674,184899,120449,0,-143,2923,0,0,,3066,2780
10,03-06-18,30,7:15,7:30,37.45,35.32,0,39.1,35.32,2,-45865,53234,99099,7369,0,-505,159,0,0,,664,-346
10,03-06-18,31,7:30,7:45,41.8,,0,41.8,41.8,1,-52878,37194,90072,-15684,0,0,4634,0,0,,4634,4634
10,03-06-18,32,7:45,8:00,76.26,,0,76.26,76.26,1,-95138,43566,138704,-51572,0,0,18906,0,0,,18906,18906
10,03-06-18,33,8:00,8:15,40.12,34.78,0,40.12,34.78,2,-40001,92349,132350,52348,0,-678,11233,0,0,,11911,10555
10,03-06-18,34,8:15,8:30,,,0,38.61,38.61,0,-46425,41172,87597,-5253,0,-7,6,0,0,,13,-1
10,03-06-18,35,8:30,8:45,,,0,38.61,38.61,0,-57114,34662,91776,-22452,0,0,0,0,0,,0,0
10,03-06-18,36,8:45,9:00,,34.45,0,34.45,34.45,-1,-68931,25756,94687,-43175,0,-16,0,0,0,,16,-16
10,03-06-18,37,9:00,9:15,,34.45,0,34.45,34.45,-1,-65809,53816,119625,-11993,0,-380,0,0,0,,380,-380
10,03-06-18,38,9:15,9:30,,37.36,0,37.36,37.36,-1,-79916,50471,130387,-29445,0,-27,0,0,0,,27,-27
10,03-06-18,39,9:30,9:45,,35.76,0,35.76,35.76,-1,-71346,61337,132683,-10009,0,-24,0,0,0,,24,-24
10,03-06-18,40,9:45,10:00,,34.78,0,34.78,34.78,-1,-71430,65240,136670,-6190,0,-836,0,0,0,,836,-836
10,03-06-18,41,10:00,10:15,,,0,38.61,38.61,0,-84392,36668,121060,-47724,0,0,0,0,0,,0,0
10,03-06-18,42,10:15,10:30,,,0,38.61,38.61,0,-86010,42344,128354,-43666,0,0,0,0,0,,0,0
10,03-06-18,43,10:30,10:45,,,0,38.61,38.61,0,-69988,41880,111868,-28108,0,0,0,0,0,,0,0
10,03-06-18,44,10:45,11:00,,34.45,0,34.45,34.45,-1,-64623,59038,123661,-5585,0,-13,0,0,0,,13,-13
10,03-06-18,45,11:00,11:15,35.74,,0,35.74,35.74,1,-91399,37653,129052,-53746,0,0,62,0,0,,62,62
10,03-06-18,46,11:15,11:30,37.45,,0,37.45,37.45,1,-100259,45900,146159,-54359,0,0,1172,0,0,,1172,1172
10,03-06-18,47,11:30,11:45,,,0,38.49,38.49,0,-85219,58473,143692,-26746,0,0,12,0,0,,12,12
10,03-06-18,48,11:45,12:00,,35.39,0,35.39,35.39,-1,-76465,83645,160110,7180,0,-808,0,0,0,,808,-808
10,03-06-18,49,12:00,12:15,,14.22,0,14.22,14.22,-1,-78313,85651,163964,7338,0,-3973,0,0,0,,3973,-3973
10,03-06-18,50,12:15,12:30,,8.35,0,8.35,8.35,-1,-83534,103590,187124,20056,0,-23934,0,0,0,,23934,-23934
10,03-06-18,51,12:30,12:45,,34.45,0,34.45,34.45,-1,-95390,137510,232900,42120,0,-14560,0,0,0,,14560,-14560
10,03-06-18,52,12:45,13:00,,-140.78,0,-140.78,-140.78,-1,-96142,160084,256226,63942,0,-60468,0,0,0,,60468,-60468
10,03-06-18,53,13:00,13:15,36.59,-33.51,0,36.59,36.59,1,-147838,73380,221218,-74458,0,-68855,17,0,0,,68872,-68838
10,03-06-18,54,13:15,13:30,159.12,-140.78,0,159.12,-140.78,2,-101638,88514,190152,-13124,0,-3738,9462,0,0,,13200,5724
10,03-06-18,55,13:30,13:45,159.12,-418.64,0,-418.64,-418.64,-1,-106828,91430,198258,-15398,-22500,-12075,455,0,0,,35030,-34120
10,03-06-18,56,13:45,14:00,,-140.78,0,-140.78,-140.78,-1,-162690,63042,225732,-99648,0,-34985,0,0,0,,34985,-34985
10,03-06-18,57,14:00,14:15,,-135.78,0,-135.78,-135.78,-1,-216675,55788,272463,-160887,0,-60685,0,0,0,,60685,-60685
10,03-06-18,58,14:15,14:30,50.87,34.74,0,50.87,50.87,1,-198832,59141,257973,-139691,0,-7816,1841,0,0,,9657,-5975
10,03-06-18,59,14:30,14:45,53.98,,0,53.98,53.98,1,-170551,71789,242340,-98762,0,0,10821,0,0,,10821,10821
10,03-06-18,60,14:45,15:00,36.75,,0,36.75,36.75,1,-173975,74868,248843,-99107,0,0,3260,0,0,,3260,3260
10,03-06-18,61,15:00,15:15,75.89,,0,75.89,75.89,1,-115420,69061,184481,-46359,0,0,5407,0,0,,5407,5407
10,03-06-18,62,15:15,15:30,127.27,,0,127.27,127.27,1,-124400,74280,198680,-50120,0,0,25323,0,0,,25323,25323
10,03-06-18,63,15:30,15:45,116.76,,0,116.76,116.76,1,-125506,70550,196056,-54956,0,0,37102,0,0,,37102,37102
10,03-06-18,64,15:45,16:00,159.12,,0,159.12,159.12,1,-133748,77110,210858,-56638,0,0,55451,0,0,,55451,55451
10,03-06-18,65,16:00,16:15,159.12,34.78,0,34.78,34.78,-1,-40553,132618,173171,92065,0,-1275,11224,0,0,,12499,9949
10,03-06-18,66,16:15,16:30,,37.01,0,37.01,37.01,-1,-45883,102672,148555,56789,0,-190,0,0,0,,190,-190
10,03-06-18,67,16:30,16:45,,36.54,0,36.54,36.54,-1,-58462,78415,136877,19953,0,-1753,0,0,0,,1753,-1753
10,03-06-18,68,16:45,17:00,42.63,36.92,0,42.63,36.92,2,-67004,42565,109569,-24439,0,-386,3828,0,0,,4214,3442
10,03-06-18,69,17:00,17:15,35.74,,0,35.74,35.74,1,-80283,85107,165390,4824,0,0,1398,0,0,,1398,1398
10,03-06-18,70,17:15,17:30,,37.5,0,37.5,37.5,-1,-66948,64059,131007,-2889,0,-36,0,0,0,,36,-36
10,03-06-18,71,17:30,17:45,,37.48,0,37.48,37.48,-1,-66075,60379,126454,-5696,0,-353,0,0,0,,353,-353
10,03-06-18,72,17:45,18:00,37.45,,0,37.45,37.45,1,-70768,70105,140873,-663,0,0,353,0,0,,353,353
10,03-06-18,73,18:00,18:15,,12.14,0,12.14,12.14,-1,-43175,72979,116154,29804,0,-12603,0,0,0,,12603,-12603
10,03-06-18,74,18:15,18:30,,12.14,0,12.14,12.14,-1,-61869,70387,132256,8518,0,-24213,0,0,0,,24213,-24213
10,03-06-18,75,18:30,18:45,36.69,12.14,0,36.69,36.69,1,-57251,53180,110431,-4071,0,-938,31,0,0,,969,-907
10,03-06-18,76,18:45,19:00,253.12,,0,253.12,253.12,1,-98885,39575,138460,-59310,0,0,25477,0,0,,25477,25477
10,03-06-18,77,19:00,19:15,90.17,,0,90.17,90.17,1,-63515,18373,81888,-45142,0,0,51076,0,0,,51076,51076
10,03-06-18,78,19:15,19:30,37.45,,0,37.45,37.45,1,-49675,27473,77148,-22202,0,0,12816,0,0,,12816,12816
10,03-06-18,79,19:30,19:45,44.63,,0,44.63,44.63,1,-48345,19751,68096,-28594,0,0,13623,0,0,,13623,13623
10,03-06-18,80,19:45,20:00,41.45,,0,41.45,41.45,1,-53264,27070,80334,-26194,0,0,9255,0,0,,9255,9255
10,03-06-18,81,20:00,20:15,47.17,,0,47.17,47.17,1,-90378,30647,121025,-59731,0,0,6110,0,0,,6110,6110
10,03-06-18,82,20:15,20:30,47.17,35.47,0,35.47,35.47,-1,-60050,36126,96176,-23924,0,-20,35,0,0,,55,15
10,03-06-18,83,20:30,20:45,,34.81,0,34.81,34.81,-1,-53047,49234,102281,-3813,0,-593,0,0,0,,593,-593
10,03-06-18,84,20:45,21:00,,25.6,0,25.6,25.6,-1,-48855,68375,117230,19520,0,-6461,0,0,0,,6461,-6461
10,03-06-18,85,21:00,21:15,,26.64,0,26.64,26.64,-1,-78878,60025,138903,-18853,0,-11277,0,0,0,,11277,-11277
10,03-06-18,86,21:15,21:30,,35.04,0,35.04,35.04,-1,-44246,53920,98166,9674,0,-216,0,0,0,,216,-216
10,03-06-18,87,21:30,21:45,,34.78,0,34.78,34.78,-1,-37388,70911,108299,33523,0,-808,0,0,0,,808,-808
10,03-06-18,88,21:45,22:00,,26.99,0,26.99,26.99,-1,-42245,104852,147097,62607,0,-7879,0,0,0,,7879,-7879
10,03-06-18,89,22:00,22:15,52.19,33.78,0,52.19,33.78,2,-134722,29557,164279,-105165,0,-8739,2958,0,0,,11697,-5781
10,03-06-18,90,22:15,22:30,36.3,33.78,0,36.3,36.3,1,-75061,18408,93469,-56653,0,-24,852,0,0,,876,828
10,03-06-18,91,22:30,22:45,,,0,38.53,38.53,0,-31710,40761,72471,9051,0,0,0,0,0,,0,0
10,03-06-18,92,22:45,23:00,,12.14,0,12.14,12.14,-1,-23977,89264,113241,65287,0,-11834,0,0,0,,11834,-11834
10,03-06-18,93,23:00,23:15,237.12,12.14,0,237.12,237.12,1,-96740,9760,106500,-86980,0,-9288,17626,0,0,,26914,8338
10,03-06-18,94,23:15,23:30,60.82,33.45,0,33.45,33.45,-1,-18307,29253,47560,10946,0,-490,26429,0,0,,26919,25939
10,03-06-18,95,23:30,23:45,60.82,33.45,0,33.45,33.45,-1,-20285,73500,93785,53215,0,-2280,28,0,0,,2308,-2252
10,03-06-18,96,23:45,0:00,,31.58,0,31.58,31.58,-1,-17048,101180,118228,84132,0,-17096,0,0,0,,17096,-17096
10,03-07-18,1,0:00,0:15,,33.03,0,33.03,33.03,-1,-16339,89036,105375,72697,0,-11954,0,0,0,,11954,-11954
10,03-07-18,2,0:15,0:30,,34.91,0,34.91,34.91,-1,-17936,89883,107819,71947,0,-560,0,0,0,,560,-560
10,03-07-18,3,0:30,0:45,,23.97,0,23.97,23.97,-1,-21441,102064,123505,80623,0,-5151,0,0,0,,5151,-5151
10,03-07-18,4,0:45,1:00,,-16.52,0,-16.52,-16.52,-1,-26752,126852,153604,100100,0,-47928,0,0,0,,47928,-47928
10,03-07-18,5,1:00,1:15,,-67.42,0,-67.42,-67.42,-1,-53592,74873,128465,21281,0,-38930,0,0,0,,38930,-38930
10,03-07-18,6,1:15,1:30,37.62,35.91,0,35.91,35.91,-1,-54173,58445,112618,4272,0,-282,7,0,0,,289,-275
10,03-07-18,7,1:30,1:45,,31.72,0,31.72,31.72,-1,-33905,53394,87299,19489,0,-1832,0,0,0,,1832,-1832
10,03-07-18,8,1:45,2:00,,31.5,0,31.5,31.5,-1,-28229,67078,95307,38849,0,-17058,0,0,0,,17058,-17058
10,03-07-18,9,2:00,2:15,38.62,22.03,0,38.62,38.62,1,-31753,49520,81273,17767,0,-14772,121,0,0,,14893,-14651
10,03-07-18,10,2:15,2:30,40.48,33.62,0,40.48,33.62,2,-35400,40805,76205,5405,0,-1659,619,0,0,,2278,-1040
10,03-07-18,11,2:30,2:45,,33.81,0,33.81,33.81,-1,-32525,49804,82329,17279,0,-3527,0,0,0,,3527,-3527
10,03-07-18,12,2:45,3:00,,33.94,0,33.94,33.94,-1,-28304,45488,73792,17184,0,-5066,0,0,0,,5066,-5066
10,03-07-18,13,3:00,3:15,,37.6,0,37.6,37.6,-1,-38834,28076,66910,-10758,0,-1633,0,0,0,,1633,-1633
10,03-07-18,14,3:15,3:30,,35.91,0,35.91,35.91,-1,-38964,40327,79291,1363,0,-1014,0,0,0,,1014,-1014
10,03-07-18,15,3:30,3:45,,35.91,0,35.91,35.91,-1,-36120,28652,64772,-7468,0,-686,0,0,0,,686,-686
10,03-07-18,16,3:45,4:00,,37.6,0,37.6,37.6,-1,-61303,23118,84421,-38185,0,-170,0,0,0,,170,-170
10,03-07-18,17,4:00,4:15,,32.71,0,32.71,32.71,-1,-25473,40158,65631,14685,0,-6036,0,0,0,,6036,-6036
10,03-07-18,18,4:15,4:30,,35.91,0,35.91,35.91,-1,-35433,31811,67244,-3622,0,-4667,0,0,0,,4667,-4667
10,03-07-18,19,4:30,4:45,,34.91,0,34.91,34.91,-1,-43914,39620,83534,-4294,0,-4863,0,0,0,,4863,-4863
10,03-07-18,20,4:45,5:00,,37.29,0,37.29,37.29,-1,-48899,30212,79111,-18687,0,-2218,0,0,0,,2218,-2218
10,03-07-18,21,5:00,5:15,,35.91,0,35.91,35.91,-1,-60348,46289,106637,-14059,0,-1989,0,0,0,,1989,-1989
10,03-07-18,22,5:15,5:30,,35.89,0,35.89,35.89,-1,-44566,53271,97837,8705,0,-3217,0,0,0,,3217,-3217
10,03-07-18,23,5:30,5:45,,35.91,0,35.91,35.91,-1,-52565,48712,101277,-3853,0,-2218,0,0,0,,2218,-2218
10,03-07-18,24,5:45,6:00,,37.6,0,37.6,37.6,-1,-53627,33513,87140,-20114,0,-1249,0,0,0,,1249,-1249
10,03-07-18,25,6:00,6:15,,12.87,0,12.87,12.87,-1,-24835,110648,135483,85813,0,-13226,0,0,0,,13226,-13226
10,03-07-18,26,6:15,6:30,,34.03,0,34.03,34.03,-1,-35334,69973,105307,34639,0,-10944,0,0,0,,10944,-10944
10,03-07-18,27,6:30,6:45,39.53,34.03,0,39.53,39.53,1,-54285,25593,79878,-28692,0,-1742,156,0,0,,1898,-1586
10,03-07-18,28,6:45,7:00,288.02,,0,288.02,288.02,1,-111147,28339,139486,-82808,0,0,23458,0,0,,23458,23458
10,03-07-18,29,7:00,7:15,38.02,-102.03,0,38.02,-102.03,2,-3972,174622,178594,170650,0,-7230,7539,0,0,,14769,309
10,03-07-18,30,7:15,7:30,,25.86,0,25.86,25.86,-1,-23205,106719,129924,83514,0,-7945,0,0,0,,7945,-7945
10,03-07-18,31,7:30,7:45,,35.52,0,35.52,35.52,-1,-34763,66052,100815,31289,0,-2480,0,0,0,,2480,-2480
10,03-07-18,32,7:45,8:00,49.63,38,0,49.63,37.85,2,-71267,34847,106114,-36420,0,-842,3573,0,0,,4415,2731
10,03-07-18,33,8:00,8:15,49.63,25.71,0,25.71,25.71,-1,-17931,112911,130842,94980,0,-3820,498,0,0,,4318,-3322
10,03-07-18,34,8:15,8:30,,35.92,0,35.92,35.92,-1,-23696,88478,112174,64782,0,-2257,0,0,0,,2257,-2257
10,03-07-18,35,8:30,8:45,,35.92,0,35.92,35.92,-1,-25134,89983,115117,64849,0,-2851,0,0,0,,2851,-2851
10,03-07-18,36,8:45,9:00,,35.86,0,35.86,35.86,-1,-32870,82385,115255,49515,0,-3155,0,0,0,,3155,-3155
10,03-07-18,37,9:00,9:15,,36.06,0,36.06,36.06,-1,-32137,109781,141918,77644,0,-2845,0,0,0,,2845,-2845
10,03-07-18,38,9:15,9:30,,35.52,0,35.52,35.52,-1,-30222,148890,179112,118668,0,-2807,0,0,0,,2807,-2807
10,03-07-18,39,9:30,9:45,,-71.84,0,-71.84,-71.84,-1,-25212,188255,213467,163043,0,-23961,0,0,0,,23961,-23961
10,03-07-18,40,9:45,10:00,,-105.11,0,-105.11,-105.11,-1,-41696,116045,157741,74349,0,-71804,0,0,0,,71804,-71804
10,03-07-18,41,10:00,10:15,,31.3,0,31.3,31.3,-1,-78454,103252,181706,24798,0,-21331,0,0,0,,21331,-21331
10,03-07-18,42,10:15,10:30,,-14.48,0,-14.48,-14.48,-1,-67117,135914,203031,68797,0,-48600,0,0,0,,48600,-48600
10,03-07-18,43,10:30,10:45,,26.02,0,26.02,26.02,-1,-58808,120642,179450,61834,0,-41546,0,0,0,,41546,-41546
10,03-07-18,44,10:45,11:00,,17.79,0,17.79,17.79,-1,-53550,139391,192941,85841,0,-48052,0,0,0,,48052,-48052
10,03-07-18,45,11:00,11:15,37.52,33.11,0,37.52,33.11,2,-141920,103690,245610,-38230,0,-16122,218,0,0,,16340,-15904
10,03-07-18,46,11:15,11:30,,,0,37.35,37.35,0,-133314,101633,234947,-31681,0,0,0,0,0,,0,0
10,03-07-18,47,11:30,11:45,,,0,37.31,37.31,0,-135604,116005,251609,-19599,0,0,0,0,0,,0,0
10,03-07-18,48,11:45,12:00,,35.52,0,35.52,35.52,-1,-130782,111481,242263,-19301,0,-94,0,0,0,,94,-94
10,03-07-18,49,12:00,12:15,,38.03,0,38.03,38.03,-1,-116494,78801,195295,-37693,0,-196,0,0,0,,196,-196
10,03-07-18,50,12:15,12:30,,,0,37.17,37.17,0,-115202,76266,191468,-38936,0,0,0,0,0,,0,0
10,03-07-18,51,12:30,12:45,,,0,37.23,37.23,0,-116947,93104,210051,-23843,0,0,0,0,0,,0,0
10,03-07-18,52,12:45,13:00,,35.52,0,35.52,35.52,-1,-118496,90240,208736,-28256,0,-7,0,0,0,,7,-7
10,03-07-18,53,13:00,13:15,,,0,37.18,37.18,0,-101351,104091,205442,2740,0,0,0,0,0,,0,0
10,03-07-18,54,13:15,13:30,,,0,37.21,37.21,0,-107918,88869,196787,-19049,0,0,0,0,0,,0,0
10,03-07-18,55,13:30,13:45,,37.95,0,37.95,37.95,-1,-99325,91485,190810,-7840,0,-7,0,0,0,,7,-7
10,03-07-18,56,13:45,14:00,,34.52,0,34.52,34.52,-1,-93532,93903,187435,371,0,-949,0,0,0,,949,-949
10,03-07-18,57,14:00,14:15,42.54,34.52,0,42.54,34.52,2,-105051,79838,184889,-25213,0,-895,4150,0,0,,5045,3255
10,03-07-18,58,14:15,14:30,41.52,,0,41.52,41.52,1,-127259,76217,203476,-51042,0,0,15649,0,0,,15649,15649
10,03-07-18,59,14:30,14:45,,,0,36.96,36.96,0,-147283,41772,189055,-105511,0,0,3614,0,0,,3614,3614
10,03-07-18,60,14:45,15:00,48.06,,0,48.06,48.06,1,-170451,28171,198622,-142280,0,0,6216,0,0,,6216,6216
10,03-07-18,61,15:00,15:15,42.09,,0,42.09,42.09,1,-124278,12610,136888,-111668,0,0,15562,0,0,,15562,15562
10,03-07-18,62,15:15,15:30,81.39,,0,81.39,81.39,1,-139824,13890,153714,-125934,0,0,24218,0,0,,24218,24218
10,03-07-18,63,15:30,15:45,43.11,,0,43.11,43.11,1,-127488,13964,141452,-113524,0,0,23644,0,0,,23644,23644
10,03-07-18,64,15:45,16:00,237.11,,0,237.11,237.11,1,-133421,17784,151205,-115637,0,0,35489,0,0,,35489,35489
10,03-07-18,65,16:00,16:15,37.52,35.52,0,37.52,35.52,2,-42388,78987,121375,36599,0,-612,8587,0,0,,9199,7975
10,03-07-18,66,16:15,16:30,,37.6,0,37.6,37.6,-1,-68175,60135,128310,-8040,0,-384,0,0,0,,384,-384
10,03-07-18,67,16:30,16:45,,37.38,0,37.38,37.38,-1,-92452,61769,154221,-30683,0,-80,0,0,0,,80,-80
10,03-07-18,68,16:45,17:00,36.48,,0,36.48,36.48,1,-105993,51661,157654,-54332,0,0,48,0,0,,48,48
10,03-07-18,69,17:00,17:15,36.56,,0,36.56,36.56,1,-82339,50604,132943,-31735,0,0,97,0,0,,97,97
10,03-07-18,70,17:15,17:30,83.11,,0,83.11,83.11,1,-87219,38812,126031,-48407,0,0,7533,0,0,,7533,7533
10,03-07-18,71,17:30,17:45,101.11,,0,101.11,101.11,1,-86084,50818,136902,-35266,0,0,27995,0,0,,27995,27995
10,03-07-18,72,17:45,18:00,41.76,,0,41.76,41.76,1,-68059,61397,129456,-6662,0,0,22641,0,0,,22641,22641
10,03-07-18,73,18:00,18:15,37.52,25.39,0,25.39,25.39,-1,-44064,48155,92219,4091,0,-4258,6987,0,0,,11245,2729
10,03-07-18,74,18:15,18:30,37.52,17.79,0,17.79,17.79,-1,-51213,53332,104545,2119,0,-16157,19,0,0,,16176,-16138
10,03-07-18,75,18:30,18:45,,37.47,0,37.47,37.47,-1,-70614,57843,128457,-12771,0,-561,0,0,0,,561,-561
10,03-07-18,76,18:45,19:00,41.52,,0,41.52,41.52,1,-70027,53469,123496,-16558,0,0,1074,0,0,,1074,1074
10,03-07-18,77,19:00,19:15,53.11,,0,53.11,53.11,1,-39318,35092,74410,-4226,0,0,10544,0,0,,10544,10544
10,03-07-18,78,19:15,19:30,53.11,35.52,0,35.52,35.52,-1,-21936,65900,87836,43964,0,-1150,318,0,0,,1468,-832
10,03-07-18,79,19:30,19:45,,35.52,0,35.52,35.52,-1,-11149,90067,101216,78918,0,-3153,0,0,0,,3153,-3153
10,03-07-18,80,19:45,20:00,,-4.4,0,-4.4,-4.4,-1,-6594,112188,118782,105594,0,-23237,0,0,0,,23237,-23237
10,03-07-18,81,20:00,20:15,,33.11,0,33.11,33.11,-1,-43802,43971,87773,169,0,-7815,0,0,0,,7815,-7815
10,03-07-18,82,20:15,20:30,,6.47,0,6.47,6.47,-1,-27333,68098,95431,40765,0,-14786,0,0,0,,14786,-14786
10,03-07-18,83,20:30,20:45,,12.87,0,12.87,12.87,-1,-25505,82241,107746,56736,0,-34470,0,0,0,,34470,-34470
10,03-07-18,84,20:45,21:00,,12.87,0,12.87,12.87,-1,-25399,86464,111863,61065,0,-44265,0,0,0,,44265,-44265
10,03-07-18,85,21:00,21:15,41.52,25.34,0,41.52,41.52,1,-97842,32043,129885,-65799,0,-23768,328,0,0,,24096,-23440
10,03-07-18,86,21:15,21:30,60.17,25.34,0,60.17,60.17,1,-67156,32405,99561,-34751,0,-8,5086,0,0,,5094,5078
10,03-07-18,87,21:30,21:45,60.17,38.28,0,38.28,38.28,-1,-36549,54160,90709,17611,0,-31,317,0,0,,348,286
10,03-07-18,88,21:45,22:00,,12.16,0,12.16,12.16,-1,-26442,85161,111603,58719,0,-12125,0,0,0,,12125,-12125
10,03-07-18,89,22:00,22:15,237.11,34.52,0,237.11,34.52,2,-170651,11198,181849,-159453,0,-5899,30409,0,0,,36308,24510
10,03-07-18,90,22:15,22:30,40.11,,0,40.11,40.11,1,-105975,22425,128400,-83550,0,0,12445,0,0,,12445,12445
10,03-07-18,91,22:30,22:45,37.52,35.52,0,37.52,35.52,2,-62530,47677,110207,-14853,0,-41,179,0,0,,220,138
10,03-07-18,92,22:45,23:00,,33.11,0,33.11,33.11,-1,-45589,68798,114387,23209,0,-4763,0,0,0,,4763,-4763
10,03-07-18,93,23:00,23:15,,37.68,0,37.68,37.68,-1,-128144,44532,172676,-83612,0,-1028,0,0,0,,1028,-1028
10,03-07-18,94,23:15,23:30,,,0,37.01,37.01,0,-91865,40823,132688,-51042,0,0,0,0,0,,0,0
10,03-07-18,95,23:30,23:45,,33.03,0,33.03,33.03,-1,-70114,77585,147699,7471,0,-5399,0,0,0,,5399,-5399
10,03-07-18,96,23:45,0:00,,25.35,0,25.35,25.35,-1,-56779,98253,155032,41474,0,-28968,0,0,0,,28968,-28968
10,03-08-18,1,0:00,0:15,,16.78,0,16.78,16.78,-1,-71626,53332,124958,-18294,0,-25088,0,0,0,,25088,-25088
10,03-08-18,2,0:15,0:30,,36.63,0,36.63,36.63,-1,-56294,73413,129707,17119,0,-1000,0,0,0,,1000,-1000
10,03-08-18,3,0:30,0:45,,26.73,0,26.73,26.73,-1,-40766,81325,122091,40559,0,-11167,0,0,0,,11167,-11167
10,03-08-18,4,0:45,1:00,,18.45,0,18.45,18.45,-1,-36968,93353,130321,56385,0,-29435,0,0,0,,29435,-29435
10,03-08-18,5,1:00,1:15,38.02,28.16,0,38.02,38.02,1,-60581,45652,106233,-14929,0,-22165,223,0,0,,22388,-21942
10,03-08-18,6,1:15,1:30,38.02,28.16,0,38.02,38.02,1,-63436,43297,106733,-20139,0,-218,440,0,0,,658,222
10,03-08-18,7,1:30,1:45,,,0,34.68,34.68,0,-55080,42402,97482,-12678,0,0,0,0,0,,0,0
10,03-08-18,8,1:45,2:00,,,0,34.68,34.68,0,-61082,46450,107532,-14632,0,0,0,0,0,,0,0
10,03-08-18,9,2:00,2:15,83.99,,0,83.99,83.99,1,-83866,26544,110410,-57322,0,0,10526,0,0,,10526,10526
10,03-08-18,10,2:15,2:30,48.97,,0,48.97,48.97,1,-65327,37864,103191,-27463,0,0,27674,0,0,,27674,27674
10,03-08-18,11,2:30,2:45,34.02,,0,34.02,34.02,1,-51960,40527,92487,-11433,0,0,7015,0,0,,7015,7015
10,03-08-18,12,2:45,3:00,34.02,32.02,0,32.02,32.02,-1,-43328,58888,102216,15560,0,-2941,88,0,0,,3029,-2853
10,03-08-18,13,3:00,3:15,,31.02,0,31.02,31.02,-1,-38041,63750,101791,25709,0,-6985,0,0,0,,6985,-6985
10,03-08-18,14,3:15,3:30,,34.3,0,34.3,34.3,-1,-19339,69140,88479,49801,0,-2104,0,0,0,,2104,-2104
10,03-08-18,15,3:30,3:45,,34.46,0,34.46,34.46,-1,-25418,70095,95513,44677,0,-2796,0,0,0,,2796,-2796
10,03-08-18,16,3:45,4:00,,5.28,0,5.28,5.28,-1,-21377,73229,94606,51852,0,-14007,0,0,0,,14007,-14007
10,03-08-18,17,4:00,4:15,,31.02,0,31.02,31.02,-1,-30313,56819,87132,26506,0,-12716,0,0,0,,12716,-12716
10,03-08-18,18,4:15,4:30,,34.52,0,34.52,34.52,-1,-37009,42639,79648,5630,0,-297,0,0,0,,297,-297
10,03-08-18,19,4:30,4:45,38.02,34.37,0,38.02,34.28,2,-48336,36255,84591,-12081,0,-296,464,0,0,,760,168
10,03-08-18,20,4:45,5:00,,,0,34.29,34.29,0,-55589,26870,82459,-28719,0,0,270,0,0,,270,270
10,03-08-18,21,5:00,5:15,,34.2,0,34.2,34.2,-1,-40924,68357,109281,27433,0,-323,0,0,0,,323,-323
10,03-08-18,22,5:15,5:30,34.02,34.05,0,34.33,34.05,2,-54768,41774,96542,-12994,0,-841,107,0,0,,948,-734
10,03-08-18,23,5:30,5:45,60.12,,0,60.12,60.12,1,-61747,27393,89140,-34354,0,0,14248,0,0,,14248,14248
10,03-08-18,24,5:45,6:00,41.19,,0,41.19,41.19,1,-68000,58164,126164,-9836,0,0,18479,0,0,,18479,18479
10,03-08-18,25,6:00,6:15,31.9,33.78,0,34.37,33.78,2,-37636,105164,142800,67528,0,-865,4429,0,0,,5294,3564
10,03-08-18,26,6:15,6:30,,,0,34.91,34.91,0,-44792,65031,109823,20239,0,-88,0,0,0,,88,-88
10,03-08-18,27,6:30,6:45,58.57,,0,58.57,58.57,1,-90838,42993,133831,-47845,0,0,14054,0,0,,14054,14054
10,03-08-18,28,6:45,7:00,77.93,,0,77.93,77.93,1,-126929,64874,191803,-62055,0,0,38274,0,0,,38274,38274
10,03-08-18,29,7:00,7:15,77.93,-148.63,0,-148.63,-148.63,-1,-8094,115660,123754,107566,0,-25508,11695,0,0,,37203,-13813
10,03-08-18,30,7:15,7:30,34.11,33.78,0,34.11,34.11,1,-42636,45359,87995,2723,0,-2839,37,0,0,,2876,-2802
10,03-08-18,31,7:30,7:45,40.79,36.13,0,40.79,35.14,2,-54349,43606,97955,-10743,0,-366,448,0,0,,814,82
10,03-08-18,32,7:45,8:00,222.12,,0,222.12,222.12,1,-102527,49593,152120,-52934,0,0,28263,0,0,,28263,28263
10,03-08-18,33,8:00,8:15,38.11,34.69,0,38.11,34.69,2,-76982,87588,164570,10606,0,-418,8501,0,0,,8919,8083
10,03-08-18,34,8:15,8:30,34.11,,0,34.11,34.11,1,-70377,72375,142752,1998,0,0,462,0,0,,462,462
10,03-08-18,35,8:30,8:45,,36.04,0,36.04,36.04,-1,-40289,60752,101041,20463,0,-56,0,0,0,,56,-56
10,03-08-18,36,8:45,9:00,,33.78,0,33.78,33.78,-1,-43617,68867,112484,25250,0,-2090,0,0,0,,2090,-2090
10,03-08-18,37,9:00,9:15,,35.95,0,35.95,35.95,-1,-61563,47741,109304,-13822,0,-1011,0,0,0,,1011,-1011
10,03-08-18,38,9:15,9:30,,34.69,0,34.69,34.69,-1,-47725,46225,93950,-1500,0,-1993,0,0,0,,1993,-1993
10,03-08-18,39,9:30,9:45,,35.93,0,35.93,35.93,-1,-68619,51187,119806,-17432,0,-2250,0,0,0,,2250,-2250
10,03-08-18,40,9:45,10:00,,35.9,0,35.9,35.9,-1,-81616,66452,148068,-15164,0,-2250,0,0,0,,2250,-2250
10,03-08-18,41,10:00,10:15,237.12,35.95,0,237.12,237.12,1,-110228,49167,159395,-61061,0,-452,19809,0,0,,20261,19357
10,03-08-18,42,10:15,10:30,57.77,,0,57.77,57.77,1,-99588,77092,176680,-22496,0,0,30717,0,0,,30717,30717
10,03-08-18,43,10:30,10:45,57.12,,0,57.12,57.12,1,-102122,72340,174462,-29782,0,0,12175,0,0,,12175,12175
10,03-08-18,44,10:45,11:00,113.12,,0,113.12,113.12,1,-113419,62117,175536,-51302,0,0,46407,0,0,,46407,46407
10,03-08-18,45,11:00,11:15,48.05,,0,48.05,48.05,1,-85656,45732,131388,-39924,0,0,40692,0,0,,40692,40692
10,03-08-18,46,11:15,11:30,61,,0,61,61,1,-93134,39355,132489,-53779,0,0,39493,0,0,,39493,39493
10,03-08-18,47,11:30,11:45,64.12,,0,64.12,64.12,1,-91029,30453,121482,-60576,0,0,57710,0,0,,57710,57710
10,03-08-18,48,11:45,12:00,61,,0,61,61,1,-86011,29171,115182,-56840,0,0,57412,0,0,,57412,57412
10,03-08-18,49,12:00,12:15,237.12,,0,237.12,237.12,1,-112339,34603,146942,-77736,0,0,51443,0,0,,51443,51443
10,03-08-18,50,12:15,12:30,154.12,34.42,0,154.12,34.42,2,-78380,74798,153178,-3582,0,-42,39280,0,0,,39322,39238
10,03-08-18,51,12:30,12:45,154.12,22.9,0,22.9,22.9,-1,-64789,96645,161434,31856,0,-18113,237,0,0,,18350,-17876
10,03-08-18,52,12:45,13:00,,13.78,0,13.78,13.78,-1,-57764,126405,184169,68641,0,-25039,0,0,0,,25039,-25039
10,03-08-18,53,13:00,13:15,53,8.78,0,53,53,1,-81161,64074,145235,-17087,0,-20536,2618,0,0,,23154,-17918
10,03-08-18,54,13:15,13:30,32.08,13.83,0,13.83,13.83,-1,-75764,115926,191690,40162,0,-14080,1649,0,0,,15729,-12431
10,03-08-18,55,13:30,13:45,,13.78,0,13.78,13.78,-1,-63473,129460,192933,65987,0,-51828,0,0,0,,51828,-51828
10,03-08-18,56,13:45,14:00,,10.95,0,10.95,10.95,-1,-68417,125638,194055,57221,0,-55636,0,0,0,,55636,-55636
10,03-08-18,57,14:00,14:15,,-10.34,0,-10.34,-10.34,-1,-55566,107967,163533,52401,0,-50616,0,0,0,,50616,-50616
10,03-08-18,58,14:15,14:30,,9.57,0,9.57,9.57,-1,-58075,126739,184814,68664,0,-42349,0,0,0,,42349,-42349
10,03-08-18,59,14:30,14:45,,25.86,0,25.86,25.86,-1,-60738,145281,206019,84543,0,-41363,0,0,0,,41363,-41363
10,03-08-18,60,14:45,15:00,,0.88,0,0.88,0.88,-1,-29396,132160,161556,102764,0,-50678,0,0,0,,50678,-50678
10,03-08-18,61,15:00,15:15,,32.78,0,32.78,32.78,-1,-56601,135203,191804,78602,0,-25464,0,0,0,,25464,-25464
10,03-08-18,62,15:15,15:30,,26.15,0,26.15,26.15,-1,-54076,146713,200789,92637,0,-11556,0,0,0,,11556,-11556
10,03-08-18,63,15:30,15:45,,32.78,0,32.78,32.78,-1,-49889,125804,175693,75915,0,-10825,0,0,0,,10825,-10825
10,03-08-18,64,15:45,16:00,,37.78,0,37.78,37.78,-1,-47000,114131,161131,67131,0,-438,0,0,0,,438,-438
10,03-08-18,65,16:00,16:15,,33.78,0,33.78,33.78,-1,-53471,118276,171747,64805,0,-1635,0,0,0,,1635,-1635
10,03-08-18,66,16:15,16:30,,37.79,0,37.79,37.79,-1,-42932,85473,128405,42541,0,-1762,0,0,0,,1762,-1762
10,03-08-18,67,16:30,16:45,,31.11,0,31.11,31.11,-1,-40729,83670,124399,42941,0,-5897,0,0,0,,5897,-5897
10,03-08-18,68,16:45,17:00,,36.17,0,36.17,36.17,-1,-66059,88024,154083,21965,0,-1676,0,0,0,,1676,-1676
10,03-08-18,69,17:00,17:15,,36.68,0,36.68,36.68,-1,-79257,66399,145656,-12858,0,-1920,0,0,0,,1920,-1920
10,03-08-18,70,17:15,17:30,62.47,36.68,0,62.47,62.47,1,-76189,38159,114348,-38030,0,-202,3903,0,0,,4105,3701
10,03-08-18,71,17:30,17:45,66.88,,0,66.88,66.88,1,-64189,61812,126001,-2377,0,0,14207,0,0,,14207,14207
10,03-08-18,72,17:45,18:00,66.88,36.37,0,36.37,36.37,-1,-55135,85770,140905,30635,0,-698,199,0,0,,897,-499
10,03-08-18,73,18:00,18:15,,23.58,0,23.58,23.58,-1,-57121,94130,151251,37009,0,-15293,0,0,0,,15293,-15293
10,03-08-18,74,18:15,18:30,,33.22,0,33.22,33.22,-1,-57569,87871,145440,30302,0,-19788,0,0,0,,19788,-19788
10,03-08-18,75,18:30,18:45,,32.11,0,32.11,32.11,-1,-61879,97874,159753,35995,0,-10846,0,0,0,,10846,-10846
10,03-08-18,76,18:45,19:00,,35.63,0,35.63,35.63,-1,-83831,94483,178314,10652,0,-5133,0,0,0,,5133,-5133
10,03-08-18,77,19:00,19:15,,33.78,0,33.78,33.78,-1,-76580,85655,162235,9075,0,-1120,0,0,0,,1120,-1120
10,03-08-18,78,19:15,19:30,,32.11,0,32.11,32.11,-1,-72766,81206,153972,8440,0,-7634,0,0,0,,7634,-7634
10,03-08-18,79,19:30,19:45,147.12,36.39,0,147.12,36.19,2,-132026,92111,224137,-39915,0,-3061,5222,0,0,,8283,2161
10,03-08-18,80,19:45,20:00,237.12,36.39,0,237.12,237.12,1,-181694,123336,305030,-58358,0,-141,63042,0,0,,63183,62901
10,03-08-18,81,20:00,20:15,135.68,,0,135.68,135.68,1,-180807,158261,339068,-22546,0,0,35681,2500,0,,38181,38181
10,03-08-18,82,20:15,20:30,135.68,-0.2,0,-0.2,-0.2,-1,-138822,166632,305454,27810,0,-13567,6771,0,0,,20338,-6796
10,03-08-18,83,20:30,20:45,,-79.35,0,-79.35,-79.35,-1,-86592,154311,240903,67719,0,-20152,0,0,0,,20152,-20152
10,03-08-18,84,20:45,21:00,,-92.39,0,-92.39,-92.39,-1,-130754,139216,269970,8462,0,-31611,0,0,0,,31611,-31611
10,03-08-18,85,21:00,21:15,42.55,7.78,0,42.55,7.78,2,-140876,150874,291750,9998,0,-18588,985,0,0,,19573,-17603
10,03-08-18,86,21:15,21:30,42.92,-70.93,0,-70.93,-70.93,-1,-125908,184062,309970,58154,0,-15617,1193,0,0,,16810,-14424
10,03-08-18,87,21:30,21:45,,-92.76,0,-92.76,-92.76,-1,-134621,143331,277952,8710,0,-26093,0,0,0,,26093,-26093
10,03-08-18,88,21:45,22:00,,-48.34,0,-48.34,-48.34,-1,-124718,166012,290730,41294,0,-26308,0,0,0,,26308,-26308
10,03-08-18,89,22:00,22:15,36.84,32.78,0,36.84,32.78,2,-119175,115620,234795,-3555,0,-4509,426,0,0,,4935,-4083
10,03-08-18,90,22:15,22:30,38.11,32.11,0,38.11,32.11,2,-116248,122188,238436,5940,0,-224,1595,0,0,,1819,1371
10,03-08-18,91,22:30,22:45,,16.97,0,16.97,16.97,-1,-117130,167108,284238,49978,0,-5604,0,0,0,,5604,-5604
10,03-08-18,92,22:45,23:00,,8.46,0,8.46,8.46,-1,-112305,194337,306642,82032,0,-33715,0,0,0,,33715,-33715
10,03-08-18,93,23:00,23:15,,31.11,0,31.11,31.11,-1,-106945,56369,163314,-50576,0,-18407,0,0,0,,18407,-18407
10,03-08-18,94,23:15,23:30,32,31.11,0,32,32,1,-109853,57553,167406,-52300,0,-25,59,0,0,,84,34
10,03-08-18,95,23:30,23:45,,,0,33.82,33.82,0,-115805,75584,191389,-40221,0,0,0,0,0,,0,0
10,03-08-18,96,23:45,0:00,,,0,33.82,33.82,0,-118835,105111,223946,-13724,0,0,0,0,0,,0,0
10,03-09-18,1,0:00,0:15,63.12,,0,63.12,63.12,1,-119195,73607,192802,-45588,0,0,4927,0,0,,4927,4927
10,03-09-18,2,0:15,0:30,84.12,,0,84.12,84.12,1,-108121,68595,176716,-39526,0,0,23256,0,0,,23256,23256
10,03-09-18,3,0:30,0:45,,,0,34.1,34.1,0,-75245,61007,136252,-14238,0,0,229,0,0,,229,229
10,03-09-18,4,0:45,1:00,,32.03,0,32.03,32.03,-1,-78449,48701,127150,-29748,0,-344,0,0,0,,344,-344
10,03-09-18,5,1:00,1:15,52.82,16.03,0,52.82,16.03,2,-83846,86221,170067,2375,0,-5506,1407,0,0,,6913,-4099
10,03-09-18,6,1:15,1:30,62.12,,0,62.12,62.12,1,-82083,51485,133568,-30598,0,0,11953,0,0,,11953,11953
10,03-09-18,7,1:30,1:45,38.42,,0,38.42,38.42,1,-75811,45535,121346,-30276,0,0,5348,0,0,,5348,5348
10,03-09-18,8,1:45,2:00,32.97,,0,32.97,32.97,1,-57733,44801,102534,-12932,0,0,2154,0,0,,2154,2154
10,03-09-18,9,2:00,2:15,,32.92,0,32.92,32.92,-1,-38625,60387,99012,21762,0,-124,0,0,0,,124,-124
10,03-09-18,10,2:15,2:30,,33.37,0,33.37,33.37,-1,-48959,44220,93179,-4739,0,-125,0,0,0,,125,-125
10,03-09-18,11,2:30,2:45,34.11,,0,34.11,34.11,1,-53679,42169,95848,-11510,0,0,1483,0,0,,1483,1483
10,03-09-18,12,2:45,3:00,32.42,,0,32.42,32.42,1,-57564,55226,112790,-2338,0,0,547,0,0,,547,547
10,03-09-18,13,3:00,3:15,43.16,,0,43.16,43.16,1,-69268,50229,119497,-19039,0,0,4633,0,0,,4633,4633
10,03-09-18,14,3:15,3:30,48.59,,0,48.59,48.59,1,-71436,45819,117255,-25617,0,0,21128,0,0,,21128,21128
10,03-09-18,15,3:30,3:45,46.89,,0,46.89,46.89,1,-75753,45985,121738,-29768,0,0,13323,0,0,,13323,13323
10,03-09-18,16,3:45,4:00,65.55,,0,65.55,65.55,1,-78272,55435,133707,-22837,0,0,30409,0,0,,30409,30409
10,03-09-18,17,4:00,4:15,65.55,27.13,0,27.13,27.13,-1,-66071,61354,127425,-4717,0,-3065,6758,0,0,,9823,3693
10,03-09-18,18,4:15,4:30,44.29,25.84,0,44.29,25.84,2,-72199,41793,113992,-30406,0,-7001,2552,0,0,,9553,-4449
10,03-09-18,19,4:30,4:45,77.9,,0,77.9,77.9,1,-83378,37228,120606,-46150,0,0,34240,0,0,,34240,34240
10,03-09-18,20,4:45,5:00,44.02,,0,44.02,44.02,1,-78780,40860,119640,-37920,0,0,35586,0,0,,35586,35586
10,03-09-18,21,5:00,5:15,44.02,-18.33,0,-18.33,-18.33,-1,-55751,92329,148080,36578,0,-8307,12379,0,0,,20686,4072
10,03-09-18,22,5:15,5:30,50.77,32.11,0,50.77,50.77,1,-84919,50648,135567,-34271,0,-3992,1792,0,0,,5784,-2200
10,03-09-18,23,5:30,5:45,123.02,,0,123.02,123.02,1,-103234,46763,149997,-56471,0,0,37688,0,0,,37688,37688
10,03-09-18,24,5:45,6:00,47.02,32.45,0,32.45,32.45,-1,-86356,66190,152546,-20166,0,-66,30751,0,0,,30817,30685
10,03-09-18,25,6:00,6:15,47.02,24.66,0,24.66,24.66,-1,-68098,126457,194555,58359,0,-3574,2178,0,0,,5752,-1396
10,03-09-18,26,6:15,6:30,34.25,27.49,0,34.42,27.49,2,-42233,72259,114492,30026,0,-12185,14,0,0,,12199,-12171
10,03-09-18,27,6:30,6:45,238.02,27.49,0,238.02,238.02,1,-94366,41832,136198,-52534,0,-978,22606,0,0,,23584,21628
10,03-09-18,28,6:45,7:00,238.02,,0,238.02,238.02,1,-133743,69315,203058,-64428,0,0,67002,0,0,,67002,67002
10,03-09-18,29,7:00,7:15,34.25,-17.75,0,34.33,-17.75,2,-71599,118282,189881,46683,0,-9746,8477,0,0,,18223,-1269
10,03-09-18,30,7:15,7:30,34.02,-17.75,0,34.02,34.02,1,-58285,43955,102240,-14330,0,-213,3994,0,0,,4207,3781
10,03-09-18,31,7:30,7:45,34.25,,0,34.25,34.25,1,-83317,43618,126935,-39699,0,0,14858,0,0,,14858,14858
10,03-09-18,32,7:45,8:00,138.02,,0,138.02,138.02,1,-158680,33551,192231,-125129,0,0,73327,0,0,,73327,73327
10,03-09-18,33,8:00,8:15,138.02,19.25,0,19.25,19.25,-1,-66424,121218,187642,54794,0,-2385,33752,0,0,,36137,31367
10,03-09-18,34,8:15,8:30,,36.34,0,36.34,36.34,-1,-70946,78601,149547,7655,0,-2421,0,0,0,,2421,-2421
10,03-09-18,35,8:30,8:45,74.93,36.8,0,74.93,74.93,1,-84250,60588,144838,-23662,0,-738,2535,0,0,,3273,1797
10,03-09-18,36,8:45,9:00,146.61,,0,146.61,146.61,1,-94642,47114,141756,-47528,0,0,36998,0,0,,36998,36998
10,03-09-18,37,9:00,9:15,55.18,,0,55.18,55.18,1,-64242,51353,115595,-12889,0,0,28716,0,0,,28716,28716
10,03-09-18,38,9:15,9:30,55.18,36.82,0,36.82,36.82,-1,-72739,66747,139486,-5992,0,-53,3550,0,0,,3603,3497
10,03-09-18,39,9:30,9:45,34.25,,0,34.25,34.25,1,-74064,81329,155393,7265,0,0,11,0,0,,11,11
10,03-09-18,40,9:45,10:00,,36.82,0,36.82,36.82,-1,-62109,96883,158992,34774,0,-67,0,0,0,,67,-67
10,03-09-18,41,10:00,10:15,,27.6,0,27.6,27.6,-1,-70044,89933,159977,19889,0,-3550,0,0,0,,3550,-3550
10,03-09-18,42,10:15,10:30,,21.96,0,21.96,21.96,-1,-77891,96778,174669,18887,0,-16989,0,0,0,,16989,-16989
10,03-09-18,43,10:30,10:45,,31.25,0,31.25,31.25,-1,-64995,89317,154312,24322,0,-15889,0,0,0,,15889,-15889
10,03-09-18,44,10:45,11:00,34.25,32.25,0,34.25,34.25,1,-62481,71365,133846,8884,0,-13682,29,0,0,,13711,-13653
10,03-09-18,45,11:00,11:15,154.02,32.25,0,154.02,154.02,1,-80192,34037,114229,-46155,0,-934,21584,0,0,,22518,20650
10,03-09-18,46,11:15,11:30,44.95,,0,44.95,44.95,1,-66389,51810,118199,-14579,0,0,24926,0,0,,24926,24926
10,03-09-18,47,11:30,11:45,34.25,33.37,0,35.5,33.37,2,-61666,59007,120673,-2659,0,-440,3404,0,0,,3844,2964
10,03-09-18,48,11:45,12:00,34.25,34.42,0,34.42,34.42,-1,-64834,67701,132535,2867,0,-287,105,0,0,,392,-182
10,03-09-18,49,12:00,12:15,,34.16,0,34.16,34.16,-1,-63035,93686,156721,30651,0,-1907,0,0,0,,1907,-1907
10,03-09-18,50,12:15,12:30,,32.25,0,32.25,32.25,-1,-55354,97887,153241,42533,0,-3336,0,0,0,,3336,-3336
10,03-09-18,51,12:30,12:45,,32.25,0,32.25,32.25,-1,-52439,137326,189765,84887,0,-2105,0,0,0,,2105,-2105
10,03-09-18,52,12:45,13:00,,33.27,0,33.27,33.27,-1,-53027,163940,216967,110913,0,-2976,0,0,0,,2976,-2976
10,03-09-18,53,13:00,13:15,,32.25,0,32.25,32.25,-1,-61466,131173,192639,69707,0,-4730,0,0,0,,4730,-4730
10,03-09-18,54,13:15,13:30,,31.25,0,31.25,31.25,-1,-61795,109771,171566,47976,0,-4524,0,0,0,,4524,-4524
10,03-09-18,55,13:30,13:45,,35.98,0,35.98,35.98,-1,-65843,94524,160367,28681,0,-2341,0,0,0,,2341,-2341
10,03-09-18,56,13:45,14:00,,36.47,0,36.47,36.47,-1,-81816,77489,159305,-4327,0,-1726,0,0,0,,1726,-1726
10,03-09-18,57,14:00,14:15,,35.25,0,35.25,35.25,-1,-54207,74331,128538,20124,0,-1147,0,0,0,,1147,-1147
10,03-09-18,58,14:15,14:30,,35.29,0,35.29,35.29,-1,-55141,51878,107019,-3263,0,-2150,0,0,0,,2150,-2150
10,03-09-18,59,14:30,14:45,,35.29,0,35.29,35.29,-1,-53564,47552,101116,-6012,0,-2033,0,0,0,,2033,-2033
10,03-09-18,60,14:45,15:00,,32.25,0,32.25,32.25,-1,-57449,52791,110240,-4658,0,-2844,0,0,0,,2844,-2844
10,03-09-18,61,15:00,15:15,,32.25,0,32.25,32.25,-1,-38952,98198,137150,59246,0,-2535,0,0,0,,2535,-2535
10,03-09-18,62,15:15,15:30,,36.17,0,36.17,36.17,-1,-34698,88621,123319,53923,0,-2566,0,0,0,,2566,-2566
10,03-09-18,63,15:30,15:45,,36.13,0,36.13,36.13,-1,-42082,63312,105394,21230,0,-2306,0,0,0,,2306,-2306
10,03-09-18,64,15:45,16:00,,36.5,0,36.5,36.5,-1,-58041,50955,108996,-7086,0,-1631,0,0,0,,1631,-1631
10,03-09-18,65,16:00,16:15,,35.66,0,35.66,35.66,-1,-42769,93762,136531,50993,0,-868,0,0,0,,868,-868
10,03-09-18,66,16:15,16:30,,35.5,0,35.5,35.5,-1,-43492,73233,116725,29741,0,-2521,0,0,0,,2521,-2521
10,03-09-18,67,16:30,16:45,34.25,35.47,0,34.25,34.25,1,-49868,54394,104262,4526,0,-1939,7,0,0,,1946,-1932
10,03-09-18,68,16:45,17:00,40.52,35.47,0,40.52,40.52,1,-72539,50037,122576,-22502,0,-101,6466,0,0,,6567,6365
10,03-09-18,69,17:00,17:15,49.07,,0,49.07,49.07,1,-88539,53972,142511,-34567,0,0,6984,0,0,,6984,6984
10,03-09-18,70,17:15,17:30,64.52,,0,64.52,64.52,1,-81004,44668,125672,-36336,0,0,33532,0,0,,33532,33532
10,03-09-18,71,17:30,17:45,41.1,,0,41.1,41.1,1,-70022,59590,129612,-10432,0,0,21320,0,0,,21320,21320
10,03-09-18,72,17:45,18:00,40.08,,0,40.08,40.08,1,-66154,62058,128212,-4096,0,0,5852,0,0,,5852,5852
10,03-09-18,73,18:00,18:15,38.25,28.88,0,38.25,28.88,2,-62608,75856,138464,13248,0,-2259,6107,0,0,,8366,3848
10,03-09-18,74,18:15,18:30,,32.25,0,32.25,32.25,-1,-51068,69854,120922,18786,0,-5240,0,0,0,,5240,-5240
10,03-09-18,75,18:30,18:45,,36.31,0,36.31,36.31,-1,-43076,58691,101767,15615,0,-500,0,0,0,,500,-500
10,03-09-18,76,18:45,19:00,40.08,36.31,0,40.08,40.08,1,-63234,51362,114596,-11872,0,-17,2404,0,0,,2421,2387
10,03-09-18,77,19:00,19:15,34.25,,0,34.25,34.25,1,-61045,44292,105337,-16753,0,0,1689,0,0,,1689,1689
10,03-09-18,78,19:15,19:30,,35.68,0,35.68,35.68,-1,-54227,51201,105428,-3026,0,-243,0,0,0,,243,-243
10,03-09-18,79,19:30,19:45,,20.69,0,20.69,20.69,-1,-37016,65613,102629,28597,0,-8248,0,0,0,,8248,-8248
10,03-09-18,80,19:45,20:00,,23.7,0,23.7,23.7,-1,-44853,73051,117904,28198,0,-25389,0,0,0,,25389,-25389
10,03-09-18,81,20:00,20:15,34.25,35.08,0,34.25,34.25,1,-76151,56298,132449,-19853,0,-8465,228,0,0,,8693,-8237
10,03-09-18,82,20:15,20:30,34.25,15.33,0,15.33,15.33,-1,-59289,88196,147485,28907,0,-7542,152,0,0,,7694,-7390
10,03-09-18,83,20:30,20:45,,27.61,0,27.61,27.61,-1,-60815,94460,155275,33645,0,-22181,0,0,0,,22181,-22181
10,03-09-18,84,20:45,21:00,,24.97,0,24.97,24.97,-1,-77017,113801,190818,36784,0,-35912,0,0,0,,35912,-35912
10,03-09-18,85,21:00,21:15,38.33,31.25,0,38.33,38.33,1,-151503,133025,284528,-18478,0,-14628,246,0,0,,14874,-14382
10,03-09-18,86,21:15,21:30,53.8,36.75,0,53.8,35.5,2,-132145,113444,245589,-18701,0,-111,4393,0,0,,4504,4282
10,03-09-18,87,21:30,21:45,,32.25,0,32.25,32.25,-1,-129179,126358,255537,-2821,0,-303,0,0,0,,303,-303
10,03-09-18,88,21:45,22:00,,32.25,0,32.25,32.25,-1,-165136,147949,313085,-17187,0,-197,0,0,0,,197,-197
10,03-09-18,89,22:00,22:15,,31.25,0,31.25,31.25,-1,-168243,164046,332289,-4197,0,-5064,0,0,0,,5064,-5064
10,03-09-18,90,22:15,22:30,,36.51,0,36.51,36.51,-1,-168030,112193,280223,-55837,0,-1285,0,0,0,,1285,-1285
10,03-09-18,91,22:30,22:45,,36.8,0,36.8,36.8,-1,-153582,131225,284807,-22357,0,-803,0,0,0,,803,-803
10,03-09-18,92,22:45,23:00,,36.64,0,36.64,36.64,-1,-141065,157286,298351,16221,0,-29,0,0,0,,29,-29
10,03-09-18,93,23:00,23:15,,,0,33.7,33.7,0,-107147,45075,152222,-62072,0,-21,0,0,0,,21,-21
10,03-09-18,94,23:15,23:30,,,0,33.71,33.71,0,-78671,27282,105953,-51389,0,0,0,0,0,,0,0
10,03-09-18,95,23:30,23:45,,31.91,0,31.91,31.91,-1,-53783,55647,109430,1864,0,-523,0,0,0,,523,-523
10,03-09-18,96,23:45,0:00,,-18.44,0,-18.44,-18.44,-1,-51036,101888,152924,50852,0,-15467,0,0,0,,15467,-15467
11,03-10-18,1,0:00,0:15,32.38,-150.78,0,35.37,-150.78,2,-44107,95082,139189,50975,0,-21728,7,0,0,,21735,-21721
11,03-10-18,2,0:15,0:30,38.18,32.18,0,38.18,32.18,2,-42288,63297,105585,21009,0,-272,843,0,0,,1115,571
11,03-10-18,3,0:30,0:45,,30.86,0,30.86,30.86,-1,-50299,62531,112830,12232,0,-5470,0,0,0,,5470,-5470
11,03-10-18,4,0:45,1:00,,29.87,0,29.87,29.87,-1,-61913,66581,128494,4668,0,-5365,0,0,0,,5365,-5365
11,03-10-18,5,1:00,1:15,,23.44,0,23.44,23.44,-1,-37205,118057,155262,80852,0,-6256,0,0,0,,6256,-6256
11,03-10-18,6,1:15,1:30,,32.78,0,32.78,32.78,-1,-34688,70788,105476,36100,0,-945,0,0,0,,945,-945
11,03-10-18,7,1:30,1:45,,32.78,0,32.78,32.78,-1,-45109,59698,104807,14589,0,-2227,0,0,0,,2227,-2227
11,03-10-18,8,1:45,2:00,,32.18,0,32.18,32.18,-1,-49811,91082,140893,41271,0,-1528,0,0,0,,1528,-1528
11,03-10-18,9,2:00,2:15,,32.18,0,32.18,32.18,-1,-32959,53292,86251,20333,0,-1562,0,0,0,,1562,-1562
11,03-10-18,10,2:15,2:30,,32.78,0,32.78,32.78,-1,-26192,42857,69049,16665,0,-2143,0,0,0,,2143,-2143
11,03-10-18,11,2:30,2:45,,32.78,0,32.78,32.78,-1,-25349,52757,78106,27408,0,-2470,0,0,0,,2470,-2470
11,03-10-18,12,2:45,3:00,,30.91,0,30.91,30.91,-1,-23887,58628,82515,34741,0,-9258,0,0,0,,9258,-9258
11,03-10-18,13,3:00,3:15,32.13,31.78,0,32.13,32.13,1,-36851,59946,96797,23095,0,-5745,11,0,0,,5756,-5734
11,03-10-18,14,3:15,3:30,32.13,31.78,0,32.13,32.13,1,-40284,52044,92328,11760,0,-8,111,0,0,,119,103
11,03-10-18,15,3:30,3:45,,32.18,0,32.18,32.18,-1,-42460,53720,96180,11260,0,-2141,0,0,0,,2141,-2141
11,03-10-18,16,3:45,4:00,,31.07,0,31.07,31.07,-1,-46150,65626,111776,19476,0,-4221,0,0,0,,4221,-4221
11,03-10-18,17,4:00,4:15,,31.11,0,31.11,31.11,-1,-58798,106067,164865,47269,0,-4707,0,0,0,,4707,-4707
11,03-10-18,18,4:15,4:30,,33.78,0,33.78,33.78,-1,-66728,77732,144460,11004,0,-336,0,0,0,,336,-336
11,03-10-18,19,4:30,4:45,,33.78,0,33.78,33.78,-1,-64013,70149,134162,6136,0,-74,0,0,0,,74,-74
11,03-10-18,20,4:45,5:00,,,0,32.95,32.95,0,-55639,62762,118401,7123,0,0,0,0,0,,0,0
11,03-10-18,21,5:00,5:15,,,0,34.92,34.92,0,-45667,61320,106987,15653,0,0,0,0,0,,0,0
11,03-10-18,22,5:15,5:30,32.14,,0,32.14,32.14,1,-41344,55339,96683,13995,0,0,14,0,0,,14,14
11,03-10-18,23,5:30,5:45,,,0,34.93,34.93,0,-40029,60028,100057,19999,0,0,0,0,0,,0,0
11,03-10-18,24,5:45,6:00,,32.78,0,32.78,32.78,-1,-39496,63487,102983,23991,0,-237,0,0,0,,237,-237
11,03-10-18,25,6:00,6:15,,31.56,0,31.56,31.56,-1,-29105,122467,151572,93362,0,-2307,0,0,0,,2307,-2307
11,03-10-18,26,6:15,6:30,,32.56,0,32.56,32.56,-1,-21461,108363,129824,86902,0,-1588,0,0,0,,1588,-1588
11,03-10-18,27,6:30,6:45,,33.78,0,33.78,33.78,-1,-24001,70022,94023,46021,0,-515,0,0,0,,515,-515
11,03-10-18,28,6:45,7:00,,32.56,0,32.56,32.56,-1,-31889,86577,118466,54688,0,-1700,0,0,0,,1700,-1700
11,03-10-18,29,7:00,7:15,,31.9,0,31.9,31.9,-1,-25306,132875,158181,107569,0,-1048,0,0,0,,1048,-1048
11,03-10-18,30,7:15,7:30,,33.78,0,33.78,33.78,-1,-26062,107349,133411,81287,0,-385,0,0,0,,385,-385
11,03-10-18,31,7:30,7:45,,32.78,0,32.78,32.78,-1,-33971,87548,121519,53577,0,-2244,0,0,0,,2244,-2244
11,03-10-18,32,7:45,8:00,,32.56,0,32.56,32.56,-1,-45146,81050,126196,35904,0,-1688,0,0,0,,1688,-1688
11,03-10-18,33,8:00,8:15,,-17.44,0,-17.44,-17.44,-1,-39759,105638,145397,65879,0,-10074,0,0,0,,10074,-10074
11,03-10-18,34,8:15,8:30,,-31.25,0,-31.25,-31.25,-1,-54892,76564,131456,21672,0,-23165,0,0,0,,23165,-23165
11,03-10-18,35,8:30,8:45,,,0,32.65,32.65,0,-59524,77729,137253,18205,0,-908,0,0,0,,908,-908
11,03-10-18,36,8:45,9:00,,,0,32.65,32.65,0,-76284,75756,152040,-528,0,0,0,0,0,,0,0
11,03-10-18,37,9:00,9:15,,32.56,0,32.56,32.56,-1,-38509,92427,130936,53918,0,-1117,0,0,0,,1117,-1117
11,03-10-18,38,9:15,9:30,,32.56,0,32.56,32.56,-1,-32709,82825,115534,50116,0,-2798,0,0,0,,2798,-2798
11,03-10-18,39,9:30,9:45,,32.56,0,32.56,32.56,-1,-20896,93282,114178,72386,0,-2677,0,0,0,,2677,-2677
11,03-10-18,40,9:45,10:00,,32.56,0,32.56,32.56,-1,-21370,85145,106515,63775,0,-2247,0,0,0,,2247,-2247
11,03-10-18,41,10:00,10:15,,32.56,0,32.56,32.56,-1,-41396,133120,174516,91724,0,-1961,0,0,0,,1961,-1961
11,03-10-18,42,10:15,10:30,,27.39,0,27.39,27.39,-1,-29492,168424,197916,138932,0,-7245,0,0,0,,7245,-7245
11,03-10-18,43,10:30,10:45,,-37.25,0,-37.25,-37.25,-1,-29760,186800,216560,157040,0,-34720,0,0,0,,34720,-34720
11,03-10-18,44,10:45,11:00,,-79.25,0,-79.25,-79.25,-1,-34110,169962,204072,135852,0,-60941,0,0,0,,60941,-60941
11,03-10-18,45,11:00,11:15,,-91.25,0,-91.25,-91.25,-1,-54078,135136,189214,81058,0,-65638,0,0,0,,65638,-65638
11,03-10-18,46,11:15,11:30,,26.02,0,26.02,26.02,-1,-57456,148039,205495,90583,0,-32073,0,0,0,,32073,-32073
11,03-10-18,47,11:30,11:45,,30.01,0,30.01,30.01,-1,-51133,161106,212239,109973,0,-11098,0,0,0,,11098,-11098
11,03-10-18,48,11:45,12:00,,-11.31,0,-11.31,-11.31,-1,-60807,142093,202900,81286,0,-16172,0,0,0,,16172,-16172
11,03-10-18,49,12:00,12:15,56.56,-11.31,0,56.56,56.56,1,-129955,91891,221846,-38064,0,-1466,5564,0,0,,7030,4098
11,03-10-18,50,12:15,12:30,38.56,32.56,0,32.56,32.56,-1,-110684,115439,226123,4755,0,-104,7852,0,0,,7956,7748
11,03-10-18,51,12:30,12:45,38.56,32.56,0,32.56,32.56,-1,-126806,133020,259826,6214,0,-2112,14,0,0,,2126,-2098
11,03-10-18,52,12:45,13:00,,29.77,0,29.77,29.77,-1,-113844,128415,242259,14571,0,-5667,0,0,0,,5667,-5667
11,03-10-18,53,13:00,13:15,,31.25,0,31.25,31.25,-1,-80394,94919,175313,14525,0,-3611,0,0,0,,3611,-3611
11,03-10-18,54,13:15,13:30,,32.56,0,32.56,32.56,-1,-76444,97660,174104,21216,0,-763,0,0,0,,763,-763
11,03-10-18,55,13:30,13:45,,32.56,0,32.56,32.56,-1,-75828,98856,174684,23028,0,-2762,0,0,0,,2762,-2762
11,03-10-18,56,13:45,14:00,,32.56,0,32.56,32.56,-1,-91515,97229,188744,5714,0,-2683,0,0,0,,2683,-2683
11,03-10-18,57,14:00,14:15,,31.56,0,31.56,31.56,-1,-78073,112410,190483,34337,0,-3715,0,0,0,,3715,-3715
11,03-10-18,58,14:15,14:30,,32.56,0,32.56,32.56,-1,-73736,69427,143163,-4309,0,-2003,0,0,0,,2003,-2003
11,03-10-18,59,14:30,14:45,58.25,,0,58.25,58.25,1,-85627,45521,131148,-40106,0,0,8981,0,0,,8981,8981
11,03-10-18,60,14:45,15:00,42.52,,0,42.52,42.52,1,-96574,62352,158926,-34222,0,0,16705,0,0,,16705,16705
11,03-10-18,61,15:00,15:15,42.52,31.56,0,31.56,31.56,-1,-74128,90684,164812,16556,0,-86,382,0,0,,468,296
11,03-10-18,62,15:15,15:30,,32.56,0,32.56,32.56,-1,-96483,103334,199817,6851,0,-1461,0,0,0,,1461,-1461
11,03-10-18,63,15:30,15:45,,32.56,0,32.56,32.56,-1,-109230,108090,217320,-1140,0,-964,0,0,0,,964,-964
11,03-10-18,64,15:45,16:00,34.56,,0,34.56,34.56,1,-115096,104335,219431,-10761,0,0,2584,0,0,,2584,2584
11,03-10-18,65,16:00,16:15,34.56,31.37,0,31.37,31.37,-1,-65544,139459,205003,73915,0,-1387,125,0,0,,1512,-1262
11,03-10-18,66,16:15,16:30,,31.76,0,31.76,31.76,-1,-73307,124222,197529,50915,0,-975,0,0,0,,975,-975
11,03-10-18,67,16:30,16:45,,32.56,0,32.56,32.56,-1,-86772,93678,180450,6906,0,-1911,0,0,0,,1911,-1911
11,03-10-18,68,16:45,17:00,32.65,33.78,0,32.65,32.65,1,-107351,88198,195549,-19153,0,-236,173,0,0,,409,-63
11,03-10-18,69,17:00,17:15,32.8,-56.78,0,34.1,-56.78,2,-68602,117202,185804,48600,0,-14660,173,0,0,,14833,-14487
11,03-10-18,70,17:15,17:30,36.56,32,0,36.56,36.56,1,-98798,89615,188413,-9183,0,-4504,232,0,0,,4736,-4272
11,03-10-18,71,17:30,17:45,57.72,,0,57.72,57.72,1,-88632,64258,152890,-24374,0,0,4579,0,0,,4579,4579
11,03-10-18,72,17:45,18:00,74.75,31.61,0,74.75,31.61,2,-86110,89714,175824,3604,0,-96,20057,0,0,,20153,19961
11,03-10-18,73,18:00,18:15,74.75,-150.78,0,-150.78,-150.78,-1,-49686,114703,164389,65017,0,-34424,1941,0,0,,36365,-32483
11,03-10-18,74,18:15,18:30,,30.05,0,30.05,30.05,-1,-87780,124988,212768,37208,0,-18781,0,0,0,,18781,-18781
11,03-10-18,75,18:30,18:45,,38.47,0,38.47,38.47,-1,-59025,126228,185253,67203,0,-3627,0,0,0,,3627,-3627
11,03-10-18,76,18:45,19:00,,32.56,0,32.56,32.56,-1,-62100,127925,190025,65825,0,-407,0,0,0,,407,-407
11,03-10-18,77,19:00,19:15,,-23.78,0,-23.78,-23.78,-1,-65466,125741,191207,60275,0,-27800,0,0,0,,27800,-27800
11,03-10-18,78,19:15,19:30,,21.59,0,21.59,21.59,-1,-85739,129126,214865,43387,0,-37847,0,0,0,,37847,-37847
11,03-10-18,79,19:30,19:45,,-17.44,0,-17.44,-17.44,-1,-91581,127382,218963,35801,0,-43964,0,0,0,,43964,-43964
11,03-10-18,80,19:45,20:00,,-65.12,0,-65.12,-65.12,-1,-79380,133211,212591,53831,0,-17754,0,0,0,,17754,-17754
11,03-10-18,81,20:00,20:15,,-17.44,0,-17.44,-17.44,-1,-126550,107415,233965,-19135,0,-18543,0,0,0,,18543,-18543
11,03-10-18,82,20:15,20:30,,32.56,0,32.56,32.56,-1,-108337,100089,208426,-8248,0,-217,0,0,0,,217,-217
11,03-10-18,83,20:30,20:45,,-12.74,0,-12.74,-12.74,-1,-71503,103836,175339,32333,0,-6453,0,0,0,,6453,-6453
11,03-10-18,84,20:45,21:00,,-64.78,0,-64.78,-64.78,-1,-84242,115379,199621,31137,0,-30798,0,0,0,,30798,-30798
11,03-10-18,85,21:00,21:15,34.56,-64.78,0,34.56,34.56,1,-99029,95988,195017,-3041,0,-2641,221,0,0,,2862,-2420
11,03-10-18,86,21:15,21:30,,23.37,0,23.37,23.37,-1,-73484,107226,180710,33742,0,-4268,0,0,0,,4268,-4268
11,03-10-18,87,21:30,21:45,,23.79,0,23.79,23.79,-1,-78154,117617,195771,39463,0,-18984,0,0,0,,18984,-18984
11,03-10-18,88,21:45,22:00,,15.45,0,15.45,15.45,-1,-79758,131468,211226,51710,0,-30081,0,0,0,,30081,-30081
11,03-10-18,89,22:00,22:15,56.56,30.44,0,56.56,30.44,2,-95662,68191,163853,-27471,0,-16277,2260,0,0,,18537,-14017
11,03-10-18,90,22:15,22:30,56.56,21.36,0,21.36,21.36,-1,-65914,81540,147454,15626,0,-5926,60,0,0,,5986,-5866
11,03-10-18,91,22:30,22:45,,21.36,0,21.36,21.36,-1,-52404,74391,126795,21987,0,-16592,0,0,0,,16592,-16592
11,03-10-18,92,22:45,23:00,,21.36,0,21.36,21.36,-1,-46874,89032,135906,42158,0,-11213,0,0,0,,11213,-11213
11,03-10-18,93,23:00,23:15,56.56,18.56,0,56.56,18.56,2,-79442,62852,142294,-16590,0,-15620,1715,0,0,,17335,-13905
11,03-10-18,94,23:15,23:30,56.56,27.09,0,27.09,27.09,-1,-61883,75082,136965,13199,0,-3127,2978,0,0,,6105,-149
11,03-10-18,95,23:30,23:45,,-17.44,0,-17.44,-17.44,-1,-66057,104408,170465,38351,0,-31971,0,0,0,,31971,-31971
11,03-10-18,96,23:45,0:00,,14.57,0,14.57,14.57,-1,-88806,118268,207074,29462,0,-31665,0,0,0,,31665,-31665
11,03-11-18,1,0:00,0:15,,-61.13,0,-61.13,-61.13,-1,-62655,119259,181914,56604,0,-26656,0,0,0,,26656,-26656
11,03-11-18,2,0:15,0:30,,14.56,0,14.56,14.56,-1,-69257,118386,187643,49129,0,-7918,0,0,0,,7918,-7918
11,03-11-18,3,0:30,0:45,,-2.03,0,-2.03,-2.03,-1,-67098,127324,194422,60226,0,-41919,0,0,0,,41919,-41919
11,03-11-18,4,0:45,1:00,,20.97,0,20.97,20.97,-1,-75638,114049,189687,38411,0,-46101,0,0,0,,46101,-46101
11,03-11-18,5,1:00,1:15,,-9.03,0,-9.03,-9.03,-1,-45094,125902,170996,80808,0,-29218,0,0,0,,29218,-29218
11,03-11-18,6,1:15,1:30,,-22.86,0,-22.86,-22.86,-1,-64826,116025,180851,51199,0,-8254,0,0,0,,8254,-8254
11,03-11-18,7,1:30,1:45,,-52.5,0,-52.5,-52.5,-1,-63629,97514,161143,33885,0,-28758,0,0,0,,28758,-28758
11,03-11-18,8,1:45,2:00,,-6.03,0,-6.03,-6.03,-1,-66700,111950,178650,45250,0,-31283,0,0,0,,31283,-31283
11,03-11-18,9,2:00,2:15,32.44,22.83,0,32.44,32.44,1,-79433,87188,166621,7755,0,-19089,46,0,0,,19135,-19043
11,03-11-18,10,2:15,2:30,32.44,22.83,0,32.44,32.44,1,-79718,74919,154637,-4799,0,-13,195,0,0,,208,182
11,03-11-18,11,2:30,2:45,,31.66,0,31.66,31.66,-1,-77625,76826,154451,-799,0,-496,0,0,0,,496,-496
11,03-11-18,12,2:45,3:00,,22.76,0,22.76,22.76,-1,-78376,92338,170714,13962,0,-7075,0,0,0,,7075,-7075
11,03-11-18,13,3:00,3:15,,15.83,0,15.83,15.83,-1,-67644,104956,172600,37312,0,-23457,0,0,0,,23457,-23457
11,03-11-18,14,3:15,3:30,,28.87,0,28.87,28.87,-1,-68017,112895,180912,44878,0,-17487,0,0,0,,17487,-17487
11,03-11-18,15,3:30,3:45,,20.42,0,20.42,20.42,-1,-67571,117305,184876,49734,0,-23800,0,0,0,,23800,-23800
11,03-11-18,16,3:45,4:00,,12.75,0,12.75,12.75,-1,-68153,108295,176448,40142,0,-33725,0,0,0,,33725,-33725
11,03-11-18,17,4:00,4:15,33.99,31.66,0,34.66,31.66,2,-66405,80755,147160,14350,0,-10089,582,0,0,,10671,-9507
11,03-11-18,18,4:15,4:30,,27.42,0,27.42,27.42,-1,-48997,98060,147057,49063,0,-9246,0,0,0,,9246,-9246
11,03-11-18,19,4:30,4:45,,19.03,0,19.03,19.03,-1,-51206,106118,157324,54912,0,-24513,0,0,0,,24513,-24513
11,03-11-18,20,4:45,5:00,,25.93,0,25.93,25.93,-1,-51088,87069,138157,35981,0,-27825,0,0,0,,27825,-27825
11,03-11-18,21,5:00,5:15,,-11.03,0,-11.03,-11.03,-1,-32747,80931,113678,48184,0,-28278,0,0,0,,28278,-28278
11,03-11-18,22,5:15,5:30,,-25.81,0,-25.81,-25.81,-1,-33249,59676,92925,26427,0,-34626,0,0,0,,34626,-34626
11,03-11-18,23,5:30,5:45,,31.03,0,31.03,31.03,-1,-37579,60711,98290,23132,0,-20237,0,0,0,,20237,-20237
11,03-11-18,24,5:45,6:00,,11.13,0,11.13,11.13,-1,-41813,84267,126080,42454,0,-27929,0,0,0,,27929,-27929
11,03-11-18,25,6:00,6:15,,30.03,0,30.03,30.03,-1,-47058,89715,136773,42657,0,-14878,0,0,0,,14878,-14878
11,03-11-18,26,6:15,6:30,,37.26,0,37.26,37.26,-1,-35901,76253,112154,40352,0,-68,0,0,0,,68,-68
11,03-11-18,27,6:30,6:45,,32.73,0,32.73,32.73,-1,-47369,76778,124147,29409,0,-1626,0,0,0,,1626,-1626
11,03-11-18,28,6:45,7:00,,32.73,0,32.73,32.73,-1,-41221,88439,129660,47218,0,-2955,0,0,0,,2955,-2955
11,03-11-18,29,7:00,7:15,,-11.03,0,-11.03,-11.03,-1,-39227,114819,154046,75592,0,-19485,0,0,0,,19485,-19485
11,03-11-18,30,7:15,7:30,,25.09,0,25.09,25.09,-1,-38421,97774,136195,59353,0,-19393,0,0,0,,19393,-19393
11,03-11-18,31,7:30,7:45,,,0,34.89,34.89,0,-46453,93765,140218,47312,0,-603,0,0,0,,603,-603
11,03-11-18,32,7:45,8:00,,32,0,32,32,-1,-65303,96396,161699,31093,0,-671,0,0,0,,671,-671
11,03-11-18,33,8:00,8:15,,-103.99,0,-103.99,-103.99,-1,-24912,135853,160765,110941,0,-26509,0,0,0,,26509,-26509
11,03-11-18,34,8:15,8:30,,28.35,0,28.35,28.35,-1,-33452,117182,150634,83730,0,-19726,0,0,0,,19726,-19726
11,03-11-18,35,8:30,8:45,,31.6,0,31.6,31.6,-1,-54033,108913,162946,54880,0,-4090,0,0,0,,4090,-4090
11,03-11-18,36,8:45,9:00,,32,0,32,32,-1,-53482,105073,158555,51591,0,-2449,0,0,0,,2449,-2449
11,03-11-18,37,9:00,9:15,,32,0,32,32,-1,-62065,95826,157891,33761,0,-3525,0,0,0,,3525,-3525
11,03-11-18,38,9:15,9:30,,32,0,32,32,-1,-71211,78819,150030,7608,0,-1665,0,0,0,,1665,-1665
11,03-11-18,39,9:30,9:45,47.04,,0,47.04,47.04,1,-81702,61422,143124,-20280,0,0,4689,0,0,,4689,4689
11,03-11-18,40,9:45,10:00,45.09,,0,45.09,45.09,1,-94311,66827,161138,-27484,0,0,20985,0,0,,20985,20985
11,03-11-18,41,10:00,10:15,199.99,,0,199.99,199.99,1,-106054,44956,151010,-61098,0,0,41265,0,0,,41265,41265
11,03-11-18,42,10:15,10:30,86.88,,0,86.88,86.88,1,-86151,80730,166881,-5421,0,0,32334,0,0,,32334,32334
11,03-11-18,43,10:30,10:45,41.95,31.99,0,41.95,31.99,2,-101976,87934,189910,-14042,0,-153,1990,0,0,,2143,1837
11,03-11-18,44,10:45,11:00,41.95,,0,41.95,41.95,1,-125316,92187,217503,-33129,0,0,9990,0,0,,9990,9990
11,03-11-18,45,11:00,11:15,41.23,30.45,0,41.23,30.45,2,-54466,90714,145180,36248,0,-690,8008,0,0,,8698,7318
11,03-11-18,46,11:15,11:30,41.23,31.99,0,31.99,31.99,-1,-50059,133089,183148,83030,0,-452,185,0,0,,637,-267
11,03-11-18,47,11:30,11:45,,32,0,32,32,-1,-39788,135242,175030,95454,0,-1855,0,0,0,,1855,-1855
11,03-11-18,48,11:45,12:00,,31,0,31,31,-1,-28002,165532,193534,137530,0,-3974,0,0,0,,3974,-3974
11,03-11-18,49,12:00,12:15,,29.87,0,29.87,29.87,-1,-55384,197503,252887,142119,0,-14004,0,0,0,,14004,-14004
11,03-11-18,50,12:15,12:30,,-74.99,0,-74.99,-74.99,-1,-62911,178529,241440,115618,0,-23835,0,0,0,,23835,-23835
11,03-11-18,51,12:30,12:45,,-92.99,0,-92.99,-92.99,-1,-70922,125202,196124,54280,0,-20642,0,0,0,,20642,-20642
11,03-11-18,52,12:45,13:00,,-79.99,0,-79.99,-79.99,-1,-75481,176223,251704,100742,0,-12826,0,0,0,,12826,-12826
11,03-11-18,53,13:00,13:15,,-64.9,0,-64.9,-64.9,-1,-72293,135200,207493,62907,0,-27801,0,0,0,,27801,-27801
11,03-11-18,54,13:15,13:30,,-104.99,0,-104.99,-104.99,-1,-58542,165831,224373,107289,0,-20913,0,0,0,,20913,-20913
11,03-11-18,55,13:30,13:45,,-59.99,0,-59.99,-59.99,-1,-73667,147092,220759,73425,0,-55976,0,0,0,,55976,-55976
11,03-11-18,56,13:45,14:00,,-49.32,0,-49.32,-49.32,-1,-80194,139333,219527,59139,0,-47717,0,0,0,,47717,-47717
11,03-11-18,57,14:00,14:15,,-25,0,-25,-25,-1,-97509,142752,240261,45243,0,-49309,0,0,0,,49309,-49309
11,03-11-18,58,14:15,14:30,36.73,28.94,0,36.73,28.94,2,-110569,116679,227248,6110,0,-9469,866,0,0,,10335,-8603
11,03-11-18,59,14:30,14:45,,2.99,0,2.99,2.99,-1,-99534,117206,216740,17672,0,-17406,0,0,0,,17406,-17406
11,03-11-18,60,14:45,15:00,,25.36,0,25.36,25.36,-1,-109205,118424,227629,9219,0,-6344,0,0,0,,6344,-6344
11,03-11-18,61,15:00,15:15,,-57.74,0,-57.74,-57.74,-1,-80378,114587,194965,34209,0,-26160,0,0,0,,26160,-26160
11,03-11-18,62,15:15,15:30,,-9.03,0,-9.03,-9.03,-1,-79934,125831,205765,45897,0,-25235,0,0,0,,25235,-25235
11,03-11-18,63,15:30,15:45,,4.72,0,4.72,4.72,-1,-110809,151770,262579,40961,0,-44063,0,0,0,,44063,-44063
11,03-11-18,64,15:45,16:00,,28.9,0,28.9,28.9,-1,-123933,134708,258641,10775,0,-20828,0,0,0,,20828,-20828
11,03-11-18,65,16:00,16:15,,8.45,0,8.45,8.45,-1,-63415,90311,153726,26896,0,-11676,0,0,0,,11676,-11676
11,03-11-18,66,16:15,16:30,,31,0,31,31,-1,-98724,110692,209416,11968,0,-14800,0,0,0,,14800,-14800
11,03-11-18,67,16:30,16:45,48.71,32,0,48.71,32,2,-111938,99797,211735,-12141,0,-7398,1445,0,0,,8843,-5953
11,03-11-18,68,16:45,17:00,118.02,32,0,118.02,118.02,1,-142088,109615,251703,-32473,0,-390,33112,0,0,,33502,32722
11,03-11-18,69,17:00,17:15,43.12,-97.03,0,-97.03,-97.03,-1,-42359,102327,144686,59968,0,-7598,14395,0,0,,21993,6797
11,03-11-18,70,17:15,17:30,62.3,-150.03,0,62.3,-150.03,2,-68172,66107,134279,-2065,0,-37604,1223,0,0,,38827,-36381
11,03-11-18,71,17:30,17:45,222.02,-150.03,0,222.02,222.02,1,-109397,66413,175810,-42984,0,-60,33092,0,0,,33152,33032
11,03-11-18,72,17:45,18:00,36.73,31.54,0,31.54,31.54,-1,-100174,114127,214301,13953,0,-169,13203,0,0,,13372,13034
11,03-11-18,73,18:00,18:15,36.73,-150.03,0,-150.03,-150.03,-1,-37481,160299,197780,122818,0,-25219,136,0,0,,25355,-25083
11,03-11-18,74,18:15,18:30,,4.4,0,4.4,4.4,-1,-43077,98079,141156,55002,0,-38892,0,0,0,,38892,-38892
11,03-11-18,75,18:30,18:45,,,0,35.63,35.63,0,-56757,89676,146433,32919,0,-4222,0,0,0,,4222,-4222
11,03-11-18,76,18:45,19:00,50,,0,50,50,1,-85628,89082,174710,3454,0,0,1378,0,0,,1378,1378
11,03-11-18,77,19:00,19:15,237.02,,0,237.02,237.02,1,-136803,34180,170983,-102623,0,0,47644,0,0,,47644,47644
11,03-11-18,78,19:15,19:30,82.02,,0,82.02,82.02,1,-96222,67573,163795,-28649,0,0,45502,0,0,,45502,45502
11,03-11-18,79,19:30,19:45,33.6,28.43,0,34.32,28.43,2,-81482,81331,162813,-151,0,-927,4465,0,0,,5392,3538
11,03-11-18,80,19:45,20:00,41.29,,0,41.29,41.29,1,-99626,76982,176608,-22644,0,0,8409,0,0,,8409,8409
11,03-11-18,81,20:00,20:15,63.1,,0,63.1,63.1,1,-98880,77599,176479,-21281,0,0,25942,0,0,,25942,25942
11,03-11-18,82,20:15,20:30,63.1,31,0,31,31,-1,-73444,81627,155071,8183,0,-424,5790,0,0,,6214,5366
11,03-11-18,83,20:30,20:45,,8.03,0,8.03,8.03,-1,-68576,96487,165063,27911,0,-13594,0,0,0,,13594,-13594
11,03-11-18,84,20:45,21:00,,-58.03,0,-58.03,-58.03,-1,-60106,103392,163498,43286,0,-20716,0,0,0,,20716,-20716
11,03-11-18,85,21:00,21:15,134.02,-64.03,0,134.02,134.02,1,-80691,66872,147563,-13819,0,-20225,3894,0,0,,24119,-16331
11,03-11-18,86,21:15,21:30,34.31,-64.03,0,34.31,34.31,1,-51187,72659,123846,21472,0,-3,3591,0,0,,3594,3588
11,03-11-18,87,21:30,21:45,,29.81,0,29.81,29.81,-1,-45992,90512,136504,44520,0,-787,0,0,0,,787,-787
11,03-11-18,88,21:45,22:00,,8.03,0,8.03,8.03,-1,-56416,114750,171166,58334,0,-8878,0,0,0,,8878,-8878
11,03-11-18,89,22:00,22:15,,31.09,0,31.09,31.09,-1,-57491,72041,129532,14550,0,-3412,0,0,0,,3412,-3412
11,03-11-18,90,22:15,22:30,,31.75,0,31.75,31.75,-1,-77762,84792,162554,7030,0,-1068,0,0,0,,1068,-1068
11,03-11-18,91,22:30,22:45,,26.76,0,26.76,26.76,-1,-95649,112207,207856,16558,0,-4722,0,0,0,,4722,-4722
11,03-11-18,92,22:45,23:00,,27.03,0,27.03,27.03,-1,-88681,145650,234331,56969,0,-7588,0,0,0,,7588,-7588
11,03-11-18,93,23:00,23:15,,32,0,32,32,-1,-90186,99805,189991,9619,0,-1428,0,0,0,,1428,-1428
11,03-11-18,94,23:15,23:30,,13.99,0,13.99,13.99,-1,-95173,144627,239800,49454,0,-6635,0,0,0,,6635,-6635
11,03-11-18,95,23:30,23:45,,7.03,0,7.03,7.03,-1,-90027,156377,246404,66350,0,-18016,0,0,0,,18016,-18016
11,03-11-18,96,23:45,0:00,,-150.03,0,-150.03,-150.03,-1,-100110,180022,280132,79912,0,-27697,0,0,0,,27697,-27697
11,03-12-18,1,0:00,0:15,,-150.78,0,-150.78,-150.78,-1,-66525,124871,191396,58346,0,-32763,0,0,0,,32763,-32763
11,03-12-18,2,0:15,0:30,,-69.78,0,-69.78,-69.78,-1,-53579,118692,172271,65113,0,-31097,0,0,0,,31097,-31097
11,03-12-18,3,0:30,0:45,,24.78,0,24.78,24.78,-1,-48144,106396,154540,58252,0,-48336,0,0,0,,48336,-48336
11,03-12-18,4,0:45,1:00,,23.58,0,23.58,23.58,-1,-57056,111663,168719,54607,0,-50645,0,0,0,,50645,-50645
11,03-12-18,5,1:00,1:15,,13.84,0,13.84,13.84,-1,-40784,102340,143124,61556,0,-27411,0,0,0,,27411,-27411
11,03-12-18,6,1:15,1:30,,24.14,0,24.14,24.14,-1,-35880,93495,129375,57615,0,-4495,0,0,0,,4495,-4495
11,03-12-18,7,1:30,1:45,,-17.27,0,-17.27,-17.27,-1,-40541,91170,131711,50629,0,-22170,0,0,0,,22170,-22170
11,03-12-18,8,1:45,2:00,,36.81,0,36.81,36.81,-1,-70748,94896,165644,24148,0,-1568,0,0,0,,1568,-1568
11,03-12-18,9,2:00,2:15,,36.32,0,36.32,36.32,-1,-49818,76471,126289,26653,0,-1156,0,0,0,,1156,-1156
11,03-12-18,10,2:15,2:30,,36.33,0,36.33,36.33,-1,-42332,58829,101161,16497,0,-2769,0,0,0,,2769,-2769
11,03-12-18,11,2:30,2:45,,36.75,0,36.75,36.75,-1,-40561,54065,94626,13504,0,-2653,0,0,0,,2653,-2653
11,03-12-18,12,2:45,3:00,,36.72,0,36.72,36.72,-1,-40632,68943,109575,28311,0,-2155,0,0,0,,2155,-2155
11,03-12-18,13,3:00,3:15,,37,0,37,37,-1,-57401,48240,105641,-9161,0,-1058,0,0,0,,1058,-1058
11,03-12-18,14,3:15,3:30,,36.11,0,36.11,36.11,-1,-41964,65323,107287,23359,0,-469,0,0,0,,469,-469
11,03-12-18,15,3:30,3:45,,27.11,0,27.11,27.11,-1,-40117,88066,128183,47949,0,-5877,0,0,0,,5877,-5877
11,03-12-18,16,3:45,4:00,,29.7,0,29.7,29.7,-1,-43250,91347,134597,48097,0,-6102,0,0,0,,6102,-6102
11,03-12-18,17,4:00,4:15,,28.38,0,28.38,28.38,-1,-39776,61122,100898,21346,0,-5692,0,0,0,,5692,-5692
11,03-12-18,18,4:15,4:30,,33.78,0,33.78,33.78,-1,-35355,59913,95268,24558,0,-1813,0,0,0,,1813,-1813
11,03-12-18,19,4:30,4:45,,31.73,0,31.73,31.73,-1,-48949,89438,138387,40489,0,-7039,0,0,0,,7039,-7039
11,03-12-18,20,4:45,5:00,,28.06,0,28.06,28.06,-1,-36780,134003,170783,97223,0,-4798,0,0,0,,4798,-4798
11,03-12-18,21,5:00,5:15,,19.17,0,19.17,19.17,-1,-74927,108358,183285,33431,0,-16155,0,0,0,,16155,-16155
11,03-12-18,22,5:15,5:30,,32.73,0,32.73,32.73,-1,-53922,77647,131569,23725,0,-17989,0,0,0,,17989,-17989
11,03-12-18,23,5:30,5:45,,31.73,0,31.73,31.73,-1,-49522,83842,133364,34320,0,-23621,0,0,0,,23621,-23621
11,03-12-18,24,5:45,6:00,,17.24,0,17.24,17.24,-1,-76400,97892,174292,21492,0,-31079,0,0,0,,31079,-31079
11,03-12-18,25,6:00,6:15,,27.78,0,27.78,27.78,-1,-59044,141277,200321,82233,0,-21421,0,0,0,,21421,-21421
11,03-12-18,26,6:15,6:30,,32.72,0,32.72,32.72,-1,-29403,80012,109415,50609,0,-3466,0,0,0,,3466,-3466
11,03-12-18,27,6:30,6:45,40.53,32.72,0,40.53,40.53,1,-63134,52318,115452,-10816,0,-297,1018,0,0,,1315,721
11,03-12-18,28,6:45,7:00,42.39,,0,42.39,42.39,1,-102910,55375,158285,-47535,0,0,7246,0,0,,7246,7246
11,03-12-18,29,7:00,7:15,42.39,-89.78,0,-89.78,-89.78,-1,-35721,134875,170596,99154,0,-28387,1331,0,0,,29718,-27056
11,03-12-18,30,7:15,7:30,,34.91,0,34.91,34.91,-1,-43282,62083,105365,18801,0,-17395,0,0,0,,17395,-17395
11,03-12-18,31,7:30,7:45,53.18,34.91,0,53.18,53.18,1,-64700,45159,109859,-19541,0,-670,4407,0,0,,5077,3737
11,03-12-18,32,7:45,8:00,110.08,,0,110.08,110.08,1,-95944,37710,133654,-58234,0,0,49237,0,0,,49237,49237
11,03-12-18,33,8:00,8:15,110.08,35.78,0,35.78,35.78,-1,-9062,116941,126003,107879,0,-1423,20705,0,0,,22128,19282
11,03-12-18,34,8:15,8:30,,39.14,0,39.14,39.14,-1,-23746,83823,107569,60077,0,-72,0,0,0,,72,-72
11,03-12-18,35,8:30,8:45,,38.72,0,38.72,38.72,-1,-22844,64428,87272,41584,0,-1310,0,0,0,,1310,-1310
11,03-12-18,36,8:45,9:00,,37.87,0,37.87,37.87,-1,-39948,54423,94371,14475,0,-1227,0,0,0,,1227,-1227
11,03-12-18,37,9:00,9:15,,,0,36.37,36.37,0,-50989,58842,109831,7853,0,-373,0,0,0,,373,-373
11,03-12-18,38,9:15,9:30,,39.44,0,39.44,39.44,-1,-47447,82644,130091,35197,0,-144,0,0,0,,144,-144
11,03-12-18,39,9:30,9:45,,38.72,0,38.72,38.72,-1,-30351,114472,144823,84121,0,-2608,0,0,0,,2608,-2608
11,03-12-18,40,9:45,10:00,,38.72,0,38.72,38.72,-1,-23743,167436,191179,143693,0,-3588,0,0,0,,3588,-3588
11,03-12-18,41,10:00,10:15,,39.16,0,39.16,39.16,-1,-57680,93617,151297,35937,0,-2139,0,0,0,,2139,-2139
11,03-12-18,42,10:15,10:30,,35.91,0,35.91,35.91,-1,-59213,150978,210191,91765,0,-2485,0,0,0,,2485,-2485
11,03-12-18,43,10:30,10:45,,38.36,0,38.36,38.36,-1,-65602,166279,231881,100677,0,-1068,0,0,0,,1068,-1068
11,03-12-18,44,10:45,11:00,,14.78,0,14.78,14.78,-1,-77450,194478,271928,117028,0,-9135,0,0,0,,9135,-9135
11,03-12-18,45,11:00,11:15,,-1.1,0,-1.1,-1.1,-1,-83400,135536,218936,52136,0,-13789,0,0,0,,13789,-13789
11,03-12-18,46,11:15,11:30,,39.17,0,39.17,39.17,-1,-78186,158335,236521,80149,0,-1320,0,0,0,,1320,-1320
11,03-12-18,47,11:30,11:45,,39.21,0,39.21,39.21,-1,-89082,167432,256514,78350,0,-2668,0,0,0,,2668,-2668
11,03-12-18,48,11:45,12:00,,35.91,0,35.91,35.91,-1,-84708,149513,234221,64805,0,-3437,0,0,0,,3437,-3437
11,03-12-18,49,12:00,12:15,,30.47,0,30.47,30.47,-1,-75108,126839,201947,51731,0,-9973,0,0,0,,9973,-9973
11,03-12-18,50,12:15,12:30,,27.01,0,27.01,27.01,-1,-87082,113351,200433,26269,0,-12311,0,0,0,,12311,-12311
11,03-12-18,51,12:30,12:45,,37.51,0,37.51,37.51,-1,-80464,120943,201407,40479,0,-3156,0,0,0,,3156,-3156
11,03-12-18,52,12:45,13:00,,38.58,0,38.58,38.58,-1,-91737,104009,195746,12272,0,-2733,0,0,0,,2733,-2733
11,03-12-18,53,13:00,13:15,62.85,38.58,0,62.85,62.85,1,-122848,92675,215523,-30173,0,-330,9849,0,0,,10179,9519
11,03-12-18,54,13:15,13:30,86.12,,0,86.12,86.12,1,-117576,66199,183775,-51377,0,0,45851,0,0,,45851,45851
11,03-12-18,55,13:30,13:45,57,,0,57,57,1,-107818,66742,174560,-41076,0,0,36395,0,0,,36395,36395
11,03-12-18,56,13:45,14:00,57,47.94,0,47.94,47.94,-1,-105350,93625,198975,-11725,0,-133,1891,0,0,,2024,1758
11,03-12-18,57,14:00,14:15,,37.52,0,37.52,37.52,-1,-83731,138467,222198,54736,0,-875,0,0,0,,875,-875
11,03-12-18,58,14:15,14:30,,52.26,0,52.26,52.26,-1,-71945,132328,204273,60383,0,-1992,0,0,0,,1992,-1992
11,03-12-18,59,14:30,14:45,,52.3,0,52.3,52.3,-1,-79095,117634,196729,38539,0,-2968,0,0,0,,2968,-2968
11,03-12-18,60,14:45,15:00,,51.34,0,51.34,51.34,-1,-85080,135538,220618,50458,0,-3347,0,0,0,,3347,-3347
11,03-12-18,61,15:00,15:15,,0.61,0,0.61,0.61,-1,-20462,174832,195294,154370,0,-19077,0,0,0,,19077,-19077
11,03-12-18,62,15:15,15:30,,35.78,0,35.78,35.78,-1,-32370,109069,141439,76699,0,-13946,0,0,0,,13946,-13946
11,03-12-18,63,15:30,15:45,,41.87,0,41.87,41.87,-1,-44222,101366,145588,57144,0,-5264,0,0,0,,5264,-5264
11,03-12-18,64,15:45,16:00,,34.54,0,34.54,34.54,-1,-56561,67075,123636,10514,0,-9135,0,0,0,,9135,-9135
11,03-12-18,65,16:00,16:15,,22.05,0,22.05,22.05,-1,-58073,142880,200953,84807,0,-18837,0,0,0,,18837,-18837
11,03-12-18,66,16:15,16:30,,34.54,0,34.54,34.54,-1,-55279,110450,165729,55171,0,-7278,0,0,0,,7278,-7278
11,03-12-18,67,16:30,16:45,,13.56,0,13.56,13.56,-1,-52744,88765,141509,36021,0,-23651,0,0,0,,23651,-23651
11,03-12-18,68,16:45,17:00,,,0,43.33,43.33,0,-53578,88666,142244,35088,0,-915,0,0,0,,915,-915
11,03-12-18,69,17:00,17:15,,53.54,0,53.54,53.54,-1,-68484,99345,167829,30861,0,-513,0,0,0,,513,-513
11,03-12-18,70,17:15,17:30,,54.02,0,54.02,54.02,-1,-64338,69723,134061,5385,0,-14,0,0,0,,14,-14
11,03-12-18,71,17:30,17:45,,53.54,0,53.54,53.54,-1,-58825,83497,142322,24672,0,-1218,0,0,0,,1218,-1218
11,03-12-18,72,17:45,18:00,,53.35,0,53.35,53.35,-1,-67549,85037,152586,17488,0,-1480,0,0,0,,1480,-1480
11,03-12-18,73,18:00,18:15,,-47.65,0,-47.65,-47.65,-1,-46622,113447,160069,66825,0,-29797,0,0,0,,29797,-29797
11,03-12-18,74,18:15,18:30,,36.63,0,36.63,36.63,-1,-46607,76013,122620,29406,0,-24628,0,0,0,,24628,-24628
11,03-12-18,75,18:30,18:45,,51.06,0,51.06,51.06,-1,-41123,88983,130106,47860,0,-13815,0,0,0,,13815,-13815
11,03-12-18,76,18:45,19:00,,,0,43.57,43.57,0,-78939,101402,180341,22463,0,-1978,0,0,0,,1978,-1978
11,03-12-18,77,19:00,19:15,55.58,,0,55.58,55.58,1,-83458,56076,139534,-27382,0,0,7639,0,0,,7639,7639
11,03-12-18,78,19:15,19:30,52.92,,0,52.92,52.92,1,-80687,63281,143968,-17406,0,0,9657,0,0,,9657,9657
11,03-12-18,79,19:30,19:45,38.12,,0,38.12,38.12,1,-65520,61617,127137,-3903,0,0,3360,0,0,,3360,3360
11,03-12-18,80,19:45,20:00,43.36,,0,43.36,43.36,1,-64174,61657,125831,-2517,0,0,6,0,0,,6,6
11,03-12-18,81,20:00,20:15,276.12,,0,276.12,276.12,1,-104588,38107,142695,-66481,0,0,29021,0,0,,29021,29021
11,03-12-18,82,20:15,20:30,56.12,42.9,0,42.9,42.9,-1,-62813,62206,125019,-607,0,-218,22269,0,0,,22487,22051
11,03-12-18,83,20:30,20:45,56.12,9.24,0,9.24,9.24,-1,-52970,95009,147979,42039,0,-26121,589,0,0,,26710,-25532
11,03-12-18,84,20:45,21:00,,32.54,0,32.54,32.54,-1,-69066,110191,179257,41125,0,-31162,0,0,0,,31162,-31162
11,03-12-18,85,21:00,21:15,54.59,33.78,0,54.59,33.78,2,-96016,73906,169922,-22110,0,-20869,2249,0,0,,23118,-18620
11,03-12-18,86,21:15,21:30,54.59,53.56,0,53.56,53.56,-1,-48104,79824,127928,31720,0,-364,195,0,0,,559,-169
11,03-12-18,87,21:30,21:45,,49.25,0,49.25,49.25,-1,-36900,99791,136691,62891,0,-1807,0,0,0,,1807,-1807
11,03-12-18,88,21:45,22:00,,-74.2,0,-74.2,-74.2,-1,-34199,146395,180594,112196,0,-23227,0,0,0,,23227,-23227
11,03-12-18,89,22:00,22:15,,28.78,0,28.78,28.78,-1,-73222,40860,114082,-32362,0,-22732,0,0,0,,22732,-22732
11,03-12-18,90,22:15,22:30,,47.55,0,47.55,47.55,-1,-45927,58756,104683,12829,0,-2330,0,0,0,,2330,-2330
11,03-12-18,91,22:30,22:45,,34.19,0,34.19,34.19,-1,-43288,80007,123295,36719,0,-4534,0,0,0,,4534,-4534
11,03-12-18,92,22:45,23:00,,-7.8,0,-7.8,-7.8,-1,-40087,107652,147739,67565,0,-28576,0,0,0,,28576,-28576
11,03-12-18,93,23:00,23:15,107.8,-7.8,0,107.8,107.8,1,-98576,39269,137845,-59307,0,-7830,11867,0,0,,19697,4037
11,03-12-18,94,23:15,23:30,51.27,,0,51.27,51.27,1,-62227,44395,106622,-17832,0,0,18028,0,0,,18028,18028
11,03-12-18,95,23:30,23:45,37.54,,0,37.54,37.54,1,-61272,51268,112540,-10004,0,0,4256,0,0,,4256,4256
11,03-12-18,96,23:45,0:00,60.14,,0,60.14,60.14,1,-117044,74281,191325,-42763,0,0,14289,0,0,,14289,14289
11,03/13/2018,1,0:00,0:15,41.3,36.69,0,43.71,36.69,2,-77045,117157,194202,40112,0,-1992,4855,0,0,,6847,2863
11,03/13/2018,2,0:15,0:30,41.3,44.12,0,43.72,43.72,2,-55092,74841,129933,19749,0,-137,1254,0,0,,1391,1117
11,03/13/2018,3,0:30,0:45,,35.3,0,35.3,35.3,-1,-45621,74914,120535,29293,0,-4499,0,0,0,,4499,-4499
11,03/13/2018,4,0:45,1:00,,29.16,0,29.16,29.16,-1,-50132,105740,155872,55608,0,-37372,0,0,0,,37372,-37372
11,03/13/2018,5,1:00,1:15,,10.11,0,10.11,10.11,-1,-36046,97684,133730,61638,0,-38559,0,0,0,,38559,-38559
11,03/13/2018,6,1:15,1:30,,18.92,0,18.92,18.92,-1,-35548,79769,115317,44221,0,-11134,0,0,0,,11134,-11134
11,03/13/2018,7,1:30,1:45,,17.38,0,17.38,17.38,-1,-29808,82095,111903,52287,0,-36134,0,0,0,,36134,-36134
11,03/13/2018,8,1:45,2:00,,-61.03,0,-61.03,-61.03,-1,-35639,109832,145471,74193,0,-59043,0,0,0,,59043,-59043
11,03/13/2018,9,2:00,2:15,,-8.03,0,-8.03,-8.03,-1,-37708,111214,148922,73506,0,-47908,0,0,0,,47908,-47908
11,03/13/2018,10,2:15,2:30,,12.32,0,12.32,12.32,-1,-36748,96396,133144,59648,0,-8872,0,0,0,,8872,-8872
11,03/13/2018,11,2:30,2:45,,-55.03,0,-55.03,-55.03,-1,-42360,98254,140614,55894,0,-49297,0,0,0,,49297,-49297
11,03/13/2018,12,2:45,3:00,,-30.03,0,-30.03,-30.03,-1,-39866,111981,151847,72115,0,-58468,0,0,0,,58468,-58468
11,03/13/2018,13,3:00,3:15,,7.62,0,7.62,7.62,-1,-48273,104518,152791,56245,0,-40973,0,0,0,,40973,-40973
11,03/13/2018,14,3:15,3:30,,,0,42.35,42.35,0,-46326,112267,158593,65941,0,-695,0,0,0,,695,-695
11,03/13/2018,15,3:30,3:45,,35.3,0,35.3,35.3,-1,-47617,113247,160864,65630,0,-1340,0,0,0,,1340,-1340
11,03/13/2018,16,3:45,4:00,,-11.03,0,-11.03,-11.03,-1,-47362,116886,164248,69524,0,-29782,0,0,0,,29782,-29782
11,03/13/2018,17,4:00,4:15,,43.03,0,43.03,43.03,-1,-43562,112143,155705,68581,0,-7428,0,0,0,,7428,-7428
11,03/13/2018,18,4:15,4:30,,52.44,0,52.44,52.44,-1,-33455,127100,160555,93645,0,-252,0,0,0,,252,-252
11,03/13/2018,19,4:30,4:45,,34.3,0,34.3,34.3,-1,-25371,157514,182885,132143,0,-3413,0,0,0,,3413,-3413
11,03/13/2018,20,4:45,5:00,,2.03,0,2.03,2.03,-1,-22942,198506,221448,175564,0,-35057,0,0,0,,35057,-35057
11,03/13/2018,21,5:00,5:15,,-73.03,0,-73.03,-73.03,-1,-46286,163308,209594,117022,0,-55055,0,0,0,,55055,-55055
11,03/13/2018,22,5:15,5:30,,-2.03,0,-2.03,-2.03,-1,-34460,169676,204136,135216,0,-41477,0,0,0,,41477,-41477
11,03/13/2018,23,5:30,5:45,,35.3,0,35.3,35.3,-1,-36834,156689,193523,119855,0,-9922,0,0,0,,9922,-9922
11,03/13/2018,24,5:45,6:00,,53.16,0,53.16,53.16,-1,-46579,176757,223336,130178,0,-1335,0,0,0,,1335,-1335
11,03/13/2018,25,6:00,6:15,,48.39,0,48.39,48.39,-1,-66415,164132,230547,97717,0,-526,0,0,0,,526,-526
11,03/13/2018,26,6:15,6:30,,42.98,0,42.98,42.98,-1,-50864,135988,186852,85124,0,-6917,0,0,0,,6917,-6917
11,03/13/2018,27,6:30,6:45,,53.2,0,53.2,53.2,-1,-52791,108693,161484,55902,0,-2136,0,0,0,,2136,-2136
11,03/13/2018,28,6:45,7:00,,49.96,0,49.96,49.96,-1,-32569,125726,158295,93157,0,-1779,0,0,0,,1779,-1779
11,03/13/2018,29,7:00,7:15,,46.93,0,46.93,46.93,-1,-68011,139406,207417,71395,0,-1651,0,0,0,,1651,-1651
11,03/13/2018,30,7:15,7:30,,46.93,0,46.93,46.93,-1,-44138,112013,156151,67875,0,-1246,0,0,0,,1246,-1246
11,03/13/2018,31,7:30,7:45,52.93,55.44,0,52.93,44.4,2,-44479,53821,98300,9342,0,-1471,73,0,0,,1544,-1398
11,03/13/2018,32,7:45,8:00,296.02,55.44,0,296.02,296.02,1,-105542,43793,149335,-61749,0,-67,28716,0,0,,28783,28649
11,03/13/2018,33,8:00,8:15,282.02,,0,282.02,282.02,1,-124681,105358,230039,-19323,0,0,41117,0,0,,41117,41117
11,03/13/2018,34,8:15,8:30,240.02,,0,240.02,240.02,1,-161537,112346,273883,-49191,0,0,18484,0,0,,18484,18484
11,03/13/2018,35,8:30,8:45,282.02,,0,282.02,282.02,1,-174476,103229,277705,-71247,0,0,61377,0,0,,61377,61377
11,03/13/2018,36,8:45,9:00,282.02,,0,282.02,282.02,1,-172125,80035,252160,-92090,0,0,71761,0,0,,71761,71761
11,03/13/2018,37,9:00,9:15,282.02,,0,282.02,282.02,1,-155696,78786,234482,-76910,0,0,79588,0,0,,79588,79588
11,03/13/2018,38,9:15,9:30,282.02,,0,282.02,282.02,1,-154013,63286,217299,-90727,0,0,76428,0,0,,76428,76428
11,03/13/2018,39,9:30,9:45,282.02,,0,282.02,282.02,1,-99452,14942,114394,-84510,0,0,87490,0,0,,87490,87490
11,03/13/2018,40,9:45,10:00,267.02,,0,267.02,267.02,1,-102339,15279,117618,-87060,0,0,68143,0,0,,68143,68143
11,03/13/2018,41,10:00,10:15,282.02,,0,282.02,282.02,1,-161526,32306,193832,-129220,0,0,87327,0,0,,87327,87327
11,03/13/2018,42,10:15,10:30,350.02,,0,350.02,350.02,1,-181488,39605,221093,-141883,0,0,101467,2500,0,,103967,103967
11,03/13/2018,43,10:30,10:45,350.02,,0,385.02,385.02,1,-204262,44618,248880,-159644,0,0,111327,2500,11666,,125493,125493
11,03/13/2018,44,10:45,11:00,350.02,,0,385.02,385.02,1,-195843,47399,243242,-148444,0,0,107963,2500,34998,,145461,145461
11,03/13/2018,45,11:00,11:15,380.75,,0,418.83,418.83,1,-185783,22880,208663,-162903,0,0,109690,5000,34998,,149688,149688
11,03/13/2018,46,11:15,11:30,380.75,,0,418.83,418.83,1,-215152,29154,244306,-185998,0,0,112436,5000,34998,,152434,152434
11,03/13/2018,47,11:30,11:45,380.75,,0,418.83,418.83,1,-223659,29037,252696,-194622,0,0,112823,5000,34998,,152821,152821
11,03/13/2018,48,11:45,12:00,380.75,,0,418.83,418.83,1,-233107,34912,268019,-198195,0,0,112440,5000,34998,,152438,152438
11,03/13/2018,49,12:00,12:15,371.82,,0,409,409,1,-190073,14912,204985,-175161,0,0,109560,5000,34998,,149558,149558
11,03/13/2018,50,12:15,12:30,371.82,,0,409,409,1,-152553,28582,181135,-123971,0,0,96626,5000,34998,,136624,136624
11,03/13/2018,51,12:30,12:45,371.82,,0,409,409,1,-140780,49367,190147,-91413,0,0,57504,5000,34998,,97502,97502
11,03/13/2018,52,12:45,13:00,371.82,,0,409,409,1,-123812,67353,191165,-56459,0,0,24437,5000,34998,,64435,64435
11,03/13/2018,53,13:00,13:15,350.02,,0,385.02,385.02,1,-138296,33965,172261,-104331,0,0,28174,0,23332,,51506,51506
11,03/13/2018,54,13:15,13:30,350.02,,0,350.02,350.02,1,-163068,45504,208572,-117564,0,0,99428,3750,0,,103178,103178
11,03/13/2018,55,13:30,13:45,350.02,,0,350.02,350.02,1,-144937,44096,189033,-100841,0,0,103358,3750,0,,107108,107108
11,03/13/2018,56,13:45,14:00,226.02,,0,226.02,226.02,1,-129937,40496,170433,-89441,0,0,88232,0,0,,88232,88232
11,03/13/2018,57,14:00,14:15,138.02,,0,138.02,138.02,1,-108276,75952,184228,-32324,0,0,55214,0,0,,55214,55214
11,03/13/2018,58,14:15,14:30,66.94,,0,66.94,66.94,1,-96540,77667,174207,-18873,0,0,6849,0,0,,6849,6849
11,03/13/2018,59,14:30,14:45,122.83,,0,122.83,122.83,1,-115881,73863,189744,-42018,0,0,30427,0,0,,30427,30427
11,03/13/2018,60,14:45,15:00,253.02,,0,253.02,253.02,1,-114942,48292,163234,-66650,0,0,52502,0,0,,52502,52502
11,03/13/2018,61,15:00,15:15,55.69,49.14,0,55.69,49.14,2,-80607,107566,188173,26959,0,-142,18067,0,0,,18209,17925
11,03/13/2018,62,15:15,15:30,54.29,,0,54.29,54.29,1,-89049,85773,174822,-3276,0,0,666,0,0,,666,666
11,03/13/2018,63,15:30,15:45,108.4,,0,108.4,108.4,1,-101798,60107,161905,-41691,0,0,26769,0,0,,26769,26769
11,03/13/2018,64,15:45,16:00,66.99,,0,66.99,66.99,1,-100566,79040,179606,-21526,0,0,26233,0,0,,26233,26233
11,03/13/2018,65,16:00,16:15,48.93,50.26,0,52.34,50.26,2,-50189,140732,190921,90543,0,-373,5052,0,0,,5425,4679
11,03/13/2018,66,16:15,16:30,,55.27,0,55.27,55.27,-1,-45959,117429,163388,71470,0,-261,0,0,0,,261,-261
11,03/13/2018,67,16:30,16:45,,49.14,0,49.14,49.14,-1,-49146,111702,160848,62556,0,-2273,0,0,0,,2273,-2273
11,03/13/2018,68,16:45,17:00,,32.03,0,32.03,32.03,-1,-55421,91553,146974,36132,0,-16899,0,0,0,,16899,-16899
11,03/13/2018,69,17:00,17:15,,32.03,0,32.03,32.03,-1,-50675,102194,152869,51519,0,-34353,0,0,0,,34353,-34353
11,03/13/2018,70,17:15,17:30,,41.93,0,41.93,41.93,-1,-41191,69418,110609,28227,0,-34808,0,0,0,,34808,-34808
11,03/13/2018,71,17:30,17:45,,46.68,0,46.68,46.68,-1,-43824,104761,148585,60937,0,-6141,0,0,0,,6141,-6141
11,03/13/2018,72,17:45,18:00,,55.7,0,55.7,55.7,-1,-44345,135382,179727,91037,0,-1840,0,0,0,,1840,-1840
11,03/13/2018,73,18:00,18:15,,-3.07,0,-3.07,-3.07,-1,-30256,70442,100698,40186,0,-22820,0,0,0,,22820,-22820
11,03/13/2018,74,18:15,18:30,,45.93,0,45.93,45.93,-1,-26642,94028,120670,67386,0,-22194,0,0,0,,22194,-22194
11,03/13/2018,75,18:30,18:45,,41.93,0,41.93,41.93,-1,-26915,123845,150760,96930,0,-13791,0,0,0,,13791,-13791
11,03/13/2018,76,18:45,19:00,,,0,50.55,50.55,0,-53379,95914,149293,42535,0,-1930,0,0,0,,1930,-1930
11,03/13/2018,77,19:00,19:15,168.02,,0,168.02,168.02,1,-93341,49696,143037,-43645,0,0,15458,0,0,,15458,15458
11,03/13/2018,78,19:15,19:30,64.41,,0,64.41,64.41,1,-86221,81179,167400,-5042,0,0,12351,0,0,,12351,12351
11,03/13/2018,79,19:30,19:45,64.41,51.02,0,51.02,51.02,-1,-75426,96850,172276,21424,0,-1007,436,0,0,,1443,-571
11,03/13/2018,80,19:45,20:00,,47.08,0,47.08,47.08,-1,-72683,92914,165597,20231,0,-4098,0,0,0,,4098,-4098
11,03/13/2018,81,20:00,20:15,117.02,55.5,0,117.02,53.99,2,-87375,58699,146074,-28676,0,-1589,10845,0,0,,12434,9256
11,03/13/2018,82,20:15,20:30,58.69,43.93,0,43.93,43.93,-1,-70616,98227,168843,27611,0,-2315,4190,0,0,,6505,1875
11,03/13/2018,83,20:30,20:45,,44.32,0,44.32,44.32,-1,-64257,112477,176734,48220,0,-14146,0,0,0,,14146,-14146
11,03/13/2018,84,20:45,21:00,,49.18,0,49.18,49.18,-1,-73406,90718,164124,17312,0,-13305,0,0,0,,13305,-13305
11,03/13/2018,85,21:00,21:15,52.93,45.93,0,52.93,45.93,2,-77706,79465,157171,1759,0,-9567,718,0,0,,10285,-8849
11,03/13/2018,86,21:15,21:30,52.93,54.04,0,54.04,54.04,-1,-40823,60150,100973,19327,0,-497,311,0,0,,808,-186
11,03/13/2018,87,21:30,21:45,,50.05,0,50.05,50.05,-1,-33980,90160,124140,56180,0,-387,0,0,0,,387,-387
11,03/13/2018,88,21:45,22:00,,11.3,0,11.3,11.3,-1,-49231,121303,170534,72072,0,-31860,0,0,0,,31860,-31860
11,03/13/2018,89,22:00,22:15,214.02,11.3,0,214.02,214.02,1,-66469,36222,102691,-30247,0,-17783,7056,0,0,,24839,-10727
11,03/13/2018,90,22:15,22:30,48.93,25.09,0,51.9,25.09,2,-32227,70207,102434,37980,0,-10879,1282,0,0,,12161,-9597
11,03/13/2018,91,22:30,22:45,,45.93,0,45.93,45.93,-1,-29433,88731,118164,59298,0,-16530,0,0,0,,16530,-16530
11,03/13/2018,92,22:45,23:00,,-20.32,0,-20.32,-20.32,-1,-27275,146721,173996,119446,0,-24355,0,0,0,,24355,-24355
11,03/13/2018,93,23:00,23:15,72.4,-69.32,0,72.4,72.4,1,-96501,85076,181577,-11425,0,-21815,2143,0,0,,23958,-19672
11,03/13/2018,94,23:15,23:30,172.02,,0,172.02,172.02,1,-80697,38090,118787,-42607,0,0,36362,0,0,,36362,36362
11,03/13/2018,95,23:30,23:45,54.93,46,0,46,46,-1,-46537,64250,110787,17713,0,-1317,17274,0,0,,18591,15957
11,03/13/2018,96,23:45,0:00,54.93,34.2,0,34.2,34.2,-1,-52962,81512,134474,28550,0,-5736,25,0,0,,5761,-5711
11,03/14/2018,1,0:00,0:15,,-6.03,0,-6.03,-6.03,-1,-31365,169380,200745,138015,0,-8001,0,0,0,,8001,-8001
11,03/14/2018,2,0:15,0:30,,46.85,0,46.85,46.85,-1,-41366,81722,123088,40356,0,-1603,0,0,0,,1603,-1603
11,03/14/2018,3,0:30,0:45,,46.94,0,46.94,46.94,-1,-64035,63733,127768,-302,0,-1655,0,0,0,,1655,-1655
11,03/14/2018,4,0:45,1:00,,42.65,0,42.65,42.65,-1,-75381,75765,151146,384,0,-379,0,0,0,,379,-379
11,03/14/2018,5,1:00,1:15,,41.35,0,41.35,41.35,-1,-48284,98016,146300,49732,0,-558,0,0,0,,558,-558
11,03/14/2018,6,1:15,1:30,,46.26,0,46.26,46.26,-1,-43433,67280,110713,23847,0,-1724,0,0,0,,1724,-1724
11,03/14/2018,7,1:30,1:45,,46.32,0,46.32,46.32,-1,-36695,59970,96665,23275,0,-3204,0,0,0,,3204,-3204
11,03/14/2018,8,1:45,2:00,,37.36,0,37.36,37.36,-1,-38710,57058,95768,18348,0,-3143,0,0,0,,3143,-3143
11,03/14/2018,9,2:00,2:15,,31.72,0,31.72,31.72,-1,-24747,82475,107222,57728,0,-2814,0,0,0,,2814,-2814
11,03/14/2018,10,2:15,2:30,,32.72,0,32.72,32.72,-1,-20162,42599,62761,22437,0,-3820,0,0,0,,3820,-3820
11,03/14/2018,11,2:30,2:45,,38.78,0,38.78,38.78,-1,-17644,35775,53419,18131,0,-3797,0,0,0,,3797,-3797
11,03/14/2018,12,2:45,3:00,,35.78,0,35.78,35.78,-1,-19229,40435,59664,21206,0,-3141,0,0,0,,3141,-3141
11,03/14/2018,13,3:00,3:15,,36.78,0,36.78,36.78,-1,-16219,74931,91150,58712,0,-2094,0,0,0,,2094,-2094
11,03/14/2018,14,3:15,3:30,,41.75,0,41.75,41.75,-1,-22055,55845,77900,33790,0,-1320,0,0,0,,1320,-1320
11,03/14/2018,15,3:30,3:45,,41.74,0,41.74,41.74,-1,-20943,57800,78743,36857,0,-3364,0,0,0,,3364,-3364
11,03/14/2018,16,3:45,4:00,,43.74,0,43.74,43.74,-1,-22239,57776,80015,35537,0,-2729,0,0,0,,2729,-2729
11,03/14/2018,17,4:00,4:15,,47.14,0,47.14,47.14,-1,-19434,60562,79996,41128,0,-2621,0,0,0,,2621,-2621
11,03/14/2018,18,4:15,4:30,,41.87,0,41.87,41.87,-1,-23004,63031,86035,40027,0,-2492,0,0,0,,2492,-2492
11,03/14/2018,19,4:30,4:45,,47.14,0,47.14,47.14,-1,-24772,61897,86669,37125,0,-1073,0,0,0,,1073,-1073
11,03/14/2018,20,4:45,5:00,,46.64,0,46.64,46.64,-1,-36198,73135,109333,36937,0,-2197,0,0,0,,2197,-2197
11,03/14/2018,21,5:00,5:15,,40.27,0,40.27,40.27,-1,-20684,78327,99011,57643,0,-3826,0,0,0,,3826,-3826
11,03/14/2018,22,5:15,5:30,,41.2,0,41.2,41.2,-1,-16642,75304,91946,58662,0,-2801,0,0,0,,2801,-2801
11,03/14/2018,23,5:30,5:45,,32.72,0,32.72,32.72,-1,-29207,51082,80289,21875,0,-4279,0,0,0,,4279,-4279
11,03/14/2018,24,5:45,6:00,47.5,32.72,0,47.5,47.5,1,-59678,51160,110838,-8518,0,-275,3526,0,0,,3801,3251
11,03/14/2018,25,6:00,6:15,47.5,-30.43,0,-30.43,-30.43,-1,-52384,158857,211241,106473,0,-18752,189,0,0,,18941,-18563
11,03/14/2018,26,6:15,6:30,,37.4,0,37.4,37.4,-1,-19530,85028,104558,65498,0,-10121,0,0,0,,10121,-10121
11,03/14/2018,27,6:30,6:45,,,0,40.53,40.53,0,-36738,48908,85646,12170,0,-681,0,0,0,,681,-681
11,03/14/2018,28,6:45,7:00,,43.4,0,43.4,43.4,-1,-64170,78492,142662,14322,0,-293,0,0,0,,293,-293
11,03/14/2018,29,7:00,7:15,,7.16,0,7.16,7.16,-1,-1940,140747,142687,138807,0,-15355,0,0,0,,15355,-15355
11,03/14/2018,30,7:15,7:30,,48.7,0,48.7,48.7,-1,-7547,58416,65963,50869,0,-3469,0,0,0,,3469,-3469
11,03/14/2018,31,7:30,7:45,,58.82,0,58.82,58.82,-1,-26450,31003,57453,4553,0,-683,0,0,0,,683,-683
11,03/14/2018,32,7:45,8:00,,44.73,0,44.73,44.73,-1,-83756,35719,119475,-48037,0,-837,0,0,0,,837,-837
11,03/14/2018,33,8:00,8:15,,36.74,0,36.74,36.74,-1,-18698,105172,123870,86474,0,-6073,0,0,0,,6073,-6073
11,03/14/2018,34,8:15,8:30,,44.53,0,44.53,44.53,-1,-39205,76809,116014,37604,0,-5027,0,0,0,,5027,-5027
11,03/14/2018,35,8:30,8:45,,41.78,0,41.78,41.78,-1,-57038,89161,146199,32123,0,-7538,0,0,0,,7538,-7538
11,03/14/2018,36,8:45,9:00,,41.78,0,41.78,41.78,-1,-76011,87425,163436,11414,0,-7142,0,0,0,,7142,-7142
11,03/14/2018,37,9:00,9:15,,37.39,0,37.39,37.39,-1,-55154,110958,166112,55804,0,-2419,0,0,0,,2419,-2419
11,03/14/2018,38,9:15,9:30,,26.05,0,26.05,26.05,-1,-71211,127235,198446,56024,0,-18367,0,0,0,,18367,-18367
11,03/14/2018,39,9:30,9:45,,-54.35,0,-54.35,-54.35,-1,-77611,158322,235933,80711,0,-45478,0,0,0,,45478,-45478
11,03/14/2018,40,9:45,10:00,,-50.78,0,-50.78,-50.78,-1,-87254,156622,243876,69368,0,-65411,0,0,0,,65411,-65411
11,03/14/2018,41,10:00,10:15,45.39,45.5,0,45.39,40.81,2,-106342,59745,166087,-46597,0,-13610,161,0,0,,13771,-13449
11,03/14/2018,42,10:15,10:30,,30.38,0,30.38,30.38,-1,-73969,124069,198038,50100,0,-16515,0,0,0,,16515,-16515
11,03/14/2018,43,10:30,10:45,,33.18,0,33.18,33.18,-1,-83348,161449,244797,78101,0,-34928,0,0,0,,34928,-34928
11,03/14/2018,44,10:45,11:00,,-6.61,0,-6.61,-6.61,-1,-74480,193722,268202,119242,0,-50696,0,0,0,,50696,-50696
11,03/14/2018,45,11:00,11:15,,41.39,0,41.39,41.39,-1,-106870,120913,227783,14043,0,-21079,0,0,0,,21079,-21079
11,03/14/2018,46,11:15,11:30,,29.61,0,29.61,29.61,-1,-75551,151035,226586,75484,0,-1287,0,0,0,,1287,-1287
11,03/14/2018,47,11:30,11:45,,39.39,0,39.39,39.39,-1,-79249,173611,252860,94362,0,-2837,0,0,0,,2837,-2837
11,03/14/2018,48,11:45,12:00,,-37.65,0,-37.65,-37.65,-1,-80448,190311,270759,109863,0,-17684,0,0,0,,17684,-17684
11,03/14/2018,49,12:00,12:15,,-36.82,0,-36.82,-36.82,-1,-89881,123669,213550,33788,0,-21876,0,0,0,,21876,-21876
11,03/14/2018,50,12:15,12:30,,-68.78,0,-68.78,-68.78,-1,-78344,160826,239170,82482,0,-30860,0,0,0,,30860,-30860
11,03/14/2018,51,12:30,12:45,,-63.78,0,-63.78,-63.78,-1,-98828,157631,256459,58803,0,-65244,0,0,0,,65244,-65244
11,03/14/2018,52,12:45,13:00,,21.5,0,21.5,21.5,-1,-101060,157554,258614,56494,0,-53381,0,0,0,,53381,-53381
11,03/14/2018,53,13:00,13:15,,32.03,0,32.03,32.03,-1,-87283,140667,227950,53384,0,-28998,0,0,0,,28998,-28998
11,03/14/2018,54,13:15,13:30,,19.26,0,19.26,19.26,-1,-78438,153867,232305,75429,0,-15435,0,0,0,,15435,-15435
11,03/14/2018,55,13:30,13:45,,39.39,0,39.39,39.39,-1,-97358,169649,267007,72291,0,-19374,0,0,0,,19374,-19374
11,03/14/2018,56,13:45,14:00,,-54.98,0,-54.98,-54.98,-1,-93583,173117,266700,79534,0,-48069,0,0,0,,48069,-48069
11,03/14/2018,57,14:00,14:15,,39.39,0,39.39,39.39,-1,-131023,188586,319609,57563,0,-21211,0,0,0,,21211,-21211
11,03/14/2018,58,14:15,14:30,,-7.25,0,-7.25,-7.25,-1,-95601,202907,298508,107306,0,-20436,0,0,0,,20436,-20436
11,03/14/2018,59,14:30,14:45,,-17.26,0,-17.26,-17.26,-1,-91075,175698,266773,84623,0,-39274,0,0,0,,39274,-39274
11,03/14/2018,60,14:45,15:00,,12.81,0,12.81,12.81,-1,-81284,177710,258994,96426,0,-48558,0,0,0,,48558,-48558
11,03/14/2018,61,15:00,15:15,,33.47,0,33.47,33.47,-1,-60788,198807,259595,138019,0,-46904,0,0,0,,46904,-46904
11,03/14/2018,62,15:15,15:30,,-37.6,0,-37.6,-37.6,-1,-59583,200122,259705,140539,0,-55672,0,0,0,,55672,-55672
11,03/14/2018,63,15:30,15:45,,21.99,0,21.99,21.99,-1,-66779,140565,207344,73786,0,-63664,0,0,0,,63664,-63664
11,03/14/2018,64,15:45,16:00,,-52.25,0,-52.25,-52.25,-1,-72098,156831,228929,84733,0,-52740,0,0,0,,52740,-52740
11,03/14/2018,65,16:00,16:15,,-35.78,0,-35.78,-35.78,-1,-60602,153462,214064,92860,0,-79214,0,0,0,,79214,-79214
11,03/14/2018,66,16:15,16:30,,25.44,0,25.44,25.44,-1,-65883,127361,193244,61478,0,-62755,0,0,0,,62755,-62755
11,03/14/2018,67,16:30,16:45,,37.39,0,37.39,37.39,-1,-60558,122126,182684,61568,0,-35859,0,0,0,,35859,-35859
11,03/14/2018,68,16:45,17:00,,39.39,0,39.39,39.39,-1,-73242,110191,183433,36949,0,-25927,0,0,0,,25927,-25927
11,03/14/2018,69,17:00,17:15,,41.39,0,41.39,41.39,-1,-66913,82892,149805,15979,0,-15115,0,0,0,,15115,-15115
11,03/14/2018,70,17:15,17:30,,45.55,0,45.55,45.55,-1,-61867,71038,132905,9171,0,-5567,0,0,0,,5567,-5567
11,03/14/2018,71,17:30,17:45,,48.54,0,48.54,48.54,-1,-75837,87704,163541,11867,0,-333,0,0,0,,333,-333
11,03/14/2018,72,17:45,18:00,,46.96,0,46.96,46.96,-1,-65427,100117,165544,34690,0,-1443,0,0,0,,1443,-1443
11,03/14/2018,73,18:00,18:15,,41.39,0,41.39,41.39,-1,-82008,80056,162064,-1952,0,-900,0,0,0,,900,-900
11,03/14/2018,74,18:15,18:30,,-4,0,-4,-4,-1,-53793,96281,150074,42488,0,-27139,0,0,0,,27139,-27139
11,03/14/2018,75,18:30,18:45,,42.66,0,42.66,42.66,-1,-34168,105704,139872,71536,0,-7951,0,0,0,,7951,-7951
11,03/14/2018,76,18:45,19:00,,15.36,0,15.36,15.36,-1,-53164,121566,174730,68402,0,-6180,0,0,0,,6180,-6180
11,03/14/2018,77,19:00,19:15,,37.39,0,37.39,37.39,-1,-58660,103657,162317,44997,0,-5261,0,0,0,,5261,-5261
11,03/14/2018,78,19:15,19:30,,-6.61,0,-6.61,-6.61,-1,-45268,99119,144387,53851,0,-14031,0,0,0,,14031,-14031
11,03/14/2018,79,19:30,19:45,,-55.78,0,-55.78,-55.78,-1,-48360,97983,146343,49623,0,-50782,0,0,0,,50782,-50782
11,03/14/2018,80,19:45,20:00,,-7.05,0,-7.05,-7.05,-1,-36382,103087,139469,66705,0,-45875,0,0,0,,45875,-45875
11,03/14/2018,81,20:00,20:15,33.12,41.39,0,33.12,33.12,1,-71404,38623,110027,-32781,0,-16868,8,0,0,,16876,-16860
11,03/14/2018,82,20:15,20:30,33.12,26.49,0,26.49,26.49,-1,-46433,88291,134724,41858,0,-1513,29,0,0,,1542,-1484
11,03/14/2018,83,20:30,20:45,,7.78,0,7.78,7.78,-1,-38277,101495,139772,63218,0,-10606,0,0,0,,10606,-10606
11,03/14/2018,84,20:45,21:00,,-40.94,0,-40.94,-40.94,-1,-43190,111035,154225,67845,0,-52829,0,0,0,,52829,-52829
11,03/14/2018,85,21:00,21:15,48.98,39.39,0,48.98,48.98,1,-80852,84693,165545,3841,0,-15591,283,0,0,,15874,-15308
11,03/14/2018,86,21:15,21:30,51.39,39.39,0,51.39,51.39,1,-79146,69081,148227,-10065,0,-55,8325,0,0,,8380,8270
11,03/14/2018,87,21:30,21:45,51.39,42.9,0,42.9,42.9,-1,-64878,83786,148664,18908,0,-445,627,0,0,,1072,182
11,03/14/2018,88,21:45,22:00,,41.39,0,41.39,41.39,-1,-75282,110050,185332,34768,0,-9822,0,0,0,,9822,-9822
11,03/14/2018,89,22:00,22:15,67.39,47.99,0,67.39,40.56,2,-135945,31699,167644,-104246,0,-2855,8474,0,0,,11329,5619
11,03/14/2018,90,22:15,22:30,46.96,,0,46.96,46.96,1,-106589,48276,154865,-58313,0,0,7573,0,0,,7573,7573
11,03/14/2018,91,22:30,22:45,,44.78,0,44.78,44.78,-1,-74741,84549,159290,9808,0,-60,0,0,0,,60,-60
11,03/14/2018,92,22:45,23:00,,12.12,0,12.12,12.12,-1,-53153,129330,182483,76177,0,-8356,0,0,0,,8356,-8356
11,03/14/2018,93,23:00,23:15,49.39,-46.56,0,49.39,-46.56,2,-70814,80353,151167,9539,0,-16830,389,0,0,,17219,-16441
11,03/14/2018,94,23:15,23:30,,2.78,0,2.78,2.78,-1,-67266,104238,171504,36972,0,-16890,0,0,0,,16890,-16890
11,03/14/2018,95,23:30,23:45,,-16.94,0,-16.94,-16.94,-1,-53299,102707,156006,49408,0,-43638,0,0,0,,43638,-43638
11,03/14/2018,96,23:45,0:00,,-104.78,0,-104.78,-104.78,-1,-40435,150812,191247,110377,0,-47588,0,0,0,,47588,-47588
11,03/15/2018,1,0:00,0:15,,3.03,0,3.03,3.03,-1,-61881,114500,176381,52619,0,-30692,0,0,0,,30692,-30692
11,03/15/2018,2,0:15,0:30,,3.13,0,3.13,3.13,-1,-48104,90982,139086,42878,0,-32337,0,0,0,,32337,-32337
11,03/15/2018,3,0:30,0:45,,-7.61,0,-7.61,-7.61,-1,-40645,102280,142925,61635,0,-41750,0,0,0,,41750,-41750
11,03/15/2018,4,0:45,1:00,,-24.64,0,-24.64,-24.64,-1,-43380,94082,137462,50702,0,-45933,0,0,0,,45933,-45933
11,03/15/2018,5,1:00,1:15,,30.03,0,30.03,30.03,-1,-71579,99018,170597,27439,0,-14192,0,0,0,,14192,-14192
11,03/15/2018,6,1:15,1:30,,13.03,0,13.03,13.03,-1,-53210,68953,122163,15743,0,-6659,0,0,0,,6659,-6659
11,03/15/2018,7,1:30,1:45,,32.61,0,32.61,32.61,-1,-45056,51949,97005,6893,0,-9931,0,0,0,,9931,-9931
11,03/15/2018,8,1:45,2:00,,-5.92,0,-5.92,-5.92,-1,-46578,75370,121948,28792,0,-21721,0,0,0,,21721,-21721
11,03/15/2018,9,2:00,2:15,,28.42,0,28.42,28.42,-1,-47544,73921,121465,26377,0,-22354,0,0,0,,22354,-22354
11,03/15/2018,10,2:15,2:30,,32.61,0,32.61,32.61,-1,-40857,49579,90436,8722,0,-14462,0,0,0,,14462,-14462
11,03/15/2018,11,2:30,2:45,,28.42,0,28.42,28.42,-1,-42278,42733,85011,455,0,-2809,0,0,0,,2809,-2809
11,03/15/2018,12,2:45,3:00,,28.42,0,28.42,28.42,-1,-42222,65032,107254,22810,0,-15511,0,0,0,,15511,-15511
11,03/15/2018,13,3:00,3:15,,18.03,0,18.03,18.03,-1,-19608,68894,88502,49286,0,-14560,0,0,0,,14560,-14560
11,03/15/2018,14,3:15,3:30,,-22.29,0,-22.29,-22.29,-1,-24771,46012,70783,21241,0,-29161,0,0,0,,29161,-29161
11,03/15/2018,15,3:30,3:45,,-8.76,0,-8.76,-8.76,-1,-24950,58447,83397,33497,0,-25372,0,0,0,,25372,-25372
11,03/15/2018,16,3:45,4:00,,24.06,0,24.06,24.06,-1,-28985,71063,100048,42078,0,-29601,0,0,0,,29601,-29601
11,03/15/2018,17,4:00,4:15,,22.1,0,22.1,22.1,-1,-44552,62564,107116,18012,0,-19407,0,0,0,,19407,-19407
11,03/15/2018,18,4:15,4:30,,5.79,0,5.79,5.79,-1,-29620,72780,102400,43160,0,-7198,0,0,0,,7198,-7198
11,03/15/2018,19,4:30,4:45,,-5.03,0,-5.03,-5.03,-1,-19936,73796,93732,53860,0,-39690,0,0,0,,39690,-39690
11,03/15/2018,20,4:45,5:00,,-37.9,0,-37.9,-37.9,-1,-36400,109140,145540,72740,0,-49582,0,0,0,,49582,-49582
11,03/15/2018,21,5:00,5:15,,-8.21,0,-8.21,-8.21,-1,-40866,93359,134225,52493,0,-33189,0,0,0,,33189,-33189
11,03/15/2018,22,5:15,5:30,,28.35,0,28.35,28.35,-1,-40874,101047,141921,60173,0,-8907,0,0,0,,8907,-8907
11,03/15/2018,23,5:30,5:45,,,0,35.16,35.16,0,-52527,87762,140289,35235,0,0,0,0,0,,0,0
11,03/15/2018,24,5:45,6:00,,41.23,0,41.23,41.23,-1,-62837,116740,179577,53903,0,-489,0,0,0,,489,-489
11,03/15/2018,25,6:00,6:15,,41.78,0,41.78,41.78,-1,-81422,120006,201428,38584,0,-1045,0,0,0,,1045,-1045
11,03/15/2018,26,6:15,6:30,,-19.26,0,-19.26,-19.26,-1,-39552,82421,121973,42869,0,-19458,0,0,0,,19458,-19458
11,03/15/2018,27,6:30,6:45,,41.78,0,41.78,41.78,-1,-38335,82046,120381,43711,0,-5745,0,0,0,,5745,-5745
11,03/15/2018,28,6:45,7:00,,45.39,0,45.39,45.39,-1,-39832,150430,190262,110598,0,-2478,0,0,0,,2478,-2478
11,03/15/2018,29,7:00,7:15,,-52.34,0,-52.34,-52.34,-1,-70993,132452,203445,61459,0,-23123,0,0,0,,23123,-23123
11,03/15/2018,30,7:15,7:30,,41.15,0,41.15,41.15,-1,-11441,88839,100280,77398,0,-6204,0,0,0,,6204,-6204
11,03/15/2018,31,7:30,7:45,,46.78,0,46.78,46.78,-1,-14543,84453,98996,69910,0,-1493,0,0,0,,1493,-1493
11,03/15/2018,32,7:45,8:00,,46.18,0,46.18,46.18,-1,-40203,62586,102789,22383,0,-1625,0,0,0,,1625,-1625
11,03/15/2018,33,8:00,8:15,,-71.29,0,-71.29,-71.29,-1,-15205,83539,98744,68334,0,-29215,0,0,0,,29215,-29215
11,03/15/2018,34,8:15,8:30,,11.03,0,11.03,11.03,-1,-24748,78103,102851,53355,0,-45732,0,0,0,,45732,-45732
11,03/15/2018,35,8:30,8:45,,31.22,0,31.22,31.22,-1,-24240,64837,89077,40597,0,-40872,0,0,0,,40872,-40872
11,03/15/2018,36,8:45,9:00,,37.45,0,37.45,37.45,-1,-19913,56211,76124,36298,0,-34358,0,0,0,,34358,-34358
11,03/15/2018,37,9:00,9:15,,23.45,0,23.45,23.45,-1,-31229,74577,105806,43348,0,-22633,0,0,0,,22633,-22633
11,03/15/2018,38,9:15,9:30,,-3.93,0,-3.93,-3.93,-1,-40515,66379,106894,25864,0,-26200,0,0,0,,26200,-26200
11,03/15/2018,39,9:30,9:45,,-28.45,0,-28.45,-28.45,-1,-19660,81669,101329,62009,0,-29505,0,0,0,,29505,-29505
11,03/15/2018,40,9:45,10:00,,-8.19,0,-8.19,-8.19,-1,-42981,114699,157680,71718,0,-54516,0,0,0,,54516,-54516
11,03/15/2018,41,10:00,10:15,,17.78,0,17.78,17.78,-1,-78263,87517,165780,9254,0,-30747,0,0,0,,30747,-30747
11,03/15/2018,42,10:15,10:30,,20.95,0,20.95,20.95,-1,-54921,85407,140328,30486,0,-29486,0,0,0,,29486,-29486
11,03/15/2018,43,10:30,10:45,,40.81,0,40.81,40.81,-1,-58833,83844,142677,25011,0,-17838,0,0,0,,17838,-17838
11,03/15/2018,44,10:45,11:00,,40.81,0,40.81,40.81,-1,-55018,98786,153804,43768,0,-10206,0,0,0,,10206,-10206
11,03/15/2018,45,11:00,11:15,,40.81,0,40.81,40.81,-1,-49291,75788,125079,26497,0,-5495,0,0,0,,5495,-5495
11,03/15/2018,46,11:15,11:30,,40.57,0,40.57,40.57,-1,-42575,78243,120818,35668,0,-994,0,0,0,,994,-994
11,03/15/2018,47,11:30,11:45,,19.96,0,19.96,19.96,-1,-44309,58707,103016,14398,0,-16572,0,0,0,,16572,-16572
11,03/15/2018,48,11:45,12:00,46.43,46.26,0,46.43,45.36,2,-43599,54064,97663,10465,0,-827,310,0,0,,1137,-517
11,03/15/2018,49,12:00,12:15,43.81,41.81,0,45.18,41.81,2,-48715,46290,95005,-2425,0,-1640,38,0,0,,1678,-1602
11,03/15/2018,50,12:15,12:30,48.78,41.81,0,48.78,48.78,1,-68016,43295,111311,-24721,0,-3,8796,0,0,,8799,8793
11,03/15/2018,51,12:30,12:45,58.79,,0,58.79,58.79,1,-80328,44328,124656,-36000,0,0,17101,0,0,,17101,17101
11,03/15/2018,52,12:45,13:00,62.12,,0,62.12,62.12,1,-85275,49923,135198,-35352,0,0,30459,0,0,,30459,30459
11,03/15/2018,53,13:00,13:15,47.85,,0,47.85,47.85,1,-71787,58851,130638,-12936,0,0,13809,0,0,,13809,13809
11,03/15/2018,54,13:15,13:30,64.4,,0,64.4,64.4,1,-92076,45285,137361,-46791,0,0,13750,0,0,,13750,13750
11,03/15/2018,55,13:30,13:45,83.4,,0,83.4,83.4,1,-97859,48860,146719,-48999,0,0,30095,0,0,,30095,30095
11,03/15/2018,56,13:45,14:00,252.22,,0,252.22,252.22,1,-126628,50977,177605,-75651,0,0,49361,0,0,,49361,49361
11,03/15/2018,57,14:00,14:15,43.81,,0,43.81,43.81,1,-70557,75596,146153,5039,0,0,24748,0,0,,24748,24748
11,03/15/2018,58,14:15,14:30,107.17,,0,107.17,107.17,1,-105645,44286,149931,-61359,0,0,22239,0,0,,22239,22239
11,03/15/2018,59,14:30,14:45,252.22,,0,252.22,252.22,1,-117384,28534,145918,-88850,0,0,48953,0,0,,48953,48953
11,03/15/2018,60,14:45,15:00,252.22,,0,252.22,252.22,1,-149673,41070,190743,-108603,0,0,77882,0,0,,77882,77882
11,03/15/2018,61,15:00,15:15,153.02,,0,153.02,153.02,1,-71497,62102,133599,-9395,0,0,38248,0,0,,38248,38248
11,03/15/2018,62,15:15,15:30,46.19,45.28,0,46.19,45.07,2,-60316,52025,112341,-8291,0,-593,168,0,0,,761,-425
11,03/15/2018,63,15:30,15:45,112.02,,0,112.02,112.02,1,-95654,40937,136591,-54717,0,0,20378,0,0,,20378,20378
11,03/15/2018,64,15:45,16:00,252.02,,0,277.22,277.22,1,-313378,44916,358294,-268462,0,0,76045,0,35084,,111129,111129
11,03/15/2018,65,16:00,16:15,366.58,,0,403.24,403.24,1,-221209,99053,320262,-122156,0,0,63855,18750,60252,,142857,142857
11,03/15/2018,66,16:15,16:30,266.58,,0,293.24,293.24,1,-148638,58863,207501,-89775,0,0,18092,17500,30000,,65592,65592
11,03/15/2018,67,16:30,16:45,366.58,,0,366.58,366.58,1,-151491,64143,215634,-87348,0,0,37760,18750,0,,56510,56510
11,03/15/2018,68,16:45,17:00,366.58,,0,366.58,366.58,1,-172977,64931,237908,-108046,0,0,45532,18750,0,,64282,64282
11,03/15/2018,69,17:00,17:15,90.61,42.22,0,42.22,42.22,-1,-59913,68836,128749,8923,0,-459,33903,6250,0,,40612,39694
11,03/15/2018,70,17:15,17:30,256.02,40.81,0,256.02,40.43,2,-107013,60977,167990,-46036,0,-238,15646,0,0,,15884,15408
11,03/15/2018,71,17:30,17:45,56.02,,0,56.02,56.02,1,-98806,71700,170506,-27106,0,0,30480,0,0,,30480,30480
11,03/15/2018,72,17:45,18:00,61.56,,0,61.56,61.56,1,-109490,79453,188943,-30037,0,0,29787,0,0,,29787,29787
11,03/15/2018,73,18:00,18:15,61.56,-46.45,0,-46.45,-46.45,-1,-63264,107948,171212,44684,0,-14383,9496,0,0,,23879,-4887
11,03/15/2018,74,18:15,18:30,,35.16,0,35.16,35.16,-1,-63459,88489,151948,25030,0,-11953,0,0,0,,11953,-11953
11,03/15/2018,75,18:30,18:45,,39.03,0,39.03,39.03,-1,-52282,77418,129700,25136,0,-22343,0,0,0,,22343,-22343
11,03/15/2018,76,18:45,19:00,47.85,39.03,0,47.85,47.85,1,-66234,55099,121333,-11135,0,-5302,969,0,0,,6271,-4333
11,03/15/2018,77,19:00,19:15,124.02,,0,124.02,124.02,1,-96740,40694,137434,-56046,0,0,21024,0,0,,21024,21024
11,03/15/2018,78,19:15,19:30,53.22,,0,53.22,53.22,1,-76439,39135,115574,-37304,0,0,23156,0,0,,23156,23156
11,03/15/2018,79,19:30,19:45,53.22,40.81,0,40.81,40.81,-1,-58612,46914,105526,-11698,0,-2236,976,0,0,,3212,-1260
11,03/15/2018,80,19:45,20:00,,40.25,0,40.25,40.25,-1,-46081,68260,114341,22179,0,-10297,0,0,0,,10297,-10297
11,03/15/2018,81,20:00,20:15,,40.03,0,40.03,40.03,-1,-33188,87982,121170,54794,0,-15258,0,0,0,,15258,-15258
11,03/15/2018,82,20:15,20:30,,-33.5,0,-33.5,-33.5,-1,-17912,103193,121105,85281,0,-21752,0,0,0,,21752,-21752
11,03/15/2018,83,20:30,20:45,,-8.19,0,-8.19,-8.19,-1,-30919,107662,138581,76743,0,-17097,0,0,0,,17097,-17097
11,03/15/2018,84,20:45,21:00,,-76,0,-76,-76,-1,-46084,107752,153836,61668,0,-38769,0,0,0,,38769,-38769
11,03/15/2018,85,21:00,21:15,,40.81,0,40.81,40.81,-1,-39395,57744,97139,18349,0,-20957,0,0,0,,20957,-20957
11,03/15/2018,86,21:15,21:30,,27.24,0,27.24,27.24,-1,-24795,67041,91836,42246,0,-31158,0,0,0,,31158,-31158
11,03/15/2018,87,21:30,21:45,,37.85,0,37.85,37.85,-1,-36971,77832,114803,40861,0,-38532,0,0,0,,38532,-38532
11,03/15/2018,88,21:45,22:00,,32.36,0,32.36,32.36,-1,-49571,97522,147093,47951,0,-45873,0,0,0,,45873,-45873
11,03/15/2018,89,22:00,22:15,237.02,32.36,0,237.02,237.02,1,-91071,30218,121289,-60853,0,-18495,10561,0,0,,29056,-7934
11,03/15/2018,90,22:15,22:30,54.05,41.78,0,41.78,41.78,-1,-64427,53853,118280,-10574,0,-160,14573,0,0,,14733,14413
11,03/15/2018,91,22:30,22:45,54.05,41.78,0,41.78,41.78,-1,-47418,45935,93353,-1483,0,-1430,113,0,0,,1543,-1317
11,03/15/2018,92,22:45,23:00,,30.03,0,30.03,30.03,-1,-45396,75381,120777,29985,0,-19809,0,0,0,,19809,-19809
11,03/15/2018,93,23:00,23:15,237.02,41.78,0,237.02,237.02,1,-120280,38776,159056,-81504,0,-7363,19335,0,0,,26698,11972
11,03/15/2018,94,23:15,23:30,222.02,,0,222.02,222.02,1,-90229,61728,151957,-28501,0,0,46802,0,0,,46802,46802
11,03/15/2018,95,23:30,23:45,222.02,41.78,0,41.78,41.78,-1,-54830,57880,112710,3050,0,-793,693,0,0,,1486,-100
11,03/15/2018,96,23:45,0:00,,11.84,0,11.84,11.84,-1,-33378,76200,109578,42822,0,-32850,0,0,0,,32850,-32850
11,03/16/2018,1,0:00,0:15,238.12,11.84,0,238.12,238.12,1,-191639,101793,293432,-89846,0,-12762,19985,0,0,,32747,7223
11,03/16/2018,2,0:15,0:30,62.66,,0,62.66,62.66,1,-50247,2563,52810,-47684,0,0,39637,0,0,,39637,39637
11,03/16/2018,3,0:30,0:45,48.07,,0,48.07,48.07,1,-46127,29968,76095,-16159,0,0,19237,0,0,,19237,19237
11,03/16/2018,4,0:45,1:00,48.07,37.25,0,37.25,37.25,-1,-59493,52170,111663,-7323,0,-378,26,0,0,,404,-352
11,03/16/2018,5,1:00,1:15,160.12,,0,160.12,160.12,1,-109256,44982,154238,-64274,0,0,17382,0,0,,17382,17382
11,03/16/2018,6,1:15,1:30,160.12,,0,160.12,160.12,1,-92806,39944,132750,-52862,0,0,53434,0,0,,53434,53434
11,03/16/2018,7,1:30,1:45,47.92,,0,47.92,47.92,1,-80338,45161,125499,-35177,0,0,31200,0,0,,31200,31200
11,03/16/2018,8,1:45,2:00,46.8,,0,46.8,46.8,1,-82170,52149,134319,-30021,0,0,25714,0,0,,25714,25714
11,03/16/2018,9,2:00,2:15,46.8,39.78,0,39.78,39.78,-1,-39186,40595,79781,1409,0,-892,8740,0,0,,9632,7848
11,03/16/2018,10,2:15,2:30,44.11,,0,44.11,44.11,1,-65210,46685,111895,-18525,0,0,6400,0,0,,6400,6400
11,03/16/2018,11,2:30,2:45,39.01,,0,39.01,39.01,1,-66455,52711,119166,-13744,0,0,5939,0,0,,5939,5939
11,03/16/2018,12,2:45,3:00,39.01,,0,39.01,39.01,1,-73690,58148,131838,-15542,0,0,4838,0,0,,4838,4838
11,03/16/2018,13,3:00,3:15,45.9,43.73,0,45.9,37.87,2,-76421,64909,141330,-11512,0,-28,2025,0,0,,2053,1997
11,03/16/2018,14,3:15,3:30,53.2,,0,53.2,53.2,1,-95886,69764,165650,-26122,0,0,18806,0,0,,18806,18806
11,03/16/2018,15,3:30,3:45,44.09,,0,44.09,44.09,1,-95889,68999,164888,-26890,0,0,19722,0,0,,19722,19722
11,03/16/2018,16,3:45,4:00,43.01,,0,43.01,43.01,1,-93747,64540,158287,-29207,0,0,21037,0,0,,21037,21037
11,03/16/2018,17,4:00,4:15,43.01,38.4,0,38.4,38.4,-1,-70148,74080,144228,3932,0,-514,10963,0,0,,11477,10449
11,03/16/2018,18,4:15,4:30,43.01,43.69,0,43.69,43.69,-1,-41575,59996,101571,18421,0,-170,71,0,0,,241,-99
11,03/16/2018,19,4:30,4:45,53.09,,0,53.09,53.09,1,-69150,45784,114934,-23366,0,0,8360,0,0,,8360,8360
11,03/16/2018,20,4:45,5:00,48.29,,0,48.29,48.29,1,-71748,39342,111090,-32406,0,0,20607,0,0,,20607,20607
11,03/16/2018,21,5:00,5:15,43.01,42.28,0,42.28,42.28,-1,-53868,50852,104720,-3016,0,-88,12344,0,0,,12432,12256
11,03/16/2018,22,5:15,5:30,53.46,42.1,0,53.46,38.09,2,-50969,23412,74381,-27557,0,-183,5031,0,0,,5214,4848
11,03/16/2018,23,5:30,5:45,81.93,,0,81.93,81.93,1,-73225,14543,87768,-58682,0,0,41778,0,0,,41778,41778
11,03/16/2018,24,5:45,6:00,78.67,39.82,0,78.67,38.09,2,-67812,68333,136145,521,0,-52,39821,0,0,,39873,39769
11,03/16/2018,25,6:00,6:15,44.79,30.74,0,44.79,30.74,2,-71810,83058,154868,11248,0,-7593,1730,0,0,,9323,-5863
11,03/16/2018,26,6:15,6:30,51.07,30.74,0,51.07,51.07,1,-64339,50529,114868,-13810,0,-60,6498,0,0,,6558,6438
11,03/16/2018,27,6:30,6:45,285.12,,0,285.12,285.12,1,-114964,49143,164107,-65821,0,0,34107,0,0,,34107,34107
11,03/16/2018,28,6:45,7:00,93.45,,0,93.45,93.45,1,-129674,81558,211232,-48116,0,0,53409,0,0,,53409,53409
11,03/16/2018,29,7:00,7:15,50.98,-15.12,0,50.98,-15.12,2,-51882,77038,128920,25156,0,-9070,15766,0,0,,24836,6696
11,03/16/2018,30,7:15,7:30,350.12,-15.12,0,350.12,350.12,1,-116198,29013,145211,-87185,0,-55,50803,0,0,,50858,50748
11,03/16/2018,31,7:30,7:45,350.12,,0,350.12,350.12,1,-156806,33468,190274,-123338,0,0,85807,0,0,,85807,85807
11,03/16/2018,32,7:45,8:00,350.12,,0,350.12,350.12,1,-211217,31539,242756,-179678,0,0,94172,0,0,,94172,94172
11,03/16/2018,33,8:00,8:15,350.12,,0,350.12,350.12,1,-109887,82636,192523,-27251,0,0,57282,0,0,,57282,57282
11,03/16/2018,34,8:15,8:30,350.12,,0,350.12,350.12,1,-129733,61593,191326,-68140,0,0,42153,0,0,,42153,42153
11,03/16/2018,35,8:30,8:45,350.12,,0,350.12,350.12,1,-147180,64360,211540,-82820,0,0,67406,0,0,,67406,67406
11,03/16/2018,36,8:45,9:00,350.12,,0,350.12,350.12,1,-174695,60589,235284,-114106,0,0,88483,0,0,,88483,88483
11,03/16/2018,37,9:00,9:15,268.12,,0,268.12,268.12,1,-96245,48034,144279,-48211,0,0,69317,1250,0,,70567,70567
11,03/16/2018,38,9:15,9:30,92.14,,0,92.14,92.14,1,-94010,52942,146952,-41068,0,0,29648,0,0,,29648,29648
11,03/16/2018,39,9:30,9:45,92.14,,0,92.14,92.14,1,-97358,55936,153294,-41422,0,0,40037,0,0,,40037,40037
11,03/16/2018,40,9:45,10:00,50.79,,0,50.79,50.79,1,-96463,60388,156851,-36075,0,0,30841,0,0,,30841,30841
11,03/16/2018,41,10:00,10:15,47.42,37.06,0,47.42,37.06,2,-92720,110637,203357,17917,0,-1949,12104,0,0,,14053,10155
11,03/16/2018,42,10:15,10:30,,44,0,44,44,-1,-105853,101717,207570,-4136,0,-382,0,0,0,,382,-382
11,03/16/2018,43,10:30,10:45,42.13,,0,42.13,42.13,1,-104954,96461,201415,-8493,0,0,256,0,0,,256,256
11,03/16/2018,44,10:45,11:00,45.45,,0,45.45,45.45,1,-109001,95687,204688,-13314,0,0,2187,0,0,,2187,2187
11,03/16/2018,45,11:00,11:15,268.12,,0,268.12,268.12,1,-117113,34708,151821,-82405,0,0,28852,0,0,,28852,28852
11,03/16/2018,46,11:15,11:30,52.19,,0,52.19,52.19,1,-93567,48987,142554,-44580,0,0,25200,0,0,,25200,25200
11,03/16/2018,47,11:30,11:45,53.12,,0,53.12,53.12,1,-111752,46175,157927,-65577,0,0,6117,0,0,,6117,6117
11,03/16/2018,48,11:45,12:00,87.12,,0,87.12,87.12,1,-117470,46774,164244,-70696,0,0,34033,0,0,,34033,34033
11,03/16/2018,49,12:00,12:15,252.12,,0,252.12,252.12,1,-140724,31623,172347,-109101,0,0,56699,0,0,,56699,56699
11,03/16/2018,50,12:15,12:30,144.12,,0,144.12,144.12,1,-126628,43683,170311,-82945,0,0,61514,0,0,,61514,61514
11,03/16/2018,51,12:30,12:45,196.12,,0,196.12,196.12,1,-109109,46030,155139,-63079,0,0,39103,0,0,,39103,39103
11,03/16/2018,52,12:45,13:00,82.12,,0,82.12,82.12,1,-101199,55668,156867,-45531,0,0,35427,0,0,,35427,35427
11,03/16/2018,53,13:00,13:15,77.12,,0,77.12,77.12,1,-117036,85921,202957,-31115,0,0,8109,0,0,,8109,8109
11,03/16/2018,54,13:15,13:30,81.88,,0,81.88,81.88,1,-125601,89381,214982,-36220,0,0,17979,0,0,,17979,17979
11,03/16/2018,55,13:30,13:45,116.07,,0,116.07,116.07,1,-162036,72590,234626,-89446,0,0,11970,0,0,,11970,11970
11,03/16/2018,56,13:45,14:00,48.33,,0,48.33,48.33,1,-187537,73177,260714,-114360,0,0,21082,0,0,,21082,21082
11,03/16/2018,57,14:00,14:15,252.12,,0,252.12,252.12,1,-167664,75879,243543,-91785,0,0,41193,0,0,,41193,41193
11,03/16/2018,58,14:15,14:30,252.12,,0,252.12,252.12,1,-138647,80480,219127,-58167,0,0,58639,0,0,,58639,58639
11,03/16/2018,59,14:30,14:45,,,0,44.04,44.04,0,-117169,89476,206645,-27693,0,0,3688,0,0,,3688,3688
11,03/16/2018,60,14:45,15:00,,35.66,0,35.66,35.66,-1,-105385,86642,192027,-18743,0,-153,0,0,0,,153,-153
11,03/16/2018,61,15:00,15:15,,34.13,0,34.13,34.13,-1,-102478,125267,227745,22789,0,-1495,0,0,0,,1495,-1495
11,03/16/2018,62,15:15,15:30,,39.78,0,39.78,39.78,-1,-91088,114699,205787,23611,0,-4327,0,0,0,,4327,-4327
11,03/16/2018,63,15:30,15:45,,45.59,0,45.59,45.59,-1,-82890,105047,187937,22157,0,-2714,0,0,0,,2714,-2714
11,03/16/2018,64,15:45,16:00,,45.56,0,45.56,45.56,-1,-72081,107931,180012,35850,0,-2094,0,0,0,,2094,-2094
11,03/16/2018,65,16:00,16:15,51.94,45.97,0,51.94,44.05,2,-104808,74427,179235,-30381,0,-618,6408,0,0,,7026,5790
11,03/16/2018,66,16:15,16:30,46.13,,0,46.13,46.13,1,-86494,70014,156508,-16480,0,0,8681,0,0,,8681,8681
11,03/16/2018,67,16:30,16:45,42.13,,0,42.13,42.13,1,-76773,79148,155921,2375,0,0,2268,0,0,,2268,2268
11,03/16/2018,68,16:45,17:00,50.98,,0,50.98,50.98,1,-87764,74129,161893,-13635,0,0,2230,0,0,,2230,2230
11,03/16/2018,69,17:00,17:15,72.12,,0,72.12,72.12,1,-104755,47440,152195,-57315,0,0,10222,0,0,,10222,10222
11,03/16/2018,70,17:15,17:30,49.69,,0,49.69,49.69,1,-97319,39417,136736,-57902,0,0,1403,0,0,,1403,1403
11,03/16/2018,71,17:30,17:45,50.98,,0,50.98,50.98,1,-96994,50654,147648,-46340,0,0,4455,0,0,,4455,4455
11,03/16/2018,72,17:45,18:00,62.02,,0,62.02,62.02,1,-97135,66969,164104,-30166,0,0,22045,0,0,,22045,22045
11,03/16/2018,73,18:00,18:15,81.66,,0,81.66,81.66,1,-109496,25927,135423,-83569,0,0,19977,0,0,,19977,19977
11,03/16/2018,74,18:15,18:30,46.51,,0,46.51,46.51,1,-73470,54423,127893,-19047,0,0,1778,0,0,,1778,1778
11,03/16/2018,75,18:30,18:45,50.98,,0,50.98,50.98,1,-84330,59146,143476,-25184,0,0,15727,0,0,,15727,15727
11,03/16/2018,76,18:45,19:00,252.12,,0,252.12,252.12,1,-94794,49191,143985,-45603,0,0,22084,0,0,,22084,22084
11,03/16/2018,77,19:00,19:15,252.12,41.49,0,252.12,41.49,2,-98248,57275,155523,-40973,0,-9,24400,0,0,,24409,24391
11,03/16/2018,78,19:15,19:30,49.55,42.09,0,49.55,42.09,2,-82687,55317,138004,-27370,0,-195,2849,0,0,,3044,2654
11,03/16/2018,79,19:30,19:45,60.12,,0,60.12,60.12,1,-95553,72316,167869,-23237,0,0,16039,0,0,,16039,16039
11,03/16/2018,80,19:45,20:00,60.12,-116.1,0,-116.1,-116.1,-1,-91816,60984,152800,-30832,0,-22186,3036,0,0,,25222,-19150
11,03/16/2018,81,20:00,20:15,42.13,38.29,0,42.13,38.2,2,-170369,30478,200847,-139891,0,-4331,424,0,0,,4755,-3907
11,03/16/2018,82,20:15,20:30,50.98,,0,50.98,50.98,1,-119069,46963,166032,-72106,0,0,3785,0,0,,3785,3785
11,03/16/2018,83,20:30,20:45,47.64,39.78,0,47.64,38.05,2,-79386,60078,139464,-19308,0,-134,4838,0,0,,4972,4704
11,03/16/2018,84,20:45,21:00,47.64,39.45,0,39.45,39.45,-1,-88180,88189,176369,9,0,-7314,62,0,0,,7376,-7252
11,03/16/2018,85,21:00,21:15,163.12,33.49,0,163.12,33.49,2,-97082,55319,152401,-41763,0,-4142,7684,0,0,,11826,3542
11,03/16/2018,86,21:15,21:30,46.52,40.73,0,40.73,40.73,-1,-80114,72505,152619,-7609,0,-192,8726,0,0,,8918,8534
11,03/16/2018,87,21:30,21:45,,39.78,0,39.78,39.78,-1,-57943,57966,115909,23,0,-1512,0,0,0,,1512,-1512
11,03/16/2018,88,21:45,22:00,51.07,39.78,0,51.07,51.07,1,-118322,70919,189241,-47403,0,-58,1186,0,0,,1244,1128
11,03/16/2018,89,22:00,22:15,239.12,,0,239.12,239.12,1,-106675,29691,136366,-76984,0,0,46512,0,0,,46512,46512
11,03/16/2018,90,22:15,22:30,62.26,,0,62.26,62.26,1,-67856,57444,125300,-10412,0,0,40627,0,0,,40627,40627
11,03/16/2018,91,22:30,22:45,48.12,39.78,0,48.12,38.97,2,-71415,59607,131022,-11808,0,-761,3798,0,0,,4559,3037
11,03/16/2018,92,22:45,23:00,49.15,,0,49.15,49.15,1,-70529,76726,147255,6197,0,0,6445,0,0,,6445,6445
11,03/16/2018,93,23:00,23:15,,,0,38.86,38.86,0,-84366,80475,164841,-3891,0,0,0,0,0,,0,0
11,03/16/2018,94,23:15,23:30,,,0,38.87,38.87,0,-94934,63557,158491,-31377,0,0,0,0,0,,0,0
11,03/16/2018,95,23:30,23:45,,42.78,0,42.78,42.78,-1,-65354,70550,135904,5196,0,-56,0,0,0,,56,-56
11,03/16/2018,96,23:45,0:00,,40.71,0,40.71,40.71,-1,-49618,95271,144889,45653,0,-1158,0,0,0,,1158,-1158
12,03/17/2018,1,0:00,0:15,,22.41,0,22.41,22.41,-1,-51293,99339,150632,48046,0,-5843,0,0,0,,5843,-5843
12,03/17/2018,2,0:15,0:30,,17.04,0,17.04,17.04,-1,-39145,69512,108657,30367,0,-10684,0,0,0,,10684,-10684
12,03/17/2018,3,0:30,0:45,,22.41,0,22.41,22.41,-1,-59840,74833,134673,14993,0,-24345,0,0,0,,24345,-24345
12,03/17/2018,4,0:45,1:00,,22.15,0,22.15,22.15,-1,-72098,91797,163895,19699,0,-35261,0,0,0,,35261,-35261
12,03/17/2018,5,1:00,1:15,,22.41,0,22.41,22.41,-1,-72794,53240,126034,-19554,0,-25333,0,0,0,,25333,-25333
12,03/17/2018,6,1:15,1:30,,6.78,0,6.78,6.78,-1,-58247,56450,114697,-1797,0,-9924,0,0,0,,9924,-9924
12,03/17/2018,7,1:30,1:45,,7.83,0,7.83,7.83,-1,-60216,55339,115555,-4877,0,-32816,0,0,0,,32816,-32816
12,03/17/2018,8,1:45,2:00,,18.39,0,18.39,18.39,-1,-52677,57591,110268,4914,0,-32039,0,0,0,,32039,-32039
12,03/17/2018,9,2:00,2:15,33.43,12.24,0,33.43,33.43,1,-68325,32926,101251,-35399,0,-24063,7,0,0,,24070,-24056
12,03/17/2018,10,2:15,2:30,38.41,44.73,0,38.41,38.26,2,-76854,37076,113930,-39778,0,-526,746,0,0,,1272,220
12,03/17/2018,11,2:30,2:45,,30.41,0,30.41,30.41,-1,-55442,47354,102796,-8088,0,-681,0,0,0,,681,-681
12,03/17/2018,12,2:45,3:00,,22.41,0,22.41,22.41,-1,-50258,52010,102268,1752,0,-9765,0,0,0,,9765,-9765
12,03/17/2018,13,3:00,3:15,,27.28,0,27.28,27.28,-1,-73009,38757,111766,-34252,0,-11134,0,0,0,,11134,-11134
12,03/17/2018,14,3:15,3:30,,30.41,0,30.41,30.41,-1,-67393,47402,114795,-19991,0,-706,0,0,0,,706,-706
12,03/17/2018,15,3:30,3:45,,26.59,0,26.59,26.59,-1,-69149,48146,117295,-21003,0,-2626,0,0,0,,2626,-2626
12,03/17/2018,16,3:45,4:00,,26.78,0,26.78,26.78,-1,-69140,55807,124947,-13333,0,-7433,0,0,0,,7433,-7433
12,03/17/2018,17,4:00,4:15,,30.41,0,30.41,30.41,-1,-84951,42978,127929,-41973,0,-5423,0,0,0,,5423,-5423
12,03/17/2018,18,4:15,4:30,,,0,38.1,38.1,0,-65143,43980,109123,-21163,0,-39,0,0,0,,39,-39
12,03/17/2018,19,4:30,4:45,,43.33,0,43.33,43.33,-1,-67639,42907,110546,-24732,0,-821,0,0,0,,821,-821
12,03/17/2018,20,4:45,5:00,,43.26,0,43.26,43.26,-1,-83030,43747,126777,-39283,0,-842,0,0,0,,842,-842
12,03/17/2018,21,5:00,5:15,,30.41,0,30.41,30.41,-1,-39276,51079,90355,11803,0,-2111,0,0,0,,2111,-2111
12,03/17/2018,22,5:15,5:30,,22.41,0,22.41,22.41,-1,-48513,51409,99922,2896,0,-15243,0,0,0,,15243,-15243
12,03/17/2018,23,5:30,5:45,,22.41,0,22.41,22.41,-1,-55151,44834,99985,-10317,0,-25921,0,0,0,,25921,-25921
12,03/17/2018,24,5:45,6:00,,20.94,0,20.94,20.94,-1,-43927,63608,107535,19681,0,-13825,0,0,0,,13825,-13825
12,03/17/2018,25,6:00,6:15,,40.73,0,40.73,40.73,-1,-39784,55133,94917,15349,0,-19609,0,0,0,,19609,-19609
12,03/17/2018,26,6:15,6:30,,36.73,0,36.73,36.73,-1,-31363,49723,81086,18360,0,-19114,0,0,0,,19114,-19114
12,03/17/2018,27,6:30,6:45,,22.65,0,22.65,22.65,-1,-40632,60839,101471,20207,0,-20899,0,0,0,,20899,-20899
12,03/17/2018,28,6:45,7:00,,11.76,0,11.76,11.76,-1,-51177,64934,116111,13757,0,-29807,0,0,0,,29807,-29807
12,03/17/2018,29,7:00,7:15,,-34.03,0,-34.03,-34.03,-1,-39646,60394,100040,20748,0,-33829,0,0,0,,33829,-33829
12,03/17/2018,30,7:15,7:30,,23.61,0,23.61,23.61,-1,-54887,44708,99595,-10179,0,-25202,0,0,0,,25202,-25202
12,03/17/2018,31,7:30,7:45,,36.73,0,36.73,36.73,-1,-67408,44752,112160,-22656,0,-18796,0,0,0,,18796,-18796
12,03/17/2018,32,7:45,8:00,,36.73,0,36.73,36.73,-1,-82572,83363,165935,791,0,-16060,0,0,0,,16060,-16060
12,03/17/2018,33,8:00,8:15,,31.41,0,31.41,31.41,-1,-60274,99485,159759,39211,0,-17216,0,0,0,,17216,-17216
12,03/17/2018,34,8:15,8:30,,44.03,0,44.03,44.03,-1,-48660,59278,107938,10618,0,-5409,0,0,0,,5409,-5409
12,03/17/2018,35,8:30,8:45,32.71,,0,32.71,32.71,1,-47906,37934,85840,-9972,0,0,12,0,0,,12,12
12,03/17/2018,36,8:45,9:00,149.02,,0,149.02,149.02,1,-84947,39060,124007,-45887,0,0,22520,0,0,,22520,22520
12,03/17/2018,37,9:00,9:15,48.73,37.73,0,48.73,37.73,2,-29945,77210,107155,47265,0,-114,10921,0,0,,11035,10807
12,03/17/2018,38,9:15,9:30,,42.03,0,42.03,42.03,-1,-27844,68793,96637,40949,0,-173,0,0,0,,173,-173
12,03/17/2018,39,9:30,9:45,,39.73,0,39.73,39.73,-1,-49883,37686,87569,-12197,0,-713,0,0,0,,713,-713
12,03/17/2018,40,9:45,10:00,,41.03,0,41.03,41.03,-1,-54606,36928,91534,-17678,0,-518,0,0,0,,518,-518
12,03/17/2018,41,10:00,10:15,53.29,,0,53.29,53.29,1,-59355,43425,102780,-15930,0,0,5740,0,0,,5740,5740
12,03/17/2018,42,10:15,10:30,33.82,,0,33.82,33.82,1,-49666,50766,100432,1100,0,0,2905,0,0,,2905,2905
12,03/17/2018,43,10:30,10:45,33.82,45.03,0,45.03,45.03,-1,-50280,63035,113315,12755,0,-4,131,0,0,,135,127
12,03/17/2018,44,10:45,11:00,,39.73,0,39.73,39.73,-1,-46293,66682,112975,20389,0,-1633,0,0,0,,1633,-1633
12,03/17/2018,45,11:00,11:15,,39.73,0,39.73,39.73,-1,-54162,56508,110670,2346,0,-1802,0,0,0,,1802,-1802
12,03/17/2018,46,11:15,11:30,,39.73,0,39.73,39.73,-1,-47520,70309,117829,22789,0,-1388,0,0,0,,1388,-1388
12,03/17/2018,47,11:30,11:45,,39.73,0,39.73,39.73,-1,-50004,73757,123761,23753,0,-2663,0,0,0,,2663,-2663
12,03/17/2018,48,11:45,12:00,,40.03,0,40.03,40.03,-1,-48066,83721,131787,35655,0,-2736,0,0,0,,2736,-2736
12,03/17/2018,49,12:00,12:15,,42.03,0,42.03,42.03,-1,-59699,73666,133365,13967,0,-1681,0,0,0,,1681,-1681
12,03/17/2018,50,12:15,12:30,,39.73,0,39.73,39.73,-1,-49703,80594,130297,30891,0,-2000,0,0,0,,2000,-2000
12,03/17/2018,51,12:30,12:45,,39.73,0,39.73,39.73,-1,-37941,105038,142979,67097,0,-2800,0,0,0,,2800,-2800
12,03/17/2018,52,12:45,13:00,,37.73,0,37.73,37.73,-1,-32575,115755,148330,83180,0,-3071,0,0,0,,3071,-3071
12,03/17/2018,53,13:00,13:15,,15.45,0,15.45,15.45,-1,-35035,119051,154086,84016,0,-9193,0,0,0,,9193,-9193
12,03/17/2018,54,13:15,13:30,,-19.97,0,-19.97,-19.97,-1,-55419,127298,182717,71879,0,-26015,0,0,0,,26015,-26015
12,03/17/2018,55,13:30,13:45,,34.73,0,34.73,34.73,-1,-82464,106165,188629,23701,0,-11397,0,0,0,,11397,-11397
12,03/17/2018,56,13:45,14:00,249.02,31.78,0,273.92,273.92,1,-208328,98323,306651,-110005,0,-7699,15994,0,3750,,27443,12045
12,03/17/2018,57,14:00,14:15,350.02,31.78,0,385.02,385.02,1,-253020,144185,397205,-108835,0,-76,42388,5000,91416,,138880,138728
12,03/17/2018,58,14:15,14:30,224.02,,0,224.02,224.02,1,-155638,85819,241457,-69819,0,0,11784,0,11666,,23450,23450
12,03/17/2018,59,14:30,14:45,110.02,,0,110.02,110.02,1,-166394,95501,261895,-70893,0,0,39963,0,0,,39963,39963
12,03/17/2018,60,14:45,15:00,237.02,,0,237.02,237.02,1,-177913,88936,266849,-88977,0,0,69920,0,0,,69920,69920
12,03/17/2018,61,15:00,15:15,61.02,,0,61.02,61.02,1,-144258,136394,280652,-7864,0,0,32732,0,0,,32732,32732
12,03/17/2018,62,15:15,15:30,199.02,38.79,0,199.02,199.02,1,-171638,114203,285841,-57435,0,-2,12454,0,0,,12456,12452
12,03/17/2018,63,15:30,15:45,224.02,,0,224.02,224.02,1,-168137,104382,272519,-63755,0,0,44670,0,0,,44670,44670
12,03/17/2018,64,15:45,16:00,73.02,,0,73.02,73.02,1,-162717,88309,251026,-74408,0,0,44984,0,0,,44984,44984
12,03/17/2018,65,16:00,16:15,52.73,34.73,0,34.73,34.73,-1,-67606,95864,163470,28258,0,-193,21597,0,0,,21790,21404
12,03/17/2018,66,16:15,16:30,,42.03,0,42.03,42.03,-1,-77292,108437,185729,31145,0,-178,0,0,0,,178,-178
12,03/17/2018,67,16:30,16:45,69.02,42.03,0,69.02,69.02,1,-110558,83395,193953,-27163,0,-119,3800,0,0,,3919,3681
12,03/17/2018,68,16:45,17:00,237.02,,0,237.02,237.02,1,-129450,74796,204246,-54654,0,0,53002,0,0,,53002,53002
12,03/17/2018,69,17:00,17:15,91.44,29.8,0,29.8,29.8,-1,-100919,94050,194969,-6869,0,-456,28389,0,0,,28845,27933
12,03/17/2018,70,17:15,17:30,252.02,29.8,0,252.02,252.02,1,-139643,67575,207218,-72068,0,-117,13383,0,0,,13500,13266
12,03/17/2018,71,17:30,17:45,252.02,,0,252.02,252.02,1,-145272,68381,213653,-76891,0,0,50469,0,0,,50469,50469
12,03/17/2018,72,17:45,18:00,149.02,,0,149.02,149.02,1,-153656,71022,224678,-82634,0,0,74224,0,0,,74224,74224
12,03/17/2018,73,18:00,18:15,159.02,-21.03,0,-21.03,-21.03,-1,-66576,75725,142301,9149,0,-1871,41666,0,0,,43537,39795
12,03/17/2018,74,18:15,18:30,149.02,-60.39,0,149.02,-60.39,2,-86660,40534,127194,-46126,0,-4805,11579,0,0,,16384,6774
12,03/17/2018,75,18:30,18:45,52.73,,0,52.73,52.73,1,-81285,58338,139623,-22947,0,0,9307,0,0,,9307,9307
12,03/17/2018,76,18:45,19:00,80.77,,0,80.77,80.77,1,-100148,46606,146754,-53542,0,0,17573,0,0,,17573,17573
12,03/17/2018,77,19:00,19:15,56.73,,0,56.73,56.73,1,-92336,74200,166536,-18136,0,0,24645,0,0,,24645,24645
12,03/17/2018,78,19:15,19:30,56.73,39.73,0,39.73,39.73,-1,-78777,76244,155021,-2533,0,-279,5305,0,0,,5584,5026
12,03/17/2018,79,19:30,19:45,,39.73,0,39.73,39.73,-1,-81171,80486,161657,-685,0,-82,0,0,0,,82,-82
12,03/17/2018,80,19:45,20:00,,29.76,0,29.76,29.76,-1,-68777,89100,157877,20323,0,-6742,0,0,0,,6742,-6742
12,03/17/2018,81,20:00,20:15,177.02,42.03,0,177.02,38.18,2,-141625,57951,199576,-83674,0,-1552,11746,0,0,,13298,10194
12,03/17/2018,82,20:15,20:30,53.04,,0,53.04,53.04,1,-118945,67581,186526,-51364,0,0,11386,0,0,,11386,11386
12,03/17/2018,83,20:30,20:45,48.73,,0,48.73,48.73,1,-114468,70744,185212,-43724,0,0,1025,0,0,,1025,1025
12,03/17/2018,84,20:45,21:00,52.73,,0,52.73,52.73,1,-96736,68929,165665,-27807,0,0,10560,0,0,,10560,10560
12,03/17/2018,85,21:00,21:15,52.73,37.73,0,37.73,37.73,-1,-60441,96405,156846,35964,0,-599,1943,0,0,,2542,1344
12,03/17/2018,86,21:15,21:30,,39.73,0,39.73,39.73,-1,-52178,104937,157115,52759,0,-1023,0,0,0,,1023,-1023
12,03/17/2018,87,21:30,21:45,,39.73,0,39.73,39.73,-1,-41762,122890,164652,81128,0,-2951,0,0,0,,2951,-2951
12,03/17/2018,88,21:45,22:00,,-105.03,0,-105.03,-105.03,-1,-35586,151979,187565,116393,0,-15350,0,0,0,,15350,-15350
12,03/17/2018,89,22:00,22:15,153.02,-121.94,0,153.02,-121.94,2,-107529,42069,149598,-65460,0,-18542,3452,0,0,,21994,-15090
12,03/17/2018,90,22:15,22:30,34.38,34.73,0,34.73,34.73,-1,-63542,68742,132284,5200,0,-1728,1623,0,0,,3351,-105
12,03/17/2018,91,22:30,22:45,,39.73,0,39.73,39.73,-1,-67969,100320,168289,32351,0,-2912,0,0,0,,2912,-2912
12,03/17/2018,92,22:45,23:00,,42.03,0,42.03,42.03,-1,-54040,112986,167026,58946,0,-2745,0,0,0,,2745,-2745
12,03/17/2018,93,23:00,23:15,57.09,41.03,0,57.09,57.09,1,-90388,75094,165482,-15294,0,-1548,2194,0,0,,3742,646
12,03/17/2018,94,23:15,23:30,60.02,41.03,0,60.02,60.02,1,-77137,60930,138067,-16207,0,-35,10246,0,0,,10281,10211
12,03/17/2018,95,23:30,23:45,,,0,38.58,38.58,0,-77085,71569,148654,-5516,0,0,93,0,0,,93,93
12,03/17/2018,96,23:45,0:00,,45.15,0,45.15,45.15,-1,-90507,99171,189678,8664,0,-22,0,0,0,,22,-22
12,03/18/2018,1,0:00,0:15,166.12,44.84,0,166.12,39.05,2,-78075,33312,111387,-44763,0,-81,9988,0,0,,10069,9907
12,03/18/2018,2,0:15,0:30,238.12,,0,238.12,238.12,1,-95171,43888,139059,-51283,0,0,56729,0,0,,56729,56729
12,03/18/2018,3,0:30,0:45,32.54,22.45,0,22.45,22.45,-1,-29709,54709,84418,25000,0,-6965,8847,0,0,,15812,1882
12,03/18/2018,4,0:45,1:00,,22.45,0,22.45,22.45,-1,-63103,64493,127596,1390,0,-14036,0,0,0,,14036,-14036
12,03/18/2018,5,1:00,1:15,,30.45,0,30.45,30.45,-1,-74048,105072,179120,31024,0,-1738,0,0,0,,1738,-1738
12,03/18/2018,6,1:15,1:30,,34.78,0,34.78,34.78,-1,-77927,106193,184120,28266,0,-1957,0,0,0,,1957,-1957
12,03/18/2018,7,1:30,1:45,,35.78,0,35.78,35.78,-1,-76937,99458,176395,22521,0,-2883,0,0,0,,2883,-2883
12,03/18/2018,8,1:45,2:00,,31.22,0,31.22,31.22,-1,-76278,111168,187446,34890,0,-2978,0,0,0,,2978,-2978
12,03/18/2018,9,2:00,2:15,,33.78,0,33.78,33.78,-1,-42954,58443,101397,15489,0,-1884,0,0,0,,1884,-1884
12,03/18/2018,10,2:15,2:30,,,0,38.63,38.63,0,-58046,57639,115685,-407,0,0,0,0,0,,0,0
12,03/18/2018,11,2:30,2:45,,,0,38.65,38.65,0,-60292,57634,117926,-2658,0,0,0,0,0,,0,0
12,03/18/2018,12,2:45,3:00,32.95,,0,32.95,32.95,1,-56197,54756,110953,-1441,0,0,565,0,0,,565,565
12,03/18/2018,13,3:00,3:15,34.45,,0,34.45,34.45,1,-50756,48190,98946,-2566,0,0,64,0,0,,64,64
12,03/18/2018,14,3:15,3:30,34.45,,0,34.45,34.45,1,-55826,47492,103318,-8334,0,0,914,0,0,,914,914
12,03/18/2018,15,3:30,3:45,34.45,,0,34.45,34.45,1,-60330,48039,108369,-12291,0,0,1739,0,0,,1739,1739
12,03/18/2018,16,3:45,4:00,34.45,41.99,0,41.99,41.99,-1,-47520,53637,101157,6117,0,-154,920,0,0,,1074,766
12,03/18/2018,17,4:00,4:15,38.45,35.78,0,38.58,35.78,2,-63618,48793,112411,-14825,0,-369,1063,0,0,,1432,694
12,03/18/2018,18,4:15,4:30,38.45,32.78,0,32.78,32.78,-1,-57502,49189,106691,-8313,0,-285,26,0,0,,311,-259
12,03/18/2018,19,4:30,4:45,,35.78,0,35.78,35.78,-1,-55508,48524,104032,-6984,0,-440,0,0,0,,440,-440
12,03/18/2018,20,4:45,5:00,,33.78,0,33.78,33.78,-1,-55756,48393,104149,-7363,0,-179,0,0,0,,179,-179
12,03/18/2018,21,5:00,5:15,,44.63,0,44.63,44.63,-1,-49378,43549,92927,-5829,0,-120,0,0,0,,120,-120
12,03/18/2018,22,5:15,5:30,32.44,,0,32.44,32.44,1,-51577,40658,92235,-10919,0,0,77,0,0,,77,77
12,03/18/2018,23,5:30,5:45,42.45,,0,42.45,42.45,1,-57868,36516,94384,-21352,0,0,3867,0,0,,3867,3867
12,03/18/2018,24,5:45,6:00,34.45,,0,34.45,34.45,1,-56571,36780,93351,-19791,0,0,3335,0,0,,3335,3335
12,03/18/2018,25,6:00,6:15,45.93,,0,45.93,45.93,1,-70139,37296,107435,-32843,0,0,4713,0,0,,4713,4713
12,03/18/2018,26,6:15,6:30,32.51,,0,32.51,32.51,1,-67578,38363,105941,-29215,0,0,1823,0,0,,1823,1823
12,03/18/2018,27,6:30,6:45,32.55,,0,32.55,32.55,1,-82360,49570,131930,-32790,0,0,114,0,0,,114,114
12,03/18/2018,28,6:45,7:00,,,0,35.51,35.51,0,-78421,60075,138496,-18346,0,0,0,0,0,,0,0
12,03/18/2018,29,7:00,7:15,,30.9,0,30.9,30.9,-1,-78404,64180,142584,-14224,0,-426,0,0,0,,426,-426
12,03/18/2018,30,7:15,7:30,,,0,35.51,35.51,0,-101927,57851,159778,-44076,0,0,0,0,0,,0,0
12,03/18/2018,31,7:30,7:45,,,0,35.51,35.51,0,-109972,62841,172813,-47131,0,0,0,0,0,,0,0
12,03/18/2018,32,7:45,8:00,,,0,35.51,35.51,0,-132481,61100,193581,-71381,0,0,0,0,0,,0,0
12,03/18/2018,33,8:00,8:15,52.12,,0,52.12,52.12,1,-86727,51872,138599,-34855,0,0,4435,0,0,,4435,4435
12,03/18/2018,34,8:15,8:30,192.12,,0,192.12,192.12,1,-105533,59261,164794,-46272,0,0,36842,0,0,,36842,36842
12,03/18/2018,35,8:30,8:45,38.37,,0,38.37,38.37,1,-86242,78713,164955,-7529,0,0,14929,0,0,,14929,14929
12,03/18/2018,36,8:45,9:00,53.12,,0,53.12,53.12,1,-92309,65714,158023,-26595,0,0,7790,0,0,,7790,7790
12,03/18/2018,37,9:00,9:15,56.97,,0,56.97,56.97,1,-96139,61265,157404,-34874,0,0,22211,0,0,,22211,22211
12,03/18/2018,38,9:15,9:30,238.12,,0,238.12,238.12,1,-121617,49671,171288,-71946,0,0,36486,0,0,,36486,36486
12,03/18/2018,39,9:30,9:45,238.12,,0,238.12,238.12,1,-106071,73201,179272,-32870,0,0,53003,0,0,,53003,53003
12,03/18/2018,40,9:45,10:00,36.86,,0,36.86,36.86,1,-99991,81627,181618,-18364,0,0,7666,0,0,,7666,7666
12,03/18/2018,41,10:00,10:15,42.37,,0,42.37,42.37,1,-118572,75720,194292,-42852,0,0,7685,0,0,,7685,7685
12,03/18/2018,42,10:15,10:30,42.37,,0,42.37,42.37,1,-107954,63067,171021,-44887,0,0,7823,0,0,,7823,7823
12,03/18/2018,43,10:30,10:45,42.37,,0,42.37,42.37,1,-92199,64607,156806,-27592,0,0,14917,0,0,,14917,14917
12,03/18/2018,44,10:45,11:00,36.12,,0,36.12,36.12,1,-81508,64642,146150,-16866,0,0,18771,0,0,,18771,18771
12,03/18/2018,45,11:00,11:15,34.37,,0,34.37,34.37,1,-99694,75132,174826,-24562,0,0,8104,0,0,,8104,8104
12,03/18/2018,46,11:15,11:30,34.37,30.84,0,30.84,30.84,-1,-84835,85001,169836,166,0,-4,2,0,0,,6,-2
12,03/18/2018,47,11:30,11:45,,38.78,0,38.78,38.78,-1,-79848,85482,165330,5634,0,-22,0,0,0,,22,-22
12,03/18/2018,48,11:45,12:00,35.47,38.78,0,38.92,38.78,2,-85332,80251,165583,-5081,0,-266,137,0,0,,403,-129
12,03/18/2018,49,12:00,12:15,222.12,,0,222.12,222.12,1,-104111,44347,148458,-59764,0,0,29303,0,0,,29303,29303
12,03/18/2018,50,12:15,12:30,38.37,,0,38.37,38.37,1,-95774,70712,166486,-25062,0,0,13265,0,0,,13265,13265
12,03/18/2018,51,12:30,12:45,38.37,,0,38.37,38.37,1,-101322,60223,161545,-41099,0,0,3343,0,0,,3343,3343
12,03/18/2018,52,12:45,13:00,38.37,,0,38.37,38.37,1,-95329,48666,143995,-46663,0,0,4841,0,0,,4841,4841
12,03/18/2018,53,13:00,13:15,56.53,,0,56.53,56.53,1,-93525,65006,158531,-28519,0,0,14428,0,0,,14428,14428
12,03/18/2018,54,13:15,13:30,38.37,,0,38.37,38.37,1,-86694,57468,144162,-29226,0,0,15651,0,0,,15651,15651
12,03/18/2018,55,13:30,13:45,,,0,38.5,38.5,0,-86072,62255,148327,-23817,0,0,256,0,0,,256,256
12,03/18/2018,56,13:45,14:00,33.12,43.24,0,38.56,38.56,2,-82902,71135,154037,-11767,0,-12,150,0,0,,162,138
12,03/18/2018,57,14:00,14:15,,30.37,0,30.37,30.37,-1,-59001,91445,150446,32444,0,-1753,0,0,0,,1753,-1753
12,03/18/2018,58,14:15,14:30,,30.37,0,30.37,30.37,-1,-61337,86126,147463,24789,0,-3105,0,0,0,,3105,-3105
12,03/18/2018,59,14:30,14:45,,31.82,0,31.82,31.82,-1,-74180,91433,165613,17253,0,-3812,0,0,0,,3812,-3812
12,03/18/2018,60,14:45,15:00,,30.37,0,30.37,30.37,-1,-62001,84024,146025,22023,0,-4003,0,0,0,,4003,-4003
12,03/18/2018,61,15:00,15:15,,32.78,0,32.78,32.78,-1,-83649,84473,168122,824,0,-3685,0,0,0,,3685,-3685
12,03/18/2018,62,15:15,15:30,,43.2,0,43.2,43.2,-1,-87413,79283,166696,-8130,0,-1782,0,0,0,,1782,-1782
12,03/18/2018,63,15:30,15:45,,43.15,0,43.15,43.15,-1,-91210,70764,161974,-20446,0,-2000,0,0,0,,2000,-2000
12,03/18/2018,64,15:45,16:00,,43.61,0,43.61,43.61,-1,-107725,60597,168322,-47128,0,-1941,0,0,0,,1941,-1941
12,03/18/2018,65,16:00,16:15,32.53,33.78,0,37.88,33.78,2,-74483,81583,156066,7100,0,-396,5,0,0,,401,-391
12,03/18/2018,66,16:15,16:30,42.37,,0,42.37,42.37,1,-102451,78629,181080,-23822,0,0,9066,0,0,,9066,9066
12,03/18/2018,67,16:30,16:45,206.12,,0,206.12,206.12,1,-138365,72758,211123,-65607,0,0,38744,0,0,,38744,38744
12,03/18/2018,68,16:45,17:00,222.12,,0,222.12,222.12,1,-134340,67740,202080,-66600,0,0,70781,0,0,,70781,70781
12,03/18/2018,69,17:00,17:15,222.12,-30.73,0,-30.73,-30.73,-1,-42823,112148,154971,69325,0,-5399,19351,0,0,,24750,13952
12,03/18/2018,70,17:15,17:30,38.37,42.85,0,38.84,38.84,2,-100428,82885,183313,-17543,0,-2572,1887,0,0,,4459,-685
12,03/18/2018,71,17:30,17:45,238.12,,0,238.12,238.12,1,-131193,76912,208105,-54281,0,0,24947,0,0,,24947,24947
12,03/18/2018,72,17:45,18:00,238.12,,0,238.12,238.12,1,-124575,104249,228824,-20326,0,0,44431,0,0,,44431,44431
12,03/18/2018,73,18:00,18:15,238.12,22.37,0,22.37,22.37,-1,-25883,42069,67952,16186,0,-7979,3090,0,0,,11069,-4889
12,03/18/2018,74,18:15,18:30,,33.78,0,33.78,33.78,-1,-40045,41484,81529,1439,0,-1513,0,0,0,,1513,-1513
12,03/18/2018,75,18:30,18:45,34.37,,0,34.37,34.37,1,-47913,33804,81717,-14109,0,0,50,0,0,,50,50
12,03/18/2018,76,18:45,19:00,238.12,,0,238.12,238.12,1,-91230,47028,138258,-44202,0,0,5857,0,0,,5857,5857
12,03/18/2018,77,19:00,19:15,256.12,,0,256.12,256.12,1,-135480,33195,168675,-102285,0,0,67264,0,0,,67264,67264
12,03/18/2018,78,19:15,19:30,134.12,,0,134.12,134.12,1,-118578,31134,149712,-87444,0,0,82122,0,0,,82122,82122
12,03/18/2018,79,19:30,19:45,172.12,,0,172.12,172.12,1,-96848,31435,128283,-65413,0,0,71081,0,0,,71081,71081
12,03/18/2018,80,19:45,20:00,152.12,,0,152.12,152.12,1,-98562,48437,146999,-50125,0,0,29829,0,0,,29829,29829
12,03/18/2018,81,20:00,20:15,148.12,,0,148.12,148.12,1,-109576,106515,216091,-3061,0,0,12149,0,0,,12149,12149
12,03/18/2018,82,20:15,20:30,34.37,,0,34.37,34.37,1,-99579,92750,192329,-6829,0,0,787,0,0,,787,787
12,03/18/2018,83,20:30,20:45,33.97,,0,33.97,33.97,1,-73703,148683,222386,74980,0,0,461,0,0,,461,461
12,03/18/2018,84,20:45,21:00,,44.87,0,44.87,44.87,-1,-61959,170582,232541,108623,0,-361,0,0,0,,361,-361
12,03/18/2018,85,21:00,21:15,248.12,44.87,0,248.12,248.12,1,-139120,56799,195919,-82321,0,-137,22340,0,0,,22477,22203
12,03/18/2018,86,21:15,21:30,248.12,,0,248.12,248.12,1,-107552,69354,176906,-38198,0,0,53107,0,0,,53107,53107
12,03/18/2018,87,21:30,21:45,248.12,32.16,0,32.16,32.16,-1,-53940,65058,118998,11118,0,-54,4339,0,0,,4393,4285
12,03/18/2018,88,21:45,22:00,,38.78,0,38.78,38.78,-1,-44714,68412,113126,23698,0,-207,0,0,0,,207,-207
12,03/18/2018,89,22:00,22:15,49.53,38.78,0,49.53,35.9,2,-111339,54784,166123,-56555,0,-110,3443,0,0,,3553,3333
12,03/18/2018,90,22:15,22:30,32.96,,0,32.96,32.96,1,-81562,56625,138187,-24937,0,0,918,0,0,,918,918
12,03/18/2018,91,22:30,22:45,,,0,36.35,36.35,0,-62575,60195,122770,-2380,0,0,0,0,0,,0,0
12,03/18/2018,92,22:45,23:00,,28.94,0,28.94,28.94,-1,-52537,71975,124512,19438,0,-1470,0,0,0,,1470,-1470
12,03/18/2018,93,23:00,23:15,,24.76,0,24.76,24.76,-1,-80500,77329,157829,-3171,0,-3276,0,0,0,,3276,-3276
12,03/18/2018,94,23:15,23:30,,43.92,0,43.92,43.92,-1,-64455,54878,119333,-9577,0,-78,0,0,0,,78,-78
12,03/18/2018,95,23:30,23:45,,38.78,0,38.78,38.78,-1,-57329,57633,114962,304,0,-884,0,0,0,,884,-884
12,03/18/2018,96,23:45,0:00,,-21.76,0,-21.76,-21.76,-1,-36260,77560,113820,41300,0,-17643,0,0,0,,17643,-17643
12,03/19/2018,1,0:00,0:15,237.02,-17.03,0,237.02,237.02,1,-101735,59010,160745,-42725,0,-19536,8480,0,0,,28016,-11056
12,03/19/2018,2,0:15,0:30,172.02,38.03,0,172.02,37.96,2,-65510,59556,125066,-5954,0,-168,24275,0,0,,24443,24107
12,03/19/2018,3,0:30,0:45,172.02,30.37,0,30.37,30.37,-1,-67274,64386,131660,-2888,0,-2671,99,0,0,,2770,-2572
12,03/19/2018,4,0:45,1:00,,26.89,0,26.89,26.89,-1,-61699,74175,135874,12476,0,-3509,0,0,0,,3509,-3509
12,03/19/2018,5,1:00,1:15,,28.03,0,28.03,28.03,-1,-91783,108002,199785,16219,0,-5251,0,0,0,,5251,-5251
12,03/19/2018,6,1:15,1:30,,33.08,0,33.08,33.08,-1,-77080,90527,167607,13447,0,-4245,0,0,0,,4245,-4245
12,03/19/2018,7,1:30,1:45,,42.01,0,42.01,42.01,-1,-62381,74910,137291,12529,0,-2799,0,0,0,,2799,-2799
12,03/19/2018,8,1:45,2:00,,37.04,0,37.04,37.04,-1,-64037,68759,132796,4722,0,-1170,0,0,0,,1170,-1170
12,03/19/2018,9,2:00,2:15,,32.34,0,32.34,32.34,-1,-51040,67759,118799,16719,0,-1929,0,0,0,,1929,-1929
12,03/19/2018,10,2:15,2:30,34.37,42.93,0,34.37,34.37,1,-67247,58321,125568,-8926,0,-918,82,0,0,,1000,-836
12,03/19/2018,11,2:30,2:45,38.37,,0,38.37,38.37,1,-58670,50827,109497,-7843,0,0,1461,0,0,,1461,1461
12,03/19/2018,12,2:45,3:00,38.37,,0,38.37,38.37,1,-65035,49768,114803,-15267,0,0,2560,0,0,,2560,2560
12,03/19/2018,13,3:00,3:15,,,0,37.97,37.97,0,-59898,78068,137966,18170,0,0,0,0,0,,0,0
12,03/19/2018,14,3:15,3:30,,,0,37.97,37.97,0,-55742,66757,122499,11015,0,0,0,0,0,,0,0
12,03/19/2018,15,3:30,3:45,,43.61,0,43.61,43.61,-1,-64055,66002,130057,1947,0,-73,0,0,0,,73,-73
12,03/19/2018,16,3:45,4:00,,34.7,0,34.7,34.7,-1,-57585,68091,125676,10506,0,-1487,0,0,0,,1487,-1487
12,03/19/2018,17,4:00,4:15,,43.62,0,43.62,43.62,-1,-54240,64922,119162,10682,0,-1630,0,0,0,,1630,-1630
12,03/19/2018,18,4:15,4:30,,43.61,0,43.61,43.61,-1,-56488,60163,116651,3675,0,-2319,0,0,0,,2319,-2319
12,03/19/2018,19,4:30,4:45,,43.61,0,43.61,43.61,-1,-60339,62532,122871,2193,0,-1629,0,0,0,,1629,-1629
12,03/19/2018,20,4:45,5:00,,43.71,0,43.71,43.71,-1,-69852,65269,135121,-4583,0,-352,0,0,0,,352,-352
12,03/19/2018,21,5:00,5:15,,26.37,0,26.37,26.37,-1,-59693,81273,140966,21580,0,-5950,0,0,0,,5950,-5950
12,03/19/2018,22,5:15,5:30,,27.9,0,27.9,27.9,-1,-43775,58141,101916,14366,0,-13138,0,0,0,,13138,-13138
12,03/19/2018,23,5:30,5:45,38.37,27.9,0,38.37,38.37,1,-56867,44389,101256,-12478,0,-2069,389,0,0,,2458,-1680
12,03/19/2018,24,5:45,6:00,44.37,,0,44.37,44.37,1,-70521,61512,132033,-9009,0,0,6183,0,0,,6183,6183
12,03/19/2018,25,6:00,6:15,,,0,39.35,39.35,0,-82059,88832,170891,6773,0,0,962,0,0,,962,962
12,03/19/2018,26,6:15,6:30,54.01,,0,54.01,54.01,1,-93210,66403,159613,-26807,0,0,6772,0,0,,6772,6772
12,03/19/2018,27,6:30,6:45,45.02,,0,45.02,45.02,1,-84005,70778,154783,-13227,0,0,7865,0,0,,7865,7865
12,03/19/2018,28,6:45,7:00,45.02,41.65,0,41.65,41.65,-1,-98783,69891,168674,-28892,0,-17,624,0,0,,641,607
12,03/19/2018,29,7:00,7:15,,13.03,0,13.03,13.03,-1,-64806,134020,198826,69214,0,-18131,0,0,0,,18131,-18131
12,03/19/2018,30,7:15,7:30,,40.01,0,40.01,40.01,-1,-60819,62283,123102,1464,0,-6031,0,0,0,,6031,-6031
12,03/19/2018,31,7:30,7:45,,46.38,0,46.38,46.38,-1,-85532,43120,128652,-42412,0,-768,0,0,0,,768,-768
12,03/19/2018,32,7:45,8:00,347.02,46.38,0,347.02,347.02,1,-113060,41471,154531,-71589,0,-518,7102,0,0,,7620,6584
12,03/19/2018,33,8:00,8:15,54.01,,0,54.01,54.01,1,-27389,119901,147290,92512,0,0,7137,0,0,,7137,7137
12,03/19/2018,34,8:15,8:30,,42.16,0,42.16,42.16,-1,-33191,126773,159964,93582,0,-386,0,0,0,,386,-386
12,03/19/2018,35,8:30,8:45,,31.14,0,31.14,31.14,-1,-48258,125393,173651,77135,0,-6325,0,0,0,,6325,-6325
12,03/19/2018,36,8:45,9:00,,23.03,0,23.03,23.03,-1,-68248,141157,209405,72909,0,-34795,0,0,0,,34795,-34795
12,03/19/2018,37,9:00,9:15,,31.14,0,31.14,31.14,-1,-53334,102805,156139,49471,0,-22225,0,0,0,,22225,-22225
12,03/19/2018,38,9:15,9:30,,18.01,0,18.01,18.01,-1,-65467,130524,195991,65057,0,-29435,0,0,0,,29435,-29435
12,03/19/2018,39,9:30,9:45,,-48.01,0,-48.01,-48.01,-1,-75178,181297,256475,106119,0,-45071,0,0,0,,45071,-45071
12,03/19/2018,40,9:45,10:00,,18.01,0,18.01,18.01,-1,-95981,192663,288644,96682,0,-57196,0,0,0,,57196,-57196
12,03/19/2018,41,10:00,10:15,44.01,18.01,0,44.01,44.01,1,-78403,80745,159148,2342,0,-27657,41,0,0,,27698,-27616
12,03/19/2018,42,10:15,10:30,,30.81,0,30.81,30.81,-1,-68075,98247,166322,30172,0,-12688,0,0,0,,12688,-12688
12,03/19/2018,43,10:30,10:45,,23.18,0,23.18,23.18,-1,-73832,118932,192764,45100,0,-25624,0,0,0,,25624,-25624
12,03/19/2018,44,10:45,11:00,,30.13,0,30.13,30.13,-1,-84222,125110,209332,40888,0,-35857,0,0,0,,35857,-35857
12,03/19/2018,45,11:00,11:15,,36.52,0,36.52,36.52,-1,-81951,99358,181309,17407,0,-20284,0,0,0,,20284,-20284
12,03/19/2018,46,11:15,11:30,,36.01,0,36.01,36.01,-1,-77017,114351,191368,37334,0,-24576,0,0,0,,24576,-24576
12,03/19/2018,47,11:30,11:45,,31.14,0,31.14,31.14,-1,-84271,123942,208213,39671,0,-37028,0,0,0,,37028,-37028
12,03/19/2018,48,11:45,12:00,,36.01,0,36.01,36.01,-1,-87843,130784,218627,42941,0,-35497,0,0,0,,35497,-35497
12,03/19/2018,49,12:00,12:15,,30.05,0,30.05,30.05,-1,-67922,110971,178893,43049,0,-35965,0,0,0,,35965,-35965
12,03/19/2018,50,12:15,12:30,,29.18,0,29.18,29.18,-1,-80401,120643,201044,40242,0,-43011,0,0,0,,43011,-43011
12,03/19/2018,51,12:30,12:45,,18.32,0,18.32,18.32,-1,-79765,145584,225349,65819,0,-47742,0,0,0,,47742,-47742
12,03/19/2018,52,12:45,13:00,,20.03,0,20.03,20.03,-1,-85571,126158,211729,40587,0,-55313,0,0,0,,55313,-55313
12,03/19/2018,53,13:00,13:15,,34.56,0,34.56,34.56,-1,-84619,124777,209396,40158,0,-19204,0,0,0,,19204,-19204
12,03/19/2018,54,13:15,13:30,,31.82,0,31.82,31.82,-1,-77776,121231,199007,43455,0,-25944,0,0,0,,25944,-25944
12,03/19/2018,55,13:30,13:45,,38.51,0,38.51,38.51,-1,-74540,110523,185063,35983,0,-15596,0,0,0,,15596,-15596
12,03/19/2018,56,13:45,14:00,,35.03,0,35.03,35.03,-1,-64625,115618,180243,50993,0,-28640,0,0,0,,28640,-28640
12,03/19/2018,57,14:00,14:15,,36.01,0,36.01,36.01,-1,-58134,144262,202396,86128,0,-28662,0,0,0,,28662,-28662
12,03/19/2018,58,14:15,14:30,,40.01,0,40.01,40.01,-1,-65463,150969,216432,85506,0,-13128,0,0,0,,13128,-13128
12,03/19/2018,59,14:30,14:45,,31.46,0,31.46,31.46,-1,-68269,129899,198168,61630,0,-20924,0,0,0,,20924,-20924
12,03/19/2018,60,14:45,15:00,,36.01,0,36.01,36.01,-1,-71816,123429,195245,51613,0,-24649,0,0,0,,24649,-24649
12,03/19/2018,61,15:00,15:15,,37.03,0,37.03,37.03,-1,-72171,175636,247807,103465,0,-12516,0,0,0,,12516,-12516
12,03/19/2018,62,15:15,15:30,,,0,40.14,40.14,0,-70627,160556,231183,89929,0,-207,0,0,0,,207,-207
12,03/19/2018,63,15:30,15:45,,,0,40.14,40.14,0,-61480,149196,210676,87716,0,0,0,0,0,,0,0
12,03/19/2018,64,15:45,16:00,,,0,40.15,40.15,0,-69755,127119,196874,57364,0,0,0,0,0,,0,0
12,03/19/2018,65,16:00,16:15,,9.55,0,9.55,9.55,-1,-84741,229878,314619,145137,0,-22619,0,0,0,,22619,-22619
12,03/19/2018,66,16:15,16:30,,40.01,0,40.01,40.01,-1,-87562,189829,277391,102267,0,-14416,0,0,0,,14416,-14416
12,03/19/2018,67,16:30,16:45,,36.01,0,36.01,36.01,-1,-74284,164315,238599,90031,0,-7795,0,0,0,,7795,-7795
12,03/19/2018,68,16:45,17:00,,,0,40.17,40.17,0,-72055,117579,189634,45524,0,-332,0,0,0,,332,-332
12,03/19/2018,69,17:00,17:15,,30.01,0,30.01,30.01,-1,-78600,229186,307786,150586,0,-5573,0,0,0,,5573,-5573
12,03/19/2018,70,17:15,17:30,,43.49,0,43.49,43.49,-1,-74685,151202,225887,76517,0,-1559,0,0,0,,1559,-1559
12,03/19/2018,71,17:30,17:45,,44.98,0,44.98,44.98,-1,-56445,126779,183224,70334,0,-880,0,0,0,,880,-880
12,03/19/2018,72,17:45,18:00,,44.97,0,44.97,44.97,-1,-43590,115869,159459,72279,0,-122,0,0,0,,122,-122
12,03/19/2018,73,18:00,18:15,,36.01,0,36.01,36.01,-1,-72633,96609,169242,23976,0,-6534,0,0,0,,6534,-6534
12,03/19/2018,74,18:15,18:30,,40.01,0,40.01,40.01,-1,-65163,95487,160650,30324,0,-9568,0,0,0,,9568,-9568
12,03/19/2018,75,18:30,18:45,,,0,40.35,40.35,0,-48470,78726,127196,30256,0,-180,0,0,0,,180,-180
12,03/19/2018,76,18:45,19:00,54.01,,0,54.01,54.01,1,-64243,51210,115453,-13033,0,0,2552,0,0,,2552,2552
12,03/19/2018,77,19:00,19:15,206.02,,0,206.02,206.02,1,-121848,77571,199419,-44277,0,0,22892,0,0,,22892,22892
12,03/19/2018,78,19:15,19:30,99.02,,0,99.02,99.02,1,-129893,77437,207330,-52456,0,0,42948,0,0,,42948,42948
12,03/19/2018,79,19:30,19:45,88.19,,0,88.19,88.19,1,-132878,94001,226879,-38877,0,0,28313,0,0,,28313,28313
12,03/19/2018,80,19:45,20:00,,,0,40.92,40.92,0,-141328,80472,221800,-60856,0,0,1723,0,0,,1723,1723
12,03/19/2018,81,20:00,20:15,54.01,,0,54.01,54.01,1,-150815,71333,222148,-79482,0,0,1279,0,0,,1279,1279
12,03/19/2018,82,20:15,20:30,,,0,40.62,40.62,0,-119412,71003,190415,-48409,0,0,0,0,0,,0,0
12,03/19/2018,83,20:30,20:45,,,0,40.62,40.62,0,-78150,69488,147638,-8662,0,0,0,0,0,,0,0
12,03/19/2018,84,20:45,21:00,,,0,40.62,40.62,0,-82578,78523,161101,-4055,0,0,0,0,0,,0,0
12,03/19/2018,85,21:00,21:15,54.01,,0,54.01,54.01,1,-116781,82233,199014,-34548,0,0,306,0,0,,306,306
12,03/19/2018,86,21:15,21:30,66.01,,0,66.01,66.01,1,-84800,75269,160069,-9531,0,0,7958,0,0,,7958,7958
12,03/19/2018,87,21:30,21:45,66.01,38.44,0,38.44,38.44,-1,-61565,82464,144029,20899,0,-1332,112,0,0,,1444,-1220
12,03/19/2018,88,21:45,22:00,,38.03,0,38.03,38.03,-1,-81000,89116,170116,8116,0,-2883,0,0,0,,2883,-2883
12,03/19/2018,89,22:00,22:15,,,0,40.16,40.16,0,-122660,68042,190702,-54618,0,-279,0,0,0,,279,-279
12,03/19/2018,90,22:15,22:30,,44.73,0,44.73,44.73,-1,-89378,67721,157099,-21657,0,-17,0,0,0,,17,-17
12,03/19/2018,91,22:30,22:45,,42.64,0,42.64,42.64,-1,-55394,67805,123199,12411,0,-213,0,0,0,,213,-213
12,03/19/2018,92,22:45,23:00,,20.37,0,20.37,20.37,-1,-36047,90277,126324,54230,0,-6010,0,0,0,,6010,-6010
12,03/19/2018,93,23:00,23:15,,30.83,0,30.83,30.83,-1,-105751,53526,159277,-52225,0,-6232,0,0,0,,6232,-6232
12,03/19/2018,94,23:15,23:30,,,0,38.47,38.47,0,-101751,43607,145358,-58144,0,0,0,0,0,,0,0
12,03/19/2018,95,23:30,23:45,,,0,38.5,38.5,0,-71827,38461,110288,-33366,0,0,0,0,0,,0,0
12,03/19/2018,96,23:45,0:00,,30.37,0,30.37,30.37,-1,-56015,50361,106376,-5654,0,-907,0,0,0,,907,-907
12,03/20/2018,1,0:00,0:15,33.35,27.77,0,33.35,33.35,1,-54949,75338,130287,20389,0,-1455,102,0,0,,1557,-1353
12,03/20/2018,2,0:15,0:30,38.37,,0,38.37,38.37,1,-36173,46996,83169,10823,0,0,580,0,0,,580,580
12,03/20/2018,3,0:30,0:45,,,0,36.51,36.51,0,-22708,60862,83570,38154,0,0,0,0,0,,0,0
12,03/20/2018,4,0:45,1:00,,38.94,0,38.94,38.94,-1,-29112,97333,126445,68221,0,-751,0,0,0,,751,-751
12,03/20/2018,5,1:00,1:15,,,0,36.31,36.31,0,-35555,63091,98646,27536,0,-301,0,0,0,,301,-301
12,03/20/2018,6,1:15,1:30,33.27,,0,33.27,33.27,1,-41462,60285,101747,18823,0,0,475,0,0,,475,475
12,03/20/2018,7,1:30,1:45,32.79,,0,32.79,32.79,1,-28435,87594,116029,59159,0,0,352,0,0,,352,352
12,03/20/2018,8,1:45,2:00,,40.42,0,40.42,40.42,-1,-25588,103099,128687,77511,0,-2,0,0,0,,2,-2
12,03/20/2018,9,2:00,2:15,,34.25,0,34.25,34.25,-1,-38122,88678,126800,50556,0,-565,0,0,0,,565,-565
12,03/20/2018,10,2:15,2:30,,40.21,0,40.21,40.21,-1,-26913,75009,101922,48096,0,-4,0,0,0,,4,-4
12,03/20/2018,11,2:30,2:45,,34.25,0,34.25,34.25,-1,-20166,95230,115396,75064,0,-4321,0,0,0,,4321,-4321
12,03/20/2018,12,2:45,3:00,,39.2,0,39.2,39.2,-1,-16434,105362,121796,88928,0,-2152,0,0,0,,2152,-2152
12,03/20/2018,13,3:00,3:15,33.14,39.2,0,33.14,33.14,1,-34071,57514,91585,23443,0,-476,95,0,0,,571,-381
12,03/20/2018,14,3:15,3:30,33.06,,0,33.06,33.06,1,-32610,45055,77665,12445,0,0,750,0,0,,750,750
12,03/20/2018,15,3:30,3:45,32.99,,0,32.99,32.99,1,-37323,50020,87343,12697,0,0,561,0,0,,561,561
12,03/20/2018,16,3:45,4:00,,,0,35.71,35.71,0,-37537,74467,112004,36930,0,0,0,0,0,,0,0
12,03/20/2018,17,4:00,4:15,,,0,36.24,36.24,0,-37967,48524,86491,10557,0,0,0,0,0,,0,0
12,03/20/2018,18,4:15,4:30,,30.37,0,30.37,30.37,-1,-35906,50848,86754,14942,0,-1263,0,0,0,,1263,-1263
12,03/20/2018,19,4:30,4:45,,30.37,0,30.37,30.37,-1,-39915,66559,106474,26644,0,-2072,0,0,0,,2072,-2072
12,03/20/2018,20,4:45,5:00,,,0,36.24,36.24,0,-49062,62211,111273,13149,0,0,0,0,0,,0,0
12,03/20/2018,21,5:00,5:15,38.37,,0,38.37,38.37,1,-54219,33474,87693,-20745,0,0,627,0,0,,627,627
12,03/20/2018,22,5:15,5:30,38.37,,0,38.37,38.37,1,-53285,27296,80581,-25989,0,0,2781,0,0,,2781,2781
12,03/20/2018,23,5:30,5:45,67.1,,0,67.1,67.1,1,-81583,26988,108571,-54595,0,0,29977,0,0,,29977,29977
12,03/20/2018,24,5:45,6:00,56.37,,0,56.37,56.37,1,-85768,52947,138715,-32821,0,0,43104,0,0,,43104,43104
12,03/20/2018,25,6:00,6:15,56.37,-6.22,0,-6.22,-6.22,-1,-52711,83015,135726,30304,0,-13101,12207,0,0,,25308,-894
12,03/20/2018,26,6:15,6:30,,37.38,0,37.38,37.38,-1,-57904,62330,120234,4426,0,-2380,0,0,0,,2380,-2380
12,03/20/2018,27,6:30,6:45,,30.37,0,30.37,30.37,-1,-66053,82339,148392,16286,0,-7350,0,0,0,,7350,-7350
12,03/20/2018,28,6:45,7:00,,18.36,0,18.36,18.36,-1,-66978,95035,162013,28057,0,-11614,0,0,0,,11614,-11614
12,03/20/2018,29,7:00,7:15,,-38.25,0,-38.25,-38.25,-1,-54628,106262,160890,51634,0,-56518,0,0,0,,56518,-56518
12,03/20/2018,30,7:15,7:30,,30.14,0,30.14,30.14,-1,-47824,79042,126866,31218,0,-15047,0,0,0,,15047,-15047
12,03/20/2018,31,7:30,7:45,60.14,35.25,0,60.14,60.14,1,-65965,52944,118909,-13021,0,-5089,1854,0,0,,6943,-3235
12,03/20/2018,32,7:45,8:00,141.1,,0,141.1,141.1,1,-100894,43047,143941,-57847,0,0,41916,0,0,,41916,41916
12,03/20/2018,33,8:00,8:15,141.1,-78.34,0,-78.34,-78.34,-1,-19712,77648,97360,57936,0,-11092,16263,0,0,,27355,5171
12,03/20/2018,34,8:15,8:30,,12.14,0,12.14,12.14,-1,-23725,66688,90413,42963,0,-17699,0,0,0,,17699,-17699
12,03/20/2018,35,8:30,8:45,,32.02,0,32.02,32.02,-1,-55949,64095,120044,8146,0,-17453,0,0,0,,17453,-17453
12,03/20/2018,36,8:45,9:00,,34.14,0,34.14,34.14,-1,-56503,70001,126504,13498,0,-4490,0,0,0,,4490,-4490
12,03/20/2018,37,9:00,9:15,60.14,38.21,0,60.14,38.21,2,-77183,58968,136151,-18215,0,-1106,4397,0,0,,5503,3291
12,03/20/2018,38,9:15,9:30,60.14,6.06,0,6.06,6.06,-1,-47595,96453,144048,48858,0,-18224,702,0,0,,18926,-17522
12,03/20/2018,39,9:30,9:45,,10.25,0,10.25,10.25,-1,-84875,150420,235295,65545,0,-43254,0,0,0,,43254,-43254
12,03/20/2018,40,9:45,10:00,,6.93,0,6.93,6.93,-1,-118183,178618,296801,60435,0,-63194,0,0,0,,63194,-63194
12,03/20/2018,41,10:00,10:15,45.14,23.23,0,45.14,45.14,1,-111001,100484,211485,-10517,0,-24956,780,0,0,,25736,-24176
12,03/20/2018,42,10:15,10:30,45.14,34.14,0,34.14,34.14,-1,-99055,154254,253309,55199,0,-4242,62,0,0,,4304,-4180
12,03/20/2018,43,10:30,10:45,,12.84,0,12.84,12.84,-1,-96573,203506,300079,106933,0,-9869,0,0,0,,9869,-9869
12,03/20/2018,44,10:45,11:00,,-8.71,0,-8.71,-8.71,-1,-119590,224065,343655,104475,0,-46762,0,0,0,,46762,-46762
12,03/20/2018,45,11:00,11:15,,-8.33,0,-8.33,-8.33,-1,-88533,139088,227621,50555,0,-54595,0,0,0,,54595,-54595
12,03/20/2018,46,11:15,11:30,,-6.5,0,-6.5,-6.5,-1,-87017,163279,250296,76262,0,-56994,0,0,0,,56994,-56994
12,03/20/2018,47,11:30,11:45,,-9.78,0,-9.78,-9.78,-1,-91501,182335,273836,90834,0,-71778,0,0,0,,71778,-71778
12,03/20/2018,48,11:45,12:00,,12.14,0,12.14,12.14,-1,-112451,191877,304328,79426,0,-78367,0,0,0,,78367,-78367
12,03/20/2018,49,12:00,12:15,,3.6,0,3.6,3.6,-1,-61466,143169,204635,81703,0,-80671,0,0,0,,80671,-80671
12,03/20/2018,50,12:15,12:30,,6.9,0,6.9,6.9,-1,-73424,162191,235615,88767,0,-80392,0,0,0,,80392,-80392
12,03/20/2018,51,12:30,12:45,,15.67,0,15.67,15.67,-1,-70732,153592,224324,82860,0,-74607,0,0,0,,74607,-74607
12,03/20/2018,52,12:45,13:00,,13.78,0,13.78,13.78,-1,-72691,152367,225058,79676,0,-73948,0,0,0,,73948,-73948
12,03/20/2018,53,13:00,13:15,,16.55,0,16.55,16.55,-1,-112652,136963,249615,24311,0,-60408,0,0,0,,60408,-60408
12,03/20/2018,54,13:15,13:30,,24.14,0,24.14,24.14,-1,-114314,138641,252955,24327,0,-24665,0,0,0,,24665,-24665
12,03/20/2018,55,13:30,13:45,,24.14,0,24.14,24.14,-1,-118701,145878,264579,27177,0,-36806,0,0,0,,36806,-36806
12,03/20/2018,56,13:45,14:00,,27.53,0,27.53,27.53,-1,-122339,128886,251225,6547,0,-33076,0,0,0,,33076,-33076
12,03/20/2018,57,14:00,14:15,,15.78,0,15.78,15.78,-1,-99141,146761,245902,47620,0,-38964,0,0,0,,38964,-38964
12,03/20/2018,58,14:15,14:30,,24.14,0,24.14,24.14,-1,-110010,137880,247890,27870,0,-37719,0,0,0,,37719,-37719
12,03/20/2018,59,14:30,14:45,,26.91,0,26.91,26.91,-1,-108772,134088,242860,25316,0,-23641,0,0,0,,23641,-23641
12,03/20/2018,60,14:45,15:00,,34.14,0,34.14,34.14,-1,-112335,120052,232387,7717,0,-15496,0,0,0,,15496,-15496
12,03/20/2018,61,15:00,15:15,,37.9,0,37.9,37.9,-1,-61071,149211,210282,88140,0,-3707,0,0,0,,3707,-3707
12,03/20/2018,62,15:15,15:30,,37.41,0,37.41,37.41,-1,-52075,129288,181363,77213,0,-2999,0,0,0,,2999,-2999
12,03/20/2018,63,15:30,15:45,,34.14,0,34.14,34.14,-1,-58509,110808,169317,52299,0,-2130,0,0,0,,2130,-2130
12,03/20/2018,64,15:45,16:00,,34.14,0,34.14,34.14,-1,-77068,91280,168348,14212,0,-51,0,0,0,,51,-51
12,03/20/2018,65,16:00,16:15,,-0.38,0,-0.38,-0.38,-1,-76446,216915,293361,140469,0,-28173,0,0,0,,28173,-28173
12,03/20/2018,66,16:15,16:30,,11.83,0,11.83,11.83,-1,-65531,182731,248262,117200,0,-37220,0,0,0,,37220,-37220
12,03/20/2018,67,16:30,16:45,,29.85,0,29.85,29.85,-1,-72856,136445,209301,63589,0,-24531,0,0,0,,24531,-24531
12,03/20/2018,68,16:45,17:00,41.6,29.85,0,41.6,41.6,1,-61349,97300,158649,35951,0,-2384,534,0,0,,2918,-1850
12,03/20/2018,69,17:00,17:15,41.6,34.14,0,34.14,34.14,-1,-55291,163876,219167,108585,0,-285,52,0,0,,337,-233
12,03/20/2018,70,17:15,17:30,,23.9,0,23.9,23.9,-1,-29686,94757,124443,65071,0,-13326,0,0,0,,13326,-13326
12,03/20/2018,71,17:30,17:45,,,0,40.75,40.75,0,-46149,62123,108272,15974,0,-602,0,0,0,,602,-602
12,03/20/2018,72,17:45,18:00,60.14,,0,60.14,60.14,1,-62764,64593,127357,1829,0,0,1677,0,0,,1677,1677
12,03/20/2018,73,18:00,18:15,42.12,,0,42.12,42.12,1,-72049,45412,117461,-26637,0,0,1973,0,0,,1973,1973
12,03/20/2018,74,18:15,18:30,41.59,,0,41.59,41.59,1,-51927,59808,111735,7881,0,0,8,0,0,,8,8
12,03/20/2018,75,18:30,18:45,60.14,,0,60.14,60.14,1,-55188,58373,113561,3185,0,0,3749,0,0,,3749,3749
12,03/20/2018,76,18:45,19:00,253.12,,0,253.12,253.12,1,-83218,46877,130095,-36341,0,0,50950,0,0,,50950,50950
12,03/20/2018,77,19:00,19:15,44.89,38.72,0,44.89,38.72,2,-34803,93589,128392,58786,0,-112,27260,0,0,,27372,27148
12,03/20/2018,78,19:15,19:30,140.12,,0,140.12,140.12,1,-66779,55655,122434,-11124,0,0,26501,0,0,,26501,26501
12,03/20/2018,79,19:30,19:45,82.12,,0,82.12,82.12,1,-51963,75214,127177,23251,0,0,29418,0,0,,29418,29418
12,03/20/2018,80,19:45,20:00,62.49,,0,62.49,62.49,1,-53564,66463,120027,12899,0,0,6164,0,0,,6164,6164
12,03/20/2018,81,20:00,20:15,45.14,,0,45.14,45.14,1,-51132,99322,150454,48190,0,0,3622,0,0,,3622,3622
12,03/20/2018,82,20:15,20:30,43.12,,0,43.12,43.12,1,-37365,112619,149984,75254,0,0,1675,0,0,,1675,1675
12,03/20/2018,83,20:30,20:45,43.12,34.03,0,34.03,34.03,-1,-33846,139685,173531,105839,0,-192,68,0,0,,260,-124
12,03/20/2018,84,20:45,21:00,,24.14,0,24.14,24.14,-1,-35519,161534,197053,126015,0,-4029,0,0,0,,4029,-4029
12,03/20/2018,85,21:00,21:15,40.94,12.14,0,40.94,40.94,1,-76548,95544,172092,18996,0,-5386,50,0,0,,5436,-5336
12,03/20/2018,86,21:15,21:30,40.85,30.14,0,30.14,30.14,-1,-55497,106890,162387,51393,0,-680,159,0,0,,839,-521
12,03/20/2018,87,21:30,21:45,,30.14,0,30.14,30.14,-1,-41240,128592,169832,87352,0,-1071,0,0,0,,1071,-1071
12,03/20/2018,88,21:45,22:00,,30.14,0,30.14,30.14,-1,-43910,155508,199418,111598,0,-1884,0,0,0,,1884,-1884
12,03/20/2018,89,22:00,22:15,,24.14,0,24.14,24.14,-1,-113221,87705,200926,-25516,0,-4023,0,0,0,,4023,-4023
12,03/20/2018,90,22:15,22:30,,38.28,0,38.28,38.28,-1,-67649,77624,145273,9975,0,-388,0,0,0,,388,-388
12,03/20/2018,91,22:30,22:45,,40.47,0,40.47,40.47,-1,-43308,99648,142956,56340,0,-2353,0,0,0,,2353,-2353
12,03/20/2018,92,22:45,23:00,,27.58,0,27.58,27.58,-1,-55435,144675,200110,89240,0,-4882,0,0,0,,4882,-4882
12,03/20/2018,93,23:00,23:15,40.54,16.78,0,40.54,16.78,2,-82534,59717,142251,-22817,0,-9771,14,0,0,,9785,-9757
12,03/20/2018,94,23:15,23:30,40.89,34.11,0,40.89,34.11,2,-54934,75081,130015,20147,0,-421,609,0,0,,1030,188
12,03/20/2018,95,23:30,23:45,,24.68,0,24.68,24.68,-1,-49508,99244,148752,49736,0,-3493,0,0,0,,3493,-3493
12,03/20/2018,96,23:45,0:00,,23.53,0,23.53,23.53,-1,-61398,115216,176614,53818,0,-29361,0,0,0,,29361,-29361
12,03/21/2018,1,0:00,0:15,42.14,12.14,0,42.14,42.14,1,-47433,63583,111016,16150,0,-19766,93,0,0,,19859,-19673
12,03/21/2018,2,0:15,0:30,,,0,36.4,36.4,0,-35270,53299,88569,18029,0,0,11,0,0,,11,11
12,03/21/2018,3,0:30,0:45,,36.37,0,36.37,36.37,-1,-31140,70906,102046,39766,0,-432,0,0,0,,432,-432
12,03/21/2018,4,0:45,1:00,,28.53,0,28.53,28.53,-1,-28525,92315,120840,63790,0,-4330,0,0,0,,4330,-4330
12,03/21/2018,5,1:00,1:15,,24.14,0,24.14,24.14,-1,-46650,46555,93205,-95,0,-7882,0,0,0,,7882,-7882
12,03/21/2018,6,1:15,1:30,,,0,36.38,36.38,0,-39248,51184,90432,11936,0,-40,0,0,0,,40,-40
12,03/21/2018,7,1:30,1:45,,,0,36.37,36.37,0,-39652,55249,94901,15597,0,0,0,0,0,,0,0
12,03/21/2018,8,1:45,2:00,,,0,36.37,36.37,0,-39184,76978,116162,37794,0,0,0,0,0,,0,0
12,03/21/2018,9,2:00,2:15,,,0,36.32,36.32,0,-40502,65108,105610,24606,0,0,0,0,0,,0,0
12,03/21/2018,10,2:15,2:30,,,0,36.31,36.31,0,-35453,50993,86446,15540,0,0,0,0,0,,0,0
12,03/21/2018,11,2:30,2:45,,,0,36.32,36.32,0,-35534,52035,87569,16501,0,0,0,0,0,,0,0
12,03/21/2018,12,2:45,3:00,,,0,36.32,36.32,0,-39149,46708,85857,7559,0,0,0,0,0,,0,0
12,03/21/2018,13,3:00,3:15,,,0,36.24,36.24,0,-35376,57658,93034,22282,0,0,0,0,0,,0,0
12,03/21/2018,14,3:15,3:30,38.14,,0,38.14,38.14,1,-41808,44270,86078,2462,0,0,138,0,0,,138,138
12,03/21/2018,15,3:30,3:45,44.28,,0,44.28,44.28,1,-44119,26061,70180,-18058,0,0,6138,0,0,,6138,6138
12,03/21/2018,16,3:45,4:00,48.14,,0,48.14,48.14,1,-51626,22333,73959,-29293,0,0,14459,0,0,,14459,14459
12,03/21/2018,17,4:00,4:15,45.65,,0,45.65,45.65,1,-60372,39291,99663,-21081,0,0,13129,0,0,,13129,13129
12,03/21/2018,18,4:15,4:30,48.14,,0,48.14,48.14,1,-60959,40646,101605,-20313,0,0,22603,0,0,,22603,22603
12,03/21/2018,19,4:30,4:45,48.14,,0,48.14,48.14,1,-64657,29136,93793,-35521,0,0,20734,0,0,,20734,20734
12,03/21/2018,20,4:45,5:00,48.14,,0,48.14,48.14,1,-73428,44655,118083,-28773,0,0,26389,0,0,,26389,26389
12,03/21/2018,21,5:00,5:15,48.14,38.13,0,38.13,38.13,-1,-50049,59223,109272,9174,0,-783,7011,0,0,,7794,6228
12,03/21/2018,22,5:15,5:30,38.14,,0,38.14,38.14,1,-55913,48197,104110,-7716,0,0,705,0,0,,705,705
12,03/21/2018,23,5:30,5:45,45.69,,0,45.69,45.69,1,-47829,36925,84754,-10904,0,0,7280,0,0,,7280,7280
12,03/21/2018,24,5:45,6:00,48.14,,0,48.14,48.14,1,-64784,53145,117929,-11639,0,0,5154,0,0,,5154,5154
12,03/21/2018,25,6:00,6:15,39.75,18.68,0,40.07,18.68,2,-38376,86173,124549,47797,0,-9036,2855,0,0,,11891,-6181
12,03/21/2018,26,6:15,6:30,41.78,34.75,0,41.78,34.75,2,-31657,36992,68649,5335,0,-6521,25,0,0,,6546,-6496
12,03/21/2018,27,6:30,6:45,62.27,34.75,0,62.27,62.27,1,-67590,39801,107391,-27789,0,-394,12722,0,0,,13116,12328
12,03/21/2018,28,6:45,7:00,237.12,,0,237.12,237.12,1,-112097,42573,154670,-69524,0,0,48761,0,0,,48761,48761
12,03/21/2018,29,7:00,7:15,237.12,-78.13,0,-78.13,-78.13,-1,-17458,186006,203464,168548,0,-20560,15417,0,0,,35977,-5143
12,03/21/2018,30,7:15,7:30,,35.79,0,35.79,35.79,-1,-43165,76669,119834,33504,0,-3582,0,0,0,,3582,-3582
12,03/21/2018,31,7:30,7:45,43.75,,0,43.75,43.75,1,-93879,60865,154744,-33014,0,0,659,0,0,,659,659
12,03/21/2018,32,7:45,8:00,157.12,,0,157.12,157.12,1,-127209,55626,182835,-71583,0,0,24317,0,0,,24317,24317
12,03/21/2018,33,8:00,8:15,45.02,,0,45.02,45.02,1,-23991,129953,153944,105962,0,0,9583,0,0,,9583,9583
12,03/21/2018,34,8:15,8:30,,38.87,0,38.87,38.87,-1,-25246,116566,141812,91320,0,-197,0,0,0,,197,-197
12,03/21/2018,35,8:30,8:45,,34.75,0,34.75,34.75,-1,-35306,115027,150333,79721,0,-1296,0,0,0,,1296,-1296
12,03/21/2018,36,8:45,9:00,,4,0,4,4,-1,-57227,109111,166338,51884,0,-24345,0,0,0,,24345,-24345
12,03/21/2018,37,9:00,9:15,,34.75,0,34.75,34.75,-1,-34227,102578,136805,68351,0,-10249,0,0,0,,10249,-10249
12,03/21/2018,38,9:15,9:30,,-6.07,0,-6.07,-6.07,-1,-23291,121570,144861,98279,0,-4741,0,0,0,,4741,-4741
12,03/21/2018,39,9:30,9:45,,-25.66,0,-25.66,-25.66,-1,-54906,129408,184314,74502,0,-51064,0,0,0,,51064,-51064
12,03/21/2018,40,9:45,10:00,,24.75,0,24.75,24.75,-1,-75931,128547,204478,52616,0,-49806,0,0,0,,49806,-49806
12,03/21/2018,41,10:00,10:15,157.33,24.75,0,157.33,157.33,1,-147276,44278,191554,-102998,0,-10060,3078,0,0,,13138,-6982
12,03/21/2018,42,10:15,10:30,,,0,40.54,40.54,0,-101894,66964,168858,-34930,0,0,0,0,0,,0,0
12,03/21/2018,43,10:30,10:45,,,0,40.56,40.56,0,-89802,79043,168845,-10759,0,0,0,0,0,,0,0
12,03/21/2018,44,10:45,11:00,,34.75,0,34.75,34.75,-1,-83498,103572,187070,20074,0,-3210,0,0,0,,3210,-3210
12,03/21/2018,45,11:00,11:15,,,0,40.41,40.41,0,-119807,56563,176370,-63244,0,-431,0,0,0,,431,-431
12,03/21/2018,46,11:15,11:30,,,0,40.42,40.42,0,-113540,67562,181102,-45978,0,0,0,0,0,,0,0
12,03/21/2018,47,11:30,11:45,,,0,40.42,40.42,0,-105306,92900,198206,-12406,0,0,0,0,0,,0,0
12,03/21/2018,48,11:45,12:00,,40.74,0,40.74,40.74,-1,-98207,89834,188041,-8373,0,-339,0,0,0,,339,-339
12,03/21/2018,49,12:00,12:15,,40.47,0,40.47,40.47,-1,-85676,42357,128033,-43319,0,-82,0,0,0,,82,-82
12,03/21/2018,50,12:15,12:30,,,0,40.32,40.32,0,-82933,40329,123262,-42604,0,0,0,0,0,,0,0
12,03/21/2018,51,12:30,12:45,43.75,,0,43.75,43.75,1,-70499,52841,123340,-17658,0,0,2620,0,0,,2620,2620
12,03/21/2018,52,12:45,13:00,39.75,,0,39.75,39.75,1,-58837,60546,119383,1709,0,0,1282,0,0,,1282,1282
12,03/21/2018,53,13:00,13:15,43.75,,0,43.75,43.75,1,-71428,52120,123548,-19308,0,0,1807,0,0,,1807,1807
12,03/21/2018,54,13:15,13:30,39.75,,0,39.75,39.75,1,-72482,46862,119344,-25620,0,0,987,0,0,,987,987
12,03/21/2018,55,13:30,13:45,39.75,,0,39.75,39.75,1,-58503,43473,101976,-15030,0,0,698,0,0,,698,698
12,03/21/2018,56,13:45,14:00,39.75,,0,39.75,39.75,1,-71936,44999,116935,-26937,0,0,1076,0,0,,1076,1076
12,03/21/2018,57,14:00,14:15,49.75,,0,49.75,49.75,1,-107008,44542,151550,-62466,0,0,5863,0,0,,5863,5863
12,03/21/2018,58,14:15,14:30,40.61,,0,40.61,40.61,1,-105004,46232,151236,-58772,0,0,4089,0,0,,4089,4089
12,03/21/2018,59,14:30,14:45,,,0,40.21,40.21,0,-95433,51430,146863,-44003,0,0,0,0,0,,0,0
12,03/21/2018,60,14:45,15:00,,,0,40.21,40.21,0,-74881,49153,124034,-25728,0,0,0,0,0,,0,0
12,03/21/2018,61,15:00,15:15,,26.49,0,26.49,26.49,-1,-49416,77689,127105,28273,0,-6041,0,0,0,,6041,-6041
12,03/21/2018,62,15:15,15:30,,24.75,0,24.75,24.75,-1,-59491,68199,127690,8708,0,-20656,0,0,0,,20656,-20656
12,03/21/2018,63,15:30,15:45,,34.75,0,34.75,34.75,-1,-42523,68188,110711,25665,0,-4888,0,0,0,,4888,-4888
12,03/21/2018,64,15:45,16:00,,-4.44,0,-4.44,-4.44,-1,-34742,86720,121462,51978,0,-10184,0,0,0,,10184,-10184
12,03/21/2018,65,16:00,16:15,,4.7,0,4.7,4.7,-1,-46464,140519,186983,94055,0,-27959,0,0,0,,27959,-27959
12,03/21/2018,66,16:15,16:30,,12.75,0,12.75,12.75,-1,-27237,135695,162932,108458,0,-37500,0,0,0,,37500,-37500
12,03/21/2018,67,16:30,16:45,,24.07,0,24.07,24.07,-1,-25504,106826,132330,81322,0,-26621,0,0,0,,26621,-26621
12,03/21/2018,68,16:45,17:00,,40.88,0,40.88,40.88,-1,-23741,105675,129416,81934,0,-8265,0,0,0,,8265,-8265
12,03/21/2018,69,17:00,17:15,,4.47,0,4.47,4.47,-1,-42278,113780,156058,71502,0,-23318,0,0,0,,23318,-23318
12,03/21/2018,70,17:15,17:30,,35.03,0,35.03,35.03,-1,-36058,69449,105507,33391,0,-12027,0,0,0,,12027,-12027
12,03/21/2018,71,17:30,17:45,,24.75,0,24.75,24.75,-1,-37502,99405,136907,61903,0,-16302,0,0,0,,16302,-16302
12,03/21/2018,72,17:45,18:00,,,0,40.54,40.54,0,-40009,107298,147307,67289,0,-4082,0,0,0,,4082,-4082
12,03/21/2018,73,18:00,18:15,,-10.31,0,-10.31,-10.31,-1,-62554,94352,156906,31798,0,-19936,0,0,0,,19936,-19936
12,03/21/2018,74,18:15,18:30,,21.23,0,21.23,21.23,-1,-59285,109606,168891,50321,0,-42582,0,0,0,,42582,-42582
12,03/21/2018,75,18:30,18:45,,30.36,0,30.36,30.36,-1,-46453,119511,165964,73058,0,-24542,0,0,0,,24542,-24542
12,03/21/2018,76,18:45,19:00,,,0,39.33,39.33,0,-54652,109990,164642,55338,0,-589,0,0,0,,589,-589
12,03/21/2018,77,19:00,19:15,,24.75,0,24.75,24.75,-1,-64321,70242,134563,5921,0,-5696,0,0,0,,5696,-5696
12,03/21/2018,78,19:15,19:30,49.91,24.75,0,49.91,49.91,1,-97948,63020,160968,-34928,0,-189,2695,0,0,,2884,2506
12,03/21/2018,79,19:30,19:45,49.91,34.75,0,34.75,34.75,-1,-67016,74555,141571,7539,0,-551,224,0,0,,775,-327
12,03/21/2018,80,19:45,20:00,,30.75,0,30.75,30.75,-1,-73751,90941,164692,17190,0,-15867,0,0,0,,15867,-15867
12,03/21/2018,81,20:00,20:15,148.02,34.03,0,148.02,34.03,2,-75562,21204,96766,-54358,0,-8229,10416,0,0,,18645,2187
12,03/21/2018,82,20:15,20:30,42.41,12.75,0,12.75,12.75,-1,-36267,69956,106223,33689,0,-6550,3792,0,0,,10342,-2758
12,03/21/2018,83,20:30,20:45,,6.03,0,6.03,6.03,-1,-43115,104569,147684,61454,0,-47278,0,0,0,,47278,-47278
12,03/21/2018,84,20:45,21:00,,3.46,0,3.46,3.46,-1,-39092,121928,161020,82836,0,-76620,0,0,0,,76620,-76620
12,03/21/2018,85,21:00,21:15,42.94,3.46,0,42.94,42.94,1,-59180,55595,114775,-3585,0,-38121,321,0,0,,38442,-37800
12,03/21/2018,86,21:15,21:30,42.94,39.07,0,39.07,39.07,-1,-31041,90043,121084,59002,0,-35,1,0,0,,36,-34
12,03/21/2018,87,21:30,21:45,,30.75,0,30.75,30.75,-1,-25105,143197,168302,118092,0,-984,0,0,0,,984,-984
12,03/21/2018,88,21:45,22:00,,11.97,0,11.97,11.97,-1,-30220,176931,207151,146711,0,-11748,0,0,0,,11748,-11748
12,03/21/2018,89,22:00,22:15,62.27,-52.19,0,62.27,-52.19,2,-69632,60538,130170,-9094,0,-24585,1619,0,0,,26204,-22966
12,03/21/2018,90,22:15,22:30,54.79,5.61,0,5.61,5.61,-1,-27869,73455,101324,45586,0,-12268,1904,0,0,,14172,-10364
12,03/21/2018,91,22:30,22:45,,4.44,0,4.44,4.44,-1,-26998,78893,105891,51895,0,-45229,0,0,0,,45229,-45229
12,03/21/2018,92,22:45,23:00,,19.87,0,19.87,19.87,-1,-44244,101384,145628,57140,0,-51520,0,0,0,,51520,-51520
12,03/21/2018,93,23:00,23:15,31.58,22.1,0,31.58,31.58,1,-41688,50013,91701,8325,0,-25219,120,0,0,,25339,-25099
12,03/21/2018,94,23:15,23:30,31.58,19.87,0,19.87,19.87,-1,-18181,54758,72939,36577,0,-15639,6,0,0,,15645,-15633
12,03/21/2018,95,23:30,23:45,,19.87,0,19.87,19.87,-1,-7927,51386,59313,43459,0,-40299,0,0,0,,40299,-40299
12,03/21/2018,96,23:45,0:00,,16.93,0,16.93,16.93,-1,-35968,85266,121234,49298,0,-52536,0,0,0,,52536,-52536
12,03/22/2018,1,0:00,0:15,239.12,16.93,0,239.12,239.12,1,-95877,32002,127879,-63875,0,-18060,16563,0,0,,34623,-1497
12,03/22/2018,2,0:15,0:30,239.12,13.74,0,13.74,13.74,-1,-25919,48069,73988,22150,0,-1809,25748,0,0,,27557,23939
12,03/22/2018,3,0:30,0:45,239.12,-25.67,0,-25.67,-25.67,-1,-37083,83797,120880,46714,0,-40545,24,0,0,,40569,-40521
12,03/22/2018,4,0:45,1:00,,11.9,0,11.9,11.9,-1,-40815,115030,155845,74215,0,-49527,0,0,0,,49527,-49527
12,03/22/2018,5,1:00,1:15,53.71,25.74,0,53.71,53.71,1,-76132,61860,137992,-14272,0,-30594,1098,0,0,,31692,-29496
12,03/22/2018,6,1:15,1:30,55.08,31.74,0,55.08,31.74,2,-49049,61991,111040,12942,0,-1545,5385,0,0,,6930,3840
12,03/22/2018,7,1:30,1:45,55.08,25.57,0,25.57,25.57,-1,-29496,58661,88157,29165,0,-24727,19,0,0,,24746,-24708
12,03/22/2018,8,1:45,2:00,,32.89,0,32.89,32.89,-1,-34343,63855,98198,29512,0,-31725,0,0,0,,31725,-31725
12,03/22/2018,9,2:00,2:15,43.74,29.87,0,43.74,43.74,1,-52044,88879,140923,36835,0,-17702,271,0,0,,17973,-17431
12,03/22/2018,10,2:15,2:30,43.74,32.31,0,32.31,32.31,-1,-46356,67034,113390,20678,0,-304,310,0,0,,614,6
12,03/22/2018,11,2:30,2:45,,19.87,0,19.87,19.87,-1,-28251,79012,107263,50761,0,-6499,0,0,0,,6499,-6499
12,03/22/2018,12,2:45,3:00,,7.87,0,7.87,7.87,-1,-31502,87748,119250,56246,0,-44092,0,0,0,,44092,-44092
12,03/22/2018,13,3:00,3:15,39.74,24.83,0,39.74,39.74,1,-64582,70333,134915,5751,0,-27476,769,0,0,,28245,-26707
12,03/22/2018,14,3:15,3:30,39.74,18.05,0,18.05,18.05,-1,-44114,73379,117493,29265,0,-9479,308,0,0,,9787,-9171
12,03/22/2018,15,3:30,3:45,,16.6,0,16.6,16.6,-1,-37144,63604,100748,26460,0,-32608,0,0,0,,32608,-32608
12,03/22/2018,16,3:45,4:00,,14.65,0,14.65,14.65,-1,-33485,91407,124892,57922,0,-30882,0,0,0,,30882,-30882
12,03/22/2018,17,4:00,4:15,,35.74,0,35.74,35.74,-1,-70369,56464,126833,-13905,0,-14944,0,0,0,,14944,-14944
12,03/22/2018,18,4:15,4:30,,37.9,0,37.9,37.9,-1,-53901,65935,119836,12034,0,-423,0,0,0,,423,-423
12,03/22/2018,19,4:30,4:45,,34.44,0,34.44,34.44,-1,-52741,62279,115020,9538,0,-4366,0,0,0,,4366,-4366
12,03/22/2018,20,4:45,5:00,,35.7,0,35.7,35.7,-1,-57044,49737,106781,-7307,0,-1836,0,0,0,,1836,-1836
12,03/22/2018,21,5:00,5:15,,19.54,0,19.54,19.54,-1,-24318,109045,133363,84727,0,-18614,0,0,0,,18614,-18614
12,03/22/2018,22,5:15,5:30,,13.74,0,13.74,13.74,-1,-21010,76368,97378,55358,0,-31232,0,0,0,,31232,-31232
12,03/22/2018,23,5:30,5:45,,25.74,0,25.74,25.74,-1,-34442,52588,87030,18146,0,-27353,0,0,0,,27353,-27353
12,03/22/2018,24,5:45,6:00,43.74,25.74,0,43.74,43.74,1,-59189,57755,116944,-1434,0,-1440,393,0,0,,1833,-1047
12,03/22/2018,25,6:00,6:15,,12.76,0,12.76,12.76,-1,-35138,111057,146195,75919,0,-17710,0,0,0,,17710,-17710
12,03/22/2018,26,6:15,6:30,,32.49,0,32.49,32.49,-1,-33122,67094,100216,33972,0,-21317,0,0,0,,21317,-21317
12,03/22/2018,27,6:30,6:45,40.49,36.49,0,40.49,40.49,1,-67096,44853,111949,-22243,0,-9099,432,0,0,,9531,-8667
12,03/22/2018,28,6:45,7:00,40.49,36.49,0,40.49,36.25,2,-97249,91674,188923,-5575,0,-67,2199,0,0,,2266,2132
12,03/22/2018,29,7:00,7:15,40.49,-102.44,0,-102.44,-102.44,-1,-52241,130932,183173,78691,0,-32424,56,0,0,,32480,-32368
12,03/22/2018,30,7:15,7:30,40.49,36.44,0,40.49,36.44,2,-49379,52385,101764,3006,0,-14069,24,0,0,,14093,-14045
12,03/22/2018,31,7:30,7:45,324.22,36.44,0,324.22,324.22,1,-114885,30223,145108,-84662,0,-1006,23888,0,0,,24894,22882
12,03/22/2018,32,7:45,8:00,143.12,,0,143.12,143.12,1,-143863,46947,190810,-96916,0,0,69622,0,0,,69622,69622
12,03/22/2018,33,8:00,8:15,44.12,-21.37,0,44.12,-21.37,2,-29942,71664,101606,41722,0,-10382,21312,0,0,,31694,10930
12,03/22/2018,34,8:15,8:30,143.12,-21.37,0,143.12,143.12,1,-72643,45031,117674,-27612,0,-744,11699,0,0,,12443,10955
12,03/22/2018,35,8:30,8:45,70.12,,0,70.12,70.12,1,-95396,73001,168397,-22395,0,0,3408,0,0,,3408,3408
12,03/22/2018,36,8:45,9:00,142.12,,0,142.12,142.12,1,-108339,45304,153643,-63035,0,0,45419,0,0,,45419,45419
12,03/22/2018,37,9:00,9:15,46.27,35.89,0,35.89,35.89,-1,-43738,89729,133467,45991,0,-1381,18517,0,0,,19898,17136
12,03/22/2018,38,9:15,9:30,79.12,34.05,0,79.12,79.12,1,-67603,56444,124047,-11159,0,-1684,5391,0,0,,7075,3707
12,03/22/2018,39,9:30,9:45,96.12,,0,96.12,96.12,1,-65907,54086,119993,-11821,0,0,23530,0,0,,23530,23530
12,03/22/2018,40,9:45,10:00,45.48,,0,45.48,45.48,1,-67630,57828,125458,-9802,0,0,15815,0,0,,15815,15815
12,03/22/2018,41,10:00,10:15,44.12,22.88,0,44.12,22.88,2,-58273,98329,156602,40056,0,-8487,7304,0,0,,15791,-1183
12,03/22/2018,42,10:15,10:30,,37.78,0,37.78,37.78,-1,-57854,80891,138745,23037,0,-8529,0,0,0,,8529,-8529
12,03/22/2018,43,10:30,10:45,,38.78,0,38.78,38.78,-1,-53713,78734,132447,25021,0,-4104,0,0,0,,4104,-4104
12,03/22/2018,44,10:45,11:00,,31.65,0,31.65,31.65,-1,-43455,93814,137269,50359,0,-15054,0,0,0,,15054,-15054
12,03/22/2018,45,11:00,11:15,,14.01,0,14.01,14.01,-1,-29696,107232,136928,77536,0,-48504,0,0,0,,48504,-48504
12,03/22/2018,46,11:15,11:30,,25.99,0,25.99,25.99,-1,-43115,107694,150809,64579,0,-54201,0,0,0,,54201,-54201
12,03/22/2018,47,11:30,11:45,,31.43,0,31.43,31.43,-1,-44676,109109,153785,64433,0,-52944,0,0,0,,52944,-52944
12,03/22/2018,48,11:45,12:00,,35.57,0,35.57,35.57,-1,-28386,98632,127018,70246,0,-37260,0,0,0,,37260,-37260
12,03/22/2018,49,12:00,12:15,,26.49,0,26.49,26.49,-1,-43352,94202,137554,50850,0,-29434,0,0,0,,29434,-29434
12,03/22/2018,50,12:15,12:30,,26.49,0,26.49,26.49,-1,-43161,87587,130748,44426,0,-45715,0,0,0,,45715,-45715
12,03/22/2018,51,12:30,12:45,,19.97,0,19.97,19.97,-1,-47384,133790,181174,86406,0,-41324,0,0,0,,41324,-41324
12,03/22/2018,52,12:45,13:00,,11.29,0,11.29,11.29,-1,-32313,174882,207195,142569,0,-11523,0,0,0,,11523,-11523
12,03/22/2018,53,13:00,13:15,,37.78,0,37.78,37.78,-1,-35506,175645,211151,140139,0,-4335,0,0,0,,4335,-4335
12,03/22/2018,54,13:15,13:30,,,0,41.56,41.56,0,-31916,170877,202793,138961,0,0,0,0,0,,0,0
12,03/22/2018,55,13:30,13:45,,31.65,0,31.65,31.65,-1,-34879,147549,182428,112670,0,-2521,0,0,0,,2521,-2521
12,03/22/2018,56,13:45,14:00,44.49,14.49,0,44.49,14.49,2,-55765,101020,156785,45255,0,-26206,41,0,0,,26247,-26165
12,03/22/2018,57,14:00,14:15,44.8,14.49,0,44.8,44.8,1,-37677,150748,188425,113071,0,-868,390,0,0,,1258,-478
12,03/22/2018,58,14:15,14:30,,,0,37.44,37.44,0,-28301,139227,167528,110926,0,0,0,0,0,,0,0
12,03/22/2018,59,14:30,14:45,,,0,37.44,37.44,0,-26903,112627,139530,85724,0,0,0,0,0,,0,0
12,03/22/2018,60,14:45,15:00,,14.49,0,14.49,14.49,-1,-29617,126184,155801,96567,0,-4163,0,0,0,,4163,-4163
12,03/22/2018,61,15:00,15:15,,-11.02,0,-11.02,-11.02,-1,-49900,110905,160805,61005,0,-38474,0,0,0,,38474,-38474
12,03/22/2018,62,15:15,15:30,,40.36,0,40.36,40.36,-1,-37925,98423,136348,60498,0,-5669,0,0,0,,5669,-5669
12,03/22/2018,63,15:30,15:45,,,0,37.43,37.43,0,-42755,89279,132034,46524,0,0,0,0,0,,0,0
12,03/22/2018,64,15:45,16:00,,,0,37.43,37.43,0,-40274,75827,116101,35553,0,0,0,0,0,,0,0
12,03/22/2018,65,16:00,16:15,,15.91,0,15.91,15.91,-1,-47694,165235,212929,117541,0,-18621,0,0,0,,18621,-18621
12,03/22/2018,66,16:15,16:30,,36.49,0,36.49,36.49,-1,-51985,114492,166477,62507,0,-11037,0,0,0,,11037,-11037
12,03/22/2018,67,16:30,16:45,,,0,37.52,37.52,0,-38770,118228,156998,79458,0,-6,0,0,0,,6,-6
12,03/22/2018,68,16:45,17:00,,,0,37.53,37.53,0,-37634,71855,109489,34221,0,0,0,0,0,,0,0
12,03/22/2018,69,17:00,17:15,,14.49,0,14.49,14.49,-1,-45310,137914,183224,92604,0,-11760,0,0,0,,11760,-11760
12,03/22/2018,70,17:15,17:30,,42.86,0,42.86,42.86,-1,-34789,97082,131871,62293,0,-2542,0,0,0,,2542,-2542
12,03/22/2018,71,17:30,17:45,,,0,41.67,41.67,0,-38722,94987,133709,56265,0,0,0,0,0,,0,0
12,03/22/2018,72,17:45,18:00,,,0,41.59,41.59,0,-46930,107178,154108,60248,0,0,0,0,0,,0,0
12,03/22/2018,73,18:00,18:15,,32.49,0,32.49,32.49,-1,-53599,78207,131806,24608,0,-3108,0,0,0,,3108,-3108
12,03/22/2018,74,18:15,18:30,,37.78,0,37.78,37.78,-1,-44494,83007,127501,38513,0,-1979,0,0,0,,1979,-1979
12,03/22/2018,75,18:30,18:45,,,0,41.63,41.63,0,-59197,77940,137137,18743,0,-5,0,0,0,,5,-5
12,03/22/2018,76,18:45,19:00,65.12,,0,65.12,65.12,1,-76316,55727,132043,-20589,0,0,13101,0,0,,13101,13101
12,03/22/2018,77,19:00,19:15,54.46,37.93,0,37.93,37.93,-1,-25347,69089,94436,43742,0,-269,8844,0,0,,9113,8575
12,03/22/2018,78,19:15,19:30,,37.01,0,37.01,37.01,-1,-61467,60330,121797,-1137,0,-1651,0,0,0,,1651,-1651
12,03/22/2018,79,19:30,19:45,,42.4,0,42.4,42.4,-1,-62159,68920,131079,6761,0,-137,0,0,0,,137,-137
12,03/22/2018,80,19:45,20:00,,36.49,0,36.49,36.49,-1,-62441,77940,140381,15499,0,-8262,0,0,0,,8262,-8262
12,03/22/2018,81,20:00,20:15,190.55,36.49,0,190.55,190.55,1,-92007,42088,134095,-49919,0,-881,25789,0,0,,26670,24908
12,03/22/2018,82,20:15,20:30,45.49,36.5,0,36.5,36.5,-1,-45695,46520,92215,825,0,-500,6021,0,0,,6521,5521
12,03/22/2018,83,20:30,20:45,,36.49,0,36.49,36.49,-1,-45787,45476,91263,-311,0,-1035,0,0,0,,1035,-1035
12,03/22/2018,84,20:45,21:00,,26.49,0,26.49,26.49,-1,-40907,87624,128531,46717,0,-19324,0,0,0,,19324,-19324
12,03/22/2018,85,21:00,21:15,269.12,36.78,0,269.12,36.78,2,-86338,36340,122678,-49998,0,-7675,11983,0,0,,19658,4308
12,03/22/2018,86,21:15,21:30,44.49,37.43,0,37.43,37.43,-1,-45533,57068,102601,11535,0,-504,4432,0,0,,4936,3928
12,03/22/2018,87,21:30,21:45,,26.75,0,26.75,26.75,-1,-42600,88842,131442,46242,0,-9442,0,0,0,,9442,-9442
12,03/22/2018,88,21:45,22:00,,19.22,0,19.22,19.22,-1,-50403,107178,157581,56775,0,-47167,0,0,0,,47167,-47167
12,03/22/2018,89,22:00,22:15,40.49,17.2,0,40.49,17.2,2,-131663,24853,156516,-106810,0,-32676,41,0,0,,32717,-32635
12,03/22/2018,90,22:15,22:30,44.49,37.86,0,44.49,37.54,2,-57428,34359,91787,-23069,0,-476,429,0,0,,905,-47
12,03/22/2018,91,22:30,22:45,,36.49,0,36.49,36.49,-1,-46231,71378,117609,25147,0,-5197,0,0,0,,5197,-5197
12,03/22/2018,92,22:45,23:00,,29.5,0,29.5,29.5,-1,-55271,114024,169295,58753,0,-27568,0,0,0,,27568,-27568
12,03/22/2018,93,23:00,23:15,40.49,34.6,0,40.49,40.49,1,-72376,66110,138486,-6266,0,-21660,156,0,0,,21816,-21504
12,03/22/2018,94,23:15,23:30,40.49,26.49,0,40.49,26.49,2,-43890,73870,117760,29980,0,-5330,296,0,0,,5626,-5034
12,03/22/2018,95,23:30,23:45,,26.49,0,26.49,26.49,-1,-45851,79906,125757,34055,0,-22796,0,0,0,,22796,-22796
12,03/22/2018,96,23:45,0:00,,,0,37.27,37.27,0,-45106,112912,158018,67806,0,-5150,0,0,0,,5150,-5150
12,03/23/2018,1,0:00,0:15,40.81,,0,40.81,40.81,1,-35677,52982,88659,17305,0,0,62,0,0,,62,62
12,03/23/2018,2,0:15,0:30,,,0,40.85,40.85,0,-23713,60146,83859,36433,0,0,0,0,0,,0,0
12,03/23/2018,3,0:30,0:45,,,0,40.6,40.6,0,-26314,84543,110857,58229,0,0,0,0,0,,0,0
12,03/23/2018,4,0:45,1:00,,14.81,0,14.81,14.81,-1,-29776,112127,141903,82351,0,-5077,0,0,0,,5077,-5077
12,03/23/2018,5,1:00,1:15,44.81,-1.4,0,44.81,-1.4,2,-34972,35407,70379,435,0,-9574,1031,0,0,,10605,-8543
12,03/23/2018,6,1:15,1:30,40.25,,0,40.25,40.25,1,-36646,41655,78301,5009,0,0,533,0,0,,533,533
12,03/23/2018,7,1:30,1:45,40.16,,0,40.16,40.16,1,-33117,47498,80615,14381,0,0,455,0,0,,455,455
12,03/23/2018,8,1:45,2:00,,,0,40.26,40.26,0,-34737,78410,113147,43673,0,0,2,0,0,,2,2
12,03/23/2018,9,2:00,2:15,,,0,40.31,40.31,0,-29887,68143,98030,38256,0,0,0,0,0,,0,0
12,03/23/2018,10,2:15,2:30,,,0,40.31,40.31,0,-22452,67304,89756,44852,0,0,0,0,0,,0,0
12,03/23/2018,11,2:30,2:45,,35.4,0,35.4,35.4,-1,-24694,77674,102368,52980,0,-213,0,0,0,,213,-213
12,03/23/2018,12,2:45,3:00,,14.81,0,14.81,14.81,-1,-28370,83257,111627,54887,0,-26270,0,0,0,,26270,-26270
12,03/23/2018,13,3:00,3:15,,26.81,0,26.81,26.81,-1,-21602,62673,84275,41071,0,-21062,0,0,0,,21062,-21062
12,03/23/2018,14,3:15,3:30,,22.58,0,22.58,22.58,-1,-29285,70985,100270,41700,0,-3494,0,0,0,,3494,-3494
12,03/23/2018,15,3:30,3:45,,14.81,0,14.81,14.81,-1,-37114,71535,108649,34421,0,-17160,0,0,0,,17160,-17160
12,03/23/2018,16,3:45,4:00,,32.81,0,32.81,32.81,-1,-39066,74019,113085,34953,0,-17845,0,0,0,,17845,-17845
12,03/23/2018,17,4:00,4:15,,34.75,0,34.75,34.75,-1,-42074,61932,104006,19858,0,-16917,0,0,0,,16917,-16917
12,03/23/2018,18,4:15,4:30,,34.73,0,34.73,34.73,-1,-43517,50400,93917,6883,0,-10588,0,0,0,,10588,-10588
12,03/23/2018,19,4:30,4:45,,35.15,0,35.15,35.15,-1,-43050,59911,102961,16861,0,-4133,0,0,0,,4133,-4133
12,03/23/2018,20,4:45,5:00,,36.6,0,36.6,36.6,-1,-43705,64276,107981,20571,0,-8877,0,0,0,,8877,-8877
12,03/23/2018,21,5:00,5:15,,26.81,0,26.81,26.81,-1,-38648,75131,113779,36483,0,-21277,0,0,0,,21277,-21277
12,03/23/2018,22,5:15,5:30,,35.15,0,35.15,35.15,-1,-33033,69468,102501,36435,0,-17116,0,0,0,,17116,-17116
12,03/23/2018,23,5:30,5:45,40.81,35.15,0,40.81,40.81,1,-41434,58077,99511,16643,0,-2705,100,0,0,,2805,-2605
12,03/23/2018,24,5:45,6:00,40.81,32.81,0,40.81,32.81,2,-53598,64099,117697,10501,0,-84,876,0,0,,960,792
12,03/23/2018,25,6:00,6:15,,-106.67,0,-106.67,-106.67,-1,-46165,117918,164083,71753,0,-26154,0,0,0,,26154,-26154
12,03/23/2018,26,6:15,6:30,,39.97,0,39.97,39.97,-1,-37730,96846,134576,59116,0,-1987,0,0,0,,1987,-1987
12,03/23/2018,27,6:30,6:45,,52.38,0,52.38,52.38,-1,-46708,78711,125419,32003,0,-1732,0,0,0,,1732,-1732
12,03/23/2018,28,6:45,7:00,,,0,46.53,46.53,0,-74416,68534,142950,-5882,0,-116,0,0,0,,116,-116
12,03/23/2018,29,7:00,7:15,,14.16,0,14.16,14.16,-1,-47286,142818,190104,95532,0,-5969,0,0,0,,5969,-5969
12,03/23/2018,30,7:15,7:30,,,0,46.47,46.47,0,-23537,65894,89431,42357,0,-46,0,0,0,,46,-46
12,03/23/2018,31,7:30,7:45,,,0,46.42,46.42,0,-42439,65621,108060,23182,0,0,0,0,0,,0,0
12,03/23/2018,32,7:45,8:00,108.66,,0,108.66,108.66,1,-89772,50248,140020,-39524,0,0,11991,0,0,,11991,11991
12,03/23/2018,33,8:00,8:15,50.42,,0,50.42,50.42,1,-63644,43160,106804,-20484,0,0,18754,0,0,,18754,18754
12,03/23/2018,34,8:15,8:30,50.42,,0,50.42,50.42,1,-71319,40075,111394,-31244,0,0,23505,0,0,,23505,23505
12,03/23/2018,35,8:30,8:45,44.16,,0,44.16,44.16,1,-68431,49651,118082,-18780,0,0,21761,0,0,,21761,21761
12,03/23/2018,36,8:45,9:00,53.02,,0,53.02,53.02,1,-81693,43031,124724,-38662,0,0,23988,0,0,,23988,23988
12,03/23/2018,37,9:00,9:15,45.6,,0,45.6,45.6,1,-71752,55525,127277,-16227,0,0,17589,0,0,,17589,17589
12,03/23/2018,38,9:15,9:30,,,0,47.13,47.13,0,-64548,50406,114954,-14142,0,0,603,0,0,,603,603
12,03/23/2018,39,9:30,9:45,,39.66,0,39.66,39.66,-1,-56450,60843,117293,4393,0,-753,0,0,0,,753,-753
12,03/23/2018,40,9:45,10:00,,36.16,0,36.16,36.16,-1,-51191,82219,133410,31028,0,-10308,0,0,0,,10308,-10308
12,03/23/2018,41,10:00,10:15,40.16,54.41,0,40.16,40.16,1,-113795,67718,181513,-46077,0,-4214,206,0,0,,4420,-4008
12,03/23/2018,42,10:15,10:30,40.16,,0,40.16,40.16,1,-74110,80677,154787,6567,0,0,343,0,0,,343,343
12,03/23/2018,43,10:30,10:45,,38.39,0,38.39,38.39,-1,-62156,102494,164650,40338,0,-1365,0,0,0,,1365,-1365
12,03/23/2018,44,10:45,11:00,,24.26,0,24.26,24.26,-1,-64892,110321,175213,45429,0,-21200,0,0,0,,21200,-21200
12,03/23/2018,45,11:00,11:15,237.02,38.56,0,237.02,38.56,2,-131755,71352,203107,-60403,0,-7941,15297,0,0,,23238,7356
12,03/23/2018,46,11:15,11:30,50.16,,0,50.16,50.16,1,-115839,110119,225958,-5720,0,0,12179,0,0,,12179,12179
12,03/23/2018,47,11:30,11:45,,,0,47.31,47.31,0,-118941,112764,231705,-6177,0,0,0,0,0,,0,0
12,03/23/2018,48,11:45,12:00,,,0,47.34,47.34,0,-131890,118129,250019,-13761,0,0,0,0,0,,0,0
12,03/23/2018,49,12:00,12:15,58.88,,0,58.88,58.88,1,-147823,84481,232304,-63342,0,0,3369,0,0,,3369,3369
12,03/23/2018,50,12:15,12:30,,,0,47.07,47.07,0,-156168,94783,250951,-61385,0,0,172,0,0,,172,172
12,03/23/2018,51,12:30,12:45,78.02,,0,78.02,78.02,1,-147733,84801,232534,-62932,0,0,11499,0,0,,11499,11499
12,03/23/2018,52,12:45,13:00,41.3,,0,41.3,41.3,1,-153548,69817,223365,-83731,0,0,7503,0,0,,7503,7503
12,03/23/2018,53,13:00,13:15,237.02,,0,237.02,237.02,1,-129350,71611,200961,-57739,0,0,33844,0,0,,33844,33844
12,03/23/2018,54,13:15,13:30,65.76,,0,65.76,65.76,1,-110323,73864,184187,-36459,0,0,40581,0,0,,40581,40581
12,03/23/2018,55,13:30,13:45,,,0,47.21,47.21,0,-119753,69026,188779,-50727,0,0,5550,0,0,,5550,5550
12,03/23/2018,56,13:45,14:00,,,0,47.22,47.22,0,-138400,50543,188943,-87857,0,0,0,0,0,,0,0
12,03/23/2018,57,14:00,14:15,237.02,,0,237.02,237.02,1,-125051,56451,181502,-68600,0,0,20818,0,0,,20818,20818
12,03/23/2018,58,14:15,14:30,69.02,,0,69.02,69.02,1,-128955,64108,193063,-64847,0,0,61296,0,0,,61296,61296
12,03/23/2018,59,14:30,14:45,62.56,,0,62.56,62.56,1,-128153,57947,186100,-70206,0,0,47243,0,0,,47243,47243
12,03/23/2018,60,14:45,15:00,141.02,,0,141.02,141.02,1,-132232,45156,177388,-87076,0,0,41325,0,0,,41325,41325
12,03/23/2018,61,15:00,15:15,50.16,,0,50.16,50.16,1,-85431,61423,146854,-24008,0,0,26367,0,0,,26367,26367
12,03/23/2018,62,15:15,15:30,62.16,,0,62.16,62.16,1,-88052,38806,126858,-49246,0,0,30055,0,0,,30055,30055
12,03/23/2018,63,15:30,15:45,62.16,,0,62.16,62.16,1,-99403,39314,138717,-60089,0,0,28872,0,0,,28872,28872
12,03/23/2018,64,15:45,16:00,78.02,,0,78.02,78.02,1,-115197,35590,150787,-79607,0,0,42193,0,0,,42193,42193
12,03/23/2018,65,16:00,16:15,62.16,,0,62.16,62.16,1,-81711,65262,146973,-16449,0,0,31891,0,0,,31891,31891
12,03/23/2018,66,16:15,16:30,41.78,,0,41.78,41.78,1,-94206,50807,145013,-43399,0,0,16630,0,0,,16630,16630
12,03/23/2018,67,16:30,16:45,237.02,,0,237.02,237.02,1,-106058,35511,141569,-70547,0,0,31305,0,0,,31305,31305
12,03/23/2018,68,16:45,17:00,237.02,,0,237.02,237.02,1,-101336,41752,143088,-59584,0,0,55011,0,0,,55011,55011
12,03/23/2018,69,17:00,17:15,41.93,,0,41.93,41.93,1,-63869,51326,115195,-12543,0,0,20527,0,0,,20527,20527
12,03/23/2018,70,17:15,17:30,40.6,,0,40.6,40.6,1,-70463,45726,116189,-24737,0,0,557,0,0,,557,557
12,03/23/2018,71,17:30,17:45,62.16,,0,62.16,62.16,1,-71235,35889,107124,-35346,0,0,13497,0,0,,13497,13497
12,03/23/2018,72,17:45,18:00,253.02,,0,253.02,253.02,1,-82968,41296,124264,-41672,0,0,40383,0,0,,40383,40383
12,03/23/2018,73,18:00,18:15,78.02,37.37,0,37.37,37.37,-1,-68704,43928,112632,-24776,0,-257,29130,0,0,,29387,28873
12,03/23/2018,74,18:15,18:30,78.02,36.03,0,36.03,36.03,-1,-30105,59180,89285,29075,0,-6741,285,0,0,,7026,-6456
12,03/23/2018,75,18:30,18:45,,38.35,0,38.35,38.35,-1,-33383,73571,106954,40188,0,-5445,0,0,0,,5445,-5445
12,03/23/2018,76,18:45,19:00,40.16,38.35,0,40.16,40.16,1,-42139,65432,107571,23293,0,-870,228,0,0,,1098,-642
12,03/23/2018,77,19:00,19:15,40.16,,0,40.16,40.16,1,-45573,73300,118873,27727,0,0,750,0,0,,750,750
12,03/23/2018,78,19:15,19:30,40.16,,0,40.16,40.16,1,-57338,58177,115515,839,0,0,1623,0,0,,1623,1623
12,03/23/2018,79,19:30,19:45,40.16,38.99,0,47.17,38.99,2,-47488,59493,106981,12005,0,-163,1020,0,0,,1183,857
12,03/23/2018,80,19:45,20:00,,38.1,0,38.1,38.1,-1,-43182,57655,100837,14473,0,-1438,0,0,0,,1438,-1438
12,03/23/2018,81,20:00,20:15,,53.69,0,53.69,53.69,-1,-45940,59092,105032,13152,0,-1281,0,0,0,,1281,-1281
12,03/23/2018,82,20:15,20:30,,,0,47.05,47.05,0,-40075,65972,106047,25897,0,-71,0,0,0,,71,-71
12,03/23/2018,83,20:30,20:45,,26.16,0,26.16,26.16,-1,-32606,76338,108944,43732,0,-4681,0,0,0,,4681,-4681
12,03/23/2018,84,20:45,21:00,,24.53,0,24.53,24.53,-1,-37662,85209,122871,47547,0,-20783,0,0,0,,20783,-20783
12,03/23/2018,85,21:00,21:15,222.02,36.16,0,222.02,222.02,1,-80851,38577,119428,-42274,0,-11255,12950,0,0,,24205,1695
12,03/23/2018,86,21:15,21:30,50.16,36.16,0,50.16,50.16,1,-48998,46731,95729,-2267,0,-6,14866,0,0,,14872,14860
12,03/23/2018,87,21:30,21:45,,,0,47.27,47.27,0,-36120,52041,88161,15921,0,0,187,0,0,,187,187
12,03/23/2018,88,21:45,22:00,,,0,46.76,46.76,0,-63208,60597,123805,-2611,0,0,0,0,0,,0,0
12,03/23/2018,89,22:00,22:15,,,0,43.75,43.75,0,-90951,29929,120880,-61022,0,0,0,0,0,,0,0
12,03/23/2018,90,22:15,22:30,,38.89,0,38.89,38.89,-1,-66045,34961,101006,-31084,0,-154,0,0,0,,154,-154
12,03/23/2018,91,22:30,22:45,33.02,39.19,0,33.02,33.02,1,-51353,38394,89747,-12959,0,-252,7,0,0,,259,-245
12,03/23/2018,92,22:45,23:00,33.02,40.7,0,40.7,40.7,-1,-47344,51865,99209,4521,0,-15,85,0,0,,100,70
12,03/23/2018,93,23:00,23:15,,36.16,0,36.16,36.16,-1,-58660,47079,105739,-11581,0,-309,0,0,0,,309,-309
12,03/23/2018,94,23:15,23:30,,,0,36.73,36.73,0,-61811,29245,91056,-32566,0,0,0,0,0,,0,0
12,03/23/2018,95,23:30,23:45,,,0,36.74,36.74,0,-62830,43639,106469,-19191,0,0,0,0,0,,0,0
12,03/23/2018,96,23:45,0:00,,36.16,0,36.16,36.16,-1,-66850,62433,129283,-4417,0,-496,0,0,0,,496,-496
13,03/24/2018,1,0:00,0:15,,36.02,0,36.02,36.02,-1,-43331,75411,118742,32080,0,-675,0,0,0,,675,-675
13,03/24/2018,2,0:15,0:30,,40.56,0,40.56,40.56,-1,-42322,68506,110828,26184,0,-6,0,0,0,,6,-6
13,03/24/2018,3,0:30,0:45,,32.02,0,32.02,32.02,-1,-35990,83124,119114,47134,0,-2262,0,0,0,,2262,-2262
13,03/24/2018,4,0:45,1:00,,26.02,0,26.02,26.02,-1,-49220,92885,142105,43665,0,-8303,0,0,0,,8303,-8303
13,03/24/2018,5,1:00,1:15,,35.78,0,35.78,35.78,-1,-74466,101214,175680,26748,0,-9062,0,0,0,,9062,-9062
13,03/24/2018,6,1:15,1:30,40.02,35.78,0,40.02,40.02,1,-61117,65992,127109,4875,0,-230,321,0,0,,551,91
13,03/24/2018,7,1:30,1:45,,,0,35.72,35.72,0,-59840,66216,126056,6376,0,0,0,0,0,,0,0
13,03/24/2018,8,1:45,2:00,,,0,35.73,35.73,0,-56586,66008,122594,9422,0,0,0,0,0,,0,0
13,03/24/2018,9,2:00,2:15,,,0,35.54,35.54,0,-45908,82717,128625,36809,0,0,0,0,0,,0,0
13,03/24/2018,10,2:15,2:30,,,0,35.54,35.54,0,-44929,81789,126718,36860,0,0,0,0,0,,0,0
13,03/24/2018,11,2:30,2:45,,,0,35.54,35.54,0,-45740,79893,125633,34153,0,0,0,0,0,,0,0
13,03/24/2018,12,2:45,3:00,,,0,35.54,35.54,0,-42078,76121,118199,34043,0,0,0,0,0,,0,0
13,03/24/2018,13,3:00,3:15,31.25,,0,31.25,31.25,1,-39153,51981,91134,12828,0,0,27,0,0,,27,27
13,03/24/2018,14,3:15,3:30,44.02,,0,44.02,44.02,1,-52576,35853,88429,-16723,0,0,7967,0,0,,7967,7967
13,03/24/2018,15,3:30,3:45,41.43,,0,41.43,41.43,1,-51122,37989,89111,-13133,0,0,13791,0,0,,13791,13791
13,03/24/2018,16,3:45,4:00,42.72,,0,42.72,42.72,1,-46787,25221,72008,-21566,0,0,12664,0,0,,12664,12664
13,03/24/2018,17,4:00,4:15,40.52,,0,40.52,40.52,1,-40438,32250,72688,-8188,0,0,7075,0,0,,7075,7075
13,03/24/2018,18,4:15,4:30,45.51,,0,45.51,45.51,1,-48223,27778,76001,-20445,0,0,14217,0,0,,14217,14217
13,03/24/2018,19,4:30,4:45,40.02,,0,40.02,40.02,1,-42801,26219,69020,-16582,0,0,6994,0,0,,6994,6994
13,03/24/2018,20,4:45,5:00,,,0,35.55,35.55,0,-42121,28236,70357,-13885,0,0,189,0,0,,189,189
13,03/24/2018,21,5:00,5:15,,,0,35.57,35.57,0,-38866,28038,66904,-10828,0,0,0,0,0,,0,0
13,03/24/2018,22,5:15,5:30,,,0,35.57,35.57,0,-32064,27634,59698,-4430,0,0,0,0,0,,0,0
13,03/24/2018,23,5:30,5:45,,,0,35.59,35.59,0,-37857,16335,54192,-21522,0,0,0,0,0,,0,0
13,03/24/2018,24,5:45,6:00,33.12,,0,33.12,33.12,1,-49666,16454,66120,-33212,0,0,89,0,0,,89,89
13,03/24/2018,25,6:00,6:15,40.02,,0,40.02,40.02,1,-24892,30273,55165,5381,0,0,1714,0,0,,1714,1714
13,03/24/2018,26,6:15,6:30,40.02,,0,40.02,40.02,1,-44952,32078,77030,-12874,0,0,2423,0,0,,2423,2423
13,03/24/2018,27,6:30,6:45,40.52,,0,40.52,40.52,1,-43898,35177,79075,-8721,0,0,3678,0,0,,3678,3678
13,03/24/2018,28,6:45,7:00,51.12,,0,51.12,51.12,1,-58686,26403,85089,-32283,0,0,14665,0,0,,14665,14665
13,03/24/2018,29,7:00,7:15,40.02,,0,40.02,40.02,1,-42678,43817,86495,1139,0,0,7291,0,0,,7291,7291
13,03/24/2018,30,7:15,7:30,52.24,,0,52.24,52.24,1,-56191,18082,74273,-38109,0,0,19157,0,0,,19157,19157
13,03/24/2018,31,7:30,7:45,62.02,,0,62.02,62.02,1,-69889,16944,86833,-52945,0,0,35885,0,0,,35885,35885
13,03/24/2018,32,7:45,8:00,74.12,,0,74.12,74.12,1,-86282,29946,116228,-56336,0,0,51406,0,0,,51406,51406
13,03/24/2018,33,8:00,8:15,38.12,37.06,0,38.12,37,2,-24162,71164,95326,47002,0,-583,17987,0,0,,18570,17404
13,03/24/2018,34,8:15,8:30,,,0,36.99,36.99,0,-41094,51177,92271,10083,0,0,0,0,0,,0,0
13,03/24/2018,35,8:30,8:45,62.02,,0,62.02,62.02,1,-57613,27443,85056,-30170,0,0,8192,0,0,,8192,8192
13,03/24/2018,36,8:45,9:00,92.12,,0,92.12,92.12,1,-82323,22673,104996,-59650,0,0,42654,0,0,,42654,42654
13,03/24/2018,37,9:00,9:15,43.95,38.43,0,43.95,36.97,2,-41662,61574,103236,19912,0,-598,15195,0,0,,15793,14597
13,03/24/2018,38,9:15,9:30,44.02,38.43,0,44.02,44.02,1,-69685,50066,119751,-19619,0,-6,2375,0,0,,2381,2369
13,03/24/2018,39,9:30,9:45,40.02,,0,40.02,40.02,1,-70367,55541,125908,-14826,0,0,4764,0,0,,4764,4764
13,03/24/2018,40,9:45,10:00,40.02,,0,40.02,40.02,1,-76724,64678,141402,-12046,0,0,2256,0,0,,2256,2256
13,03/24/2018,41,10:00,10:15,35.12,38.15,0,36.93,36.93,2,-46346,53691,100037,7345,0,-52,1443,0,0,,1495,1391
13,03/24/2018,42,10:15,10:30,35.12,32.02,0,32.02,32.02,-1,-49626,72484,122110,22858,0,-13750,29,0,0,,13779,-13721
13,03/24/2018,43,10:30,10:45,,32.02,0,32.02,32.02,-1,-40684,77797,118481,37113,0,-28523,0,0,0,,28523,-28523
13,03/24/2018,44,10:45,11:00,,35.78,0,35.78,35.78,-1,-42345,74473,116818,32128,0,-26603,0,0,0,,26603,-26603
13,03/24/2018,45,11:00,11:15,,35.78,0,35.78,35.78,-1,-45050,51098,96148,6048,0,-15283,0,0,0,,15283,-15283
13,03/24/2018,46,11:15,11:30,,36.02,0,36.02,36.02,-1,-43465,64502,107967,21037,0,-1518,0,0,0,,1518,-1518
13,03/24/2018,47,11:30,11:45,,35.78,0,35.78,35.78,-1,-39598,71562,111160,31964,0,-4894,0,0,0,,4894,-4894
13,03/24/2018,48,11:45,12:00,,34.78,0,34.78,34.78,-1,-37242,82451,119693,45209,0,-13072,0,0,0,,13072,-13072
13,03/24/2018,49,12:00,12:15,,40.79,0,40.79,40.79,-1,-54367,51449,105816,-2918,0,-5580,0,0,0,,5580,-5580
13,03/24/2018,50,12:15,12:30,,32.02,0,32.02,32.02,-1,-46991,85300,132291,38309,0,-6300,0,0,0,,6300,-6300
13,03/24/2018,51,12:30,12:45,,35.78,0,35.78,35.78,-1,-47442,92376,139818,44934,0,-15076,0,0,0,,15076,-15076
13,03/24/2018,52,12:45,13:00,,32.02,0,32.02,32.02,-1,-49708,85314,135022,35606,0,-19670,0,0,0,,19670,-19670
13,03/24/2018,53,13:00,13:15,,35.78,0,35.78,35.78,-1,-54020,71845,125865,17825,0,-20537,0,0,0,,20537,-20537
13,03/24/2018,54,13:15,13:30,,35.78,0,35.78,35.78,-1,-56308,73834,130142,17526,0,-13030,0,0,0,,13030,-13030
13,03/24/2018,55,13:30,13:45,,22.75,0,22.75,22.75,-1,-47835,94610,142445,46775,0,-28202,0,0,0,,28202,-28202
13,03/24/2018,56,13:45,14:00,,11.91,0,11.91,11.91,-1,-65282,113932,179214,48650,0,-49547,0,0,0,,49547,-49547
13,03/24/2018,57,14:00,14:15,,14.02,0,14.02,14.02,-1,-44688,127995,172683,83307,0,-44665,0,0,0,,44665,-44665
13,03/24/2018,58,14:15,14:30,,11.98,0,11.98,11.98,-1,-41879,152738,194617,110859,0,-27928,0,0,0,,27928,-27928
13,03/24/2018,59,14:30,14:45,,3.68,0,3.68,3.68,-1,-44476,118883,163359,74407,0,-44013,0,0,0,,44013,-44013
13,03/24/2018,60,14:45,15:00,,-23.78,0,-23.78,-23.78,-1,-47754,116282,164036,68528,0,-49943,0,0,0,,49943,-49943
13,03/24/2018,61,15:00,15:15,,23.53,0,23.53,23.53,-1,-30456,130608,161064,100152,0,-32476,0,0,0,,32476,-32476
13,03/24/2018,62,15:15,15:30,,26.02,0,26.02,26.02,-1,-19866,134626,154492,114760,0,-6694,0,0,0,,6694,-6694
13,03/24/2018,63,15:30,15:45,,26.02,0,26.02,26.02,-1,-20723,129632,150355,108909,0,-7259,0,0,0,,7259,-7259
13,03/24/2018,64,15:45,16:00,,29.67,0,29.67,29.67,-1,-22671,124102,146773,101431,0,-2497,0,0,0,,2497,-2497
13,03/24/2018,65,16:00,16:15,,36.02,0,36.02,36.02,-1,-38982,171994,210976,133012,0,-2021,0,0,0,,2021,-2021
13,03/24/2018,66,16:15,16:30,,,0,36.24,36.24,0,-40762,149948,190710,109186,0,-3,0,0,0,,3,-3
13,03/24/2018,67,16:30,16:45,,,0,36.24,36.24,0,-36485,124913,161398,88428,0,0,0,0,0,,0,0
13,03/24/2018,68,16:45,17:00,,,0,36.22,36.22,0,-37474,98696,136170,61222,0,0,0,0,0,,0,0
13,03/24/2018,69,17:00,17:15,,39.27,0,39.27,39.27,-1,-42308,153492,195800,111184,0,-497,0,0,0,,497,-497
13,03/24/2018,70,17:15,17:30,,32.02,0,32.02,32.02,-1,-32892,122755,155647,89863,0,-3999,0,0,0,,3999,-3999
13,03/24/2018,71,17:30,17:45,,-13.78,0,-13.78,-13.78,-1,-31880,87513,119393,55633,0,-16703,0,0,0,,16703,-16703
13,03/24/2018,72,17:45,18:00,,36.02,0,36.02,36.02,-1,-37152,81731,118883,44579,0,-2539,0,0,0,,2539,-2539
13,03/24/2018,73,18:00,18:15,,14.02,0,14.02,14.02,-1,-47874,88676,136550,40802,0,-17820,0,0,0,,17820,-17820
13,03/24/2018,74,18:15,18:30,,28.56,0,28.56,28.56,-1,-30217,75063,105280,44846,0,-33740,0,0,0,,33740,-33740
13,03/24/2018,75,18:30,18:45,,27.27,0,27.27,27.27,-1,-21712,76140,97852,54428,0,-34217,0,0,0,,34217,-34217
13,03/24/2018,76,18:45,19:00,,,0,36.99,36.99,0,-25263,60261,85524,34998,0,-4974,0,0,0,,4974,-4974
13,03/24/2018,77,19:00,19:15,,,0,46.28,46.28,0,-44746,71681,116427,26935,0,0,0,0,0,,0,0
13,03/24/2018,78,19:15,19:30,44,,0,44,44,1,-59125,57331,116456,-1794,0,0,183,0,0,,183,183
13,03/24/2018,79,19:30,19:45,41.63,,0,41.63,41.63,1,-55680,54020,109700,-1660,0,0,1256,0,0,,1256,1256
13,03/24/2018,80,19:45,20:00,41.12,36.02,0,36.02,36.02,-1,-44535,60348,104883,15813,0,-657,866,0,0,,1523,209
13,03/24/2018,81,20:00,20:15,41.5,36.02,0,41.5,36.02,2,-50938,41875,92813,-9063,0,-949,1293,0,0,,2242,344
13,03/24/2018,82,20:15,20:30,,36.02,0,36.02,36.02,-1,-36271,53163,89434,16892,0,-1451,0,0,0,,1451,-1451
13,03/24/2018,83,20:30,20:45,,26.25,0,26.25,26.25,-1,-48014,75902,123916,27888,0,-18432,0,0,0,,18432,-18432
13,03/24/2018,84,20:45,21:00,,19.35,0,19.35,19.35,-1,-46532,100097,146629,53565,0,-36879,0,0,0,,36879,-36879
13,03/24/2018,85,21:00,21:15,206.12,19.35,0,206.12,206.12,1,-85590,31752,117342,-53838,0,-16883,11317,0,0,,28200,-5566
13,03/24/2018,86,21:15,21:30,45.09,,0,45.09,45.09,1,-48687,49129,97816,442,0,0,10709,0,0,,10709,10709
13,03/24/2018,87,21:30,21:45,45.09,39.45,0,39.45,39.45,-1,-50688,67379,118067,16691,0,-868,29,0,0,,897,-839
13,03/24/2018,88,21:45,22:00,,26.6,0,26.6,26.6,-1,-46885,95856,142741,48971,0,-18789,0,0,0,,18789,-18789
13,03/24/2018,89,22:00,22:15,40.02,32.02,0,40.02,40.02,1,-86221,38840,125061,-47381,0,-15610,338,0,0,,15948,-15272
13,03/24/2018,90,22:15,22:30,,,0,36.51,36.51,0,-65911,37932,103843,-27979,0,-40,24,0,0,,64,-16
13,03/24/2018,91,22:30,22:45,,,0,36.51,36.51,0,-57880,67059,124939,9179,0,0,0,0,0,,0,0
13,03/24/2018,92,22:45,23:00,,36.02,0,36.02,36.02,-1,-52009,101234,153243,49225,0,-31,0,0,0,,31,-31
13,03/24/2018,93,23:00,23:15,,32.02,0,32.02,32.02,-1,-60398,71738,132136,11340,0,-3297,0,0,0,,3297,-3297
13,03/24/2018,94,23:15,23:30,,40.16,0,40.16,40.16,-1,-67422,62265,129687,-5157,0,-957,0,0,0,,957,-957
13,03/24/2018,95,23:30,23:45,,36.78,0,36.78,36.78,-1,-61449,57127,118576,-4322,0,-663,0,0,0,,663,-663
13,03/24/2018,96,23:45,0:00,,40.36,0,40.36,40.36,-1,-79506,67715,147221,-11791,0,-82,0,0,0,,82,-82
13,03/25/2018,1,0:00,0:15,,34.52,0,34.52,34.52,-1,-59649,84626,144275,24977,0,-500,0,0,0,,500,-500
13,03/25/2018,2,0:15,0:30,,,0,36.45,36.45,0,-63768,63978,127746,210,0,0,0,0,0,,0,0
13,03/25/2018,3,0:30,0:45,,,0,36.45,36.45,0,-54241,58100,112341,3859,0,0,0,0,0,,0,0
13,03/25/2018,4,0:45,1:00,,34.32,0,34.32,34.32,-1,-45840,73688,119528,27848,0,-1146,0,0,0,,1146,-1146
13,03/25/2018,5,1:00,1:15,45.88,31.31,0,45.88,45.88,1,-53125,34052,87177,-19073,0,-2167,1749,0,0,,3916,-418
13,03/25/2018,6,1:15,1:30,40.8,,0,40.8,40.8,1,-48784,40124,88908,-8660,0,0,3175,0,0,,3175,3175
13,03/25/2018,7,1:30,1:45,,,0,36.11,36.11,0,-49363,49879,99242,516,0,0,0,0,0,,0,0
13,03/25/2018,8,1:45,3:00,,34.32,0,34.32,34.32,-1,-76270,46451,122721,-29819,0,-358,0,0,0,,358,-358
13,03/25/2018,9,3:00,3:15,222.02,,0,222.02,222.02,1,-115298,76356,191654,-38942,0,0,16217,0,0,,16217,16217
13,03/25/2018,10,3:15,3:30,107.02,,0,107.02,107.02,1,-113078,58122,171200,-54956,0,0,48437,0,0,,48437,48437
13,03/25/2018,11,3:30,3:45,,,0,36.11,36.11,0,-103818,58491,162309,-45327,0,0,5614,0,0,,5614,5614
13,03/25/2018,12,3:45,4:00,,,0,35.55,35.55,0,-105827,54540,160367,-51287,0,0,0,0,0,,0,0
13,03/25/2018,13,4:00,4:15,222.02,,0,222.02,222.02,1,-189900,48337,238237,-141563,0,0,28304,0,0,,28304,28304
13,03/25/2018,14,4:15,4:30,222.02,,0,222.02,222.02,1,-199113,43385,242498,-155728,0,0,81254,0,0,,81254,81254
13,03/25/2018,15,4:30,4:45,67.6,,0,67.6,67.6,1,-206042,56754,262796,-149288,0,0,60106,0,0,,60106,60106
13,03/25/2018,16,4:45,5:00,222.02,,0,222.02,222.02,1,-202804,66351,269155,-136453,0,0,81365,0,0,,81365,81365
13,03/25/2018,17,5:00,5:15,222.02,38.22,0,38.22,38.22,-1,-54628,88263,142891,33635,0,-142,30776,0,0,,30918,30634
13,03/25/2018,18,5:15,5:30,38.32,,0,38.32,38.32,1,-75480,68754,144234,-6726,0,0,624,0,0,,624,624
13,03/25/2018,19,5:30,5:45,46.04,,0,46.04,46.04,1,-75592,59529,135121,-16063,0,0,10170,0,0,,10170,10170
13,03/25/2018,20,5:45,6:00,32.44,,0,32.44,32.44,1,-25022,75927,100949,50905,0,0,3413,0,0,,3413,3413
13,03/25/2018,21,6:00,6:15,,30.4,0,30.4,30.4,-1,-20390,112016,132406,91626,0,-1412,0,0,0,,1412,-1412
13,03/25/2018,22,6:15,6:30,,34.4,0,34.4,34.4,-1,-23789,143390,167179,119601,0,-1987,0,0,0,,1987,-1987
13,03/25/2018,23,6:30,6:45,,34.4,0,34.4,34.4,-1,-23757,149630,173387,125873,0,-2473,0,0,0,,2473,-2473
13,03/25/2018,24,6:45,7:00,,38.72,0,38.72,38.72,-1,-32090,121878,153968,89788,0,-537,0,0,0,,537,-537
13,03/25/2018,25,7:00,7:15,55.17,,0,55.17,55.17,1,-106090,55759,161849,-50331,0,0,10478,0,0,,10478,10478
13,03/25/2018,26,7:15,7:30,42.16,,0,42.16,42.16,1,-66349,58076,124425,-8273,0,0,11147,0,0,,11147,11147
13,03/25/2018,27,7:30,7:45,,,0,33.51,33.51,0,-65017,58454,123471,-6563,0,0,97,0,0,,97,97
13,03/25/2018,28,7:45,8:00,,33.03,0,33.03,33.03,-1,-58346,64291,122637,5945,0,-1283,0,0,0,,1283,-1283
13,03/25/2018,29,8:00,8:15,,34.4,0,34.4,34.4,-1,-32963,42064,75027,9101,0,-1884,0,0,0,,1884,-1884
13,03/25/2018,30,8:15,8:30,,34.4,0,34.4,34.4,-1,-21929,30467,52396,8538,0,-1732,0,0,0,,1732,-1732
13,03/25/2018,31,8:30,8:45,,,0,36.09,36.09,0,-30171,34306,64477,4135,0,0,0,0,0,,0,0
13,03/25/2018,32,8:45,9:00,,,0,36.09,36.09,0,-36952,74118,111070,37166,0,0,0,0,0,,0,0
13,03/25/2018,33,9:00,9:15,,34.4,0,34.4,34.4,-1,-23853,42052,65905,18199,0,-1072,0,0,0,,1072,-1072
13,03/25/2018,34,9:15,9:30,,40.25,0,40.25,40.25,-1,-16211,29014,45225,12803,0,-642,0,0,0,,642,-642
13,03/25/2018,35,9:30,9:45,,,0,36.24,36.24,0,-20666,36607,57273,15941,0,0,0,0,0,,0,0
13,03/25/2018,36,9:45,10:00,,,0,36.24,36.24,0,-24677,45761,70438,21084,0,0,0,0,0,,0,0
13,03/25/2018,37,10:00,10:15,,,0,36.87,36.87,0,-53098,53013,106111,-85,0,0,0,0,0,,0,0
13,03/25/2018,38,10:15,10:30,41.37,,0,41.37,41.37,1,-53528,50174,103702,-3354,0,0,725,0,0,,725,725
13,03/25/2018,39,10:30,10:45,32.43,,0,32.43,32.43,1,-49296,65404,114700,16108,0,0,363,0,0,,363,363
13,03/25/2018,40,10:45,11:00,,34.4,0,34.4,34.4,-1,-53563,75162,128725,21599,0,-1134,0,0,0,,1134,-1134
13,03/25/2018,41,11:00,11:15,,40.18,0,40.18,40.18,-1,-60108,51574,111682,-8534,0,-325,0,0,0,,325,-325
13,03/25/2018,42,11:15,11:30,,34.4,0,34.4,34.4,-1,-58263,61424,119687,3161,0,-1220,0,0,0,,1220,-1220
13,03/25/2018,43,11:30,11:45,,30.4,0,30.4,30.4,-1,-56616,75401,132017,18785,0,-6296,0,0,0,,6296,-6296
13,03/25/2018,44,11:45,12:00,,29.24,0,29.24,29.24,-1,-51472,80880,132352,29408,0,-19620,0,0,0,,19620,-19620
13,03/25/2018,45,12:00,12:15,,33.03,0,33.03,33.03,-1,-49964,85635,135599,35671,0,-18968,0,0,0,,18968,-18968
13,03/25/2018,46,12:15,12:30,,20.85,0,20.85,20.85,-1,-49288,109890,159178,60602,0,-27232,0,0,0,,27232,-27232
13,03/25/2018,47,12:30,12:45,,20.68,0,20.68,20.68,-1,-45055,116330,161385,71275,0,-20928,0,0,0,,20928,-20928
13,03/25/2018,48,12:45,13:00,,8.48,0,8.48,8.48,-1,-43000,121617,164617,78617,0,-19413,0,0,0,,19413,-19413
13,03/25/2018,49,13:00,13:15,,24.4,0,24.4,24.4,-1,-47307,102978,150285,55671,0,-26951,0,0,0,,26951,-26951
13,03/25/2018,50,13:15,13:30,,16.67,0,16.67,16.67,-1,-47521,101908,149429,54387,0,-33976,0,0,0,,33976,-33976
13,03/25/2018,51,13:30,13:45,,12.4,0,12.4,12.4,-1,-44857,101729,146586,56872,0,-51292,0,0,0,,51292,-51292
13,03/25/2018,52,13:45,14:00,,12.4,0,12.4,12.4,-1,-36642,97450,134092,60808,0,-65230,0,0,0,,65230,-65230
13,03/25/2018,53,14:00,14:15,,-58.03,0,-58.03,-58.03,-1,-39231,178715,217946,139484,0,-62411,0,0,0,,62411,-62411
13,03/25/2018,54,14:15,14:30,,7.86,0,7.86,7.86,-1,-38970,121651,160621,82681,0,-47873,0,0,0,,47873,-47873
13,03/25/2018,55,14:30,14:45,,6.5,0,6.5,6.5,-1,-39392,84815,124207,45423,0,-50719,0,0,0,,50719,-50719
13,03/25/2018,56,14:45,15:00,,30.4,0,30.4,30.4,-1,-74408,79804,154212,5396,0,-20804,0,0,0,,20804,-20804
13,03/25/2018,57,15:00,15:15,,-150.03,0,-150.03,-150.03,-1,-37521,143209,180730,105688,0,-47067,0,0,0,,47067,-47067
13,03/25/2018,58,15:15,15:30,,22.23,0,22.23,22.23,-1,-51984,117641,169625,65657,0,-59739,0,0,0,,59739,-59739
13,03/25/2018,59,15:30,15:45,,25.9,0,25.9,25.9,-1,-40423,104413,144836,63990,0,-44135,0,0,0,,44135,-44135
13,03/25/2018,60,15:45,16:00,,27.68,0,27.68,27.68,-1,-44970,95404,140374,50434,0,-21453,0,0,0,,21453,-21453
13,03/25/2018,61,16:00,16:15,,26.03,0,26.03,26.03,-1,-56064,96741,152805,40677,0,-16799,0,0,0,,16799,-16799
13,03/25/2018,62,16:15,16:30,,34.4,0,34.4,34.4,-1,-61070,82765,143835,21695,0,-345,0,0,0,,345,-345
13,03/25/2018,63,16:30,16:45,,30.4,0,30.4,30.4,-1,-73758,86478,160236,12720,0,-6465,0,0,0,,6465,-6465
13,03/25/2018,64,16:45,17:00,,,0,35.89,35.89,0,-92571,77042,169613,-15529,0,-1055,0,0,0,,1055,-1055
13,03/25/2018,65,17:00,17:15,,39.72,0,39.72,39.72,-1,-70293,106148,176441,35855,0,-14,0,0,0,,14,-14
13,03/25/2018,66,17:15,17:30,,29.17,0,29.17,29.17,-1,-55250,103550,158800,48300,0,-4372,0,0,0,,4372,-4372
13,03/25/2018,67,17:30,17:45,,34.4,0,34.4,34.4,-1,-64605,116890,181495,52285,0,-306,0,0,0,,306,-306
13,03/25/2018,68,17:45,18:00,,,0,33.31,33.31,0,-91135,127240,218375,36105,0,0,0,0,0,,0,0
13,03/25/2018,69,18:00,18:15,74.02,,0,74.02,74.02,1,-129327,43338,172665,-85989,0,0,23743,0,0,,23743,23743
13,03/25/2018,70,18:15,18:30,47.02,,0,47.02,47.02,1,-68755,52003,120758,-16752,0,0,26807,0,0,,26807,26807
13,03/25/2018,71,18:30,18:45,35.02,,0,35.02,35.02,1,-65826,65022,130848,-804,0,0,4914,0,0,,4914,4914
13,03/25/2018,72,18:45,19:00,41.81,,0,41.81,41.81,1,-55185,66319,121504,11134,0,0,2567,0,0,,2567,2567
13,03/25/2018,73,19:00,19:15,42.4,26.64,0,26.64,26.64,-1,-48120,57593,105713,9473,0,-4207,2413,0,0,,6620,-1794
13,03/25/2018,74,19:15,19:30,,19.95,0,19.95,19.95,-1,-22684,59361,82045,36677,0,-25913,0,0,0,,25913,-25913
13,03/25/2018,75,19:30,19:45,,41.43,0,41.43,41.43,-1,-35157,47809,82966,12652,0,-1465,0,0,0,,1465,-1465
13,03/25/2018,76,19:45,20:00,32.52,41.43,0,36.98,36.98,2,-53347,53054,106401,-293,0,-253,65,0,0,,318,-188
13,03/25/2018,77,20:00,20:15,37.02,,0,37.02,37.02,1,-29330,53779,83109,24449,0,0,287,0,0,,287,287
13,03/25/2018,78,20:15,20:30,38.4,,0,38.4,38.4,1,-66486,28654,95140,-37832,0,0,1831,0,0,,1831,1831
13,03/25/2018,79,20:30,20:45,38.4,,0,38.4,38.4,1,-58557,36069,94626,-22488,0,0,1217,0,0,,1217,1217
13,03/25/2018,80,20:45,21:00,,,0,38.21,38.21,0,-55053,42104,97157,-12949,0,0,29,0,0,,29,29
13,03/25/2018,81,21:00,21:15,48.4,,0,48.4,48.4,1,-63644,42386,106030,-21258,0,0,6079,0,0,,6079,6079
13,03/25/2018,82,21:15,21:30,38.4,32.03,0,32.03,32.03,-1,-38688,50952,89640,12264,0,-1007,1760,0,0,,2767,753
13,03/25/2018,83,21:30,21:45,,30.4,0,30.4,30.4,-1,-38328,61773,100101,23445,0,-3294,0,0,0,,3294,-3294
13,03/25/2018,84,21:45,22:00,,31.03,0,31.03,31.03,-1,-41785,71638,113423,29853,0,-15084,0,0,0,,15084,-15084
13,03/25/2018,85,22:00,22:15,35.02,37.56,0,35.02,35.02,1,-90848,48720,139568,-42128,0,-6690,23,0,0,,6713,-6667
13,03/25/2018,86,22:15,22:30,38.4,37.56,0,38.4,38.4,1,-62627,46212,108839,-16415,0,-12,510,0,0,,522,498
13,03/25/2018,87,22:30,22:45,,,0,38.23,38.23,0,-45857,55748,101605,9891,0,0,1,0,0,,1,1
13,03/25/2018,88,22:45,23:00,,40.95,0,40.95,40.95,-1,-43453,70285,113738,26832,0,-25,0,0,0,,25,-25
13,03/25/2018,89,23:00,23:15,,35.3,0,35.3,35.3,-1,-68254,55185,123439,-13069,0,-194,0,0,0,,194,-194
13,03/25/2018,90,23:15,23:30,,39.41,0,39.41,39.41,-1,-56588,61603,118191,5015,0,-63,0,0,0,,63,-63
13,03/25/2018,91,23:30,23:45,,34.4,0,34.4,34.4,-1,-39434,60250,99684,20816,0,-4149,0,0,0,,4149,-4149
13,03/25/2018,92,23:45,0:00,,24.4,0,24.4,24.4,-1,-35381,66470,101851,31089,0,-13234,0,0,0,,13234,-13234
13,03/26/2018,1,0:00,0:15,63.61,19.41,0,63.61,19.41,2,-48594,18638,67232,-29956,0,-11898,3150,0,0,,15048,-8748
13,03/26/2018,2,0:15,0:30,41.43,,0,41.43,41.43,1,-32311,17899,50210,-14412,0,0,1772,0,0,,1772,1772
13,03/26/2018,3,0:30,0:45,,38.97,0,38.97,38.97,-1,-28916,32031,60947,3115,0,-589,0,0,0,,589,-589
13,03/26/2018,4,0:45,1:00,,30.4,0,30.4,30.4,-1,-25284,46049,71333,20765,0,-11332,0,0,0,,11332,-11332
13,03/26/2018,5,1:00,1:15,31.93,30.78,0,31.93,31.93,1,-41829,36658,78487,-5171,0,-9773,81,0,0,,9854,-9692
13,03/26/2018,6,1:15,1:30,31.89,36.4,0,36.28,36.28,2,-41947,42832,84779,885,0,-95,185,0,0,,280,90
13,03/26/2018,7,1:30,1:45,,30.4,0,30.4,30.4,-1,-34585,49999,84584,15414,0,-3321,0,0,0,,3321,-3321
13,03/26/2018,8,1:45,2:00,,30.4,0,30.4,30.4,-1,-47586,59498,107084,11912,0,-10816,0,0,0,,10816,-10816
13,03/26/2018,9,2:00,2:15,,33.78,0,33.78,33.78,-1,-60193,50839,111032,-9354,0,-7205,0,0,0,,7205,-7205
13,03/26/2018,10,2:15,2:30,,36.4,0,36.4,36.4,-1,-50473,45912,96385,-4561,0,-147,0,0,0,,147,-147
13,03/26/2018,11,2:30,2:45,,31.78,0,31.78,31.78,-1,-35808,41041,76849,5233,0,-5198,0,0,0,,5198,-5198
13,03/26/2018,12,2:45,3:00,,32.78,0,32.78,32.78,-1,-32406,40507,72913,8101,0,-7629,0,0,0,,7629,-7629
13,03/26/2018,13,3:00,3:15,,30.4,0,30.4,30.4,-1,-32984,61854,94838,28870,0,-8160,0,0,0,,8160,-8160
13,03/26/2018,14,3:15,3:30,,29.99,0,29.99,29.99,-1,-26787,55886,82673,29099,0,-1575,0,0,0,,1575,-1575
13,03/26/2018,15,3:30,3:45,,28.97,0,28.97,28.97,-1,-27031,42768,69799,15737,0,-10948,0,0,0,,10948,-10948
13,03/26/2018,16,3:45,4:00,,27.11,0,27.11,27.11,-1,-21055,38814,59869,17759,0,-13724,0,0,0,,13724,-13724
13,03/26/2018,17,4:00,4:15,,20.45,0,20.45,20.45,-1,-24448,47520,71968,23072,0,-24180,0,0,0,,24180,-24180
13,03/26/2018,18,4:15,4:30,,36.4,0,36.4,36.4,-1,-32064,39550,71614,7486,0,-5021,0,0,0,,5021,-5021
13,03/26/2018,19,4:30,4:45,,36.4,0,36.4,36.4,-1,-38624,28702,67326,-9922,0,-1216,0,0,0,,1216,-1216
13,03/26/2018,20,4:45,5:00,,36.4,0,36.4,36.4,-1,-49097,38508,87605,-10589,0,-300,0,0,0,,300,-300
13,03/26/2018,21,5:00,5:15,,28.43,0,28.43,28.43,-1,-41320,55576,96896,14256,0,-9302,0,0,0,,9302,-9302
13,03/26/2018,22,5:15,5:30,,34.78,0,34.78,34.78,-1,-38952,32524,71476,-6428,0,-5847,0,0,0,,5847,-5847
13,03/26/2018,23,5:30,5:45,43.08,,0,43.08,43.08,1,-50843,23827,74670,-27016,0,0,610,0,0,,610,610
13,03/26/2018,24,5:45,6:00,46.39,,0,46.39,46.39,1,-65964,25156,91120,-40808,0,0,3592,0,0,,3592,3592
13,03/26/2018,25,6:00,6:15,46.39,-23.78,0,-23.78,-23.78,-1,-42579,90338,132917,47759,0,-11781,564,0,0,,12345,-11217
13,03/26/2018,26,6:15,6:30,,34.78,0,34.78,34.78,-1,-46340,37082,83422,-9258,0,-4552,0,0,0,,4552,-4552
13,03/26/2018,27,6:30,6:45,88.13,,0,88.13,88.13,1,-90748,37695,128443,-53053,0,0,3159,0,0,,3159,3159
13,03/26/2018,28,6:45,7:00,350.12,,0,350.12,350.12,1,-139544,38783,178327,-100761,0,0,58062,0,0,,58062,58062
13,03/26/2018,29,7:00,7:15,350.12,23.72,0,23.72,23.72,-1,-23371,143076,166447,119705,0,-1755,18888,0,0,,20643,17133
13,03/26/2018,30,7:15,7:30,,,0,50.49,50.49,0,-39137,77468,116605,38331,0,0,0,0,0,,0,0
13,03/26/2018,31,7:30,7:45,96.03,,0,96.03,96.03,1,-73200,62549,135749,-10651,0,0,6854,0,0,,6854,6854
13,03/26/2018,32,7:45,8:00,221.12,,0,221.12,221.12,1,-125531,57459,182990,-68072,0,0,56692,0,0,,56692,56692
13,03/26/2018,33,8:00,8:15,221.12,35.77,0,35.77,35.77,-1,-50249,81344,131593,31095,0,-338,25831,0,0,,26169,25493
13,03/26/2018,34,8:15,8:30,93.12,35.77,0,93.12,93.12,1,-63568,43101,106669,-20467,0,-49,3980,0,0,,4029,3931
13,03/26/2018,35,8:30,8:45,142.12,,0,142.12,142.12,1,-90348,39775,130123,-50573,0,0,36144,0,0,,36144,36144
13,03/26/2018,36,8:45,9:00,157.12,,0,157.12,157.12,1,-128243,30670,158913,-97573,0,0,63529,0,0,,63529,63529
13,03/26/2018,37,9:00,9:15,168.12,,0,168.12,168.12,1,-130889,27613,158502,-103276,0,0,81564,0,0,,81564,81564
13,03/26/2018,38,9:15,9:30,168.12,,0,168.12,168.12,1,-141131,24117,165248,-117014,0,0,100130,0,0,,100130,100130
13,03/26/2018,39,9:30,9:45,163.12,,0,163.12,163.12,1,-97848,42732,140580,-55116,0,0,76946,0,0,,76946,76946
13,03/26/2018,40,9:45,10:00,46.61,,0,46.61,46.61,1,-85113,66218,151331,-18895,0,0,13327,0,0,,13327,13327
13,03/26/2018,41,10:00,10:15,162.12,,0,162.12,162.12,1,-164191,30604,194795,-133587,0,0,54997,0,0,,54997,54997
13,03/26/2018,42,10:15,10:30,152.12,,0,152.12,152.12,1,-96644,42206,138850,-54438,0,0,60376,0,0,,60376,60376
13,03/26/2018,43,10:30,10:45,42.5,,0,42.5,42.5,1,-67676,51164,118840,-16512,0,0,7833,0,0,,7833,7833
13,03/26/2018,44,10:45,11:00,,42.01,0,42.01,42.01,-1,-54429,62041,116470,7612,0,-126,0,0,0,,126,-126
13,03/26/2018,45,11:00,11:15,42.5,61.84,0,50.17,50.17,2,-83222,52324,135546,-30898,0,-71,541,0,0,,612,470
13,03/26/2018,46,11:15,11:30,38.5,,0,38.5,38.5,1,-61030,53715,114745,-7315,0,0,330,0,0,,330,330
13,03/26/2018,47,11:30,11:45,38.5,42.21,0,40.36,40.36,2,-45328,58134,103462,12806,0,-3,20,0,0,,23,17
13,03/26/2018,48,11:45,12:00,,31.62,0,31.62,31.62,-1,-30614,63587,94201,32973,0,-8784,0,0,0,,8784,-8784
13,03/26/2018,49,12:00,12:15,38.5,31.6,0,38.5,38.5,1,-43337,34910,78247,-8427,0,-10013,115,0,0,,10128,-9898
13,03/26/2018,50,12:15,12:30,38.5,35.78,0,35.78,35.78,-1,-28990,73919,102909,44929,0,-1088,19,0,0,,1107,-1069
13,03/26/2018,51,12:30,12:45,,35.16,0,35.16,35.16,-1,-28024,94457,122481,66433,0,-2406,0,0,0,,2406,-2406
13,03/26/2018,52,12:45,13:00,,-17.1,0,-17.1,-17.1,-1,-29938,94920,124858,64982,0,-19966,0,0,0,,19966,-19966
13,03/26/2018,53,13:00,13:15,140.12,35.78,0,140.12,35.78,2,-92180,43904,136084,-48276,0,-6394,8129,0,0,,14523,1735
13,03/26/2018,54,13:15,13:30,41.89,,0,41.89,41.89,1,-80475,71214,151689,-9261,0,0,5097,0,0,,5097,5097
13,03/26/2018,55,13:30,13:45,38.5,,0,38.5,38.5,1,-79334,72193,151527,-7141,0,0,1206,0,0,,1206,1206
13,03/26/2018,56,13:45,14:00,,41.97,0,41.97,41.97,-1,-78248,77494,155742,-754,0,-17,0,0,0,,17,-17
13,03/26/2018,57,14:00,14:15,67.12,41.8,0,67.12,67.12,1,-90906,57586,148492,-33320,0,-43,7791,0,0,,7834,7748
13,03/26/2018,58,14:15,14:30,42.5,,0,42.5,42.5,1,-68723,60811,129534,-7912,0,0,13067,0,0,,13067,13067
13,03/26/2018,59,14:30,14:45,42.5,41.8,0,41.8,41.8,-1,-53997,68947,122944,14950,0,-3,605,0,0,,608,602
13,03/26/2018,60,14:45,15:00,,35.78,0,35.78,35.78,-1,-52194,75214,127408,23020,0,-10952,0,0,0,,10952,-10952
13,03/26/2018,61,15:00,15:15,,34.78,0,34.78,34.78,-1,-42645,86513,129158,43868,0,-12896,0,0,0,,12896,-12896
13,03/26/2018,62,15:15,15:30,,,0,37.11,37.11,0,-44385,79260,123645,34875,0,-336,0,0,0,,336,-336
13,03/26/2018,63,15:30,15:45,43.52,,0,43.52,43.52,1,-54939,51099,106038,-3840,0,0,1363,0,0,,1363,1363
13,03/26/2018,64,15:45,16:00,45.48,,0,45.48,45.48,1,-95528,46781,142309,-48747,0,0,5186,0,0,,5186,5186
13,03/26/2018,65,16:00,16:15,32.8,,0,32.8,32.8,1,-44300,77524,121824,33224,0,0,540,0,0,,540,540
13,03/26/2018,66,16:15,16:30,,,0,37.16,37.16,0,-51161,69163,120324,18002,0,0,0,0,0,,0,0
13,03/26/2018,67,16:30,16:45,42.1,,0,42.1,42.1,1,-65896,67702,133598,1806,0,0,361,0,0,,361,361
13,03/26/2018,68,16:45,17:00,42.62,,0,42.62,42.62,1,-87082,72157,159239,-14925,0,0,4594,0,0,,4594,4594
13,03/26/2018,69,17:00,17:15,,,0,37.26,37.26,0,-35598,97782,133380,62184,0,0,894,0,0,,894,894
13,03/26/2018,70,17:15,17:30,,,0,37.26,37.26,0,-36478,86100,122578,49622,0,0,0,0,0,,0,0
13,03/26/2018,71,17:30,17:45,,,0,37.24,37.24,0,-31179,84261,115440,53082,0,0,0,0,0,,0,0
13,03/26/2018,72,17:45,18:00,,,0,37.26,37.26,0,-30984,71333,102317,40349,0,0,0,0,0,,0,0
13,03/26/2018,73,18:00,18:15,,40.27,0,40.27,40.27,-1,-56565,44228,100793,-12337,0,-272,0,0,0,,272,-272
13,03/26/2018,74,18:15,18:30,,36.5,0,36.5,36.5,-1,-48087,45896,93983,-2191,0,-624,0,0,0,,624,-624
13,03/26/2018,75,18:30,18:45,,,0,37.67,37.67,0,-54988,55377,110365,389,0,0,0,0,0,,0,0
13,03/26/2018,76,18:45,19:00,38.5,,0,38.5,38.5,1,-61994,46138,108132,-15856,0,0,199,0,0,,199,199
13,03/26/2018,77,19:00,19:15,38.5,,0,38.5,38.5,1,-100209,45126,145335,-55083,0,0,1545,0,0,,1545,1545
13,03/26/2018,78,19:15,19:30,42.51,,0,42.51,42.51,1,-106315,26613,132928,-79702,0,0,663,0,0,,663,663
13,03/26/2018,79,19:30,19:45,,,0,40.36,40.36,0,-98300,34379,132679,-63921,0,0,0,0,0,,0,0
13,03/26/2018,80,19:45,20:00,87.4,,0,87.4,87.4,1,-112108,32696,144804,-79412,0,0,2755,0,0,,2755,2755
13,03/26/2018,81,20:00,20:15,38.5,,0,38.5,38.5,1,-76079,70969,147048,-5110,0,0,825,0,0,,825,825
13,03/26/2018,82,20:15,20:30,38.5,,0,38.5,38.5,1,-113178,39485,152663,-73693,0,0,735,0,0,,735,735
13,03/26/2018,83,20:30,20:45,38.5,,0,38.5,38.5,1,-119645,36302,155947,-83343,0,0,5,0,0,,5,5
13,03/26/2018,84,20:45,21:00,,,0,40.37,40.37,0,-105707,41048,146755,-64659,0,0,0,0,0,,0,0
13,03/26/2018,85,21:00,21:15,38.5,,0,38.5,38.5,1,-71081,21172,92253,-49909,0,0,314,0,0,,314,314
13,03/26/2018,86,21:15,21:30,42.46,,0,42.46,42.46,1,-66593,21323,87916,-45270,0,0,564,0,0,,564,564
13,03/26/2018,87,21:30,21:45,,42.09,0,42.09,42.09,-1,-52846,44577,97423,-8269,0,-31,0,0,0,,31,-31
13,03/26/2018,88,21:45,22:00,,36.5,0,36.5,36.5,-1,-38719,62818,101537,24099,0,-5626,0,0,0,,5626,-5626
13,03/26/2018,89,22:00,22:15,,39.75,0,39.75,39.75,-1,-87451,18399,105850,-69052,0,-2399,0,0,0,,2399,-2399
13,03/26/2018,90,22:15,22:30,,,0,36.96,36.96,0,-50005,26367,76372,-23638,0,0,0,0,0,,0,0
13,03/26/2018,91,22:30,22:45,,,0,36.99,36.99,0,-40428,47124,87552,6696,0,0,0,0,0,,0,0
13,03/26/2018,92,22:45,23:00,,38.63,0,38.63,38.63,-1,-32853,87309,120162,54456,0,-1436,0,0,0,,1436,-1436
13,03/26/2018,93,23:00,23:15,59.12,42.12,0,59.12,36.89,2,-73508,9042,82550,-64466,0,-378,5384,0,0,,5762,5006
13,03/26/2018,94,23:15,23:30,42.12,,0,42.12,42.12,1,-40109,18179,58288,-21930,0,0,4387,0,0,,4387,4387
13,03/26/2018,95,23:30,23:45,42.12,36.5,0,36.5,36.5,-1,-28836,43336,72172,14500,0,-792,270,0,0,,1062,-522
13,03/26/2018,96,23:45,0:00,,18.78,0,18.78,18.78,-1,-35687,78775,114462,43088,0,-19753,0,0,0,,19753,-19753
13,03/27/2018,1,0:00,0:15,80.02,8.03,0,80.02,8.03,2,-41093,20490,61583,-20603,0,-15205,4396,0,0,,19601,-10809
13,03/27/2018,2,0:15,0:30,37.11,35.23,0,37.11,34.86,2,-22001,45584,67585,23583,0,-51,877,0,0,,928,826
13,03/27/2018,3,0:30,0:45,,-0.22,0,-0.22,-0.22,-1,-22855,79699,102554,56844,0,-7781,0,0,0,,7781,-7781
13,03/27/2018,4,0:45,1:00,,1.03,0,1.03,1.03,-1,-36164,97798,133962,61634,0,-44038,0,0,0,,44038,-44038
13,03/27/2018,5,1:00,1:15,38.5,25.38,0,38.5,38.5,1,-57798,51297,109095,-6501,0,-28427,196,0,0,,28623,-28231
13,03/27/2018,6,1:15,1:30,38.5,36.26,0,38.5,36.26,2,-37556,35687,73243,-1869,0,-864,214,0,0,,1078,-650
13,03/27/2018,7,1:30,1:45,,33.03,0,33.03,33.03,-1,-34953,61171,96124,26218,0,-6528,0,0,0,,6528,-6528
13,03/27/2018,8,1:45,2:00,,27.19,0,27.19,27.19,-1,-34247,66592,100839,32345,0,-20734,0,0,0,,20734,-20734
13,03/27/2018,9,2:00,2:15,39.76,30.5,0,39.76,39.76,1,-50309,39874,90183,-10435,0,-16917,423,0,0,,17340,-16494
13,03/27/2018,10,2:15,2:30,42.5,36.5,0,42.5,36.5,2,-36945,37563,74508,618,0,-326,2539,0,0,,2865,2213
13,03/27/2018,11,2:30,2:45,,35.58,0,35.58,35.58,-1,-33076,43654,76730,10578,0,-2291,0,0,0,,2291,-2291
13,03/27/2018,12,2:45,3:00,,30.5,0,30.5,30.5,-1,-30183,53850,84033,23667,0,-5570,0,0,0,,5570,-5570
13,03/27/2018,13,3:00,3:15,,30.22,0,30.22,30.22,-1,-38806,64691,103497,25885,0,-5806,0,0,0,,5806,-5806
13,03/27/2018,14,3:15,3:30,,,0,36.7,36.7,0,-34640,51887,86527,17247,0,0,0,0,0,,0,0
13,03/27/2018,15,3:30,3:45,,,0,36.7,36.7,0,-35174,44570,79744,9396,0,0,0,0,0,,0,0
13,03/27/2018,16,3:45,4:00,,,0,36.65,36.65,0,-37860,56437,94297,18577,0,0,0,0,0,,0,0
13,03/27/2018,17,4:00,4:15,,36.5,0,36.5,36.5,-1,-34574,77889,112463,43315,0,-951,0,0,0,,951,-951
13,03/27/2018,18,4:15,4:30,,30.5,0,30.5,30.5,-1,-40834,65142,105976,24308,0,-4538,0,0,0,,4538,-4538
13,03/27/2018,19,4:30,4:45,,36.5,0,36.5,36.5,-1,-37184,68659,105843,31475,0,-388,0,0,0,,388,-388
13,03/27/2018,20,4:45,5:00,,36.5,0,36.5,36.5,-1,-38650,54624,93274,15974,0,-459,0,0,0,,459,-459
13,03/27/2018,21,5:00,5:15,,36.5,0,36.5,36.5,-1,-43470,77108,120578,33638,0,-137,0,0,0,,137,-137
13,03/27/2018,22,5:15,5:30,39.64,36.5,0,39.64,34.89,2,-47971,33952,81923,-14019,0,-927,208,0,0,,1135,-719
13,03/27/2018,23,5:30,5:45,52.03,,0,52.03,52.03,1,-64486,32166,96652,-32320,0,0,19038,0,0,,19038,19038
13,03/27/2018,24,5:45,6:00,42.5,,0,42.5,42.5,1,-76387,48587,124974,-27800,0,0,23085,0,0,,23085,23085
13,03/27/2018,25,6:00,6:15,42.5,-133.03,0,-133.03,-133.03,-1,-30498,169844,200342,139346,0,-25284,4123,0,0,,29407,-21161
13,03/27/2018,26,6:15,6:30,,31.52,0,31.52,31.52,-1,-50940,79407,130347,28467,0,-16787,0,0,0,,16787,-16787
13,03/27/2018,27,6:30,6:45,47.49,31.52,0,47.49,47.49,1,-59537,59504,119041,-33,0,-2383,2308,0,0,,4691,-75
13,03/27/2018,28,6:45,7:00,82.27,,0,82.27,82.27,1,-90803,58996,149799,-31807,0,0,25609,0,0,,25609,25609
13,03/27/2018,29,7:00,7:15,36.58,-132.03,0,44.76,-132.03,2,-21118,117531,138649,96413,0,-33096,8294,0,0,,41390,-24802
13,03/27/2018,30,7:15,7:30,,35.06,0,35.06,35.06,-1,-56669,87569,144238,30900,0,-4671,0,0,0,,4671,-4671
13,03/27/2018,31,7:30,7:45,,35.49,0,35.49,35.49,-1,-45003,70646,115649,25643,0,-1788,0,0,0,,1788,-1788
13,03/27/2018,32,7:45,8:00,,52.81,0,52.81,52.81,-1,-85296,58003,143299,-27293,0,-681,0,0,0,,681,-681
13,03/27/2018,33,8:00,8:15,,53.31,0,53.31,53.31,-1,-21796,140069,161865,118273,0,-804,0,0,0,,804,-804
13,03/27/2018,34,8:15,8:30,,53.31,0,53.31,53.31,-1,-23133,133811,156944,110678,0,-7,0,0,0,,7,-7
13,03/27/2018,35,8:30,8:45,,53.25,0,53.25,53.25,-1,-32152,126301,158453,94149,0,-158,0,0,0,,158,-158
13,03/27/2018,36,8:45,9:00,,-26.03,0,-26.03,-26.03,-1,-38457,119718,158175,81261,0,-7240,0,0,0,,7240,-7240
13,03/27/2018,37,9:00,9:15,,-128.03,0,-128.03,-128.03,-1,-45471,127052,172523,81581,0,-15564,0,0,0,,15564,-15564
13,03/27/2018,38,9:15,9:30,,4.03,0,4.03,4.03,-1,-35321,116265,151586,80944,0,-25852,0,0,0,,25852,-25852
13,03/27/2018,39,9:30,9:45,,-34.03,0,-34.03,-34.03,-1,-33046,106121,139167,73075,0,-40173,0,0,0,,40173,-40173
13,03/27/2018,40,9:45,10:00,,-52.03,0,-52.03,-52.03,-1,-51590,108018,159608,56428,0,-50134,0,0,0,,50134,-50134
13,03/27/2018,41,10:00,10:15,38.57,-52.03,0,38.57,38.57,1,-109654,112791,222445,3137,0,-20473,147,0,0,,20620,-20326
13,03/27/2018,42,10:15,10:30,,-133.03,0,-133.03,-133.03,-1,-57363,149832,207195,92469,0,-35572,0,0,0,,35572,-35572
13,03/27/2018,43,10:30,10:45,,14.03,0,14.03,14.03,-1,-74561,128750,203311,54189,0,-36738,0,0,0,,36738,-36738
13,03/27/2018,44,10:45,11:00,,12.97,0,12.97,12.97,-1,-66895,116807,183702,49912,0,-41630,0,0,0,,41630,-41630
13,03/27/2018,45,11:00,11:15,41.49,35.49,0,41.49,35.49,2,-103469,69985,173454,-33484,0,-10491,1488,0,0,,11979,-9003
13,03/27/2018,46,11:15,11:30,37.3,35.49,0,37.33,35.49,2,-82000,90706,172706,8706,0,-91,142,0,0,,233,51
13,03/27/2018,47,11:30,11:45,,35.49,0,35.49,35.49,-1,-80707,116044,196751,35337,0,-1985,0,0,0,,1985,-1985
13,03/27/2018,48,11:45,12:00,,12.93,0,12.93,12.93,-1,-83223,135095,218318,51872,0,-16096,0,0,0,,16096,-16096
13,03/27/2018,49,12:00,12:15,,34.22,0,34.22,34.22,-1,-103324,88213,191537,-15111,0,-7684,0,0,0,,7684,-7684
13,03/27/2018,50,12:15,12:30,,33.48,0,33.48,33.48,-1,-77888,88498,166386,10610,0,-3793,0,0,0,,3793,-3793
13,03/27/2018,51,12:30,12:45,,5.45,0,5.45,5.45,-1,-76973,114734,191707,37761,0,-27832,0,0,0,,27832,-27832
13,03/27/2018,52,12:45,13:00,,13.39,0,13.39,13.39,-1,-79252,118607,197859,39355,0,-34919,0,0,0,,34919,-34919
13,03/27/2018,53,13:00,13:15,,30.78,0,30.78,30.78,-1,-75263,93564,168827,18301,0,-21387,0,0,0,,21387,-21387
13,03/27/2018,54,13:15,13:30,,29.49,0,29.49,29.49,-1,-63980,86464,150444,22484,0,-3181,0,0,0,,3181,-3181
13,03/27/2018,55,13:30,13:45,,35.49,0,35.49,35.49,-1,-72416,73661,146077,1245,0,-4049,0,0,0,,4049,-4049
13,03/27/2018,56,13:45,14:00,,,0,44.87,44.87,0,-88428,60995,149423,-27433,0,0,0,0,0,,0,0
13,03/27/2018,57,14:00,14:15,169.02,,0,169.02,169.02,1,-98882,59962,158844,-38920,0,0,13396,0,0,,13396,13396
13,03/27/2018,58,14:15,14:30,57.61,,0,57.61,57.61,1,-81283,52897,134180,-28386,0,0,32571,0,0,,32571,32571
13,03/27/2018,59,14:30,14:45,57.61,33.34,0,33.34,33.34,-1,-67126,79554,146680,12428,0,-1005,5884,0,0,,6889,4879
13,03/27/2018,60,14:45,15:00,,35.49,0,35.49,35.49,-1,-63637,74731,138368,11094,0,-1894,0,0,0,,1894,-1894
13,03/27/2018,61,15:00,15:15,,36.7,0,36.7,36.7,-1,-69362,118204,187566,48842,0,-1270,0,0,0,,1270,-1270
13,03/27/2018,62,15:15,15:30,,24.68,0,24.68,24.68,-1,-69717,116384,186101,46667,0,-5947,0,0,0,,5947,-5947
13,03/27/2018,63,15:30,15:45,,33.91,0,33.91,33.91,-1,-87895,82204,170099,-5691,0,-7814,0,0,0,,7814,-7814
13,03/27/2018,64,15:45,16:00,37.49,33.91,0,37.49,37.49,1,-92845,81939,174784,-10906,0,-70,251,0,0,,321,181
13,03/27/2018,65,16:00,16:15,36.77,,0,36.77,36.77,1,-95103,124320,219423,29217,0,0,751,0,0,,751,751
13,03/27/2018,66,16:15,16:30,37.49,,0,37.49,37.49,1,-94852,102972,197824,8120,0,0,802,0,0,,802,802
13,03/27/2018,67,16:30,16:45,47.49,,0,47.49,47.49,1,-102078,92169,194247,-9909,0,0,2899,0,0,,2899,2899
13,03/27/2018,68,16:45,17:00,47.49,,0,47.49,47.49,1,-109720,85035,194755,-24685,0,0,12194,0,0,,12194,12194
13,03/27/2018,69,17:00,17:15,63.94,,0,63.94,63.94,1,-150470,103689,254159,-46781,0,0,19954,0,0,,19954,19954
13,03/27/2018,70,17:15,17:30,71.12,,0,71.12,71.12,1,-123248,86588,209836,-36660,0,0,30975,0,0,,30975,30975
13,03/27/2018,71,17:30,17:45,41.49,,0,41.49,41.49,1,-121632,112025,233657,-9607,0,0,16997,0,0,,16997,16997
13,03/27/2018,72,17:45,18:00,47.49,,0,47.49,47.49,1,-121064,104326,225390,-16738,0,0,10522,0,0,,10522,10522
13,03/27/2018,73,18:00,18:15,61.92,,0,61.92,61.92,1,-145079,52208,197287,-92871,0,0,18807,0,0,,18807,18807
13,03/27/2018,74,18:15,18:30,98.02,,0,98.02,98.02,1,-119011,69141,188152,-49870,0,0,21730,0,0,,21730,21730
13,03/27/2018,75,18:30,18:45,43.02,,0,43.02,43.02,1,-114902,108285,223187,-6617,0,0,12385,0,0,,12385,12385
13,03/27/2018,76,18:45,19:00,272.02,,0,272.02,272.02,1,-118871,69826,188697,-49045,0,0,25923,0,0,,25923,25923
13,03/27/2018,77,19:00,19:15,290.02,,0,290.02,290.02,1,-143246,46884,190130,-96362,0,0,64892,0,0,,64892,64892
13,03/27/2018,78,19:15,19:30,61.02,,0,61.02,61.02,1,-136091,59950,196041,-76141,0,0,39721,0,0,,39721,39721
13,03/27/2018,79,19:30,19:45,92.41,,0,92.41,92.41,1,-140430,60922,201352,-79508,0,0,31740,0,0,,31740,31740
13,03/27/2018,80,19:45,20:00,291.02,,0,291.02,291.02,1,-156054,58632,214686,-97422,0,0,44478,0,0,,44478,44478
13,03/27/2018,81,20:00,20:15,170.02,,0,170.02,170.02,1,-168001,52268,220269,-115733,0,0,82612,0,0,,82612,82612
13,03/27/2018,82,20:15,20:30,162.02,,0,162.02,162.02,1,-170494,79790,250284,-90704,0,0,92948,0,0,,92948,92948
13,03/27/2018,83,20:30,20:45,149.02,,0,149.02,149.02,1,-161676,90184,251860,-71492,0,0,77102,0,0,,77102,77102
13,03/27/2018,84,20:45,21:00,84.9,,0,84.9,84.9,1,-140913,115498,256411,-25415,0,0,36885,0,0,,36885,36885
13,03/27/2018,85,21:00,21:15,138.02,,0,138.02,138.02,1,-153601,115399,269000,-38202,0,0,9680,0,0,,9680,9680
13,03/27/2018,86,21:15,21:30,47.02,33.95,0,33.95,33.95,-1,-118259,120110,238369,1851,0,-96,16420,0,0,,16516,16324
13,03/27/2018,87,21:30,21:45,47.02,14.35,0,14.35,14.35,-1,-102068,140646,242714,38578,0,-22595,330,0,0,,22925,-22265
13,03/27/2018,88,21:45,22:00,,29.49,0,29.49,29.49,-1,-113062,151200,264262,38138,0,-24042,0,0,0,,24042,-24042
13,03/27/2018,89,22:00,22:15,169.02,32.03,0,169.02,169.02,1,-147069,80170,227239,-66899,0,-11523,18973,0,0,,30496,7450
13,03/27/2018,90,22:15,22:30,71.1,,0,71.1,71.1,1,-118985,103159,222144,-15826,0,0,28737,0,0,,28737,28737
13,03/27/2018,91,22:30,22:45,71.1,35.49,0,35.49,35.49,-1,-104635,147877,252512,43242,0,-901,2206,0,0,,3107,1305
13,03/27/2018,92,22:45,23:00,,32.88,0,32.88,32.88,-1,-104240,202098,306338,97858,0,-2184,0,0,0,,2184,-2184
13,03/27/2018,93,23:00,23:15,69.12,35.8,0,69.12,35.8,2,-119690,90327,210017,-29363,0,-324,6416,0,0,,6740,6092
13,03/27/2018,94,23:15,23:30,70.02,36.16,0,70.02,36.16,2,-103566,93563,197129,-10003,0,-52,22424,0,0,,22476,22372
13,03/27/2018,95,23:30,23:45,70.02,27.72,0,27.72,27.72,-1,-86264,127071,213335,40807,0,-12048,1152,0,0,,13200,-10896
13,03/27/2018,96,23:45,0:00,,10.31,0,10.31,10.31,-1,-115398,166787,282185,51389,0,-35957,0,0,0,,35957,-35957
13,03/28/2018,1,0:00,0:15,207.12,5.39,0,207.12,207.12,1,-66690,16947,83637,-49743,0,-24547,8284,0,0,,32831,-16263
13,03/28/2018,2,0:15,0:30,207.12,36.69,0,207.12,34.67,2,-64062,56295,120357,-7767,0,-11,31535,0,0,,31546,31524
13,03/28/2018,3,0:30,0:45,207.12,36.19,0,36.19,36.19,-1,-65138,81877,147015,16739,0,-1401,56,0,0,,1457,-1345
13,03/28/2018,4,0:45,1:00,,33.78,0,33.78,33.78,-1,-62119,105661,167780,43542,0,-5667,0,0,0,,5667,-5667
13,03/28/2018,5,1:00,1:15,39.58,25.78,0,39.58,25.78,2,-23562,32154,55716,8592,0,-7179,592,0,0,,7771,-6587
13,03/28/2018,6,1:15,1:30,,,0,33.94,33.94,0,-18081,45121,63202,27040,0,0,91,0,0,,91,91
13,03/28/2018,7,1:30,1:45,,27.58,0,27.58,27.58,-1,-16006,47554,63560,31548,0,-1762,0,0,0,,1762,-1762
13,03/28/2018,8,1:45,2:00,,20.2,0,20.2,20.2,-1,-16771,66052,82823,49281,0,-25890,0,0,0,,25890,-25890
13,03/28/2018,9,2:00,2:15,,21.78,0,21.78,21.78,-1,-23779,48198,71977,24419,0,-19609,0,0,0,,19609,-19609
13,03/28/2018,10,2:15,2:30,,,0,34.02,34.02,0,-20914,41682,62596,20768,0,-81,0,0,0,,81,-81
13,03/28/2018,11,2:30,2:45,,,0,34.02,34.02,0,-27993,42847,70840,14854,0,0,0,0,0,,0,0
13,03/28/2018,12,2:45,3:00,,31.78,0,31.78,31.78,-1,-24113,33572,57685,9459,0,-395,0,0,0,,395,-395
13,03/28/2018,13,3:00,3:15,,,0,33.94,33.94,0,-30602,47799,78401,17197,0,-122,0,0,0,,122,-122
13,03/28/2018,14,3:15,3:30,,,0,33.94,33.94,0,-28911,42580,71491,13669,0,0,0,0,0,,0,0
13,03/28/2018,15,3:30,3:45,,,0,33.95,33.95,0,-21507,39430,60937,17923,0,0,0,0,0,,0,0
13,03/28/2018,16,3:45,4:00,,28.78,0,28.78,28.78,-1,-18643,47608,66251,28965,0,-1853,0,0,0,,1853,-1853
13,03/28/2018,17,4:00,4:15,,35.14,0,35.14,35.14,-1,-19112,90146,109258,71034,0,-1205,0,0,0,,1205,-1205
13,03/28/2018,18,4:15,4:30,,,0,33.92,33.92,0,-19960,77482,97442,57522,0,0,0,0,0,,0,0
13,03/28/2018,19,4:30,4:45,,30.94,0,30.94,30.94,-1,-24225,82595,106820,58370,0,-1272,0,0,0,,1272,-1272
13,03/28/2018,20,4:45,5:00,,31.78,0,31.78,31.78,-1,-25921,85976,111897,60055,0,-1658,0,0,0,,1658,-1658
13,03/28/2018,21,5:00,5:15,,8.16,0,8.16,8.16,-1,-21533,115396,136929,93863,0,-14857,0,0,0,,14857,-14857
13,03/28/2018,22,5:15,5:30,,26.55,0,26.55,26.55,-1,-18563,107944,126507,89381,0,-31472,0,0,0,,31472,-31472
13,03/28/2018,23,5:30,5:45,,,0,34.47,34.47,0,-23724,74102,97826,50378,0,-6408,0,0,0,,6408,-6408
13,03/28/2018,24,5:45,6:00,,,0,34.44,34.44,0,-35215,98962,134177,63747,0,0,0,0,0,,0,0
13,03/28/2018,25,6:00,6:15,,-150.78,0,-150.78,-150.78,-1,-21133,150494,171627,129361,0,-33523,0,0,0,,33523,-33523
13,03/28/2018,26,6:15,6:30,,16.43,0,16.43,16.43,-1,-45180,93622,138802,48442,0,-57596,0,0,0,,57596,-57596
13,03/28/2018,27,6:30,6:45,,32.78,0,32.78,32.78,-1,-53858,79352,133210,25494,0,-20353,0,0,0,,20353,-20353
13,03/28/2018,28,6:45,7:00,39.71,32.78,0,39.71,39.71,1,-84309,62398,146707,-21911,0,-722,477,0,0,,1199,-245
13,03/28/2018,29,7:00,7:15,,-53.54,0,-53.54,-53.54,-1,-33986,103253,137239,69267,0,-14370,0,0,0,,14370,-14370
13,03/28/2018,30,7:15,7:30,,29.48,0,29.48,29.48,-1,-50280,76087,126367,25807,0,-7476,0,0,0,,7476,-7476
13,03/28/2018,31,7:30,7:45,41.08,26.43,0,45.11,26.43,2,-56883,57168,114051,285,0,-19092,166,0,0,,19258,-18926
13,03/28/2018,32,7:45,8:00,140.12,26.43,0,140.12,140.12,1,-134451,48177,182628,-86274,0,-1327,20698,0,0,,22025,19371
13,03/28/2018,33,8:00,8:15,140.12,-121.78,0,-121.78,-121.78,-1,-28442,88768,117210,60326,0,-23361,1681,0,0,,25042,-21680
13,03/28/2018,34,8:15,8:30,,21.71,0,21.71,21.71,-1,-49733,82677,132410,32944,0,-13170,0,0,0,,13170,-13170
13,03/28/2018,35,8:30,8:45,40.98,33.78,0,45.19,33.78,2,-81214,59705,140919,-21509,0,-5907,1228,0,0,,7135,-4679
13,03/28/2018,36,8:45,9:00,56.18,,0,56.18,56.18,1,-105738,63880,169618,-41858,0,0,3537,0,0,,3537,3537
13,03/28/2018,37,9:00,9:15,56.18,33.71,0,33.71,33.71,-1,-55119,114063,169182,58944,0,-629,740,0,0,,1369,111
13,03/28/2018,38,9:15,9:30,,30.07,0,30.07,30.07,-1,-70850,86885,157735,16035,0,-1872,0,0,0,,1872,-1872
13,03/28/2018,39,9:30,9:45,,35.61,0,35.61,35.61,-1,-76318,89198,165516,12880,0,-1985,0,0,0,,1985,-1985
13,03/28/2018,40,9:45,10:00,,53.47,0,53.47,53.47,-1,-78066,60772,138838,-17294,0,-1442,0,0,0,,1442,-1442
13,03/28/2018,41,10:00,10:15,54.78,,0,54.78,54.78,1,-101094,77191,178285,-23903,0,0,6504,0,0,,6504,6504
13,03/28/2018,42,10:15,10:30,44.78,,0,44.78,44.78,1,-122353,85189,207542,-37164,0,0,10544,0,0,,10544,10544
13,03/28/2018,43,10:30,10:45,65.12,,0,65.12,65.12,1,-120022,73313,193335,-46709,0,0,14774,0,0,,14774,14774
13,03/28/2018,44,10:45,11:00,39.83,,0,39.83,39.83,1,-138211,82654,220865,-55557,0,0,8567,0,0,,8567,8567
13,03/28/2018,45,11:00,11:15,50.65,,0,50.65,50.65,1,-121762,104133,225895,-17629,0,0,14094,0,0,,14094,14094
13,03/28/2018,46,11:15,11:30,39.82,,0,39.82,39.82,1,-134744,113675,248419,-21069,0,0,16101,0,0,,16101,16101
13,03/28/2018,47,11:30,11:45,61.12,,0,61.12,61.12,1,-134250,106243,240493,-28007,0,0,15521,0,0,,15521,15521
13,03/28/2018,48,11:45,12:00,129.12,,0,129.12,129.12,1,-127655,93654,221309,-34001,0,0,32403,0,0,,32403,32403
13,03/28/2018,49,12:00,12:15,39.25,,0,39.25,39.25,1,-112451,94280,206731,-18171,0,0,17620,0,0,,17620,17620
13,03/28/2018,50,12:15,12:30,39.31,,0,39.31,39.31,1,-108123,87502,195625,-20621,0,0,10589,0,0,,10589,10589
13,03/28/2018,51,12:30,12:45,75.12,,0,75.12,75.12,1,-113463,86443,199906,-27020,0,0,12098,0,0,,12098,12098
13,03/28/2018,52,12:45,13:00,123.05,,0,123.05,123.05,1,-122820,67726,190546,-55094,0,0,32581,0,0,,32581,32581
13,03/28/2018,53,13:00,13:15,92.12,,0,92.12,92.12,1,-85683,42724,128407,-42959,0,0,40361,0,0,,40361,40361
13,03/28/2018,54,13:15,13:30,139.12,,0,139.12,139.12,1,-125241,22252,147493,-102989,0,0,72827,0,0,,72827,72827
13,03/28/2018,55,13:30,13:45,139.12,,0,139.12,139.12,1,-143675,36017,179692,-107658,0,0,103214,0,0,,103214,103214
13,03/28/2018,56,13:45,14:00,139.12,,0,139.12,139.12,1,-148198,24245,172443,-123953,0,0,99734,0,0,,99734,99734
13,03/28/2018,57,14:00,14:15,311.12,,0,311.12,311.12,1,-108539,42339,150878,-66200,0,0,72800,0,0,,72800,72800
13,03/28/2018,58,14:15,14:30,169.12,,0,169.12,169.12,1,-118931,54304,173235,-64627,0,0,49247,0,0,,49247,49247
13,03/28/2018,59,14:30,14:45,311.12,,0,311.12,311.12,1,-131503,55550,187053,-75953,0,0,64957,0,0,,64957,64957
13,03/28/2018,60,14:45,15:00,237.12,,0,237.12,237.12,1,-128238,52937,181175,-75301,0,0,67210,0,0,,67210,67210
13,03/28/2018,61,15:00,15:15,237.12,34.48,0,34.48,34.48,-1,-81338,105256,186594,23918,0,-775,17370,0,0,,18145,16595
13,03/28/2018,62,15:15,15:30,56.51,,0,56.51,56.51,1,-114353,88992,203345,-25361,0,0,2549,0,0,,2549,2549
13,03/28/2018,63,15:30,15:45,49.07,,0,49.07,49.07,1,-103429,78409,181838,-25020,0,0,12751,0,0,,12751,12751
13,03/28/2018,64,15:45,16:00,55.91,36.63,0,55.91,36.41,2,-84594,75659,160253,-8935,0,-23,16469,0,0,,16492,16446
13,03/28/2018,65,16:00,16:15,55.91,27.36,0,27.36,27.36,-1,-84903,121125,206028,36222,0,-13490,1507,0,0,,14997,-11983
13,03/28/2018,66,16:15,16:30,,33.71,0,33.71,33.71,-1,-74420,104478,178898,30058,0,-10180,0,0,0,,10180,-10180
13,03/28/2018,67,16:30,16:45,,35.53,0,35.53,35.53,-1,-65100,112864,177964,47764,0,-5061,0,0,0,,5061,-5061
13,03/28/2018,68,16:45,17:00,,,0,36.34,36.34,0,-75783,105597,181380,29814,0,-256,0,0,0,,256,-256
13,03/28/2018,69,17:00,17:15,36.73,,0,36.73,36.73,1,-109157,95920,205077,-13237,0,0,822,0,0,,822,822
13,03/28/2018,70,17:15,17:30,39.71,,0,39.71,39.71,1,-114270,97965,212235,-16305,0,0,5270,0,0,,5270,5270
13,03/28/2018,71,17:30,17:45,39.71,,0,39.71,39.71,1,-113305,104644,217949,-8661,0,0,7018,0,0,,7018,7018
13,03/28/2018,72,17:45,18:00,35.71,,0,35.71,35.71,1,-81456,132561,214017,51105,0,0,1319,0,0,,1319,1319
13,03/28/2018,73,18:00,18:15,36.48,,0,36.48,36.48,1,-146456,100524,246980,-45932,0,0,1564,0,0,,1564,1564
13,03/28/2018,74,18:15,18:30,36.48,32.78,0,32.78,32.78,-1,-105310,139393,244703,34083,0,-3806,53,0,0,,3859,-3753
13,03/28/2018,75,18:30,18:45,,36.46,0,36.46,36.46,-1,-75514,161990,237504,86476,0,-2011,0,0,0,,2011,-2011
13,03/28/2018,76,18:45,19:00,,37.36,0,37.36,37.36,-1,-68408,188478,256886,120070,0,-783,0,0,0,,783,-783
13,03/28/2018,77,19:00,19:15,,27.71,0,27.71,27.71,-1,-114387,124994,239381,10607,0,-9543,0,0,0,,9543,-9543
13,03/28/2018,78,19:15,19:30,,33.01,0,33.01,33.01,-1,-116124,134626,250750,18502,0,-11935,0,0,0,,11935,-11935
13,03/28/2018,79,19:30,19:45,,-7.78,0,-7.78,-7.78,-1,-86732,149969,236701,63237,0,-9480,0,0,0,,9480,-9480
13,03/28/2018,80,19:45,20:00,35.71,-7.78,0,35.71,35.71,1,-110165,138358,248523,28193,0,-14743,12,0,0,,14755,-14731
13,03/28/2018,81,20:00,20:15,75.12,-7.78,0,75.12,75.12,1,-107224,67649,174873,-39575,0,-96,12423,0,0,,12519,12327
13,03/28/2018,82,20:15,20:30,39.71,,0,39.71,39.71,1,-88176,79697,167873,-8479,0,0,8635,0,0,,8635,8635
13,03/28/2018,83,20:30,20:45,35.71,,0,35.71,35.71,1,-87523,101060,188583,13537,0,0,2056,0,0,,2056,2056
13,03/28/2018,84,20:45,21:00,35.71,,0,35.71,35.71,1,-63843,118106,181949,54263,0,0,15,0,0,,15,15
13,03/28/2018,85,21:00,21:15,,,0,36.54,36.54,0,-55852,136761,192613,80909,0,0,0,0,0,,0,0
13,03/28/2018,86,21:15,21:30,,,0,36.54,36.54,0,-32452,142262,174714,109810,0,0,0,0,0,,0,0
13,03/28/2018,87,21:30,21:45,,36.46,0,36.46,36.46,-1,-24261,176760,201021,152499,0,-99,0,0,0,,99,-99
13,03/28/2018,88,21:45,22:00,,19.95,0,19.95,19.95,-1,-31241,211222,242463,179981,0,-16480,0,0,0,,16480,-16480
13,03/28/2018,89,22:00,22:15,39.71,12.93,0,39.71,39.71,1,-108163,33069,141232,-75094,0,-15708,514,0,0,,16222,-15194
13,03/28/2018,90,22:15,22:30,,,0,36.35,36.35,0,-49662,35072,84734,-14590,0,-7,100,0,0,,107,93
13,03/28/2018,91,22:30,22:45,35.71,,0,35.71,35.71,1,-49308,40748,90056,-8560,0,0,980,0,0,,980,980
13,03/28/2018,92,22:45,23:00,35.71,32.78,0,32.78,32.78,-1,-44264,85471,129735,41207,0,-1963,464,0,0,,2427,-1499
13,03/28/2018,93,23:00,23:15,36.83,29.95,0,36.83,29.95,2,-128537,44569,173106,-83968,0,-2585,381,0,0,,2966,-2204
13,03/28/2018,94,23:15,23:30,,,0,36.23,36.23,0,-98803,46690,145493,-52113,0,0,0,0,0,,0,0
13,03/28/2018,95,23:30,23:45,36.62,,0,36.62,36.62,1,-66784,59679,126463,-7105,0,0,965,0,0,,965,965
13,03/28/2018,96,23:45,0:00,35.71,,0,35.71,35.71,1,-93182,96282,189464,3100,0,0,797,0,0,,797,797
13,03/29/2018,1,0:00,0:15,237.02,,0,237.02,237.02,1,-77675,15936,93611,-61739,0,0,26516,0,0,,26516,26516
13,03/29/2018,2,0:15,0:30,53.02,,0,53.02,53.02,1,-67547,44708,112255,-22839,0,0,34238,0,0,,34238,34238
13,03/29/2018,3,0:30,0:45,53.02,34.34,0,34.34,34.34,-1,-52319,57956,110275,5637,0,-812,5538,0,0,,6350,4726
13,03/29/2018,4,0:45,1:00,,,0,34.78,34.78,0,-55919,54142,110061,-1777,0,0,0,0,0,,0,0
13,03/29/2018,5,1:00,1:15,180.02,,0,180.02,180.02,1,-75460,15588,91048,-59872,0,0,16216,0,0,,16216,16216
13,03/29/2018,6,1:15,1:30,39.23,,0,39.23,39.23,1,-47659,21052,68711,-26607,0,0,14259,0,0,,14259,14259
13,03/29/2018,7,1:30,1:45,32.52,,0,32.52,32.52,1,-37166,36779,73945,-387,0,0,4412,0,0,,4412,4412
13,03/29/2018,8,1:45,2:00,,22.34,0,22.34,22.34,-1,-21328,45939,67267,24611,0,-4058,0,0,0,,4058,-4058
13,03/29/2018,9,2:00,2:15,,13.97,0,13.97,13.97,-1,-28873,44120,72993,15247,0,-9364,0,0,0,,9364,-9364
13,03/29/2018,10,2:15,2:30,,,0,34.58,34.58,0,-31141,55811,86952,24670,0,-9,0,0,0,,9,-9
13,03/29/2018,11,2:30,2:45,40.34,,0,40.34,40.34,1,-36981,22633,59614,-14348,0,0,3303,0,0,,3303,3303
13,03/29/2018,12,2:45,3:00,40.96,,0,40.96,40.96,1,-46571,14666,61237,-31905,0,0,14302,0,0,,14302,14302
13,03/29/2018,13,3:00,3:15,39.4,,0,39.4,39.4,1,-48882,55957,104839,7075,0,0,5727,0,0,,5727,5727
13,03/29/2018,14,3:15,3:30,46.34,,0,46.34,46.34,1,-57301,45436,102737,-11865,0,0,6378,0,0,,6378,6378
13,03/29/2018,15,3:30,3:45,38.07,,0,38.07,38.07,1,-45982,30034,76016,-15948,0,0,1542,0,0,,1542,1542
13,03/29/2018,16,3:45,4:00,46.34,,0,46.34,46.34,1,-47791,16854,64645,-30937,0,0,12681,0,0,,12681,12681
13,03/29/2018,17,4:00,4:15,46.34,32.2,0,32.2,32.2,-1,-53369,81147,134516,27778,0,-958,4202,0,0,,5160,3244
13,03/29/2018,18,4:15,4:30,46.34,,0,46.34,46.34,1,-60528,41241,101769,-19287,0,0,3130,0,0,,3130,3130
13,03/29/2018,19,4:30,4:45,48.17,,0,48.17,48.17,1,-65015,35461,100476,-29554,0,0,21261,0,0,,21261,21261
13,03/29/2018,20,4:45,5:00,40.35,,0,40.35,40.35,1,-62037,42088,104125,-19949,0,0,22657,0,0,,22657,22657
13,03/29/2018,21,5:00,5:15,104.02,,0,104.02,104.02,1,-74064,37720,111784,-36344,0,0,27388,0,0,,27388,27388
13,03/29/2018,22,5:15,5:30,40.92,22.34,0,40.92,22.34,2,-45154,41191,86345,-3963,0,-3044,3698,0,0,,6742,654
13,03/29/2018,23,5:30,5:45,47.96,,0,47.96,47.96,1,-56882,21502,78384,-35380,0,0,18168,0,0,,18168,18168
13,03/29/2018,24,5:45,6:00,40.35,,0,40.35,40.35,1,-64441,42274,106715,-22167,0,0,19808,0,0,,19808,19808
13,03/29/2018,25,6:00,6:15,40.35,15.52,0,15.52,15.52,-1,-52052,84594,136646,32542,0,-9421,4867,0,0,,14288,-4554
13,03/29/2018,26,6:15,6:30,46.63,15.52,0,46.63,46.63,1,-59208,27041,86249,-32167,0,-493,10318,0,0,,10811,9825
13,03/29/2018,27,6:30,6:45,350.02,,0,350.02,350.02,1,-98631,20789,119420,-77842,0,0,50037,0,0,,50037,50037
13,03/29/2018,28,6:45,7:00,350.02,,0,350.02,350.02,1,-159475,50664,210139,-108811,0,0,85908,0,0,,85908,85908
13,03/29/2018,29,7:00,7:15,40.63,8.75,0,40.63,8.75,2,-53758,129519,183277,75761,0,-4573,30334,0,0,,34907,25761
13,03/29/2018,30,7:15,7:30,54.02,,0,54.02,54.02,1,-69552,50278,119830,-19274,0,0,6326,0,0,,6326,6326
13,03/29/2018,31,7:30,7:45,159.02,,0,159.02,159.02,1,-94499,49042,143541,-45457,0,0,22359,0,0,,22359,22359
13,03/29/2018,32,7:45,8:00,143.02,,0,143.02,143.02,1,-145030,59894,204924,-85136,0,0,60230,0,0,,60230,60230
13,03/29/2018,33,8:00,8:15,44.34,,0,44.34,44.34,1,-82270,68681,150951,-13589,0,0,26001,0,0,,26001,26001
13,03/29/2018,34,8:15,8:30,146.02,,0,146.02,146.02,1,-106361,52963,159324,-53398,0,0,31682,0,0,,31682,31682
13,03/29/2018,35,8:30,8:45,141.02,,0,141.02,141.02,1,-110678,41999,152677,-68679,0,0,54686,0,0,,54686,54686
13,03/29/2018,36,8:45,9:00,155.02,,0,155.02,155.02,1,-123408,37918,161326,-85490,0,0,65216,0,0,,65216,65216
13,03/29/2018,37,9:00,9:15,189.02,,0,189.02,189.02,1,-95138,38561,133699,-56577,0,0,69964,0,0,,69964,69964
13,03/29/2018,38,9:15,9:30,69.17,36.37,0,36.37,36.37,-1,-72918,57934,130852,-14984,0,-18,33102,0,0,,33120,33084
13,03/29/2018,39,9:30,9:45,59.17,34.63,0,59.17,34.63,2,-86407,70038,156445,-16369,0,-728,3966,0,0,,4694,3238
13,03/29/2018,40,9:45,10:00,59.17,,0,59.17,59.17,1,-75622,67730,143352,-7892,0,0,7117,0,0,,7117,7117
13,03/29/2018,41,10:00,10:15,160.02,,0,160.02,160.02,1,-107048,50306,157354,-56742,0,0,33914,0,0,,33914,33914
13,03/29/2018,42,10:15,10:30,60.9,,0,60.9,60.9,1,-76373,55769,132142,-20604,0,0,30114,0,0,,30114,30114
13,03/29/2018,43,10:30,10:45,39.76,29.04,0,47.98,29.04,2,-49692,56740,106432,7048,0,-1283,8638,0,0,,9921,7355
13,03/29/2018,44,10:45,11:00,,28.63,0,28.63,28.63,-1,-61163,74178,135341,13015,0,-9120,0,0,0,,9120,-9120
13,03/29/2018,45,11:00,11:15,43.16,34.63,0,47.82,34.63,2,-89490,73139,162629,-16351,0,-6949,1077,0,0,,8026,-5872
13,03/29/2018,46,11:15,11:30,,10.61,0,10.61,10.61,-1,-78223,107525,185748,29302,0,-10664,0,0,0,,10664,-10664
13,03/29/2018,47,11:30,11:45,,-76.73,0,-76.73,-76.73,-1,-83751,142621,226372,58870,0,-55044,0,0,0,,55044,-55044
13,03/29/2018,48,11:45,12:00,,27.54,0,27.54,27.54,-1,-94392,138539,232931,44147,0,-29529,0,0,0,,29529,-29529
13,03/29/2018,49,12:00,12:15,,28.03,0,28.03,28.03,-1,-91696,116984,208680,25288,0,-14278,0,0,0,,14278,-14278
13,03/29/2018,50,12:15,12:30,,-33.97,0,-33.97,-33.97,-1,-66124,164300,230424,98176,0,-7322,0,0,0,,7322,-7322
13,03/29/2018,51,12:30,12:45,,-57.33,0,-57.33,-57.33,-1,-86936,160123,247059,73187,0,-31860,0,0,0,,31860,-31860
13,03/29/2018,52,12:45,13:00,,-65.03,0,-65.03,-65.03,-1,-86423,176526,262949,90103,0,-66551,0,0,0,,66551,-66551
13,03/29/2018,53,13:00,13:15,38.45,-20.03,0,38.45,38.45,1,-126626,105498,232124,-21128,0,-42716,56,0,0,,42772,-42660
13,03/29/2018,54,13:15,13:30,38.45,26.33,0,26.33,26.33,-1,-95009,108364,203373,13355,0,-5334,3,0,0,,5337,-5331
13,03/29/2018,55,13:30,13:45,,25.03,0,25.03,25.03,-1,-99509,105354,204863,5845,0,-10315,0,0,0,,10315,-10315
13,03/29/2018,56,13:45,14:00,,21.03,0,21.03,21.03,-1,-91604,109892,201496,18288,0,-20099,0,0,0,,20099,-20099
13,03/29/2018,57,14:00,14:15,,27.95,0,27.95,27.95,-1,-83474,141490,224964,58016,0,-16982,0,0,0,,16982,-16982
13,03/29/2018,58,14:15,14:30,,2.63,0,2.63,2.63,-1,-75298,136646,211944,61348,0,-7955,0,0,0,,7955,-7955
13,03/29/2018,59,14:30,14:45,,-9.44,0,-9.44,-9.44,-1,-86082,115861,201943,29779,0,-29963,0,0,0,,29963,-29963
13,03/29/2018,60,14:45,15:00,,27.74,0,27.74,27.74,-1,-100090,137426,237516,37336,0,-33580,0,0,0,,33580,-33580
13,03/29/2018,61,15:00,15:15,,20.07,0,20.07,20.07,-1,-100295,155650,255945,55355,0,-41310,0,0,0,,41310,-41310
13,03/29/2018,62,15:15,15:30,,22.63,0,22.63,22.63,-1,-92893,148508,241401,55615,0,-32606,0,0,0,,32606,-32606
13,03/29/2018,63,15:30,15:45,,24.61,0,24.61,24.61,-1,-78761,135527,214288,56766,0,-32441,0,0,0,,32441,-32441
13,03/29/2018,64,15:45,16:00,,14.03,0,14.03,14.03,-1,-93013,140698,233711,47685,0,-34428,0,0,0,,34428,-34428
13,03/29/2018,65,16:00,16:15,,-38.03,0,-38.03,-38.03,-1,-62593,159490,222083,96897,0,-40202,0,0,0,,40202,-40202
13,03/29/2018,66,16:15,16:30,,-62.03,0,-62.03,-62.03,-1,-72959,131975,204934,59016,0,-58958,0,0,0,,58958,-58958
13,03/29/2018,67,16:30,16:45,,15.54,0,15.54,15.54,-1,-75469,133052,208521,57583,0,-46214,0,0,0,,46214,-46214
13,03/29/2018,68,16:45,17:00,,26.63,0,26.63,26.63,-1,-87503,120067,207570,32564,0,-33123,0,0,0,,33123,-33123
13,03/29/2018,69,17:00,17:15,,22.63,0,22.63,22.63,-1,-64447,126239,190686,61792,0,-31770,0,0,0,,31770,-31770
13,03/29/2018,70,17:15,17:30,,26.88,0,26.88,26.88,-1,-59517,101226,160743,41709,0,-30099,0,0,0,,30099,-30099
13,03/29/2018,71,17:30,17:45,,32.69,0,32.69,32.69,-1,-64847,107059,171906,42212,0,-7910,0,0,0,,7910,-7910
13,03/29/2018,72,17:45,18:00,,28.63,0,28.63,28.63,-1,-69409,104954,174363,35545,0,-8667,0,0,0,,8667,-8667
13,03/29/2018,73,18:00,18:15,,8.91,0,8.91,8.91,-1,-60377,84562,144939,24185,0,-12717,0,0,0,,12717,-12717
13,03/29/2018,74,18:15,18:30,,-1.25,0,-1.25,-1.25,-1,-56097,56788,112885,691,0,-23287,0,0,0,,23287,-23287
13,03/29/2018,75,18:30,18:45,,34.63,0,34.63,34.63,-1,-56793,76633,133426,19840,0,-1753,0,0,0,,1753,-1753
13,03/29/2018,76,18:45,19:00,,,0,37.21,37.21,0,-48575,93162,141737,44587,0,0,0,0,0,,0,0
13,03/29/2018,77,19:00,19:15,,,0,47.89,47.89,0,-88423,49774,138197,-38649,0,0,0,0,0,,0,0
13,03/29/2018,78,19:15,19:30,40.63,,0,40.63,40.63,1,-87520,47656,135176,-39864,0,0,477,0,0,,477,477
13,03/29/2018,79,19:30,19:45,46.63,,0,46.63,46.63,1,-72715,42215,114930,-30500,0,0,5926,0,0,,5926,5926
13,03/29/2018,80,19:45,20:00,36.63,,0,36.63,36.63,1,-95899,32172,128071,-63727,0,0,3190,0,0,,3190,3190
13,03/29/2018,81,20:00,20:15,40.63,,0,40.63,40.63,1,-53684,25127,78811,-28557,0,0,1155,0,0,,1155,1155
13,03/29/2018,82,20:15,20:30,150.02,,0,150.02,150.02,1,-96423,15139,111562,-81284,0,0,34638,0,0,,34638,34638
13,03/29/2018,83,20:30,20:45,139.02,,0,139.02,139.02,1,-82199,20636,102835,-61563,0,0,54176,0,0,,54176,54176
13,03/29/2018,84,20:45,21:00,139.02,22.63,0,22.63,22.63,-1,-31048,41663,72711,10615,0,-6693,6653,0,0,,13346,-40
13,03/29/2018,85,21:00,21:15,139.02,19.68,0,139.02,19.68,2,-84175,37629,121804,-46546,0,-11064,8692,0,0,,19756,-2372
13,03/29/2018,86,21:15,21:30,40.63,34.63,0,34.63,34.63,-1,-37064,52757,89821,15693,0,-354,4463,0,0,,4817,4109
13,03/29/2018,87,21:30,21:45,,28.21,0,28.21,28.21,-1,-14633,103289,117922,88656,0,-3255,0,0,0,,3255,-3255
13,03/29/2018,88,21:45,22:00,,-72.16,0,-72.16,-72.16,-1,-31986,101505,133491,69519,0,-44507,0,0,0,,44507,-44507
13,03/29/2018,89,22:00,22:15,36.63,34.63,0,36.63,34.63,2,-106379,26618,132997,-79761,0,-7493,295,0,0,,7788,-7198
13,03/29/2018,90,22:15,22:30,,37.7,0,37.7,37.7,-1,-43925,30359,74284,-13566,0,-38,0,0,0,,38,-38
13,03/29/2018,91,22:30,22:45,,34.63,0,34.63,34.63,-1,-12735,44056,56791,31321,0,-1415,0,0,0,,1415,-1415
13,03/29/2018,92,22:45,23:00,,33.03,0,33.03,33.03,-1,-14413,100730,115143,86317,0,-4215,0,0,0,,4215,-4215
13,03/29/2018,93,23:00,23:15,272.02,31.03,0,272.02,272.02,1,-95910,22461,118371,-73449,0,-3994,15366,0,0,,19360,11372
13,03/29/2018,94,23:15,23:30,272.02,31.03,0,272.02,272.02,1,-56007,45291,101298,-10716,0,-11,38969,0,0,,38980,38958
13,03/29/2018,95,23:30,23:45,272.02,36.21,0,36.21,36.21,-1,-28167,81459,109626,53292,0,-163,1573,0,0,,1736,1410
13,03/29/2018,96,23:45,0:00,,30.78,0,30.78,30.78,-1,-29733,73018,102751,43285,0,-3525,0,0,0,,3525,-3525
13,03/30/2018,1,0:00,0:15,32.81,31,0,32.81,32.81,1,-94884,126894,221778,32010,0,-3545,19,0,0,,3564,-3526
13,03/30/2018,2,0:15,0:30,42.58,,0,42.58,42.58,1,-100495,85542,186037,-14953,0,0,8030,0,0,,8030,8030
13,03/30/2018,3,0:30,0:45,35.73,,0,35.73,35.73,1,-92214,91350,183564,-864,0,0,2494,0,0,,2494,2494
13,03/30/2018,4,0:45,1:00,,,0,35.17,35.17,0,-110157,110443,220600,286,0,0,93,0,0,,93,93
13,03/30/2018,5,1:00,1:15,,,0,34.56,34.56,0,-82498,112116,194614,29618,0,0,0,0,0,,0,0
13,03/30/2018,6,1:15,1:30,,,0,34.56,34.56,0,-83339,119400,202739,36061,0,0,0,0,0,,0,0
13,03/30/2018,7,1:30,1:45,,,0,34.56,34.56,0,-45182,118990,164172,73808,0,0,0,0,0,,0,0
13,03/30/2018,8,1:45,2:00,,-150.78,0,-150.78,-150.78,-1,-46556,122148,168704,75592,0,-16264,0,0,0,,16264,-16264
13,03/30/2018,9,2:00,2:15,,27.73,0,27.73,27.73,-1,-65149,93603,158752,28454,0,-10268,0,0,0,,10268,-10268
13,03/30/2018,10,2:15,2:30,,,0,34.4,34.4,0,-58809,74276,133085,15467,0,0,0,0,0,,0,0
13,03/30/2018,11,2:30,2:45,,,0,34.39,34.39,0,-54186,73034,127220,18848,0,0,0,0,0,,0,0
13,03/30/2018,12,2:45,3:00,,17.76,0,17.76,17.76,-1,-50285,99006,149291,48721,0,-8127,0,0,0,,8127,-8127
13,03/30/2018,13,3:00,3:15,35.73,30.12,0,35.73,30.12,2,-73533,69623,143156,-3910,0,-7275,580,0,0,,7855,-6695
13,03/30/2018,14,3:15,3:30,,,0,34.31,34.31,0,-40720,68424,109144,27704,0,0,119,0,0,,119,119
13,03/30/2018,15,3:30,3:45,,,0,34.31,34.31,0,-58360,90586,148946,32226,0,0,0,0,0,,0,0
13,03/30/2018,16,3:45,4:00,,,0,34.31,34.31,0,-63588,93311,156899,29723,0,0,0,0,0,,0,0
13,03/30/2018,17,4:00,4:15,,,0,33.19,33.19,0,-40524,94390,134914,53866,0,0,0,0,0,,0,0
13,03/30/2018,18,4:15,4:30,,,0,33.2,33.2,0,-35582,98702,134284,63120,0,0,0,0,0,,0,0
13,03/30/2018,19,4:30,4:45,,,0,33.21,33.21,0,-45594,95451,141045,49857,0,0,0,0,0,,0,0
13,03/30/2018,20,4:45,5:00,,33.73,0,33.73,33.73,-1,-42044,99258,141302,57214,0,-455,0,0,0,,455,-455
13,03/30/2018,21,5:00,5:15,,27.73,0,27.73,27.73,-1,-39036,128809,167845,89773,0,-4545,0,0,0,,4545,-4545
13,03/30/2018,22,5:15,5:30,,15.78,0,15.78,15.78,-1,-57604,107627,165231,50023,0,-24548,0,0,0,,24548,-24548
13,03/30/2018,23,5:30,5:45,32.7,30.78,0,32.7,32.7,1,-68119,79336,147455,11217,0,-9203,8,0,0,,9211,-9195
13,03/30/2018,24,5:45,6:00,37.12,30.78,0,37.12,37.12,1,-64583,70560,135143,5977,0,-29,1834,0,0,,1863,1805
13,03/30/2018,25,6:00,6:15,,-46.78,0,-46.78,-46.78,-1,-66302,140356,206658,74054,0,-20945,0,0,0,,20945,-20945
13,03/30/2018,26,6:15,6:30,,-48.78,0,-48.78,-48.78,-1,-93802,94151,187953,349,0,-27782,0,0,0,,27782,-27782
13,03/30/2018,27,6:30,6:45,,,0,35.06,35.06,0,-127384,78054,205438,-49330,0,-562,0,0,0,,562,-562
13,03/30/2018,28,6:45,7:00,40.83,,0,40.83,40.83,1,-162789,128600,291389,-34189,0,0,1109,0,0,,1109,1109
13,03/30/2018,29,7:00,7:15,39.21,,0,39.21,39.21,1,-170208,110672,280880,-59536,0,0,3458,0,0,,3458,3458
13,03/30/2018,30,7:15,7:30,40.43,,0,40.43,40.43,1,-156214,126502,282716,-29712,0,0,1613,0,0,,1613,1613
13,03/30/2018,31,7:30,7:45,46.43,,0,46.43,46.43,1,-166247,106648,272895,-59599,0,0,14816,0,0,,14816,14816
13,03/30/2018,32,7:45,8:00,44.12,,0,44.12,44.12,1,-185831,91463,277294,-94368,0,0,21203,0,0,,21203,21203
13,03/30/2018,33,8:00,8:15,44.12,33.02,0,33.02,33.02,-1,-102293,130181,232474,27888,0,-5274,5400,0,0,,10674,126
13,03/30/2018,34,8:15,8:30,54.12,33.02,0,54.12,54.12,1,-122533,81524,204057,-41009,0,-283,2080,0,0,,2363,1797
13,03/30/2018,35,8:30,8:45,237.12,,0,237.12,237.12,1,-129630,75312,204942,-54318,0,0,37381,0,0,,37381,37381
13,03/30/2018,36,8:45,9:00,46.43,,0,46.43,46.43,1,-128506,85267,213773,-43239,0,0,27634,0,0,,27634,27634
13,03/30/2018,37,9:00,9:15,81.12,,0,81.12,81.12,1,-81962,46254,128216,-35708,0,0,30962,0,0,,30962,30962
13,03/30/2018,38,9:15,9:30,42.63,,0,42.63,42.63,1,-55616,49266,104882,-6350,0,0,22230,0,0,,22230,22230
13,03/30/2018,39,9:30,9:45,40.69,35.94,0,40.69,35.94,2,-51151,39107,90258,-12044,0,-496,2903,0,0,,3399,2407
13,03/30/2018,40,9:45,10:00,44.32,,0,44.32,44.32,1,-48492,47340,95832,-1152,0,0,7239,0,0,,7239,7239
13,03/30/2018,41,10:00,10:15,253.12,,0,253.12,253.12,1,-111141,39387,150528,-71754,0,0,23109,0,0,,23109,23109
13,03/30/2018,42,10:15,10:30,47.12,37.87,0,37.87,37.87,-1,-79803,80394,160197,591,0,-5,21968,0,0,,21973,21963
13,03/30/2018,43,10:30,10:45,47.12,28.43,0,28.43,28.43,-1,-58485,111596,170081,53111,0,-2600,343,0,0,,2943,-2257
13,03/30/2018,44,10:45,11:00,,-7.2,0,-7.2,-7.2,-1,-58734,131978,190712,73244,0,-33736,0,0,0,,33736,-33736
13,03/30/2018,45,11:00,11:15,,31.99,0,31.99,31.99,-1,-39647,65660,105307,26013,0,-27150,0,0,0,,27150,-27150
13,03/30/2018,46,11:15,11:30,,28.43,0,28.43,28.43,-1,-39669,89047,128716,49378,0,-34151,0,0,0,,34151,-34151
13,03/30/2018,47,11:30,11:45,,28.43,0,28.43,28.43,-1,-51839,96158,147997,44319,0,-36951,0,0,0,,36951,-36951
13,03/30/2018,48,11:45,12:00,,20.13,0,20.13,20.13,-1,-61993,118383,180376,56390,0,-42461,0,0,0,,42461,-42461
13,03/30/2018,49,12:00,12:15,,14.55,0,14.55,14.55,-1,-30198,101085,131283,70887,0,-27533,0,0,0,,27533,-27533
13,03/30/2018,50,12:15,12:30,,-141.78,0,-141.78,-141.78,-1,-17468,156223,173691,138755,0,-52013,0,0,0,,52013,-52013
13,03/30/2018,51,12:30,12:45,,-8.77,0,-8.77,-8.77,-1,-38156,164154,202310,125998,0,-80253,0,0,0,,80253,-80253
13,03/30/2018,52,12:45,13:00,,-141.78,0,-141.78,-141.78,-1,-60090,201555,261645,141465,0,-108109,0,0,0,,108109,-108109
13,03/30/2018,53,13:00,13:15,,-101.78,0,-101.78,-101.78,-1,-102284,146786,249070,44502,0,-74437,0,0,0,,74437,-74437
13,03/30/2018,54,13:15,13:30,,-36.78,0,-36.78,-36.78,-1,-76652,164783,241435,88131,0,-34836,0,0,0,,34836,-34836
13,03/30/2018,55,13:30,13:45,,21.62,0,21.62,21.62,-1,-81549,168379,249928,86830,0,-58820,0,0,0,,58820,-58820
13,03/30/2018,56,13:45,14:00,,-28.51,0,-28.51,-28.51,-1,-87878,193643,281521,105765,0,-77140,0,0,0,,77140,-77140
13,03/30/2018,57,14:00,14:15,,7.6,0,7.6,7.6,-1,-91667,142218,233885,50551,0,-55699,0,0,0,,55699,-55699
13,03/30/2018,58,14:15,14:30,,18.99,0,18.99,18.99,-1,-81578,156823,238401,75245,0,-38785,0,0,0,,38785,-38785
13,03/30/2018,59,14:30,14:45,,7.88,0,7.88,7.88,-1,-84788,169052,253840,84264,0,-55978,0,0,0,,55978,-55978
13,03/30/2018,60,14:45,15:00,,19.33,0,19.33,19.33,-1,-94103,161606,255709,67503,0,-58191,0,0,0,,58191,-58191
13,03/30/2018,61,15:00,15:15,46.43,26.51,0,46.43,46.43,1,-113057,110086,223143,-2971,0,-32067,496,0,0,,32563,-31571
13,03/30/2018,62,15:15,15:30,61.12,36.85,0,61.12,36.85,2,-109469,106257,215726,-3212,0,-80,4521,0,0,,4601,4441
13,03/30/2018,63,15:30,15:45,45.93,34.43,0,45.93,34.43,2,-114678,97877,212555,-16801,0,-135,6829,0,0,,6964,6694
13,03/30/2018,64,15:45,16:00,36.43,,0,36.43,36.43,1,-86494,119610,206104,33116,0,0,2701,0,0,,2701,2701
13,03/30/2018,65,16:00,16:15,,,0,37.07,37.07,0,-43726,143661,187387,99935,0,0,0,0,0,,0,0
13,03/30/2018,66,16:15,16:30,,,0,37.07,37.07,0,-40723,149307,190030,108584,0,0,0,0,0,,0,0
13,03/30/2018,67,16:30,16:45,,34.43,0,34.43,34.43,-1,-40816,163446,204262,122630,0,-572,0,0,0,,572,-572
13,03/30/2018,68,16:45,17:00,,,0,37.04,37.04,0,-61958,177788,239746,115830,0,0,0,0,0,,0,0
13,03/30/2018,69,17:00,17:15,,37.96,0,37.96,37.96,-1,-59568,159767,219335,100199,0,-50,0,0,0,,50,-50
13,03/30/2018,70,17:15,17:30,,,0,37.2,37.2,0,-58801,150358,209159,91557,0,0,0,0,0,,0,0
13,03/30/2018,71,17:30,17:45,,,0,37.2,37.2,0,-74911,159956,234867,85045,0,0,0,0,0,,0,0
13,03/30/2018,72,17:45,18:00,,,0,37.2,37.2,0,-86352,165284,251636,78932,0,0,0,0,0,,0,0
13,03/30/2018,73,18:00,18:15,,35.1,0,35.1,35.1,-1,-59060,158813,217873,99753,0,-121,0,0,0,,121,-121
13,03/30/2018,74,18:15,18:30,,,0,37.18,37.18,0,-43684,164099,207783,120415,0,-12,0,0,0,,12,-12
13,03/30/2018,75,18:30,18:45,,,0,37.2,37.2,0,-36852,188403,225255,151551,0,0,0,0,0,,0,0
13,03/30/2018,76,18:45,19:00,,,0,37.2,37.2,0,-37830,194907,232737,157077,0,0,0,0,0,,0,0
13,03/30/2018,77,19:00,19:15,,-14.35,0,-14.35,-14.35,-1,-88320,118627,206947,30307,0,-18174,0,0,0,,18174,-18174
13,03/30/2018,78,19:15,19:30,,26.98,0,26.98,26.98,-1,-84165,122943,207108,38778,0,-9561,0,0,0,,9561,-9561
13,03/30/2018,79,19:30,19:45,,27.13,0,27.13,27.13,-1,-87071,128078,215149,41007,0,-29260,0,0,0,,29260,-29260
13,03/30/2018,80,19:45,20:00,,33.78,0,33.78,33.78,-1,-87673,125209,212882,37536,0,-20158,0,0,0,,20158,-20158
13,03/30/2018,81,20:00,20:15,40.43,33.78,0,40.43,40.43,1,-100274,81176,181450,-19098,0,-4774,2505,0,0,,7279,-2269
13,03/30/2018,82,20:15,20:30,194.12,,0,194.12,194.12,1,-105435,53972,159407,-51463,0,0,27885,0,0,,27885,27885
13,03/30/2018,83,20:30,20:45,253.12,,0,278.43,278.43,1,-207528,61309,268837,-146219,0,0,61184,0,0,,61184,61184
13,03/30/2018,84,20:45,21:00,350.12,,0,385.13,385.13,1,-261777,122691,384468,-139086,0,0,70916,0,79832,,150748,150748
13,03/30/2018,85,21:00,21:15,142.4,21.74,0,242.4,21.74,2,-171841,103655,275496,-68186,0,-2804,5892,1250,60749,,70695,65087
13,03/30/2018,86,21:15,21:30,194.12,,0,194.12,194.12,1,-181393,130565,311958,-50828,0,0,34474,1250,0,,35724,35724
13,03/30/2018,87,21:30,21:45,57.12,,0,57.12,57.12,1,-198497,155876,354373,-42621,0,0,34869,0,0,,34869,34869
13,03/30/2018,88,21:45,22:00,46.43,,0,46.43,46.43,1,-192123,122527,314650,-69596,0,0,37641,0,0,,37641,37641
13,03/30/2018,89,22:00,22:15,238.12,,0,261.93,261.93,1,-297705,95894,393599,-201811,0,0,61875,0,43332,,105207,105207
13,03/30/2018,90,22:15,22:30,221.12,35.12,0,35.12,35.12,-1,-230100,162033,392133,-68067,0,-205,46751,0,64998,,111954,111544
13,03/30/2018,91,22:30,22:45,350.12,35.12,0,385.13,385.13,1,-242444,141857,384301,-100587,0,-91,24795,0,33332,,58218,58036
13,03/30/2018,92,22:45,23:00,61.12,,0,61.12,61.12,1,-211592,191671,403263,-19921,0,0,29186,0,0,,29186,29186
13,03/30/2018,93,23:00,23:15,64.47,,0,64.47,64.47,1,-171800,101250,273050,-70550,0,0,13178,0,0,,13178,13178
13,03/30/2018,94,23:15,23:30,45.67,,0,45.67,45.67,1,-171810,92825,264635,-78985,0,0,25266,0,0,,25266,25266
13,03/30/2018,95,23:30,23:45,46.43,,0,46.43,46.43,1,-161040,105484,266524,-55556,0,0,16760,0,0,,16760,16760
13,03/30/2018,96,23:45,0:00,41.07,,0,41.07,41.07,1,-144729,95026,239755,-49703,0,0,16740,0,0,,16740,16740
14,03/31/2018,1,0:00,0:15,52.1,,0,52.1,52.1,1,-95360,66206,161566,-29154,0,0,12791,0,0,,12791,12791
14,03/31/2018,2,0:15,0:30,80.17,,0,80.17,80.17,1,-98770,53150,151920,-45620,0,0,25254,0,0,,25254,25254
14,03/31/2018,3,0:30,0:45,45.21,,0,45.21,45.21,1,-87324,53490,140814,-33834,0,0,30567,0,0,,30567,30567
14,03/31/2018,4,0:45,1:00,,,0,35.12,35.12,0,-88881,62924,151805,-25957,0,0,7185,0,0,,7185,7185
14,03/31/2018,5,1:00,1:15,148.02,,0,148.02,148.02,1,-104366,28089,132455,-76277,0,0,25399,0,0,,25399,25399
14,03/31/2018,6,1:15,1:30,92.02,,0,92.02,92.02,1,-83766,32460,116226,-51306,0,0,58976,0,0,,58976,58976
14,03/31/2018,7,1:30,1:45,40.23,,0,40.23,40.23,1,-45795,33084,78879,-12711,0,0,18623,0,0,,18623,18623
14,03/31/2018,8,1:45,2:00,45.21,,0,45.21,45.21,1,-44379,31729,76108,-12650,0,0,1809,0,0,,1809,1809
14,03/31/2018,9,2:00,2:15,140.02,,0,140.02,140.02,1,-165379,32134,197513,-133245,0,0,65123,0,0,,65123,65123
14,03/31/2018,10,2:15,2:30,140.02,,0,140.02,140.02,1,-137225,47262,184487,-89963,0,0,94949,0,0,,94949,94949
14,03/31/2018,11,2:30,2:45,129.21,,0,129.21,129.21,1,-106259,45165,151424,-61094,0,0,70714,0,0,,70714,70714
14,03/31/2018,12,2:45,3:00,43.55,,0,43.55,43.55,1,-85815,49762,135577,-36053,0,0,30014,0,0,,30014,30014
14,03/31/2018,13,3:00,3:15,45.21,,0,45.21,45.21,1,-90455,49701,140156,-40754,0,0,26645,0,0,,26645,26645
14,03/31/2018,14,3:15,3:30,54.39,,0,54.39,54.39,1,-94283,53526,147809,-40757,0,0,34788,0,0,,34788,34788
14,03/31/2018,15,3:30,3:45,58.02,,0,58.02,58.02,1,-95271,49040,144311,-46231,0,0,34455,0,0,,34455,34455
14,03/31/2018,16,3:45,4:00,81.02,,0,81.02,81.02,1,-96447,50404,146851,-46043,0,0,42350,0,0,,42350,42350
14,03/31/2018,17,4:00,4:15,35.21,31.78,0,36.23,31.78,2,-36100,72279,108379,36179,0,-866,15872,0,0,,16738,15006
14,03/31/2018,18,4:15,4:30,38.81,31.78,0,38.81,38.81,1,-54800,40451,95251,-14349,0,-63,1266,0,0,,1329,1203
14,03/31/2018,19,4:30,4:45,41.06,,0,41.06,41.06,1,-60051,34256,94307,-25795,0,0,6926,0,0,,6926,6926
14,03/31/2018,20,4:45,5:00,43.68,,0,43.68,43.68,1,-64128,31407,95535,-32721,0,0,19270,0,0,,19270,19270
14,03/31/2018,21,5:00,5:15,39.74,,0,39.74,39.74,1,-53028,45659,98687,-7369,0,0,12523,0,0,,12523,12523
14,03/31/2018,22,5:15,5:30,45.21,,0,45.21,45.21,1,-77325,39381,116706,-37944,0,0,17030,0,0,,17030,17030
14,03/31/2018,23,5:30,5:45,56.35,,0,56.35,56.35,1,-77363,34811,112174,-42552,0,0,34639,0,0,,34639,34639
14,03/31/2018,24,5:45,6:00,41.99,,0,41.99,41.99,1,-65325,32660,97985,-32665,0,0,26602,0,0,,26602,26602
14,03/31/2018,25,6:00,6:15,54.02,,0,54.02,54.02,1,-76309,63278,139587,-13031,0,0,8142,0,0,,8142,8142
14,03/31/2018,26,6:15,6:30,190.02,,0,190.02,190.02,1,-104404,70128,174532,-34276,0,0,31577,0,0,,31577,31577
14,03/31/2018,27,6:30,6:45,176.02,,0,176.02,176.02,1,-120803,70735,191538,-50068,0,0,42468,0,0,,42468,42468
14,03/31/2018,28,6:45,7:00,237.02,,0,237.02,237.02,1,-115790,67316,183106,-48474,0,0,61205,0,0,,61205,61205
14,03/31/2018,29,7:00,7:15,68.38,,0,68.38,68.38,1,-80063,80071,160134,8,0,0,29250,0,0,,29250,29250
14,03/31/2018,30,7:15,7:30,74.53,,0,74.53,74.53,1,-96351,67142,163493,-29209,0,0,10718,0,0,,10718,10718
14,03/31/2018,31,7:30,7:45,99.02,,0,99.02,99.02,1,-106878,60333,167211,-46545,0,0,37245,0,0,,37245,37245
14,03/31/2018,32,7:45,8:00,138.02,,0,138.02,138.02,1,-140024,78335,218359,-61689,0,0,51914,0,0,,51914,51914
14,03/31/2018,33,8:00,8:15,45.71,25.66,0,45.71,25.66,2,-90211,95653,185864,5442,0,-2239,21877,0,0,,24116,19638
14,03/31/2018,34,8:15,8:30,235.15,25.66,0,235.15,235.15,1,-120259,84083,204342,-36176,0,-3,20162,0,0,,20165,20159
14,03/31/2018,35,8:30,8:45,198.15,,0,198.15,198.15,1,-121772,72612,194384,-49160,0,0,29934,0,0,,29934,29934
14,03/31/2018,36,8:45,9:00,109.15,,0,109.15,109.15,1,-136869,87969,224838,-48900,0,0,52139,0,0,,52139,52139
14,03/31/2018,37,9:00,9:15,39.71,31.99,0,39.71,31.99,2,-86201,95020,181221,8819,0,-453,15330,0,0,,15783,14877
14,03/31/2018,38,9:15,9:30,46,,0,46,46,1,-90233,73735,163968,-16498,0,0,9861,0,0,,9861,9861
14,03/31/2018,39,9:30,9:45,39.98,,0,39.98,39.98,1,-80672,74057,154729,-6615,0,0,9888,0,0,,9888,9888
14,03/31/2018,40,9:45,10:00,40,,0,40,40,1,-84448,94690,179138,10242,0,0,1087,0,0,,1087,1087
14,03/31/2018,41,10:00,10:15,97.85,,0,97.85,97.85,1,-69626,106854,176480,37228,0,0,7224,0,0,,7224,7224
14,03/31/2018,42,10:15,10:30,,,0,36.43,36.43,0,-61620,133191,194811,71571,0,0,0,0,0,,0,0
14,03/31/2018,43,10:30,10:45,,,0,36.43,36.43,0,-50743,170936,221679,120193,0,0,0,0,0,,0,0
14,03/31/2018,44,10:45,11:00,,12.66,0,12.66,12.66,-1,-59227,187540,246767,128313,0,-20992,0,0,0,,20992,-20992
14,03/31/2018,45,11:00,11:15,,26.88,0,26.88,26.88,-1,-91152,110261,201413,19109,0,-21002,0,0,0,,21002,-21002
14,03/31/2018,46,11:15,11:30,,,0,36.43,36.43,0,-75823,129007,204830,53184,0,-14,0,0,0,,14,-14
14,03/31/2018,47,11:30,11:45,,19.09,0,19.09,19.09,-1,-86475,144153,230628,57678,0,-12777,0,0,0,,12777,-12777
14,03/31/2018,48,11:45,12:00,,28,0,28,28,-1,-112216,153515,265731,41299,0,-18448,0,0,0,,18448,-18448
14,03/31/2018,49,12:00,12:15,,28,0,28,28,-1,-112960,160664,273624,47704,0,-15873,0,0,0,,15873,-15873
14,03/31/2018,50,12:15,12:30,,11.85,0,11.85,11.85,-1,-102156,166424,268580,64268,0,-7821,0,0,0,,7821,-7821
14,03/31/2018,51,12:30,12:45,,7.62,0,7.62,7.62,-1,-126699,159738,286437,33039,0,-10504,0,0,0,,10504,-10504
14,03/31/2018,52,12:45,13:00,,,0,33.87,33.87,0,-98325,162022,260347,63697,0,0,0,0,0,,0,0
14,03/31/2018,53,13:00,13:15,,,0,33.83,33.83,0,-94164,122963,217127,28799,0,0,0,0,0,,0,0
14,03/31/2018,54,13:15,13:30,,,0,33.82,33.82,0,-116256,119333,235589,3077,0,0,0,0,0,,0,0
14,03/31/2018,55,13:30,13:45,46,,0,46,46,1,-132767,104520,237287,-28247,0,0,8373,0,0,,8373,8373
14,03/31/2018,56,13:45,14:00,50.38,,0,50.38,50.38,1,-143253,94196,237449,-49057,0,0,28667,0,0,,28667,28667
14,03/31/2018,57,14:00,14:15,156.15,,0,156.15,156.15,1,-130530,62301,192831,-68229,0,0,52190,0,0,,52190,52190
14,03/31/2018,58,14:15,14:30,82.15,,0,82.15,82.15,1,-114609,67710,182319,-46899,0,0,54317,0,0,,54317,54317
14,03/31/2018,59,14:30,14:45,84.48,,0,84.48,84.48,1,-113537,58101,171638,-55436,0,0,30872,0,0,,30872,30872
14,03/31/2018,60,14:45,15:00,188.15,,0,188.15,188.15,1,-122418,44317,166735,-78101,0,0,53904,0,0,,53904,53904
14,03/31/2018,61,15:00,15:15,82.15,,0,82.15,82.15,1,-121285,59813,181098,-61472,0,0,55588,0,0,,55588,55588
14,03/31/2018,62,15:15,15:30,93.15,,0,93.15,93.15,1,-121791,54061,175852,-67730,0,0,54961,0,0,,54961,54961
14,03/31/2018,63,15:30,15:45,135.15,,0,135.15,135.15,1,-129427,50429,179856,-78998,0,0,54375,0,0,,54375,54375
14,03/31/2018,64,15:45,16:00,235.15,,0,235.15,235.15,1,-142347,49612,191959,-92735,0,0,75392,0,0,,75392,75392
14,03/31/2018,65,16:00,16:15,209.15,,0,209.15,209.15,1,-140292,81666,221958,-58626,0,0,72274,0,0,,72274,72274
14,03/31/2018,66,16:15,16:30,182.15,,0,182.15,182.15,1,-148855,78896,227751,-69959,0,0,44250,0,0,,44250,44250
14,03/31/2018,67,16:30,16:45,235.15,,0,235.15,235.15,1,-161325,80767,242092,-80558,0,0,63056,0,0,,63056,63056
14,03/31/2018,68,16:45,17:00,156.15,,0,156.15,156.15,1,-163744,80345,244089,-83399,0,0,70451,0,0,,70451,70451
14,03/31/2018,69,17:00,17:15,243.71,,0,243.71,243.71,1,-129070,104750,233820,-24320,0,0,38844,3750,0,,42594,42594
14,03/31/2018,70,17:15,17:30,235.15,,0,235.15,235.15,1,-150799,101965,252764,-48834,0,0,16646,0,0,,16646,16646
14,03/31/2018,71,17:30,17:45,235.15,,0,235.15,235.15,1,-155359,113725,269084,-41634,0,0,39699,0,0,,39699,39699
14,03/31/2018,72,17:45,18:00,130.15,,0,130.15,130.15,1,-162427,105709,268136,-56718,0,0,44234,0,0,,44234,44234
14,03/31/2018,73,18:00,18:15,88.15,,0,88.15,88.15,1,-146932,80603,227535,-66329,0,0,51309,0,0,,51309,51309
14,03/31/2018,74,18:15,18:30,151.15,,0,151.15,151.15,1,-143778,79461,223239,-64317,0,0,55763,0,0,,55763,55763
14,03/31/2018,75,18:30,18:45,98.15,,0,98.15,98.15,1,-130316,100284,230600,-30032,0,0,49507,0,0,,49507,49507
14,03/31/2018,76,18:45,19:00,43.04,,0,43.04,43.04,1,-129161,105334,234495,-23827,0,0,20381,0,0,,20381,20381
14,03/31/2018,77,19:00,19:15,114.37,,0,114.37,114.37,1,-113888,67612,181500,-46276,0,0,31480,0,0,,31480,31480
14,03/31/2018,78,19:15,19:30,46,,0,46,46,1,-110949,89710,200659,-21239,0,0,28453,0,0,,28453,28453
14,03/31/2018,79,19:30,19:45,73.15,,0,73.15,73.15,1,-117057,86981,204038,-30076,0,0,26012,0,0,,26012,26012
14,03/31/2018,80,19:45,20:00,131.15,,0,131.15,131.15,1,-117907,87641,205548,-30266,0,0,39803,0,0,,39803,39803
14,03/31/2018,81,20:00,20:15,40,32.58,0,40,32.58,2,-95189,99372,194561,4183,0,-315,9406,0,0,,9721,9091
14,03/31/2018,82,20:15,20:30,233.15,,0,233.15,233.15,1,-122464,67242,189706,-55222,0,0,28833,0,0,,28833,28833
14,03/31/2018,83,20:30,20:45,101.15,,0,101.15,101.15,1,-113787,93197,206984,-20590,0,0,40854,0,0,,40854,40854
14,03/31/2018,84,20:45,21:00,101.15,28.31,0,28.31,28.31,-1,-94778,111707,206485,16929,0,-3908,5641,0,0,,9549,1733
14,03/31/2018,85,21:00,21:15,132.15,28.31,0,132.15,132.15,1,-92666,65843,158509,-26823,0,-473,10867,0,0,,11340,10394
14,03/31/2018,86,21:15,21:30,36,,0,36,36,1,-72721,83498,156219,10777,0,0,2736,0,0,,2736,2736
14,03/31/2018,87,21:30,21:45,36,,0,36,36,1,-64061,100681,164742,36620,0,0,36,0,0,,36,36
14,03/31/2018,88,21:45,22:00,,,0,35.93,35.93,0,-68682,99235,167917,30553,0,0,0,0,0,,0,0
14,03/31/2018,89,22:00,22:15,35.85,,0,35.85,35.85,1,-70406,81188,151594,10782,0,0,1,0,0,,1,1
14,03/31/2018,90,22:15,22:30,145.15,,0,145.15,145.15,1,-94587,59381,153968,-35206,0,0,17199,0,0,,17199,17199
14,03/31/2018,91,22:30,22:45,48.82,,0,48.82,48.82,1,-74296,76839,151135,2543,0,0,21139,0,0,,21139,21139
14,03/31/2018,92,22:45,23:00,48.82,34.73,0,48.82,34.73,2,-102934,85332,188266,-17602,0,-123,3169,0,0,,3292,3046
14,03/31/2018,93,23:00,23:15,199.15,,0,199.15,199.15,1,-155793,70012,225805,-85781,0,0,48837,0,0,,48837,48837
14,03/31/2018,94,23:15,23:30,146.15,,0,146.15,146.15,1,-115492,88259,203751,-27233,0,0,50154,0,0,,50154,50154
14,03/31/2018,95,23:30,23:45,48.01,34.93,0,48.01,34.93,2,-105941,91151,197092,-14790,0,-131,5492,0,0,,5623,5361
14,03/31/2018,96,23:45,0:00,114.15,,0,114.15,114.15,1,-146858,78718,225576,-68140,0,0,48446,0,0,,48446,48446
14,04-01-18,1,0:00,0:15,114.15,-101.12,0,-101.12,-101.12,-1,-44449,212210,256659,167761,0,-29818,12847,0,0,,42665,-16971
14,04-01-18,2,0:15,0:30,36.7,34.48,0,36.7,34.48,2,-75615,77368,152983,1753,0,-3479,187,0,0,,3666,-3292
14,04-01-18,3,0:30,0:45,,24.48,0,24.48,24.48,-1,-45531,75535,121066,30004,0,-2420,0,0,0,,2420,-2420
14,04-01-18,4,0:45,1:00,,15.41,0,15.41,15.41,-1,-71763,113860,185623,42097,0,-29759,0,0,0,,29759,-29759
14,04-01-18,5,1:00,1:15,37.39,25.71,0,37.39,37.39,1,-55473,83981,139454,28508,0,-19502,3,0,0,,19505,-19499
14,04-01-18,6,1:15,1:30,37.57,18.31,0,37.57,18.31,2,-61845,90560,152405,28715,0,-4972,19,0,0,,4991,-4953
14,04-01-18,7,1:30,1:45,,18.31,0,18.31,18.31,-1,-68209,78293,146502,10084,0,-11458,0,0,0,,11458,-11458
14,04-01-18,8,1:45,2:00,,30.51,0,30.51,30.51,-1,-79817,74800,154617,-5017,0,-1915,0,0,0,,1915,-1915
14,04-01-18,9,2:00,2:15,,30.28,0,30.28,30.28,-1,-41537,86700,128237,45163,0,-4032,0,0,0,,4032,-4032
14,04-01-18,10,2:15,2:30,,24.04,0,24.04,24.04,-1,-43127,72231,115358,29104,0,-7066,0,0,0,,7066,-7066
14,04-01-18,11,2:30,2:45,,30.28,0,30.28,30.28,-1,-40087,66787,106874,26700,0,-7374,0,0,0,,7374,-7374
14,04-01-18,12,2:45,3:00,,18.69,0,18.69,18.69,-1,-38583,60379,98962,21796,0,-30082,0,0,0,,30082,-30082
14,04-01-18,13,3:00,3:15,,25.71,0,25.71,25.71,-1,-50881,84356,135237,33475,0,-23704,0,0,0,,23704,-23704
14,04-01-18,14,3:15,3:30,,15.71,0,15.71,15.71,-1,-46234,81647,127881,35413,0,-17993,0,0,0,,17993,-17993
14,04-01-18,15,3:30,3:45,,24.37,0,24.37,24.37,-1,-43303,71606,114909,28303,0,-26924,0,0,0,,26924,-26924
14,04-01-18,16,3:45,4:00,,23.96,0,23.96,23.96,-1,-42151,74899,117050,32748,0,-35930,0,0,0,,35930,-35930
14,04-01-18,17,4:00,4:15,,25.71,0,25.71,25.71,-1,-28516,54097,82613,25581,0,-30075,0,0,0,,30075,-30075
14,04-01-18,18,4:15,4:30,,25.71,0,25.71,25.71,-1,-27115,55344,82459,28229,0,-24901,0,0,0,,24901,-24901
14,04-01-18,19,4:30,4:45,,30.03,0,30.03,30.03,-1,-32079,50733,82812,18654,0,-25379,0,0,0,,25379,-25379
14,04-01-18,20,4:45,5:00,,22.59,0,22.59,22.59,-1,-29548,58403,87951,28855,0,-26841,0,0,0,,26841,-26841
14,04-01-18,21,5:00,5:15,,18.54,0,18.54,18.54,-1,-33100,81499,114599,48399,0,-40368,0,0,0,,40368,-40368
14,04-01-18,22,5:15,5:30,,18.16,0,18.16,18.16,-1,-40713,70006,110719,29293,0,-42696,0,0,0,,42696,-42696
14,04-01-18,23,5:30,5:45,,21.71,0,21.71,21.71,-1,-40418,73570,113988,33152,0,-28211,0,0,0,,28211,-28211
14,04-01-18,24,5:45,6:00,,21.71,0,21.71,21.71,-1,-36346,72161,108507,35815,0,-36456,0,0,0,,36456,-36456
14,04-01-18,25,6:00,6:15,,-27.03,0,-27.03,-27.03,-1,-19744,91308,111052,71564,0,-56659,0,0,0,,56659,-56659
14,04-01-18,26,6:15,6:30,,13.25,0,13.25,13.25,-1,-20665,91239,111904,70574,0,-67223,0,0,0,,67223,-67223
14,04-01-18,27,6:30,6:45,,20.75,0,20.75,20.75,-1,-24477,83874,108351,59397,0,-56207,0,0,0,,56207,-56207
14,04-01-18,28,6:45,7:00,,20.17,0,20.17,20.17,-1,-26055,83023,109078,56968,0,-49293,0,0,0,,49293,-49293
14,04-01-18,29,7:00,7:15,,37.91,0,37.91,37.91,-1,-38085,105351,143436,67266,0,-16461,0,0,0,,16461,-16461
14,04-01-18,30,7:15,7:30,,,0,35.73,35.73,0,-34505,103385,137890,68880,0,0,0,0,0,,0,0
14,04-01-18,31,7:30,7:45,,,0,35.75,35.75,0,-35766,99394,135160,63628,0,0,0,0,0,,0,0
14,04-01-18,32,7:45,8:00,,,0,35.73,35.73,0,-42498,96043,138541,53545,0,0,0,0,0,,0,0
14,04-01-18,33,8:00,8:15,,,0,35.86,35.86,0,-24382,103967,128349,79585,0,0,0,0,0,,0,0
14,04-01-18,34,8:15,8:30,,,0,35.74,35.74,0,-35508,76877,112385,41369,0,0,0,0,0,,0,0
14,04-01-18,35,8:30,8:45,47.74,,0,47.74,47.74,1,-64136,60052,124188,-4084,0,0,3663,0,0,,3663,3663
14,04-01-18,36,8:45,9:00,41.74,,0,41.74,41.74,1,-71749,61258,133007,-10491,0,0,5765,0,0,,5765,5765
14,04-01-18,37,9:00,9:15,46.58,,0,46.58,46.58,1,-81423,54654,136077,-26769,0,0,9194,0,0,,9194,9194
14,04-01-18,38,9:15,9:30,48.02,,0,48.02,48.02,1,-89885,38799,128684,-51086,0,0,35408,0,0,,35408,35408
14,04-01-18,39,9:30,9:45,52.8,,0,52.8,52.8,1,-98496,42753,141249,-55743,0,0,44404,0,0,,44404,44404
14,04-01-18,40,9:45,10:00,58.74,,0,58.74,58.74,1,-112012,41698,153710,-70314,0,0,52080,0,0,,52080,52080
14,04-01-18,41,10:00,10:15,55.69,,0,55.69,55.69,1,-95934,42968,138902,-52966,0,0,47684,0,0,,47684,47684
14,04-01-18,42,10:15,10:30,50.45,,0,50.45,50.45,1,-87355,48083,135438,-39272,0,0,40931,0,0,,40931,40931
14,04-01-18,43,10:30,10:45,51.09,,0,51.09,51.09,1,-96355,48392,144747,-47963,0,0,33640,0,0,,33640,33640
14,04-01-18,44,10:45,11:00,47.74,,0,47.74,47.74,1,-86988,46016,133004,-40972,0,0,37236,0,0,,37236,37236
14,04-01-18,45,11:00,11:15,70.74,,0,70.74,70.74,1,-115094,54005,169099,-61089,0,0,36581,0,0,,36581,36581
14,04-01-18,46,11:15,11:30,61.45,,0,61.45,61.45,1,-121557,51925,173482,-69632,0,0,53381,0,0,,53381,53381
14,04-01-18,47,11:30,11:45,60.31,,0,60.31,60.31,1,-123034,48388,171422,-74646,0,0,59987,0,0,,59987,59987
14,04-01-18,48,11:45,12:00,58.74,,0,58.74,58.74,1,-107477,54310,161787,-53167,0,0,53932,0,0,,53932,53932
14,04-01-18,49,12:00,12:15,70.74,,0,70.74,70.74,1,-136939,65695,202634,-71244,0,0,49048,0,0,,49048,49048
14,04-01-18,50,12:15,12:30,58.06,,0,58.06,58.06,1,-133145,72810,205955,-60335,0,0,56321,0,0,,56321,56321
14,04-01-18,51,12:30,12:45,51.77,,0,51.77,51.77,1,-122262,68889,191151,-53373,0,0,48375,0,0,,48375,48375
14,04-01-18,52,12:45,13:00,46.91,,0,46.91,46.91,1,-108542,73610,182152,-34932,0,0,35056,0,0,,35056,35056
14,04-01-18,53,13:00,13:15,69.71,,0,69.71,69.71,1,-119478,62748,182226,-56730,0,0,34353,0,0,,34353,34353
14,04-01-18,54,13:15,13:30,47.24,,0,47.24,47.24,1,-111768,68685,180453,-43083,0,0,34481,0,0,,34481,34481
14,04-01-18,55,13:30,13:45,47.29,,0,47.29,47.29,1,-105357,62315,167672,-43042,0,0,35231,0,0,,35231,35231
14,04-01-18,56,13:45,14:00,41.41,37.15,0,37.15,37.15,-1,-95921,85883,181804,-10038,0,-28,20819,0,0,,20847,20791
14,04-01-18,57,14:00,14:15,133.02,36.92,0,133.02,34.97,2,-124022,61416,185438,-62606,0,-195,17571,0,0,,17766,17376
14,04-01-18,58,14:15,14:30,166.02,,0,166.02,166.02,1,-101887,70829,172716,-31058,0,0,45267,0,0,,45267,45267
14,04-01-18,59,14:30,14:45,40.95,,0,40.95,40.95,1,-92328,76089,168417,-16239,0,0,10979,0,0,,10979,10979
14,04-01-18,60,14:45,15:00,47.74,,0,47.74,47.74,1,-102543,73902,176445,-28641,0,0,15806,0,0,,15806,15806
14,04-01-18,61,15:00,15:15,56.07,,0,56.07,56.07,1,-91937,49883,141820,-42054,0,0,33008,0,0,,33008,33008
14,04-01-18,62,15:15,15:30,42.02,,0,42.02,42.02,1,-103222,72675,175897,-30547,0,0,28509,0,0,,28509,28509
14,04-01-18,63,15:30,15:45,58.74,,0,58.74,58.74,1,-111747,61428,173175,-50319,0,0,38662,0,0,,38662,38662
14,04-01-18,64,15:45,16:00,45.13,36.42,0,36.42,36.42,-1,-108529,109886,218415,1357,0,-272,25641,0,0,,25913,25369
14,04-01-18,65,16:00,16:15,45.13,30.03,0,30.03,30.03,-1,-93541,103191,196732,9650,0,-640,633,0,0,,1273,-7
14,04-01-18,66,16:15,16:30,,,0,35.19,35.19,0,-90352,113171,203523,22819,0,0,0,0,0,,0,0
14,04-01-18,67,16:30,16:45,,,0,35.1,35.1,0,-98382,114853,213235,16471,0,0,0,0,0,,0,0
14,04-01-18,68,16:45,17:00,,,0,35.03,35.03,0,-111816,151817,263633,40001,0,0,0,0,0,,0,0
14,04-01-18,69,17:00,17:15,,,0,35.32,35.32,0,-106035,101203,207238,-4832,0,0,0,0,0,,0,0
14,04-01-18,70,17:15,17:30,39.33,,0,39.33,39.33,1,-85338,92791,178129,7453,0,0,184,0,0,,184,184
14,04-01-18,71,17:30,17:45,50.02,,0,50.02,50.02,1,-90626,72119,162745,-18507,0,0,4399,0,0,,4399,4399
14,04-01-18,72,17:45,18:00,61.98,,0,61.98,61.98,1,-102001,82479,184480,-19522,0,0,36832,0,0,,36832,36832
14,04-01-18,73,18:00,18:15,130.74,,0,130.74,130.74,1,-141067,55643,196710,-85424,0,0,47867,0,0,,47867,47867
14,04-01-18,74,18:15,18:30,57.85,,0,57.85,57.85,1,-129632,70662,200294,-58970,0,0,52916,0,0,,52916,52916
14,04-01-18,75,18:30,18:45,56.94,,0,56.94,56.94,1,-122682,82203,204885,-40479,0,0,47123,0,0,,47123,47123
14,04-01-18,76,18:45,19:00,77.02,,0,77.02,77.02,1,-123040,72882,195922,-50158,0,0,41888,0,0,,41888,41888
14,04-01-18,77,19:00,19:15,93.87,37.36,0,37.36,37.36,-1,-112595,85206,197801,-27389,0,-19,38153,0,0,,38172,38134
14,04-01-18,78,19:15,19:30,77.02,34.36,0,77.02,34.36,2,-109823,74501,184324,-35322,0,-656,10828,0,0,,11484,10172
14,04-01-18,79,19:30,19:45,88.02,,0,88.02,88.02,1,-111455,78373,189828,-33082,0,0,36656,0,0,,36656,36656
14,04-01-18,80,19:45,20:00,57.85,,0,57.85,57.85,1,-116593,69988,186581,-46605,0,0,34603,0,0,,34603,34603
14,04-01-18,81,20:00,20:15,53.4,32.76,0,32.76,32.76,-1,-91293,110942,202235,19649,0,-589,19285,0,0,,19874,18696
14,04-01-18,82,20:15,20:30,159.02,32.76,0,159.02,159.02,1,-115293,64686,179979,-50607,0,-209,14835,0,0,,15044,14626
14,04-01-18,83,20:30,20:45,253.02,,0,253.02,253.02,1,-123056,70766,193822,-52290,0,0,58059,0,0,,58059,58059
14,04-01-18,84,20:45,21:00,47.27,,0,47.27,47.27,1,-112920,83698,196618,-29222,0,0,32757,0,0,,32757,32757
14,04-01-18,85,21:00,21:15,46.85,,0,46.85,46.85,1,-106394,74302,180696,-32092,0,0,22613,0,0,,22613,22613
14,04-01-18,86,21:15,21:30,45.39,,0,45.39,45.39,1,-107715,88004,195719,-19711,0,0,23979,0,0,,23979,23979
14,04-01-18,87,21:30,21:45,40.85,,0,40.85,40.85,1,-105687,91664,197351,-14023,0,0,4232,0,0,,4232,4232
14,04-01-18,88,21:45,22:00,40.85,,0,40.85,40.85,1,-112692,102921,215613,-9771,0,0,2775,0,0,,2775,2775
14,04-01-18,89,22:00,22:15,107.02,,0,107.02,107.02,1,-96886,44330,141216,-52556,0,0,23710,0,0,,23710,23710
14,04-01-18,90,22:15,22:30,46.85,,0,46.85,46.85,1,-88597,68097,156694,-20500,0,0,28750,0,0,,28750,28750
14,04-01-18,91,22:30,22:45,46.85,34.32,0,34.32,34.32,-1,-82285,97567,179852,15282,0,-1041,6148,0,0,,7189,5107
14,04-01-18,92,22:45,23:00,,,0,37.5,37.5,0,-86504,108835,195339,22331,0,0,0,0,0,,0,0
14,04-01-18,93,23:00,23:15,237.02,,0,237.02,237.02,1,-127528,44393,171921,-83135,0,0,26905,0,0,,26905,26905
14,04-01-18,94,23:15,23:30,57.85,,0,57.85,57.85,1,-120378,73185,193563,-47193,0,0,47329,0,0,,47329,47329
14,04-01-18,95,23:30,23:45,46.85,34.46,0,34.46,34.46,-1,-94839,99727,194566,4888,0,-461,23451,0,0,,23912,22990
14,04-01-18,96,23:45,0:00,46.85,22.74,0,22.74,22.74,-1,-93481,110527,204008,17046,0,-8731,45,0,0,,8776,-8686
14,04-02-18,1,0:00,0:15,40.74,-26.55,0,40.74,-26.55,2,-58201,110225,168426,52024,0,-26728,20,0,0,,26748,-26708
14,04-02-18,2,0:15,0:30,41.05,-6.89,0,41.05,-6.89,2,-32558,83380,115938,50822,0,-5736,339,0,0,,6075,-5397
14,04-02-18,3,0:30,0:45,,-38.78,0,-38.78,-38.78,-1,-35773,74366,110139,38593,0,-42327,0,0,0,,42327,-42327
14,04-02-18,4,0:45,1:00,,32.74,0,32.74,32.74,-1,-54572,65272,119844,10700,0,-21803,0,0,0,,21803,-21803
14,04-02-18,5,1:00,1:15,,20.38,0,20.38,20.38,-1,-36713,78151,114864,41438,0,-15032,0,0,0,,15032,-15032
14,04-02-18,6,1:15,1:30,,23.85,0,23.85,23.85,-1,-44130,86865,130995,42735,0,-3179,0,0,0,,3179,-3179
14,04-02-18,7,1:30,1:45,,19.26,0,19.26,19.26,-1,-39490,91865,131355,52375,0,-26341,0,0,0,,26341,-26341
14,04-02-18,8,1:45,2:00,,26.2,0,26.2,26.2,-1,-36363,61422,97785,25059,0,-34158,0,0,0,,34158,-34158
14,04-02-18,9,2:00,2:15,,15.82,0,15.82,15.82,-1,-31019,89695,120714,58676,0,-19551,0,0,0,,19551,-19551
14,04-02-18,10,2:15,2:30,,,0,35.49,35.49,0,-35524,72943,108467,37419,0,-20,0,0,0,,20,-20
14,04-02-18,11,2:30,2:45,,31.85,0,31.85,31.85,-1,-28339,75202,103541,46863,0,-377,0,0,0,,377,-377
14,04-02-18,12,2:45,3:00,,26.81,0,26.81,26.81,-1,-25205,80845,106050,55640,0,-1772,0,0,0,,1772,-1772
14,04-02-18,13,3:00,3:15,,24.4,0,24.4,24.4,-1,-31159,69565,100724,38406,0,-2389,0,0,0,,2389,-2389
14,04-02-18,14,3:15,3:30,,,0,35.38,35.38,0,-31953,55660,87613,23707,0,0,0,0,0,,0,0
14,04-02-18,15,3:30,3:45,,,0,35.38,35.38,0,-30578,56804,87382,26226,0,0,0,0,0,,0,0
14,04-02-18,16,3:45,4:00,,,0,35.42,35.42,0,-27458,58832,86290,31374,0,0,0,0,0,,0,0
14,04-02-18,17,4:00,4:15,,,0,35.21,35.21,0,-41732,67585,109317,25853,0,0,0,0,0,,0,0
14,04-02-18,18,4:15,4:30,,,0,35.19,35.19,0,-43316,62272,105588,18956,0,0,0,0,0,,0,0
14,04-02-18,19,4:30,4:45,,,0,35.2,35.2,0,-45614,56720,102334,11106,0,0,0,0,0,,0,0
14,04-02-18,20,4:45,5:00,,,0,35.2,35.2,0,-42680,55866,98546,13186,0,0,0,0,0,,0,0
14,04-02-18,21,5:00,5:15,,,0,35.26,35.26,0,-48255,58034,106289,9779,0,0,0,0,0,,0,0
14,04-02-18,22,5:15,5:30,,,0,35.27,35.27,0,-49407,52608,102015,3201,0,0,0,0,0,,0,0
14,04-02-18,23,5:30,5:45,35.85,,0,35.85,35.85,1,-51489,45573,97062,-5916,0,0,582,0,0,,582,582
14,04-02-18,24,5:45,6:00,35.85,,0,35.85,35.85,1,-54485,46195,100680,-8290,0,0,2521,0,0,,2521,2521
14,04-02-18,25,6:00,6:15,33.66,,0,33.66,33.66,1,-37366,64424,101790,27058,0,0,695,0,0,,695,695
14,04-02-18,26,6:15,6:30,,,0,35.28,35.28,0,-31170,62620,93790,31450,0,0,0,0,0,,0,0
14,04-02-18,27,6:30,6:45,,,0,35.28,35.28,0,-36549,61388,97937,24839,0,0,0,0,0,,0,0
14,04-02-18,28,6:45,7:00,,36.89,0,36.89,36.89,-1,-37388,57937,95325,20549,0,-58,0,0,0,,58,-58
14,04-02-18,29,7:00,7:15,,26.46,0,26.46,26.46,-1,-39613,95499,135112,55886,0,-11778,0,0,0,,11778,-11778
14,04-02-18,30,7:15,7:30,,31.55,0,31.55,31.55,-1,-37147,91152,128299,54005,0,-10556,0,0,0,,10556,-10556
14,04-02-18,31,7:30,7:45,,30.38,0,30.38,30.38,-1,-52894,85493,138387,32599,0,-8923,0,0,0,,8923,-8923
14,04-02-18,32,7:45,8:00,,31.55,0,31.55,31.55,-1,-61873,92969,154842,31096,0,-2513,0,0,0,,2513,-2513
14,04-02-18,33,8:00,8:15,,-46.78,0,-46.78,-46.78,-1,-34669,89115,123784,54446,0,-33172,0,0,0,,33172,-33172
14,04-02-18,34,8:15,8:30,,27.01,0,27.01,27.01,-1,-43619,73216,116835,29597,0,-34312,0,0,0,,34312,-34312
14,04-02-18,35,8:30,8:45,,31.55,0,31.55,31.55,-1,-45920,55458,101378,9538,0,-22227,0,0,0,,22227,-22227
14,04-02-18,36,8:45,9:00,44.75,31.55,0,44.75,44.75,1,-58525,38093,96618,-20432,0,-2296,8874,0,0,,11170,6578
14,04-02-18,37,9:00,9:15,39.47,37.16,0,37.16,37.16,-1,-54053,95156,149209,41103,0,-140,5384,0,0,,5524,5244
14,04-02-18,38,9:15,9:30,39.47,37.16,0,37.16,37.16,-1,-51716,79403,131119,27687,0,-1928,9,0,0,,1937,-1919
14,04-02-18,39,9:30,9:45,,37.16,0,37.16,37.16,-1,-53518,70341,123859,16823,0,-18,0,0,0,,18,-18
14,04-02-18,40,9:45,10:00,39.37,,0,39.37,39.37,1,-59209,49573,108782,-9636,0,0,1130,0,0,,1130,1130
14,04-02-18,41,10:00,10:15,,,0,35.19,35.19,0,-73359,83577,156936,10218,0,0,117,0,0,,117,117
14,04-02-18,42,10:15,10:30,,,0,35.19,35.19,0,-67413,79548,146961,12135,0,0,0,0,0,,0,0
14,04-02-18,43,10:30,10:45,,,0,35.19,35.19,0,-62897,89080,151977,26183,0,0,0,0,0,,0,0
14,04-02-18,44,10:45,11:00,,,0,35.19,35.19,0,-58605,76562,135167,17957,0,0,0,0,0,,0,0
14,04-02-18,45,11:00,11:15,39.39,,0,39.39,39.39,1,-73466,71829,145295,-1637,0,0,950,0,0,,950,950
14,04-02-18,46,11:15,11:30,42.97,,0,42.97,42.97,1,-87015,70712,157727,-16303,0,0,3295,0,0,,3295,3295
14,04-02-18,47,11:30,11:45,47.29,,0,47.29,47.29,1,-96727,83222,179949,-13505,0,0,17615,0,0,,17615,17615
14,04-02-18,48,11:45,12:00,47.29,37.16,0,37.16,37.16,-1,-69016,96627,165643,27611,0,-448,2218,0,0,,2666,1770
14,04-02-18,49,12:00,12:15,39.55,37.08,0,39.55,35.06,2,-96009,87137,183146,-8872,0,-98,567,0,0,,665,469
14,04-02-18,50,12:15,12:30,39.55,31.55,0,39.55,31.55,2,-91604,95517,187121,3913,0,-444,1045,0,0,,1489,601
14,04-02-18,51,12:30,12:45,,23.31,0,23.31,23.31,-1,-66819,99957,166776,33138,0,-12087,0,0,0,,12087,-12087
14,04-02-18,52,12:45,13:00,,23.31,0,23.31,23.31,-1,-69038,88095,157133,19057,0,-30683,0,0,0,,30683,-30683
14,04-02-18,53,13:00,13:15,51.24,31.55,0,51.24,31.55,2,-80430,58856,139286,-21574,0,-12091,5521,0,0,,17612,-6570
14,04-02-18,54,13:15,13:30,43.55,31.55,0,43.55,43.55,1,-75541,59126,134667,-16415,0,-11,13446,0,0,,13457,13435
14,04-02-18,55,13:30,13:45,43.55,27.55,0,27.55,27.55,-1,-72085,88762,160847,16677,0,-10243,2041,0,0,,12284,-8202
14,04-02-18,56,13:45,14:00,,23.55,0,23.55,23.55,-1,-68719,105391,174110,36672,0,-26819,0,0,0,,26819,-26819
14,04-02-18,57,14:00,14:15,,26.62,0,26.62,26.62,-1,-57540,80362,137902,22822,0,-19502,0,0,0,,19502,-19502
14,04-02-18,58,14:15,14:30,,37.36,0,37.36,37.36,-1,-52294,97409,149703,45115,0,-199,0,0,0,,199,-199
14,04-02-18,59,14:30,14:45,,-8.92,0,-8.92,-8.92,-1,-45818,112128,157946,66310,0,-4280,0,0,0,,4280,-4280
14,04-02-18,60,14:45,15:00,,-150.78,0,-150.78,-150.78,-1,-72824,108124,180948,35300,0,-37356,0,0,0,,37356,-37356
14,04-02-18,61,15:00,15:15,,,0,35.86,35.86,0,-37696,65108,102804,27412,0,-3417,0,0,0,,3417,-3417
14,04-02-18,62,15:15,15:30,,31.46,0,31.46,31.46,-1,-35808,95004,130812,59196,0,-1046,0,0,0,,1046,-1046
14,04-02-18,63,15:30,15:45,,32.78,0,32.78,32.78,-1,-36391,118431,154822,82040,0,-1248,0,0,0,,1248,-1248
14,04-02-18,64,15:45,16:00,,-150.78,0,-150.78,-150.78,-1,-33666,155817,189483,122151,0,-20888,0,0,0,,20888,-20888
14,04-02-18,65,16:00,16:15,,-150.78,0,-150.78,-150.78,-1,-40522,178932,219454,138410,0,-101777,0,0,0,,101777,-101777
14,04-02-18,66,16:15,16:30,,-150.78,0,-150.78,-150.78,-1,-45467,111591,157058,66124,0,-86317,0,0,0,,86317,-86317
14,04-02-18,67,16:30,16:45,,16.87,0,16.87,16.87,-1,-39138,94657,133795,55519,0,-42481,0,0,0,,42481,-42481
14,04-02-18,68,16:45,17:00,,23.55,0,23.55,23.55,-1,-37628,99546,137174,61918,0,-41096,0,0,0,,41096,-41096
14,04-02-18,69,17:00,17:15,,-8.27,0,-8.27,-8.27,-1,-67665,123516,191181,55851,0,-41642,0,0,0,,41642,-41642
14,04-02-18,70,17:15,17:30,,28.48,0,28.48,28.48,-1,-66673,101154,167827,34481,0,-36786,0,0,0,,36786,-36786
14,04-02-18,71,17:30,17:45,,,0,33.43,33.43,0,-61108,86095,147203,24987,0,-7817,0,0,0,,7817,-7817
14,04-02-18,72,17:45,18:00,40.19,,0,40.19,40.19,1,-66880,82784,149664,15904,0,0,644,0,0,,644,644
14,04-02-18,73,18:00,18:15,34.23,,0,34.23,34.23,1,-95333,59174,154507,-36159,0,0,105,0,0,,105,105
14,04-02-18,74,18:15,18:30,45.38,,0,45.38,45.38,1,-84198,42208,126406,-41990,0,0,3712,0,0,,3712,3712
14,04-02-18,75,18:30,18:45,47.12,,0,47.12,47.12,1,-70063,63763,133826,-6300,0,0,14667,0,0,,14667,14667
14,04-02-18,76,18:45,19:00,,,0,33.56,33.56,0,-65879,75275,141154,9396,0,0,1661,0,0,,1661,1661
14,04-02-18,77,19:00,19:15,,-5.78,0,-5.78,-5.78,-1,-36985,72369,109354,35384,0,-18547,0,0,0,,18547,-18547
14,04-02-18,78,19:15,19:30,,31.55,0,31.55,31.55,-1,-49075,60783,109858,11708,0,-13093,0,0,0,,13093,-13093
14,04-02-18,79,19:30,19:45,,23.55,0,23.55,23.55,-1,-35102,82071,117173,46969,0,-24757,0,0,0,,24757,-24757
14,04-02-18,80,19:45,20:00,,31.55,0,31.55,31.55,-1,-33552,70647,104199,37095,0,-16552,0,0,0,,16552,-16552
14,04-02-18,81,20:00,20:15,,22.61,0,22.61,22.61,-1,-55971,97935,153906,41964,0,-11491,0,0,0,,11491,-11491
14,04-02-18,82,20:15,20:30,43.7,31.55,0,43.7,43.7,1,-95962,62029,157991,-33933,0,-11993,1467,0,0,,13460,-10526
14,04-02-18,83,20:30,20:45,35,31.55,0,35,35,1,-80776,65896,146672,-14880,0,-79,1761,0,0,,1840,1682
14,04-02-18,84,20:45,21:00,,19.27,0,19.27,19.27,-1,-59437,92206,151643,32769,0,-12617,0,0,0,,12617,-12617
14,04-02-18,85,21:00,21:15,,31.55,0,31.55,31.55,-1,-68654,85046,153700,16392,0,-13268,0,0,0,,13268,-13268
14,04-02-18,86,21:15,21:30,,-55.28,0,-55.28,-55.28,-1,-49294,100106,149400,50812,0,-25653,0,0,0,,25653,-25653
14,04-02-18,87,21:30,21:45,,-10.78,0,-10.78,-10.78,-1,-59453,118410,177863,58957,0,-46674,0,0,0,,46674,-46674
14,04-02-18,88,21:45,22:00,,23.55,0,23.55,23.55,-1,-70544,115525,186069,44981,0,-42235,0,0,0,,42235,-42235
14,04-02-18,89,22:00,22:15,253.12,23.55,0,253.12,253.12,1,-150947,24077,175024,-126870,0,-9690,25881,0,0,,35571,16191
14,04-02-18,90,22:15,22:30,76.12,37.27,0,37.27,37.27,-1,-75734,57402,133136,-18332,0,-46,38908,0,0,,38954,38862
14,04-02-18,91,22:30,22:45,76.12,6.06,0,6.06,6.06,-1,-28269,83531,111800,55262,0,-32266,1504,0,0,,33770,-30762
14,04-02-18,92,22:45,23:00,,-101.78,0,-101.78,-101.78,-1,-27108,100055,127163,72947,0,-59990,0,0,0,,59990,-59990
14,04-02-18,93,23:00,23:15,181.12,-9.78,0,181.12,181.12,1,-88762,18193,106955,-70569,0,-35190,5322,0,0,,40512,-29868
14,04-02-18,94,23:15,23:30,40.03,23.09,0,23.09,23.09,-1,-39953,57040,96993,17087,0,-3927,3645,0,0,,7572,-282
14,04-02-18,95,23:30,23:45,,20.29,0,20.29,20.29,-1,-40903,61285,102188,20382,0,-27986,0,0,0,,27986,-27986
14,04-02-18,96,23:45,0:00,,17.32,0,17.32,17.32,-1,-56052,53966,110018,-2086,0,-14305,0,0,0,,14305,-14305
14,04-03-18,1,0:00,0:15,,-150.03,0,-150.03,-150.03,-1,-64630,83729,148359,19099,0,-44307,0,0,0,,44307,-44307
14,04-03-18,2,0:15,0:30,,23.79,0,23.79,23.79,-1,-55302,61681,116983,6379,0,-6274,0,0,0,,6274,-6274
14,04-03-18,3,0:30,0:45,,23.79,0,23.79,23.79,-1,-63884,73710,137594,9826,0,-22544,0,0,0,,22544,-22544
14,04-03-18,4,0:45,1:00,,23.79,0,23.79,23.79,-1,-66499,71592,138091,5093,0,-15910,0,0,0,,15910,-15910
14,04-03-18,5,1:00,1:15,,-150.03,0,-150.03,-150.03,-1,-40224,116974,157198,76750,0,-43027,0,0,0,,43027,-43027
14,04-03-18,6,1:15,1:30,,-66.69,0,-66.69,-66.69,-1,-25039,82658,107697,57619,0,-29297,0,0,0,,29297,-29297
14,04-03-18,7,1:30,1:45,,-65.03,0,-65.03,-65.03,-1,-23630,66832,90462,43202,0,-44221,0,0,0,,44221,-44221
14,04-03-18,8,1:45,2:00,,-63.03,0,-63.03,-63.03,-1,-12257,75499,87756,63242,0,-56115,0,0,0,,56115,-56115
14,04-03-18,9,2:00,2:15,,-8.91,0,-8.91,-8.91,-1,-35279,133910,169189,98631,0,-35142,0,0,0,,35142,-35142
14,04-03-18,10,2:15,2:30,,-150.03,0,-150.03,-150.03,-1,-21786,139758,161544,117972,0,-23203,0,0,0,,23203,-23203
14,04-03-18,11,2:30,2:45,,-150.03,0,-150.03,-150.03,-1,-22489,120988,143477,98499,0,-81538,0,0,0,,81538,-81538
14,04-03-18,12,2:45,3:00,,-71.98,0,-71.98,-71.98,-1,-32521,111826,144347,79305,0,-81393,0,0,0,,81393,-81393
14,04-03-18,13,3:00,3:15,,-18.21,0,-18.21,-18.21,-1,-43711,126525,170236,82814,0,-54943,0,0,0,,54943,-54943
14,04-03-18,14,3:15,3:30,,-150.03,0,-150.03,-150.03,-1,-28558,138162,166720,109604,0,-30200,0,0,0,,30200,-30200
14,04-03-18,15,3:30,3:45,,-150.03,0,-150.03,-150.03,-1,-46444,105119,151563,58675,0,-74133,0,0,0,,74133,-74133
14,04-03-18,16,3:45,4:00,,-77.38,0,-77.38,-77.38,-1,-34415,116906,151321,82491,0,-64459,0,0,0,,64459,-64459
14,04-03-18,17,4:00,4:15,,-11.09,0,-11.09,-11.09,-1,-17603,161911,179514,144308,0,-46142,0,0,0,,46142,-46142
14,04-03-18,18,4:15,4:30,,-150.03,0,-150.03,-150.03,-1,-19689,159558,179247,139869,0,-69433,0,0,0,,69433,-69433
14,04-03-18,19,4:30,4:45,,-82.82,0,-82.82,-82.82,-1,-25115,140996,166111,115881,0,-84234,0,0,0,,84234,-84234
14,04-03-18,20,4:45,5:00,,-96.56,0,-96.56,-96.56,-1,-20103,164180,184283,144077,0,-79991,0,0,0,,79991,-79991
14,04-03-18,21,5:00,5:15,,-150.03,0,-150.03,-150.03,-1,-8317,183272,191589,174955,0,-93553,0,0,0,,93553,-93553
14,04-03-18,22,5:15,5:30,,-150.03,0,-150.03,-150.03,-1,-10095,174168,184263,164073,-11250,-114190,0,0,0,,125440,-125440
14,04-03-18,23,5:30,5:45,,-150.03,0,-250.03,-250.03,-1,-15411,128327,143738,112916,-11250,-80962,0,0,0,-8336,100548,-100548
14,04-03-18,24,5:45,6:00,,-99.03,0,-226.67,-226.67,-1,-42326,118311,160637,75985,-17500,-2199,0,0,0,-25008,44707,-44707
14,04-03-18,25,6:00,6:15,,-150.03,0,-250.03,-250.03,-1,-91825,169669,261494,77844,-12500,-22990,0,0,0,-25008,60498,-60498
14,04-03-18,26,6:15,6:30,,-86.03,0,-210.34,-210.34,-1,-88573,116484,205057,27911,-20000,-21600,0,0,0,-25008,66608,-66608
14,04-03-18,27,6:30,6:45,,-16.53,0,-16.53,-16.53,-1,-80692,176188,256880,95496,0,-12273,0,0,0,-8336,20609,-20609
14,04-03-18,28,6:45,7:00,,-16.03,0,-16.03,-16.03,-1,-114483,187631,302114,73148,0,-20138,0,0,0,,20138,-20138
14,04-03-18,29,7:00,7:15,,-88.55,0,-88.55,-88.55,-1,-81498,88457,169955,6959,0,-42572,0,0,0,,42572,-42572
14,04-03-18,30,7:15,7:30,,4.87,0,4.87,4.87,-1,-99110,39304,138414,-59806,0,-57083,0,0,0,,57083,-57083
14,04-03-18,31,7:30,7:45,,31.99,0,31.99,31.99,-1,-103815,28144,131959,-75671,0,-24757,0,0,0,,24757,-24757
14,04-03-18,32,7:45,8:00,,,0,33.91,33.91,0,-134376,47561,181937,-86815,0,-5522,0,0,0,,5522,-5522
14,04-03-18,33,8:00,8:15,35.99,,0,35.99,35.99,1,-110001,58805,168806,-51196,0,0,202,0,0,,202,202
14,04-03-18,34,8:15,8:30,58.99,,0,58.99,58.99,1,-119777,55522,175299,-64255,0,0,5861,0,0,,5861,5861
14,04-03-18,35,8:30,8:45,90.2,,0,90.2,90.2,1,-139684,59170,198854,-80514,0,0,30819,0,0,,30819,30819
14,04-03-18,36,8:45,9:00,39.99,,0,39.99,39.99,1,-119961,69808,189769,-50153,0,0,30919,0,0,,30919,30919
14,04-03-18,37,9:00,9:15,170.95,34.28,0,170.95,34.28,2,-83288,71517,154805,-11771,0,-418,8001,1250,0,,9669,8833
14,04-03-18,38,9:15,9:30,,,0,34.37,34.37,0,-92207,121532,213739,29325,0,0,0,0,0,,0,0
14,04-03-18,39,9:30,9:45,,,0,35.27,35.27,0,-87393,128352,215745,40959,0,0,0,0,0,,0,0
14,04-03-18,40,9:45,10:00,,29.93,0,29.93,29.93,-1,-83824,120008,203832,36184,0,-4293,0,0,0,,4293,-4293
14,04-03-18,41,10:00,10:15,35.99,29.93,0,35.99,35.99,1,-65093,66386,131479,1293,0,-551,1154,0,0,,1705,603
14,04-03-18,42,10:15,10:30,35.13,,0,35.13,35.13,1,-56390,75494,131884,19104,0,0,689,0,0,,689,689
14,04-03-18,43,10:30,10:45,,,0,34.37,34.37,0,-43379,66239,109618,22860,0,0,0,0,0,,0,0
14,04-03-18,44,10:45,11:00,,23.99,0,23.99,23.99,-1,-37611,96675,134286,59064,0,-3835,0,0,0,,3835,-3835
14,04-03-18,45,11:00,11:15,,8.71,0,8.71,8.71,-1,-75904,60817,136721,-15087,0,-12704,0,0,0,,12704,-12704
14,04-03-18,46,11:15,11:30,,-5.03,0,-5.03,-5.03,-1,-63437,101558,164995,38121,0,-10288,0,0,0,,10288,-10288
14,04-03-18,47,11:30,11:45,,4.03,0,4.03,4.03,-1,-51233,95496,146729,44263,0,-37268,0,0,0,,37268,-37268
14,04-03-18,48,11:45,12:00,,23.99,0,23.99,23.99,-1,-44432,124694,169126,80262,0,-31100,0,0,0,,31100,-31100
14,04-03-18,49,12:00,12:15,206.02,31.99,0,206.02,206.02,1,-100572,51034,151606,-49538,0,-12341,8797,0,0,,21138,-3544
14,04-03-18,50,12:15,12:30,43.99,,0,43.99,43.99,1,-71389,94824,166213,23435,0,0,11686,0,0,,11686,11686
14,04-03-18,51,12:30,12:45,,,0,33.6,33.6,0,-70176,106766,176942,36590,0,0,5,0,0,,5,5
14,04-03-18,52,12:45,13:00,,,0,33.53,33.53,0,-71373,105544,176917,34171,0,0,0,0,0,,0,0
14,04-03-18,53,13:00,13:15,,,0,33.64,33.64,0,-73665,147799,221464,74134,0,0,0,0,0,,0,0
14,04-03-18,54,13:15,13:30,,-30.43,0,-30.43,-30.43,-1,-50758,105493,156251,54735,0,-8499,0,0,0,,8499,-8499
14,04-03-18,55,13:30,13:45,,-416.22,0,-416.22,-416.22,-1,-78999,58325,137324,-20674,-30000,-50915,0,0,0,,80915,-80915
14,04-03-18,56,13:45,14:00,35.99,-416.22,0,35.99,-416.22,2,-103436,29430,132866,-74006,-30000,-10527,17,0,0,,40544,-40510
14,04-03-18,57,14:00,14:15,42.43,-416.22,0,42.43,-416.22,2,-46840,80639,127479,33799,-20000,-1298,1920,0,0,,23218,-19378
14,04-03-18,58,14:15,14:30,33.29,31.7,0,33.29,31.7,2,-45338,98694,144032,53356,0,-230,68,0,0,,298,-162
14,04-03-18,59,14:30,14:45,,,0,33.03,33.03,0,-40358,143757,184115,103399,0,-3,0,0,0,,3,-3
14,04-03-18,60,14:45,15:00,,-150.03,0,-150.03,-150.03,-1,-35141,137758,172899,102617,0,-26871,0,0,0,,26871,-26871
14,04-03-18,61,15:00,15:15,,23.99,0,23.99,23.99,-1,-65191,157917,223108,92726,0,-18121,0,0,0,,18121,-18121
14,04-03-18,62,15:15,15:30,,,0,34.22,34.22,0,-68027,163564,231591,95537,0,0,0,0,0,,0,0
14,04-03-18,63,15:30,15:45,,30.49,0,30.49,30.49,-1,-67916,151469,219385,83553,0,-370,0,0,0,,370,-370
14,04-03-18,64,15:45,16:00,,-57.24,0,-57.24,-57.24,-1,-58477,110414,168891,51937,0,-25881,0,0,0,,25881,-25881
14,04-03-18,65,16:00,16:15,,-76.03,0,-76.03,-76.03,-1,-58670,139180,197850,80510,0,-41351,0,0,0,,41351,-41351
14,04-03-18,66,16:15,16:30,,23.2,0,23.2,23.2,-1,-61745,109556,171301,47811,0,-51516,0,0,0,,51516,-51516
14,04-03-18,67,16:30,16:45,,27.79,0,27.79,27.79,-1,-56194,91434,147628,35240,0,-40484,0,0,0,,40484,-40484
14,04-03-18,68,16:45,17:00,,,0,33.62,33.62,0,-67546,80782,148328,13236,0,-6656,0,0,0,,6656,-6656
14,04-03-18,69,17:00,17:15,,16.79,0,16.79,16.79,-1,-84098,112133,196231,28035,0,-14984,0,0,0,,14984,-14984
14,04-03-18,70,17:15,17:30,,34.73,0,34.73,34.73,-1,-120834,82426,203260,-38408,0,-3013,0,0,0,,3013,-3013
14,04-03-18,71,17:30,17:45,47.22,,0,47.22,47.22,1,-142213,67509,209722,-74704,0,0,2045,0,0,,2045,2045
14,04-03-18,72,17:45,18:00,238.12,,0,238.12,238.12,1,-151226,74757,225983,-76469,0,0,49648,0,0,,49648,49648
14,04-03-18,73,18:00,18:15,33.07,32.05,0,32.05,32.05,-1,-115070,85279,200349,-29791,0,-28,17070,0,0,,17098,17042
14,04-03-18,74,18:15,18:30,,32.05,0,32.05,32.05,-1,-106290,101780,208070,-4510,0,-46,0,0,0,,46,-46
14,04-03-18,75,18:30,18:45,,,0,33.79,33.79,0,-103764,94796,198560,-8968,0,0,0,0,0,,0,0
14,04-03-18,76,18:45,19:00,35.99,,0,35.99,35.99,1,-88267,74241,162508,-14026,0,0,1614,0,0,,1614,1614
14,04-03-18,77,19:00,19:15,36.12,,0,36.12,36.12,1,-111244,80068,191312,-31176,0,0,9755,0,0,,9755,9755
14,04-03-18,78,19:15,19:30,33.66,,0,33.66,33.66,1,-55906,83612,139518,27706,0,0,2844,0,0,,2844,2844
14,04-03-18,79,19:30,19:45,,,0,34,34,0,-34265,94017,128282,59752,0,0,8,0,0,,8,8
14,04-03-18,80,19:45,20:00,35.99,,0,35.99,35.99,1,-71763,76717,148480,4954,0,0,510,0,0,,510,510
14,04-03-18,81,20:00,20:15,38.19,,0,38.19,38.19,1,-52886,85491,138377,32605,0,0,527,0,0,,527,527
14,04-03-18,82,20:15,20:30,35.99,,0,35.99,35.99,1,-75557,48792,124349,-26765,0,0,325,0,0,,325,325
14,04-03-18,83,20:30,20:45,35.99,,0,35.99,35.99,1,-83703,40687,124390,-43016,0,0,384,0,0,,384,384
14,04-03-18,84,20:45,21:00,,33.82,0,33.82,33.82,-1,-74688,50448,125136,-24240,0,-19,0,0,0,,19,-19
14,04-03-18,85,21:00,21:15,,27.99,0,27.99,27.99,-1,-89328,126919,216247,37591,0,-765,0,0,0,,765,-765
14,04-03-18,86,21:15,21:30,,,0,34.53,34.53,0,-65701,78866,144567,13165,0,0,0,0,0,,0,0
14,04-03-18,87,21:30,21:45,,34.64,0,34.64,34.64,-1,-71029,94266,165295,23237,0,-12,0,0,0,,12,-12
14,04-03-18,88,21:45,22:00,,31.99,0,31.99,31.99,-1,-82859,94187,177046,11328,0,-6909,0,0,0,,6909,-6909
14,04-03-18,89,22:00,22:15,39.99,31.99,0,39.99,39.99,1,-191208,88810,280018,-102398,0,-1966,1266,0,0,,3232,-700
14,04-03-18,90,22:15,22:30,,,0,34.7,34.7,0,-159625,38440,198065,-121185,0,0,26,0,0,,26,26
14,04-03-18,91,22:30,22:45,46.21,,0,46.21,46.21,1,-131614,30156,161770,-101458,0,0,5381,0,0,,5381,5381
14,04-03-18,92,22:45,23:00,58.99,,0,58.99,58.99,1,-83622,46745,130367,-36877,0,0,20324,0,0,,20324,20324
14,04-03-18,93,23:00,23:15,54.25,,0,54.25,54.25,1,-114680,43557,158237,-71123,0,0,3878,0,0,,3878,3878
14,04-03-18,94,23:15,23:30,35.99,34.06,0,34.06,34.06,-1,-83148,57778,140926,-25370,0,-38,3269,0,0,,3307,3231
14,04-03-18,95,23:30,23:45,,26.61,0,26.61,26.61,-1,-50860,74228,125088,23368,0,-8988,0,0,0,,8988,-8988
14,04-03-18,96,23:45,0:00,,27.99,0,27.99,27.99,-1,-97209,82279,179488,-14930,0,-12648,0,0,0,,12648,-12648
14,04-04-18,1,0:00,0:15,,,0,34.65,34.65,0,-71479,121564,193043,50085,0,-148,0,0,0,,148,-148
14,04-04-18,2,0:15,0:30,37.19,,0,37.19,37.19,1,-92098,95430,187528,3332,0,0,973,0,0,,973,973
14,04-04-18,3,0:30,0:45,,30.43,0,30.43,30.43,-1,-103251,122990,226241,19739,0,-304,0,0,0,,304,-304
14,04-04-18,4,0:45,1:00,,21.41,0,21.41,21.41,-1,-123726,132603,256329,8877,0,-10254,0,0,0,,10254,-10254
14,04-04-18,5,1:00,1:15,,31.78,0,31.78,31.78,-1,-122314,146785,269099,24471,0,-2526,0,0,0,,2526,-2526
14,04-04-18,6,1:15,1:30,,,0,32.46,32.46,0,-84963,125324,210287,40361,0,0,0,0,0,,0,0
14,04-04-18,7,1:30,1:45,,31.78,0,31.78,31.78,-1,-34213,112108,146321,77895,0,-91,0,0,0,,91,-91
14,04-04-18,8,1:45,2:00,,-6.23,0,-6.23,-6.23,-1,-40654,106704,147358,66050,0,-9439,0,0,0,,9439,-9439
14,04-04-18,9,2:00,2:15,,30.9,0,30.9,30.9,-1,-41311,71014,112325,29703,0,-4897,0,0,0,,4897,-4897
14,04-04-18,10,2:15,2:30,,,0,32.46,32.46,0,-52720,68435,121155,15715,0,0,0,0,0,,0,0
14,04-04-18,11,2:30,2:45,,31.24,0,31.24,31.24,-1,-29545,100210,129755,70665,0,-272,0,0,0,,272,-272
14,04-04-18,12,2:45,3:00,,-20.41,0,-20.41,-20.41,-1,-33610,128866,162476,95256,0,-23447,0,0,0,,23447,-23447
14,04-04-18,13,3:00,3:15,,31.78,0,31.78,31.78,-1,-37491,101917,139408,64426,0,-5579,0,0,0,,5579,-5579
14,04-04-18,14,3:15,3:30,,,0,32.92,32.92,0,-41324,102289,143613,60965,0,0,0,0,0,,0,0
14,04-04-18,15,3:30,3:45,,,0,33.02,33.02,0,-38227,81620,119847,43393,0,0,0,0,0,,0,0
14,04-04-18,16,3:45,4:00,,20.11,0,20.11,20.11,-1,-43522,70056,113578,26534,0,-2601,0,0,0,,2601,-2601
14,04-04-18,17,4:00,4:15,,8.41,0,8.41,8.41,-1,-50799,84512,135311,33713,0,-11000,0,0,0,,11000,-11000
14,04-04-18,18,4:15,4:30,,21.8,0,21.8,21.8,-1,-56294,89125,145419,32831,0,-15753,0,0,0,,15753,-15753
14,04-04-18,19,4:30,4:45,39.78,21.8,0,39.78,39.78,1,-71530,56247,127777,-15283,0,-3057,4164,0,0,,7221,1107
14,04-04-18,20,4:45,5:00,40.32,32.32,0,40.32,32.32,2,-47785,51612,99397,3827,0,-34,10852,0,0,,10886,10818
14,04-04-18,21,5:00,5:15,40.32,-55.41,0,-55.41,-55.41,-1,-25221,101865,127086,76644,0,-27111,236,0,0,,27347,-26875
14,04-04-18,22,5:15,5:30,,11.41,0,11.41,11.41,-1,-30645,98425,129070,67780,0,-46772,0,0,0,,46772,-46772
14,04-04-18,23,5:30,5:45,,14.57,0,14.57,14.57,-1,-31010,82499,113509,51489,0,-36121,0,0,0,,36121,-36121
14,04-04-18,24,5:45,6:00,,31.82,0,31.82,31.82,-1,-56682,99596,156278,42914,0,-7020,0,0,0,,7020,-7020
14,04-04-18,25,6:00,6:15,,4.76,0,4.76,4.76,-1,-50904,118502,169406,67598,0,-11261,0,0,0,,11261,-11261
14,04-04-18,26,6:15,6:30,,3.45,0,3.45,3.45,-1,-15840,105897,121737,90057,0,-46258,0,0,0,,46258,-46258
14,04-04-18,27,6:30,6:45,42.51,31.34,0,42.51,31.34,2,-59413,50382,109795,-9031,0,-11442,677,0,0,,12119,-10765
14,04-04-18,28,6:45,7:00,60.31,,0,60.31,60.31,1,-109101,57705,166806,-51396,0,0,8006,0,0,,8006,8006
14,04-04-18,29,7:00,7:15,35.78,-80.49,0,-80.49,-80.49,-1,-38401,159704,198105,121303,0,-32772,3299,0,0,,36071,-29473
14,04-04-18,30,7:15,7:30,,-86,0,-86,-86,-1,-70921,75757,146678,4836,0,-54794,0,0,0,,54794,-54794
14,04-04-18,31,7:30,7:45,,,0,34.29,34.29,0,-99143,79661,178804,-19482,0,-30,0,0,0,,30,-30
14,04-04-18,32,7:45,8:00,38.88,,0,38.88,38.88,1,-150910,68076,218986,-82834,0,0,316,0,0,,316,316
14,04-04-18,33,8:00,8:15,,23.78,0,23.78,23.78,-1,-77943,122709,200652,44766,0,-7942,0,0,0,,7942,-7942
14,04-04-18,34,8:15,8:30,,34.05,0,34.05,34.05,-1,-87737,92934,180671,5197,0,-1707,0,0,0,,1707,-1707
14,04-04-18,35,8:30,8:45,38.85,34.05,0,38.85,38.85,1,-107227,81094,188321,-26133,0,-8,52,0,0,,60,44
14,04-04-18,36,8:45,9:00,58.78,,0,58.78,58.78,1,-135791,73388,209179,-62403,0,0,8312,0,0,,8312,8312
14,04-04-18,37,9:00,9:15,40.33,,0,40.33,40.33,1,-108401,91440,199841,-16961,0,0,3229,0,0,,3229,3229
14,04-04-18,38,9:15,9:30,46.72,,0,46.72,46.72,1,-109636,82854,192490,-26782,0,0,13237,0,0,,13237,13237
14,04-04-18,39,9:30,9:45,35.78,,0,35.78,35.78,1,-88619,88408,177027,-211,0,0,5459,0,0,,5459,5459
14,04-04-18,40,9:45,10:00,,35.63,0,35.63,35.63,-1,-75624,81199,156823,5575,0,-1327,0,0,0,,1327,-1327
14,04-04-18,41,10:00,10:15,35.78,35.63,0,35.78,35.78,1,-112454,102219,214673,-10235,0,-264,799,0,0,,1063,535
14,04-04-18,42,10:15,10:30,35.78,,0,35.78,35.78,1,-97972,107974,205946,10002,0,0,1561,0,0,,1561,1561
14,04-04-18,43,10:30,10:45,35.21,31.78,0,35.21,31.78,2,-57989,111694,169683,53705,0,-489,336,0,0,,825,-153
14,04-04-18,44,10:45,11:00,,31.78,0,31.78,31.78,-1,-47609,163385,210994,115776,0,-1836,0,0,0,,1836,-1836
14,04-04-18,45,11:00,11:15,,24.74,0,24.74,24.74,-1,-45871,145713,191584,99842,0,-2658,0,0,0,,2658,-2658
14,04-04-18,46,11:15,11:30,,33.78,0,33.78,33.78,-1,-42644,140500,183144,97856,0,-317,0,0,0,,317,-317
14,04-04-18,47,11:30,11:45,,,0,34.19,34.19,0,-49469,121324,170793,71855,0,0,0,0,0,,0,0
14,04-04-18,48,11:45,12:00,,,0,34.38,34.38,0,-78552,98926,177478,20374,0,0,0,0,0,,0,0
14,04-04-18,49,12:00,12:15,35.78,,0,35.78,35.78,1,-120754,55926,176680,-64828,0,0,523,0,0,,523,523
14,04-04-18,50,12:15,12:30,,,0,34.24,34.24,0,-129710,66877,196587,-62833,0,0,0,0,0,,0,0
14,04-04-18,51,12:30,12:45,,,0,34.24,34.24,0,-127731,65651,193382,-62080,0,0,0,0,0,,0,0
14,04-04-18,52,12:45,13:00,34.5,,0,34.5,34.5,1,-140139,50387,190526,-89752,0,0,338,0,0,,338,338
14,04-04-18,53,13:00,13:15,155.12,,0,155.12,155.12,1,-139564,48406,187970,-91158,0,0,9081,0,0,,9081,9081
14,04-04-18,54,13:15,13:30,221.12,,0,221.12,221.12,1,-169963,61275,231238,-108688,0,0,66005,0,0,,66005,66005
14,04-04-18,55,13:30,13:45,43.78,,0,43.78,43.78,1,-131363,90750,222113,-40613,0,0,38284,0,0,,38284,38284
14,04-04-18,56,13:45,14:00,39.9,,0,39.9,39.9,1,-131229,89421,220650,-41808,0,0,26433,0,0,,26433,26433
14,04-04-18,57,14:00,14:15,33.79,34.05,0,33.92,33.92,2,-83145,82479,165624,-666,0,-89,5880,0,0,,5969,5791
14,04-04-18,58,14:15,14:30,43.78,,0,43.78,43.78,1,-112014,79430,191444,-32584,0,0,9475,0,0,,9475,9475
14,04-04-18,59,14:30,14:45,54.51,,0,54.51,54.51,1,-133293,93545,226838,-39748,0,0,31438,0,0,,31438,31438
14,04-04-18,60,14:45,15:00,34.12,31.78,0,31.78,31.78,-1,-120385,100819,221204,-19566,0,-5,10698,0,0,,10703,10693
14,04-04-18,61,15:00,15:15,,34.3,0,34.3,34.3,-1,-70493,129876,200369,59383,0,-29,0,0,0,,29,-29
14,04-04-18,62,15:15,15:30,,30.82,0,30.82,30.82,-1,-54698,99996,154694,45298,0,-5185,0,0,0,,5185,-5185
14,04-04-18,63,15:30,15:45,,31.78,0,31.78,31.78,-1,-65346,87930,153276,22584,0,-7944,0,0,0,,7944,-7944
14,04-04-18,64,15:45,16:00,,31.78,0,31.78,31.78,-1,-84667,90311,174978,5644,0,-3219,0,0,0,,3219,-3219
14,04-04-18,65,16:00,16:15,,31.78,0,31.78,31.78,-1,-69341,72492,141833,3151,0,-6188,0,0,0,,6188,-6188
14,04-04-18,66,16:15,16:30,,34.41,0,34.41,34.41,-1,-74473,62269,136742,-12204,0,-1870,0,0,0,,1870,-1870
14,04-04-18,67,16:30,16:45,,,0,33.99,33.99,0,-91440,68632,160072,-22808,0,0,0,0,0,,0,0
14,04-04-18,68,16:45,17:00,,,0,34.07,34.07,0,-100022,75336,175358,-24686,0,0,0,0,0,,0,0
14,04-04-18,69,17:00,17:15,,,0,34.04,34.04,0,-101582,65642,167224,-35940,0,0,0,0,0,,0,0
14,04-04-18,70,17:15,17:30,43.78,,0,43.78,43.78,1,-125723,60492,186215,-65231,0,0,1325,0,0,,1325,1325
14,04-04-18,71,17:30,17:45,237.12,,0,237.12,237.12,1,-146649,48777,195426,-97872,0,0,48841,0,0,,48841,48841
14,04-04-18,72,17:45,18:00,38.12,,0,38.12,38.12,1,-114928,132436,247364,17508,0,0,23555,0,0,,23555,23555
14,04-04-18,73,18:00,18:15,,33.7,0,33.7,33.7,-1,-122122,81892,204014,-40230,0,-193,0,0,0,,193,-193
14,04-04-18,74,18:15,18:30,,11.88,0,11.88,11.88,-1,-78060,123254,201314,45194,0,-20805,0,0,0,,20805,-20805
14,04-04-18,75,18:30,18:45,,12.3,0,12.3,12.3,-1,-42452,132827,175279,90375,0,-56788,0,0,0,,56788,-56788
14,04-04-18,76,18:45,19:00,,,0,34.05,34.05,0,-70960,162167,233127,91207,0,-10215,0,0,0,,10215,-10215
14,04-04-18,77,19:00,19:15,39.98,,0,39.98,39.98,1,-94678,46821,141499,-47857,0,0,38,0,0,,38,38
14,04-04-18,78,19:15,19:30,58.78,,0,58.78,58.78,1,-154999,19476,174475,-135523,0,0,10544,0,0,,10544,10544
14,04-04-18,79,19:30,19:45,41.06,,0,41.06,41.06,1,-149949,23238,173187,-126711,0,0,26072,0,0,,26072,26072
14,04-04-18,80,19:45,20:00,38.82,,0,38.82,38.82,1,-138116,27744,165860,-110372,0,0,13408,0,0,,13408,13408
14,04-04-18,81,20:00,20:15,43.78,,0,43.78,43.78,1,-81889,49900,131789,-31989,0,0,14404,0,0,,14404,14404
14,04-04-18,82,20:15,20:30,237.12,,0,237.12,237.12,1,-100340,30929,131269,-69411,0,0,27002,0,0,,27002,27002
14,04-04-18,83,20:30,20:45,237.12,,0,237.12,237.12,1,-105107,33563,138670,-71544,0,0,74006,0,0,,74006,74006
14,04-04-18,84,20:45,21:00,39.78,,0,39.78,39.78,1,-66308,50260,116568,-16048,0,0,18167,0,0,,18167,18167
14,04-04-18,85,21:00,21:15,237.12,,0,237.12,237.12,1,-133125,54919,188044,-78206,0,0,43524,0,0,,43524,43524
14,04-04-18,86,21:15,21:30,65.12,,0,65.12,65.12,1,-107746,66226,173972,-41520,0,0,52743,0,0,,52743,52743
14,04-04-18,87,21:30,21:45,37.12,33.2,0,37.12,33.2,2,-81308,88804,170112,7496,0,-592,13450,0,0,,14042,12858
14,04-04-18,88,21:45,22:00,,34.23,0,34.23,34.23,-1,-69503,111279,180782,41776,0,-531,0,0,0,,531,-531
14,04-04-18,89,22:00,22:15,237.12,33.99,0,237.12,237.12,1,-176888,55277,232165,-121611,0,-320,27942,0,0,,28262,27622
14,04-04-18,90,22:15,22:30,237.12,,0,237.12,237.12,1,-133887,83127,217014,-50760,0,0,51268,0,0,,51268,51268
14,04-04-18,91,22:30,22:45,38.25,,0,38.25,38.25,1,-90723,100697,191420,9974,0,0,6740,0,0,,6740,6740
14,04-04-18,92,22:45,23:00,,,0,22.59,22.59,0,-64876,91225,156101,26349,0,0,0,0,0,,0,0
14,04-04-18,93,23:00,23:15,221.12,,0,221.12,221.12,1,-151145,44279,195424,-106866,0,0,27944,0,0,,27944,27944
14,04-04-18,94,23:15,23:30,207.12,,0,207.12,207.12,1,-122896,96990,219886,-25906,0,0,55994,0,0,,55994,55994
14,04-04-18,95,23:30,23:45,39.12,,0,39.12,39.12,1,-101685,87075,188760,-14610,0,0,2842,0,0,,2842,2842
14,04-04-18,96,23:45,0:00,,,0,34.3,34.3,0,-92915,106073,198988,13158,0,0,29,0,0,,29,29
14,04-05-18,1,0:00,0:15,,,0,32.9,32.9,0,-80606,148072,228678,67466,0,0,0,0,0,,0,0
14,04-05-18,2,0:15,0:30,,30.42,0,30.42,30.42,-1,-47050,99585,146635,52535,0,-45,0,0,0,,45,-45
14,04-05-18,3,0:30,0:45,,-44.81,0,-44.81,-44.81,-1,-38092,110729,148821,72637,0,-30647,0,0,0,,30647,-30647
14,04-05-18,4,0:45,1:00,,-18.68,0,-18.68,-18.68,-1,-72989,111131,184120,38142,0,-53082,0,0,0,,53082,-53082
14,04-05-18,5,1:00,1:15,,29.03,0,29.03,29.03,-1,-80374,84579,164953,4205,0,-9624,0,0,0,,9624,-9624
14,04-05-18,6,1:15,1:30,,-17.91,0,-17.91,-17.91,-1,-46618,82362,128980,35744,0,-16659,0,0,0,,16659,-16659
14,04-05-18,7,1:30,1:45,,-17.91,0,-17.91,-17.91,-1,-41689,78984,120673,37295,0,-44321,0,0,0,,44321,-44321
14,04-05-18,8,1:45,2:00,,-20.51,0,-20.51,-20.51,-1,-45301,93471,138772,48170,0,-47571,0,0,0,,47571,-47571
14,04-05-18,9,2:00,2:15,77.3,27.78,0,77.3,77.3,1,-92356,61027,153383,-31329,0,-13117,6225,0,0,,19342,-6892
14,04-05-18,10,2:15,2:30,68.79,,0,68.79,68.79,1,-72256,52836,125092,-19420,0,0,17694,0,0,,17694,17694
14,04-05-18,11,2:30,2:45,68.79,27.78,0,27.78,27.78,-1,-56460,72206,128666,15746,0,-3959,1234,0,0,,5193,-2725
14,04-05-18,12,2:45,3:00,,-8.64,0,-8.64,-8.64,-1,-43856,81855,125711,37999,0,-29370,0,0,0,,29370,-29370
14,04-05-18,13,3:00,3:15,35.78,27.56,0,35.78,27.56,2,-52410,47969,100379,-4441,0,-10936,391,0,0,,11327,-10545
14,04-05-18,14,3:15,3:30,35.78,35.18,0,35.18,35.18,-1,-52144,61721,113865,9577,0,-2,35,0,0,,37,33
14,04-05-18,15,3:30,3:45,,13.78,0,13.78,13.78,-1,-48176,72490,120666,24314,0,-2694,0,0,0,,2694,-2694
14,04-05-18,16,3:45,4:00,,13.78,0,13.78,13.78,-1,-45739,71225,116964,25486,0,-14290,0,0,0,,14290,-14290
14,04-05-18,17,4:00,4:15,,35.3,0,35.3,35.3,-1,-53481,60985,114466,7504,0,-5879,0,0,0,,5879,-5879
14,04-05-18,18,4:15,4:30,,,0,34.21,34.21,0,-48457,65846,114303,17389,0,0,0,0,0,,0,0
14,04-05-18,19,4:30,4:45,35.78,,0,35.78,35.78,1,-41876,50969,92845,9093,0,0,22,0,0,,22,22
14,04-05-18,20,4:45,5:00,34.92,,0,34.92,34.92,1,-43741,56951,100692,13210,0,0,11,0,0,,11,11
14,04-05-18,21,5:00,5:15,35.78,,0,35.78,35.78,1,-111891,39292,151183,-72599,0,0,3459,0,0,,3459,3459
14,04-05-18,22,5:15,5:30,35.78,,0,35.78,35.78,1,-60877,39445,100322,-21432,0,0,665,0,0,,665,665
14,04-05-18,23,5:30,5:45,35.78,,0,35.78,35.78,1,-50761,32172,82933,-18589,0,0,6786,0,0,,6786,6786
14,04-05-18,24,5:45,6:00,35.78,,0,35.78,35.78,1,-50006,56077,106083,6071,0,0,6990,0,0,,6990,6990
14,04-05-18,25,6:00,6:15,36.18,33.76,0,33.76,33.76,-1,-88297,58109,146406,-30188,0,-48,2393,0,0,,2441,2345
14,04-05-18,26,6:15,6:30,42.4,20.18,0,42.4,20.18,2,-51533,48179,99712,-3354,0,-7081,435,0,0,,7516,-6646
14,04-05-18,27,6:30,6:45,52.3,20.18,0,52.3,52.3,1,-72567,35171,107738,-37396,0,-80,14326,0,0,,14406,14246
14,04-05-18,28,6:45,7:00,44.18,,0,44.18,44.18,1,-75952,49021,124973,-26931,0,0,20466,0,0,,20466,20466
14,04-05-18,29,7:00,7:15,37.16,27.52,0,27.52,27.52,-1,-77191,66322,143513,-10869,0,-1508,10420,0,0,,11928,8912
14,04-05-18,30,7:15,7:30,37.16,23.82,0,23.82,23.82,-1,-43902,56329,100231,12427,0,-11419,149,0,0,,11568,-11270
14,04-05-18,31,7:30,7:45,,,0,33.31,33.31,0,-70174,42428,112602,-27746,0,-476,0,0,0,,476,-476
14,04-05-18,32,7:45,8:00,53.4,,0,53.4,53.4,1,-111404,50786,162190,-60618,0,0,6345,0,0,,6345,6345
14,04-05-18,33,8:00,8:15,38.64,-6.03,0,-6.03,-6.03,-1,-12284,74185,86469,61901,0,-8657,4873,0,0,,13530,-3784
14,04-05-18,34,8:15,8:30,,-16.03,0,-16.03,-16.03,-1,-70138,41946,112084,-28192,0,-17159,0,0,0,,17159,-17159
14,04-05-18,35,8:30,8:45,,,0,34.29,34.29,0,-56433,43926,100359,-12507,0,-33,0,0,0,,33,-33
14,04-05-18,36,8:45,9:00,,,0,34.33,34.33,0,-73279,40075,113354,-33204,0,0,0,0,0,,0,0
14,04-05-18,37,9:00,9:15,35.11,,0,35.11,35.11,1,-47548,49489,97037,1941,0,0,293,0,0,,293,293
14,04-05-18,38,9:15,9:30,,32.94,0,32.94,32.94,-1,-42640,44469,87109,1829,0,-980,0,0,0,,980,-980
14,04-05-18,39,9:30,9:45,,33.36,0,33.36,33.36,-1,-59879,40274,100153,-19605,0,-1537,0,0,0,,1537,-1537
14,04-05-18,40,9:45,10:00,,34.78,0,34.78,34.78,-1,-82117,40736,122853,-41381,0,-128,0,0,0,,128,-128
14,04-05-18,41,10:00,10:15,147.02,,0,147.02,147.02,1,-144323,44706,189029,-99617,0,0,15872,0,0,,15872,15872
14,04-05-18,42,10:15,10:30,46.29,,0,46.29,46.29,1,-115357,55113,170470,-60244,0,0,21384,0,0,,21384,21384
14,04-05-18,43,10:30,10:45,34.64,,0,34.64,34.64,1,-83785,50974,134759,-32811,0,0,2062,0,0,,2062,2062
14,04-05-18,44,10:45,11:00,,,0,34.72,34.72,0,-89651,65951,155602,-23700,0,0,0,0,0,,0,0
14,04-05-18,45,11:00,11:15,62.7,,0,62.7,62.7,1,-130823,60064,190887,-70759,0,0,12168,0,0,,12168,12168
14,04-05-18,46,11:15,11:30,39.71,,0,39.71,39.71,1,-103163,83885,187048,-19278,0,0,7867,0,0,,7867,7867
14,04-05-18,47,11:30,11:45,,,0,34.63,34.63,0,-107816,73424,181240,-34392,0,0,0,0,0,,0,0
14,04-05-18,48,11:45,12:00,,,0,34.65,34.65,0,-97705,83777,181482,-13928,0,0,0,0,0,,0,0
14,04-05-18,49,12:00,12:15,39.71,,0,39.71,39.71,1,-116030,68878,184908,-47152,0,0,3635,0,0,,3635,3635
14,04-05-18,50,12:15,12:30,39.71,31.46,0,31.46,31.46,-1,-64991,84864,149855,19873,0,-423,267,0,0,,690,-156
14,04-05-18,51,12:30,12:45,,32.27,0,32.27,32.27,-1,-54904,86979,141883,32075,0,-683,0,0,0,,683,-683
14,04-05-18,52,12:45,13:00,,23.71,0,23.71,23.71,-1,-45601,105864,151465,60263,0,-2452,0,0,0,,2452,-2452
14,04-05-18,53,13:00,13:15,33.67,8.71,0,34.47,8.71,2,-41340,71755,113095,30415,0,-6626,10,0,0,,6636,-6616
14,04-05-18,54,13:15,13:30,37.45,23.71,0,37.45,23.71,2,-45142,63701,108843,18559,0,-2223,873,0,0,,3096,-1350
14,04-05-18,55,13:30,13:45,35.71,-8.93,0,35.71,-8.93,2,-56567,45204,101771,-11363,0,-17714,98,0,0,,17812,-17616
14,04-05-18,56,13:45,14:00,35.71,28.58,0,35.71,28.58,2,-63746,71752,135498,8006,0,-2740,214,0,0,,2954,-2526
14,04-05-18,57,14:00,14:15,39.86,32.07,0,39.86,32.07,2,-70121,51909,122030,-18212,0,-1085,1874,0,0,,2959,789
14,04-05-18,58,14:15,14:30,33.68,,0,33.68,33.68,1,-67862,71207,139069,3345,0,0,1110,0,0,,1110,1110
14,04-05-18,59,14:30,14:45,,28.75,0,28.75,28.75,-1,-40949,80563,121512,39614,0,-1630,0,0,0,,1630,-1630
14,04-05-18,60,14:45,15:00,,28.75,0,28.75,28.75,-1,-46132,78211,124343,32079,0,-9860,0,0,0,,9860,-9860
14,04-05-18,61,15:00,15:15,,32.08,0,32.08,32.08,-1,-38240,108996,147236,70756,0,-1514,0,0,0,,1514,-1514
14,04-05-18,62,15:15,15:30,,32.18,0,32.18,32.18,-1,-39804,115204,155008,75400,0,-1245,0,0,0,,1245,-1245
14,04-05-18,63,15:30,15:45,,27.71,0,27.71,27.71,-1,-44631,112608,157239,67977,0,-2203,0,0,0,,2203,-2203
14,04-05-18,64,15:45,16:00,,19.63,0,19.63,19.63,-1,-51180,92004,143184,40824,0,-18813,0,0,0,,18813,-18813
14,04-05-18,65,16:00,16:15,,31.71,0,31.71,31.71,-1,-86082,94866,180948,8784,0,-6544,0,0,0,,6544,-6544
14,04-05-18,66,16:15,16:30,,25.37,0,25.37,25.37,-1,-76321,91460,167781,15139,0,-16528,0,0,0,,16528,-16528
14,04-05-18,67,16:30,16:45,,,0,34.43,34.43,0,-78278,74583,152861,-3695,0,-843,0,0,0,,843,-843
14,04-05-18,68,16:45,17:00,,,0,34.61,34.61,0,-79419,81996,161415,2577,0,0,0,0,0,,0,0
14,04-05-18,69,17:00,17:15,,35.18,0,35.18,35.18,-1,-49699,145353,195052,95654,0,-145,0,0,0,,145,-145
14,04-05-18,70,17:15,17:30,,34.81,0,34.81,34.81,-1,-41522,100249,141771,58727,0,-690,0,0,0,,690,-690
14,04-05-18,71,17:30,17:45,39.71,22.34,0,39.71,22.34,2,-40568,59101,99669,18533,0,-7894,41,0,0,,7935,-7853
14,04-05-18,72,17:45,18:00,90.38,22.34,0,90.38,90.38,1,-88791,52568,141359,-36223,0,-699,19234,0,0,,19933,18535
14,04-05-18,73,18:00,18:15,34.31,29.09,0,34.37,29.09,2,-107298,72989,180287,-34309,0,-2518,3973,0,0,,6491,1455
14,04-05-18,74,18:15,18:30,,,0,34.37,34.37,0,-119636,64206,183842,-55430,0,0,0,0,0,,0,0
14,04-05-18,75,18:30,18:45,39.01,,0,39.01,39.01,1,-126169,45845,172014,-80324,0,0,59,0,0,,59,59
14,04-05-18,76,18:45,19:00,238.02,,0,238.02,238.02,1,-131276,61077,192353,-70199,0,0,35853,0,0,,35853,35853
14,04-05-18,77,19:00,19:15,39,33.35,0,39,33.35,2,-57253,60887,118140,3634,0,-191,9613,0,0,,9804,9422
14,04-05-18,78,19:15,19:30,,33.36,0,33.36,33.36,-1,-50826,54374,105200,3548,0,-847,0,0,0,,847,-847
14,04-05-18,79,19:30,19:45,43.71,33.36,0,43.71,43.71,1,-76413,40852,117265,-35561,0,-23,2284,0,0,,2307,2261
14,04-05-18,80,19:45,20:00,113.33,,0,113.33,113.33,1,-104662,40801,145463,-63861,0,0,28216,0,0,,28216,28216
14,04-05-18,81,20:00,20:15,39.71,-65.03,0,39.71,-65.03,2,-19818,139832,159650,120014,0,-10650,7090,0,0,,17740,-3560
14,04-05-18,82,20:15,20:30,,33.76,0,33.76,33.76,-1,-66841,86926,153767,20085,0,-1079,0,0,0,,1079,-1079
14,04-05-18,83,20:30,20:45,58.71,,0,58.71,58.71,1,-112735,49440,162175,-63295,0,0,3402,0,0,,3402,3402
14,04-05-18,84,20:45,21:00,35.29,,0,35.29,35.29,1,-112919,62955,175874,-49964,0,0,442,0,0,,442,442
14,04-05-18,85,21:00,21:15,43.13,,0,43.13,43.13,1,-91281,33650,124931,-57631,0,0,4222,0,0,,4222,4222
14,04-05-18,86,21:15,21:30,57.04,,0,57.04,57.04,1,-73717,46373,120090,-27344,0,0,25635,0,0,,25635,25635
14,04-05-18,87,21:30,21:45,38.02,,0,38.02,38.02,1,-57223,54910,112133,-2313,0,0,8888,0,0,,8888,8888
14,04-05-18,88,21:45,22:00,,31.71,0,31.71,31.71,-1,-55733,86749,142482,31016,0,-933,0,0,0,,933,-933
14,04-05-18,89,22:00,22:15,,28.65,0,28.65,28.65,-1,-87328,76853,164181,-10475,0,-1829,0,0,0,,1829,-1829
14,04-05-18,90,22:15,22:30,,31.71,0,31.71,31.71,-1,-55695,59144,114839,3449,0,-4858,0,0,0,,4858,-4858
14,04-05-18,91,22:30,22:45,,31.71,0,31.71,31.71,-1,-42438,53842,96280,11404,0,-2846,0,0,0,,2846,-2846
14,04-05-18,92,22:45,23:00,,25.42,0,25.42,25.42,-1,-65993,87879,153872,21886,0,-15762,0,0,0,,15762,-15762
14,04-05-18,93,23:00,23:15,,33.03,0,33.03,33.03,-1,-48644,54146,102790,5502,0,-6743,0,0,0,,6743,-6743
14,04-05-18,94,23:15,23:30,,27.71,0,27.71,27.71,-1,-29716,55049,84765,25333,0,-14489,0,0,0,,14489,-14489
14,04-05-18,95,23:30,23:45,,23.88,0,23.88,23.88,-1,-34950,47241,82191,12291,0,-20635,0,0,0,,20635,-20635
14,04-05-18,96,23:45,0:00,,31.71,0,31.71,31.71,-1,-69645,56195,125840,-13450,0,-2694,0,0,0,,2694,-2694
14,04-06-18,1,0:00,0:15,,30.69,0,30.69,30.69,-1,-49772,114338,164110,64566,0,-338,0,0,0,,338,-338
14,04-06-18,2,0:15,0:30,34.31,,0,34.31,34.31,1,-46204,35026,81230,-11178,0,0,411,0,0,,411,411
14,04-06-18,3,0:30,0:45,34.13,,0,34.13,34.13,1,-59552,26045,85597,-33507,0,0,919,0,0,,919,919
14,04-06-18,4,0:45,1:00,34.03,,0,34.03,34.03,1,-114918,36703,151621,-78215,0,0,492,0,0,,492,492
14,04-06-18,5,1:00,1:15,60.3,,0,60.3,60.3,1,-61844,51748,113592,-10096,0,0,6321,0,0,,6321,6321
14,04-06-18,6,1:15,1:30,58.98,,0,58.98,58.98,1,-51802,19109,70911,-32693,0,0,16564,0,0,,16564,16564
14,04-06-18,7,1:30,1:45,58.98,31.8,0,31.8,31.8,-1,-40767,34301,75068,-6466,0,-930,83,0,0,,1013,-847
14,04-06-18,8,1:45,2:00,,28.82,0,28.82,28.82,-1,-45944,46795,92739,851,0,-2651,0,0,0,,2651,-2651
14,04-06-18,9,2:00,2:15,,24.82,0,24.82,24.82,-1,-39103,50868,89971,11765,0,-7909,0,0,0,,7909,-7909
14,04-06-18,10,2:15,2:30,34.24,,0,34.24,34.24,1,-52382,29799,82181,-22583,0,0,904,0,0,,904,904
14,04-06-18,11,2:30,2:45,,,0,32.47,32.47,0,-49635,33512,83147,-16123,0,0,142,0,0,,142,142
14,04-06-18,12,2:45,3:00,,,0,32.56,32.56,0,-49459,36286,85745,-13173,0,0,0,0,0,,0,0
14,04-06-18,13,3:00,3:15,36.18,,0,36.18,36.18,1,-50570,35693,86263,-14877,0,0,3096,0,0,,3096,3096
14,04-06-18,14,3:15,3:30,34.18,,0,34.18,34.18,1,-41895,25456,67351,-16439,0,0,1358,0,0,,1358,1358
14,04-06-18,15,3:30,3:45,,,0,32.47,32.47,0,-29342,31809,61151,2467,0,0,0,0,0,,0,0
14,04-06-18,16,3:45,4:00,,,0,32.59,32.59,0,-22835,38973,61808,16138,0,0,0,0,0,,0,0
14,04-06-18,17,4:00,4:15,,,0,32.64,32.64,0,-36508,52629,89137,16121,0,0,0,0,0,,0,0
14,04-06-18,18,4:15,4:30,,32.82,0,32.82,32.82,-1,-27874,91245,119119,63371,0,-560,0,0,0,,560,-560
14,04-06-18,19,4:30,4:45,,,0,32.7,32.7,0,-29081,72765,101846,43684,0,0,0,0,0,,0,0
14,04-06-18,20,4:45,5:00,,,0,32.69,32.69,0,-35288,80121,115409,44833,0,0,0,0,0,,0,0
14,04-06-18,21,5:00,5:15,,28.82,0,28.82,28.82,-1,-66363,66082,132445,-281,0,-1957,0,0,0,,1957,-1957
14,04-06-18,22,5:15,5:30,,22.29,0,22.29,22.29,-1,-58464,78316,136780,19852,0,-21562,0,0,0,,21562,-21562
14,04-06-18,23,5:30,5:45,40.74,22.29,0,40.74,40.74,1,-72861,45689,118550,-27172,0,-1937,1914,0,0,,3851,-23
14,04-06-18,24,5:45,6:00,53.7,,0,53.7,53.7,1,-97391,55138,152529,-42253,0,0,8659,0,0,,8659,8659
14,04-06-18,25,6:00,6:15,36.24,35.28,0,35.28,35.28,-1,-87614,83545,171159,-4069,0,-261,3190,0,0,,3451,2929
14,04-06-18,26,6:15,6:30,,34.34,0,34.34,34.34,-1,-66859,67188,134047,329,0,-1558,0,0,0,,1558,-1558
14,04-06-18,27,6:30,6:45,54.12,,0,54.12,54.12,1,-93429,58872,152301,-34557,0,0,13941,0,0,,13941,13941
14,04-06-18,28,6:45,7:00,51.4,,0,51.4,51.4,1,-118430,68302,186732,-50128,0,0,28326,0,0,,28326,28326
14,04-06-18,29,7:00,7:15,51.4,-97.78,0,-97.78,-97.78,-1,-57920,168292,226212,110372,0,-20770,9501,0,0,,30271,-11269
14,04-06-18,30,7:15,7:30,,32.24,0,32.24,32.24,-1,-60396,68288,128684,7892,0,-8815,0,0,0,,8815,-8815
14,04-06-18,31,7:30,7:45,,35.09,0,35.09,35.09,-1,-94554,69264,163818,-25290,0,-931,0,0,0,,931,-931
14,04-06-18,32,7:45,8:00,,,0,34.13,34.13,0,-135666,68435,204101,-67231,0,0,0,0,0,,0,0
14,04-06-18,33,8:00,8:15,38.81,,0,38.81,38.81,1,-52023,58060,110083,6037,0,0,389,0,0,,389,389
14,04-06-18,34,8:15,8:30,36.24,,0,36.24,36.24,1,-44604,39922,84526,-4682,0,0,264,0,0,,264,264
14,04-06-18,35,8:30,8:45,40.5,,0,40.5,40.5,1,-65894,37438,103332,-28456,0,0,4935,0,0,,4935,4935
14,04-06-18,36,8:45,9:00,40.5,,0,40.5,40.5,1,-65866,49132,114998,-16734,0,0,972,0,0,,972,972
14,04-06-18,37,9:00,9:15,237.12,,0,237.12,237.12,1,-131933,35220,167153,-96713,0,0,35998,0,0,,35998,35998
14,04-06-18,38,9:15,9:30,44.12,,0,44.12,44.12,1,-96364,74802,171166,-21562,0,0,19725,0,0,,19725,19725
14,04-06-18,39,9:30,9:45,44.12,25.09,0,25.09,25.09,-1,-76046,95946,171992,19900,0,-2248,1532,0,0,,3780,-716
14,04-06-18,40,9:45,10:00,,-145.78,0,-145.78,-145.78,-1,-79251,133883,213134,54632,0,-39315,0,0,0,,39315,-39315
14,04-06-18,41,10:00,10:15,55.54,32.24,0,55.54,32.24,2,-86462,49461,135923,-37001,0,-7774,2189,0,0,,9963,-5585
14,04-06-18,42,10:15,10:30,36.24,32.24,0,32.24,32.24,-1,-60014,85620,145634,25606,0,-622,235,0,0,,857,-387
14,04-06-18,43,10:30,10:45,,-10.78,0,-10.78,-10.78,-1,-63074,121108,184182,58034,0,-9859,0,0,0,,9859,-9859
14,04-06-18,44,10:45,11:00,,6.2,0,6.2,6.2,-1,-97235,105651,202886,8416,0,-16247,0,0,0,,16247,-16247
14,04-06-18,45,11:00,11:15,44.6,6.2,0,44.6,44.6,1,-143054,67713,210767,-75341,0,-737,3228,0,0,,3965,2491
14,04-06-18,46,11:15,11:30,44.6,31.19,0,31.19,31.19,-1,-90979,114309,205288,23330,0,-612,303,0,0,,915,-309
14,04-06-18,47,11:30,11:45,,25.38,0,25.38,25.38,-1,-83242,166779,250021,83537,0,-2212,0,0,0,,2212,-2212
14,04-06-18,48,11:45,12:00,,-150.78,0,-150.78,-150.78,-1,-95385,167021,262406,71636,0,-35836,0,0,0,,35836,-35836
14,04-06-18,49,12:00,12:15,,31.78,0,31.78,31.78,-1,-106300,104704,211004,-1596,0,-9505,0,0,0,,9505,-9505
14,04-06-18,50,12:15,12:30,33.64,31.78,0,33.64,33.64,1,-133529,118661,252190,-14868,0,-53,275,0,0,,328,222
14,04-06-18,51,12:30,12:45,,28.24,0,28.24,28.24,-1,-110569,159587,270156,49018,0,-3461,0,0,0,,3461,-3461
14,04-06-18,52,12:45,13:00,,-150.78,0,-150.78,-150.78,-1,-115841,166729,282570,50888,0,-27147,0,0,0,,27147,-27147
14,04-06-18,53,13:00,13:15,,24.24,0,24.24,24.24,-1,-74732,161197,235929,86465,0,-18468,0,0,0,,18468,-18468
14,04-06-18,54,13:15,13:30,,9.24,0,9.24,9.24,-1,-75158,127900,203058,52742,0,-9482,0,0,0,,9482,-9482
14,04-06-18,55,13:30,13:45,,30.45,0,30.45,30.45,-1,-90561,142356,232917,51795,0,-12076,0,0,0,,12076,-12076
14,04-06-18,56,13:45,14:00,,-13.78,0,-13.78,-13.78,-1,-111022,158034,269056,47012,0,-19650,0,0,0,,19650,-19650
14,04-06-18,57,14:00,14:15,,31.08,0,31.08,31.08,-1,-67454,127035,194489,59581,0,-19287,0,0,0,,19287,-19287
14,04-06-18,58,14:15,14:30,,32.24,0,32.24,32.24,-1,-84194,171461,255655,87267,0,-967,0,0,0,,967,-967
14,04-06-18,59,14:30,14:45,,22.81,0,22.81,22.81,-1,-73574,197798,271372,124224,0,-7751,0,0,0,,7751,-7751
14,04-06-18,60,14:45,15:00,,-150.78,0,-150.78,-150.78,-1,-90900,199121,290021,108221,0,-44525,0,0,0,,44525,-44525
14,04-06-18,61,15:00,15:15,,14.7,0,14.7,14.7,-1,-84224,180244,264468,96020,0,-35416,0,0,0,,35416,-35416
14,04-06-18,62,15:15,15:30,,23.24,0,23.24,23.24,-1,-97830,178411,276241,80581,0,-7543,0,0,0,,7543,-7543
14,04-06-18,63,15:30,15:45,,9.24,0,9.24,9.24,-1,-97408,169533,266941,72125,0,-14010,0,0,0,,14010,-14010
14,04-06-18,64,15:45,16:00,,,0,35.22,35.22,0,-96954,161825,258779,64871,0,-64,0,0,0,,64,-64
14,04-06-18,65,16:00,16:15,,,0,35.36,35.36,0,-105483,170369,275852,64886,0,0,0,0,0,,0,0
14,04-06-18,66,16:15,16:30,,24.24,0,24.24,24.24,-1,-75215,163012,238227,87797,0,-5320,0,0,0,,5320,-5320
14,04-06-18,67,16:30,16:45,,32.24,0,32.24,32.24,-1,-73534,135023,208557,61489,0,-5556,0,0,0,,5556,-5556
14,04-06-18,68,16:45,17:00,,,0,35.31,35.31,0,-74072,99022,173094,24950,0,-729,0,0,0,,729,-729
14,04-06-18,69,17:00,17:15,,,0,32.85,32.85,0,-109354,117065,226419,7711,0,0,0,0,0,,0,0
14,04-06-18,70,17:15,17:30,,,0,32.74,32.74,0,-85525,74375,159900,-11150,0,0,0,0,0,,0,0
14,04-06-18,71,17:30,17:45,40.24,,0,40.24,40.24,1,-92554,55960,148514,-36594,0,0,1519,0,0,,1519,1519
14,04-06-18,72,17:45,18:00,51.12,,0,51.12,51.12,1,-98803,66054,164857,-32749,0,0,18560,0,0,,18560,18560
14,04-06-18,73,18:00,18:15,43.76,,0,43.76,43.76,1,-114049,58875,172924,-55174,0,0,17108,0,0,,17108,17108
14,04-06-18,74,18:15,18:30,43.76,32.24,0,32.24,32.24,-1,-73959,70886,144845,-3073,0,-39,173,0,0,,212,134
14,04-06-18,75,18:30,18:45,,,0,33.89,33.89,0,-61326,69831,131157,8505,0,0,0,0,0,,0,0
14,04-06-18,76,18:45,19:00,,,0,33.92,33.92,0,-68246,74045,142291,5799,0,0,0,0,0,,0,0
14,04-06-18,77,19:00,19:15,,28.24,0,28.24,28.24,-1,-48024,84826,132850,36802,0,-3499,0,0,0,,3499,-3499
14,04-06-18,78,19:15,19:30,,,0,34.11,34.11,0,-52706,75570,128276,22864,0,-31,0,0,0,,31,-31
14,04-06-18,79,19:30,19:45,,31.78,0,31.78,31.78,-1,-51330,88295,139625,36965,0,-5139,0,0,0,,5139,-5139
14,04-06-18,80,19:45,20:00,,31.78,0,31.78,31.78,-1,-49191,91659,140850,42468,0,-13185,0,0,0,,13185,-13185
14,04-06-18,81,20:00,20:15,,31.78,0,31.78,31.78,-1,-42703,122419,165122,79716,0,-17014,0,0,0,,17014,-17014
14,04-06-18,82,20:15,20:30,,25.6,0,25.6,25.6,-1,-50083,105635,155718,55552,0,-19203,0,0,0,,19203,-19203
14,04-06-18,83,20:30,20:45,,24.24,0,24.24,24.24,-1,-74203,77708,151911,3505,0,-23179,0,0,0,,23179,-23179
14,04-06-18,84,20:45,21:00,36.24,24.24,0,36.24,36.24,1,-79376,70112,149488,-9264,0,-875,1240,0,0,,2115,365
14,04-06-18,85,21:00,21:15,64.12,,0,64.12,64.12,1,-130830,93083,223913,-37747,0,0,17941,0,0,,17941,17941
14,04-06-18,86,21:15,21:30,40.5,34,0,34,34,-1,-88240,92868,181108,4628,0,-101,11808,0,0,,11909,11707
14,04-06-18,87,21:30,21:45,40.5,9.24,0,9.24,9.24,-1,-52127,112609,164736,60482,0,-17510,223,0,0,,17733,-17287
14,04-06-18,88,21:45,22:00,,-22.44,0,-22.44,-22.44,-1,-47053,120414,167467,73361,0,-35274,0,0,0,,35274,-35274
14,04-06-18,89,22:00,22:15,41.25,32.78,0,41.25,32.78,2,-85211,63822,149033,-21389,0,-11698,778,0,0,,12476,-10920
14,04-06-18,90,22:15,22:30,,33.78,0,33.78,33.78,-1,-49974,61062,111036,11088,0,-444,0,0,0,,444,-444
14,04-06-18,91,22:30,22:45,,32.78,0,32.78,32.78,-1,-37474,71310,108784,33836,0,-2000,0,0,0,,2000,-2000
14,04-06-18,92,22:45,23:00,,32.24,0,32.24,32.24,-1,-33256,114164,147420,80908,0,-1258,0,0,0,,1258,-1258
14,04-06-18,93,23:00,23:15,64.12,32.24,0,64.12,32.24,2,-71694,27679,99373,-44015,0,-1007,9039,0,0,,10046,8032
14,04-06-18,94,23:15,23:30,39.03,32.24,0,32.24,32.24,-1,-52787,46685,99472,-6102,0,-102,8324,0,0,,8426,8222
14,04-06-18,95,23:30,23:45,39.03,32.78,0,32.78,32.78,-1,-55500,55373,110873,-127,0,-869,65,0,0,,934,-804
14,04-06-18,96,23:45,0:00,,32.24,0,32.24,32.24,-1,-71708,68188,139896,-3520,0,-3595,0,0,0,,3595,-3595
15,04-07-18,1,0:00,0:15,40.24,25.79,0,40.24,40.24,1,-43810,62339,106149,18529,0,-1788,926,0,0,,2714,-862
15,04-07-18,2,0:15,0:30,33.02,,0,33.02,33.02,1,-32409,33957,66366,1548,0,0,504,0,0,,504,504
15,04-07-18,3,0:30,0:45,40.24,,0,40.24,40.24,1,-56280,36565,92845,-19715,0,0,2679,0,0,,2679,2679
15,04-07-18,4,0:45,1:00,43.97,,0,43.97,43.97,1,-90353,44155,134508,-46198,0,0,21568,0,0,,21568,21568
15,04-07-18,5,1:00,1:15,56.6,,0,56.6,56.6,1,-75247,21984,97231,-53263,0,0,35392,0,0,,35392,35392
15,04-07-18,6,1:15,1:30,44.24,,0,44.24,44.24,1,-58898,18485,77383,-40413,0,0,41135,0,0,,41135,41135
15,04-07-18,7,1:30,1:45,37.57,,0,37.57,37.57,1,-44463,25555,70018,-18908,0,0,20525,0,0,,20525,20525
15,04-07-18,8,1:45,2:00,33.76,,0,33.76,33.76,1,-43838,24847,68685,-18991,0,0,3493,0,0,,3493,3493
15,04-07-18,9,2:00,2:15,36.24,,0,36.24,36.24,1,-30151,26971,57122,-3180,0,0,1090,0,0,,1090,1090
15,04-07-18,10,2:15,2:30,36.24,,0,36.24,36.24,1,-37986,26913,64899,-11073,0,0,1518,0,0,,1518,1518
15,04-07-18,11,2:30,2:45,33.92,,0,33.92,33.92,1,-32168,26053,58221,-6115,0,0,876,0,0,,876,876
15,04-07-18,12,2:45,3:00,33.92,30.4,0,30.4,30.4,-1,-27926,31706,59632,3780,0,-4221,14,0,0,,4235,-4207
15,04-07-18,13,3:00,3:15,36.24,30.06,0,36.24,30.06,2,-43714,33427,77141,-10287,0,-7165,480,0,0,,7645,-6685
15,04-07-18,14,3:15,3:30,46.16,30.06,0,46.16,46.16,1,-51728,17061,68789,-34667,0,-148,13010,0,0,,13158,12862
15,04-07-18,15,3:30,3:45,38.95,,0,38.95,38.95,1,-46753,17050,63803,-29703,0,0,15929,0,0,,15929,15929
15,04-07-18,16,3:45,4:00,36.24,,0,36.24,36.24,1,-45908,20158,66066,-25750,0,0,8370,0,0,,8370,8370
15,04-07-18,17,4:00,4:15,36.24,,0,36.24,36.24,1,-42238,29164,71402,-13074,0,0,4024,0,0,,4024,4024
15,04-07-18,18,4:15,4:30,38.59,,0,38.59,38.59,1,-44854,20437,65291,-24417,0,0,4597,0,0,,4597,4597
15,04-07-18,19,4:30,4:45,59.77,,0,59.77,59.77,1,-60135,14896,75031,-45239,0,0,20778,0,0,,20778,20778
15,04-07-18,20,4:45,5:00,41.02,,0,41.02,41.02,1,-46747,19214,65961,-27533,0,0,27770,0,0,,27770,27770
15,04-07-18,21,5:00,5:15,40.24,,0,40.24,40.24,1,-57372,28858,86230,-28514,0,0,16168,0,0,,16168,16168
15,04-07-18,22,5:15,5:30,51.02,,0,51.02,51.02,1,-73898,26424,100322,-47474,0,0,29504,0,0,,29504,29504
15,04-07-18,23,5:30,5:45,42.52,,0,42.52,42.52,1,-64418,25969,90387,-38449,0,0,30071,0,0,,30071,30071
15,04-07-18,24,5:45,6:00,42.53,34.61,0,34.61,34.61,-1,-57618,48053,105671,-9565,0,-8,26674,0,0,,26682,26666
15,04-07-18,25,6:00,6:15,42.53,21.27,0,21.27,21.27,-1,-31176,44682,75858,13506,0,-5514,3786,0,0,,9300,-1728
15,04-07-18,26,6:15,6:30,,35.15,0,35.15,35.15,-1,-34482,31108,65590,-3374,0,-369,0,0,0,,369,-369
15,04-07-18,27,6:30,6:45,40.36,,0,40.36,40.36,1,-45375,26584,71959,-18791,0,0,6079,0,0,,6079,6079
15,04-07-18,28,6:45,7:00,41.02,,0,41.02,41.02,1,-48544,28682,77226,-19862,0,0,19673,0,0,,19673,19673
15,04-07-18,29,7:00,7:15,34.32,32.36,0,34.32,32.36,2,-46361,54994,101355,8633,0,-226,7507,0,0,,7733,7281
15,04-07-18,30,7:15,7:30,36.39,,0,36.39,36.39,1,-38519,33386,71905,-5133,0,0,422,0,0,,422,422
15,04-07-18,31,7:30,7:45,59.39,,0,59.39,59.39,1,-61455,34534,95989,-26921,0,0,9836,0,0,,9836,9836
15,04-07-18,32,7:45,8:00,62.98,,0,62.98,62.98,1,-63658,63171,126829,-487,0,0,27091,0,0,,27091,27091
15,04-07-18,33,8:00,8:15,65.17,,0,65.17,65.17,1,-102879,52761,155640,-50118,0,0,15659,0,0,,15659,15659
15,04-07-18,34,8:15,8:30,107.02,,0,107.02,107.02,1,-117571,40751,158322,-76820,0,0,59503,0,0,,59503,59503
15,04-07-18,35,8:30,8:45,111.36,,0,111.36,111.36,1,-110362,48108,158470,-62254,0,0,68429,0,0,,68429,68429
15,04-07-18,36,8:45,9:00,85.99,,0,85.99,85.99,1,-129118,53769,182887,-75349,0,0,63449,0,0,,63449,63449
15,04-07-18,37,9:00,9:15,110.23,,0,110.23,110.23,1,-121585,46645,168230,-74940,0,0,71676,0,0,,71676,71676
15,04-07-18,38,9:15,9:30,71.64,,0,71.64,71.64,1,-110009,55928,165937,-54081,0,0,62138,0,0,,62138,62138
15,04-07-18,39,9:30,9:45,48.04,,0,48.04,48.04,1,-106286,64340,170626,-41946,0,0,42872,0,0,,42872,42872
15,04-07-18,40,9:45,10:00,44.02,,0,44.02,44.02,1,-104344,78297,182641,-26047,0,0,30838,0,0,,30838,30838
15,04-07-18,41,10:00,10:15,58.36,,0,58.36,58.36,1,-86851,53699,140550,-33152,0,0,20876,0,0,,20876,20876
15,04-07-18,42,10:15,10:30,40.39,34.78,0,34.78,34.78,-1,-78946,78829,157775,-117,0,-29,12697,0,0,,12726,12668
15,04-07-18,43,10:30,10:45,40.39,34.78,0,34.78,34.78,-1,-81475,77775,159250,-3700,0,-709,73,0,0,,782,-636
15,04-07-18,44,10:45,11:00,40.39,,0,40.39,40.39,1,-90487,73270,163757,-17217,0,0,6524,0,0,,6524,6524
15,04-07-18,45,11:00,11:15,,,0,33.9,33.9,0,-49511,103381,152892,53870,0,0,1650,0,0,,1650,1650
15,04-07-18,46,11:15,11:30,,,0,33.9,33.9,0,-60735,87844,148579,27109,0,0,0,0,0,,0,0
15,04-07-18,47,11:30,11:45,,,0,33.9,33.9,0,-70067,92464,162531,22397,0,0,0,0,0,,0,0
15,04-07-18,48,11:45,12:00,,32.39,0,32.39,32.39,-1,-69605,100013,169618,30408,0,-763,0,0,0,,763,-763
15,04-07-18,49,12:00,12:15,,28.39,0,28.39,28.39,-1,-68591,111333,179924,42742,0,-1030,0,0,0,,1030,-1030
15,04-07-18,50,12:15,12:30,,28.39,0,28.39,28.39,-1,-72034,88601,160635,16567,0,-1479,0,0,0,,1479,-1479
15,04-07-18,51,12:30,12:45,,34.68,0,34.68,34.68,-1,-80571,110216,190787,29645,0,-497,0,0,0,,497,-497
15,04-07-18,52,12:45,13:00,,34.79,0,34.79,34.79,-1,-88179,103377,191556,15198,0,-227,0,0,0,,227,-227
15,04-07-18,53,13:00,13:15,222.02,,0,222.02,222.02,1,-153333,54594,207927,-98739,0,0,32462,0,0,,32462,32462
15,04-07-18,54,13:15,13:30,69.02,,0,69.02,69.02,1,-112336,91467,203803,-20869,0,0,41206,0,0,,41206,41206
15,04-07-18,55,13:30,13:45,34.43,,0,34.43,34.43,1,-105790,103711,209501,-2079,0,0,3834,0,0,,3834,3834
15,04-07-18,56,13:45,14:00,38.62,32.39,0,38.62,32.39,2,-105335,90166,195501,-15169,0,-68,2379,0,0,,2447,2311
15,04-07-18,57,14:00,14:15,38.62,-150.03,0,-150.03,-150.03,-1,-75665,163291,238956,87626,0,-31265,47,0,0,,31312,-31218
15,04-07-18,58,14:15,14:30,,32.36,0,32.36,32.36,-1,-95894,109271,205165,13377,0,-4385,0,0,0,,4385,-4385
15,04-07-18,59,14:30,14:45,,28.36,0,28.36,28.36,-1,-74360,119128,193488,44768,0,-2554,0,0,0,,2554,-2554
15,04-07-18,60,14:45,15:00,,9.98,0,9.98,9.98,-1,-81018,127808,208826,46790,0,-13808,0,0,0,,13808,-13808
15,04-07-18,61,15:00,15:15,,9.36,0,9.36,9.36,-1,-57244,143430,200674,86186,0,-14239,0,0,0,,14239,-14239
15,04-07-18,62,15:15,15:30,,,0,33.83,33.83,0,-71805,105705,177510,33900,0,-247,0,0,0,,247,-247
15,04-07-18,63,15:30,15:45,,,0,33.83,33.83,0,-74628,113545,188173,38917,0,0,0,0,0,,0,0
15,04-07-18,64,15:45,16:00,,,0,33.83,33.83,0,-77000,98766,175766,21766,0,0,0,0,0,,0,0
15,04-07-18,65,16:00,16:15,,,0,33.92,33.92,0,-40593,146999,187592,106406,0,0,0,0,0,,0,0
15,04-07-18,66,16:15,16:30,,,0,33.84,33.84,0,-47263,127656,174919,80393,0,0,0,0,0,,0,0
15,04-07-18,67,16:30,16:45,,,0,33.81,33.81,0,-58814,121285,180099,62471,0,0,0,0,0,,0,0
15,04-07-18,68,16:45,17:00,,,0,33.81,33.81,0,-70724,112702,183426,41978,0,0,0,0,0,,0,0
15,04-07-18,69,17:00,17:15,,28.36,0,28.36,28.36,-1,-30369,161340,191709,130971,0,-4072,0,0,0,,4072,-4072
15,04-07-18,70,17:15,17:30,,33.84,0,33.84,33.84,-1,-49341,142145,191486,92804,0,-1428,0,0,0,,1428,-1428
15,04-07-18,71,17:30,17:45,,,0,33.91,33.91,0,-69990,110457,180447,40467,0,0,0,0,0,,0,0
15,04-07-18,72,17:45,18:00,38.08,,0,38.08,38.08,1,-92487,80608,173095,-11879,0,0,1565,0,0,,1565,1565
15,04-07-18,73,18:00,18:15,34.27,15.85,0,34.29,15.85,2,-39651,82824,122475,43173,0,-11566,242,0,0,,11808,-11324
15,04-07-18,74,18:15,18:30,34.29,32.39,0,34.29,34.29,1,-58762,48473,107235,-10289,0,-5191,8,0,0,,5199,-5183
15,04-07-18,75,18:30,18:45,42.38,,0,42.38,42.38,1,-79740,49651,129391,-30089,0,0,2573,0,0,,2573,2573
15,04-07-18,76,18:45,19:00,83.56,,0,83.56,83.56,1,-85206,37590,122796,-47616,0,0,32138,0,0,,32138,32138
15,04-07-18,77,19:00,19:15,39.21,,0,39.21,39.21,1,-74977,51736,126713,-23241,0,0,13020,0,0,,13020,13020
15,04-07-18,78,19:15,19:30,37.2,,0,37.2,37.2,1,-82354,45157,127511,-37197,0,0,378,0,0,,378,378
15,04-07-18,79,19:30,19:45,44.39,,0,44.39,44.39,1,-88736,39535,128271,-49201,0,0,5665,0,0,,5665,5665
15,04-07-18,80,19:45,20:00,48.72,,0,48.72,48.72,1,-89630,38266,127896,-51364,0,0,19835,0,0,,19835,19835
15,04-07-18,81,20:00,20:15,40.39,,0,40.39,40.39,1,-75027,55163,130190,-19864,0,0,22182,0,0,,22182,22182
15,04-07-18,82,20:15,20:30,166.02,,0,166.02,166.02,1,-101869,39153,141022,-62716,0,0,24476,0,0,,24476,24476
15,04-07-18,83,20:30,20:45,256.02,,0,256.02,256.02,1,-117703,29745,147448,-87958,0,0,79668,0,0,,79668,79668
15,04-07-18,84,20:45,21:00,92.02,,0,92.02,92.02,1,-93018,62197,155215,-30821,0,0,48642,0,0,,48642,48642
15,04-07-18,85,21:00,21:15,45.98,,0,45.98,45.98,1,-83323,54673,137996,-28650,0,0,22236,0,0,,22236,22236
15,04-07-18,86,21:15,21:30,55.98,,0,55.98,55.98,1,-72579,38157,110736,-34422,0,0,29041,0,0,,29041,29041
15,04-07-18,87,21:30,21:45,38.84,,0,38.84,38.84,1,-48423,31834,80257,-16589,0,0,7674,0,0,,7674,7674
15,04-07-18,88,21:45,22:00,38.84,33.63,0,33.63,33.63,-1,-51516,33991,85507,-17525,0,-60,152,0,0,,212,92
15,04-07-18,89,22:00,22:15,,32.03,0,32.03,32.03,-1,-45531,74151,119682,28620,0,-998,0,0,0,,998,-998
15,04-07-18,90,22:15,22:30,,32.39,0,32.39,32.39,-1,-48115,57921,106036,9806,0,-2118,0,0,0,,2118,-2118
15,04-07-18,91,22:30,22:45,,32.39,0,32.39,32.39,-1,-34100,63122,97222,29022,0,-739,0,0,0,,739,-739
15,04-07-18,92,22:45,23:00,,,0,34.42,34.42,0,-24734,76524,101258,51790,0,0,0,0,0,,0,0
15,04-07-18,93,23:00,23:15,51.09,,0,51.09,51.09,1,-80329,29892,110221,-50437,0,0,6290,0,0,,6290,6290
15,04-07-18,94,23:15,23:30,36.39,,0,36.39,36.39,1,-60709,33143,93852,-27566,0,0,4724,0,0,,4724,4724
15,04-07-18,95,23:30,23:45,36.39,,0,36.39,36.39,1,-49084,34914,83998,-14170,0,0,1836,0,0,,1836,1836
15,04-07-18,96,23:45,0:00,36.39,32.32,0,32.32,32.32,-1,-36980,49270,86250,12290,0,-1025,224,0,0,,1249,-801
15,04-08-18,1,0:00,0:15,86.12,32.32,0,86.12,86.12,1,-90701,38768,129469,-51933,0,-83,14011,0,0,,14094,13928
15,04-08-18,2,0:15,0:30,43.14,,0,43.14,43.14,1,-67002,44437,111439,-22565,0,0,17301,0,0,,17301,17301
15,04-08-18,3,0:30,0:45,,,0,36.45,36.45,0,-55201,40555,95756,-14646,0,0,2712,0,0,,2712,2712
15,04-08-18,4,0:45,1:00,,35.21,0,35.21,35.21,-1,-73631,25166,98797,-48465,0,-31,0,0,0,,31,-31
15,04-08-18,5,1:00,1:15,36.72,9.36,0,36.72,9.36,2,-54234,99368,153602,45134,0,-11715,57,0,0,,11772,-11658
15,04-08-18,6,1:15,1:30,58.61,9.36,0,58.61,58.61,1,-49458,30516,79974,-18942,0,-267,10091,0,0,,10358,9824
15,04-08-18,7,1:30,1:45,58.61,32.36,0,32.36,32.36,-1,-34536,51702,86238,17166,0,-5478,142,0,0,,5620,-5336
15,04-08-18,8,1:45,2:00,,32.36,0,32.36,32.36,-1,-34511,38969,73480,4458,0,-12860,0,0,0,,12860,-12860
15,04-08-18,9,2:00,2:15,36.36,34.76,0,36.36,34.76,2,-39531,54176,93707,14645,0,-8334,276,0,0,,8610,-8058
15,04-08-18,10,2:15,2:30,40.36,34.93,0,40.36,34.93,2,-31057,28321,59378,-2736,0,-183,2878,0,0,,3061,2695
15,04-08-18,11,2:30,2:45,,32.36,0,32.36,32.36,-1,-28448,37528,65976,9080,0,-1030,0,0,0,,1030,-1030
15,04-08-18,12,2:45,3:00,,31.04,0,31.04,31.04,-1,-33254,35974,69228,2720,0,-9968,0,0,0,,9968,-9968
15,04-08-18,13,3:00,3:15,,-6.32,0,-6.32,-6.32,-1,-12665,99817,112482,87152,0,-18569,0,0,0,,18569,-18569
15,04-08-18,14,3:15,3:30,,15.32,0,15.32,15.32,-1,-8307,63344,71651,55037,0,-9289,0,0,0,,9289,-9289
15,04-08-18,15,3:30,3:45,,15.52,0,15.52,15.52,-1,-11727,66930,78657,55203,0,-34352,0,0,0,,34352,-34352
15,04-08-18,16,3:45,4:00,,22.89,0,22.89,22.89,-1,-14152,82210,96362,68058,0,-39735,0,0,0,,39735,-39735
15,04-08-18,17,4:00,4:15,,28.36,0,28.36,28.36,-1,-17865,66419,84284,48554,0,-19756,0,0,0,,19756,-19756
15,04-08-18,18,4:15,4:30,,,0,34.95,34.95,0,-17903,57148,75051,39245,0,0,0,0,0,,0,0
15,04-08-18,19,4:30,4:45,,,0,34.95,34.95,0,-18553,66919,85472,48366,0,0,0,0,0,,0,0
15,04-08-18,20,4:45,5:00,,,0,34.95,34.95,0,-20429,77775,98204,57346,0,0,0,0,0,,0,0
15,04-08-18,21,5:00,5:15,,,0,34.95,34.95,0,-29250,90731,119981,61481,0,0,0,0,0,,0,0
15,04-08-18,22,5:15,5:30,,,0,34.95,34.95,0,-23961,75126,99087,51165,0,0,0,0,0,,0,0
15,04-08-18,23,5:30,5:45,,,0,34.95,34.95,0,-28371,66536,94907,38165,0,0,0,0,0,,0,0
15,04-08-18,24,5:45,6:00,,,0,34.95,34.95,0,-28445,80849,109294,52404,0,0,0,0,0,,0,0
15,04-08-18,25,6:00,6:15,,,0,34.95,34.95,0,-16389,99453,115842,83064,0,0,0,0,0,,0,0
15,04-08-18,26,6:15,6:30,,,0,34.95,34.95,0,-19790,90583,110373,70793,0,0,0,0,0,,0,0
15,04-08-18,27,6:30,6:45,,,0,34.95,34.95,0,-16552,78232,94784,61680,0,0,0,0,0,,0,0
15,04-08-18,28,6:45,7:00,,23.19,0,23.19,23.19,-1,-17104,91873,108977,74769,0,-3982,0,0,0,,3982,-3982
15,04-08-18,29,7:00,7:15,,-150.78,0,-150.78,-150.78,-1,-27579,122460,150039,94881,0,-45666,0,0,0,,45666,-45666
15,04-08-18,30,7:15,7:30,,6.78,0,6.78,6.78,-1,-32610,92065,124675,59455,0,-62427,0,0,0,,62427,-62427
15,04-08-18,31,7:30,7:45,,22.5,0,22.5,22.5,-1,-36237,81492,117729,45255,0,-43258,0,0,0,,43258,-43258
15,04-08-18,32,7:45,8:00,,,0,34.95,34.95,0,-39277,70346,109623,31069,0,-6369,0,0,0,,6369,-6369
15,04-08-18,33,8:00,8:15,,32.98,0,32.98,32.98,-1,-28507,69641,98148,41134,0,-1298,0,0,0,,1298,-1298
15,04-08-18,34,8:15,8:30,,35.11,0,35.11,35.11,-1,-26156,55454,81610,29298,0,-1755,0,0,0,,1755,-1755
15,04-08-18,35,8:30,8:45,,,0,34.95,34.95,0,-35339,50759,86098,15420,0,-158,0,0,0,,158,-158
15,04-08-18,36,8:45,9:00,,,0,34.95,34.95,0,-32900,55146,88046,22246,0,0,0,0,0,,0,0
15,04-08-18,37,9:00,9:15,,,0,34.95,34.95,0,-68750,67563,136313,-1187,0,0,0,0,0,,0,0
15,04-08-18,38,9:15,9:30,,34.78,0,34.78,34.78,-1,-41243,65098,106341,23855,0,-3079,0,0,0,,3079,-3079
15,04-08-18,39,9:30,9:45,,28.31,0,28.31,28.31,-1,-47055,76114,123169,29059,0,-4920,0,0,0,,4920,-4920
15,04-08-18,40,9:45,10:00,206.12,27.32,0,206.12,27.32,2,-137371,90072,227443,-47299,0,-9485,7563,0,0,,17048,-1922
15,04-08-18,41,10:00,10:15,222.12,27.32,0,222.12,222.12,1,-147697,86949,234646,-60748,0,-134,57421,0,0,,57555,57287
15,04-08-18,42,10:15,10:30,44.31,,0,44.31,44.31,1,-123344,97224,220568,-26120,0,0,31686,0,0,,31686,31686
15,04-08-18,43,10:30,10:45,37.03,,0,37.03,37.03,1,-116245,116713,232958,468,0,0,11479,0,0,,11479,11479
15,04-08-18,44,10:45,11:00,,,0,34.45,34.45,0,-120696,135179,255875,14483,0,0,133,0,0,,133,133
15,04-08-18,45,11:00,11:15,,27.32,0,27.32,27.32,-1,-83569,118366,201935,34797,0,-2284,0,0,0,,2284,-2284
15,04-08-18,46,11:15,11:30,,17.16,0,17.16,17.16,-1,-90658,107433,198091,16775,0,-14749,0,0,0,,14749,-14749
15,04-08-18,47,11:30,11:45,,34.78,0,34.78,34.78,-1,-91708,95345,187053,3637,0,-2053,0,0,0,,2053,-2053
15,04-08-18,48,11:45,12:00,,32.31,0,32.31,32.31,-1,-88854,93734,182588,4880,0,-2420,0,0,0,,2420,-2420
15,04-08-18,49,12:00,12:15,,,0,34.45,34.45,0,-67420,77927,145347,10507,0,-180,0,0,0,,180,-180
15,04-08-18,50,12:15,12:30,,30.95,0,30.95,30.95,-1,-54292,87756,142048,33464,0,-5824,0,0,0,,5824,-5824
15,04-08-18,51,12:30,12:45,,28.31,0,28.31,28.31,-1,-49746,80022,129768,30276,0,-15715,0,0,0,,15715,-15715
15,04-08-18,52,12:45,13:00,,24.31,0,24.31,24.31,-1,-46491,76131,122622,29640,0,-32169,0,0,0,,32169,-32169
15,04-08-18,53,13:00,13:15,36.67,33.78,0,36.67,36.67,1,-69192,69692,138884,500,0,-13708,512,0,0,,14220,-13196
15,04-08-18,54,13:15,13:30,36.31,32.31,0,36.31,32.31,2,-75362,79362,154724,4000,0,-706,479,0,0,,1185,-227
15,04-08-18,55,13:30,13:45,,32.31,0,32.31,32.31,-1,-61969,93450,155419,31481,0,-2758,0,0,0,,2758,-2758
15,04-08-18,56,13:45,14:00,,24.31,0,24.31,24.31,-1,-55218,108533,163751,53315,0,-11141,0,0,0,,11141,-11141
15,04-08-18,57,14:00,14:15,,6.52,0,6.52,6.52,-1,-52316,110815,163131,58499,0,-37445,0,0,0,,37445,-37445
15,04-08-18,58,14:15,14:30,,6.52,0,6.52,6.52,-1,-59117,121807,180924,62690,0,-29036,0,0,0,,29036,-29036
15,04-08-18,59,14:30,14:45,,4.78,0,4.78,4.78,-1,-44793,114965,159758,70172,0,-37483,0,0,0,,37483,-37483
15,04-08-18,60,14:45,15:00,,6.52,0,6.52,6.52,-1,-46060,117903,163963,71843,0,-25224,0,0,0,,25224,-25224
15,04-08-18,61,15:00,15:15,,28.31,0,28.31,28.31,-1,-45640,128521,174161,82881,0,-17173,0,0,0,,17173,-17173
15,04-08-18,62,15:15,15:30,,-77.78,0,-77.78,-77.78,-1,-51492,126296,177788,74804,0,-34315,0,0,0,,34315,-34315
15,04-08-18,63,15:30,15:45,,28.31,0,28.31,28.31,-1,-62804,124201,187005,61397,0,-19400,0,0,0,,19400,-19400
15,04-08-18,64,15:45,16:00,,19.46,0,19.46,19.46,-1,-64623,136224,200847,71601,0,-18968,0,0,0,,18968,-18968
15,04-08-18,65,16:00,16:15,,21.52,0,21.52,21.52,-1,-53672,133346,187018,79674,0,-23538,0,0,0,,23538,-23538
15,04-08-18,66,16:15,16:30,,13.91,0,13.91,13.91,-1,-58663,112011,170674,53348,0,-35530,0,0,0,,35530,-35530
15,04-08-18,67,16:30,16:45,36.44,30.02,0,36.44,36.44,1,-75273,84843,160116,9570,0,-16254,119,0,0,,16373,-16135
15,04-08-18,68,16:45,17:00,,,0,34.45,34.45,0,-96489,87454,183943,-9035,0,0,5,0,0,,5,5
15,04-08-18,69,17:00,17:15,,24.31,0,24.31,24.31,-1,-66325,103339,169664,37014,0,-4614,0,0,0,,4614,-4614
15,04-08-18,70,17:15,17:30,35.72,15.49,0,35.72,15.49,2,-73698,82394,156092,8696,0,-21305,40,0,0,,21345,-21265
15,04-08-18,71,17:30,17:45,54.84,15.49,0,54.84,54.84,1,-92511,64287,156798,-28224,0,-1186,12446,0,0,,13632,11260
15,04-08-18,72,17:45,18:00,38.62,,0,38.62,38.62,1,-55031,79859,134890,24828,0,0,9580,0,0,,9580,9580
15,04-08-18,73,18:00,18:15,38.62,36.78,0,36.78,36.78,-1,-81054,71969,153023,-9085,0,-124,167,0,0,,291,43
15,04-08-18,74,18:15,18:30,,32.31,0,32.31,32.31,-1,-58728,79980,138708,21252,0,-932,0,0,0,,932,-932
15,04-08-18,75,18:30,18:45,,36.78,0,36.78,36.78,-1,-46288,85831,132119,39543,0,-394,0,0,0,,394,-394
15,04-08-18,76,18:45,19:00,,,0,34.95,34.95,0,-56646,106921,163567,50275,0,0,0,0,0,,0,0
15,04-08-18,77,19:00,19:15,238.12,,0,238.12,238.12,1,-159064,62448,221512,-96616,0,0,25033,0,0,,25033,25033
15,04-08-18,78,19:15,19:30,40.37,,0,40.37,40.37,1,-83872,63221,147093,-20651,0,0,17135,0,0,,17135,17135
15,04-08-18,79,19:30,19:45,,,0,36.45,36.45,0,-63779,63125,126904,-654,0,0,2455,0,0,,2455,2455
15,04-08-18,80,19:45,20:00,,,0,36.45,36.45,0,-74614,59672,134286,-14942,0,0,0,0,0,,0,0
15,04-08-18,81,20:00,20:15,,13.55,0,13.55,13.55,-1,-33236,94882,128118,61646,0,-14653,0,0,0,,14653,-14653
15,04-08-18,82,20:15,20:30,36.37,34.82,0,36.45,34.82,2,-69095,64308,133403,-4787,0,-5581,25,0,0,,5606,-5556
15,04-08-18,83,20:30,20:45,39.49,,0,39.49,39.49,1,-92517,54249,146766,-38268,0,0,4766,0,0,,4766,4766
15,04-08-18,84,20:45,21:00,40.37,,0,40.37,40.37,1,-135014,52101,187115,-82913,0,0,7542,0,0,,7542,7542
15,04-08-18,85,21:00,21:15,77.07,,0,77.07,77.07,1,-88317,41410,129727,-46907,0,0,21844,0,0,,21844,21844
15,04-08-18,86,21:15,21:30,44.37,37.68,0,44.37,36.45,2,-77538,62263,139801,-15275,0,-10,23938,0,0,,23948,23928
15,04-08-18,87,21:30,21:45,44.37,25.5,0,25.5,25.5,-1,-60631,77106,137737,16475,0,-9137,1280,0,0,,10417,-7857
15,04-08-18,88,21:45,22:00,,34.59,0,34.59,34.59,-1,-68180,80149,148329,11969,0,-4851,0,0,0,,4851,-4851
15,04-08-18,89,22:00,22:15,,38.78,0,38.78,38.78,-1,-95765,54434,150199,-41331,0,-1020,0,0,0,,1020,-1020
15,04-08-18,90,22:15,22:30,,,0,36.45,36.45,0,-80046,42007,122053,-38039,0,0,0,0,0,,0,0
15,04-08-18,91,22:30,22:45,,,0,36.95,36.95,0,-60261,47354,107615,-12907,0,0,0,0,0,,0,0
15,04-08-18,92,22:45,23:00,,36.26,0,36.26,36.26,-1,-41289,59519,100808,18230,0,-3078,0,0,0,,3078,-3078
15,04-08-18,93,23:00,23:15,222.12,36.26,0,222.12,222.12,1,-123220,21068,144288,-102152,0,-242,21689,0,0,,21931,21447
15,04-08-18,94,23:15,23:30,44.37,,0,44.37,44.37,1,-97783,32751,130534,-65032,0,0,17418,0,0,,17418,17418
15,04-08-18,95,23:30,23:45,38.25,,0,38.25,38.25,1,-61014,36257,97271,-24757,0,0,1402,0,0,,1402,1402
15,04-08-18,96,23:45,0:00,34.71,,0,34.71,34.71,1,-44100,45146,89246,1046,0,0,567,0,0,,567,567
15,04-09-18,1,0:00,0:15,40.31,,0,40.31,40.31,1,-60340,41114,101454,-19226,0,0,3738,0,0,,3738,3738
15,04-09-18,2,0:15,0:30,36.31,,0,36.31,36.31,1,-47116,38686,85802,-8430,0,0,3368,0,0,,3368,3368
15,04-09-18,3,0:30,0:45,,,0,34.75,34.75,0,-33563,29544,63107,-4019,0,0,303,0,0,,303,303
15,04-09-18,4,0:45,1:00,,28.31,0,28.31,28.31,-1,-27642,43629,71271,15987,0,-11930,0,0,0,,11930,-11930
15,04-09-18,5,1:00,1:15,36.31,31.03,0,36.31,36.31,1,-42122,53471,95593,11349,0,-12852,84,0,0,,12936,-12768
15,04-09-18,6,1:15,1:30,36.31,31.03,0,36.31,36.31,1,-39103,39916,79019,813,0,-243,586,0,0,,829,343
15,04-09-18,7,1:30,1:45,,,0,34.44,34.44,0,-24579,45368,69947,20789,0,0,0,0,0,,0,0
15,04-09-18,8,1:45,2:00,,10.37,0,10.37,10.37,-1,-14815,64209,79024,49394,0,-20143,0,0,0,,20143,-20143
15,04-09-18,9,2:00,2:15,34.84,-3.8,0,34.84,-3.8,2,-45975,81227,127202,35252,0,-33296,43,0,0,,33339,-33253
15,04-09-18,10,2:15,2:30,36.31,22.35,0,36.31,22.35,2,-38723,69226,107949,30503,0,-2410,122,0,0,,2532,-2288
15,04-09-18,11,2:30,2:45,,10.84,0,10.84,10.84,-1,-27461,77750,105211,50289,0,-25393,0,0,0,,25393,-25393
15,04-09-18,12,2:45,3:00,,22.63,0,22.63,22.63,-1,-22867,62531,85398,39664,0,-31650,0,0,0,,31650,-31650
15,04-09-18,13,3:00,3:15,,16.12,0,16.12,16.12,-1,-19662,86947,106609,67285,0,-43178,0,0,0,,43178,-43178
15,04-09-18,14,3:15,3:30,,28.31,0,28.31,28.31,-1,-50433,72723,123156,22290,0,-25349,0,0,0,,25349,-25349
15,04-09-18,15,3:30,3:45,,29.26,0,29.26,29.26,-1,-60569,76671,137240,16102,0,-19322,0,0,0,,19322,-19322
15,04-09-18,16,3:45,4:00,,28.15,0,28.15,28.15,-1,-42690,75770,118460,33080,0,-14714,0,0,0,,14714,-14714
15,04-09-18,17,4:00,4:15,,32.31,0,32.31,32.31,-1,-51297,69065,120362,17768,0,-17022,0,0,0,,17022,-17022
15,04-09-18,18,4:15,4:30,,12.94,0,12.94,12.94,-1,-34273,84080,118353,49807,0,-31570,0,0,0,,31570,-31570
15,04-09-18,19,4:30,4:45,,12.46,0,12.46,12.46,-1,-36386,104328,140714,67942,0,-49355,0,0,0,,49355,-49355
15,04-09-18,20,4:45,5:00,,-150.03,0,-150.03,-150.03,-1,-23358,137336,160694,113978,0,-73187,0,0,0,,73187,-73187
15,04-09-18,21,5:00,5:15,,-150.03,0,-150.03,-150.03,-1,-64613,132520,197133,67907,0,-42155,0,0,0,,42155,-42155
15,04-09-18,22,5:15,5:30,,-150.03,0,-150.03,-150.03,-1,-36085,163460,199545,127375,0,-103272,0,0,0,,103272,-103272
15,04-09-18,23,5:30,5:45,,-150.03,0,-150.03,-150.03,-1,-25141,154745,179886,129604,0,-105550,0,0,0,,105550,-105550
15,04-09-18,24,5:45,6:00,,9.03,0,9.03,9.03,-1,-51648,177595,229243,125947,0,-85354,0,0,0,,85354,-85354
15,04-09-18,25,6:00,6:15,,22.03,0,22.03,22.03,-1,-53689,114370,168059,60681,0,-59450,0,0,0,,59450,-59450
15,04-09-18,26,6:15,6:30,,32.31,0,32.31,32.31,-1,-61968,128930,190898,66962,0,-9126,0,0,0,,9126,-9126
15,04-09-18,27,6:30,6:45,,36.11,0,36.11,36.11,-1,-41522,103261,144783,61739,0,-1886,0,0,0,,1886,-1886
15,04-09-18,28,6:45,7:00,,36.61,0,36.61,36.61,-1,-67894,156163,224057,88269,0,-71,0,0,0,,71,-71
15,04-09-18,29,7:00,7:15,,10.66,0,10.66,10.66,-1,-53828,181991,235819,128163,0,-19792,0,0,0,,19792,-19792
15,04-09-18,30,7:15,7:30,,8.31,0,8.31,8.31,-1,-42728,139025,181753,96297,0,-54380,0,0,0,,54380,-54380
15,04-09-18,31,7:30,7:45,,26.57,0,26.57,26.57,-1,-70138,109154,179292,39016,0,-38688,0,0,0,,38688,-38688
15,04-09-18,32,7:45,8:00,37.86,26.57,0,37.86,37.86,1,-119212,94249,213461,-24963,0,-3020,1153,0,0,,4173,-1867
15,04-09-18,33,8:00,8:15,,33,0,33,33,-1,-61535,107037,168572,45502,0,-806,0,0,0,,806,-806
15,04-09-18,34,8:15,8:30,,33,0,33,33,-1,-69066,84795,153861,15729,0,-886,0,0,0,,886,-886
15,04-09-18,35,8:30,8:45,37.36,,0,37.36,37.36,1,-92972,62827,155799,-30145,0,0,256,0,0,,256,256
15,04-09-18,36,8:45,9:00,62.13,,0,62.13,62.13,1,-97927,49866,147793,-48061,0,0,25095,0,0,,25095,25095
15,04-09-18,37,9:00,9:15,50.55,,0,50.55,50.55,1,-85975,60699,146674,-25276,0,0,32793,0,0,,32793,32793
15,04-09-18,38,9:15,9:30,41.84,,0,41.84,41.84,1,-89420,62843,152263,-26577,0,0,14271,0,0,,14271,14271
15,04-09-18,39,9:30,9:45,40.55,,0,40.55,40.55,1,-71248,56315,127563,-14933,0,0,11832,0,0,,11832,11832
15,04-09-18,40,9:45,10:00,50.55,,0,50.55,50.55,1,-69414,40498,109912,-28916,0,0,26557,0,0,,26557,26557
15,04-09-18,41,10:00,10:15,66.02,,0,66.02,66.02,1,-127601,66260,193861,-61341,0,0,39711,0,0,,39711,39711
15,04-09-18,42,10:15,10:30,57.92,,0,57.92,57.92,1,-102179,53792,155971,-48387,0,0,36956,0,0,,36956,36956
15,04-09-18,43,10:30,10:45,46.66,,0,46.66,46.66,1,-86990,57796,144786,-29194,0,0,38461,0,0,,38461,38461
15,04-09-18,44,10:45,11:00,35.76,34.11,0,35.76,34.11,2,-63345,73580,136925,10235,0,-287,9403,0,0,,9690,9116
15,04-09-18,45,11:00,11:15,35.76,,0,35.76,35.76,1,-95372,52654,148026,-42718,0,0,2434,0,0,,2434,2434
15,04-09-18,46,11:15,11:30,36.43,,0,36.43,36.43,1,-87155,67180,154335,-19975,0,0,2185,0,0,,2185,2185
15,04-09-18,47,11:30,11:45,,,0,35.57,35.57,0,-76886,81675,158561,4789,0,0,0,0,0,,0,0
15,04-09-18,48,11:45,12:00,,,0,35.58,35.58,0,-76801,82622,159423,5821,0,0,0,0,0,,0,0
15,04-09-18,49,12:00,12:15,148.02,,0,148.02,148.02,1,-127042,48946,175988,-78096,0,0,20777,0,0,,20777,20777
15,04-09-18,50,12:15,12:30,41.02,,0,41.02,41.02,1,-104030,60788,164818,-43242,0,0,11146,0,0,,11146,11146
15,04-09-18,51,12:30,12:45,36.99,,0,36.99,36.99,1,-90411,76643,167054,-13768,0,0,966,0,0,,966,966
15,04-09-18,52,12:45,13:00,,,0,35.55,35.55,0,-83944,81975,165919,-1969,0,0,37,0,0,,37,37
15,04-09-18,53,13:00,13:15,50.32,,0,50.32,50.32,1,-102968,56683,159651,-46285,0,0,13351,0,0,,13351,13351
15,04-09-18,54,13:15,13:30,46.66,,0,46.66,46.66,1,-120513,59146,179659,-61367,0,0,30000,0,0,,30000,30000
15,04-09-18,55,13:30,13:45,46.66,,0,46.66,46.66,1,-122328,65855,188183,-56473,0,0,37756,0,0,,37756,37756
15,04-09-18,56,13:45,14:00,44.02,,0,44.02,44.02,1,-116119,63462,179581,-52657,0,0,35623,0,0,,35623,35623
15,04-09-18,57,14:00,14:15,46.66,,0,46.66,46.66,1,-87081,51848,138929,-35233,0,0,20629,0,0,,20629,20629
15,04-09-18,58,14:15,14:30,42.97,,0,42.97,42.97,1,-86988,51197,138185,-35791,0,0,29241,0,0,,29241,29241
15,04-09-18,59,14:30,14:45,35.76,,0,35.76,35.76,1,-82866,48774,131640,-34092,0,0,7289,0,0,,7289,7289
15,04-09-18,60,14:45,15:00,35.76,,0,35.76,35.76,1,-89548,50965,140513,-38583,0,0,958,0,0,,958,958
15,04-09-18,61,15:00,15:15,39.95,,0,39.95,39.95,1,-69661,52625,122286,-17036,0,0,5756,0,0,,5756,5756
15,04-09-18,62,15:15,15:30,39.95,,0,39.95,39.95,1,-89700,36191,125891,-53509,0,0,17493,0,0,,17493,17493
15,04-09-18,63,15:30,15:45,148.02,,0,148.02,148.02,1,-131486,28792,160278,-102694,0,0,32280,0,0,,32280,32280
15,04-09-18,64,15:45,16:00,58.66,,0,58.66,58.66,1,-124958,37927,162885,-87031,0,0,35795,0,0,,35795,35795
15,04-09-18,65,16:00,16:15,39.94,,0,39.94,39.94,1,-154312,25075,179387,-129237,0,0,2410,0,0,,2410,2410
15,04-09-18,66,16:15,16:30,50.32,,0,50.32,50.32,1,-167485,22166,189651,-145319,0,0,20464,0,0,,20464,20464
15,04-09-18,67,16:30,16:45,58.66,,0,58.66,58.66,1,-172224,33795,206019,-138429,0,0,25971,0,0,,25971,25971
15,04-09-18,68,16:45,17:00,39.95,,0,39.95,39.95,1,-195222,50161,245383,-145061,0,0,23929,0,0,,23929,23929
15,04-09-18,69,17:00,17:15,52.09,,0,52.09,52.09,1,-164002,39745,203747,-124257,0,0,27510,0,0,,27510,27510
15,04-09-18,70,17:15,17:30,148.02,,0,148.02,148.02,1,-177138,46491,223629,-130647,0,0,22405,0,0,,22405,22405
15,04-09-18,71,17:30,17:45,148.02,,0,148.02,148.02,1,-158534,55652,214186,-102882,0,0,63933,0,0,,63933,63933
15,04-09-18,72,17:45,18:00,53.02,,0,53.02,53.02,1,-124125,66303,190428,-57822,0,0,62803,0,0,,62803,62803
15,04-09-18,73,18:00,18:15,48.2,,0,48.2,48.2,1,-143493,23525,167018,-119968,0,0,28036,0,0,,28036,28036
15,04-09-18,74,18:15,18:30,,,0,35.55,35.55,0,-119705,29383,149088,-90322,0,0,0,0,0,,0,0
15,04-09-18,75,18:30,18:45,82.66,,0,82.66,82.66,1,-103715,28557,132272,-75158,0,0,17605,0,0,,17605,17605
15,04-09-18,76,18:45,19:00,58.66,,0,58.66,58.66,1,-92043,36070,128113,-55973,0,0,46161,0,0,,46161,46161
15,04-09-18,77,19:00,19:15,42.94,,0,42.94,42.94,1,-111950,54576,166526,-57374,0,0,36068,0,0,,36068,36068
15,04-09-18,78,19:15,19:30,46.66,,0,46.66,46.66,1,-108209,65462,173671,-42747,0,0,32608,0,0,,32608,32608
15,04-09-18,79,19:30,19:45,38.02,,0,38.02,38.02,1,-92268,62103,154371,-30165,0,0,12619,0,0,,12619,12619
15,04-09-18,80,19:45,20:00,,,0,35.58,35.58,0,-99704,55077,154781,-44627,0,0,5,0,0,,5,5
15,04-09-18,81,20:00,20:15,35.76,32.5,0,35.76,35.76,1,-53137,55657,108794,2520,0,-6,77,0,0,,83,71
15,04-09-18,82,20:15,20:30,54.73,,0,54.73,54.73,1,-84464,60655,145119,-23809,0,0,6986,0,0,,6986,6986
15,04-09-18,83,20:30,20:45,59.25,,0,59.25,59.25,1,-104089,69755,173844,-34334,0,0,29594,0,0,,29594,29594
15,04-09-18,84,20:45,21:00,82.66,,0,82.66,82.66,1,-133771,77592,211363,-56179,0,0,35704,0,0,,35704,35704
15,04-09-18,85,21:00,21:15,148.02,,0,148.02,148.02,1,-165451,70439,235890,-95012,0,0,82456,0,0,,82456,82456
15,04-09-18,86,21:15,21:30,62.25,,0,62.25,62.25,1,-112756,74336,187092,-38420,0,0,58478,0,0,,58478,58478
15,04-09-18,87,21:30,21:45,35.76,,0,35.76,35.76,1,-95848,92984,188832,-2864,0,0,6198,0,0,,6198,6198
15,04-09-18,88,21:45,22:00,37.57,,0,37.57,37.57,1,-109734,99275,209009,-10459,0,0,992,0,0,,992,992
15,04-09-18,89,22:00,22:15,35.76,,0,35.76,35.76,1,-139876,58902,198778,-80974,0,0,2348,0,0,,2348,2348
15,04-09-18,90,22:15,22:30,34.09,,0,34.09,34.09,1,-119277,54176,173453,-65101,0,0,346,0,0,,346,346
15,04-09-18,91,22:30,22:45,,,0,34.71,34.71,0,-102937,63049,165986,-39888,0,0,0,0,0,,0,0
15,04-09-18,92,22:45,23:00,,,0,34.72,34.72,0,-101740,88594,190334,-13146,0,0,0,0,0,,0,0
15,04-09-18,93,23:00,23:15,,,0,35.54,35.54,0,-77266,44343,121609,-32923,0,0,0,0,0,,0,0
15,04-09-18,94,23:15,23:30,,,0,35.54,35.54,0,-66896,34841,101737,-32055,0,0,0,0,0,,0,0
15,04-09-18,95,23:30,23:45,,,0,35.57,35.57,0,-83917,48977,132894,-34940,0,0,0,0,0,,0,0
15,04-09-18,96,23:45,0:00,,,0,35.6,35.6,0,-110280,31806,142086,-78474,0,0,0,0,0,,0,0
15,04-10-18,1,0:00,0:15,44.42,,0,44.42,44.42,1,-157892,95910,253802,-61982,0,0,2413,0,0,,2413,2413
15,04-10-18,2,0:15,0:30,151.17,,0,151.17,151.17,1,-163251,16545,179796,-146706,0,0,39231,0,0,,39231,39231
15,04-10-18,3,0:30,0:45,88.14,,0,88.14,88.14,1,-154176,36570,190746,-117606,0,0,47929,0,0,,47929,47929
15,04-10-18,4,0:45,1:00,,,0,34.14,34.14,0,-134742,30132,164874,-104610,0,0,6971,0,0,,6971,6971
15,04-10-18,5,1:00,1:15,76.87,32.31,0,76.87,32.31,2,-110625,92981,203606,-17644,0,-27,5029,0,0,,5056,5002
15,04-10-18,6,1:15,1:30,217.17,,0,217.17,217.17,1,-131443,26997,158440,-104446,0,0,47284,0,0,,47284,47284
15,04-10-18,7,1:30,1:45,48.14,,0,48.14,48.14,1,-107790,48267,156057,-59523,0,0,29495,0,0,,29495,29495
15,04-10-18,8,1:45,2:00,57.19,,0,57.19,57.19,1,-118739,49365,168104,-69374,0,0,40300,0,0,,40300,40300
15,04-10-18,9,2:00,2:15,46.4,60.75,0,46.44,46.44,2,-107655,95618,203273,-12037,0,-32,11555,0,0,,11587,11523
15,04-10-18,10,2:15,2:30,82.66,,0,82.66,82.66,1,-107936,48360,156296,-59576,0,0,38716,0,0,,38716,38716
15,04-10-18,11,2:30,2:45,43.66,,0,43.66,43.66,1,-96569,55862,152431,-40707,0,0,35007,0,0,,35007,35007
15,04-10-18,12,2:45,3:00,46.4,,0,46.4,46.4,1,-108628,54631,163259,-53997,0,0,33456,0,0,,33456,33456
15,04-10-18,13,3:00,3:15,40.31,34.59,0,34.59,34.59,-1,-67963,61647,129610,-6316,0,-131,17264,0,0,,17395,17133
15,04-10-18,14,3:15,3:30,40.31,34.59,0,34.59,34.59,-1,-77416,60095,137511,-17321,0,-51,55,0,0,,106,4
15,04-10-18,15,3:30,3:45,34.31,,0,34.31,34.31,1,-76974,69338,146312,-7636,0,0,9,0,0,,9,9
15,04-10-18,16,3:45,4:00,34.31,,0,34.31,34.31,1,-73870,67326,141196,-6544,0,0,267,0,0,,267,267
15,04-10-18,17,4:00,4:15,58.66,,0,58.66,58.66,1,-131727,59725,191452,-72002,0,0,14094,0,0,,14094,14094
15,04-10-18,18,4:15,4:30,32.12,,0,32.12,32.12,1,-62628,56340,118968,-6288,0,0,2070,0,0,,2070,2070
15,04-10-18,19,4:30,4:45,,28.31,0,28.31,28.31,-1,-64490,89339,153829,24849,0,-2546,0,0,0,,2546,-2546
15,04-10-18,20,4:45,5:00,36.31,32.31,0,46.75,32.31,2,-73046,104610,177656,31564,0,-3331,7,0,0,,3338,-3324
15,04-10-18,21,5:00,5:15,37.6,32.31,0,37.6,37.6,1,-160671,80239,240910,-80432,0,-419,225,0,0,,644,-194
15,04-10-18,22,5:15,5:30,,,0,34.89,34.89,0,-94301,63538,157839,-30763,0,0,0,0,0,,0,0
15,04-10-18,23,5:30,5:45,,,0,34.75,34.75,0,-88326,59066,147392,-29260,0,0,0,0,0,,0,0
15,04-10-18,24,5:45,6:00,,,0,33.14,33.14,0,-115597,77247,192844,-38350,0,0,0,0,0,,0,0
15,04-10-18,25,6:00,6:15,40.31,,0,40.31,40.31,1,-190623,61319,251942,-129304,0,0,3253,0,0,,3253,3253
15,04-10-18,26,6:15,6:30,36.31,,0,36.31,36.31,1,-90338,61181,151519,-29157,0,0,25,0,0,,25,25
15,04-10-18,27,6:30,6:45,75.68,,0,75.68,75.68,1,-110099,35315,145414,-74784,0,0,18554,0,0,,18554,18554
15,04-10-18,28,6:45,7:00,42.7,34.04,0,42.7,33.98,2,-73118,75813,148931,2695,0,-17,19189,0,0,,19206,19172
15,04-10-18,29,7:00,7:15,42.7,20.61,0,20.61,20.61,-1,-72964,140351,213315,67387,0,-18186,1317,0,0,,19503,-16869
15,04-10-18,30,7:15,7:30,,34.74,0,34.74,34.74,-1,-71824,103370,175194,31546,0,-3968,0,0,0,,3968,-3968
15,04-10-18,31,7:30,7:45,39.94,,0,39.94,39.94,1,-75525,75448,150973,-77,0,0,872,0,0,,872,872
15,04-10-18,32,7:45,8:00,48.06,,0,48.06,48.06,1,-109482,62370,171852,-47112,0,0,13982,0,0,,13982,13982
15,04-10-18,33,8:00,8:15,48.06,-132.83,0,-132.83,-132.83,-1,-56826,95447,152273,38621,0,-20838,690,0,0,,21528,-20148
15,04-10-18,34,8:15,8:30,,34.26,0,34.26,34.26,-1,-75737,83291,159028,7554,0,-361,0,0,0,,361,-361
15,04-10-18,35,8:30,8:45,,33.78,0,33.78,33.78,-1,-67705,79117,146822,11412,0,-1889,0,0,0,,1889,-1889
15,04-10-18,36,8:45,9:00,,34.05,0,34.05,34.05,-1,-80349,79641,159990,-708,0,-2248,0,0,0,,2248,-2248
15,04-10-18,37,9:00,9:15,42.43,32.31,0,42.43,32.31,2,-120642,83190,203832,-37452,0,-2714,2757,0,0,,5471,43
15,04-10-18,38,9:15,9:30,35.94,,0,35.94,35.94,1,-107723,81448,189171,-26275,0,0,572,0,0,,572,572
15,04-10-18,39,9:30,9:45,,33.78,0,33.78,33.78,-1,-86523,89013,175536,2490,0,-588,0,0,0,,588,-588
15,04-10-18,40,9:45,10:00,,32.31,0,32.31,32.31,-1,-68744,89789,158533,21045,0,-7548,0,0,0,,7548,-7548
15,04-10-18,41,10:00,10:15,,34.78,0,34.78,34.78,-1,-132127,86878,219005,-45249,0,-4228,0,0,0,,4228,-4228
15,04-10-18,42,10:15,10:30,,,0,36.79,36.79,0,-112913,104822,217735,-8091,0,0,0,0,0,,0,0
15,04-10-18,43,10:30,10:45,,32.27,0,32.27,32.27,-1,-97882,106782,204664,8900,0,-2079,0,0,0,,2079,-2079
15,04-10-18,44,10:45,11:00,,28.31,0,28.31,28.31,-1,-86454,104317,190771,17863,0,-19961,0,0,0,,19961,-19961
15,04-10-18,45,11:00,11:15,35.94,28.31,0,35.94,35.94,1,-134343,76014,210357,-58329,0,-4505,1404,0,0,,5909,-3101
15,04-10-18,46,11:15,11:30,37.49,,0,37.49,37.49,1,-146068,72407,218475,-73661,0,0,2780,0,0,,2780,2780
15,04-10-18,47,11:30,11:45,41.24,,0,41.24,41.24,1,-138209,78121,216330,-60088,0,0,4997,0,0,,4997,4997
15,04-10-18,48,11:45,12:00,37.49,,0,37.49,37.49,1,-132944,80032,212976,-52912,0,0,7977,0,0,,7977,7977
15,04-10-18,49,12:00,12:15,37.35,,0,37.35,37.35,1,-92452,97575,190027,5123,0,0,4337,0,0,,4337,4337
15,04-10-18,50,12:15,12:30,,35.29,0,35.29,35.29,-1,-77976,96250,174226,18274,0,-54,0,0,0,,54,-54
15,04-10-18,51,12:30,12:45,,35.38,0,35.38,35.38,-1,-83650,100154,183804,16504,0,-1024,0,0,0,,1024,-1024
15,04-10-18,52,12:45,13:00,,33.9,0,33.9,33.9,-1,-88320,106413,194733,18093,0,-605,0,0,0,,605,-605
15,04-10-18,53,13:00,13:15,,33.29,0,33.29,33.29,-1,-63788,91189,154977,27401,0,-807,0,0,0,,807,-807
15,04-10-18,54,13:15,13:30,,33.85,0,33.85,33.85,-1,-73993,93173,167166,19180,0,-221,0,0,0,,221,-221
15,04-10-18,55,13:30,13:45,,33.92,0,33.92,33.92,-1,-76994,95515,172509,18521,0,-120,0,0,0,,120,-120
15,04-10-18,56,13:45,14:00,,33.57,0,33.57,33.57,-1,-76058,88454,164512,12396,0,-4243,0,0,0,,4243,-4243
15,04-10-18,57,14:00,14:15,,32.78,0,32.78,32.78,-1,-67856,93012,160868,25156,0,-5446,0,0,0,,5446,-5446
15,04-10-18,58,14:15,14:30,,28.31,0,28.31,28.31,-1,-57568,98134,155702,40566,0,-9762,0,0,0,,9762,-9762
15,04-10-18,59,14:30,14:45,,28.31,0,28.31,28.31,-1,-68294,95332,163626,27038,0,-22879,0,0,0,,22879,-22879
15,04-10-18,60,14:45,15:00,,32.78,0,32.78,32.78,-1,-74835,90684,165519,15849,0,-12677,0,0,0,,12677,-12677
15,04-10-18,61,15:00,15:15,,35.19,0,35.19,35.19,-1,-59291,79721,139012,20430,0,-2861,0,0,0,,2861,-2861
15,04-10-18,62,15:15,15:30,,,0,34.62,34.62,0,-52547,73514,126061,20967,0,0,0,0,0,,0,0
15,04-10-18,63,15:30,15:45,,,0,34.61,34.61,0,-50047,69206,119253,19159,0,0,0,0,0,,0,0
15,04-10-18,64,15:45,16:00,,,0,34.5,34.5,0,-41459,66997,108456,25538,0,0,0,0,0,,0,0
15,04-10-18,65,16:00,16:15,,35.11,0,35.11,35.11,-1,-60904,60326,121230,-578,0,-306,0,0,0,,306,-306
15,04-10-18,66,16:15,16:30,35.94,,0,35.94,35.94,1,-56720,50616,107336,-6104,0,0,521,0,0,,521,521
15,04-10-18,67,16:30,16:45,35.94,,0,35.94,35.94,1,-55983,51348,107331,-4635,0,0,844,0,0,,844,844
15,04-10-18,68,16:45,17:00,35.94,,0,35.94,35.94,1,-75104,51076,126180,-24028,0,0,3103,0,0,,3103,3103
15,04-10-18,69,17:00,17:15,35.94,34.88,0,34.88,34.88,-1,-51118,85389,136507,34271,0,-641,317,0,0,,958,-324
15,04-10-18,70,17:15,17:30,,34.88,0,34.88,34.88,-1,-47141,77679,124820,30538,0,-2513,0,0,0,,2513,-2513
15,04-10-18,71,17:30,17:45,,34.78,0,34.78,34.78,-1,-50356,74678,125034,24322,0,-870,0,0,0,,870,-870
15,04-10-18,72,17:45,18:00,36.91,,0,36.91,36.91,1,-59914,73963,133877,14049,0,0,207,0,0,,207,207
15,04-10-18,73,18:00,18:15,58.84,,0,58.84,58.84,1,-103707,15186,118893,-88521,0,0,26278,0,0,,26278,26278
15,04-10-18,74,18:15,18:30,46.16,,0,46.16,46.16,1,-82754,37759,120513,-44995,0,0,41812,0,0,,41812,41812
15,04-10-18,75,18:30,18:45,39.94,,0,39.94,39.94,1,-83402,49982,133384,-33420,0,0,34405,0,0,,34405,34405
15,04-10-18,76,18:45,19:00,43.22,,0,43.22,43.22,1,-78716,46874,125590,-31842,0,0,32733,0,0,,32733,32733
15,04-10-18,77,19:00,19:15,109.83,,0,109.83,109.83,1,-95983,14794,110777,-81189,0,0,42035,0,0,,42035,42035
15,04-10-18,78,19:15,19:30,50.12,,0,50.12,50.12,1,-75368,22893,98261,-52475,0,0,57346,0,0,,57346,57346
15,04-10-18,79,19:30,19:45,38.12,,0,38.12,38.12,1,-68119,34885,103004,-33234,0,0,19919,0,0,,19919,19919
15,04-10-18,80,19:45,20:00,46.45,,0,46.45,46.45,1,-79054,35054,114108,-44000,0,0,25428,0,0,,25428,25428
15,04-10-18,81,20:00,20:15,35.94,35.78,0,36.8,35.78,2,-54248,65813,120061,11565,0,-523,7516,0,0,,8039,6993
15,04-10-18,82,20:15,20:30,38.44,,0,38.44,38.44,1,-73451,48171,121622,-25280,0,0,524,0,0,,524,524
15,04-10-18,83,20:30,20:45,66.38,,0,66.38,66.38,1,-81030,26247,107277,-54783,0,0,28611,0,0,,28611,28611
15,04-10-18,84,20:45,21:00,66.38,,0,66.38,66.38,1,-87596,23915,111511,-63681,0,0,61255,0,0,,61255,61255
15,04-10-18,85,21:00,21:15,46.16,,0,46.16,46.16,1,-68882,22099,90981,-46783,0,0,49950,0,0,,49950,49950
15,04-10-18,86,21:15,21:30,43.84,,0,43.84,43.84,1,-58871,36643,95514,-22228,0,0,33592,0,0,,33592,33592
15,04-10-18,87,21:30,21:45,43.84,37,0,37,37,-1,-43737,50177,93914,6440,0,-566,5454,0,0,,6020,4888
15,04-10-18,88,21:45,22:00,,35.78,0,35.78,35.78,-1,-47177,87592,134769,40415,0,-2210,0,0,0,,2210,-2210
15,04-10-18,89,22:00,22:15,36.45,35.78,0,36.45,36.45,1,-66001,34948,100949,-31053,0,-692,414,0,0,,1106,-278
15,04-10-18,90,22:15,22:30,,,0,36.93,36.93,0,-56234,57194,113428,960,0,0,0,0,0,,0,0
15,04-10-18,91,22:30,22:45,,37.92,0,37.92,37.92,-1,-53469,67385,120854,13916,0,-6,0,0,0,,6,-6
15,04-10-18,92,22:45,23:00,,34.78,0,34.78,34.78,-1,-70265,93740,164005,23475,0,-3597,0,0,0,,3597,-3597
15,04-10-18,93,23:00,23:15,,32.78,0,32.78,32.78,-1,-65012,104475,169487,39463,0,-4497,0,0,0,,4497,-4497
15,04-10-18,94,23:15,23:30,,32.5,0,32.5,32.5,-1,-50111,73292,123403,23181,0,-3442,0,0,0,,3442,-3442
15,04-10-18,95,23:30,23:45,,32.31,0,32.31,32.31,-1,-47407,101919,149326,54512,0,-6834,0,0,0,,6834,-6834
15,04-10-18,96,23:45,0:00,,20.61,0,20.61,20.61,-1,-75078,129429,204507,54351,0,-15614,0,0,0,,15614,-15614
15,04-11-18,1,0:00,0:15,46.82,12.03,0,46.82,46.82,1,-80385,73626,154011,-6759,0,-17651,1918,0,0,,19569,-15733
15,04-11-18,2,0:15,0:30,50.14,,0,50.14,50.14,1,-58449,80075,138524,21626,0,0,8159,0,0,,8159,8159
15,04-11-18,3,0:30,0:45,39.97,,0,39.97,39.97,1,-61200,66248,127448,5048,0,0,911,0,0,,911,911
15,04-11-18,4,0:45,1:00,46.91,,0,46.91,46.91,1,-88355,38568,126923,-49787,0,0,15532,0,0,,15532,15532
15,04-11-18,5,1:00,1:15,93.39,,0,93.39,93.39,1,-107058,32029,139087,-75029,0,0,68590,0,0,,68590,68590
15,04-11-18,6,1:15,1:30,59.09,,0,59.09,59.09,1,-80123,40752,120875,-39371,0,0,52835,0,0,,52835,52835
15,04-11-18,7,1:30,1:45,48.01,,0,48.01,48.01,1,-81682,37120,118802,-44562,0,0,34979,0,0,,34979,34979
15,04-11-18,8,1:45,2:00,39.2,,0,39.2,39.2,1,-81037,51574,132611,-29463,0,0,19256,0,0,,19256,19256
15,04-11-18,9,2:00,2:15,144.02,,0,144.02,144.02,1,-120240,46556,166796,-73684,0,0,42601,0,0,,42601,42601
15,04-11-18,10,2:15,2:30,59.09,,0,59.09,59.09,1,-107423,40452,147875,-66971,0,0,67625,0,0,,67625,67625
15,04-11-18,11,2:30,2:45,48.12,,0,48.12,48.12,1,-102099,40756,142855,-61343,0,0,61482,0,0,,61482,61482
15,04-11-18,12,2:45,3:00,52.5,,0,52.5,52.5,1,-114161,39207,153368,-74954,0,0,60764,0,0,,60764,60764
15,04-11-18,13,3:00,3:15,63.19,,0,63.19,63.19,1,-119100,65139,184239,-53961,0,0,49794,0,0,,49794,49794
15,04-11-18,14,3:15,3:30,85.02,,0,85.02,85.02,1,-132728,49819,182547,-82909,0,0,76730,0,0,,76730,76730
15,04-11-18,15,3:30,3:45,53.77,,0,53.77,53.77,1,-109783,59254,169037,-50529,0,0,59201,0,0,,59201,59201
15,04-11-18,16,3:45,4:00,40.31,,0,40.31,40.31,1,-98145,64731,162876,-33414,0,0,29677,0,0,,29677,29677
15,04-11-18,17,4:00,4:15,61.38,,0,61.38,61.38,1,-115148,54706,169854,-60442,0,0,44253,0,0,,44253,44253
15,04-11-18,18,4:15,4:30,45.86,,0,45.86,45.86,1,-92839,62051,154890,-30788,0,0,31854,0,0,,31854,31854
15,04-11-18,19,4:30,4:45,46.5,,0,46.5,46.5,1,-108573,63086,171659,-45487,0,0,32343,0,0,,32343,32343
15,04-11-18,20,4:45,5:00,59.09,,0,59.09,59.09,1,-121134,58002,179136,-63132,0,0,51426,0,0,,51426,51426
15,04-11-18,21,5:00,5:15,49.24,,0,49.24,49.24,1,-108562,55816,164378,-52746,0,0,42937,0,0,,42937,42937
15,04-11-18,22,5:15,5:30,94.77,,0,94.77,94.77,1,-146530,51097,197627,-95433,0,0,51320,0,0,,51320,51320
15,04-11-18,23,5:30,5:45,116.74,,0,116.74,116.74,1,-166888,50190,217078,-116698,0,0,96097,0,0,,96097,96097
15,04-11-18,24,5:45,6:00,71.59,,0,71.59,71.59,1,-159949,73558,233507,-86391,0,0,85489,0,0,,85489,85489
15,04-11-18,25,6:00,6:15,51.02,,0,51.02,51.02,1,-130779,79832,210611,-50947,0,0,35465,0,0,,35465,35465
15,04-11-18,26,6:15,6:30,149.02,,0,149.02,149.02,1,-164595,52595,217190,-112000,0,0,24520,0,0,,24520,24520
15,04-11-18,27,6:30,6:45,170.43,,0,170.43,170.43,1,-183978,62584,246562,-121394,0,0,88336,0,0,,88336,88336
15,04-11-18,28,6:45,7:00,118.17,,0,118.17,118.17,1,-127835,86250,214085,-41585,0,0,77648,0,0,,77648,77648
15,04-11-18,29,7:00,7:15,59.92,,0,59.92,59.92,1,-155189,69508,224697,-85681,0,0,10010,0,0,,10010,10010
15,04-11-18,30,7:15,7:30,149.02,,0,149.02,149.02,1,-111408,31961,143369,-79447,0,0,43128,0,0,,43128,43128
15,04-11-18,31,7:30,7:45,47.05,,0,47.05,47.05,1,-118395,72431,190826,-45964,0,0,19490,0,0,,19490,19490
15,04-11-18,32,7:45,8:00,149.02,,0,149.02,149.02,1,-147359,70018,217377,-77341,0,0,52036,0,0,,52036,52036
15,04-11-18,33,8:00,8:15,149.02,,0,149.02,149.02,1,-138340,49897,188237,-88443,0,0,50277,0,0,,50277,50277
15,04-11-18,34,8:15,8:30,149.02,,0,149.02,149.02,1,-123666,41384,165050,-82282,0,0,80040,0,0,,80040,80040
15,04-11-18,35,8:30,8:45,83.75,,0,83.75,83.75,1,-123811,33624,157435,-90187,0,0,82044,0,0,,82044,82044
15,04-11-18,36,8:45,9:00,122.02,,0,122.02,122.02,1,-126984,28444,155428,-98540,0,0,84992,0,0,,84992,84992
15,04-11-18,37,9:00,9:15,168.32,,0,168.32,168.32,1,-140721,46215,186936,-94506,0,0,88577,0,0,,88577,88577
15,04-11-18,38,9:15,9:30,172.5,,0,172.5,172.5,1,-130960,51418,182378,-79542,0,0,80571,13750,0,,94321,94321
15,04-11-18,39,9:30,9:45,172.5,32.98,0,172.5,32.98,2,-95055,80513,175568,-14542,0,-157,22548,13750,0,,36455,36141
15,04-11-18,40,9:45,10:00,43.54,,0,43.54,43.54,1,-100769,91453,192222,-9316,0,0,2434,0,0,,2434,2434
15,04-11-18,41,10:00,10:15,39.59,,0,39.59,39.59,1,-75057,66417,141474,-8640,0,0,8989,0,0,,8989,8989
15,04-11-18,42,10:15,10:30,36.98,,0,36.98,36.98,1,-70885,69440,140325,-1445,0,0,2323,0,0,,2323,2323
15,04-11-18,43,10:30,10:45,36.98,,0,36.98,36.98,1,-63931,71733,135664,7802,0,0,2101,0,0,,2101,2101
15,04-11-18,44,10:45,11:00,36.98,,0,36.98,36.98,1,-61436,73842,135278,12406,0,0,555,0,0,,555,555
15,04-11-18,45,11:00,11:15,39.19,,0,39.19,39.19,1,-80140,72039,152179,-8101,0,0,2993,0,0,,2993,2993
15,04-11-18,46,11:15,11:30,38.92,,0,38.92,38.92,1,-89076,83018,172094,-6058,0,0,4593,0,0,,4593,4593
15,04-11-18,47,11:30,11:45,38.72,,0,38.72,38.72,1,-97340,86940,184280,-10400,0,0,5323,0,0,,5323,5323
15,04-11-18,48,11:45,12:00,38.65,,0,38.65,38.65,1,-101970,84749,186719,-17221,0,0,8966,0,0,,8966,8966
15,04-11-18,49,12:00,12:15,100.52,,0,100.52,100.52,1,-117958,60263,178221,-57695,0,0,31715,0,0,,31715,31715
15,04-11-18,50,12:15,12:30,47.17,,0,47.17,47.17,1,-110425,77455,187880,-32970,0,0,37810,0,0,,37810,37810
15,04-11-18,51,12:30,12:45,40.98,34.94,0,40.98,34.94,2,-104461,88967,193428,-15494,0,-81,11112,0,0,,11193,11031
15,04-11-18,52,12:45,13:00,42.78,,0,42.78,42.78,1,-107553,89289,196842,-18264,0,0,12714,0,0,,12714,12714
15,04-11-18,53,13:00,13:15,44.93,,0,44.93,44.93,1,-102529,78121,180650,-24408,0,0,12311,0,0,,12311,12311
15,04-11-18,54,13:15,13:30,47.17,,0,47.17,47.17,1,-107929,66996,174925,-40933,0,0,28153,0,0,,28153,28153
15,04-11-18,55,13:30,13:45,47.17,,0,47.17,47.17,1,-105186,69288,174474,-35898,0,0,35947,0,0,,35947,35947
15,04-11-18,56,13:45,14:00,41.74,,0,41.74,41.74,1,-82214,65004,147218,-17210,0,0,28066,0,0,,28066,28066
15,04-11-18,57,14:00,14:15,36.98,12.66,0,36.98,12.66,2,-74674,93437,168111,18763,0,-7906,3666,0,0,,11572,-4240
15,04-11-18,58,14:15,14:30,47.17,12.66,0,47.17,47.17,1,-112277,95479,207756,-16798,0,-479,8567,0,0,,9046,8088
15,04-11-18,59,14:30,14:45,36.98,,0,36.98,36.98,1,-93148,91270,184418,-1878,0,0,1535,0,0,,1535,1535
15,04-11-18,60,14:45,15:00,37.93,,0,37.93,37.93,1,-91280,90006,181286,-1274,0,0,1596,0,0,,1596,1596
15,04-11-18,61,15:00,15:15,38.1,,0,38.1,38.1,1,-84197,66486,150683,-17711,0,0,5162,0,0,,5162,5162
15,04-11-18,62,15:15,15:30,36.98,,0,36.98,36.98,1,-74693,71796,146489,-2897,0,0,2503,0,0,,2503,2503
15,04-11-18,63,15:30,15:45,36.98,,0,36.98,36.98,1,-65224,60122,125346,-5102,0,0,916,0,0,,916,916
15,04-11-18,64,15:45,16:00,36.98,32.98,0,36.98,32.98,2,-45015,50391,95406,5376,0,-103,1399,0,0,,1502,1296
15,04-11-18,65,16:00,16:15,36.98,21.68,0,21.68,21.68,-1,-40925,77249,118174,36324,0,-15931,17,0,0,,15948,-15914
15,04-11-18,66,16:15,16:30,,32.98,0,32.98,32.98,-1,-41782,71398,113180,29616,0,-3138,0,0,0,,3138,-3138
15,04-11-18,67,16:30,16:45,,28.98,0,28.98,28.98,-1,-45125,78511,123636,33386,0,-19940,0,0,0,,19940,-19940
15,04-11-18,68,16:45,17:00,,32.98,0,32.98,32.98,-1,-64518,72365,136883,7847,0,-19026,0,0,0,,19026,-19026
15,04-11-18,69,17:00,17:15,,-150.03,0,-150.03,-150.03,-1,-34382,167253,201635,132871,0,-51181,0,0,0,,51181,-51181
15,04-11-18,70,17:15,17:30,,23.17,0,23.17,23.17,-1,-57180,107325,164505,50145,0,-26455,0,0,0,,26455,-26455
15,04-11-18,71,17:30,17:45,,31.83,0,31.83,31.83,-1,-55634,116996,172630,61362,0,-23948,0,0,0,,23948,-23948
15,04-11-18,72,17:45,18:00,,,0,35.83,35.83,0,-36972,137293,174265,100321,0,-2447,0,0,0,,2447,-2447
15,04-11-18,73,18:00,18:15,,18.58,0,18.58,18.58,-1,-44196,55389,99585,11193,0,-5207,0,0,0,,5207,-5207
15,04-11-18,74,18:15,18:30,,11.75,0,11.75,11.75,-1,-42910,73340,116250,30430,0,-22130,0,0,0,,22130,-22130
15,04-11-18,75,18:30,18:45,,32.98,0,32.98,32.98,-1,-35363,88739,124102,53376,0,-9049,0,0,0,,9049,-9049
15,04-11-18,76,18:45,19:00,,,0,35.64,35.64,0,-35646,97145,132791,61499,0,-565,0,0,0,,565,-565
15,04-11-18,77,19:00,19:15,39.42,,0,39.42,39.42,1,-57916,33379,91295,-24537,0,0,1584,0,0,,1584,1584
15,04-11-18,78,19:15,19:30,34.28,,0,34.28,34.28,1,-56818,35408,92226,-21410,0,0,110,0,0,,110,110
15,04-11-18,79,19:30,19:45,34.24,,0,34.24,34.24,1,-63448,38212,101660,-25236,0,0,202,0,0,,202,202
15,04-11-18,80,19:45,20:00,34.2,,0,34.2,34.2,1,-68935,40933,109868,-28002,0,0,188,0,0,,188,188
15,04-11-18,81,20:00,20:15,,32.48,0,32.48,32.48,-1,-42578,59654,102232,17076,0,-5278,0,0,0,,5278,-5278
15,04-11-18,82,20:15,20:30,,34.83,0,34.83,34.83,-1,-42673,46115,88788,3442,0,-6159,0,0,0,,6159,-6159
15,04-11-18,83,20:30,20:45,36.98,35.25,0,36.98,36.98,1,-55212,42256,97468,-12956,0,-3024,356,0,0,,3380,-2668
15,04-11-18,84,20:45,21:00,40.98,35.25,0,40.98,40.98,1,-81749,51192,132941,-30557,0,-32,3564,0,0,,3596,3532
15,04-11-18,85,21:00,21:15,149.02,,0,149.02,149.02,1,-101690,22000,123690,-79690,0,0,45652,0,0,,45652,45652
15,04-11-18,86,21:15,21:30,57.46,,0,57.46,57.46,1,-55501,30681,86182,-24820,0,0,46225,0,0,,46225,46225
15,04-11-18,87,21:30,21:45,36.98,34.86,0,36.98,34.86,2,-51855,47361,99216,-4494,0,-387,3743,0,0,,4130,3356
15,04-11-18,88,21:45,22:00,36.98,32.98,0,32.98,32.98,-1,-65341,68109,133450,2768,0,-285,623,0,0,,908,338
15,04-11-18,89,22:00,22:15,,28.98,0,28.98,28.98,-1,-53643,79430,133073,25787,0,-9958,0,0,0,,9958,-9958
15,04-11-18,90,22:15,22:30,,28.98,0,28.98,28.98,-1,-45090,58177,103267,13087,0,-8791,0,0,0,,8791,-8791
15,04-11-18,91,22:30,22:45,,28.98,0,28.98,28.98,-1,-37969,65821,103790,27852,0,-17374,0,0,0,,17374,-17374
15,04-11-18,92,22:45,23:00,,23.17,0,23.17,23.17,-1,-56590,97023,153613,40433,0,-36945,0,0,0,,36945,-36945
15,04-11-18,93,23:00,23:15,151.38,28.03,0,151.38,151.38,1,-78383,32067,110450,-46316,0,-16671,11812,0,0,,28483,-4859
15,04-11-18,94,23:15,23:30,153.05,32.98,0,153.05,32.98,2,-51413,34798,86211,-16615,0,-64,33664,0,0,,33728,33600
15,04-11-18,95,23:30,23:45,153.05,11.75,0,11.75,11.75,-1,-35781,72174,107955,36393,0,-16772,918,0,0,,17690,-15854
15,04-11-18,96,23:45,0:00,,28.98,0,28.98,28.98,-1,-52898,74021,126919,21123,0,-29176,0,0,0,,29176,-29176
15,04-12-18,1,0:00,0:15,,28.76,0,28.76,28.76,-1,-40210,119099,159309,78889,0,-14011,0,0,0,,14011,-14011
15,04-12-18,2,0:15,0:30,36.76,32.76,0,36.76,23.26,2,-25068,39043,64111,13975,0,-472,17,0,0,,489,-455
15,04-12-18,3,0:30,0:45,,30.88,0,30.88,30.88,-1,-50984,41904,92888,-9080,0,-4833,0,0,0,,4833,-4833
15,04-12-18,4,0:45,1:00,,,0,35.32,35.32,0,-83519,48380,131899,-35139,0,0,0,0,0,,0,0
15,04-12-18,5,1:00,1:15,64,,0,64,64,1,-98308,48709,147017,-49599,0,0,19130,0,0,,19130,19130
15,04-12-18,6,1:15,1:30,60.87,,0,60.87,60.87,1,-92905,31892,124797,-61013,0,0,55628,0,0,,55628,55628
15,04-12-18,7,1:30,1:45,46.43,,0,46.43,46.43,1,-81471,35603,117074,-45868,0,0,42438,0,0,,42438,42438
15,04-12-18,8,1:45,2:00,36.76,35.05,0,36.76,35.05,2,-50686,33458,84144,-17228,0,-102,15994,0,0,,16096,15892
15,04-12-18,9,2:00,2:15,40.76,,0,40.76,40.76,1,-62805,52107,114912,-10698,0,0,5930,0,0,,5930,5930
15,04-12-18,10,2:15,2:30,46,,0,46,46,1,-74448,36920,111368,-37528,0,0,27060,0,0,,27060,27060
15,04-12-18,11,2:30,2:45,,,0,34.39,34.39,0,-59468,30140,89608,-29328,0,0,6960,0,0,,6960,6960
15,04-12-18,12,2:45,3:00,,32.76,0,32.76,32.76,-1,-55918,26970,82888,-28948,0,-376,0,0,0,,376,-376
15,04-12-18,13,3:00,3:15,37.12,32.76,0,37.12,32.76,2,-57283,61621,118904,4338,0,-1269,775,0,0,,2044,-494
15,04-12-18,14,3:15,3:30,40.76,,0,40.76,40.76,1,-48317,37325,85642,-10992,0,0,6236,0,0,,6236,6236
15,04-12-18,15,3:30,3:45,36.1,,0,36.1,36.1,1,-40737,40080,80817,-657,0,0,1399,0,0,,1399,1399
15,04-12-18,16,3:45,4:00,36.1,33.78,0,33.78,33.78,-1,-33781,42260,76041,8479,0,-924,285,0,0,,1209,-639
15,04-12-18,17,4:00,4:15,,35.1,0,35.1,35.1,-1,-56382,36462,92844,-19920,0,-1151,0,0,0,,1151,-1151
15,04-12-18,18,4:15,4:30,,,0,34.11,34.11,0,-63406,36423,99829,-26983,0,0,0,0,0,,0,0
15,04-12-18,19,4:30,4:45,,,0,34.09,34.09,0,-72021,29743,101764,-42278,0,0,0,0,0,,0,0
15,04-12-18,20,4:45,5:00,,,0,34.45,34.45,0,-68970,28479,97449,-40491,0,0,0,0,0,,0,0
15,04-12-18,21,5:00,5:15,,35.96,0,35.96,35.96,-1,-69187,57457,126644,-11730,0,-122,0,0,0,,122,-122
15,04-12-18,22,5:15,5:30,,35.53,0,35.53,35.53,-1,-57652,31198,88850,-26454,0,-168,0,0,0,,168,-168
15,04-12-18,23,5:30,5:45,59.99,,0,59.99,59.99,1,-92668,21707,114375,-70961,0,0,9578,0,0,,9578,9578
15,04-12-18,24,5:45,6:00,60.73,,0,60.73,60.73,1,-98824,71745,170569,-27079,0,0,32432,0,0,,32432,32432
15,04-12-18,25,6:00,6:15,142.12,,0,142.12,142.12,1,-205457,44668,250125,-160789,0,0,68328,0,0,,68328,68328
15,04-12-18,26,6:15,6:30,57.23,,0,57.23,57.23,1,-56957,36196,93153,-20761,0,0,42938,0,0,,42938,42938
15,04-12-18,27,6:30,6:45,36.76,,0,36.76,36.76,1,-57814,60969,118783,3155,0,0,1966,0,0,,1966,1966
15,04-12-18,28,6:45,7:00,,,0,34.23,34.23,0,-47806,83590,131396,35784,0,0,0,0,0,,0,0
15,04-12-18,29,7:00,7:15,,-8.69,0,-8.69,-8.69,-1,-41076,112240,153316,71164,0,-23091,0,0,0,,23091,-23091
15,04-12-18,30,7:15,7:30,,34.09,0,34.09,34.09,-1,-41152,70706,111858,29554,0,-2446,0,0,0,,2446,-2446
15,04-12-18,31,7:30,7:45,47.59,,0,47.59,47.59,1,-75507,59327,134834,-16180,0,0,3707,0,0,,3707,3707
15,04-12-18,32,7:45,8:00,47.59,,0,47.59,47.59,1,-77154,75663,152817,-1491,0,0,14407,0,0,,14407,14407
15,04-12-18,33,8:00,8:15,47.59,10.41,0,47.59,10.41,2,-45565,66562,112127,20997,0,-9488,2508,0,0,,11996,-6980
15,04-12-18,34,8:15,8:30,61.56,,0,61.56,61.56,1,-57598,51067,108665,-6531,0,0,11369,0,0,,11369,11369
15,04-12-18,35,8:30,8:45,41.35,,0,41.35,41.35,1,-75562,61401,136963,-14161,0,0,2252,0,0,,2252,2252
15,04-12-18,36,8:45,9:00,67.12,,0,67.12,67.12,1,-103955,52980,156935,-50975,0,0,36520,0,0,,36520,36520
15,04-12-18,37,9:00,9:15,62.44,,0,62.44,62.44,1,-85458,21565,107023,-63893,0,0,52333,0,0,,52333,52333
15,04-12-18,38,9:15,9:30,62.44,,0,62.44,62.44,1,-100655,30820,131475,-69835,0,0,62405,0,0,,62405,62405
15,04-12-18,39,9:30,9:45,62.44,,0,62.44,62.44,1,-105282,29915,135197,-75367,0,0,67722,0,0,,67722,67722
15,04-12-18,40,9:45,10:00,134.38,,0,134.38,134.38,1,-123460,24707,148167,-98753,0,0,78526,0,0,,78526,78526
15,04-12-18,41,10:00,10:15,97.71,,0,97.71,97.71,1,-129217,31092,160309,-98125,0,0,89594,0,0,,89594,89594
15,04-12-18,42,10:15,10:30,76.12,,0,76.12,76.12,1,-114944,27350,142294,-87594,0,0,85094,0,0,,85094,85094
15,04-12-18,43,10:30,10:45,60.94,,0,60.94,60.94,1,-100835,44276,145111,-56559,0,0,70852,0,0,,70852,70852
15,04-12-18,44,10:45,11:00,54.26,,0,54.26,54.26,1,-86764,46431,133195,-40333,0,0,39309,0,0,,39309,39309
15,04-12-18,45,11:00,11:15,237.12,,0,237.12,237.12,1,-144563,38137,182700,-106426,0,0,73039,0,0,,73039,73039
15,04-12-18,46,11:15,11:30,69.92,,0,69.92,69.92,1,-113544,38160,151704,-75384,0,0,73483,0,0,,73483,73483
15,04-12-18,47,11:30,11:45,60.12,,0,60.12,60.12,1,-109747,40007,149754,-69740,0,0,63892,0,0,,63892,63892
15,04-12-18,48,11:45,12:00,54.76,,0,54.76,54.76,1,-103353,39680,143033,-63673,0,0,62685,0,0,,62685,62685
15,04-12-18,49,12:00,12:15,67.43,,0,67.43,67.43,1,-126182,47740,173922,-78442,0,0,68578,0,0,,68578,68578
15,04-12-18,50,12:15,12:30,53.12,,0,53.12,53.12,1,-112426,49305,161731,-63121,0,0,66615,0,0,,66615,66615
15,04-12-18,51,12:30,12:45,47.54,,0,47.54,47.54,1,-106024,59262,165286,-46762,0,0,50617,0,0,,50617,50617
15,04-12-18,52,12:45,13:00,41.98,,0,41.98,41.98,1,-81922,62994,144916,-18928,0,0,27008,0,0,,27008,27008
15,04-12-18,53,13:00,13:15,237.12,,0,237.12,237.12,1,-124178,46950,171128,-77228,0,0,35984,0,0,,35984,35984
15,04-12-18,54,13:15,13:30,237.12,,0,237.12,237.12,1,-133499,49911,183410,-83588,0,0,87128,0,0,,87128,87128
15,04-12-18,55,13:30,13:45,60.12,,0,60.12,60.12,1,-143336,62218,205554,-81118,0,0,76628,0,0,,76628,76628
15,04-12-18,56,13:45,14:00,60.12,,0,60.12,60.12,1,-146901,58314,205215,-88587,0,0,78285,0,0,,78285,78285
15,04-12-18,57,14:00,14:15,148.12,,0,148.12,148.12,1,-162136,45928,208064,-116208,0,0,97719,0,0,,97719,97719
15,04-12-18,58,14:15,14:30,142,,0,142,142,1,-151690,48069,199759,-103621,0,0,97088,12500,0,,109588,109588
15,04-12-18,59,14:30,14:45,60.12,,0,60.12,60.12,1,-148658,72499,221157,-76159,0,0,77961,0,0,,77961,77961
15,04-12-18,60,14:45,15:00,51.23,,0,51.23,51.23,1,-151746,79977,231723,-71769,0,0,57351,0,0,,57351,57351
15,04-12-18,61,15:00,15:15,60.12,,0,60.12,60.12,1,-137687,49823,187510,-87864,0,0,42764,0,0,,42764,42764
15,04-12-18,62,15:15,15:30,72.46,,0,72.46,72.46,1,-148387,54286,202673,-94101,0,0,57862,0,0,,57862,57862
15,04-12-18,63,15:30,15:45,72.46,,0,72.46,72.46,1,-151640,62726,214366,-88914,0,0,68490,0,0,,68490,68490
15,04-12-18,64,15:45,16:00,60.12,,0,60.12,60.12,1,-138794,64136,202930,-74658,0,0,70726,0,0,,70726,70726
15,04-12-18,65,16:00,16:15,60.12,-19.42,0,-19.42,-19.42,-1,-81591,129046,210637,47455,0,-8772,23718,0,0,,32490,14946
15,04-12-18,66,16:15,16:30,41.35,35.62,0,41.35,35.62,2,-82537,71435,153972,-11102,0,-3028,790,0,0,,3818,-2238
15,04-12-18,67,16:30,16:45,,39.48,0,39.48,39.48,-1,-94281,108670,202951,14389,0,-552,0,0,0,,552,-552
15,04-12-18,68,16:45,17:00,41.07,39.48,0,41.07,41.07,1,-107768,110875,218643,3107,0,-82,223,0,0,,305,141
15,04-12-18,69,17:00,17:15,61.18,,0,61.18,61.18,1,-100521,32904,133425,-67617,0,0,22989,0,0,,22989,22989
15,04-12-18,70,17:15,17:30,61.18,,0,61.18,61.18,1,-102638,48067,150705,-54571,0,0,40663,0,0,,40663,40663
15,04-12-18,71,17:30,17:45,84.12,,0,84.12,84.12,1,-127082,57003,184085,-70079,0,0,55800,0,0,,55800,55800
15,04-12-18,72,17:45,18:00,61.74,,0,61.74,61.74,1,-132489,60973,193462,-71516,0,0,66330,0,0,,66330,66330
15,04-12-18,73,18:00,18:15,42.2,,0,42.2,42.2,1,-103173,61941,165114,-41232,0,0,28698,0,0,,28698,28698
15,04-12-18,74,18:15,18:30,47.54,,0,47.54,47.54,1,-100787,66456,167243,-34331,0,0,16422,0,0,,16422,16422
15,04-12-18,75,18:30,18:45,47.54,,0,47.54,47.54,1,-100395,63571,163966,-36824,0,0,28098,0,0,,28098,28098
15,04-12-18,76,18:45,19:00,47.54,,0,47.54,47.54,1,-94552,57392,151944,-37160,0,0,29080,0,0,,29080,29080
15,04-12-18,77,19:00,19:15,42.71,,0,42.71,42.71,1,-79607,44648,124255,-34959,0,0,25557,0,0,,25557,25557
15,04-12-18,78,19:15,19:30,42.71,,0,42.71,42.71,1,-76440,44695,121135,-31745,0,0,19733,0,0,,19733,19733
15,04-12-18,79,19:30,19:45,47.54,,0,47.54,47.54,1,-82069,42345,124414,-39724,0,0,30608,0,0,,30608,30608
15,04-12-18,80,19:45,20:00,47.54,,0,47.54,47.54,1,-76772,42497,119269,-34275,0,0,36765,0,0,,36765,36765
15,04-12-18,81,20:00,20:15,41.35,,0,41.35,41.35,1,-61044,38157,99201,-22887,0,0,15360,0,0,,15360,15360
15,04-12-18,82,20:15,20:30,35.77,,0,35.77,35.77,1,-66750,23962,90712,-42788,0,0,972,0,0,,972,972
15,04-12-18,83,20:30,20:45,56.92,,0,56.92,56.92,1,-91514,17645,109159,-73869,0,0,15152,0,0,,15152,15152
15,04-12-18,84,20:45,21:00,84.12,,0,84.12,84.12,1,-134862,13082,147944,-121780,0,0,51272,0,0,,51272,51272
15,04-12-18,85,21:00,21:15,77.12,,0,77.12,77.12,1,-96938,38783,135721,-58155,0,0,60649,0,0,,60649,60649
15,04-12-18,86,21:15,21:30,47.54,,0,47.54,47.54,1,-55517,32015,87532,-23502,0,0,34296,0,0,,34296,34296
15,04-12-18,87,21:30,21:45,41.29,,0,41.29,41.29,1,-46696,32481,79177,-14215,0,0,2926,0,0,,2926,2926
15,04-12-18,88,21:45,22:00,37.35,36.41,0,37.35,24.79,2,-35702,44003,79705,8301,0,-906,2444,0,0,,3350,1538
15,04-12-18,89,22:00,22:15,253.12,39.53,0,253.12,24.77,2,-111023,24070,135093,-86953,0,-29,25652,0,0,,25681,25623
15,04-12-18,90,22:15,22:30,62.07,32.88,0,32.88,32.88,-1,-44624,38358,82982,-6266,0,-61,35607,0,0,,35668,35546
15,04-12-18,91,22:30,22:45,62.07,23.54,0,23.54,23.54,-1,-24081,49709,73790,25628,0,-17388,93,0,0,,17481,-17295
15,04-12-18,92,22:45,23:00,,18.48,0,18.48,18.48,-1,-46777,86931,133708,40154,0,-10165,0,0,0,,10165,-10165
15,04-12-18,93,23:00,23:15,74.01,-0.78,0,74.01,-0.78,2,-73529,32834,106363,-40695,0,-8874,8659,0,0,,17533,-215
15,04-12-18,94,23:15,23:30,41.35,36.34,0,36.34,36.34,-1,-55935,48281,104216,-7654,0,-3,4062,0,0,,4065,4059
15,04-12-18,95,23:30,23:45,,33.35,0,33.35,33.35,-1,-52708,59545,112253,6837,0,-356,0,0,0,,356,-356
15,04-12-18,96,23:45,0:00,,29.35,0,29.35,29.35,-1,-41705,42172,83877,467,0,-4078,0,0,0,,4078,-4078
15,04/13/2018,1,0:00,0:15,44.33,-7.38,0,44.33,-7.38,2,-63482,89709,153191,26227,0,-23931,118,0,0,,24049,-23813
15,04/13/2018,2,0:15,0:30,83.87,32.78,0,83.87,22.89,2,-59393,42178,101571,-17215,0,-522,10714,0,0,,11236,10192
15,04/13/2018,3,0:30,0:45,47.48,32.78,0,47.48,23.09,2,-65301,41700,107001,-23601,0,-579,2130,0,0,,2709,1551
15,04/13/2018,4,0:45,1:00,62.39,,0,62.39,62.39,1,-109051,73008,182059,-36043,0,0,35243,0,0,,35243,35243
15,04/13/2018,5,1:00,1:15,66.36,,0,66.36,66.36,1,-66907,15873,82780,-51034,0,0,26834,0,0,,26834,26834
15,04/13/2018,6,1:15,1:30,66.34,32.92,0,32.92,32.92,-1,-43696,34774,78470,-8922,0,-128,31984,0,0,,32112,31856
15,04/13/2018,7,1:30,1:45,36.78,26.33,0,36.97,26.33,2,-33638,29454,63092,-4184,0,-3128,1786,0,0,,4914,-1342
15,04/13/2018,8,1:45,2:00,36.78,36.26,0,36.98,36.26,2,-44450,30266,74716,-14184,0,-299,416,0,0,,715,117
15,04/13/2018,9,2:00,2:15,40.78,,0,40.78,40.78,1,-53293,57228,110521,3935,0,0,3456,0,0,,3456,3456
15,04/13/2018,10,2:15,2:30,40.78,32.78,0,32.78,32.78,-1,-41616,52170,93786,10554,0,-2253,68,0,0,,2321,-2185
15,04/13/2018,11,2:30,2:45,,32.78,0,32.78,32.78,-1,-34784,48335,83119,13551,0,-3950,0,0,0,,3950,-3950
15,04/13/2018,12,2:45,3:00,,26.48,0,26.48,26.48,-1,-35836,54915,90751,19079,0,-14672,0,0,0,,14672,-14672
15,04/13/2018,13,3:00,3:15,,30.04,0,30.04,30.04,-1,-18955,43425,62380,24470,0,-17151,0,0,0,,17151,-17151
15,04/13/2018,14,3:15,3:30,34.41,32.78,0,34.41,34.41,1,-39153,39476,78629,323,0,-13257,3,0,0,,13260,-13254
15,04/13/2018,15,3:30,3:45,36.78,32.78,0,36.78,36.78,1,-57807,47996,105803,-9811,0,-697,554,0,0,,1251,-143
15,04/13/2018,16,3:45,4:00,,32.78,0,32.78,32.78,-1,-58826,60573,119399,1747,0,-397,0,0,0,,397,-397
15,04/13/2018,17,4:00,4:15,,29.35,0,29.35,29.35,-1,-13203,79414,92617,66211,0,-1144,0,0,0,,1144,-1144
15,04/13/2018,18,4:15,4:30,,28.78,0,28.78,28.78,-1,-15860,97435,113295,81575,0,-10323,0,0,0,,10323,-10323
15,04/13/2018,19,4:30,4:45,,28.3,0,28.3,28.3,-1,-35385,97502,132887,62117,0,-6634,0,0,0,,6634,-6634
15,04/13/2018,20,4:45,5:00,,32.78,0,32.78,32.78,-1,-37077,86194,123271,49117,0,-7143,0,0,0,,7143,-7143
15,04/13/2018,21,5:00,5:15,,23.43,0,23.43,23.43,-1,-49013,98134,147147,49121,0,-26664,0,0,0,,26664,-26664
15,04/13/2018,22,5:15,5:30,,28.81,0,28.81,28.81,-1,-43754,95084,138838,51330,0,-40092,0,0,0,,40092,-40092
15,04/13/2018,23,5:30,5:45,,28.78,0,28.78,28.78,-1,-47176,79469,126645,32293,0,-36025,0,0,0,,36025,-36025
15,04/13/2018,24,5:45,6:00,36.78,35.85,0,36.78,35.45,2,-41247,82072,123319,40825,0,-5746,265,0,0,,6011,-5481
15,04/13/2018,25,6:00,6:15,,31.51,0,31.51,31.51,-1,-97670,102190,199860,4520,0,-6952,0,0,0,,6952,-6952
15,04/13/2018,26,6:15,6:30,,,0,35.83,35.83,0,-52390,62566,114956,10176,0,-394,0,0,0,,394,-394
15,04/13/2018,27,6:30,6:45,40.96,,0,40.96,40.96,1,-67245,58649,125894,-8596,0,0,755,0,0,,755,755
15,04/13/2018,28,6:45,7:00,41.52,,0,41.52,41.52,1,-78652,60005,138657,-18647,0,0,4599,0,0,,4599,4599
15,04/13/2018,29,7:00,7:15,35.34,-3.59,0,36.29,-3.59,2,-40289,108579,148868,68290,0,-26869,809,0,0,,27678,-26060
15,04/13/2018,30,7:15,7:30,,23.56,0,23.56,23.56,-1,-40925,79863,120788,38938,0,-43528,0,0,0,,43528,-43528
15,04/13/2018,31,7:30,7:45,52.43,29.47,0,52.43,52.43,1,-69738,59676,129414,-10062,0,-23449,1141,0,0,,24590,-22308
15,04/13/2018,32,7:45,8:00,99.22,29.47,0,99.22,99.22,1,-92614,47385,139999,-45229,0,-219,37995,0,0,,38214,37776
15,04/13/2018,33,8:00,8:15,99.22,31.6,0,31.6,31.6,-1,-79724,99442,179166,19718,0,-5068,12853,0,0,,17921,7785
15,04/13/2018,34,8:15,8:30,,27.43,0,27.43,27.43,-1,-61043,102939,163982,41896,0,-19219,0,0,0,,19219,-19219
15,04/13/2018,35,8:30,8:45,,32.24,0,32.24,32.24,-1,-68756,107543,176299,38787,0,-32548,0,0,0,,32548,-32548
15,04/13/2018,36,8:45,9:00,,,0,37.85,37.85,0,-75108,98005,173113,22897,0,-6695,0,0,0,,6695,-6695
15,04/13/2018,37,9:00,9:15,39.74,33.41,0,33.41,33.41,-1,-42510,77578,120088,35068,0,-1059,11,0,0,,1070,-1048
15,04/13/2018,38,9:15,9:30,,23.56,0,23.56,23.56,-1,-44072,99155,143227,55083,0,-28411,0,0,0,,28411,-28411
15,04/13/2018,39,9:30,9:45,,33.23,0,33.23,33.23,-1,-48159,119534,167693,71375,0,-16813,0,0,0,,16813,-16813
15,04/13/2018,40,9:45,10:00,,29.47,0,29.47,29.47,-1,-27137,134885,162022,107748,0,-25890,0,0,0,,25890,-25890
15,04/13/2018,41,10:00,10:15,,35.03,0,35.03,35.03,-1,-56087,160386,216473,104299,0,-9828,0,0,0,,9828,-9828
15,04/13/2018,42,10:15,10:30,,34.8,0,34.8,34.8,-1,-48394,197553,245947,149159,0,-92,0,0,0,,92,-92
15,04/13/2018,43,10:30,10:45,,33.41,0,33.41,33.41,-1,-47232,197138,244370,149906,0,-965,0,0,0,,965,-965
15,04/13/2018,44,10:45,11:00,,29.47,0,29.47,29.47,-1,-47421,197261,244682,149840,0,-4022,0,0,0,,4022,-4022
15,04/13/2018,45,11:00,11:15,,34.43,0,34.43,34.43,-1,-49086,157159,206245,108073,0,-5736,0,0,0,,5736,-5736
15,04/13/2018,46,11:15,11:30,,,0,38.21,38.21,0,-49206,167069,216275,117863,0,0,0,0,0,,0,0
15,04/13/2018,47,11:30,11:45,,,0,38.21,38.21,0,-49177,171632,220809,122455,0,0,0,0,0,,0,0
15,04/13/2018,48,11:45,12:00,,,0,38.21,38.21,0,-48278,181602,229880,133324,0,0,0,0,0,,0,0
15,04/13/2018,49,12:00,12:15,,37.02,0,37.02,37.02,-1,-55831,156145,211976,100314,0,-20,0,0,0,,20,-20
15,04/13/2018,50,12:15,12:30,,-12.38,0,-12.38,-12.38,-1,-51588,150639,202227,99051,0,-20323,0,0,0,,20323,-20323
15,04/13/2018,51,12:30,12:45,,27.03,0,27.03,27.03,-1,-48619,126945,175564,78326,0,-24650,0,0,0,,24650,-24650
15,04/13/2018,52,12:45,13:00,,25.2,0,25.2,25.2,-1,-58711,147326,206037,88615,0,-16112,0,0,0,,16112,-16112
15,04/13/2018,53,13:00,13:15,39.04,32.8,0,39.04,39.04,1,-78514,86549,165063,8035,0,-14054,618,0,0,,14672,-13436
15,04/13/2018,54,13:15,13:30,40.64,32.8,0,40.64,40.64,1,-87169,66792,153961,-20377,0,-131,2751,0,0,,2882,2620
15,04/13/2018,55,13:30,13:45,41.56,,0,41.56,41.56,1,-91700,64985,156685,-26715,0,0,5139,0,0,,5139,5139
15,04/13/2018,56,13:45,14:00,37.44,,0,37.44,37.44,1,-90120,72147,162267,-17973,0,0,1623,0,0,,1623,1623
15,04/13/2018,57,14:00,14:15,42.89,38.12,0,42.89,36.69,2,-70531,55935,126466,-14596,0,-72,3063,0,0,,3135,2991
15,04/13/2018,58,14:15,14:30,42.02,,0,42.02,42.02,1,-88108,66359,154467,-21749,0,0,9547,0,0,,9547,9547
15,04/13/2018,59,14:30,14:45,37.44,,0,37.44,37.44,1,-89642,64943,154585,-24699,0,0,2065,0,0,,2065,2065
15,04/13/2018,60,14:45,15:00,34.23,,0,34.23,34.23,1,-101334,71590,172924,-29744,0,0,541,0,0,,541,541
15,04/13/2018,61,15:00,15:15,,35.59,0,35.59,35.59,-1,-63479,95858,159337,32379,0,-956,0,0,0,,956,-956
15,04/13/2018,62,15:15,15:30,,36.56,0,36.56,36.56,-1,-61107,81207,142314,20100,0,-1317,0,0,0,,1317,-1317
15,04/13/2018,63,15:30,15:45,,,0,35.8,35.8,0,-72291,75496,147787,3205,0,-203,0,0,0,,203,-203
15,04/13/2018,64,15:45,16:00,,36.31,0,36.31,36.31,-1,-71950,69274,141224,-2676,0,-1781,0,0,0,,1781,-1781
15,04/13/2018,65,16:00,16:15,,36.86,0,36.86,36.86,-1,-83152,74781,157933,-8371,0,-1078,0,0,0,,1078,-1078
15,04/13/2018,66,16:15,16:30,,,0,35.74,35.74,0,-76177,75630,151807,-547,0,0,0,0,0,,0,0
15,04/13/2018,67,16:30,16:45,,,0,35.74,35.74,0,-74222,70407,144629,-3815,0,0,0,0,0,,0,0
15,04/13/2018,68,16:45,17:00,37.44,,0,37.44,37.44,1,-81099,65173,146272,-15926,0,0,2355,0,0,,2355,2355
15,04/13/2018,69,17:00,17:15,37.44,36.1,0,36.1,36.1,-1,-49500,94576,144076,45076,0,-583,248,0,0,,831,-335
15,04/13/2018,70,17:15,17:30,42.4,,0,42.4,42.4,1,-88272,59088,147360,-29184,0,0,13455,0,0,,13455,13455
15,04/13/2018,71,17:30,17:45,39.45,37.23,0,37.23,37.23,-1,-50787,62172,112959,11385,0,-99,9607,0,0,,9706,9508
15,04/13/2018,72,17:45,18:00,39.45,37.23,0,37.23,37.23,-1,-44154,78763,122917,34609,0,-1128,4,0,0,,1132,-1124
15,04/13/2018,73,18:00,18:15,,36.1,0,36.1,36.1,-1,-102007,94011,196018,-7996,0,-111,0,0,0,,111,-111
15,04/13/2018,74,18:15,18:30,,34.23,0,34.23,34.23,-1,-60590,95186,155776,34596,0,-2682,0,0,0,,2682,-2682
15,04/13/2018,75,18:30,18:45,,34.03,0,34.03,34.03,-1,-46469,85803,132272,39334,0,-6071,0,0,0,,6071,-6071
15,04/13/2018,76,18:45,19:00,,34.03,0,34.03,34.03,-1,-41708,79534,121242,37826,0,-7941,0,0,0,,7941,-7941
15,04/13/2018,77,19:00,19:15,,36.88,0,36.88,36.88,-1,-59948,71452,131400,11504,0,-1382,0,0,0,,1382,-1382
15,04/13/2018,78,19:15,19:30,,35.61,0,35.61,35.61,-1,-43910,68120,112030,24210,0,-1970,0,0,0,,1970,-1970
15,04/13/2018,79,19:30,19:45,,33.41,0,33.41,33.41,-1,-41119,69041,110160,27922,0,-10779,0,0,0,,10779,-10779
15,04/13/2018,80,19:45,20:00,,36.01,0,36.01,36.01,-1,-48919,76576,125495,27657,0,-15389,0,0,0,,15389,-15389
15,04/13/2018,81,20:00,20:15,,18.59,0,18.59,18.59,-1,-36230,94554,130784,58324,0,-36838,0,0,0,,36838,-36838
15,04/13/2018,82,20:15,20:30,,34.23,0,34.23,34.23,-1,-23487,61184,84671,37697,0,-15252,0,0,0,,15252,-15252
15,04/13/2018,83,20:30,20:45,,33.41,0,33.41,33.41,-1,-25504,52787,78291,27283,0,-13678,0,0,0,,13678,-13678
15,04/13/2018,84,20:45,21:00,,36.1,0,36.1,36.1,-1,-47642,38127,85769,-9515,0,-7191,0,0,0,,7191,-7191
15,04/13/2018,85,21:00,21:15,,,0,37.55,37.55,0,-46683,61559,108242,14876,0,-47,0,0,0,,47,-47
15,04/13/2018,86,21:15,21:30,,33.41,0,33.41,33.41,-1,-25263,53461,78724,28198,0,-1795,0,0,0,,1795,-1795
15,04/13/2018,87,21:30,21:45,,19.72,0,19.72,19.72,-1,-25851,77612,103463,51761,0,-18622,0,0,0,,18622,-18622
15,04/13/2018,88,21:45,22:00,,22.81,0,22.81,22.81,-1,-32103,91528,123631,59425,0,-46000,0,0,0,,46000,-46000
15,04/13/2018,89,22:00,22:15,41.56,31.92,0,41.56,41.56,1,-56648,41861,98509,-14787,0,-22691,371,0,0,,23062,-22320
15,04/13/2018,90,22:15,22:30,41.56,29.47,0,29.47,29.47,-1,-33182,65277,98459,32095,0,-14332,52,0,0,,14384,-14280
15,04/13/2018,91,22:30,22:45,,23.56,0,23.56,23.56,-1,-29124,100408,129532,71284,0,-33246,0,0,0,,33246,-33246
15,04/13/2018,92,22:45,23:00,,11.56,0,11.56,11.56,-1,-27093,112772,139865,85679,0,-53013,0,0,0,,53013,-53013
15,04/13/2018,93,23:00,23:15,,29.47,0,29.47,29.47,-1,-47599,91454,139053,43855,0,-19923,0,0,0,,19923,-19923
15,04/13/2018,94,23:15,23:30,,33.41,0,33.41,33.41,-1,-37627,77795,115422,40168,0,-120,0,0,0,,120,-120
15,04/13/2018,95,23:30,23:45,,33.41,0,33.41,33.41,-1,-39121,114847,153968,75726,0,-546,0,0,0,,546,-546
15,04/13/2018,96,23:45,0:00,,29.67,0,29.67,29.67,-1,-61676,121248,182924,59572,0,-7299,0,0,0,,7299,-7299
16,04/14/2018,1,0:00,0:15,,,0,35.28,35.28,0,-36633,144367,181000,107734,0,-1295,0,0,0,,1295,-1295
16,04/14/2018,2,0:15,0:30,,32.96,0,32.96,32.96,-1,-23565,83237,106802,59672,0,-386,0,0,0,,386,-386
16,04/14/2018,3,0:30,0:45,,32.96,0,32.96,32.96,-1,-72107,61548,133655,-10559,0,-725,0,0,0,,725,-725
16,04/14/2018,4,0:45,1:00,,,0,35.56,35.56,0,-155797,36473,192270,-119324,0,0,0,0,0,,0,0
16,04/14/2018,5,1:00,1:15,,,0,35.37,35.37,0,-17063,59956,77019,42893,0,0,0,0,0,,0,0
16,04/14/2018,6,1:15,1:30,,35.56,0,35.56,35.56,-1,-28089,42314,70403,14225,0,-61,0,0,0,,61,-61
16,04/14/2018,7,1:30,1:45,,28.96,0,28.96,28.96,-1,-28568,55691,84259,27123,0,-5842,0,0,0,,5842,-5842
16,04/14/2018,8,1:45,2:00,,23.13,0,23.13,23.13,-1,-28626,65152,93778,36526,0,-32035,0,0,0,,32035,-32035
16,04/14/2018,9,2:00,2:15,,27.51,0,27.51,27.51,-1,-12520,36432,48952,23912,0,-21145,0,0,0,,21145,-21145
16,04/14/2018,10,2:15,2:30,,23.13,0,23.13,23.13,-1,-16376,45048,61424,28672,0,-4457,0,0,0,,4457,-4457
16,04/14/2018,11,2:30,2:45,,20.37,0,20.37,20.37,-1,-19105,67534,86639,48429,0,-26784,0,0,0,,26784,-26784
16,04/14/2018,12,2:45,3:00,,28.96,0,28.96,28.96,-1,-21530,68309,89839,46779,0,-28066,0,0,0,,28066,-28066
16,04/14/2018,13,3:00,3:15,,28.67,0,28.67,28.67,-1,-20001,57290,77291,37289,0,-16399,0,0,0,,16399,-16399
16,04/14/2018,14,3:15,3:30,,,0,35.43,35.43,0,-27933,59370,87303,31437,0,-121,0,0,0,,121,-121
16,04/14/2018,15,3:30,3:45,,23.13,0,23.13,23.13,-1,-27056,75341,102397,48285,0,-3084,0,0,0,,3084,-3084
16,04/14/2018,16,3:45,4:00,,20.56,0,20.56,20.56,-1,-20008,97071,117079,77063,0,-21991,0,0,0,,21991,-21991
16,04/14/2018,17,4:00,4:15,,20.6,0,20.6,20.6,-1,-29352,112763,142115,83411,0,-21547,0,0,0,,21547,-21547
16,04/14/2018,18,4:15,4:30,,,0,35.41,35.41,0,-31912,112059,143971,80147,0,-688,0,0,0,,688,-688
16,04/14/2018,19,4:30,4:45,,35.49,0,35.49,35.49,-1,-31932,100780,132712,68848,0,-27,0,0,0,,27,-27
16,04/14/2018,20,4:45,5:00,,35.46,0,35.46,35.46,-1,-31219,103457,134676,72238,0,-484,0,0,0,,484,-484
16,04/14/2018,21,5:00,5:15,,35.9,0,35.9,35.9,-1,-40519,105701,146220,65182,0,-333,0,0,0,,333,-333
16,04/14/2018,22,5:15,5:30,,32.96,0,32.96,32.96,-1,-25292,113376,138668,88084,0,-2301,0,0,0,,2301,-2301
16,04/14/2018,23,5:30,5:45,,35.55,0,35.55,35.55,-1,-30136,114621,144757,84485,0,-555,0,0,0,,555,-555
16,04/14/2018,24,5:45,6:00,,35.49,0,35.49,35.49,-1,-31364,126149,157513,94785,0,-19,0,0,0,,19,-19
16,04/14/2018,25,6:00,6:15,,33.2,0,33.2,33.2,-1,-22391,158255,180646,135864,0,-4114,0,0,0,,4114,-4114
16,04/14/2018,26,6:15,6:30,,33.2,0,33.2,33.2,-1,-19933,131697,151630,111764,0,-6141,0,0,0,,6141,-6141
16,04/14/2018,27,6:30,6:45,,20.67,0,20.67,20.67,-1,-16220,106112,122332,89892,0,-2519,0,0,0,,2519,-2519
16,04/14/2018,28,6:45,7:00,,12.38,0,12.38,12.38,-1,-24518,99206,123724,74688,0,-24593,0,0,0,,24593,-24593
16,04/14/2018,29,7:00,7:15,,29.2,0,29.2,29.2,-1,-41970,85599,127569,43629,0,-16166,0,0,0,,16166,-16166
16,04/14/2018,30,7:15,7:30,,37.32,0,37.32,37.32,-1,-44539,76423,120962,31884,0,-5224,0,0,0,,5224,-5224
16,04/14/2018,31,7:30,7:45,42.38,36.45,0,42.38,35.02,2,-59026,46924,105950,-12102,0,-675,829,0,0,,1504,154
16,04/14/2018,32,7:45,8:00,49.23,,0,49.23,49.23,1,-74791,49602,124393,-25189,0,0,10372,0,0,,10372,10372
16,04/14/2018,33,8:00,8:15,33.9,29.2,0,35.61,29.2,2,-23387,46184,69571,22797,0,-5255,2140,0,0,,7395,-3115
16,04/14/2018,34,8:15,8:30,,36.43,0,36.43,36.43,-1,-28017,27854,55871,-163,0,-2061,0,0,0,,2061,-2061
16,04/14/2018,35,8:30,8:45,45.2,,0,45.2,45.2,1,-53011,29502,82513,-23509,0,0,3854,0,0,,3854,3854
16,04/14/2018,36,8:45,9:00,55.04,,0,55.04,55.04,1,-85283,34777,120060,-50506,0,0,27566,0,0,,27566,27566
16,04/14/2018,37,9:00,9:15,42.38,33.39,0,42.38,33.39,2,-21294,39486,60780,18192,0,-994,14484,0,0,,15478,13490
16,04/14/2018,38,9:15,9:30,,,0,35.9,35.9,0,-44612,54546,99158,9934,0,-63,0,0,0,,63,-63
16,04/14/2018,39,9:30,9:45,42.02,,0,42.02,42.02,1,-60372,51931,112303,-8441,0,0,426,0,0,,426,426
16,04/14/2018,40,9:45,10:00,,29.2,0,29.2,29.2,-1,-52379,74555,126934,22176,0,-2436,0,0,0,,2436,-2436
16,04/14/2018,41,10:00,10:15,,23.5,0,23.5,23.5,-1,-71090,99817,170907,28727,0,-6326,0,0,0,,6326,-6326
16,04/14/2018,42,10:15,10:30,,29.2,0,29.2,29.2,-1,-62168,99793,161961,37625,0,-2492,0,0,0,,2492,-2492
16,04/14/2018,43,10:30,10:45,,23.5,0,23.5,23.5,-1,-67416,102228,169644,34812,0,-11402,0,0,0,,11402,-11402
16,04/14/2018,44,10:45,11:00,,23.5,0,23.5,23.5,-1,-58707,97615,156322,38908,0,-36676,0,0,0,,36676,-36676
16,04/14/2018,45,11:00,11:15,46.53,29.2,0,46.53,29.2,2,-90857,63575,154432,-27282,0,-15738,1483,0,0,,17221,-14255
16,04/14/2018,46,11:15,11:30,40,,0,40,40,1,-89138,68631,157769,-20507,0,0,1895,0,0,,1895,1895
16,04/14/2018,47,11:30,11:45,35.51,,0,35.51,35.51,1,-89781,74803,164584,-14978,0,0,1493,0,0,,1493,1493
16,04/14/2018,48,11:45,12:00,,33.2,0,33.2,33.2,-1,-77603,93187,170790,15584,0,-588,0,0,0,,588,-588
16,04/14/2018,49,12:00,12:15,,35.99,0,35.99,35.99,-1,-143923,57975,201898,-85948,0,-545,0,0,0,,545,-545
16,04/14/2018,50,12:15,12:30,,,0,35.67,35.67,0,-129924,65779,195703,-64145,0,0,0,0,0,,0,0
16,04/14/2018,51,12:30,12:45,61.33,,0,61.33,61.33,1,-114823,64536,179359,-50287,0,0,12619,0,0,,12619,12619
16,04/14/2018,52,12:45,13:00,42.38,,0,42.38,42.38,1,-115071,63113,178184,-51958,0,0,19471,0,0,,19471,19471
16,04/14/2018,53,13:00,13:15,42.38,33.68,0,33.68,33.68,-1,-54735,120355,175090,65620,0,-667,4820,0,0,,5487,4153
16,04/14/2018,54,13:15,13:30,,29.2,0,29.2,29.2,-1,-71952,99801,171753,27849,0,-387,0,0,0,,387,-387
16,04/14/2018,55,13:30,13:45,,23.5,0,23.5,23.5,-1,-56395,107945,164340,51550,0,-4536,0,0,0,,4536,-4536
16,04/14/2018,56,13:45,14:00,,5.97,0,5.97,5.97,-1,-49440,98592,148032,49152,0,-43839,0,0,0,,43839,-43839
16,04/14/2018,57,14:00,14:15,,29.2,0,29.2,29.2,-1,-57413,69517,126930,12104,0,-19164,0,0,0,,19164,-19164
16,04/14/2018,58,14:15,14:30,,24.65,0,24.65,24.65,-1,-47194,85696,132890,38502,0,-1277,0,0,0,,1277,-1277
16,04/14/2018,59,14:30,14:45,,21.19,0,21.19,21.19,-1,-40599,84852,125451,44253,0,-31572,0,0,0,,31572,-31572
16,04/14/2018,60,14:45,15:00,,23.5,0,23.5,23.5,-1,-40865,87948,128813,47083,0,-36100,0,0,0,,36100,-36100
16,04/14/2018,61,15:00,15:15,,21.89,0,21.89,21.89,-1,-29124,135026,164150,105902,0,-24577,0,0,0,,24577,-24577
16,04/14/2018,62,15:15,15:30,,29.2,0,29.2,29.2,-1,-25315,157042,182357,131727,0,-1804,0,0,0,,1804,-1804
16,04/14/2018,63,15:30,15:45,,29.2,0,29.2,29.2,-1,-22332,159216,181548,136884,0,-12171,0,0,0,,12171,-12171
16,04/14/2018,64,15:45,16:00,,29.2,0,29.2,29.2,-1,-25137,162561,187698,137424,0,-21587,0,0,0,,21587,-21587
16,04/14/2018,65,16:00,16:15,,29.2,0,29.2,29.2,-1,-29299,156347,185646,127048,0,-9081,0,0,0,,9081,-9081
16,04/14/2018,66,16:15,16:30,,27.78,0,27.78,27.78,-1,-25153,145018,170171,119865,0,-17812,0,0,0,,17812,-17812
16,04/14/2018,67,16:30,16:45,,33.2,0,33.2,33.2,-1,-21830,123610,145440,101780,0,-2277,0,0,0,,2277,-2277
16,04/14/2018,68,16:45,17:00,,34.29,0,34.29,34.29,-1,-24763,97174,121937,72411,0,-1047,0,0,0,,1047,-1047
16,04/14/2018,69,17:00,17:15,,-150.78,0,-150.78,-150.78,-1,-35067,145271,180338,110204,0,-32808,0,0,0,,32808,-32808
16,04/14/2018,70,17:15,17:30,,25.73,0,25.73,25.73,-1,-23379,120447,143826,97068,0,-51450,0,0,0,,51450,-51450
16,04/14/2018,71,17:30,17:45,,,0,35.73,35.73,0,-20511,87091,107602,66580,0,-10902,0,0,0,,10902,-10902
16,04/14/2018,72,17:45,18:00,,33.2,0,33.2,33.2,-1,-24666,79221,103887,54555,0,-1676,0,0,0,,1676,-1676
16,04/14/2018,73,18:00,18:15,,34.38,0,34.38,34.38,-1,-55787,70543,126330,14756,0,-8645,0,0,0,,8645,-8645
16,04/14/2018,74,18:15,18:30,,34.38,0,34.38,34.38,-1,-42671,60971,103642,18300,0,-9003,0,0,0,,9003,-9003
16,04/14/2018,75,18:30,18:45,,37.35,0,37.35,37.35,-1,-48527,66247,114774,17720,0,-3493,0,0,0,,3493,-3493
16,04/14/2018,76,18:45,19:00,,34.89,0,34.89,34.89,-1,-49150,63480,112630,14330,0,-5106,0,0,0,,5106,-5106
16,04/14/2018,77,19:00,19:15,,34.38,0,34.38,34.38,-1,-39364,66358,105722,26994,0,-7591,0,0,0,,7591,-7591
16,04/14/2018,78,19:15,19:30,,40.17,0,40.17,40.17,-1,-36045,66059,102104,30014,0,-2430,0,0,0,,2430,-2430
16,04/14/2018,79,19:30,19:45,,,0,37.27,37.27,0,-31406,62421,93827,31015,0,0,0,0,0,,0,0
16,04/14/2018,80,19:45,20:00,,,0,37.26,37.26,0,-26839,59418,86257,32579,0,0,0,0,0,,0,0
16,04/14/2018,81,20:00,20:15,,40.04,0,40.04,40.04,-1,-4551,117861,122412,113310,0,-287,0,0,0,,287,-287
16,04/14/2018,82,20:15,20:30,,40.31,0,40.31,40.31,-1,-7874,107599,115473,99725,0,-218,0,0,0,,218,-218
16,04/14/2018,83,20:30,20:45,,40.3,0,40.3,40.3,-1,-7866,109991,117857,102125,0,-83,0,0,0,,83,-83
16,04/14/2018,84,20:45,21:00,,,0,37.76,37.76,0,-42322,93615,135937,51293,0,0,0,0,0,,0,0
16,04/14/2018,85,21:00,21:15,,40.22,0,40.22,40.22,-1,-31616,79186,110802,47570,0,-221,0,0,0,,221,-221
16,04/14/2018,86,21:15,21:30,,39.9,0,39.9,39.9,-1,-23940,77490,101430,53550,0,-113,0,0,0,,113,-113
16,04/14/2018,87,21:30,21:45,,35.61,0,35.61,35.61,-1,-38343,92706,131049,54363,0,-99,0,0,0,,99,-99
16,04/14/2018,88,21:45,22:00,,14.61,0,14.61,14.61,-1,-22665,106378,129043,83713,0,-6823,0,0,0,,6823,-6823
16,04/14/2018,89,22:00,22:15,43.73,13.33,0,43.73,43.73,1,-68080,39658,107738,-28422,0,-11042,1535,0,0,,12577,-9507
16,04/14/2018,90,22:15,22:30,38.38,,0,38.38,38.38,1,-43781,39814,83595,-3967,0,0,4220,0,0,,4220,4220
16,04/14/2018,91,22:30,22:45,,,0,37.27,37.27,0,-24555,43480,68035,18925,0,0,424,0,0,,424,424
16,04/14/2018,92,22:45,23:00,,,0,37.49,37.49,0,-28515,49457,77972,20942,0,0,0,0,0,,0,0
16,04/14/2018,93,23:00,23:15,85.5,,0,85.5,85.5,1,-93225,26471,119696,-66754,0,0,19819,0,0,,19819,19819
16,04/14/2018,94,23:15,23:30,49.23,,0,49.23,49.23,1,-61589,28787,90376,-32802,0,0,33209,0,0,,33209,33209
16,04/14/2018,95,23:30,23:45,39.46,,0,39.46,39.46,1,-49056,34925,83981,-14131,0,0,9891,0,0,,9891,9891
16,04/14/2018,96,23:45,0:00,34.25,,0,34.25,34.25,1,-34564,50378,84942,15814,0,0,409,0,0,,409,409
16,04/15/2018,1,0:00,0:15,53.98,,0,53.98,53.98,1,-53664,37376,91040,-16288,0,0,6417,0,0,,6417,6417
16,04/15/2018,2,0:15,0:30,61.35,,0,61.35,61.35,1,-56578,35650,92228,-20928,0,0,28420,0,0,,28420,28420
16,04/15/2018,3,0:30,0:45,61.35,33.2,0,33.2,33.2,-1,-38884,47734,86618,8850,0,-1335,1962,0,0,,3297,627
16,04/15/2018,4,0:45,1:00,,35.16,0,35.16,35.16,-1,-74973,56506,131479,-18467,0,-2815,0,0,0,,2815,-2815
16,04/15/2018,5,1:00,1:15,37.2,30.24,0,37.2,30.24,2,-36548,56911,93459,20363,0,-3228,231,0,0,,3459,-2997
16,04/15/2018,6,1:15,1:30,37.2,,0,37.2,37.2,1,-50670,33922,84592,-16748,0,0,557,0,0,,557,557
16,04/15/2018,7,1:30,1:45,,,0,34.36,34.36,0,-35286,44916,80202,9630,0,0,0,0,0,,0,0
16,04/15/2018,8,1:45,2:00,,27.03,0,27.03,27.03,-1,-37403,63154,100557,25751,0,-7495,0,0,0,,7495,-7495
16,04/15/2018,9,2:00,2:15,,29.2,0,29.2,29.2,-1,-39158,82022,121180,42864,0,-8777,0,0,0,,8777,-8777
16,04/15/2018,10,2:15,2:30,34.17,,0,34.17,34.17,1,-40999,49516,90515,8517,0,0,14,0,0,,14,14
16,04/15/2018,11,2:30,2:45,34.17,,0,34.17,34.17,1,-36010,43067,79077,7057,0,0,190,0,0,,190,190
16,04/15/2018,12,2:45,3:00,,29.2,0,29.2,29.2,-1,-31660,56738,88398,25078,0,-3896,0,0,0,,3896,-3896
16,04/15/2018,13,3:00,3:15,,34.16,0,34.16,34.16,-1,-36925,39490,76415,2565,0,-2460,0,0,0,,2460,-2460
16,04/15/2018,14,3:15,3:30,,,0,47.65,47.65,0,-30207,43744,73951,13537,0,0,0,0,0,,0,0
16,04/15/2018,15,3:30,3:45,,,0,47.65,47.65,0,-26568,32863,59431,6295,0,0,0,0,0,,0,0
16,04/15/2018,16,3:45,4:00,,29.2,0,29.2,29.2,-1,-21954,55529,77483,33575,0,-1772,0,0,0,,1772,-1772
16,04/15/2018,17,4:00,4:15,,34,0,34,34,-1,-45813,52186,97999,6373,0,-983,0,0,0,,983,-983
16,04/15/2018,18,4:15,4:30,,,0,47.53,47.53,0,-40843,54144,94987,13301,0,0,0,0,0,,0,0
16,04/15/2018,19,4:30,4:45,,,0,35.9,35.9,0,-46337,54815,101152,8478,0,0,0,0,0,,0,0
16,04/15/2018,20,4:45,5:00,,,0,35.9,35.9,0,-40595,63358,103953,22763,0,0,0,0,0,,0,0
16,04/15/2018,21,5:00,5:15,,,0,35.99,35.99,0,-32746,60788,93534,28042,0,0,0,0,0,,0,0
16,04/15/2018,22,5:15,5:30,,38.83,0,38.83,38.83,-1,-28766,57333,86099,28567,0,-37,0,0,0,,37,-37
16,04/15/2018,23,5:30,5:45,,38.83,0,38.83,38.83,-1,-31839,45755,77594,13916,0,-306,0,0,0,,306,-306
16,04/15/2018,24,5:45,6:00,,,0,35.99,35.99,0,-30854,37769,68623,6915,0,0,0,0,0,,0,0
16,04/15/2018,25,6:00,6:15,,,0,34.34,34.34,0,-32137,63549,95686,31412,0,0,0,0,0,,0,0
16,04/15/2018,26,6:15,6:30,,,0,34.34,34.34,0,-35125,49546,84671,14421,0,0,0,0,0,,0,0
16,04/15/2018,27,6:30,6:45,,,0,34.31,34.31,0,-30720,44252,74972,13532,0,0,0,0,0,,0,0
16,04/15/2018,28,6:45,7:00,,,0,34.31,34.31,0,-29363,52727,82090,23364,0,0,0,0,0,,0,0
16,04/15/2018,29,7:00,7:15,,12.1,0,12.1,12.1,-1,-22461,75325,97786,52864,0,-21184,0,0,0,,21184,-21184
16,04/15/2018,30,7:15,7:30,,29.37,0,29.37,29.37,-1,-27506,55289,82795,27783,0,-22470,0,0,0,,22470,-22470
16,04/15/2018,31,7:30,7:45,,,0,36.49,36.49,0,-36624,46206,82830,9582,0,-2181,0,0,0,,2181,-2181
16,04/15/2018,32,7:45,8:00,37.37,,0,37.37,37.37,1,-54319,48061,102380,-6258,0,0,1204,0,0,,1204,1204
16,04/15/2018,33,8:00,8:15,37.37,,0,37.37,37.37,1,-40838,39658,80496,-1180,0,0,697,0,0,,697,697
16,04/15/2018,34,8:15,8:30,41.37,,0,41.37,41.37,1,-47312,39801,87113,-7511,0,0,2914,0,0,,2914,2914
16,04/15/2018,35,8:30,8:45,37.37,,0,37.37,37.37,1,-51275,47320,98595,-3955,0,0,4351,0,0,,4351,4351
16,04/15/2018,36,8:45,9:00,37.37,,0,37.37,37.37,1,-67351,59734,127085,-7617,0,0,2264,0,0,,2264,2264
16,04/15/2018,37,9:00,9:15,35.42,33.37,0,33.37,33.37,-1,-40208,49025,89233,8817,0,-648,1178,0,0,,1826,530
16,04/15/2018,38,9:15,9:30,35.42,33.37,0,33.37,33.37,-1,-34589,48352,82941,13763,0,-3312,11,0,0,,3323,-3301
16,04/15/2018,39,9:30,9:45,,33.37,0,33.37,33.37,-1,-42853,60247,103100,17394,0,-3778,0,0,0,,3778,-3778
16,04/15/2018,40,9:45,10:00,,33.37,0,33.37,33.37,-1,-52545,58493,111038,5948,0,-1195,0,0,0,,1195,-1195
16,04/15/2018,41,10:00,10:15,,,0,35.31,35.31,0,-64848,43089,107937,-21759,0,0,0,0,0,,0,0
16,04/15/2018,42,10:15,10:30,,36.35,0,36.35,36.35,-1,-57867,50215,108082,-7652,0,-5,0,0,0,,5,-5
16,04/15/2018,43,10:30,10:45,,,0,35.25,35.25,0,-65025,51689,116714,-13336,0,0,0,0,0,,0,0
16,04/15/2018,44,10:45,11:00,,33.37,0,33.37,33.37,-1,-54020,59330,113350,5310,0,-2720,0,0,0,,2720,-2720
16,04/15/2018,45,11:00,11:15,,36.26,0,36.26,36.26,-1,-55273,52303,107576,-2970,0,-650,0,0,0,,650,-650
16,04/15/2018,46,11:15,11:30,,36.2,0,36.2,36.2,-1,-54882,58115,112997,3233,0,-134,0,0,0,,134,-134
16,04/15/2018,47,11:30,11:45,,33.37,0,33.37,33.37,-1,-47261,66671,113932,19410,0,-1052,0,0,0,,1052,-1052
16,04/15/2018,48,11:45,12:00,,35.98,0,35.98,35.98,-1,-48757,58360,107117,9603,0,-2399,0,0,0,,2399,-2399
16,04/15/2018,49,12:00,12:15,,36.01,0,36.01,36.01,-1,-68297,106837,175134,38540,0,-1910,0,0,0,,1910,-1910
16,04/15/2018,50,12:15,12:30,,36.08,0,36.08,36.08,-1,-67111,74753,141864,7642,0,-72,0,0,0,,72,-72
16,04/15/2018,51,12:30,12:45,,36.29,0,36.29,36.29,-1,-59216,68574,127790,9358,0,-289,0,0,0,,289,-289
16,04/15/2018,52,12:45,13:00,,36.29,0,36.29,36.29,-1,-60192,71951,132143,11759,0,-77,0,0,0,,77,-77
16,04/15/2018,53,13:00,13:15,,36.1,0,36.1,36.1,-1,-75227,99926,175153,24699,0,-1295,0,0,0,,1295,-1295
16,04/15/2018,54,13:15,13:30,37.37,36.1,0,37.37,37.37,1,-81726,65090,146816,-16636,0,-33,670,0,0,,703,637
16,04/15/2018,55,13:30,13:45,37.67,,0,37.67,37.67,1,-83373,64274,147647,-19099,0,0,6290,0,0,,6290,6290
16,04/15/2018,56,13:45,14:00,35.6,,0,35.6,35.6,1,-73845,53297,127142,-20548,0,0,1530,0,0,,1530,1530
16,04/15/2018,57,14:00,14:15,37.37,33.37,0,37.37,33.37,2,-71078,79336,150414,8258,0,-825,269,0,0,,1094,-556
16,04/15/2018,58,14:15,14:30,38.61,,0,38.61,38.61,1,-70626,43737,114363,-26889,0,0,5914,0,0,,5914,5914
16,04/15/2018,59,14:30,14:45,41.37,,0,41.37,41.37,1,-74858,36125,110983,-38733,0,0,8460,0,0,,8460,8460
16,04/15/2018,60,14:45,15:00,47.86,,0,47.86,47.86,1,-84315,35093,119408,-49222,0,0,26013,0,0,,26013,26013
16,04/15/2018,61,15:00,15:15,41.52,,0,41.52,41.52,1,-104203,57354,161557,-46849,0,0,12175,0,0,,12175,12175
16,04/15/2018,62,15:15,15:30,47.2,,0,47.2,47.2,1,-107578,57135,164713,-50443,0,0,24132,0,0,,24132,24132
16,04/15/2018,63,15:30,15:45,41.37,,0,41.37,41.37,1,-97949,53194,151143,-44755,0,0,28912,0,0,,28912,28912
16,04/15/2018,64,15:45,16:00,39.15,,0,39.15,39.15,1,-90088,73437,163525,-16651,0,0,20818,0,0,,20818,20818
16,04/15/2018,65,16:00,16:15,61.34,,0,61.34,61.34,1,-80600,19761,100361,-60839,0,0,33778,0,0,,33778,33778
16,04/15/2018,66,16:15,16:30,41.37,,0,41.37,41.37,1,-78583,37134,115717,-41449,0,0,24338,0,0,,24338,24338
16,04/15/2018,67,16:30,16:45,47.86,,0,47.86,47.86,1,-99984,45600,145584,-54384,0,0,31790,0,0,,31790,31790
16,04/15/2018,68,16:45,17:00,61.34,,0,61.34,61.34,1,-106075,55867,161942,-50208,0,0,52126,0,0,,52126,52126
16,04/15/2018,69,17:00,17:15,41.5,,0,41.5,41.5,1,-77994,36581,114575,-41413,0,0,26861,0,0,,26861,26861
16,04/15/2018,70,17:15,17:30,61.34,,0,61.34,61.34,1,-82165,24380,106545,-57785,0,0,42040,0,0,,42040,42040
16,04/15/2018,71,17:30,17:45,66.07,,0,66.07,66.07,1,-99794,28956,128750,-70838,0,0,55444,0,0,,55444,55444
16,04/15/2018,72,17:45,18:00,100.02,,0,100.02,100.02,1,-125974,46872,172846,-79102,0,0,83717,0,0,,83717,83717
16,04/15/2018,73,18:00,18:15,100.02,33.37,0,33.37,33.37,-1,-39637,55038,94675,15401,0,-941,21343,0,0,,22284,20402
16,04/15/2018,74,18:15,18:30,,36.17,0,36.17,36.17,-1,-47851,61904,109755,14053,0,-665,0,0,0,,665,-665
16,04/15/2018,75,18:30,18:45,,,0,37.06,37.06,0,-41450,50407,91857,8957,0,0,0,0,0,,0,0
16,04/15/2018,76,18:45,19:00,37.37,,0,37.37,37.37,1,-48028,49878,97906,1850,0,0,505,0,0,,505,505
16,04/15/2018,77,19:00,19:15,40.45,,0,40.45,40.45,1,-58337,42059,100396,-16278,0,0,2091,0,0,,2091,2091
16,04/15/2018,78,19:15,19:30,40.42,,0,40.42,40.42,1,-52068,39554,91622,-12514,0,0,4723,0,0,,4723,4723
16,04/15/2018,79,19:30,19:45,41.37,,0,41.37,41.37,1,-51024,36766,87790,-14258,0,0,7989,0,0,,7989,7989
16,04/15/2018,80,19:45,20:00,53.6,,0,53.6,53.6,1,-74485,30239,104724,-44246,0,0,25365,0,0,,25365,25365
16,04/15/2018,81,20:00,20:15,41.37,34.53,0,34.53,34.53,-1,-29735,55176,84911,25441,0,-594,14828,0,0,,15422,14234
16,04/15/2018,82,20:15,20:30,,,0,36.9,36.9,0,-37410,45927,83337,8517,0,-74,2,0,0,,76,-72
16,04/15/2018,83,20:30,20:45,,39.73,0,39.73,39.73,-1,-43121,41886,85007,-1235,0,-49,0,0,0,,49,-49
16,04/15/2018,84,20:45,21:00,44.83,,0,44.83,44.83,1,-45518,21487,67005,-24031,0,0,11625,0,0,,11625,11625
16,04/15/2018,85,21:00,21:15,35.08,,0,35.08,35.08,1,-30050,60487,90537,30437,0,0,3010,0,0,,3010,3010
16,04/15/2018,86,21:15,21:30,,33.37,0,33.37,33.37,-1,-13208,55643,68851,42435,0,-866,0,0,0,,866,-866
16,04/15/2018,87,21:30,21:45,,29.37,0,29.37,29.37,-1,-12141,62917,75058,50776,0,-6498,0,0,0,,6498,-6498
16,04/15/2018,88,21:45,22:00,,20.44,0,20.44,20.44,-1,-22154,77524,99678,55370,0,-12114,0,0,0,,12114,-12114
16,04/15/2018,89,22:00,22:15,,13.34,0,13.34,13.34,-1,-30987,55781,86768,24794,0,-13753,0,0,0,,13753,-13753
16,04/15/2018,90,22:15,22:30,,29.37,0,29.37,29.37,-1,-10829,53178,64007,42349,0,-4597,0,0,0,,4597,-4597
16,04/15/2018,91,22:30,22:45,,29.37,0,29.37,29.37,-1,-12810,80186,92996,67376,0,-5266,0,0,0,,5266,-5266
16,04/15/2018,92,22:45,23:00,,23.86,0,23.86,23.86,-1,-9480,120136,129616,110656,0,-6958,0,0,0,,6958,-6958
16,04/15/2018,93,23:00,23:15,,34.03,0,34.03,34.03,-1,-46398,41398,87796,-5000,0,-4648,0,0,0,,4648,-4648
16,04/15/2018,94,23:15,23:30,,23.86,0,23.86,23.86,-1,-19062,45345,64407,26283,0,-4106,0,0,0,,4106,-4106
16,04/15/2018,95,23:30,23:45,,13.34,0,13.34,13.34,-1,-17838,84858,102696,67020,0,-48045,0,0,0,,48045,-48045
16,04/15/2018,96,23:45,0:00,,-4.03,0,-4.03,-4.03,-1,-24094,113020,137114,88926,0,-58417,0,0,0,,58417,-58417
16,04/16/2018,1,0:00,0:15,37.37,29.37,0,37.37,29.37,2,-57511,37903,95414,-19608,0,-19897,409,0,0,,20306,-19488
16,04/16/2018,2,0:15,0:30,,28.78,0,28.78,28.78,-1,-20910,39746,60656,18836,0,-6312,0,0,0,,6312,-6312
16,04/16/2018,3,0:30,0:45,,27.69,0,27.69,27.69,-1,-28712,44285,72997,15573,0,-25435,0,0,0,,25435,-25435
16,04/16/2018,4,0:45,1:00,,29.37,0,29.37,29.37,-1,-29608,48097,77705,18489,0,-15135,0,0,0,,15135,-15135
16,04/16/2018,5,1:00,1:15,42.11,26.99,0,42.11,26.99,2,-57693,44578,102271,-13115,0,-15020,597,0,0,,15617,-14423
16,04/16/2018,6,1:15,1:30,,,0,37.14,37.14,0,-55326,33152,88478,-22174,0,-411,312,0,0,,723,-99
16,04/16/2018,7,1:30,1:45,,,0,37.1,37.1,0,-39617,42035,81652,2418,0,0,0,0,0,,0,0
16,04/16/2018,8,1:45,2:00,,,0,37.04,37.04,0,-35086,49938,85024,14852,0,0,0,0,0,,0,0
16,04/16/2018,9,2:00,2:15,37.37,,0,37.37,37.37,1,-41475,37466,78941,-4009,0,0,1286,0,0,,1286,1286
16,04/16/2018,10,2:15,2:30,37.37,,0,37.37,37.37,1,-43984,43632,87616,-352,0,0,2825,0,0,,2825,2825
16,04/16/2018,11,2:30,2:45,34.44,,0,34.44,34.44,1,-40422,40192,80614,-230,0,0,1058,0,0,,1058,1058
16,04/16/2018,12,2:45,3:00,34.35,,0,34.35,34.35,1,-31123,34419,65542,3296,0,0,391,0,0,,391,391
16,04/16/2018,13,3:00,3:15,34.6,,0,34.6,34.6,1,-24961,40770,65731,15809,0,0,750,0,0,,750,750
16,04/16/2018,14,3:15,3:30,34.62,,0,34.62,34.62,1,-25708,45331,71039,19623,0,0,253,0,0,,253,253
16,04/16/2018,15,3:30,3:45,,,0,35.51,35.51,0,-16839,52072,68911,35233,0,0,0,0,0,,0,0
16,04/16/2018,16,3:45,4:00,,29.37,0,29.37,29.37,-1,-9664,65443,75107,55779,0,-2255,0,0,0,,2255,-2255
16,04/16/2018,17,4:00,4:15,,20.59,0,20.59,20.59,-1,-18554,71919,90473,53365,0,-21677,0,0,0,,21677,-21677
16,04/16/2018,18,4:15,4:30,,29.47,0,29.47,29.47,-1,-22303,65298,87601,42995,0,-20501,0,0,0,,20501,-20501
16,04/16/2018,19,4:30,4:45,,36.24,0,36.24,36.24,-1,-20483,64570,85053,44087,0,-7697,0,0,0,,7697,-7697
16,04/16/2018,20,4:45,5:00,,,0,35.49,35.49,0,-16525,67468,83993,50943,0,0,0,0,0,,0,0
16,04/16/2018,21,5:00,5:15,,29.37,0,29.37,29.37,-1,-52920,62970,115890,10050,0,-1946,0,0,0,,1946,-1946
16,04/16/2018,22,5:15,5:30,,23.86,0,23.86,23.86,-1,-44135,96716,140851,52581,0,-21031,0,0,0,,21031,-21031
16,04/16/2018,23,5:30,5:45,42.11,23.86,0,42.11,42.11,1,-58942,50750,109692,-8192,0,-4519,4097,0,0,,8616,-422
16,04/16/2018,24,5:45,6:00,37.37,,0,37.37,37.37,1,-57318,82217,139535,24899,0,0,2207,0,0,,2207,2207
16,04/16/2018,25,6:00,6:15,,37.56,0,37.56,37.56,-1,-96112,57204,153316,-38908,0,-439,0,0,0,,439,-439
16,04/16/2018,26,6:15,6:30,,38.56,0,38.56,38.56,-1,-85348,39373,124721,-45975,0,-356,0,0,0,,356,-356
16,04/16/2018,27,6:30,6:45,,34.5,0,34.5,34.5,-1,-27843,46942,74785,19099,0,-744,0,0,0,,744,-744
16,04/16/2018,28,6:45,7:00,,,0,37.24,37.24,0,-66675,93124,159799,26449,0,0,0,0,0,,0,0
16,04/16/2018,29,7:00,7:15,,30.5,0,30.5,30.5,-1,-75819,99371,175190,23552,0,-5814,0,0,0,,5814,-5814
16,04/16/2018,30,7:15,7:30,,37.44,0,37.44,37.44,-1,-48958,71729,120687,22771,0,-3478,0,0,0,,3478,-3478
16,04/16/2018,31,7:30,7:45,,,0,36.77,36.77,0,-33886,35075,68961,1189,0,-18,0,0,0,,18,-18
16,04/16/2018,32,7:45,8:00,,,0,36.71,36.71,0,-72729,48699,121428,-24030,0,0,0,0,0,,0,0
16,04/16/2018,33,8:00,8:15,,,0,50.82,50.82,0,-48803,57707,106510,8904,0,0,0,0,0,,0,0
16,04/16/2018,34,8:15,8:30,,,0,50.82,50.82,0,-35527,49169,84696,13642,0,0,0,0,0,,0,0
16,04/16/2018,35,8:30,8:45,,34.5,0,34.5,34.5,-1,-36251,71532,107783,35281,0,-1223,0,0,0,,1223,-1223
16,04/16/2018,36,8:45,9:00,,34.26,0,34.26,34.26,-1,-42679,102898,145577,60219,0,-1515,0,0,0,,1515,-1515
16,04/16/2018,37,9:00,9:15,,30.5,0,30.5,30.5,-1,-43442,127676,171118,84234,0,-11220,0,0,0,,11220,-11220
16,04/16/2018,38,9:15,9:30,,19.63,0,19.63,19.63,-1,-38143,124119,162262,85976,0,-27398,0,0,0,,27398,-27398
16,04/16/2018,39,9:30,9:45,,12.65,0,12.65,12.65,-1,-27037,129281,156318,102244,0,-51220,0,0,0,,51220,-51220
16,04/16/2018,40,9:45,10:00,,14.22,0,14.22,14.22,-1,-21705,128306,150011,106601,0,-58846,0,0,0,,58846,-58846
16,04/16/2018,41,10:00,10:15,,24.22,0,24.22,24.22,-1,-53613,73233,126846,19620,0,-33620,0,0,0,,33620,-33620
16,04/16/2018,42,10:15,10:30,,22.8,0,22.8,22.8,-1,-34814,79990,114804,45176,0,-28225,0,0,0,,28225,-28225
16,04/16/2018,43,10:30,10:45,,18.62,0,18.62,18.62,-1,-30009,80609,110618,50600,0,-34276,0,0,0,,34276,-34276
16,04/16/2018,44,10:45,11:00,,13.37,0,13.37,13.37,-1,-29801,83548,113349,53747,0,-42860,0,0,0,,42860,-42860
16,04/16/2018,45,11:00,11:15,38.38,31.79,0,38.38,38.38,1,-64347,63578,127925,-769,0,-16124,115,0,0,,16239,-16009
16,04/16/2018,46,11:15,11:30,,,0,35.62,35.62,0,-49457,89554,139011,40097,0,0,11,0,0,,11,11
16,04/16/2018,47,11:30,11:45,,,0,35.65,35.65,0,-60459,109613,170072,49154,0,0,0,0,0,,0,0
16,04/16/2018,48,11:45,12:00,,,0,35.61,35.61,0,-63546,118956,182502,55410,0,0,0,0,0,,0,0
16,04/16/2018,49,12:00,12:15,43.55,,0,43.55,43.55,1,-101173,76162,177335,-25011,0,0,7177,0,0,,7177,7177
16,04/16/2018,50,12:15,12:30,38.5,,0,38.5,38.5,1,-89446,95084,184530,5638,0,0,2792,0,0,,2792,2792
16,04/16/2018,51,12:30,12:45,,,0,36.55,36.55,0,-73948,99972,173920,26024,0,0,0,0,0,,0,0
16,04/16/2018,52,12:45,13:00,,,0,36.55,36.55,0,-78832,101158,179990,22326,0,0,0,0,0,,0,0
16,04/16/2018,53,13:00,13:15,38.5,,0,38.5,38.5,1,-83253,82617,165870,-636,0,0,625,0,0,,625,625
16,04/16/2018,54,13:15,13:30,38.5,,0,38.5,38.5,1,-82746,64817,147563,-17929,0,0,1165,0,0,,1165,1165
16,04/16/2018,55,13:30,13:45,38.5,,0,38.5,38.5,1,-73929,80560,154489,6631,0,0,1897,0,0,,1897,1897
16,04/16/2018,56,13:45,14:00,38.5,34.5,0,38.5,34.5,2,-72477,84755,157232,12278,0,-39,1889,0,0,,1928,1850
16,04/16/2018,57,14:00,14:15,38.5,35.75,0,35.75,35.75,-1,-42612,109307,151919,66695,0,-822,42,0,0,,864,-780
16,04/16/2018,58,14:15,14:30,,27.36,0,27.36,27.36,-1,-42658,103852,146510,61194,0,-9508,0,0,0,,9508,-9508
16,04/16/2018,59,14:30,14:45,,24.54,0,24.54,24.54,-1,-44018,104770,148788,60752,0,-21890,0,0,0,,21890,-21890
16,04/16/2018,60,14:45,15:00,,24.54,0,24.54,24.54,-1,-43815,93651,137466,49836,0,-34915,0,0,0,,34915,-34915
16,04/16/2018,61,15:00,15:15,,30.5,0,30.5,30.5,-1,-36912,111386,148298,74474,0,-26179,0,0,0,,26179,-26179
16,04/16/2018,62,15:15,15:30,,30.5,0,30.5,30.5,-1,-39780,126656,166436,86876,0,-4724,0,0,0,,4724,-4724
16,04/16/2018,63,15:30,15:45,,24.54,0,24.54,24.54,-1,-52865,127183,180048,74318,0,-21067,0,0,0,,21067,-21067
16,04/16/2018,64,15:45,16:00,,12.65,0,12.65,12.65,-1,-53280,125834,179114,72554,0,-19313,0,0,0,,19313,-19313
16,04/16/2018,65,16:00,16:15,,28.47,0,28.47,28.47,-1,-60907,133502,194409,72595,0,-46267,0,0,0,,46267,-46267
16,04/16/2018,66,16:15,16:30,,13.69,0,13.69,13.69,-1,-49902,129860,179762,79958,0,-47242,0,0,0,,47242,-47242
16,04/16/2018,67,16:30,16:45,,12.65,0,12.65,12.65,-1,-55904,100187,156091,44283,0,-53106,0,0,0,,53106,-53106
16,04/16/2018,68,16:45,17:00,,12.65,0,12.65,12.65,-1,-52857,106288,159145,53431,0,-35081,0,0,0,,35081,-35081
16,04/16/2018,69,17:00,17:15,,15.53,0,15.53,15.53,-1,-66077,125377,191454,59300,0,-56050,0,0,0,,56050,-56050
16,04/16/2018,70,17:15,17:30,,33.78,0,33.78,33.78,-1,-76046,105243,181289,29197,0,-28770,0,0,0,,28770,-28770
16,04/16/2018,71,17:30,17:45,,33.78,0,33.78,33.78,-1,-58187,101969,160156,43782,0,-24369,0,0,0,,24369,-24369
16,04/16/2018,72,17:45,18:00,,34.78,0,34.78,34.78,-1,-60783,100422,161205,39639,0,-10958,0,0,0,,10958,-10958
16,04/16/2018,73,18:00,18:15,,32.93,0,32.93,32.93,-1,-53547,81913,135460,28366,0,-9912,0,0,0,,9912,-9912
16,04/16/2018,74,18:15,18:30,,30.5,0,30.5,30.5,-1,-52560,91285,143845,38725,0,-26294,0,0,0,,26294,-26294
16,04/16/2018,75,18:30,18:45,,34.5,0,34.5,34.5,-1,-63719,89792,153511,26073,0,-12701,0,0,0,,12701,-12701
16,04/16/2018,76,18:45,19:00,,,0,35.02,35.02,0,-67486,85285,152771,17799,0,-1467,0,0,0,,1467,-1467
16,04/16/2018,77,19:00,19:15,,29.27,0,29.27,29.27,-1,-62041,95050,157091,33009,0,-11547,0,0,0,,11547,-11547
16,04/16/2018,78,19:15,19:30,,33.78,0,33.78,33.78,-1,-66269,70600,136869,4331,0,-14217,0,0,0,,14217,-14217
16,04/16/2018,79,19:30,19:45,37.32,33.78,0,37.32,37.32,1,-73573,71010,144583,-2563,0,-349,397,0,0,,746,48
16,04/16/2018,80,19:45,20:00,,,0,23.19,23.19,0,-76150,61045,137195,-15105,0,0,0,0,0,,0,0
16,04/16/2018,81,20:00,20:15,,29.95,0,29.95,29.95,-1,-35839,95517,131356,59678,0,-4186,0,0,0,,4186,-4186
16,04/16/2018,82,20:15,20:30,,27.29,0,27.29,27.29,-1,-57461,104987,162448,47526,0,-21382,0,0,0,,21382,-21382
16,04/16/2018,83,20:30,20:45,,34.5,0,34.5,34.5,-1,-43008,80808,123816,37800,0,-23025,0,0,0,,23025,-23025
16,04/16/2018,84,20:45,21:00,38.5,34.5,0,38.5,38.5,1,-53572,61742,115314,8170,0,-2131,37,0,0,,2168,-2094
16,04/16/2018,85,21:00,21:15,39.12,,0,39.12,39.12,1,-34305,48372,82677,14067,0,0,207,0,0,,207,207
16,04/16/2018,86,21:15,21:30,42.63,,0,42.63,42.63,1,-48894,40181,89075,-8713,0,0,6586,0,0,,6586,6586
16,04/16/2018,87,21:30,21:45,42.63,36.6,0,36.6,36.6,-1,-41899,47432,89331,5533,0,-21,12,0,0,,33,-9
16,04/16/2018,88,21:45,22:00,,34.78,0,34.78,34.78,-1,-50639,66054,116693,15415,0,-2315,0,0,0,,2315,-2315
16,04/16/2018,89,22:00,22:15,,34.86,0,34.86,34.86,-1,-85211,65706,150917,-19505,0,-2322,0,0,0,,2322,-2322
16,04/16/2018,90,22:15,22:30,,,0,23.2,23.2,0,-72257,44474,116731,-27783,0,0,0,0,0,,0,0
16,04/16/2018,91,22:30,22:45,,34.5,0,34.5,34.5,-1,-55836,65308,121144,9472,0,-2419,0,0,0,,2419,-2419
16,04/16/2018,92,22:45,23:00,,24.88,0,24.88,24.88,-1,-63048,98722,161770,35674,0,-17032,0,0,0,,17032,-17032
16,04/16/2018,93,23:00,23:15,,16.43,0,16.43,16.43,-1,-62285,91690,153975,29405,0,-29839,0,0,0,,29839,-29839
16,04/16/2018,94,23:15,23:30,,24.88,0,24.88,24.88,-1,-49866,80387,130253,30521,0,-14935,0,0,0,,14935,-14935
16,04/16/2018,95,23:30,23:45,,24.88,0,24.88,24.88,-1,-66765,107436,174201,40671,0,-36053,0,0,0,,36053,-36053
16,04/16/2018,96,23:45,0:00,,27.45,0,27.45,27.45,-1,-113431,127291,240722,13860,0,-43148,0,0,0,,43148,-43148
16,04/17/2018,1,0:00,0:15,,-68.16,0,-68.16,-68.16,-1,-49108,152854,201962,103746,0,-30907,0,0,0,,30907,-30907
16,04/17/2018,2,0:15,0:30,41.79,33.37,0,41.79,33.37,2,-45735,35145,80880,-10590,0,-1241,594,0,0,,1835,-647
16,04/17/2018,3,0:30,0:45,,33.37,0,33.37,33.37,-1,-45775,54512,100287,8737,0,-932,0,0,0,,932,-932
16,04/17/2018,4,0:45,1:00,,27.97,0,27.97,27.97,-1,-41869,66947,108816,25078,0,-12124,0,0,0,,12124,-12124
16,04/17/2018,5,1:00,1:15,,33.37,0,33.37,33.37,-1,-48963,35748,84711,-13215,0,-6289,0,0,0,,6289,-6289
16,04/17/2018,6,1:15,1:30,,33.37,0,33.37,33.37,-1,-37964,47847,85811,9883,0,-192,0,0,0,,192,-192
16,04/17/2018,7,1:30,1:45,,29.37,0,29.37,29.37,-1,-31980,67504,99484,35524,0,-2103,0,0,0,,2103,-2103
16,04/17/2018,8,1:45,2:00,,23.65,0,23.65,23.65,-1,-32026,79678,111704,47652,0,-26524,0,0,0,,26524,-26524
16,04/17/2018,9,2:00,2:15,41.79,33.37,0,41.79,33.37,2,-40045,28495,68540,-11550,0,-10429,663,0,0,,11092,-9766
16,04/17/2018,10,2:15,2:30,,33.37,0,33.37,33.37,-1,-30970,49456,80426,18486,0,-48,0,0,0,,48,-48
16,04/17/2018,11,2:30,2:45,,28.11,0,28.11,28.11,-1,-31670,63747,95417,32077,0,-8051,0,0,0,,8051,-8051
16,04/17/2018,12,2:45,3:00,,33.37,0,33.37,33.37,-1,-37332,81325,118657,43993,0,-10835,0,0,0,,10835,-10835
16,04/17/2018,13,3:00,3:15,,35.55,0,35.55,35.55,-1,-63120,57696,120816,-5424,0,-1130,0,0,0,,1130,-1130
16,04/17/2018,14,3:15,3:30,,,0,36.97,36.97,0,-51987,61284,113271,9297,0,0,0,0,0,,0,0
16,04/17/2018,15,3:30,3:45,,33.37,0,33.37,33.37,-1,-41270,68816,110086,27546,0,-1399,0,0,0,,1399,-1399
16,04/17/2018,16,3:45,4:00,,12.5,0,12.5,12.5,-1,-34256,81123,115379,46867,0,-4032,0,0,0,,4032,-4032
16,04/17/2018,17,4:00,4:15,,6.03,0,6.03,6.03,-1,-42234,73971,116205,31737,0,-9140,0,0,0,,9140,-9140
16,04/17/2018,18,4:15,4:30,,26.54,0,26.54,26.54,-1,-23493,93397,116890,69904,0,-2625,0,0,0,,2625,-2625
16,04/17/2018,19,4:30,4:45,,9.23,0,9.23,9.23,-1,-22457,89611,112068,67154,0,-22457,0,0,0,,22457,-22457
16,04/17/2018,20,4:45,5:00,,28.03,0,28.03,28.03,-1,-24613,100922,125535,76309,0,-19270,0,0,0,,19270,-19270
16,04/17/2018,21,5:00,5:15,,-150.03,0,-150.03,-150.03,-1,-47789,130889,178678,83100,0,-37205,0,0,0,,37205,-37205
16,04/17/2018,22,5:15,5:30,,27,0,27,27,-1,-67040,115830,182870,48790,0,-35391,0,0,0,,35391,-35391
16,04/17/2018,23,5:30,5:45,,35.89,0,35.89,35.89,-1,-59523,98199,157722,38676,0,-9562,0,0,0,,9562,-9562
16,04/17/2018,24,5:45,6:00,,,0,34.65,34.65,0,-70822,100443,171265,29621,0,0,0,0,0,,0,0
16,04/17/2018,25,6:00,6:15,37.37,,0,37.37,37.37,1,-87789,47957,135746,-39832,0,0,1481,0,0,,1481,1481
16,04/17/2018,26,6:15,6:30,37.37,28.03,0,28.03,28.03,-1,-58447,80745,139192,22298,0,-10824,63,0,0,,10887,-10761
16,04/17/2018,27,6:30,6:45,,,0,36.85,36.85,0,-65854,58425,124279,-7429,0,-1355,0,0,0,,1355,-1355
16,04/17/2018,28,6:45,7:00,37.37,,0,37.37,37.37,1,-79699,71641,151340,-8058,0,0,423,0,0,,423,423
16,04/17/2018,29,7:00,7:15,,9.3,0,9.3,9.3,-1,-37007,130338,167345,93331,0,-19782,0,0,0,,19782,-19782
16,04/17/2018,30,7:15,7:30,,34.56,0,34.56,34.56,-1,-41097,121478,162575,80381,0,-9081,0,0,0,,9081,-9081
16,04/17/2018,31,7:30,7:45,,,0,37.33,37.33,0,-37066,109112,146178,72046,0,-281,0,0,0,,281,-281
16,04/17/2018,32,7:45,8:00,,40.54,0,40.54,40.54,-1,-45776,90290,136066,44514,0,-18,0,0,0,,18,-18
16,04/17/2018,33,8:00,8:15,,16.09,0,16.09,16.09,-1,-83314,121287,204601,37973,0,-15046,0,0,0,,15046,-15046
16,04/17/2018,34,8:15,8:30,,41.16,0,41.16,41.16,-1,-93319,89289,182608,-4030,0,-2917,0,0,0,,2917,-2917
16,04/17/2018,35,8:30,8:45,,40.47,0,40.47,40.47,-1,-98783,86199,184982,-12584,0,-901,0,0,0,,901,-901
16,04/17/2018,36,8:45,9:00,,40.78,0,40.78,40.78,-1,-99655,73613,173268,-26042,0,-1000,0,0,0,,1000,-1000
16,04/17/2018,37,9:00,9:15,,38.52,0,38.52,38.52,-1,-96315,74698,171013,-21617,0,-122,0,0,0,,122,-122
16,04/17/2018,38,9:15,9:30,,34.56,0,34.56,34.56,-1,-81976,76829,158805,-5147,0,-1660,0,0,0,,1660,-1660
16,04/17/2018,39,9:30,9:45,,25.18,0,25.18,25.18,-1,-60982,97418,158400,36436,0,-18477,0,0,0,,18477,-18477
16,04/17/2018,40,9:45,10:00,,30.56,0,30.56,30.56,-1,-62745,109631,172376,46886,0,-41673,0,0,0,,41673,-41673
16,04/17/2018,41,10:00,10:15,38.56,32.32,0,38.56,38.56,1,-105524,86865,192389,-18659,0,-19950,322,0,0,,20272,-19628
16,04/17/2018,42,10:15,10:30,38.56,30.56,0,30.56,30.56,-1,-88060,109939,197999,21879,0,-11296,14,0,0,,11310,-11282
16,04/17/2018,43,10:30,10:45,,33.03,0,33.03,33.03,-1,-95642,117095,212737,21453,0,-17882,0,0,0,,17882,-17882
16,04/17/2018,44,10:45,11:00,,25.18,0,25.18,25.18,-1,-92571,140115,232686,47544,0,-35301,0,0,0,,35301,-35301
16,04/17/2018,45,11:00,11:15,34.7,30.56,0,34.7,34.7,1,-130045,131062,261107,1017,0,-24084,30,0,0,,24114,-24054
16,04/17/2018,46,11:15,11:30,,7.42,0,7.42,7.42,-1,-109052,156890,265942,47838,0,-15279,0,0,0,,15279,-15279
16,04/17/2018,47,11:30,11:45,,8.23,0,8.23,8.23,-1,-123861,184943,308804,61082,0,-59695,0,0,0,,59695,-59695
16,04/17/2018,48,11:45,12:00,,25.18,0,25.18,25.18,-1,-120688,177087,297775,56399,0,-60454,0,0,0,,60454,-60454
16,04/17/2018,49,12:00,12:15,,15.84,0,15.84,15.84,-1,-130575,201357,331932,70782,0,-63243,0,0,0,,63243,-63243
16,04/17/2018,50,12:15,12:30,,21.54,0,21.54,21.54,-1,-130525,181977,312502,51452,0,-47125,0,0,0,,47125,-47125
16,04/17/2018,51,12:30,12:45,,15.84,0,15.84,15.84,-1,-127418,184572,311990,57154,0,-61503,0,0,0,,61503,-61503
16,04/17/2018,52,12:45,13:00,,25.18,0,25.18,25.18,-1,-142005,196271,338276,54266,0,-53322,0,0,0,,53322,-53322
16,04/17/2018,53,13:00,13:15,,23.06,0,23.06,23.06,-1,-151131,224809,375940,73678,0,-34680,0,0,0,,34680,-34680
16,04/17/2018,54,13:15,13:30,,,0,36.17,36.17,0,-155844,218249,374093,62405,0,-275,0,0,0,,275,-275
16,04/17/2018,55,13:30,13:45,,,0,36.17,36.17,0,-145931,203420,349351,57489,0,0,0,0,0,,0,0
16,04/17/2018,56,13:45,14:00,,31.81,0,31.81,31.81,-1,-147599,172420,320019,24821,0,-4261,0,0,0,,4261,-4261
16,04/17/2018,57,14:00,14:15,,34.56,0,34.56,34.56,-1,-142593,172030,314623,29437,0,-1099,0,0,0,,1099,-1099
16,04/17/2018,58,14:15,14:30,,,0,36.08,36.08,0,-146406,150085,296491,3679,0,-6,0,0,0,,6,-6
16,04/17/2018,59,14:30,14:45,,,0,36.09,36.09,0,-143219,155292,298511,12073,0,0,0,0,0,,0,0
16,04/17/2018,60,14:45,15:00,,34.56,0,34.56,34.56,-1,-147308,144943,292251,-2365,0,-232,0,0,0,,232,-232
16,04/17/2018,61,15:00,15:15,,34.56,0,34.56,34.56,-1,-88227,185902,274129,97675,0,-667,0,0,0,,667,-667
16,04/17/2018,62,15:15,15:30,,,0,36.04,36.04,0,-93500,178213,271713,84713,0,0,0,0,0,,0,0
16,04/17/2018,63,15:30,15:45,,,0,36.03,36.03,0,-101138,147098,248236,45960,0,0,0,0,0,,0,0
16,04/17/2018,64,15:45,16:00,,,0,36.04,36.04,0,-86842,123654,210496,36812,0,0,0,0,0,,0,0
16,04/17/2018,65,16:00,16:15,,34.56,0,34.56,34.56,-1,-79941,121930,201871,41989,0,-538,0,0,0,,538,-538
16,04/17/2018,66,16:15,16:30,,34.56,0,34.56,34.56,-1,-79167,103987,183154,24820,0,-6935,0,0,0,,6935,-6935
16,04/17/2018,67,16:30,16:45,35.35,34.56,0,36.15,34.56,2,-77898,84847,162745,6949,0,-2492,7,0,0,,2499,-2485
16,04/17/2018,68,16:45,17:00,42.56,,0,42.56,42.56,1,-96116,86099,182215,-10017,0,0,3427,0,0,,3427,3427
16,04/17/2018,69,17:00,17:15,35.3,,0,35.3,35.3,1,-114501,78588,193089,-35913,0,0,757,0,0,,757,757
16,04/17/2018,70,17:15,17:30,,,0,36.21,36.21,0,-112866,88686,201552,-24180,0,0,0,0,0,,0,0
16,04/17/2018,71,17:30,17:45,35.5,,0,35.5,35.5,1,-113192,96255,209447,-16937,0,0,9,0,0,,9,9
16,04/17/2018,72,17:45,18:00,42.56,,0,42.56,42.56,1,-119531,104882,224413,-14649,0,0,6124,0,0,,6124,6124
16,04/17/2018,73,18:00,18:15,38.56,,0,38.56,38.56,1,-110687,82205,192892,-28482,0,0,3221,0,0,,3221,3221
16,04/17/2018,74,18:15,18:30,,,0,36.32,36.32,0,-99928,93845,193773,-6083,0,0,25,0,0,,25,25
16,04/17/2018,75,18:30,18:45,,38.68,0,38.68,38.68,-1,-102346,99398,201744,-2948,0,-119,0,0,0,,119,-119
16,04/17/2018,76,18:45,19:00,,,0,36.26,36.26,0,-108568,81258,189826,-27310,0,0,0,0,0,,0,0
16,04/17/2018,77,19:00,19:15,,34.56,0,34.56,34.56,-1,-58589,86703,145292,28114,0,-2742,0,0,0,,2742,-2742
16,04/17/2018,78,19:15,19:30,,34.56,0,34.56,34.56,-1,-67726,85717,153443,17991,0,-5323,0,0,0,,5323,-5323
16,04/17/2018,79,19:30,19:45,,34.56,0,34.56,34.56,-1,-63389,83263,146652,19874,0,-4009,0,0,0,,4009,-4009
16,04/17/2018,80,19:45,20:00,,38.46,0,38.46,38.46,-1,-72617,86207,158824,13590,0,-847,0,0,0,,847,-847
16,04/17/2018,81,20:00,20:15,,41.35,0,41.35,41.35,-1,-51654,76624,128278,24970,0,-7,0,0,0,,7,-7
16,04/17/2018,82,20:15,20:30,,41.36,0,41.36,41.36,-1,-59560,78746,138306,19186,0,-105,0,0,0,,105,-105
16,04/17/2018,83,20:30,20:45,,41.34,0,41.34,41.34,-1,-59266,95145,154411,35879,0,-260,0,0,0,,260,-260
16,04/17/2018,84,20:45,21:00,,,0,37.68,37.68,0,-74706,87041,161747,12335,0,0,0,0,0,,0,0
16,04/17/2018,85,21:00,21:15,68.65,,0,68.65,68.65,1,-92004,53812,145816,-38192,0,0,13835,0,0,,13835,13835
16,04/17/2018,86,21:15,21:30,43.82,,0,43.82,43.82,1,-83758,56756,140514,-27002,0,0,29806,0,0,,29806,29806
16,04/17/2018,87,21:30,21:45,43.82,34.56,0,34.56,34.56,-1,-70519,69961,140480,-558,0,-520,5600,0,0,,6120,5080
16,04/17/2018,88,21:45,22:00,,36.74,0,36.74,36.74,-1,-74202,74738,148940,536,0,-906,0,0,0,,906,-906
16,04/17/2018,89,22:00,22:15,,37.96,0,37.96,37.96,-1,-78586,26526,105112,-52060,0,-264,0,0,0,,264,-264
16,04/17/2018,90,22:15,22:30,,38.29,0,38.29,38.29,-1,-61926,29394,91320,-32532,0,-250,0,0,0,,250,-250
16,04/17/2018,91,22:30,22:45,,38.54,0,38.54,38.54,-1,-50552,39835,90387,-10717,0,-309,0,0,0,,309,-309
16,04/17/2018,92,22:45,23:00,,,0,24.46,24.46,0,-79540,55815,135355,-23725,0,-18,0,0,0,,18,-18
16,04/17/2018,93,23:00,23:15,,,0,24.05,24.05,0,-123684,24436,148120,-99248,0,0,0,0,0,,0,0
16,04/17/2018,94,23:15,23:30,,,0,36.21,36.21,0,-85861,29209,115070,-56652,0,0,0,0,0,,0,0
16,04/17/2018,95,23:30,23:45,,37.84,0,37.84,37.84,-1,-65152,64316,129468,-836,0,-97,0,0,0,,97,-97
16,04/17/2018,96,23:45,0:00,,36.86,0,36.86,36.86,-1,-83253,68101,151354,-15152,0,-364,0,0,0,,364,-364
16,04/18/2018,1,0:00,0:15,59.93,,0,59.93,59.93,1,-129281,89908,219189,-39373,0,0,12629,0,0,,12629,12629
16,04/18/2018,2,0:15,0:30,57.76,,0,57.76,57.76,1,-75057,52276,127333,-22781,0,0,23607,0,0,,23607,23607
16,04/18/2018,3,0:30,0:45,57.76,35.71,0,35.71,35.71,-1,-75364,70162,145526,-5202,0,-299,429,0,0,,728,130
16,04/18/2018,4,0:45,1:00,,33.37,0,33.37,33.37,-1,-82210,88888,171098,6678,0,-10701,0,0,0,,10701,-10701
16,04/18/2018,5,1:00,1:15,37.37,34.97,0,37.37,37.37,1,-87257,87792,175049,535,0,-1820,155,0,0,,1975,-1665
16,04/18/2018,6,1:15,1:30,,,0,35.97,35.97,0,-82674,77204,159878,-5470,0,0,124,0,0,,124,124
16,04/18/2018,7,1:30,1:45,,33.37,0,33.37,33.37,-1,-74697,95525,170222,20828,0,-1947,0,0,0,,1947,-1947
16,04/18/2018,8,1:45,2:00,,29.02,0,29.02,29.02,-1,-76288,100132,176420,23844,0,-20179,0,0,0,,20179,-20179
16,04/18/2018,9,2:00,2:15,35.58,33.37,0,35.58,33.37,2,-76101,73458,149559,-2643,0,-9405,436,0,0,,9841,-8969
16,04/18/2018,10,2:15,2:30,,,0,35.9,35.9,0,-70106,86447,156553,16341,0,0,0,0,0,,0,0
16,04/18/2018,11,2:30,2:45,,33.68,0,33.68,33.68,-1,-73285,77099,150384,3814,0,-782,0,0,0,,782,-782
16,04/18/2018,12,2:45,3:00,,33.37,0,33.37,33.37,-1,-84965,86540,171505,1575,0,-1776,0,0,0,,1776,-1776
16,04/18/2018,13,3:00,3:15,,33.37,0,33.37,33.37,-1,-84709,92264,176973,7555,0,-2181,0,0,0,,2181,-2181
16,04/18/2018,14,3:15,3:30,,33.37,0,33.37,33.37,-1,-84596,88101,172697,3505,0,-2374,0,0,0,,2374,-2374
16,04/18/2018,15,3:30,3:45,,34.93,0,34.93,34.93,-1,-80539,85972,166511,5433,0,-1005,0,0,0,,1005,-1005
16,04/18/2018,16,3:45,4:00,,34.82,0,34.82,34.82,-1,-74044,67098,141142,-6946,0,-2790,0,0,0,,2790,-2790
16,04/18/2018,17,4:00,4:15,,29.37,0,29.37,29.37,-1,-53391,79114,132505,25723,0,-5726,0,0,0,,5726,-5726
16,04/18/2018,18,4:15,4:30,,32.62,0,32.62,32.62,-1,-56957,75511,132468,18554,0,-9726,0,0,0,,9726,-9726
16,04/18/2018,19,4:30,4:45,,33.37,0,33.37,33.37,-1,-64081,73572,137653,9491,0,-6501,0,0,0,,6501,-6501
16,04/18/2018,20,4:45,5:00,,,0,34.46,34.46,0,-67634,76035,143669,8401,0,-233,0,0,0,,233,-233
16,04/18/2018,21,5:00,5:15,,13.44,0,13.44,13.44,-1,-49428,101088,150516,51660,0,-24096,0,0,0,,24096,-24096
16,04/18/2018,22,5:15,5:30,,28.59,0,28.59,28.59,-1,-74696,106974,181670,32278,0,-37249,0,0,0,,37249,-37249
16,04/18/2018,23,5:30,5:45,35.79,32.65,0,35.79,35.79,1,-75752,91599,167351,15847,0,-15207,69,0,0,,15276,-15138
16,04/18/2018,24,5:45,6:00,41.58,32.65,0,41.58,41.58,1,-94687,89959,184646,-4728,0,-645,1169,0,0,,1814,524
16,04/18/2018,25,6:00,6:15,,34.59,0,34.59,34.59,-1,-65129,75682,140811,10553,0,-861,0,0,0,,861,-861
16,04/18/2018,26,6:15,6:30,,23.24,0,23.24,23.24,-1,-52158,120038,172196,67880,0,-14022,0,0,0,,14022,-14022
16,04/18/2018,27,6:30,6:45,,28.78,0,28.78,28.78,-1,-78360,100674,179034,22314,0,-16760,0,0,0,,16760,-16760
16,04/18/2018,28,6:45,7:00,36.97,28.78,0,36.97,36.97,1,-91092,90639,181731,-453,0,-332,788,0,0,,1120,456
16,04/18/2018,29,7:00,7:15,36.34,23.54,0,37.46,23.54,2,-80064,146533,226597,66469,0,-14276,51,0,0,,14327,-14225
16,04/18/2018,30,7:15,7:30,,34.78,0,34.78,34.78,-1,-97466,124933,222399,27467,0,-2865,0,0,0,,2865,-2865
16,04/18/2018,31,7:30,7:45,,38.19,0,38.19,38.19,-1,-101216,87360,188576,-13856,0,-346,0,0,0,,346,-346
16,04/18/2018,32,7:45,8:00,40.97,38.19,0,40.97,40.97,1,-120013,87515,207528,-32498,0,-9,3314,0,0,,3323,3305
16,04/18/2018,33,8:00,8:15,36.97,,0,36.97,36.97,1,-122554,123666,246220,1112,0,0,4373,0,0,,4373,4373
16,04/18/2018,34,8:15,8:30,36.97,38.14,0,38.14,38.14,-1,-104105,117200,221305,13095,0,-192,860,0,0,,1052,668
16,04/18/2018,35,8:30,8:45,,28.97,0,28.97,28.97,-1,-86305,105252,191557,18947,0,-4821,0,0,0,,4821,-4821
16,04/18/2018,36,8:45,9:00,,32.97,0,32.97,32.97,-1,-85160,93664,178824,8504,0,-5150,0,0,0,,5150,-5150
16,04/18/2018,37,9:00,9:15,36.97,32.97,0,36.97,36.97,1,-150038,114167,264205,-35871,0,-165,512,0,0,,677,347
16,04/18/2018,38,9:15,9:30,,,0,36.44,36.44,0,-144217,113022,257239,-31195,0,0,0,0,0,,0,0
16,04/18/2018,39,9:30,9:45,,35.61,0,35.61,35.61,-1,-134396,138419,272815,4023,0,-1,0,0,0,,1,-1
16,04/18/2018,40,9:45,10:00,,32.97,0,32.97,32.97,-1,-124974,149616,274590,24642,0,-2782,0,0,0,,2782,-2782
16,04/18/2018,41,10:00,10:15,40.97,35.39,0,40.97,40.97,1,-170113,153403,323516,-16710,0,-2347,1645,0,0,,3992,-702
16,04/18/2018,42,10:15,10:30,39.14,,0,39.14,39.14,1,-152699,139483,292182,-13216,0,0,4057,0,0,,4057,4057
16,04/18/2018,43,10:30,10:45,36.97,,0,36.97,36.97,1,-142867,129752,272619,-13115,0,0,2669,0,0,,2669,2669
16,04/18/2018,44,10:45,11:00,36.97,,0,36.97,36.97,1,-140377,122988,263365,-17389,0,0,2576,0,0,,2576,2576
16,04/18/2018,45,11:00,11:15,39.51,,0,39.51,39.51,1,-189478,88561,278039,-100917,0,0,3837,0,0,,3837,3837
16,04/18/2018,46,11:15,11:30,36.97,,0,36.97,36.97,1,-187745,94917,282662,-92828,0,0,2653,0,0,,2653,2653
16,04/18/2018,47,11:30,11:45,39.01,,0,39.01,39.01,1,-183604,95800,279404,-87804,0,0,2047,0,0,,2047,2047
16,04/18/2018,48,11:45,12:00,,,0,35.89,35.89,0,-183264,87248,270512,-96016,0,0,29,0,0,,29,29
16,04/18/2018,49,12:00,12:15,47.89,,0,47.89,47.89,1,-138657,114941,253598,-23716,0,0,10467,0,0,,10467,10467
16,04/18/2018,50,12:15,12:30,40.83,,0,40.83,40.83,1,-123258,89400,212658,-33858,0,0,13130,0,0,,13130,13130
16,04/18/2018,51,12:30,12:45,,,0,35.97,35.97,0,-92365,85456,177821,-6909,0,0,817,0,0,,817,817
16,04/18/2018,52,12:45,13:00,,,0,35.94,35.94,0,-84605,67540,152145,-17065,0,0,0,0,0,,0,0
16,04/18/2018,53,13:00,13:15,40.97,,0,40.97,40.97,1,-113433,112868,226301,-565,0,0,1003,0,0,,1003,1003
16,04/18/2018,54,13:15,13:30,40.97,,0,40.97,40.97,1,-129022,96176,225198,-32846,0,0,6028,0,0,,6028,6028
16,04/18/2018,55,13:30,13:45,,,0,35.84,35.84,0,-125904,91043,216947,-34861,0,0,0,0,0,,0,0
16,04/18/2018,56,13:45,14:00,,,0,35.86,35.86,0,-123295,89184,212479,-34111,0,0,0,0,0,,0,0
16,04/18/2018,57,14:00,14:15,,,0,36.99,36.99,0,-104801,73874,178675,-30927,0,0,0,0,0,,0,0
16,04/18/2018,58,14:15,14:30,35.64,,0,35.64,35.64,1,-117700,67510,185210,-50190,0,0,451,0,0,,451,451
16,04/18/2018,59,14:30,14:45,35.59,,0,35.59,35.59,1,-113602,64014,177616,-49588,0,0,129,0,0,,129,129
16,04/18/2018,60,14:45,15:00,35.64,,0,35.64,35.64,1,-118723,60683,179406,-58040,0,0,57,0,0,,57,57
16,04/18/2018,61,15:00,15:15,47.89,,0,47.89,47.89,1,-113459,74532,187991,-38927,0,0,9177,0,0,,9177,9177
16,04/18/2018,62,15:15,15:30,53.54,,0,53.54,53.54,1,-119295,69158,188453,-50137,0,0,16324,0,0,,16324,16324
16,04/18/2018,63,15:30,15:45,59.2,,0,59.2,59.2,1,-138455,67162,205617,-71293,0,0,44109,0,0,,44109,44109
16,04/18/2018,64,15:45,16:00,63.06,,0,63.06,63.06,1,-136003,73040,209043,-62963,0,0,53251,0,0,,53251,53251
16,04/18/2018,65,16:00,16:15,,,0,36.78,36.78,0,-97081,74428,171509,-22653,0,0,10545,0,0,,10545,10545
16,04/18/2018,66,16:15,16:30,,,0,36.81,36.81,0,-128860,70505,199365,-58355,0,0,0,0,0,,0,0
16,04/18/2018,67,16:30,16:45,,,0,36.88,36.88,0,-138041,68258,206299,-69783,0,0,0,0,0,,0,0
16,04/18/2018,68,16:45,17:00,36.97,,0,36.97,36.97,1,-172926,77850,250776,-95076,0,0,2357,0,0,,2357,2357
16,04/18/2018,69,17:00,17:15,139.12,,0,139.12,139.12,1,-126678,34660,161338,-92018,0,0,39763,0,0,,39763,39763
16,04/18/2018,70,17:15,17:30,59.2,,0,59.2,59.2,1,-115830,44717,160547,-71113,0,0,50826,0,0,,50826,50826
16,04/18/2018,71,17:30,17:45,59.2,,0,59.2,59.2,1,-128640,46945,175585,-81695,0,0,67018,0,0,,67018,67018
16,04/18/2018,72,17:45,18:00,86.19,,0,86.19,86.19,1,-148645,51168,199813,-97477,0,0,87333,0,0,,87333,87333
16,04/18/2018,73,18:00,18:15,80.24,,0,80.24,80.24,1,-114372,23315,137687,-91057,0,0,72249,0,0,,72249,72249
16,04/18/2018,74,18:15,18:30,44.9,,0,44.9,44.9,1,-59805,26976,86781,-32829,0,0,17163,0,0,,17163,17163
16,04/18/2018,75,18:30,18:45,45.27,,0,45.27,45.27,1,-65368,31238,96606,-34130,0,0,24289,0,0,,24289,24289
16,04/18/2018,76,18:45,19:00,67.54,,0,67.54,67.54,1,-79746,25560,105306,-54186,0,0,48736,0,0,,48736,48736
16,04/18/2018,77,19:00,19:15,45.12,,0,45.12,45.12,1,-92301,45902,138203,-46399,0,0,40389,0,0,,40389,40389
16,04/18/2018,78,19:15,19:30,47.93,,0,47.93,47.93,1,-91508,40344,131852,-51164,0,0,36512,0,0,,36512,36512
16,04/18/2018,79,19:30,19:45,50.74,,0,50.74,50.74,1,-82818,37751,120569,-45067,0,0,43878,0,0,,43878,43878
16,04/18/2018,80,19:45,20:00,45.16,,0,45.16,45.16,1,-70706,41903,112609,-28803,0,0,36624,0,0,,36624,36624
16,04/18/2018,81,20:00,20:15,45.16,20.34,0,20.34,20.34,-1,-48268,90077,138345,41809,0,-7045,8379,0,0,,15424,1334
16,04/18/2018,82,20:15,20:30,,31.51,0,31.51,31.51,-1,-60775,92804,153579,32029,0,-9897,0,0,0,,9897,-9897
16,04/18/2018,83,20:30,20:45,,32.97,0,32.97,32.97,-1,-64466,89151,153617,24685,0,-10883,0,0,0,,10883,-10883
16,04/18/2018,84,20:45,21:00,39.66,32.97,0,39.66,39.66,1,-92295,74125,166420,-18170,0,-597,2167,0,0,,2764,1570
16,04/18/2018,85,21:00,21:15,139.12,,0,139.12,139.12,1,-165153,46199,211352,-118954,0,0,46765,0,0,,46765,46765
16,04/18/2018,86,21:15,21:30,139.12,,0,139.12,139.12,1,-131330,52651,183981,-78679,0,0,95080,0,0,,95080,95080
16,04/18/2018,87,21:30,21:45,139.12,19.22,0,19.22,19.22,-1,-63049,93430,156479,30381,0,-7643,10728,0,0,,18371,3085
16,04/18/2018,88,21:45,22:00,,16.28,0,16.28,16.28,-1,-77898,91977,169875,14079,0,-18935,0,0,0,,18935,-18935
16,04/18/2018,89,22:00,22:15,54.1,16.28,0,54.1,54.1,1,-122765,39329,162094,-83436,0,-575,6627,0,0,,7202,6052
16,04/18/2018,90,22:15,22:30,38.48,,0,38.48,38.48,1,-121715,72084,193799,-49631,0,0,6355,0,0,,6355,6355
16,04/18/2018,91,22:30,22:45,38.48,36.07,0,36.07,36.07,-1,-104814,118961,223775,14147,0,-129,130,0,0,,259,1
16,04/18/2018,92,22:45,23:00,,30.61,0,30.61,30.61,-1,-118659,162444,281103,43785,0,-13803,0,0,0,,13803,-13803
16,04/18/2018,93,23:00,23:15,59.2,32.76,0,59.2,32.76,2,-116401,74861,191262,-41540,0,-8964,8098,0,0,,17062,-866
16,04/18/2018,94,23:15,23:30,36.97,,0,36.97,36.97,1,-107124,88146,195270,-18978,0,0,2172,0,0,,2172,2172
16,04/18/2018,95,23:30,23:45,,32.83,0,32.83,32.83,-1,-86519,124569,211088,38050,0,-2422,0,0,0,,2422,-2422
16,04/18/2018,96,23:45,0:00,,-150.78,0,-150.78,-150.78,-1,-81295,156235,237530,74940,0,-49881,0,0,0,,49881,-49881
16,04/19/2018,1,0:00,0:15,,-12.6,0,-12.6,-12.6,-1,-23299,138873,162172,115574,0,-65344,0,0,0,,65344,-65344
16,04/19/2018,2,0:15,0:30,,-150.03,0,-150.03,-150.03,-1,-18650,128646,147296,109996,0,-72390,0,0,0,,72390,-72390
16,04/19/2018,3,0:30,0:45,,-150.03,0,-150.03,-150.03,-1,-55463,108280,163743,52817,0,-66959,0,0,0,,66959,-66959
16,04/19/2018,4,0:45,1:00,,-150.03,0,-150.03,-150.03,-1,-50107,146930,197037,96823,0,-71912,0,0,0,,71912,-71912
16,04/19/2018,5,1:00,1:15,,25.65,0,25.65,25.65,-1,-44394,111184,155578,66790,0,-38410,0,0,0,,38410,-38410
16,04/19/2018,6,1:15,1:30,,-150.03,0,-150.03,-150.03,-1,-48814,152944,201758,104130,0,-37638,0,0,0,,37638,-37638
16,04/19/2018,7,1:30,1:45,,-4.03,0,-4.03,-4.03,-1,-78170,170076,248246,91906,0,-89969,0,0,0,,89969,-89969
16,04/19/2018,8,1:45,2:00,,-39.6,0,-39.6,-39.6,-1,-74909,184915,259824,110006,0,-86054,0,0,0,,86054,-86054
16,04/19/2018,9,2:00,2:15,,6.75,0,6.75,6.75,-1,-72062,126357,198419,54295,0,-49650,0,0,0,,49650,-49650
16,04/19/2018,10,2:15,2:30,,-22.03,0,-22.03,-22.03,-1,-67573,135875,203448,68302,0,-21398,0,0,0,,21398,-21398
16,04/19/2018,11,2:30,2:45,,-150.03,0,-150.03,-150.03,-1,-86969,105135,192104,18166,0,-37083,0,0,0,,37083,-37083
16,04/19/2018,12,2:45,3:00,,-12.6,0,-12.6,-12.6,-1,-67110,121360,188470,54250,0,-40939,0,0,0,,40939,-40939
16,04/19/2018,13,3:00,3:15,,21.98,0,21.98,21.98,-1,-52625,129537,182162,76912,0,-54439,0,0,0,,54439,-54439
16,04/19/2018,14,3:15,3:30,,21.98,0,21.98,21.98,-1,-53611,115797,169408,62186,0,-61320,0,0,0,,61320,-61320
16,04/19/2018,15,3:30,3:45,,23.4,0,23.4,23.4,-1,-50027,113520,163547,63493,0,-63005,0,0,0,,63005,-63005
16,04/19/2018,16,3:45,4:00,,11.4,0,11.4,11.4,-1,-42783,114801,157584,72018,0,-69224,0,0,0,,69224,-69224
16,04/19/2018,17,4:00,4:15,,11.4,0,11.4,11.4,-1,-52829,112777,165606,59948,0,-64357,0,0,0,,64357,-64357
16,04/19/2018,18,4:15,4:30,,25.91,0,25.91,25.91,-1,-49710,103756,153466,54046,0,-44843,0,0,0,,44843,-44843
16,04/19/2018,19,4:30,4:45,,24.66,0,24.66,24.66,-1,-54712,104166,158878,49454,0,-44453,0,0,0,,44453,-44453
16,04/19/2018,20,4:45,5:00,,29.01,0,29.01,29.01,-1,-59373,99026,158399,39653,0,-22803,0,0,0,,22803,-22803
16,04/19/2018,21,5:00,5:15,,-150.03,0,-150.03,-150.03,-1,-45966,111101,157067,65135,0,-28325,0,0,0,,28325,-28325
16,04/19/2018,22,5:15,5:30,,23.4,0,23.4,23.4,-1,-47110,93626,140736,46516,0,-41987,0,0,0,,41987,-41987
16,04/19/2018,23,5:30,5:45,36.77,23.4,0,36.77,36.77,1,-61828,74753,136581,12925,0,-6346,123,0,0,,6469,-6223
16,04/19/2018,24,5:45,6:00,,28.77,0,28.77,28.77,-1,-58066,109205,167271,51139,0,-921,0,0,0,,921,-921
16,04/19/2018,25,6:00,6:15,,32.11,0,32.11,32.11,-1,-61683,70614,132297,8931,0,-5712,0,0,0,,5712,-5712
16,04/19/2018,26,6:15,6:30,,22.67,0,22.67,22.67,-1,-33601,94089,127690,60488,0,-30469,0,0,0,,30469,-30469
16,04/19/2018,27,6:30,6:45,,22.81,0,22.81,22.81,-1,-35448,90734,126182,55286,0,-43860,0,0,0,,43860,-43860
16,04/19/2018,28,6:45,7:00,35.69,31.03,0,35.69,35.69,1,-76613,84623,161236,8010,0,-18601,86,0,0,,18687,-18515
16,04/19/2018,29,7:00,7:15,35.82,32.41,0,37.18,32.41,2,-53564,126843,180407,73279,0,-3566,34,0,0,,3600,-3532
16,04/19/2018,30,7:15,7:30,39.96,27.49,0,39.96,27.49,2,-80055,97432,177487,17377,0,-17877,211,0,0,,18088,-17666
16,04/19/2018,31,7:30,7:45,47.31,27.49,0,47.31,47.31,1,-104319,61528,165847,-42791,0,-1348,8565,0,0,,9913,7217
16,04/19/2018,32,7:45,8:00,62,,0,62,62,1,-124763,61931,186694,-62832,0,0,23259,0,0,,23259,23259
16,04/19/2018,33,8:00,8:15,36.41,32.53,0,37.41,32.53,2,-79824,66667,146491,-13157,0,-1011,8081,0,0,,9092,7070
16,04/19/2018,34,8:15,8:30,38.85,,0,38.85,38.85,1,-99183,55650,154833,-43533,0,0,1122,0,0,,1122,1122
16,04/19/2018,35,8:30,8:45,,,0,37.27,37.27,0,-77874,49554,127428,-28320,0,0,16,0,0,,16,16
16,04/19/2018,36,8:45,9:00,40.41,,0,40.41,40.41,1,-88874,37240,126114,-51634,0,0,3237,0,0,,3237,3237
16,04/19/2018,37,9:00,9:15,36.41,,0,36.41,36.41,1,-94365,70841,165206,-23524,0,0,1595,0,0,,1595,1595
16,04/19/2018,38,9:15,9:30,39.33,,0,39.33,39.33,1,-92357,61097,153454,-31260,0,0,2135,0,0,,2135,2135
16,04/19/2018,39,9:30,9:45,36.41,,0,36.41,36.41,1,-87923,59906,147829,-28017,0,0,3739,0,0,,3739,3739
16,04/19/2018,40,9:45,10:00,40.41,,0,40.41,40.41,1,-94908,57405,152313,-37503,0,0,5503,0,0,,5503,5503
16,04/19/2018,41,10:00,10:15,40.41,,0,40.41,40.41,1,-162193,81503,243696,-80690,0,0,4970,0,0,,4970,4970
16,04/19/2018,42,10:15,10:30,42.06,,0,42.06,42.06,1,-143528,66373,209901,-77155,0,0,7217,0,0,,7217,7217
16,04/19/2018,43,10:30,10:45,36.41,,0,36.41,36.41,1,-120788,57051,177839,-63737,0,0,3966,0,0,,3966,3966
16,04/19/2018,44,10:45,11:00,,,0,36.83,36.83,0,-94403,46434,140837,-47969,0,0,195,0,0,,195,195
16,04/19/2018,45,11:00,11:15,,,0,36.45,36.45,0,-121577,37288,158865,-84289,0,0,0,0,0,,0,0
16,04/19/2018,46,11:15,11:30,,,0,36.45,36.45,0,-108725,44996,153721,-63729,0,0,0,0,0,,0,0
16,04/19/2018,47,11:30,11:45,,,0,36.45,36.45,0,-111313,42219,153532,-69094,0,0,0,0,0,,0,0
16,04/19/2018,48,11:45,12:00,45.79,,0,45.79,45.79,1,-104543,44158,148701,-60385,0,0,5156,0,0,,5156,5156
16,04/19/2018,49,12:00,12:15,36.41,,0,36.41,36.41,1,-62074,66822,128896,4748,0,0,852,0,0,,852,852
16,04/19/2018,50,12:15,12:30,36.41,38.38,0,38.38,38.38,-1,-48579,52285,100864,3706,0,-20,22,0,0,,42,2
16,04/19/2018,51,12:30,12:45,,37.25,0,37.25,37.25,-1,-55499,60981,116480,5482,0,-367,0,0,0,,367,-367
16,04/19/2018,52,12:45,13:00,37.92,,0,37.92,37.92,1,-67053,53664,120717,-13389,0,0,1998,0,0,,1998,1998
16,04/19/2018,53,13:00,13:15,36.41,,0,36.41,36.41,1,-52279,56091,108370,3812,0,0,876,0,0,,876,876
16,04/19/2018,54,13:15,13:30,38.34,,0,38.34,38.34,1,-75795,45722,121517,-30073,0,0,9319,0,0,,9319,9319
16,04/19/2018,55,13:30,13:45,36.41,,0,36.41,36.41,1,-81419,34748,116167,-46671,0,0,8636,0,0,,8636,8636
16,04/19/2018,56,13:45,14:00,39.03,,0,39.03,39.03,1,-75671,27382,103053,-48289,0,0,5098,0,0,,5098,5098
16,04/19/2018,57,14:00,14:15,47.31,,0,47.31,47.31,1,-112165,37095,149260,-75070,0,0,25521,0,0,,25521,25521
16,04/19/2018,58,14:15,14:30,47.31,,0,47.31,47.31,1,-107452,31436,138888,-76016,0,0,37447,0,0,,37447,37447
16,04/19/2018,59,14:30,14:45,38.3,,0,38.3,38.3,1,-89712,46861,136573,-42851,0,0,13410,0,0,,13410,13410
16,04/19/2018,60,14:45,15:00,38.3,34.81,0,34.81,34.81,-1,-74447,56363,130810,-18084,0,-163,6,0,0,,169,-157
16,04/19/2018,61,15:00,15:15,,34.53,0,34.53,34.53,-1,-56814,82984,139798,26170,0,-733,0,0,0,,733,-733
16,04/19/2018,62,15:15,15:30,,32.41,0,32.41,32.41,-1,-56559,53961,110520,-2598,0,-4560,0,0,0,,4560,-4560
16,04/19/2018,63,15:30,15:45,,,0,36.68,36.68,0,-79886,56597,136483,-23289,0,-85,0,0,0,,85,-85
16,04/19/2018,64,15:45,16:00,,,0,35.42,35.42,0,-100016,50265,150281,-49751,0,0,0,0,0,,0,0
16,04/19/2018,65,16:00,16:15,,,0,35.52,35.52,0,-111482,50320,161802,-61162,0,0,0,0,0,,0,0
16,04/19/2018,66,16:15,16:30,,35.76,0,35.76,35.76,-1,-59502,57700,117202,-1802,0,-570,0,0,0,,570,-570
16,04/19/2018,67,16:30,16:45,,32.41,0,32.41,32.41,-1,-53893,55707,109600,1814,0,-724,0,0,0,,724,-724
16,04/19/2018,68,16:45,17:00,,34.97,0,34.97,34.97,-1,-65884,63671,129555,-2213,0,-290,0,0,0,,290,-290
16,04/19/2018,69,17:00,17:15,,38.48,0,38.48,38.48,-1,-130848,40172,171020,-90676,0,-71,0,0,0,,71,-71
16,04/19/2018,70,17:15,17:30,,,0,36.6,36.6,0,-86092,35667,121759,-50425,0,0,0,0,0,,0,0
16,04/19/2018,71,17:30,17:45,41.41,,0,41.41,41.41,1,-77112,42497,119609,-34615,0,0,2959,0,0,,2959,2959
16,04/19/2018,72,17:45,18:00,41.41,,0,41.41,41.41,1,-83501,80155,163656,-3346,0,0,5688,0,0,,5688,5688
16,04/19/2018,73,18:00,18:15,45.41,,0,45.41,45.41,1,-85909,34002,119911,-51907,0,0,9480,0,0,,9480,9480
16,04/19/2018,74,18:15,18:30,46.55,,0,46.55,46.55,1,-79901,38860,118761,-41041,0,0,27206,0,0,,27206,27206
16,04/19/2018,75,18:30,18:45,88.97,,0,88.97,88.97,1,-107987,39351,147338,-68636,0,0,52650,0,0,,52650,52650
16,04/19/2018,76,18:45,19:00,147.02,,0,147.02,147.02,1,-184383,41165,225548,-143218,0,0,103037,0,0,,103037,103037
16,04/19/2018,77,19:00,19:15,147.02,,0,147.02,147.02,1,-125981,66530,192511,-59451,0,0,74036,0,0,,74036,74036
16,04/19/2018,78,19:15,19:30,45.41,,0,45.41,45.41,1,-129731,82326,212057,-47405,0,0,18413,0,0,,18413,18413
16,04/19/2018,79,19:30,19:45,69.02,,0,69.02,69.02,1,-137340,83712,221052,-53628,0,0,31385,0,0,,31385,31385
16,04/19/2018,80,19:45,20:00,88.86,,0,88.86,88.86,1,-145430,88511,233941,-56919,0,0,58148,0,0,,58148,58148
16,04/19/2018,81,20:00,20:15,88.86,-47.19,0,-47.19,-47.19,-1,-29032,109896,138928,80864,0,-20907,15665,0,0,,36572,-5242
16,04/19/2018,82,20:15,20:30,,28.41,0,28.41,28.41,-1,-61888,89423,151311,27535,0,-14759,0,0,0,,14759,-14759
16,04/19/2018,83,20:30,20:45,,26.72,0,26.72,26.72,-1,-88290,113851,202141,25561,0,-16544,0,0,0,,16544,-16544
16,04/19/2018,84,20:45,21:00,,28.41,0,28.41,28.41,-1,-95216,121314,216530,26098,0,-6548,0,0,0,,6548,-6548
16,04/19/2018,85,21:00,21:15,47.01,38.01,0,47.01,47.01,1,-114326,111846,226172,-2480,0,-3111,1002,0,0,,4113,-2109
16,04/19/2018,86,21:15,21:30,55.72,,0,55.72,55.72,1,-126888,127461,254349,573,0,0,10715,0,0,,10715,10715
16,04/19/2018,87,21:30,21:45,,,0,38.46,38.46,0,-110979,145746,256725,34767,0,0,421,0,0,,421,421
16,04/19/2018,88,21:45,22:00,,22.95,0,22.95,22.95,-1,-83850,153876,237726,70026,0,-8371,0,0,0,,8371,-8371
16,04/19/2018,89,22:00,22:15,120,22.95,0,120,120,1,-150173,94777,244950,-55396,0,-2848,16133,0,0,,18981,13285
16,04/19/2018,90,22:15,22:30,45.98,32.41,0,45.98,32.41,2,-75180,101556,176736,26376,0,-599,6213,0,0,,6812,5614
16,04/19/2018,91,22:30,22:45,,11.31,0,11.31,11.31,-1,-77225,141827,219052,64602,0,-20580,0,0,0,,20580,-20580
16,04/19/2018,92,22:45,23:00,,32.41,0,32.41,32.41,-1,-80297,191222,271519,110925,0,-9966,0,0,0,,9966,-9966
16,04/19/2018,93,23:00,23:15,,24.03,0,24.03,24.03,-1,-117853,145197,263050,27344,0,-8037,0,0,0,,8037,-8037
16,04/19/2018,94,23:15,23:30,,,0,37.84,37.84,0,-79087,141863,220950,62776,0,-69,0,0,0,,69,-69
16,04/19/2018,95,23:30,23:45,,,0,37.39,37.39,0,-74634,123367,198001,48733,0,0,0,0,0,,0,0
16,04/19/2018,96,23:45,0:00,,32.41,0,32.41,32.41,-1,-75650,107759,183409,32109,0,-3501,0,0,0,,3501,-3501
16,04/20/2018,1,0:00,0:15,,32.48,0,32.48,32.48,-1,-123163,165976,289139,42813,0,-2756,0,0,0,,2756,-2756
16,04/20/2018,2,0:15,0:30,58.57,,0,58.57,58.57,1,-112840,73101,185941,-39739,0,0,15825,0,0,,15825,15825
16,04/20/2018,3,0:30,0:45,40.48,,0,40.48,40.48,1,-87833,70754,158587,-17079,0,0,21702,0,0,,21702,21702
16,04/20/2018,4,0:45,1:00,40.48,,0,40.48,40.48,1,-116230,81470,197700,-34760,0,0,8878,0,0,,8878,8878
16,04/20/2018,5,1:00,1:15,35.7,30.97,0,35.7,30.97,2,-115551,158651,274202,43100,0,-530,2340,0,0,,2870,1810
16,04/20/2018,6,1:15,1:30,36.48,,0,36.48,36.48,1,-123827,112829,236656,-10998,0,0,2498,0,0,,2498,2498
16,04/20/2018,7,1:30,1:45,,,0,35.45,35.45,0,-106963,108983,215946,2020,0,0,0,0,0,,0,0
16,04/20/2018,8,1:45,2:00,,,0,35.45,35.45,0,-97446,86345,183791,-11101,0,0,0,0,0,,0,0
16,04/20/2018,9,2:00,2:15,70.32,,0,70.32,70.32,1,-110732,58637,169369,-52095,0,0,21459,0,0,,21459,21459
16,04/20/2018,10,2:15,2:30,46.84,,0,46.84,46.84,1,-95462,73175,168637,-22287,0,0,38278,0,0,,38278,38278
16,04/20/2018,11,2:30,2:45,46.84,35.12,0,46.84,34.62,2,-87795,58926,146721,-28869,0,-193,5213,0,0,,5406,5020
16,04/20/2018,12,2:45,3:00,53.78,,0,53.78,53.78,1,-87357,57116,144473,-30241,0,0,20534,0,0,,20534,20534
16,04/20/2018,13,3:00,3:15,,,0,34.38,34.38,0,-55164,81583,136747,26419,0,0,2026,0,0,,2026,2026
16,04/20/2018,14,3:15,3:30,,,0,34.53,34.53,0,-55439,62662,118101,7223,0,0,0,0,0,,0,0
16,04/20/2018,15,3:30,3:45,,32.48,0,32.48,32.48,-1,-51377,72977,124354,21600,0,-3225,0,0,0,,3225,-3225
16,04/20/2018,16,3:45,4:00,,31.17,0,31.17,31.17,-1,-37463,76944,114407,39481,0,-6412,0,0,0,,6412,-6412
16,04/20/2018,17,4:00,4:15,,28.78,0,28.78,28.78,-1,-45818,83867,129685,38049,0,-17821,0,0,0,,17821,-17821
16,04/20/2018,18,4:15,4:30,,32.48,0,32.48,32.48,-1,-38418,82235,120653,43817,0,-8210,0,0,0,,8210,-8210
16,04/20/2018,19,4:30,4:45,,32.48,0,32.48,32.48,-1,-33931,74855,108786,40924,0,-2688,0,0,0,,2688,-2688
16,04/20/2018,20,4:45,5:00,,32.48,0,32.48,32.48,-1,-46821,70977,117798,24156,0,-2845,0,0,0,,2845,-2845
16,04/20/2018,21,5:00,5:15,,8.78,0,8.78,8.78,-1,-49756,103624,153380,53868,0,-22295,0,0,0,,22295,-22295
16,04/20/2018,22,5:15,5:30,,2.65,0,2.65,2.65,-1,-52659,94126,146785,41467,0,-50845,0,0,0,,50845,-50845
16,04/20/2018,23,5:30,5:45,,32.48,0,32.48,32.48,-1,-57482,78067,135549,20585,0,-7915,0,0,0,,7915,-7915
16,04/20/2018,24,5:45,6:00,,31.52,0,31.52,31.52,-1,-57060,127177,184237,70117,0,-1176,0,0,0,,1176,-1176
16,04/20/2018,25,6:00,6:15,,29.34,0,29.34,29.34,-1,-46420,68020,114440,21600,0,-7490,0,0,0,,7490,-7490
16,04/20/2018,26,6:15,6:30,,28.65,0,28.65,28.65,-1,-48220,89207,137427,40987,0,-19906,0,0,0,,19906,-19906
16,04/20/2018,27,6:30,6:45,,38.07,0,38.07,38.07,-1,-49737,72262,121999,22525,0,-3966,0,0,0,,3966,-3966
16,04/20/2018,28,6:45,7:00,40.65,,0,40.65,40.65,1,-58366,56023,114389,-2343,0,0,2157,0,0,,2157,2157
16,04/20/2018,29,7:00,7:15,,-150.78,0,-150.78,-150.78,-1,-55747,144635,200382,88888,0,-43747,0,0,0,,43747,-43747
16,04/20/2018,30,7:15,7:30,,33.78,0,33.78,33.78,-1,-57809,59227,117036,1418,0,-5881,0,0,0,,5881,-5881
16,04/20/2018,31,7:30,7:45,41.3,33.78,0,41.3,41.3,1,-69736,43108,112844,-26628,0,-362,7223,0,0,,7585,6861
16,04/20/2018,32,7:45,8:00,49.3,,0,49.3,49.3,1,-72216,33610,105826,-38606,0,0,19432,0,0,,19432,19432
16,04/20/2018,33,8:00,8:15,36.65,,0,36.65,36.65,1,-82352,84832,167184,2480,0,0,9081,0,0,,9081,9081
16,04/20/2018,34,8:15,8:30,36.65,,0,36.65,36.65,1,-64673,76313,140986,11640,0,0,177,0,0,,177,177
16,04/20/2018,35,8:30,8:45,,38.61,0,38.61,38.61,-1,-58862,73901,132763,15039,0,-563,0,0,0,,563,-563
16,04/20/2018,36,8:45,9:00,,38.31,0,38.31,38.31,-1,-53886,59555,113441,5669,0,-571,0,0,0,,571,-571
16,04/20/2018,37,9:00,9:15,36.65,,0,36.65,36.65,1,-111356,88185,199541,-23171,0,0,568,0,0,,568,568
16,04/20/2018,38,9:15,9:30,40.65,,0,40.65,40.65,1,-124831,72442,197273,-52389,0,0,7529,0,0,,7529,7529
16,04/20/2018,39,9:30,9:45,40.65,,0,40.65,40.65,1,-123975,66219,190194,-57756,0,0,14246,0,0,,14246,14246
16,04/20/2018,40,9:45,10:00,40.25,,0,40.25,40.25,1,-111514,63304,174818,-48210,0,0,13803,0,0,,13803,13803
16,04/20/2018,41,10:00,10:15,147.12,,0,147.12,147.12,1,-158778,64715,223493,-94063,0,0,41044,0,0,,41044,41044
16,04/20/2018,42,10:15,10:30,49.07,,0,49.07,49.07,1,-123483,66612,190095,-56871,0,0,30116,0,0,,30116,30116
16,04/20/2018,43,10:30,10:45,,,0,37.24,37.24,0,-109018,58913,167931,-50105,0,0,631,0,0,,631,631
16,04/20/2018,44,10:45,11:00,47.56,,0,47.56,47.56,1,-111143,37671,148814,-73472,0,0,11793,0,0,,11793,11793
16,04/20/2018,45,11:00,11:15,147.12,,0,147.12,147.12,1,-141036,27278,168314,-113758,0,0,51058,0,0,,51058,51058
16,04/20/2018,46,11:15,11:30,147.12,,0,147.12,147.12,1,-117520,22521,140041,-94999,0,0,86354,0,0,,86354,86354
16,04/20/2018,47,11:30,11:45,39.75,,0,39.75,39.75,1,-88772,21848,110620,-66924,0,0,8850,0,0,,8850,8850
16,04/20/2018,48,11:45,12:00,47.56,,0,47.56,47.56,1,-134746,24676,159422,-110070,0,0,8155,0,0,,8155,8155
16,04/20/2018,49,12:00,12:15,147.12,,0,147.12,147.12,1,-174799,42158,216957,-132641,0,0,62805,0,0,,62805,62805
16,04/20/2018,50,12:15,12:30,147.12,,0,147.12,147.12,1,-139340,45396,184736,-93944,0,0,108876,0,0,,108876,108876
16,04/20/2018,51,12:30,12:45,48.22,,0,48.22,48.22,1,-92237,44796,137033,-47441,0,0,53937,0,0,,53937,53937
16,04/20/2018,52,12:45,13:00,41.38,,0,41.38,41.38,1,-75415,50467,125882,-24948,0,0,28270,0,0,,28270,28270
16,04/20/2018,53,13:00,13:15,38.35,,0,38.35,38.35,1,-74845,68929,143774,-5916,0,0,8152,0,0,,8152,8152
16,04/20/2018,54,13:15,13:30,43.22,,0,43.22,43.22,1,-96268,66099,162367,-30169,0,0,16483,0,0,,16483,16483
16,04/20/2018,55,13:30,13:45,47.56,,0,47.56,47.56,1,-102579,63546,166125,-39033,0,0,25443,0,0,,25443,25443
16,04/20/2018,56,13:45,14:00,47.56,,0,47.56,47.56,1,-94935,55851,150786,-39084,0,0,40527,0,0,,40527,40527
16,04/20/2018,57,14:00,14:15,42.56,,0,42.56,42.56,1,-88866,57071,145937,-31795,0,0,31351,0,0,,31351,31351
16,04/20/2018,58,14:15,14:30,42.12,,0,42.12,42.12,1,-83070,55853,138923,-27217,0,0,29553,0,0,,29553,29553
16,04/20/2018,59,14:30,14:45,41.6,,0,41.6,41.6,1,-80958,57112,138070,-23846,0,0,22182,0,0,,22182,22182
16,04/20/2018,60,14:45,15:00,46.12,,0,46.12,46.12,1,-89014,52884,141898,-36130,0,0,24325,0,0,,24325,24325
16,04/20/2018,61,15:00,15:15,46.12,32.65,0,32.65,32.65,-1,-69264,98812,168076,29548,0,-1000,7930,0,0,,8930,6930
16,04/20/2018,62,15:15,15:30,,,0,36.94,36.94,0,-71015,82146,153161,11131,0,0,0,0,0,,0,0
16,04/20/2018,63,15:30,15:45,40.05,,0,40.05,40.05,1,-83336,80539,163875,-2797,0,0,569,0,0,,569,569
16,04/20/2018,64,15:45,16:00,34.85,,0,34.85,34.85,1,-78989,84241,163230,5252,0,0,1149,0,0,,1149,1149
16,04/20/2018,65,16:00,16:15,39.03,,0,39.03,39.03,1,-68838,64116,132954,-4722,0,0,510,0,0,,510,510
16,04/20/2018,66,16:15,16:30,38.97,,0,38.97,38.97,1,-69789,74308,144097,4519,0,0,1502,0,0,,1502,1502
16,04/20/2018,67,16:30,16:45,34.75,,0,34.75,34.75,1,-78571,82693,161264,4122,0,0,907,0,0,,907,907
16,04/20/2018,68,16:45,17:00,54.56,,0,54.56,54.56,1,-96733,63600,160333,-33133,0,0,14041,0,0,,14041,14041
16,04/20/2018,69,17:00,17:15,41.18,38.22,0,38.22,38.22,-1,-73649,75626,149275,1977,0,-88,9805,0,0,,9893,9717
16,04/20/2018,70,17:15,17:30,41.18,38.09,0,38.09,38.09,-1,-69294,71801,141095,2507,0,-942,59,0,0,,1001,-883
16,04/20/2018,71,17:30,17:45,47.65,,0,47.65,47.65,1,-83649,67326,150975,-16323,0,0,1782,0,0,,1782,1782
16,04/20/2018,72,17:45,18:00,47.65,,0,47.65,47.65,1,-70007,68358,138365,-1649,0,0,12119,0,0,,12119,12119
16,04/20/2018,73,18:00,18:15,47.65,,0,47.65,47.65,1,-95786,63621,159407,-32165,0,0,8269,0,0,,8269,8269
16,04/20/2018,74,18:15,18:30,43.46,,0,43.46,43.46,1,-76092,58853,134945,-17239,0,0,7018,0,0,,7018,7018
16,04/20/2018,75,18:30,18:45,43.52,,0,43.52,43.52,1,-78310,58978,137288,-19332,0,0,16731,0,0,,16731,16731
16,04/20/2018,76,18:45,19:00,47.65,,0,47.65,47.65,1,-81451,51953,133404,-29498,0,0,23010,0,0,,23010,23010
16,04/20/2018,77,19:00,19:15,54.56,,0,54.56,54.56,1,-99833,49269,149102,-50564,0,0,35170,0,0,,35170,35170
16,04/20/2018,78,19:15,19:30,47.65,,0,47.65,47.65,1,-91198,52239,143437,-38959,0,0,37197,0,0,,37197,37197
16,04/20/2018,79,19:30,19:45,44.66,,0,44.66,44.66,1,-78660,45276,123936,-33384,0,0,32489,0,0,,32489,32489
16,04/20/2018,80,19:45,20:00,40.05,,0,40.05,40.05,1,-74108,59756,133864,-14352,0,0,20781,0,0,,20781,20781
16,04/20/2018,81,20:00,20:15,40.05,28.65,0,28.65,28.65,-1,-38602,71578,110180,32976,0,-11918,3444,0,0,,15362,-8474
16,04/20/2018,82,20:15,20:30,,34.71,0,34.71,34.71,-1,-44465,66190,110655,21725,0,-15606,0,0,0,,15606,-15606
16,04/20/2018,83,20:30,20:45,,29.35,0,29.35,29.35,-1,-48667,83599,132266,34932,0,-22613,0,0,0,,22613,-22613
16,04/20/2018,84,20:45,21:00,40.05,33.78,0,40.05,40.05,1,-56313,53314,109627,-2999,0,-15547,462,0,0,,16009,-15085
16,04/20/2018,85,21:00,21:15,40.05,33.78,0,40.05,40.05,1,-43700,55346,99046,11646,0,-258,250,0,0,,508,-8
16,04/20/2018,86,21:15,21:30,46.72,,0,46.72,46.72,1,-53243,31785,85028,-21458,0,0,9878,0,0,,9878,9878
16,04/20/2018,87,21:30,21:45,45.12,38.92,0,38.92,38.92,-1,-39201,52485,91686,13284,0,-7,17286,0,0,,17293,17279
16,04/20/2018,88,21:45,22:00,45.12,31.16,0,31.16,31.16,-1,-32566,101623,134189,69057,0,-5150,662,0,0,,5812,-4488
16,04/20/2018,89,22:00,22:15,50.56,33.78,0,50.56,33.78,2,-87559,36341,123900,-51218,0,-3963,7604,0,0,,11567,3641
16,04/20/2018,90,22:15,22:30,40.05,,0,40.05,40.05,1,-69165,61727,130892,-7438,0,0,4567,0,0,,4567,4567
16,04/20/2018,91,22:30,22:45,,35.17,0,35.17,35.17,-1,-46333,75222,121555,28889,0,-557,0,0,0,,557,-557
16,04/20/2018,92,22:45,23:00,,31.16,0,31.16,31.16,-1,-38166,92565,130731,54399,0,-11860,0,0,0,,11860,-11860
16,04/20/2018,93,23:00,23:15,50.56,32.65,0,50.56,32.65,2,-62035,40430,102465,-21605,0,-8995,3839,0,0,,12834,-5156
16,04/20/2018,94,23:15,23:30,38.12,34.49,0,38.12,34.49,2,-51817,53533,105350,1716,0,-336,1292,0,0,,1628,956
16,04/20/2018,95,23:30,23:45,,32.78,0,32.78,32.78,-1,-39917,69281,109198,29364,0,-8928,0,0,0,,8928,-8928
16,04/20/2018,96,23:45,0:00,,32.65,0,32.65,32.65,-1,-82428,67658,150086,-14770,0,-8012,0,0,0,,8012,-8012
17,04/21/2018,1,0:00,0:15,,29.02,0,29.02,29.02,-1,-50850,106887,157737,56037,0,-535,0,0,0,,535,-535
17,04/21/2018,2,0:15,0:30,37.79,,0,37.79,37.79,1,-48323,33231,81554,-15092,0,0,1563,0,0,,1563,1563
17,04/21/2018,3,0:30,0:45,37.66,,0,37.66,37.66,1,-56218,21625,77843,-34593,0,0,2116,0,0,,2116,2116
17,04/21/2018,4,0:45,1:00,41.14,,0,41.14,41.14,1,-53935,13652,67587,-40283,0,0,6429,0,0,,6429,6429
17,04/21/2018,5,1:00,1:15,,,0,34.48,34.48,0,-44820,77510,122330,32690,0,0,1952,0,0,,1952,1952
17,04/21/2018,6,1:15,1:30,,33.02,0,33.02,33.02,-1,-38782,52127,90909,13345,0,-58,0,0,0,,58,-58
17,04/21/2018,7,1:30,1:45,,33.02,0,33.02,33.02,-1,-29023,64217,93240,35194,0,-1573,0,0,0,,1573,-1573
17,04/21/2018,8,1:45,2:00,,23.1,0,23.1,23.1,-1,-21525,62551,84076,41026,0,-23177,0,0,0,,23177,-23177
17,04/21/2018,9,2:00,2:15,37.02,29.94,0,37.02,37.02,1,-42037,39469,81506,-2568,0,-12882,380,0,0,,13262,-12502
17,04/21/2018,10,2:15,2:30,37.02,34.07,0,34.07,34.07,-1,-29128,40918,70046,11790,0,-349,47,0,0,,396,-302
17,04/21/2018,11,2:30,2:45,,33.02,0,33.02,33.02,-1,-25123,45954,71077,20831,0,-1854,0,0,0,,1854,-1854
17,04/21/2018,12,2:45,3:00,,33.02,0,33.02,33.02,-1,-28137,53354,81491,25217,0,-3744,0,0,0,,3744,-3744
17,04/21/2018,13,3:00,3:15,41.14,36.47,0,41.14,35.25,2,-55732,32177,87909,-23555,0,-1207,2950,0,0,,4157,1743
17,04/21/2018,14,3:15,3:30,34.14,,0,34.14,34.14,1,-26454,56407,82861,29953,0,0,958,0,0,,958,958
17,04/21/2018,15,3:30,3:45,,,0,35.26,35.26,0,-22013,56889,78902,34876,0,0,0,0,0,,0,0
17,04/21/2018,16,3:45,4:00,,29.02,0,29.02,29.02,-1,-19978,76838,96816,56860,0,-1611,0,0,0,,1611,-1611
17,04/21/2018,17,4:00,4:15,,33.02,0,33.02,33.02,-1,-15933,47599,63532,31666,0,-3708,0,0,0,,3708,-3708
17,04/21/2018,18,4:15,4:30,,29.02,0,29.02,29.02,-1,-21527,52831,74358,31304,0,-11488,0,0,0,,11488,-11488
17,04/21/2018,19,4:30,4:45,,33.02,0,33.02,33.02,-1,-17953,39613,57566,21660,0,-15868,0,0,0,,15868,-15868
17,04/21/2018,20,4:45,5:00,,33.02,0,33.02,33.02,-1,-15615,50290,65905,34675,0,-12429,0,0,0,,12429,-12429
17,04/21/2018,21,5:00,5:15,,33.02,0,33.02,33.02,-1,-26243,66838,93081,40595,0,-4597,0,0,0,,4597,-4597
17,04/21/2018,22,5:15,5:30,,36.51,0,36.51,36.51,-1,-24880,42235,67115,17355,0,-290,0,0,0,,290,-290
17,04/21/2018,23,5:30,5:45,,36.47,0,36.47,36.47,-1,-26224,38453,64677,12229,0,-1192,0,0,0,,1192,-1192
17,04/21/2018,24,5:45,6:00,,33.02,0,33.02,33.02,-1,-36112,46168,82280,10056,0,-2980,0,0,0,,2980,-2980
17,04/21/2018,25,6:00,6:15,,28.94,0,28.94,28.94,-1,-27017,75572,102589,48555,0,-15679,0,0,0,,15679,-15679
17,04/21/2018,26,6:15,6:30,,16.31,0,16.31,16.31,-1,-22695,83356,106051,60661,0,-21244,0,0,0,,21244,-21244
17,04/21/2018,27,6:30,6:45,,11.08,0,11.08,11.08,-1,-22136,75951,98087,53815,0,-49303,0,0,0,,49303,-49303
17,04/21/2018,28,6:45,7:00,,32.78,0,32.78,32.78,-1,-23742,50755,74497,27013,0,-18754,0,0,0,,18754,-18754
17,04/21/2018,29,7:00,7:15,,25.64,0,25.64,25.64,-1,-42350,71676,114026,29326,0,-7663,0,0,0,,7663,-7663
17,04/21/2018,30,7:15,7:30,,36.13,0,36.13,36.13,-1,-54917,60433,115350,5516,0,-382,0,0,0,,382,-382
17,04/21/2018,31,7:30,7:45,40.99,,0,40.99,40.99,1,-49454,35982,85436,-13472,0,0,2547,0,0,,2547,2547
17,04/21/2018,32,7:45,8:00,38.71,,0,38.71,38.71,1,-34692,36289,70981,1597,0,0,6080,0,0,,6080,6080
17,04/21/2018,33,8:00,8:15,,,0,35.16,35.16,0,-55468,98894,154362,43426,0,0,405,0,0,,405,405
17,04/21/2018,34,8:15,8:30,,,0,34.98,34.98,0,-42890,88455,131345,45565,0,0,0,0,0,,0,0
17,04/21/2018,35,8:30,8:45,,,0,34.92,34.92,0,-35745,80595,116340,44850,0,0,0,0,0,,0,0
17,04/21/2018,36,8:45,9:00,,,0,34.79,34.79,0,-31274,75966,107240,44692,0,0,0,0,0,,0,0
17,04/21/2018,37,9:00,9:15,,36.24,0,36.24,36.24,-1,-12247,94898,107145,82651,0,-7,0,0,0,,7,-7
17,04/21/2018,38,9:15,9:30,,36.22,0,36.22,36.22,-1,-13267,98516,111783,85249,0,-21,0,0,0,,21,-21
17,04/21/2018,39,9:30,9:45,,33.69,0,33.69,33.69,-1,-13764,101458,115222,87694,0,-2126,0,0,0,,2126,-2126
17,04/21/2018,40,9:45,10:00,,5.35,0,5.35,5.35,-1,-15109,99005,114114,83896,0,-7595,0,0,0,,7595,-7595
17,04/21/2018,41,10:00,10:15,,-150.03,0,-150.03,-150.03,-1,-9890,150107,159997,140217,0,-38603,0,0,0,,38603,-38603
17,04/21/2018,42,10:15,10:30,,22.98,0,22.98,22.98,-1,-13030,93834,106864,80804,0,-26518,0,0,0,,26518,-26518
17,04/21/2018,43,10:30,10:45,,11.08,0,11.08,11.08,-1,-27669,128440,156109,100771,0,-37031,0,0,0,,37031,-37031
17,04/21/2018,44,10:45,11:00,,28.4,0,28.4,28.4,-1,-28435,131043,159478,102608,0,-20205,0,0,0,,20205,-20205
17,04/21/2018,45,11:00,11:15,,32.85,0,32.85,32.85,-1,-14772,103575,118347,88803,0,-3956,0,0,0,,3956,-3956
17,04/21/2018,46,11:15,11:30,,32.94,0,32.94,32.94,-1,-13327,119840,133167,106513,0,-1089,0,0,0,,1089,-1089
17,04/21/2018,47,11:30,11:45,,6.28,0,6.28,6.28,-1,-13159,159121,172280,145962,0,-25709,0,0,0,,25709,-25709
17,04/21/2018,48,11:45,12:00,,-150.03,0,-150.03,-150.03,-1,-14085,117366,131451,103281,0,-65181,0,0,0,,65181,-65181
17,04/21/2018,49,12:00,12:15,53.28,-150.03,0,53.28,53.28,1,-84884,50164,135048,-34720,0,-5956,5725,0,0,,11681,-231
17,04/21/2018,50,12:15,12:30,34.53,32.94,0,35.29,32.94,2,-52175,71022,123197,18847,0,-1673,910,0,0,,2583,-763
17,04/21/2018,51,12:30,12:45,,35.22,0,35.22,35.22,-1,-37449,77548,114997,40099,0,-2254,0,0,0,,2254,-2254
17,04/21/2018,52,12:45,13:00,,32.94,0,32.94,32.94,-1,-32528,77758,110286,45230,0,-305,0,0,0,,305,-305
17,04/21/2018,53,13:00,13:15,,32.94,0,32.94,32.94,-1,-28994,57763,86757,28769,0,-267,0,0,0,,267,-267
17,04/21/2018,54,13:15,13:30,,22.98,0,22.98,22.98,-1,-25679,70413,96092,44734,0,-4697,0,0,0,,4697,-4697
17,04/21/2018,55,13:30,13:45,,21.98,0,21.98,21.98,-1,-25508,60189,85697,34681,0,-32429,0,0,0,,32429,-32429
17,04/21/2018,56,13:45,14:00,,32.94,0,32.94,32.94,-1,-57442,65502,122944,8060,0,-17937,0,0,0,,17937,-17937
17,04/21/2018,57,14:00,14:15,,22.98,0,22.98,22.98,-1,-26160,122626,148786,96466,0,-9998,0,0,0,,9998,-9998
17,04/21/2018,58,14:15,14:30,,,0,34.79,34.79,0,-30644,94753,125397,64109,0,-621,0,0,0,,621,-621
17,04/21/2018,59,14:30,14:45,,,0,34.8,34.8,0,-25309,82591,107900,57282,0,0,0,0,0,,0,0
17,04/21/2018,60,14:45,15:00,,,0,34.8,34.8,0,-39851,67530,107381,27679,0,0,0,0,0,,0,0
17,04/21/2018,61,15:00,15:15,,,0,34.79,34.79,0,-34414,108013,142427,73599,0,0,0,0,0,,0,0
17,04/21/2018,62,15:15,15:30,,,0,34.79,34.79,0,-48180,78286,126466,30106,0,0,0,0,0,,0,0
17,04/21/2018,63,15:30,15:45,,,0,34.79,34.79,0,-40913,73010,113923,32097,0,0,0,0,0,,0,0
17,04/21/2018,64,15:45,16:00,,,0,34.79,34.79,0,-29947,73785,103732,43838,0,0,0,0,0,,0,0
17,04/21/2018,65,16:00,16:15,,24.88,0,24.88,24.88,-1,-15149,117685,132834,102536,0,-7493,0,0,0,,7493,-7493
17,04/21/2018,66,16:15,16:30,,28.94,0,28.94,28.94,-1,-14877,118133,133010,103256,0,-16705,0,0,0,,16705,-16705
17,04/21/2018,67,16:30,16:45,,35.81,0,35.81,35.81,-1,-17665,86629,104294,68964,0,-5349,0,0,0,,5349,-5349
17,04/21/2018,68,16:45,17:00,,,0,34.79,34.79,0,-23249,90269,113518,67020,0,0,0,0,0,,0,0
17,04/21/2018,69,17:00,17:15,,,0,35.42,35.42,0,-22162,90280,112442,68118,0,0,0,0,0,,0,0
17,04/21/2018,70,17:15,17:30,,35.95,0,35.95,35.95,-1,-18126,87806,105932,69680,0,-1092,0,0,0,,1092,-1092
17,04/21/2018,71,17:30,17:45,,36.59,0,36.59,36.59,-1,-35613,84876,120489,49263,0,-685,0,0,0,,685,-685
17,04/21/2018,72,17:45,18:00,,,0,35.28,35.28,0,-46234,72517,118751,26283,0,0,0,0,0,,0,0
17,04/21/2018,73,18:00,18:15,,,0,35.31,35.31,0,-42413,32277,74690,-10136,0,0,0,0,0,,0,0
17,04/21/2018,74,18:15,18:30,41.08,,0,41.08,41.08,1,-42285,26614,68899,-15671,0,0,3794,0,0,,3794,3794
17,04/21/2018,75,18:30,18:45,38.56,,0,38.56,38.56,1,-37716,22400,60116,-15316,0,0,9439,0,0,,9439,9439
17,04/21/2018,76,18:45,19:00,41.08,,0,41.08,41.08,1,-43337,19400,62737,-23937,0,0,18169,0,0,,18169,18169
17,04/21/2018,77,19:00,19:15,41.08,22.39,0,22.39,22.39,-1,-29056,58989,88045,29933,0,-8372,5567,0,0,,13939,-2805
17,04/21/2018,78,19:15,19:30,,28.94,0,28.94,28.94,-1,-30317,29624,59941,-693,0,-12185,0,0,0,,12185,-12185
17,04/21/2018,79,19:30,19:45,,,0,35.28,35.28,0,-31665,30721,62386,-944,0,-270,0,0,0,,270,-270
17,04/21/2018,80,19:45,20:00,37.04,,0,37.04,37.04,1,-28625,32679,61304,4054,0,0,270,0,0,,270,270
17,04/21/2018,81,20:00,20:15,,32.94,0,32.94,32.94,-1,-30063,44837,74900,14774,0,-1838,0,0,0,,1838,-1838
17,04/21/2018,82,20:15,20:30,,32.94,0,32.94,32.94,-1,-31747,47420,79167,15673,0,-3380,0,0,0,,3380,-3380
17,04/21/2018,83,20:30,20:45,,34.37,0,34.37,34.37,-1,-31662,56003,87665,24341,0,-3595,0,0,0,,3595,-3595
17,04/21/2018,84,20:45,21:00,,32.94,0,32.94,32.94,-1,-37010,54604,91614,17594,0,-5014,0,0,0,,5014,-5014
17,04/21/2018,85,21:00,21:15,,36.56,0,36.56,36.56,-1,-31873,53933,85806,22060,0,-2000,0,0,0,,2000,-2000
17,04/21/2018,86,21:15,21:30,,,0,37.04,37.04,0,-35127,43090,78217,7963,0,0,0,0,0,,0,0
17,04/21/2018,87,21:30,21:45,,,0,37.04,37.04,0,-35695,64357,100052,28662,0,0,0,0,0,,0,0
17,04/21/2018,88,21:45,22:00,,22.98,0,22.98,22.98,-1,-37026,77726,114752,40700,0,-8919,0,0,0,,8919,-8919
17,04/21/2018,89,22:00,22:15,,32.94,0,32.94,32.94,-1,-41164,78769,119933,37605,0,-9031,0,0,0,,9031,-9031
17,04/21/2018,90,22:15,22:30,,21.69,0,21.69,21.69,-1,-21184,80669,101853,59485,0,-3481,0,0,0,,3481,-3481
17,04/21/2018,91,22:30,22:45,,11.08,0,11.08,11.08,-1,-16935,56307,73242,39372,0,-9833,0,0,0,,9833,-9833
17,04/21/2018,92,22:45,23:00,,27.04,0,27.04,27.04,-1,-37755,80145,117900,42390,0,-8373,0,0,0,,8373,-8373
17,04/21/2018,93,23:00,23:15,40.99,32.94,0,40.99,32.94,2,-49145,31474,80619,-17671,0,-6331,3188,0,0,,9519,-3143
17,04/21/2018,94,23:15,23:30,39.64,35.08,0,39.64,35.08,2,-47976,39025,87001,-8951,0,-86,9065,0,0,,9151,8979
17,04/21/2018,95,23:30,23:45,39.64,22.98,0,22.98,22.98,-1,-31364,68046,99410,36682,0,-23225,864,0,0,,24089,-22361
17,04/21/2018,96,23:45,0:00,,22.98,0,22.98,22.98,-1,-69555,108383,177938,38828,0,-50774,0,0,0,,50774,-50774
17,04/22/2018,1,0:00,0:15,34.53,28.94,0,34.53,34.53,1,-64239,69128,133367,4889,0,-21698,38,0,0,,21736,-21660
17,04/22/2018,2,0:15,0:30,34.28,33.78,0,36.03,33.78,2,-46993,47767,94760,774,0,-392,453,0,0,,845,61
17,04/22/2018,3,0:30,0:45,,28.07,0,28.07,28.07,-1,-32858,49505,82363,16647,0,-18000,0,0,0,,18000,-18000
17,04/22/2018,4,0:45,1:00,,24.94,0,24.94,24.94,-1,-34351,59365,93716,25014,0,-35957,0,0,0,,35957,-35957
17,04/22/2018,5,1:00,1:15,36.94,33.62,0,36.94,36.94,1,-63190,56546,119736,-6644,0,-16280,636,0,0,,16916,-15644
17,04/22/2018,6,1:15,1:30,36.94,28.94,0,28.94,28.94,-1,-45411,61065,106476,15654,0,-3411,138,0,0,,3549,-3273
17,04/22/2018,7,1:30,1:45,,25.7,0,25.7,25.7,-1,-31913,82895,114808,50982,0,-27815,0,0,0,,27815,-27815
17,04/22/2018,8,1:45,2:00,,7.33,0,7.33,7.33,-1,-25457,98356,123813,72899,0,-56646,0,0,0,,56646,-56646
17,04/22/2018,9,2:00,2:15,,19.32,0,19.32,19.32,-1,-51260,66241,117501,14981,0,-30144,0,0,0,,30144,-30144
17,04/22/2018,10,2:15,2:30,,,0,36.03,36.03,0,-46196,55945,102141,9749,0,0,0,0,0,,0,0
17,04/22/2018,11,2:30,2:45,36.94,34.41,0,36.94,34.41,2,-35561,53196,88757,17635,0,-2140,2,0,0,,2142,-2138
17,04/22/2018,12,2:45,3:00,,24.94,0,24.94,24.94,-1,-36382,61164,97546,24782,0,-17288,0,0,0,,17288,-17288
17,04/22/2018,13,3:00,3:15,42.98,36.23,0,42.98,42.98,1,-72807,46746,119553,-26061,0,-7222,5587,0,0,,12809,-1635
17,04/22/2018,14,3:15,3:30,36.94,,0,36.94,36.94,1,-72942,54528,127470,-18414,0,0,11435,0,0,,11435,11435
17,04/22/2018,15,3:30,3:45,36.94,,0,36.94,36.94,1,-75255,64016,139271,-11239,0,0,4829,0,0,,4829,4829
17,04/22/2018,16,3:45,4:00,35.71,,0,35.71,35.71,1,-74344,71724,146068,-2620,0,0,3623,0,0,,3623,3623
17,04/22/2018,17,4:00,4:15,36.94,,0,36.94,36.94,1,-71804,73753,145557,1949,0,0,3098,0,0,,3098,3098
17,04/22/2018,18,4:15,4:30,,,0,35.27,35.27,0,-62550,84643,147193,22093,0,0,342,0,0,,342,342
17,04/22/2018,19,4:30,4:45,,33.65,0,33.65,33.65,-1,-56879,93358,150237,36479,0,-2343,0,0,0,,2343,-2343
17,04/22/2018,20,4:45,5:00,,33.68,0,33.68,33.68,-1,-79393,90982,170375,11589,0,-2906,0,0,0,,2906,-2906
17,04/22/2018,21,5:00,5:15,,33.71,0,33.71,33.71,-1,-74699,78522,153221,3823,0,-1767,0,0,0,,1767,-1767
17,04/22/2018,22,5:15,5:30,,33.78,0,33.78,33.78,-1,-63370,68571,131941,5201,0,-3983,0,0,0,,3983,-3983
17,04/22/2018,23,5:30,5:45,,33.78,0,33.78,33.78,-1,-50255,65963,116218,15708,0,-3493,0,0,0,,3493,-3493
17,04/22/2018,24,5:45,6:00,,33.47,0,33.47,33.47,-1,-53562,70575,124137,17013,0,-5120,0,0,0,,5120,-5120
17,04/22/2018,25,6:00,6:15,,22.9,0,22.9,22.9,-1,-50350,112007,162357,61657,0,-20442,0,0,0,,20442,-20442
17,04/22/2018,26,6:15,6:30,,4.8,0,4.8,4.8,-1,-41478,126867,168345,85389,0,-47326,0,0,0,,47326,-47326
17,04/22/2018,27,6:30,6:45,,16.34,0,16.34,16.34,-1,-40604,103949,144553,63345,0,-63397,0,0,0,,63397,-63397
17,04/22/2018,28,6:45,7:00,,22.9,0,22.9,22.9,-1,-50173,94069,144242,43896,0,-44547,0,0,0,,44547,-44547
17,04/22/2018,29,7:00,7:15,,3.6,0,3.6,3.6,-1,-52872,130116,182988,77244,0,-60391,0,0,0,,60391,-60391
17,04/22/2018,30,7:15,7:30,,11.21,0,11.21,11.21,-1,-38825,117709,156534,78884,0,-76768,0,0,0,,76768,-76768
17,04/22/2018,31,7:30,7:45,,16.57,0,16.57,16.57,-1,-49100,108834,157934,59734,0,-69191,0,0,0,,69191,-69191
17,04/22/2018,32,7:45,8:00,,16.96,0,16.96,16.96,-1,-69442,118703,188145,49261,0,-43492,0,0,0,,43492,-43492
17,04/22/2018,33,8:00,8:15,,22.9,0,22.9,22.9,-1,-39989,107691,147680,67702,0,-24560,0,0,0,,24560,-24560
17,04/22/2018,34,8:15,8:30,,,0,36.07,36.07,0,-52688,100763,153451,48075,0,-321,0,0,0,,321,-321
17,04/22/2018,35,8:30,8:45,,,0,36.17,36.17,0,-64158,109345,173503,45187,0,0,0,0,0,,0,0
17,04/22/2018,36,8:45,9:00,,35.78,0,35.78,35.78,-1,-65045,109827,174872,44782,0,-64,0,0,0,,64,-64
17,04/22/2018,37,9:00,9:15,,36.78,0,36.78,36.78,-1,-59504,142856,202360,83352,0,-756,0,0,0,,756,-756
17,04/22/2018,38,9:15,9:30,,37.78,0,37.78,37.78,-1,-50669,143638,194307,92969,0,-700,0,0,0,,700,-700
17,04/22/2018,39,9:30,9:45,,36,0,36,36,-1,-56848,143016,199864,86168,0,-74,0,0,0,,74,-74
17,04/22/2018,40,9:45,10:00,,22.9,0,22.9,22.9,-1,-57160,158975,216135,101815,0,-5330,0,0,0,,5330,-5330
17,04/22/2018,41,10:00,10:15,,11.21,0,11.21,11.21,-1,-45717,173915,219632,128198,0,-23286,0,0,0,,23286,-23286
17,04/22/2018,42,10:15,10:30,,7.37,0,7.37,7.37,-1,-43395,153077,196472,109682,0,-45992,0,0,0,,45992,-45992
17,04/22/2018,43,10:30,10:45,,7.37,0,7.37,7.37,-1,-35241,139829,175070,104588,0,-68160,0,0,0,,68160,-68160
17,04/22/2018,44,10:45,11:00,,17.26,0,17.26,17.26,-1,-43913,128182,172095,84269,0,-52110,0,0,0,,52110,-52110
17,04/22/2018,45,11:00,11:15,,28.8,0,28.8,28.8,-1,-27550,137016,164566,109466,0,-29619,0,0,0,,29619,-29619
17,04/22/2018,46,11:15,11:30,,28.8,0,28.8,28.8,-1,-31553,128683,160236,97130,0,-22620,0,0,0,,22620,-22620
17,04/22/2018,47,11:30,11:45,,16.77,0,16.77,16.77,-1,-45572,113773,159345,68201,0,-40869,0,0,0,,40869,-40869
17,04/22/2018,48,11:45,12:00,,22.9,0,22.9,22.9,-1,-48030,111955,159985,63925,0,-56094,0,0,0,,56094,-56094
17,04/22/2018,49,12:00,12:15,,23.78,0,23.78,23.78,-1,-61986,91285,153271,29299,0,-39147,0,0,0,,39147,-39147
17,04/22/2018,50,12:15,12:30,,28.32,0,28.32,28.32,-1,-43259,109042,152301,65783,0,-13399,0,0,0,,13399,-13399
17,04/22/2018,51,12:30,12:45,,32.03,0,32.03,32.03,-1,-21446,120509,141955,99063,0,-11419,0,0,0,,11419,-11419
17,04/22/2018,52,12:45,13:00,,,0,36.33,36.33,0,-21353,133930,155283,112577,0,-150,0,0,0,,150,-150
17,04/22/2018,53,13:00,13:15,,32.03,0,32.03,32.03,-1,-27601,156320,183921,128719,0,-5985,0,0,0,,5985,-5985
17,04/22/2018,54,13:15,13:30,,32.8,0,32.8,32.8,-1,-28880,150836,179716,121956,0,-4352,0,0,0,,4352,-4352
17,04/22/2018,55,13:30,13:45,,32.8,0,32.8,32.8,-1,-26882,147602,174484,120720,0,-6558,0,0,0,,6558,-6558
17,04/22/2018,56,13:45,14:00,,20.79,0,20.79,20.79,-1,-28069,157392,185461,129323,0,-11352,0,0,0,,11352,-11352
17,04/22/2018,57,14:00,14:15,,-150.78,0,-150.78,-150.78,-1,-25566,146623,172189,121057,0,-55810,0,0,0,,55810,-55810
17,04/22/2018,58,14:15,14:30,,2.42,0,2.42,2.42,-1,-25705,124172,149877,98467,0,-77501,0,0,0,,77501,-77501
17,04/22/2018,59,14:30,14:45,,-17.99,0,-17.99,-17.99,-1,-26252,119198,145450,92946,0,-89520,0,0,0,,89520,-89520
17,04/22/2018,60,14:45,15:00,,-28.47,0,-28.47,-28.47,-1,-43259,133486,176745,90227,0,-88340,0,0,0,,88340,-88340
17,04/22/2018,61,15:00,15:15,,-27.49,0,-27.49,-27.49,-1,-34785,134596,169381,99811,0,-77918,0,0,0,,77918,-77918
17,04/22/2018,62,15:15,15:30,,13.03,0,13.03,13.03,-1,-34033,117423,151456,83390,0,-57959,0,0,0,,57959,-57959
17,04/22/2018,63,15:30,15:45,,13.03,0,13.03,13.03,-1,-39011,144137,183148,105126,0,-47992,0,0,0,,47992,-47992
17,04/22/2018,64,15:45,16:00,,32.8,0,32.8,32.8,-1,-45149,142219,187368,97070,0,-20244,0,0,0,,20244,-20244
17,04/22/2018,65,16:00,16:15,,32.03,0,32.03,32.03,-1,-38461,164378,202839,125917,0,-5238,0,0,0,,5238,-5238
17,04/22/2018,66,16:15,16:30,,34.78,0,34.78,34.78,-1,-47862,153482,201344,105620,0,-3986,0,0,0,,3986,-3986
17,04/22/2018,67,16:30,16:45,,,0,36.39,36.39,0,-77429,151751,229180,74322,0,-60,0,0,0,,60,-60
17,04/22/2018,68,16:45,17:00,,,0,36.39,36.39,0,-99126,158026,257152,58900,0,0,0,0,0,,0,0
17,04/22/2018,69,17:00,17:15,,,0,36.3,36.3,0,-93911,98811,192722,4900,0,0,0,0,0,,0,0
17,04/22/2018,70,17:15,17:30,36.41,,0,36.41,36.41,1,-94120,95126,189246,1006,0,0,703,0,0,,703,703
17,04/22/2018,71,17:30,17:45,36.8,,0,36.8,36.8,1,-77234,98658,175892,21424,0,0,1420,0,0,,1420,1420
17,04/22/2018,72,17:45,18:00,,,0,36.4,36.4,0,-73489,115740,189229,42251,0,0,2,0,0,,2,2
17,04/22/2018,73,18:00,18:15,,,0,36.24,36.24,0,-116118,59068,175186,-57050,0,0,0,0,0,,0,0
17,04/22/2018,74,18:15,18:30,,,0,36.16,36.16,0,-77568,62935,140503,-14633,0,0,0,0,0,,0,0
17,04/22/2018,75,18:30,18:45,40.41,,0,40.41,40.41,1,-91927,39898,131825,-52029,0,0,1782,0,0,,1782,1782
17,04/22/2018,76,18:45,19:00,40.88,,0,40.88,40.88,1,-102847,27384,130231,-75463,0,0,9487,0,0,,9487,9487
17,04/22/2018,77,19:00,19:15,,,0,36.22,36.22,0,-135417,140527,275944,5110,0,0,1776,0,0,,1776,1776
17,04/22/2018,78,19:15,19:30,,36.33,0,36.33,36.33,-1,-132204,135366,267570,3162,0,-818,0,0,0,,818,-818
17,04/22/2018,79,19:30,19:45,,,0,36.22,36.22,0,-143977,144504,288481,527,0,0,0,0,0,,0,0
17,04/22/2018,80,19:45,20:00,,36.78,0,36.78,36.78,-1,-144903,146991,291894,2088,0,-370,0,0,0,,370,-370
17,04/22/2018,81,20:00,20:15,,32.8,0,32.8,32.8,-1,-82105,88509,170614,6404,0,-621,0,0,0,,621,-621
17,04/22/2018,82,20:15,20:30,,25.92,0,25.92,25.92,-1,-59872,93510,153382,33638,0,-17622,0,0,0,,17622,-17622
17,04/22/2018,83,20:30,20:45,,32.8,0,32.8,32.8,-1,-69867,100409,170276,30542,0,-22926,0,0,0,,22926,-22926
17,04/22/2018,84,20:45,21:00,,34.73,0,34.73,34.73,-1,-69071,80127,149198,11056,0,-13398,0,0,0,,13398,-13398
17,04/22/2018,85,21:00,21:15,47.02,34.73,0,47.02,47.02,1,-77547,68535,146082,-9012,0,-1018,4795,0,0,,5813,3777
17,04/22/2018,86,21:15,21:30,50.53,,0,50.53,50.53,1,-99787,57317,157104,-42470,0,0,34312,0,0,,34312,34312
17,04/22/2018,87,21:30,21:45,40.41,,0,40.41,40.41,1,-82230,58105,140335,-24125,0,0,23742,0,0,,23742,23742
17,04/22/2018,88,21:45,22:00,40.41,11.21,0,11.21,11.21,-1,-65861,86281,152142,20420,0,-10420,5776,0,0,,16196,-4644
17,04/22/2018,89,22:00,22:15,,11.21,0,11.21,11.21,-1,-57115,105198,162313,48083,0,-17124,0,0,0,,17124,-17124
17,04/22/2018,90,22:15,22:30,,25.89,0,25.89,25.89,-1,-55004,96046,151050,41042,0,-2006,0,0,0,,2006,-2006
17,04/22/2018,91,22:30,22:45,,7.33,0,7.33,7.33,-1,-54757,148766,203523,94009,0,-49732,0,0,0,,49732,-49732
17,04/22/2018,92,22:45,23:00,,-150.78,0,-150.78,-150.78,-1,-66093,164570,230663,98477,0,-90032,0,0,0,,90032,-90032
17,04/22/2018,93,23:00,23:15,,11.21,0,11.21,11.21,-1,-85325,154785,240110,69460,0,-62905,0,0,0,,62905,-62905
17,04/22/2018,94,23:15,23:30,,-12.79,0,-12.79,-12.79,-1,-66277,150795,217072,84518,0,-79657,0,0,0,,79657,-79657
17,04/22/2018,95,23:30,23:45,,11.21,0,11.21,11.21,-1,-70832,144460,215292,73628,0,-77727,0,0,0,,77727,-77727
17,04/22/2018,96,23:45,0:00,39.97,22.9,0,39.97,39.97,1,-104854,115198,220052,10344,0,-38855,139,0,0,,38994,-38716
17,04/23/2018,1,0:00,0:15,208.02,22.9,0,208.02,208.02,1,-173300,18556,191856,-154744,0,-37,30199,0,0,,30236,30162
17,04/23/2018,2,0:15,0:30,288.02,,0,288.02,288.02,1,-119999,45179,165178,-74820,0,0,71222,0,0,,71222,71222
17,04/23/2018,3,0:30,0:45,288.02,29.03,0,29.03,29.03,-1,-113629,115009,228638,1380,0,-82,2017,0,0,,2099,1935
17,04/23/2018,4,0:45,1:00,,,0,35.13,35.13,0,-127334,118146,245480,-9188,0,0,0,0,0,,0,0
17,04/23/2018,5,1:00,1:15,,,0,34.67,34.67,0,-139923,87184,227107,-52739,0,0,0,0,0,,0,0
17,04/23/2018,6,1:15,1:30,,,0,34.72,34.72,0,-170404,76197,246601,-94207,0,0,0,0,0,,0,0
17,04/23/2018,7,1:30,1:45,,,0,35.01,35.01,0,-159376,72912,232288,-86464,0,0,0,0,0,,0,0
17,04/23/2018,8,1:45,2:00,,,0,34.72,34.72,0,-146717,65118,211835,-81599,0,0,0,0,0,,0,0
17,04/23/2018,9,2:00,2:15,47.97,,0,47.97,47.97,1,-79680,50297,129977,-29383,0,0,10885,0,0,,10885,10885
17,04/23/2018,10,2:15,2:30,40.32,,0,40.32,40.32,1,-90890,66392,157282,-24498,0,0,6595,0,0,,6595,6595
17,04/23/2018,11,2:30,2:45,,,0,34.63,34.63,0,-100973,73345,174318,-27628,0,0,818,0,0,,818,818
17,04/23/2018,12,2:45,3:00,,,0,34.63,34.63,0,-90358,67721,158079,-22637,0,0,0,0,0,,0,0
17,04/23/2018,13,3:00,3:15,33.97,,0,33.97,33.97,1,-76981,86115,163096,9134,0,0,528,0,0,,528,528
17,04/23/2018,14,3:15,3:30,,,0,34.62,34.62,0,-56502,80166,136668,23664,0,0,13,0,0,,13,13
17,04/23/2018,15,3:30,3:45,34.29,,0,34.29,34.29,1,-64155,83091,147246,18936,0,0,139,0,0,,139,139
17,04/23/2018,16,3:45,4:00,,34.34,0,34.34,34.34,-1,-61296,106962,168258,45666,0,-5,0,0,0,,5,-5
17,04/23/2018,17,4:00,4:15,,-150.03,0,-150.03,-150.03,-1,-43215,138596,181811,95381,0,-43510,0,0,0,,43510,-43510
17,04/23/2018,18,4:15,4:30,,-12.03,0,-12.03,-12.03,-1,-42999,108701,151700,65702,0,-75926,0,0,0,,75926,-75926
17,04/23/2018,19,4:30,4:45,,9.97,0,9.97,9.97,-1,-57828,110502,168330,52674,0,-58692,0,0,0,,58692,-58692
17,04/23/2018,20,4:45,5:00,,13.27,0,13.27,13.27,-1,-54776,100353,155129,45577,0,-48411,0,0,0,,48411,-48411
17,04/23/2018,21,5:00,5:15,,22.8,0,22.8,22.8,-1,-47750,84321,132071,36571,0,-37538,0,0,0,,37538,-37538
17,04/23/2018,22,5:15,5:30,,32.8,0,32.8,32.8,-1,-47524,81948,129472,34424,0,-12639,0,0,0,,12639,-12639
17,04/23/2018,23,5:30,5:45,,19.03,0,19.03,19.03,-1,-36715,66832,103547,30117,0,-8869,0,0,0,,8869,-8869
17,04/23/2018,24,5:45,6:00,,29.91,0,29.91,29.91,-1,-70353,105165,175518,34812,0,-16884,0,0,0,,16884,-16884
17,04/23/2018,25,6:00,6:15,36.8,34.15,0,36.8,36.8,1,-109405,59274,168679,-50131,0,-9923,304,0,0,,10227,-9619
17,04/23/2018,26,6:15,6:30,36.8,34.15,0,36.8,36.8,1,-72024,64868,136892,-7156,0,-26,1318,0,0,,1344,1292
17,04/23/2018,27,6:30,6:45,,,0,35.33,35.33,0,-81102,46105,127207,-34997,0,0,0,0,0,,0,0
17,04/23/2018,28,6:45,7:00,47.61,,0,47.61,47.61,1,-106854,69167,176021,-37687,0,0,1442,0,0,,1442,1442
17,04/23/2018,29,7:00,7:15,42.53,,0,42.53,42.53,1,-128413,87120,215533,-41293,0,0,7139,0,0,,7139,7139
17,04/23/2018,30,7:15,7:30,60.14,,0,60.14,60.14,1,-90656,54957,145613,-35699,0,0,14230,0,0,,14230,14230
17,04/23/2018,31,7:30,7:45,66.99,,0,66.99,66.99,1,-84602,47193,131795,-37409,0,0,35386,0,0,,35386,35386
17,04/23/2018,32,7:45,8:00,60.14,,0,60.14,60.14,1,-96364,71506,167870,-24858,0,0,24691,0,0,,24691,24691
17,04/23/2018,33,8:00,8:15,43.88,38.55,0,38.55,38.55,-1,-98963,84428,183391,-14535,0,-43,15040,0,0,,15083,14997
17,04/23/2018,34,8:15,8:30,48.25,37.03,0,48.25,36.82,2,-99824,54270,154094,-45554,0,-131,2648,0,0,,2779,2517
17,04/23/2018,35,8:30,8:45,55.24,,0,55.24,55.24,1,-109999,79030,189029,-30969,0,0,9364,0,0,,9364,9364
17,04/23/2018,36,8:45,9:00,,,0,36.69,36.69,0,-78116,72582,150698,-5534,0,0,643,0,0,,643,643
17,04/23/2018,37,9:00,9:15,253.02,,0,253.02,253.02,1,-157635,80804,238439,-76831,0,0,25845,0,0,,25845,25845
17,04/23/2018,38,9:15,9:30,48.14,,0,48.14,48.14,1,-105955,91971,197926,-13984,0,0,19312,0,0,,19312,19312
17,04/23/2018,39,9:30,9:45,38.14,,0,38.14,38.14,1,-76864,90691,167555,13827,0,0,3112,0,0,,3112,3112
17,04/23/2018,40,9:45,10:00,,,0,38.23,38.23,0,-58468,89783,148251,31315,0,0,0,0,0,,0,0
17,04/23/2018,41,10:00,10:15,45.44,,0,45.44,45.44,1,-99509,85557,185066,-13952,0,0,2128,0,0,,2128,2128
17,04/23/2018,42,10:15,10:30,38.14,,0,38.14,38.14,1,-82871,90049,172920,7178,0,0,112,0,0,,112,112
17,04/23/2018,43,10:30,10:45,38.14,,0,38.14,38.14,1,-75760,87660,163420,11900,0,0,903,0,0,,903,903
17,04/23/2018,44,10:45,11:00,34.84,,0,34.84,34.84,1,-84607,95694,180301,11087,0,0,500,0,0,,500,500
17,04/23/2018,45,11:00,11:15,51.6,,0,51.6,51.6,1,-105606,86573,192179,-19033,0,0,9096,0,0,,9096,9096
17,04/23/2018,46,11:15,11:30,38.14,,0,38.14,38.14,1,-88672,91963,180635,3291,0,0,4946,0,0,,4946,4946
17,04/23/2018,47,11:30,11:45,38.14,33.92,0,33.92,33.92,-1,-68162,100147,168309,31985,0,-606,465,0,0,,1071,-141
17,04/23/2018,48,11:45,12:00,,33.94,0,33.94,33.94,-1,-65881,88254,154135,22373,0,-1781,0,0,0,,1781,-1781
17,04/23/2018,49,12:00,12:15,55.49,,0,55.49,55.49,1,-110809,84282,195091,-26527,0,0,8087,0,0,,8087,8087
17,04/23/2018,50,12:15,12:30,41.21,35.55,0,35.55,35.55,-1,-90877,98988,189865,8111,0,-60,4307,0,0,,4367,4247
17,04/23/2018,51,12:30,12:45,,32.04,0,32.04,32.04,-1,-56384,92058,148442,35674,0,-964,0,0,0,,964,-964
17,04/23/2018,52,12:45,13:00,,22.8,0,22.8,22.8,-1,-61786,97890,159676,36104,0,-10738,0,0,0,,10738,-10738
17,04/23/2018,53,13:00,13:15,,28.56,0,28.56,28.56,-1,-63963,105663,169626,41700,0,-11668,0,0,0,,11668,-11668
17,04/23/2018,54,13:15,13:30,,27.25,0,27.25,27.25,-1,-67545,96111,163656,28566,0,-2713,0,0,0,,2713,-2713
17,04/23/2018,55,13:30,13:45,,32.8,0,32.8,32.8,-1,-82239,96605,178844,14366,0,-2676,0,0,0,,2676,-2676
17,04/23/2018,56,13:45,14:00,49.09,,0,49.09,49.09,1,-121698,113001,234699,-8697,0,0,797,0,0,,797,797
17,04/23/2018,57,14:00,14:15,68.69,,0,68.69,68.69,1,-93860,66860,160720,-27000,0,0,15419,0,0,,15419,15419
17,04/23/2018,58,14:15,14:30,83.56,,0,83.56,83.56,1,-117012,62375,179387,-54637,0,0,40318,0,0,,40318,40318
17,04/23/2018,59,14:30,14:45,62.08,,0,62.08,62.08,1,-113038,66167,179205,-46871,0,0,47700,0,0,,47700,47700
17,04/23/2018,60,14:45,15:00,51.16,,0,51.16,51.16,1,-109430,66809,176239,-42621,0,0,37024,0,0,,37024,37024
17,04/23/2018,61,15:00,15:15,55.58,,0,55.58,55.58,1,-104446,94347,198793,-10099,0,0,27492,0,0,,27492,27492
17,04/23/2018,62,15:15,15:30,42.75,33.2,0,42.75,33.2,2,-89974,86121,176095,-3853,0,-733,4602,0,0,,5335,3869
17,04/23/2018,63,15:30,15:45,50.52,,0,50.52,50.52,1,-100572,83748,184320,-16824,0,0,12518,0,0,,12518,12518
17,04/23/2018,64,15:45,16:00,33.85,,0,33.85,33.85,1,-88850,89113,177963,263,0,0,2869,0,0,,2869,2869
17,04/23/2018,65,16:00,16:15,,22.8,0,22.8,22.8,-1,-75948,115037,190985,39089,0,-3547,0,0,0,,3547,-3547
17,04/23/2018,66,16:15,16:30,,35.6,0,35.6,35.6,-1,-72598,92776,165374,20178,0,-2848,0,0,0,,2848,-2848
17,04/23/2018,67,16:30,16:45,,31.85,0,31.85,31.85,-1,-75395,113499,188894,38104,0,-6508,0,0,0,,6508,-6508
17,04/23/2018,68,16:45,17:00,,22.8,0,22.8,22.8,-1,-85390,110299,195689,24909,0,-4237,0,0,0,,4237,-4237
17,04/23/2018,69,17:00,17:15,,-30.56,0,-30.56,-30.56,-1,-48299,172695,220994,124396,0,-19991,0,0,0,,19991,-19991
17,04/23/2018,70,17:15,17:30,,,0,35.07,35.07,0,-56700,163609,220309,106909,0,-2552,0,0,0,,2552,-2552
17,04/23/2018,71,17:30,17:45,,28.8,0,28.8,28.8,-1,-33343,153752,187095,120409,0,-1973,0,0,0,,1973,-1973
17,04/23/2018,72,17:45,18:00,,12.8,0,12.8,12.8,-1,-40988,139790,180778,98802,0,-2523,0,0,0,,2523,-2523
17,04/23/2018,73,18:00,18:15,,-28.56,0,-28.56,-28.56,-1,-83246,94037,177283,10791,0,-23446,0,0,0,,23446,-23446
17,04/23/2018,74,18:15,18:30,,28.8,0,28.8,28.8,-1,-69952,88898,158850,18946,0,-11057,0,0,0,,11057,-11057
17,04/23/2018,75,18:30,18:45,,32.8,0,32.8,32.8,-1,-71762,97589,169351,25827,0,-12889,0,0,0,,12889,-12889
17,04/23/2018,76,18:45,19:00,,28.8,0,28.8,28.8,-1,-67982,91045,159027,23063,0,-9248,0,0,0,,9248,-9248
17,04/23/2018,77,19:00,19:15,,18.56,0,18.56,18.56,-1,-59505,81021,140526,21516,0,-14347,0,0,0,,14347,-14347
17,04/23/2018,78,19:15,19:30,,32.8,0,32.8,32.8,-1,-60247,68043,128290,7796,0,-4984,0,0,0,,4984,-4984
17,04/23/2018,79,19:30,19:45,,33.12,0,33.12,33.12,-1,-42650,78570,121220,35920,0,-6058,0,0,0,,6058,-6058
17,04/23/2018,80,19:45,20:00,,32.8,0,32.8,32.8,-1,-42820,81136,123956,38316,0,-2964,0,0,0,,2964,-2964
17,04/23/2018,81,20:00,20:15,,6.48,0,6.48,6.48,-1,-43370,106462,149832,63092,0,-16320,0,0,0,,16320,-16320
17,04/23/2018,82,20:15,20:30,,10.8,0,10.8,10.8,-1,-41573,104464,146037,62891,0,-21482,0,0,0,,21482,-21482
17,04/23/2018,83,20:30,20:45,,34.15,0,34.15,34.15,-1,-33449,99667,133116,66218,0,-16165,0,0,0,,16165,-16165
17,04/23/2018,84,20:45,21:00,,31.96,0,31.96,31.96,-1,-44510,67443,111953,22933,0,-3167,0,0,0,,3167,-3167
17,04/23/2018,85,21:00,21:15,,22.8,0,22.8,22.8,-1,-25340,74885,100225,49545,0,-6382,0,0,0,,6382,-6382
17,04/23/2018,86,21:15,21:30,,37.56,0,37.56,37.56,-1,-38911,65436,104347,26525,0,-236,0,0,0,,236,-236
17,04/23/2018,87,21:30,21:45,,34.29,0,34.29,34.29,-1,-49317,109065,158382,59748,0,-1754,0,0,0,,1754,-1754
17,04/23/2018,88,21:45,22:00,,-19.39,0,-19.39,-19.39,-1,-64018,157246,221264,93228,0,-7644,0,0,0,,7644,-7644
17,04/23/2018,89,22:00,22:15,,-34.43,0,-34.43,-34.43,-1,-43827,90768,134595,46941,0,-13633,0,0,0,,13633,-13633
17,04/23/2018,90,22:15,22:30,,10.8,0,10.8,10.8,-1,-32128,84162,116290,52034,0,-32154,0,0,0,,32154,-32154
17,04/23/2018,91,22:30,22:45,,17.71,0,17.71,17.71,-1,-64660,114194,178854,49534,0,-45250,0,0,0,,45250,-45250
17,04/23/2018,92,22:45,23:00,,19.6,0,19.6,19.6,-1,-80684,136087,216771,55403,0,-23201,0,0,0,,23201,-23201
17,04/23/2018,93,23:00,23:15,,18.61,0,18.61,18.61,-1,-55204,86106,141310,30902,0,-19325,0,0,0,,19325,-19325
17,04/23/2018,94,23:15,23:30,,5.59,0,5.59,5.59,-1,-36029,87366,123395,51337,0,-6323,0,0,0,,6323,-6323
17,04/23/2018,95,23:30,23:45,,-26.56,0,-26.56,-26.56,-1,-42301,126865,169166,84564,0,-34774,0,0,0,,34774,-34774
17,04/23/2018,96,23:45,0:00,,22.8,0,22.8,22.8,-1,-40568,182472,223040,141904,0,-25689,0,0,0,,25689,-25689
17,04/24/2018,1,0:00,0:15,,10.8,0,10.8,10.8,-1,-26967,138538,165505,111571,0,-17111,0,0,0,,17111,-17111
17,04/24/2018,2,0:15,0:30,,10.8,0,10.8,10.8,-1,-16778,113749,130527,96971,0,-2814,0,0,0,,2814,-2814
17,04/24/2018,3,0:30,0:45,,-150.78,0,-150.78,-150.78,-1,-28263,91925,120188,63662,0,-44526,0,0,0,,44526,-44526
17,04/24/2018,4,0:45,1:00,,-72.78,0,-72.78,-72.78,-1,-33968,102883,136851,68915,0,-59157,0,0,0,,59157,-59157
17,04/24/2018,5,1:00,1:15,,,0,34,34,0,-29902,83884,113786,53982,0,-20409,0,0,0,,20409,-20409
17,04/24/2018,6,1:15,1:30,,,0,33.81,33.81,0,-20347,83080,103427,62733,0,0,0,0,0,,0,0
17,04/24/2018,7,1:30,1:45,,32.78,0,32.78,32.78,-1,-20107,106692,126799,86585,0,-1411,0,0,0,,1411,-1411
17,04/24/2018,8,1:45,2:00,,-150.78,0,-150.78,-150.78,-1,-25774,119124,144898,93350,0,-19887,0,0,0,,19887,-19887
17,04/24/2018,9,2:00,2:15,,30.78,0,30.78,30.78,-1,-28591,50910,79501,22319,0,-7939,0,0,0,,7939,-7939
17,04/24/2018,10,2:15,2:30,,31.3,0,31.3,31.3,-1,-27021,54627,81648,27606,0,-458,0,0,0,,458,-458
17,04/24/2018,11,2:30,2:45,,22.8,0,22.8,22.8,-1,-31586,55262,86848,23676,0,-13949,0,0,0,,13949,-13949
17,04/24/2018,12,2:45,3:00,,31.38,0,31.38,31.38,-1,-30173,52123,82296,21950,0,-18981,0,0,0,,18981,-18981
17,04/24/2018,13,3:00,3:15,,30.96,0,30.96,30.96,-1,-38637,53432,92069,14795,0,-9976,0,0,0,,9976,-9976
17,04/24/2018,14,3:15,3:30,,,0,35.25,35.25,0,-29382,64009,93391,34627,0,-2,0,0,0,,2,-2
17,04/24/2018,15,3:30,3:45,,28.8,0,28.8,28.8,-1,-29988,70337,100325,40349,0,-2225,0,0,0,,2225,-2225
17,04/24/2018,16,3:45,4:00,,10.8,0,10.8,10.8,-1,-30270,82226,112496,51956,0,-15760,0,0,0,,15760,-15760
17,04/24/2018,17,4:00,4:15,,22.8,0,22.8,22.8,-1,-41845,65335,107180,23490,0,-24880,0,0,0,,24880,-24880
17,04/24/2018,18,4:15,4:30,,29.78,0,29.78,29.78,-1,-30744,47667,78411,16923,0,-19868,0,0,0,,19868,-19868
17,04/24/2018,19,4:30,4:45,,31.04,0,31.04,31.04,-1,-26769,40456,67225,13687,0,-15497,0,0,0,,15497,-15497
17,04/24/2018,20,4:45,5:00,,30.84,0,30.84,30.84,-1,-26498,41256,67754,14758,0,-9973,0,0,0,,9973,-9973
17,04/24/2018,21,5:00,5:15,,32.8,0,32.8,32.8,-1,-61557,52338,113895,-9219,0,-3826,0,0,0,,3826,-3826
17,04/24/2018,22,5:15,5:30,,,0,33.91,33.91,0,-55031,52861,107892,-2170,0,0,0,0,0,,0,0
17,04/24/2018,23,5:30,5:45,34.37,,0,34.37,34.37,1,-45252,29042,74294,-16210,0,0,1429,0,0,,1429,1429
17,04/24/2018,24,5:45,6:00,34.66,,0,34.66,34.66,1,-60898,24163,85061,-36735,0,0,948,0,0,,948,948
17,04/24/2018,25,6:00,6:15,,34.78,0,34.78,34.78,-1,-69132,69440,138572,308,0,-270,0,0,0,,270,-270
17,04/24/2018,26,6:15,6:30,,30.78,0,30.78,30.78,-1,-44968,52619,97587,7651,0,-6721,0,0,0,,6721,-6721
17,04/24/2018,27,6:30,6:45,,35.51,0,35.51,35.51,-1,-55591,53296,108887,-2295,0,-2039,0,0,0,,2039,-2039
17,04/24/2018,28,6:45,7:00,,35.51,0,35.51,35.51,-1,-72872,78613,151485,5741,0,-86,0,0,0,,86,-86
17,04/24/2018,29,7:00,7:15,,25.48,0,25.48,25.48,-1,-122182,131123,253305,8941,0,-4409,0,0,0,,4409,-4409
17,04/24/2018,30,7:15,7:30,,7.42,0,7.42,7.42,-1,-66347,102346,168693,35999,0,-34474,0,0,0,,34474,-34474
17,04/24/2018,31,7:30,7:45,37.6,7.42,0,37.6,37.6,1,-72878,85767,158645,12889,0,-3268,147,0,0,,3415,-3121
17,04/24/2018,32,7:45,8:00,40.65,,0,40.65,40.65,1,-89797,92062,181859,2265,0,0,1065,0,0,,1065,1065
17,04/24/2018,33,8:00,8:15,52.97,,0,52.97,52.97,1,-120643,78738,199381,-41905,0,0,13439,0,0,,13439,13439
17,04/24/2018,34,8:15,8:30,60.3,,0,60.3,60.3,1,-109139,68114,177253,-41025,0,0,24316,0,0,,24316,24316
17,04/24/2018,35,8:30,8:45,238.12,,0,238.12,238.12,1,-136904,55375,192279,-81529,0,0,60997,0,0,,60997,60997
17,04/24/2018,36,8:45,9:00,98.84,,0,98.84,98.84,1,-125876,55136,181012,-70740,0,0,76151,0,0,,76151,76151
17,04/24/2018,37,9:00,9:15,98.84,21.24,0,21.24,21.24,-1,-32049,78399,110448,46350,0,-1877,24334,0,0,,26211,22457
17,04/24/2018,38,9:15,9:30,,23.6,0,23.6,23.6,-1,-41774,58267,100041,16493,0,-3251,0,0,0,,3251,-3251
17,04/24/2018,39,9:30,9:45,,33.78,0,33.78,33.78,-1,-38274,60336,98610,22062,0,-344,0,0,0,,344,-344
17,04/24/2018,40,9:45,10:00,39.81,33.78,0,39.81,33.78,2,-44603,56386,100989,11783,0,-2053,18,0,0,,2071,-2035
17,04/24/2018,41,10:00,10:15,47.6,,0,47.6,47.6,1,-93057,62539,155596,-30518,0,0,5607,0,0,,5607,5607
17,04/24/2018,42,10:15,10:30,47.6,28.46,0,28.46,28.46,-1,-55864,77082,132946,21218,0,-1688,372,0,0,,2060,-1316
17,04/24/2018,43,10:30,10:45,,,0,38.35,38.35,0,-76878,80040,156918,3162,0,-53,0,0,0,,53,-53
17,04/24/2018,44,10:45,11:00,41.6,,0,41.6,41.6,1,-79075,79509,158584,434,0,0,875,0,0,,875,875
17,04/24/2018,45,11:00,11:15,42.67,,0,42.67,42.67,1,-81560,65243,146803,-16317,0,0,2008,0,0,,2008,2008
17,04/24/2018,46,11:15,11:30,47.6,,0,47.6,47.6,1,-55244,79954,135198,24710,0,0,5196,0,0,,5196,5196
17,04/24/2018,47,11:30,11:45,,,0,38.41,38.41,0,-38901,103050,141951,64149,0,0,0,0,0,,0,0
17,04/24/2018,48,11:45,12:00,,20.26,0,20.26,20.26,-1,-38016,107138,145154,69122,0,-856,0,0,0,,856,-856
17,04/24/2018,49,12:00,12:15,,13.25,0,13.25,13.25,-1,-28056,125580,153636,97524,0,-3784,0,0,0,,3784,-3784
17,04/24/2018,50,12:15,12:30,,-30.46,0,-30.46,-30.46,-1,-44920,85791,130711,40871,0,-31639,0,0,0,,31639,-31639
17,04/24/2018,51,12:30,12:45,,33.6,0,33.6,33.6,-1,-61138,100388,161526,39250,0,-10279,0,0,0,,10279,-10279
17,04/24/2018,52,12:45,13:00,,24.29,0,24.29,24.29,-1,-63874,91228,155102,27354,0,-20567,0,0,0,,20567,-20567
17,04/24/2018,53,13:00,13:15,60.3,16.25,0,60.3,16.25,2,-62501,63972,126473,1471,0,-22492,1694,0,0,,24186,-20798
17,04/24/2018,54,13:15,13:30,81.25,33.6,0,81.25,33.6,2,-51690,73783,125473,22093,0,-445,12032,0,0,,12477,11587
17,04/24/2018,55,13:30,13:45,81.25,29.76,0,29.76,29.76,-1,-40201,105315,145516,65114,0,-1606,37,0,0,,1643,-1569
17,04/24/2018,56,13:45,14:00,,29.6,0,29.6,29.6,-1,-64527,79780,144307,15253,0,-5907,0,0,0,,5907,-5907
17,04/24/2018,57,14:00,14:15,,32.44,0,32.44,32.44,-1,-55347,93202,148549,37855,0,-7290,0,0,0,,7290,-7290
17,04/24/2018,58,14:15,14:30,,17.73,0,17.73,17.73,-1,-53876,98550,152426,44674,0,-13157,0,0,0,,13157,-13157
17,04/24/2018,59,14:30,14:45,,25,0,25,25,-1,-63109,109306,172415,46197,0,-22664,0,0,0,,22664,-22664
17,04/24/2018,60,14:45,15:00,,9.46,0,9.46,9.46,-1,-66790,122744,189534,55954,0,-34516,0,0,0,,34516,-34516
17,04/24/2018,61,15:00,15:15,,-8.44,0,-8.44,-8.44,-1,-37391,190769,228160,153378,0,-40347,0,0,0,,40347,-40347
17,04/24/2018,62,15:15,15:30,,23.6,0,23.6,23.6,-1,-22594,179133,201727,156539,0,-33386,0,0,0,,33386,-33386
17,04/24/2018,63,15:30,15:45,,15.44,0,15.44,15.44,-1,-26576,186725,213301,160149,0,-51533,0,0,0,,51533,-51533
17,04/24/2018,64,15:45,16:00,,15.67,0,15.67,15.67,-1,-52521,192204,244725,139683,0,-53349,0,0,0,,53349,-53349
17,04/24/2018,65,16:00,16:15,,-46.44,0,-46.44,-46.44,-1,-62509,154411,216920,91902,0,-70765,0,0,0,,70765,-70765
17,04/24/2018,66,16:15,16:30,,21.44,0,21.44,21.44,-1,-84871,151342,236213,66471,0,-56991,0,0,0,,56991,-56991
17,04/24/2018,67,16:30,16:45,,20.36,0,20.36,20.36,-1,-90121,129952,220073,39831,0,-50048,0,0,0,,50048,-50048
17,04/24/2018,68,16:45,17:00,,29.04,0,29.04,29.04,-1,-84306,111805,196111,27499,0,-18544,0,0,0,,18544,-18544
17,04/24/2018,69,17:00,17:15,,23.6,0,23.6,23.6,-1,-62767,115971,178738,53204,0,-17702,0,0,0,,17702,-17702
17,04/24/2018,70,17:15,17:30,33.95,33.44,0,35.24,33.44,2,-88017,82844,170861,-5173,0,-7962,4,0,0,,7966,-7958
17,04/24/2018,71,17:30,17:45,39.25,33.44,0,39.25,39.25,1,-82289,68703,150992,-13586,0,-278,1347,0,0,,1625,1069
17,04/24/2018,72,17:45,18:00,39.12,,0,39.12,39.12,1,-85400,60338,145738,-25062,0,0,1288,0,0,,1288,1288
17,04/24/2018,73,18:00,18:15,39.36,,0,39.36,39.36,1,-82786,34705,117491,-48081,0,0,2413,0,0,,2413,2413
17,04/24/2018,74,18:15,18:30,34.15,,0,34.15,34.15,1,-63233,58537,121770,-4696,0,0,90,0,0,,90,90
17,04/24/2018,75,18:30,18:45,37.6,,0,37.6,37.6,1,-50790,50433,101223,-357,0,0,782,0,0,,782,782
17,04/24/2018,76,18:45,19:00,34.18,,0,34.18,34.18,1,-52363,78423,130786,26060,0,0,262,0,0,,262,262
17,04/24/2018,77,19:00,19:15,41.6,,0,41.6,41.6,1,-75610,30993,106603,-44617,0,0,499,0,0,,499,499
17,04/24/2018,78,19:15,19:30,53.98,,0,53.98,53.98,1,-70257,37602,107859,-32655,0,0,6943,0,0,,6943,6943
17,04/24/2018,79,19:30,19:45,41.6,,0,41.6,41.6,1,-67740,52054,119794,-15686,0,0,11632,0,0,,11632,11632
17,04/24/2018,80,19:45,20:00,40.89,,0,40.89,40.89,1,-68963,42812,111775,-26151,0,0,2565,0,0,,2565,2565
17,04/24/2018,81,20:00,20:15,47.6,,0,47.6,47.6,1,-63006,38518,101524,-24488,0,0,11478,0,0,,11478,11478
17,04/24/2018,82,20:15,20:30,45.44,,0,45.44,45.44,1,-68809,43711,112520,-25098,0,0,21804,0,0,,21804,21804
17,04/24/2018,83,20:30,20:45,39.91,,0,39.91,39.91,1,-68998,52775,121773,-16223,0,0,11857,0,0,,11857,11857
17,04/24/2018,84,20:45,21:00,39.91,,0,39.91,39.91,1,-78322,53142,131464,-25180,0,0,773,0,0,,773,773
17,04/24/2018,85,21:00,21:15,122.44,,0,122.44,122.44,1,-89215,40243,129458,-48972,0,0,19397,0,0,,19397,19397
17,04/24/2018,86,21:15,21:30,52.09,,0,52.09,52.09,1,-75140,42902,118042,-32238,0,0,35241,0,0,,35241,35241
17,04/24/2018,87,21:30,21:45,52.09,35.58,0,35.58,35.58,-1,-56978,62303,119281,5325,0,-901,8900,0,0,,9801,7999
17,04/24/2018,88,21:45,22:00,,,0,37.34,37.34,0,-79567,84026,163593,4459,0,0,0,0,0,,0,0
17,04/24/2018,89,22:00,22:15,43.47,,0,43.47,43.47,1,-97074,54607,151681,-42467,0,0,544,0,0,,544,544
17,04/24/2018,90,22:15,22:30,,30.94,0,30.94,30.94,-1,-61574,75301,136875,13727,0,-945,0,0,0,,945,-945
17,04/24/2018,91,22:30,22:45,,29.6,0,29.6,29.6,-1,-45216,94866,140082,49650,0,-3180,0,0,0,,3180,-3180
17,04/24/2018,92,22:45,23:00,,33.6,0,33.6,33.6,-1,-82844,134227,217071,51383,0,-180,0,0,0,,180,-180
17,04/24/2018,93,23:00,23:15,,28.58,0,28.58,28.58,-1,-28723,101979,130702,73256,0,-439,0,0,0,,439,-439
17,04/24/2018,94,23:15,23:30,,-55.6,0,-55.6,-55.6,-1,-26825,106491,133316,79666,0,-18779,0,0,0,,18779,-18779
17,04/24/2018,95,23:30,23:45,,-74.44,0,-74.44,-74.44,-1,-49208,117774,166982,68566,0,-42803,0,0,0,,42803,-42803
17,04/24/2018,96,23:45,0:00,,-39.1,0,-39.1,-39.1,-1,-34129,134597,168726,100468,0,-53788,0,0,0,,53788,-53788
17,04/25/2018,1,0:00,0:15,38.51,-9.03,0,38.51,38.51,1,-52733,78338,131071,25605,0,-32357,244,0,0,,32601,-32113
17,04/25/2018,2,0:15,0:30,37.2,,0,37.2,37.2,1,-48845,47403,96248,-1442,0,0,626,0,0,,626,626
17,04/25/2018,3,0:30,0:45,,-21.75,0,-21.75,-21.75,-1,-42176,95264,137440,53088,0,-12924,0,0,0,,12924,-12924
17,04/25/2018,4,0:45,1:00,,-43.03,0,-43.03,-43.03,-1,-52151,100014,152165,47863,0,-49111,0,0,0,,49111,-49111
17,04/25/2018,5,1:00,1:15,34.72,25.77,0,34.72,34.72,1,-78474,65376,143850,-13098,0,-15924,39,0,0,,15963,-15885
17,04/25/2018,6,1:15,1:30,34.39,-24.03,0,34.87,-24.03,2,-38139,86429,124568,48290,0,-14028,31,0,0,,14059,-13997
17,04/25/2018,7,1:30,1:45,84.24,-27.03,0,84.24,-27.03,2,-45182,93712,138894,48530,0,-52251,347,0,0,,52598,-51904
17,04/25/2018,8,1:45,2:00,33.85,-25.71,0,35.02,-25.71,2,-52873,77679,130552,24806,0,-41125,10,0,0,,41135,-41115
17,04/25/2018,9,2:00,2:15,34.94,-16.03,0,34.94,-16.03,2,-40542,98774,139316,58232,0,-12252,164,0,0,,12416,-12088
17,04/25/2018,10,2:15,2:30,35.88,-150.03,0,35.88,-150.03,2,-22834,139205,162039,116371,0,-29561,19,0,0,,29580,-29542
17,04/25/2018,11,2:30,2:45,186.12,-150.03,0,186.12,-150.03,2,-25691,102914,128605,77223,0,-89173,2854,0,0,,92027,-86319
17,04/25/2018,12,2:45,3:00,155.98,-150.03,0,155.98,-150.03,2,-22268,128192,150460,105924,0,-93637,2355,0,0,,95992,-91282
17,04/25/2018,13,3:00,3:15,181.1,-150.03,0,181.1,-150.03,2,-27042,126860,153902,99818,0,-56153,1502,0,0,,57655,-54651
17,04/25/2018,14,3:15,3:30,,-50.03,0,-50.03,-50.03,-1,-37132,137987,175119,100855,0,-23527,0,0,0,,23527,-23527
17,04/25/2018,15,3:30,3:45,,-150.03,0,-150.03,-150.03,-1,-36090,130795,166885,94705,0,-54497,0,0,0,,54497,-54497
17,04/25/2018,16,3:45,4:00,,-150.03,0,-150.03,-150.03,-1,-40651,137044,177695,96393,0,-68830,0,0,0,,68830,-68830
17,04/25/2018,17,4:00,4:15,,-150.03,0,-150.03,-150.03,-1,-27486,126210,153696,98724,0,-70242,0,0,0,,70242,-70242
17,04/25/2018,18,4:15,4:30,,-150.03,0,-150.03,-150.03,-1,-30398,119037,149435,88639,0,-63290,0,0,0,,63290,-63290
17,04/25/2018,19,4:30,4:45,,-150.03,0,-150.03,-150.03,-1,-32303,101371,133674,69068,0,-55913,0,0,0,,55913,-55913
17,04/25/2018,20,4:45,5:00,,-150.03,0,-150.03,-150.03,-1,-40382,96136,136518,55754,0,-45099,0,0,0,,45099,-45099
17,04/25/2018,21,5:00,5:15,,-150.03,0,-150.03,-150.03,-1,-38211,138853,177064,100642,0,-61780,0,0,0,,61780,-61780
17,04/25/2018,22,5:15,5:30,,0.2,0,0.2,0.2,-1,-59670,115954,175624,56284,0,-53422,0,0,0,,53422,-53422
17,04/25/2018,23,5:30,5:45,,-150.03,0,-150.03,-150.03,-1,-52743,92357,145100,39614,0,-40470,0,0,0,,40470,-40470
17,04/25/2018,24,5:45,6:00,,-150.03,0,-150.03,-150.03,-1,-65234,139435,204669,74201,0,-32827,0,0,0,,32827,-32827
17,04/25/2018,25,6:00,6:15,,-150.03,0,-150.03,-150.03,-1,-94948,203013,297961,108065,0,-51155,0,0,0,,51155,-51155
17,04/25/2018,26,6:15,6:30,,-150.03,0,-150.03,-150.03,-1,-58125,150163,208288,92038,0,-54779,0,0,0,,54779,-54779
17,04/25/2018,27,6:30,6:45,33.83,-150.03,0,35.84,-150.03,2,-38593,85290,123883,46697,0,-38264,18,0,0,,38282,-38246
17,04/25/2018,28,6:45,7:00,33.91,-52.24,0,35.85,-52.24,2,-44249,159648,203897,115399,0,-6844,61,0,0,,6905,-6783
17,04/25/2018,29,7:00,7:15,,-162.24,0,-162.24,-162.24,-1,-82991,229435,312426,146444,0,-47557,0,0,0,,47557,-47557
17,04/25/2018,30,7:15,7:30,,-162.24,0,-162.24,-162.24,-1,-116755,229274,346029,112519,0,-46977,0,0,0,,46977,-46977
17,04/25/2018,31,7:30,7:45,,,0,33.88,33.88,0,-122619,181288,303907,58669,0,-2075,0,0,0,,2075,-2075
17,04/25/2018,32,7:45,8:00,44.41,,0,44.41,44.41,1,-146301,125271,271572,-21030,0,0,5241,0,0,,5241,5241
17,04/25/2018,33,8:00,8:15,44.41,25.53,0,25.53,25.53,-1,-124256,159529,283785,35273,0,-6212,1171,0,0,,7383,-5041
17,04/25/2018,34,8:15,8:30,,32.66,0,32.66,32.66,-1,-92302,111920,204222,19618,0,-6534,0,0,0,,6534,-6534
17,04/25/2018,35,8:30,8:45,44.16,32.66,0,44.16,44.16,1,-134572,90516,225088,-44056,0,-1944,1319,0,0,,3263,-625
17,04/25/2018,36,8:45,9:00,48.19,,0,48.19,48.19,1,-131884,96149,228033,-35735,0,0,15159,0,0,,15159,15159
17,04/25/2018,37,9:00,9:15,41.06,36.35,0,36.35,36.35,-1,-108601,108580,217181,-21,0,-277,9900,0,0,,10177,9623
17,04/25/2018,38,9:15,9:30,253.24,36.35,0,253.24,36.35,2,-148054,47423,195477,-100631,0,-94,20118,0,0,,20212,20024
17,04/25/2018,39,9:30,9:45,51.24,,0,51.24,51.24,1,-115073,58207,173280,-56866,0,0,25034,0,0,,25034,25034
17,04/25/2018,40,9:45,10:00,40.61,,0,40.61,40.61,1,-127358,55329,182687,-72029,0,0,1136,0,0,,1136,1136
17,04/25/2018,41,10:00,10:15,42.19,,0,42.19,42.19,1,-109665,83827,193492,-25838,0,0,1771,0,0,,1771,1771
17,04/25/2018,42,10:15,10:30,39.31,,0,39.31,39.31,1,-105200,94807,200007,-10393,0,0,1895,0,0,,1895,1895
17,04/25/2018,43,10:30,10:45,40.34,,0,40.34,40.34,1,-102245,90769,193014,-11476,0,0,5785,0,0,,5785,5785
17,04/25/2018,44,10:45,11:00,51.46,,0,51.46,51.46,1,-106997,70868,177865,-36129,0,0,17941,0,0,,17941,17941
17,04/25/2018,45,11:00,11:15,237.24,,0,237.24,237.24,1,-108928,110183,219111,1255,0,0,52616,0,0,,52616,52616
17,04/25/2018,46,11:15,11:30,149.9,,0,149.9,149.9,1,-86447,134522,220969,48075,0,0,60678,8750,0,,69428,69428
17,04/25/2018,47,11:30,11:45,38.19,36.47,0,38.19,36.47,2,-49194,192707,241901,143513,0,-496,8512,0,0,,9008,8016
17,04/25/2018,48,11:45,12:00,,,0,37.47,37.47,0,-49117,209552,258669,160435,0,0,0,0,0,,0,0
17,04/25/2018,49,12:00,12:15,42.69,,0,42.69,42.69,1,-102943,82475,185418,-20468,0,0,2969,0,0,,2969,2969
17,04/25/2018,50,12:15,12:30,42.69,22.76,0,22.76,22.76,-1,-63725,93371,157096,29646,0,-3685,257,0,0,,3942,-3428
17,04/25/2018,51,12:30,12:45,,18.24,0,18.24,18.24,-1,-65507,104047,169554,38540,0,-12576,0,0,0,,12576,-12576
17,04/25/2018,52,12:45,13:00,,36.39,0,36.39,36.39,-1,-69599,107376,176975,37777,0,-170,0,0,0,,170,-170
17,04/25/2018,53,13:00,13:15,,20.7,0,20.7,20.7,-1,-75530,128109,203639,52579,0,-4241,0,0,0,,4241,-4241
17,04/25/2018,54,13:15,13:30,42.19,,0,42.19,42.19,1,-108765,118207,226972,9442,0,0,458,0,0,,458,458
17,04/25/2018,55,13:30,13:45,,28.76,0,28.76,28.76,-1,-96014,133947,229961,37933,0,-757,0,0,0,,757,-757
17,04/25/2018,56,13:45,14:00,,10.76,0,10.76,10.76,-1,-77783,127136,204919,49353,0,-5975,0,0,0,,5975,-5975
17,04/25/2018,57,14:00,14:15,48.19,9.51,0,48.19,9.51,2,-101233,99290,200523,-1943,0,-10539,2123,0,0,,12662,-8416
17,04/25/2018,58,14:15,14:30,37.46,28.76,0,28.76,28.76,-1,-65537,88324,153861,22787,0,-307,2827,0,0,,3134,2520
17,04/25/2018,59,14:30,14:45,,-13.24,0,-13.24,-13.24,-1,-48419,93488,141907,45069,0,-26758,0,0,0,,26758,-26758
17,04/25/2018,60,14:45,15:00,,28.76,0,28.76,28.76,-1,-61808,72164,133972,10356,0,-23962,0,0,0,,23962,-23962
17,04/25/2018,61,15:00,15:15,,26.14,0,26.14,26.14,-1,-38200,120649,158849,82449,0,-17096,0,0,0,,17096,-17096
17,04/25/2018,62,15:15,15:30,,-10.24,0,-10.24,-10.24,-1,-40223,170408,210631,130185,0,-22356,0,0,0,,22356,-22356
17,04/25/2018,63,15:30,15:45,,-48.24,0,-48.24,-48.24,-1,-32514,167141,199655,134627,0,-50484,0,0,0,,50484,-50484
17,04/25/2018,64,15:45,16:00,,-162.24,0,-162.24,-162.24,-1,-32035,126115,158150,94080,0,-58095,0,0,0,,58095,-58095
17,04/25/2018,65,16:00,16:15,,-33.24,0,-33.24,-33.24,-1,-44387,128746,173133,84359,0,-55433,0,0,0,,55433,-55433
17,04/25/2018,66,16:15,16:30,,-162.24,0,-162.24,-162.24,-1,-69894,109451,179345,39557,0,-57889,0,0,0,,57889,-57889
17,04/25/2018,67,16:30,16:45,,-162.24,0,-162.24,-162.24,-1,-51470,125775,177245,74305,0,-38111,0,0,0,,38111,-38111
17,04/25/2018,68,16:45,17:00,,-162.24,0,-162.24,-162.24,-1,-43689,133023,176712,89334,0,-49497,0,0,0,,49497,-49497
17,04/25/2018,69,17:00,17:15,207.24,7.24,0,207.24,207.24,1,-183311,120350,303661,-62961,0,-30643,5682,0,0,,36325,-24961
17,04/25/2018,70,17:15,17:30,253.24,28.76,0,253.24,28.76,2,-104588,124938,229526,20350,0,-308,17772,0,0,,18080,17464
17,04/25/2018,71,17:30,17:45,253.24,22.76,0,22.76,22.76,-1,-59398,178601,237999,119203,0,-5819,218,0,0,,6037,-5601
17,04/25/2018,72,17:45,18:00,,22.76,0,22.76,22.76,-1,-53992,194711,248703,140719,0,-1827,0,0,0,,1827,-1827
17,04/25/2018,73,18:00,18:15,,-73.24,0,-73.24,-73.24,-1,-24156,143319,167475,119163,0,-43327,0,0,0,,43327,-43327
17,04/25/2018,74,18:15,18:30,,16.29,0,16.29,16.29,-1,-29039,150667,179706,121628,0,-32612,0,0,0,,32612,-32612
17,04/25/2018,75,18:30,18:45,,22.76,0,22.76,22.76,-1,-31384,145649,177033,114265,0,-22595,0,0,0,,22595,-22595
17,04/25/2018,76,18:45,19:00,,,0,35.72,35.72,0,-29483,137242,166725,107759,0,-1792,0,0,0,,1792,-1792
17,04/25/2018,77,19:00,19:15,,-8.24,0,-8.24,-8.24,-1,-39727,194329,234056,154602,0,-20482,0,0,0,,20482,-20482
17,04/25/2018,78,19:15,19:30,,32.76,0,32.76,32.76,-1,-42760,146349,189109,103589,0,-5477,0,0,0,,5477,-5477
17,04/25/2018,79,19:30,19:45,,,0,36.57,36.57,0,-47186,139142,186328,91956,0,0,0,0,0,,0,0
17,04/25/2018,80,19:45,20:00,,,0,24.48,24.48,0,-61603,129347,190950,67744,0,0,0,0,0,,0,0
17,04/25/2018,81,20:00,20:15,,,0,24.48,24.48,0,-75926,121124,197050,45198,0,0,0,0,0,,0,0
17,04/25/2018,82,20:15,20:30,,39.4,0,39.4,39.4,-1,-69425,109515,178940,40090,0,-261,0,0,0,,261,-261
17,04/25/2018,83,20:30,20:45,,39.34,0,39.34,39.34,-1,-87338,97674,185012,10336,0,-485,0,0,0,,485,-485
17,04/25/2018,84,20:45,21:00,,,0,24.58,24.58,0,-93162,91393,184555,-1769,0,0,0,0,0,,0,0
17,04/25/2018,85,21:00,21:15,237.24,,0,237.24,237.24,1,-122330,80735,203065,-41595,0,0,14688,0,0,,14688,14688
17,04/25/2018,86,21:15,21:30,237.24,,0,237.24,237.24,1,-132939,82545,215484,-50394,0,0,67909,0,0,,67909,67909
17,04/25/2018,87,21:30,21:45,40.57,,0,40.57,40.57,1,-91207,128162,219369,36955,0,0,7008,0,0,,7008,7008
17,04/25/2018,88,21:45,22:00,,39.39,0,39.39,39.39,-1,-108486,131048,239534,22562,0,-38,0,0,0,,38,-38
17,04/25/2018,89,22:00,22:15,41.32,38.59,0,41.32,37.18,2,-145848,133494,279342,-12354,0,-650,228,0,0,,878,-422
17,04/25/2018,90,22:15,22:30,42.19,,0,42.19,42.19,1,-129113,111714,240827,-17399,0,0,5738,0,0,,5738,5738
17,04/25/2018,91,22:30,22:45,,,0,36.96,36.96,0,-136579,132263,268842,-4316,0,0,733,0,0,,733,733
17,04/25/2018,92,22:45,23:00,,32.76,0,32.76,32.76,-1,-136503,156249,292752,19746,0,-781,0,0,0,,781,-781
17,04/25/2018,93,23:00,23:15,95.09,32.76,0,95.09,95.09,1,-156556,116812,273368,-39744,0,-511,12183,0,0,,12694,11672
17,04/25/2018,94,23:15,23:30,101.86,,0,101.86,101.86,1,-135585,89224,224809,-46361,0,0,56789,0,0,,56789,56789
17,04/25/2018,95,23:30,23:45,39.54,29.37,0,39.54,29.37,2,-143833,157056,300889,13223,0,-1434,10793,0,0,,12227,9359
17,04/25/2018,96,23:45,0:00,48.85,26.44,0,48.85,26.44,2,-173869,163200,337069,-10669,0,-8874,875,0,0,,9749,-7999
17,04/26/2018,1,0:00,0:15,63.9,26.44,0,63.9,63.9,1,-135601,69910,205511,-65691,0,-524,9789,0,0,,10313,9265
17,04/26/2018,2,0:15,0:30,63.9,,0,63.9,63.9,1,-78601,56047,134648,-22554,0,0,28645,0,0,,28645,28645
17,04/26/2018,3,0:30,0:45,63.9,34.26,0,34.26,34.26,-1,-70871,94681,165552,23810,0,-751,2766,0,0,,3517,2015
17,04/26/2018,4,0:45,1:00,,2.94,0,2.94,2.94,-1,-65120,127621,192741,62501,0,-16687,0,0,0,,16687,-16687
17,04/26/2018,5,1:00,1:15,,22.76,0,22.76,22.76,-1,-47662,59989,107651,12327,0,-14252,0,0,0,,14252,-14252
17,04/26/2018,6,1:15,1:30,,32.76,0,32.76,32.76,-1,-32408,60863,93271,28455,0,-1245,0,0,0,,1245,-1245
17,04/26/2018,7,1:30,1:45,,34.23,0,34.23,34.23,-1,-18760,77608,96368,58848,0,-1336,0,0,0,,1336,-1336
17,04/26/2018,8,1:45,2:00,,-109.78,0,-109.78,-109.78,-1,-13321,113783,127104,100462,0,-20786,0,0,0,,20786,-20786
17,04/26/2018,9,2:00,2:15,,14.78,0,14.78,14.78,-1,-42549,60784,103333,18235,0,-21924,0,0,0,,21924,-21924
17,04/26/2018,10,2:15,2:30,,,0,34.75,34.75,0,-46795,63135,109930,16340,0,-81,0,0,0,,81,-81
17,04/26/2018,11,2:30,2:45,,33.04,0,33.04,33.04,-1,-53871,54849,108720,978,0,-898,0,0,0,,898,-898
17,04/26/2018,12,2:45,3:00,,30.78,0,30.78,30.78,-1,-50057,64399,114456,14342,0,-8245,0,0,0,,8245,-8245
17,04/26/2018,13,3:00,3:15,74.74,30.78,0,74.74,74.74,1,-94802,38053,132855,-56749,0,-1098,20165,0,0,,21263,19067
17,04/26/2018,14,3:15,3:30,46.46,,0,46.46,46.46,1,-94839,49626,144465,-45213,0,0,44394,0,0,,44394,44394
17,04/26/2018,15,3:30,3:45,41.81,10.76,0,10.76,10.76,-1,-71336,94108,165444,22772,0,-1853,20463,0,0,,22316,18610
17,04/26/2018,16,3:45,4:00,,0.78,0,0.78,0.78,-1,-61280,96321,157601,35041,0,-26518,0,0,0,,26518,-26518
17,04/26/2018,17,4:00,4:15,,30.78,0,30.78,30.78,-1,-67749,83733,151482,15984,0,-8855,0,0,0,,8855,-8855
17,04/26/2018,18,4:15,4:30,,,0,35.77,35.77,0,-66107,81876,147983,15769,0,-109,0,0,0,,109,-109
17,04/26/2018,19,4:30,4:45,,,0,35.77,35.77,0,-56088,100328,156416,44240,0,0,0,0,0,,0,0
17,04/26/2018,20,4:45,5:00,,,0,35.75,35.75,0,-46562,108022,154584,61460,0,0,0,0,0,,0,0
17,04/26/2018,21,5:00,5:15,,10.76,0,10.76,10.76,-1,-21739,167758,189497,146019,0,-13646,0,0,0,,13646,-13646
17,04/26/2018,22,5:15,5:30,,5.78,0,5.78,5.78,-1,-19893,148283,168176,128390,0,-30233,0,0,0,,30233,-30233
17,04/26/2018,23,5:30,5:45,,28.76,0,28.76,28.76,-1,-25356,118548,143904,93192,0,-14939,0,0,0,,14939,-14939
17,04/26/2018,24,5:45,6:00,,32.76,0,32.76,32.76,-1,-42167,120989,163156,78822,0,-3819,0,0,0,,3819,-3819
17,04/26/2018,25,6:00,6:15,,23.04,0,23.04,23.04,-1,-42353,91429,133782,49076,0,-12748,0,0,0,,12748,-12748
17,04/26/2018,26,6:15,6:30,,29.36,0,29.36,29.36,-1,-27181,95297,122478,68116,0,-16593,0,0,0,,16593,-16593
17,04/26/2018,27,6:30,6:45,37.04,29.36,0,37.04,37.04,1,-32858,53090,85948,20232,0,-2446,34,0,0,,2480,-2412
17,04/26/2018,28,6:45,7:00,37.04,,0,37.04,37.04,1,-58163,58075,116238,-88,0,0,484,0,0,,484,484
17,04/26/2018,29,7:00,7:15,33.95,34.79,0,35.37,34.79,2,-80116,92680,172796,12564,0,-178,5,0,0,,183,-173
17,04/26/2018,30,7:15,7:30,62.78,,0,62.78,62.78,1,-83306,48426,131732,-34880,0,0,15772,0,0,,15772,15772
17,04/26/2018,31,7:30,7:45,75.31,,0,75.31,75.31,1,-78215,56448,134663,-21767,0,0,33047,0,0,,33047,33047
17,04/26/2018,32,7:45,8:00,34.11,,0,34.11,34.11,1,-103512,103969,207481,457,0,0,5728,0,0,,5728,5728
17,04/26/2018,33,8:00,8:15,57.8,,0,57.8,57.8,1,-131234,106000,237234,-25234,0,0,11292,0,0,,11292,11292
17,04/26/2018,34,8:15,8:30,42.28,,0,42.28,42.28,1,-107883,113542,221425,5659,0,0,9588,0,0,,9588,9588
17,04/26/2018,35,8:30,8:45,,,0,35.95,35.95,0,-91119,102690,193809,11571,0,0,35,0,0,,35,35
17,04/26/2018,36,8:45,9:00,,,0,35.95,35.95,0,-77017,111193,188210,34176,0,0,0,0,0,,0,0
17,04/26/2018,37,9:00,9:15,48.28,,0,48.28,48.28,1,-87596,62063,149659,-25533,0,0,5776,0,0,,5776,5776
17,04/26/2018,38,9:15,9:30,48.28,36.2,0,48.28,35.95,2,-80228,90912,171140,10684,0,-15,17387,0,0,,17402,17372
17,04/26/2018,39,9:30,9:45,48.28,26.66,0,26.66,26.66,-1,-65603,128379,193982,62776,0,-2465,811,0,0,,3276,-1654
17,04/26/2018,40,9:45,10:00,,29.17,0,29.17,29.17,-1,-59357,128954,188311,69597,0,-5498,0,0,0,,5498,-5498
17,04/26/2018,41,10:00,10:15,,36.78,0,36.78,36.78,-1,-69106,102974,172080,33868,0,-1553,0,0,0,,1553,-1553
17,04/26/2018,42,10:15,10:30,,,0,37.34,37.34,0,-64994,96898,161892,31904,0,0,0,0,0,,0,0
17,04/26/2018,43,10:30,10:45,,39.57,0,39.57,39.57,-1,-59836,111445,171281,51609,0,-16,0,0,0,,16,-16
17,04/26/2018,44,10:45,11:00,,34.28,0,34.28,34.28,-1,-50686,114890,165576,64204,0,-1027,0,0,0,,1027,-1027
17,04/26/2018,45,11:00,11:15,69.59,35.78,0,69.59,35.78,2,-121045,51307,172352,-69738,0,-563,10426,0,0,,10989,9863
17,04/26/2018,46,11:15,11:30,48.28,,0,48.28,48.28,1,-115056,69821,184877,-45235,0,0,20817,0,0,,20817,20817
17,04/26/2018,47,11:30,11:45,43.34,,0,43.34,43.34,1,-112516,69257,181773,-43259,0,0,17971,0,0,,17971,17971
17,04/26/2018,48,11:45,12:00,42.28,,0,42.28,42.28,1,-94464,89574,184038,-4890,0,0,12688,0,0,,12688,12688
17,04/26/2018,49,12:00,12:15,71.38,,0,71.38,71.38,1,-100792,36355,137147,-64437,0,0,18058,0,0,,18058,18058
17,04/26/2018,50,12:15,12:30,49.06,,0,49.06,49.06,1,-84788,46358,131146,-38430,0,0,26876,0,0,,26876,26876
17,04/26/2018,51,12:30,12:45,,,0,35.95,35.95,0,-76195,72127,148322,-4068,0,0,3297,0,0,,3297,3297
17,04/26/2018,52,12:45,13:00,,24.28,0,24.28,24.28,-1,-57898,70300,128198,12402,0,-653,0,0,0,,653,-653
17,04/26/2018,53,13:00,13:15,,23.68,0,23.68,23.68,-1,-6625,90478,97103,83853,0,-1687,0,0,0,,1687,-1687
17,04/26/2018,54,13:15,13:30,,23.35,0,23.35,23.35,-1,-18456,80791,99247,62335,0,-10395,0,0,0,,10395,-10395
17,04/26/2018,55,13:30,13:45,,34.28,0,34.28,34.28,-1,-16421,103133,119554,86712,0,-6623,0,0,0,,6623,-6623
17,04/26/2018,56,13:45,14:00,,30.28,0,30.28,30.28,-1,-12076,130677,142753,118601,0,-5713,0,0,0,,5713,-5713
17,04/26/2018,57,14:00,14:15,,18.85,0,18.85,18.85,-1,-6292,139932,146224,133640,0,-16494,0,0,0,,16494,-16494
17,04/26/2018,58,14:15,14:30,,-76.78,0,-76.78,-76.78,-1,-36681,107881,144562,71200,0,-40828,0,0,0,,40828,-40828
17,04/26/2018,59,14:30,14:45,,-51.78,0,-51.78,-51.78,-1,-34867,103866,138733,68999,0,-43487,0,0,0,,43487,-43487
17,04/26/2018,60,14:45,15:00,,-100.78,0,-100.78,-100.78,-1,-73890,84963,158853,11073,0,-37600,0,0,0,,37600,-37600
17,04/26/2018,61,15:00,15:15,,-150.78,0,-150.78,-150.78,-1,-37029,120446,157475,83417,0,-38050,0,0,0,,38050,-38050
17,04/26/2018,62,15:15,15:30,,24.28,0,24.28,24.28,-1,-43253,117224,160477,73971,0,-30311,0,0,0,,30311,-30311
17,04/26/2018,63,15:30,15:45,,23.33,0,23.33,23.33,-1,-38075,118945,157020,80870,0,-17497,0,0,0,,17497,-17497
17,04/26/2018,64,15:45,16:00,,-27.44,0,-27.44,-27.44,-1,-60856,97344,158200,36488,0,-31888,0,0,0,,31888,-31888
17,04/26/2018,65,16:00,16:15,,30.28,0,30.28,30.28,-1,-87991,114011,202002,26020,0,-13770,0,0,0,,13770,-13770
17,04/26/2018,66,16:15,16:30,,,0,36.34,36.34,0,-78529,113922,192451,35393,0,-287,0,0,0,,287,-287
17,04/26/2018,67,16:30,16:45,,,0,36.24,36.24,0,-82212,113499,195711,31287,0,0,0,0,0,,0,0
17,04/26/2018,68,16:45,17:00,,,0,36.24,36.24,0,-58131,92663,150794,34532,0,0,0,0,0,,0,0
17,04/26/2018,69,17:00,17:15,,32.08,0,32.08,32.08,-1,-83438,103411,186849,19973,0,-78,0,0,0,,78,-78
17,04/26/2018,70,17:15,17:30,35.83,,0,35.83,35.83,1,-71800,70782,142582,-1018,0,0,185,0,0,,185,185
17,04/26/2018,71,17:30,17:45,42.28,,0,42.28,42.28,1,-63046,59954,123000,-3092,0,0,421,0,0,,421,421
17,04/26/2018,72,17:45,18:00,69.45,,0,69.45,69.45,1,-107140,56366,163506,-50774,0,0,17190,0,0,,17190,17190
17,04/26/2018,73,18:00,18:15,69.45,-52.78,0,-52.78,-52.78,-1,-40567,100250,140817,59683,0,-12793,3468,0,0,,16261,-9325
17,04/26/2018,74,18:15,18:30,,-78.78,0,-78.78,-78.78,-1,-67108,77694,144802,10586,0,-25736,0,0,0,,25736,-25736
17,04/26/2018,75,18:30,18:45,,24.28,0,24.28,24.28,-1,-49989,89419,139408,39430,0,-11315,0,0,0,,11315,-11315
17,04/26/2018,76,18:45,19:00,,33.78,0,33.78,33.78,-1,-49026,92092,141118,43066,0,-11225,0,0,0,,11225,-11225
17,04/26/2018,77,19:00,19:15,,31.53,0,31.53,31.53,-1,-63675,104600,168275,40925,0,-12247,0,0,0,,12247,-12247
17,04/26/2018,78,19:15,19:30,,,0,35.69,35.69,0,-66587,79116,145703,12529,0,-2409,0,0,0,,2409,-2409
17,04/26/2018,79,19:30,19:45,34.6,,0,34.6,34.6,1,-60487,64105,124592,3618,0,0,259,0,0,,259,259
17,04/26/2018,80,19:45,20:00,43.88,,0,43.88,43.88,1,-67973,54143,122116,-13830,0,0,3597,0,0,,3597,3597
17,04/26/2018,81,20:00,20:15,34.92,,0,34.92,34.92,1,-46315,84243,130558,37928,0,0,1143,0,0,,1143,1143
17,04/26/2018,82,20:15,20:30,,36.04,0,36.04,36.04,-1,-49869,84289,134158,34420,0,-4,0,0,0,,4,-4
17,04/26/2018,83,20:30,20:45,,35.57,0,35.57,35.57,-1,-55153,81459,136612,26306,0,-239,0,0,0,,239,-239
17,04/26/2018,84,20:45,21:00,,36.2,0,36.2,36.2,-1,-65107,52431,117538,-12676,0,-897,0,0,0,,897,-897
17,04/26/2018,85,21:00,21:15,,,0,36.29,36.29,0,-37897,98575,136472,60678,0,0,0,0,0,,0,0
17,04/26/2018,86,21:15,21:30,42.28,,0,42.28,42.28,1,-47445,45486,92931,-1959,0,0,759,0,0,,759,759
17,04/26/2018,87,21:30,21:45,,,0,36.26,36.26,0,-29442,56233,85675,26791,0,0,135,0,0,,135,135
17,04/26/2018,88,21:45,22:00,,36.64,0,36.64,36.64,-1,-30277,75496,105773,45219,0,-56,0,0,0,,56,-56
17,04/26/2018,89,22:00,22:15,48.12,32.78,0,48.12,32.78,2,-62861,29862,92723,-32999,0,-184,1660,0,0,,1844,1476
17,04/26/2018,90,22:15,22:30,39.29,29.51,0,39.29,29.51,2,-40375,50772,91147,10397,0,-787,1735,0,0,,2522,948
17,04/26/2018,91,22:30,22:45,,25.58,0,25.58,25.58,-1,-31667,83293,114960,51626,0,-8474,0,0,0,,8474,-8474
17,04/26/2018,92,22:45,23:00,,-8.19,0,-8.19,-8.19,-1,-26252,100469,126721,74217,0,-16493,0,0,0,,16493,-16493
17,04/26/2018,93,23:00,23:15,85.42,-33.24,0,85.42,85.42,1,-73372,41905,115277,-31467,0,-16176,6248,0,0,,22424,-9928
17,04/26/2018,94,23:15,23:30,44.71,34.28,0,34.28,34.28,-1,-50307,45770,96077,-4537,0,-187,13047,0,0,,13234,12860
17,04/26/2018,95,23:30,23:45,44.71,24.28,0,24.28,24.28,-1,-48300,60660,108960,12360,0,-9319,194,0,0,,9513,-9125
17,04/26/2018,96,23:45,0:00,,24.28,0,24.28,24.28,-1,-60241,67746,127987,7505,0,-5703,0,0,0,,5703,-5703
17,04/27/2018,1,0:00,0:15,,7.37,0,7.37,7.37,-1,-37121,109935,147056,72814,0,-8010,0,0,0,,8010,-8010
17,04/27/2018,2,0:15,0:30,,33.27,0,33.27,33.27,-1,-30800,86437,117237,55637,0,-32,0,0,0,,32,-32
17,04/27/2018,3,0:30,0:45,,22.1,0,22.1,22.1,-1,-14684,35123,49807,20439,0,-8195,0,0,0,,8195,-8195
17,04/27/2018,4,0:45,1:00,34.36,30.22,0,37.36,30.22,2,-32476,41772,74248,9296,0,-1209,255,0,0,,1464,-954
17,04/27/2018,5,1:00,1:15,37.27,30.22,0,37.27,37.27,1,-53053,50460,103513,-2593,0,-122,156,0,0,,278,34
17,04/27/2018,6,1:15,1:30,37.27,27.35,0,27.35,27.35,-1,-35514,54671,90185,19157,0,-1165,337,0,0,,1502,-828
17,04/27/2018,7,1:30,1:45,,22.07,0,22.07,22.07,-1,-35626,59242,94868,23616,0,-20657,0,0,0,,20657,-20657
17,04/27/2018,8,1:45,2:00,,29.27,0,29.27,29.27,-1,-38113,51084,89197,12971,0,-18983,0,0,0,,18983,-18983
17,04/27/2018,9,2:00,2:15,,34.62,0,34.62,34.62,-1,-31957,56392,88349,24435,0,-6772,0,0,0,,6772,-6772
17,04/27/2018,10,2:15,2:30,,25.62,0,25.62,25.62,-1,-29410,58625,88035,29215,0,-2123,0,0,0,,2123,-2123
17,04/27/2018,11,2:30,2:45,,23.27,0,23.27,23.27,-1,-32427,65263,97690,32836,0,-15424,0,0,0,,15424,-15424
17,04/27/2018,12,2:45,3:00,,23.27,0,23.27,23.27,-1,-37147,73495,110642,36348,0,-26226,0,0,0,,26226,-26226
17,04/27/2018,13,3:00,3:15,,25,0,25,25,-1,-52634,101480,154114,48846,0,-20166,0,0,0,,20166,-20166
17,04/27/2018,14,3:15,3:30,,,0,36.71,36.71,0,-50961,89144,140105,38183,0,-1624,0,0,0,,1624,-1624
17,04/27/2018,15,3:30,3:45,,35.77,0,35.77,35.77,-1,-51520,76599,128119,25079,0,-18,0,0,0,,18,-18
17,04/27/2018,16,3:45,4:00,,35.71,0,35.71,35.71,-1,-67295,72163,139458,4868,0,-859,0,0,0,,859,-859
17,04/27/2018,17,4:00,4:15,,33.92,0,33.92,33.92,-1,-26615,40980,67595,14365,0,-2195,0,0,0,,2195,-2195
17,04/27/2018,18,4:15,4:30,,36.15,0,36.15,36.15,-1,-44487,51972,96459,7485,0,-231,0,0,0,,231,-231
17,04/27/2018,19,4:30,4:45,37.27,,0,37.27,37.27,1,-49032,44041,93073,-4991,0,0,308,0,0,,308,308
17,04/27/2018,20,4:45,5:00,35.67,,0,35.67,35.67,1,-55108,53935,109043,-1173,0,0,1107,0,0,,1107,1107
17,04/27/2018,21,5:00,5:15,46.52,,0,46.52,46.52,1,-65844,31941,97785,-33903,0,0,5421,0,0,,5421,5421
17,04/27/2018,22,5:15,5:30,,,0,35.16,35.16,0,-43735,45664,89399,1929,0,0,383,0,0,,383,383
17,04/27/2018,23,5:30,5:45,47.27,,0,47.27,47.27,1,-52020,32603,84623,-19417,0,0,3443,0,0,,3443,3443
17,04/27/2018,24,5:45,6:00,41.24,35.18,0,35.18,35.18,-1,-50670,57196,107866,6526,0,-32,6179,0,0,,6211,6147
17,04/27/2018,25,6:00,6:15,41.51,,0,41.51,41.51,1,-124122,18813,142935,-105309,0,0,2787,0,0,,2787,2787
17,04/27/2018,26,6:15,6:30,,,0,36.92,36.92,0,-51765,36075,87840,-15690,0,0,743,0,0,,743,743
17,04/27/2018,27,6:30,6:45,68.37,,0,68.37,68.37,1,-62691,29303,91994,-33388,0,0,6261,0,0,,6261,6261
17,04/27/2018,28,6:45,7:00,88.02,,0,88.02,88.02,1,-59921,60592,120513,671,0,0,30466,0,0,,30466,30466
17,04/27/2018,29,7:00,7:15,35.02,39.49,0,39.49,39.49,-1,-88437,67429,155866,-21008,0,-417,1472,0,0,,1889,1055
17,04/27/2018,30,7:15,7:30,,39.05,0,39.05,39.05,-1,-75759,62880,138639,-12879,0,-1248,0,0,0,,1248,-1248
17,04/27/2018,31,7:30,7:45,,38.68,0,38.68,38.68,-1,-81366,49915,131281,-31451,0,-175,0,0,0,,175,-175
17,04/27/2018,32,7:45,8:00,,38.39,0,38.39,38.39,-1,-79463,48306,127769,-31157,0,-79,0,0,0,,79,-79
17,04/27/2018,33,8:00,8:15,,39.23,0,39.23,39.23,-1,-47388,87106,134494,39718,0,-807,0,0,0,,807,-807
17,04/27/2018,34,8:15,8:30,,38.21,0,38.21,38.21,-1,-50644,76975,127619,26331,0,-3793,0,0,0,,3793,-3793
17,04/27/2018,35,8:30,8:45,,39.14,0,39.14,39.14,-1,-54043,65295,119338,11252,0,-647,0,0,0,,647,-647
17,04/27/2018,36,8:45,9:00,,,0,36.83,36.83,0,-50276,63898,114174,13622,0,0,0,0,0,,0,0
17,04/27/2018,37,9:00,9:15,37.76,,0,37.76,37.76,1,-85501,100426,185927,14925,0,0,63,0,0,,63,63
17,04/27/2018,38,9:15,9:30,37.76,,0,37.76,37.76,1,-84759,86944,171703,2185,0,0,317,0,0,,317,317
17,04/27/2018,39,9:30,9:45,,35.73,0,35.73,35.73,-1,-91904,91805,183709,-99,0,-1536,0,0,0,,1536,-1536
17,04/27/2018,40,9:45,10:00,,35.73,0,35.73,35.73,-1,-89059,91660,180719,2601,0,-2280,0,0,0,,2280,-2280
17,04/27/2018,41,10:00,10:15,,35.51,0,35.51,35.51,-1,-74789,82861,157650,8072,0,-1351,0,0,0,,1351,-1351
17,04/27/2018,42,10:15,10:30,,33.76,0,33.76,33.76,-1,-67355,84242,151597,16887,0,-5422,0,0,0,,5422,-5422
17,04/27/2018,43,10:30,10:45,,33.39,0,33.39,33.39,-1,-65889,79888,145777,13999,0,-12121,0,0,0,,12121,-12121
17,04/27/2018,44,10:45,11:00,,36.09,0,36.09,36.09,-1,-75167,67764,142931,-7403,0,-4687,0,0,0,,4687,-4687
17,04/27/2018,45,11:00,11:15,,37.46,0,37.46,37.46,-1,-81726,78832,160558,-2894,0,-358,0,0,0,,358,-358
17,04/27/2018,46,11:15,11:30,,35.73,0,35.73,35.73,-1,-84217,85629,169846,1412,0,-2730,0,0,0,,2730,-2730
17,04/27/2018,47,11:30,11:45,40.31,35.73,0,40.31,35.72,2,-87328,81641,168969,-5687,0,-2111,983,0,0,,3094,-1128
17,04/27/2018,48,11:45,12:00,41.76,,0,41.76,41.76,1,-86603,60870,147473,-25733,0,0,5357,0,0,,5357,5357
17,04/27/2018,49,12:00,12:15,41.76,27.99,0,27.99,27.99,-1,-29799,102860,132659,73061,0,-4662,846,0,0,,5508,-3816
17,04/27/2018,50,12:15,12:30,,-15.03,0,-15.03,-15.03,-1,-29389,94223,123612,64834,0,-32357,0,0,0,,32357,-32357
17,04/27/2018,51,12:30,12:45,,-5.03,0,-5.03,-5.03,-1,-26779,102660,129439,75881,0,-59129,0,0,0,,59129,-59129
17,04/27/2018,52,12:45,13:00,,-65.03,0,-65.03,-65.03,-1,-39996,97430,137426,57434,0,-72454,0,0,0,,72454,-72454
17,04/27/2018,53,13:00,13:15,,22.76,0,22.76,22.76,-1,-50762,121038,171800,70276,0,-54304,0,0,0,,54304,-54304
17,04/27/2018,54,13:15,13:30,,24.17,0,24.17,24.17,-1,-51962,115146,167108,63184,0,-48738,0,0,0,,48738,-48738
17,04/27/2018,55,13:30,13:45,,24.17,0,24.17,24.17,-1,-53816,121502,175318,67686,0,-41885,0,0,0,,41885,-41885
17,04/27/2018,56,13:45,14:00,,27.81,0,27.81,27.81,-1,-57312,108288,165600,50976,0,-7646,0,0,0,,7646,-7646
17,04/27/2018,57,14:00,14:15,,24.7,0,24.7,24.7,-1,-56008,113955,169963,57947,0,-15871,0,0,0,,15871,-15871
17,04/27/2018,58,14:15,14:30,,30.7,0,30.7,30.7,-1,-56871,90479,147350,33608,0,-15227,0,0,0,,15227,-15227
17,04/27/2018,59,14:30,14:45,,27.49,0,27.49,27.49,-1,-55510,84680,140190,29170,0,-20649,0,0,0,,20649,-20649
17,04/27/2018,60,14:45,15:00,,31.41,0,31.41,31.41,-1,-62084,79060,141144,16976,0,-5432,0,0,0,,5432,-5432
17,04/27/2018,61,15:00,15:15,,36.94,0,36.94,36.94,-1,-80353,73091,153444,-7262,0,-331,0,0,0,,331,-331
17,04/27/2018,62,15:15,15:30,,36.94,0,36.94,36.94,-1,-87534,83786,171320,-3748,0,-5,0,0,0,,5,-5
17,04/27/2018,63,15:30,15:45,,30.7,0,30.7,30.7,-1,-84971,103042,188013,18071,0,-6485,0,0,0,,6485,-6485
17,04/27/2018,64,15:45,16:00,,34.7,0,34.7,34.7,-1,-105284,103950,209234,-1334,0,-3811,0,0,0,,3811,-3811
17,04/27/2018,65,16:00,16:15,,,0,37.53,37.53,0,-69913,97691,167604,27778,0,-106,0,0,0,,106,-106
17,04/27/2018,66,16:15,16:30,,37.3,0,37.3,37.3,-1,-65617,74080,139697,8463,0,-652,0,0,0,,652,-652
17,04/27/2018,67,16:30,16:45,44.04,37.3,0,44.04,44.04,1,-81419,58142,139561,-23277,0,-15,8291,0,0,,8306,8276
17,04/27/2018,68,16:45,17:00,42.79,,0,42.79,42.79,1,-76935,51160,128095,-25775,0,0,19224,0,0,,19224,19224
17,04/27/2018,69,17:00,17:15,37.76,35.27,0,38.79,35.27,2,-51194,94414,145608,43220,0,-490,7378,0,0,,7868,6888
17,04/27/2018,70,17:15,17:30,,,0,38.79,38.79,0,-38587,90211,128798,51624,0,0,0,0,0,,0,0
17,04/27/2018,71,17:30,17:45,,,0,38.79,38.79,0,-49670,83830,133500,34160,0,0,0,0,0,,0,0
17,04/27/2018,72,17:45,18:00,,,0,38.67,38.67,0,-68472,83621,152093,15149,0,0,0,0,0,,0,0
17,04/27/2018,73,18:00,18:15,,1.88,0,1.88,1.88,-1,-32063,126453,158516,94390,0,-14479,0,0,0,,14479,-14479
17,04/27/2018,74,18:15,18:30,,33.76,0,33.76,33.76,-1,-48308,80867,129175,32559,0,-17299,0,0,0,,17299,-17299
17,04/27/2018,75,18:30,18:45,,,0,38.79,38.79,0,-44311,75852,120163,31541,0,-2503,0,0,0,,2503,-2503
17,04/27/2018,76,18:45,19:00,,,0,38.79,38.79,0,-41090,72311,113401,31221,0,0,0,0,0,,0,0
17,04/27/2018,77,19:00,19:15,,,0,38.78,38.78,0,-46427,58331,104758,11904,0,0,0,0,0,,0,0
17,04/27/2018,78,19:15,19:30,,,0,38.88,38.88,0,-28861,73222,102083,44361,0,0,0,0,0,,0,0
17,04/27/2018,79,19:30,19:45,,,0,38.84,38.84,0,-23275,69029,92304,45754,0,0,0,0,0,,0,0
17,04/27/2018,80,19:45,20:00,,,0,38.84,38.84,0,-27768,65932,93700,38164,0,0,0,0,0,,0,0
17,04/27/2018,81,20:00,20:15,67.29,,0,67.29,67.29,1,-69907,36213,106120,-33694,0,0,13342,0,0,,13342,13342
17,04/27/2018,82,20:15,20:30,42.13,,0,42.13,42.13,1,-62582,41843,104425,-20739,0,0,19164,0,0,,19164,19164
17,04/27/2018,83,20:30,20:45,41.76,,0,41.76,41.76,1,-59174,56768,115942,-2406,0,0,13558,0,0,,13558,13558
17,04/27/2018,84,20:45,21:00,,,0,38.67,38.67,0,-62968,51587,114555,-11381,0,0,690,0,0,,690,690
17,04/27/2018,85,21:00,21:15,,,0,39,39,0,-51478,120507,171985,69029,0,0,0,0,0,,0,0
17,04/27/2018,86,21:15,21:30,60.7,,0,60.7,60.7,1,-88851,67880,156731,-20971,0,0,3079,0,0,,3079,3079
17,04/27/2018,87,21:30,21:45,80.14,,0,80.14,80.14,1,-121514,85555,207069,-35959,0,0,32266,0,0,,32266,32266
17,04/27/2018,88,21:45,22:00,39.42,35.61,0,39.42,35.61,2,-72315,71801,144116,-514,0,-501,9045,0,0,,9546,8544
17,04/27/2018,89,22:00,22:15,,28.87,0,28.87,28.87,-1,-51929,103076,155005,51147,0,-672,0,0,0,,672,-672
17,04/27/2018,90,22:15,22:30,,29.76,0,29.76,29.76,-1,-41913,72893,114806,30980,0,-1050,0,0,0,,1050,-1050
17,04/27/2018,91,22:30,22:45,,30.1,0,30.1,30.1,-1,-32848,79566,112414,46718,0,-2340,0,0,0,,2340,-2340
17,04/27/2018,92,22:45,23:00,,11.76,0,11.76,11.76,-1,-24224,87038,111262,62814,0,-7068,0,0,0,,7068,-7068
17,04/27/2018,93,23:00,23:15,106.49,33.76,0,106.49,33.76,2,-79468,35580,115048,-43888,0,-3054,12166,0,0,,15220,9112
17,04/27/2018,94,23:15,23:30,42.09,,0,42.09,42.09,1,-47374,42064,89438,-5310,0,0,11384,0,0,,11384,11384
17,04/27/2018,95,23:30,23:45,42.09,25.63,0,25.63,25.63,-1,-31888,58066,89954,26178,0,-2212,318,0,0,,2530,-1894
17,04/27/2018,96,23:45,0:00,,11.03,0,11.03,11.03,-1,-31542,85226,116768,53684,0,-33701,0,0,0,,33701,-33701
18,04/28/2018,1,0:00,0:15,,-150.78,0,-150.78,-150.78,-1,-62308,137668,199976,75360,0,-47548,0,0,0,,47548,-47548
18,04/28/2018,2,0:15,0:30,,31.78,0,31.78,31.78,-1,-81582,99407,180989,17825,0,-11061,0,0,0,,11061,-11061
18,04/28/2018,3,0:30,0:45,,21.55,0,21.55,21.55,-1,-77905,107798,185703,29893,0,-5233,0,0,0,,5233,-5233
18,04/28/2018,4,0:45,1:00,,-48.78,0,-48.78,-48.78,-1,-48287,97293,145580,49006,0,-38597,0,0,0,,38597,-38597
18,04/28/2018,5,1:00,1:15,,23.29,0,23.29,23.29,-1,-81409,118485,199894,37076,0,-21713,0,0,0,,21713,-21713
18,04/28/2018,6,1:15,1:30,,33.29,0,33.29,33.29,-1,-68381,100448,168829,32067,0,-3614,0,0,0,,3614,-3614
18,04/28/2018,7,1:30,1:45,,20.28,0,20.28,20.28,-1,-52329,99365,151694,47036,0,-10472,0,0,0,,10472,-10472
18,04/28/2018,8,1:45,2:00,,11.29,0,11.29,11.29,-1,-49932,98226,148158,48294,0,-29182,0,0,0,,29182,-29182
18,04/28/2018,9,2:00,2:15,58.92,32.36,0,58.92,32.36,2,-74339,51929,126268,-22410,0,-11318,4545,0,0,,15863,-6773
18,04/28/2018,10,2:15,2:30,41.29,,0,41.29,41.29,1,-96011,73668,169679,-22343,0,0,13684,0,0,,13684,13684
18,04/28/2018,11,2:30,2:45,41.29,,0,41.29,41.29,1,-94201,77836,172037,-16365,0,0,16483,0,0,,16483,16483
18,04/28/2018,12,2:45,3:00,37.29,,0,37.29,37.29,1,-85605,71401,157006,-14204,0,0,8743,0,0,,8743,8743
18,04/28/2018,13,3:00,3:15,42.12,,0,42.12,42.12,1,-75302,62840,138142,-12462,0,0,8422,0,0,,8422,8422
18,04/28/2018,14,3:15,3:30,,,0,35.4,35.4,0,-65672,70770,136442,5098,0,0,1248,0,0,,1248,1248
18,04/28/2018,15,3:30,3:45,,,0,35.42,35.42,0,-60151,71448,131599,11297,0,0,0,0,0,,0,0
18,04/28/2018,16,3:45,4:00,,,0,35.43,35.43,0,-59398,74433,133831,15035,0,0,0,0,0,,0,0
18,04/28/2018,17,4:00,4:15,,,0,35.4,35.4,0,-54473,78450,132923,23977,0,0,0,0,0,,0,0
18,04/28/2018,18,4:15,4:30,34.31,,0,34.31,34.31,1,-60238,66689,126927,6451,0,0,357,0,0,,357,357
18,04/28/2018,19,4:30,4:45,34.35,,0,34.35,34.35,1,-56891,56949,113840,58,0,0,900,0,0,,900,900
18,04/28/2018,20,4:45,5:00,34.48,,0,34.48,34.48,1,-40243,51869,92112,11626,0,0,450,0,0,,450,450
18,04/28/2018,21,5:00,5:15,,33.78,0,33.78,33.78,-1,-32668,69784,102452,37116,0,-620,0,0,0,,620,-620
18,04/28/2018,22,5:15,5:30,,33.78,0,33.78,33.78,-1,-31541,55498,87039,23957,0,-4157,0,0,0,,4157,-4157
18,04/28/2018,23,5:30,5:45,,33.78,0,33.78,33.78,-1,-32938,52068,85006,19130,0,-3079,0,0,0,,3079,-3079
18,04/28/2018,24,5:45,6:00,,36.39,0,36.39,36.39,-1,-31203,66002,97205,34799,0,-1147,0,0,0,,1147,-1147
18,04/28/2018,25,6:00,6:15,,32.78,0,32.78,32.78,-1,-30822,91890,122712,61068,0,-1754,0,0,0,,1754,-1754
18,04/28/2018,26,6:15,6:30,,21.93,0,21.93,21.93,-1,-22089,89539,111628,67450,0,-11924,0,0,0,,11924,-11924
18,04/28/2018,27,6:30,6:45,,33.59,0,33.59,33.59,-1,-36783,70011,106794,33228,0,-2913,0,0,0,,2913,-2913
18,04/28/2018,28,6:45,7:00,,36.65,0,36.65,36.65,-1,-34311,76840,111151,42529,0,-1566,0,0,0,,1566,-1566
18,04/28/2018,29,7:00,7:15,,30.25,0,30.25,30.25,-1,-49014,104065,153079,55051,0,-8718,0,0,0,,8718,-8718
18,04/28/2018,30,7:15,7:30,,,0,35.86,35.86,0,-54000,63210,117210,9210,0,-1906,0,0,0,,1906,-1906
18,04/28/2018,31,7:30,7:45,,,0,35.76,35.76,0,-53900,53777,107677,-123,0,0,0,0,0,,0,0
18,04/28/2018,32,7:45,8:00,65.03,,0,65.03,65.03,1,-71794,38736,110530,-33058,0,0,14915,0,0,,14915,14915
18,04/28/2018,33,8:00,8:15,40.63,25.68,0,40.63,25.68,2,-39312,99223,138535,59911,0,-1510,7142,0,0,,8652,5632
18,04/28/2018,34,8:15,8:30,,33.59,0,33.59,33.59,-1,-50657,94051,144708,43394,0,-1415,0,0,0,,1415,-1415
18,04/28/2018,35,8:30,8:45,,,0,35.92,35.92,0,-57969,89783,147752,31814,0,0,0,0,0,,0,0
18,04/28/2018,36,8:45,9:00,41.59,,0,41.59,41.59,1,-71328,62566,133894,-8762,0,0,738,0,0,,738,738
18,04/28/2018,37,9:00,9:15,,,0,35.88,35.88,0,-55764,96103,151867,40339,0,0,54,0,0,,54,54
18,04/28/2018,38,9:15,9:30,,,0,35.84,35.84,0,-63423,91654,155077,28231,0,0,0,0,0,,0,0
18,04/28/2018,39,9:30,9:45,,,0,35.93,35.93,0,-59452,97421,156873,37969,0,0,0,0,0,,0,0
18,04/28/2018,40,9:45,10:00,,35.75,0,35.75,35.75,-1,-60450,96356,156806,35906,0,-745,0,0,0,,745,-745
18,04/28/2018,41,10:00,10:15,,37.45,0,37.45,37.45,-1,-61474,86586,148060,25112,0,-1971,0,0,0,,1971,-1971
18,04/28/2018,42,10:15,10:30,,37.29,0,37.29,37.29,-1,-65796,87294,153090,21498,0,-361,0,0,0,,361,-361
18,04/28/2018,43,10:30,10:45,,37.18,0,37.18,37.18,-1,-59619,99781,159400,40162,0,-787,0,0,0,,787,-787
18,04/28/2018,44,10:45,11:00,,32.76,0,32.76,32.76,-1,-61917,94731,156648,32814,0,-2291,0,0,0,,2291,-2291
18,04/28/2018,45,11:00,11:15,86.16,32.76,0,86.16,86.16,1,-149153,104611,253764,-44542,0,-459,13891,0,0,,14350,13432
18,04/28/2018,46,11:15,11:30,49.66,,0,49.66,49.66,1,-155596,117625,273221,-37971,0,0,30988,0,0,,30988,30988
18,04/28/2018,47,11:30,11:45,49.66,35.01,0,35.01,35.01,-1,-137998,129940,267938,-8058,0,-427,6482,0,0,,6909,6055
18,04/28/2018,48,11:45,12:00,,,0,35.51,35.51,0,-125793,132539,258332,6746,0,0,0,0,0,,0,0
18,04/28/2018,49,12:00,12:15,,,0,35.56,35.56,0,-122370,141478,263848,19108,0,0,0,0,0,,0,0
18,04/28/2018,50,12:15,12:30,,,0,35.56,35.56,0,-124879,127150,252029,2271,0,0,0,0,0,,0,0
18,04/28/2018,51,12:30,12:45,37.59,,0,37.59,37.59,1,-116280,111264,227544,-5016,0,0,118,0,0,,118,118
18,04/28/2018,52,12:45,13:00,37.59,,0,37.59,37.59,1,-117887,107581,225468,-10306,0,0,1387,0,0,,1387,1387
18,04/28/2018,53,13:00,13:15,39.76,,0,39.76,39.76,1,-131659,124911,256570,-6748,0,0,2784,0,0,,2784,2784
18,04/28/2018,54,13:15,13:30,37.59,35.12,0,37.59,35.12,2,-112967,110734,223701,-2233,0,-24,1752,0,0,,1776,1728
18,04/28/2018,55,13:30,13:45,,29.59,0,29.59,29.59,-1,-123939,161356,285295,37417,0,-2187,0,0,0,,2187,-2187
18,04/28/2018,56,13:45,14:00,,32.76,0,32.76,32.76,-1,-120699,173274,293973,52575,0,-2463,0,0,0,,2463,-2463
18,04/28/2018,57,14:00,14:15,41.59,33.59,0,41.59,33.59,2,-96719,103412,200131,6693,0,-1519,205,0,0,,1724,-1314
18,04/28/2018,58,14:15,14:30,41.59,,0,41.59,41.59,1,-119862,106945,226807,-12917,0,0,3839,0,0,,3839,3839
18,04/28/2018,59,14:30,14:45,,,0,35.55,35.55,0,-108291,107356,215647,-935,0,0,318,0,0,,318,318
18,04/28/2018,60,14:45,15:00,37.59,,0,37.59,37.59,1,-115188,104287,219475,-10901,0,0,384,0,0,,384,384
18,04/28/2018,61,15:00,15:15,,,0,35.56,35.56,0,-108351,124102,232453,15751,0,0,0,0,0,,0,0
18,04/28/2018,62,15:15,15:30,34.63,,0,34.63,34.63,1,-96335,94897,191232,-1438,0,0,5,0,0,,5,5
18,04/28/2018,63,15:30,15:45,36.64,,0,36.64,36.64,1,-91726,96499,188225,4773,0,0,742,0,0,,742,742
18,04/28/2018,64,15:45,16:00,36.64,,0,36.64,36.64,1,-98555,118612,217167,20057,0,0,1012,0,0,,1012,1012
18,04/28/2018,65,16:00,16:15,36.64,25.66,0,25.66,25.66,-1,-41573,112077,153650,70504,0,-3754,27,0,0,,3781,-3727
18,04/28/2018,66,16:15,16:30,,30.79,0,30.79,30.79,-1,-47668,86283,133951,38615,0,-10760,0,0,0,,10760,-10760
18,04/28/2018,67,16:30,16:45,,36.72,0,36.72,36.72,-1,-53085,85513,138598,32428,0,-1387,0,0,0,,1387,-1387
18,04/28/2018,68,16:45,17:00,,30.79,0,30.79,30.79,-1,-62474,125536,188010,63062,0,-3223,0,0,0,,3223,-3223
18,04/28/2018,69,17:00,17:15,,37.65,0,37.65,37.65,-1,-58166,76345,134511,18179,0,-1218,0,0,0,,1218,-1218
18,04/28/2018,70,17:15,17:30,41,37.66,0,41,35.89,2,-46442,51863,98305,5421,0,-878,54,0,0,,932,-824
18,04/28/2018,71,17:30,17:45,57.94,,0,57.94,57.94,1,-85724,61388,147112,-24336,0,0,15300,0,0,,15300,15300
18,04/28/2018,72,17:45,18:00,48.77,,0,48.77,48.77,1,-103076,75168,178244,-27908,0,0,19259,0,0,,19259,19259
18,04/28/2018,73,18:00,18:15,40.65,36.23,0,36.23,36.23,-1,-71287,80140,151427,8853,0,-247,10770,0,0,,11017,10523
18,04/28/2018,74,18:15,18:30,46.2,36.23,0,46.2,46.2,1,-89465,78181,167646,-11284,0,-143,1320,0,0,,1463,1177
18,04/28/2018,75,18:30,18:45,46.28,,0,46.28,46.28,1,-89676,56685,146361,-32991,0,0,3622,0,0,,3622,3622
18,04/28/2018,76,18:45,19:00,60.77,,0,60.77,60.77,1,-97335,63394,160729,-33941,0,0,15925,0,0,,15925,15925
18,04/28/2018,77,19:00,19:15,42.77,37.52,0,37.52,37.52,-1,-63960,64670,128630,710,0,-111,11181,0,0,,11292,11070
18,04/28/2018,78,19:15,19:30,42.77,35.96,0,35.96,35.96,-1,-63101,55555,118656,-7546,0,-902,61,0,0,,963,-841
18,04/28/2018,79,19:30,19:45,,37.56,0,37.56,37.56,-1,-54681,66043,120724,11362,0,-151,0,0,0,,151,-151
18,04/28/2018,80,19:45,20:00,,37.64,0,37.64,37.64,-1,-54759,55728,110487,969,0,-2158,0,0,0,,2158,-2158
18,04/28/2018,81,20:00,20:15,,36.41,0,36.41,36.41,-1,-41828,48287,90115,6459,0,-463,0,0,0,,463,-463
18,04/28/2018,82,20:15,20:30,,36.67,0,36.67,36.67,-1,-37752,40805,78557,3053,0,-601,0,0,0,,601,-601
18,04/28/2018,83,20:30,20:45,,36.27,0,36.27,36.27,-1,-27835,36082,63917,8247,0,-934,0,0,0,,934,-934
18,04/28/2018,84,20:45,21:00,,35.78,0,35.78,35.78,-1,-31847,32874,64721,1027,0,-854,0,0,0,,854,-854
18,04/28/2018,85,21:00,21:15,,35.99,0,35.99,35.99,-1,-21529,89086,110615,67557,0,-971,0,0,0,,971,-971
18,04/28/2018,86,21:15,21:30,,36.78,0,36.78,36.78,-1,-42956,52516,95472,9560,0,-1743,0,0,0,,1743,-1743
18,04/28/2018,87,21:30,21:45,,37.58,0,37.58,37.58,-1,-39849,59304,99153,19455,0,-98,0,0,0,,98,-98
18,04/28/2018,88,21:45,22:00,,21.64,0,21.64,21.64,-1,-36359,64425,100784,28066,0,-11673,0,0,0,,11673,-11673
18,04/28/2018,89,22:00,22:15,42.77,26.37,0,42.77,26.37,2,-62529,64108,126637,1579,0,-21391,77,0,0,,21468,-21314
18,04/28/2018,90,22:15,22:30,66.4,26.37,0,66.4,66.4,1,-58019,29154,87173,-28865,0,-2168,13474,0,0,,15642,11306
18,04/28/2018,91,22:30,22:45,66.4,34.77,0,34.77,34.77,-1,-27981,50196,78177,22215,0,-1109,1308,0,0,,2417,199
18,04/28/2018,92,22:45,23:00,,24.27,0,24.27,24.27,-1,-21626,66997,88623,45371,0,-11587,0,0,0,,11587,-11587
18,04/28/2018,93,23:00,23:15,34.62,15.02,0,34.62,34.62,1,-54565,23103,77668,-31462,0,-13702,112,0,0,,13814,-13590
18,04/28/2018,94,23:15,23:30,38.77,15.02,0,38.77,38.77,1,-47088,22330,69418,-24758,0,-32,1259,0,0,,1291,1227
18,04/28/2018,95,23:30,23:45,,23.59,0,23.59,23.59,-1,-33930,54913,88843,20983,0,-5464,0,0,0,,5464,-5464
18,04/28/2018,96,23:45,0:00,,23.59,0,23.59,23.59,-1,-39238,66787,106025,27549,0,-23289,0,0,0,,23289,-23289
18,04/29/2018,1,0:00,0:15,39.69,31.03,0,39.69,39.69,1,-31502,37113,68615,5611,0,-11178,121,0,0,,11299,-11057
18,04/29/2018,2,0:15,0:30,39.69,29.59,0,29.59,29.59,-1,-25608,44767,70375,19159,0,-829,16,0,0,,845,-813
18,04/29/2018,3,0:30,0:45,,23.59,0,23.59,23.59,-1,-22414,71000,93414,48586,0,-18406,0,0,0,,18406,-18406
18,04/29/2018,4,0:45,1:00,,-24.03,0,-24.03,-24.03,-1,-22729,107770,130499,85041,0,-55410,0,0,0,,55410,-55410
18,04/29/2018,5,1:00,1:15,,14.76,0,14.76,14.76,-1,-25658,67048,92706,41390,0,-27982,0,0,0,,27982,-27982
18,04/29/2018,6,1:15,1:30,,,0,35.61,35.61,0,-19902,57502,77404,37600,0,0,0,0,0,,0,0
18,04/29/2018,7,1:30,1:45,,,0,35.67,35.67,0,-14764,73039,87803,58275,0,0,0,0,0,,0,0
18,04/29/2018,8,1:45,2:00,,21.18,0,21.18,21.18,-1,-14733,103487,118220,88754,0,-4881,0,0,0,,4881,-4881
18,04/29/2018,9,2:00,2:15,,10.39,0,10.39,10.39,-1,-25026,59983,85009,34957,0,-10637,0,0,0,,10637,-10637
18,04/29/2018,10,2:15,2:30,,37.2,0,37.2,37.2,-1,-24008,60827,84835,36819,0,-2,0,0,0,,2,-2
18,04/29/2018,11,2:30,2:45,,35,0,35,35,-1,-23615,70230,93845,46615,0,-98,0,0,0,,98,-98
18,04/29/2018,12,2:45,3:00,,11.59,0,11.59,11.59,-1,-21172,83324,104496,62152,0,-11288,0,0,0,,11288,-11288
18,04/29/2018,13,3:00,3:15,,32.18,0,32.18,32.18,-1,-22980,64306,87286,41326,0,-10076,0,0,0,,10076,-10076
18,04/29/2018,14,3:15,3:30,,23.19,0,23.19,23.19,-1,-20884,79508,100392,58624,0,-6807,0,0,0,,6807,-6807
18,04/29/2018,15,3:30,3:45,,32.39,0,32.39,32.39,-1,-20455,80500,100955,60045,0,-2745,0,0,0,,2745,-2745
18,04/29/2018,16,3:45,4:00,,-150.03,0,-150.03,-150.03,-1,-21373,98056,119429,76683,0,-35316,0,0,0,,35316,-35316
18,04/29/2018,17,4:00,4:15,,25.24,0,25.24,25.24,-1,-27755,55640,83395,27885,0,-22352,0,0,0,,22352,-22352
18,04/29/2018,18,4:15,4:30,,33.59,0,33.59,33.59,-1,-32239,59892,92131,27653,0,-3964,0,0,0,,3964,-3964
18,04/29/2018,19,4:30,4:45,,27.03,0,27.03,27.03,-1,-28245,54114,82359,25869,0,-8532,0,0,0,,8532,-8532
18,04/29/2018,20,4:45,5:00,,37.21,0,37.21,37.21,-1,-23678,51085,74763,27407,0,-1183,0,0,0,,1183,-1183
18,04/29/2018,21,5:00,5:15,,35.08,0,35.08,35.08,-1,-38613,72857,111470,34244,0,-1818,0,0,0,,1818,-1818
18,04/29/2018,22,5:15,5:30,,,0,35.59,35.59,0,-44117,58378,102495,14261,0,-56,0,0,0,,56,-56
18,04/29/2018,23,5:30,5:45,,,0,35.58,35.58,0,-44236,67326,111562,23090,0,0,0,0,0,,0,0
18,04/29/2018,24,5:45,6:00,,17.24,0,17.24,17.24,-1,-38711,87175,125886,48464,0,-4299,0,0,0,,4299,-4299
18,04/29/2018,25,6:00,6:15,,33.8,0,33.8,33.8,-1,-46259,79232,125491,32973,0,-4099,0,0,0,,4099,-4099
18,04/29/2018,26,6:15,6:30,,9.83,0,9.83,9.83,-1,-37478,84221,121699,46743,0,-15032,0,0,0,,15032,-15032
18,04/29/2018,27,6:30,6:45,,-0.03,0,-0.03,-0.03,-1,-42434,99128,141562,56694,0,-58245,0,0,0,,58245,-58245
18,04/29/2018,28,6:45,7:00,,23.8,0,23.8,23.8,-1,-41082,68025,109107,26943,0,-30416,0,0,0,,30416,-30416
18,04/29/2018,29,7:00,7:15,,36.61,0,36.61,36.61,-1,-50935,54993,105928,4058,0,-5774,0,0,0,,5774,-5774
18,04/29/2018,30,7:15,7:30,40.35,36.61,0,40.35,40.35,1,-51256,46592,97848,-4664,0,-106,996,0,0,,1102,890
18,04/29/2018,31,7:30,7:45,,31.93,0,31.93,31.93,-1,-31876,45482,77358,13606,0,-2576,0,0,0,,2576,-2576
18,04/29/2018,32,7:45,8:00,,33.8,0,33.8,33.8,-1,-33917,64749,98666,30832,0,-4568,0,0,0,,4568,-4568
18,04/29/2018,33,8:00,8:15,,33.12,0,33.12,33.12,-1,-26186,71059,97245,44873,0,-8771,0,0,0,,8771,-8771
18,04/29/2018,34,8:15,8:30,,37.31,0,37.31,37.31,-1,-24570,65161,89731,40591,0,-2372,0,0,0,,2372,-2372
18,04/29/2018,35,8:30,8:45,,,0,35.76,35.76,0,-30191,54637,84828,24446,0,0,0,0,0,,0,0
18,04/29/2018,36,8:45,9:00,,36.86,0,36.86,36.86,-1,-38572,56004,94576,17432,0,-201,0,0,0,,201,-201
18,04/29/2018,37,9:00,9:15,,33.8,0,33.8,33.8,-1,-19007,134752,153759,115745,0,-743,0,0,0,,743,-743
18,04/29/2018,38,9:15,9:30,,,0,35.48,35.48,0,-24299,107935,132234,83636,0,0,0,0,0,,0,0
18,04/29/2018,39,9:30,9:45,,32.57,0,32.57,32.57,-1,-36205,80247,116452,44042,0,-1255,0,0,0,,1255,-1255
18,04/29/2018,40,9:45,10:00,,31.14,0,31.14,31.14,-1,-48874,59966,108840,11092,0,-3336,0,0,0,,3336,-3336
18,04/29/2018,41,10:00,10:15,,37.29,0,37.29,37.29,-1,-42032,77361,119393,35329,0,-455,0,0,0,,455,-455
18,04/29/2018,42,10:15,10:30,34.07,37.26,0,35.67,35.67,2,-48996,47216,96212,-1780,0,-422,1,0,0,,423,-421
18,04/29/2018,43,10:30,10:45,57.24,,0,57.24,57.24,1,-65459,33728,99187,-31731,0,0,16015,0,0,,16015,16015
18,04/29/2018,44,10:45,11:00,47.95,,0,47.95,47.95,1,-69848,31216,101064,-38632,0,0,31437,0,0,,31437,31437
18,04/29/2018,45,11:00,11:15,57.02,,0,57.02,57.02,1,-76992,30405,107397,-46587,0,0,38063,0,0,,38063,38063
18,04/29/2018,46,11:15,11:30,58.06,,0,58.06,58.06,1,-80659,28181,108840,-52478,0,0,43039,0,0,,43039,43039
18,04/29/2018,47,11:30,11:45,59.8,,0,59.8,59.8,1,-88727,25961,114688,-62766,0,0,51225,0,0,,51225,51225
18,04/29/2018,48,11:45,12:00,51.65,,0,51.65,51.65,1,-94784,50083,144867,-44701,0,0,51905,0,0,,51905,51905
18,04/29/2018,49,12:00,12:15,58.45,,0,58.45,58.45,1,-103232,57975,161207,-45257,0,0,37457,0,0,,37457,37457
18,04/29/2018,50,12:15,12:30,62.21,,0,62.21,62.21,1,-114290,65960,180250,-48330,0,0,46486,0,0,,46486,46486
18,04/29/2018,51,12:30,12:45,47.8,,0,47.8,47.8,1,-102656,59980,162636,-42676,0,0,38117,0,0,,38117,38117
18,04/29/2018,52,12:45,13:00,93.06,,0,93.06,93.06,1,-106943,48895,155838,-58048,0,0,41987,0,0,,41987,41987
18,04/29/2018,53,13:00,13:15,59.8,,0,59.8,59.8,1,-87337,39311,126648,-48026,0,0,45728,0,0,,45728,45728
18,04/29/2018,54,13:15,13:30,47.8,,0,47.8,47.8,1,-90600,53837,144437,-36763,0,0,35412,0,0,,35412,35412
18,04/29/2018,55,13:30,13:45,40.34,34.03,0,34.03,34.03,-1,-59802,67072,126874,7270,0,-696,15874,0,0,,16570,15178
18,04/29/2018,56,13:45,14:00,40.34,24.81,0,24.81,24.81,-1,-52596,96407,149003,43811,0,-3013,170,0,0,,3183,-2843
18,04/29/2018,57,14:00,14:15,62.35,33.8,0,62.35,33.8,2,-74194,44680,118874,-29514,0,-1802,9422,0,0,,11224,7620
18,04/29/2018,58,14:15,14:30,37.5,35.74,0,35.74,35.74,-1,-50465,60266,110731,9801,0,-6,3909,0,0,,3915,3903
18,04/29/2018,59,14:30,14:45,,33.69,0,33.69,33.69,-1,-35823,94027,129850,58204,0,-599,0,0,0,,599,-599
18,04/29/2018,60,14:45,15:00,,22.85,0,22.85,22.85,-1,-31663,105995,137658,74332,0,-11145,0,0,0,,11145,-11145
18,04/29/2018,61,15:00,15:15,46.12,22.85,0,46.12,46.12,1,-78280,55481,133761,-22799,0,-435,5309,0,0,,5744,4874
18,04/29/2018,62,15:15,15:30,36.02,,0,36.02,36.02,1,-69454,59723,129177,-9731,0,0,5006,0,0,,5006,5006
18,04/29/2018,63,15:30,15:45,38.35,,0,38.35,38.35,1,-74678,68229,142907,-6449,0,0,5768,0,0,,5768,5768
18,04/29/2018,64,15:45,16:00,34.04,,0,34.04,34.04,1,-53146,71913,125059,18767,0,0,1647,0,0,,1647,1647
18,04/29/2018,65,16:00,16:15,71.15,,0,71.15,71.15,1,-125241,67605,192846,-57636,0,0,19896,0,0,,19896,19896
18,04/29/2018,66,16:15,16:30,42.15,,0,42.15,42.15,1,-113482,79634,193116,-33848,0,0,27451,0,0,,27451,27451
18,04/29/2018,67,16:30,16:45,47.8,,0,47.8,47.8,1,-123073,82682,205755,-40391,0,0,27175,0,0,,27175,27175
18,04/29/2018,68,16:45,17:00,46.05,,0,46.05,46.05,1,-122708,83750,206458,-38958,0,0,33811,0,0,,33811,33811
18,04/29/2018,69,17:00,17:15,46.05,29.8,0,29.8,29.8,-1,-63888,89409,153297,25521,0,-2645,8197,0,0,,10842,5552
18,04/29/2018,70,17:15,17:30,,33.8,0,33.8,33.8,-1,-81412,92401,173813,10989,0,-1026,0,0,0,,1026,-1026
18,04/29/2018,71,17:30,17:45,37.8,33.44,0,37.8,33.44,2,-95588,98172,193760,2584,0,-1335,377,0,0,,1712,-958
18,04/29/2018,72,17:45,18:00,37.8,33.44,0,37.8,37.8,1,-110615,110905,221520,290,0,-3,334,0,0,,337,331
18,04/29/2018,73,18:00,18:15,45.15,,0,45.15,45.15,1,-96473,83654,180127,-12819,0,0,3925,0,0,,3925,3925
18,04/29/2018,74,18:15,18:30,34.88,,0,34.88,34.88,1,-77026,89287,166313,12261,0,0,632,0,0,,632,632
18,04/29/2018,75,18:30,18:45,,,0,34.38,34.38,0,-66484,99907,166391,33423,0,0,0,0,0,,0,0
18,04/29/2018,76,18:45,19:00,,,0,34.34,34.34,0,-50438,123014,173452,72576,0,0,0,0,0,,0,0
18,04/29/2018,77,19:00,19:15,,33.13,0,33.13,33.13,-1,-69035,98104,167139,29069,0,-102,0,0,0,,102,-102
18,04/29/2018,78,19:15,19:30,,27.53,0,27.53,27.53,-1,-41360,94932,136292,53572,0,-7096,0,0,0,,7096,-7096
18,04/29/2018,79,19:30,19:45,,-14.25,0,-14.25,-14.25,-1,-31428,118258,149686,86830,0,-7096,0,0,0,,7096,-7096
18,04/29/2018,80,19:45,20:00,,-46.85,0,-46.85,-46.85,-1,-49292,85058,134350,35766,0,-24714,0,0,0,,24714,-24714
18,04/29/2018,81,20:00,20:15,,-55.85,0,-55.85,-55.85,-1,-34018,131719,165737,97701,0,-15838,0,0,0,,15838,-15838
18,04/29/2018,82,20:15,20:30,,-80.85,0,-80.85,-80.85,-1,-43826,59225,103051,15399,0,-29798,0,0,0,,29798,-29798
18,04/29/2018,83,20:30,20:45,,-23.23,0,-23.23,-23.23,-1,-27784,67590,95374,39806,0,-19864,0,0,0,,19864,-19864
18,04/29/2018,84,20:45,21:00,,-42.85,0,-42.85,-42.85,-1,-44217,71351,115568,27134,0,-33493,0,0,0,,33493,-33493
18,04/29/2018,85,21:00,21:15,99.4,23.8,0,99.4,23.8,2,-72605,72316,144921,-289,0,-7733,5456,0,0,,13189,-2277
18,04/29/2018,86,21:15,21:30,43.35,-21.07,0,43.35,-21.07,2,-68705,69777,138482,1072,0,-17744,360,0,0,,18104,-17384
18,04/29/2018,87,21:30,21:45,43.35,-80.85,0,-80.85,-80.85,-1,-51874,111849,163723,59975,0,-26292,115,0,0,,26407,-26177
18,04/29/2018,88,21:45,22:00,,-21.53,0,-21.53,-21.53,-1,-66948,113692,180640,46744,0,-47724,0,0,0,,47724,-47724
18,04/29/2018,89,22:00,22:15,,29.8,0,29.8,29.8,-1,-72526,87476,160002,14950,0,-14644,0,0,0,,14644,-14644
18,04/29/2018,90,22:15,22:30,,11.8,0,11.8,11.8,-1,-81425,110799,192224,29374,0,-16840,0,0,0,,16840,-16840
18,04/29/2018,91,22:30,22:45,,-39.2,0,-39.2,-39.2,-1,-73091,108661,181752,35570,0,-36813,0,0,0,,36813,-36813
18,04/29/2018,92,22:45,23:00,,-80.85,0,-80.85,-80.85,-1,-49475,126275,175750,76800,0,-30161,0,0,0,,30161,-30161
18,04/29/2018,93,23:00,23:15,,10.85,0,10.85,10.85,-1,-43443,93099,136542,49656,0,-29887,0,0,0,,29887,-29887
18,04/29/2018,94,23:15,23:30,,-1.85,0,-1.85,-1.85,-1,-33260,69167,102427,35907,0,-47641,0,0,0,,47641,-47641
18,04/29/2018,95,23:30,23:45,,-7.62,0,-7.62,-7.62,-1,-30026,96196,126222,66170,0,-35910,0,0,0,,35910,-35910
18,04/29/2018,96,23:45,0:00,,-7.62,0,-7.62,-7.62,-1,-59176,96548,155724,37372,0,-31919,0,0,0,,31919,-31919
18,04/30/2018,1,0:00,0:15,35.8,-26.97,0,35.8,-26.97,2,-85155,109711,194866,24556,0,-27555,53,0,0,,27608,-27502
18,04/30/2018,2,0:15,0:30,35.5,-21.06,0,35.5,-21.06,2,-67040,130173,197213,63133,0,-12943,70,0,0,,13013,-12873
18,04/30/2018,3,0:30,0:45,,-150.78,0,-150.78,-150.78,-1,-72588,101193,173781,28605,0,-35649,0,0,0,,35649,-35649
18,04/30/2018,4,0:45,1:00,,-150.78,0,-150.78,-150.78,-1,-45204,131093,176297,85889,0,-53988,0,0,0,,53988,-53988
18,04/30/2018,5,1:00,1:15,,24.08,0,24.08,24.08,-1,-101258,132236,233494,30978,0,-43020,0,0,0,,43020,-43020
18,04/30/2018,6,1:15,1:30,,29.8,0,29.8,29.8,-1,-86427,149133,235560,62706,0,-23851,0,0,0,,23851,-23851
18,04/30/2018,7,1:30,1:45,,,0,35.45,35.45,0,-94099,144722,238821,50623,0,-4563,0,0,0,,4563,-4563
18,04/30/2018,8,1:45,2:00,,-12.93,0,-12.93,-12.93,-1,-90513,152919,243432,62406,0,-9071,0,0,0,,9071,-9071
18,04/30/2018,9,2:00,2:15,,-11.78,0,-11.78,-11.78,-1,-72692,153866,226558,81174,0,-15165,0,0,0,,15165,-15165
18,04/30/2018,10,2:15,2:30,,,0,35.18,35.18,0,-79388,151865,231253,72477,0,0,0,0,0,,0,0
18,04/30/2018,11,2:30,2:45,,,0,35.18,35.18,0,-82499,111117,193616,28618,0,0,0,0,0,,0,0
18,04/30/2018,12,2:45,3:00,37.8,,0,37.8,37.8,1,-91557,66314,157871,-25243,0,0,1672,0,0,,1672,1672
18,04/30/2018,13,3:00,3:15,,,0,35.05,35.05,0,-62792,92719,155511,29927,0,0,153,0,0,,153,153
18,04/30/2018,14,3:15,3:30,48.91,,0,48.91,48.91,1,-98776,72536,171312,-26240,0,0,5238,0,0,,5238,5238
18,04/30/2018,15,3:30,3:45,60.91,,0,60.91,60.91,1,-125993,74375,200368,-51618,0,0,42727,0,0,,42727,42727
18,04/30/2018,16,3:45,4:00,42.17,35.86,0,35.86,35.86,-1,-95297,95778,191075,481,0,-97,25120,0,0,,25217,25023
18,04/30/2018,17,4:00,4:15,42.17,30.47,0,30.47,30.47,-1,-45602,123150,168752,77548,0,-930,1164,0,0,,2094,234
18,04/30/2018,18,4:15,4:30,,,0,35.07,35.07,0,-67059,80960,148019,13901,0,0,0,0,0,,0,0
18,04/30/2018,19,4:30,4:45,34.34,,0,34.34,34.34,1,-84258,69574,153832,-14684,0,0,45,0,0,,45,45
18,04/30/2018,20,4:45,5:00,42.17,,0,42.17,42.17,1,-99112,72211,171323,-26901,0,0,7172,0,0,,7172,7172
18,04/30/2018,21,5:00,5:15,,,0,35.95,35.95,0,-65653,114263,179916,48610,0,0,439,0,0,,439,439
18,04/30/2018,22,5:15,5:30,,,0,35.41,35.41,0,-91196,125869,217065,34673,0,0,0,0,0,,0,0
18,04/30/2018,23,5:30,5:45,54.45,,0,54.45,54.45,1,-118659,73409,192068,-45250,0,0,12832,0,0,,12832,12832
18,04/30/2018,24,5:45,6:00,84.91,,0,84.91,84.91,1,-151468,79906,231374,-71562,0,0,58608,0,0,,58608,58608
18,04/30/2018,25,6:00,6:15,42.25,37.76,0,42.25,35.95,2,-59402,67492,126894,8090,0,-12,26653,0,0,,26665,26641
18,04/30/2018,26,6:15,6:30,42.25,28.78,0,28.78,28.78,-1,-81481,86795,168276,5314,0,-7461,2601,0,0,,10062,-4860
18,04/30/2018,27,6:30,6:45,145.12,37.76,0,145.12,145.12,1,-152229,60910,213139,-91319,0,-1446,24350,0,0,,25796,22904
18,04/30/2018,28,6:45,7:00,145.12,,0,145.12,145.12,1,-185307,88776,274083,-96531,0,0,103098,0,0,,103098,103098
18,04/30/2018,29,7:00,7:15,145.12,33.8,0,33.8,33.8,-1,-101007,100353,201360,-654,0,-643,16070,0,0,,16713,15427
18,04/30/2018,30,7:15,7:30,46.79,,0,46.79,46.79,1,-134074,79640,213714,-54434,0,0,12626,0,0,,12626,12626
18,04/30/2018,31,7:30,7:45,85.16,,0,85.16,85.16,1,-161863,67231,229094,-94632,0,0,48514,0,0,,48514,48514
18,04/30/2018,32,7:45,8:00,145.12,,0,145.12,145.12,1,-221977,65470,287447,-156507,0,0,104974,0,0,,104974,104974
18,04/30/2018,33,8:00,8:15,145.12,34.91,0,34.91,34.91,-1,-94336,93791,188127,-545,0,-236,57061,0,0,,57297,56825
18,04/30/2018,34,8:15,8:30,145.12,34.91,0,145.12,145.12,1,-126120,43734,169854,-82386,0,-15,26136,0,0,,26151,26121
18,04/30/2018,35,8:30,8:45,145.12,,0,145.12,145.12,1,-164802,30533,195335,-134269,0,0,107069,0,0,,107069,107069
18,04/30/2018,36,8:45,9:00,145.12,,0,145.12,145.12,1,-181436,16828,198264,-164608,0,0,115479,0,0,,115479,115479
18,04/30/2018,37,9:00,9:15,162.64,,0,263.7,263.7,1,-181392,15472,196864,-165920,0,0,115434,0,11666,,127100,127100
18,04/30/2018,38,9:15,9:30,162.64,,0,263.7,263.7,1,-184634,22409,207043,-162225,0,0,115556,0,34998,,150554,150554
18,04/30/2018,39,9:30,9:45,162.64,,0,263.7,263.7,1,-183759,7579,191338,-176180,0,0,112959,0,64998,,177957,177957
18,04/30/2018,40,9:45,10:00,162.64,,0,263.7,263.7,1,-202647,3894,206541,-198753,0,0,105192,0,64998,,170190,170190
18,04/30/2018,41,10:00,10:15,181.48,,0,271.66,271.66,1,-297879,3060,300939,-294819,0,0,117478,0,72250,,189728,189728
18,04/30/2018,42,10:15,10:30,181.48,,0,271.66,271.66,1,-293758,3179,296937,-290579,0,0,116714,0,93031,,209745,209745
18,04/30/2018,43,10:30,10:45,181.48,,0,271.66,271.66,1,-308239,5502,313741,-302737,0,0,116948,0,97059,,214007,214007
18,04/30/2018,44,10:45,11:00,181.48,,0,271.66,271.66,1,-322857,5484,328341,-317373,0,0,116964,0,102063,,219027,219027
18,04/30/2018,45,11:00,11:15,165.08,,0,264.73,264.73,1,-358288,14452,372740,-343836,0,0,116964,0,102063,,219027,219027
18,04/30/2018,46,11:15,11:30,364.73,,0,401.2,401.2,1,-368022,16729,384751,-351293,0,0,117200,5000,102063,,224263,224263
18,04/30/2018,47,11:30,11:45,364.73,,0,401.2,401.2,1,-370043,14810,384853,-355233,0,0,117214,5000,111229,,233443,233443
18,04/30/2018,48,11:45,12:00,364.73,,0,401.2,401.2,1,-362500,16701,379201,-345799,0,0,86390,5000,115812,,207202,207202
18,04/30/2018,49,12:00,12:15,85.16,,0,252.38,252.38,1,-340527,18426,358953,-322101,0,0,75864,0,115812,,191676,191676
18,04/30/2018,50,12:15,12:30,57.03,,0,252.38,252.38,1,-340242,20802,361044,-319440,0,0,54850,0,115812,,170662,170662
18,04/30/2018,51,12:30,12:45,61.16,,0,252.38,252.38,1,-343069,29806,372875,-313263,0,0,59467,0,104808,,164275,164275
18,04/30/2018,52,12:45,13:00,66.92,,0,252.38,252.38,1,-345203,31721,376924,-313482,0,0,67027,0,91545,,158572,158572
18,04/30/2018,53,13:00,13:15,53.12,,0,241,241,1,-361710,52338,414048,-309372,0,0,56155,0,89043,,145198,145198
18,04/30/2018,54,13:15,13:30,52.56,,0,241,241,1,-361392,50042,411434,-311350,0,0,52153,0,89043,,141196,141196
18,04/30/2018,55,13:30,13:45,61.87,,0,241,241,1,-382309,49404,431713,-332905,0,0,58633,0,89043,,147676,147676
18,04/30/2018,56,13:45,14:00,61.16,,0,241,241,1,-339371,46859,386230,-292512,0,0,55305,0,86754,,142059,142059
18,04/30/2018,57,14:00,14:15,34.56,36.16,0,235.6,36.16,2,-329718,22462,352180,-307256,0,-386,4439,0,86754,,91579,90807
18,04/30/2018,58,14:15,14:30,34.56,,0,235.6,235.6,1,-316353,57326,373679,-259027,0,0,323,0,64998,,65321,65321
18,04/30/2018,59,14:30,14:45,,24.14,0,24.14,24.14,-1,-294513,49238,343751,-245275,0,-7410,0,0,64998,,72408,57588
18,04/30/2018,60,14:45,15:00,,24.14,0,24.14,24.14,-1,-304704,37386,342090,-267318,0,-27582,0,0,59165,,86747,31583
18,04/30/2018,61,15:00,15:15,,6.63,0,6.63,6.63,-1,-237924,60478,298402,-177446,0,-31742,0,0,47499,,79241,15757
18,04/30/2018,62,15:15,15:30,,-21.37,0,-21.37,-21.37,-1,-252448,50728,303176,-201720,0,-65389,0,0,31666,,97055,-33723
18,04/30/2018,63,15:30,15:45,,24.14,0,24.14,24.14,-1,-256193,78414,334607,-177779,0,-8993,0,0,0,,8993,-8993
18,04/30/2018,64,15:45,16:00,,24.14,0,24.14,24.14,-1,-219931,75760,295691,-144171,0,-12446,0,0,0,,12446,-12446
18,04/30/2018,65,16:00,16:15,,24.93,0,24.93,24.93,-1,-198233,75432,273665,-122801,0,-21874,0,0,0,,21874,-21874
18,04/30/2018,66,16:15,16:30,,24.14,0,24.14,24.14,-1,-175315,75459,250774,-99856,0,-34078,0,0,0,,34078,-34078
18,04/30/2018,67,16:30,16:45,,7.12,0,7.12,7.12,-1,-163058,83641,246699,-79417,0,-61268,0,0,0,,61268,-61268
18,04/30/2018,68,16:45,17:00,,29.8,0,29.8,29.8,-1,-179545,69548,249093,-109997,0,-43454,0,0,0,,43454,-43454
18,04/30/2018,69,17:00,17:15,,-150.78,0,-150.78,-150.78,-1,-133950,62286,196236,-71664,0,-48014,0,0,0,,48014,-48014
18,04/30/2018,70,17:15,17:30,,22.37,0,22.37,22.37,-1,-149375,48257,197632,-101118,0,-31025,0,0,0,,31025,-31025
18,04/30/2018,71,17:30,17:45,,15.35,0,15.35,15.35,-1,-142114,56243,198357,-85871,0,-51136,0,0,0,,51136,-51136
18,04/30/2018,72,17:45,18:00,,-10.84,0,-10.84,-10.84,-1,-113101,55680,168781,-57421,0,-54212,0,0,0,,54212,-54212
18,04/30/2018,73,18:00,18:15,,-12.78,0,-12.78,-12.78,-1,-143466,50339,193805,-93127,0,-63980,0,0,0,,63980,-63980
18,04/30/2018,74,18:15,18:30,,13.16,0,13.16,13.16,-1,-133687,63551,197238,-70136,0,-65639,0,0,0,,65639,-65639
18,04/30/2018,75,18:30,18:45,,24.14,0,24.14,24.14,-1,-134770,43059,177829,-91711,0,-46751,0,0,0,,46751,-46751
18,04/30/2018,76,18:45,19:00,,34.78,0,34.78,34.78,-1,-129341,28421,157762,-100920,0,-16489,0,0,0,,16489,-16489
18,04/30/2018,77,19:00,19:15,49.16,,0,49.16,49.16,1,-204589,9872,214461,-194717,0,0,10749,0,0,,10749,10749
18,04/30/2018,78,19:15,19:30,41.12,,0,41.12,41.12,1,-193894,12271,206165,-181623,0,0,17682,0,0,,17682,17682
18,04/30/2018,79,19:30,19:45,34.7,37.27,0,37.27,37.27,-1,-174287,33894,208181,-140393,0,-640,6198,0,0,,6838,5558
18,04/30/2018,80,19:45,20:00,,36.83,0,36.83,36.83,-1,-149989,47522,197511,-102467,0,-4161,0,0,0,,4161,-4161
18,04/30/2018,81,20:00,20:15,,32.7,0,32.7,32.7,-1,-130621,84267,214888,-46354,0,-5353,0,0,0,,5353,-5353
18,04/30/2018,82,20:15,20:30,,21.35,0,21.35,21.35,-1,-115179,89493,204672,-25686,0,-16105,0,0,0,,16105,-16105
18,04/30/2018,83,20:30,20:45,,29.8,0,29.8,29.8,-1,-129701,80205,209906,-49496,0,-19051,0,0,0,,19051,-19051
18,04/30/2018,84,20:45,21:00,,,0,37.44,37.44,0,-145325,66115,211440,-79210,0,-511,0,0,0,,511,-511
18,04/30/2018,85,21:00,21:15,61.16,,0,61.16,61.16,1,-125177,99118,224295,-26059,0,0,7414,0,0,,7414,7414
18,04/30/2018,86,21:15,21:30,76.04,,0,76.04,76.04,1,-132451,102116,234567,-30335,0,0,36315,0,0,,36315,36315
18,04/30/2018,87,21:30,21:45,76.04,36.82,0,36.82,36.82,-1,-89936,116690,206626,26754,0,-344,4978,0,0,,5322,4634
18,04/30/2018,88,21:45,22:00,,-150.78,0,-150.78,-150.78,-1,-66795,147448,214243,80653,0,-27645,0,0,0,,27645,-27645
18,04/30/2018,89,22:00,22:15,221.12,-150.78,0,221.12,221.12,1,-214844,21626,236470,-193218,0,-4717,37413,0,0,,42130,32696
18,04/30/2018,90,22:15,22:30,221.12,,0,221.12,221.12,1,-199170,29304,228474,-169866,0,0,113962,0,0,,113962,113962
18,04/30/2018,91,22:30,22:45,127.12,,0,127.12,127.12,1,-106976,93943,200919,-13033,0,0,59895,0,0,,59895,59895
18,04/30/2018,92,22:45,23:00,,29.8,0,29.8,29.8,-1,-101912,176863,278775,74951,0,-3406,0,0,0,,3406,-3406
18,04/30/2018,93,23:00,23:15,221.12,29.8,0,221.12,221.12,1,-210296,45758,256054,-164538,0,-905,37446,0,0,,38351,36541
18,04/30/2018,94,23:15,23:30,221.12,,0,221.12,221.12,1,-174411,77113,251524,-97298,0,0,104788,0,0,,104788,104788
18,04/30/2018,95,23:30,23:45,221.12,28.03,0,28.03,28.03,-1,-112184,134734,246918,22550,0,-5181,18717,0,0,,23898,13536
18,04/30/2018,96,23:45,0:00,,33.8,0,33.8,33.8,-1,-71616,117297,188913,45681,0,-16361,0,0,0,,16361,-16361
18,05-01-18,1,0:00,0:15,,-11.04,0,-11.04,-11.04,-1,-51596,157455,209051,105859,0,-30846,0,0,0,,30846,-30846
18,05-01-18,2,0:15,0:30,,-150.03,0,-150.03,-150.03,-1,-65982,92133,158115,26151,0,-48650,0,0,0,,48650,-48650
18,05-01-18,3,0:30,0:45,,-11.04,0,-11.04,-11.04,-1,-37781,98091,135872,60310,0,-29444,0,0,0,,29444,-29444
18,05-01-18,4,0:45,1:00,,-11.04,0,-11.04,-11.04,-1,-66263,104446,170709,38183,0,-57387,0,0,0,,57387,-57387
18,05-01-18,5,1:00,1:15,47.08,-11.04,0,47.08,47.08,1,-99007,61655,160662,-37352,0,-7231,784,0,0,,8015,-6447
18,05-01-18,6,1:15,1:30,35.15,33.8,0,36.05,33.8,2,-68806,72198,141004,3392,0,-1307,67,0,0,,1374,-1240
18,05-01-18,7,1:30,1:45,,37.07,0,37.07,37.07,-1,-54515,47706,102221,-6809,0,-966,0,0,0,,966,-966
18,05-01-18,8,1:45,2:00,,33.8,0,33.8,33.8,-1,-41038,72944,113982,31906,0,-4514,0,0,0,,4514,-4514
18,05-01-18,9,2:00,2:15,,29.8,0,29.8,29.8,-1,-36929,77315,114244,40386,0,-2879,0,0,0,,2879,-2879
18,05-01-18,10,2:15,2:30,,20.66,0,20.66,20.66,-1,-27864,59444,87308,31580,0,-6051,0,0,0,,6051,-6051
18,05-01-18,11,2:30,2:45,,7.03,0,7.03,7.03,-1,-26916,69216,96132,42300,0,-37391,0,0,0,,37391,-37391
18,05-01-18,12,2:45,3:00,,23.94,0,23.94,23.94,-1,-23938,67098,91036,43160,0,-43381,0,0,0,,43381,-43381
18,05-01-18,13,3:00,3:15,,28.03,0,28.03,28.03,-1,-29032,58401,87433,29369,0,-36903,0,0,0,,36903,-36903
18,05-01-18,14,3:15,3:30,,29.8,0,29.8,29.8,-1,-19865,60522,80387,40657,0,-18563,0,0,0,,18563,-18563
18,05-01-18,15,3:30,3:45,,12.96,0,12.96,12.96,-1,-19491,68730,88221,49239,0,-34065,0,0,0,,34065,-34065
18,05-01-18,16,3:45,4:00,,12.96,0,12.96,12.96,-1,-26672,85076,111748,58404,0,-36999,0,0,0,,36999,-36999
18,05-01-18,17,4:00,4:15,,31.86,0,31.86,31.86,-1,-40612,53485,94097,12873,0,-16783,0,0,0,,16783,-16783
18,05-01-18,18,4:15,4:30,37.8,,0,37.8,37.8,1,-41596,50762,92358,9166,0,0,19,0,0,,19,19
18,05-01-18,19,4:30,4:45,35.33,,0,35.33,35.33,1,-50522,52301,102823,1779,0,0,30,0,0,,30,30
18,05-01-18,20,4:45,5:00,36.29,,0,36.29,36.29,1,-60057,50104,110161,-9953,0,0,1544,0,0,,1544,1544
18,05-01-18,21,5:00,5:15,35.33,,0,35.33,35.33,1,-40416,71209,111625,30793,0,0,901,0,0,,901,901
18,05-01-18,22,5:15,5:30,34.02,,0,34.02,34.02,1,-48392,70128,118520,21736,0,0,57,0,0,,57,57
18,05-01-18,23,5:30,5:45,37.87,,0,37.87,37.87,1,-62477,43535,106012,-18942,0,0,2207,0,0,,2207,2207
18,05-01-18,24,5:45,6:00,48.96,,0,48.96,48.96,1,-95298,51425,146723,-43873,0,0,23606,0,0,,23606,23606
18,05-01-18,25,6:00,6:15,34.02,33.56,0,36.41,33.56,2,-46495,134116,180611,87621,0,-1301,5786,0,0,,7087,4485
18,05-01-18,26,6:15,6:30,,33.56,0,33.56,33.56,-1,-43491,108132,151623,64641,0,-914,0,0,0,,914,-914
18,05-01-18,27,6:30,6:45,,33.56,0,33.56,33.56,-1,-74915,69125,144040,-5790,0,-554,0,0,0,,554,-554
18,05-01-18,28,6:45,7:00,42.16,,0,42.16,42.16,1,-110474,86022,196496,-24452,0,0,7500,0,0,,7500,7500
18,05-01-18,29,7:00,7:15,35.66,38.5,0,38.5,38.5,-1,-49242,121848,171090,72606,0,-524,2601,0,0,,3125,2077
18,05-01-18,30,7:15,7:30,,38.5,0,38.5,38.5,-1,-49138,129872,179010,80734,0,-676,0,0,0,,676,-676
18,05-01-18,31,7:30,7:45,,,0,36.53,36.53,0,-66604,113178,179782,46574,0,0,0,0,0,,0,0
18,05-01-18,32,7:45,8:00,,,0,36.53,36.53,0,-85956,111108,197064,25152,0,0,0,0,0,,0,0
18,05-01-18,33,8:00,8:15,,,0,36.76,36.76,0,-63085,116375,179460,53290,0,0,0,0,0,,0,0
18,05-01-18,34,8:15,8:30,,,0,36.76,36.76,0,-79659,91642,171301,11983,0,0,0,0,0,,0,0
18,05-01-18,35,8:30,8:45,85.17,,0,85.17,85.17,1,-119906,69963,189869,-49943,0,0,21816,0,0,,21816,21816
18,05-01-18,36,8:45,9:00,85.17,,0,85.17,85.17,1,-126768,63971,190739,-62797,0,0,52645,0,0,,52645,52645
18,05-01-18,37,9:00,9:15,192.34,,0,192.34,192.34,1,-119276,27581,146857,-91695,0,0,76386,0,0,,76386,76386
18,05-01-18,38,9:15,9:30,83.56,,0,83.56,83.56,1,-121090,51800,172890,-69290,0,0,57984,0,0,,57984,57984
18,05-01-18,39,9:30,9:45,63.56,,0,63.56,63.56,1,-115596,59100,174696,-56496,0,0,59365,0,0,,59365,59365
18,05-01-18,40,9:45,10:00,47.02,,0,47.02,47.02,1,-109262,92684,201946,-16578,0,0,25574,0,0,,25574,25574
18,05-01-18,41,10:00,10:15,45.04,,0,45.04,45.04,1,-112262,90152,202414,-22110,0,0,7819,0,0,,7819,7819
18,05-01-18,42,10:15,10:30,38.02,,0,38.02,38.02,1,-96293,103899,200192,7606,0,0,1838,0,0,,1838,1838
18,05-01-18,43,10:30,10:45,,,0,36.78,36.78,0,-63255,127828,191083,64573,0,0,0,0,0,,0,0
18,05-01-18,44,10:45,11:00,,,0,38.19,38.19,0,-97142,182588,279730,85446,0,0,0,0,0,,0,0
18,05-01-18,45,11:00,11:15,,33.56,0,33.56,33.56,-1,-77511,173530,251041,96019,0,-1337,0,0,0,,1337,-1337
18,05-01-18,46,11:15,11:30,,29.56,0,29.56,29.56,-1,-45720,173858,219578,128138,0,-15890,0,0,0,,15890,-15890
18,05-01-18,47,11:30,11:45,,36.95,0,36.95,36.95,-1,-60212,176178,236390,115966,0,-7325,0,0,0,,7325,-7325
18,05-01-18,48,11:45,12:00,,36.95,0,36.95,36.95,-1,-52031,189813,241844,137782,0,-1751,0,0,0,,1751,-1751
18,05-01-18,49,12:00,12:15,,13.17,0,13.17,13.17,-1,-52600,149914,202514,97314,0,-7938,0,0,0,,7938,-7938
18,05-01-18,50,12:15,12:30,,12.46,0,12.46,12.46,-1,-56789,150930,207719,94141,0,-36191,0,0,0,,36191,-36191
18,05-01-18,51,12:30,12:45,,13.17,0,13.17,13.17,-1,-54747,176217,230964,121470,0,-40279,0,0,0,,40279,-40279
18,05-01-18,52,12:45,13:00,,-51.12,0,-51.12,-51.12,-1,-41348,190322,231670,148974,0,-30917,0,0,0,,30917,-30917
18,05-01-18,53,13:00,13:15,,28.28,0,28.28,28.28,-1,-89677,126851,216528,37174,0,-21330,0,0,0,,21330,-21330
18,05-01-18,54,13:15,13:30,,24.16,0,24.16,24.16,-1,-72200,128501,200701,56301,0,-40690,0,0,0,,40690,-40690
18,05-01-18,55,13:30,13:45,,26.79,0,26.79,26.79,-1,-72710,135019,207729,62309,0,-58024,0,0,0,,58024,-58024
18,05-01-18,56,13:45,14:00,,24.16,0,24.16,24.16,-1,-68465,135077,203542,66612,0,-60151,0,0,0,,60151,-60151
18,05-01-18,57,14:00,14:15,39.66,24.16,0,39.66,39.66,1,-93084,100239,193323,7155,0,-32970,25,0,0,,32995,-32945
18,05-01-18,58,14:15,14:30,39.66,33.56,0,39.66,33.56,2,-97256,107834,205090,10578,0,-3485,16,0,0,,3501,-3469
18,05-01-18,59,14:30,14:45,,33.56,0,33.56,33.56,-1,-89472,108413,197885,18941,0,-13231,0,0,0,,13231,-13231
18,05-01-18,60,14:45,15:00,,27.34,0,27.34,27.34,-1,-90707,115174,205881,24467,0,-21267,0,0,0,,21267,-21267
18,05-01-18,61,15:00,15:15,,24.16,0,24.16,24.16,-1,-88105,145264,233369,57159,0,-35632,0,0,0,,35632,-35632
18,05-01-18,62,15:15,15:30,,28.23,0,28.23,28.23,-1,-90306,124030,214336,33724,0,-40464,0,0,0,,40464,-40464
18,05-01-18,63,15:30,15:45,42.22,28.23,0,42.22,42.22,1,-90661,92926,183587,2265,0,-3963,280,0,0,,4243,-3683
18,05-01-18,64,15:45,16:00,42.22,38.2,0,42.22,38.2,2,-106866,87441,194307,-19425,0,-5,2674,0,0,,2679,2669
18,05-01-18,65,16:00,16:15,42.22,29.56,0,29.56,29.56,-1,-47579,125448,173027,77869,0,-3289,170,0,0,,3459,-3119
18,05-01-18,66,16:15,16:30,,29.56,0,29.56,29.56,-1,-49924,92190,142114,42266,0,-9407,0,0,0,,9407,-9407
18,05-01-18,67,16:30,16:45,,34.03,0,34.03,34.03,-1,-50055,87715,137770,37660,0,-2258,0,0,0,,2258,-2258
18,05-01-18,68,16:45,17:00,,38.35,0,38.35,38.35,-1,-61555,85480,147035,23925,0,-95,0,0,0,,95,-95
18,05-01-18,69,17:00,17:15,,38.53,0,38.53,38.53,-1,-60853,133324,194177,72471,0,-395,0,0,0,,395,-395
18,05-01-18,70,17:15,17:30,,,0,38.33,38.33,0,-71869,101655,173524,29786,0,0,0,0,0,,0,0
18,05-01-18,71,17:30,17:45,47.22,,0,47.22,47.22,1,-88952,74041,162993,-14911,0,0,1466,0,0,,1466,1466
18,05-01-18,72,17:45,18:00,95.02,,0,95.02,95.02,1,-123944,61216,185160,-62728,0,0,38352,0,0,,38352,38352
18,05-01-18,73,18:00,18:15,44.38,31.61,0,44.38,31.61,2,-39096,95040,134136,55944,0,-1392,13969,0,0,,15361,12577
18,05-01-18,74,18:15,18:30,,31.61,0,31.61,31.61,-1,-45242,93239,138481,47997,0,-6492,0,0,0,,6492,-6492
18,05-01-18,75,18:30,18:45,,36.21,0,36.21,36.21,-1,-40207,78758,118965,38551,0,-3451,0,0,0,,3451,-3451
18,05-01-18,76,18:45,19:00,,,0,36.93,36.93,0,-49783,67755,117538,17972,0,-432,0,0,0,,432,-432
18,05-01-18,77,19:00,19:15,,,0,38.45,38.45,0,-52153,71017,123170,18864,0,0,0,0,0,,0,0
18,05-01-18,78,19:15,19:30,46.3,,0,46.3,46.3,1,-75695,61107,136802,-14588,0,0,2094,0,0,,2094,2094
18,05-01-18,79,19:30,19:45,57.19,,0,57.19,57.19,1,-111050,63735,174785,-47315,0,0,34211,0,0,,34211,34211
18,05-01-18,80,19:45,20:00,78.02,,0,78.02,78.02,1,-136900,62390,199290,-74510,0,0,58440,0,0,,58440,58440
18,05-01-18,81,20:00,20:15,61.17,,0,61.17,61.17,1,-134443,105076,239519,-29367,0,0,42295,0,0,,42295,42295
18,05-01-18,82,20:15,20:30,47.41,,0,47.41,47.41,1,-122452,92836,215288,-29616,0,0,25202,0,0,,25202,25202
18,05-01-18,83,20:30,20:45,46.16,,0,46.16,46.16,1,-119178,81215,200393,-37963,0,0,27747,0,0,,27747,27747
18,05-01-18,84,20:45,21:00,49.02,,0,49.02,49.02,1,-120242,69305,189547,-50937,0,0,34511,0,0,,34511,34511
18,05-01-18,85,21:00,21:15,63.69,,0,63.69,63.69,1,-98987,69694,168681,-29293,0,0,22055,0,0,,22055,22055
18,05-01-18,86,21:15,21:30,85.17,,0,85.17,85.17,1,-100906,40497,141403,-60409,0,0,45126,0,0,,45126,45126
18,05-01-18,87,21:30,21:45,65.02,,0,65.02,65.02,1,-108676,43257,151933,-65419,0,0,54893,0,0,,54893,54893
18,05-01-18,88,21:45,22:00,61.17,,0,61.17,61.17,1,-88315,49174,137489,-39141,0,0,51319,0,0,,51319,51319
18,05-01-18,89,22:00,22:15,95.17,36.38,0,95.17,36.38,2,-112880,72600,185480,-40280,0,-303,10260,0,0,,10563,9957
18,05-01-18,90,22:15,22:30,150.02,,0,150.02,150.02,1,-98737,65506,164243,-33231,0,0,33797,0,0,,33797,33797
18,05-01-18,91,22:30,22:45,150.02,34.22,0,34.22,34.22,-1,-66311,69792,136103,3481,0,-1025,1093,0,0,,2118,68
18,05-01-18,92,22:45,23:00,40.45,,0,40.45,40.45,1,-83489,93579,177068,10090,0,0,49,0,0,,49,49
18,05-01-18,93,23:00,23:15,150.02,,0,150.02,150.02,1,-140914,45911,186825,-95003,0,0,36812,0,0,,36812,36812
18,05-01-18,94,23:15,23:30,71.17,,0,71.17,71.17,1,-102199,55476,157675,-46723,0,0,61096,0,0,,61096,61096
18,05-01-18,95,23:30,23:45,71.17,34.22,0,34.22,34.22,-1,-55440,62252,117692,6812,0,-1725,8403,0,0,,10128,6678
18,05-01-18,96,23:45,0:00,,24.03,0,24.03,24.03,-1,-40316,81418,121734,41102,0,-31211,0,0,0,,31211,-31211
18,05-02-18,1,0:00,0:15,58.36,29.56,0,58.36,58.36,1,-101851,73044,174895,-28807,0,-16058,5217,0,0,,21275,-10841
18,05-02-18,2,0:15,0:30,37.56,,0,37.56,37.56,1,-86987,57042,144029,-29945,0,0,4409,0,0,,4409,4409
18,05-02-18,3,0:30,0:45,37.56,29.56,0,29.56,29.56,-1,-62637,64000,126637,1363,0,-1510,15,0,0,,1525,-1495
18,05-02-18,4,0:45,1:00,,29.54,0,29.54,29.54,-1,-47527,61742,109269,14215,0,-21859,0,0,0,,21859,-21859
18,05-02-18,5,1:00,1:15,42.16,29.54,0,42.16,42.16,1,-94340,65896,160236,-28444,0,-2201,1487,0,0,,3688,-714
18,05-02-18,6,1:15,1:30,52.02,,0,52.02,52.02,1,-84652,60716,145368,-23936,0,0,18431,0,0,,18431,18431
18,05-02-18,7,1:30,1:45,52.02,29.56,0,29.56,29.56,-1,-51553,68571,120124,17018,0,-1026,1371,0,0,,2397,345
18,05-02-18,8,1:45,2:00,,20.58,0,20.58,20.58,-1,-33768,74928,108696,41160,0,-25104,0,0,0,,25104,-25104
18,05-02-18,9,2:00,2:15,37.56,29.56,0,37.56,37.56,1,-82738,67168,149906,-15570,0,-13716,385,0,0,,14101,-13331
18,05-02-18,10,2:15,2:30,35.49,29.56,0,35.49,35.49,1,-83482,57799,141281,-25683,0,-328,1188,0,0,,1516,860
18,05-02-18,11,2:30,2:45,37.56,,0,37.56,37.56,1,-71325,53713,125038,-17612,0,0,2717,0,0,,2717,2717
18,05-02-18,12,2:45,3:00,37.12,,0,37.12,37.12,1,-75905,59566,135471,-16339,0,0,3528,0,0,,3528,3528
18,05-02-18,13,3:00,3:15,,,0,35.08,35.08,0,-89379,95033,184412,5654,0,0,178,0,0,,178,178
18,05-02-18,14,3:15,3:30,37.56,,0,37.56,37.56,1,-82182,66425,148607,-15757,0,0,1428,0,0,,1428,1428
18,05-02-18,15,3:30,3:45,37.56,,0,37.56,37.56,1,-82162,55396,137558,-26766,0,0,3512,0,0,,3512,3512
18,05-02-18,16,3:45,4:00,35.15,,0,35.15,35.15,1,-73894,60280,134174,-13614,0,0,1071,0,0,,1071,1071
18,05-02-18,17,4:00,4:15,42.16,,0,42.16,42.16,1,-95938,63886,159824,-32052,0,0,4243,0,0,,4243,4243
18,05-02-18,18,4:15,4:30,37.56,,0,37.56,37.56,1,-97468,70960,168428,-26508,0,0,3496,0,0,,3496,3496
18,05-02-18,19,4:30,4:45,35.25,,0,35.25,35.25,1,-86066,73435,159501,-12631,0,0,1926,0,0,,1926,1926
18,05-02-18,20,4:45,5:00,,,0,35.5,35.5,0,-86587,80269,166856,-6318,0,0,192,0,0,,192,192
18,05-02-18,21,5:00,5:15,,37.58,0,37.58,37.58,-1,-61307,81921,143228,20614,0,-745,0,0,0,,745,-745
18,05-02-18,22,5:15,5:30,,37.58,0,37.58,37.58,-1,-82101,78816,160917,-3285,0,-794,0,0,0,,794,-794
18,05-02-18,23,5:30,5:45,42.16,,0,42.16,42.16,1,-103155,68241,171396,-34914,0,0,1258,0,0,,1258,1258
18,05-02-18,24,5:45,6:00,35.48,,0,35.48,35.48,1,-114645,108443,223088,-6202,0,0,574,0,0,,574,574
18,05-02-18,25,6:00,6:15,,,0,36.66,36.66,0,-133850,121694,255544,-12156,0,0,0,0,0,,0,0
18,05-02-18,26,6:15,6:30,,,0,36.95,36.95,0,-112835,97570,210405,-15265,0,0,0,0,0,,0,0
18,05-02-18,27,6:30,6:45,62.03,,0,62.03,62.03,1,-129616,74800,204416,-54816,0,0,3928,0,0,,3928,3928
18,05-02-18,28,6:45,7:00,66.12,,0,66.12,66.12,1,-84583,95239,179822,10656,0,0,19285,0,0,,19285,19285
18,05-02-18,29,7:00,7:15,40.73,38.78,0,40.73,37.1,2,-100394,81401,181795,-18993,0,-930,557,0,0,,1487,-373
18,05-02-18,30,7:15,7:30,62.12,,0,62.12,62.12,1,-104477,60204,164681,-44273,0,0,27548,0,0,,27548,27548
18,05-02-18,31,7:30,7:45,53.12,,0,53.12,53.12,1,-100309,55027,155336,-45282,0,0,48835,0,0,,48835,48835
18,05-02-18,32,7:45,8:00,59.07,,0,59.07,59.07,1,-110618,58410,169028,-52208,0,0,41214,0,0,,41214,41214
18,05-02-18,33,8:00,8:15,247.63,38.4,0,247.63,38.03,2,-59731,76372,136103,16641,0,-359,13634,0,0,,13993,13275
18,05-02-18,34,8:15,8:30,247.63,,0,272.39,272.39,1,-197196,66897,264093,-130299,0,0,79077,0,6180,,85257,85257
18,05-02-18,35,8:30,8:45,175.42,,0,252.3,252.3,1,-183127,125831,308958,-57296,0,0,64007,0,18540,,82547,82547
18,05-02-18,36,8:45,9:00,49.38,,0,252.3,252.3,1,-172560,137890,310450,-34670,0,0,8136,0,18540,,26676,26676
18,05-02-18,37,9:00,9:15,245.08,,0,245.08,245.08,1,-203430,87064,290494,-116366,0,0,57132,0,0,,57132,57132
18,05-02-18,38,9:15,9:30,134.07,,0,134.07,134.07,1,-152512,100013,252525,-52499,0,0,73978,0,0,,73978,73978
18,05-02-18,39,9:30,9:45,34.12,35.06,0,35.06,35.06,-1,-97423,117394,214817,19971,0,-664,9941,0,0,,10605,9277
18,05-02-18,40,9:45,10:00,,28.29,0,28.29,28.29,-1,-68237,134633,202870,66396,0,-18901,0,0,0,,18901,-18901
18,05-02-18,41,10:00,10:15,,28.08,0,28.08,28.08,-1,-54022,68899,122921,14877,0,-17137,0,0,0,,17137,-17137
18,05-02-18,42,10:15,10:30,,31.06,0,31.06,31.06,-1,-59370,86853,146223,27483,0,-6149,0,0,0,,6149,-6149
18,05-02-18,43,10:30,10:45,,14.03,0,14.03,14.03,-1,-45349,116904,162253,71555,0,-45349,0,0,0,,45349,-45349
18,05-02-18,44,10:45,11:00,,-11.95,0,-11.95,-11.95,-1,-29888,124741,154629,94853,0,-68709,0,0,0,,68709,-68709
18,05-02-18,45,11:00,11:15,,22.37,0,22.37,22.37,-1,-48800,94644,143444,45844,0,-54705,0,0,0,,54705,-54705
18,05-02-18,46,11:15,11:30,,26.56,0,26.56,26.56,-1,-42011,98008,140019,55997,0,-44999,0,0,0,,44999,-44999
18,05-02-18,47,11:30,11:45,,29.19,0,29.19,29.19,-1,-30911,91702,122613,60791,0,-52982,0,0,0,,52982,-52982
18,05-02-18,48,11:45,12:00,,29.19,0,29.19,29.19,-1,-42447,108426,150873,65979,0,-51642,0,0,0,,51642,-51642
18,05-02-18,49,12:00,12:15,52.78,29.19,0,52.78,52.78,1,-87377,59496,146873,-27881,0,-17783,4403,0,0,,22186,-13380
18,05-02-18,50,12:15,12:30,35.42,35.06,0,35.06,35.06,-1,-52375,68040,120415,15665,0,-94,1448,0,0,,1542,1354
18,05-02-18,51,12:30,12:45,,32.63,0,32.63,32.63,-1,-23673,96819,120492,73146,0,-569,0,0,0,,569,-569
18,05-02-18,52,12:45,13:00,,14.03,0,14.03,14.03,-1,-39525,103712,143237,64187,0,-13317,0,0,0,,13317,-13317
18,05-02-18,53,13:00,13:15,,14.03,0,14.03,14.03,-1,-62358,93689,156047,31331,0,-16293,0,0,0,,16293,-16293
18,05-02-18,54,13:15,13:30,,,0,37.07,37.07,0,-56950,98624,155574,41674,0,0,0,0,0,,0,0
18,05-02-18,55,13:30,13:45,,,0,37.08,37.08,0,-51202,107356,158558,56154,0,0,0,0,0,,0,0
18,05-02-18,56,13:45,14:00,,,0,37.07,37.07,0,-50101,112823,162924,62722,0,0,0,0,0,,0,0
18,05-02-18,57,14:00,14:15,,,0,35.43,35.43,0,-33468,145445,178913,111977,0,0,0,0,0,,0,0
18,05-02-18,58,14:15,14:30,,,0,35.06,35.06,0,-34957,144781,179738,109824,0,0,0,0,0,,0,0
18,05-02-18,59,14:30,14:45,,33.37,0,33.37,33.37,-1,-32526,155014,187540,122488,0,-2247,0,0,0,,2247,-2247
18,05-02-18,60,14:45,15:00,,31.06,0,31.06,31.06,-1,-26078,146396,172474,120318,0,-5351,0,0,0,,5351,-5351
18,05-02-18,61,15:00,15:15,,25.18,0,25.18,25.18,-1,-9647,155655,165302,146008,0,-15115,0,0,0,,15115,-15115
18,05-02-18,62,15:15,15:30,,25.18,0,25.18,25.18,-1,-14628,149461,164089,134833,0,-20864,0,0,0,,20864,-20864
18,05-02-18,63,15:30,15:45,,33.78,0,33.78,33.78,-1,-23550,129994,153544,106444,0,-7016,0,0,0,,7016,-7016
18,05-02-18,64,15:45,16:00,,33.02,0,33.02,33.02,-1,-16707,123011,139718,106304,0,-41,0,0,0,,41,-41
18,05-02-18,65,16:00,16:15,,-9.97,0,-9.97,-9.97,-1,-18818,198976,217794,180158,0,-25380,0,0,0,,25380,-25380
18,05-02-18,66,16:15,16:30,,25.18,0,25.18,25.18,-1,-16099,165190,181289,149091,0,-38869,0,0,0,,38869,-38869
18,05-02-18,67,16:30,16:45,,11.15,0,11.15,11.15,-1,-22681,153111,175792,130430,0,-47523,0,0,0,,47523,-47523
18,05-02-18,68,16:45,17:00,,31.06,0,31.06,31.06,-1,-41185,105619,146804,64434,0,-17370,0,0,0,,17370,-17370
18,05-02-18,69,17:00,17:15,,-150.78,0,-150.78,-150.78,-1,-47972,149712,197684,101740,0,-40621,0,0,0,,40621,-40621
18,05-02-18,70,17:15,17:30,,35.06,0,35.06,35.06,-1,-81940,112297,194237,30357,0,-23661,0,0,0,,23661,-23661
18,05-02-18,71,17:30,17:45,43.06,35.06,0,43.06,43.06,1,-77148,79359,156507,2211,0,-5976,863,0,0,,6839,-5113
18,05-02-18,72,17:45,18:00,40.82,,0,40.82,40.82,1,-74699,66151,140850,-8548,0,0,2356,0,0,,2356,2356
18,05-02-18,73,18:00,18:15,40.23,,0,40.23,40.23,1,-97453,74335,171788,-23118,0,0,1196,0,0,,1196,1196
18,05-02-18,74,18:15,18:30,43.06,,0,43.06,43.06,1,-76490,60410,136900,-16080,0,0,2204,0,0,,2204,2204
18,05-02-18,75,18:30,18:45,40.06,,0,40.06,40.06,1,-77564,65136,142700,-12428,0,0,4632,0,0,,4632,4632
18,05-02-18,76,18:45,19:00,62.03,,0,62.03,62.03,1,-88102,46611,134713,-41491,0,0,24981,0,0,,24981,24981
18,05-02-18,77,19:00,19:15,49.38,,0,49.38,49.38,1,-76006,42556,118562,-33450,0,0,27125,0,0,,27125,27125
18,05-02-18,78,19:15,19:30,62.03,,0,62.03,62.03,1,-82434,30128,112562,-52306,0,0,28312,0,0,,28312,28312
18,05-02-18,79,19:30,19:45,46.13,,0,46.13,46.13,1,-68784,45267,114051,-23517,0,0,29533,0,0,,29533,29533
18,05-02-18,80,19:45,20:00,40.19,,0,40.19,40.19,1,-60150,55993,116143,-4157,0,0,11243,0,0,,11243,11243
18,05-02-18,81,20:00,20:15,,,0,37.3,37.3,0,-33112,113287,146399,80175,0,0,805,0,0,,805,805
18,05-02-18,82,20:15,20:30,,,0,37.3,37.3,0,-19650,115113,134763,95463,0,0,0,0,0,,0,0
18,05-02-18,83,20:30,20:45,,,0,37.3,37.3,0,-22250,110167,132417,87917,0,0,0,0,0,,0,0
18,05-02-18,84,20:45,21:00,,39.45,0,39.45,39.45,-1,-28514,106259,134773,77745,0,-1,0,0,0,,1,-1
18,05-02-18,85,21:00,21:15,,37.83,0,37.83,37.83,-1,-19787,110614,130401,90827,0,-62,0,0,0,,62,-62
18,05-02-18,86,21:15,21:30,,37.51,0,37.51,37.51,-1,-27832,79054,106886,51222,0,-177,0,0,0,,177,-177
18,05-02-18,87,21:30,21:45,,35.06,0,35.06,35.06,-1,-24613,69050,93663,44437,0,-741,0,0,0,,741,-741
18,05-02-18,88,21:45,22:00,,28.54,0,28.54,28.54,-1,-37459,74887,112346,37428,0,-17354,0,0,0,,17354,-17354
18,05-02-18,89,22:00,22:15,140.12,38.78,0,140.12,140.12,1,-172818,40736,213554,-132082,0,-5786,30184,0,0,,35970,24398
18,05-02-18,90,22:15,22:30,140.12,,0,140.12,140.12,1,-90281,58737,149018,-31544,0,0,53990,0,0,,53990,53990
18,05-02-18,91,22:30,22:45,140.12,39.25,0,39.25,39.25,-1,-66601,75345,141946,8744,0,-2,1067,0,0,,1069,1065
18,05-02-18,92,22:45,23:00,,25.13,0,25.13,25.13,-1,-47901,98131,146032,50230,0,-16854,0,0,0,,16854,-16854
18,05-02-18,93,23:00,23:15,86.03,31.06,0,86.03,86.03,1,-78884,47701,126585,-31183,0,-17331,3291,0,0,,20622,-14040
18,05-02-18,94,23:15,23:30,140.12,31.06,0,140.12,140.12,1,-91434,30716,122150,-60718,0,-26,47423,0,0,,47449,47397
18,05-02-18,95,23:30,23:45,49.38,,0,49.38,49.38,1,-83710,40940,124650,-42770,0,0,41100,0,0,,41100,41100
18,05-02-18,96,23:45,0:00,43.76,,0,43.76,43.76,1,-75906,52004,127910,-23902,0,0,26946,0,0,,26946,26946
18,05-03-18,1,0:00,0:15,61.67,36.98,0,61.67,36.98,2,-79304,43922,123226,-35382,0,-81,13191,0,0,,13272,13110
18,05-03-18,2,0:15,0:30,73.74,,0,73.74,73.74,1,-87799,32215,120014,-55584,0,0,48524,0,0,,48524,48524
18,05-03-18,3,0:30,0:45,,,0,24.02,24.02,0,-63908,24410,88318,-39498,0,0,8754,0,0,,8754,8754
18,05-03-18,4,0:45,1:00,41.09,,0,41.09,41.09,1,-61688,23761,85449,-37927,0,0,1582,0,0,,1582,1582
18,05-03-18,5,1:00,1:15,41.09,33.71,0,33.71,33.71,-1,-43051,117526,160577,74475,0,-2104,30,0,0,,2134,-2074
18,05-03-18,6,1:15,1:30,,38.03,0,38.03,38.03,-1,-36633,79624,116257,42991,0,-290,0,0,0,,290,-290
18,05-03-18,7,1:30,1:45,,36.88,0,36.88,36.88,-1,-39581,55803,95384,16222,0,-3,0,0,0,,3,-3
18,05-03-18,8,1:45,2:00,,9.33,0,9.33,9.33,-1,-27010,88506,115516,61496,0,-28607,0,0,0,,28607,-28607
18,05-03-18,9,2:00,2:15,38.12,25.07,0,38.12,38.12,1,-63481,67460,130941,3979,0,-23528,277,0,0,,23805,-23251
18,05-03-18,10,2:15,2:30,,,0,36.8,36.8,0,-67004,67381,134385,377,0,-3,203,0,0,,206,200
18,05-03-18,11,2:30,2:45,,,0,36.8,36.8,0,-55294,67548,122842,12254,0,0,0,0,0,,0,0
18,05-03-18,12,2:45,3:00,,34.71,0,34.71,34.71,-1,-52122,80142,132264,28020,0,-970,0,0,0,,970,-970
18,05-03-18,13,3:00,3:15,,34.71,0,34.71,34.71,-1,-68652,99284,167936,30632,0,-1901,0,0,0,,1901,-1901
18,05-03-18,14,3:15,3:30,,37.03,0,37.03,37.03,-1,-64319,138048,202367,73729,0,-803,0,0,0,,803,-803
18,05-03-18,15,3:30,3:45,,,0,37.58,37.58,0,-52543,156071,208614,103528,0,-126,0,0,0,,126,-126
18,05-03-18,16,3:45,4:00,,-150.03,0,-150.03,-150.03,-1,-41861,153545,195406,111684,0,-24581,0,0,0,,24581,-24581
18,05-03-18,17,4:00,4:15,,25.07,0,25.07,25.07,-1,-74093,89466,163559,15373,0,-21997,0,0,0,,21997,-21997
18,05-03-18,18,4:15,4:30,,30.71,0,30.71,30.71,-1,-66733,88219,154952,21486,0,-12143,0,0,0,,12143,-12143
18,05-03-18,19,4:30,4:45,,33.34,0,33.34,33.34,-1,-71266,73999,145265,2733,0,-14849,0,0,0,,14849,-14849
18,05-03-18,20,4:45,5:00,38.71,33.34,0,38.71,38.71,1,-73594,47823,121417,-25771,0,-1068,1734,0,0,,2802,666
18,05-03-18,21,5:00,5:15,42.45,,0,42.45,42.45,1,-78960,32825,111785,-46135,0,0,1673,0,0,,1673,1673
18,05-03-18,22,5:15,5:30,48.83,,0,48.83,48.83,1,-95046,32305,127351,-62741,0,0,2643,0,0,,2643,2643
18,05-03-18,23,5:30,5:45,79.02,,0,79.02,79.02,1,-126786,18978,145764,-107808,0,0,48302,0,0,,48302,48302
18,05-03-18,24,5:45,6:00,84.02,,0,84.02,84.02,1,-124133,17546,141679,-106587,0,0,73347,0,0,,73347,73347
18,05-03-18,25,6:00,6:15,48.47,,0,48.47,48.47,1,-102148,63756,165904,-38392,0,0,25874,0,0,,25874,25874
18,05-03-18,26,6:15,6:30,47.28,,0,47.28,47.28,1,-79092,56882,135974,-22210,0,0,565,0,0,,565,565
18,05-03-18,27,6:30,6:45,146.02,,0,146.02,146.02,1,-115955,33434,149389,-82521,0,0,50017,0,0,,50017,50017
18,05-03-18,28,6:45,7:00,78.02,,0,78.02,78.02,1,-77478,63256,140734,-14222,0,0,49262,0,0,,49262,49262
18,05-03-18,29,7:00,7:15,78.02,7.83,0,7.83,7.83,-1,-31044,122754,153798,91710,0,-13904,1355,0,0,,15259,-12549
18,05-03-18,30,7:15,7:30,,34.35,0,34.35,34.35,-1,-25395,91493,116888,66098,0,-4188,0,0,0,,4188,-4188
18,05-03-18,31,7:30,7:45,,,0,38.32,38.32,0,-45370,60778,106148,15408,0,0,0,0,0,,0,0
18,05-03-18,32,7:45,8:00,38.35,,0,38.35,38.35,1,-60257,70924,131181,10667,0,0,79,0,0,,79,79
18,05-03-18,33,8:00,8:15,38.35,34.35,0,38.35,34.35,2,-76807,85807,162614,9000,0,-1329,128,0,0,,1457,-1201
18,05-03-18,34,8:15,8:30,,,0,38.32,38.32,0,-90680,77569,168249,-13111,0,0,0,0,0,,0,0
18,05-03-18,35,8:30,8:45,41.41,,0,41.41,41.41,1,-97837,80830,178667,-17007,0,0,2344,0,0,,2344,2344
18,05-03-18,36,8:45,9:00,38.35,,0,38.35,38.35,1,-88877,87563,176440,-1314,0,0,2923,0,0,,2923,2923
18,05-03-18,37,9:00,9:15,,,0,38.32,38.32,0,-53592,73116,126708,19524,0,0,7,0,0,,7,7
18,05-03-18,38,9:15,9:30,,,0,38.32,38.32,0,-38855,78225,117080,39370,0,0,0,0,0,,0,0
18,05-03-18,39,9:30,9:45,,,0,38.32,38.32,0,-41017,82580,123597,41563,0,0,0,0,0,,0,0
18,05-03-18,40,9:45,10:00,,34.35,0,34.35,34.35,-1,-42974,90682,133656,47708,0,-2037,0,0,0,,2037,-2037
18,05-03-18,41,10:00,10:15,38.35,34.35,0,38.35,38.35,1,-70493,62491,132984,-8002,0,-113,727,0,0,,840,614
18,05-03-18,42,10:15,10:30,38.35,,0,38.35,38.35,1,-59893,68687,128580,8794,0,0,572,0,0,,572,572
18,05-03-18,43,10:30,10:45,38.35,,0,38.35,38.35,1,-73589,76350,149939,2761,0,0,866,0,0,,866,866
18,05-03-18,44,10:45,11:00,,,0,38.32,38.32,0,-60218,89420,149638,29202,0,0,0,0,0,,0,0
18,05-03-18,45,11:00,11:15,39.64,,0,39.64,39.64,1,-84327,68423,152750,-15904,0,0,2053,0,0,,2053,2053
18,05-03-18,46,11:15,11:30,42.87,,0,42.87,42.87,1,-88676,71031,159707,-17645,0,0,7506,0,0,,7506,7506
18,05-03-18,47,11:30,11:45,40.63,,0,40.63,40.63,1,-95300,77374,172674,-17926,0,0,10499,0,0,,10499,10499
18,05-03-18,48,11:45,12:00,40.63,,0,40.63,40.63,1,-96336,78223,174559,-18113,0,0,9450,0,0,,9450,9450
18,05-03-18,49,12:00,12:15,38.35,,0,38.35,38.35,1,-97710,76369,174079,-21341,0,0,4489,0,0,,4489,4489
18,05-03-18,50,12:15,12:30,36.41,,0,36.41,36.41,1,-108923,72730,181653,-36193,0,0,475,0,0,,475,475
18,05-03-18,51,12:30,12:45,40.76,,0,40.76,40.76,1,-105929,80928,186857,-25001,0,0,1749,0,0,,1749,1749
18,05-03-18,52,12:45,13:00,,,0,37.27,37.27,0,-117150,87505,204655,-29645,0,0,123,0,0,,123,123
18,05-03-18,53,13:00,13:15,36.8,,0,36.8,36.8,1,-80942,98823,179765,17881,0,0,340,0,0,,340,340
18,05-03-18,54,13:15,13:30,49.04,,0,49.04,49.04,1,-101706,72026,173732,-29680,0,0,12826,0,0,,12826,12826
18,05-03-18,55,13:30,13:45,47.29,,0,47.29,47.29,1,-100633,65589,166222,-35044,0,0,30674,0,0,,30674,30674
18,05-03-18,56,13:45,14:00,42.61,,0,42.61,42.61,1,-95875,77262,173137,-18613,0,0,22043,0,0,,22043,22043
18,05-03-18,57,14:00,14:15,55.14,35.58,0,55.14,35.58,2,-105748,81122,186870,-24626,0,-536,6366,0,0,,6902,5830
18,05-03-18,58,14:15,14:30,65.02,,0,65.02,65.02,1,-102636,58454,161090,-44182,0,0,39691,0,0,,39691,39691
18,05-03-18,59,14:30,14:45,55.14,,0,55.14,55.14,1,-103093,57057,160150,-46036,0,0,32374,0,0,,32374,32374
18,05-03-18,60,14:45,15:00,54.78,,0,54.78,54.78,1,-107069,43218,150287,-63851,0,0,25233,0,0,,25233,25233
18,05-03-18,61,15:00,15:15,54.78,35.54,0,35.54,35.54,-1,-79662,79019,158681,-643,0,-21,1545,0,0,,1566,1524
18,05-03-18,62,15:15,15:30,42.61,,0,42.61,42.61,1,-74203,64197,138400,-10006,0,0,1535,0,0,,1535,1535
18,05-03-18,63,15:30,15:45,42.61,,0,42.61,42.61,1,-80506,67280,147786,-13226,0,0,9763,0,0,,9763,9763
18,05-03-18,64,15:45,16:00,42.61,,0,42.61,42.61,1,-89301,66273,155574,-23028,0,0,10394,0,0,,10394,10394
18,05-03-18,65,16:00,16:15,38.35,,0,38.35,38.35,1,-97196,94730,191926,-2466,0,0,5983,0,0,,5983,5983
18,05-03-18,66,16:15,16:30,38.35,,0,38.35,38.35,1,-91852,90826,182678,-1026,0,0,5419,0,0,,5419,5419
18,05-03-18,67,16:30,16:45,42.61,,0,42.61,42.61,1,-96715,85378,182093,-11337,0,0,6068,0,0,,6068,6068
18,05-03-18,68,16:45,17:00,38.35,,0,38.35,38.35,1,-96821,83267,180088,-13554,0,0,6777,0,0,,6777,6777
18,05-03-18,69,17:00,17:15,49.04,,0,49.04,49.04,1,-80000,62137,142137,-17863,0,0,12285,0,0,,12285,12285
18,05-03-18,70,17:15,17:30,49.04,,0,49.04,49.04,1,-84913,50965,135878,-33948,0,0,12126,0,0,,12126,12126
18,05-03-18,71,17:30,17:45,52.52,,0,52.52,52.52,1,-91053,50663,141716,-40390,0,0,26268,0,0,,26268,26268
18,05-03-18,72,17:45,18:00,42.87,,0,42.87,42.87,1,-84665,61439,146104,-23226,0,0,22742,0,0,,22742,22742
18,05-03-18,73,18:00,18:15,41.02,,0,41.02,41.02,1,-107282,63801,171083,-43481,0,0,9677,0,0,,9677,9677
18,05-03-18,74,18:15,18:30,41.02,34.35,0,34.35,34.35,-1,-88145,85445,173590,-2700,0,-563,31,0,0,,594,-532
18,05-03-18,75,18:30,18:45,39.41,,0,39.41,39.41,1,-93372,58955,152327,-34417,0,0,476,0,0,,476,476
18,05-03-18,76,18:45,19:00,49.04,,0,49.04,49.04,1,-88638,51061,139699,-37577,0,0,12674,0,0,,12674,12674
18,05-03-18,77,19:00,19:15,39.85,,0,39.85,39.85,1,-70608,72094,142702,1486,0,0,7541,0,0,,7541,7541
18,05-03-18,78,19:15,19:30,49.04,,0,49.04,49.04,1,-75331,58613,133944,-16718,0,0,3350,0,0,,3350,3350
18,05-03-18,79,19:30,19:45,50.8,,0,50.8,50.8,1,-93241,53775,147016,-39466,0,0,28138,0,0,,28138,28138
18,05-03-18,80,19:45,20:00,44.57,,0,44.57,44.57,1,-82842,52926,135768,-29916,0,0,27416,0,0,,27416,27416
18,05-03-18,81,20:00,20:15,42.87,,0,42.87,42.87,1,-63221,34882,98103,-28339,0,0,20443,0,0,,20443,20443
18,05-03-18,82,20:15,20:30,45.44,,0,45.44,45.44,1,-67020,32036,99056,-34984,0,0,23411,0,0,,23411,23411
18,05-03-18,83,20:30,20:45,41.02,,0,41.02,41.02,1,-53196,38198,91394,-14998,0,0,13893,0,0,,13893,13893
18,05-03-18,84,20:45,21:00,38.35,,0,38.35,38.35,1,-56405,44158,100563,-12247,0,0,1020,0,0,,1020,1020
18,05-03-18,85,21:00,21:15,,38.03,0,38.03,38.03,-1,-44388,60611,104999,16223,0,-234,0,0,0,,234,-234
18,05-03-18,86,21:15,21:30,53,38.03,0,53,53,1,-53495,24735,78230,-28760,0,-231,4836,0,0,,5067,4605
18,05-03-18,87,21:30,21:45,73,,0,73,73,1,-59667,27112,86779,-32555,0,0,31649,0,0,,31649,31649
18,05-03-18,88,21:45,22:00,73,36.52,0,36.52,36.52,-1,-43454,38003,81457,-5451,0,-68,3503,0,0,,3571,3435
18,05-03-18,89,22:00,22:15,42.87,,0,42.87,42.87,1,-82035,51849,133884,-30186,0,0,2491,0,0,,2491,2491
18,05-03-18,90,22:15,22:30,40.15,,0,40.15,40.15,1,-54906,45876,100782,-9030,0,0,4618,0,0,,4618,4618
18,05-03-18,91,22:30,22:45,40.15,34.35,0,34.35,34.35,-1,-31813,56553,88366,24740,0,-3457,166,0,0,,3623,-3291
18,05-03-18,92,22:45,23:00,,29.5,0,29.5,29.5,-1,-17278,60699,77977,43421,0,-16294,0,0,0,,16294,-16294
18,05-03-18,93,23:00,23:15,49.04,31.38,0,49.04,31.38,2,-72777,59498,132275,-13279,0,-12803,2333,0,0,,15136,-10470
18,05-03-18,94,23:15,23:30,49.04,30.35,0,30.35,30.35,-1,-56929,74282,131211,17353,0,-2400,153,0,0,,2553,-2247
18,05-03-18,95,23:30,23:45,,30.35,0,30.35,30.35,-1,-32085,89336,121421,57251,0,-3631,0,0,0,,3631,-3631
18,05-03-18,96,23:45,0:00,,-37.37,0,-37.37,-37.37,-1,-21502,88257,109759,66755,0,-28973,0,0,0,,28973,-28973
18,05-04-18,1,0:00,0:15,84.49,12.49,0,84.49,84.49,1,-74625,57633,132258,-16992,0,-27802,3642,0,0,,31444,-24160
18,05-04-18,2,0:15,0:30,144.12,,0,144.12,144.12,1,-57966,51713,109679,-6253,0,0,23008,0,0,,23008,23008
18,05-04-18,3,0:30,0:45,144.12,38.1,0,38.1,38.1,-1,-51301,53450,104751,2149,0,-871,221,0,0,,1092,-650
18,05-04-18,4,0:45,1:00,,31.75,0,31.75,31.75,-1,-60035,64485,124520,4450,0,-3836,0,0,0,,3836,-3836
18,05-04-18,5,1:00,1:15,,18.78,0,18.78,18.78,-1,-37009,121215,158224,84206,0,-11871,0,0,0,,11871,-11871
18,05-04-18,6,1:15,1:30,,,0,35.48,35.48,0,-35818,71037,106855,35219,0,-376,0,0,0,,376,-376
18,05-04-18,7,1:30,1:45,,,0,35.52,35.52,0,-32938,79808,112746,46870,0,0,0,0,0,,0,0
18,05-04-18,8,1:45,2:00,,27.89,0,27.89,27.89,-1,-25945,82044,107989,56099,0,-4199,0,0,0,,4199,-4199
18,05-04-18,9,2:00,2:15,,24.4,0,24.4,24.4,-1,-38334,107849,146183,69515,0,-9501,0,0,0,,9501,-9501
18,05-04-18,10,2:15,2:30,,19.86,0,19.86,19.86,-1,-35810,107298,143108,71488,0,-20006,0,0,0,,20006,-20006
18,05-04-18,11,2:30,2:45,,30.35,0,30.35,30.35,-1,-31240,109460,140700,78220,0,-12957,0,0,0,,12957,-12957
18,05-04-18,12,2:45,3:00,,11.01,0,11.01,11.01,-1,-29671,116940,146611,87269,0,-28736,0,0,0,,28736,-28736
18,05-04-18,13,3:00,3:15,,29.78,0,29.78,29.78,-1,-58672,66889,125561,8217,0,-23354,0,0,0,,23354,-23354
18,05-04-18,14,3:15,3:30,,37.78,0,37.78,37.78,-1,-50443,66174,116617,15731,0,-275,0,0,0,,275,-275
18,05-04-18,15,3:30,3:45,,37.78,0,37.78,37.78,-1,-48427,73876,122303,25449,0,-1012,0,0,0,,1012,-1012
18,05-04-18,16,3:45,4:00,,36.69,0,36.69,36.69,-1,-41793,81252,123045,39459,0,-817,0,0,0,,817,-817
18,05-04-18,17,4:00,4:15,,37.78,0,37.78,37.78,-1,-46705,72676,119381,25971,0,-488,0,0,0,,488,-488
18,05-04-18,18,4:15,4:30,,,0,36.26,36.26,0,-35190,77681,112871,42491,0,0,0,0,0,,0,0
18,05-04-18,19,4:30,4:45,,,0,36.26,36.26,0,-38562,86930,125492,48368,0,0,0,0,0,,0,0
18,05-04-18,20,4:45,5:00,,,0,36.27,36.27,0,-42904,85820,128724,42916,0,0,0,0,0,,0,0
18,05-04-18,21,5:00,5:15,,35.03,0,35.03,35.03,-1,-12820,59719,72539,46899,0,-300,0,0,0,,300,-300
18,05-04-18,22,5:15,5:30,,,0,36.23,36.23,0,-21766,45627,67393,23861,0,0,0,0,0,,0,0
18,05-04-18,23,5:30,5:45,,,0,36.13,36.13,0,-39802,46975,86777,7173,0,0,0,0,0,,0,0
18,05-04-18,24,5:45,6:00,,34.35,0,34.35,34.35,-1,-22880,95236,118116,72356,0,-264,0,0,0,,264,-264
18,05-04-18,25,6:00,6:15,,20.71,0,20.71,20.71,-1,-41816,104497,146313,62681,0,-17202,0,0,0,,17202,-17202
18,05-04-18,26,6:15,6:30,,35.89,0,35.89,35.89,-1,-23770,73612,97382,49842,0,-1604,0,0,0,,1604,-1604
18,05-04-18,27,6:30,6:45,,,0,36.56,36.56,0,-35809,49230,85039,13421,0,0,0,0,0,,0,0
18,05-04-18,28,6:45,7:00,41.92,,0,41.92,41.92,1,-75401,61838,137239,-13563,0,0,2450,0,0,,2450,2450
18,05-04-18,29,7:00,7:15,41.92,29.92,0,29.92,29.92,-1,-33889,117057,150946,83168,0,-4293,60,0,0,,4353,-4233
18,05-04-18,30,7:15,7:30,,,0,36.85,36.85,0,-33562,81816,115378,48254,0,-95,0,0,0,,95,-95
18,05-04-18,31,7:30,7:45,41.92,36.94,0,41.92,36.71,2,-39496,40393,79889,897,0,-362,434,0,0,,796,72
18,05-04-18,32,7:45,8:00,41.92,,0,41.92,41.92,1,-39506,39747,79253,241,0,0,2074,0,0,,2074,2074
18,05-04-18,33,8:00,8:15,35.12,35.98,0,36.85,35.98,2,-51692,82178,133870,30486,0,-112,183,0,0,,295,71
18,05-04-18,34,8:15,8:30,,,0,36.8,36.8,0,-45805,66949,112754,21144,0,0,0,0,0,,0,0
18,05-04-18,35,8:30,8:45,,,0,36.75,36.75,0,-35976,61551,97527,25575,0,0,0,0,0,,0,0
18,05-04-18,36,8:45,9:00,,,0,36.72,36.72,0,-38718,59399,98117,20681,0,0,0,0,0,,0,0
18,05-04-18,37,9:00,9:15,,,0,36.75,36.75,0,-57620,68206,125826,10586,0,0,0,0,0,,0,0
18,05-04-18,38,9:15,9:30,,,0,36.75,36.75,0,-57044,70491,127535,13447,0,0,0,0,0,,0,0
18,05-04-18,39,9:30,9:45,,,0,36.76,36.76,0,-48123,79303,127426,31180,0,0,0,0,0,,0,0
18,05-04-18,40,9:45,10:00,,,0,36.77,36.77,0,-39144,78482,117626,39338,0,0,0,0,0,,0,0
18,05-04-18,41,10:00,10:15,65.48,,0,65.48,65.48,1,-94158,59138,153296,-35020,0,0,11075,0,0,,11075,11075
18,05-04-18,42,10:15,10:30,71.37,,0,71.37,71.37,1,-64613,64283,128896,-330,0,0,24588,0,0,,24588,24588
18,05-04-18,43,10:30,10:45,71.37,37.25,0,37.25,37.25,-1,-49813,80236,130049,30423,0,-2057,672,0,0,,2729,-1385
18,05-04-18,44,10:45,11:00,,33.92,0,33.92,33.92,-1,-57797,80810,138607,23013,0,-4143,0,0,0,,4143,-4143
18,05-04-18,45,11:00,11:15,,38.23,0,38.23,38.23,-1,-78480,76474,154954,-2006,0,-1258,0,0,0,,1258,-1258
18,05-04-18,46,11:15,11:30,,,0,36.73,36.73,0,-83797,79302,163099,-4495,0,0,0,0,0,,0,0
18,05-04-18,47,11:30,11:45,,,0,36.73,36.73,0,-75149,90784,165933,15635,0,0,0,0,0,,0,0
18,05-04-18,48,11:45,12:00,,,0,36.27,36.27,0,-66909,105598,172507,38689,0,0,0,0,0,,0,0
18,05-04-18,49,12:00,12:15,,33.92,0,33.92,33.92,-1,-66091,100939,167030,34848,0,-171,0,0,0,,171,-171
18,05-04-18,50,12:15,12:30,,33.92,0,33.92,33.92,-1,-51553,76072,127625,24519,0,-6023,0,0,0,,6023,-6023
18,05-04-18,51,12:30,12:45,,29.92,0,29.92,29.92,-1,-43956,74396,118352,30440,0,-9748,0,0,0,,9748,-9748
18,05-04-18,52,12:45,13:00,,33.92,0,33.92,33.92,-1,-65348,76930,142278,11582,0,-5169,0,0,0,,5169,-5169
18,05-04-18,53,13:00,13:15,,33.92,0,33.92,33.92,-1,-58131,102294,160425,44163,0,-3251,0,0,0,,3251,-3251
18,05-04-18,54,13:15,13:30,,,0,36.23,36.23,0,-61415,77821,139236,16406,0,0,0,0,0,,0,0
18,05-04-18,55,13:30,13:45,,,0,36.24,36.24,0,-64366,81085,145451,16719,0,0,0,0,0,,0,0
18,05-04-18,56,13:45,14:00,,33.92,0,33.92,33.92,-1,-67313,79696,147009,12383,0,-2235,0,0,0,,2235,-2235
18,05-04-18,57,14:00,14:15,35.06,37.65,0,35.06,35.06,1,-63344,71238,134582,7894,0,-1308,154,0,0,,1462,-1154
18,05-04-18,58,14:15,14:30,35.03,,0,35.03,35.03,1,-52407,69609,122016,17202,0,0,500,0,0,,500,500
18,05-04-18,59,14:30,14:45,35.01,,0,35.01,35.01,1,-53726,68508,122234,14782,0,0,628,0,0,,628,628
18,05-04-18,60,14:45,15:00,35.01,33.92,0,33.92,33.92,-1,-57738,70767,128505,13029,0,-1227,6,0,0,,1233,-1221
18,05-04-18,61,15:00,15:15,,33.92,0,33.92,33.92,-1,-46427,109902,156329,63475,0,-1691,0,0,0,,1691,-1691
18,05-04-18,62,15:15,15:30,,,0,37.79,37.79,0,-46271,90517,136788,44246,0,0,0,0,0,,0,0
18,05-04-18,63,15:30,15:45,,,0,37.78,37.78,0,-45547,83128,128675,37581,0,0,0,0,0,,0,0
18,05-04-18,64,15:45,16:00,,,0,37.79,37.79,0,-44975,97277,142252,52302,0,0,0,0,0,,0,0
18,05-04-18,65,16:00,16:15,,12.86,0,12.86,12.86,-1,-31625,76997,108622,45372,0,-17641,0,0,0,,17641,-17641
18,05-04-18,66,16:15,16:30,,16.46,0,16.46,16.46,-1,-35720,73161,108881,37441,0,-44570,0,0,0,,44570,-44570
18,05-04-18,67,16:30,16:45,,29.92,0,29.92,29.92,-1,-37458,74017,111475,36559,0,-34856,0,0,0,,34856,-34856
18,05-04-18,68,16:45,17:00,,33.92,0,33.92,33.92,-1,-50986,69008,119994,18022,0,-25386,0,0,0,,25386,-25386
18,05-04-18,69,17:00,17:15,,38.17,0,38.17,38.17,-1,-94385,105407,199792,11022,0,-6103,0,0,0,,6103,-6103
18,05-04-18,70,17:15,17:30,44.77,38.17,0,44.77,44.77,1,-93458,66349,159807,-27109,0,-75,861,0,0,,936,786
18,05-04-18,71,17:30,17:45,135.12,,0,135.12,135.12,1,-128511,56423,184934,-72088,0,0,48202,0,0,,48202,48202
18,05-04-18,72,17:45,18:00,60.06,,0,60.06,60.06,1,-92934,64973,157907,-27961,0,0,42577,0,0,,42577,42577
18,05-04-18,73,18:00,18:15,39.94,36.16,0,39.94,36.16,2,-39977,51455,91432,11478,0,-336,7996,0,0,,8332,7660
18,05-04-18,74,18:15,18:30,,36.84,0,36.84,36.84,-1,-40173,65747,105920,25574,0,-147,0,0,0,,147,-147
18,05-04-18,75,18:30,18:45,,,0,36.66,36.66,0,-51420,79527,130947,28107,0,0,0,0,0,,0,0
18,05-04-18,76,18:45,19:00,39.58,,0,39.58,39.58,1,-67859,62397,130256,-5462,0,0,902,0,0,,902,902
18,05-04-18,77,19:00,19:15,41.92,,0,41.92,41.92,1,-54925,46743,101668,-8182,0,0,2586,0,0,,2586,2586
18,05-04-18,78,19:15,19:30,37.92,,0,37.92,37.92,1,-54790,62084,116874,7294,0,0,1740,0,0,,1740,1740
18,05-04-18,79,19:30,19:45,39.72,,0,39.72,39.72,1,-58594,55969,114563,-2625,0,0,1267,0,0,,1267,1267
18,05-04-18,80,19:45,20:00,41.92,,0,41.92,41.92,1,-56662,64295,120957,7633,0,0,5680,0,0,,5680,5680
18,05-04-18,81,20:00,20:15,37.92,,0,37.92,37.92,1,-61280,77725,139005,16445,0,0,562,0,0,,562,562
18,05-04-18,82,20:15,20:30,37.92,,0,37.92,37.92,1,-62678,57076,119754,-5602,0,0,905,0,0,,905,905
18,05-04-18,83,20:30,20:45,,38.01,0,38.01,38.01,-1,-54995,62836,117831,7841,0,-50,0,0,0,,50,-50
18,05-04-18,84,20:45,21:00,,36.09,0,36.09,36.09,-1,-54917,65492,120409,10575,0,-507,0,0,0,,507,-507
18,05-04-18,85,21:00,21:15,,36.54,0,36.54,36.54,-1,-55222,63137,118359,7915,0,-208,0,0,0,,208,-208
18,05-04-18,86,21:15,21:30,37.92,,0,37.92,37.92,1,-62435,47084,109519,-15351,0,0,796,0,0,,796,796
18,05-04-18,87,21:30,21:45,48.29,,0,48.29,48.29,1,-66198,40339,106537,-25859,0,0,9845,0,0,,9845,9845
18,05-04-18,88,21:45,22:00,37.92,36.67,0,36.67,36.67,-1,-55359,55682,111041,323,0,-486,4006,0,0,,4492,3520
18,05-04-18,89,22:00,22:15,54.9,36.16,0,54.9,36.16,2,-49317,21688,71005,-27629,0,-922,8287,0,0,,9209,7365
18,05-04-18,90,22:15,22:30,37.92,,0,37.92,37.92,1,-28507,30860,59367,2353,0,0,4204,0,0,,4204,4204
18,05-04-18,91,22:30,22:45,37.92,22.29,0,22.29,22.29,-1,-6334,53230,59564,46896,0,-18911,248,0,0,,19159,-18663
18,05-04-18,92,22:45,23:00,,33.92,0,33.92,33.92,-1,-24450,66987,91437,42537,0,-26567,0,0,0,,26567,-26567
18,05-04-18,93,23:00,23:15,135.12,35.78,0,135.12,135.12,1,-90761,27575,118336,-63186,0,-11159,14179,0,0,,25338,3020
18,05-04-18,94,23:15,23:30,145.12,37.6,0,145.12,36.79,2,-62266,49450,111716,-12816,0,-26,36539,0,0,,36565,36513
18,05-04-18,95,23:30,23:45,145.12,17.12,0,17.12,17.12,-1,-27347,83196,110543,55849,0,-7219,574,0,0,,7793,-6645
18,05-04-18,96,23:45,0:00,,15.94,0,15.94,15.94,-1,-56135,85195,141330,29060,0,-41012,0,0,0,,41012,-41012
19,05-05-18,1,0:00,0:15,42.06,34.06,0,42.06,34.06,2,-41012,40793,81805,-219,0,-9094,2818,0,0,,11912,-6276
19,05-05-18,2,0:15,0:30,37.97,,0,37.97,37.97,1,-63440,60984,124424,-2456,0,0,2520,0,0,,2520,2520
19,05-05-18,3,0:30,0:45,37.97,31.69,0,31.69,31.69,-1,-42554,58321,100875,15767,0,-2464,201,0,0,,2665,-2263
19,05-05-18,4,0:45,1:00,,30.06,0,30.06,30.06,-1,-35664,47265,82929,11601,0,-7825,0,0,0,,7825,-7825
19,05-05-18,5,1:00,1:15,,27.66,0,27.66,27.66,-1,-35676,86667,122343,50991,0,-12134,0,0,0,,12134,-12134
19,05-05-18,6,1:15,1:30,,37.05,0,37.05,37.05,-1,-48061,55299,103360,7238,0,-409,0,0,0,,409,-409
19,05-05-18,7,1:30,1:45,,34.06,0,34.06,34.06,-1,-28699,41391,70090,12692,0,-1733,0,0,0,,1733,-1733
19,05-05-18,8,1:45,2:00,,34.03,0,34.03,34.03,-1,-35373,45676,81049,10303,0,-4331,0,0,0,,4331,-4331
19,05-05-18,9,2:00,2:15,38.06,34.06,0,38.06,38.06,1,-38442,38057,76499,-385,0,-2670,779,0,0,,3449,-1891
19,05-05-18,10,2:15,2:30,42.06,,0,42.06,42.06,1,-32669,26640,59309,-6029,0,0,4993,0,0,,4993,4993
19,05-05-18,11,2:30,2:45,34.72,,0,34.72,34.72,1,-36120,31224,67344,-4896,0,0,466,0,0,,466,466
19,05-05-18,12,2:45,3:00,36.36,,0,36.36,36.36,1,-39472,32521,71993,-6951,0,0,900,0,0,,900,900
19,05-05-18,13,3:00,3:15,37.77,,0,37.77,37.77,1,-35400,26228,61628,-9172,0,0,927,0,0,,927,927
19,05-05-18,14,3:15,3:30,34.83,,0,34.83,34.83,1,-36636,34389,71025,-2247,0,0,345,0,0,,345,345
19,05-05-18,15,3:30,3:45,34.02,,0,34.02,34.02,1,-36082,45056,81138,8974,0,0,22,0,0,,22,22
19,05-05-18,16,3:45,4:00,,,0,35.94,35.94,0,-33693,47193,80886,13500,0,0,0,0,0,,0,0
19,05-05-18,17,4:00,4:15,42.06,,0,42.06,42.06,1,-47409,30944,78353,-16465,0,0,1985,0,0,,1985,1985
19,05-05-18,18,4:15,4:30,42.06,,0,42.06,42.06,1,-39742,32463,72205,-7279,0,0,6906,0,0,,6906,6906
19,05-05-18,19,4:30,4:45,,,0,36.09,36.09,0,-31850,33763,65613,1913,0,0,648,0,0,,648,648
19,05-05-18,20,4:45,5:00,38.06,,0,38.06,38.06,1,-29380,24460,53840,-4920,0,0,1505,0,0,,1505,1505
19,05-05-18,21,5:00,5:15,35.26,,0,35.26,35.26,1,-23714,36413,60127,12699,0,0,1325,0,0,,1325,1325
19,05-05-18,22,5:15,5:30,34.02,,0,34.02,34.02,1,-23666,34817,58483,11151,0,0,201,0,0,,201,201
19,05-05-18,23,5:30,5:45,,,0,35.57,35.57,0,-37238,42910,80148,5672,0,0,0,0,0,,0,0
19,05-05-18,24,5:45,6:00,,24.06,0,24.06,24.06,-1,-17255,61598,78853,44343,0,-3054,0,0,0,,3054,-3054
19,05-05-18,25,6:00,6:15,,29.96,0,29.96,29.96,-1,-25882,77143,103025,51261,0,-20674,0,0,0,,20674,-20674
19,05-05-18,26,6:15,6:30,,29.03,0,29.03,29.03,-1,-24288,70357,94645,46069,0,-22355,0,0,0,,22355,-22355
19,05-05-18,27,6:30,6:45,,37.73,0,37.73,37.73,-1,-33170,39677,72847,6507,0,-1772,0,0,0,,1772,-1772
19,05-05-18,28,6:45,7:00,,,0,36.34,36.34,0,-26321,43192,69513,16871,0,0,0,0,0,,0,0
19,05-05-18,29,7:00,7:15,,,0,36.38,36.38,0,-72948,83434,156382,10486,0,0,0,0,0,,0,0
19,05-05-18,30,7:15,7:30,46.08,,0,46.08,46.08,1,-71058,48564,119622,-22494,0,0,7544,0,0,,7544,7544
19,05-05-18,31,7:30,7:45,41.96,,0,41.96,41.96,1,-59485,47305,106790,-12180,0,0,12541,0,0,,12541,12541
19,05-05-18,32,7:45,8:00,41.96,,0,41.96,41.96,1,-47896,27036,74932,-20860,0,0,12969,0,0,,12969,12969
19,05-05-18,33,8:00,8:15,37.96,,0,37.96,37.96,1,-60988,62364,123352,1376,0,0,5568,0,0,,5568,5568
19,05-05-18,34,8:15,8:30,41.96,,0,41.96,41.96,1,-61504,48945,110449,-12559,0,0,2266,0,0,,2266,2266
19,05-05-18,35,8:30,8:45,44.96,,0,44.96,44.96,1,-55280,25301,80581,-29979,0,0,22827,0,0,,22827,22827
19,05-05-18,36,8:45,9:00,41.96,,0,41.96,41.96,1,-53863,29862,83725,-24001,0,0,21538,0,0,,21538,21538
19,05-05-18,37,9:00,9:15,37.96,29.96,0,29.96,29.96,-1,-54732,72368,127100,17636,0,-1969,6962,0,0,,8931,4993
19,05-05-18,38,9:15,9:30,41.96,29.96,0,41.96,41.96,1,-68884,54319,123203,-14565,0,-2302,652,0,0,,2954,-1650
19,05-05-18,39,9:30,9:45,102.95,,0,102.95,102.95,1,-105214,39688,144902,-65526,0,0,34719,0,0,,34719,34719
19,05-05-18,40,9:45,10:00,45.71,,0,45.71,45.71,1,-84736,52517,137253,-32219,0,0,29650,0,0,,29650,29650
19,05-05-18,41,10:00,10:15,45.71,37.31,0,37.31,37.31,-1,-51190,54548,105738,3358,0,-86,3812,0,0,,3898,3726
19,05-05-18,42,10:15,10:30,34.57,,0,34.57,34.57,1,-60122,50739,110861,-9383,0,0,310,0,0,,310,310
19,05-05-18,43,10:30,10:45,,29.96,0,29.96,29.96,-1,-49185,57886,107071,8701,0,-1529,0,0,0,,1529,-1529
19,05-05-18,44,10:45,11:00,,29.96,0,29.96,29.96,-1,-43797,65923,109720,22126,0,-7108,0,0,0,,7108,-7108
19,05-05-18,45,11:00,11:15,41.96,33.96,0,41.96,33.96,2,-67495,48056,115551,-19439,0,-3788,3359,0,0,,7147,-429
19,05-05-18,46,11:15,11:30,41.96,33.96,0,33.96,33.96,-1,-55603,59457,115060,3854,0,-563,7046,0,0,,7609,6483
19,05-05-18,47,11:30,11:45,,14.51,0,14.51,14.51,-1,-47048,88917,135965,41869,0,-15200,0,0,0,,15200,-15200
19,05-05-18,48,11:45,12:00,,11.56,0,11.56,11.56,-1,-49518,128107,177625,78589,0,-43882,0,0,0,,43882,-43882
19,05-05-18,49,12:00,12:15,,23.96,0,23.96,23.96,-1,-46617,100909,147526,54292,0,-31631,0,0,0,,31631,-31631
19,05-05-18,50,12:15,12:30,,33.96,0,33.96,33.96,-1,-51145,116665,167810,65520,0,-6276,0,0,0,,6276,-6276
19,05-05-18,51,12:30,12:45,,33.96,0,33.96,33.96,-1,-46535,141483,188018,94948,0,-2207,0,0,0,,2207,-2207
19,05-05-18,52,12:45,13:00,,-150.03,0,-150.03,-150.03,-1,-53982,151388,205370,97406,0,-32099,0,0,0,,32099,-32099
19,05-05-18,53,13:00,13:15,,23.96,0,23.96,23.96,-1,-89203,118252,207455,29049,0,-20085,0,0,0,,20085,-20085
19,05-05-18,54,13:15,13:30,,23.96,0,23.96,23.96,-1,-84136,120522,204658,36386,0,-2858,0,0,0,,2858,-2858
19,05-05-18,55,13:30,13:45,,18.2,0,18.2,18.2,-1,-80471,132471,212942,52000,0,-30117,0,0,0,,30117,-30117
19,05-05-18,56,13:45,14:00,,23.96,0,23.96,23.96,-1,-80467,132401,212868,51934,0,-41778,0,0,0,,41778,-41778
19,05-05-18,57,14:00,14:15,37.96,29.96,0,37.96,37.96,1,-89344,74130,163474,-15214,0,-20419,580,0,0,,20999,-19839
19,05-05-18,58,14:15,14:30,,,0,35.27,35.27,0,-98345,72365,170710,-25980,0,-88,187,0,0,,275,99
19,05-05-18,59,14:30,14:45,34.94,,0,34.94,34.94,1,-91857,69332,161189,-22525,0,0,83,0,0,,83,83
19,05-05-18,60,14:45,15:00,,36.61,0,36.61,36.61,-1,-77019,73673,150692,-3346,0,-20,0,0,0,,20,-20
19,05-05-18,61,15:00,15:15,,36.35,0,36.35,36.35,-1,-69578,60347,129925,-9231,0,-312,0,0,0,,312,-312
19,05-05-18,62,15:15,15:30,,33.96,0,33.96,33.96,-1,-66677,66217,132894,-460,0,-427,0,0,0,,427,-427
19,05-05-18,63,15:30,15:45,,23.96,0,23.96,23.96,-1,-57256,85443,142699,28187,0,-12261,0,0,0,,12261,-12261
19,05-05-18,64,15:45,16:00,,31.73,0,31.73,31.73,-1,-60723,72109,132832,11386,0,-9861,0,0,0,,9861,-9861
19,05-05-18,65,16:00,16:15,,23.96,0,23.96,23.96,-1,-28830,96150,124980,67320,0,-24706,0,0,0,,24706,-24706
19,05-05-18,66,16:15,16:30,,28.03,0,28.03,28.03,-1,-34233,88952,123185,54719,0,-34062,0,0,0,,34062,-34062
19,05-05-18,67,16:30,16:45,,30.44,0,30.44,30.44,-1,-50155,73392,123547,23237,0,-16505,0,0,0,,16505,-16505
19,05-05-18,68,16:45,17:00,37.96,30.44,0,37.96,37.96,1,-54725,55596,110321,871,0,-481,8,0,0,,489,-473
19,05-05-18,69,17:00,17:15,,19.45,0,19.45,19.45,-1,-24790,139364,164154,114574,0,-8362,0,0,0,,8362,-8362
19,05-05-18,70,17:15,17:30,,-9.49,0,-9.49,-9.49,-1,-39011,123382,162393,84371,0,-29431,0,0,0,,29431,-29431
19,05-05-18,71,17:30,17:45,,33.96,0,33.96,33.96,-1,-37474,102657,140131,65183,0,-11101,0,0,0,,11101,-11101
19,05-05-18,72,17:45,18:00,,,0,36.03,36.03,0,-35294,91981,127275,56687,0,-435,0,0,0,,435,-435
19,05-05-18,73,18:00,18:15,,33.61,0,33.61,33.61,-1,-71453,84624,156077,13171,0,-627,0,0,0,,627,-627
19,05-05-18,74,18:15,18:30,,25.35,0,25.35,25.35,-1,-68072,88582,156654,20510,0,-16196,0,0,0,,16196,-16196
19,05-05-18,75,18:30,18:45,,33.96,0,33.96,33.96,-1,-63808,74759,138567,10951,0,-12298,0,0,0,,12298,-12298
19,05-05-18,76,18:45,19:00,,36.03,0,36.03,36.03,-1,-67865,62624,130489,-5241,0,-3751,0,0,0,,3751,-3751
19,05-05-18,77,19:00,19:15,,37.42,0,37.42,37.42,-1,-75637,73122,148759,-2515,0,-306,0,0,0,,306,-306
19,05-05-18,78,19:15,19:30,47.96,,0,47.96,47.96,1,-88615,60307,148922,-28308,0,0,7762,0,0,,7762,7762
19,05-05-18,79,19:30,19:45,53.81,,0,53.81,53.81,1,-94964,49553,144517,-45411,0,0,31230,0,0,,31230,31230
19,05-05-18,80,19:45,20:00,62.51,,0,62.51,62.51,1,-111760,45583,157343,-66177,0,0,48315,0,0,,48315,48315
19,05-05-18,81,20:00,20:15,37.96,36.06,0,37.96,36.06,2,-37096,47126,84222,10030,0,-213,17932,0,0,,18145,17719
19,05-05-18,82,20:15,20:30,37.96,36.06,0,37.96,37.96,1,-57439,41149,98588,-16290,0,-6,871,0,0,,877,865
19,05-05-18,83,20:30,20:45,41.96,,0,41.96,41.96,1,-50538,43202,93740,-7336,0,0,1679,0,0,,1679,1679
19,05-05-18,84,20:45,21:00,41.96,33.96,0,33.96,33.96,-1,-43610,52273,95883,8663,0,-2132,1,0,0,,2133,-2131
19,05-05-18,85,21:00,21:15,,30.85,0,30.85,30.85,-1,-46729,68563,115292,21834,0,-10592,0,0,0,,10592,-10592
19,05-05-18,86,21:15,21:30,37.96,34.09,0,37.96,37.96,1,-55083,55983,111066,900,0,-4985,17,0,0,,5002,-4968
19,05-05-18,87,21:30,21:45,41.96,34.09,0,41.96,41.96,1,-73581,52449,126030,-21132,0,-54,8381,0,0,,8435,8327
19,05-05-18,88,21:45,22:00,37.96,,0,37.96,37.96,1,-58926,61875,120801,2949,0,0,4805,0,0,,4805,4805
19,05-05-18,89,22:00,22:15,145.02,,0,145.02,145.02,1,-123173,57497,180670,-65676,0,0,21199,0,0,,21199,21199
19,05-05-18,90,22:15,22:30,47.96,,0,47.96,47.96,1,-88212,71348,159560,-16864,0,0,22138,0,0,,22138,22138
19,05-05-18,91,22:30,22:45,37.96,37.63,0,37.63,37.63,-1,-71693,70692,142385,-1001,0,-34,2295,0,0,,2329,2261
19,05-05-18,92,22:45,23:00,37.96,37.21,0,37.96,36.53,2,-62629,70864,133493,8235,0,-1723,2,0,0,,1725,-1721
19,05-05-18,93,23:00,23:15,149.43,37.21,0,149.43,149.43,1,-144282,40281,184563,-104001,0,-207,34298,0,0,,34505,34091
19,05-05-18,94,23:15,23:30,54.02,,0,54.02,54.02,1,-81868,50161,132029,-31707,0,0,43145,0,0,,43145,43145
19,05-05-18,95,23:30,23:45,54.02,35.49,0,35.49,35.49,-1,-59857,81954,141811,22097,0,-525,4701,0,0,,5226,4176
19,05-05-18,96,23:45,0:00,,23.4,0,23.4,23.4,-1,-50597,93046,143643,42449,0,-22038,0,0,0,,22038,-22038
19,05-06-18,1,0:00,0:15,86.89,28.78,0,86.89,86.89,1,-91527,37166,128693,-54361,0,-15977,3242,0,0,,19219,-12735
19,05-06-18,2,0:15,0:30,41.96,,0,41.96,41.96,1,-59289,34440,93729,-24849,0,0,4890,0,0,,4890,4890
19,05-06-18,3,0:30,0:45,41.96,29.96,0,29.96,29.96,-1,-42543,42745,85288,202,0,-751,1,0,0,,752,-750
19,05-06-18,4,0:45,1:00,,-9.11,0,-9.11,-9.11,-1,-40052,79629,119681,39577,0,-29745,0,0,0,,29745,-29745
19,05-06-18,5,1:00,1:15,,14.78,0,14.78,14.78,-1,-23695,95539,119234,71844,0,-28321,0,0,0,,28321,-28321
19,05-06-18,6,1:15,1:30,,-400,0,-400,-400,-1,-32709,94497,127206,61788,0,-36558,0,0,0,,36558,-36558
19,05-06-18,7,1:30,1:45,,-400,0,-400,-400,-1,-33134,112150,145284,79016,0,-58176,0,0,0,,58176,-58176
19,05-06-18,8,1:45,2:00,,-400,0,-400,-400,-1,-43952,130567,174519,86615,0,-72177,0,0,0,,72177,-72177
19,05-06-18,9,2:00,2:15,,-400,0,-400,-400,-1,-54133,101449,155582,47316,0,-57253,0,0,0,,57253,-57253
19,05-06-18,10,2:15,2:30,,13.24,0,13.24,13.24,-1,-62799,98727,161526,35928,0,-10259,0,0,0,,10259,-10259
19,05-06-18,11,2:30,2:45,,-400,0,-400,-400,-1,-48775,92612,141387,43837,0,-43047,0,0,0,,43047,-43047
19,05-06-18,12,2:45,3:00,,-400,0,-400,-400,-1,-58841,100822,159663,41981,0,-42623,0,0,0,,42623,-42623
19,05-06-18,13,3:00,3:15,,28.78,0,28.78,28.78,-1,-62718,103816,166534,41098,0,-19915,0,0,0,,19915,-19915
19,05-06-18,14,3:15,3:30,,14.89,0,14.89,14.89,-1,-56944,91924,148868,34980,0,-17343,0,0,0,,17343,-17343
19,05-06-18,15,3:30,3:45,,14.89,0,14.89,14.89,-1,-52992,81521,134513,28529,0,-28453,0,0,0,,28453,-28453
19,05-06-18,16,3:45,4:00,,23.96,0,23.96,23.96,-1,-47312,79174,126486,31862,0,-25753,0,0,0,,25753,-25753
19,05-06-18,17,4:00,4:15,37.96,29.96,0,37.96,37.96,1,-60949,61534,122483,585,0,-12667,48,0,0,,12715,-12619
19,05-06-18,18,4:15,4:30,37.96,33.96,0,33.96,33.96,-1,-56396,58592,114988,2196,0,-119,50,0,0,,169,-69
19,05-06-18,19,4:30,4:45,,33.96,0,33.96,33.96,-1,-52915,54661,107576,1746,0,-701,0,0,0,,701,-701
19,05-06-18,20,4:45,5:00,,29.96,0,29.96,29.96,-1,-52466,53262,105728,796,0,-2095,0,0,0,,2095,-2095
19,05-06-18,21,5:00,5:15,,-400,0,-400,-400,-1,-26837,91873,118710,65036,0,-27564,0,0,0,,27564,-27564
19,05-06-18,22,5:15,5:30,,14.89,0,14.89,14.89,-1,-31252,77903,109155,46651,0,-39746,0,0,0,,39746,-39746
19,05-06-18,23,5:30,5:45,,19.78,0,19.78,19.78,-1,-29858,68242,98100,38384,0,-39372,0,0,0,,39372,-39372
19,05-06-18,24,5:45,6:00,,23.96,0,23.96,23.96,-1,-19016,59252,78268,40236,0,-34383,0,0,0,,34383,-34383
19,05-06-18,25,6:00,6:15,,24.2,0,24.2,24.2,-1,-28434,48890,77324,20456,0,-30393,0,0,0,,30393,-30393
19,05-06-18,26,6:15,6:30,,24.2,0,24.2,24.2,-1,-22682,50865,73547,28183,0,-24167,0,0,0,,24167,-24167
19,05-06-18,27,6:30,6:45,,25.78,0,25.78,25.78,-1,-24135,43368,67503,19233,0,-22795,0,0,0,,22795,-22795
19,05-06-18,28,6:45,7:00,,30.2,0,30.2,30.2,-1,-31514,42510,74024,10996,0,-7637,0,0,0,,7637,-7637
19,05-06-18,29,7:00,7:15,,6.78,0,6.78,6.78,-1,-13459,63334,76793,49875,0,-16415,0,0,0,,16415,-16415
19,05-06-18,30,7:15,7:30,,24.2,0,24.2,24.2,-1,-25308,60427,85735,35119,0,-29216,0,0,0,,29216,-29216
19,05-06-18,31,7:30,7:45,,,0,34.66,34.66,0,-28445,69929,98374,41484,0,-5201,0,0,0,,5201,-5201
19,05-06-18,32,7:45,8:00,,34.2,0,34.2,34.2,-1,-15801,98221,114022,82420,0,-24,0,0,0,,24,-24
19,05-06-18,33,8:00,8:15,,-36.09,0,-36.09,-36.09,-1,-810,133131,133941,132321,0,-23379,0,0,0,,23379,-23379
19,05-06-18,34,8:15,8:30,,22.22,0,22.22,22.22,-1,-9005,104670,113675,95665,0,-27287,0,0,0,,27287,-27287
19,05-06-18,35,8:30,8:45,,30.2,0,30.2,30.2,-1,-12099,104024,116123,91925,0,-6121,0,0,0,,6121,-6121
19,05-06-18,36,8:45,9:00,,,0,34.16,34.16,0,-18307,99346,117653,81039,0,0,0,0,0,,0,0
19,05-06-18,37,9:00,9:15,,,0,34.66,34.66,0,-13540,90709,104249,77169,0,0,0,0,0,,0,0
19,05-06-18,38,9:15,9:30,,,0,34.66,34.66,0,-18387,92383,110770,73996,0,0,0,0,0,,0,0
19,05-06-18,39,9:30,9:45,,34.2,0,34.2,34.2,-1,-10915,100066,110981,89151,0,-1313,0,0,0,,1313,-1313
19,05-06-18,40,9:45,10:00,,14.91,0,14.91,14.91,-1,-7517,103775,111292,96258,0,-7637,0,0,0,,7637,-7637
19,05-06-18,41,10:00,10:15,,-400,0,-400,-400,-1,-37150,65345,102495,28195,0,-33535,0,0,0,,33535,-33535
19,05-06-18,42,10:15,10:30,,,0,34.66,34.66,0,-60432,53314,113746,-7118,0,-2957,0,0,0,,2957,-2957
19,05-06-18,43,10:30,10:45,,30.2,0,30.2,30.2,-1,-50673,55036,105709,4363,0,-1697,0,0,0,,1697,-1697
19,05-06-18,44,10:45,11:00,,25.78,0,25.78,25.78,-1,-38268,55907,94175,17639,0,-8524,0,0,0,,8524,-8524
19,05-06-18,45,11:00,11:15,,25.78,0,25.78,25.78,-1,-47010,73021,120031,26011,0,-21112,0,0,0,,21112,-21112
19,05-06-18,46,11:15,11:30,,30.2,0,30.2,30.2,-1,-45388,69057,114445,23669,0,-21624,0,0,0,,21624,-21624
19,05-06-18,47,11:30,11:45,,24.2,0,24.2,24.2,-1,-46420,71297,117717,24877,0,-27745,0,0,0,,27745,-27745
19,05-06-18,48,11:45,12:00,,24.2,0,24.2,24.2,-1,-42886,70333,113219,27447,0,-23775,0,0,0,,23775,-23775
19,05-06-18,49,12:00,12:15,38.2,30.2,0,38.2,38.2,1,-68656,58250,126906,-10406,0,-13800,284,0,0,,14084,-13516
19,05-06-18,50,12:15,12:30,38.2,34.2,0,38.2,34.2,2,-65911,64550,130461,-1361,0,-499,427,0,0,,926,-72
19,05-06-18,51,12:30,12:45,,30.2,0,30.2,30.2,-1,-53930,76828,130758,22898,0,-3162,0,0,0,,3162,-3162
19,05-06-18,52,12:45,13:00,,24.2,0,24.2,24.2,-1,-48577,81789,130366,33212,0,-13916,0,0,0,,13916,-13916
19,05-06-18,53,13:00,13:15,,31.78,0,31.78,31.78,-1,-60389,73538,133927,13149,0,-9721,0,0,0,,9721,-9721
19,05-06-18,54,13:15,13:30,,24.2,0,24.2,24.2,-1,-59818,73278,133096,13460,0,-2512,0,0,0,,2512,-2512
19,05-06-18,55,13:30,13:45,,14.91,0,14.91,14.91,-1,-50310,79332,129642,29022,0,-26461,0,0,0,,26461,-26461
19,05-06-18,56,13:45,14:00,,24.2,0,24.2,24.2,-1,-54603,85988,140591,31385,0,-29412,0,0,0,,29412,-29412
19,05-06-18,57,14:00,14:15,,1.11,0,1.11,1.11,-1,-24844,94095,118939,69251,0,-36089,0,0,0,,36089,-36089
19,05-06-18,58,14:15,14:30,,14.91,0,14.91,14.91,-1,-33320,92212,125532,58892,0,-42823,0,0,0,,42823,-42823
19,05-06-18,59,14:30,14:45,,-9.09,0,-9.09,-9.09,-1,-31216,95625,126841,64409,0,-51381,0,0,0,,51381,-51381
19,05-06-18,60,14:45,15:00,,-400,0,-400,-400,-1,-45654,80487,126141,34833,0,-55880,0,0,0,,55880,-55880
19,05-06-18,61,15:00,15:15,,-400,0,-400,-400,-1,-33613,105287,138900,71674,0,-50599,0,0,0,,50599,-50599
19,05-06-18,62,15:15,15:30,,14.63,0,14.63,14.63,-1,-39188,87463,126651,48275,0,-46620,0,0,0,,46620,-46620
19,05-06-18,63,15:30,15:45,,3.44,0,3.44,3.44,-1,-45391,92535,137926,47144,0,-47692,0,0,0,,47692,-47692
19,05-06-18,64,15:45,16:00,,14.63,0,14.63,14.63,-1,-49234,99175,148409,49941,0,-34928,0,0,0,,34928,-34928
19,05-06-18,65,16:00,16:15,,-400,0,-400,-400,-1,-43400,79641,123041,36241,0,-38205,0,0,0,,38205,-38205
19,05-06-18,66,16:15,16:30,,14.91,0,14.91,14.91,-1,-38490,85134,123624,46644,0,-19245,0,0,0,,19245,-19245
19,05-06-18,67,16:30,16:45,,14.91,0,14.91,14.91,-1,-49898,72966,122864,23068,0,-21698,0,0,0,,21698,-21698
19,05-06-18,68,16:45,17:00,42.2,14.91,0,42.2,42.2,1,-63891,58768,122659,-5123,0,-1357,92,0,0,,1449,-1265
19,05-06-18,69,17:00,17:15,,14.91,0,14.91,14.91,-1,-36301,118123,154424,81822,0,-5107,0,0,0,,5107,-5107
19,05-06-18,70,17:15,17:30,,20.7,0,20.7,20.7,-1,-37004,90244,127248,53240,0,-5615,0,0,0,,5615,-5615
19,05-06-18,71,17:30,17:45,,30.2,0,30.2,30.2,-1,-59743,71422,131165,11679,0,-3574,0,0,0,,3574,-3574
19,05-06-18,72,17:45,18:00,,34.2,0,34.2,34.2,-1,-66122,61046,127168,-5076,0,-67,0,0,0,,67,-67
19,05-06-18,73,18:00,18:15,,34.2,0,34.2,34.2,-1,-109721,75217,184938,-34504,0,-12,0,0,0,,12,-12
19,05-06-18,74,18:15,18:30,,29.78,0,29.78,29.78,-1,-64090,78761,142851,14671,0,-7038,0,0,0,,7038,-7038
19,05-06-18,75,18:30,18:45,,30.2,0,30.2,30.2,-1,-72842,79235,152077,6393,0,-7024,0,0,0,,7024,-7024
19,05-06-18,76,18:45,19:00,,30.2,0,30.2,30.2,-1,-64625,79704,144329,15079,0,-3234,0,0,0,,3234,-3234
19,05-06-18,77,19:00,19:15,,24.2,0,24.2,24.2,-1,-78378,97878,176256,19500,0,-13481,0,0,0,,13481,-13481
19,05-06-18,78,19:15,19:30,,30.2,0,30.2,30.2,-1,-84976,93893,178869,8917,0,-9567,0,0,0,,9567,-9567
19,05-06-18,79,19:30,19:45,,,0,34.66,34.66,0,-83355,97936,181291,14581,0,-758,0,0,0,,758,-758
19,05-06-18,80,19:45,20:00,38.2,,0,38.2,38.2,1,-99377,98416,197793,-961,0,0,865,0,0,,865,865
19,05-06-18,81,20:00,20:15,38.2,,0,38.2,38.2,1,-84605,89575,174180,4970,0,0,2108,0,0,,2108,2108
19,05-06-18,82,20:15,20:30,38.2,,0,38.2,38.2,1,-89272,91636,180908,2364,0,0,1055,0,0,,1055,1055
19,05-06-18,83,20:30,20:45,38.2,30.2,0,30.2,30.2,-1,-79812,98692,178504,18880,0,-997,445,0,0,,1442,-552
19,05-06-18,84,20:45,21:00,,24.2,0,24.2,24.2,-1,-75036,102480,177516,27444,0,-17585,0,0,0,,17585,-17585
19,05-06-18,85,21:00,21:15,,30.2,0,30.2,30.2,-1,-84985,104834,189819,19849,0,-21267,0,0,0,,21267,-21267
19,05-06-18,86,21:15,21:30,42.2,34.2,0,42.2,42.2,1,-89184,93074,182258,3890,0,-6243,687,0,0,,6930,-5556
19,05-06-18,87,21:30,21:45,67,,0,67,67,1,-111700,88249,199949,-23451,0,0,9119,0,0,,9119,9119
19,05-06-18,88,21:45,22:00,67,,0,67,67,1,-115422,91234,206656,-24188,0,0,22175,0,0,,22175,22175
19,05-06-18,89,22:00,22:15,50.12,,0,50.12,50.12,1,-121021,78636,199657,-42385,0,0,23541,0,0,,23541,23541
19,05-06-18,90,22:15,22:30,48.2,,0,48.2,48.2,1,-95247,87737,182984,-7510,0,0,21691,0,0,,21691,21691
19,05-06-18,91,22:30,22:45,48.2,-400,0,-400,-400,-1,-53434,98609,152043,45175,0,-19796,2132,0,0,,21928,-17664
19,05-06-18,92,22:45,23:00,,14.91,0,14.91,14.91,-1,-56848,110231,167079,53383,0,-44157,0,0,0,,44157,-44157
19,05-06-18,93,23:00,23:15,450,14.91,0,450,450,1,-140282,88840,229122,-51442,0,-17465,6634,0,0,,24099,-10831
19,05-06-18,94,23:15,23:30,450,14.91,0,14.91,14.91,-1,-61227,96955,158182,35728,0,-3242,605,0,0,,3847,-2637
19,05-06-18,95,23:30,23:45,,-400,0,-400,-400,-1,-63139,125991,189130,62852,0,-34160,0,0,0,,34160,-34160
19,05-06-18,96,23:45,0:00,,-400,0,-400,-400,-1,-68891,141179,210070,72288,0,-56282,0,0,0,,56282,-56282
19,05-07-18,1,0:00,0:15,145.02,-400,0,145.02,145.02,1,-125630,33267,158897,-92363,0,-14140,11804,0,0,,25944,-2336
19,05-07-18,2,0:15,0:30,145.02,,0,145.02,145.02,1,-76380,50286,126666,-26094,0,0,25864,0,0,,25864,25864
19,05-07-18,3,0:30,0:45,,,0,36.53,36.53,0,-52209,51236,103445,-973,0,0,1517,0,0,,1517,1517
19,05-07-18,4,0:45,1:00,38.2,36.85,0,38.2,36.53,2,-61335,52775,114110,-8560,0,-8,622,0,0,,630,614
19,05-07-18,5,1:00,1:15,,34.2,0,34.2,34.2,-1,-35009,59657,94666,24648,0,-268,0,0,0,,268,-268
19,05-07-18,6,1:15,1:30,,34.2,0,34.2,34.2,-1,-32243,52016,84259,19773,0,-3103,0,0,0,,3103,-3103
19,05-07-18,7,1:30,1:45,,30.9,0,30.9,30.9,-1,-32554,45647,78201,13093,0,-5334,0,0,0,,5334,-5334
19,05-07-18,8,1:45,2:00,,31.52,0,31.52,31.52,-1,-34854,42690,77544,7836,0,-9901,0,0,0,,9901,-9901
19,05-07-18,9,2:00,2:15,,34,0,34,34,-1,-13593,64166,77759,50573,0,-4229,0,0,0,,4229,-4229
19,05-07-18,10,2:15,2:30,,,0,36.53,36.53,0,-16980,49479,66459,32499,0,-31,0,0,0,,31,-31
19,05-07-18,11,2:30,2:45,,34.06,0,34.06,34.06,-1,-31190,53729,84919,22539,0,-2588,0,0,0,,2588,-2588
19,05-07-18,12,2:45,3:00,,30.83,0,30.83,30.83,-1,-30115,48076,78191,17961,0,-7193,0,0,0,,7193,-7193
19,05-07-18,13,3:00,3:15,,11.2,0,11.2,11.2,-1,-11655,88627,100282,76972,0,-22674,0,0,0,,22674,-22674
19,05-07-18,14,3:15,3:30,,11.2,0,11.2,11.2,-1,-16828,80513,97341,63685,0,-34450,0,0,0,,34450,-34450
19,05-07-18,15,3:30,3:45,,22.24,0,22.24,22.24,-1,-20779,85613,106392,64834,0,-37590,0,0,0,,37590,-37590
19,05-07-18,16,3:45,4:00,,11.2,0,11.2,11.2,-1,-33982,93948,127930,59966,0,-33738,0,0,0,,33738,-33738
19,05-07-18,17,4:00,4:15,,-3.03,0,-3.03,-3.03,-1,-22779,95919,118698,73140,0,-48115,0,0,0,,48115,-48115
19,05-07-18,18,4:15,4:30,,19.31,0,19.31,19.31,-1,-38355,84644,122999,46289,0,-44515,0,0,0,,44515,-44515
19,05-07-18,19,4:30,4:45,,34.2,0,34.2,34.2,-1,-40875,81158,122033,40283,0,-14582,0,0,0,,14582,-14582
19,05-07-18,20,4:45,5:00,,,0,35.25,35.25,0,-33534,85674,119208,52140,0,-107,0,0,0,,107,-107
19,05-07-18,21,5:00,5:15,,26.98,0,26.98,26.98,-1,-23664,126170,149834,102506,0,-6391,0,0,0,,6391,-6391
19,05-07-18,22,5:15,5:30,,26.2,0,26.2,26.2,-1,-15261,108280,123541,93019,0,-12008,0,0,0,,12008,-12008
19,05-07-18,23,5:30,5:45,,30.2,0,30.2,30.2,-1,-19118,107854,126972,88736,0,-8848,0,0,0,,8848,-8848
19,05-07-18,24,5:45,6:00,,-14.83,0,-14.83,-14.83,-1,-28471,154775,183246,126304,0,-14602,0,0,0,,14602,-14602
19,05-07-18,25,6:00,6:15,,-150.03,0,-150.03,-150.03,-1,-67959,158753,226712,90794,0,-77101,0,0,0,,77101,-77101
19,05-07-18,26,6:15,6:30,,-5.8,0,-5.8,-5.8,-1,-49597,137131,186728,87534,0,-87243,0,0,0,,87243,-87243
19,05-07-18,27,6:30,6:45,,26.2,0,26.2,26.2,-1,-42171,83737,125908,41566,0,-46677,0,0,0,,46677,-46677
19,05-07-18,28,6:45,7:00,35.16,26.2,0,35.16,35.16,1,-47559,64657,112216,17098,0,-4225,180,0,0,,4405,-4045
19,05-07-18,29,7:00,7:15,,,0,36.31,36.31,0,-120903,98549,219452,-22354,0,0,0,0,0,,0,0
19,05-07-18,30,7:15,7:30,95.02,,0,95.02,95.02,1,-76838,93938,170776,17100,0,0,11545,0,0,,11545,11545
19,05-07-18,31,7:30,7:45,145.02,,0,145.02,145.02,1,-52172,67629,119801,15457,0,0,41553,0,0,,41553,41553
19,05-07-18,32,7:45,8:00,62.04,35.25,0,35.25,35.25,-1,-53017,84085,137102,31068,0,-101,25444,0,0,,25545,25343
19,05-07-18,33,8:00,8:15,62.04,35.04,0,35.04,35.04,-1,-40738,109117,149855,68379,0,-1544,55,0,0,,1599,-1489
19,05-07-18,34,8:15,8:30,43.04,,0,43.04,43.04,1,-65207,54510,119717,-10697,0,0,1050,0,0,,1050,1050
19,05-07-18,35,8:30,8:45,40.37,,0,40.37,40.37,1,-57471,50958,108429,-6513,0,0,1530,0,0,,1530,1530
19,05-07-18,36,8:45,9:00,47.4,,0,47.4,47.4,1,-69951,44217,114168,-25734,0,0,2706,0,0,,2706,2706
19,05-07-18,37,9:00,9:15,63.9,,0,63.9,63.9,1,-92281,72593,164874,-19688,0,0,19698,0,0,,19698,19698
19,05-07-18,38,9:15,9:30,39.04,37.68,0,39.04,37.68,2,-86843,80170,167013,-6673,0,-12,2821,0,0,,2833,2809
19,05-07-18,39,9:30,9:45,39.93,,0,39.93,39.93,1,-78612,79936,158548,1324,0,0,1168,0,0,,1168,1168
19,05-07-18,40,9:45,10:00,39.04,,0,39.04,39.04,1,-59738,72953,132691,13215,0,0,157,0,0,,157,157
19,05-07-18,41,10:00,10:15,50.78,,0,50.78,50.78,1,-105086,71023,176109,-34063,0,0,12448,0,0,,12448,12448
19,05-07-18,42,10:15,10:30,51.21,,0,51.21,51.21,1,-96226,54507,150733,-41719,0,0,22606,0,0,,22606,22606
19,05-07-18,43,10:30,10:45,55.1,,0,55.1,55.1,1,-100592,56093,156685,-44499,0,0,23913,0,0,,23913,23913
19,05-07-18,44,10:45,11:00,51.32,,0,51.32,51.32,1,-104663,63621,168284,-41042,0,0,28467,0,0,,28467,28467
19,05-07-18,45,11:00,11:15,76.65,,0,76.65,76.65,1,-115433,50150,165583,-65283,0,0,44845,0,0,,44845,44845
19,05-07-18,46,11:15,11:30,63.9,,0,63.9,63.9,1,-119115,57738,176853,-61377,0,0,53130,0,0,,53130,53130
19,05-07-18,47,11:30,11:45,59.21,,0,59.21,59.21,1,-112830,63198,176028,-49632,0,0,43844,0,0,,43844,43844
19,05-07-18,48,11:45,12:00,57.52,,0,57.52,57.52,1,-111341,59545,170886,-51796,0,0,25340,0,0,,25340,25340
19,05-07-18,49,12:00,12:15,48.9,,0,48.9,48.9,1,-102659,64518,167177,-38141,0,0,32510,0,0,,32510,32510
19,05-07-18,50,12:15,12:30,46.02,,0,46.02,46.02,1,-91770,75478,167248,-16292,0,0,23530,0,0,,23530,23530
19,05-07-18,51,12:30,12:45,46.02,37.21,0,37.21,37.21,-1,-81910,94433,176343,12523,0,-465,2678,0,0,,3143,2213
19,05-07-18,52,12:45,13:00,,35.67,0,35.67,35.67,-1,-78758,88727,167485,9969,0,-1989,0,0,0,,1989,-1989
19,05-07-18,53,13:00,13:15,43.04,37.05,0,43.04,37.05,2,-80457,67380,147837,-13077,0,-1582,1770,0,0,,3352,188
19,05-07-18,54,13:15,13:30,40.57,,0,40.57,40.57,1,-89380,74568,163948,-14812,0,0,5898,0,0,,5898,5898
19,05-07-18,55,13:30,13:45,43.04,,0,43.04,43.04,1,-90257,74809,165066,-15448,0,0,9980,0,0,,9980,9980
19,05-07-18,56,13:45,14:00,53.87,,0,53.87,53.87,1,-101542,74881,176423,-26661,0,0,7824,0,0,,7824,7824
19,05-07-18,57,14:00,14:15,69.02,,0,69.02,69.02,1,-130728,87396,218124,-43332,0,0,29423,0,0,,29423,29423
19,05-07-18,58,14:15,14:30,47.51,,0,47.51,47.51,1,-120258,95332,215590,-24926,0,0,26868,0,0,,26868,26868
19,05-07-18,59,14:30,14:45,63.9,,0,63.9,63.9,1,-127820,89471,217291,-38349,0,0,19969,0,0,,19969,19969
19,05-07-18,60,14:45,15:00,69.02,,0,69.02,69.02,1,-135790,86538,222328,-49252,0,0,42129,0,0,,42129,42129
19,05-07-18,61,15:00,15:15,48.9,,0,48.9,48.9,1,-113859,83340,197199,-30519,0,0,22688,0,0,,22688,22688
19,05-07-18,62,15:15,15:30,43.02,,0,43.02,43.02,1,-119155,90934,210089,-28221,0,0,10374,0,0,,10374,10374
19,05-07-18,63,15:30,15:45,40.24,,0,40.24,40.24,1,-130881,86041,216922,-44840,0,0,3219,0,0,,3219,3219
19,05-07-18,64,15:45,16:00,44.9,,0,44.9,44.9,1,-141341,73876,215217,-67465,0,0,15275,0,0,,15275,15275
19,05-07-18,65,16:00,16:15,43.04,,0,43.04,43.04,1,-110880,72848,183728,-38032,0,0,15738,0,0,,15738,15738
19,05-07-18,66,16:15,16:30,88.9,,0,88.9,88.9,1,-120234,64762,184996,-55472,0,0,26426,0,0,,26426,26426
19,05-07-18,67,16:30,16:45,63.02,,0,63.02,63.02,1,-126241,75548,201789,-50693,0,0,35871,0,0,,35871,35871
19,05-07-18,68,16:45,17:00,107.02,,0,107.02,107.02,1,-134026,64126,198152,-69900,0,0,59964,0,0,,59964,59964
19,05-07-18,69,17:00,17:15,39.04,35.04,0,39.04,35.04,2,-101761,105363,207124,3602,0,-381,20467,0,0,,20848,20086
19,05-07-18,70,17:15,17:30,41.9,,0,41.9,41.9,1,-87040,70081,157121,-16959,0,0,6301,0,0,,6301,6301
19,05-07-18,71,17:30,17:45,39.04,,0,39.04,39.04,1,-77393,65214,142607,-12179,0,0,5560,0,0,,5560,5560
19,05-07-18,72,17:45,18:00,39.04,,0,39.04,39.04,1,-73037,70933,143970,-2104,0,0,2682,0,0,,2682,2682
19,05-07-18,73,18:00,18:15,39.56,,0,39.56,39.56,1,-90268,59639,149907,-30629,0,0,845,0,0,,845,845
19,05-07-18,74,18:15,18:30,,35.04,0,35.04,35.04,-1,-53962,64386,118348,10424,0,-1236,0,0,0,,1236,-1236
19,05-07-18,75,18:30,18:45,,37.11,0,37.11,37.11,-1,-62974,64254,127228,1280,0,-1121,0,0,0,,1121,-1121
19,05-07-18,76,18:45,19:00,39.29,,0,39.29,39.29,1,-73151,63586,136737,-9565,0,0,1190,0,0,,1190,1190
19,05-07-18,77,19:00,19:15,150.02,,0,150.02,150.02,1,-100202,25264,125466,-74938,0,0,24726,0,0,,24726,24726
19,05-07-18,78,19:15,19:30,150.02,,0,150.02,150.02,1,-102905,25100,128005,-77805,0,0,75606,0,0,,75606,75606
19,05-07-18,79,19:30,19:45,63.9,,0,63.9,63.9,1,-51285,26898,78183,-24387,0,0,42624,0,0,,42624,42624
19,05-07-18,80,19:45,20:00,48.9,,0,48.9,48.9,1,-50546,26139,76685,-24407,0,0,5131,0,0,,5131,5131
19,05-07-18,81,20:00,20:15,39.04,,0,39.04,39.04,1,-39571,62795,102366,23224,0,0,2111,0,0,,2111,2111
19,05-07-18,82,20:15,20:30,39.91,,0,39.91,39.91,1,-49376,42171,91547,-7205,0,0,2090,0,0,,2090,2090
19,05-07-18,83,20:30,20:45,39.91,35.04,0,35.04,35.04,-1,-40603,56101,96704,15498,0,-2127,999,0,0,,3126,-1128
19,05-07-18,84,20:45,21:00,,35.04,0,35.04,35.04,-1,-54515,53662,108177,-853,0,-3076,0,0,0,,3076,-3076
19,05-07-18,85,21:00,21:15,48.9,,0,48.9,48.9,1,-58441,46869,105310,-11572,0,0,1789,0,0,,1789,1789
19,05-07-18,86,21:15,21:30,48.9,,0,48.9,48.9,1,-64565,40807,105372,-23758,0,0,11154,0,0,,11154,11154
19,05-07-18,87,21:30,21:45,54.61,,0,54.61,54.61,1,-75814,35831,111645,-39983,0,0,23038,0,0,,23038,23038
19,05-07-18,88,21:45,22:00,63.9,,0,63.9,63.9,1,-76918,45861,122779,-31057,0,0,32181,0,0,,32181,32181
19,05-07-18,89,22:00,22:15,163.98,,0,163.98,163.98,1,-231054,22568,253622,-208486,0,0,66700,0,0,,66700,66700
19,05-07-18,90,22:15,22:30,220.5,,0,270.5,270.5,1,-149199,24731,173930,-124468,0,0,93129,2500,5417,,101046,101046
19,05-07-18,91,22:30,22:45,220.5,33.43,0,33.43,33.43,-1,-45272,85182,130454,39910,0,-537,27871,0,16251,,44659,43585
19,05-07-18,92,22:45,23:00,,35.04,0,35.04,35.04,-1,-25390,107988,133378,82598,0,-3129,0,0,5417,,8546,2288
19,05-07-18,93,23:00,23:15,151.02,30.64,0,151.02,30.64,2,-87660,31035,118695,-56625,0,-3003,10125,0,0,,13128,7122
19,05-07-18,94,23:15,23:30,151.02,36.69,0,151.02,36.69,2,-60535,37975,98510,-22560,0,-12,26695,0,0,,26707,26683
19,05-07-18,95,23:30,23:45,151.02,19.05,0,19.05,19.05,-1,-34494,73502,107996,39008,0,-8679,63,0,0,,8742,-8616
19,05-07-18,96,23:45,0:00,,20.7,0,20.7,20.7,-1,-50192,101056,151248,50864,0,-37032,0,0,0,,37032,-37032
19,05-08-18,1,0:00,0:15,135.12,28.78,0,135.12,135.12,1,-241405,164544,405949,-76861,0,-18445,13504,0,0,,31949,-4941
19,05-08-18,2,0:15,0:30,136.12,,0,136.12,136.12,1,-216506,150874,367380,-65632,0,0,65200,0,0,,65200,65200
19,05-08-18,3,0:30,0:45,45.97,39.35,0,39.35,39.35,-1,-166369,163509,329878,-2860,0,-109,20196,0,0,,20305,20087
19,05-08-18,4,0:45,1:00,45.97,38.51,0,38.51,38.51,-1,-177191,183095,360286,5904,0,-1628,2,0,0,,1630,-1626
19,05-08-18,5,1:00,1:15,146.12,38.51,0,146.12,146.12,1,-217467,151117,368584,-66350,0,-558,28585,0,0,,29143,28027
19,05-08-18,6,1:15,1:30,60.42,,0,60.42,60.42,1,-188717,155023,343740,-33694,0,0,47490,0,0,,47490,47490
19,05-08-18,7,1:30,1:45,38.62,39.69,0,39.69,39.69,-1,-168159,180376,348535,12217,0,-112,8692,0,0,,8804,8580
19,05-08-18,8,1:45,2:00,,34.7,0,34.7,34.7,-1,-161999,194745,356744,32746,0,-2423,0,0,0,,2423,-2423
19,05-08-18,9,2:00,2:15,60.98,31.05,0,60.98,60.98,1,-195351,171290,366641,-24061,0,-2647,5428,0,0,,8075,2781
19,05-08-18,10,2:15,2:30,63.71,,0,63.71,63.71,1,-184898,172508,357406,-12390,0,0,18968,0,0,,18968,18968
19,05-08-18,11,2:30,2:45,,,0,38.02,38.02,0,-177363,182164,359527,4801,0,0,886,0,0,,886,886
19,05-08-18,12,2:45,3:00,,35.78,0,35.78,35.78,-1,-173467,183931,357398,10464,0,-1963,0,0,0,,1963,-1963
19,05-08-18,13,3:00,3:15,,36.32,0,36.32,36.32,-1,-160078,190887,350965,30809,0,-1028,0,0,0,,1028,-1028
19,05-08-18,14,3:15,3:30,,35.05,0,35.05,35.05,-1,-149859,199179,349038,49320,0,-686,0,0,0,,686,-686
19,05-08-18,15,3:30,3:45,,35.05,0,35.05,35.05,-1,-136800,202959,339759,66159,0,-785,0,0,0,,785,-785
19,05-08-18,16,3:45,4:00,,34.32,0,34.32,34.32,-1,-132547,204830,337377,72283,0,-5333,0,0,0,,5333,-5333
19,05-08-18,17,4:00,4:15,,33.78,0,33.78,33.78,-1,-129039,234372,363411,105333,0,-15542,0,0,0,,15542,-15542
19,05-08-18,18,4:15,4:30,,33.78,0,33.78,33.78,-1,-132016,224182,356198,92166,0,-17580,0,0,0,,17580,-17580
19,05-08-18,19,4:30,4:45,,35.05,0,35.05,35.05,-1,-128773,223411,352184,94638,0,-8029,0,0,0,,8029,-8029
19,05-08-18,20,4:45,5:00,,35.05,0,35.05,35.05,-1,-130139,228165,358304,98026,0,-5766,0,0,0,,5766,-5766
19,05-08-18,21,5:00,5:15,,-150.78,0,-150.78,-150.78,-1,-132771,267570,400341,134799,0,-27910,0,0,0,,27910,-27910
19,05-08-18,22,5:15,5:30,,29.01,0,29.01,29.01,-1,-131426,259898,391324,128472,0,-34472,0,0,0,,34472,-34472
19,05-08-18,23,5:30,5:45,,31.48,0,31.48,31.48,-1,-142825,223485,366310,80660,0,-26978,0,0,0,,26978,-26978
19,05-08-18,24,5:45,6:00,,,0,37.65,37.65,0,-138791,210825,349616,72034,0,-2270,0,0,0,,2270,-2270
19,05-08-18,25,6:00,6:15,,10.4,0,10.4,10.4,-1,-170171,275529,445700,105358,0,-20321,0,0,0,,20321,-20321
19,05-08-18,26,6:15,6:30,,33.71,0,33.71,33.71,-1,-138167,233886,372053,95719,0,-25858,0,0,0,,25858,-25858
19,05-08-18,27,6:30,6:45,38.61,33.92,0,38.61,38.61,1,-136815,178026,314841,41211,0,-18214,114,0,0,,18328,-18100
19,05-08-18,28,6:45,7:00,65.68,33.92,0,65.68,65.68,1,-190654,157633,348287,-33021,0,-1129,18653,0,0,,19782,17524
19,05-08-18,29,7:00,7:15,38.61,-150.78,0,39.58,-150.78,2,-167330,306412,473742,139082,0,-20997,4558,0,0,,25555,-16439
19,05-08-18,30,7:15,7:30,,10.57,0,10.57,10.57,-1,-159912,265165,425077,105253,0,-35223,0,0,0,,35223,-35223
19,05-08-18,31,7:30,7:45,,29.92,0,29.92,29.92,-1,-154802,223074,377876,68272,0,-25124,0,0,0,,25124,-25124
19,05-08-18,32,7:45,8:00,,,0,39.5,39.5,0,-174840,227824,402664,52984,0,-1095,0,0,0,,1095,-1095
19,05-08-18,33,8:00,8:15,,,0,39.53,39.53,0,-213946,263932,477878,49986,0,0,0,0,0,,0,0
19,05-08-18,34,8:15,8:30,,,0,39.53,39.53,0,-213381,222978,436359,9597,0,0,0,0,0,,0,0
19,05-08-18,35,8:30,8:45,,,0,39.53,39.53,0,-202029,223035,425064,21006,0,0,0,0,0,,0,0
19,05-08-18,36,8:45,9:00,,,0,39.5,39.5,0,-201697,208261,409958,6564,0,0,0,0,0,,0,0
19,05-08-18,37,9:00,9:15,,,0,39.62,39.62,0,-182198,221520,403718,39322,0,0,0,0,0,,0,0
19,05-08-18,38,9:15,9:30,,,0,39.62,39.62,0,-182346,232715,415061,50369,0,0,0,0,0,,0,0
19,05-08-18,39,9:30,9:45,,,0,39.62,39.62,0,-179541,214495,394036,34954,0,0,0,0,0,,0,0
19,05-08-18,40,9:45,10:00,,,0,39.62,39.62,0,-183756,211712,395468,27956,0,0,0,0,0,,0,0
19,05-08-18,41,10:00,10:15,42.61,,0,42.61,42.61,1,-218260,193722,411982,-24538,0,0,5097,0,0,,5097,5097
19,05-08-18,42,10:15,10:30,42.61,,0,42.61,42.61,1,-218319,191888,410207,-26431,0,0,15584,0,0,,15584,15584
19,05-08-18,43,10:30,10:45,,,0,38.36,38.36,0,-209506,192423,401929,-17083,0,0,3772,0,0,,3772,3772
19,05-08-18,44,10:45,11:00,38.61,,0,38.61,38.61,1,-207204,204739,411943,-2465,0,0,18,0,0,,18,18
19,05-08-18,45,11:00,11:15,88.9,,0,88.9,88.9,1,-255469,193490,448959,-61979,0,0,18945,0,0,,18945,18945
19,05-08-18,46,11:15,11:30,73.95,,0,73.95,73.95,1,-251097,188277,439374,-62820,0,0,25197,0,0,,25197,25197
19,05-08-18,47,11:30,11:45,80.6,,0,80.6,80.6,1,-257479,206436,463915,-51043,0,0,35296,0,0,,35296,35296
19,05-08-18,48,11:45,12:00,40.12,,0,40.12,40.12,1,-248924,221047,469971,-27877,0,0,11451,0,0,,11451,11451
19,05-08-18,49,12:00,12:15,150.12,,0,150.12,150.12,1,-305275,193230,498505,-112045,0,0,44195,0,0,,44195,44195
19,05-08-18,50,12:15,12:30,140.12,,0,140.12,140.12,1,-255918,207011,462929,-48907,0,0,77329,0,0,,77329,77329
19,05-08-18,51,12:30,12:45,38.61,,0,38.61,38.61,1,-225128,228669,453797,3541,0,0,3882,0,0,,3882,3882
19,05-08-18,52,12:45,13:00,48.9,,0,48.9,48.9,1,-225189,200557,425746,-24632,0,0,12275,0,0,,12275,12275
19,05-08-18,53,13:00,13:15,68.12,,0,68.12,68.12,1,-234795,189317,424112,-45478,0,0,28099,0,0,,28099,28099
19,05-08-18,54,13:15,13:30,60.35,,0,60.35,60.35,1,-235858,192060,427918,-43798,0,0,44321,0,0,,44321,44321
19,05-08-18,55,13:30,13:45,56.12,,0,56.12,56.12,1,-242891,194932,437823,-47959,0,0,38842,0,0,,38842,38842
19,05-08-18,56,13:45,14:00,63.9,,0,63.9,63.9,1,-252881,194407,447288,-58474,0,0,47224,0,0,,47224,47224
19,05-08-18,57,14:00,14:15,42.61,,0,42.61,42.61,1,-214414,210832,425246,-3582,0,0,17830,0,0,,17830,17830
19,05-08-18,58,14:15,14:30,48.9,,0,48.9,48.9,1,-228208,205145,433353,-23063,0,0,9302,0,0,,9302,9302
19,05-08-18,59,14:30,14:45,52.41,,0,52.41,52.41,1,-243587,201637,445224,-41950,0,0,27195,0,0,,27195,27195
19,05-08-18,60,14:45,15:00,52.41,,0,52.41,52.41,1,-249014,202943,451957,-46071,0,0,34951,0,0,,34951,34951
19,05-08-18,61,15:00,15:15,63.9,,0,63.9,63.9,1,-258023,201772,459795,-56251,0,0,36282,0,0,,36282,36282
19,05-08-18,62,15:15,15:30,65.9,,0,65.9,65.9,1,-237150,205271,442421,-31879,0,0,37095,0,0,,37095,37095
19,05-08-18,63,15:30,15:45,65.9,,0,65.9,65.9,1,-243038,198678,441716,-44360,0,0,27315,0,0,,27315,27315
19,05-08-18,64,15:45,16:00,122.12,,0,122.12,122.12,1,-264225,189223,453448,-75002,0,0,62852,0,0,,62852,62852
19,05-08-18,65,16:00,16:15,63.12,36.38,0,36.38,36.38,-1,-201185,200952,402137,-233,0,-261,33396,0,0,,33657,33135
19,05-08-18,66,16:15,16:30,65.94,36.38,0,65.94,65.94,1,-223735,192004,415739,-31731,0,-32,7136,0,0,,7168,7104
19,05-08-18,67,16:30,16:45,115.9,,0,115.9,115.9,1,-244473,187964,432437,-56509,0,0,50184,0,0,,50184,50184
19,05-08-18,68,16:45,17:00,90.9,,0,90.9,90.9,1,-264579,187047,451626,-77532,0,0,57318,0,0,,57318,57318
19,05-08-18,69,17:00,17:15,63.12,,0,63.12,63.12,1,-260003,225743,485746,-34260,0,0,44240,0,0,,44240,44240
19,05-08-18,70,17:15,17:30,149.12,,0,149.12,149.12,1,-277149,196701,473850,-80448,0,0,54799,0,0,,54799,54799
19,05-08-18,71,17:30,17:45,149.12,,0,149.12,149.12,1,-285133,193633,478766,-91500,0,0,85718,0,0,,85718,85718
19,05-08-18,72,17:45,18:00,114.12,,0,114.12,114.12,1,-285274,200068,485342,-85206,0,0,85231,0,0,,85231,85231
19,05-08-18,73,18:00,18:15,51.3,,0,51.3,51.3,1,-231030,214703,445733,-16327,0,0,33146,0,0,,33146,33146
19,05-08-18,74,18:15,18:30,50.9,,0,50.9,50.9,1,-231429,211233,442662,-20196,0,0,4958,0,0,,4958,4958
19,05-08-18,75,18:30,18:45,50.9,,0,50.9,50.9,1,-237354,200520,437874,-36834,0,0,22200,0,0,,22200,22200
19,05-08-18,76,18:45,19:00,65.9,,0,65.9,65.9,1,-251483,197289,448772,-54194,0,0,40538,0,0,,40538,40538
19,05-08-18,77,19:00,19:15,90.9,,0,90.9,90.9,1,-250288,180695,430983,-69593,0,0,50394,0,0,,50394,50394
19,05-08-18,78,19:15,19:30,63.61,,0,63.61,63.61,1,-242757,192043,434800,-50714,0,0,55725,0,0,,55725,55725
19,05-08-18,79,19:30,19:45,48.12,,0,48.12,48.12,1,-234375,186970,421345,-47405,0,0,43193,0,0,,43193,43193
19,05-08-18,80,19:45,20:00,52.21,,0,52.21,52.21,1,-243039,190618,433657,-52421,0,0,45079,0,0,,45079,45079
19,05-08-18,81,20:00,20:15,50.9,,0,50.9,50.9,1,-195313,168482,363795,-26831,0,0,36355,0,0,,36355,36355
19,05-08-18,82,20:15,20:30,41.02,,0,41.02,41.02,1,-185985,172465,358450,-13520,0,0,7310,0,0,,7310,7310
19,05-08-18,83,20:30,20:45,39.92,,0,39.92,39.92,1,-176567,176136,352703,-431,0,0,1566,0,0,,1566,1566
19,05-08-18,84,20:45,21:00,39.92,40.32,0,40.32,40.32,-1,-183748,195164,378912,11416,0,-194,119,0,0,,313,-75
19,05-08-18,85,21:00,21:15,,39.8,0,39.8,39.8,-1,-190822,188042,378864,-2780,0,-1234,0,0,0,,1234,-1234
19,05-08-18,86,21:15,21:30,50.9,,0,50.9,50.9,1,-209688,179166,388854,-30522,0,0,10571,0,0,,10571,10571
19,05-08-18,87,21:30,21:45,53.12,,0,53.12,53.12,1,-223079,170032,393111,-53047,0,0,36473,0,0,,36473,36473
19,05-08-18,88,21:45,22:00,90.9,,0,90.9,90.9,1,-235684,181941,417625,-53743,0,0,49576,0,0,,49576,49576
19,05-08-18,89,22:00,22:15,173.1,,0,173.1,173.1,1,-323351,174981,498332,-148370,0,0,78191,0,0,,78191,78191
19,05-08-18,90,22:15,22:30,173.1,,0,173.1,173.1,1,-247819,185145,432964,-62674,0,0,82539,0,0,,82539,82539
19,05-08-18,91,22:30,22:45,173.1,38.29,0,38.29,38.29,-1,-167405,201319,368724,33914,0,-203,10653,0,0,,10856,10450
19,05-08-18,92,22:45,23:00,,,0,25.29,25.29,0,-171524,227092,398616,55568,0,0,0,0,0,,0,0
19,05-08-18,93,23:00,23:15,44.94,,0,44.94,44.94,1,-209100,208708,417808,-392,0,0,1609,0,0,,1609,1609
19,05-08-18,94,23:15,23:30,53.97,,0,53.97,53.97,1,-231374,200239,431613,-31135,0,0,21687,0,0,,21687,21687
19,05-08-18,95,23:30,23:45,39.92,36.92,0,36.92,36.92,-1,-197732,200796,398528,3064,0,-235,12656,0,0,,12891,12421
19,05-08-18,96,23:45,0:00,39.92,25.92,0,25.92,25.92,-1,-188163,226362,414525,38199,0,-21703,234,0,0,,21937,-21469
19,05-09-18,1,0:00,0:15,145.02,25.92,0,145.02,145.02,1,-136121,38703,174824,-97418,0,-12230,17525,0,0,,29755,5295
19,05-09-18,2,0:15,0:30,145.02,,0,145.02,145.02,1,-94275,36203,130478,-58072,0,0,67040,0,0,,67040,67040
19,05-09-18,3,0:30,0:45,37.92,37.71,0,37.92,25.42,2,-46257,45974,92231,-283,0,-425,8482,0,0,,8907,8057
19,05-09-18,4,0:45,1:00,,,0,25.42,25.42,0,-75829,62915,138744,-12914,0,0,0,0,0,,0,0
19,05-09-18,5,1:00,1:15,53.65,,0,53.65,53.65,1,-55563,62570,118133,7007,0,0,2213,0,0,,2213,2213
19,05-09-18,6,1:15,1:30,66.02,,0,66.02,66.02,1,-66208,60559,126767,-5649,0,0,21570,0,0,,21570,21570
19,05-09-18,7,1:30,1:45,,,0,23.74,23.74,0,-35987,63754,99741,27767,0,0,640,0,0,,640,640
19,05-09-18,8,1:45,2:00,,,0,23.74,23.74,0,-36839,68269,105108,31430,0,0,0,0,0,,0,0
19,05-09-18,9,2:00,2:15,37.92,,0,37.92,37.92,1,-48996,86385,135381,37389,0,0,269,0,0,,269,269
19,05-09-18,10,2:15,2:30,43.16,,0,43.16,43.16,1,-81271,73184,154455,-8087,0,0,7645,0,0,,7645,7645
19,05-09-18,11,2:30,2:45,42.02,,0,42.02,42.02,1,-84466,67431,151897,-17035,0,0,5843,0,0,,5843,5843
19,05-09-18,12,2:45,3:00,37,,0,37,37,1,-73970,65595,139565,-8375,0,0,3836,0,0,,3836,3836
19,05-09-18,13,3:00,3:15,36.02,,0,36.02,36.02,1,-65250,73847,139097,8597,0,0,1132,0,0,,1132,1132
19,05-09-18,14,3:15,3:30,,,0,24.83,24.83,0,-53244,68996,122240,15752,0,0,270,0,0,,270,270
19,05-09-18,15,3:30,3:45,,,0,24.83,24.83,0,-51941,69801,121742,17860,0,0,0,0,0,,0,0
19,05-09-18,16,3:45,4:00,,,0,36.84,36.84,0,-43618,99015,142633,55397,0,0,0,0,0,,0,0
19,05-09-18,17,4:00,4:15,,,0,35.26,35.26,0,-52077,28790,80867,-23287,0,0,0,0,0,,0,0
19,05-09-18,18,4:15,4:30,35.42,,0,35.42,35.42,1,-58303,24073,82376,-34230,0,0,282,0,0,,282,282
19,05-09-18,19,4:30,4:45,51.62,,0,51.62,51.62,1,-78192,7345,85537,-70847,0,0,15298,0,0,,15298,15298
19,05-09-18,20,4:45,5:00,53.6,,0,53.6,53.6,1,-96881,17901,114782,-78980,0,0,36692,0,0,,36692,36692
19,05-09-18,21,5:00,5:15,49.59,,0,49.59,49.59,1,-71775,19962,91737,-51813,0,0,33293,0,0,,33293,33293
19,05-09-18,22,5:15,5:30,40.32,,0,40.32,40.32,1,-78710,43149,121859,-35561,0,0,4299,0,0,,4299,4299
19,05-09-18,23,5:30,5:45,61.02,,0,61.02,61.02,1,-96806,21388,118194,-75418,0,0,21431,0,0,,21431,21431
19,05-09-18,24,5:45,6:00,86.54,,0,86.54,86.54,1,-93535,39869,133404,-53666,0,0,51665,0,0,,51665,51665
19,05-09-18,25,6:00,6:15,41.18,,0,41.18,41.18,1,-117410,55217,172627,-62193,0,0,16599,0,0,,16599,16599
19,05-09-18,26,6:15,6:30,,34.96,0,34.96,34.96,-1,-64160,41783,105943,-22377,0,-34,0,0,0,,34,-34
19,05-09-18,27,6:30,6:45,47.47,,0,47.47,47.47,1,-78778,34193,112971,-44585,0,0,1835,0,0,,1835,1835
19,05-09-18,28,6:45,7:00,87.07,,0,87.07,87.07,1,-84405,37465,121870,-46940,0,0,24142,0,0,,24142,24142
19,05-09-18,29,7:00,7:15,44.93,,0,44.93,44.93,1,-68466,64939,133405,-3527,0,0,6911,0,0,,6911,6911
19,05-09-18,30,7:15,7:30,,,0,36.44,36.44,0,-63830,78849,142679,15019,0,0,92,0,0,,92,92
19,05-09-18,31,7:30,7:45,90.14,,0,90.14,90.14,1,-93792,54411,148203,-39381,0,0,12795,0,0,,12795,12795
19,05-09-18,32,7:45,8:00,150.02,,0,150.02,150.02,1,-105333,31140,136473,-74193,0,0,66157,0,0,,66157,66157
19,05-09-18,33,8:00,8:15,150.02,36.08,0,36.08,36.08,-1,-50734,69947,120681,19213,0,-528,24457,0,0,,24985,23929
19,05-09-18,34,8:15,8:30,,,0,38.12,38.12,0,-58624,74306,132930,15682,0,0,0,0,0,,0,0
19,05-09-18,35,8:30,8:45,40.81,,0,40.81,40.81,1,-69026,51482,120508,-17544,0,0,3276,0,0,,3276,3276
19,05-09-18,36,8:45,9:00,53.73,,0,53.73,53.73,1,-74299,38097,112396,-36202,0,0,16098,0,0,,16098,16098
19,05-09-18,37,9:00,9:15,90.14,,0,90.14,90.14,1,-97619,49577,147196,-48042,0,0,21802,0,0,,21802,21802
19,05-09-18,38,9:15,9:30,50.14,,0,50.14,50.14,1,-89592,47492,137084,-42100,0,0,36423,0,0,,36423,36423
19,05-09-18,39,9:30,9:45,49.08,,0,49.08,49.08,1,-72754,45556,118310,-27198,0,0,31787,0,0,,31787,31787
19,05-09-18,40,9:45,10:00,66.4,,0,66.4,66.4,1,-66962,37119,104081,-29843,0,0,12344,0,0,,12344,12344
19,05-09-18,41,10:00,10:15,65.14,,0,65.14,65.14,1,-60665,42812,103477,-17853,0,0,14204,0,0,,14204,14204
19,05-09-18,42,10:15,10:30,,,0,36.96,36.96,0,-60908,50234,111142,-10674,0,0,2868,0,0,,2868,2868
19,05-09-18,43,10:30,10:45,,,0,37,37,0,-62911,56065,118976,-6846,0,0,0,0,0,,0,0
19,05-09-18,44,10:45,11:00,36.11,,0,36.11,36.11,1,-68900,51276,120176,-17624,0,0,811,0,0,,811,811
19,05-09-18,45,11:00,11:15,36.11,,0,36.11,36.11,1,-72112,74922,147034,2810,0,0,521,0,0,,521,521
19,05-09-18,46,11:15,11:30,36.11,,0,36.11,36.11,1,-83880,65497,149377,-18383,0,0,2256,0,0,,2256,2256
19,05-09-18,47,11:30,11:45,40.73,,0,40.73,40.73,1,-91997,69060,161057,-22937,0,0,404,0,0,,404,404
19,05-09-18,48,11:45,12:00,65.14,,0,65.14,65.14,1,-105117,67260,172377,-37857,0,0,13289,0,0,,13289,13289
19,05-09-18,49,12:00,12:15,63.02,,0,63.02,63.02,1,-107298,72706,180004,-34592,0,0,19724,0,0,,19724,19724
19,05-09-18,50,12:15,12:30,50.14,,0,50.14,50.14,1,-97573,65611,163184,-31962,0,0,31347,0,0,,31347,31347
19,05-09-18,51,12:30,12:45,41.36,35.76,0,35.76,35.76,-1,-78760,94792,173552,16032,0,-888,12640,0,0,,13528,11752
19,05-09-18,52,12:45,13:00,,,0,36.97,36.97,0,-80497,82634,163131,2137,0,-81,0,0,0,,81,-81
19,05-09-18,53,13:00,13:15,60.3,,0,60.3,60.3,1,-76286,43587,119873,-32699,0,0,12795,0,0,,12795,12795
19,05-09-18,54,13:15,13:30,59.02,,0,59.02,59.02,1,-88140,37061,125201,-51079,0,0,36980,0,0,,36980,36980
19,05-09-18,55,13:30,13:45,52.98,,0,52.98,52.98,1,-81165,35225,116390,-45940,0,0,44626,0,0,,44626,44626
19,05-09-18,56,13:45,14:00,48.02,,0,48.02,48.02,1,-73578,32358,105936,-41220,0,0,38327,0,0,,38327,38327
19,05-09-18,57,14:00,14:15,56.06,,0,56.06,56.06,1,-77959,22582,100541,-55377,0,0,39763,0,0,,39763,39763
19,05-09-18,58,14:15,14:30,55.91,,0,55.91,55.91,1,-79188,30835,110023,-48353,0,0,42406,0,0,,42406,42406
19,05-09-18,59,14:30,14:45,67.52,,0,67.52,67.52,1,-93934,32385,126319,-61549,0,0,50014,0,0,,50014,50014
19,05-09-18,60,14:45,15:00,67.52,,0,67.52,67.52,1,-97924,42880,140804,-55044,0,0,57293,0,0,,57293,57293
19,05-09-18,61,15:00,15:15,53.12,,0,53.12,53.12,1,-95749,45233,140982,-50516,0,0,43441,0,0,,43441,43441
19,05-09-18,62,15:15,15:30,65.14,,0,65.14,65.14,1,-91360,33092,124452,-58268,0,0,44200,0,0,,44200,44200
19,05-09-18,63,15:30,15:45,90.14,,0,90.14,90.14,1,-84362,28129,112491,-56233,0,0,56201,0,0,,56201,56201
19,05-09-18,64,15:45,16:00,59.7,,0,59.7,59.7,1,-98509,28423,126932,-70086,0,0,49373,0,0,,49373,49373
19,05-09-18,65,16:00,16:15,59.7,7.74,0,7.74,7.74,-1,-38183,177844,216027,139661,0,-6449,15662,0,0,,22111,9213
19,05-09-18,66,16:15,16:30,,34.03,0,34.03,34.03,-1,-60138,112245,172383,52107,0,-7905,0,0,0,,7905,-7905
19,05-09-18,67,16:30,16:45,,,0,36.78,36.78,0,-69518,99930,169448,30412,0,-533,0,0,0,,533,-533
19,05-09-18,68,16:45,17:00,,,0,36.62,36.62,0,-88586,100626,189212,12040,0,0,0,0,0,,0,0
19,05-09-18,69,17:00,17:15,36.11,,0,36.11,36.11,1,-73213,80408,153621,7195,0,0,128,0,0,,128,128
19,05-09-18,70,17:15,17:30,,,0,36.93,36.93,0,-58663,76595,135258,17932,0,0,0,0,0,,0,0
19,05-09-18,71,17:30,17:45,44.93,,0,44.93,44.93,1,-86380,73032,159412,-13348,0,0,4720,0,0,,4720,4720
19,05-09-18,72,17:45,18:00,44.93,,0,44.93,44.93,1,-100315,71037,171352,-29278,0,0,17013,0,0,,17013,17013
19,05-09-18,73,18:00,18:15,42.51,,0,42.51,42.51,1,-82240,38728,120968,-43512,0,0,10586,0,0,,10586,10586
19,05-09-18,74,18:15,18:30,44.93,,0,44.93,44.93,1,-66660,50103,116763,-16557,0,0,1447,0,0,,1447,1447
19,05-09-18,75,18:30,18:45,44.88,,0,44.88,44.88,1,-75023,52760,127783,-22263,0,0,11683,0,0,,11683,11683
19,05-09-18,76,18:45,19:00,40.44,,0,40.44,40.44,1,-70790,47058,117848,-23732,0,0,13163,0,0,,13163,13163
19,05-09-18,77,19:00,19:15,67.02,,0,67.02,67.02,1,-101551,40776,142327,-60775,0,0,21994,0,0,,21994,21994
19,05-09-18,78,19:15,19:30,50.53,,0,50.53,50.53,1,-95306,53843,149149,-41463,0,0,21064,0,0,,21064,21064
19,05-09-18,79,19:30,19:45,53.96,,0,53.96,53.96,1,-87457,44620,132077,-42837,0,0,33021,0,0,,33021,33021
19,05-09-18,80,19:45,20:00,47.41,,0,47.41,47.41,1,-77503,47503,125006,-30000,0,0,32005,0,0,,32005,32005
19,05-09-18,81,20:00,20:15,44.93,,0,44.93,44.93,1,-58837,26487,85324,-32350,0,0,24900,0,0,,24900,24900
19,05-09-18,82,20:15,20:30,53.71,,0,53.71,53.71,1,-64756,21671,86427,-43085,0,0,29651,0,0,,29651,29651
19,05-09-18,83,20:30,20:45,45.81,,0,45.81,45.81,1,-65259,23535,88794,-41724,0,0,28927,0,0,,28927,28927
19,05-09-18,84,20:45,21:00,36.81,,0,36.81,36.81,1,-53278,24355,77633,-28923,0,0,11058,0,0,,11058,11058
19,05-09-18,85,21:00,21:15,65.14,,0,65.14,65.14,1,-71681,39151,110832,-32530,0,0,8308,0,0,,8308,8308
19,05-09-18,86,21:15,21:30,44.93,,0,44.93,44.93,1,-72915,37350,110265,-35565,0,0,20917,0,0,,20917,20917
19,05-09-18,87,21:30,21:45,90.14,,0,90.14,90.14,1,-92478,24543,117021,-67935,0,0,35250,0,0,,35250,35250
19,05-09-18,88,21:45,22:00,50.14,,0,50.14,50.14,1,-86163,23463,109626,-62700,0,0,44896,0,0,,44896,44896
19,05-09-18,89,22:00,22:15,92.32,,0,92.32,92.32,1,-114893,23671,138564,-91222,0,0,53987,0,0,,53987,53987
19,05-09-18,90,22:15,22:30,65.14,,0,65.14,65.14,1,-72187,43539,115726,-28648,0,0,39918,0,0,,39918,39918
19,05-09-18,91,22:30,22:45,36.11,36.09,0,38.47,36.09,2,-55316,52257,107573,-3059,0,-68,1404,0,0,,1472,1336
19,05-09-18,92,22:45,23:00,36.11,,0,36.11,36.11,1,-56612,76280,132892,19668,0,0,740,0,0,,740,740
19,05-09-18,93,23:00,23:15,104.93,,0,104.93,104.93,1,-87175,35451,122626,-51724,0,0,19037,0,0,,19037,19037
19,05-09-18,94,23:15,23:30,50.14,,0,50.14,50.14,1,-43407,34688,78095,-8719,0,0,25785,0,0,,25785,25785
19,05-09-18,95,23:30,23:45,50.14,36.41,0,36.41,36.41,-1,-18377,63955,82332,45578,0,-593,1868,0,0,,2461,1275
19,05-09-18,96,23:45,0:00,,34.96,0,34.96,34.96,-1,-25066,64481,89547,39415,0,-2336,0,0,0,,2336,-2336
19,05-10-18,1,0:00,0:15,,,0,37.57,37.57,0,-35445,106329,141774,70884,0,-717,0,0,0,,717,-717
19,05-10-18,2,0:15,0:30,62.82,,0,62.82,62.82,1,-73941,41759,115700,-32182,0,0,7789,0,0,,7789,7789
19,05-10-18,3,0:30,0:45,46.86,,0,46.86,46.86,1,-84449,53822,138271,-30627,0,0,26768,0,0,,26768,26768
19,05-10-18,4,0:45,1:00,42.45,,0,42.45,42.45,1,-97978,72053,170031,-25925,0,0,17784,0,0,,17784,17784
19,05-10-18,5,1:00,1:15,42.45,30.86,0,30.86,30.86,-1,-35094,136718,171812,101624,0,-1564,4219,0,0,,5783,2655
19,05-10-18,6,1:15,1:30,,,0,36.61,36.61,0,-56049,60783,116832,4734,0,0,0,0,0,,0,0
19,05-10-18,7,1:30,1:45,,,0,36.66,36.66,0,-60114,64266,124380,4152,0,0,0,0,0,,0,0
19,05-10-18,8,1:45,2:00,,,0,37.07,37.07,0,-52029,70234,122263,18205,0,0,0,0,0,,0,0
19,05-10-18,9,2:00,2:15,40.38,,0,40.38,40.38,1,-63651,61406,125057,-2245,0,0,1082,0,0,,1082,1082
19,05-10-18,10,2:15,2:30,34.44,,0,34.44,34.44,1,-44762,52132,96894,7370,0,0,81,0,0,,81,81
19,05-10-18,11,2:30,2:45,36.12,,0,36.12,36.12,1,-36672,44202,80874,7530,0,0,362,0,0,,362,362
19,05-10-18,12,2:45,3:00,,,0,37.11,37.11,0,-38947,49685,88632,10738,0,0,0,0,0,,0,0
19,05-10-18,13,3:00,3:15,42.86,,0,42.86,42.86,1,-48300,35541,83841,-12759,0,0,6195,0,0,,6195,6195
19,05-10-18,14,3:15,3:30,37.37,,0,37.37,37.37,1,-42084,44423,86507,2339,0,0,4357,0,0,,4357,4357
19,05-10-18,15,3:30,3:45,34.7,,0,34.7,34.7,1,-36756,49470,86226,12714,0,0,1,0,0,,1,1
19,05-10-18,16,3:45,4:00,34.75,,0,34.75,34.75,1,-31953,48886,80839,16933,0,0,282,0,0,,282,282
19,05-10-18,17,4:00,4:15,34.82,,0,34.82,34.82,1,-40541,69790,110331,29249,0,0,374,0,0,,374,374
19,05-10-18,18,4:15,4:30,,,0,36.71,36.71,0,-33164,60866,94030,27702,0,0,0,0,0,,0,0
19,05-10-18,19,4:30,4:45,,,0,36.71,36.71,0,-33343,58408,91751,25065,0,0,0,0,0,,0,0
19,05-10-18,20,4:45,5:00,,,0,37.27,37.27,0,-32211,54620,86831,22409,0,0,0,0,0,,0,0
19,05-10-18,21,5:00,5:15,38.86,,0,38.86,38.86,1,-46508,52569,99077,6061,0,0,791,0,0,,791,791
19,05-10-18,22,5:15,5:30,38.86,,0,38.86,38.86,1,-53753,49666,103419,-4087,0,0,2979,0,0,,2979,2979
19,05-10-18,23,5:30,5:45,34.83,,0,34.83,34.83,1,-53506,62431,115937,8925,0,0,307,0,0,,307,307
19,05-10-18,24,5:45,6:00,,,0,36.6,36.6,0,-38660,54193,92853,15533,0,0,0,0,0,,0,0
19,05-10-18,25,6:00,6:15,34.79,,0,34.79,34.79,1,-46444,79858,126302,33414,0,0,101,0,0,,101,101
19,05-10-18,26,6:15,6:30,,35.16,0,35.16,35.16,-1,-50128,98153,148281,48025,0,-1116,0,0,0,,1116,-1116
19,05-10-18,27,6:30,6:45,,,0,36.7,36.7,0,-58513,70846,129359,12333,0,0,0,0,0,,0,0
19,05-10-18,28,6:45,7:00,,35.16,0,35.16,35.16,-1,-59030,81702,140732,22672,0,-102,0,0,0,,102,-102
19,05-10-18,29,7:00,7:15,,38.53,0,38.53,38.53,-1,-81167,63246,144413,-17921,0,-513,0,0,0,,513,-513
19,05-10-18,30,7:15,7:30,43.16,,0,43.16,43.16,1,-83293,60984,144277,-22309,0,0,1280,0,0,,1280,1280
19,05-10-18,31,7:30,7:45,54.25,,0,54.25,54.25,1,-108167,61047,169214,-47120,0,0,19290,0,0,,19290,19290
19,05-10-18,32,7:45,8:00,90.98,,0,90.98,90.98,1,-129539,64593,194132,-64946,0,0,31711,0,0,,31711,31711
19,05-10-18,33,8:00,8:15,136.12,,0,136.12,136.12,1,-157274,46412,203686,-110862,0,0,83210,0,0,,83210,83210
19,05-10-18,34,8:15,8:30,76.55,,0,76.55,76.55,1,-101370,78899,180269,-22471,0,0,37260,0,0,,37260,37260
19,05-10-18,35,8:30,8:45,90.12,,0,90.12,90.12,1,-119923,56752,176675,-63171,0,0,22788,0,0,,22788,22788
19,05-10-18,36,8:45,9:00,62.15,,0,62.15,62.15,1,-122652,62744,185396,-59908,0,0,47485,0,0,,47485,47485
19,05-10-18,37,9:00,9:15,47.16,37.51,0,37.51,37.51,-1,-104702,109095,213797,4393,0,-287,19246,0,0,,19533,18959
19,05-10-18,38,9:15,9:30,39.16,37.51,0,39.16,39.16,1,-99268,98345,197613,-923,0,-25,239,0,0,,264,214
19,05-10-18,39,9:30,9:45,,,0,37.25,37.25,0,-101645,111530,213175,9885,0,0,0,0,0,,0,0
19,05-10-18,40,9:45,10:00,,,0,37,37,0,-78777,104493,183270,25716,0,0,0,0,0,,0,0
19,05-10-18,41,10:00,10:15,,,0,36.88,36.88,0,-85302,106572,191874,21270,0,0,0,0,0,,0,0
19,05-10-18,42,10:15,10:30,,39.33,0,39.33,39.33,-1,-97378,134887,232265,37509,0,-12,0,0,0,,12,-12
19,05-10-18,43,10:30,10:45,,36.26,0,36.26,36.26,-1,-66063,127416,193479,61353,0,-1923,0,0,0,,1923,-1923
19,05-10-18,44,10:45,11:00,,35.16,0,35.16,35.16,-1,-63358,161700,225058,98342,0,-4826,0,0,0,,4826,-4826
19,05-10-18,45,11:00,11:15,,39.2,0,39.2,39.2,-1,-101263,137767,239030,36504,0,-1285,0,0,0,,1285,-1285
19,05-10-18,46,11:15,11:30,,,0,37.03,37.03,0,-96617,113816,210433,17199,0,0,0,0,0,,0,0
19,05-10-18,47,11:30,11:45,35.99,,0,35.99,35.99,1,-80594,89444,170038,8850,0,0,388,0,0,,388,388
19,05-10-18,48,11:45,12:00,35.93,,0,35.93,35.93,1,-67315,85303,152618,17988,0,0,608,0,0,,608,608
19,05-10-18,49,12:00,12:15,62.16,,0,62.16,62.16,1,-120533,57513,178046,-63020,0,0,12454,0,0,,12454,12454
19,05-10-18,50,12:15,12:30,47.13,,0,47.13,47.13,1,-126422,78122,204544,-48300,0,0,26480,0,0,,26480,26480
19,05-10-18,51,12:30,12:45,39.16,,0,39.16,39.16,1,-112484,95070,207554,-17414,0,0,14680,0,0,,14680,14680
19,05-10-18,52,12:45,13:00,43.16,,0,43.16,43.16,1,-122076,115465,237541,-6611,0,0,3881,0,0,,3881,3881
19,05-10-18,53,13:00,13:15,127.12,,0,127.12,127.12,1,-145261,74198,219459,-71063,0,0,40752,0,0,,40752,40752
19,05-10-18,54,13:15,13:30,59.94,,0,59.94,59.94,1,-144745,96562,241307,-48183,0,0,45219,0,0,,45219,45219
19,05-10-18,55,13:30,13:45,53.64,,0,53.64,53.64,1,-148956,86219,235175,-62737,0,0,33099,0,0,,33099,33099
19,05-10-18,56,13:45,14:00,54.38,,0,54.38,54.38,1,-163472,86509,249981,-76963,0,0,42876,0,0,,42876,42876
19,05-10-18,57,14:00,14:15,138.12,,0,138.12,138.12,1,-165884,86836,252720,-79048,0,0,65770,0,0,,65770,65770
19,05-10-18,58,14:15,14:30,53.12,,0,53.12,53.12,1,-142775,123733,266508,-19042,0,0,24875,0,0,,24875,24875
19,05-10-18,59,14:30,14:45,51.07,,0,51.07,51.07,1,-144640,113828,258468,-30812,0,0,7164,0,0,,7164,7164
19,05-10-18,60,14:45,15:00,42.47,,0,42.47,42.47,1,-134288,116726,251014,-17562,0,0,18518,0,0,,18518,18518
19,05-10-18,61,15:00,15:15,42.47,38.56,0,38.56,38.56,-1,-122404,128933,251337,6529,0,-262,4452,0,0,,4714,4190
19,05-10-18,62,15:15,15:30,,38.64,0,38.64,38.64,-1,-114873,139222,254095,24349,0,-270,0,0,0,,270,-270
19,05-10-18,63,15:30,15:45,,35.16,0,35.16,35.16,-1,-110697,180451,291148,69754,0,-969,0,0,0,,969,-969
19,05-10-18,64,15:45,16:00,,19.59,0,19.59,19.59,-1,-108132,201651,309783,93519,0,-5555,0,0,0,,5555,-5555
19,05-10-18,65,16:00,16:15,39.16,21.78,0,39.16,39.16,1,-114222,108507,222729,-5715,0,-6551,232,0,0,,6783,-6319
19,05-10-18,66,16:15,16:30,52.68,21.78,0,52.68,52.68,1,-113890,85215,199105,-28675,0,-23,10696,0,0,,10719,10673
19,05-10-18,67,16:30,16:45,50.03,,0,50.03,50.03,1,-114637,78528,193165,-36109,0,0,28074,0,0,,28074,28074
19,05-10-18,68,16:45,17:00,57.12,,0,57.12,57.12,1,-129484,66540,196024,-62944,0,0,37779,0,0,,37779,37779
19,05-10-18,69,17:00,17:15,57.12,-150.78,0,-150.78,-150.78,-1,-95341,219705,315046,124364,0,-18522,11867,0,0,,30389,-6655
19,05-10-18,70,17:15,17:30,35.03,-150.78,0,35.03,35.03,1,-105974,114691,220665,8717,0,-26018,9,0,0,,26027,-26009
19,05-10-18,71,17:30,17:45,62.16,-150.78,0,62.16,62.16,1,-104221,69293,173514,-34928,0,-183,17224,0,0,,17407,17041
19,05-10-18,72,17:45,18:00,47.16,,0,47.16,47.16,1,-109995,92221,202216,-17774,0,0,32684,0,0,,32684,32684
19,05-10-18,73,18:00,18:15,43.16,,0,43.16,43.16,1,-94500,83009,177509,-11491,0,0,18524,0,0,,18524,18524
19,05-10-18,74,18:15,18:30,43.16,35.16,0,35.16,35.16,-1,-56896,103765,160661,46869,0,-561,2467,0,0,,3028,1906
19,05-10-18,75,18:30,18:45,,,0,37.62,37.62,0,-55482,79669,135151,24187,0,0,0,0,0,,0,0
19,05-10-18,76,18:45,19:00,43.16,,0,43.16,43.16,1,-44154,68095,112249,23941,0,0,279,0,0,,279,279
19,05-10-18,77,19:00,19:15,138.12,,0,138.12,138.12,1,-143668,45068,188736,-98600,0,0,32220,0,0,,32220,32220
19,05-10-18,78,19:15,19:30,138.12,35.16,0,35.16,35.16,-1,-36239,53990,90229,17751,0,-247,3898,0,0,,4145,3651
19,05-10-18,79,19:30,19:45,,35.19,0,35.19,35.19,-1,-48131,60341,108472,12210,0,-796,0,0,0,,796,-796
19,05-10-18,80,19:45,20:00,59.73,,0,59.73,59.73,1,-72287,35604,107891,-36683,0,0,4307,0,0,,4307,4307
19,05-10-18,81,20:00,20:15,64.47,,0,64.47,64.47,1,-56129,69795,125924,13666,0,0,15613,0,0,,15613,15613
19,05-10-18,82,20:15,20:30,64.47,38.23,0,38.23,38.23,-1,-45134,69109,114243,23975,0,-532,228,0,0,,760,-304
19,05-10-18,83,20:30,20:45,,35.31,0,35.31,35.31,-1,-34650,78569,113219,43919,0,-1123,0,0,0,,1123,-1123
19,05-10-18,84,20:45,21:00,,37.64,0,37.64,37.64,-1,-29205,84330,113535,55125,0,-318,0,0,0,,318,-318
19,05-10-18,85,21:00,21:15,,27.31,0,27.31,27.31,-1,-2663,140265,142928,137602,0,-9669,0,0,0,,9669,-9669
19,05-10-18,86,21:15,21:30,,,0,39.51,39.51,0,-7806,94195,102001,86389,0,-1418,0,0,0,,1418,-1418
19,05-10-18,87,21:30,21:45,,36.35,0,36.35,36.35,-1,-29192,37485,66677,8293,0,-123,0,0,0,,123,-123
19,05-10-18,88,21:45,22:00,61.35,,0,61.35,61.35,1,-69360,24895,94255,-44465,0,0,9528,0,0,,9528,9528
19,05-10-18,89,22:00,22:15,47.12,,0,47.12,47.12,1,-50265,41080,91345,-9185,0,0,13388,0,0,,13388,13388
19,05-10-18,90,22:15,22:30,47.12,35.31,0,35.31,35.31,-1,-45745,57009,102754,11264,0,-1275,1090,0,0,,2365,-185
19,05-10-18,91,22:30,22:45,,36.78,0,36.78,36.78,-1,-39211,50325,89536,11114,0,-813,0,0,0,,813,-813
19,05-10-18,92,22:45,23:00,,,0,39.48,39.48,0,-36909,52289,89198,15380,0,0,0,0,0,,0,0
19,05-10-18,93,23:00,23:15,53.29,,0,53.29,53.29,1,-59528,42417,101945,-17111,0,0,4776,0,0,,4776,4776
19,05-10-18,94,23:15,23:30,41.62,34.9,0,34.9,34.9,-1,-45267,62573,107840,17306,0,-767,3434,0,0,,4201,2667
19,05-10-18,95,23:30,23:45,,35.31,0,35.31,35.31,-1,-30093,74874,104967,44781,0,-1383,0,0,0,,1383,-1383
19,05-10-18,96,23:45,0:00,,37.36,0,37.36,37.36,-1,-37966,68431,106397,30465,0,-2096,0,0,0,,2096,-2096
19,05-11-18,1,0:00,0:15,55.32,37.36,0,55.32,55.32,1,-56237,33133,89370,-23104,0,-578,4276,0,0,,4854,3698
19,05-11-18,2,0:15,0:30,43.84,38.94,0,43.84,37.35,2,-41784,29156,70940,-12628,0,-6,14294,0,0,,14300,14288
19,05-11-18,3,0:30,0:45,43.84,21.68,0,21.68,21.68,-1,-31786,39795,71581,8009,0,-6958,2311,0,0,,9269,-4647
19,05-11-18,4,0:45,1:00,41.25,21.68,0,41.25,41.25,1,-43481,31604,75085,-11877,0,-598,3784,0,0,,4382,3186
19,05-11-18,5,1:00,1:15,50.58,,0,50.58,50.58,1,-100789,94910,195699,-5879,0,0,2415,0,0,,2415,2415
19,05-11-18,6,1:15,1:30,39.16,,0,39.16,39.16,1,-46157,38341,84498,-7816,0,0,6560,0,0,,6560,6560
19,05-11-18,7,1:30,1:45,39.16,31.16,0,31.16,31.16,-1,-20719,44738,65457,24019,0,-2369,1030,0,0,,3399,-1339
19,05-11-18,8,1:45,2:00,,22.32,0,22.32,22.32,-1,-11430,46916,58346,35486,0,-26718,0,0,0,,26718,-26718
19,05-11-18,9,2:00,2:15,,21.2,0,21.2,21.2,-1,-32721,50906,83627,18185,0,-20917,0,0,0,,20917,-20917
19,05-11-18,10,2:15,2:30,,38.36,0,38.36,38.36,-1,-18090,50501,68591,32411,0,-202,0,0,0,,202,-202
19,05-11-18,11,2:30,2:45,,15.89,0,15.89,15.89,-1,-16068,61483,77551,45415,0,-8420,0,0,0,,8420,-8420
19,05-11-18,12,2:45,3:00,,16.52,0,16.52,16.52,-1,-25686,69255,94941,43569,0,-38931,0,0,0,,38931,-38931
19,05-11-18,13,3:00,3:15,,35.6,0,35.6,35.6,-1,-15642,64823,80465,49181,0,-10698,0,0,0,,10698,-10698
19,05-11-18,14,3:15,3:30,,,0,36.73,36.73,0,-13993,73634,87627,59641,0,0,0,0,0,,0,0
19,05-11-18,15,3:30,3:45,,,0,36.73,36.73,0,-14849,77369,92218,62520,0,0,0,0,0,,0,0
19,05-11-18,16,3:45,4:00,,,0,36.74,36.74,0,-14538,74975,89513,60437,0,0,0,0,0,,0,0
19,05-11-18,17,4:00,4:15,,,0,36.63,36.63,0,-5393,80008,85401,74615,0,0,0,0,0,,0,0
19,05-11-18,18,4:15,4:30,,,0,36.63,36.63,0,-6281,75916,82197,69635,0,0,0,0,0,,0,0
19,05-11-18,19,4:30,4:45,,,0,36.63,36.63,0,-10002,79844,89846,69842,0,0,0,0,0,,0,0
19,05-11-18,20,4:45,5:00,,,0,36.61,36.61,0,-14931,86255,101186,71324,0,0,0,0,0,,0,0
19,05-11-18,21,5:00,5:15,,37.23,0,37.23,37.23,-1,-16167,87310,103477,71143,0,-1114,0,0,0,,1114,-1114
19,05-11-18,22,5:15,5:30,,31.16,0,31.16,31.16,-1,-25589,79032,104621,53443,0,-4618,0,0,0,,4618,-4618
19,05-11-18,23,5:30,5:45,,35.16,0,35.16,35.16,-1,-29833,86592,116425,56759,0,-2145,0,0,0,,2145,-2145
19,05-11-18,24,5:45,6:00,,27.16,0,27.16,27.16,-1,-26893,71163,98056,44270,0,-2261,0,0,0,,2261,-2261
19,05-11-18,25,6:00,6:15,,-37.25,0,-37.25,-37.25,-1,-13200,87287,100487,74087,0,-37560,0,0,0,,37560,-37560
19,05-11-18,26,6:15,6:30,,27.75,0,27.75,27.75,-1,-17927,73125,91052,55198,0,-29788,0,0,0,,29788,-29788
19,05-11-18,27,6:30,6:45,,31.44,0,31.44,31.44,-1,-20865,74640,95505,53775,0,-24533,0,0,0,,24533,-24533
19,05-11-18,28,6:45,7:00,,,0,37.38,37.38,0,-34596,90453,125049,55857,0,-3786,0,0,0,,3786,-3786
19,05-11-18,29,7:00,7:15,,22.44,0,22.44,22.44,-1,-20084,119335,139419,99251,0,-5885,0,0,0,,5885,-5885
19,05-11-18,30,7:15,7:30,,35.26,0,35.26,35.26,-1,-11233,122268,133501,111035,0,-1753,0,0,0,,1753,-1753
19,05-11-18,31,7:30,7:45,,-9.65,0,-9.65,-9.65,-1,-14086,132571,146657,118485,0,-15958,0,0,0,,15958,-15958
19,05-11-18,32,7:45,8:00,,27.26,0,27.26,27.26,-1,-16197,129127,145324,112930,0,-24262,0,0,0,,24262,-24262
19,05-11-18,33,8:00,8:15,,-34.65,0,-34.65,-34.65,-1,-21808,152673,174481,130865,0,-59393,0,0,0,,59393,-59393
19,05-11-18,34,8:15,8:30,,-34.65,0,-34.65,-34.65,-1,-39539,107100,146639,67561,0,-86689,0,0,0,,86689,-86689
19,05-11-18,35,8:30,8:45,,13.03,0,13.03,13.03,-1,-39219,100564,139783,61345,0,-37444,0,0,0,,37444,-37444
19,05-11-18,36,8:45,9:00,,13.03,0,13.03,13.03,-1,-43767,99685,143452,55918,0,-43203,0,0,0,,43203,-43203
19,05-11-18,37,9:00,9:15,,,0,38.62,38.62,0,-38713,100498,139211,61785,0,-10106,0,0,0,,10106,-10106
19,05-11-18,38,9:15,9:30,,,0,38.61,38.61,0,-38191,124792,162983,86601,0,0,0,0,0,,0,0
19,05-11-18,39,9:30,9:45,,22.56,0,22.56,22.56,-1,-34385,132200,166585,97815,0,-4420,0,0,0,,4420,-4420
19,05-11-18,40,9:45,10:00,,12.27,0,12.27,12.27,-1,-37961,122635,160596,84674,0,-20255,0,0,0,,20255,-20255
19,05-11-18,41,10:00,10:15,39.26,35.26,0,39.26,39.26,1,-79711,75699,155410,-4012,0,-10341,59,0,0,,10400,-10282
19,05-11-18,42,10:15,10:30,39.26,36.54,0,39.26,36.54,2,-73872,84356,158228,10484,0,-283,93,0,0,,376,-190
19,05-11-18,43,10:30,10:45,,31.26,0,31.26,31.26,-1,-74258,98458,172716,24200,0,-6861,0,0,0,,6861,-6861
19,05-11-18,44,10:45,11:00,,25.52,0,25.52,25.52,-1,-63032,107223,170255,44191,0,-21435,0,0,0,,21435,-21435
19,05-11-18,45,11:00,11:15,,25.02,0,25.02,25.02,-1,-65183,125570,190753,60387,0,-33409,0,0,0,,33409,-33409
19,05-11-18,46,11:15,11:30,,13.82,0,13.82,13.82,-1,-61272,129380,190652,68108,0,-49956,0,0,0,,49956,-49956
19,05-11-18,47,11:30,11:45,,22.44,0,22.44,22.44,-1,-58546,124367,182913,65821,0,-50438,0,0,0,,50438,-50438
19,05-11-18,48,11:45,12:00,,30.54,0,30.54,30.54,-1,-106673,130394,237067,23721,0,-30587,0,0,0,,30587,-30587
19,05-11-18,49,12:00,12:15,43.88,30.54,0,43.88,43.88,1,-185373,105772,291145,-79601,0,-4934,899,0,0,,5833,-4035
19,05-11-18,50,12:15,12:30,,,0,37,37,0,-196801,132111,328912,-64690,0,0,0,0,0,,0,0
19,05-11-18,51,12:30,12:45,,,0,36.98,36.98,0,-220848,149547,370395,-71301,0,0,0,0,0,,0,0
19,05-11-18,52,12:45,13:00,34.5,,0,34.5,34.5,1,-233458,181227,414685,-52231,0,0,16,0,0,,16,16
19,05-11-18,53,13:00,13:15,35,,0,35,35,1,-111133,133990,245123,22857,0,0,210,0,0,,210,210
19,05-11-18,54,13:15,13:30,35.19,,0,35.19,35.19,1,-116020,133760,249780,17740,0,0,174,0,0,,174,174
19,05-11-18,55,13:30,13:45,43.35,,0,43.35,43.35,1,-186288,153555,339843,-32733,0,0,1269,0,0,,1269,1269
19,05-11-18,56,13:45,14:00,36.55,,0,36.55,36.55,1,-198028,156276,354304,-41752,0,0,2062,0,0,,2062,2062
19,05-11-18,57,14:00,14:15,,,0,37.04,37.04,0,-100892,151497,252389,50605,0,0,80,0,0,,80,80
19,05-11-18,58,14:15,14:30,,,0,37,37,0,-104299,130879,235178,26580,0,0,0,0,0,,0,0
19,05-11-18,59,14:30,14:45,,35.26,0,35.26,35.26,-1,-103168,142411,245579,39243,0,-102,0,0,0,,102,-102
19,05-11-18,60,14:45,15:00,,31.26,0,31.26,31.26,-1,-102240,133492,235732,31252,0,-2678,0,0,0,,2678,-2678
19,05-11-18,61,15:00,15:15,,,0,36.93,36.93,0,-102393,123621,226014,21228,0,-8,0,0,0,,8,-8
19,05-11-18,62,15:15,15:30,,,0,36.9,36.9,0,-103599,129786,233385,26187,0,0,0,0,0,,0,0
19,05-11-18,63,15:30,15:45,,,0,37.23,37.23,0,-106807,122701,229508,15894,0,0,0,0,0,,0,0
19,05-11-18,64,15:45,16:00,,,0,36.77,36.77,0,-116346,127266,243612,10920,0,0,0,0,0,,0,0
19,05-11-18,65,16:00,16:15,,,0,37.03,37.03,0,-99583,104441,204024,4858,0,0,0,0,0,,0,0
19,05-11-18,66,16:15,16:30,,,0,37.03,37.03,0,-89085,104898,193983,15813,0,0,0,0,0,,0,0
19,05-11-18,67,16:30,16:45,44.88,,0,44.88,44.88,1,-88257,73800,162057,-14457,0,0,2362,0,0,,2362,2362
19,05-11-18,68,16:45,17:00,50.35,,0,50.35,50.35,1,-93579,57889,151468,-35690,0,0,22589,0,0,,22589,22589
19,05-11-18,69,17:00,17:15,42.84,31.26,0,42.84,31.26,2,-62453,100817,163270,38364,0,-1696,12731,0,0,,14427,11035
19,05-11-18,70,17:15,17:30,42.84,35.26,0,35.26,35.26,-1,-62064,90792,152856,28728,0,-3077,12,0,0,,3089,-3065
19,05-11-18,71,17:30,17:45,,39.11,0,39.11,39.11,-1,-73530,80432,153962,6902,0,-565,0,0,0,,565,-565
19,05-11-18,72,17:45,18:00,43.88,,0,43.88,43.88,1,-86161,74075,160236,-12086,0,0,1030,0,0,,1030,1030
19,05-11-18,73,18:00,18:15,69.55,,0,69.55,69.55,1,-78287,41176,119463,-37111,0,0,12942,0,0,,12942,12942
19,05-11-18,74,18:15,18:30,43.88,36.78,0,43.88,36.78,2,-59844,51252,111096,-8592,0,-195,2224,0,0,,2419,2029
19,05-11-18,75,18:30,18:45,41.26,,0,41.26,41.26,1,-54195,45910,100105,-8285,0,0,5480,0,0,,5480,5480
19,05-11-18,76,18:45,19:00,39.26,,0,39.26,39.26,1,-54141,57027,111168,2886,0,0,4354,0,0,,4354,4354
19,05-11-18,77,19:00,19:15,41.32,,0,41.32,41.32,1,-60010,42494,102504,-17516,0,0,2579,0,0,,2579,2579
19,05-11-18,78,19:15,19:30,44.68,,0,44.68,44.68,1,-64069,42665,106734,-21404,0,0,9053,0,0,,9053,9053
19,05-11-18,79,19:30,19:45,41.11,,0,41.11,41.11,1,-57902,44841,102743,-13061,0,0,8664,0,0,,8664,8664
19,05-11-18,80,19:45,20:00,41.04,,0,41.04,41.04,1,-65673,54448,120121,-11225,0,0,6699,0,0,,6699,6699
19,05-11-18,81,20:00,20:15,48.32,,0,48.32,48.32,1,-77997,51416,129413,-26581,0,0,11689,0,0,,11689,11689
19,05-11-18,82,20:15,20:30,46.6,,0,46.6,46.6,1,-78722,52004,130726,-26718,0,0,20922,0,0,,20922,20922
19,05-11-18,83,20:30,20:45,39.26,,0,39.26,39.26,1,-69678,67217,136895,-2461,0,0,5667,0,0,,5667,5667
19,05-11-18,84,20:45,21:00,,,0,39.38,39.38,0,-72191,70824,143015,-1367,0,0,0,0,0,,0,0
19,05-11-18,85,21:00,21:15,,,0,39.35,39.35,0,-30571,99251,129822,68680,0,0,0,0,0,,0,0
19,05-11-18,86,21:15,21:30,,35.26,0,35.26,35.26,-1,-34650,100003,134653,65353,0,-861,0,0,0,,861,-861
19,05-11-18,87,21:30,21:45,,39.5,0,39.5,39.5,-1,-41214,81587,122801,40373,0,-1262,0,0,0,,1262,-1262
19,05-11-18,88,21:45,22:00,39.26,38.55,0,39.38,38.55,2,-50387,77869,128256,27482,0,-372,3,0,0,,375,-369
19,05-11-18,89,22:00,22:15,90.35,,0,90.35,90.35,1,-100884,15551,116435,-85333,0,0,9230,0,0,,9230,9230
19,05-11-18,90,22:15,22:30,42.78,,0,42.78,42.78,1,-58044,24336,82380,-33708,0,0,2155,0,0,,2155,2155
19,05-11-18,91,22:30,22:45,42.28,,0,42.28,42.28,1,-56503,41838,98341,-14665,0,0,1291,0,0,,1291,1291
19,05-11-18,92,22:45,23:00,39.26,,0,39.26,39.26,1,-42248,72902,115150,30654,0,0,40,0,0,,40,40
19,05-11-18,93,23:00,23:15,143.55,,0,143.55,143.55,1,-121236,23435,144671,-97801,0,0,27168,0,0,,27168,27168
19,05-11-18,94,23:15,23:30,143.55,,0,143.55,143.55,1,-101214,44267,145481,-56947,0,0,69624,0,0,,69624,69624
19,05-11-18,95,23:30,23:45,39.26,31.26,0,31.26,31.26,-1,-61254,79338,140592,18084,0,-1417,8867,0,0,,10284,7450
19,05-11-18,96,23:45,0:00,,24.99,0,24.99,24.99,-1,-79075,100236,179311,21161,0,-27220,0,0,0,,27220,-27220
20,05-12-18,1,0:00,0:15,39.75,35.75,0,39.75,39.75,1,-34925,81290,116215,46365,0,-15034,340,0,0,,15374,-14694
20,05-12-18,2,0:15,0:30,39.75,38.49,0,38.49,38.49,-1,-19994,49796,69790,29802,0,-114,29,0,0,,143,-85
20,05-12-18,3,0:30,0:45,,38.78,0,38.78,38.78,-1,-39044,38856,77900,-188,0,-697,0,0,0,,697,-697
20,05-12-18,4,0:45,1:00,,39.31,0,39.31,39.31,-1,-62788,56148,118936,-6640,0,-2479,0,0,0,,2479,-2479
20,05-12-18,5,1:00,1:15,,32.76,0,32.76,32.76,-1,-15418,132011,147429,116593,0,-4422,0,0,0,,4422,-4422
20,05-12-18,6,1:15,1:30,,24.34,0,24.34,24.34,-1,-12653,114809,127462,102156,0,-15324,0,0,0,,15324,-15324
20,05-12-18,7,1:30,1:45,,31.78,0,31.78,31.78,-1,-13837,87025,100862,73188,0,-14851,0,0,0,,14851,-14851
20,05-12-18,8,1:45,2:00,,33.76,0,33.76,33.76,-1,-21943,82553,104496,60610,0,-2072,0,0,0,,2072,-2072
20,05-12-18,9,2:00,2:15,,38.08,0,38.08,38.08,-1,-45565,70538,116103,24973,0,-1956,0,0,0,,1956,-1956
20,05-12-18,10,2:15,2:30,,,0,36.89,36.89,0,-39447,73765,113212,34318,0,0,0,0,0,,0,0
20,05-12-18,11,2:30,2:45,,38.1,0,38.1,38.1,-1,-27058,93242,120300,66184,0,-91,0,0,0,,91,-91
20,05-12-18,12,2:45,3:00,,27.75,0,27.75,27.75,-1,-30856,108484,139340,77628,0,-4147,0,0,0,,4147,-4147
20,05-12-18,13,3:00,3:15,,35.75,0,35.75,35.75,-1,-52877,88374,141251,35497,0,-4515,0,0,0,,4515,-4515
20,05-12-18,14,3:15,3:30,,37.55,0,37.55,37.55,-1,-47191,84770,131961,37579,0,-19,0,0,0,,19,-19
20,05-12-18,15,3:30,3:45,,35.75,0,35.75,35.75,-1,-43295,80460,123755,37165,0,-491,0,0,0,,491,-491
20,05-12-18,16,3:45,4:00,,,0,36.81,36.81,0,-43479,74016,117495,30537,0,0,0,0,0,,0,0
20,05-12-18,17,4:00,4:15,,,0,36.87,36.87,0,-48764,61789,110553,13025,0,0,0,0,0,,0,0
20,05-12-18,18,4:15,4:30,39.75,,0,39.75,39.75,1,-56786,53753,110539,-3033,0,0,612,0,0,,612,612
20,05-12-18,19,4:30,4:45,39.75,,0,39.75,39.75,1,-64734,49127,113861,-15607,0,0,1593,0,0,,1593,1593
20,05-12-18,20,4:45,5:00,39.75,,0,39.75,39.75,1,-55576,46297,101873,-9279,0,0,3734,0,0,,3734,3734
20,05-12-18,21,5:00,5:15,35.9,,0,35.9,35.9,1,-45841,41574,87415,-4267,0,0,3330,0,0,,3330,3330
20,05-12-18,22,5:15,5:30,36.08,,0,36.08,36.08,1,-41109,29783,70892,-11326,0,0,2594,0,0,,2594,2594
20,05-12-18,23,5:30,5:45,34.98,,0,34.98,34.98,1,-36192,27405,63597,-8787,0,0,373,0,0,,373,373
20,05-12-18,24,5:45,6:00,,35.12,0,35.12,35.12,-1,-24578,32046,56624,7468,0,-578,0,0,0,,578,-578
20,05-12-18,25,6:00,6:15,,,0,37.09,37.09,0,-102274,57012,159286,-45262,0,0,0,0,0,,0,0
20,05-12-18,26,6:15,6:30,,30.92,0,30.92,30.92,-1,-54571,56489,111060,1918,0,-1650,0,0,0,,1650,-1650
20,05-12-18,27,6:30,6:45,,26.32,0,26.32,26.32,-1,-41643,42274,83917,631,0,-9291,0,0,0,,9291,-9291
20,05-12-18,28,6:45,7:00,,28.24,0,28.24,28.24,-1,-47208,57464,104672,10256,0,-2507,0,0,0,,2507,-2507
20,05-12-18,29,7:00,7:15,,13.24,0,13.24,13.24,-1,-36778,61321,98099,24543,0,-14453,0,0,0,,14453,-14453
20,05-12-18,30,7:15,7:30,,12.21,0,12.21,12.21,-1,-25953,61821,87774,35868,0,-31455,0,0,0,,31455,-31455
20,05-12-18,31,7:30,7:45,36.29,28.24,0,36.29,36.29,1,-33474,32082,65556,-1392,0,-25971,37,0,0,,26008,-25934
20,05-12-18,32,7:45,8:00,40.24,28.24,0,40.24,40.24,1,-50958,37240,88198,-13718,0,-1451,1019,0,0,,2470,-432
20,05-12-18,33,8:00,8:15,,29.73,0,29.73,29.73,-1,-47419,67304,114723,19885,0,-11463,0,0,0,,11463,-11463
20,05-12-18,34,8:15,8:30,35.39,34.78,0,37.51,34.78,2,-39863,34574,74437,-5289,0,-18485,11,0,0,,18496,-18474
20,05-12-18,35,8:30,8:45,40.24,34.78,0,40.24,40.24,1,-53203,25241,78444,-27962,0,-798,428,0,0,,1226,-370
20,05-12-18,36,8:45,9:00,,,0,37.51,37.51,0,-54324,18954,73278,-35370,0,0,0,0,0,,0,0
20,05-12-18,37,9:00,9:15,,,0,37.46,37.46,0,-53853,55458,109311,1605,0,0,0,0,0,,0,0
20,05-12-18,38,9:15,9:30,,38.5,0,38.5,38.5,-1,-34834,56963,91797,22129,0,-231,0,0,0,,231,-231
20,05-12-18,39,9:30,9:45,,37.78,0,37.78,37.78,-1,-34673,59322,93995,24649,0,-439,0,0,0,,439,-439
20,05-12-18,40,9:45,10:00,,,0,37.46,37.46,0,-40701,38921,79622,-1780,0,0,0,0,0,,0,0
20,05-12-18,41,10:00,10:15,,38.24,0,38.24,38.24,-1,-37859,61321,99180,23462,0,-962,0,0,0,,962,-962
20,05-12-18,42,10:15,10:30,,36.24,0,36.24,36.24,-1,-44862,56416,101278,11554,0,-709,0,0,0,,709,-709
20,05-12-18,43,10:30,10:45,,36.24,0,36.24,36.24,-1,-40960,60064,101024,19104,0,-1011,0,0,0,,1011,-1011
20,05-12-18,44,10:45,11:00,,36.24,0,36.24,36.24,-1,-40685,64730,105415,24045,0,-1223,0,0,0,,1223,-1223
20,05-12-18,45,11:00,11:15,35.62,37.4,0,35.62,35.62,1,-57190,36584,93774,-20606,0,-610,161,0,0,,771,-449
20,05-12-18,46,11:15,11:30,35.62,,0,35.62,35.62,1,-46446,39672,86118,-6774,0,0,1029,0,0,,1029,1029
20,05-12-18,47,11:30,11:45,35.51,,0,35.51,35.51,1,-45702,25146,70848,-20556,0,0,798,0,0,,798,798
20,05-12-18,48,11:45,12:00,35.45,,0,35.45,35.45,1,-40260,26477,66737,-13783,0,0,1555,0,0,,1555,1555
20,05-12-18,49,12:00,12:15,63.24,,0,63.24,63.24,1,-95299,31698,126997,-63601,0,0,6609,0,0,,6609,6609
20,05-12-18,50,12:15,12:30,76.45,,0,76.45,76.45,1,-83044,43599,126643,-39445,0,0,35063,0,0,,35063,35063
20,05-12-18,51,12:30,12:45,40.24,,0,40.24,40.24,1,-51545,46206,97751,-5339,0,0,6095,0,0,,6095,6095
20,05-12-18,52,12:45,13:00,40.24,,0,40.24,40.24,1,-43645,38973,82618,-4672,0,0,742,0,0,,742,742
20,05-12-18,53,13:00,13:15,,,0,37.31,37.31,0,-51082,82347,133429,31265,0,0,0,0,0,,0,0
20,05-12-18,54,13:15,13:30,,,0,37.3,37.3,0,-37536,75872,113408,38336,0,0,0,0,0,,0,0
20,05-12-18,55,13:30,13:45,,,0,37.31,37.31,0,-31543,82190,113733,50647,0,0,0,0,0,,0,0
20,05-12-18,56,13:45,14:00,,23.85,0,23.85,23.85,-1,-36735,91043,127778,54308,0,-4969,0,0,0,,4969,-4969
20,05-12-18,57,14:00,14:15,,36.24,0,36.24,36.24,-1,-45653,96635,142288,50982,0,-3043,0,0,0,,3043,-3043
20,05-12-18,58,14:15,14:30,44.24,,0,44.24,44.24,1,-70970,82415,153385,11445,0,0,1101,0,0,,1101,1101
20,05-12-18,59,14:30,14:45,48.87,,0,48.87,48.87,1,-105278,78103,183381,-27175,0,0,21612,0,0,,21612,21612
20,05-12-18,60,14:45,15:00,40.24,,0,40.24,40.24,1,-103662,86241,189903,-17421,0,0,18265,0,0,,18265,18265
20,05-12-18,61,15:00,15:15,40.24,,0,40.24,40.24,1,-100073,89210,189283,-10863,0,0,7028,0,0,,7028,7028
20,05-12-18,62,15:15,15:30,44.24,,0,44.24,44.24,1,-103675,79229,182904,-24446,0,0,6973,0,0,,6973,6973
20,05-12-18,63,15:30,15:45,48.58,,0,48.58,48.58,1,-106977,72361,179338,-34616,0,0,14774,0,0,,14774,14774
20,05-12-18,64,15:45,16:00,52.63,,0,52.63,52.63,1,-100145,56106,156251,-44039,0,0,31718,0,0,,31718,31718
20,05-12-18,65,16:00,16:15,44.24,,0,44.24,44.24,1,-93859,63685,157544,-30174,0,0,23867,0,0,,23867,23867
20,05-12-18,66,16:15,16:30,47.46,,0,47.46,47.46,1,-113696,59881,173577,-53815,0,0,18594,0,0,,18594,18594
20,05-12-18,67,16:30,16:45,78.12,,0,78.12,78.12,1,-135392,48571,183963,-86821,0,0,40777,0,0,,40777,40777
20,05-12-18,68,16:45,17:00,57.99,,0,57.99,57.99,1,-140993,70324,211317,-70669,0,0,50465,0,0,,50465,50465
20,05-12-18,69,17:00,17:15,36.07,38.73,0,37.69,37.69,2,-112473,109429,221902,-3044,0,-1140,12628,0,0,,13768,11488
20,05-12-18,70,17:15,17:30,51.27,38.73,0,51.27,51.27,1,-120343,93332,213675,-27011,0,-7,4637,0,0,,4644,4630
20,05-12-18,71,17:30,17:45,66.94,,0,66.94,66.94,1,-144968,86993,231961,-57975,0,0,42364,0,0,,42364,42364
20,05-12-18,72,17:45,18:00,63.24,,0,63.24,63.24,1,-153394,94069,247463,-59325,0,0,54790,0,0,,54790,54790
20,05-12-18,73,18:00,18:15,48.27,,0,48.27,48.27,1,-127824,99166,226990,-28658,0,0,38396,0,0,,38396,38396
20,05-12-18,74,18:15,18:30,50.05,39,0,50.05,38.05,2,-120377,87736,208113,-32641,0,-250,7387,0,0,,7637,7137
20,05-12-18,75,18:30,18:45,63.24,,0,63.24,63.24,1,-128204,91223,219427,-36981,0,0,33632,0,0,,33632,33632
20,05-12-18,76,18:45,19:00,46.42,,0,46.42,46.42,1,-117819,100130,217949,-17689,0,0,20044,0,0,,20044,20044
20,05-12-18,77,19:00,19:15,63.24,,0,63.24,63.24,1,-131597,50102,181699,-81495,0,0,26052,0,0,,26052,26052
20,05-12-18,78,19:15,19:30,49.86,,0,49.86,49.86,1,-137655,62980,200635,-74675,0,0,36797,0,0,,36797,36797
20,05-12-18,79,19:30,19:45,45.14,,0,45.14,45.14,1,-128948,66047,194995,-62901,0,0,31063,0,0,,31063,31063
20,05-12-18,80,19:45,20:00,42.12,,0,42.12,42.12,1,-124105,69817,193922,-54288,0,0,13575,0,0,,13575,13575
20,05-12-18,81,20:00,20:15,44.24,,0,44.24,44.24,1,-123512,44384,167896,-79128,0,0,1193,0,0,,1193,1193
20,05-12-18,82,20:15,20:30,44.3,,0,44.3,44.3,1,-133229,49517,182746,-83712,0,0,7264,0,0,,7264,7264
20,05-12-18,83,20:30,20:45,40.24,,0,40.24,40.24,1,-123097,60388,183485,-62709,0,0,3164,0,0,,3164,3164
20,05-12-18,84,20:45,21:00,,,0,38.21,38.21,0,-129820,77642,207462,-52178,0,0,7,0,0,,7,7
20,05-12-18,85,21:00,21:15,,,0,38.09,38.09,0,-60406,74450,134856,14044,0,0,0,0,0,,0,0
20,05-12-18,86,21:15,21:30,,39.74,0,39.74,39.74,-1,-32334,76901,109235,44567,0,-58,0,0,0,,58,-58
20,05-12-18,87,21:30,21:45,,39.78,0,39.78,39.78,-1,-49023,76420,125443,27397,0,-1419,0,0,0,,1419,-1419
20,05-12-18,88,21:45,22:00,,31.62,0,31.62,31.62,-1,-38553,89248,127801,50695,0,-3235,0,0,0,,3235,-3235
20,05-12-18,89,22:00,22:15,,24.24,0,24.24,24.24,-1,-57357,82660,140017,25303,0,-18982,0,0,0,,18982,-18982
20,05-12-18,90,22:15,22:30,,20.61,0,20.61,20.61,-1,-46471,92343,138814,45872,0,-27124,0,0,0,,27124,-27124
20,05-12-18,91,22:30,22:45,,20.18,0,20.18,20.18,-1,-48856,103393,152249,54537,0,-46082,0,0,0,,46082,-46082
20,05-12-18,92,22:45,23:00,,3.78,0,3.78,3.78,-1,-28575,115690,144265,87115,0,-52758,0,0,0,,52758,-52758
20,05-12-18,93,23:00,23:15,126.31,28.24,0,126.31,126.31,1,-122049,74119,196168,-47930,0,-25041,4746,0,0,,29787,-20295
20,05-12-18,94,23:15,23:30,41.37,,0,41.37,41.37,1,-75006,77161,152167,2155,0,0,2894,0,0,,2894,2894
20,05-12-18,95,23:30,23:45,,,0,38.45,38.45,0,-49579,89272,138851,39693,0,0,0,0,0,,0,0
20,05-12-18,96,23:45,0:00,,39.22,0,39.22,39.22,-1,-59770,85957,145727,26187,0,-283,0,0,0,,283,-283
20,05/13/2018,1,0:00,0:15,146.02,,0,146.02,146.02,1,-94192,43499,137691,-50693,0,0,12827,0,0,,12827,12827
20,05/13/2018,2,0:15,0:30,195.16,,0,195.16,195.16,1,-90946,31517,122463,-59429,0,0,63168,0,0,,63168,63168
20,05/13/2018,3,0:30,0:45,40.24,,0,40.24,40.24,1,-53071,44796,97867,-8275,0,0,8168,0,0,,8168,8168
20,05/13/2018,4,0:45,1:00,,,0,38.01,38.01,0,-57787,42148,99935,-15639,0,0,0,0,0,,0,0
20,05/13/2018,5,1:00,1:15,,,0,37.3,37.3,0,-48691,72498,121189,23807,0,0,0,0,0,,0,0
20,05/13/2018,6,1:15,1:30,,,0,37.38,37.38,0,-48059,60653,108712,12594,0,0,0,0,0,,0,0
20,05/13/2018,7,1:30,1:45,,36.24,0,36.24,36.24,-1,-42711,62062,104773,19351,0,-516,0,0,0,,516,-516
20,05/13/2018,8,1:45,2:00,,32.24,0,32.24,32.24,-1,-34672,60768,95440,26096,0,-15229,0,0,0,,15229,-15229
20,05/13/2018,9,2:00,2:15,80.9,38.67,0,80.9,80.9,1,-100635,55306,155941,-45329,0,-4943,6802,0,0,,11745,1859
20,05/13/2018,10,2:15,2:30,87.33,,0,87.33,87.33,1,-98080,60464,158544,-37616,0,0,32748,0,0,,32748,32748
20,05/13/2018,11,2:30,2:45,44.24,,0,44.24,44.24,1,-95763,61240,157003,-34523,0,0,23820,0,0,,23820,23820
20,05/13/2018,12,2:45,3:00,38.42,,0,38.42,38.42,1,-86742,62926,149668,-23816,0,0,9805,0,0,,9805,9805
20,05/13/2018,13,3:00,3:15,35.4,,0,35.4,35.4,1,-85771,58286,144057,-27485,0,0,626,0,0,,626,626
20,05/13/2018,14,3:15,3:30,,,0,36.89,36.89,0,-70403,56282,126685,-14121,0,0,32,0,0,,32,32
20,05/13/2018,15,3:30,3:45,,,0,36.85,36.85,0,-68211,55091,123302,-13120,0,0,0,0,0,,0,0
20,05/13/2018,16,3:45,4:00,,,0,36.83,36.83,0,-67837,60014,127851,-7823,0,0,0,0,0,,0,0
20,05/13/2018,17,4:00,4:15,40.24,,0,40.24,40.24,1,-57581,45174,102755,-12407,0,0,1211,0,0,,1211,1211
20,05/13/2018,18,4:15,4:30,40.24,,0,40.24,40.24,1,-59940,39430,99370,-20510,0,0,4698,0,0,,4698,4698
20,05/13/2018,19,4:30,4:45,40.24,,0,40.24,40.24,1,-62346,34696,97042,-27650,0,0,5038,0,0,,5038,5038
20,05/13/2018,20,4:45,5:00,35.39,,0,35.39,35.39,1,-47542,35613,83155,-11929,0,0,2628,0,0,,2628,2628
20,05/13/2018,21,5:00,5:15,40.24,,0,40.24,40.24,1,-57574,31040,88614,-26534,0,0,2752,0,0,,2752,2752
20,05/13/2018,22,5:15,5:30,50.66,,0,50.66,50.66,1,-59483,27707,87190,-31776,0,0,14145,0,0,,14145,14145
20,05/13/2018,23,5:30,5:45,40.09,,0,40.09,40.09,1,-44108,34919,79027,-9189,0,0,7930,0,0,,7930,7930
20,05/13/2018,24,5:45,6:00,35.46,,0,35.46,35.46,1,-44632,48062,92694,3430,0,0,327,0,0,,327,327
20,05/13/2018,25,6:00,6:15,50.61,,0,50.61,50.61,1,-75141,19028,94169,-56113,0,0,10534,0,0,,10534,10534
20,05/13/2018,26,6:15,6:30,40.74,,0,40.74,40.74,1,-56497,31837,88334,-24660,0,0,14033,0,0,,14033,14033
20,05/13/2018,27,6:30,6:45,63.74,,0,63.74,63.74,1,-69428,19019,88447,-50409,0,0,22595,0,0,,22595,22595
20,05/13/2018,28,6:45,7:00,50.61,,0,50.61,50.61,1,-67896,24963,92859,-42933,0,0,27667,0,0,,27667,27667
20,05/13/2018,29,7:00,7:15,44.74,32.74,0,32.74,32.74,-1,-73706,68643,142349,-5063,0,-667,15952,0,0,,16619,15285
20,05/13/2018,30,7:15,7:30,44.74,35.93,0,35.93,35.93,-1,-79482,91909,171391,12427,0,-2840,54,0,0,,2894,-2786
20,05/13/2018,31,7:30,7:45,,,0,37.27,37.27,0,-89287,88101,177388,-1186,0,-7,0,0,0,,7,-7
20,05/13/2018,32,7:45,8:00,40.74,,0,40.74,40.74,1,-105129,90552,195681,-14577,0,0,2125,0,0,,2125,2125
20,05/13/2018,33,8:00,8:15,,,0,37.44,37.44,0,-76292,109483,185775,33191,0,0,43,0,0,,43,43
20,05/13/2018,34,8:15,8:30,49,,0,49,49,1,-80616,67239,147855,-13377,0,0,2609,0,0,,2609,2609
20,05/13/2018,35,8:30,8:45,55.56,,0,55.56,55.56,1,-113666,75489,189155,-38177,0,0,23865,0,0,,23865,23865
20,05/13/2018,36,8:45,9:00,63.74,,0,63.74,63.74,1,-133221,96030,229251,-37191,0,0,38057,0,0,,38057,38057
20,05/13/2018,37,9:00,9:15,47.26,,0,47.26,47.26,1,-136517,87000,223517,-49517,0,0,26983,0,0,,26983,26983
20,05/13/2018,38,9:15,9:30,118.02,,0,118.02,118.02,1,-144104,73441,217545,-70663,0,0,32187,0,0,,32187,32187
20,05/13/2018,39,9:30,9:45,62.03,,0,62.03,62.03,1,-154086,94604,248690,-59482,0,0,47844,0,0,,47844,47844
20,05/13/2018,40,9:45,10:00,68.02,,0,68.02,68.02,1,-155060,112005,267065,-43055,0,0,47662,0,0,,47662,47662
20,05/13/2018,41,10:00,10:15,67.25,,0,67.25,67.25,1,-141919,83285,225204,-58634,0,0,29381,0,0,,29381,29381
20,05/13/2018,42,10:15,10:30,46.71,,0,46.71,46.71,1,-136046,103691,239737,-32355,0,0,26200,0,0,,26200,26200
20,05/13/2018,43,10:30,10:45,46.73,,0,46.73,46.73,1,-134987,105840,240827,-29147,0,0,24904,0,0,,24904,24904
20,05/13/2018,44,10:45,11:00,48.74,,0,48.74,48.74,1,-136155,102843,238998,-33312,0,0,19936,0,0,,19936,19936
20,05/13/2018,45,11:00,11:15,63.74,,0,63.74,63.74,1,-116614,91980,208594,-24634,0,0,28602,0,0,,28602,28602
20,05/13/2018,46,11:15,11:30,44.74,,0,44.74,44.74,1,-105867,97978,203845,-7889,0,0,8660,0,0,,8660,8660
20,05/13/2018,47,11:30,11:45,71.14,,0,71.14,71.14,1,-113190,79899,193089,-33291,0,0,31399,0,0,,31399,31399
20,05/13/2018,48,11:45,12:00,44.74,,0,44.74,44.74,1,-122429,108619,231048,-13810,0,0,18513,0,0,,18513,18513
20,05/13/2018,49,12:00,12:15,151.02,,0,151.02,151.02,1,-151088,64117,215205,-86971,0,0,40405,0,0,,40405,40405
20,05/13/2018,50,12:15,12:30,62.5,,0,62.5,62.5,1,-139421,76271,215692,-63150,0,0,59220,0,0,,59220,59220
20,05/13/2018,51,12:30,12:45,57.34,,0,57.34,57.34,1,-135798,84953,220751,-50845,0,0,54085,0,0,,54085,54085
20,05/13/2018,52,12:45,13:00,48.74,,0,48.74,48.74,1,-136383,85234,221617,-51149,0,0,41873,0,0,,41873,41873
20,05/13/2018,53,13:00,13:15,49.87,,0,49.87,49.87,1,-142326,101972,244298,-40354,0,0,36017,0,0,,36017,36017
20,05/13/2018,54,13:15,13:30,54.69,,0,54.69,54.69,1,-144078,90131,234209,-53947,0,0,37547,0,0,,37547,37547
20,05/13/2018,55,13:30,13:45,54.04,,0,54.04,54.04,1,-146897,87575,234472,-59322,0,0,39339,0,0,,39339,39339
20,05/13/2018,56,13:45,14:00,74.26,,0,74.26,74.26,1,-155877,71892,227769,-83985,0,0,52834,0,0,,52834,52834
20,05/13/2018,57,14:00,14:15,150.02,,0,150.02,150.02,1,-187328,81366,268694,-105962,0,0,83329,0,0,,83329,83329
20,05/13/2018,58,14:15,14:30,151.02,,0,151.02,151.02,1,-182182,115111,297293,-67071,0,0,90725,0,0,,90725,90725
20,05/13/2018,59,14:30,14:45,53.26,,0,53.26,53.26,1,-180718,131795,312513,-48923,0,0,49490,0,0,,49490,49490
20,05/13/2018,60,14:45,15:00,52.02,,0,52.02,52.02,1,-182113,123972,306085,-58141,0,0,52200,0,0,,52200,52200
20,05/13/2018,61,15:00,15:15,36.04,35.26,0,36.79,35.26,2,-153487,186990,340477,33503,0,-512,18883,0,0,,19395,18371
20,05/13/2018,62,15:15,15:30,,,0,36.81,36.81,0,-138926,162571,301497,23645,0,0,0,0,0,,0,0
20,05/13/2018,63,15:30,15:45,61.73,,0,61.73,61.73,1,-149894,121649,271543,-28245,0,0,7879,0,0,,7879,7879
20,05/13/2018,64,15:45,16:00,44.74,,0,44.74,44.74,1,-147567,123992,271559,-23575,0,0,25974,0,0,,25974,25974
20,05/13/2018,65,16:00,16:15,134.02,,0,134.02,134.02,1,-152195,91656,243851,-60539,0,0,22081,0,0,,22081,22081
20,05/13/2018,66,16:15,16:30,151.02,,0,151.02,151.02,1,-137187,107008,244195,-30179,0,0,44143,0,0,,44143,44143
20,05/13/2018,67,16:30,16:45,35.2,37.64,0,37.11,37.11,2,-129014,131936,260950,2922,0,-710,5572,0,0,,6282,4862
20,05/13/2018,68,16:45,17:00,,,0,37.06,37.06,0,-139831,133931,273762,-5900,0,0,0,0,0,,0,0
20,05/13/2018,69,17:00,17:15,,-150.03,0,-150.03,-150.03,-1,-102465,235816,338281,133351,0,-16018,0,0,0,,16018,-16018
20,05/13/2018,70,17:15,17:30,,36.74,0,36.74,36.74,-1,-130951,147596,278547,16645,0,-6595,0,0,0,,6595,-6595
20,05/13/2018,71,17:30,17:45,44.74,36.74,0,44.74,44.74,1,-144299,130783,275082,-13516,0,-72,3558,0,0,,3630,3486
20,05/13/2018,72,17:45,18:00,51.06,,0,51.06,51.06,1,-163193,121956,285149,-41237,0,0,19946,0,0,,19946,19946
20,05/13/2018,73,18:00,18:15,88.74,,0,88.74,88.74,1,-185316,90915,276231,-94401,0,0,34932,0,0,,34932,34932
20,05/13/2018,74,18:15,18:30,42.13,,0,42.13,42.13,1,-136849,117709,254558,-19140,0,0,8910,0,0,,8910,8910
20,05/13/2018,75,18:30,18:45,54.14,,0,54.14,54.14,1,-135924,102406,238330,-33518,0,0,4273,0,0,,4273,4273
20,05/13/2018,76,18:45,19:00,54.67,,0,54.67,54.67,1,-135285,105511,240796,-29774,0,0,18444,0,0,,18444,18444
20,05/13/2018,77,19:00,19:15,48.74,,0,48.74,48.74,1,-128512,93618,222130,-34894,0,0,18688,0,0,,18688,18688
20,05/13/2018,78,19:15,19:30,48.74,,0,48.74,48.74,1,-109279,92022,201301,-17257,0,0,24748,0,0,,24748,24748
20,05/13/2018,79,19:30,19:45,48.74,37.03,0,37.03,37.03,-1,-102940,109069,212009,6129,0,-422,4155,0,0,,4577,3733
20,05/13/2018,80,19:45,20:00,44.2,,0,44.2,44.2,1,-111677,97929,209606,-13748,0,0,1792,0,0,,1792,1792
20,05/13/2018,81,20:00,20:15,48.74,,0,48.74,48.74,1,-102628,74069,176697,-28559,0,0,23121,0,0,,23121,23121
20,05/13/2018,82,20:15,20:30,44.74,,0,44.74,44.74,1,-112977,92270,205247,-20707,0,0,22220,0,0,,22220,22220
20,05/13/2018,83,20:30,20:45,,,0,37.81,37.81,0,-101638,99480,201118,-2158,0,0,5397,0,0,,5397,5397
20,05/13/2018,84,20:45,21:00,41.49,,0,41.49,41.49,1,-103989,98450,202439,-5539,0,0,1165,0,0,,1165,1165
20,05/13/2018,85,21:00,21:15,,,0,38.21,38.21,0,-94018,146021,240039,52003,0,0,67,0,0,,67,67
20,05/13/2018,86,21:15,21:30,,,0,38.21,38.21,0,-104914,134569,239483,29655,0,0,0,0,0,,0,0
20,05/13/2018,87,21:30,21:45,,,0,38.21,38.21,0,-110156,136481,246637,26325,0,0,0,0,0,,0,0
20,05/13/2018,88,21:45,22:00,,36.74,0,36.74,36.74,-1,-117811,162192,280003,44381,0,-635,0,0,0,,635,-635
20,05/13/2018,89,22:00,22:15,,34.91,0,34.91,34.91,-1,-105630,154851,260481,49221,0,-1817,0,0,0,,1817,-1817
20,05/13/2018,90,22:15,22:30,,37.18,0,37.18,37.18,-1,-113080,150464,263544,37384,0,-2863,0,0,0,,2863,-2863
20,05/13/2018,91,22:30,22:45,,37.18,0,37.18,37.18,-1,-110748,158669,269417,47921,0,-2752,0,0,0,,2752,-2752
20,05/13/2018,92,22:45,23:00,,39.26,0,39.26,39.26,-1,-109270,198336,307606,89066,0,-113,0,0,0,,113,-113
20,05/13/2018,93,23:00,23:15,63.74,38.79,0,63.74,37.66,2,-110586,78309,188895,-32277,0,-272,7320,0,0,,7592,7048
20,05/13/2018,94,23:15,23:30,48.74,,0,48.74,48.74,1,-116696,87225,203921,-29471,0,0,16211,0,0,,16211,16211
20,05/13/2018,95,23:30,23:45,42.86,,0,42.86,42.86,1,-113768,90502,204270,-23266,0,0,7713,0,0,,7713,7713
20,05/13/2018,96,23:45,0:00,35.91,39.78,0,37.71,37.71,2,-91850,105396,197246,13546,0,-132,1624,0,0,,1756,1492
20,05/14/2018,1,0:00,0:15,151.12,,0,151.12,151.12,1,-189112,32344,221456,-156768,0,0,36559,0,0,,36559,36559
20,05/14/2018,2,0:15,0:30,151.12,,0,151.12,151.12,1,-135889,42301,178190,-93588,0,0,92832,0,0,,92832,92832
20,05/14/2018,3,0:30,0:45,63.74,,0,63.74,63.74,1,-99976,51851,151827,-48125,0,0,48882,0,0,,48882,48882
20,05/14/2018,4,0:45,1:00,48.74,,0,48.74,48.74,1,-104232,53035,157267,-51197,0,0,37215,0,0,,37215,37215
20,05/14/2018,5,1:00,1:15,96.17,,0,96.17,96.17,1,-112044,47145,159189,-64899,0,0,44960,0,0,,44960,44960
20,05/14/2018,6,1:15,1:30,51.39,,0,51.39,51.39,1,-84231,62199,146430,-22032,0,0,42706,0,0,,42706,42706
20,05/14/2018,7,1:30,1:45,46.57,38.32,0,46.57,37.82,2,-67027,47837,114864,-19190,0,-583,5783,0,0,,6366,5200
20,05/14/2018,8,1:45,2:00,53.12,,0,53.12,53.12,1,-82688,34634,117322,-48054,0,0,31909,0,0,,31909,31909
20,05/14/2018,9,2:00,2:15,35.02,,0,35.02,35.02,1,-40385,42269,82654,1884,0,0,10414,0,0,,10414,10414
20,05/14/2018,10,2:15,2:30,40.74,36.14,0,40.74,36.14,2,-37572,44546,82118,6974,0,-227,622,0,0,,849,395
20,05/14/2018,11,2:30,2:45,,36.21,0,36.21,36.21,-1,-25071,39822,64893,14751,0,-3051,0,0,0,,3051,-3051
20,05/14/2018,12,2:45,3:00,,36.39,0,36.39,36.39,-1,-39248,34305,73553,-4943,0,-4087,0,0,0,,4087,-4087
20,05/14/2018,13,3:00,3:15,,-11.26,0,-11.26,-11.26,-1,-12187,135748,147935,123561,0,-17827,0,0,0,,17827,-17827
20,05/14/2018,14,3:15,3:30,,35.78,0,35.78,35.78,-1,-30260,107640,137900,77380,0,-6650,0,0,0,,6650,-6650
20,05/14/2018,15,3:30,3:45,,36.74,0,36.74,36.74,-1,-37451,110301,147752,72850,0,-2804,0,0,0,,2804,-2804
20,05/14/2018,16,3:45,4:00,,37.69,0,37.69,37.69,-1,-35691,116132,151823,80441,0,-2216,0,0,0,,2216,-2216
20,05/14/2018,17,4:00,4:15,,36.74,0,36.74,36.74,-1,-39087,83983,123070,44896,0,-406,0,0,0,,406,-406
20,05/14/2018,18,4:15,4:30,,,0,35.42,35.42,0,-54016,52955,106971,-1061,0,0,0,0,0,,0,0
20,05/14/2018,19,4:30,4:45,44.74,,0,44.74,44.74,1,-71763,40807,112570,-30956,0,0,1307,0,0,,1307,1307
20,05/14/2018,20,4:45,5:00,84.43,,0,84.43,84.43,1,-100077,32584,132661,-67493,0,0,36477,0,0,,36477,36477
20,05/14/2018,21,5:00,5:15,45.12,38.32,0,38.32,38.32,-1,-75568,62812,138380,-12756,0,-13,27916,0,0,,27929,27903
20,05/14/2018,22,5:15,5:30,45.12,38.32,0,38.32,38.32,-1,-88774,58234,147008,-30540,0,-100,430,0,0,,530,330
20,05/14/2018,23,5:30,5:45,57.14,,0,57.14,57.14,1,-104961,58280,163241,-46681,0,0,9252,0,0,,9252,9252
20,05/14/2018,24,5:45,6:00,66.4,,0,66.4,66.4,1,-106449,74286,180735,-32163,0,0,24484,0,0,,24484,24484
20,05/14/2018,25,6:00,6:15,40.76,,0,40.76,40.76,1,-124954,59786,184740,-65168,0,0,9295,0,0,,9295,9295
20,05/14/2018,26,6:15,6:30,63.74,,0,63.74,63.74,1,-89737,37659,127396,-52078,0,0,15006,0,0,,15006,15006
20,05/14/2018,27,6:30,6:45,147.12,,0,147.12,147.12,1,-125438,29662,155100,-95776,0,0,64523,0,0,,64523,64523
20,05/14/2018,28,6:45,7:00,151.12,,0,151.12,151.12,1,-157474,56709,214183,-100765,0,0,94779,0,0,,94779,94779
20,05/14/2018,29,7:00,7:15,151.12,37.21,0,37.21,37.21,-1,-90657,121366,212023,30709,0,-894,29837,0,0,,30731,28943
20,05/14/2018,30,7:15,7:30,90.87,,0,90.87,90.87,1,-92385,63951,156336,-28434,0,0,6707,0,0,,6707,6707
20,05/14/2018,31,7:30,7:45,152.12,,0,152.12,152.12,1,-130769,69168,199937,-61601,0,0,56630,0,0,,56630,56630
20,05/14/2018,32,7:45,8:00,104.12,,0,104.12,104.12,1,-170639,100738,271377,-69901,0,0,60639,0,0,,60639,60639
20,05/14/2018,33,8:00,8:15,58.12,,0,58.12,58.12,1,-120652,100907,221559,-19745,0,0,30357,0,0,,30357,30357
20,05/14/2018,34,8:15,8:30,152.12,,0,152.12,152.12,1,-132286,61950,194236,-70336,0,0,45449,0,0,,45449,45449
20,05/14/2018,35,8:30,8:45,97.12,,0,97.12,97.12,1,-158355,71270,229625,-87085,0,0,73640,0,0,,73640,73640
20,05/14/2018,36,8:45,9:00,117.12,,0,117.12,117.12,1,-167181,72585,239766,-94596,0,0,79193,0,0,,79193,79193
20,05/14/2018,37,9:00,9:15,104.12,,0,104.12,104.12,1,-146828,68175,215003,-78653,0,0,79446,0,0,,79446,79446
20,05/14/2018,38,9:15,9:30,85.87,,0,85.87,85.87,1,-136751,66150,202901,-70601,0,0,70013,0,0,,70013,70013
20,05/14/2018,39,9:30,9:45,155.83,,0,155.83,155.83,1,-106965,52505,159470,-54460,0,0,57110,15000,0,,72110,72110
20,05/14/2018,40,9:45,10:00,66.15,,0,66.15,66.15,1,-95971,68837,164808,-27134,0,0,10484,0,0,,10484,10484
20,05/14/2018,41,10:00,10:15,152.12,,0,152.12,152.12,1,-137361,44195,181556,-93166,0,0,57339,0,0,,57339,57339
20,05/14/2018,42,10:15,10:30,75.12,,0,75.12,75.12,1,-99790,61005,160795,-38785,0,0,51295,0,0,,51295,51295
20,05/14/2018,43,10:30,10:45,45.22,,0,45.22,45.22,1,-69660,52710,122370,-16950,0,0,23069,0,0,,23069,23069
20,05/14/2018,44,10:45,11:00,42.15,,0,42.15,42.15,1,-64041,53430,117471,-10611,0,0,7432,0,0,,7432,7432
20,05/14/2018,45,11:00,11:15,45.53,,0,45.53,45.53,1,-79812,72026,151838,-7786,0,0,10219,0,0,,10219,10219
20,05/14/2018,46,11:15,11:30,45.22,,0,45.22,45.22,1,-80383,71135,151518,-9248,0,0,3385,0,0,,3385,3385
20,05/14/2018,47,11:30,11:45,40.82,,0,40.82,40.82,1,-80731,77070,157801,-3661,0,0,2835,0,0,,2835,2835
20,05/14/2018,48,11:45,12:00,49.36,,0,49.36,49.36,1,-77492,83274,160766,5782,0,0,2177,0,0,,2177,2177
20,05/14/2018,49,12:00,12:15,155.73,,0,155.73,155.73,1,-145469,59829,205298,-85640,0,0,43344,0,0,,43344,43344
20,05/14/2018,50,12:15,12:30,62.12,,0,62.12,62.12,1,-94488,73944,168432,-20544,0,0,36640,0,0,,36640,36640
20,05/14/2018,51,12:30,12:45,40.48,36.85,0,40.48,36.85,2,-75768,89945,165713,14177,0,-739,7612,0,0,,8351,6873
20,05/14/2018,52,12:45,13:00,54.9,,0,54.9,54.9,1,-91427,66094,157521,-25333,0,0,7845,0,0,,7845,7845
20,05/14/2018,53,13:00,13:15,66.52,,0,66.52,66.52,1,-111261,69026,180287,-42235,0,0,28888,0,0,,28888,28888
20,05/14/2018,54,13:15,13:30,49.32,,0,49.32,49.32,1,-117301,79252,196553,-38049,0,0,30111,0,0,,30111,30111
20,05/14/2018,55,13:30,13:45,51.15,,0,51.15,51.15,1,-117655,75869,193524,-41786,0,0,27691,0,0,,27691,27691
20,05/14/2018,56,13:45,14:00,45.22,,0,45.22,45.22,1,-102669,77463,180132,-25206,0,0,18306,0,0,,18306,18306
20,05/14/2018,57,14:00,14:15,54.18,,0,54.18,54.18,1,-73957,56028,129985,-17929,0,0,9461,0,0,,9461,9461
20,05/14/2018,58,14:15,14:30,45.22,,0,45.22,45.22,1,-87263,65361,152624,-21902,0,0,17698,0,0,,17698,17698
20,05/14/2018,59,14:30,14:45,41.94,,0,41.94,41.94,1,-82457,73106,155563,-9351,0,0,7003,0,0,,7003,7003
20,05/14/2018,60,14:45,15:00,41.66,,0,41.66,41.66,1,-80566,64447,145013,-16119,0,0,4497,0,0,,4497,4497
20,05/14/2018,61,15:00,15:15,,,0,37.42,37.42,0,-43221,95585,138806,52364,0,0,508,0,0,,508,508
20,05/14/2018,62,15:15,15:30,35.66,,0,35.66,35.66,1,-69082,78501,147583,9419,0,0,83,0,0,,83,83
20,05/14/2018,63,15:30,15:45,35.67,,0,35.67,35.67,1,-65028,83416,148444,18388,0,0,250,0,0,,250,250
20,05/14/2018,64,15:45,16:00,35.71,,0,35.71,35.71,1,-72564,71683,144247,-881,0,0,329,0,0,,329,329
20,05/14/2018,65,16:00,16:15,35.93,,0,35.93,35.93,1,-62395,98104,160499,35709,0,0,155,0,0,,155,155
20,05/14/2018,66,16:15,16:30,,,0,37.33,37.33,0,-73784,96507,170291,22723,0,0,0,0,0,,0,0
20,05/14/2018,67,16:30,16:45,,,0,37.37,37.37,0,-79954,94424,174378,14470,0,0,0,0,0,,0,0
20,05/14/2018,68,16:45,17:00,40.74,,0,40.74,40.74,1,-95962,86880,182842,-9082,0,0,472,0,0,,472,472
20,05/14/2018,69,17:00,17:15,66.15,,0,66.15,66.15,1,-89622,60857,150479,-28765,0,0,6367,0,0,,6367,6367
20,05/14/2018,70,17:15,17:30,69.09,,0,69.09,69.09,1,-93957,56497,150454,-37460,0,0,28799,0,0,,28799,28799
20,05/14/2018,71,17:30,17:45,55.48,,0,55.48,55.48,1,-103539,60710,164249,-42829,0,0,31845,0,0,,31845,31845
20,05/14/2018,72,17:45,18:00,57.13,,0,57.13,57.13,1,-102425,68012,170437,-34413,0,0,36787,0,0,,36787,36787
20,05/14/2018,73,18:00,18:15,150.12,,0,150.12,150.12,1,-148187,75432,223619,-72755,0,0,52956,0,0,,52956,52956
20,05/14/2018,74,18:15,18:30,45.22,38.82,0,38.82,38.82,-1,-91734,98455,190189,6721,0,-301,8329,0,0,,8630,8028
20,05/14/2018,75,18:30,18:45,,39.13,0,39.13,39.13,-1,-87352,94706,182058,7354,0,-925,0,0,0,,925,-925
20,05/14/2018,76,18:45,19:00,44.41,,0,44.41,44.41,1,-93221,90251,183472,-2970,0,0,1303,0,0,,1303,1303
20,05/14/2018,77,19:00,19:15,63.04,,0,63.04,63.04,1,-130992,109118,240110,-21874,0,0,10071,0,0,,10071,10071
20,05/14/2018,78,19:15,19:30,47.22,,0,47.22,47.22,1,-127036,100173,227209,-26863,0,0,24527,0,0,,24527,24527
20,05/14/2018,79,19:30,19:45,52.15,,0,52.15,52.15,1,-136304,98645,234949,-37659,0,0,30179,0,0,,30179,30179
20,05/14/2018,80,19:45,20:00,59.72,,0,59.72,59.72,1,-141365,96901,238266,-44464,0,0,37258,0,0,,37258,37258
20,05/14/2018,81,20:00,20:15,151.12,,0,151.12,151.12,1,-149775,57030,206805,-92745,0,0,61501,0,0,,61501,61501
20,05/14/2018,82,20:15,20:30,151.12,,0,151.12,151.12,1,-122937,57478,180415,-65459,0,0,78750,0,0,,78750,78750
20,05/14/2018,83,20:30,20:45,50.24,36.15,0,36.15,36.15,-1,-83093,81062,164155,-2031,0,-1127,20490,0,0,,21617,19363
20,05/14/2018,84,20:45,21:00,,35.74,0,35.74,35.74,-1,-91848,103308,195156,11460,0,-6940,0,0,0,,6940,-6940
20,05/14/2018,85,21:00,21:15,,-150.78,0,-150.78,-150.78,-1,-54385,122698,177083,68313,0,-37222,0,0,0,,37222,-37222
20,05/14/2018,86,21:15,21:30,44.45,32.49,0,44.45,44.45,1,-61508,62758,124266,1250,0,-20228,348,0,0,,20576,-19880
20,05/14/2018,87,21:30,21:45,52.15,32.49,0,52.15,52.15,1,-71535,49950,121485,-21585,0,-152,3942,0,0,,4094,3790
20,05/14/2018,88,21:45,22:00,67.15,,0,67.15,67.15,1,-101552,50703,152255,-50849,0,0,35846,0,0,,35846,35846
20,05/14/2018,89,22:00,22:15,151.12,,0,151.12,151.12,1,-137111,46849,183960,-90262,0,0,61374,0,0,,61374,61374
20,05/14/2018,90,22:15,22:30,78.15,,0,78.15,78.15,1,-124229,74141,198370,-50088,0,0,63765,0,0,,63765,63765
20,05/14/2018,91,22:30,22:45,43.39,,0,43.39,43.39,1,-99762,94537,194299,-5225,0,0,11834,0,0,,11834,11834
20,05/14/2018,92,22:45,23:00,,,0,24.94,24.94,0,-88284,116020,204304,27736,0,0,0,0,0,,0,0
20,05/14/2018,93,23:00,23:15,67.15,,0,67.15,67.15,1,-123360,82816,206176,-40544,0,0,13137,0,0,,13137,13137
20,05/14/2018,94,23:15,23:30,43.01,35.74,0,35.74,35.74,-1,-85738,111176,196914,25438,0,-1290,5237,0,0,,6527,3947
20,05/14/2018,95,23:30,23:45,,31.74,0,31.74,31.74,-1,-59984,105162,165146,45178,0,-6086,0,0,0,,6086,-6086
20,05/14/2018,96,23:45,0:00,,-150.78,0,-150.78,-150.78,-1,-66750,126427,193177,59677,0,-34745,0,0,0,,34745,-34745
20,05/15/2018,1,0:00,0:15,,32.74,0,32.74,32.74,-1,-35611,105645,141256,70034,0,-7724,0,0,0,,7724,-7724
20,05/15/2018,2,0:15,0:30,,,0,37.76,37.76,0,-48355,96604,144959,48249,0,0,0,0,0,,0,0
20,05/15/2018,3,0:30,0:45,,-11.26,0,-11.26,-11.26,-1,-36866,113735,150601,76869,0,-15039,0,0,0,,15039,-15039
20,05/15/2018,4,0:45,1:00,,-150.03,0,-150.03,-150.03,-1,-47609,117026,164635,69417,0,-55556,0,0,0,,55556,-55556
20,05/15/2018,5,1:00,1:15,,15.03,0,15.03,15.03,-1,-32647,174529,207176,141882,0,-43887,0,0,0,,43887,-43887
20,05/15/2018,6,1:15,1:30,,35.88,0,35.88,35.88,-1,-53509,146824,200333,93315,0,-16276,0,0,0,,16276,-16276
20,05/15/2018,7,1:30,1:45,,11.12,0,11.12,11.12,-1,-20425,157354,177779,136929,0,-11306,0,0,0,,11306,-11306
20,05/15/2018,8,1:45,2:00,,32.74,0,32.74,32.74,-1,-40117,139013,179130,98896,0,-23539,0,0,0,,23539,-23539
20,05/15/2018,9,2:00,2:15,,28.74,0,28.74,28.74,-1,-21147,153688,174835,132541,0,-20335,0,0,0,,20335,-20335
20,05/15/2018,10,2:15,2:30,,35.53,0,35.53,35.53,-1,-18630,126054,144684,107424,0,-18723,0,0,0,,18723,-18723
20,05/15/2018,11,2:30,2:45,,35.86,0,35.86,35.86,-1,-20897,114624,135521,93727,0,-7821,0,0,0,,7821,-7821
20,05/15/2018,12,2:45,3:00,,,0,36.79,36.79,0,-18873,99847,118720,80974,0,-45,0,0,0,,45,-45
20,05/15/2018,13,3:00,3:15,35.38,,0,35.38,35.38,1,-73845,70218,144063,-3627,0,0,4,0,0,,4,4
20,05/15/2018,14,3:15,3:30,79.79,,0,79.79,79.79,1,-88382,37485,125867,-50897,0,0,22195,0,0,,22195,22195
20,05/15/2018,15,3:30,3:45,48.18,,0,48.18,48.18,1,-80583,52560,133143,-28023,0,0,26234,0,0,,26234,26234
20,05/15/2018,16,3:45,4:00,,,0,36.81,36.81,0,-92252,56541,148793,-35711,0,0,1176,0,0,,1176,1176
20,05/15/2018,17,4:00,4:15,,36.74,0,36.74,36.74,-1,-80384,55701,136085,-24683,0,-1,0,0,0,,1,-1
20,05/15/2018,18,4:15,4:30,,36.74,0,36.74,36.74,-1,-55338,45702,101040,-9636,0,-7,0,0,0,,7,-7
20,05/15/2018,19,4:30,4:45,40.74,,0,40.74,40.74,1,-64943,44136,109079,-20807,0,0,969,0,0,,969,969
20,05/15/2018,20,4:45,5:00,37.02,,0,37.02,37.02,1,-64882,44961,109843,-19921,0,0,2053,0,0,,2053,2053
20,05/15/2018,21,5:00,5:15,35.06,30.46,0,30.46,30.46,-1,-82366,92836,175202,10470,0,-1013,907,0,0,,1920,-106
20,05/15/2018,22,5:15,5:30,,23.26,0,23.26,23.26,-1,-53851,89752,143603,35901,0,-9878,0,0,0,,9878,-9878
20,05/15/2018,23,5:30,5:45,,,0,36.53,36.53,0,-68970,84577,153547,15607,0,-123,0,0,0,,123,-123
20,05/15/2018,24,5:45,6:00,,,0,36.53,36.53,0,-68715,78766,147481,10051,0,0,0,0,0,,0,0
20,05/15/2018,25,6:00,6:15,,39.67,0,39.67,39.67,-1,-119053,135987,255040,16934,0,-134,0,0,0,,134,-134
20,05/15/2018,26,6:15,6:30,,38.86,0,38.86,38.86,-1,-61823,89297,151120,27474,0,-915,0,0,0,,915,-915
20,05/15/2018,27,6:30,6:45,54.57,,0,54.57,54.57,1,-70474,46395,116869,-24079,0,0,9173,0,0,,9173,9173
20,05/15/2018,28,6:45,7:00,54.66,,0,54.66,54.66,1,-76208,50649,126857,-25559,0,0,33589,0,0,,33589,33589
20,05/15/2018,29,7:00,7:15,40.67,-11.26,0,40.67,-11.26,2,-41059,134892,175951,93833,0,-13999,9714,0,0,,23713,-4285
20,05/15/2018,30,7:15,7:30,,35.03,0,35.03,35.03,-1,-45189,95754,140943,50565,0,-11309,0,0,0,,11309,-11309
20,05/15/2018,31,7:30,7:45,45.7,35.03,0,45.7,45.7,1,-68639,56355,124994,-12284,0,-939,2770,0,0,,3709,1831
20,05/15/2018,32,7:45,8:00,91.14,,0,91.14,91.14,1,-117129,54707,171836,-62422,0,0,35013,0,0,,35013,35013
20,05/15/2018,33,8:00,8:15,48.36,37.43,0,37.43,37.43,-1,-81224,82010,163234,786,0,-88,24299,0,0,,24387,24211
20,05/15/2018,34,8:15,8:30,40.74,38.03,0,40.74,37.88,2,-61641,62650,124291,1009,0,-186,249,0,0,,435,63
20,05/15/2018,35,8:30,8:45,52.9,,0,52.9,52.9,1,-76595,54205,130800,-22390,0,0,9482,0,0,,9482,9482
20,05/15/2018,36,8:45,9:00,51.14,,0,51.14,51.14,1,-98763,63129,161892,-35634,0,0,28988,0,0,,28988,28988
20,05/15/2018,37,9:00,9:15,158.11,,0,158.11,158.11,1,-120585,40378,160963,-80207,0,0,48089,0,0,,48089,48089
20,05/15/2018,38,9:15,9:30,158.11,,0,158.11,158.11,1,-108678,35883,144561,-72795,0,0,75857,0,0,,75857,75857
20,05/15/2018,39,9:30,9:45,55.02,,0,55.02,55.02,1,-85621,60901,146522,-24720,0,0,33704,0,0,,33704,33704
20,05/15/2018,40,9:45,10:00,91.14,,0,91.14,91.14,1,-91367,40890,132257,-50477,0,0,18810,0,0,,18810,18810
20,05/15/2018,41,10:00,10:15,111.98,,0,111.98,111.98,1,-121125,30195,151320,-90930,0,0,59721,0,0,,59721,59721
20,05/15/2018,42,10:15,10:30,78.02,,0,78.02,78.02,1,-115772,24694,140466,-91078,0,0,66498,0,0,,66498,66498
20,05/15/2018,43,10:30,10:45,66.14,,0,66.14,66.14,1,-98776,31171,129947,-67605,0,0,60331,0,0,,60331,60331
20,05/15/2018,44,10:45,11:00,100.18,,0,100.18,100.18,1,-91594,31176,122770,-60418,0,0,44003,11250,0,,55253,55253
20,05/15/2018,45,11:00,11:15,42.35,,0,42.35,42.35,1,-65369,53007,118376,-12362,0,0,8307,0,0,,8307,8307
20,05/15/2018,46,11:15,11:30,45.22,,0,45.22,45.22,1,-68753,64124,132877,-4629,0,0,4251,0,0,,4251,4251
20,05/15/2018,47,11:30,11:45,,,0,37.9,37.9,0,-65753,84385,150138,18632,0,0,180,0,0,,180,180
20,05/15/2018,48,11:45,12:00,,,0,37.99,37.99,0,-73428,89357,162785,15929,0,0,0,0,0,,0,0
20,05/15/2018,49,12:00,12:15,,,0,37.87,37.87,0,-59099,141908,201007,82809,0,0,0,0,0,,0,0
20,05/15/2018,50,12:15,12:30,,,0,37.95,37.95,0,-69519,107150,176669,37631,0,0,0,0,0,,0,0
20,05/15/2018,51,12:30,12:45,,,0,37.95,37.95,0,-77623,104465,182088,26842,0,0,0,0,0,,0,0
20,05/15/2018,52,12:45,13:00,,39.88,0,39.88,39.88,-1,-67575,96509,164084,28934,0,-445,0,0,0,,445,-445
20,05/15/2018,53,13:00,13:15,,39.62,0,39.62,39.62,-1,-39745,69421,109166,29676,0,-1140,0,0,0,,1140,-1140
20,05/15/2018,54,13:15,13:30,,39.6,0,39.6,39.6,-1,-50212,59317,109529,9105,0,-38,0,0,0,,38,-38
20,05/15/2018,55,13:30,13:45,,39.62,0,39.62,39.62,-1,-49008,62330,111338,13322,0,-912,0,0,0,,912,-912
20,05/15/2018,56,13:45,14:00,,,0,37.7,37.7,0,-54249,51442,105691,-2807,0,0,0,0,0,,0,0
20,05/15/2018,57,14:00,14:15,,,0,37.57,37.57,0,-52851,61316,114167,8465,0,0,0,0,0,,0,0
20,05/15/2018,58,14:15,14:30,41.54,,0,41.54,41.54,1,-74435,66372,140807,-8063,0,0,988,0,0,,988,988
20,05/15/2018,59,14:30,14:45,43.29,,0,43.29,43.29,1,-71697,65052,136749,-6645,0,0,4139,0,0,,4139,4139
20,05/15/2018,60,14:45,15:00,40.74,,0,40.74,40.74,1,-74340,63429,137769,-10911,0,0,3214,0,0,,3214,3214
20,05/15/2018,61,15:00,15:15,45.12,,0,45.12,45.12,1,-71587,62687,134274,-8900,0,0,4827,0,0,,4827,4827
20,05/15/2018,62,15:15,15:30,40.74,,0,40.74,40.74,1,-73947,57444,131391,-16503,0,0,2202,0,0,,2202,2202
20,05/15/2018,63,15:30,15:45,43.37,,0,43.37,43.37,1,-76256,49599,125855,-26657,0,0,6253,0,0,,6253,6253
20,05/15/2018,64,15:45,16:00,40.74,,0,40.74,40.74,1,-83218,50720,133938,-32498,0,0,5396,0,0,,5396,5396
20,05/15/2018,65,16:00,16:15,,,0,37.4,37.4,0,-62179,52325,114504,-9854,0,0,916,0,0,,916,916
20,05/15/2018,66,16:15,16:30,,,0,37.37,37.37,0,-57970,53766,111736,-4204,0,0,0,0,0,,0,0
20,05/15/2018,67,16:30,16:45,,,0,37.39,37.39,0,-50884,57887,108771,7003,0,0,0,0,0,,0,0
20,05/15/2018,68,16:45,17:00,43.6,,0,43.6,43.6,1,-80217,56524,136741,-23693,0,0,2133,0,0,,2133,2133
20,05/15/2018,69,17:00,17:15,40.59,,0,40.59,40.59,1,-39300,50270,89570,10970,0,0,64,0,0,,64,64
20,05/15/2018,70,17:15,17:30,42.3,,0,42.3,42.3,1,-60867,43893,104760,-16974,0,0,2718,0,0,,2718,2718
20,05/15/2018,71,17:30,17:45,40.74,,0,40.74,40.74,1,-56814,58057,114871,1243,0,0,4211,0,0,,4211,4211
20,05/15/2018,72,17:45,18:00,,,0,37.79,37.79,0,-53104,66217,119321,13113,0,0,652,0,0,,652,652
20,05/15/2018,73,18:00,18:15,,36.64,0,36.64,36.64,-1,-58883,61175,120058,2292,0,-709,0,0,0,,709,-709
20,05/15/2018,74,18:15,18:30,,32.74,0,32.74,32.74,-1,-40200,86065,126265,45865,0,-13222,0,0,0,,13222,-13222
20,05/15/2018,75,18:30,18:45,,30.33,0,30.33,30.33,-1,-44881,92278,137159,47397,0,-17631,0,0,0,,17631,-17631
20,05/15/2018,76,18:45,19:00,,39.2,0,39.2,39.2,-1,-56993,95935,152928,38942,0,-7049,0,0,0,,7049,-7049
20,05/15/2018,77,19:00,19:15,,,0,37.84,37.84,0,-65991,58236,124227,-7755,0,-53,0,0,0,,53,-53
20,05/15/2018,78,19:15,19:30,51.14,,0,51.14,51.14,1,-84914,38174,123088,-46740,0,0,3467,0,0,,3467,3467
20,05/15/2018,79,19:30,19:45,66.14,,0,66.14,66.14,1,-77079,40302,117381,-36777,0,0,21653,0,0,,21653,21653
20,05/15/2018,80,19:45,20:00,43.02,,0,43.02,43.02,1,-76577,36618,113195,-39959,0,0,15251,0,0,,15251,15251
20,05/15/2018,81,20:00,20:15,45.22,,0,45.22,45.22,1,-63327,32220,95547,-31107,0,0,18993,0,0,,18993,18993
20,05/15/2018,82,20:15,20:30,45.22,,0,45.22,45.22,1,-65591,35727,101318,-29864,0,0,21477,0,0,,21477,21477
20,05/15/2018,83,20:30,20:45,40.96,,0,40.96,40.96,1,-58556,49683,108239,-8873,0,0,15638,0,0,,15638,15638
20,05/15/2018,84,20:45,21:00,40.52,,0,40.52,40.52,1,-69652,60810,130462,-8842,0,0,2478,0,0,,2478,2478
20,05/15/2018,85,21:00,21:15,39.02,,0,39.02,39.02,1,-43728,68437,112165,24709,0,0,665,0,0,,665,665
20,05/15/2018,86,21:15,21:30,36.02,,0,36.02,36.02,1,-34788,64054,98842,29266,0,0,5,0,0,,5,5
20,05/15/2018,87,21:30,21:45,40.74,,0,40.74,40.74,1,-51073,60160,111233,9087,0,0,232,0,0,,232,232
20,05/15/2018,88,21:45,22:00,40.74,,0,40.74,40.74,1,-69796,55603,125399,-14193,0,0,2975,0,0,,2975,2975
20,05/15/2018,89,22:00,22:15,149.02,,0,149.02,149.02,1,-94880,20818,115698,-74062,0,0,33359,0,0,,33359,33359
20,05/15/2018,90,22:15,22:30,51.14,,0,51.14,51.14,1,-41383,37837,79220,-3546,0,0,25964,0,0,,25964,25964
20,05/15/2018,91,22:30,22:45,51.14,39.95,0,39.95,39.95,-1,-29718,56996,86714,27278,0,-921,747,0,0,,1668,-174
20,05/15/2018,92,22:45,23:00,,39.95,0,39.95,39.95,-1,-20228,94428,114656,74200,0,-1083,0,0,0,,1083,-1083
20,05/15/2018,93,23:00,23:15,,39.41,0,39.41,39.41,-1,-42523,53747,96270,11224,0,-512,0,0,0,,512,-512
20,05/15/2018,94,23:15,23:30,,8.16,0,8.16,8.16,-1,-23484,70731,94215,47247,0,-10234,0,0,0,,10234,-10234
20,05/15/2018,95,23:30,23:45,,9.29,0,9.29,9.29,-1,-18123,63112,81235,44989,0,-18991,0,0,0,,18991,-18991
20,05/15/2018,96,23:45,0:00,,7.36,0,7.36,7.36,-1,-15953,99533,115486,83580,0,-15853,0,0,0,,15853,-15853
20,05/16/2018,1,0:00,0:15,60.79,31.53,0,60.79,31.53,2,-69968,29020,98988,-40948,0,-11258,5284,0,0,,16542,-5974
20,05/16/2018,2,0:15,0:30,42.14,36.74,0,36.74,36.74,-1,-44962,54350,99312,9388,0,-187,5465,0,0,,5652,5278
20,05/16/2018,3,0:30,0:45,42.14,27.89,0,27.89,27.89,-1,-34999,78418,113417,43419,0,-22672,13,0,0,,22685,-22659
20,05/16/2018,4,0:45,1:00,,13.74,0,13.74,13.74,-1,-26118,87723,113841,61605,0,-46004,0,0,0,,46004,-46004
20,05/16/2018,5,1:00,1:15,62.57,30.78,0,62.57,30.78,2,-65165,35796,100961,-29369,0,-15998,3949,0,0,,19947,-12049
20,05/16/2018,6,1:15,1:30,41.49,,0,41.49,41.49,1,-46413,48326,94739,1913,0,0,3907,0,0,,3907,3907
20,05/16/2018,7,1:30,1:45,,36.74,0,36.74,36.74,-1,-29814,65317,95131,35503,0,-1506,0,0,0,,1506,-1506
20,05/16/2018,8,1:45,2:00,,26.15,0,26.15,26.15,-1,-29891,71201,101092,41310,0,-26723,0,0,0,,26723,-26723
20,05/16/2018,9,2:00,2:15,34.83,30.78,0,36.83,30.78,2,-37481,59662,97143,22181,0,-23083,21,0,0,,23104,-23062
20,05/16/2018,10,2:15,2:30,34.85,30.78,0,34.85,34.85,1,-27635,43789,71424,16154,0,-377,55,0,0,,432,-322
20,05/16/2018,11,2:30,2:45,,,0,36.9,36.9,0,-27325,42025,69350,14700,0,0,0,0,0,,0,0
20,05/16/2018,12,2:45,3:00,,,0,36.97,36.97,0,-23285,52353,75638,29068,0,0,0,0,0,,0,0
20,05/16/2018,13,3:00,3:15,,,0,36.9,36.9,0,-37477,91601,129078,54124,0,0,0,0,0,,0,0
20,05/16/2018,14,3:15,3:30,,,0,36.91,36.91,0,-33469,76885,110354,43416,0,0,0,0,0,,0,0
20,05/16/2018,15,3:30,3:45,,,0,36.9,36.9,0,-32222,98947,131169,66725,0,0,0,0,0,,0,0
20,05/16/2018,16,3:45,4:00,,38.94,0,38.94,38.94,-1,-27042,120554,147596,93512,0,-255,0,0,0,,255,-255
20,05/16/2018,17,4:00,4:15,,35.72,0,35.72,35.72,-1,-28795,69138,97933,40343,0,-4012,0,0,0,,4012,-4012
20,05/16/2018,18,4:15,4:30,,16.67,0,16.67,16.67,-1,-21296,85684,106980,64388,0,-17945,0,0,0,,17945,-17945
20,05/16/2018,19,4:30,4:45,,32.74,0,32.74,32.74,-1,-28146,70088,98234,41942,0,-16723,0,0,0,,16723,-16723
20,05/16/2018,20,4:45,5:00,,30.78,0,30.78,30.78,-1,-29356,90700,120056,61344,0,-6735,0,0,0,,6735,-6735
20,05/16/2018,21,5:00,5:15,,39.78,0,39.78,39.78,-1,-82942,97028,179970,14086,0,-4316,0,0,0,,4316,-4316
20,05/16/2018,22,5:15,5:30,,28.74,0,28.74,28.74,-1,-34972,89950,124922,54978,0,-12978,0,0,0,,12978,-12978
20,05/16/2018,23,5:30,5:45,,37.36,0,37.36,37.36,-1,-23520,99083,122603,75563,0,-8515,0,0,0,,8515,-8515
20,05/16/2018,24,5:45,6:00,,36.14,0,36.14,36.14,-1,-34131,112434,146565,78303,0,-2718,0,0,0,,2718,-2718
20,05/16/2018,25,6:00,6:15,,29.15,0,29.15,29.15,-1,-91900,117210,209110,25310,0,-14709,0,0,0,,14709,-14709
20,05/16/2018,26,6:15,6:30,,27.78,0,27.78,27.78,-1,-66773,71537,138310,4764,0,-21605,0,0,0,,21605,-21605
20,05/16/2018,27,6:30,6:45,56.76,27.78,0,56.76,56.76,1,-96230,40274,136504,-55956,0,-2494,6191,0,0,,8685,3697
20,05/16/2018,28,6:45,7:00,74.24,,0,74.24,74.24,1,-145901,67574,213475,-78327,0,0,31845,0,0,,31845,31845
20,05/16/2018,29,7:00,7:15,48.12,,0,48.12,48.12,1,-136904,100636,237540,-36268,0,0,30362,0,0,,30362,30362
20,05/16/2018,30,7:15,7:30,42.2,39.08,0,42.2,39.08,2,-114313,89413,203726,-24900,0,-395,2706,0,0,,3101,2311
20,05/16/2018,31,7:30,7:45,51.07,,0,51.07,51.07,1,-122504,70777,193281,-51727,0,0,14591,0,0,,14591,14591
20,05/16/2018,32,7:45,8:00,152.12,,0,152.12,152.12,1,-162099,68139,230238,-93960,0,0,44979,0,0,,44979,44979
20,05/16/2018,33,8:00,8:15,63.12,40,0,40,40,-1,-81288,98375,179663,17087,0,-210,22748,0,0,,22958,22538
20,05/16/2018,34,8:15,8:30,,38.19,0,38.19,38.19,-1,-72767,88252,161019,15485,0,-1438,0,0,0,,1438,-1438
20,05/16/2018,35,8:30,8:45,,38.19,0,38.19,38.19,-1,-57572,76908,134480,19336,0,-1669,0,0,0,,1669,-1669
20,05/16/2018,36,8:45,9:00,46.34,39.11,0,46.34,46.34,1,-73720,60556,134276,-13164,0,-508,1651,0,0,,2159,1143
20,05/16/2018,37,9:00,9:15,47.02,,0,47.02,47.02,1,-77513,64946,142459,-12567,0,0,9790,0,0,,9790,9790
20,05/16/2018,38,9:15,9:30,45.9,,0,45.9,45.9,1,-92574,64230,156804,-28344,0,0,13711,0,0,,13711,13711
20,05/16/2018,39,9:30,9:45,75.1,,0,75.1,75.1,1,-97984,51043,149027,-46941,0,0,32415,0,0,,32415,32415
20,05/16/2018,40,9:45,10:00,104.12,,0,104.12,104.12,1,-106496,44758,151254,-61738,0,0,47836,0,0,,47836,47836
20,05/16/2018,41,10:00,10:15,156.6,,0,156.6,156.6,1,-142555,32994,175549,-109561,0,0,75486,0,0,,75486,75486
20,05/16/2018,42,10:15,10:30,126.12,,0,126.12,126.12,1,-98498,39202,137700,-59296,0,0,71972,5000,0,,76972,76972
20,05/16/2018,43,10:30,10:45,83.38,,0,83.38,83.38,1,-73729,49756,123485,-23973,0,0,23713,5000,0,,28713,28713
20,05/16/2018,44,10:45,11:00,42.8,,0,42.8,42.8,1,-70980,62587,133567,-8393,0,0,4681,0,0,,4681,4681
20,05/16/2018,45,11:00,11:15,166.58,,0,166.58,166.58,1,-136906,34005,170911,-102901,0,0,31859,0,0,,31859,31859
20,05/16/2018,46,11:15,11:30,166.58,,0,166.58,166.58,1,-121513,34558,156071,-86955,0,0,85748,0,0,,85748,85748
20,05/16/2018,47,11:30,11:45,221.7,,0,221.7,221.7,1,-88647,48135,136782,-40512,0,0,53230,6250,0,,59480,59480
20,05/16/2018,48,11:45,12:00,221.7,38.98,0,38.98,38.98,-1,-68758,63042,131800,-5716,0,-638,7066,0,0,,7704,6428
20,05/16/2018,49,12:00,12:15,149.12,,0,149.12,149.12,1,-119484,50954,170438,-68530,0,0,20723,0,0,,20723,20723
20,05/16/2018,50,12:15,12:30,149.12,,0,149.12,149.12,1,-133058,51673,184731,-81385,0,0,83276,0,0,,83276,83276
20,05/16/2018,51,12:30,12:45,356.7,,0,356.7,356.7,1,-124599,89554,214153,-35045,0,0,42432,8750,0,,51182,51182
20,05/16/2018,52,12:45,13:00,356.7,37.15,0,37.15,37.15,-1,-94113,116996,211109,22883,0,-291,5842,0,0,,6133,5551
20,05/16/2018,53,13:00,13:15,,37.15,0,37.15,37.15,-1,-63465,108329,171794,44864,0,-730,0,0,0,,730,-730
20,05/16/2018,54,13:15,13:30,,34.5,0,34.5,34.5,-1,-68053,113502,181555,45449,0,-258,0,0,0,,258,-258
20,05/16/2018,55,13:30,13:45,,33.15,0,33.15,33.15,-1,-73613,126427,200040,52814,0,-1701,0,0,0,,1701,-1701
20,05/16/2018,56,13:45,14:00,,19.86,0,19.86,19.86,-1,-67064,132216,199280,65152,0,-8900,0,0,0,,8900,-8900
20,05/16/2018,57,14:00,14:15,,-4.78,0,-4.78,-4.78,-1,-53165,111136,164301,57971,0,-14463,0,0,0,,14463,-14463
20,05/16/2018,58,14:15,14:30,,,0,36.72,36.72,0,-51496,94460,145956,42964,0,0,0,0,0,,0,0
20,05/16/2018,59,14:30,14:45,,35.42,0,35.42,35.42,-1,-29249,123926,153175,94677,0,-1719,0,0,0,,1719,-1719
20,05/16/2018,60,14:45,15:00,,29.15,0,29.15,29.15,-1,-48205,149261,197466,101056,0,-16885,0,0,0,,16885,-16885
20,05/16/2018,61,15:00,15:15,,25.94,0,25.94,25.94,-1,-38533,65491,104024,26958,0,-30897,0,0,0,,30897,-30897
20,05/16/2018,62,15:15,15:30,41.68,37.15,0,41.68,37.14,2,-50533,60684,111217,10151,0,-7599,1023,0,0,,8622,-6576
20,05/16/2018,63,15:30,15:45,,29.15,0,29.15,29.15,-1,-32574,68488,101062,35914,0,-23643,0,0,0,,23643,-23643
20,05/16/2018,64,15:45,16:00,,30.78,0,30.78,30.78,-1,-36811,68770,105581,31959,0,-22010,0,0,0,,22010,-22010
20,05/16/2018,65,16:00,16:15,,37.15,0,37.15,37.15,-1,-74609,58035,132644,-16574,0,-4158,0,0,0,,4158,-4158
20,05/16/2018,66,16:15,16:30,41.68,,0,41.68,41.68,1,-56193,63493,119686,7300,0,0,296,0,0,,296,296
20,05/16/2018,67,16:30,16:45,,,0,37.02,37.02,0,-45755,72759,118514,27004,0,0,0,0,0,,0,0
20,05/16/2018,68,16:45,17:00,,37.15,0,37.15,37.15,-1,-52828,66550,119378,13722,0,-23,0,0,0,,23,-23
20,05/16/2018,69,17:00,17:15,,-150.78,0,-150.78,-150.78,-1,-56895,102123,159018,45228,0,-22628,0,0,0,,22628,-22628
20,05/16/2018,70,17:15,17:30,,30.78,0,30.78,30.78,-1,-53819,87180,140999,33361,0,-20756,0,0,0,,20756,-20756
20,05/16/2018,71,17:30,17:45,,28.18,0,28.18,28.18,-1,-52335,95643,147978,43308,0,-29015,0,0,0,,29015,-29015
20,05/16/2018,72,17:45,18:00,,-31.78,0,-31.78,-31.78,-1,-55423,125058,180481,69635,0,-49352,0,0,0,,49352,-49352
20,05/16/2018,73,18:00,18:15,,31.61,0,31.61,31.61,-1,-72191,115177,187368,42986,0,-16064,0,0,0,,16064,-16064
20,05/16/2018,74,18:15,18:30,,,0,37.54,37.54,0,-50381,117729,168110,67348,0,0,0,0,0,,0,0
20,05/16/2018,75,18:30,18:45,,,0,37.78,37.78,0,-46848,139439,186287,92591,0,0,0,0,0,,0,0
20,05/16/2018,76,18:45,19:00,,,0,37.78,37.78,0,-43841,138200,182041,94359,0,0,0,0,0,,0,0
20,05/16/2018,77,19:00,19:15,41.68,,0,41.68,41.68,1,-57928,70722,128650,12794,0,0,670,0,0,,670,670
20,05/16/2018,78,19:15,19:30,45.77,,0,45.77,45.77,1,-71526,60523,132049,-11003,0,0,3049,0,0,,3049,3049
20,05/16/2018,79,19:30,19:45,53.27,,0,53.27,53.27,1,-79874,50204,130078,-29670,0,0,15368,0,0,,15368,15368
20,05/16/2018,80,19:45,20:00,64.77,,0,64.77,64.77,1,-103693,49025,152718,-54668,0,0,50600,0,0,,50600,50600
20,05/16/2018,81,20:00,20:15,42.54,,0,42.54,42.54,1,-79471,77702,157173,-1769,0,0,20642,0,0,,20642,20642
20,05/16/2018,82,20:15,20:30,54.3,,0,54.3,54.3,1,-84384,55752,140136,-28632,0,0,4241,0,0,,4241,4241
20,05/16/2018,83,20:30,20:45,41.71,,0,41.71,41.71,1,-76108,62614,138722,-13494,0,0,6279,0,0,,6279,6279
20,05/16/2018,84,20:45,21:00,,,0,38.06,38.06,0,-68988,60516,129504,-8472,0,0,391,0,0,,391,391
20,05/16/2018,85,21:00,21:15,45.77,,0,45.77,45.77,1,-57248,47876,105124,-9372,0,0,1553,0,0,,1553,1553
20,05/16/2018,86,21:15,21:30,41.7,,0,41.7,41.7,1,-77745,33836,111581,-43909,0,0,2244,0,0,,2244,2244
20,05/16/2018,87,21:30,21:45,41.68,,0,41.68,41.68,1,-88423,27241,115664,-61182,0,0,1556,0,0,,1556,1556
20,05/16/2018,88,21:45,22:00,43.66,,0,43.66,43.66,1,-122083,26297,148380,-95786,0,0,6296,0,0,,6296,6296
20,05/16/2018,89,22:00,22:15,41.68,,0,41.68,41.68,1,-96945,126460,223405,29515,0,0,3760,0,0,,3760,3760
20,05/16/2018,90,22:15,22:30,41.68,29.15,0,29.15,29.15,-1,-71583,101333,172916,29750,0,-6317,634,0,0,,6951,-5683
20,05/16/2018,91,22:30,22:45,,33.15,0,33.15,33.15,-1,-46611,83419,130030,36808,0,-7925,0,0,0,,7925,-7925
20,05/16/2018,92,22:45,23:00,,33.15,0,33.15,33.15,-1,-38585,111583,150168,72998,0,-174,0,0,0,,174,-174
20,05/16/2018,93,23:00,23:15,,36.73,0,36.73,36.73,-1,-132999,18453,151452,-114546,0,-358,0,0,0,,358,-358
20,05/16/2018,94,23:15,23:30,,39.9,0,39.9,39.9,-1,-90011,17252,107263,-72759,0,-2,0,0,0,,2,-2
20,05/16/2018,95,23:30,23:45,,33.15,0,33.15,33.15,-1,-54861,20466,75327,-34395,0,-3374,0,0,0,,3374,-3374
20,05/16/2018,96,23:45,0:00,,-35.85,0,-35.85,-35.85,-1,-74334,55186,129520,-19148,0,-28661,0,0,0,,28661,-28661
20,05/17/2018,1,0:00,0:15,,33.15,0,33.15,33.15,-1,-74697,189045,263742,114348,0,-9945,0,0,0,,9945,-9945
20,05/17/2018,2,0:15,0:30,,-10.85,0,-10.85,-10.85,-1,-52232,194923,247155,142691,0,-7966,0,0,0,,7966,-7966
20,05/17/2018,3,0:30,0:45,,-27.45,0,-27.45,-27.45,-1,-78016,182910,260926,104894,0,-41302,0,0,0,,41302,-41302
20,05/17/2018,4,0:45,1:00,34.01,-150.03,0,34.01,-150.03,2,-158637,175221,333858,16584,0,-50437,6,0,0,,50443,-50431
20,05/17/2018,5,1:00,1:15,54.47,-150.03,0,54.47,54.47,1,-111074,69116,180190,-41958,0,-1071,2335,0,0,,3406,1264
20,05/17/2018,6,1:15,1:30,55.23,,0,55.23,55.23,1,-97818,68373,166191,-29445,0,0,7160,0,0,,7160,7160
20,05/17/2018,7,1:30,1:45,,,0,24.72,24.72,0,-72422,74789,147211,2367,0,0,0,0,0,,0,0
20,05/17/2018,8,1:45,2:00,,37.15,0,37.15,37.15,-1,-62149,72083,134232,9934,0,-3079,0,0,0,,3079,-3079
20,05/17/2018,9,2:00,2:15,53.45,37.15,0,53.45,53.45,1,-91373,11981,103354,-79392,0,-329,2638,0,0,,2967,2309
20,05/17/2018,10,2:15,2:30,41.15,,0,41.15,41.15,1,-103408,16171,119579,-87237,0,0,3870,0,0,,3870,3870
20,05/17/2018,11,2:30,2:45,34.27,,0,34.27,34.27,1,-89287,25926,115213,-63361,0,0,89,0,0,,89,89
20,05/17/2018,12,2:45,3:00,,,0,35.71,35.71,0,-80547,28513,109060,-52034,0,0,0,0,0,,0,0
20,05/17/2018,13,3:00,3:15,35.09,,0,35.09,35.09,1,-71603,34918,106521,-36685,0,0,697,0,0,,697,697
20,05/17/2018,14,3:15,3:30,34.34,,0,34.34,34.34,1,-59692,42470,102162,-17222,0,0,833,0,0,,833,833
20,05/17/2018,15,3:30,3:45,,,0,35.76,35.76,0,-51141,41577,92718,-9564,0,0,0,0,0,,0,0
20,05/17/2018,16,3:45,4:00,,33.15,0,33.15,33.15,-1,-49902,40589,90491,-9313,0,-20,0,0,0,,20,-20
20,05/17/2018,17,4:00,4:15,,-26.45,0,-26.45,-26.45,-1,-32596,70513,103109,37917,0,-21775,0,0,0,,21775,-21775
20,05/17/2018,18,4:15,4:30,34.35,-150.03,0,35.75,-150.03,2,-25978,77339,103317,51361,0,-18547,22,0,0,,18569,-18525
20,05/17/2018,19,4:30,4:45,,-150.03,0,-150.03,-150.03,-1,-84339,33277,117616,-51062,0,-75579,0,0,0,,75579,-75579
20,05/17/2018,20,4:45,5:00,,5.24,0,5.24,5.24,-1,-57796,35941,93737,-21855,0,-49453,0,0,0,,49453,-49453
20,05/17/2018,21,5:00,5:15,,33.15,0,33.15,33.15,-1,-32063,35462,67525,3399,0,-17155,0,0,0,,17155,-17155
20,05/17/2018,22,5:15,5:30,,,0,36.6,36.6,0,-21208,32496,53704,11288,0,0,0,0,0,,0,0
20,05/17/2018,23,5:30,5:45,41.15,38.49,0,38.49,38.49,-1,-34785,31057,65842,-3728,0,-378,2,0,0,,380,-376
20,05/17/2018,24,5:45,6:00,41.15,38.49,0,41.15,41.15,1,-58662,36396,95058,-22266,0,-184,65,0,0,,249,-119
20,05/17/2018,25,6:00,6:15,55.28,39.64,0,55.28,37.16,2,-103383,76780,180163,-26603,0,-41,11558,0,0,,11599,11517
20,05/17/2018,26,6:15,6:30,55.28,14.27,0,14.27,14.27,-1,-44596,52939,97535,8343,0,-7077,121,0,0,,7198,-6956
20,05/17/2018,27,6:30,6:45,89.27,14.27,0,89.27,89.27,1,-73309,30622,103931,-42687,0,-97,8815,0,0,,8912,8718
20,05/17/2018,28,6:45,7:00,148.02,38.11,0,148.02,37.12,2,-85836,82567,168403,-3269,0,-37,38575,0,0,,38612,38538
20,05/17/2018,29,7:00,7:15,148.02,19.76,0,19.76,19.76,-1,-34984,100584,135568,65600,0,-5561,2053,0,0,,7614,-3508
20,05/17/2018,30,7:15,7:30,,37.63,0,37.63,37.63,-1,-20040,85409,105449,65369,0,-2754,0,0,0,,2754,-2754
20,05/17/2018,31,7:30,7:45,,37.63,0,37.63,37.63,-1,-17359,87160,104519,69801,0,-3134,0,0,0,,3134,-3134
20,05/17/2018,32,7:45,8:00,,33.69,0,33.69,33.69,-1,-42698,92209,134907,49511,0,-2382,0,0,0,,2382,-2382
20,05/17/2018,33,8:00,8:15,,37.69,0,37.69,37.69,-1,-41160,72424,113584,31264,0,-4056,0,0,0,,4056,-4056
20,05/17/2018,34,8:15,8:30,45.88,37.69,0,50.38,37.69,2,-49690,40824,90514,-8866,0,-1142,1308,0,0,,2450,166
20,05/17/2018,35,8:30,8:45,45.88,,0,45.88,45.88,1,-53146,37814,90960,-15332,0,0,5121,0,0,,5121,5121
20,05/17/2018,36,8:45,9:00,43.77,37.69,0,50.37,37.69,2,-48564,39600,88164,-8964,0,-30,5198,0,0,,5228,5168
20,05/17/2018,37,9:00,9:15,43.77,26.63,0,26.63,26.63,-1,-22556,69945,92501,47389,0,-16004,234,0,0,,16238,-15770
20,05/17/2018,38,9:15,9:30,,14.69,0,14.69,14.69,-1,-26275,61665,87940,35390,0,-30913,0,0,0,,30913,-30913
20,05/17/2018,39,9:30,9:45,,-20.34,0,-20.34,-20.34,-1,-25091,98034,123125,72943,0,-26353,0,0,0,,26353,-26353
20,05/17/2018,40,9:45,10:00,,-59.63,0,-59.63,-59.63,-1,-31455,88341,119796,56886,0,-42291,0,0,0,,42291,-42291
20,05/17/2018,41,10:00,10:15,,37.39,0,37.39,37.39,-1,-58704,71187,129891,12483,0,-16950,0,0,0,,16950,-16950
20,05/17/2018,42,10:15,10:30,,,0,50.42,50.42,0,-40287,109028,149315,68741,0,0,0,0,0,,0,0
20,05/17/2018,43,10:30,10:45,,,0,50.43,50.43,0,-38888,143951,182839,105063,0,0,0,0,0,,0,0
20,05/17/2018,44,10:45,11:00,,,0,50.43,50.43,0,-39300,149824,189124,110524,0,0,0,0,0,,0,0
20,05/17/2018,45,11:00,11:15,,,0,39.25,39.25,0,-45836,154329,200165,108493,0,0,0,0,0,,0,0
20,05/17/2018,46,11:15,11:30,,37.69,0,37.69,37.69,-1,-46717,166732,213449,120015,0,-1584,0,0,0,,1584,-1584
20,05/17/2018,47,11:30,11:45,,37.69,0,37.69,37.69,-1,-46758,174001,220759,127243,0,-3429,0,0,0,,3429,-3429
20,05/17/2018,48,11:45,12:00,,33.69,0,33.69,33.69,-1,-51718,189622,241340,137904,0,-9585,0,0,0,,9585,-9585
20,05/17/2018,49,12:00,12:15,,37.69,0,37.69,37.69,-1,-72428,153107,225535,80679,0,-8795,0,0,0,,8795,-8795
20,05/17/2018,50,12:15,12:30,,-150.03,0,-150.03,-150.03,-1,-49290,160514,209804,111224,0,-13171,0,0,0,,13171,-13171
20,05/17/2018,51,12:30,12:45,,-150.03,0,-150.03,-150.03,-1,-79706,117096,196802,37390,0,-33523,0,0,0,,33523,-33523
20,05/17/2018,52,12:45,13:00,,-150.03,0,-150.03,-150.03,-1,-69049,129890,198939,60841,0,-32150,0,0,0,,32150,-32150
20,05/17/2018,53,13:00,13:15,,32.03,0,32.03,32.03,-1,-59426,99811,159237,40385,0,-23031,0,0,0,,23031,-23031
20,05/17/2018,54,13:15,13:30,,35.35,0,35.35,35.35,-1,-72151,97235,169386,25084,0,-23571,0,0,0,,23571,-23571
20,05/17/2018,55,13:30,13:45,,35.62,0,35.62,35.62,-1,-72533,111356,183889,38823,0,-15495,0,0,0,,15495,-15495
20,05/17/2018,56,13:45,14:00,,33.69,0,33.69,33.69,-1,-89510,114866,204376,25356,0,-17603,0,0,0,,17603,-17603
20,05/17/2018,57,14:00,14:15,,35.04,0,35.04,35.04,-1,-76522,102782,179304,26260,0,-13296,0,0,0,,13296,-13296
20,05/17/2018,58,14:15,14:30,,,0,39.1,39.1,0,-86323,107803,194126,21480,0,-349,0,0,0,,349,-349
20,05/17/2018,59,14:30,14:45,,37.69,0,37.69,37.69,-1,-86900,109336,196236,22436,0,-2004,0,0,0,,2004,-2004
20,05/17/2018,60,14:45,15:00,,39.77,0,39.77,39.77,-1,-89587,102987,192574,13400,0,-1574,0,0,0,,1574,-1574
20,05/17/2018,61,15:00,15:15,,37.69,0,37.69,37.69,-1,-90532,130265,220797,39733,0,-1152,0,0,0,,1152,-1152
20,05/17/2018,62,15:15,15:30,,33.79,0,33.79,33.79,-1,-74663,114555,189218,39892,0,-5305,0,0,0,,5305,-5305
20,05/17/2018,63,15:30,15:45,,37.61,0,37.61,37.61,-1,-75628,103487,179115,27859,0,-14031,0,0,0,,14031,-14031
20,05/17/2018,64,15:45,16:00,,37.69,0,37.69,37.69,-1,-77714,84037,161751,6323,0,-10574,0,0,0,,10574,-10574
20,05/17/2018,65,16:00,16:15,,37.63,0,37.63,37.63,-1,-49861,91051,140912,41190,0,-4494,0,0,0,,4494,-4494
20,05/17/2018,66,16:15,16:30,,39.24,0,39.24,39.24,-1,-38076,86224,124300,48148,0,-1899,0,0,0,,1899,-1899
20,05/17/2018,67,16:30,16:45,89.69,39.24,0,89.69,89.69,1,-91925,58289,150214,-33636,0,-321,4601,0,0,,4922,4280
20,05/17/2018,68,16:45,17:00,148.02,,0,148.02,148.02,1,-114830,39147,153977,-75683,0,0,58571,0,0,,58571,58571
20,05/17/2018,69,17:00,17:15,148.02,-28.22,0,-28.22,-28.22,-1,-36278,87054,123332,50776,0,-11123,12028,0,0,,23151,905
20,05/17/2018,70,17:15,17:30,43.46,38.36,0,43.46,43.46,1,-62690,51075,113765,-11615,0,-1413,1032,0,0,,2445,-381
20,05/17/2018,71,17:30,17:45,45.69,,0,45.69,45.69,1,-58076,36865,94941,-21211,0,0,10731,0,0,,10731,10731
20,05/17/2018,72,17:45,18:00,45.69,,0,45.69,45.69,1,-74449,52670,127119,-21779,0,0,13077,0,0,,13077,13077
20,05/17/2018,73,18:00,18:15,41.63,,0,41.63,41.63,1,-61198,51985,113183,-9213,0,0,7295,0,0,,7295,7295
20,05/17/2018,74,18:15,18:30,41.63,40.28,0,41.63,37.71,2,-57670,46299,103969,-11371,0,-53,523,0,0,,576,470
20,05/17/2018,75,18:30,18:45,45.57,,0,45.57,45.57,1,-57670,49007,106677,-8663,0,0,3364,0,0,,3364,3364
20,05/17/2018,76,18:45,19:00,45.69,,0,45.69,45.69,1,-76599,49779,126378,-26820,0,0,14692,0,0,,14692,14692
20,05/17/2018,77,19:00,19:15,63.36,,0,63.36,63.36,1,-82803,40686,123489,-42117,0,0,22752,0,0,,22752,22752
20,05/17/2018,78,19:15,19:30,52.14,,0,52.14,52.14,1,-79754,41347,121101,-38407,0,0,33643,0,0,,33643,33643
20,05/17/2018,79,19:30,19:45,45.69,,0,45.69,45.69,1,-71718,51096,122814,-20622,0,0,22449,0,0,,22449,22449
20,05/17/2018,80,19:45,20:00,113.02,,0,113.02,113.02,1,-94984,36821,131805,-58163,0,0,32312,0,0,,32312,32312
20,05/17/2018,81,20:00,20:15,51.3,,0,51.3,51.3,1,-59453,48238,107691,-11215,0,0,23307,0,0,,23307,23307
20,05/17/2018,82,20:15,20:30,62.02,,0,62.02,62.02,1,-77873,46416,124289,-31457,0,0,17593,0,0,,17593,17593
20,05/17/2018,83,20:30,20:45,43.27,40.34,0,40.34,40.34,-1,-41274,51806,93080,10532,0,-78,9607,0,0,,9685,9529
20,05/17/2018,84,20:45,21:00,43.27,37.63,0,37.63,37.63,-1,-54790,58985,113775,4195,0,-1846,35,0,0,,1881,-1811
20,05/17/2018,85,21:00,21:15,,39.07,0,39.07,39.07,-1,-35900,68129,104029,32229,0,-2000,0,0,0,,2000,-2000
20,05/17/2018,86,21:15,21:30,45.69,40.33,0,45.69,45.69,1,-59604,51257,110861,-8347,0,-300,761,0,0,,1061,461
20,05/17/2018,87,21:30,21:45,45.69,,0,45.69,45.69,1,-64777,53502,118279,-11275,0,0,4538,0,0,,4538,4538
20,05/17/2018,88,21:45,22:00,148.02,,0,148.02,148.02,1,-118819,44949,163768,-73870,0,0,28651,0,0,,28651,28651
20,05/17/2018,89,22:00,22:15,148.02,,0,148.02,148.02,1,-113573,49605,163178,-63968,0,0,78179,0,0,,78179,78179
20,05/17/2018,90,22:15,22:30,51.99,,0,51.99,51.99,1,-74795,41368,116163,-33427,0,0,37037,0,0,,37037,37037
20,05/17/2018,91,22:30,22:45,48.61,,0,48.61,48.61,1,-75780,52101,127881,-23679,0,0,25019,0,0,,25019,25019
20,05/17/2018,92,22:45,23:00,43.82,,0,43.82,43.82,1,-68337,53444,121781,-14893,0,0,8235,0,0,,8235,8235
20,05/17/2018,93,23:00,23:15,148.02,,0,148.02,148.02,1,-107067,28451,135518,-78616,0,0,42208,0,0,,42208,42208
20,05/17/2018,94,23:15,23:30,66.02,,0,66.02,66.02,1,-100150,39039,139189,-61111,0,0,65901,0,0,,65901,65901
20,05/17/2018,95,23:30,23:45,45,,0,45,45,1,-65537,36734,102271,-28803,0,0,29299,0,0,,29299,29299
20,05/17/2018,96,23:45,0:00,44.36,,0,44.36,44.36,1,-89506,55197,144703,-34309,0,0,12611,0,0,,12611,12611
20,05/18/2018,1,0:00,0:15,64.27,37.27,0,64.27,37.27,2,-91026,84974,176000,-6052,0,-854,4912,0,0,,5766,4058
20,05/18/2018,2,0:15,0:30,148.12,,0,148.12,148.12,1,-143042,27343,170385,-115699,0,0,59146,0,0,,59146,59146
20,05/18/2018,3,0:30,0:45,66.12,,0,66.12,66.12,1,-99715,56983,156698,-42732,0,0,50322,0,0,,50322,50322
20,05/18/2018,4,0:45,1:00,44.04,,0,44.04,44.04,1,-90174,75475,165649,-14699,0,0,1632,0,0,,1632,1632
20,05/18/2018,5,1:00,1:15,105.12,,0,105.12,105.12,1,-138758,83482,222240,-55276,0,0,30967,0,0,,30967,30967
20,05/18/2018,6,1:15,1:30,66.12,,0,66.12,66.12,1,-97938,41475,139413,-56463,0,0,45221,0,0,,45221,45221
20,05/18/2018,7,1:30,1:45,66.12,,0,66.12,66.12,1,-92913,49210,142123,-43703,0,0,49290,0,0,,49290,49290
20,05/18/2018,8,1:45,2:00,45.27,,0,45.27,45.27,1,-99544,74308,173852,-25236,0,0,23217,0,0,,23217,23217
20,05/18/2018,9,2:00,2:15,49.27,,0,49.27,49.27,1,-113950,92542,206492,-21408,0,0,13585,0,0,,13585,13585
20,05/18/2018,10,2:15,2:30,138.12,,0,138.12,138.12,1,-124615,62254,186869,-62361,0,0,45455,0,0,,45455,45455
20,05/18/2018,11,2:30,2:45,55.69,,0,55.69,55.69,1,-118788,79157,197945,-39631,0,0,40058,0,0,,40058,40058
20,05/18/2018,12,2:45,3:00,148.12,,0,148.12,148.12,1,-163962,63325,227287,-100637,0,0,56893,0,0,,56893,56893
20,05/18/2018,13,3:00,3:15,64.27,,0,64.27,64.27,1,-122308,117109,239417,-5199,0,0,35118,0,0,,35118,35118
20,05/18/2018,14,3:15,3:30,148.12,,0,148.12,148.12,1,-123416,43461,166877,-79955,0,0,38634,0,0,,38634,38634
20,05/18/2018,15,3:30,3:45,67.1,,0,67.1,67.1,1,-123300,48745,172045,-74555,0,0,71865,0,0,,71865,71865
20,05/18/2018,16,3:45,4:00,64.27,,0,64.27,64.27,1,-123782,51097,174879,-72685,0,0,67746,0,0,,67746,67746
20,05/18/2018,17,4:00,4:15,64.27,,0,64.27,64.27,1,-103596,51564,155160,-52032,0,0,60764,0,0,,60764,60764
20,05/18/2018,18,4:15,4:30,49.27,,0,49.27,49.27,1,-96705,55136,151841,-41569,0,0,37297,0,0,,37297,37297
20,05/18/2018,19,4:30,4:45,148.12,,0,148.12,148.12,1,-117969,41125,159094,-76844,0,0,50707,0,0,,50707,50707
20,05/18/2018,20,4:45,5:00,148.12,,0,148.12,148.12,1,-130864,54479,185343,-76385,0,0,78275,0,0,,78275,78275
20,05/18/2018,21,5:00,5:15,97.99,,0,97.99,97.99,1,-115832,52341,168173,-63491,0,0,63191,0,0,,63191,63191
20,05/18/2018,22,5:15,5:30,46.63,,0,46.63,46.63,1,-67056,52438,119494,-14618,0,0,25603,0,0,,25603,25603
20,05/18/2018,23,5:30,5:45,46.63,41.78,0,41.78,41.78,-1,-50581,59360,109941,8779,0,-237,725,0,0,,962,488
20,05/18/2018,24,5:45,6:00,49.27,41.78,0,49.27,49.27,1,-70125,51175,121300,-18950,0,-16,3128,0,0,,3144,3112
20,05/18/2018,25,6:00,6:15,41.27,39.14,0,41.27,39.14,2,-103821,129555,233376,25734,0,-1282,1472,0,0,,2754,190
20,05/18/2018,26,6:15,6:30,,40.97,0,40.97,40.97,-1,-65395,92533,157928,27138,0,-421,0,0,0,,421,-421
20,05/18/2018,27,6:30,6:45,,,0,40.45,40.45,0,-68335,73106,141441,4771,0,0,0,0,0,,0,0
20,05/18/2018,28,6:45,7:00,45.27,,0,45.27,45.27,1,-91535,87188,178723,-4347,0,0,1515,0,0,,1515,1515
20,05/18/2018,29,7:00,7:15,,-150.78,0,-150.78,-150.78,-1,-69136,165041,234177,95905,0,-18507,0,0,0,,18507,-18507
20,05/18/2018,30,7:15,7:30,,37.7,0,37.7,37.7,-1,-77772,128947,206719,51175,0,-9328,0,0,0,,9328,-9328
20,05/18/2018,31,7:30,7:45,45.27,,0,45.27,45.27,1,-87707,82866,170573,-4841,0,0,406,0,0,,406,406
20,05/18/2018,32,7:45,8:00,89.69,,0,89.69,89.69,1,-113264,74955,188219,-38309,0,0,26108,0,0,,26108,26108
20,05/18/2018,33,8:00,8:15,64.35,,0,64.35,64.35,1,-127207,79297,206504,-47910,0,0,29530,0,0,,29530,29530
20,05/18/2018,34,8:15,8:30,77.71,,0,77.71,77.71,1,-124000,68406,192406,-55594,0,0,45421,0,0,,45421,45421
20,05/18/2018,35,8:30,8:45,153.12,,0,153.12,153.12,1,-128963,51046,180009,-77917,0,0,58541,0,0,,58541,58541
20,05/18/2018,36,8:45,9:00,113.12,,0,113.12,113.12,1,-138062,52970,191032,-85092,0,0,67917,0,0,,67917,67917
20,05/18/2018,37,9:00,9:15,179.81,,0,179.81,179.81,1,-190352,60579,250931,-129773,0,0,87195,0,0,,87195,87195
20,05/18/2018,38,9:15,9:30,227.79,,0,227.79,227.79,1,-178266,71922,250188,-106344,0,0,95827,2500,0,,98327,98327
20,05/18/2018,39,9:30,9:45,227.79,,0,227.79,227.79,1,-152912,109621,262533,-43291,0,0,59148,2500,0,,61648,61648
20,05/18/2018,40,9:45,10:00,45.27,,0,45.27,45.27,1,-129002,95208,224210,-33794,0,0,18602,0,0,,18602,18602
20,05/18/2018,41,10:00,10:15,43.32,62.99,0,62.99,62.99,-1,-73282,128629,201911,55347,0,-139,10286,0,0,,10425,10147
20,05/18/2018,42,10:15,10:30,43.32,41.78,0,41.78,41.78,-1,-69794,135182,204976,65388,0,-1539,5,0,0,,1544,-1534
20,05/18/2018,43,10:30,10:45,,63.05,0,63.05,63.05,-1,-67506,133542,201048,66036,0,-498,0,0,0,,498,-498
20,05/18/2018,44,10:45,11:00,,40.78,0,40.78,40.78,-1,-64833,125329,190162,60496,0,-409,0,0,0,,409,-409
20,05/18/2018,45,11:00,11:15,,37.27,0,37.27,37.27,-1,-58634,149221,207855,90587,0,-2526,0,0,0,,2526,-2526
20,05/18/2018,46,11:15,11:30,,39.76,0,39.76,39.76,-1,-54044,158978,213022,104934,0,-1633,0,0,0,,1633,-1633
20,05/18/2018,47,11:30,11:45,,39.78,0,39.78,39.78,-1,-55592,173894,229486,118302,0,-4151,0,0,0,,4151,-4151
20,05/18/2018,48,11:45,12:00,,29.27,0,29.27,29.27,-1,-54097,169556,223653,115459,0,-7105,0,0,0,,7105,-7105
20,05/18/2018,49,12:00,12:15,41.27,14.27,0,41.27,14.27,2,-75985,102855,178840,26870,0,-11248,130,0,0,,11378,-11118
20,05/18/2018,50,12:15,12:30,41.27,32.1,0,41.27,32.1,2,-65509,93861,159370,28352,0,-3550,182,0,0,,3732,-3368
20,05/18/2018,51,12:30,12:45,,23.01,0,23.01,23.01,-1,-63320,115891,179211,52571,0,-18268,0,0,0,,18268,-18268
20,05/18/2018,52,12:45,13:00,,25.64,0,25.64,25.64,-1,-60709,109466,170175,48757,0,-18551,0,0,0,,18551,-18551
20,05/18/2018,53,13:00,13:15,,17.78,0,17.78,17.78,-1,-50038,111823,161861,61785,0,-21018,0,0,0,,21018,-21018
20,05/18/2018,54,13:15,13:30,,33.27,0,33.27,33.27,-1,-53920,99928,153848,46008,0,-1021,0,0,0,,1021,-1021
20,05/18/2018,55,13:30,13:45,,21.44,0,21.44,21.44,-1,-54318,96417,150735,42099,0,-25440,0,0,0,,25440,-25440
20,05/18/2018,56,13:45,14:00,,29.27,0,29.27,29.27,-1,-57036,100250,157286,43214,0,-34088,0,0,0,,34088,-34088
20,05/18/2018,57,14:00,14:15,,32.78,0,32.78,32.78,-1,-54339,101744,156083,47405,0,-22221,0,0,0,,22221,-22221
20,05/18/2018,58,14:15,14:30,,21.83,0,21.83,21.83,-1,-54474,110690,165164,56216,0,-2691,0,0,0,,2691,-2691
20,05/18/2018,59,14:30,14:45,,8.88,0,8.88,8.88,-1,-61586,110165,171751,48579,0,-32864,0,0,0,,32864,-32864
20,05/18/2018,60,14:45,15:00,,37.27,0,37.27,37.27,-1,-57653,115790,173443,58137,0,-20157,0,0,0,,20157,-20157
20,05/18/2018,61,15:00,15:15,,,0,38.07,38.07,0,-55413,78759,134172,23346,0,-4339,0,0,0,,4339,-4339
20,05/18/2018,62,15:15,15:30,,,0,38.07,38.07,0,-50326,80552,130878,30226,0,0,0,0,0,,0,0
20,05/18/2018,63,15:30,15:45,,,0,38.07,38.07,0,-56369,79291,135660,22922,0,0,0,0,0,,0,0
20,05/18/2018,64,15:45,16:00,41.27,,0,41.27,41.27,1,-64693,68655,133348,3962,0,0,149,0,0,,149,149
20,05/18/2018,65,16:00,16:15,,41.43,0,41.43,41.43,-1,-55028,69691,124719,14663,0,-10,0,0,0,,10,-10
20,05/18/2018,66,16:15,16:30,,38.39,0,38.39,38.39,-1,-54825,74912,129737,20087,0,-2207,0,0,0,,2207,-2207
20,05/18/2018,67,16:30,16:45,,37.99,0,37.99,37.99,-1,-57750,66534,124284,8784,0,-1993,0,0,0,,1993,-1993
20,05/18/2018,68,16:45,17:00,43.87,,0,43.87,43.87,1,-57740,54943,112683,-2797,0,0,2526,0,0,,2526,2526
20,05/18/2018,69,17:00,17:15,41.27,38.64,0,41.27,38.48,2,-67364,74609,141973,7245,0,-254,1040,0,0,,1294,786
20,05/18/2018,70,17:15,17:30,45.27,,0,45.27,45.27,1,-75402,48695,124097,-26707,0,0,527,0,0,,527,527
20,05/18/2018,71,17:30,17:45,69.12,,0,69.12,69.12,1,-67659,24504,92163,-43155,0,0,29277,0,0,,29277,29277
20,05/18/2018,72,17:45,18:00,49.27,,0,49.27,49.27,1,-48948,29493,78441,-19455,0,0,27721,0,0,,27721,27721
20,05/18/2018,73,18:00,18:15,48,,0,48,48,1,-82010,24778,106788,-57232,0,0,14756,0,0,,14756,14756
20,05/18/2018,74,18:15,18:30,60.54,,0,60.54,60.54,1,-87638,27171,114809,-60467,0,0,18495,0,0,,18495,18495
20,05/18/2018,75,18:30,18:45,52.71,,0,52.71,52.71,1,-79493,32923,112416,-46570,0,0,25957,0,0,,25957,25957
20,05/18/2018,76,18:45,19:00,57.37,,0,57.37,57.37,1,-67547,30917,98464,-36630,0,0,33922,0,0,,33922,33922
20,05/18/2018,77,19:00,19:15,76.43,,0,76.43,76.43,1,-79041,29452,108493,-49589,0,0,28363,0,0,,28363,28363
20,05/18/2018,78,19:15,19:30,49.27,,0,49.27,49.27,1,-74055,32425,106480,-41630,0,0,31710,0,0,,31710,31710
20,05/18/2018,79,19:30,19:45,50.15,,0,50.15,50.15,1,-77105,37078,114183,-40027,0,0,11456,0,0,,11456,11456
20,05/18/2018,80,19:45,20:00,57.93,,0,57.93,57.93,1,-74589,36338,110927,-38251,0,0,25971,0,0,,25971,25971
20,05/18/2018,81,20:00,20:15,41.27,39.71,0,39.71,39.71,-1,-50229,56471,106700,6242,0,-547,9445,0,0,,9992,8898
20,05/18/2018,82,20:15,20:30,44.14,39.71,0,44.14,44.14,1,-52969,42830,95799,-10139,0,-17,871,0,0,,888,854
20,05/18/2018,83,20:30,20:45,43.99,,0,43.99,43.99,1,-54790,63603,118393,8813,0,0,1095,0,0,,1095,1095
20,05/18/2018,84,20:45,21:00,,,0,39.41,39.41,0,-77173,73274,150447,-3899,0,0,0,0,0,,0,0
20,05/18/2018,85,21:00,21:15,43.5,,0,43.5,43.5,1,-56380,68761,125141,12381,0,0,332,0,0,,332,332
20,05/18/2018,86,21:15,21:30,44.38,,0,44.38,44.38,1,-60087,65580,125667,5493,0,0,2748,0,0,,2748,2748
20,05/18/2018,87,21:30,21:45,41.27,,0,41.27,41.27,1,-52247,70343,122590,18096,0,0,190,0,0,,190,190
20,05/18/2018,88,21:45,22:00,,40.53,0,40.53,40.53,-1,-57173,71534,128707,14361,0,-28,0,0,0,,28,-28
20,05/18/2018,89,22:00,22:15,,37.96,0,37.96,37.96,-1,-48167,80652,128819,32485,0,-155,0,0,0,,155,-155
20,05/18/2018,90,22:15,22:30,,40.39,0,40.39,40.39,-1,-43587,74768,118355,31181,0,-2160,0,0,0,,2160,-2160
20,05/18/2018,91,22:30,22:45,,38.74,0,38.74,38.74,-1,-39176,92910,132086,53734,0,-2690,0,0,0,,2690,-2690
20,05/18/2018,92,22:45,23:00,,23.75,0,23.75,23.75,-1,-44440,115374,159814,70934,0,-7992,0,0,0,,7992,-7992
20,05/18/2018,93,23:00,23:15,,37.78,0,37.78,37.78,-1,-81873,66091,147964,-15782,0,-5462,0,0,0,,5462,-5462
20,05/18/2018,94,23:15,23:30,,41.53,0,41.53,41.53,-1,-78310,67781,146091,-10529,0,-3,0,0,0,,3,-3
20,05/18/2018,95,23:30,23:45,,33.27,0,33.27,33.27,-1,-60153,83117,143270,22964,0,-9911,0,0,0,,9911,-9911
20,05/18/2018,96,23:45,0:00,,40.39,0,40.39,40.39,-1,-92604,103216,195820,10612,0,-5134,0,0,0,,5134,-5134
21,05/19/2018,1,0:00,0:15,64.04,40.39,0,64.04,64.04,1,-56348,33097,89445,-23251,0,-165,3234,0,0,,3399,3069
21,05/19/2018,2,0:15,0:30,92.7,,0,92.7,92.7,1,-62754,47100,109854,-15654,0,0,22979,0,0,,22979,22979
21,05/19/2018,3,0:30,0:45,92.7,16.06,0,16.06,16.06,-1,-33552,81227,114779,47675,0,-3879,2618,0,0,,6497,-1261
21,05/19/2018,4,0:45,1:00,,13.26,0,13.26,13.26,-1,-38309,87099,125408,48790,0,-36846,0,0,0,,36846,-36846
21,05/19/2018,5,1:00,1:15,,38.03,0,38.03,38.03,-1,-27086,96437,123523,69351,0,-12642,0,0,0,,12642,-12642
21,05/19/2018,6,1:15,1:30,,,0,38.04,38.04,0,-35097,70581,105678,35484,0,0,0,0,0,,0,0
21,05/19/2018,7,1:30,1:45,,,0,38.04,38.04,0,-50353,64282,114635,13929,0,0,0,0,0,,0,0
21,05/19/2018,8,1:45,2:00,,39.09,0,39.09,39.09,-1,-50377,86782,137159,36405,0,-623,0,0,0,,623,-623
21,05/19/2018,9,2:00,2:15,,38.87,0,38.87,38.87,-1,-61889,70092,131981,8203,0,-379,0,0,0,,379,-379
21,05/19/2018,10,2:15,2:30,43.01,,0,43.01,43.01,1,-55343,51667,107010,-3676,0,0,851,0,0,,851,851
21,05/19/2018,11,2:30,2:45,43.01,65.84,0,65.84,65.84,-1,-51884,59728,111612,7844,0,-68,76,0,0,,144,8
21,05/19/2018,12,2:45,3:00,,65.84,0,65.84,65.84,-1,-50023,54500,104523,4477,0,-629,0,0,0,,629,-629
21,05/19/2018,13,3:00,3:15,54.02,65.84,0,54.02,54.02,1,-63346,35980,99326,-27366,0,-150,8841,0,0,,8991,8691
21,05/19/2018,14,3:15,3:30,44.78,,0,44.78,44.78,1,-60565,50661,111226,-9904,0,0,11505,0,0,,11505,11505
21,05/19/2018,15,3:30,3:45,44.78,38.87,0,38.87,38.87,-1,-54815,58016,112831,3201,0,-1794,1063,0,0,,2857,-731
21,05/19/2018,16,3:45,4:00,,36.15,0,36.15,36.15,-1,-49755,62245,112000,12490,0,-8750,0,0,0,,8750,-8750
21,05/19/2018,17,4:00,4:15,43.01,38.87,0,43.01,38.87,2,-53915,49707,103622,-4208,0,-6878,774,0,0,,7652,-6104
21,05/19/2018,18,4:15,4:30,43.01,40.26,0,40.26,40.26,-1,-53990,51505,105495,-2485,0,-33,29,0,0,,62,-4
21,05/19/2018,19,4:30,4:45,,40.26,0,40.26,40.26,-1,-51828,50861,102689,-967,0,-2171,0,0,0,,2171,-2171
21,05/19/2018,20,4:45,5:00,,40.26,0,40.26,40.26,-1,-56834,52207,109041,-4627,0,-580,0,0,0,,580,-580
21,05/19/2018,21,5:00,5:15,44.74,,0,44.74,44.74,1,-63603,50686,114289,-12917,0,0,2623,0,0,,2623,2623
21,05/19/2018,22,5:15,5:30,44.75,,0,44.75,44.75,1,-61048,46255,107303,-14793,0,0,8802,0,0,,8802,8802
21,05/19/2018,23,5:30,5:45,43.01,30.87,0,30.87,30.87,-1,-48005,63684,111689,15679,0,-5112,3918,0,0,,9030,-1194
21,05/19/2018,24,5:45,6:00,43.01,30.87,0,30.87,30.87,-1,-38403,66052,104455,27649,0,-30581,6,0,0,,30587,-30575
21,05/19/2018,25,6:00,6:15,,30.81,0,30.81,30.81,-1,-35350,73700,109050,38350,0,-34132,0,0,0,,34132,-34132
21,05/19/2018,26,6:15,6:30,47.93,31.88,0,47.93,47.93,1,-44689,43313,88002,-1376,0,-26896,460,0,0,,27356,-26436
21,05/19/2018,27,6:30,6:45,55.7,31.88,0,55.7,55.7,1,-64119,48052,112171,-16067,0,-940,7226,0,0,,8166,6286
21,05/19/2018,28,6:45,7:00,58.92,,0,58.92,58.92,1,-77496,65845,143341,-11651,0,0,22323,0,0,,22323,22323
21,05/19/2018,29,7:00,7:15,58.92,34.81,0,34.81,34.81,-1,-70767,78489,149256,7722,0,-4629,4146,0,0,,8775,-483
21,05/19/2018,30,7:15,7:30,,38.22,0,38.22,38.22,-1,-60951,77627,138578,16676,0,-3522,0,0,0,,3522,-3522
21,05/19/2018,31,7:30,7:45,42.95,38.81,0,42.95,42.95,1,-69759,61656,131415,-8103,0,-1422,156,0,0,,1578,-1266
21,05/19/2018,32,7:45,8:00,43.38,,0,43.38,43.38,1,-86565,62913,149478,-23652,0,0,3049,0,0,,3049,3049
21,05/19/2018,33,8:00,8:15,42.92,40.11,0,42.92,38.27,2,-62216,70411,132627,8195,0,-1132,251,0,0,,1383,-881
21,05/19/2018,34,8:15,8:30,51,41.06,0,51,51,1,-65707,48117,113824,-17590,0,-603,1671,0,0,,2274,1068
21,05/19/2018,35,8:30,8:45,91.05,,0,91.05,91.05,1,-100405,49150,149555,-51255,0,0,36036,0,0,,36036,36036
21,05/19/2018,36,8:45,9:00,60.92,12.04,0,60.92,12.04,2,-117321,60244,177565,-57077,0,-329,36973,0,0,,37302,36644
21,05/19/2018,37,9:00,9:15,60.92,-34,0,-34,-34,-1,-53571,79555,133126,25984,0,-21029,3722,0,0,,24751,-17307
21,05/19/2018,38,9:15,9:30,44.79,54.21,0,48.58,48.58,2,-78397,56554,134951,-21843,0,-1100,1162,0,0,,2262,62
21,05/19/2018,39,9:30,9:45,43.51,,0,43.51,43.51,1,-86263,66286,152549,-19977,0,0,1268,0,0,,1268,1268
21,05/19/2018,40,9:45,10:00,49.35,,0,49.35,49.35,1,-102303,64870,167173,-37433,0,0,5246,0,0,,5246,5246
21,05/19/2018,41,10:00,10:15,75.48,,0,75.48,75.48,1,-100828,52649,153477,-48179,0,0,17747,0,0,,17747,17747
21,05/19/2018,42,10:15,10:30,42.95,,0,42.95,42.95,1,-92571,58596,151167,-33975,0,0,1936,0,0,,1936,1936
21,05/19/2018,43,10:30,10:45,45.06,,0,45.06,45.06,1,-97345,33671,131016,-63674,0,0,2238,0,0,,2238,2238
21,05/19/2018,44,10:45,11:00,47,,0,47,47,1,-102128,40709,142837,-61419,0,0,8792,0,0,,8792,8792
21,05/19/2018,45,11:00,11:15,44.75,,0,44.75,44.75,1,-94223,67649,161872,-26574,0,0,6563,0,0,,6563,6563
21,05/19/2018,46,11:15,11:30,44.55,,0,44.55,44.55,1,-98513,39745,138258,-58768,0,0,1637,0,0,,1637,1637
21,05/19/2018,47,11:30,11:45,,,0,42.05,42.05,0,-102360,44366,146726,-57994,0,0,36,0,0,,36,36
21,05/19/2018,48,11:45,12:00,42.39,,0,42.39,42.39,1,-114646,48476,163122,-66170,0,0,188,0,0,,188,188
21,05/19/2018,49,12:00,12:15,92.93,,0,92.93,92.93,1,-125007,84726,209733,-40281,0,0,18538,0,0,,18538,18538
21,05/19/2018,50,12:15,12:30,49.21,,0,49.21,49.21,1,-116023,97550,213573,-18473,0,0,23474,0,0,,23474,23474
21,05/19/2018,51,12:30,12:45,49.21,38.41,0,38.41,38.41,-1,-100682,95996,196678,-4686,0,-150,3145,0,0,,3295,2995
21,05/19/2018,52,12:45,13:00,,26.81,0,26.81,26.81,-1,-78304,85135,163439,6831,0,-9364,0,0,0,,9364,-9364
21,05/19/2018,53,13:00,13:15,45.37,41.22,0,45.37,41.22,2,-66669,44424,111093,-22245,0,-2641,1252,0,0,,3893,-1389
21,05/19/2018,54,13:15,13:30,42.95,,0,42.95,42.95,1,-67994,53440,121434,-14554,0,0,673,0,0,,673,673
21,05/19/2018,55,13:30,13:45,42.31,26.81,0,26.81,26.81,-1,-58466,64574,123040,6108,0,-1296,663,0,0,,1959,-633
21,05/19/2018,56,13:45,14:00,,26.81,0,26.81,26.81,-1,-57673,50537,108210,-7136,0,-7207,0,0,0,,7207,-7207
21,05/19/2018,57,14:00,14:15,,39.98,0,39.98,39.98,-1,-75402,92696,168098,17294,0,-472,0,0,0,,472,-472
21,05/19/2018,58,14:15,14:30,,40.25,0,40.25,40.25,-1,-76123,99760,175883,23637,0,-1676,0,0,0,,1676,-1676
21,05/19/2018,59,14:30,14:45,,41.22,0,41.22,41.22,-1,-75385,103330,178715,27945,0,-197,0,0,0,,197,-197
21,05/19/2018,60,14:45,15:00,,,0,41.66,41.66,0,-77631,95257,172888,17626,0,0,0,0,0,,0,0
21,05/19/2018,61,15:00,15:15,,,0,41.54,41.54,0,-78056,88085,166141,10029,0,0,0,0,0,,0,0
21,05/19/2018,62,15:15,15:30,,,0,41.54,41.54,0,-84881,100990,185871,16109,0,0,0,0,0,,0,0
21,05/19/2018,63,15:30,15:45,,40.9,0,40.9,40.9,-1,-75940,92254,168194,16314,0,-3,0,0,0,,3,-3
21,05/19/2018,64,15:45,16:00,,39.76,0,39.76,39.76,-1,-67809,107167,174976,39358,0,-1322,0,0,0,,1322,-1322
21,05/19/2018,65,16:00,16:15,,22.81,0,22.81,22.81,-1,-72667,100984,173651,28317,0,-6874,0,0,0,,6874,-6874
21,05/19/2018,66,16:15,16:30,,37.75,0,37.75,37.75,-1,-66318,95997,162315,29679,0,-2334,0,0,0,,2334,-2334
21,05/19/2018,67,16:30,16:45,,33.79,0,33.79,33.79,-1,-65862,102632,168494,36770,0,-1652,0,0,0,,1652,-1652
21,05/19/2018,68,16:45,17:00,,40.84,0,40.84,40.84,-1,-71013,98790,169803,27777,0,-90,0,0,0,,90,-90
21,05/19/2018,69,17:00,17:15,,18.73,0,18.73,18.73,-1,-36824,121201,158025,84377,0,-6096,0,0,0,,6096,-6096
21,05/19/2018,70,17:15,17:30,,34.81,0,34.81,34.81,-1,-38571,110743,149314,72172,0,-2849,0,0,0,,2849,-2849
21,05/19/2018,71,17:30,17:45,,34.81,0,34.81,34.81,-1,-47482,103655,151137,56173,0,-2028,0,0,0,,2028,-2028
21,05/19/2018,72,17:45,18:00,,33.81,0,33.81,33.81,-1,-45334,115662,160996,70328,0,-4399,0,0,0,,4399,-4399
21,05/19/2018,73,18:00,18:15,,39.68,0,39.68,39.68,-1,-105798,76641,182439,-29157,0,-1277,0,0,0,,1277,-1277
21,05/19/2018,74,18:15,18:30,42.95,,0,42.95,42.95,1,-58078,55654,113732,-2424,0,0,253,0,0,,253,253
21,05/19/2018,75,18:30,18:45,43.42,,0,43.42,43.42,1,-53468,47382,100850,-6086,0,0,2972,0,0,,2972,2972
21,05/19/2018,76,18:45,19:00,42.95,,0,42.95,42.95,1,-44411,50552,94963,6141,0,0,1697,0,0,,1697,1697
21,05/19/2018,77,19:00,19:15,47.1,,0,47.1,47.1,1,-67320,61082,128402,-6238,0,0,2846,0,0,,2846,2846
21,05/19/2018,78,19:15,19:30,,,0,42.1,42.1,0,-57491,72631,130122,15140,0,0,4,0,0,,4,4
21,05/19/2018,79,19:30,19:45,,41.41,0,41.41,41.41,-1,-36978,75519,112497,38541,0,-520,0,0,0,,520,-520
21,05/19/2018,80,19:45,20:00,,41.41,0,41.41,41.41,-1,-31220,71411,102631,40191,0,-567,0,0,0,,567,-567
21,05/19/2018,81,20:00,20:15,,41.41,0,41.41,41.41,-1,-36707,88563,125270,51856,0,-1003,0,0,0,,1003,-1003
21,05/19/2018,82,20:15,20:30,,41.41,0,41.41,41.41,-1,-38555,81714,120269,43159,0,-153,0,0,0,,153,-153
21,05/19/2018,83,20:30,20:45,,39.73,0,39.73,39.73,-1,-34361,83629,117990,49268,0,-145,0,0,0,,145,-145
21,05/19/2018,84,20:45,21:00,,38.81,0,38.81,38.81,-1,-36468,89772,126240,53304,0,-499,0,0,0,,499,-499
21,05/19/2018,85,21:00,21:15,,41.52,0,41.52,41.52,-1,-28764,81858,110622,53094,0,-12,0,0,0,,12,-12
21,05/19/2018,86,21:15,21:30,,9.43,0,9.43,9.43,-1,-27652,75522,103174,47870,0,-9853,0,0,0,,9853,-9853
21,05/19/2018,87,21:30,21:45,,6.12,0,6.12,6.12,-1,-31852,55007,86859,23155,0,-19342,0,0,0,,19342,-19342
21,05/19/2018,88,21:45,22:00,,-34,0,-34,-34,-1,-42246,48221,90467,5975,0,-33106,0,0,0,,33106,-33106
21,05/19/2018,89,22:00,22:15,,-34,0,-34,-34,-1,-97977,13613,111590,-84364,0,-35959,0,0,0,,35959,-35959
21,05/19/2018,90,22:15,22:30,,-9,0,-9,-9,-1,-82439,15024,97463,-67415,0,-31135,0,0,0,,31135,-31135
21,05/19/2018,91,22:30,22:45,,-15.31,0,-15.31,-15.31,-1,-79253,29547,108800,-49706,0,-53289,0,0,0,,53289,-53289
21,05/19/2018,92,22:45,23:00,,-34,0,-34,-34,-1,-58671,43615,102286,-15056,0,-43912,0,0,0,,43912,-43912
21,05/19/2018,93,23:00,23:15,109.01,-34,0,109.01,-34,2,-78294,46495,124789,-31799,0,-34763,3221,0,0,,37984,-31542
21,05/19/2018,94,23:15,23:30,42.95,33.25,0,33.25,33.25,-1,-62597,76334,138931,13737,0,-1524,446,0,0,,1970,-1078
21,05/19/2018,95,23:30,23:45,,16,0,16,16,-1,-42410,107750,150160,65340,0,-13549,0,0,0,,13549,-13549
21,05/19/2018,96,23:45,0:00,,-34,0,-34,-34,-1,-59408,111049,170457,51641,0,-53543,0,0,0,,53543,-53543
21,05/20/2018,1,0:00,0:15,,34.33,0,34.33,34.33,-1,-54504,77119,131623,22615,0,-13866,0,0,0,,13866,-13866
21,05/20/2018,2,0:15,0:30,,36.94,0,36.94,36.94,-1,-35541,58866,94407,23325,0,-1789,0,0,0,,1789,-1789
21,05/20/2018,3,0:30,0:45,,36,0,36,36,-1,-28741,49982,78723,21241,0,-5714,0,0,0,,5714,-5714
21,05/20/2018,4,0:45,1:00,,38.33,0,38.33,38.33,-1,-52979,47514,100493,-5465,0,-9275,0,0,0,,9275,-9275
21,05/20/2018,5,1:00,1:15,50.33,38.33,0,50.33,50.33,1,-43550,31006,74556,-12544,0,-401,1182,0,0,,1583,781
21,05/20/2018,6,1:15,1:30,65.33,,0,65.33,65.33,1,-50445,21014,71459,-29431,0,0,21621,0,0,,21621,21621
21,05/20/2018,7,1:30,1:45,65.33,40.99,0,40.99,40.99,-1,-34360,33104,67464,-1256,0,-136,3411,0,0,,3547,3275
21,05/20/2018,8,1:45,2:00,,41.08,0,41.08,41.08,-1,-42879,24197,67076,-18682,0,-387,0,0,0,,387,-387
21,05/20/2018,9,2:00,2:15,31.08,40.93,0,31.08,31.08,1,-38828,41569,80397,2741,0,-129,240,0,0,,369,111
21,05/20/2018,10,2:15,2:30,42.33,,0,42.33,42.33,1,-36156,42796,78952,6640,0,0,1387,0,0,,1387,1387
21,05/20/2018,11,2:30,2:45,30.96,,0,30.96,30.96,1,-32059,42153,74212,10094,0,0,698,0,0,,698,698
21,05/20/2018,12,2:45,3:00,30.95,,0,30.95,30.95,1,-32095,47005,79100,14910,0,0,30,0,0,,30,30
21,05/20/2018,13,3:00,3:15,46.98,,0,46.98,46.98,1,-45350,32336,77686,-13014,0,0,5793,0,0,,5793,5793
21,05/20/2018,14,3:15,3:30,42.33,,0,42.33,42.33,1,-37921,30454,68375,-7467,0,0,6211,0,0,,6211,6211
21,05/20/2018,15,3:30,3:45,42.33,,0,42.33,42.33,1,-32690,25203,57893,-7487,0,0,3563,0,0,,3563,3563
21,05/20/2018,16,3:45,4:00,30.94,,0,30.94,30.94,1,-27280,23519,50799,-3761,0,0,1202,0,0,,1202,1202
21,05/20/2018,17,4:00,4:15,,,0,35.8,35.8,0,-32340,33359,65699,1019,0,0,0,0,0,,0,0
21,05/20/2018,18,4:15,4:30,,30.33,0,30.33,30.33,-1,-23060,37509,60569,14449,0,-6920,0,0,0,,6920,-6920
21,05/20/2018,19,4:30,4:45,,-150.78,0,-150.78,-150.78,-1,-24514,49341,73855,24827,0,-67519,0,0,0,,67519,-67519
21,05/20/2018,20,4:45,5:00,,-150.78,0,-150.78,-150.78,-1,-28317,56966,85283,28649,0,-95911,0,0,0,,95911,-95911
21,05/20/2018,21,5:00,5:15,156.12,-150.78,0,156.12,156.12,1,-67701,8626,76327,-59075,0,-30718,9481,0,0,,40199,-21237
21,05/20/2018,22,5:15,5:30,50.33,,0,50.33,50.33,1,-30385,15297,45682,-15088,0,0,16080,0,0,,16080,16080
21,05/20/2018,23,5:30,5:45,44.22,38.33,0,44.22,35.95,2,-30824,26889,57713,-3935,0,-138,5251,0,0,,5389,5113
21,05/20/2018,24,5:45,6:00,44.22,35.78,0,35.78,35.78,-1,-21780,40095,61875,18315,0,-9428,153,0,0,,9581,-9275
21,05/20/2018,25,6:00,6:15,42.12,38.12,0,42.12,42.12,1,-24705,16161,40866,-8544,0,-7349,547,0,0,,7896,-6802
21,05/20/2018,26,6:15,6:30,30.88,40.79,0,35.84,35.84,2,-29016,28842,57858,-174,0,-70,284,0,0,,354,214
21,05/20/2018,27,6:30,6:45,,38.12,0,38.12,38.12,-1,-26838,34836,61674,7998,0,-1403,0,0,0,,1403,-1403
21,05/20/2018,28,6:45,7:00,,30.12,0,30.12,30.12,-1,-17823,54288,72111,36465,0,-17726,0,0,0,,17726,-17726
21,05/20/2018,29,7:00,7:15,,35.37,0,35.37,35.37,-1,-23099,38260,61359,15161,0,-25979,0,0,0,,25979,-25979
21,05/20/2018,30,7:15,7:30,,38.12,0,38.12,38.12,-1,-16406,42743,59149,26337,0,-8423,0,0,0,,8423,-8423
21,05/20/2018,31,7:30,7:45,,38.12,0,38.12,38.12,-1,-21711,43151,64862,21440,0,-3079,0,0,0,,3079,-3079
21,05/20/2018,32,7:45,8:00,,40.59,0,40.59,40.59,-1,-24573,67995,92568,43422,0,-643,0,0,0,,643,-643
21,05/20/2018,33,8:00,8:15,,,0,41.71,41.71,0,-19811,34590,54401,14779,0,0,0,0,0,,0,0
21,05/20/2018,34,8:15,8:30,,,0,41.67,41.67,0,-14685,39527,54212,24842,0,0,0,0,0,,0,0
21,05/20/2018,35,8:30,8:45,,41.08,0,41.08,41.08,-1,-19423,44463,63886,25040,0,-372,0,0,0,,372,-372
21,05/20/2018,36,8:45,9:00,,41.08,0,41.08,41.08,-1,-14004,57727,71731,43723,0,-174,0,0,0,,174,-174
21,05/20/2018,37,9:00,9:15,,34.12,0,34.12,34.12,-1,-9309,120431,129740,111122,0,-4100,0,0,0,,4100,-4100
21,05/20/2018,38,9:15,9:30,,13.2,0,13.2,13.2,-1,-9773,115716,125489,105943,0,-17314,0,0,0,,17314,-17314
21,05/20/2018,39,9:30,9:45,,4.26,0,4.26,4.26,-1,-10125,105324,115449,95199,0,-44047,0,0,0,,44047,-44047
21,05/20/2018,40,9:45,10:00,,31.78,0,31.78,31.78,-1,-10750,92979,103729,82229,0,-33615,0,0,0,,33615,-33615
21,05/20/2018,41,10:00,10:15,,27.12,0,27.12,27.12,-1,-10874,101449,112323,90575,0,-27400,0,0,0,,27400,-27400
21,05/20/2018,42,10:15,10:30,,-150.78,0,-150.78,-150.78,-1,-9173,103223,112396,94050,0,-53802,0,0,0,,53802,-53802
21,05/20/2018,43,10:30,10:45,,23.12,0,23.12,23.12,-1,-28091,91954,120045,63863,0,-48450,0,0,0,,48450,-48450
21,05/20/2018,44,10:45,11:00,,13.74,0,13.74,13.74,-1,-24013,101501,125514,77488,0,-41558,0,0,0,,41558,-41558
21,05/20/2018,45,11:00,11:15,,-20.88,0,-20.88,-20.88,-1,-26790,109334,136124,82544,0,-71149,0,0,0,,71149,-71149
21,05/20/2018,46,11:15,11:30,,13.81,0,13.81,13.81,-1,-43303,96273,139576,52970,0,-63047,0,0,0,,63047,-63047
21,05/20/2018,47,11:30,11:45,,27.12,0,27.12,27.12,-1,-60869,97529,158398,36660,0,-35778,0,0,0,,35778,-35778
21,05/20/2018,48,11:45,12:00,,8.69,0,8.69,8.69,-1,-49718,109086,158804,59368,0,-50870,0,0,0,,50870,-50870
21,05/20/2018,49,12:00,12:15,42.12,23.12,0,42.12,42.12,1,-55814,65283,121097,9469,0,-26029,26,0,0,,26055,-26003
21,05/20/2018,50,12:15,12:30,,32.41,0,32.41,32.41,-1,-47694,74266,121960,26572,0,-3603,0,0,0,,3603,-3603
21,05/20/2018,51,12:30,12:45,,34.78,0,34.78,34.78,-1,-40121,84708,124829,44587,0,-4771,0,0,0,,4771,-4771
21,05/20/2018,52,12:45,13:00,,4.12,0,4.12,4.12,-1,-38348,102925,141273,64577,0,-24055,0,0,0,,24055,-24055
21,05/20/2018,53,13:00,13:15,,26.12,0,26.12,26.12,-1,-43932,84331,128263,40399,0,-26906,0,0,0,,26906,-26906
21,05/20/2018,54,13:15,13:30,,32.4,0,32.4,32.4,-1,-44012,93336,137348,49324,0,-7321,0,0,0,,7321,-7321
21,05/20/2018,55,13:30,13:45,,26.12,0,26.12,26.12,-1,-43329,101758,145087,58429,0,-27299,0,0,0,,27299,-27299
21,05/20/2018,56,13:45,14:00,,4.12,0,4.12,4.12,-1,-42236,106420,148656,64184,0,-26801,0,0,0,,26801,-26801
21,05/20/2018,57,14:00,14:15,,-20.88,0,-20.88,-20.88,-1,-39962,121620,161582,81658,0,-40165,0,0,0,,40165,-40165
21,05/20/2018,58,14:15,14:30,,19.12,0,19.12,19.12,-1,-41168,128112,169280,86944,0,-37949,0,0,0,,37949,-37949
21,05/20/2018,59,14:30,14:45,,19.12,0,19.12,19.12,-1,-40427,131216,171643,90789,0,-42955,0,0,0,,42955,-42955
21,05/20/2018,60,14:45,15:00,,28.78,0,28.78,28.78,-1,-36298,126138,162436,89840,0,-38141,0,0,0,,38141,-38141
21,05/20/2018,61,15:00,15:15,,31.62,0,31.62,31.62,-1,-48926,132033,180959,83107,0,-23263,0,0,0,,23263,-23263
21,05/20/2018,62,15:15,15:30,,38.55,0,38.55,38.55,-1,-47748,120082,167830,72334,0,-5606,0,0,0,,5606,-5606
21,05/20/2018,63,15:30,15:45,,35.66,0,35.66,35.66,-1,-49629,126309,175938,76680,0,-5155,0,0,0,,5155,-5155
21,05/20/2018,64,15:45,16:00,,4.12,0,4.12,4.12,-1,-51335,122593,173928,71258,0,-4712,0,0,0,,4712,-4712
21,05/20/2018,65,16:00,16:15,,30.42,0,30.42,30.42,-1,-83249,118683,201932,35434,0,-6537,0,0,0,,6537,-6537
21,05/20/2018,66,16:15,16:30,,36.07,0,36.07,36.07,-1,-80550,107605,188155,27055,0,-1374,0,0,0,,1374,-1374
21,05/20/2018,67,16:30,16:45,,,0,35.9,35.9,0,-82902,89951,172853,7049,0,-55,0,0,0,,55,-55
21,05/20/2018,68,16:45,17:00,,14.49,0,14.49,14.49,-1,-80983,92611,173594,11628,0,-2200,0,0,0,,2200,-2200
21,05/20/2018,69,17:00,17:15,,14.32,0,14.32,14.32,-1,-62885,136969,199854,74084,0,-7715,0,0,0,,7715,-7715
21,05/20/2018,70,17:15,17:30,,38.14,0,38.14,38.14,-1,-62442,125673,188115,63231,0,-2233,0,0,0,,2233,-2233
21,05/20/2018,71,17:30,17:45,,41,0,41,41,-1,-61277,105299,166576,44022,0,-519,0,0,0,,519,-519
21,05/20/2018,72,17:45,18:00,,32.17,0,32.17,32.17,-1,-58980,80974,139954,21994,0,-917,0,0,0,,917,-917
21,05/20/2018,73,18:00,18:15,,21.04,0,21.04,21.04,-1,-52422,69129,121551,16707,0,-7573,0,0,0,,7573,-7573
21,05/20/2018,74,18:15,18:30,,30.12,0,30.12,30.12,-1,-45958,70471,116429,24513,0,-21899,0,0,0,,21899,-21899
21,05/20/2018,75,18:30,18:45,,,0,41.75,41.75,0,-42515,52834,95349,10319,0,-5815,0,0,0,,5815,-5815
21,05/20/2018,76,18:45,19:00,,,0,41.73,41.73,0,-22158,57030,79188,34872,0,0,0,0,0,,0,0
21,05/20/2018,77,19:00,19:15,,38.12,0,38.12,38.12,-1,-42573,51037,93610,8464,0,-204,0,0,0,,204,-204
21,05/20/2018,78,19:15,19:30,42.12,,0,42.12,42.12,1,-41894,41145,83039,-749,0,0,231,0,0,,231,231
21,05/20/2018,79,19:30,19:45,,38.5,0,38.5,38.5,-1,-37558,69862,107420,32304,0,-266,0,0,0,,266,-266
21,05/20/2018,80,19:45,20:00,53.49,,0,53.49,53.49,1,-64152,46884,111036,-17268,0,0,2898,0,0,,2898,2898
21,05/20/2018,81,20:00,20:15,173.15,,0,173.15,173.15,1,-87346,31139,118485,-56207,0,0,41706,0,0,,41706,41706
21,05/20/2018,82,20:15,20:30,50.12,,0,50.12,50.12,1,-88976,54427,143403,-34549,0,0,34784,0,0,,34784,34784
21,05/20/2018,83,20:30,20:45,46.88,,0,46.88,46.88,1,-74232,65939,140171,-8293,0,0,21282,0,0,,21282,21282
21,05/20/2018,84,20:45,21:00,42.12,41.29,0,42.12,41.29,2,-67984,63023,131007,-4961,0,-148,1390,0,0,,1538,1242
21,05/20/2018,85,21:00,21:15,55.16,,0,55.16,55.16,1,-77440,50079,127519,-27361,0,0,12061,0,0,,12061,12061
21,05/20/2018,86,21:15,21:30,61.6,,0,61.6,61.6,1,-92139,40530,132669,-51609,0,0,37480,0,0,,37480,37480
21,05/20/2018,87,21:30,21:45,65.15,,0,65.15,65.15,1,-96761,54165,150926,-42596,0,0,42906,0,0,,42906,42906
21,05/20/2018,88,21:45,22:00,163.15,,0,163.15,163.15,1,-117075,49638,166713,-67437,0,0,39980,0,0,,39980,39980
21,05/20/2018,89,22:00,22:15,163.15,,0,163.15,163.15,1,-125951,71364,197315,-54587,0,0,55034,0,0,,55034,55034
21,05/20/2018,90,22:15,22:30,60.7,,0,60.7,60.7,1,-124405,75198,199603,-49207,0,0,48833,0,0,,48833,48833
21,05/20/2018,91,22:30,22:45,49.15,,0,49.15,49.15,1,-107030,81048,188078,-25982,0,0,28650,0,0,,28650,28650
21,05/20/2018,92,22:45,23:00,43.35,38.4,0,43.35,38.4,2,-71734,87681,159415,15947,0,-403,7639,0,0,,8042,7236
21,05/20/2018,93,23:00,23:15,173.34,38.4,0,173.34,173.34,1,-172839,41376,214215,-131463,0,-11,34858,0,0,,34869,34847
21,05/20/2018,94,23:15,23:30,173.34,,0,173.34,173.34,1,-110631,50723,161354,-59908,0,0,76336,0,0,,76336,76336
21,05/20/2018,95,23:30,23:45,46.58,33.95,0,33.95,33.95,-1,-69614,69648,139262,34,0,-387,18904,0,0,,19291,18517
21,05/20/2018,96,23:45,0:00,46.58,19.29,0,19.29,19.29,-1,-70177,74120,144297,3943,0,-9019,5,0,0,,9024,-9014
21,05/21/2018,1,0:00,0:15,46.12,41.08,0,46.12,46.12,1,-54969,70937,125906,15968,0,-686,936,0,0,,1622,250
21,05/21/2018,2,0:15,0:30,47.8,,0,47.8,47.8,1,-42324,41816,84140,-508,0,0,6333,0,0,,6333,6333
21,05/21/2018,3,0:30,0:45,47.8,41.17,0,41.17,41.17,-1,-40391,54461,94852,14070,0,-34,106,0,0,,140,72
21,05/21/2018,4,0:45,1:00,,40.16,0,40.16,40.16,-1,-40547,51073,91620,10526,0,-1149,0,0,0,,1149,-1149
21,05/21/2018,5,1:00,1:15,30.38,40.16,0,30.38,30.38,1,-46514,51375,97889,4861,0,-4,77,0,0,,81,73
21,05/21/2018,6,1:15,1:30,30.44,30.12,0,30.12,30.12,-1,-32699,63312,96011,30613,0,-2024,98,0,0,,2122,-1926
21,05/21/2018,7,1:30,1:45,,30.12,0,30.12,30.12,-1,-26855,69550,96405,42695,0,-3153,0,0,0,,3153,-3153
21,05/21/2018,8,1:45,2:00,,-129.03,0,-129.03,-129.03,-1,-22852,81129,103981,58277,0,-12749,0,0,0,,12749,-12749
21,05/21/2018,9,2:00,2:15,,30.12,0,30.12,30.12,-1,-39568,46652,86220,7084,0,-15567,0,0,0,,15567,-15567
21,05/21/2018,10,2:15,2:30,,11.5,0,11.5,11.5,-1,-30412,62847,93259,32435,0,-4299,0,0,0,,4299,-4299
21,05/21/2018,11,2:30,2:45,,2.93,0,2.93,2.93,-1,-19888,70867,90755,50979,0,-32474,0,0,0,,32474,-32474
21,05/21/2018,12,2:45,3:00,,34.12,0,34.12,34.12,-1,-14284,69398,83682,55114,0,-28911,0,0,0,,28911,-28911
21,05/21/2018,13,3:00,3:15,,34.12,0,34.12,34.12,-1,-32697,62424,95121,29727,0,-16612,0,0,0,,16612,-16612
21,05/21/2018,14,3:15,3:30,,,0,35.49,35.49,0,-19725,57049,76774,37324,0,-155,0,0,0,,155,-155
21,05/21/2018,15,3:30,3:45,,,0,35.49,35.49,0,-15705,51260,66965,35555,0,0,0,0,0,,0,0
21,05/21/2018,16,3:45,4:00,,37.65,0,37.65,37.65,-1,-15464,64820,80284,49356,0,-300,0,0,0,,300,-300
21,05/21/2018,17,4:00,4:15,,,0,35.55,35.55,0,-30519,55360,85879,24841,0,-241,0,0,0,,241,-241
21,05/21/2018,18,4:15,4:30,,38.12,0,38.12,38.12,-1,-28812,59843,88655,31031,0,-1134,0,0,0,,1134,-1134
21,05/21/2018,19,4:30,4:45,,40.69,0,40.69,40.69,-1,-35777,59512,95289,23735,0,-485,0,0,0,,485,-485
21,05/21/2018,20,4:45,5:00,,39.59,0,39.59,39.59,-1,-34122,61268,95390,27146,0,-655,0,0,0,,655,-655
21,05/21/2018,21,5:00,5:15,,39.51,0,39.51,39.51,-1,-42368,63443,105811,21075,0,-1008,0,0,0,,1008,-1008
21,05/21/2018,22,5:15,5:30,,40.53,0,40.53,40.53,-1,-22442,66392,88834,43950,0,-61,0,0,0,,61,-61
21,05/21/2018,23,5:30,5:45,,38.12,0,38.12,38.12,-1,-10298,79497,89795,69199,0,-469,0,0,0,,469,-469
21,05/21/2018,24,5:45,6:00,,-61.03,0,-61.03,-61.03,-1,-3294,91938,95232,88644,0,-18644,0,0,0,,18644,-18644
21,05/21/2018,25,6:00,6:15,,40.15,0,40.15,40.15,-1,-7750,72980,80730,65230,0,-4551,0,0,0,,4551,-4551
21,05/21/2018,26,6:15,6:30,,,0,41.47,41.47,0,-7034,72973,80007,65939,0,0,0,0,0,,0,0
21,05/21/2018,27,6:30,6:45,,30.12,0,30.12,30.12,-1,-13574,59351,72925,45777,0,-7032,0,0,0,,7032,-7032
21,05/21/2018,28,6:45,7:00,,34.12,0,34.12,34.12,-1,-11830,55087,66917,43257,0,-9438,0,0,0,,9438,-9438
21,05/21/2018,29,7:00,7:15,,40.71,0,40.71,40.71,-1,-22747,101839,124586,79092,0,-4776,0,0,0,,4776,-4776
21,05/21/2018,30,7:15,7:30,,38.47,0,38.47,38.47,-1,-27815,91379,119194,63564,0,-468,0,0,0,,468,-468
21,05/21/2018,31,7:30,7:45,,,0,35.6,35.6,0,-35793,86501,122294,50708,0,0,0,0,0,,0,0
21,05/21/2018,32,7:45,8:00,,,0,35.57,35.57,0,-42374,107516,149890,65142,0,0,0,0,0,,0,0
21,05/21/2018,33,8:00,8:15,,,0,41.56,41.56,0,-51982,71151,123133,19169,0,0,0,0,0,,0,0
21,05/21/2018,34,8:15,8:30,,,0,41.56,41.56,0,-48214,110033,158247,61819,0,0,0,0,0,,0,0
21,05/21/2018,35,8:30,8:45,,,0,41.56,41.56,0,-48927,103847,152774,54920,0,0,0,0,0,,0,0
21,05/21/2018,36,8:45,9:00,,,0,41.5,41.5,0,-50656,100492,151148,49836,0,0,0,0,0,,0,0
21,05/21/2018,37,9:00,9:15,,34.12,0,34.12,34.12,-1,-46835,117783,164618,70948,0,-1499,0,0,0,,1499,-1499
21,05/21/2018,38,9:15,9:30,,,0,41.64,41.64,0,-52947,103211,156158,50264,0,0,0,0,0,,0,0
21,05/21/2018,39,9:30,9:45,,,0,41.65,41.65,0,-57971,94044,152015,36073,0,0,0,0,0,,0,0
21,05/21/2018,40,9:45,10:00,,,0,41.63,41.63,0,-63491,98989,162480,35498,0,0,0,0,0,,0,0
21,05/21/2018,41,10:00,10:15,72.02,,0,72.02,72.02,1,-84705,48955,133660,-35750,0,0,12020,0,0,,12020,12020
21,05/21/2018,42,10:15,10:30,46.02,37.17,0,37.17,37.17,-1,-81389,82707,164096,1318,0,-339,10488,0,0,,10827,10149
21,05/21/2018,43,10:30,10:45,46.02,35.36,0,35.36,35.36,-1,-81384,102892,184276,21508,0,-1834,38,0,0,,1872,-1796
21,05/21/2018,44,10:45,11:00,,38.12,0,38.12,38.12,-1,-66639,108717,175356,42078,0,-918,0,0,0,,918,-918
21,05/21/2018,45,11:00,11:15,,33.91,0,33.91,33.91,-1,-97475,147128,244603,49653,0,-5516,0,0,0,,5516,-5516
21,05/21/2018,46,11:15,11:30,,30.12,0,30.12,30.12,-1,-98725,150665,249390,51940,0,-20998,0,0,0,,20998,-20998
21,05/21/2018,47,11:30,11:45,,34.12,0,34.12,34.12,-1,-93952,157860,251812,63908,0,-22598,0,0,0,,22598,-22598
21,05/21/2018,48,11:45,12:00,,16.94,0,16.94,16.94,-1,-85091,162664,247755,77573,0,-25816,0,0,0,,25816,-25816
21,05/21/2018,49,12:00,12:15,77.02,34.12,0,77.02,34.12,2,-143122,107506,250628,-35616,0,-11957,6741,0,0,,18698,-5216
21,05/21/2018,50,12:15,12:30,43.86,,0,43.86,43.86,1,-103879,111779,215658,7900,0,0,3175,0,0,,3175,3175
21,05/21/2018,51,12:30,12:45,,,0,41.5,41.5,0,-100736,126696,227432,25960,0,0,0,0,0,,0,0
21,05/21/2018,52,12:45,13:00,,,0,41.5,41.5,0,-92986,152579,245565,59593,0,0,0,0,0,,0,0
21,05/21/2018,53,13:00,13:15,50.91,,0,50.91,50.91,1,-111048,91673,202721,-19375,0,0,4280,0,0,,4280,4280
21,05/21/2018,54,13:15,13:30,46.3,,0,46.3,46.3,1,-101962,97352,199314,-4610,0,0,14393,0,0,,14393,14393
21,05/21/2018,55,13:30,13:45,,,0,41.34,41.34,0,-101546,112579,214125,11033,0,0,1790,0,0,,1790,1790
21,05/21/2018,56,13:45,14:00,,,0,41.34,41.34,0,-104278,112433,216711,8155,0,0,0,0,0,,0,0
21,05/21/2018,57,14:00,14:15,50.12,,0,50.12,50.12,1,-113671,95376,209047,-18295,0,0,6054,0,0,,6054,6054
21,05/21/2018,58,14:15,14:30,48.25,,0,48.25,48.25,1,-121193,92219,213412,-28974,0,0,21394,0,0,,21394,21394
21,05/21/2018,59,14:30,14:45,46.12,,0,46.12,46.12,1,-104071,87189,191260,-16882,0,0,19426,0,0,,19426,19426
21,05/21/2018,60,14:45,15:00,59,,0,59,59,1,-113002,72890,185892,-40112,0,0,18218,0,0,,18218,18218
21,05/21/2018,61,15:00,15:15,59,38.95,0,38.95,38.95,-1,-60967,102297,163264,41330,0,-928,5590,0,0,,6518,4662
21,05/21/2018,62,15:15,15:30,,,0,41.19,41.19,0,-61266,78936,140202,17670,0,0,0,0,0,,0,0
21,05/21/2018,63,15:30,15:45,43.35,,0,43.35,43.35,1,-60696,51244,111940,-9452,0,0,1802,0,0,,1802,1802
21,05/21/2018,64,15:45,16:00,57.67,,0,57.67,57.67,1,-70645,36048,106693,-34597,0,0,11144,0,0,,11144,11144
21,05/21/2018,65,16:00,16:15,41.9,-41.03,0,-41.03,-41.03,-1,-29110,99780,128890,70670,0,-7290,3378,0,0,,10668,-3912
21,05/21/2018,66,16:15,16:30,54.97,-105.03,0,54.97,-105.03,2,-62720,53949,116669,-8771,0,-18984,950,0,0,,19934,-18034
21,05/21/2018,67,16:30,16:45,88.59,-105.03,0,88.59,88.59,1,-78902,48134,127036,-30768,0,-18,22237,0,0,,22255,22219
21,05/21/2018,68,16:45,17:00,46.12,,0,46.12,46.12,1,-59593,28949,88542,-30644,0,0,22701,0,0,,22701,22701
21,05/21/2018,69,17:00,17:15,46.12,,0,46.12,46.12,1,-69821,55557,125378,-14264,0,0,17666,0,0,,17666,17666
21,05/21/2018,70,17:15,17:30,68.02,,0,68.02,68.02,1,-69345,28610,97955,-40735,0,0,23751,0,0,,23751,23751
21,05/21/2018,71,17:30,17:45,135.02,,0,135.02,135.02,1,-83728,13177,96905,-70551,0,0,56774,0,0,,56774,56774
21,05/21/2018,72,17:45,18:00,90.76,,0,90.76,90.76,1,-85790,24892,110682,-60898,0,0,63666,0,0,,63666,63666
21,05/21/2018,73,18:00,18:15,57.64,,0,57.64,57.64,1,-72694,27853,100547,-44841,0,0,47510,0,0,,47510,47510
21,05/21/2018,74,18:15,18:30,50.76,,0,50.76,50.76,1,-61012,27935,88947,-33077,0,0,33637,0,0,,33637,33637
21,05/21/2018,75,18:30,18:45,68.02,,0,68.02,68.02,1,-69011,24550,93561,-44461,0,0,34215,0,0,,34215,34215
21,05/21/2018,76,18:45,19:00,210.02,,0,210.02,210.02,1,-91573,21182,112755,-70391,0,0,56422,0,0,,56422,56422
21,05/21/2018,77,19:00,19:15,210.02,12.03,0,12.03,12.03,-1,-35448,93008,128456,57560,0,-3128,21050,0,0,,24178,17922
21,05/21/2018,78,19:15,19:30,,38.12,0,38.12,38.12,-1,-43441,62127,105568,18686,0,-972,0,0,0,,972,-972
21,05/21/2018,79,19:30,19:45,210.02,,0,210.02,210.02,1,-74819,26531,101350,-48288,0,0,14836,0,0,,14836,14836
21,05/21/2018,80,19:45,20:00,210.02,,0,210.02,210.02,1,-83236,37044,120280,-46192,0,0,49859,0,0,,49859,49859
21,05/21/2018,81,20:00,20:15,47.4,,0,47.4,47.4,1,-89751,78244,167995,-11507,0,0,17822,0,0,,17822,17822
21,05/21/2018,82,20:15,20:30,212.02,,0,212.02,212.02,1,-109494,56823,166317,-52671,0,0,22289,0,0,,22289,22289
21,05/21/2018,83,20:30,20:45,65.76,,0,65.76,65.76,1,-115171,54533,169704,-60638,0,0,55555,0,0,,55555,55555
21,05/21/2018,84,20:45,21:00,65.76,,0,65.76,65.76,1,-111619,58744,170363,-52875,0,0,55507,0,0,,55507,55507
21,05/21/2018,85,21:00,21:15,212.02,,0,212.02,212.02,1,-102685,26293,128978,-76392,0,0,61852,0,0,,61852,61852
21,05/21/2018,86,21:15,21:30,85.82,,0,85.82,85.82,1,-94410,31901,126311,-62509,0,0,63987,0,0,,63987,63987
21,05/21/2018,87,21:30,21:45,63.21,,0,63.21,63.21,1,-87121,52022,139143,-35099,0,0,45264,0,0,,45264,45264
21,05/21/2018,88,21:45,22:00,94.02,,0,94.02,94.02,1,-104629,49781,154410,-54848,0,0,23866,0,0,,23866,23866
21,05/21/2018,89,22:00,22:15,53.27,,0,53.27,53.27,1,-112935,76113,189048,-36822,0,0,30380,0,0,,30380,30380
21,05/21/2018,90,22:15,22:30,56.27,,0,56.27,56.27,1,-103801,51467,155268,-52334,0,0,31927,0,0,,31927,31927
21,05/21/2018,91,22:30,22:45,50.76,,0,50.76,50.76,1,-76857,40461,117318,-36396,0,0,30208,0,0,,30208,30208
21,05/21/2018,92,22:45,23:00,47.67,,0,47.67,47.67,1,-63264,47230,110494,-16034,0,0,18270,0,0,,18270,18270
21,05/21/2018,93,23:00,23:15,212.02,,0,212.02,212.02,1,-156696,34229,190925,-122467,0,0,44428,0,0,,44428,44428
21,05/21/2018,94,23:15,23:30,212.02,,0,212.02,212.02,1,-111531,51348,162879,-60183,0,0,74312,0,0,,74312,74312
21,05/21/2018,95,23:30,23:45,46.15,36.25,0,36.25,36.25,-1,-60918,74143,135061,13225,0,-2827,9431,0,0,,12258,6604
21,05/21/2018,96,23:45,0:00,,38.12,0,38.12,38.12,-1,-56115,67542,123657,11427,0,-9567,0,0,0,,9567,-9567
21,05/22/2018,1,0:00,0:15,350.12,38.12,0,350.12,350.12,1,-100832,27505,128337,-73327,0,-3455,21948,0,0,,25403,18493
21,05/22/2018,2,0:15,0:30,71.04,,0,71.04,71.04,1,-70078,20325,90403,-49753,0,0,45563,0,0,,45563,45563
21,05/22/2018,3,0:30,0:45,42.35,39.19,0,39.19,39.19,-1,-48575,36117,84692,-12458,0,-54,13308,0,0,,13362,13254
21,05/22/2018,4,0:45,1:00,50.12,,0,50.12,50.12,1,-50670,25320,75990,-25350,0,0,1684,0,0,,1684,1684
21,05/22/2018,5,1:00,1:15,63.87,,0,63.87,63.87,1,-70147,45024,115171,-25123,0,0,15417,0,0,,15417,15417
21,05/22/2018,6,1:15,1:30,50.12,,0,50.12,50.12,1,-75360,43011,118371,-32349,0,0,27609,0,0,,27609,27609
21,05/22/2018,7,1:30,1:45,46.12,,0,46.12,46.12,1,-68249,45509,113758,-22740,0,0,21782,0,0,,21782,21782
21,05/22/2018,8,1:45,2:00,49.26,,0,49.26,49.26,1,-71407,44002,115409,-27405,0,0,20161,0,0,,20161,20161
21,05/22/2018,9,2:00,2:15,46.99,,0,46.99,46.99,1,-81415,61200,142615,-20215,0,0,18091,0,0,,18091,18091
21,05/22/2018,10,2:15,2:30,56.27,,0,56.27,56.27,1,-86861,52450,139311,-34411,0,0,23056,0,0,,23056,23056
21,05/22/2018,11,2:30,2:45,47.12,,0,47.12,47.12,1,-64963,44904,109867,-20059,0,0,23907,0,0,,23907,23907
21,05/22/2018,12,2:45,3:00,51.07,,0,51.07,51.07,1,-81071,42735,123806,-38336,0,0,14221,0,0,,14221,14221
21,05/22/2018,13,3:00,3:15,42.12,38.12,0,42.12,35.16,2,-8883,87369,96252,78486,0,-669,5205,0,0,,5874,4536
21,05/22/2018,14,3:15,3:30,,,0,35.16,35.16,0,-16467,64169,80636,47702,0,0,0,0,0,,0,0
21,05/22/2018,15,3:30,3:45,,,0,35.16,35.16,0,-43178,63825,107003,20647,0,0,0,0,0,,0,0
21,05/22/2018,16,3:45,4:00,,,0,35.17,35.17,0,-47905,62347,110252,14442,0,0,0,0,0,,0,0
21,05/22/2018,17,4:00,4:15,,38.12,0,38.12,38.12,-1,-28489,47889,76378,19400,0,-1571,0,0,0,,1571,-1571
21,05/22/2018,18,4:15,4:30,,40.32,0,40.32,40.32,-1,-34502,42342,76844,7840,0,-1468,0,0,0,,1468,-1468
21,05/22/2018,19,4:30,4:45,42.23,,0,42.23,42.23,1,-56910,47668,104578,-9242,0,0,149,0,0,,149,149
21,05/22/2018,20,4:45,5:00,59.76,,0,59.76,59.76,1,-77002,39834,116836,-37168,0,0,19420,0,0,,19420,19420
21,05/22/2018,21,5:00,5:15,46.12,,0,46.12,46.12,1,-81422,70369,151791,-11053,0,0,20458,0,0,,20458,20458
21,05/22/2018,22,5:15,5:30,42.12,,0,42.12,42.12,1,-68171,64568,132739,-3603,0,0,1217,0,0,,1217,1217
21,05/22/2018,23,5:30,5:45,46.12,,0,46.12,46.12,1,-66866,60045,126911,-6821,0,0,2064,0,0,,2064,2064
21,05/22/2018,24,5:45,6:00,47.02,28.87,0,47.02,28.87,2,-72777,58673,131450,-14104,0,-983,8093,0,0,,9076,7110
21,05/22/2018,25,6:00,6:15,47.02,-34.88,0,-34.88,-34.88,-1,-97320,88083,185403,-9237,0,-12895,585,0,0,,13480,-12310
21,05/22/2018,26,6:15,6:30,,38.12,0,38.12,38.12,-1,-49815,60726,110541,10911,0,-4531,0,0,0,,4531,-4531
21,05/22/2018,27,6:30,6:45,56.27,39.36,0,56.27,56.27,1,-66064,41622,107686,-24442,0,-2007,2036,0,0,,4043,29
21,05/22/2018,28,6:45,7:00,56.75,,0,56.75,56.75,1,-50159,45415,95574,-4744,0,0,12004,0,0,,12004,12004
21,05/22/2018,29,7:00,7:15,43.08,36.78,0,36.78,36.78,-1,-122061,109274,231335,-12787,0,-2163,2184,0,0,,4347,21
21,05/22/2018,30,7:15,7:30,,36.41,0,36.41,36.41,-1,-88283,57783,146066,-30500,0,-5333,0,0,0,,5333,-5333
21,05/22/2018,31,7:30,7:45,50.87,,0,50.87,50.87,1,-98795,45779,144574,-53016,0,0,585,0,0,,585,585
21,05/22/2018,32,7:45,8:00,138.12,,0,138.12,138.12,1,-108932,44891,153823,-64041,0,0,28650,0,0,,28650,28650
21,05/22/2018,33,8:00,8:15,50.87,,0,50.87,50.87,1,-89675,67900,157575,-21775,0,0,23397,0,0,,23397,23397
21,05/22/2018,34,8:15,8:30,50.87,38.96,0,38.96,38.96,-1,-84487,59607,144094,-24880,0,-75,219,0,0,,294,144
21,05/22/2018,35,8:30,8:45,42.81,,0,42.81,42.81,1,-102166,53432,155598,-48734,0,0,460,0,0,,460,460
21,05/22/2018,36,8:45,9:00,50.18,,0,50.18,50.18,1,-141281,60864,202145,-80417,0,0,4553,0,0,,4553,4553
21,05/22/2018,37,9:00,9:15,213.12,,0,213.12,213.12,1,-143467,32390,175857,-111077,0,0,29074,0,0,,29074,29074
21,05/22/2018,38,9:15,9:30,213.12,,0,213.12,213.12,1,-147460,39309,186769,-108151,0,0,85414,0,0,,85414,85414
21,05/22/2018,39,9:30,9:45,170.62,,0,170.62,170.62,1,-105398,44971,150369,-60427,0,0,66817,2500,0,,69317,69317
21,05/22/2018,40,9:45,10:00,213.12,,0,213.12,213.12,1,-124470,35267,159737,-89203,0,0,50017,0,0,,50017,50017
21,05/22/2018,41,10:00,10:15,101.08,,0,101.08,101.08,1,-95293,56372,151665,-38921,0,0,55195,0,0,,55195,55195
21,05/22/2018,42,10:15,10:30,54.12,,0,54.12,54.12,1,-100150,47519,147669,-52631,0,0,30389,0,0,,30389,30389
21,05/22/2018,43,10:30,10:45,46.87,,0,46.87,46.87,1,-91604,46735,138339,-44869,0,0,28708,0,0,,28708,28708
21,05/22/2018,44,10:45,11:00,43.95,,0,43.95,43.95,1,-78204,47449,125653,-30755,0,0,14994,0,0,,14994,14994
21,05/22/2018,45,11:00,11:15,46.87,,0,46.87,46.87,1,-82304,63999,146303,-18305,0,0,7281,0,0,,7281,7281
21,05/22/2018,46,11:15,11:30,42.81,,0,42.81,42.81,1,-73327,62084,135411,-11243,0,0,4896,0,0,,4896,4896
21,05/22/2018,47,11:30,11:45,42.81,,0,42.81,42.81,1,-76691,66177,142868,-10514,0,0,4937,0,0,,4937,4937
21,05/22/2018,48,11:45,12:00,42.81,,0,42.81,42.81,1,-54030,71984,126014,17954,0,0,1329,0,0,,1329,1329
21,05/22/2018,49,12:00,12:15,212.12,,0,212.12,212.12,1,-116265,48113,164378,-68152,0,0,25614,0,0,,25614,25614
21,05/22/2018,50,12:15,12:30,46.03,41.25,0,41.25,41.25,-1,-54400,66080,120480,11680,0,-39,9249,0,0,,9288,9210
21,05/22/2018,51,12:30,12:45,,40.03,0,40.03,40.03,-1,-41542,81664,123206,40122,0,-1841,0,0,0,,1841,-1841
21,05/22/2018,52,12:45,13:00,,41.41,0,41.41,41.41,-1,-39276,82454,121730,43178,0,-437,0,0,0,,437,-437
21,05/22/2018,53,13:00,13:15,100.12,,0,100.12,100.12,1,-98398,40256,138654,-58142,0,0,8937,0,0,,8937,8937
21,05/22/2018,54,13:15,13:30,100.12,,0,100.12,100.12,1,-96290,35820,132110,-60470,0,0,29957,0,0,,29957,29957
21,05/22/2018,55,13:30,13:45,73.12,,0,73.12,73.12,1,-101241,32541,133782,-68700,0,0,34344,0,0,,34344,34344
21,05/22/2018,56,13:45,14:00,47.35,,0,47.35,47.35,1,-104494,36913,141407,-67581,0,0,36820,0,0,,36820,36820
21,05/22/2018,57,14:00,14:15,65.39,,0,65.39,65.39,1,-87615,57761,145376,-29854,0,0,38380,0,0,,38380,38380
21,05/22/2018,58,14:15,14:30,53.12,,0,53.12,53.12,1,-93152,58710,151862,-34442,0,0,42350,0,0,,42350,42350
21,05/22/2018,59,14:30,14:45,65.39,,0,65.39,65.39,1,-92059,53410,145469,-38649,0,0,40969,0,0,,40969,40969
21,05/22/2018,60,14:45,15:00,55.85,,0,55.85,55.85,1,-96852,62858,159710,-33994,0,0,44604,0,0,,44604,44604
21,05/22/2018,61,15:00,15:15,43.38,42.21,0,43.38,42.1,2,-81532,84570,166102,3038,0,-50,13603,0,0,,13653,13553
21,05/22/2018,62,15:15,15:30,44.59,,0,44.59,44.59,1,-88096,78135,166231,-9961,0,0,3508,0,0,,3508,3508
21,05/22/2018,63,15:30,15:45,55.87,,0,55.87,55.87,1,-104253,68123,172376,-36130,0,0,24697,0,0,,24697,24697
21,05/22/2018,64,15:45,16:00,48.44,,0,48.44,48.44,1,-97824,74023,171847,-23801,0,0,32139,0,0,,32139,32139
21,05/22/2018,65,16:00,16:15,48.44,39.58,0,39.58,39.58,-1,-96367,118283,214650,21916,0,-1089,6669,0,0,,7758,5580
21,05/22/2018,66,16:15,16:30,,,0,42.18,42.18,0,-95594,120912,216506,25318,0,0,0,0,0,,0,0
21,05/22/2018,67,16:30,16:45,,,0,42.18,42.18,0,-104059,126525,230584,22466,0,0,0,0,0,,0,0
21,05/22/2018,68,16:45,17:00,43.38,,0,43.38,43.38,1,-134963,118450,253413,-16513,0,0,1965,0,0,,1965,1965
21,05/22/2018,69,17:00,17:15,112.12,,0,112.12,112.12,1,-125265,62673,187938,-62592,0,0,9411,0,0,,9411,9411
21,05/22/2018,70,17:15,17:30,196.12,,0,196.12,196.12,1,-124582,84335,208917,-40247,0,0,54886,0,0,,54886,54886
21,05/22/2018,71,17:30,17:45,42.51,42.73,0,42.73,42.73,-1,-83734,98089,181823,14355,0,-387,8451,0,0,,8838,8064
21,05/22/2018,72,17:45,18:00,,42.72,0,42.72,42.72,-1,-89477,100743,190220,11266,0,-630,0,0,0,,630,-630
21,05/22/2018,73,18:00,18:15,42.39,,0,42.39,42.39,1,-166801,63471,230272,-103330,0,0,1586,0,0,,1586,1586
21,05/22/2018,74,18:15,18:30,41.99,,0,41.99,41.99,1,-117412,72561,189973,-44851,0,0,511,0,0,,511,511
21,05/22/2018,75,18:30,18:45,,,0,42.32,42.32,0,-105134,95810,200944,-9324,0,0,0,0,0,,0,0
21,05/22/2018,76,18:45,19:00,42.39,,0,42.39,42.39,1,-98338,98564,196902,226,0,0,600,0,0,,600,600
21,05/22/2018,77,19:00,19:15,42.07,,0,42.07,42.07,1,-80200,85475,165675,5275,0,0,977,0,0,,977,977
21,05/22/2018,78,19:15,19:30,42.12,,0,42.12,42.12,1,-94197,79501,173698,-14696,0,0,1132,0,0,,1132,1132
21,05/22/2018,79,19:30,19:45,41.99,,0,41.99,41.99,1,-91895,77392,169287,-14503,0,0,300,0,0,,300,300
21,05/22/2018,80,19:45,20:00,42.02,,0,42.02,42.02,1,-98832,69468,168300,-29364,0,0,137,0,0,,137,137
21,05/22/2018,81,20:00,20:15,60.71,,0,60.71,60.71,1,-92700,57638,150338,-35062,0,0,15615,0,0,,15615,15615
21,05/22/2018,82,20:15,20:30,46.39,,0,46.39,46.39,1,-96809,61574,158383,-35235,0,0,20103,0,0,,20103,20103
21,05/22/2018,83,20:30,20:45,,,0,42.66,42.66,0,-88641,66235,154876,-22406,0,0,1783,0,0,,1783,1783
21,05/22/2018,84,20:45,21:00,,40.39,0,40.39,40.39,-1,-87164,66735,153899,-20429,0,-195,0,0,0,,195,-195
21,05/22/2018,85,21:00,21:15,,,0,42.66,42.66,0,-85082,68928,154010,-16154,0,0,0,0,0,,0,0
21,05/22/2018,86,21:15,21:30,,,0,42.66,42.66,0,-95549,73057,168606,-22492,0,0,0,0,0,,0,0
21,05/22/2018,87,21:30,21:45,,,0,42.66,42.66,0,-86842,84975,171817,-1867,0,0,0,0,0,,0,0
21,05/22/2018,88,21:45,22:00,,,0,42.66,42.66,0,-82304,82659,164963,355,0,0,0,0,0,,0,0
21,05/22/2018,89,22:00,22:15,50.97,,0,50.97,50.97,1,-114331,38136,152467,-76195,0,0,3025,0,0,,3025,3025
21,05/22/2018,90,22:15,22:30,43.91,,0,43.91,43.91,1,-101362,50905,152267,-50457,0,0,1529,0,0,,1529,1529
21,05/22/2018,91,22:30,22:45,42.39,,0,42.39,42.39,1,-81720,58165,139885,-23555,0,0,1387,0,0,,1387,1387
21,05/22/2018,92,22:45,23:00,42.39,41.98,0,42.66,41.98,2,-67247,82945,150192,15698,0,-163,807,0,0,,970,644
21,05/22/2018,93,23:00,23:15,,42.48,0,42.48,42.48,-1,-124314,84417,208731,-39897,0,-208,0,0,0,,208,-208
21,05/22/2018,94,23:15,23:30,,42.59,0,42.59,42.59,-1,-103419,75366,178785,-28053,0,-19,0,0,0,,19,-19
21,05/22/2018,95,23:30,23:45,,35.21,0,35.21,35.21,-1,-77515,94918,172433,17403,0,-5659,0,0,0,,5659,-5659
21,05/22/2018,96,23:45,0:00,,34.12,0,34.12,34.12,-1,-64244,45749,109993,-18495,0,-12495,0,0,0,,12495,-12495
21,05/23/2018,1,0:00,0:15,197.02,41.05,0,197.02,197.02,1,-96771,59691,156462,-37080,0,-491,8331,0,0,,8822,7840
21,05/23/2018,2,0:15,0:30,341.6,,0,341.6,341.6,1,-101003,24826,125829,-76177,0,0,53642,5000,0,,58642,58642
21,05/23/2018,3,0:30,0:45,341.6,40.57,0,341.6,40.57,2,-33706,68886,102592,35180,0,-287,8927,5000,0,,14214,13640
21,05/23/2018,4,0:45,1:00,,40.57,0,40.57,40.57,-1,-30431,60612,91043,30181,0,-1749,0,0,0,,1749,-1749
21,05/23/2018,5,1:00,1:15,,37.03,0,37.03,37.03,-1,-33451,68534,101985,35083,0,-1912,0,0,0,,1912,-1912
21,05/23/2018,6,1:15,1:30,42.8,34.12,0,42.92,34.12,2,-27225,47304,74529,20079,0,-1516,25,0,0,,1541,-1491
21,05/23/2018,7,1:30,1:45,,30.12,0,30.12,30.12,-1,-24009,39227,63236,15218,0,-11505,0,0,0,,11505,-11505
21,05/23/2018,8,1:45,2:00,,40.12,0,40.12,40.12,-1,-42041,35836,77877,-6205,0,-5890,0,0,0,,5890,-5890
21,05/23/2018,9,2:00,2:15,43.63,40.12,0,43.63,43.63,1,-68416,50820,119236,-17596,0,-162,1289,0,0,,1451,1127
21,05/23/2018,10,2:15,2:30,42.8,,0,42.8,42.8,1,-67038,58849,125887,-8189,0,0,717,0,0,,717,717
21,05/23/2018,11,2:30,2:45,,,0,41.89,41.89,0,-58369,56049,114418,-2320,0,0,0,0,0,,0,0
21,05/23/2018,12,2:45,3:00,,41.07,0,41.07,41.07,-1,-58810,52533,111343,-6277,0,-231,0,0,0,,231,-231
21,05/23/2018,13,3:00,3:15,56.35,40.24,0,56.35,56.35,1,-69946,18420,88366,-51526,0,-130,8496,0,0,,8626,8366
21,05/23/2018,14,3:15,3:30,57.2,,0,57.2,57.2,1,-69483,15589,85072,-53894,0,0,30292,0,0,,30292,30292
21,05/23/2018,15,3:30,3:45,46.8,,0,46.8,46.8,1,-72120,20359,92479,-51761,0,0,25690,0,0,,25690,25690
21,05/23/2018,16,3:45,4:00,50.02,,0,50.02,50.02,1,-78584,25198,103782,-53386,0,0,26699,0,0,,26699,26699
21,05/23/2018,17,4:00,4:15,65.8,,0,65.8,65.8,1,-97785,31082,128867,-66703,0,0,40719,0,0,,40719,40719
21,05/23/2018,18,4:15,4:30,53.47,,0,53.47,53.47,1,-89352,37439,126791,-51913,0,0,45368,0,0,,45368,45368
21,05/23/2018,19,4:30,4:45,50.8,,0,50.8,50.8,1,-90447,39767,130214,-50680,0,0,25882,0,0,,25882,25882
21,05/23/2018,20,4:45,5:00,58.61,,0,58.61,58.61,1,-95740,48987,144727,-46753,0,0,34191,0,0,,34191,34191
21,05/23/2018,21,5:00,5:15,42.8,,0,42.8,42.8,1,-80144,64361,144505,-15783,0,0,7375,0,0,,7375,7375
21,05/23/2018,22,5:15,5:30,,,0,42.92,42.92,0,-84305,63641,147946,-20664,0,0,0,0,0,,0,0
21,05/23/2018,23,5:30,5:45,,,0,42.92,42.92,0,-76958,60802,137760,-16156,0,0,0,0,0,,0,0
21,05/23/2018,24,5:45,6:00,48.73,,0,48.73,48.73,1,-94850,64597,159447,-30253,0,0,2300,0,0,,2300,2300
21,05/23/2018,25,6:00,6:15,48.73,12.03,0,12.03,12.03,-1,-67259,111212,178471,43953,0,-15565,26,0,0,,15591,-15539
21,05/23/2018,26,6:15,6:30,,34.11,0,34.11,34.11,-1,-59523,78157,137680,18634,0,-29665,0,0,0,,29665,-29665
21,05/23/2018,27,6:30,6:45,47.92,34.11,0,47.92,47.92,1,-100897,57158,158055,-43739,0,-3294,4680,0,0,,7974,1386
21,05/23/2018,28,6:45,7:00,59.57,,0,59.57,59.57,1,-121553,57181,178734,-64372,0,0,23114,0,0,,23114,23114
21,05/23/2018,29,7:00,7:15,47.92,,0,47.92,47.92,1,-105993,62517,168510,-43476,0,0,14632,0,0,,14632,14632
21,05/23/2018,30,7:15,7:30,76.02,,0,76.02,76.02,1,-126050,58636,184686,-67414,0,0,3777,0,0,,3777,3777
21,05/23/2018,31,7:30,7:45,198.02,,0,198.02,198.02,1,-146741,64624,211365,-82117,0,0,45099,0,0,,45099,45099
21,05/23/2018,32,7:45,8:00,79.45,,0,79.45,79.45,1,-153940,91409,245349,-62531,0,0,56504,0,0,,56504,56504
21,05/23/2018,33,8:00,8:15,57.56,,0,57.56,57.56,1,-81173,58937,140110,-22236,0,0,33434,0,0,,33434,33434
21,05/23/2018,34,8:15,8:30,56.06,,0,56.06,56.06,1,-83282,62095,145377,-21187,0,0,7587,0,0,,7587,7587
21,05/23/2018,35,8:30,8:45,198.02,,0,198.02,198.02,1,-131091,60051,191142,-71040,0,0,51581,0,0,,51581,51581
21,05/23/2018,36,8:45,9:00,109.23,,0,109.23,109.23,1,-121260,61209,182469,-60051,0,0,63465,0,0,,63465,63465
21,05/23/2018,37,9:00,9:15,198.02,,0,198.02,198.02,1,-188524,29872,218396,-158652,0,0,82691,0,0,,82691,82691
21,05/23/2018,38,9:15,9:30,198.02,,0,284.54,284.54,1,-203141,26116,229257,-177025,0,0,94960,1250,23332,,119542,119542
21,05/23/2018,39,9:30,9:45,198.02,,0,284.54,284.54,1,-167227,23964,191191,-143263,0,0,92375,1250,52407,,146032,146032
21,05/23/2018,40,9:45,10:00,184.54,,0,284.54,284.54,1,-143011,24418,167429,-118593,0,0,65019,1250,52407,,118676,118676
21,05/23/2018,41,10:00,10:15,60.1,,0,269.9,269.9,1,-112816,50773,163589,-62043,0,0,34444,0,52407,,86851,86851
21,05/23/2018,42,10:15,10:30,121.02,,0,121.02,121.02,1,-105963,60704,166667,-45259,0,0,8276,0,5833,,14109,14109
21,05/23/2018,43,10:30,10:45,198.02,,0,198.02,198.02,1,-88561,71900,160461,-16661,0,0,34753,0,0,,34753,34753
21,05/23/2018,44,10:45,11:00,43.87,43.11,0,44.69,43.11,2,-75909,77318,153227,1409,0,-145,2419,0,0,,2564,2274
21,05/23/2018,45,11:00,11:15,44.03,,0,44.03,44.03,1,-72259,73880,146139,1621,0,0,270,0,0,,270,270
21,05/23/2018,46,11:15,11:30,47.92,,0,47.92,47.92,1,-89311,72972,162283,-16339,0,0,6341,0,0,,6341,6341
21,05/23/2018,47,11:30,11:45,47.2,,0,47.2,47.2,1,-90422,81804,172226,-8618,0,0,10474,0,0,,10474,10474
21,05/23/2018,48,11:45,12:00,47.92,,0,47.92,47.92,1,-77642,77049,154691,-593,0,0,3304,0,0,,3304,3304
21,05/23/2018,49,12:00,12:15,90.02,,0,90.02,90.02,1,-124081,79202,203283,-44879,0,0,27501,0,0,,27501,27501
21,05/23/2018,50,12:15,12:30,43.87,39.03,0,44.57,39.03,2,-70210,96239,166449,26029,0,-1561,10772,0,0,,12333,9211
21,05/23/2018,51,12:30,12:45,,,0,44.57,44.57,0,-64407,85769,150176,21362,0,-48,0,0,0,,48,-48
21,05/23/2018,52,12:45,13:00,,43.03,0,43.03,43.03,-1,-66756,93714,160470,26958,0,-116,0,0,0,,116,-116
21,05/23/2018,53,13:00,13:15,47.92,39.86,0,47.92,39.86,2,-104202,89582,193784,-14620,0,-707,1531,0,0,,2238,824
21,05/23/2018,54,13:15,13:30,51.92,,0,51.92,51.92,1,-99786,87187,186973,-12599,0,0,10105,0,0,,10105,10105
21,05/23/2018,55,13:30,13:45,47.92,,0,47.92,47.92,1,-89768,75502,165270,-14266,0,0,12916,0,0,,12916,12916
21,05/23/2018,56,13:45,14:00,43.79,,0,43.79,43.79,1,-87125,83684,170809,-3441,0,0,2461,0,0,,2461,2461
21,05/23/2018,57,14:00,14:15,52.17,,0,52.17,52.17,1,-91008,77509,168517,-13499,0,0,7148,0,0,,7148,7148
21,05/23/2018,58,14:15,14:30,45.24,,0,45.24,45.24,1,-83010,78808,161818,-4202,0,0,5990,0,0,,5990,5990
21,05/23/2018,59,14:30,14:45,46,,0,46,46,1,-78293,73073,151366,-5220,0,0,2206,0,0,,2206,2206
21,05/23/2018,60,14:45,15:00,47.85,,0,47.85,47.85,1,-83686,62281,145967,-21405,0,0,5699,0,0,,5699,5699
21,05/23/2018,61,15:00,15:15,47.92,,0,47.92,47.92,1,-92113,80062,172175,-12051,0,0,9107,0,0,,9107,9107
21,05/23/2018,62,15:15,15:30,49,,0,49,49,1,-102559,75605,178164,-26954,0,0,22494,0,0,,22494,22494
21,05/23/2018,63,15:30,15:45,55.86,,0,55.86,55.86,1,-107168,73931,181099,-33237,0,0,23905,0,0,,23905,23905
21,05/23/2018,64,15:45,16:00,55.02,,0,55.02,55.02,1,-95986,68141,164127,-27845,0,0,30458,0,0,,30458,30458
21,05/23/2018,65,16:00,16:15,43.87,41.03,0,44.08,41.03,2,-76999,91489,168488,14490,0,-610,10674,0,0,,11284,10064
21,05/23/2018,66,16:15,16:30,,,0,44.08,44.08,0,-59974,105865,165839,45891,0,-4,0,0,0,,4,-4
21,05/23/2018,67,16:30,16:45,,,0,44.08,44.08,0,-49321,110708,160029,61387,0,0,0,0,0,,0,0
21,05/23/2018,68,16:45,17:00,,38.11,0,38.11,38.11,-1,-57987,122192,180179,64205,0,-483,0,0,0,,483,-483
21,05/23/2018,69,17:00,17:15,,32.39,0,32.39,32.39,-1,-63237,75958,139195,12721,0,-5253,0,0,0,,5253,-5253
21,05/23/2018,70,17:15,17:30,,40.35,0,40.35,40.35,-1,-47274,60710,107984,13436,0,-739,0,0,0,,739,-739
21,05/23/2018,71,17:30,17:45,,38.11,0,38.11,38.11,-1,-44947,78185,123132,33238,0,-1356,0,0,0,,1356,-1356
21,05/23/2018,72,17:45,18:00,,34.11,0,34.11,34.11,-1,-54984,91760,146744,36776,0,-11653,0,0,0,,11653,-11653
21,05/23/2018,73,18:00,18:15,64.88,34.11,0,64.88,64.88,1,-98137,55590,153727,-42547,0,-3444,10392,0,0,,13836,6948
21,05/23/2018,74,18:15,18:30,43.87,43.12,0,43.12,43.12,-1,-71162,74265,145427,3103,0,-357,4399,0,0,,4756,4042
21,05/23/2018,75,18:30,18:45,,42.03,0,42.03,42.03,-1,-68383,76208,144591,7825,0,-3124,0,0,0,,3124,-3124
21,05/23/2018,76,18:45,19:00,44.33,42.03,0,44.33,44.33,1,-77123,73872,150995,-3251,0,-178,598,0,0,,776,420
21,05/23/2018,77,19:00,19:15,197.02,,0,197.02,197.02,1,-113341,32084,145425,-81257,0,0,19308,0,0,,19308,19308
21,05/23/2018,78,19:15,19:30,197.02,,0,197.02,197.02,1,-126291,26465,152756,-99826,0,0,96362,0,0,,96362,96362
21,05/23/2018,79,19:30,19:45,197.02,42.43,0,42.43,42.43,-1,-85667,78373,164040,-7294,0,-113,27727,0,0,,27840,27614
21,05/23/2018,80,19:45,20:00,186.02,,0,186.02,186.02,1,-123388,68915,192303,-54473,0,0,23291,0,0,,23291,23291
21,05/23/2018,81,20:00,20:15,66.92,,0,66.92,66.92,1,-92948,46241,139189,-46707,0,0,45217,0,0,,45217,45217
21,05/23/2018,82,20:15,20:30,61.14,,0,61.14,61.14,1,-113173,41400,154573,-71773,0,0,43970,0,0,,43970,43970
21,05/23/2018,83,20:30,20:45,95.02,,0,95.02,95.02,1,-111543,46101,157644,-65442,0,0,52325,0,0,,52325,52325
21,05/23/2018,84,20:45,21:00,58.02,,0,58.02,58.02,1,-100524,62852,163376,-37672,0,0,43951,0,0,,43951,43951
21,05/23/2018,85,21:00,21:15,80.92,,0,80.92,80.92,1,-94944,44993,139937,-49951,0,0,32102,0,0,,32102,32102
21,05/23/2018,86,21:15,21:30,58.82,,0,58.82,58.82,1,-87782,48909,136691,-38873,0,0,43314,0,0,,43314,43314
21,05/23/2018,87,21:30,21:45,46.02,39.48,0,39.48,39.48,-1,-58354,53601,111955,-4753,0,-466,17209,0,0,,17675,16743
21,05/23/2018,88,21:45,22:00,46.3,39.03,0,46.3,39.03,2,-65231,52576,117807,-12655,0,-633,540,0,0,,1173,-93
21,05/23/2018,89,22:00,22:15,198.02,,0,198.02,198.02,1,-139008,40215,179223,-98793,0,0,42442,0,0,,42442,42442
21,05/23/2018,90,22:15,22:30,91.92,,0,91.92,91.92,1,-98353,57167,155520,-41186,0,0,55820,0,0,,55820,55820
21,05/23/2018,91,22:30,22:45,45.91,41.17,0,45.91,41.17,2,-51899,64900,116799,13001,0,-412,10488,0,0,,10900,10076
21,05/23/2018,92,22:45,23:00,,20.32,0,20.32,20.32,-1,-43561,82442,126003,38881,0,-10006,0,0,0,,10006,-10006
21,05/23/2018,93,23:00,23:15,137.02,22.03,0,137.02,22.03,2,-96574,56050,152624,-40524,0,-11536,7587,0,0,,19123,-3949
21,05/23/2018,94,23:15,23:30,51.92,43.28,0,51.92,43.28,2,-65947,63100,129047,-2847,0,-10,14535,0,0,,14545,14525
21,05/23/2018,95,23:30,23:45,51.92,38.11,0,38.11,38.11,-1,-21342,86394,107736,65052,0,-4918,548,0,0,,5466,-4370
21,05/23/2018,96,23:45,0:00,,-21.32,0,-21.32,-21.32,-1,-46343,92556,138899,46213,0,-27192,0,0,0,,27192,-27192
21,05/24/2018,1,0:00,0:15,,-35.78,0,-35.78,-35.78,-1,-27818,112883,140701,85065,0,-44714,0,0,0,,44714,-44714
21,05/24/2018,2,0:15,0:30,,29.72,0,29.72,29.72,-1,-19716,60757,80473,41041,0,-4255,0,0,0,,4255,-4255
21,05/24/2018,3,0:30,0:45,,7.02,0,7.02,7.02,-1,-23105,65367,88472,42262,0,-20711,0,0,0,,20711,-20711
21,05/24/2018,4,0:45,1:00,,35,0,35,35,-1,-38799,68553,107352,29754,0,-23565,0,0,0,,23565,-23565
21,05/24/2018,5,1:00,1:15,,36.71,0,36.71,36.71,-1,-27329,135406,162735,108077,0,-15227,0,0,0,,15227,-15227
21,05/24/2018,6,1:15,1:30,,30.11,0,30.11,30.11,-1,-11889,107293,119182,95404,0,-7947,0,0,0,,7947,-7947
21,05/24/2018,7,1:30,1:45,,38.81,0,38.81,38.81,-1,-5951,65973,71924,60022,0,-3543,0,0,0,,3543,-3543
21,05/24/2018,8,1:45,2:00,,-150.78,0,-150.78,-150.78,-1,-9311,89572,98883,80261,0,-26459,0,0,0,,26459,-26459
21,05/24/2018,9,2:00,2:15,,-150.78,0,-150.78,-150.78,-1,-39114,78442,117556,39328,0,-39059,0,0,0,,39059,-39059
21,05/24/2018,10,2:15,2:30,,,0,35.82,35.82,0,-24326,88509,112835,64183,0,-59,0,0,0,,59,-59
21,05/24/2018,11,2:30,2:45,,38.43,0,38.43,38.43,-1,-21366,77210,98576,55844,0,-773,0,0,0,,773,-773
21,05/24/2018,12,2:45,3:00,,41.76,0,41.76,41.76,-1,-19851,72887,92738,53036,0,-298,0,0,0,,298,-298
21,05/24/2018,13,3:00,3:15,,17.67,0,17.67,17.67,-1,-29620,69320,98940,39700,0,-18410,0,0,0,,18410,-18410
21,05/24/2018,14,3:15,3:30,,37.83,0,37.83,37.83,-1,-33178,59492,92670,26314,0,-30500,0,0,0,,30500,-30500
21,05/24/2018,15,3:30,3:45,,38.11,0,38.11,38.11,-1,-34447,43539,77986,9092,0,-16525,0,0,0,,16525,-16525
21,05/24/2018,16,3:45,4:00,,38.07,0,38.07,38.07,-1,-34763,42837,77600,8074,0,-4642,0,0,0,,4642,-4642
21,05/24/2018,17,4:00,4:15,,38.28,0,38.28,38.28,-1,-33560,53684,87244,20124,0,-12571,0,0,0,,12571,-12571
21,05/24/2018,18,4:15,4:30,,38.2,0,38.2,38.2,-1,-34041,49145,83186,15104,0,-17490,0,0,0,,17490,-17490
21,05/24/2018,19,4:30,4:45,42.11,39.78,0,42.11,35.69,2,-39579,37614,77193,-1965,0,-5429,21,0,0,,5450,-5408
21,05/24/2018,20,4:45,5:00,48.12,41.42,0,48.12,35.79,2,-49141,44241,93382,-4900,0,-387,6579,0,0,,6966,6192
21,05/24/2018,21,5:00,5:15,48.12,34.11,0,34.11,34.11,-1,-60540,79485,140025,18945,0,-13426,383,0,0,,13809,-13043
21,05/24/2018,22,5:15,5:30,,38.11,0,38.11,38.11,-1,-50296,69121,119417,18825,0,-21067,0,0,0,,21067,-21067
21,05/24/2018,23,5:30,5:45,,38.11,0,38.11,38.11,-1,-49802,56045,105847,6243,0,-14223,0,0,0,,14223,-14223
21,05/24/2018,24,5:45,6:00,46.11,36.13,0,46.11,36.13,2,-58549,65766,124315,7217,0,-4356,1546,0,0,,5902,-2810
21,05/24/2018,25,6:00,6:15,,-150.78,0,-150.78,-150.78,-1,-59015,112769,171784,53754,0,-40466,0,0,0,,40466,-40466
21,05/24/2018,26,6:15,6:30,,38.71,0,38.71,38.71,-1,-48863,80077,128940,31214,0,-31661,0,0,0,,31661,-31661
21,05/24/2018,27,6:30,6:45,,39,0,39,39,-1,-57805,65013,122818,7208,0,-21393,0,0,0,,21393,-21393
21,05/24/2018,28,6:45,7:00,46.71,26.59,0,46.71,26.59,2,-69322,97700,167022,28378,0,-7836,1414,0,0,,9250,-6422
21,05/24/2018,29,7:00,7:15,,34.71,0,34.71,34.71,-1,-77147,119274,196421,42127,0,-15008,0,0,0,,15008,-15008
21,05/24/2018,30,7:15,7:30,,,0,43.74,43.74,0,-50594,70736,121330,20142,0,-1554,0,0,0,,1554,-1554
21,05/24/2018,31,7:30,7:45,52.29,,0,52.29,52.29,1,-69157,57194,126351,-11963,0,0,2357,0,0,,2357,2357
21,05/24/2018,32,7:45,8:00,58.12,,0,58.12,58.12,1,-87260,64325,151585,-22935,0,0,22331,0,0,,22331,22331
21,05/24/2018,33,8:00,8:15,67.25,,0,67.25,67.25,1,-81289,44486,125775,-36803,0,0,29059,0,0,,29059,29059
21,05/24/2018,34,8:15,8:30,48.25,,0,48.25,48.25,1,-78295,54144,132439,-24151,0,0,15542,0,0,,15542,15542
21,05/24/2018,35,8:30,8:45,52.93,,0,52.93,52.93,1,-88037,57229,145266,-30808,0,0,19341,0,0,,19341,19341
21,05/24/2018,36,8:45,9:00,68.02,,0,68.02,68.02,1,-105522,54212,159734,-51310,0,0,32600,0,0,,32600,32600
21,05/24/2018,37,9:00,9:15,72.71,,0,72.71,72.71,1,-87787,39676,127463,-48111,0,0,49753,0,0,,49753,49753
21,05/24/2018,38,9:15,9:30,49.62,,0,49.62,49.62,1,-88097,53221,141318,-34876,0,0,27715,0,0,,27715,27715
21,05/24/2018,39,9:30,9:45,50.86,,0,50.86,50.86,1,-85805,48737,134542,-37068,0,0,24598,0,0,,24598,24598
21,05/24/2018,40,9:45,10:00,67.25,,0,67.25,67.25,1,-99322,48646,147968,-50676,0,0,31577,0,0,,31577,31577
21,05/24/2018,41,10:00,10:15,198.12,,0,198.12,198.12,1,-133242,50154,183396,-83088,0,0,67459,0,0,,67459,67459
21,05/24/2018,42,10:15,10:30,66.48,,0,66.48,66.48,1,-99428,59693,159121,-39735,0,0,51294,0,0,,51294,51294
21,05/24/2018,43,10:30,10:45,47,,0,47,47,1,-95035,70548,165583,-24487,0,0,21045,0,0,,21045,21045
21,05/24/2018,44,10:45,11:00,48.25,,0,48.25,48.25,1,-101789,74471,176260,-27318,0,0,13369,0,0,,13369,13369
21,05/24/2018,45,11:00,11:15,55.83,,0,55.83,55.83,1,-114285,63250,177535,-51035,0,0,23182,0,0,,23182,23182
21,05/24/2018,46,11:15,11:30,57.8,,0,57.8,57.8,1,-107707,59770,167477,-47937,0,0,22792,0,0,,22792,22792
21,05/24/2018,47,11:30,11:45,198.12,,0,198.12,198.12,1,-146035,64726,210761,-81309,0,0,53189,0,0,,53189,53189
21,05/24/2018,48,11:45,12:00,55.21,,0,55.21,55.21,1,-160506,91367,251873,-69139,0,0,52811,0,0,,52811,52811
21,05/24/2018,49,12:00,12:15,92.25,,0,92.25,92.25,1,-179886,114223,294109,-65663,0,0,55563,0,0,,55563,55563
21,05/24/2018,50,12:15,12:30,65.66,,0,65.66,65.66,1,-163864,115862,279726,-48002,0,0,51463,0,0,,51463,51463
21,05/24/2018,51,12:30,12:45,47.95,42.97,0,42.97,42.97,-1,-139200,130883,270083,-8317,0,-152,16373,0,0,,16525,16221
21,05/24/2018,52,12:45,13:00,198.12,,0,253,253,1,-232340,135163,367503,-97177,0,0,26846,0,5417,,32263,32263
21,05/24/2018,53,13:00,13:15,256,,0,281.6,281.6,1,-247704,124034,371738,-123670,0,0,95445,3750,16251,,115446,115446
21,05/24/2018,54,13:15,13:30,256,,0,281.6,281.6,1,-240772,165354,406126,-75418,0,0,69434,3750,16251,,89435,89435
21,05/24/2018,55,13:30,13:45,256,,0,281.6,281.6,1,-236721,189363,426084,-47358,0,0,28271,3750,16251,,48272,48272
21,05/24/2018,56,13:45,14:00,80.12,,0,80.12,80.12,1,-232074,182675,414749,-49399,0,0,32829,0,0,,32829,32829
21,05/24/2018,57,14:00,14:15,198.12,,0,198.12,198.12,1,-216493,142665,359158,-73828,0,0,67026,0,0,,67026,67026
21,05/24/2018,58,14:15,14:30,92.69,,0,92.69,92.69,1,-213760,155107,368867,-58653,0,0,64949,0,0,,64949,64949
21,05/24/2018,59,14:30,14:45,67.71,,0,67.71,67.71,1,-186551,153240,339791,-33311,0,0,47154,0,0,,47154,47154
21,05/24/2018,60,14:45,15:00,67.71,,0,67.71,67.71,1,-168696,132822,301518,-35874,0,0,19633,0,0,,19633,19633
21,05/24/2018,61,15:00,15:15,48.25,45.35,0,45.35,45.35,-1,-171153,181200,352353,10047,0,-2,12762,0,0,,12764,12760
21,05/24/2018,62,15:15,15:30,48.25,42.93,0,42.93,42.93,-1,-134469,154570,289039,20101,0,-1251,220,0,0,,1471,-1031
21,05/24/2018,63,15:30,15:45,49.69,43.78,0,49.69,49.69,1,-145146,132377,277523,-12769,0,-253,897,0,0,,1150,644
21,05/24/2018,64,15:45,16:00,52.25,,0,52.25,52.25,1,-121601,142419,264020,20818,0,0,3957,0,0,,3957,3957
21,05/24/2018,65,16:00,16:15,,-32.75,0,-32.75,-32.75,-1,-46195,228203,274398,182008,0,-21260,0,0,0,,21260,-21260
21,05/24/2018,66,16:15,16:30,,37.4,0,37.4,37.4,-1,-58923,178358,237281,119435,0,-16260,0,0,0,,16260,-16260
21,05/24/2018,67,16:30,16:45,,41.51,0,41.51,41.51,-1,-63417,189872,253289,126455,0,-5105,0,0,0,,5105,-5105
21,05/24/2018,68,16:45,17:00,,43.5,0,43.5,43.5,-1,-86467,165824,252291,79357,0,-1835,0,0,0,,1835,-1835
21,05/24/2018,69,17:00,17:15,,,0,43.93,43.93,0,-128333,149522,277855,21189,0,-32,0,0,0,,32,-32
21,05/24/2018,70,17:15,17:30,46.64,,0,46.64,46.64,1,-139389,133291,272680,-6098,0,0,346,0,0,,346,346
21,05/24/2018,71,17:30,17:45,56.68,,0,56.68,56.68,1,-120062,100455,220517,-19607,0,0,5959,0,0,,5959,5959
21,05/24/2018,72,17:45,18:00,69.82,,0,69.82,69.82,1,-117729,94710,212439,-23019,0,0,25715,0,0,,25715,25715
21,05/24/2018,73,18:00,18:15,48.25,,0,48.25,48.25,1,-111023,63124,174147,-47899,0,0,15710,0,0,,15710,15710
21,05/24/2018,74,18:15,18:30,44.14,,0,44.14,44.14,1,-88404,63397,151801,-25007,0,0,4770,0,0,,4770,4770
21,05/24/2018,75,18:30,18:45,44.14,,0,44.14,44.14,1,-75852,92129,167981,16277,0,0,1461,0,0,,1461,1461
21,05/24/2018,76,18:45,19:00,44.14,,0,44.14,44.14,1,-80293,89300,169593,9007,0,0,1202,0,0,,1202,1202
21,05/24/2018,77,19:00,19:15,44.65,,0,44.65,44.65,1,-95410,101536,196946,6126,0,0,608,0,0,,608,608
21,05/24/2018,78,19:15,19:30,47.66,,0,47.66,47.66,1,-107389,89508,196897,-17881,0,0,3409,0,0,,3409,3409
21,05/24/2018,79,19:30,19:45,81.86,,0,81.86,81.86,1,-118160,80172,198332,-37988,0,0,24177,0,0,,24177,24177
21,05/24/2018,80,19:45,20:00,52.12,,0,52.12,52.12,1,-111608,88501,200109,-23107,0,0,28107,0,0,,28107,28107
21,05/24/2018,81,20:00,20:15,52.12,43.29,0,43.29,43.29,-1,-51415,66727,118142,15312,0,-472,6082,0,0,,6554,5610
21,05/24/2018,82,20:15,20:30,48.25,,0,48.25,48.25,1,-69020,50928,119948,-18092,0,0,2864,0,0,,2864,2864
21,05/24/2018,83,20:30,20:45,49.11,,0,49.11,49.11,1,-59600,39865,99465,-19735,0,0,12692,0,0,,12692,12692
21,05/24/2018,84,20:45,21:00,44.28,,0,44.28,44.28,1,-55510,46431,101941,-9079,0,0,7502,0,0,,7502,7502
21,05/24/2018,85,21:00,21:15,44.14,,0,44.14,44.14,1,-46717,71251,117968,24534,0,0,428,0,0,,428,428
21,05/24/2018,86,21:15,21:30,46.51,,0,46.51,46.51,1,-50321,43908,94229,-6413,0,0,4409,0,0,,4409,4409
21,05/24/2018,87,21:30,21:45,45.13,,0,45.13,45.13,1,-49842,48948,98790,-894,0,0,1447,0,0,,1447,1447
21,05/24/2018,88,21:45,22:00,45.65,,0,45.65,45.65,1,-53804,63558,117362,9754,0,0,1409,0,0,,1409,1409
21,05/24/2018,89,22:00,22:15,198.12,,0,198.12,198.12,1,-93660,31934,125594,-61726,0,0,28859,0,0,,28859,28859
21,05/24/2018,90,22:15,22:30,50.86,,0,50.86,50.86,1,-60559,58973,119532,-1586,0,0,16268,0,0,,16268,16268
21,05/24/2018,91,22:30,22:45,50.86,43.41,0,43.41,43.41,-1,-52000,70608,122608,18608,0,-1728,94,0,0,,1822,-1634
21,05/24/2018,92,22:45,23:00,,43.78,0,43.78,43.78,-1,-51133,81634,132767,30501,0,-4429,0,0,0,,4429,-4429
21,05/24/2018,93,23:00,23:15,197.12,40.78,0,197.12,197.12,1,-78086,40597,118683,-37489,0,-2554,9408,0,0,,11962,6854
21,05/24/2018,94,23:15,23:30,198.12,43.61,0,198.12,43.61,2,-39576,26418,65994,-13158,0,-2,34952,0,0,,34954,34950
21,05/24/2018,95,23:30,23:45,198.12,40.25,0,40.25,40.25,-1,-27798,92984,120782,65186,0,-840,646,0,0,,1486,-194
21,05/24/2018,96,23:45,0:00,,13.2,0,13.2,13.2,-1,-34356,108768,143124,74412,0,-28509,0,0,0,,28509,-28509
21,05/25/2018,1,0:00,0:15,,40.34,0,40.34,40.34,-1,-52941,82625,135566,29684,0,-12990,0,0,0,,12990,-12990
21,05/25/2018,2,0:15,0:30,,,0,44.11,44.11,0,-32915,46932,79847,14017,0,0,0,0,0,,0,0
21,05/25/2018,3,0:30,0:45,,38.67,0,38.67,38.67,-1,-23092,54064,77156,30972,0,-480,0,0,0,,480,-480
21,05/25/2018,4,0:45,1:00,,37.34,0,37.34,37.34,-1,-49024,59569,108593,10545,0,-6682,0,0,0,,6682,-6682
21,05/25/2018,5,1:00,1:15,,34.83,0,34.83,34.83,-1,-28295,112312,140607,84017,0,-3876,0,0,0,,3876,-3876
21,05/25/2018,6,1:15,1:30,,40.34,0,40.34,40.34,-1,-23256,64281,87537,41025,0,-127,0,0,0,,127,-127
21,05/25/2018,7,1:30,1:45,,40.34,0,40.34,40.34,-1,-17697,66741,84438,49044,0,-255,0,0,0,,255,-255
21,05/25/2018,8,1:45,2:00,,37.56,0,37.56,37.56,-1,-32437,70977,103414,38540,0,-5400,0,0,0,,5400,-5400
21,05/25/2018,9,2:00,2:15,,40.34,0,40.34,40.34,-1,-42450,64347,106797,21897,0,-3703,0,0,0,,3703,-3703
21,05/25/2018,10,2:15,2:30,,39.72,0,39.72,39.72,-1,-49653,66508,116161,16855,0,-589,0,0,0,,589,-589
21,05/25/2018,11,2:30,2:45,,37.59,0,37.59,37.59,-1,-44396,67861,112257,23465,0,-2531,0,0,0,,2531,-2531
21,05/25/2018,12,2:45,3:00,,36.34,0,36.34,36.34,-1,-40649,57271,97920,16622,0,-12123,0,0,0,,12123,-12123
21,05/25/2018,13,3:00,3:15,48.34,40.34,0,48.34,48.34,1,-48566,43621,92187,-4945,0,-6177,1272,0,0,,7449,-4905
21,05/25/2018,14,3:15,3:30,47.62,,0,47.62,47.62,1,-48541,34017,82558,-14524,0,0,2972,0,0,,2972,2972
21,05/25/2018,15,3:30,3:45,51.25,,0,51.25,51.25,1,-56673,37463,94136,-19210,0,0,11722,0,0,,11722,11722
21,05/25/2018,16,3:45,4:00,47.41,,0,47.41,47.41,1,-56849,39466,96315,-17383,0,0,11700,0,0,,11700,11700
21,05/25/2018,17,4:00,4:15,48.34,,0,48.34,48.34,1,-54304,38178,92482,-16126,0,0,8112,0,0,,8112,8112
21,05/25/2018,18,4:15,4:30,52.34,,0,52.34,52.34,1,-61050,30169,91219,-30881,0,0,21513,0,0,,21513,21513
21,05/25/2018,19,4:30,4:45,59.44,,0,59.44,59.44,1,-75505,30506,106011,-44999,0,0,30073,0,0,,30073,30073
21,05/25/2018,20,4:45,5:00,53.98,,0,53.98,53.98,1,-86952,46734,133686,-40218,0,0,37040,0,0,,37040,37040
21,05/25/2018,21,5:00,5:15,48.34,,0,48.34,48.34,1,-85675,43989,129664,-41686,0,0,28304,0,0,,28304,28304
21,05/25/2018,22,5:15,5:30,47.18,,0,47.18,47.18,1,-60682,33685,94367,-26997,0,0,16360,0,0,,16360,16360
21,05/25/2018,23,5:30,5:45,59.73,,0,59.73,59.73,1,-71107,35275,106382,-35832,0,0,18321,0,0,,18321,18321
21,05/25/2018,24,5:45,6:00,70.3,,0,70.3,70.3,1,-56316,56002,112318,-314,0,0,29422,0,0,,29422,29422
21,05/25/2018,25,6:00,6:15,70.3,40.29,0,40.29,40.29,-1,-84359,68343,152702,-16016,0,-2022,3328,0,0,,5350,1306
21,05/25/2018,26,6:15,6:30,,,0,44.43,44.43,0,-64908,53210,118118,-11698,0,-182,0,0,0,,182,-182
21,05/25/2018,27,6:30,6:45,70.02,,0,70.02,70.02,1,-94019,42682,136701,-51337,0,0,11409,0,0,,11409,11409
21,05/25/2018,28,6:45,7:00,95.02,,0,95.02,95.02,1,-117112,71105,188217,-46007,0,0,40171,0,0,,40171,40171
21,05/25/2018,29,7:00,7:15,95.02,37.02,0,37.02,37.02,-1,-73141,153126,226267,79985,0,-1658,7540,0,0,,9198,5882
21,05/25/2018,30,7:15,7:30,44.47,,0,44.47,44.47,1,-73569,80936,154505,7367,0,0,199,0,0,,199,199
21,05/25/2018,31,7:30,7:45,67.56,,0,67.56,67.56,1,-95984,59591,155575,-36393,0,0,15442,0,0,,15442,15442
21,05/25/2018,32,7:45,8:00,104.02,,0,104.02,104.02,1,-103173,80486,183659,-22687,0,0,37608,0,0,,37608,37608
21,05/25/2018,33,8:00,8:15,104.02,41.56,0,41.56,41.56,-1,-74116,139583,213699,65467,0,-602,6751,0,0,,7353,6149
21,05/25/2018,34,8:15,8:30,,36.56,0,36.56,36.56,-1,-61516,129195,190711,67679,0,-2112,0,0,0,,2112,-2112
21,05/25/2018,35,8:30,8:45,,35.14,0,35.14,35.14,-1,-71485,85339,156824,13854,0,-3043,0,0,0,,3043,-3043
21,05/25/2018,36,8:45,9:00,44.88,35.14,0,44.88,44.88,1,-81018,80860,161878,-158,0,-56,696,0,0,,752,640
21,05/25/2018,37,9:00,9:15,59.8,,0,59.8,59.8,1,-107663,61519,169182,-46144,0,0,15079,0,0,,15079,15079
21,05/25/2018,38,9:15,9:30,57.87,,0,57.87,57.87,1,-113232,71091,184323,-42141,0,0,23051,0,0,,23051,23051
21,05/25/2018,39,9:30,9:45,53.02,,0,53.02,53.02,1,-107145,76687,183832,-30458,0,0,27540,0,0,,27540,27540
21,05/25/2018,40,9:45,10:00,47.02,,0,47.02,47.02,1,-94656,73704,168360,-20952,0,0,11826,0,0,,11826,11826
21,05/25/2018,41,10:00,10:15,198.02,,0,198.02,198.02,1,-108863,58495,167358,-50368,0,0,32766,0,0,,32766,32766
21,05/25/2018,42,10:15,10:30,198.02,,0,260,260,1,-144776,45203,189979,-99573,0,0,64290,0,0,,64290,64290
21,05/25/2018,43,10:30,10:45,160,41.9,0,41.9,41.9,-1,-129890,99241,229131,-30649,0,-63,46176,1250,34998,,82487,82361
21,05/25/2018,44,10:45,11:00,160,41.88,0,160,41.88,2,-138248,164907,303155,26659,0,-563,670,1250,11666,,14149,13023
21,05/25/2018,45,11:00,11:15,44.47,,0,44.47,44.47,1,-173832,126373,300205,-47459,0,0,659,0,0,,659,659
21,05/25/2018,46,11:15,11:30,46.02,,0,46.02,46.02,1,-169006,79817,248823,-89189,0,0,7223,0,0,,7223,7223
21,05/25/2018,47,11:30,11:45,45.02,,0,45.02,45.02,1,-161687,78474,240161,-83213,0,0,13145,0,0,,13145,13145
21,05/25/2018,48,11:45,12:00,127.63,,0,127.63,127.63,1,-135846,79550,215396,-56296,0,0,39842,0,0,,39842,39842
21,05/25/2018,49,12:00,12:15,44.47,24.64,0,24.64,24.64,-1,-62570,117980,180550,55410,0,-2274,16749,0,0,,19023,14475
21,05/25/2018,50,12:15,12:30,,25.03,0,25.03,25.03,-1,-47487,114744,162231,67257,0,-5212,0,0,0,,5212,-5212
21,05/25/2018,51,12:30,12:45,,45.05,0,45.05,45.05,-1,-47708,101209,148917,53501,0,-873,0,0,0,,873,-873
21,05/25/2018,52,12:45,13:00,,,0,45.01,45.01,0,-40329,96324,136653,55995,0,0,0,0,0,,0,0
21,05/25/2018,53,13:00,13:15,45.08,,0,45.08,45.08,1,-65674,79673,145347,13999,0,0,559,0,0,,559,559
21,05/25/2018,54,13:15,13:30,67.56,,0,67.56,67.56,1,-86629,70011,156640,-16618,0,0,9534,0,0,,9534,9534
21,05/25/2018,55,13:30,13:45,48.56,,0,48.56,48.56,1,-94597,84491,179088,-10106,0,0,15133,0,0,,15133,15133
21,05/25/2018,56,13:45,14:00,48.56,,0,48.56,48.56,1,-104628,91376,196004,-13252,0,0,16089,0,0,,16089,16089
21,05/25/2018,57,14:00,14:15,84.05,,0,84.05,84.05,1,-109852,57290,167142,-52562,0,0,29404,0,0,,29404,29404
21,05/25/2018,58,14:15,14:30,57.02,,0,57.02,57.02,1,-104507,63032,167539,-41475,0,0,40304,0,0,,40304,40304
21,05/25/2018,59,14:30,14:45,50.42,,0,50.42,50.42,1,-97200,65003,162203,-32197,0,0,29827,0,0,,29827,29827
21,05/25/2018,60,14:45,15:00,50.39,,0,50.39,50.39,1,-102614,55850,158464,-46764,0,0,20237,0,0,,20237,20237
21,05/25/2018,61,15:00,15:15,96.02,,0,96.02,96.02,1,-93228,30429,123657,-62799,0,0,27355,0,0,,27355,27355
21,05/25/2018,62,15:15,15:30,52.56,,0,52.56,52.56,1,-89266,46829,136095,-42437,0,0,30412,0,0,,30412,30412
21,05/25/2018,63,15:30,15:45,175.02,,0,175.02,175.02,1,-108448,42037,150485,-66411,0,0,35013,0,0,,35013,35013
21,05/25/2018,64,15:45,16:00,186.02,,0,186.02,186.02,1,-102092,54351,156443,-47741,0,0,46472,0,0,,46472,46472
21,05/25/2018,65,16:00,16:15,186.02,36.56,0,36.56,36.56,-1,-45517,83452,128969,37935,0,-2392,7866,0,0,,10258,5474
21,05/25/2018,66,16:15,16:30,,,0,44.93,44.93,0,-81759,67980,149739,-13779,0,-83,0,0,0,,83,-83
21,05/25/2018,67,16:30,16:45,44.47,,0,44.47,44.47,1,-92871,70373,163244,-22498,0,0,1140,0,0,,1140,1140
21,05/25/2018,68,16:45,17:00,,,0,44.87,44.87,0,-114124,70772,184896,-43352,0,0,114,0,0,,114,114
21,05/25/2018,69,17:00,17:15,,40.56,0,40.56,40.56,-1,-73351,96262,169613,22911,0,-2244,0,0,0,,2244,-2244
21,05/25/2018,70,17:15,17:30,,45.14,0,45.14,45.14,-1,-78836,75996,154832,-2840,0,-1274,0,0,0,,1274,-1274
21,05/25/2018,71,17:30,17:45,,,0,44.96,44.96,0,-96838,79408,176246,-17430,0,-155,0,0,0,,155,-155
21,05/25/2018,72,17:45,18:00,198.02,,0,198.02,198.02,1,-169700,71676,241376,-98024,0,0,14261,0,0,,14261,14261
21,05/25/2018,73,18:00,18:15,108.02,,0,108.02,108.02,1,-137394,89928,227322,-47466,0,0,41011,0,0,,41011,41011
21,05/25/2018,74,18:15,18:30,67.56,,0,67.56,67.56,1,-109110,67689,176799,-41421,0,0,28393,0,0,,28393,28393
21,05/25/2018,75,18:30,18:45,75.02,,0,75.02,75.02,1,-96234,66168,162402,-30066,0,0,34795,0,0,,34795,34795
21,05/25/2018,76,18:45,19:00,48.56,42.3,0,42.3,42.3,-1,-53754,75405,129159,21651,0,-149,14906,0,0,,15055,14757
21,05/25/2018,77,19:00,19:15,48.56,10.36,0,10.36,10.36,-1,-52809,101677,154486,48868,0,-20409,378,0,0,,20787,-20031
21,05/25/2018,78,19:15,19:30,44.47,40.56,0,44.47,44.47,1,-100425,87550,187975,-12875,0,-10765,93,0,0,,10858,-10672
21,05/25/2018,79,19:30,19:45,44.47,40.56,0,44.47,44.47,1,-79574,71294,150868,-8280,0,-72,1038,0,0,,1110,966
21,05/25/2018,80,19:45,20:00,,,0,45.07,45.07,0,-81816,54934,136750,-26882,0,0,0,0,0,,0,0
21,05/25/2018,81,20:00,20:15,165.02,,0,165.02,165.02,1,-99848,56659,156507,-43189,0,0,18568,0,0,,18568,18568
21,05/25/2018,82,20:15,20:30,52.47,45.21,0,45.21,45.21,-1,-53525,64288,117813,10763,0,-21,16354,0,0,,16375,16333
21,05/25/2018,83,20:30,20:45,52.47,44.84,0,44.84,44.84,-1,-39359,70029,109388,30670,0,-1566,121,0,0,,1687,-1445
21,05/25/2018,84,20:45,21:00,,45.3,0,45.3,45.3,-1,-39935,77692,117627,37757,0,-1369,0,0,0,,1369,-1369
21,05/25/2018,85,21:00,21:15,52.56,45.3,0,52.56,52.56,1,-70740,60891,131631,-9849,0,-417,2537,0,0,,2954,2120
21,05/25/2018,86,21:15,21:30,53.67,,0,53.67,53.67,1,-60566,65597,126163,5031,0,0,5578,0,0,,5578,5578
21,05/25/2018,87,21:30,21:45,,40.56,0,40.56,40.56,-1,-54483,69166,123649,14683,0,-2036,0,0,0,,2036,-2036
21,05/25/2018,88,21:45,22:00,,44.03,0,44.03,44.03,-1,-56597,59036,115633,2439,0,-1068,0,0,0,,1068,-1068
21,05/25/2018,89,22:00,22:15,67.8,,0,67.8,67.8,1,-113265,21798,135063,-91467,0,0,9564,0,0,,9564,9564
21,05/25/2018,90,22:15,22:30,49.4,,0,49.4,49.4,1,-93753,21002,114755,-72751,0,0,20801,0,0,,20801,20801
21,05/25/2018,91,22:30,22:45,76.32,,0,76.32,76.32,1,-88667,27469,116136,-61198,0,0,4604,0,0,,4604,4604
21,05/25/2018,92,22:45,23:00,198.02,,0,198.02,198.02,1,-88248,31592,119840,-56656,0,0,39854,0,0,,39854,39854
21,05/25/2018,93,23:00,23:15,52.02,,0,52.02,52.02,1,-112845,71044,183889,-41801,0,0,15729,0,0,,15729,15729
21,05/25/2018,94,23:15,23:30,48.56,,0,48.56,48.56,1,-93123,57297,150420,-35826,0,0,11044,0,0,,11044,11044
21,05/25/2018,95,23:30,23:45,48.56,,0,48.56,48.56,1,-82496,50563,133059,-31933,0,0,869,0,0,,869,869
21,05/25/2018,96,23:45,0:00,44.47,41.69,0,44.89,41.69,2,-56853,34288,91141,-22565,0,-52,1677,0,0,,1729,1625
22,05/26/2018,1,0:00,0:15,44.29,17.3,0,44.29,17.3,2,-50296,120664,170960,70368,0,-3156,3,0,0,,3159,-3153
22,05/26/2018,2,0:15,0:30,56.83,,0,56.83,56.83,1,-70605,51379,121984,-19226,0,0,6975,0,0,,6975,6975
22,05/26/2018,3,0:30,0:45,45.47,,0,45.47,45.47,1,-76357,54966,131323,-21391,0,0,772,0,0,,772,772
22,05/26/2018,4,0:45,1:00,67.3,,0,67.3,67.3,1,-141176,56340,197516,-84836,0,0,18847,0,0,,18847,18847
22,05/26/2018,5,1:00,1:15,74.44,,0,74.44,74.44,1,-62489,29835,92324,-32654,0,0,31242,0,0,,31242,31242
22,05/26/2018,6,1:15,1:30,51.12,,0,51.12,51.12,1,-54847,24251,79098,-30596,0,0,27227,0,0,,27227,27227
22,05/26/2018,7,1:30,1:45,48.3,,0,48.3,48.3,1,-35785,8191,43976,-27594,0,0,9748,0,0,,9748,9748
22,05/26/2018,8,1:45,2:00,52.3,,0,52.3,52.3,1,-59538,26841,86379,-32697,0,0,23126,0,0,,23126,23126
22,05/26/2018,9,2:00,2:15,81.9,,0,81.9,81.9,1,-74791,28866,103657,-45925,0,0,32262,0,0,,32262,32262
22,05/26/2018,10,2:15,2:30,53.09,,0,53.09,53.09,1,-49176,37448,86624,-11728,0,0,28508,0,0,,28508,28508
22,05/26/2018,11,2:30,2:45,53.09,40.62,0,40.62,40.62,-1,-28429,38768,67197,10339,0,-791,2459,0,0,,3250,1668
22,05/26/2018,12,2:45,3:00,,40.3,0,40.3,40.3,-1,-28973,34943,63916,5970,0,-622,0,0,0,,622,-622
22,05/26/2018,13,3:00,3:15,52.3,40.3,0,52.3,52.3,1,-59830,42000,101830,-17830,0,-481,6708,0,0,,7189,6227
22,05/26/2018,14,3:15,3:30,44.3,,0,44.3,44.3,1,-45565,43052,88617,-2513,0,0,3071,0,0,,3071,3071
22,05/26/2018,15,3:30,3:45,42.92,,0,42.92,42.92,1,-41011,53073,94084,12062,0,0,1348,0,0,,1348,1348
22,05/26/2018,16,3:45,4:00,,38.78,0,38.78,38.78,-1,-39712,53306,93018,13594,0,-1223,0,0,0,,1223,-1223
22,05/26/2018,17,4:00,4:15,,37.78,0,37.78,37.78,-1,-40876,62449,103325,21573,0,-3321,0,0,0,,3321,-3321
22,05/26/2018,18,4:15,4:30,,,0,41.87,41.87,0,-38658,50589,89247,11931,0,0,0,0,0,,0,0
22,05/26/2018,19,4:30,4:45,,,0,41.87,41.87,0,-36246,48073,84319,11827,0,0,0,0,0,,0,0
22,05/26/2018,20,4:45,5:00,,40.79,0,40.79,40.79,-1,-39380,48194,87574,8814,0,-187,0,0,0,,187,-187
22,05/26/2018,21,5:00,5:15,,32.3,0,32.3,32.3,-1,-50073,79536,129609,29463,0,-13341,0,0,0,,13341,-13341
22,05/26/2018,22,5:15,5:30,,27.42,0,27.42,27.42,-1,-34919,74269,109188,39350,0,-33550,0,0,0,,33550,-33550
22,05/26/2018,23,5:30,5:45,,31.78,0,31.78,31.78,-1,-25342,73927,99269,48585,0,-41279,0,0,0,,41279,-41279
22,05/26/2018,24,5:45,6:00,,27.78,0,27.78,27.78,-1,-29827,75959,105786,46132,0,-47954,0,0,0,,47954,-47954
22,05/26/2018,25,6:00,6:15,,12.78,0,12.78,12.78,-1,-16524,79298,95822,62774,0,-56104,0,0,0,,56104,-56104
22,05/26/2018,26,6:15,6:30,,19.27,0,19.27,19.27,-1,-29615,48762,78377,19147,0,-44520,0,0,0,,44520,-44520
22,05/26/2018,27,6:30,6:45,,39.64,0,39.64,39.64,-1,-32338,37733,70071,5395,0,-4075,0,0,0,,4075,-4075
22,05/26/2018,28,6:45,7:00,47.64,39.64,0,47.64,47.64,1,-49596,34938,84534,-14658,0,-85,5006,0,0,,5091,4921
22,05/26/2018,29,7:00,7:15,43.19,23.45,0,23.45,23.45,-1,-25268,51275,76543,26007,0,-11624,1876,0,0,,13500,-9748
22,05/26/2018,30,7:15,7:30,,38.86,0,38.86,38.86,-1,-28395,31606,60001,3211,0,-18595,0,0,0,,18595,-18595
22,05/26/2018,31,7:30,7:45,47.64,38.86,0,47.64,47.64,1,-39364,18430,57794,-20934,0,-2327,3671,0,0,,5998,1344
22,05/26/2018,32,7:45,8:00,51.74,,0,51.74,51.74,1,-59675,35835,95510,-23840,0,0,12898,0,0,,12898,12898
22,05/26/2018,33,8:00,8:15,,,0,42.82,42.82,0,-41992,48506,90498,6514,0,0,1796,0,0,,1796,1796
22,05/26/2018,34,8:15,8:30,,,0,42.88,42.88,0,-40186,44233,84419,4047,0,0,0,0,0,,0,0
22,05/26/2018,35,8:30,8:45,48.69,,0,48.69,48.69,1,-68435,55263,123698,-13172,0,0,1759,0,0,,1759,1759
22,05/26/2018,36,8:45,9:00,57.14,,0,57.14,57.14,1,-104853,64473,169326,-40380,0,0,26092,0,0,,26092,26092
22,05/26/2018,37,9:00,9:15,197.12,,0,197.12,197.12,1,-53693,86436,140129,32743,0,0,53084,0,0,,53084,53084
22,05/26/2018,38,9:15,9:30,197.12,,0,197.12,197.12,1,-39533,103935,143468,64402,0,0,91073,13750,0,,104823,104823
22,05/26/2018,39,9:30,9:45,129.17,,0,129.17,129.17,1,-40899,175696,216595,134797,0,0,32779,13750,0,,46529,46529
22,05/26/2018,40,9:45,10:00,111.38,,0,111.38,111.38,1,-44132,175369,219501,131237,0,0,12817,12500,0,,25317,25317
22,05/26/2018,41,10:00,10:15,43.64,,0,43.64,43.64,1,-28455,200610,229065,172155,0,0,3391,0,0,,3391,3391
22,05/26/2018,42,10:15,10:30,68,,0,68,68,1,-33259,155500,188759,122241,0,0,16516,0,0,,16516,16516
22,05/26/2018,43,10:30,10:45,47.64,,0,47.64,47.64,1,-23513,151382,174895,127869,0,0,20704,0,0,,20704,20704
22,05/26/2018,44,10:45,11:00,57.11,,0,57.11,57.11,1,-34621,147585,182206,112964,0,0,17536,0,0,,17536,17536
22,05/26/2018,45,11:00,11:15,45.22,,0,45.22,45.22,1,-29752,171573,201325,141821,0,0,10703,0,0,,10703,10703
22,05/26/2018,46,11:15,11:30,43.53,,0,43.53,43.53,1,-28548,176505,205053,147957,0,0,4954,0,0,,4954,4954
22,05/26/2018,47,11:30,11:45,43.53,,0,43.53,43.53,1,-27440,175254,202694,147814,0,0,994,0,0,,994,994
22,05/26/2018,48,11:45,12:00,47.64,,0,47.64,47.64,1,-21417,182224,203641,160807,0,0,7281,0,0,,7281,7281
22,05/26/2018,49,12:00,12:15,43.28,,0,43.28,43.28,1,-60511,120616,181127,60105,0,0,1885,0,0,,1885,1885
22,05/26/2018,50,12:15,12:30,43.28,,0,43.28,43.28,1,-57195,122285,179480,65090,0,0,2,0,0,,2,2
22,05/26/2018,51,12:30,12:45,,39.64,0,39.64,39.64,-1,-37541,123284,160825,85743,0,-207,0,0,0,,207,-207
22,05/26/2018,52,12:45,13:00,,31.64,0,31.64,31.64,-1,-29196,118987,148183,89791,0,-3556,0,0,0,,3556,-3556
22,05/26/2018,53,13:00,13:15,,38.78,0,38.78,38.78,-1,-56620,108973,165593,52353,0,-3670,0,0,0,,3670,-3670
22,05/26/2018,54,13:15,13:30,,38.78,0,38.78,38.78,-1,-61996,106430,168426,44434,0,-3159,0,0,0,,3159,-3159
22,05/26/2018,55,13:30,13:45,,34.4,0,34.4,34.4,-1,-39866,110810,150676,70944,0,-4905,0,0,0,,4905,-4905
22,05/26/2018,56,13:45,14:00,,-0.78,0,-0.78,-0.78,-1,-27376,101315,128691,73939,0,-39369,0,0,0,,39369,-39369
22,05/26/2018,57,14:00,14:15,,31.64,0,31.64,31.64,-1,-39819,60251,100070,20432,0,-30963,0,0,0,,30963,-30963
22,05/26/2018,58,14:15,14:30,44.77,31.64,0,44.77,44.77,1,-52520,58850,111370,6330,0,-2569,83,0,0,,2652,-2486
22,05/26/2018,59,14:30,14:45,,41.42,0,41.42,41.42,-1,-51628,57117,108745,5489,0,-340,0,0,0,,340,-340
22,05/26/2018,60,14:45,15:00,,41.42,0,41.42,41.42,-1,-72846,62071,134917,-10775,0,-1316,0,0,0,,1316,-1316
22,05/26/2018,61,15:00,15:15,,41.38,0,41.38,41.38,-1,-75156,64846,140002,-10310,0,-1058,0,0,0,,1058,-1058
22,05/26/2018,62,15:15,15:30,46.82,,0,46.82,46.82,1,-72158,56999,129157,-15159,0,0,1481,0,0,,1481,1481
22,05/26/2018,63,15:30,15:45,49.66,,0,49.66,49.66,1,-78456,52648,131104,-25808,0,0,6279,0,0,,6279,6279
22,05/26/2018,64,15:45,16:00,47.64,,0,47.64,47.64,1,-75699,55325,131024,-20374,0,0,17142,0,0,,17142,17142
22,05/26/2018,65,16:00,16:15,47.64,,0,47.64,47.64,1,-48312,49937,98249,1625,0,0,11170,0,0,,11170,11170
22,05/26/2018,66,16:15,16:30,42.86,,0,42.86,42.86,1,-45831,61983,107814,16152,0,0,324,0,0,,324,324
22,05/26/2018,67,16:30,16:45,43.53,,0,43.53,43.53,1,-43820,60802,104622,16982,0,0,2288,0,0,,2288,2288
22,05/26/2018,68,16:45,17:00,47.64,,0,47.64,47.64,1,-63950,37907,101857,-26043,0,0,5146,0,0,,5146,5146
22,05/26/2018,69,17:00,17:15,43.53,,0,43.53,43.53,1,-59280,98280,157560,39000,0,0,2450,0,0,,2450,2450
22,05/26/2018,70,17:15,17:30,43.53,,0,43.53,43.53,1,-50821,75523,126344,24702,0,0,498,0,0,,498,498
22,05/26/2018,71,17:30,17:45,51.64,,0,51.64,51.64,1,-62065,67934,129999,5869,0,0,2760,0,0,,2760,2760
22,05/26/2018,72,17:45,18:00,95,,0,95,95,1,-81312,68420,149732,-12892,0,0,29430,0,0,,29430,29430
22,05/26/2018,73,18:00,18:15,187.12,,0,187.12,187.12,1,-100861,55245,156106,-45616,0,0,56497,0,0,,56497,56497
22,05/26/2018,74,18:15,18:30,187.12,,0,187.12,187.12,1,-93237,70617,163854,-22620,0,0,90331,0,0,,90331,90331
22,05/26/2018,75,18:30,18:45,95,,0,95,95,1,-70304,88944,159248,18640,0,0,42049,11250,0,,53299,53299
22,05/26/2018,76,18:45,19:00,86.12,,0,86.12,86.12,1,-79756,105751,185507,25995,0,0,12587,0,0,,12587,12587
22,05/26/2018,77,19:00,19:15,,,0,42.43,42.43,0,-88283,79809,168092,-8474,0,0,9356,0,0,,9356,9356
22,05/26/2018,78,19:15,19:30,97.12,,0,97.12,97.12,1,-90368,49780,140148,-40588,0,0,16077,0,0,,16077,16077
22,05/26/2018,79,19:30,19:45,97.12,,0,97.12,97.12,1,-101579,44270,145849,-57309,0,0,46608,0,0,,46608,46608
22,05/26/2018,80,19:45,20:00,91.12,,0,91.12,91.12,1,-103537,47626,151163,-55911,0,0,54177,0,0,,54177,54177
22,05/26/2018,81,20:00,20:15,80.5,,0,80.5,80.5,1,-134525,76060,210585,-58465,0,0,52171,0,0,,52171,52171
22,05/26/2018,82,20:15,20:30,130.12,,0,130.12,130.12,1,-133360,65549,198909,-67811,0,0,65640,0,0,,65640,65640
22,05/26/2018,83,20:30,20:45,63.12,,0,63.12,63.12,1,-102792,69221,172013,-33571,0,0,46978,0,0,,46978,46978
22,05/26/2018,84,20:45,21:00,47.12,,0,47.12,47.12,1,-80005,58362,138367,-21643,0,0,20676,0,0,,20676,20676
22,05/26/2018,85,21:00,21:15,51.74,,0,51.74,51.74,1,-77879,44866,122745,-33013,0,0,21882,0,0,,21882,21882
22,05/26/2018,86,21:15,21:30,53.12,,0,53.12,53.12,1,-87243,45244,132487,-41999,0,0,30055,0,0,,30055,30055
22,05/26/2018,87,21:30,21:45,98.99,,0,98.99,98.99,1,-101041,44481,145522,-56560,0,0,43367,0,0,,43367,43367
22,05/26/2018,88,21:45,22:00,60.98,,0,60.98,60.98,1,-77668,52656,130324,-25012,0,0,35670,0,0,,35670,35670
22,05/26/2018,89,22:00,22:15,187.12,,0,187.12,187.12,1,-118675,42316,160991,-76359,0,0,37945,0,0,,37945,37945
22,05/26/2018,90,22:15,22:30,108.22,,0,108.22,108.22,1,-104644,42152,146796,-62492,0,0,69537,0,0,,69537,69537
22,05/26/2018,91,22:30,22:45,55.44,40.39,0,40.39,40.39,-1,-61788,58752,120540,-3036,0,-169,28232,0,0,,28401,28063
22,05/26/2018,92,22:45,23:00,55.44,39.64,0,39.64,39.64,-1,-55785,74134,129919,18349,0,-1252,8,0,0,,1260,-1244
22,05/26/2018,93,23:00,23:15,51.64,41.88,0,51.64,41.88,2,-79529,60287,139816,-19242,0,-133,4173,0,0,,4306,4040
22,05/26/2018,94,23:15,23:30,51.64,40.46,0,40.46,40.46,-1,-49041,57282,106323,8241,0,-19,720,0,0,,739,701
22,05/26/2018,95,23:30,23:45,,16.33,0,16.33,16.33,-1,-33887,73974,107861,40087,0,-6317,0,0,0,,6317,-6317
22,05/26/2018,96,23:45,0:00,,18.78,0,18.78,18.78,-1,-67418,83255,150673,15837,0,-20119,0,0,0,,20119,-20119
22,05/27/2018,1,0:00,0:15,99.02,18.78,0,99.02,99.02,1,-101034,58478,159512,-42556,0,-5088,10857,0,0,,15945,5769
22,05/27/2018,2,0:15,0:30,185.02,,0,185.02,185.02,1,-87125,59616,146741,-27509,0,0,41632,0,0,,41632,41632
22,05/27/2018,3,0:30,0:45,185.02,41.19,0,41.19,41.19,-1,-81645,85743,167388,4098,0,-695,3749,0,0,,4444,3054
22,05/27/2018,4,0:45,1:00,,41.19,0,41.19,41.19,-1,-93898,87504,181402,-6394,0,-2378,0,0,0,,2378,-2378
22,05/27/2018,5,1:00,1:15,42.98,40.67,0,42.98,40.67,2,-69651,70151,139802,500,0,-1207,376,0,0,,1583,-831
22,05/27/2018,6,1:15,1:30,42.98,,0,42.98,42.98,1,-62399,72746,135145,10347,0,0,660,0,0,,660,660
22,05/27/2018,7,1:30,1:45,,,0,41.92,41.92,0,-56402,66881,123283,10479,0,0,0,0,0,,0,0
22,05/27/2018,8,1:45,2:00,,38.98,0,38.98,38.98,-1,-50266,57508,107774,7242,0,-35,0,0,0,,35,-35
22,05/27/2018,9,2:00,2:15,44.36,38.98,0,44.36,44.36,1,-66096,76812,142908,10716,0,-132,326,0,0,,458,194
22,05/27/2018,10,2:15,2:30,44.02,,0,44.02,44.02,1,-67709,63961,131670,-3748,0,0,786,0,0,,786,786
22,05/27/2018,11,2:30,2:45,,38.03,0,38.03,38.03,-1,-55438,65758,121196,10320,0,-1245,0,0,0,,1245,-1245
22,05/27/2018,12,2:45,3:00,,34.98,0,34.98,34.98,-1,-57893,62724,120617,4831,0,-7694,0,0,0,,7694,-7694
22,05/27/2018,13,3:00,3:15,42.98,34.98,0,42.98,42.98,1,-70073,75914,145987,5841,0,-855,218,0,0,,1073,-637
22,05/27/2018,14,3:15,3:30,43.15,,0,43.15,43.15,1,-47366,59579,106945,12213,0,0,795,0,0,,795,795
22,05/27/2018,15,3:30,3:45,,,0,35.56,35.56,0,-57086,60504,117590,3418,0,0,0,0,0,,0,0
22,05/27/2018,16,3:45,4:00,,38.98,0,38.98,38.98,-1,-52972,60168,113140,7196,0,-1138,0,0,0,,1138,-1138
22,05/27/2018,17,4:00,4:15,,38.53,0,38.53,38.53,-1,-42382,75962,118344,33580,0,-1678,0,0,0,,1678,-1678
22,05/27/2018,18,4:15,4:30,,40.58,0,40.58,40.58,-1,-52696,65044,117740,12348,0,-385,0,0,0,,385,-385
22,05/27/2018,19,4:30,4:45,,,0,41.71,41.71,0,-43459,62787,106246,19328,0,0,0,0,0,,0,0
22,05/27/2018,20,4:45,5:00,,,0,41.71,41.71,0,-42086,66796,108882,24710,0,0,0,0,0,,0,0
22,05/27/2018,21,5:00,5:15,,40.6,0,40.6,40.6,-1,-59619,85637,145256,26018,0,-558,0,0,0,,558,-558
22,05/27/2018,22,5:15,5:30,,40.6,0,40.6,40.6,-1,-41197,93971,135168,52774,0,-663,0,0,0,,663,-663
22,05/27/2018,23,5:30,5:45,,38.98,0,38.98,38.98,-1,-37308,103315,140623,66007,0,-800,0,0,0,,800,-800
22,05/27/2018,24,5:45,6:00,,38.98,0,38.98,38.98,-1,-19136,106269,125405,87133,0,-2850,0,0,0,,2850,-2850
22,05/27/2018,25,6:00,6:15,,7.78,0,7.78,7.78,-1,-30845,113335,144180,82490,0,-21171,0,0,0,,21171,-21171
22,05/27/2018,26,6:15,6:30,,8.03,0,8.03,8.03,-1,-36755,101793,138548,65038,0,-46808,0,0,0,,46808,-46808
22,05/27/2018,27,6:30,6:45,,35.69,0,35.69,35.69,-1,-37814,94838,132652,57024,0,-18737,0,0,0,,18737,-18737
22,05/27/2018,28,6:45,7:00,,38.74,0,38.74,38.74,-1,-47242,94605,141847,47363,0,-1822,0,0,0,,1822,-1822
22,05/27/2018,29,7:00,7:15,,40.44,0,40.44,40.44,-1,-48370,79631,128001,31261,0,-1541,0,0,0,,1541,-1541
22,05/27/2018,30,7:15,7:30,,40.17,0,40.17,40.17,-1,-57300,82244,139544,24944,0,-1676,0,0,0,,1676,-1676
22,05/27/2018,31,7:30,7:45,,,0,35.73,35.73,0,-65380,79934,145314,14554,0,0,0,0,0,,0,0
22,05/27/2018,32,7:45,8:00,50.9,,0,50.9,50.9,1,-80730,76860,157590,-3870,0,0,1812,0,0,,1812,1812
22,05/27/2018,33,8:00,8:15,52,,0,52,52,1,-73369,65259,138628,-8110,0,0,19454,0,0,,19454,19454
22,05/27/2018,34,8:15,8:30,,,0,36.21,36.21,0,-67138,67316,134454,178,0,0,2870,0,0,,2870,2870
22,05/27/2018,35,8:30,8:45,43.44,,0,43.44,43.44,1,-78047,71847,149894,-6200,0,0,1499,0,0,,1499,1499
22,05/27/2018,36,8:45,9:00,46.9,,0,46.9,46.9,1,-87379,82942,170321,-4437,0,0,3859,0,0,,3859,3859
22,05/27/2018,37,9:00,9:15,,,0,42.69,42.69,0,-66966,87354,154320,20388,0,0,18,0,0,,18,18
22,05/27/2018,38,9:15,9:30,,,0,42.63,42.63,0,-48460,91688,140148,43228,0,0,0,0,0,,0,0
22,05/27/2018,39,9:30,9:45,,,0,42.61,42.61,0,-53658,91745,145403,38087,0,0,0,0,0,,0,0
22,05/27/2018,40,9:45,10:00,,,0,42.57,42.57,0,-63830,97834,161664,34004,0,0,0,0,0,,0,0
22,05/27/2018,41,10:00,10:15,,,0,36.07,36.07,0,-74087,96721,170808,22634,0,0,0,0,0,,0,0
22,05/27/2018,42,10:15,10:30,,,0,36.03,36.03,0,-61275,93786,155061,32511,0,0,0,0,0,,0,0
22,05/27/2018,43,10:30,10:45,,,0,36.05,36.05,0,-50486,84072,134558,33586,0,0,0,0,0,,0,0
22,05/27/2018,44,10:45,11:00,,,0,36.02,36.02,0,-53467,94705,148172,41238,0,0,0,0,0,,0,0
22,05/27/2018,45,11:00,11:15,,,0,36.27,36.27,0,-53635,78561,132196,24926,0,0,0,0,0,,0,0
22,05/27/2018,46,11:15,11:30,,,0,36.27,36.27,0,-62555,78147,140702,15592,0,0,0,0,0,,0,0
22,05/27/2018,47,11:30,11:45,47.43,,0,47.43,47.43,1,-70349,61087,131436,-9262,0,0,1174,0,0,,1174,1174
22,05/27/2018,48,11:45,12:00,47.59,,0,47.59,47.59,1,-81324,67603,148927,-13721,0,0,3800,0,0,,3800,3800
22,05/27/2018,49,12:00,12:15,163.02,,0,163.02,163.02,1,-104680,53894,158574,-50786,0,0,15403,0,0,,15403,15403
22,05/27/2018,50,12:15,12:30,196.02,,0,196.02,196.02,1,-107292,68536,175828,-38756,0,0,41051,0,0,,41051,41051
22,05/27/2018,51,12:30,12:45,46.9,,0,46.9,46.9,1,-101422,76617,178039,-24805,0,0,19173,0,0,,19173,19173
22,05/27/2018,52,12:45,13:00,77.02,,0,77.02,77.02,1,-112619,60464,173083,-52155,0,0,29262,0,0,,29262,29262
22,05/27/2018,53,13:00,13:15,50.02,,0,50.02,50.02,1,-121711,78697,200408,-43014,0,0,43393,0,0,,43393,43393
22,05/27/2018,54,13:15,13:30,97.3,,0,97.3,97.3,1,-135295,71459,206754,-63836,0,0,47461,0,0,,47461,47461
22,05/27/2018,55,13:30,13:45,99.02,,0,99.02,99.02,1,-141471,86018,227489,-55453,0,0,56309,0,0,,56309,56309
22,05/27/2018,56,13:45,14:00,65.9,,0,65.9,65.9,1,-160008,95878,255886,-64130,0,0,48217,0,0,,48217,48217
22,05/27/2018,57,14:00,14:15,64.9,,0,64.9,64.9,1,-162967,111758,274725,-51209,0,0,53293,0,0,,53293,53293
22,05/27/2018,58,14:15,14:30,64.9,,0,64.9,64.9,1,-171616,116800,288416,-54816,0,0,45128,0,0,,45128,45128
22,05/27/2018,59,14:30,14:45,82.02,,0,82.02,82.02,1,-175364,118394,293758,-56970,0,0,52782,0,0,,52782,52782
22,05/27/2018,60,14:45,15:00,51.18,,0,51.18,51.18,1,-192253,113776,306029,-78477,0,0,33471,0,0,,33471,33471
22,05/27/2018,61,15:00,15:15,47.9,,0,47.9,47.9,1,-192769,135124,327893,-57645,0,0,28476,0,0,,28476,28476
22,05/27/2018,62,15:15,15:30,49.07,,0,49.07,49.07,1,-189262,125667,314929,-63595,0,0,32917,0,0,,32917,32917
22,05/27/2018,63,15:30,15:45,144.02,,0,144.02,144.02,1,-207943,117643,325586,-90300,0,0,44480,0,0,,44480,44480
22,05/27/2018,64,15:45,16:00,60.02,,0,60.02,60.02,1,-223937,140626,364563,-83311,0,0,54451,0,0,,54451,54451
22,05/27/2018,65,16:00,16:15,53.94,,0,53.94,53.94,1,-153297,98443,251740,-54854,0,0,39288,0,0,,39288,39288
22,05/27/2018,66,16:15,16:30,144.02,,0,144.02,144.02,1,-168145,107609,275754,-60536,0,0,26743,0,0,,26743,26743
22,05/27/2018,67,16:30,16:45,58.02,,0,58.02,58.02,1,-158549,135899,294448,-22650,0,0,34802,0,0,,34802,34802
22,05/27/2018,68,16:45,17:00,49.9,,0,49.9,49.9,1,-169881,136519,306400,-33362,0,0,14441,0,0,,14441,14441
22,05/27/2018,69,17:00,17:15,82.02,,0,82.02,82.02,1,-140541,102663,243204,-37878,0,0,23039,0,0,,23039,23039
22,05/27/2018,70,17:15,17:30,49.9,,0,49.9,49.9,1,-168943,123940,292883,-45003,0,0,40101,0,0,,40101,40101
22,05/27/2018,71,17:30,17:45,49.9,,0,49.9,49.9,1,-168958,134974,303932,-33984,0,0,36615,0,0,,36615,36615
22,05/27/2018,72,17:45,18:00,47.7,38.31,0,38.31,38.31,-1,-138671,149695,288366,11024,0,-516,14616,0,0,,15132,14100
22,05/27/2018,73,18:00,18:15,46.9,38.31,0,46.9,46.9,1,-120676,114231,234907,-6445,0,-208,491,0,0,,699,283
22,05/27/2018,74,18:15,18:30,,,0,42.75,42.75,0,-76149,113635,189784,37486,0,0,0,0,0,,0,0
22,05/27/2018,75,18:30,18:45,,,0,42.75,42.75,0,-46105,109816,155921,63711,0,0,0,0,0,,0,0
22,05/27/2018,76,18:45,19:00,,,0,42.66,42.66,0,-49101,112413,161514,63312,0,0,0,0,0,,0,0
22,05/27/2018,77,19:00,19:15,,37.03,0,37.03,37.03,-1,-94627,133626,228253,38999,0,-6955,0,0,0,,6955,-6955
22,05/27/2018,78,19:15,19:30,46.9,42.09,0,46.9,42.09,2,-122939,109866,232805,-13073,0,-2206,1660,0,0,,3866,-546
22,05/27/2018,79,19:30,19:45,46.9,,0,46.9,46.9,1,-123931,107699,231630,-16232,0,0,5913,0,0,,5913,5913
22,05/27/2018,80,19:45,20:00,99.02,,0,99.02,99.02,1,-144747,102759,247506,-41988,0,0,22935,0,0,,22935,22935
22,05/27/2018,81,20:00,20:15,197.02,,0,197.02,197.02,1,-168022,61990,230012,-106032,0,0,54619,0,0,,54619,54619
22,05/27/2018,82,20:15,20:30,50.67,,0,50.67,50.67,1,-151802,65098,216900,-86704,0,0,26502,0,0,,26502,26502
22,05/27/2018,83,20:30,20:45,197.02,,0,197.02,197.02,1,-149647,90548,240195,-59099,0,0,48785,0,0,,48785,48785
22,05/27/2018,84,20:45,21:00,197.02,,0,197.02,197.02,1,-132510,88825,221335,-43685,0,0,86400,0,0,,86400,86400
22,05/27/2018,85,21:00,21:15,88.02,,0,88.02,88.02,1,-87931,156777,244708,68846,0,0,56574,0,0,,56574,56574
22,05/27/2018,86,21:15,21:30,113.02,,0,113.02,113.02,1,-75324,128135,203459,52811,0,0,31694,0,0,,31694,31694
22,05/27/2018,87,21:30,21:45,116.09,,0,116.09,116.09,1,-68496,118078,186574,49582,0,0,51861,0,0,,51861,51861
22,05/27/2018,88,21:45,22:00,59.64,,0,59.64,59.64,1,-69889,127735,197624,57846,0,0,42975,0,0,,42975,42975
22,05/27/2018,89,22:00,22:15,197.02,,0,197.02,197.02,1,-113799,129479,243278,15680,0,0,59464,0,0,,59464,59464
22,05/27/2018,90,22:15,22:30,134.24,,0,134.24,134.24,1,-70530,142745,213275,72215,0,0,57939,0,0,,57939,57939
22,05/27/2018,91,22:30,22:45,43.56,,0,43.56,43.56,1,-51213,163824,215037,112611,0,0,3787,0,0,,3787,3787
22,05/27/2018,92,22:45,23:00,43.49,,0,43.49,43.49,1,-36504,171550,208054,135046,0,0,127,0,0,,127,127
22,05/27/2018,93,23:00,23:15,106.02,,0,106.02,106.02,1,-93276,62940,156216,-30336,0,0,13762,0,0,,13762,13762
22,05/27/2018,94,23:15,23:30,47.09,40.54,0,47.09,40.54,2,-69081,88863,157944,19782,0,-305,4252,0,0,,4557,3947
22,05/27/2018,95,23:30,23:45,,34.9,0,34.9,34.9,-1,-41786,98031,139817,56245,0,-2807,0,0,0,,2807,-2807
22,05/27/2018,96,23:45,0:00,,34.9,0,34.9,34.9,-1,-31862,114131,145993,82269,0,-5269,0,0,0,,5269,-5269
22,05/28/2018,1,0:00,0:15,42.01,42.78,0,42.01,42.01,1,-74099,78137,152236,4038,0,-569,1114,0,0,,1683,545
22,05/28/2018,2,0:15,0:30,42.01,,0,42.01,42.01,1,-50277,64908,115185,14631,0,0,813,0,0,,813,813
22,05/28/2018,3,0:30,0:45,42.01,,0,42.01,42.01,1,-40397,62761,103158,22364,0,0,8,0,0,,8,8
22,05/28/2018,4,0:45,1:00,,42.78,0,42.78,42.78,-1,-65806,79356,145162,13550,0,-18,0,0,0,,18,-18
22,05/28/2018,5,1:00,1:15,51.85,41.02,0,51.85,41.02,2,-68904,49591,118495,-19313,0,-90,4346,0,0,,4436,4256
22,05/28/2018,6,1:15,1:30,56.79,,0,56.79,56.79,1,-72874,46648,119522,-26226,0,0,24238,0,0,,24238,24238
22,05/28/2018,7,1:30,1:45,46.5,,0,46.5,46.5,1,-79583,51140,130723,-28443,0,0,14254,0,0,,14254,14254
22,05/28/2018,8,1:45,2:00,45.84,,0,45.84,45.84,1,-87129,52992,140121,-34137,0,0,12760,0,0,,12760,12760
22,05/28/2018,9,2:00,2:15,153.12,,0,153.12,153.12,1,-112343,34462,146805,-77881,0,0,39720,0,0,,39720,39720
22,05/28/2018,10,2:15,2:30,57.24,,0,57.24,57.24,1,-86402,37615,124017,-48787,0,0,50397,0,0,,50397,50397
22,05/28/2018,11,2:30,2:45,48.73,,0,48.73,48.73,1,-81856,41886,123742,-39970,0,0,33324,0,0,,33324,33324
22,05/28/2018,12,2:45,3:00,50.25,,0,50.25,50.25,1,-88699,38831,127530,-49868,0,0,30068,0,0,,30068,30068
22,05/28/2018,13,3:00,3:15,57.12,,0,57.12,57.12,1,-90300,45007,135307,-45293,0,0,40878,0,0,,40878,40878
22,05/28/2018,14,3:15,3:30,50.25,,0,50.25,50.25,1,-98723,53454,152177,-45269,0,0,32299,0,0,,32299,32299
22,05/28/2018,15,3:30,3:45,50.25,,0,50.25,50.25,1,-95102,55416,150518,-39686,0,0,38478,0,0,,38478,38478
22,05/28/2018,16,3:45,4:00,46.01,,0,46.01,46.01,1,-88522,55679,144201,-32843,0,0,28069,0,0,,28069,28069
22,05/28/2018,17,4:00,4:15,46.01,,0,46.01,46.01,1,-77091,57144,134235,-19947,0,0,20335,0,0,,20335,20335
22,05/28/2018,18,4:15,4:30,42.01,,0,42.01,42.01,1,-72125,54585,126710,-17540,0,0,2022,0,0,,2022,2022
22,05/28/2018,19,4:30,4:45,42.01,,0,42.01,42.01,1,-73731,47038,120769,-26693,0,0,2167,0,0,,2167,2167
22,05/28/2018,20,4:45,5:00,50.08,,0,50.08,50.08,1,-68231,40760,108991,-27471,0,0,13005,0,0,,13005,13005
22,05/28/2018,21,5:00,5:15,42.01,40.79,0,40.79,40.79,-1,-50476,69757,120233,19281,0,-373,5025,0,0,,5398,4652
22,05/28/2018,22,5:15,5:30,,40.46,0,40.46,40.46,-1,-47438,75807,123245,28369,0,-1128,0,0,0,,1128,-1128
22,05/28/2018,23,5:30,5:45,,37.78,0,37.78,37.78,-1,-50349,90720,141069,40371,0,-3491,0,0,0,,3491,-3491
22,05/28/2018,24,5:45,6:00,,29.86,0,29.86,29.86,-1,-43690,93979,137669,50289,0,-20246,0,0,0,,20246,-20246
22,05/28/2018,25,6:00,6:15,41.69,39.29,0,41.69,41.69,1,-126157,91715,217872,-34442,0,-9234,231,0,0,,9465,-9003
22,05/28/2018,26,6:15,6:30,41.69,39.29,0,41.69,41.69,1,-83974,68625,152599,-15349,0,-6,398,0,0,,404,392
22,05/28/2018,27,6:30,6:45,45.69,,0,45.69,45.69,1,-83658,37939,121597,-45719,0,0,2891,0,0,,2891,2891
22,05/28/2018,28,6:45,7:00,51.71,,0,51.71,51.71,1,-117837,44870,162707,-72967,0,0,12011,0,0,,12011,12011
22,05/28/2018,29,7:00,7:15,51.71,15.76,0,15.76,15.76,-1,-64735,154482,219217,89747,0,-16283,4658,0,0,,20941,-11625
22,05/28/2018,30,7:15,7:30,64.9,38.78,0,64.9,64.9,1,-58413,96843,155256,38430,0,-4486,3518,0,0,,8004,-968
22,05/28/2018,31,7:30,7:45,84.9,,0,84.9,84.9,1,-88160,83800,171960,-4360,0,0,44572,0,0,,44572,44572
22,05/28/2018,32,7:45,8:00,82.72,,0,82.72,82.72,1,-85696,95868,181564,10172,0,0,57166,0,0,,57166,57166
22,05/28/2018,33,8:00,8:15,46.76,40.51,0,40.51,40.51,-1,-104320,123037,227357,18717,0,-380,21617,0,0,,21997,21237
22,05/28/2018,34,8:15,8:30,42.86,40.51,0,42.86,42.86,1,-84559,91595,176154,7036,0,-55,345,0,0,,400,290
22,05/28/2018,35,8:30,8:45,54.65,,0,54.65,54.65,1,-103192,83571,186763,-19621,0,0,7757,0,0,,7757,7757
22,05/28/2018,36,8:45,9:00,58.12,,0,58.12,58.12,1,-123986,86222,210208,-37764,0,0,35373,0,0,,35373,35373
22,05/28/2018,37,9:00,9:15,179.31,,0,179.31,179.31,1,-152617,62619,215236,-89998,0,0,69127,0,0,,69127,69127
22,05/28/2018,38,9:15,9:30,77.56,,0,77.56,77.56,1,-137824,78584,216408,-59240,0,0,73799,0,0,,73799,73799
22,05/28/2018,39,9:30,9:45,48.12,,0,48.12,48.12,1,-109412,85395,194807,-24017,0,0,28094,0,0,,28094,28094
22,05/28/2018,40,9:45,10:00,57.56,,0,57.56,57.56,1,-124899,76662,201561,-48237,0,0,15482,0,0,,15482,15482
22,05/28/2018,41,10:00,10:15,48.12,,0,48.12,48.12,1,-86925,79980,166905,-6945,0,0,27529,0,0,,27529,27529
22,05/28/2018,42,10:15,10:30,48.55,,0,48.55,48.55,1,-93650,70985,164635,-22665,0,0,17346,0,0,,17346,17346
22,05/28/2018,43,10:30,10:45,54.89,,0,54.89,54.89,1,-95724,65668,161392,-30056,0,0,28998,0,0,,28998,28998
22,05/28/2018,44,10:45,11:00,55.47,,0,55.47,55.47,1,-106859,69449,176308,-37410,0,0,42011,0,0,,42011,42011
22,05/28/2018,45,11:00,11:15,84.12,,0,84.12,84.12,1,-83418,72060,155478,-11358,0,0,42214,0,0,,42214,42214
22,05/28/2018,46,11:15,11:30,85.77,,0,85.77,85.77,1,-74518,81001,155519,6483,0,0,50615,0,0,,50615,50615
22,05/28/2018,47,11:30,11:45,50.77,,0,50.77,50.77,1,-61487,74785,136272,13298,0,0,27350,0,0,,27350,27350
22,05/28/2018,48,11:45,12:00,56.36,,0,56.36,56.36,1,-68554,77180,145734,8626,0,0,35249,0,0,,35249,35249
22,05/28/2018,49,12:00,12:15,49.26,,0,49.26,49.26,1,-78426,104227,182653,25801,0,0,28555,0,0,,28555,28555
22,05/28/2018,50,12:15,12:30,45.12,,0,45.12,45.12,1,-70099,103811,173910,33712,0,0,20628,0,0,,20628,20628
22,05/28/2018,51,12:30,12:45,45.12,44.4,0,44.4,44.4,-1,-50879,112070,162949,61191,0,-560,1923,0,0,,2483,1363
22,05/28/2018,52,12:45,13:00,52.88,,0,52.88,52.88,1,-67548,95635,163183,28087,0,0,5981,0,0,,5981,5981
22,05/28/2018,53,13:00,13:15,68.56,,0,68.56,68.56,1,-101884,94667,196551,-7217,0,0,26787,0,0,,26787,26787
22,05/28/2018,54,13:15,13:30,68.56,,0,68.56,68.56,1,-124647,91355,216002,-33292,0,0,43327,0,0,,43327,43327
22,05/28/2018,55,13:30,13:45,78.12,,0,78.12,78.12,1,-137015,90426,227441,-46589,0,0,56155,0,0,,56155,56155
22,05/28/2018,56,13:45,14:00,73.56,,0,73.56,73.56,1,-140426,92331,232757,-48095,0,0,75519,0,0,,75519,75519
22,05/28/2018,57,14:00,14:15,56.31,,0,56.31,56.31,1,-102423,107927,210350,5504,0,0,45768,0,0,,45768,45768
22,05/28/2018,58,14:15,14:30,74,,0,74,74,1,-121218,100102,221320,-21116,0,0,41185,0,0,,41185,41185
22,05/28/2018,59,14:30,14:45,57.12,,0,57.12,57.12,1,-124624,101003,225627,-23621,0,0,57875,0,0,,57875,57875
22,05/28/2018,60,14:45,15:00,51.41,,0,51.41,51.41,1,-128734,102170,230904,-26564,0,0,47725,0,0,,47725,47725
22,05/28/2018,61,15:00,15:15,51.22,,0,51.22,51.22,1,-88092,78324,166416,-9768,0,0,38760,0,0,,38760,38760
22,05/28/2018,62,15:15,15:30,67.81,,0,67.81,67.81,1,-96959,74630,171589,-22329,0,0,50953,0,0,,50953,50953
22,05/28/2018,63,15:30,15:45,67.81,,0,67.81,67.81,1,-105447,78422,183869,-27025,0,0,61773,0,0,,61773,61773
22,05/28/2018,64,15:45,16:00,67.81,,0,67.81,67.81,1,-109822,76998,186820,-32824,0,0,64851,0,0,,64851,64851
22,05/28/2018,65,16:00,16:15,83.12,,0,83.12,83.12,1,-103256,78845,182101,-24411,0,0,63528,0,0,,63528,63528
22,05/28/2018,66,16:15,16:30,88.12,,0,88.12,88.12,1,-103470,92053,195523,-11417,0,0,69288,0,0,,69288,69288
22,05/28/2018,67,16:30,16:45,54.12,,0,54.12,54.12,1,-99155,95249,194404,-3906,0,0,53413,0,0,,53413,53413
22,05/28/2018,68,16:45,17:00,68.39,,0,68.39,68.39,1,-113600,92409,206009,-21191,0,0,59957,0,0,,59957,59957
22,05/28/2018,69,17:00,17:15,53.4,,0,53.4,53.4,1,-75587,110754,186341,35167,0,0,35640,0,0,,35640,35640
22,05/28/2018,70,17:15,17:30,49.27,,0,49.27,49.27,1,-82547,103856,186403,21309,0,0,2413,0,0,,2413,2413
22,05/28/2018,71,17:30,17:45,54.9,,0,54.9,54.9,1,-75407,108109,183516,32702,0,0,18489,0,0,,18489,18489
22,05/28/2018,72,17:45,18:00,45.69,,0,45.69,45.69,1,-68667,108721,177388,40054,0,0,14415,0,0,,14415,14415
22,05/28/2018,73,18:00,18:15,84.12,,0,84.12,84.12,1,-114222,123592,237814,9370,0,0,39538,0,0,,39538,39538
22,05/28/2018,74,18:15,18:30,47.66,,0,47.66,47.66,1,-90346,131815,222161,41469,0,0,35239,0,0,,35239,35239
22,05/28/2018,75,18:30,18:45,45.77,,0,45.77,45.77,1,-81746,139096,220842,57350,0,0,22362,0,0,,22362,22362
22,05/28/2018,76,18:45,19:00,45.77,,0,45.77,45.77,1,-91634,151684,243318,60050,0,0,8411,0,0,,8411,8411
22,05/28/2018,77,19:00,19:15,185.98,,0,185.98,185.98,1,-151391,85882,237273,-65509,0,0,51326,0,0,,51326,51326
22,05/28/2018,78,19:15,19:30,80.63,,0,80.63,80.63,1,-102217,91118,193335,-11099,0,0,66014,0,0,,66014,66014
22,05/28/2018,79,19:30,19:45,47.34,,0,47.34,47.34,1,-88652,96352,185004,7700,0,0,20506,0,0,,20506,20506
22,05/28/2018,80,19:45,20:00,80.63,,0,80.63,80.63,1,-126584,100945,227529,-25639,0,0,34858,0,0,,34858,34858
22,05/28/2018,81,20:00,20:15,83.12,,0,83.12,83.12,1,-126734,83530,210264,-43204,0,0,49488,0,0,,49488,49488
22,05/28/2018,82,20:15,20:30,104.12,,0,104.12,104.12,1,-129118,74301,203419,-54817,0,0,69551,0,0,,69551,69551
22,05/28/2018,83,20:30,20:45,67.12,,0,67.12,67.12,1,-89826,77719,167545,-12107,0,0,51657,0,0,,51657,51657
22,05/28/2018,84,20:45,21:00,45.69,,0,45.69,45.69,1,-81156,79391,160547,-1765,0,0,7860,0,0,,7860,7860
22,05/28/2018,85,21:00,21:15,42.96,,0,42.96,42.96,1,-84698,127369,212067,42671,0,0,3460,0,0,,3460,3460
22,05/28/2018,86,21:15,21:30,,,0,27.57,27.57,0,-99782,142793,242575,43011,0,0,0,0,0,,0,0
22,05/28/2018,87,21:30,21:45,,38.57,0,38.57,38.57,-1,-97154,161332,258486,64178,0,-3026,0,0,0,,3026,-3026
22,05/28/2018,88,21:45,22:00,,15.76,0,15.76,15.76,-1,-77167,169856,247023,92689,0,-46916,0,0,0,,46916,-46916
22,05/28/2018,89,22:00,22:15,43.07,38.57,0,43.07,43.07,1,-78403,143401,221804,64998,0,-20119,255,0,0,,20374,-19864
22,05/28/2018,90,22:15,22:30,,38.57,0,38.57,38.57,-1,-77825,165548,243373,87723,0,-8457,0,0,0,,8457,-8457
22,05/28/2018,91,22:30,22:45,,36.46,0,36.46,36.46,-1,-66914,190072,256986,123158,0,-27311,0,0,0,,27311,-27311
22,05/28/2018,92,22:45,23:00,,-34.24,0,-34.24,-34.24,-1,-49701,207134,256835,157433,0,-60347,0,0,0,,60347,-60347
22,05/28/2018,93,23:00,23:15,,26.55,0,26.55,26.55,-1,-47685,196379,244064,148694,0,-38200,0,0,0,,38200,-38200
22,05/28/2018,94,23:15,23:30,,-34.24,0,-34.24,-34.24,-1,-43776,223128,266904,179352,0,-12112,0,0,0,,12112,-12112
22,05/28/2018,95,23:30,23:45,,-34.24,0,-34.24,-34.24,-1,-72680,220481,293161,147801,0,-40520,0,0,0,,40520,-40520
22,05/28/2018,96,23:45,0:00,,-34.24,0,-34.24,-34.24,-1,-42996,254518,297514,211522,0,-66519,0,0,0,,66519,-66519
22,05/29/2018,1,0:00,0:15,117.81,15.46,0,117.81,117.81,1,-117961,69340,187301,-48621,0,-28274,5033,0,0,,33307,-23241
22,05/29/2018,2,0:15,0:30,135.02,,0,135.02,135.02,1,-84927,49218,134145,-35709,0,0,24668,0,0,,24668,24668
22,05/29/2018,3,0:30,0:45,41.69,,0,41.69,41.69,1,-105027,65005,170032,-40022,0,0,3534,0,0,,3534,3534
22,05/29/2018,4,0:45,1:00,41.69,,0,41.69,41.69,1,-90086,68775,158861,-21311,0,0,50,0,0,,50,50
22,05/29/2018,5,1:00,1:15,67.81,,0,67.81,67.81,1,-86742,44215,130957,-42527,0,0,15448,0,0,,15448,15448
22,05/29/2018,6,1:15,1:30,50.38,,0,50.38,50.38,1,-61399,56659,118058,-4740,0,0,22873,0,0,,22873,22873
22,05/29/2018,7,1:30,1:45,50.38,40.48,0,40.48,40.48,-1,-37601,58877,96478,21276,0,-1163,856,0,0,,2019,-307
22,05/29/2018,8,1:45,2:00,,40.74,0,40.74,40.74,-1,-50217,50315,100532,98,0,-285,0,0,0,,285,-285
22,05/29/2018,9,2:00,2:15,41.69,40.35,0,41.69,40.35,2,-52903,61083,113986,8180,0,-36,126,0,0,,162,90
22,05/29/2018,10,2:15,2:30,42.42,,0,42.42,42.42,1,-51072,60350,111422,9278,0,0,772,0,0,,772,772
22,05/29/2018,11,2:30,2:45,43.92,,0,43.92,43.92,1,-60595,48752,109347,-11843,0,0,1220,0,0,,1220,1220
22,05/29/2018,12,2:45,3:00,41.69,34.14,0,41.69,34.14,2,-55619,68350,123969,12731,0,-598,740,0,0,,1338,142
22,05/29/2018,13,3:00,3:15,45.35,33.69,0,45.35,45.35,1,-66123,48887,115010,-17236,0,-1144,1611,0,0,,2755,467
22,05/29/2018,14,3:15,3:30,45.69,,0,45.69,45.69,1,-60529,47449,107978,-13080,0,0,7613,0,0,,7613,7613
22,05/29/2018,15,3:30,3:45,43.49,,0,43.49,43.49,1,-57004,47002,104006,-10002,0,0,5657,0,0,,5657,5657
22,05/29/2018,16,3:45,4:00,45.26,,0,45.26,45.26,1,-63955,41412,105367,-22543,0,0,7708,0,0,,7708,7708
22,05/29/2018,17,4:00,4:15,41.69,,0,41.69,41.69,1,-70633,60605,131238,-10028,0,0,1477,0,0,,1477,1477
22,05/29/2018,18,4:15,4:30,,40.35,0,40.35,40.35,-1,-69645,60077,129722,-9568,0,-135,0,0,0,,135,-135
22,05/29/2018,19,4:30,4:45,41.69,40.31,0,41.69,40.31,2,-60559,55997,116556,-4562,0,-49,3,0,0,,52,-46
22,05/29/2018,20,4:45,5:00,42.39,,0,42.39,42.39,1,-71574,49121,120695,-22453,0,0,4012,0,0,,4012,4012
22,05/29/2018,21,5:00,5:15,42.39,37.69,0,37.69,37.69,-1,-60279,63933,124212,3654,0,-1871,1006,0,0,,2877,-865
22,05/29/2018,22,5:15,5:30,,35.29,0,35.29,35.29,-1,-56255,55896,112151,-359,0,-9505,0,0,0,,9505,-9505
22,05/29/2018,23,5:30,5:45,41.69,35.29,0,41.69,41.69,1,-60091,49072,109163,-11019,0,-279,121,0,0,,400,-158
22,05/29/2018,24,5:45,6:00,41.69,,0,41.69,41.69,1,-97336,53994,151330,-43342,0,0,1802,0,0,,1802,1802
22,05/29/2018,25,6:00,6:15,42.07,16.15,0,42.07,16.15,2,-40246,82607,122853,42361,0,-10264,495,0,0,,10759,-9769
22,05/29/2018,26,6:15,6:30,,34.07,0,34.07,34.07,-1,-50100,76229,126329,26129,0,-29274,0,0,0,,29274,-29274
22,05/29/2018,27,6:30,6:45,,38.99,0,38.99,38.99,-1,-82112,81468,163580,-644,0,-10743,0,0,0,,10743,-10743
22,05/29/2018,28,6:45,7:00,42.62,38.99,0,42.62,42.62,1,-110575,70085,180660,-40490,0,-87,1809,0,0,,1896,1722
22,05/29/2018,29,7:00,7:15,42.62,10.16,0,10.16,10.16,-1,-58039,126743,184782,68704,0,-18754,213,0,0,,18967,-18541
22,05/29/2018,30,7:15,7:30,,38.07,0,38.07,38.07,-1,-45393,62300,107693,16907,0,-11281,0,0,0,,11281,-11281
22,05/29/2018,31,7:30,7:45,68.22,38.07,0,68.22,68.22,1,-84385,35796,120181,-48589,0,-1,7110,0,0,,7111,7109
22,05/29/2018,32,7:45,8:00,137.02,,0,137.02,137.02,1,-116024,42428,158452,-73596,0,0,55026,0,0,,55026,55026
22,05/29/2018,33,8:00,8:15,42.07,40.34,0,43.35,40.34,2,-51529,70372,121901,18843,0,-428,11423,0,0,,11851,10995
22,05/29/2018,34,8:15,8:30,,,0,43.35,43.35,0,-54447,61097,115544,6650,0,0,0,0,0,,0,0
22,05/29/2018,35,8:30,8:45,,,0,43.35,43.35,0,-75215,65011,140226,-10204,0,0,0,0,0,,0,0
22,05/29/2018,36,8:45,9:00,68.22,,0,68.22,68.22,1,-106754,44201,150955,-62553,0,0,7581,0,0,,7581,7581
22,05/29/2018,37,9:00,9:15,179.25,,0,179.25,179.25,1,-110270,51859,162129,-58411,0,0,66431,0,0,,66431,66431
22,05/29/2018,38,9:15,9:30,77.53,,0,77.53,77.53,1,-80336,74332,154668,-6004,0,0,51930,0,0,,51930,51930
22,05/29/2018,39,9:30,9:45,42.91,41.72,0,43.17,41.72,2,-64249,81286,145535,17037,0,-429,3906,0,0,,4335,3477
22,05/29/2018,40,9:45,10:00,79.02,,0,79.02,79.02,1,-76426,52652,129078,-23774,0,0,24008,0,0,,24008,24008
22,05/29/2018,41,10:00,10:15,43.5,41.72,0,41.72,41.72,-1,-77169,108895,186064,31726,0,-159,12193,0,0,,12352,12034
22,05/29/2018,42,10:15,10:30,,41.72,0,41.72,41.72,-1,-73943,85469,159412,11526,0,-687,0,0,0,,687,-687
22,05/29/2018,43,10:30,10:45,,,0,43.08,43.08,0,-65247,65225,130472,-22,0,0,0,0,0,,0,0
22,05/29/2018,44,10:45,11:00,43.03,,0,43.03,43.03,1,-79196,50264,129460,-28932,0,0,2490,0,0,,2490,2490
22,05/29/2018,45,11:00,11:15,171.51,,0,171.51,171.51,1,-96677,40698,137375,-55979,0,0,32689,0,0,,32689,32689
22,05/29/2018,46,11:15,11:30,73.97,,0,73.97,73.97,1,-77965,58310,136275,-19655,0,0,42950,0,0,,42950,42950
22,05/29/2018,47,11:30,11:45,46.07,,0,46.07,46.07,1,-71246,66565,137811,-4681,0,0,15207,0,0,,15207,15207
22,05/29/2018,48,11:45,12:00,54.53,,0,54.53,54.53,1,-77202,54789,131991,-22413,0,0,23102,0,0,,23102,23102
22,05/29/2018,49,12:00,12:15,109.93,,0,109.93,109.93,1,-141022,57628,198650,-83394,0,0,50594,0,0,,50594,50594
22,05/29/2018,50,12:15,12:30,84.02,,0,84.02,84.02,1,-136770,65660,202430,-71110,0,0,55180,0,0,,55180,55180
22,05/29/2018,51,12:30,12:45,68.22,,0,68.22,68.22,1,-138858,66548,205406,-72310,0,0,66813,0,0,,66813,66813
22,05/29/2018,52,12:45,13:00,68.22,,0,68.22,68.22,1,-135894,67092,202986,-68802,0,0,68823,0,0,,68823,68823
22,05/29/2018,53,13:00,13:15,68.22,,0,68.22,68.22,1,-92875,39513,132388,-53362,0,0,61495,0,0,,61495,61495
22,05/29/2018,54,13:15,13:30,155.02,,0,155.02,155.02,1,-119776,26784,146560,-92992,0,0,82886,0,0,,82886,82886
22,05/29/2018,55,13:30,13:45,155.02,,0,155.02,155.02,1,-118768,37589,156357,-81179,0,0,102301,0,0,,102301,102301
22,05/29/2018,56,13:45,14:00,68.22,,0,68.22,68.22,1,-108209,45780,153989,-62429,0,0,69612,0,0,,69612,69612
22,05/29/2018,57,14:00,14:15,59.55,,0,59.55,59.55,1,-104861,91891,196752,-12970,0,0,40450,0,0,,40450,40450
22,05/29/2018,58,14:15,14:30,70.02,,0,70.02,70.02,1,-118611,74534,193145,-44077,0,0,36068,0,0,,36068,36068
22,05/29/2018,59,14:30,14:45,154.02,,0,154.02,154.02,1,-143378,63955,207333,-79423,0,0,71160,0,0,,71160,71160
22,05/29/2018,60,14:45,15:00,98.26,,0,98.26,98.26,1,-145244,64537,209781,-80707,0,0,86626,0,0,,86626,86626
22,05/29/2018,61,15:00,15:15,154.02,,0,154.02,154.02,1,-165067,72640,237707,-92427,0,0,90357,0,0,,90357,90357
22,05/29/2018,62,15:15,15:30,154.02,,0,255.16,255.16,1,-190106,62887,252993,-127219,0,0,107927,0,0,,107927,107927
22,05/29/2018,63,15:30,15:45,154.02,,0,255.16,255.16,1,-178758,70840,249598,-107918,0,0,92395,0,45842,,138237,138237
22,05/29/2018,64,15:45,16:00,51.61,,0,255.16,255.16,1,-161938,89616,251554,-72322,0,0,33593,0,51255,,84848,84848
22,05/29/2018,65,16:00,16:15,50.15,,0,258.85,258.85,1,-162798,92991,255789,-69807,0,0,14648,0,34170,,48818,48818
22,05/29/2018,66,16:15,16:30,155.02,,0,155.02,155.02,1,-191528,106540,298068,-84988,0,0,49725,0,0,,49725,49725
22,05/29/2018,67,16:30,16:45,75.86,,0,75.86,75.86,1,-187303,110225,297528,-77078,0,0,68211,0,0,,68211,68211
22,05/29/2018,68,16:45,17:00,69.6,,0,69.6,69.6,1,-190826,103563,294389,-87263,0,0,68875,0,0,,68875,68875
22,05/29/2018,69,17:00,17:15,118.22,,0,118.22,118.22,1,-170765,91043,261808,-79722,0,0,66562,0,0,,66562,66562
22,05/29/2018,70,17:15,17:30,155.18,,0,155.18,155.18,1,-196636,77223,273859,-119413,0,0,99831,0,0,,99831,99831
22,05/29/2018,71,17:30,17:45,155.18,,0,155.18,155.18,1,-184661,91946,276607,-92715,0,0,105175,0,0,,105175,105175
22,05/29/2018,72,17:45,18:00,68.22,,0,68.22,68.22,1,-162750,109140,271890,-53610,0,0,64910,0,0,,64910,64910
22,05/29/2018,73,18:00,18:15,69.88,,0,69.88,69.88,1,-147389,90633,238022,-56756,0,0,46807,0,0,,46807,46807
22,05/29/2018,74,18:15,18:30,58.02,,0,58.02,58.02,1,-109653,86845,196498,-22808,0,0,37890,0,0,,37890,37890
22,05/29/2018,75,18:30,18:45,58.02,,0,58.02,58.02,1,-116999,87514,204513,-29485,0,0,28840,0,0,,28840,28840
22,05/29/2018,76,18:45,19:00,81.62,,0,81.62,81.62,1,-121979,82339,204318,-39640,0,0,38224,0,0,,38224,38224
22,05/29/2018,77,19:00,19:15,121.02,,0,121.02,121.02,1,-103690,73798,177488,-29892,0,0,42798,0,0,,42798,42798
22,05/29/2018,78,19:15,19:30,94.54,44.6,0,94.54,43.88,2,-115817,83777,199594,-32040,0,-33,8343,0,0,,8376,8310
22,05/29/2018,79,19:30,19:45,133.45,,0,133.45,133.45,1,-133487,70982,204469,-62505,0,0,53981,0,0,,53981,53981
22,05/29/2018,80,19:45,20:00,68.22,,0,68.22,68.22,1,-95917,74055,169972,-21862,0,0,45702,0,0,,45702,45702
22,05/29/2018,81,20:00,20:15,68.56,,0,68.56,68.56,1,-126836,77564,204400,-49272,0,0,11051,0,0,,11051,11051
22,05/29/2018,82,20:15,20:30,159.76,,0,159.76,159.76,1,-160232,84313,244545,-75919,0,0,62331,0,0,,62331,62331
22,05/29/2018,83,20:30,20:45,70.02,,0,70.02,70.02,1,-156422,83803,240225,-72619,0,0,65283,0,0,,65283,65283
22,05/29/2018,84,20:45,21:00,74.02,,0,74.02,74.02,1,-163874,81834,245708,-82040,0,0,70188,0,0,,70188,70188
22,05/29/2018,85,21:00,21:15,68.22,,0,68.22,68.22,1,-125830,67112,192942,-58718,0,0,65988,0,0,,65988,65988
22,05/29/2018,86,21:15,21:30,56.96,,0,56.96,56.96,1,-104182,71813,175995,-32369,0,0,39853,0,0,,39853,39853
22,05/29/2018,87,21:30,21:45,68.22,,0,68.22,68.22,1,-110825,56377,167202,-54448,0,0,35664,0,0,,35664,35664
22,05/29/2018,88,21:45,22:00,68.22,,0,68.22,68.22,1,-113223,51278,164501,-61945,0,0,58035,0,0,,58035,58035
22,05/29/2018,89,22:00,22:15,64.9,,0,64.9,64.9,1,-91760,47330,139090,-44430,0,0,49141,0,0,,49141,49141
22,05/29/2018,90,22:15,22:30,43.15,40.5,0,43.92,40.5,2,-59658,54727,114385,-4931,0,-34,11154,0,0,,11188,11120
22,05/29/2018,91,22:30,22:45,,,0,43.92,43.92,0,-54865,50491,105356,-4374,0,0,0,0,0,,0,0
22,05/29/2018,92,22:45,23:00,43.72,,0,43.72,43.72,1,-66252,63427,129679,-2825,0,0,1685,0,0,,1685,1685
22,05/29/2018,93,23:00,23:15,155.02,,0,155.02,155.02,1,-282735,54546,337281,-228189,0,0,51024,0,0,,51024,51024
22,05/29/2018,94,23:15,23:30,155.02,,0,252.3,252.3,1,-238478,55833,294311,-182645,0,0,109578,0,0,,109578,109578
22,05/29/2018,95,23:30,23:45,155.02,35.43,0,35.43,35.43,-1,-174831,104287,279118,-70544,0,-254,76810,0,51249,,128313,127805
22,05/29/2018,96,23:45,0:00,43.15,7.44,0,43.48,7.44,2,-130190,130907,261097,717,0,-7252,2343,0,17083,,26678,12174
22,05/30/2018,1,0:00,0:15,153.12,7.44,0,153.12,153.12,1,-227412,69344,296756,-158068,0,-133,19907,0,0,,20040,19774
22,05/30/2018,2,0:15,0:30,257.37,,0,257.37,257.37,1,-191814,75379,267193,-116435,0,0,72629,8750,0,,81379,81379
22,05/30/2018,3,0:30,0:45,68.22,,0,68.22,68.22,1,-164943,93962,258905,-70981,0,0,23483,0,0,,23483,23483
22,05/30/2018,4,0:45,1:00,94.12,,0,94.12,94.12,1,-160413,95416,255829,-64997,0,0,48793,0,0,,48793,48793
22,05/30/2018,5,1:00,1:15,153.12,,0,153.12,153.12,1,-179875,114596,294471,-65279,0,0,22891,0,0,,22891,22891
22,05/30/2018,6,1:15,1:30,153.12,,0,153.12,153.12,1,-174832,95678,270510,-79154,0,0,60342,0,0,,60342,60342
22,05/30/2018,7,1:30,1:45,48.29,,0,48.29,48.29,1,-123448,106262,229710,-17186,0,0,6182,0,0,,6182,6182
22,05/30/2018,8,1:45,2:00,42.97,41.51,0,41.51,41.51,-1,-99670,99492,199162,-178,0,-156,3714,0,0,,3870,3558
22,05/30/2018,9,2:00,2:15,46.07,38.78,0,46.07,46.07,1,-84607,75457,160064,-9150,0,-251,3687,0,0,,3938,3436
22,05/30/2018,10,2:15,2:30,44.12,,0,44.12,44.12,1,-55605,61127,116732,5522,0,0,6143,0,0,,6143,6143
22,05/30/2018,11,2:30,2:45,,,0,41.49,41.49,0,-43382,61626,105008,18244,0,0,0,0,0,,0,0
22,05/30/2018,12,2:45,3:00,42.07,,0,42.07,42.07,1,-54745,58405,113150,3660,0,0,421,0,0,,421,421
22,05/30/2018,13,3:00,3:15,50.77,,0,50.77,50.77,1,-84117,66622,150739,-17495,0,0,10316,0,0,,10316,10316
22,05/30/2018,14,3:15,3:30,45.9,,0,45.9,45.9,1,-71414,68273,139687,-3141,0,0,14622,0,0,,14622,14622
22,05/30/2018,15,3:30,3:45,45.9,40.83,0,40.83,40.83,-1,-59917,67765,127682,7848,0,-806,709,0,0,,1515,-97
22,05/30/2018,16,3:45,4:00,43.16,40.83,0,43.16,43.16,1,-69461,67523,136984,-1938,0,-9,900,0,0,,909,891
22,05/30/2018,17,4:00,4:15,,39.15,0,39.15,39.15,-1,-50317,72021,122338,21704,0,-1582,0,0,0,,1582,-1582
22,05/30/2018,18,4:15,4:30,,41.01,0,41.01,41.01,-1,-41203,63726,104929,22523,0,-563,0,0,0,,563,-563
22,05/30/2018,19,4:30,4:45,,,0,41.54,41.54,0,-48395,59600,107995,11205,0,0,0,0,0,,0,0
22,05/30/2018,20,4:45,5:00,44.3,,0,44.3,44.3,1,-69798,56919,126717,-12879,0,0,3732,0,0,,3732,3732
22,05/30/2018,21,5:00,5:15,43.98,,0,43.98,43.98,1,-65148,59517,124665,-5631,0,0,3426,0,0,,3426,3426
22,05/30/2018,22,5:15,5:30,,,0,43,43,0,-59828,62610,122438,2782,0,0,0,0,0,,0,0
22,05/30/2018,23,5:30,5:45,50.77,,0,50.77,50.77,1,-79503,60189,139692,-19314,0,0,5200,0,0,,5200,5200
22,05/30/2018,24,5:45,6:00,44.9,40.76,0,40.76,40.76,-1,-72505,89146,161651,16641,0,-43,8803,0,0,,8846,8760
22,05/30/2018,25,6:00,6:15,44.9,14.34,0,14.34,14.34,-1,-74096,100501,174597,26405,0,-9402,25,0,0,,9427,-9377
22,05/30/2018,26,6:15,6:30,42.17,44.88,0,42.17,42.17,1,-76855,64797,141652,-12058,0,-95,11,0,0,,106,-84
22,05/30/2018,27,6:30,6:45,144.12,,0,144.12,144.12,1,-105450,48138,153588,-57312,0,0,23107,0,0,,23107,23107
22,05/30/2018,28,6:45,7:00,153.12,,0,153.12,153.12,1,-136344,65430,201774,-70914,0,0,74086,0,0,,74086,74086
22,05/30/2018,29,7:00,7:15,153.12,36.19,0,36.19,36.19,-1,-21600,114406,136006,92806,0,-2180,17246,0,0,,19426,15066
22,05/30/2018,30,7:15,7:30,43.26,,0,43.26,43.26,1,-33617,57394,91011,23777,0,0,62,0,0,,62,62
22,05/30/2018,31,7:30,7:45,54.76,,0,54.76,54.76,1,-62876,34699,97575,-28177,0,0,6399,0,0,,6399,6399
22,05/30/2018,32,7:45,8:00,72.12,,0,72.12,72.12,1,-113010,46155,159165,-66855,0,0,49757,0,0,,49757,49757
22,05/30/2018,33,8:00,8:15,68.33,31.87,0,31.87,31.87,-1,-12889,99136,112025,86247,0,-858,43283,0,0,,44141,42425
22,05/30/2018,34,8:15,8:30,68.33,14.07,0,14.07,14.07,-1,-22948,73793,96741,50845,0,-4097,1298,0,0,,5395,-2799
22,05/30/2018,35,8:30,8:45,,,0,43.77,43.77,0,-51978,64038,116016,12060,0,0,0,0,0,,0,0
22,05/30/2018,36,8:45,9:00,,42.12,0,42.12,42.12,-1,-71846,69551,141397,-2295,0,-7,0,0,0,,7,-7
22,05/30/2018,37,9:00,9:15,,42.48,0,42.48,42.48,-1,-48745,70836,119581,22091,0,-138,0,0,0,,138,-138
22,05/30/2018,38,9:15,9:30,,42.78,0,42.78,42.78,-1,-50627,72098,122725,21471,0,-885,0,0,0,,885,-885
22,05/30/2018,39,9:30,9:45,,41.53,0,41.53,41.53,-1,-44387,83650,128037,39263,0,-517,0,0,0,,517,-517
22,05/30/2018,40,9:45,10:00,43.26,41.53,0,43.26,43.26,1,-31849,98980,130829,67131,0,-181,8,0,0,,189,-173
22,05/30/2018,41,10:00,10:15,54.9,,0,54.9,54.9,1,-79213,61293,140506,-17920,0,0,7766,0,0,,7766,7766
22,05/30/2018,42,10:15,10:30,44.17,,0,44.17,44.17,1,-71942,61239,133181,-10703,0,0,3405,0,0,,3405,3405
22,05/30/2018,43,10:30,10:45,43.26,,0,43.26,43.26,1,-69913,58567,128480,-11346,0,0,601,0,0,,601,601
22,05/30/2018,44,10:45,11:00,44.63,,0,44.63,44.63,1,-65469,60219,125688,-5250,0,0,4830,0,0,,4830,4830
22,05/30/2018,45,11:00,11:15,48.71,,0,48.71,48.71,1,-75222,45431,120653,-29791,0,0,5302,0,0,,5302,5302
22,05/30/2018,46,11:15,11:30,47.26,,0,47.26,47.26,1,-62909,44999,107908,-17910,0,0,1585,0,0,,1585,1585
22,05/30/2018,47,11:30,11:45,48.71,,0,48.71,48.71,1,-58115,64983,123098,6868,0,0,3341,0,0,,3341,3341
22,05/30/2018,48,11:45,12:00,48.64,,0,48.64,48.64,1,-65549,54598,120147,-10951,0,0,5838,0,0,,5838,5838
22,05/30/2018,49,12:00,12:15,54.9,,0,54.9,54.9,1,-65102,45421,110523,-19681,0,0,16720,0,0,,16720,16720
22,05/30/2018,50,12:15,12:30,,,0,43.65,43.65,0,-68305,53299,121604,-15006,0,0,1474,0,0,,1474,1474
22,05/30/2018,51,12:30,12:45,43.55,,0,43.55,43.55,1,-57841,44184,102025,-13657,0,0,2066,0,0,,2066,2066
22,05/30/2018,52,12:45,13:00,47.26,,0,47.26,47.26,1,-65735,28792,94527,-36943,0,0,9475,0,0,,9475,9475
22,05/30/2018,53,13:00,13:15,79.9,,0,79.9,79.9,1,-87274,17151,104425,-70123,0,0,19418,0,0,,19418,19418
22,05/30/2018,54,13:15,13:30,109.95,,0,109.95,109.95,1,-85877,19458,105335,-66419,0,0,44168,0,0,,44168,44168
22,05/30/2018,55,13:30,13:45,43.6,,0,43.6,43.6,1,-71613,21402,93015,-50211,0,0,12437,0,0,,12437,12437
22,05/30/2018,56,13:45,14:00,59.9,,0,59.9,59.9,1,-82610,16880,99490,-65730,0,0,5237,0,0,,5237,5237
22,05/30/2018,57,14:00,14:15,76,,0,76,76,1,-59668,43679,103347,-15989,0,0,22292,0,0,,22292,22292
22,05/30/2018,58,14:15,14:30,43.29,,0,43.29,43.29,1,-66062,46104,112166,-19958,0,0,4725,0,0,,4725,4725
22,05/30/2018,59,14:30,14:45,43.24,,0,43.24,43.24,1,-66584,45179,111763,-21405,0,0,230,0,0,,230,230
22,05/30/2018,60,14:45,15:00,43.24,,0,43.24,43.24,1,-75879,38976,114855,-36903,0,0,209,0,0,,209,209
22,05/30/2018,61,15:00,15:15,,,0,43.52,43.52,0,-52258,71984,124242,19726,0,0,0,0,0,,0,0
22,05/30/2018,62,15:15,15:30,43.12,,0,43.12,43.12,1,-56198,58646,114844,2448,0,0,547,0,0,,547,547
22,05/30/2018,63,15:30,15:45,43.12,,0,43.12,43.12,1,-69260,59481,128741,-9779,0,0,441,0,0,,441,441
22,05/30/2018,64,15:45,16:00,43.12,,0,43.12,43.12,1,-76341,63580,139921,-12761,0,0,3,0,0,,3,3
22,05/30/2018,65,16:00,16:15,52.16,,0,52.16,52.16,1,-73553,51369,124922,-22184,0,0,7135,0,0,,7135,7135
22,05/30/2018,66,16:15,16:30,47.26,,0,47.26,47.26,1,-68663,49855,118518,-18808,0,0,16026,0,0,,16026,16026
22,05/30/2018,67,16:30,16:45,50.51,,0,50.51,50.51,1,-69087,40357,109444,-28730,0,0,15113,0,0,,15113,15113
22,05/30/2018,68,16:45,17:00,52.41,,0,52.41,52.41,1,-94601,45293,139894,-49308,0,0,38252,0,0,,38252,38252
22,05/30/2018,69,17:00,17:15,87.16,,0,87.16,87.16,1,-96617,36497,133114,-60120,0,0,50185,0,0,,50185,50185
22,05/30/2018,70,17:15,17:30,57.16,,0,57.16,57.16,1,-77450,39874,117324,-37576,0,0,41213,0,0,,41213,41213
22,05/30/2018,71,17:30,17:45,52.12,,0,52.12,52.12,1,-64825,47005,111830,-17820,0,0,27595,0,0,,27595,27595
22,05/30/2018,72,17:45,18:00,52.37,,0,52.37,52.37,1,-63470,53084,116554,-10386,0,0,10544,0,0,,10544,10544
22,05/30/2018,73,18:00,18:15,195.69,,0,195.69,195.69,1,-83468,38340,121808,-45128,0,0,37335,0,0,,37335,37335
22,05/30/2018,74,18:15,18:30,49.18,,0,49.18,49.18,1,-47801,47186,94987,-615,0,0,15093,0,0,,15093,15093
22,05/30/2018,75,18:30,18:45,47.93,,0,47.93,47.93,1,-45179,40950,86129,-4229,0,0,7905,0,0,,7905,7905
22,05/30/2018,76,18:45,19:00,52.6,,0,52.6,52.6,1,-56573,33764,90337,-22809,0,0,24402,0,0,,24402,24402
22,05/30/2018,77,19:00,19:15,81.59,,0,81.59,81.59,1,-89355,38502,127857,-50853,0,0,38683,0,0,,38683,38683
22,05/30/2018,78,19:15,19:30,81.59,,0,81.59,81.59,1,-85376,34268,119644,-51108,0,0,55581,0,0,,55581,55581
22,05/30/2018,79,19:30,19:45,61.59,,0,61.59,61.59,1,-88611,33245,121856,-55366,0,0,54727,0,0,,54727,54727
22,05/30/2018,80,19:45,20:00,61.59,,0,61.59,61.59,1,-88192,31293,119485,-56899,0,0,55703,0,0,,55703,55703
22,05/30/2018,81,20:00,20:15,52.7,,0,52.7,52.7,1,-91956,67614,159570,-24342,0,0,38338,0,0,,38338,38338
22,05/30/2018,82,20:15,20:30,47.26,,0,47.26,47.26,1,-74566,47616,122182,-26950,0,0,20631,0,0,,20631,20631
22,05/30/2018,83,20:30,20:45,47.96,,0,47.96,47.96,1,-58844,34345,93189,-24499,0,0,26072,0,0,,26072,26072
22,05/30/2018,84,20:45,21:00,44,,0,44,44,1,-44228,36279,80507,-7949,0,0,15113,0,0,,15113,15113
22,05/30/2018,85,21:00,21:15,55.12,,0,55.12,55.12,1,-81667,46603,128270,-35064,0,0,20501,0,0,,20501,20501
22,05/30/2018,86,21:15,21:30,47.79,,0,47.79,47.79,1,-69998,47088,117086,-22910,0,0,30356,0,0,,30356,30356
22,05/30/2018,87,21:30,21:45,43.26,41.84,0,44.4,41.84,2,-42826,44942,87768,2116,0,-745,8238,0,0,,8983,7493
22,05/30/2018,88,21:45,22:00,47.26,,0,47.26,47.26,1,-52371,44405,96776,-7966,0,0,2709,0,0,,2709,2709
22,05/30/2018,89,22:00,22:15,102.12,,0,102.12,102.12,1,-92428,32392,124820,-60036,0,0,21154,0,0,,21154,21154
22,05/30/2018,90,22:15,22:30,49.18,,0,49.18,49.18,1,-70560,34410,104970,-36150,0,0,34942,0,0,,34942,34942
22,05/30/2018,91,22:30,22:45,47.26,,0,47.26,47.26,1,-46519,41864,88383,-4655,0,0,18347,0,0,,18347,18347
22,05/30/2018,92,22:45,23:00,47.26,42.61,0,42.61,42.61,-1,-32056,50479,82535,18423,0,-158,597,0,0,,755,439
22,05/30/2018,93,23:00,23:15,129.12,,0,129.12,129.12,1,-90533,43681,134214,-46852,0,0,17085,0,0,,17085,17085
22,05/30/2018,94,23:15,23:30,49.12,41.78,0,41.78,41.78,-1,-43808,57681,101489,13873,0,-183,14705,0,0,,14888,14522
22,05/30/2018,95,23:30,23:45,49.12,41.55,0,41.55,41.55,-1,-38398,62484,100882,24086,0,-405,9,0,0,,414,-396
22,05/30/2018,96,23:45,0:00,,14.17,0,14.17,14.17,-1,-38909,86992,125901,48083,0,-12952,0,0,0,,12952,-12952
22,05/31/2018,1,0:00,0:15,68.58,-31.67,0,68.58,-31.67,2,-117084,66344,183428,-50740,0,-20452,2044,0,0,,22496,-18408
22,05/31/2018,2,0:15,0:30,77.78,-31.67,0,77.78,77.78,1,-83463,73262,156725,-10201,0,-87,12050,0,0,,12137,11963
22,05/31/2018,3,0:30,0:45,77.78,41.89,0,41.89,41.89,-1,-62090,67824,129914,5734,0,-19,70,0,0,,89,51
22,05/31/2018,4,0:45,1:00,,41.55,0,41.55,41.55,-1,-69309,72097,141406,2788,0,-360,0,0,0,,360,-360
22,05/31/2018,5,1:00,1:15,68.33,41.49,0,68.33,41.49,2,-102245,70885,173130,-31360,0,-496,5904,0,0,,6400,5408
22,05/31/2018,6,1:15,1:30,68.33,,0,68.33,68.33,1,-71342,71822,143164,480,0,0,18278,0,0,,18278,18278
22,05/31/2018,7,1:30,1:45,,,0,43.07,43.07,0,-54314,75883,130197,21569,0,0,362,0,0,,362,362
22,05/31/2018,8,1:45,2:00,,37.47,0,37.47,37.47,-1,-50086,78452,128538,28366,0,-3939,0,0,0,,3939,-3939
22,05/31/2018,9,2:00,2:15,44.45,30.87,0,44.45,44.45,1,-69877,77536,147413,7659,0,-7241,838,0,0,,8079,-6403
22,05/31/2018,10,2:15,2:30,46.17,,0,46.17,46.17,1,-71570,65254,136824,-6316,0,0,3407,0,0,,3407,3407
22,05/31/2018,11,2:30,2:45,42.17,,0,42.17,42.17,1,-64605,71718,136323,7113,0,0,549,0,0,,549,549
22,05/31/2018,12,2:45,3:00,,,0,41.87,41.87,0,-52578,85043,137621,32465,0,0,0,0,0,,0,0
22,05/31/2018,13,3:00,3:15,42.17,,0,42.17,42.17,1,-60134,74229,134363,14095,0,0,174,0,0,,174,174
22,05/31/2018,14,3:15,3:30,44.61,,0,44.61,44.61,1,-76451,72635,149086,-3816,0,0,1738,0,0,,1738,1738
22,05/31/2018,15,3:30,3:45,42.17,,0,42.17,42.17,1,-73698,71926,145624,-1772,0,0,139,0,0,,139,139
22,05/31/2018,16,3:45,4:00,42.17,,0,42.17,42.17,1,-72554,78139,150693,5585,0,0,433,0,0,,433,433
22,05/31/2018,17,4:00,4:15,42.17,,0,42.17,42.17,1,-78333,74307,152640,-4026,0,0,90,0,0,,90,90
22,05/31/2018,18,4:15,4:30,,,0,43.07,43.07,0,-72273,67355,139628,-4918,0,0,0,0,0,,0,0
22,05/31/2018,19,4:30,4:45,44.51,,0,44.51,44.51,1,-78357,66905,145262,-11452,0,0,1810,0,0,,1810,1810
22,05/31/2018,20,4:45,5:00,,,0,43.07,43.07,0,-81593,74338,155931,-7255,0,0,443,0,0,,443,443
22,05/31/2018,21,5:00,5:15,,,0,43.07,43.07,0,-54018,85589,139607,31571,0,0,0,0,0,,0,0
22,05/31/2018,22,5:15,5:30,,,0,43.07,43.07,0,-51027,85446,136473,34419,0,0,0,0,0,,0,0
22,05/31/2018,23,5:30,5:45,,,0,43.07,43.07,0,-67175,88136,155311,20961,0,0,0,0,0,,0,0
22,05/31/2018,24,5:45,6:00,50.87,,0,50.87,50.87,1,-110196,84503,194699,-25693,0,0,4790,0,0,,4790,4790
22,05/31/2018,25,6:00,6:15,50.87,32.01,0,32.01,32.01,-1,-33616,105306,138922,71690,0,-13207,790,0,0,,13997,-12417
22,05/31/2018,26,6:15,6:30,,10.26,0,10.26,10.26,-1,-11356,83355,94711,71999,0,-51136,0,0,0,,51136,-51136
22,05/31/2018,27,6:30,6:45,47.29,39.29,0,47.29,39.29,2,-72067,70824,142891,-1243,0,-10649,1396,0,0,,12045,-9253
22,05/31/2018,28,6:45,7:00,52.01,,0,52.01,52.01,1,-114643,83991,198634,-30652,0,0,9934,0,0,,9934,9934
22,05/31/2018,29,7:00,7:15,44.4,-32.6,0,44.4,-32.6,2,-22348,119072,141420,96724,0,-20637,5427,0,0,,26064,-15210
22,05/31/2018,30,7:15,7:30,,35.56,0,35.56,35.56,-1,-30143,65831,95974,35688,0,-28940,0,0,0,,28940,-28940
22,05/31/2018,31,7:30,7:45,45.26,35.56,0,45.26,45.26,1,-91584,66980,158564,-24604,0,-1997,2619,0,0,,4616,622
22,05/31/2018,32,7:45,8:00,69.53,,0,69.53,69.53,1,-150983,81074,232057,-69909,0,0,23477,0,0,,23477,23477
22,05/31/2018,33,8:00,8:15,48.4,,0,48.4,48.4,1,-42460,90861,133321,48401,0,0,15132,0,0,,15132,15132
22,05/31/2018,34,8:15,8:30,48.4,43.62,0,43.62,43.62,-1,-63771,85802,149573,22031,0,-737,144,0,0,,881,-593
22,05/31/2018,35,8:30,8:45,,46.44,0,46.44,46.44,-1,-65858,90589,156447,24731,0,-376,0,0,0,,376,-376
22,05/31/2018,36,8:45,9:00,44.4,,0,44.4,44.4,1,-92847,88295,181142,-4552,0,0,40,0,0,,40,40
22,05/31/2018,37,9:00,9:15,54.16,,0,54.16,54.16,1,-71294,48741,120035,-22553,0,0,6689,0,0,,6689,6689
22,05/31/2018,38,9:15,9:30,54.16,,0,54.16,54.16,1,-74619,55205,129824,-19414,0,0,21692,0,0,,21692,21692
22,05/31/2018,39,9:30,9:45,44.4,40.6,0,45.35,40.6,2,-37806,59207,97013,21401,0,-2804,8395,0,0,,11199,5591
22,05/31/2018,40,9:45,10:00,,40.2,0,40.2,40.2,-1,-39458,68247,107705,28789,0,-11409,0,0,0,,11409,-11409
22,05/31/2018,41,10:00,10:15,182.32,42.33,0,182.32,42.33,2,-112801,55305,168106,-57496,0,-6152,18054,0,0,,24206,11902
22,05/31/2018,42,10:15,10:30,66.5,,0,66.5,66.5,1,-116067,60552,176619,-55515,0,0,49690,0,0,,49690,49690
22,05/31/2018,43,10:30,10:45,66.5,,0,66.5,66.5,1,-121079,70813,191892,-50266,0,0,50269,0,0,,50269,50269
22,05/31/2018,44,10:45,11:00,66.5,,0,66.5,66.5,1,-115211,75196,190407,-40015,0,0,41897,0,0,,41897,41897
22,05/31/2018,45,11:00,11:15,138.02,,0,138.02,138.02,1,-117625,42795,160420,-74830,0,0,51187,0,0,,51187,51187
22,05/31/2018,46,11:15,11:30,196.04,,0,196.04,196.04,1,-132746,41686,174432,-91060,0,0,79635,0,0,,79635,79635
22,05/31/2018,47,11:30,11:45,85.26,,0,85.26,85.26,1,-121409,53531,174940,-67878,0,0,68669,0,0,,68669,68669
22,05/31/2018,48,11:45,12:00,65.26,,0,65.26,65.26,1,-114326,58953,173279,-55373,0,0,50329,0,0,,50329,50329
22,05/31/2018,49,12:00,12:15,51.37,43.62,0,43.62,43.62,-1,-84527,73740,158267,-10787,0,-2,24118,0,0,,24120,24116
22,05/31/2018,50,12:15,12:30,51.37,42.52,0,42.52,42.52,-1,-84930,73834,158764,-11096,0,-211,623,0,0,,834,412
22,05/31/2018,51,12:30,12:45,49.81,,0,49.81,49.81,1,-94341,75057,169398,-19284,0,0,1675,0,0,,1675,1675
22,05/31/2018,52,12:45,13:00,44.36,,0,44.36,44.36,1,-87464,75589,163053,-11875,0,0,1226,0,0,,1226,1226
22,05/31/2018,53,13:00,13:15,,40.2,0,40.2,40.2,-1,-60018,80399,140417,20381,0,-6366,0,0,0,,6366,-6366
22,05/31/2018,54,13:15,13:30,,41.55,0,41.55,41.55,-1,-51949,74188,126137,22239,0,-5224,0,0,0,,5224,-5224
22,05/31/2018,55,13:30,13:45,,40.2,0,40.2,40.2,-1,-54383,97844,152227,43461,0,-10435,0,0,0,,10435,-10435
22,05/31/2018,56,13:45,14:00,,39.48,0,39.48,39.48,-1,-56736,98709,155445,41973,0,-18462,0,0,0,,18462,-18462
22,05/31/2018,57,14:00,14:15,,42.33,0,42.33,42.33,-1,-71473,121749,193222,50276,0,-8184,0,0,0,,8184,-8184
22,05/31/2018,58,14:15,14:30,,,0,45.07,45.07,0,-59463,105646,165109,46183,0,0,0,0,0,,0,0
22,05/31/2018,59,14:30,14:45,,6.03,0,6.03,6.03,-1,-21147,147852,168999,126705,0,-20250,0,0,0,,20250,-20250
22,05/31/2018,60,14:45,15:00,,-32.6,0,-32.6,-32.6,-1,-16127,148916,165043,132789,0,-28748,0,0,0,,28748,-28748
22,05/31/2018,61,15:00,15:15,,32.38,0,32.38,32.38,-1,-12422,191333,203755,178911,0,-27734,0,0,0,,27734,-27734
22,05/31/2018,62,15:15,15:30,,38.18,0,38.18,38.18,-1,-13701,159765,173466,146064,0,-32847,0,0,0,,32847,-32847
22,05/31/2018,63,15:30,15:45,,,0,45,45,0,-21811,132910,154721,111099,0,-4960,0,0,0,,4960,-4960
22,05/31/2018,64,15:45,16:00,,,0,45,45,0,-30983,131437,162420,100454,0,0,0,0,0,,0,0
22,05/31/2018,65,16:00,16:15,,,0,43.94,43.94,0,-58946,97353,156299,38407,0,0,0,0,0,,0,0
22,05/31/2018,66,16:15,16:30,48.4,,0,48.4,48.4,1,-75736,78752,154488,3016,0,0,145,0,0,,145,145
22,05/31/2018,67,16:30,16:45,44.78,,0,44.78,44.78,1,-84474,73292,157766,-11182,0,0,3227,0,0,,3227,3227
22,05/31/2018,68,16:45,17:00,48.4,,0,48.4,48.4,1,-102142,62373,164515,-39769,0,0,11655,0,0,,11655,11655
22,05/31/2018,69,17:00,17:15,52.93,,0,52.93,52.93,1,-79884,53617,133501,-26267,0,0,18859,0,0,,18859,18859
22,05/31/2018,70,17:15,17:30,46.98,,0,46.98,46.98,1,-63882,50724,114606,-13158,0,0,18886,0,0,,18886,18886
22,05/31/2018,71,17:30,17:45,44.4,,0,44.4,44.4,1,-70384,74598,144982,4214,0,0,2720,0,0,,2720,2720
22,05/31/2018,72,17:45,18:00,44.4,,0,44.4,44.4,1,-71434,98303,169737,26869,0,0,27,0,0,,27,27
22,05/31/2018,73,18:00,18:15,195.69,,0,195.69,195.69,1,-152161,69997,222158,-82164,0,0,34074,0,0,,34074,34074
22,05/31/2018,74,18:15,18:30,55.1,,0,55.1,55.1,1,-109253,84928,194181,-24325,0,0,27766,0,0,,27766,27766
22,05/31/2018,75,18:30,18:45,47.02,,0,47.02,47.02,1,-99986,86150,186136,-13836,0,0,12243,0,0,,12243,12243
22,05/31/2018,76,18:45,19:00,65.1,,0,65.1,65.1,1,-116511,77570,194081,-38941,0,0,23113,0,0,,23113,23113
22,05/31/2018,77,19:00,19:15,62.51,,0,62.51,62.51,1,-104077,65647,169724,-38430,0,0,42372,0,0,,42372,42372
22,05/31/2018,78,19:15,19:30,82.51,,0,82.51,82.51,1,-107471,53012,160483,-54459,0,0,53288,0,0,,53288,53288
22,05/31/2018,79,19:30,19:45,63.02,,0,63.02,63.02,1,-103874,53995,157869,-49879,0,0,62094,0,0,,62094,62094
22,05/31/2018,80,19:45,20:00,60.02,,0,60.02,60.02,1,-86411,53148,139559,-33263,0,0,46917,0,0,,46917,46917
22,05/31/2018,81,20:00,20:15,53.02,,0,53.02,53.02,1,-68780,78931,147711,10151,0,0,23653,0,0,,23653,23653
22,05/31/2018,82,20:15,20:30,44.34,43.62,0,45.44,43.62,2,-65839,61920,127759,-3919,0,-28,485,0,0,,513,457
22,05/31/2018,83,20:30,20:45,49.9,,0,49.9,49.9,1,-74520,56363,130883,-18157,0,0,6573,0,0,,6573,6573
22,05/31/2018,84,20:45,21:00,44.4,,0,44.4,44.4,1,-56697,59700,116397,3003,0,0,6924,0,0,,6924,6924
22,05/31/2018,85,21:00,21:15,69.53,,0,69.53,69.53,1,-82746,47009,129755,-35737,0,0,14349,0,0,,14349,14349
22,05/31/2018,86,21:15,21:30,49.6,,0,49.6,49.6,1,-72742,40903,113645,-31839,0,0,29731,0,0,,29731,29731
22,05/31/2018,87,21:30,21:45,48.4,,0,48.4,48.4,1,-68481,40658,109139,-27823,0,0,26643,0,0,,26643,26643
22,05/31/2018,88,21:45,22:00,48.4,,0,48.4,48.4,1,-49690,48374,98064,-1316,0,0,15194,0,0,,15194,15194
22,05/31/2018,89,22:00,22:15,50.69,,0,50.69,50.69,1,-74859,50859,125718,-24000,0,0,7123,0,0,,7123,7123
22,05/31/2018,90,22:15,22:30,53.58,,0,53.58,53.58,1,-83207,43951,127158,-39256,0,0,28228,0,0,,28228,28228
22,05/31/2018,91,22:30,22:45,48.4,,0,48.4,48.4,1,-53251,38049,91300,-15202,0,0,21271,0,0,,21271,21271
22,05/31/2018,92,22:45,23:00,44.4,,0,44.4,44.4,1,-47413,38362,85775,-9051,0,0,3056,0,0,,3056,3056
22,05/31/2018,93,23:00,23:15,156.02,,0,156.02,156.02,1,-152491,30948,183439,-121543,0,0,42363,0,0,,42363,42363
22,05/31/2018,94,23:15,23:30,102.3,,0,102.3,102.3,1,-95756,49584,145340,-46172,0,0,67041,0,0,,67041,67041
22,05/31/2018,95,23:30,23:45,102.3,39.33,0,39.33,39.33,-1,-40781,60559,101340,19778,0,-5824,4700,0,0,,10524,-1124
22,05/31/2018,96,23:45,0:00,,28.58,0,28.58,28.58,-1,-37125,96730,133855,59605,0,-31378,0,0,0,,31378,-31378
22,06-01-18,1,0:00,0:15,165.02,36.03,0,165.02,165.02,1,-144687,56618,201305,-88069,0,-20991,17011,0,0,,38002,-3980
22,06-01-18,2,0:15,0:30,175.02,,0,175.02,175.02,1,-93904,72019,165923,-21885,0,0,35352,0,0,,35352,35352
22,06-01-18,3,0:30,0:45,175.02,32.62,0,32.62,32.62,-1,-52814,76909,129723,24095,0,-12957,2448,0,0,,15405,-10509
22,06-01-18,4,0:45,1:00,,42.29,0,42.29,42.29,-1,-73895,81724,155619,7829,0,-2918,0,0,0,,2918,-2918
22,06-01-18,5,1:00,1:15,173.02,,0,173.02,173.02,1,-131377,51951,183328,-79426,0,0,28133,0,0,,28133,28133
22,06-01-18,6,1:15,1:30,174.02,39.6,0,39.6,39.6,-1,-85577,81832,167409,-3745,0,-70,47778,0,0,,47848,47708
22,06-01-18,7,1:30,1:45,174.02,19.67,0,19.67,19.67,-1,-44565,83512,128077,38947,0,-12332,477,0,0,,12809,-11855
22,06-01-18,8,1:45,2:00,,31.12,0,31.12,31.12,-1,-43012,99614,142626,56602,0,-19081,0,0,0,,19081,-19081
22,06-01-18,9,2:00,2:15,,32.62,0,32.62,32.62,-1,-45845,90032,135877,44187,0,-33045,0,0,0,,33045,-33045
22,06-01-18,10,2:15,2:30,,40.04,0,40.04,40.04,-1,-46569,75527,122096,28958,0,-22122,0,0,0,,22122,-22122
22,06-01-18,11,2:30,2:45,,40.04,0,40.04,40.04,-1,-48203,76607,124810,28404,0,-17928,0,0,0,,17928,-17928
22,06-01-18,12,2:45,3:00,,40.04,0,40.04,40.04,-1,-40305,70726,111031,30421,0,-18381,0,0,0,,18381,-18381
22,06-01-18,13,3:00,3:15,77.78,44.03,0,77.78,77.78,1,-69778,34126,103904,-35652,0,-6711,8267,0,0,,14978,1556
22,06-01-18,14,3:15,3:30,53.01,,0,53.01,53.01,1,-70513,39778,110291,-30735,0,0,27091,0,0,,27091,27091
22,06-01-18,15,3:30,3:45,48.54,,0,48.54,48.54,1,-59497,41214,100711,-18283,0,0,20279,0,0,,20279,20279
22,06-01-18,16,3:45,4:00,49.66,,0,49.66,49.66,1,-57684,28933,86617,-28751,0,0,18231,0,0,,18231,18231
22,06-01-18,17,4:00,4:15,48.54,44.35,0,44.35,44.35,-1,-52372,62992,115364,10620,0,-274,12363,0,0,,12637,12089
22,06-01-18,18,4:15,4:30,,,0,45.83,45.83,0,-56198,61282,117480,5084,0,-175,56,0,0,,231,-119
22,06-01-18,19,4:30,4:45,,,0,45.83,45.83,0,-45735,60219,105954,14484,0,0,0,0,0,,0,0
22,06-01-18,20,4:45,5:00,48.54,,0,48.54,48.54,1,-72662,46977,119639,-25685,0,0,836,0,0,,836,836
22,06-01-18,21,5:00,5:15,53.01,,0,53.01,53.01,1,-70517,31611,102128,-38906,0,0,14135,0,0,,14135,14135
22,06-01-18,22,5:15,5:30,47.02,,0,47.02,47.02,1,-60443,31415,91858,-29028,0,0,18223,0,0,,18223,18223
22,06-01-18,23,5:30,5:45,48.54,,0,48.54,48.54,1,-60512,32980,93492,-27532,0,0,9673,0,0,,9673,9673
22,06-01-18,24,5:45,6:00,53.01,,0,53.01,53.01,1,-62077,30415,92492,-31662,0,0,15033,0,0,,15033,15033
22,06-01-18,25,6:00,6:15,53.01,-62.55,0,-62.55,-62.55,-1,-44315,78811,123126,34496,0,-23163,3615,0,0,,26778,-19548
22,06-01-18,26,6:15,6:30,,40.51,0,40.51,40.51,-1,-43693,46055,89748,2362,0,-14788,0,0,0,,14788,-14788
22,06-01-18,27,6:30,6:45,146.02,40.51,0,146.02,146.02,1,-78967,27163,106130,-51804,0,-2228,16448,0,0,,18676,14220
22,06-01-18,28,6:45,7:00,174.02,,0,174.02,174.02,1,-136661,27250,163911,-109411,0,0,53174,0,0,,53174,53174
22,06-01-18,29,7:00,7:15,74.74,42.17,0,42.17,42.17,-1,-42101,72536,114637,30435,0,-361,30190,0,0,,30551,29829
22,06-01-18,30,7:15,7:30,48.73,42.17,0,48.73,48.73,1,-41786,42089,83875,303,0,-132,899,0,0,,1031,767
22,06-01-18,31,7:30,7:45,88.8,,0,88.8,88.8,1,-75890,32441,108331,-43449,0,0,30805,0,0,,30805,30805
22,06-01-18,32,7:45,8:00,88.8,,0,88.8,88.8,1,-118879,55400,174279,-63479,0,0,50880,0,0,,50880,50880
22,06-01-18,33,8:00,8:15,63.02,-81.41,0,-81.41,-81.41,-1,-11119,139675,150794,128556,0,-13573,21104,0,0,,34677,7531
22,06-01-18,34,8:15,8:30,,-81.72,0,-81.72,-81.72,-1,-31940,73594,105534,41654,0,-38784,0,0,0,,38784,-38784
22,06-01-18,35,8:30,8:45,,42.32,0,42.32,42.32,-1,-48556,57878,106434,9322,0,-8715,0,0,0,,8715,-8715
22,06-01-18,36,8:45,9:00,146.02,42.32,0,146.02,146.02,1,-70422,61355,131777,-9067,0,-42,10767,0,0,,10809,10725
22,06-01-18,37,9:00,9:15,176.02,,0,176.02,176.02,1,-35840,59681,95521,23841,0,0,28040,0,0,,28040,28040
22,06-01-18,38,9:15,9:30,176.02,46.58,0,46.58,46.58,-1,-19597,78154,97751,58557,0,-429,710,0,0,,1139,281
22,06-01-18,39,9:30,9:45,,46.58,0,46.58,46.58,-1,-16643,98800,115443,82157,0,-624,0,0,0,,624,-624
22,06-01-18,40,9:45,10:00,,,0,45.79,45.79,0,-18353,102433,120786,84080,0,-8,0,0,0,,8,-8
22,06-01-18,41,10:00,10:15,,,0,46.48,46.48,0,-49661,83689,133350,34028,0,0,0,0,0,,0,0
22,06-01-18,42,10:15,10:30,,,0,46.48,46.48,0,-48975,86443,135418,37468,0,0,0,0,0,,0,0
22,06-01-18,43,10:30,10:45,,46.58,0,46.58,46.58,-1,-48794,91559,140353,42765,0,-694,0,0,0,,694,-694
22,06-01-18,44,10:45,11:00,,46.58,0,46.58,46.58,-1,-47999,83748,131747,35749,0,-856,0,0,0,,856,-856
22,06-01-18,45,11:00,11:15,103.08,46.58,0,103.08,103.08,1,-63139,43560,106699,-19579,0,-16,17596,0,0,,17612,17580
22,06-01-18,46,11:15,11:30,51.76,,0,51.76,51.76,1,-45746,53165,98911,7419,0,0,20555,0,0,,20555,20555
22,06-01-18,47,11:30,11:45,51.76,,0,51.76,51.76,1,-51794,48729,100523,-3065,0,0,18113,0,0,,18113,18113
22,06-01-18,48,11:45,12:00,51.76,,0,51.76,51.76,1,-46436,44088,90524,-2348,0,0,20856,0,0,,20856,20856
22,06-01-18,49,12:00,12:15,176.02,,0,176.02,176.02,1,-100205,29027,129232,-71178,0,0,40028,0,0,,40028,40028
22,06-01-18,50,12:15,12:30,176.02,,0,176.02,176.02,1,-99900,49561,149461,-50339,0,0,61511,0,0,,61511,61511
22,06-01-18,51,12:30,12:45,54.05,,0,54.05,54.05,1,-82087,59019,141106,-23068,0,0,17947,0,0,,17947,17947
22,06-01-18,52,12:45,13:00,93.03,,0,93.03,93.03,1,-94930,51530,146460,-43400,0,0,32814,0,0,,32814,32814
22,06-01-18,53,13:00,13:15,176.02,,0,176.02,176.02,1,-128636,40633,169269,-88003,0,0,49134,0,0,,49134,49134
22,06-01-18,54,13:15,13:30,176.02,,0,176.02,176.02,1,-116441,54748,171189,-61693,0,0,69159,0,0,,69159,69159
22,06-01-18,55,13:30,13:45,54.05,,0,54.05,54.05,1,-108358,69539,177897,-38819,0,0,34584,0,0,,34584,34584
22,06-01-18,56,13:45,14:00,54.05,,0,54.05,54.05,1,-113596,61125,174721,-52471,0,0,34422,0,0,,34422,34422
22,06-01-18,57,14:00,14:15,175.02,,0,175.02,175.02,1,-123358,57016,180374,-66342,0,0,42474,0,0,,42474,42474
22,06-01-18,58,14:15,14:30,70.11,,0,70.11,70.11,1,-116760,69146,185906,-47614,0,0,53961,0,0,,53961,53961
22,06-01-18,59,14:30,14:45,63.02,,0,63.02,63.02,1,-110645,68679,179324,-41966,0,0,44193,0,0,,44193,44193
22,06-01-18,60,14:45,15:00,54.05,,0,54.05,54.05,1,-107387,69432,176819,-37955,0,0,34710,0,0,,34710,34710
22,06-01-18,61,15:00,15:15,52.02,,0,52.02,52.02,1,-95363,83330,178693,-12033,0,0,28419,0,0,,28419,28419
22,06-01-18,62,15:15,15:30,48.73,,0,48.73,48.73,1,-84896,69394,154290,-15502,0,0,10199,0,0,,10199,10199
22,06-01-18,63,15:30,15:45,47.3,,0,47.3,47.3,1,-78707,65999,144706,-12708,0,0,14036,0,0,,14036,14036
22,06-01-18,64,15:45,16:00,44.73,32.74,0,32.74,32.74,-1,-54809,69248,124057,14439,0,-647,4510,0,0,,5157,3863
22,06-01-18,65,16:00,16:15,,-78.09,0,-78.09,-78.09,-1,-29840,151094,180934,121254,0,-56749,0,0,0,,56749,-56749
22,06-01-18,66,16:15,16:30,,36.56,0,36.56,36.56,-1,-46697,118120,164817,71423,0,-36560,0,0,0,,36560,-36560
22,06-01-18,67,16:30,16:45,,26.48,0,26.48,26.48,-1,-49959,120344,170303,70385,0,-50551,0,0,0,,50551,-50551
22,06-01-18,68,16:45,17:00,,40.73,0,40.73,40.73,-1,-80467,104701,185168,24234,0,-16912,0,0,0,,16912,-16912
22,06-01-18,69,17:00,17:15,48.73,45.54,0,55.75,45.54,2,-62456,45267,107723,-17189,0,-1486,1321,0,0,,2807,-165
22,06-01-18,70,17:15,17:30,54.05,,0,54.05,54.05,1,-71168,51289,122457,-19879,0,0,16359,0,0,,16359,16359
22,06-01-18,71,17:30,17:45,54.05,,0,54.05,54.05,1,-84743,58196,142939,-26547,0,0,17370,0,0,,17370,17370
22,06-01-18,72,17:45,18:00,54.05,,0,54.05,54.05,1,-87851,58323,146174,-29528,0,0,26883,0,0,,26883,26883
22,06-01-18,73,18:00,18:15,176.02,,0,176.02,176.02,1,-113639,21779,135418,-91860,0,0,17536,0,0,,17536,17536
22,06-01-18,74,18:15,18:30,175.02,,0,175.02,175.02,1,-80277,33205,113482,-47072,0,0,53460,0,0,,53460,53460
22,06-01-18,75,18:30,18:45,48.73,,0,48.73,48.73,1,-64049,57983,122032,-6066,0,0,11472,0,0,,11472,11472
22,06-01-18,76,18:45,19:00,48.73,,0,48.73,48.73,1,-52109,53994,106103,1885,0,0,4941,0,0,,4941,4941
22,06-01-18,77,19:00,19:15,47.68,,0,47.68,47.68,1,-68877,58902,127779,-9975,0,0,1213,0,0,,1213,1213
22,06-01-18,78,19:15,19:30,48.73,,0,48.73,48.73,1,-73437,52522,125959,-20915,0,0,7102,0,0,,7102,7102
22,06-01-18,79,19:30,19:45,44.73,43.03,0,43.03,43.03,-1,-58209,68686,126895,10477,0,-284,4101,0,0,,4385,3817
22,06-01-18,80,19:45,20:00,,,0,55.84,55.84,0,-35683,89606,125289,53923,0,-28,0,0,0,,28,-28
22,06-01-18,81,20:00,20:15,48.73,,0,48.73,48.73,1,-67422,54680,122102,-12742,0,0,2309,0,0,,2309,2309
22,06-01-18,82,20:15,20:30,44.73,,0,44.73,44.73,1,-35240,55753,90993,20513,0,0,583,0,0,,583,583
22,06-01-18,83,20:30,20:45,,,0,55.01,55.01,0,-36748,51168,87916,14420,0,0,0,0,0,,0,0
22,06-01-18,84,20:45,21:00,,,0,55.01,55.01,0,-15049,55533,70582,40484,0,0,0,0,0,,0,0
22,06-01-18,85,21:00,21:15,,46.14,0,46.14,46.14,-1,-43556,96821,140377,53265,0,-73,0,0,0,,73,-73
22,06-01-18,86,21:15,21:30,,42.32,0,42.32,42.32,-1,-33697,98774,132471,65077,0,-86,0,0,0,,86,-86
22,06-01-18,87,21:30,21:45,,40.73,0,40.73,40.73,-1,-32016,109112,141128,77096,0,-3211,0,0,0,,3211,-3211
22,06-01-18,88,21:45,22:00,,42.32,0,42.32,42.32,-1,-33959,102266,136225,68307,0,-1469,0,0,0,,1469,-1469
22,06-01-18,89,22:00,22:15,48.73,36.73,0,53.84,36.73,2,-51841,53740,105581,1899,0,-2816,875,0,0,,3691,-1941
22,06-01-18,90,22:15,22:30,54.05,,0,54.05,54.05,1,-52017,45308,97325,-6709,0,0,10416,0,0,,10416,10416
22,06-01-18,91,22:30,22:45,54.05,40.68,0,40.68,40.68,-1,-44664,83691,128355,39027,0,-1890,480,0,0,,2370,-1410
22,06-01-18,92,22:45,23:00,,31.86,0,31.86,31.86,-1,-36370,116911,153281,80541,0,-29290,0,0,0,,29290,-29290
22,06-01-18,93,23:00,23:15,,32.74,0,32.74,32.74,-1,-42433,54996,97429,12563,0,-23255,0,0,0,,23255,-23255
22,06-01-18,94,23:15,23:30,,,0,54.64,54.64,0,-33594,69903,103497,36309,0,0,0,0,0,,0,0
22,06-01-18,95,23:30,23:45,,45.85,0,45.85,45.85,-1,-26337,92480,118817,66143,0,-318,0,0,0,,318,-318
22,06-01-18,96,23:45,0:00,,17.75,0,17.75,17.75,-1,-26537,114639,141176,88102,0,-27765,0,0,0,,27765,-27765
23,06-02-18,1,0:00,0:15,67.44,17.44,0,67.44,67.44,1,-74325,16896,91221,-57429,0,-28384,1269,0,0,,29653,-27115
23,06-02-18,2,0:15,0:30,67.44,17.44,0,67.44,67.44,1,-48261,26669,74930,-21592,0,-1,3879,0,0,,3880,3878
23,06-02-18,3,0:30,0:45,46.84,,0,46.84,46.84,1,-47591,26488,74079,-21103,0,0,5340,0,0,,5340,5340
23,06-02-18,4,0:45,1:00,45.24,,0,45.24,45.24,1,-93991,47893,141884,-46098,0,0,4078,0,0,,4078,4078
23,06-02-18,5,1:00,1:15,45.24,38.78,0,38.78,38.78,-1,-42257,106395,148652,64138,0,-275,666,0,0,,941,391
23,06-02-18,6,1:15,1:30,52.41,,0,52.41,52.41,1,-65349,28749,94098,-36600,0,0,5200,0,0,,5200,5200
23,06-02-18,7,1:30,1:45,47.87,,0,47.87,47.87,1,-63138,24820,87958,-38318,0,0,2866,0,0,,2866,2866
23,06-02-18,8,1:45,2:00,44.16,,0,44.16,44.16,1,-77250,17490,94740,-59760,0,0,11851,0,0,,11851,11851
23,06-02-18,9,2:00,2:15,174.12,,0,174.12,174.12,1,-108141,24326,132467,-83815,0,0,34966,0,0,,34966,34966
23,06-02-18,10,2:15,2:30,67.41,,0,67.41,67.41,1,-71456,30027,101483,-41429,0,0,27902,0,0,,27902,27902
23,06-02-18,11,2:30,2:45,52.41,,0,52.41,52.41,1,-67269,34608,101877,-32661,0,0,31618,0,0,,31618,31618
23,06-02-18,12,2:45,3:00,48.03,,0,48.03,48.03,1,-69440,35742,105182,-33698,0,0,17062,0,0,,17062,17062
23,06-02-18,13,3:00,3:15,67.41,,0,67.41,67.41,1,-78254,37315,115569,-40939,0,0,27611,0,0,,27611,27611
23,06-02-18,14,3:15,3:30,47.87,,0,47.87,47.87,1,-55965,50954,106919,-5011,0,0,17820,0,0,,17820,17820
23,06-02-18,15,3:30,3:45,47.87,41.84,0,41.84,41.84,-1,-44919,66723,111642,21804,0,-1647,914,0,0,,2561,-733
23,06-02-18,16,3:45,4:00,,39.46,0,39.46,39.46,-1,-39351,84120,123471,44769,0,-3904,0,0,0,,3904,-3904
23,06-02-18,17,4:00,4:15,,39.46,0,39.46,39.46,-1,-46775,88936,135711,42161,0,-4577,0,0,0,,4577,-4577
23,06-02-18,18,4:15,4:30,,42.65,0,42.65,42.65,-1,-31451,105353,136804,73902,0,-921,0,0,0,,921,-921
23,06-02-18,19,4:30,4:45,,42.65,0,42.65,42.65,-1,-33698,115061,148759,81363,0,-188,0,0,0,,188,-188
23,06-02-18,20,4:45,5:00,,39.46,0,39.46,39.46,-1,-45947,113972,159919,68025,0,-166,0,0,0,,166,-166
23,06-02-18,21,5:00,5:15,,,0,43.5,43.5,0,-51644,65974,117618,14330,0,-73,0,0,0,,73,-73
23,06-02-18,22,5:15,5:30,,42.44,0,42.44,42.44,-1,-40067,48379,88446,8312,0,-346,0,0,0,,346,-346
23,06-02-18,23,5:30,5:45,,40.78,0,40.78,40.78,-1,-39662,48559,88221,8897,0,-717,0,0,0,,717,-717
23,06-02-18,24,5:45,6:00,,39.46,0,39.46,39.46,-1,-29787,57649,87436,27862,0,-3089,0,0,0,,3089,-3089
23,06-02-18,25,6:00,6:15,,37.99,0,37.99,37.99,-1,-29272,52081,81353,22809,0,-1063,0,0,0,,1063,-1063
23,06-02-18,26,6:15,6:30,,,0,42.89,42.89,0,-29697,41208,70905,11511,0,0,0,0,0,,0,0
23,06-02-18,27,6:30,6:45,51.12,,0,51.12,51.12,1,-53400,30972,84372,-22428,0,0,2065,0,0,,2065,2065
23,06-02-18,28,6:45,7:00,46.47,,0,46.47,46.47,1,-54559,48943,103502,-5616,0,0,7718,0,0,,7718,7718
23,06-02-18,29,7:00,7:15,,,0,43.2,43.2,0,-30780,60383,91163,29603,0,0,225,0,0,,225,225
23,06-02-18,30,7:15,7:30,,,0,43.67,43.67,0,-28765,45049,73814,16284,0,0,0,0,0,,0,0
23,06-02-18,31,7:30,7:45,55.5,,0,55.5,55.5,1,-58572,32915,91487,-25657,0,0,9339,0,0,,9339,9339
23,06-02-18,32,7:45,8:00,78.12,,0,78.12,78.12,1,-96681,36519,133200,-60162,0,0,46834,0,0,,46834,46834
23,06-02-18,33,8:00,8:15,78.12,40.72,0,40.72,40.72,-1,-24976,97073,122049,72097,0,-633,13605,0,0,,14238,12972
23,06-02-18,34,8:15,8:30,,42.78,0,42.78,42.78,-1,-33411,72883,106294,39472,0,-1031,0,0,0,,1031,-1031
23,06-02-18,35,8:30,8:45,46.98,42.78,0,46.98,46.98,1,-71547,46613,118160,-24934,0,-205,1797,0,0,,2002,1592
23,06-02-18,36,8:45,9:00,174.12,,0,174.12,174.12,1,-102134,35081,137215,-67053,0,0,28525,0,0,,28525,28525
23,06-02-18,37,9:00,9:15,174.12,22,0,22,22,-1,-36600,105449,142049,68849,0,-8486,8386,0,0,,16872,-100
23,06-02-18,38,9:15,9:30,,42.78,0,42.78,42.78,-1,-49422,56068,105490,6646,0,-1318,0,0,0,,1318,-1318
23,06-02-18,39,9:30,9:45,46.98,,0,46.98,46.98,1,-58935,42658,101593,-16277,0,0,2845,0,0,,2845,2845
23,06-02-18,40,9:45,10:00,47.04,,0,47.04,47.04,1,-62582,36800,99382,-25782,0,0,13719,0,0,,13719,13719
23,06-02-18,41,10:00,10:15,70.03,,0,70.03,70.03,1,-87324,40142,127466,-47182,0,0,28090,0,0,,28090,28090
23,06-02-18,42,10:15,10:30,47.13,,0,47.13,47.13,1,-70235,45508,115743,-24727,0,0,21240,0,0,,21240,21240
23,06-02-18,43,10:30,10:45,51.12,,0,51.12,51.12,1,-79127,43552,122679,-35575,0,0,11412,0,0,,11412,11412
23,06-02-18,44,10:45,11:00,51.12,,0,51.12,51.12,1,-79861,46152,126013,-33709,0,0,16496,0,0,,16496,16496
23,06-02-18,45,11:00,11:15,42.93,,0,42.93,42.93,1,-58303,49058,107361,-9245,0,0,5352,0,0,,5352,5352
23,06-02-18,46,11:15,11:30,45.61,,0,45.61,45.61,1,-52421,41012,93433,-11409,0,0,1633,0,0,,1633,1633
23,06-02-18,47,11:30,11:45,45.61,,0,45.61,45.61,1,-51930,43767,95697,-8163,0,0,2932,0,0,,2932,2932
23,06-02-18,48,11:45,12:00,46.7,,0,46.7,46.7,1,-55031,43848,98879,-11183,0,0,6194,0,0,,6194,6194
23,06-02-18,49,12:00,12:15,44.85,,0,44.85,44.85,1,-64882,50001,114883,-14881,0,0,6874,0,0,,6874,6874
23,06-02-18,50,12:15,12:30,42.93,,0,42.93,42.93,1,-69107,55738,124845,-13369,0,0,3796,0,0,,3796,3796
23,06-02-18,51,12:30,12:45,42.93,,0,42.93,42.93,1,-73051,78532,151583,5481,0,0,1199,0,0,,1199,1199
23,06-02-18,52,12:45,13:00,42.93,34.95,0,34.95,34.95,-1,-49704,86763,136467,37059,0,-6492,51,0,0,,6543,-6441
23,06-02-18,53,13:00,13:15,,40.26,0,40.26,40.26,-1,-72219,107832,180051,35613,0,-8923,0,0,0,,8923,-8923
23,06-02-18,54,13:15,13:30,,38.93,0,38.93,38.93,-1,-68055,106995,175050,38940,0,-708,0,0,0,,708,-708
23,06-02-18,55,13:30,13:45,,34.95,0,34.95,34.95,-1,-65114,110794,175908,45680,0,-8958,0,0,0,,8958,-8958
23,06-02-18,56,13:45,14:00,,28.44,0,28.44,28.44,-1,-60221,107604,167825,47383,0,-40724,0,0,0,,40724,-40724
23,06-02-18,57,14:00,14:15,66.12,28.44,0,66.12,66.12,1,-93815,72068,165883,-21747,0,-14540,6283,0,0,,20823,-8257
23,06-02-18,58,14:15,14:30,45.5,,0,45.5,45.5,1,-69612,77709,147321,8097,0,0,5142,0,0,,5142,5142
23,06-02-18,59,14:30,14:45,42.93,,0,42.93,42.93,1,-79530,79936,159466,406,0,0,1309,0,0,,1309,1309
23,06-02-18,60,14:45,15:00,42.93,,0,42.93,42.93,1,-83078,86905,169983,3827,0,0,2778,0,0,,2778,2778
23,06-02-18,61,15:00,15:15,51.12,,0,51.12,51.12,1,-86574,68121,154695,-18453,0,0,6098,0,0,,6098,6098
23,06-02-18,62,15:15,15:30,44.98,,0,44.98,44.98,1,-76411,61163,137574,-15248,0,0,9523,0,0,,9523,9523
23,06-02-18,63,15:30,15:45,42.93,,0,42.93,42.93,1,-70869,59300,130169,-11569,0,0,987,0,0,,987,987
23,06-02-18,64,15:45,16:00,44.65,,0,44.65,44.65,1,-74846,63696,138542,-11150,0,0,2880,0,0,,2880,2880
23,06-02-18,65,16:00,16:15,46.98,,0,46.98,46.98,1,-118218,104702,222920,-13516,0,0,6826,0,0,,6826,6826
23,06-02-18,66,16:15,16:30,45,,0,45,45,1,-108652,96381,205033,-12271,0,0,4823,0,0,,4823,4823
23,06-02-18,67,16:30,16:45,51.12,,0,51.12,51.12,1,-114861,82651,197512,-32210,0,0,18596,0,0,,18596,18596
23,06-02-18,68,16:45,17:00,46.98,38.93,0,38.93,38.93,-1,-79745,79225,158970,-520,0,-248,13179,0,0,,13427,12931
23,06-02-18,69,17:00,17:15,,,0,43.66,43.66,0,-89095,116416,205511,27321,0,-188,44,0,0,,232,-144
23,06-02-18,70,17:15,17:30,,,0,43.65,43.65,0,-51275,94899,146174,43624,0,0,0,0,0,,0,0
23,06-02-18,71,17:30,17:45,,,0,43.63,43.63,0,-53703,77617,131320,23914,0,0,0,0,0,,0,0
23,06-02-18,72,17:45,18:00,46.98,,0,46.98,46.98,1,-63534,64574,128108,1040,0,0,702,0,0,,702,702
23,06-02-18,73,18:00,18:15,66.12,,0,66.12,66.12,1,-65300,49658,114958,-15642,0,0,11843,0,0,,11843,11843
23,06-02-18,74,18:15,18:30,45,,0,45,45,1,-51222,55218,106440,3996,0,0,713,0,0,,713,713
23,06-02-18,75,18:30,18:45,,,0,43.69,43.69,0,-52637,60190,112827,7553,0,0,13,0,0,,13,13
23,06-02-18,76,18:45,19:00,42.93,,0,42.93,42.93,1,-55517,62956,118473,7439,0,0,223,0,0,,223,223
23,06-02-18,77,19:00,19:15,51.12,,0,51.12,51.12,1,-78304,63090,141394,-15214,0,0,6569,0,0,,6569,6569
23,06-02-18,78,19:15,19:30,51.12,,0,51.12,51.12,1,-85233,61729,146962,-23504,0,0,19011,0,0,,19011,19011
23,06-02-18,79,19:30,19:45,45.79,,0,45.79,45.79,1,-76631,62164,138795,-14467,0,0,13261,0,0,,13261,13261
23,06-02-18,80,19:45,20:00,46.98,,0,46.98,46.98,1,-86589,62799,149388,-23790,0,0,15230,0,0,,15230,15230
23,06-02-18,81,20:00,20:15,46.69,,0,46.69,46.69,1,-66995,62218,129213,-4777,0,0,10146,0,0,,10146,10146
23,06-02-18,82,20:15,20:30,42.93,,0,42.93,42.93,1,-59143,62548,121691,3405,0,0,1117,0,0,,1117,1117
23,06-02-18,83,20:30,20:45,,,0,43.69,43.69,0,-49116,69669,118785,20553,0,0,0,0,0,,0,0
23,06-02-18,84,20:45,21:00,,,0,43.69,43.69,0,-47141,83505,130646,36364,0,0,0,0,0,,0,0
23,06-02-18,85,21:00,21:15,42.93,,0,42.93,42.93,1,-53301,62948,116249,9647,0,0,175,0,0,,175,175
23,06-02-18,86,21:15,21:30,46.98,,0,46.98,46.98,1,-71459,52832,124291,-18627,0,0,5335,0,0,,5335,5335
23,06-02-18,87,21:30,21:45,45.03,,0,45.03,45.03,1,-60527,52317,112844,-8210,0,0,7006,0,0,,7006,7006
23,06-02-18,88,21:45,22:00,46.98,,0,46.98,46.98,1,-77328,47260,124588,-30068,0,0,8514,0,0,,8514,8514
23,06-02-18,89,22:00,22:15,46.98,42.78,0,42.78,42.78,-1,-16634,78945,95579,62311,0,-467,815,0,0,,1282,348
23,06-02-18,90,22:15,22:30,,44.41,0,44.41,44.41,-1,-16219,59768,75987,43549,0,-1295,0,0,0,,1295,-1295
23,06-02-18,91,22:30,22:45,,44.38,0,44.38,44.38,-1,-10656,69100,79756,58444,0,-175,0,0,0,,175,-175
23,06-02-18,92,22:45,23:00,,44.41,0,44.41,44.41,-1,-11612,88684,100296,77072,0,-56,0,0,0,,56,-56
23,06-02-18,93,23:00,23:15,42.93,38.78,0,42.93,38.78,2,-28573,34970,63543,6397,0,-407,456,0,0,,863,49
23,06-02-18,94,23:15,23:30,45.16,38.93,0,38.93,38.93,-1,-14173,47979,62152,33806,0,-1070,876,0,0,,1946,-194
23,06-02-18,95,23:30,23:45,,38.93,0,38.93,38.93,-1,-16567,76749,93316,60182,0,-1823,0,0,0,,1823,-1823
23,06-02-18,96,23:45,0:00,,37.78,0,37.78,37.78,-1,-16323,104349,120672,88026,0,-3743,0,0,0,,3743,-3743
23,06-03-18,1,0:00,0:15,,40.8,0,40.8,40.8,-1,-35465,69569,105034,34104,0,-782,0,0,0,,782,-782
23,06-03-18,2,0:15,0:30,46.44,38.4,0,46.44,38.4,2,-33020,39351,72371,6331,0,-161,606,0,0,,767,445
23,06-03-18,3,0:30,0:45,47.21,37.47,0,47.21,37.47,2,-61505,48896,110401,-12609,0,-2676,1631,0,0,,4307,-1045
23,06-03-18,4,0:45,1:00,69.02,,0,69.02,69.02,1,-94469,45386,139855,-49083,0,0,33423,0,0,,33423,33423
23,06-03-18,5,1:00,1:15,50.59,38.4,0,38.4,38.4,-1,-37116,47196,84312,10080,0,-390,21200,0,0,,21590,20810
23,06-03-18,6,1:15,1:30,50.59,38.4,0,38.4,38.4,-1,-23110,55391,78501,32281,0,-271,6,0,0,,277,-265
23,06-03-18,7,1:30,1:45,,,0,43.01,43.01,0,-13879,64270,78149,50391,0,0,0,0,0,,0,0
23,06-03-18,8,1:45,2:00,,33.93,0,33.93,33.93,-1,-10675,85480,96155,74805,0,-11380,0,0,0,,11380,-11380
23,06-03-18,9,2:00,2:15,,38.4,0,38.4,38.4,-1,-30741,35360,66101,4619,0,-6286,0,0,0,,6286,-6286
23,06-03-18,10,2:15,2:30,,,0,42.97,42.97,0,-17203,38947,56150,21744,0,-21,0,0,0,,21,-21
23,06-03-18,11,2:30,2:45,,,0,42.98,42.98,0,-16901,47180,64081,30279,0,0,0,0,0,,0,0
23,06-03-18,12,2:45,3:00,,38.4,0,38.4,38.4,-1,-7282,58826,66108,51544,0,-162,0,0,0,,162,-162
23,06-03-18,13,3:00,3:15,,43.53,0,43.53,43.53,-1,-28196,38175,66371,9979,0,-81,0,0,0,,81,-81
23,06-03-18,14,3:15,3:30,,43.53,0,43.53,43.53,-1,-14600,43313,57913,28713,0,-16,0,0,0,,16,-16
23,06-03-18,15,3:30,3:45,,39.99,0,39.99,39.99,-1,-8123,56558,64681,48435,0,-592,0,0,0,,592,-592
23,06-03-18,16,3:45,4:00,,34.43,0,34.43,34.43,-1,-7418,64608,72026,57190,0,-3931,0,0,0,,3931,-3931
23,06-03-18,17,4:00,4:15,,38.4,0,38.4,38.4,-1,-20980,42125,63105,21145,0,-2585,0,0,0,,2585,-2585
23,06-03-18,18,4:15,4:30,,,0,42.91,42.91,0,-16376,47309,63685,30933,0,0,0,0,0,,0,0
23,06-03-18,19,4:30,4:45,,43.42,0,43.42,43.42,-1,-21841,52349,74190,30508,0,-201,0,0,0,,201,-201
23,06-03-18,20,4:45,5:00,,43.43,0,43.43,43.43,-1,-22431,57041,79472,34610,0,-311,0,0,0,,311,-311
23,06-03-18,21,5:00,5:15,,43.02,0,43.02,43.02,-1,-37075,46538,83613,9463,0,-173,0,0,0,,173,-173
23,06-03-18,22,5:15,5:30,,,0,42.72,42.72,0,-20876,52557,73433,31681,0,0,0,0,0,,0,0
23,06-03-18,23,5:30,5:45,,43.06,0,43.06,43.06,-1,-14059,66235,80294,52176,0,-975,0,0,0,,975,-975
23,06-03-18,24,5:45,6:00,,37.16,0,37.16,37.16,-1,-14588,72023,86611,57435,0,-5707,0,0,0,,5707,-5707
23,06-03-18,25,6:00,6:15,,20.46,0,20.46,20.46,-1,-13261,61880,75141,48619,0,-29177,0,0,0,,29177,-29177
23,06-03-18,26,6:15,6:30,,34.54,0,34.54,34.54,-1,-21463,54367,75830,32904,0,-37817,0,0,0,,37817,-37817
23,06-03-18,27,6:30,6:45,,34.54,0,34.54,34.54,-1,-18579,52728,71307,34149,0,-33665,0,0,0,,33665,-33665
23,06-03-18,28,6:45,7:00,,34.54,0,34.54,34.54,-1,-21660,65393,87053,43733,0,-34922,0,0,0,,34922,-34922
23,06-03-18,29,7:00,7:15,,28.14,0,28.14,28.14,-1,-16809,88445,105254,71636,0,-42717,0,0,0,,42717,-42717
23,06-03-18,30,7:15,7:30,,36.98,0,36.98,36.98,-1,-13143,65299,78442,52156,0,-29284,0,0,0,,29284,-29284
23,06-03-18,31,7:30,7:45,,44.02,0,44.02,44.02,-1,-23597,59045,82642,35448,0,-4495,0,0,0,,4495,-4495
23,06-03-18,32,7:45,8:00,,34.54,0,34.54,34.54,-1,-26977,80827,107804,53850,0,-9152,0,0,0,,9152,-9152
23,06-03-18,33,8:00,8:15,,38.51,0,38.51,38.51,-1,-17831,84855,102686,67024,0,-19032,0,0,0,,19032,-19032
23,06-03-18,34,8:15,8:30,,44.5,0,44.5,44.5,-1,-18612,78634,97246,60022,0,-4772,0,0,0,,4772,-4772
23,06-03-18,35,8:30,8:45,,,0,43.5,43.5,0,-26486,77305,103791,50819,0,0,0,0,0,,0,0
23,06-03-18,36,8:45,9:00,,,0,43.49,43.49,0,-40103,90501,130604,50398,0,0,0,0,0,,0,0
23,06-03-18,37,9:00,9:15,,28.55,0,28.55,28.55,-1,-16434,113363,129797,96929,0,-17299,0,0,0,,17299,-17299
23,06-03-18,38,9:15,9:30,,38.03,0,38.03,38.03,-1,-23163,90136,113299,66973,0,-17435,0,0,0,,17435,-17435
23,06-03-18,39,9:30,9:45,,38.51,0,38.51,38.51,-1,-23193,82317,105510,59124,0,-5923,0,0,0,,5923,-5923
23,06-03-18,40,9:45,10:00,,15.7,0,15.7,15.7,-1,-16418,81256,97674,64838,0,-17680,0,0,0,,17680,-17680
23,06-03-18,41,10:00,10:15,,35.87,0,35.87,35.87,-1,-23542,87020,110562,63478,0,-25629,0,0,0,,25629,-25629
23,06-03-18,42,10:15,10:30,,38.51,0,38.51,38.51,-1,-27813,78339,106152,50526,0,-20267,0,0,0,,20267,-20267
23,06-03-18,43,10:30,10:45,,38.51,0,38.51,38.51,-1,-26853,88183,115036,61330,0,-10142,0,0,0,,10142,-10142
23,06-03-18,44,10:45,11:00,,38.51,0,38.51,38.51,-1,-24822,104767,129589,79945,0,-3217,0,0,0,,3217,-3217
23,06-03-18,45,11:00,11:15,,,0,43.36,43.36,0,-19052,116102,135154,97050,0,-464,0,0,0,,464,-464
23,06-03-18,46,11:15,11:30,,,0,43.36,43.36,0,-19453,127061,146514,107608,0,0,0,0,0,,0,0
23,06-03-18,47,11:30,11:45,,,0,43.36,43.36,0,-14914,104998,119912,90084,0,0,0,0,0,,0,0
23,06-03-18,48,11:45,12:00,,34.54,0,34.54,34.54,-1,-12395,104228,116623,91833,0,-2616,0,0,0,,2616,-2616
23,06-03-18,49,12:00,12:15,,41.61,0,41.61,41.61,-1,-25131,81894,107025,56763,0,-1301,0,0,0,,1301,-1301
23,06-03-18,50,12:15,12:30,,38.51,0,38.51,38.51,-1,-20544,86638,107182,66094,0,-432,0,0,0,,432,-432
23,06-03-18,51,12:30,12:45,,38.51,0,38.51,38.51,-1,-21056,89270,110326,68214,0,-1094,0,0,0,,1094,-1094
23,06-03-18,52,12:45,13:00,,,0,43.5,43.5,0,-19681,88932,108613,69251,0,0,0,0,0,,0,0
23,06-03-18,53,13:00,13:15,,,0,43.41,43.41,0,-32069,59007,91076,26938,0,0,0,0,0,,0,0
23,06-03-18,54,13:15,13:30,,,0,43.41,43.41,0,-36702,65509,102211,28807,0,0,0,0,0,,0,0
23,06-03-18,55,13:30,13:45,,,0,43.41,43.41,0,-32377,77035,109412,44658,0,0,0,0,0,,0,0
23,06-03-18,56,13:45,14:00,,40.21,0,40.21,40.21,-1,-44175,69413,113588,25238,0,-208,0,0,0,,208,-208
23,06-03-18,57,14:00,14:15,,21.71,0,21.71,21.71,-1,-22685,135407,158092,112722,0,-17471,0,0,0,,17471,-17471
23,06-03-18,58,14:15,14:30,,29.7,0,29.7,29.7,-1,-23022,97183,120205,74161,0,-31103,0,0,0,,31103,-31103
23,06-03-18,59,14:30,14:45,,29.7,0,29.7,29.7,-1,-27779,73326,101105,45547,0,-31308,0,0,0,,31308,-31308
23,06-03-18,60,14:45,15:00,,30.7,0,30.7,30.7,-1,-29034,71441,100475,42407,0,-33792,0,0,0,,33792,-33792
23,06-03-18,61,15:00,15:15,,43.48,0,43.48,43.48,-1,-50748,75221,125969,24473,0,-10305,0,0,0,,10305,-10305
23,06-03-18,62,15:15,15:30,,38.48,0,38.48,38.48,-1,-39842,87218,127060,47376,0,-3044,0,0,0,,3044,-3044
23,06-03-18,63,15:30,15:45,,38.03,0,38.03,38.03,-1,-42147,107924,150071,65777,0,-10946,0,0,0,,10946,-10946
23,06-03-18,64,15:45,16:00,,30.7,0,30.7,30.7,-1,-44775,119562,164337,74787,0,-11389,0,0,0,,11389,-11389
23,06-03-18,65,16:00,16:15,,34.54,0,34.54,34.54,-1,-29975,84223,114198,54248,0,-20677,0,0,0,,20677,-20677
23,06-03-18,66,16:15,16:30,,40.67,0,40.67,40.67,-1,-44855,84453,129308,39598,0,-4081,0,0,0,,4081,-4081
23,06-03-18,67,16:30,16:45,,40.13,0,40.13,40.13,-1,-52985,73997,126982,21012,0,-2329,0,0,0,,2329,-2329
23,06-03-18,68,16:45,17:00,,43.86,0,43.86,43.86,-1,-45852,63877,109729,18025,0,-271,0,0,0,,271,-271
23,06-03-18,69,17:00,17:15,,30.7,0,30.7,30.7,-1,-21809,105404,127213,83595,0,-15144,0,0,0,,15144,-15144
23,06-03-18,70,17:15,17:30,,38.51,0,38.51,38.51,-1,-17428,109163,126591,91735,0,-17276,0,0,0,,17276,-17276
23,06-03-18,71,17:30,17:45,,,0,43.48,43.48,0,-10663,87211,97874,76548,0,-805,0,0,0,,805,-805
23,06-03-18,72,17:45,18:00,,,0,43.48,43.48,0,-25357,97949,123306,72592,0,0,0,0,0,,0,0
23,06-03-18,73,18:00,18:15,,15.7,0,15.7,15.7,-1,-22450,76545,98995,54095,0,-13087,0,0,0,,13087,-13087
23,06-03-18,74,18:15,18:30,,11.1,0,11.1,11.1,-1,-9349,63257,72606,53908,0,-51724,0,0,0,,51724,-51724
23,06-03-18,75,18:30,18:45,,,0,43.48,43.48,0,-6973,50736,57709,43763,0,-5362,0,0,0,,5362,-5362
23,06-03-18,76,18:45,19:00,,,0,43.48,43.48,0,-9768,76025,85793,66257,0,0,0,0,0,,0,0
23,06-03-18,77,19:00,19:15,,38.51,0,38.51,38.51,-1,-25256,73944,99200,48688,0,-2847,0,0,0,,2847,-2847
23,06-03-18,78,19:15,19:30,,40.59,0,40.59,40.59,-1,-46719,73084,119803,26365,0,-4467,0,0,0,,4467,-4467
23,06-03-18,79,19:30,19:45,42.51,40.59,0,42.51,42.51,1,-52465,54928,107393,2463,0,-140,524,0,0,,664,384
23,06-03-18,80,19:45,20:00,46.55,,0,46.55,46.55,1,-65428,41179,106607,-24249,0,0,7580,0,0,,7580,7580
23,06-03-18,81,20:00,20:15,42.51,,0,42.51,42.51,1,-57134,53886,111020,-3248,0,0,2284,0,0,,2284,2284
23,06-03-18,82,20:15,20:30,46.55,,0,46.55,46.55,1,-71146,49094,120240,-22052,0,0,3377,0,0,,3377,3377
23,06-03-18,83,20:30,20:45,47.99,,0,47.99,47.99,1,-61575,54838,116413,-6737,0,0,8498,0,0,,8498,8498
23,06-03-18,84,20:45,21:00,42.51,,0,42.51,42.51,1,-58627,54295,112922,-4332,0,0,4376,0,0,,4376,4376
23,06-03-18,85,21:00,21:15,46.55,,0,46.55,46.55,1,-58758,30552,89310,-28206,0,0,10580,0,0,,10580,10580
23,06-03-18,86,21:15,21:30,65.7,,0,65.7,65.7,1,-74211,24628,98839,-49583,0,0,25285,0,0,,25285,25285
23,06-03-18,87,21:30,21:45,50.7,,0,50.7,50.7,1,-70016,26394,96410,-43622,0,0,32752,0,0,,32752,32752
23,06-03-18,88,21:45,22:00,50.7,,0,50.7,50.7,1,-70290,27374,97664,-42916,0,0,23589,0,0,,23589,23589
23,06-03-18,89,22:00,22:15,50.7,38.73,0,38.73,38.73,-1,-38802,57320,96122,18518,0,-534,785,0,0,,1319,251
23,06-03-18,90,22:15,22:30,55.3,,0,55.3,55.3,1,-67730,21673,89403,-46057,0,0,11946,0,0,,11946,11946
23,06-03-18,91,22:30,22:45,49.74,,0,49.74,49.74,1,-66107,23830,89937,-42277,0,0,34971,0,0,,34971,34971
23,06-03-18,92,22:45,23:00,46.02,,0,46.02,46.02,1,-52852,36542,89394,-16310,0,0,21739,0,0,,21739,21739
23,06-03-18,93,23:00,23:15,43.43,,0,43.43,43.43,1,-59075,50412,109487,-8663,0,0,1783,0,0,,1783,1783
23,06-03-18,94,23:15,23:30,,,0,43.43,43.43,0,-38039,34596,72635,-3443,0,0,13,0,0,,13,13
23,06-03-18,95,23:30,23:45,,38.51,0,38.51,38.51,-1,-16006,34879,50885,18873,0,-330,0,0,0,,330,-330
23,06-03-18,96,23:45,0:00,,38.51,0,38.51,38.51,-1,-26988,53840,80828,26852,0,-1395,0,0,0,,1395,-1395
23,06-04-18,1,0:00,0:15,310.55,38.51,0,310.55,310.55,1,-134037,24446,158483,-109591,0,-61,17257,0,0,,17318,17196
23,06-04-18,2,0:15,0:30,310.55,,0,310.55,310.55,1,-80032,31982,112014,-48050,0,0,60860,0,0,,60860,60860
23,06-04-18,3,0:30,0:45,310.55,40.59,0,40.59,40.59,-1,-39989,72320,112309,32331,0,-745,4007,0,0,,4752,3262
23,06-04-18,4,0:45,1:00,,15.7,0,15.7,15.7,-1,-46905,80428,127333,33523,0,-22536,0,0,0,,22536,-22536
23,06-04-18,5,1:00,1:15,45.34,38.7,0,45.34,38.7,2,-30875,33625,64500,2750,0,-11208,386,0,0,,11594,-10822
23,06-04-18,6,1:15,1:30,,,0,43.06,43.06,0,-18904,25926,44830,7022,0,0,9,0,0,,9,9
23,06-04-18,7,1:30,1:45,,43.44,0,43.44,43.44,-1,-16787,40425,57212,23638,0,-43,0,0,0,,43,-43
23,06-04-18,8,1:45,2:00,,34.7,0,34.7,34.7,-1,-16979,61190,78169,44211,0,-1061,0,0,0,,1061,-1061
23,06-04-18,9,2:00,2:15,,,0,42.9,42.9,0,-22952,59834,82786,36882,0,-144,0,0,0,,144,-144
23,06-04-18,10,2:15,2:30,,,0,42.91,42.91,0,-20377,48269,68646,27892,0,0,0,0,0,,0,0
23,06-04-18,11,2:30,2:45,,,0,42.91,42.91,0,-24455,46861,71316,22406,0,0,0,0,0,,0,0
23,06-04-18,12,2:45,3:00,,,0,42.91,42.91,0,-27898,49734,77632,21836,0,0,0,0,0,,0,0
23,06-04-18,13,3:00,3:15,,,0,43.02,43.02,0,-30971,33467,64438,2496,0,0,0,0,0,,0,0
23,06-04-18,14,3:15,3:30,42.7,,0,42.7,42.7,1,-34363,34334,68697,-29,0,0,5,0,0,,5,5
23,06-04-18,15,3:30,3:45,42.7,,0,42.7,42.7,1,-32277,36634,68911,4357,0,0,372,0,0,,372,372
23,06-04-18,16,3:45,4:00,42.7,,0,42.7,42.7,1,-37251,36935,74186,-316,0,0,206,0,0,,206,206
23,06-04-18,17,4:00,4:15,50.7,,0,50.7,50.7,1,-65711,38071,103782,-27640,0,0,6387,0,0,,6387,6387
23,06-04-18,18,4:15,4:30,46.7,,0,46.7,46.7,1,-49303,31809,81112,-17494,0,0,7370,0,0,,7370,7370
23,06-04-18,19,4:30,4:45,44.69,,0,44.69,44.69,1,-36795,28750,65545,-8045,0,0,5142,0,0,,5142,5142
23,06-04-18,20,4:45,5:00,47.37,,0,47.37,47.37,1,-34490,26948,61438,-7542,0,0,4302,0,0,,4302,4302
23,06-04-18,21,5:00,5:15,226.95,,0,226.95,226.95,1,-129700,55733,185433,-73967,0,0,35847,0,0,,35847,35847
23,06-04-18,22,5:15,5:30,46.7,43.14,0,43.14,43.14,-1,-46585,52305,98890,5720,0,-16,9514,0,0,,9530,9498
23,06-04-18,23,5:30,5:45,,42.12,0,42.12,42.12,-1,-43506,52096,95602,8590,0,-187,0,0,0,,187,-187
23,06-04-18,24,5:45,6:00,50.7,34.7,0,50.7,34.7,2,-61540,29046,90586,-32494,0,-535,3122,0,0,,3657,2587
23,06-04-18,25,6:00,6:15,,28.59,0,28.59,28.59,-1,-96218,112127,208345,15909,0,-13336,0,0,0,,13336,-13336
23,06-04-18,26,6:15,6:30,45.5,28.59,0,45.5,45.5,1,-59196,56431,115627,-2765,0,-1540,716,0,0,,2256,-824
23,06-04-18,27,6:30,6:45,266.85,,0,266.85,266.85,1,-78512,30575,109087,-47937,0,0,20835,0,0,,20835,20835
23,06-04-18,28,6:45,7:00,266.84,,0,266.84,266.84,1,-98362,44579,142941,-53783,0,0,72515,0,0,,72515,72515
23,06-04-18,29,7:00,7:15,266.84,-150.78,0,-150.78,-150.78,-1,-1568,179234,180802,177666,0,-18398,12605,0,0,,31003,-5793
23,06-04-18,30,7:15,7:30,,30.75,0,30.75,30.75,-1,-17829,66212,84041,48383,0,-17445,0,0,0,,17445,-17445
23,06-04-18,31,7:30,7:45,48.81,30.75,0,48.81,48.81,1,-55062,32047,87109,-23015,0,-307,1120,0,0,,1427,813
23,06-04-18,32,7:45,8:00,304.44,,0,304.44,304.44,1,-98541,25550,124091,-72991,0,0,36651,0,0,,36651,36651
23,06-04-18,33,8:00,8:15,45.11,44.25,0,44.25,44.25,-1,-47306,97795,145101,50489,0,-246,10723,0,0,,10969,10477
23,06-04-18,34,8:15,8:30,,41.78,0,41.78,41.78,-1,-44138,58095,102233,13957,0,-1627,0,0,0,,1627,-1627
23,06-04-18,35,8:30,8:45,52.8,41.78,0,52.8,52.8,1,-69387,26753,96140,-42634,0,-116,2186,0,0,,2302,2070
23,06-04-18,36,8:45,9:00,52.8,,0,52.8,52.8,1,-86773,16681,103454,-70092,0,0,8803,0,0,,8803,8803
23,06-04-18,37,9:00,9:15,52.8,39.78,0,52.8,39.78,2,-89056,60089,149145,-28967,0,-927,5811,0,0,,6738,4884
23,06-04-18,38,9:15,9:30,48.8,,0,48.8,48.8,1,-83570,59634,143204,-23936,0,0,12572,0,0,,12572,12572
23,06-04-18,39,9:30,9:45,48.83,,0,48.83,48.83,1,-64950,53096,118046,-11854,0,0,12222,0,0,,12222,12222
23,06-04-18,40,9:45,10:00,52.8,44.33,0,52.8,43.54,2,-60210,56760,116970,-3450,0,-83,767,0,0,,850,684
23,06-04-18,41,10:00,10:15,145.12,,0,145.12,145.12,1,-103268,26514,129782,-76754,0,0,18801,0,0,,18801,18801
23,06-04-18,42,10:15,10:30,48.8,,0,48.8,48.8,1,-95378,25486,120864,-69892,0,0,2129,0,0,,2129,2129
23,06-04-18,43,10:30,10:45,56.72,,0,56.72,56.72,1,-96752,26175,122927,-70577,0,0,5659,0,0,,5659,5659
23,06-04-18,44,10:45,11:00,48.75,,0,48.75,48.75,1,-102089,26955,129044,-75134,0,0,2251,0,0,,2251,2251
23,06-04-18,45,11:00,11:15,206.6,,0,206.6,206.6,1,-124171,39849,164020,-84322,0,0,14984,0,0,,14984,14984
23,06-04-18,46,11:15,11:30,51.12,,0,51.12,51.12,1,-107975,41319,149294,-66656,0,0,18610,0,0,,18610,18610
23,06-04-18,47,11:30,11:45,47.61,,0,47.61,47.61,1,-99007,40318,139325,-58689,0,0,14677,0,0,,14677,14677
23,06-04-18,48,11:45,12:00,62.27,,0,62.27,62.27,1,-108590,41299,149889,-67291,0,0,14642,0,0,,14642,14642
23,06-04-18,49,12:00,12:15,128.12,,0,128.12,128.12,1,-84413,39841,124254,-44572,0,0,22483,0,0,,22483,22483
23,06-04-18,50,12:15,12:30,50.1,,0,50.1,50.1,1,-66763,39284,106047,-27479,0,0,21907,0,0,,21907,21907
23,06-04-18,51,12:30,12:45,92.76,,0,92.76,92.76,1,-80822,42664,123486,-38158,0,0,28167,0,0,,28167,28167
23,06-04-18,52,12:45,13:00,50.1,41.78,0,41.78,41.78,-1,-45213,45955,91168,742,0,-248,17599,0,0,,17847,17351
23,06-04-18,53,13:00,13:15,88.12,41.78,0,88.12,41.78,2,-64872,40651,105523,-24221,0,-328,6649,0,0,,6977,6321
23,06-04-18,54,13:15,13:30,104.38,,0,104.38,104.38,1,-65672,38628,104300,-27044,0,0,16570,0,0,,16570,16570
23,06-04-18,55,13:30,13:45,42.75,,0,42.75,42.75,1,-54198,52688,106886,-1510,0,0,3344,0,0,,3344,3344
23,06-04-18,56,13:45,14:00,45.13,,0,45.13,45.13,1,-58586,68276,126862,9690,0,0,3038,0,0,,3038,3038
23,06-04-18,57,14:00,14:15,42.75,,0,42.75,42.75,1,-57248,57347,114595,99,0,0,534,0,0,,534,534
23,06-04-18,58,14:15,14:30,44.73,,0,44.73,44.73,1,-55466,63239,118705,7773,0,0,2940,0,0,,2940,2940
23,06-04-18,59,14:30,14:45,42.75,,0,42.75,42.75,1,-49529,65440,114969,15911,0,0,438,0,0,,438,438
23,06-04-18,60,14:45,15:00,42.75,,0,42.75,42.75,1,-50343,68408,118751,18065,0,0,116,0,0,,116,116
23,06-04-18,61,15:00,15:15,,,0,43.48,43.48,0,-37084,64571,101655,27487,0,0,0,0,0,,0,0
23,06-04-18,62,15:15,15:30,,,0,43.48,43.48,0,-37838,69588,107426,31750,0,0,0,0,0,,0,0
23,06-04-18,63,15:30,15:45,42.75,,0,42.75,42.75,1,-62738,65193,127931,2455,0,0,790,0,0,,790,790
23,06-04-18,64,15:45,16:00,42.75,,0,42.75,42.75,1,-69187,67179,136366,-2008,0,0,1845,0,0,,1845,1845
23,06-04-18,65,16:00,16:15,42.75,,0,42.75,42.75,1,-40982,47514,88496,6532,0,0,441,0,0,,441,441
23,06-04-18,66,16:15,16:30,42.75,,0,42.75,42.75,1,-39909,33223,73132,-6686,0,0,445,0,0,,445,445
23,06-04-18,67,16:30,16:45,42.75,44.31,0,43.53,43.53,2,-45163,37441,82604,-7722,0,-29,43,0,0,,72,14
23,06-04-18,68,16:45,17:00,45.08,,0,45.08,45.08,1,-72403,38465,110868,-33938,0,0,2534,0,0,,2534,2534
23,06-04-18,69,17:00,17:15,55,,0,55,55,1,-111473,30893,142366,-80580,0,0,10487,0,0,,10487,10487
23,06-04-18,70,17:15,17:30,267.35,,0,267.35,267.35,1,-120295,26573,146868,-93722,0,0,20874,0,0,,20874,20874
23,06-04-18,71,17:30,17:45,267.35,,0,267.35,267.35,1,-109130,31655,140785,-77475,0,0,74653,0,0,,74653,74653
23,06-04-18,72,17:45,18:00,75,44.35,0,75,43.62,2,-46088,47929,94017,1841,0,-63,25011,0,0,,25074,24948
23,06-04-18,73,18:00,18:15,48.8,,0,48.8,48.8,1,-82543,37440,119983,-45103,0,0,3143,0,0,,3143,3143
23,06-04-18,74,18:15,18:30,42.75,,0,42.75,42.75,1,-66278,50745,117023,-15533,0,0,2581,0,0,,2581,2581
23,06-04-18,75,18:30,18:45,,,0,43.62,43.62,0,-58017,68103,126120,10086,0,0,0,0,0,,0,0
23,06-04-18,76,18:45,19:00,,,0,43.62,43.62,0,-62936,68568,131504,5632,0,0,0,0,0,,0,0
23,06-04-18,77,19:00,19:15,,38.78,0,38.78,38.78,-1,-65926,94343,160269,28417,0,-1509,0,0,0,,1509,-1509
23,06-04-18,78,19:15,19:30,,38.78,0,38.78,38.78,-1,-63068,92789,155857,29721,0,-3080,0,0,0,,3080,-3080
23,06-04-18,79,19:30,19:45,,44.3,0,44.3,44.3,-1,-74989,78434,153423,3445,0,-1594,0,0,0,,1594,-1594
23,06-04-18,80,19:45,20:00,52.8,44.3,0,52.8,52.8,1,-90504,75090,165594,-15414,0,-55,6578,0,0,,6633,6523
23,06-04-18,81,20:00,20:15,48.8,,0,48.8,48.8,1,-81633,62875,144508,-18758,0,0,13682,0,0,,13682,13682
23,06-04-18,82,20:15,20:30,52.8,,0,52.8,52.8,1,-85934,62007,147941,-23927,0,0,12066,0,0,,12066,12066
23,06-04-18,83,20:30,20:45,47.32,,0,47.32,47.32,1,-82947,62364,145311,-20583,0,0,16248,0,0,,16248,16248
23,06-04-18,84,20:45,21:00,45.36,,0,45.36,45.36,1,-76178,72864,149042,-3314,0,0,6857,0,0,,6857,6857
23,06-04-18,85,21:00,21:15,250.69,,0,250.69,250.69,1,-114478,37670,152148,-76808,0,0,30990,0,0,,30990,30990
23,06-04-18,86,21:15,21:30,125.81,,0,125.81,125.81,1,-77315,49132,126447,-28183,0,0,44150,0,0,,44150,44150
23,06-04-18,87,21:30,21:45,42.75,,0,42.75,42.75,1,-63318,55087,118405,-8231,0,0,4092,0,0,,4092,4092
23,06-04-18,88,21:45,22:00,48.8,,0,48.8,48.8,1,-71845,50730,122575,-21115,0,0,10234,0,0,,10234,10234
23,06-04-18,89,22:00,22:15,,,0,43.55,43.55,0,-66882,42153,109035,-24729,0,0,1606,0,0,,1606,1606
23,06-04-18,90,22:15,22:30,,,0,43.55,43.55,0,-72977,32817,105794,-40160,0,0,0,0,0,,0,0
23,06-04-18,91,22:30,22:45,,,0,43.56,43.56,0,-40957,40643,81600,-314,0,0,0,0,0,,0,0
23,06-04-18,92,22:45,23:00,,38.75,0,38.75,38.75,-1,-18886,58379,77265,39493,0,-2049,0,0,0,,2049,-2049
23,06-04-18,93,23:00,23:15,214.18,34.75,0,214.18,214.18,1,-93178,40370,133548,-52808,0,-1894,14336,0,0,,16230,12442
23,06-04-18,94,23:15,23:30,214.18,,0,214.18,214.18,1,-76263,37918,114181,-38345,0,0,31801,0,0,,31801,31801
23,06-04-18,95,23:30,23:45,214.18,44.11,0,44.11,44.11,-1,-49252,60940,110192,11688,0,-19,125,0,0,,144,106
23,06-04-18,96,23:45,0:00,,35.78,0,35.78,35.78,-1,-39320,62797,102117,23477,0,-6314,0,0,0,,6314,-6314
23,06-05-18,1,0:00,0:15,44.86,38.57,0,44.86,38.57,2,-79205,53698,132903,-25507,0,-425,572,0,0,,997,147
23,06-05-18,2,0:15,0:30,44.86,,0,44.86,44.86,1,-66923,42045,108968,-24878,0,0,1395,0,0,,1395,1395
23,06-05-18,3,0:30,0:45,42.57,,0,42.57,42.57,1,-49923,49797,99720,-126,0,0,468,0,0,,468,468
23,06-05-18,4,0:45,1:00,,,0,43.5,43.5,0,-76992,53241,130233,-23751,0,0,0,0,0,,0,0
23,06-05-18,5,1:00,1:15,350.02,,0,350.02,350.02,1,-94038,30609,124647,-63429,0,0,12187,0,0,,12187,12187
23,06-05-18,6,1:15,1:30,210.45,,0,210.45,210.45,1,-78231,56686,134917,-21545,0,0,49131,0,0,,49131,49131
23,06-05-18,7,1:30,1:45,210.45,43.44,0,43.44,43.44,-1,-52977,70832,123809,17855,0,-90,855,0,0,,945,765
23,06-05-18,8,1:45,2:00,,,0,26.73,26.73,0,-48673,72860,121533,24187,0,0,0,0,0,,0,0
23,06-05-18,9,2:00,2:15,49.66,,0,49.66,49.66,1,-67489,54125,121614,-13364,0,0,2316,0,0,,2316,2316
23,06-05-18,10,2:15,2:30,49.66,,0,49.66,49.66,1,-63359,61048,124407,-2311,0,0,5627,0,0,,5627,5627
23,06-05-18,11,2:30,2:45,,,0,42.65,42.65,0,-45387,56943,102330,11556,0,0,32,0,0,,32,32
23,06-05-18,12,2:45,3:00,42.57,,0,42.57,42.57,1,-47175,62136,109311,14961,0,0,18,0,0,,18,18
23,06-05-18,13,3:00,3:15,53.92,,0,53.92,53.92,1,-66678,45958,112636,-20720,0,0,8837,0,0,,8837,8837
23,06-05-18,14,3:15,3:30,43.02,,0,43.02,43.02,1,-58934,49877,108811,-9057,0,0,5212,0,0,,5212,5212
23,06-05-18,15,3:30,3:45,42.57,,0,42.57,42.57,1,-57152,50133,107285,-7019,0,0,1892,0,0,,1892,1892
23,06-05-18,16,3:45,4:00,67.8,,0,67.8,67.8,1,-62237,52856,115093,-9381,0,0,13630,0,0,,13630,13630
23,06-05-18,17,4:00,4:15,,,0,42.86,42.86,0,-63141,58438,121579,-4703,0,0,1410,0,0,,1410,1410
23,06-05-18,18,4:15,4:30,,,0,42.86,42.86,0,-40854,53916,94770,13062,0,0,0,0,0,,0,0
23,06-05-18,19,4:30,4:45,,,0,42.86,42.86,0,-41829,44927,86756,3098,0,0,0,0,0,,0,0
23,06-05-18,20,4:45,5:00,45.28,,0,45.28,45.28,1,-44448,40017,84465,-4431,0,0,413,0,0,,413,413
23,06-05-18,21,5:00,5:15,45.28,30.68,0,30.68,30.68,-1,-42143,70452,112595,28309,0,-4857,155,0,0,,5012,-4702
23,06-05-18,22,5:15,5:30,,28.71,0,28.71,28.71,-1,-25889,60799,86688,34910,0,-16290,0,0,0,,16290,-16290
23,06-05-18,23,5:30,5:45,,35.03,0,35.03,35.03,-1,-26760,38187,64947,11427,0,-12298,0,0,0,,12298,-12298
23,06-05-18,24,5:45,6:00,42.57,35.03,0,42.57,42.57,1,-42108,39541,81649,-2567,0,-777,171,0,0,,948,-606
23,06-05-18,25,6:00,6:15,42.57,-150.03,0,-150.03,-150.03,-1,-59551,134280,193831,74729,0,-19804,51,0,0,,19855,-19753
23,06-05-18,26,6:15,6:30,,11.03,0,11.03,11.03,-1,-43238,84834,128072,41596,0,-34929,0,0,0,,34929,-34929
23,06-05-18,27,6:30,6:45,53.53,11.03,0,53.53,53.53,1,-69796,49865,119661,-19931,0,-4593,4332,0,0,,8925,-261
23,06-05-18,28,6:45,7:00,49.66,,0,49.66,49.66,1,-91790,56192,147982,-35598,0,0,14356,0,0,,14356,14356
23,06-05-18,29,7:00,7:15,49.66,44.57,0,44.57,44.57,-1,-87824,123465,211289,35641,0,-110,3509,0,0,,3619,3399
23,06-05-18,30,7:15,7:30,43.62,44.57,0,43.62,43.62,1,-48972,52592,101564,3620,0,-16,29,0,0,,45,13
23,06-05-18,31,7:30,7:45,121.02,,0,121.02,121.02,1,-55691,18077,73768,-37614,0,0,17717,0,0,,17717,17717
23,06-05-18,32,7:45,8:00,79.02,,0,79.02,79.02,1,-79713,44763,124476,-34950,0,0,35172,0,0,,35172,35172
23,06-05-18,33,8:00,8:15,68.53,39.62,0,68.53,39.62,2,-40317,100957,141274,60640,0,-918,7224,0,0,,8142,6306
23,06-05-18,34,8:15,8:30,308.47,,0,339.32,339.32,1,-202360,103306,305666,-99054,0,0,44096,0,12500,,56596,56596
23,06-05-18,35,8:30,8:45,68.53,,0,266.28,266.28,1,-191787,142032,333819,-49755,0,0,26228,0,12500,,38728,38728
23,06-05-18,36,8:45,9:00,145.02,,0,145.02,145.02,1,-151794,88350,240144,-63444,0,0,31830,0,0,,31830,31830
23,06-05-18,37,9:00,9:15,253.64,,0,253.64,253.64,1,-133396,57006,190402,-76390,0,0,56774,0,0,,56774,56774
23,06-05-18,38,9:15,9:30,127.29,,0,127.29,127.29,1,-132492,65527,198019,-66965,0,0,52934,0,0,,52934,52934
23,06-05-18,39,9:30,9:45,106.02,,0,106.02,106.02,1,-147211,75332,222543,-71879,0,0,53098,0,0,,53098,53098
23,06-05-18,40,9:45,10:00,164.85,,0,164.85,164.85,1,-149213,82344,231557,-66869,0,0,55771,0,0,,55771,55771
23,06-05-18,41,10:00,10:15,265.02,,0,265.02,265.02,1,-150777,63871,214648,-86906,0,0,70927,0,0,,70927,70927
23,06-05-18,42,10:15,10:30,381.22,,0,381.22,381.22,1,-147456,67344,214800,-80112,0,0,74572,5000,0,,79572,79572
23,06-05-18,43,10:30,10:45,381.22,,0,381.22,381.22,1,-148567,77075,225642,-71492,0,0,69580,5000,0,,74580,74580
23,06-05-18,44,10:45,11:00,381.22,,0,381.22,381.22,1,-148202,85477,233679,-62725,0,0,57193,5000,0,,62193,62193
23,06-05-18,45,11:00,11:15,378.62,,0,378.62,378.62,1,-148265,72719,220984,-75546,0,0,58176,5000,0,,63176,63176
23,06-05-18,46,11:15,11:30,378.62,,0,378.62,378.62,1,-141314,77147,218461,-64167,0,0,58326,5000,0,,63326,63326
23,06-05-18,47,11:30,11:45,378.62,,0,378.62,378.62,1,-123726,81712,205438,-42014,0,0,51103,5000,0,,56103,56103
23,06-05-18,48,11:45,12:00,378.62,,0,378.62,378.62,1,-102139,82173,184312,-19966,0,0,15013,5000,0,,20013,20013
23,06-05-18,49,12:00,12:15,181.02,,0,181.02,181.02,1,-122225,77845,200070,-44380,0,0,21067,0,0,,21067,21067
23,06-05-18,50,12:15,12:30,78.02,,0,78.02,78.02,1,-120144,82425,202569,-37719,0,0,41504,0,0,,41504,41504
23,06-05-18,51,12:30,12:45,53.53,,0,53.53,53.53,1,-101005,85613,186618,-15392,0,0,25403,0,0,,25403,25403
23,06-05-18,52,12:45,13:00,53.53,,0,53.53,53.53,1,-103957,82622,186579,-21335,0,0,8761,0,0,,8761,8761
23,06-05-18,53,13:00,13:15,309.3,,0,309.3,309.3,1,-133798,74359,208157,-59439,0,0,36019,0,0,,36019,36019
23,06-05-18,54,13:15,13:30,100.02,,0,100.02,100.02,1,-114828,79173,194001,-35655,0,0,47473,0,0,,47473,47473
23,06-05-18,55,13:30,13:45,68.53,,0,68.53,68.53,1,-110728,83115,193843,-27613,0,0,17285,0,0,,17285,17285
23,06-05-18,56,13:45,14:00,106.02,44.48,0,106.02,44.05,2,-119611,91933,211544,-27678,0,-3,29742,0,0,,29745,29739
23,06-05-18,57,14:00,14:15,68.53,16.62,0,68.53,16.62,2,-82135,85709,167844,3574,0,-2566,7696,0,0,,10262,5130
23,06-05-18,58,14:15,14:30,118.53,,0,118.53,118.53,1,-90645,94137,184782,3492,0,0,22615,0,0,,22615,22615
23,06-05-18,59,14:30,14:45,118.53,35.62,0,35.62,35.62,-1,-82806,113012,195818,30206,0,-805,1569,0,0,,2374,764
23,06-05-18,60,14:45,15:00,,29.28,0,29.28,29.28,-1,-84109,118909,203018,34800,0,-4261,0,0,0,,4261,-4261
23,06-05-18,61,15:00,15:15,,16.62,0,16.62,16.62,-1,-52843,93990,146833,41147,0,-13110,0,0,0,,13110,-13110
23,06-05-18,62,15:15,15:30,,,0,43.98,43.98,0,-66735,86636,153371,19901,0,-345,0,0,0,,345,-345
23,06-05-18,63,15:30,15:45,43.62,,0,43.62,43.62,1,-75802,82585,158387,6783,0,0,64,0,0,,64,64
23,06-05-18,64,15:45,16:00,43.62,,0,43.62,43.62,1,-76021,84659,160680,8638,0,0,841,0,0,,841,841
23,06-05-18,65,16:00,16:15,,35.62,0,35.62,35.62,-1,-106199,220610,326809,114411,0,-1426,0,0,0,,1426,-1426
23,06-05-18,66,16:15,16:30,,15.03,0,15.03,15.03,-1,-97089,225853,322942,128764,0,-21700,0,0,0,,21700,-21700
23,06-05-18,67,16:30,16:45,,-33.38,0,-33.38,-33.38,-1,-94879,209896,304775,115017,0,-42409,0,0,0,,42409,-42409
23,06-05-18,68,16:45,17:00,,16.62,0,16.62,16.62,-1,-117828,183011,300839,65183,0,-57606,0,0,0,,57606,-57606
23,06-05-18,69,17:00,17:15,,9.42,0,9.42,9.42,-1,-96039,173378,269417,77339,0,-42069,0,0,0,,42069,-42069
23,06-05-18,70,17:15,17:30,,28.39,0,28.39,28.39,-1,-96489,181021,277510,84532,0,-4917,0,0,0,,4917,-4917
23,06-05-18,71,17:30,17:45,,16.62,0,16.62,16.62,-1,-94684,181508,276192,86824,0,-8523,0,0,0,,8523,-8523
23,06-05-18,72,17:45,18:00,,35.62,0,35.62,35.62,-1,-101740,190803,292543,89063,0,-1486,0,0,0,,1486,-1486
23,06-05-18,73,18:00,18:15,,-10.03,0,-10.03,-10.03,-1,-50826,96547,147373,45721,0,-31271,0,0,0,,31271,-31271
23,06-05-18,74,18:15,18:30,,30.5,0,30.5,30.5,-1,-54117,106448,160565,52331,0,-34078,0,0,0,,34078,-34078
23,06-05-18,75,18:30,18:45,,31.62,0,31.62,31.62,-1,-49134,120896,170030,71762,0,-26457,0,0,0,,26457,-26457
23,06-05-18,76,18:45,19:00,,39.62,0,39.62,39.62,-1,-49723,114896,164619,65173,0,-11607,0,0,0,,11607,-11607
23,06-05-18,77,19:00,19:15,,35.62,0,35.62,35.62,-1,-72600,100812,173412,28212,0,-3512,0,0,0,,3512,-3512
23,06-05-18,78,19:15,19:30,,39.62,0,39.62,39.62,-1,-85130,98095,183225,12965,0,-4682,0,0,0,,4682,-4682
23,06-05-18,79,19:30,19:45,,,0,44.11,44.11,0,-88832,91560,180392,2728,0,-352,0,0,0,,352,-352
23,06-05-18,80,19:45,20:00,49.53,,0,49.53,49.53,1,-90169,80815,170984,-9354,0,0,2161,0,0,,2161,2161
23,06-05-18,81,20:00,20:15,53.53,,0,53.53,53.53,1,-87160,71403,158563,-15757,0,0,10855,0,0,,10855,10855
23,06-05-18,82,20:15,20:30,45.61,,0,45.61,45.61,1,-79200,69217,148417,-9983,0,0,4797,0,0,,4797,4797
23,06-05-18,83,20:30,20:45,43.62,,0,43.62,43.62,1,-64571,75178,139749,10607,0,0,3101,0,0,,3101,3101
23,06-05-18,84,20:45,21:00,,,0,44.1,44.1,0,-60234,100069,160303,39835,0,0,0,0,0,,0,0
23,06-05-18,85,21:00,21:15,,,0,43.88,43.88,0,-53896,82806,136702,28910,0,0,0,0,0,,0,0
23,06-05-18,86,21:15,21:30,,28.01,0,28.01,28.01,-1,-31293,89242,120535,57949,0,-3295,0,0,0,,3295,-3295
23,06-05-18,87,21:30,21:45,,26.33,0,26.33,26.33,-1,-14303,105887,120190,91584,0,-12116,0,0,0,,12116,-12116
23,06-05-18,88,21:45,22:00,,-33.38,0,-33.38,-33.38,-1,-13723,135536,149259,121813,0,-25814,0,0,0,,25814,-25814
23,06-05-18,89,22:00,22:15,,-33.38,0,-33.38,-33.38,-1,-22054,94007,116061,71953,0,-50599,0,0,0,,50599,-50599
23,06-05-18,90,22:15,22:30,,31.62,0,31.62,31.62,-1,-25462,78493,103955,53031,0,-30686,0,0,0,,30686,-30686
23,06-05-18,91,22:30,22:45,,27.85,0,27.85,27.85,-1,-27487,103376,130863,75889,0,-34824,0,0,0,,34824,-34824
23,06-05-18,92,22:45,23:00,,-33.38,0,-33.38,-33.38,-1,-27611,126553,154164,98942,0,-49449,0,0,0,,49449,-49449
23,06-05-18,93,23:00,23:15,53.53,21.18,0,53.53,53.53,1,-58315,39364,97679,-18951,0,-27488,938,0,0,,28426,-26550
23,06-05-18,94,23:15,23:30,53.53,29.12,0,29.12,29.12,-1,-37890,76109,113999,38219,0,-4890,301,0,0,,5191,-4589
23,06-05-18,95,23:30,23:45,,26.46,0,26.46,26.46,-1,-23176,96852,120028,73676,0,-21864,0,0,0,,21864,-21864
23,06-05-18,96,23:45,0:00,,-33.38,0,-33.38,-33.38,-1,-25531,119396,144927,93865,0,-46608,0,0,0,,46608,-46608
23,06-06-18,1,0:00,0:15,,24.48,0,24.48,24.48,-1,-21590,82069,103659,60479,0,-27929,0,0,0,,27929,-27929
23,06-06-18,2,0:15,0:30,,-150.78,0,-150.78,-150.78,-1,-15519,94253,109772,78734,0,-32448,0,0,0,,32448,-32448
23,06-06-18,3,0:30,0:45,,-150.78,0,-150.78,-150.78,-1,-38039,68660,106699,30621,0,-48769,0,0,0,,48769,-48769
23,06-06-18,4,0:45,1:00,,-150.78,0,-150.78,-150.78,-1,-24386,107442,131828,83056,0,-46974,0,0,0,,46974,-46974
23,06-06-18,5,1:00,1:15,,-150.78,0,-150.78,-150.78,-1,-25184,120555,145739,95371,0,-51469,0,0,0,,51469,-51469
23,06-06-18,6,1:15,1:30,45.22,25.99,0,45.22,25.99,2,-26957,76641,103598,49684,0,-3120,46,0,0,,3166,-3074
23,06-06-18,7,1:30,1:45,,17.08,0,17.08,17.08,-1,-29516,115799,145315,86283,0,-14577,0,0,0,,14577,-14577
23,06-06-18,8,1:45,2:00,,7.78,0,7.78,7.78,-1,-35993,96159,132152,60166,0,-42270,0,0,0,,42270,-42270
23,06-06-18,9,2:00,2:15,,39.78,0,39.78,39.78,-1,-55499,56148,111647,649,0,-20673,0,0,0,,20673,-20673
23,06-06-18,10,2:15,2:30,44.08,,0,44.08,44.08,1,-56843,52955,109798,-3888,0,0,220,0,0,,220,220
23,06-06-18,11,2:30,2:45,44.08,,0,44.08,44.08,1,-59175,58506,117681,-669,0,0,567,0,0,,567,567
23,06-06-18,12,2:45,3:00,,36.08,0,36.08,36.08,-1,-47403,69920,117323,22517,0,-4179,0,0,0,,4179,-4179
23,06-06-18,13,3:00,3:15,,40.08,0,40.08,40.08,-1,-64017,59002,123019,-5015,0,-1039,0,0,0,,1039,-1039
23,06-06-18,14,3:15,3:30,,30.86,0,30.86,30.86,-1,-49610,59535,109145,9925,0,-1413,0,0,0,,1413,-1413
23,06-06-18,15,3:30,3:45,,28.04,0,28.04,28.04,-1,-41803,65984,107787,24181,0,-17530,0,0,0,,17530,-17530
23,06-06-18,16,3:45,4:00,46.11,36.08,0,46.11,46.11,1,-57967,72368,130335,14401,0,-9952,510,0,0,,10462,-9442
23,06-06-18,17,4:00,4:15,46.11,40.08,0,40.08,40.08,-1,-49184,52679,101863,3495,0,-185,45,0,0,,230,-140
23,06-06-18,18,4:15,4:30,,40.08,0,40.08,40.08,-1,-38653,53356,92009,14703,0,-545,0,0,0,,545,-545
23,06-06-18,19,4:30,4:45,,36.08,0,36.08,36.08,-1,-19050,54120,73170,35070,0,-3330,0,0,0,,3330,-3330
23,06-06-18,20,4:45,5:00,,40.08,0,40.08,40.08,-1,-18099,59362,77461,41263,0,-1566,0,0,0,,1566,-1566
23,06-06-18,21,5:00,5:15,,-150.78,0,-150.78,-150.78,-1,-18377,89294,107671,70917,0,-22984,0,0,0,,22984,-22984
23,06-06-18,22,5:15,5:30,,31.02,0,31.02,31.02,-1,-12190,86846,99036,74656,0,-24154,0,0,0,,24154,-24154
23,06-06-18,23,5:30,5:45,,17.08,0,17.08,17.08,-1,-18775,62103,80878,43328,0,-36599,0,0,0,,36599,-36599
23,06-06-18,24,5:45,6:00,,32.08,0,32.08,32.08,-1,-28780,57138,85918,28358,0,-19714,0,0,0,,19714,-19714
23,06-06-18,25,6:00,6:15,,-150.78,0,-150.78,-150.78,-1,-28377,155627,184004,127250,0,-22747,0,0,0,,22747,-22747
23,06-06-18,26,6:15,6:30,,16.46,0,16.46,16.46,-1,-9350,93740,103090,84390,0,-33090,0,0,0,,33090,-33090
23,06-06-18,27,6:30,6:45,43.46,16.46,0,43.46,43.46,1,-19635,40718,60353,21083,0,-4096,3,0,0,,4099,-4093
23,06-06-18,28,6:45,7:00,49.66,,0,49.66,49.66,1,-53171,31977,85148,-21194,0,0,5800,0,0,,5800,5800
23,06-06-18,29,7:00,7:15,49.66,-150.78,0,-150.78,-150.78,-1,-21535,185668,207203,164133,0,-33811,1155,0,0,,34966,-32656
23,06-06-18,30,7:15,7:30,,-209.68,0,-209.68,-209.68,-1,-30916,110615,141531,79699,-21250,-82709,0,0,0,,103959,-103959
23,06-06-18,31,7:30,7:45,45.77,29.27,0,45.77,29.27,2,-40509,72704,113213,32195,0,-11425,62,0,0,,11487,-11363
23,06-06-18,32,7:45,8:00,,31.46,0,31.46,31.46,-1,-47249,81584,128833,34335,0,-2842,0,0,0,,2842,-2842
23,06-06-18,33,8:00,8:15,,-150.78,0,-150.78,-150.78,-1,-49819,130473,180292,80654,0,-24065,0,0,0,,24065,-24065
23,06-06-18,34,8:15,8:30,,35.46,0,35.46,35.46,-1,-50189,117730,167919,67541,0,-14383,0,0,0,,14383,-14383
23,06-06-18,35,8:30,8:45,,44.53,0,44.53,44.53,-1,-46993,106396,153389,59403,0,-2392,0,0,0,,2392,-2392
23,06-06-18,36,8:45,9:00,,30.24,0,30.24,30.24,-1,-46470,105835,152305,59365,0,-4545,0,0,0,,4545,-4545
23,06-06-18,37,9:00,9:15,,35.46,0,35.46,35.46,-1,-66700,80054,146754,13354,0,-3994,0,0,0,,3994,-3994
23,06-06-18,38,9:15,9:30,,31.46,0,31.46,31.46,-1,-60611,86998,147609,26387,0,-7351,0,0,0,,7351,-7351
23,06-06-18,39,9:30,9:45,,31.46,0,31.46,31.46,-1,-65708,96345,162053,30637,0,-20352,0,0,0,,20352,-20352
23,06-06-18,40,9:45,10:00,,29.9,0,29.9,29.9,-1,-56269,98205,154474,41936,0,-26853,0,0,0,,26853,-26853
23,06-06-18,41,10:00,10:15,46.16,41.02,0,46.16,41.02,2,-67009,64720,131729,-2289,0,-9378,334,0,0,,9712,-9044
23,06-06-18,42,10:15,10:30,,39.46,0,39.46,39.46,-1,-62643,74589,137232,11946,0,-1190,0,0,0,,1190,-1190
23,06-06-18,43,10:30,10:45,,41.78,0,41.78,41.78,-1,-80384,80055,160439,-329,0,-987,0,0,0,,987,-987
23,06-06-18,44,10:45,11:00,,42.78,0,42.78,42.78,-1,-76114,93461,169575,17347,0,-1552,0,0,0,,1552,-1552
23,06-06-18,45,11:00,11:15,,,0,43.99,43.99,0,-95475,88961,184436,-6514,0,-163,0,0,0,,163,-163
23,06-06-18,46,11:15,11:30,,44.51,0,44.51,44.51,-1,-94744,88857,183601,-5887,0,-16,0,0,0,,16,-16
23,06-06-18,47,11:30,11:45,,39.46,0,39.46,39.46,-1,-84466,96475,180941,12009,0,-992,0,0,0,,992,-992
23,06-06-18,48,11:45,12:00,,44.53,0,44.53,44.53,-1,-67935,99135,167070,31200,0,-570,0,0,0,,570,-570
23,06-06-18,49,12:00,12:15,,39.46,0,39.46,39.46,-1,-68462,105412,173874,36950,0,-1505,0,0,0,,1505,-1505
23,06-06-18,50,12:15,12:30,,30.69,0,30.69,30.69,-1,-57138,104988,162126,47850,0,-16274,0,0,0,,16274,-16274
23,06-06-18,51,12:30,12:45,,35.78,0,35.78,35.78,-1,-57898,109217,167115,51319,0,-13317,0,0,0,,13317,-13317
23,06-06-18,52,12:45,13:00,,,0,44,44,0,-51888,125153,177041,73265,0,-84,0,0,0,,84,-84
23,06-06-18,53,13:00,13:15,,,0,43.98,43.98,0,-42679,119590,162269,76911,0,0,0,0,0,,0,0
23,06-06-18,54,13:15,13:30,,,0,43.98,43.98,0,-58484,99152,157636,40668,0,0,0,0,0,,0,0
23,06-06-18,55,13:30,13:45,,39.46,0,39.46,39.46,-1,-69708,97269,166977,27561,0,-534,0,0,0,,534,-534
23,06-06-18,56,13:45,14:00,,37.78,0,37.78,37.78,-1,-65546,94686,160232,29140,0,-7134,0,0,0,,7134,-7134
23,06-06-18,57,14:00,14:15,,43.78,0,43.78,43.78,-1,-49913,73591,123504,23678,0,-2767,0,0,0,,2767,-2767
23,06-06-18,58,14:15,14:30,,,0,43.79,43.79,0,-41273,71141,112414,29868,0,0,0,0,0,,0,0
23,06-06-18,59,14:30,14:45,,,0,43.81,43.81,0,-51411,77951,129362,26540,0,0,0,0,0,,0,0
23,06-06-18,60,14:45,15:00,,35.46,0,35.46,35.46,-1,-61237,78853,140090,17616,0,-440,0,0,0,,440,-440
23,06-06-18,61,15:00,15:15,,11.96,0,11.96,11.96,-1,-34563,93021,127584,58458,0,-23182,0,0,0,,23182,-23182
23,06-06-18,62,15:15,15:30,,31.46,0,31.46,31.46,-1,-35286,73576,108862,38290,0,-29290,0,0,0,,29290,-29290
23,06-06-18,63,15:30,15:45,,39.46,0,39.46,39.46,-1,-44918,67498,112416,22580,0,-11072,0,0,0,,11072,-11072
23,06-06-18,64,15:45,16:00,,39.46,0,39.46,39.46,-1,-55727,66885,122612,11158,0,-3327,0,0,0,,3327,-3327
23,06-06-18,65,16:00,16:15,,39.46,0,39.46,39.46,-1,-58728,65023,123751,6295,0,-2042,0,0,0,,2042,-2042
23,06-06-18,66,16:15,16:30,43.46,,0,43.46,43.46,1,-53414,53403,106817,-11,0,0,1210,0,0,,1210,1210
23,06-06-18,67,16:30,16:45,45.88,,0,45.88,45.88,1,-56811,57786,114597,975,0,0,3798,0,0,,3798,3798
23,06-06-18,68,16:45,17:00,47.2,,0,47.2,47.2,1,-58574,44064,102638,-14510,0,0,4973,0,0,,4973,4973
23,06-06-18,69,17:00,17:15,43.46,,0,43.46,43.46,1,-71803,60014,131817,-11789,0,0,3223,0,0,,3223,3223
23,06-06-18,70,17:15,17:30,153.12,,0,153.12,153.12,1,-80726,39859,120585,-40867,0,0,14294,0,0,,14294,14294
23,06-06-18,71,17:30,17:45,53.53,,0,53.53,53.53,1,-55479,41190,96669,-14289,0,0,22801,0,0,,22801,22801
23,06-06-18,72,17:45,18:00,47.31,,0,47.31,47.31,1,-63856,51069,114925,-12787,0,0,6136,0,0,,6136,6136
23,06-06-18,73,18:00,18:15,43.46,,0,43.46,43.46,1,-39499,42187,81686,2688,0,0,1071,0,0,,1071,1071
23,06-06-18,74,18:15,18:30,,,0,43.97,43.97,0,-21134,43243,64377,22109,0,0,0,0,0,,0,0
23,06-06-18,75,18:30,18:45,43.46,,0,43.46,43.46,1,-52193,44874,97067,-7319,0,0,509,0,0,,509,509
23,06-06-18,76,18:45,19:00,43.46,,0,43.46,43.46,1,-45168,43973,89141,-1195,0,0,3168,0,0,,3168,3168
23,06-06-18,77,19:00,19:15,43.46,,0,43.46,43.46,1,-63190,64176,127366,986,0,0,2553,0,0,,2553,2553
23,06-06-18,78,19:15,19:30,45.76,,0,45.76,45.76,1,-57603,52398,110001,-5205,0,0,1075,0,0,,1075,1075
23,06-06-18,79,19:30,19:45,43.46,,0,43.46,43.46,1,-62397,49599,111996,-12798,0,0,588,0,0,,588,588
23,06-06-18,80,19:45,20:00,46.31,,0,46.31,46.31,1,-86626,43883,130509,-42743,0,0,4603,0,0,,4603,4603
23,06-06-18,81,20:00,20:15,128.12,,0,128.12,128.12,1,-76736,30941,107677,-45795,0,0,19452,0,0,,19452,19452
23,06-06-18,82,20:15,20:30,55.99,,0,55.99,55.99,1,-62153,42800,104953,-19353,0,0,32163,0,0,,32163,32163
23,06-06-18,83,20:30,20:45,55.99,44.11,0,44.11,44.11,-1,-51965,49526,101491,-2439,0,-159,4075,0,0,,4234,3916
23,06-06-18,84,20:45,21:00,45.83,,0,45.83,45.83,1,-55418,55281,110699,-137,0,0,389,0,0,,389,389
23,06-06-18,85,21:00,21:15,118.53,,0,118.53,118.53,1,-81157,36734,117891,-44423,0,0,25396,0,0,,25396,25396
23,06-06-18,86,21:15,21:30,68.53,,0,68.53,68.53,1,-85388,36123,121511,-49265,0,0,40407,0,0,,40407,40407
23,06-06-18,87,21:30,21:45,54.12,,0,54.12,54.12,1,-72216,46093,118309,-26123,0,0,33339,0,0,,33339,33339
23,06-06-18,88,21:45,22:00,49.53,,0,49.53,49.53,1,-71775,49417,121192,-22358,0,0,17597,0,0,,17597,17597
23,06-06-18,89,22:00,22:15,243.83,,0,243.83,243.83,1,-92232,7920,100152,-84312,0,0,31233,0,0,,31233,31233
23,06-06-18,90,22:15,22:30,243.83,,0,243.83,243.83,1,-103371,10515,113886,-92856,0,0,83442,0,0,,83442,83442
23,06-06-18,91,22:30,22:45,49.53,,0,49.53,49.53,1,-48679,27434,76113,-21245,0,0,31420,0,0,,31420,31420
23,06-06-18,92,22:45,23:00,49.53,39.46,0,39.46,39.46,-1,-17436,38582,56018,21146,0,-477,687,0,0,,1164,210
23,06-06-18,93,23:00,23:15,234.49,,0,234.49,234.49,1,-114108,23781,137889,-90327,0,0,33020,0,0,,33020,33020
23,06-06-18,94,23:15,23:30,128.27,,0,128.27,128.27,1,-51332,34912,86244,-16420,0,0,49613,0,0,,49613,49613
23,06-06-18,95,23:30,23:45,128.27,40.78,0,40.78,40.78,-1,-35091,58715,93806,23624,0,-199,2919,0,0,,3118,2720
23,06-06-18,96,23:45,0:00,,35.46,0,35.46,35.46,-1,-26217,77589,103806,51372,0,-5095,0,0,0,,5095,-5095
23,06-07-18,1,0:00,0:15,108.02,43.03,0,108.02,43.03,2,-89774,59716,149490,-30058,0,-2874,9844,0,0,,12718,6970
23,06-07-18,2,0:15,0:30,49.04,,0,49.04,49.04,1,-82611,68098,150709,-14513,0,0,19028,0,0,,19028,19028
23,06-07-18,3,0:30,0:45,46.18,,0,46.18,46.18,1,-99520,84371,183891,-15149,0,0,10410,0,0,,10410,10410
23,06-07-18,4,0:45,1:00,42.99,,0,42.99,42.99,1,-100925,107441,208366,6516,0,0,3046,0,0,,3046,3046
23,06-07-18,5,1:00,1:15,,,0,27.02,27.02,0,-16338,75178,91516,58840,0,0,0,0,0,,0,0
23,06-07-18,6,1:15,1:30,,,0,27.02,27.02,0,-37104,67730,104834,30626,0,0,0,0,0,,0,0
23,06-07-18,7,1:30,1:45,,,0,27.02,27.02,0,-24902,70932,95834,46030,0,0,0,0,0,,0,0
23,06-07-18,8,1:45,2:00,,29.11,0,29.11,29.11,-1,-26247,76464,102711,50217,0,-5375,0,0,0,,5375,-5375
23,06-07-18,9,2:00,2:15,42.99,27.45,0,42.99,42.99,1,-31264,66100,97364,34836,0,-8878,87,0,0,,8965,-8791
23,06-07-18,10,2:15,2:30,42.99,,0,42.99,42.99,1,-25235,55302,80537,30067,0,0,441,0,0,,441,441
23,06-07-18,11,2:30,2:45,,,0,37.86,37.86,0,-26914,57524,84438,30610,0,0,0,0,0,,0,0
23,06-07-18,12,2:45,3:00,,,0,37.86,37.86,0,-20787,51755,72542,30968,0,0,0,0,0,,0,0
23,06-07-18,13,3:00,3:15,,,0,42.03,42.03,0,-38448,40396,78844,1948,0,0,0,0,0,,0,0
23,06-07-18,14,3:15,3:30,,38.99,0,38.99,38.99,-1,-36481,37824,74305,1343,0,-2223,0,0,0,,2223,-2223
23,06-07-18,15,3:30,3:45,49.04,38.99,0,49.04,49.04,1,-41466,28005,69471,-13461,0,-152,982,0,0,,1134,830
23,06-07-18,16,3:45,4:00,60.02,,0,60.02,60.02,1,-39280,26058,65338,-13222,0,0,16919,0,0,,16919,16919
23,06-07-18,17,4:00,4:15,44.71,,0,44.71,44.71,1,-46828,23986,70814,-22842,0,0,4628,0,0,,4628,4628
23,06-07-18,18,4:15,4:30,42.99,,0,42.99,42.99,1,-35523,17546,53069,-17977,0,0,1975,0,0,,1975,1975
23,06-07-18,19,4:30,4:45,50.02,,0,50.02,50.02,1,-42727,11292,54019,-31435,0,0,9299,0,0,,9299,9299
23,06-07-18,20,4:45,5:00,44.75,,0,44.75,44.75,1,-21253,21337,42590,84,0,0,7436,0,0,,7436,7436
23,06-07-18,21,5:00,5:15,44.75,38.99,0,38.99,38.99,-1,-28151,49761,77912,21610,0,-1680,2,0,0,,1682,-1678
23,06-07-18,22,5:15,5:30,,41.03,0,41.03,41.03,-1,-13123,42828,55951,29705,0,-1072,0,0,0,,1072,-1072
23,06-07-18,23,5:30,5:45,,,0,37.89,37.89,0,-12497,27574,40071,15077,0,-26,0,0,0,,26,-26
23,06-07-18,24,5:45,6:00,,38.99,0,38.99,38.99,-1,-30243,19134,49377,-11109,0,-21,0,0,0,,21,-21
23,06-07-18,25,6:00,6:15,,15.99,0,15.99,15.99,-1,-42605,92195,134800,49590,0,-19636,0,0,0,,19636,-19636
23,06-07-18,26,6:15,6:30,49.04,34.99,0,49.04,49.04,1,-63935,59498,123433,-4437,0,-11710,397,0,0,,12107,-11313
23,06-07-18,27,6:30,6:45,92.59,34.99,0,92.59,92.59,1,-62040,18180,80220,-43860,0,-13,16770,0,0,,16783,16757
23,06-07-18,28,6:45,7:00,238.93,,0,238.93,238.93,1,-113144,55943,169087,-57201,0,0,55004,0,0,,55004,55004
23,06-07-18,29,7:00,7:15,238.93,-150.03,0,-150.03,-150.03,-1,-33103,137908,171011,104805,0,-11626,14894,0,0,,26520,3268
23,06-07-18,30,7:15,7:30,,35.13,0,35.13,35.13,-1,-35934,62574,98508,26640,0,-3735,0,0,0,,3735,-3735
23,06-07-18,31,7:30,7:45,53.04,,0,53.04,53.04,1,-63380,51116,114496,-12264,0,0,2382,0,0,,2382,2382
23,06-07-18,32,7:45,8:00,89.02,,0,89.02,89.02,1,-98208,68239,166447,-29969,0,0,28193,0,0,,28193,28193
23,06-07-18,33,8:00,8:15,42.99,15.99,0,43.61,15.99,2,-35054,79166,114220,44112,0,-3801,7817,0,0,,11618,4016
23,06-07-18,34,8:15,8:30,,38.99,0,38.99,38.99,-1,-39619,62093,101712,22474,0,-571,0,0,0,,571,-571
23,06-07-18,35,8:30,8:45,,42.03,0,42.03,42.03,-1,-52939,58251,111190,5312,0,-748,0,0,0,,748,-748
23,06-07-18,36,8:45,9:00,45.61,42.03,0,45.61,45.61,1,-77067,49008,126075,-28059,0,-401,872,0,0,,1273,471
23,06-07-18,37,9:00,9:15,253.02,,0,253.02,253.02,1,-139649,28568,168217,-111081,0,0,41081,0,0,,41081,41081
23,06-07-18,38,9:15,9:30,59.02,,0,59.02,59.02,1,-98203,69073,167276,-29130,0,0,35906,0,0,,35906,35906
23,06-07-18,39,9:30,9:45,63.02,,0,63.02,63.02,1,-101632,68693,170325,-32939,0,0,28964,0,0,,28964,28964
23,06-07-18,40,9:45,10:00,250.3,,0,250.3,250.3,1,-136239,48273,184512,-87966,0,0,40394,0,0,,40394,40394
23,06-07-18,41,10:00,10:15,318.95,,0,318.95,318.95,1,-193801,85419,279220,-108382,0,0,88771,1250,0,,90021,90021
23,06-07-18,42,10:15,10:30,186.02,,0,186.02,186.02,1,-97936,142196,240132,44260,0,0,80921,1250,0,,82171,82171
23,06-07-18,43,10:30,10:45,168.7,,0,168.7,168.7,1,-75861,143405,219266,67544,0,0,69174,1250,0,,70424,70424
23,06-07-18,44,10:45,11:00,168.7,,0,168.7,168.7,1,-60431,156306,216737,95875,0,0,29700,1250,0,,30950,30950
23,06-07-18,45,11:00,11:15,315.92,,0,347.51,347.51,1,-69588,170555,240143,100967,0,0,55202,1250,0,,56452,56452
23,06-07-18,46,11:15,11:30,315.92,,0,347.51,347.51,1,-72009,125156,197165,53147,0,0,64017,1250,15303,,80570,80570
23,06-07-18,47,11:30,11:45,,,0,43.59,43.59,0,-62946,161738,224684,98792,0,0,1436,0,5721,,7157,7157
23,06-07-18,48,11:45,12:00,68.04,,0,68.04,68.04,1,-65368,140387,205755,75019,0,0,12914,0,0,,12914,12914
23,06-07-18,49,12:00,12:15,299.78,,0,299.78,299.78,1,-99466,115864,215330,16398,0,0,34050,0,0,,34050,34050
23,06-07-18,50,12:15,12:30,86.02,,0,86.02,86.02,1,-87607,125741,213348,38134,0,0,45651,0,0,,45651,45651
23,06-07-18,51,12:30,12:45,53.04,,0,53.04,53.04,1,-79112,123181,202293,44069,0,0,28450,0,0,,28450,28450
23,06-07-18,52,12:45,13:00,106.58,,0,106.58,106.58,1,-83450,108752,192202,25302,0,0,40030,0,0,,40030,40030
23,06-07-18,53,13:00,13:15,42.99,38.99,0,43.53,38.99,2,-43404,140330,183734,96926,0,-319,13901,0,0,,14220,13582
23,06-07-18,54,13:15,13:30,,,0,43.53,43.53,0,-36436,112541,148977,76105,0,-7,0,0,0,,7,-7
23,06-07-18,55,13:30,13:45,,44.13,0,44.13,44.13,-1,-29447,89900,119347,60453,0,-611,0,0,0,,611,-611
23,06-07-18,56,13:45,14:00,45.82,44.13,0,45.82,45.82,1,-54608,80697,135305,26089,0,-14,1441,0,0,,1455,1427
23,06-07-18,57,14:00,14:15,44.94,,0,44.94,44.94,1,-53571,87444,141015,33873,0,0,2117,0,0,,2117,2117
23,06-07-18,58,14:15,14:30,53.04,,0,53.04,53.04,1,-71288,78920,150208,7632,0,0,17051,0,0,,17051,17051
23,06-07-18,59,14:30,14:45,49.04,,0,49.04,49.04,1,-60820,81018,141838,20198,0,0,20254,0,0,,20254,20254
23,06-07-18,60,14:45,15:00,49.04,40.03,0,40.03,40.03,-1,-40418,77334,117752,36916,0,-311,5159,0,0,,5470,4848
23,06-07-18,61,15:00,15:15,,38.99,0,38.99,38.99,-1,-35758,101144,136902,65386,0,-887,0,0,0,,887,-887
23,06-07-18,62,15:15,15:30,,,0,43.48,43.48,0,-39181,98284,137465,59103,0,0,0,0,0,,0,0
23,06-07-18,63,15:30,15:45,,,0,43.48,43.48,0,-58966,99148,158114,40182,0,0,0,0,0,,0,0
23,06-07-18,64,15:45,16:00,,43.93,0,43.93,43.93,-1,-75764,96081,171845,20317,0,-8,0,0,0,,8,-8
23,06-07-18,65,16:00,16:15,,38.99,0,38.99,38.99,-1,-67471,86723,154194,19252,0,-1500,0,0,0,,1500,-1500
23,06-07-18,66,16:15,16:30,,,0,43.55,43.55,0,-56272,84613,140885,28341,0,0,0,0,0,,0,0
23,06-07-18,67,16:30,16:45,,,0,43.56,43.56,0,-51934,88101,140035,36167,0,0,0,0,0,,0,0
23,06-07-18,68,16:45,17:00,,31.31,0,31.31,31.31,-1,-58257,84905,143162,26648,0,-574,0,0,0,,574,-574
23,06-07-18,69,17:00,17:15,,30.99,0,30.99,30.99,-1,-84081,89566,173647,5485,0,-1267,0,0,0,,1267,-1267
23,06-07-18,70,17:15,17:30,45.09,,0,45.09,45.09,1,-91277,72173,163450,-19104,0,0,1207,0,0,,1207,1207
23,06-07-18,71,17:30,17:45,45.09,,0,45.09,45.09,1,-68164,60168,128332,-7996,0,0,3079,0,0,,3079,3079
23,06-07-18,72,17:45,18:00,45.81,,0,45.81,45.81,1,-72896,62688,135584,-10208,0,0,6461,0,0,,6461,6461
23,06-07-18,73,18:00,18:15,84.02,,0,84.02,84.02,1,-81391,47242,128633,-34149,0,0,16736,0,0,,16736,16736
23,06-07-18,74,18:15,18:30,73.16,,0,73.16,73.16,1,-68978,44517,113495,-24461,0,0,16386,0,0,,16386,16386
23,06-07-18,75,18:30,18:45,101.02,,0,101.02,101.02,1,-79838,51834,131672,-28004,0,0,15477,0,0,,15477,15477
23,06-07-18,76,18:45,19:00,185.03,,0,185.03,185.03,1,-114723,70150,184873,-44573,0,0,44165,0,0,,44165,44165
23,06-07-18,77,19:00,19:15,52.02,,0,52.02,52.02,1,-100828,81805,182633,-19023,0,0,24031,0,0,,24031,24031
23,06-07-18,78,19:15,19:30,42.99,43.99,0,43.99,43.99,-1,-48056,55490,103546,7434,0,-334,5892,0,0,,6226,5558
23,06-07-18,79,19:30,19:45,137.02,44.03,0,137.02,137.02,1,-84676,40387,125063,-44289,0,-132,6314,0,0,,6446,6182
23,06-07-18,80,19:45,20:00,250.3,,0,250.3,250.3,1,-85995,54737,140732,-31258,0,0,35286,0,0,,35286,35286
23,06-07-18,81,20:00,20:15,42.99,43.8,0,43.8,43.8,-1,-40332,95909,136241,55577,0,-584,6194,0,0,,6778,5610
23,06-07-18,82,20:15,20:30,,43.99,0,43.99,43.99,-1,-59073,84536,143609,25463,0,-1270,0,0,0,,1270,-1270
23,06-07-18,83,20:30,20:45,,36.28,0,36.28,36.28,-1,-64481,84719,149200,20238,0,-1408,0,0,0,,1408,-1408
23,06-07-18,84,20:45,21:00,71.02,34.99,0,71.02,34.99,2,-84449,71811,156260,-12638,0,-2804,3330,0,0,,6134,526
23,06-07-18,85,21:00,21:15,180,,0,180,180,1,-88602,53839,142441,-34763,0,0,37708,0,0,,37708,37708
23,06-07-18,86,21:15,21:30,44.47,,0,44.47,44.47,1,-72291,69970,142261,-2321,0,0,5361,0,0,,5361,5361
23,06-07-18,87,21:30,21:45,44.47,,0,44.47,44.47,1,-62030,75261,137291,13231,0,0,462,0,0,,462,462
23,06-07-18,88,21:45,22:00,,30.32,0,30.32,30.32,-1,-49324,79106,128430,29782,0,-833,0,0,0,,833,-833
23,06-07-18,89,22:00,22:15,42.99,-34.01,0,44.01,-34.01,2,-58997,50096,109093,-8901,0,-13110,133,0,0,,13243,-12977
23,06-07-18,90,22:15,22:30,45.02,,0,45.02,45.02,1,-66161,44343,110504,-21818,0,0,3271,0,0,,3271,3271
23,06-07-18,91,22:30,22:45,45.49,,0,45.49,45.49,1,-58551,54226,112777,-4325,0,0,5617,0,0,,5617,5617
23,06-07-18,92,22:45,23:00,45.49,38.99,0,38.99,38.99,-1,-50553,71606,122159,21053,0,-193,281,0,0,,474,88
23,06-07-18,93,23:00,23:15,250.96,,0,250.96,250.96,1,-102636,13814,116450,-88822,0,0,24025,0,0,,24025,24025
23,06-07-18,94,23:15,23:30,49.49,34.99,0,34.99,34.99,-1,-44393,28865,73258,-15528,0,-219,14818,0,0,,15037,14599
23,06-07-18,95,23:30,23:45,49.49,30.99,0,30.99,30.99,-1,-27644,43915,71559,16271,0,-2532,5,0,0,,2537,-2527
23,06-07-18,96,23:45,0:00,,15.99,0,15.99,15.99,-1,-43504,75439,118943,31935,0,-8591,0,0,0,,8591,-8591
23,06-08-18,1,0:00,0:15,128.12,-120,0,128.12,-120,2,-89424,43134,132558,-46290,0,-16717,1671,0,0,,18388,-15046
23,06-08-18,2,0:15,0:30,350.12,-120,0,350.12,350.12,1,-77549,30419,107968,-47130,0,-155,36726,0,0,,36881,36571
23,06-08-18,3,0:30,0:45,45.15,,0,45.15,45.15,1,-77821,66246,144067,-11575,0,0,6953,0,0,,6953,6953
23,06-08-18,4,0:45,1:00,,,0,26.3,26.3,0,-70725,74917,145642,4192,0,0,532,0,0,,532,532
23,06-08-18,5,1:00,1:15,58.12,,0,58.12,58.12,1,-59383,43623,103006,-15760,0,0,2654,0,0,,2654,2654
23,06-08-18,6,1:15,1:30,67.43,,0,67.43,67.43,1,-34848,30032,64880,-4816,0,0,13918,0,0,,13918,13918
23,06-08-18,7,1:30,1:45,67.43,42.66,0,42.66,42.66,-1,-29827,55549,85376,25722,0,-113,615,0,0,,728,502
23,06-08-18,8,1:45,2:00,,42.66,0,42.66,42.66,-1,-35032,55301,90333,20269,0,-211,0,0,0,,211,-211
23,06-08-18,9,2:00,2:15,,42.39,0,42.39,42.39,-1,-25053,59159,84212,34106,0,-139,0,0,0,,139,-139
23,06-08-18,10,2:15,2:30,,,0,42.4,42.4,0,-21982,51316,73298,29334,0,0,0,0,0,,0,0
23,06-08-18,11,2:30,2:45,,,0,42.4,42.4,0,-19955,57609,77564,37654,0,0,0,0,0,,0,0
23,06-08-18,12,2:45,3:00,,38.4,0,38.4,38.4,-1,-22016,59552,81568,37536,0,-278,0,0,0,,278,-278
23,06-08-18,13,3:00,3:15,,42.53,0,42.53,42.53,-1,-42530,59189,101719,16659,0,-336,0,0,0,,336,-336
23,06-08-18,14,3:15,3:30,42.4,,0,42.4,42.4,1,-42714,39252,81966,-3462,0,0,446,0,0,,446,446
23,06-08-18,15,3:30,3:45,42.4,,0,42.4,42.4,1,-39585,54720,94305,15135,0,0,1360,0,0,,1360,1360
23,06-08-18,16,3:45,4:00,46.06,,0,46.06,46.06,1,-50239,47764,98003,-2475,0,0,3835,0,0,,3835,3835
23,06-08-18,17,4:00,4:15,100.12,,0,100.12,100.12,1,-61361,12997,74358,-48364,0,0,13609,0,0,,13609,13609
23,06-08-18,18,4:15,4:30,55.01,,0,55.01,55.01,1,-68952,16163,85115,-52789,0,0,34378,0,0,,34378,34378
23,06-08-18,19,4:30,4:45,67.43,,0,67.43,67.43,1,-61676,14521,76197,-47155,0,0,37973,0,0,,37973,37973
23,06-08-18,20,4:45,5:00,45.15,,0,45.15,45.15,1,-49950,24223,74173,-25727,0,0,15718,0,0,,15718,15718
23,06-08-18,21,5:00,5:15,42.4,,0,42.4,42.4,1,-63001,36371,99372,-26630,0,0,847,0,0,,847,847
23,06-08-18,22,5:15,5:30,42.4,,0,42.4,42.4,1,-43661,33944,77605,-9717,0,0,59,0,0,,59,59
23,06-08-18,23,5:30,5:45,48.43,,0,48.43,48.43,1,-55244,23369,78613,-31875,0,0,3374,0,0,,3374,3374
23,06-08-18,24,5:45,6:00,52.43,42.46,0,52.43,42.43,2,-63896,22799,86695,-41097,0,-7,13043,0,0,,13050,13036
23,06-08-18,25,6:00,6:15,52.43,-150.78,0,-150.78,-150.78,-1,-61866,132923,194789,71057,0,-19044,1600,0,0,,20644,-17444
23,06-08-18,26,6:15,6:30,52.33,38.31,0,52.33,52.33,1,-64246,68191,132437,3945,0,-3907,1624,0,0,,5531,-2283
23,06-08-18,27,6:30,6:45,104.73,,0,104.73,104.73,1,-62851,49175,112026,-13676,0,0,28245,0,0,,28245,28245
23,06-08-18,28,6:45,7:00,42.31,34.31,0,34.31,34.31,-1,-78688,88178,166866,9490,0,-917,11963,0,0,,12880,11046
23,06-08-18,29,7:00,7:15,,1.28,0,1.28,1.28,-1,-91853,144437,236290,52584,0,-20656,0,0,0,,20656,-20656
23,06-08-18,30,7:15,7:30,52.33,43.59,0,52.33,52.33,1,-64753,69396,134149,4643,0,-3083,1179,0,0,,4262,-1904
23,06-08-18,31,7:30,7:45,145.12,,0,145.12,145.12,1,-79300,46650,125950,-32650,0,0,33708,0,0,,33708,33708
23,06-08-18,32,7:45,8:00,75.69,,0,75.69,75.69,1,-101848,74595,176443,-27253,0,0,44934,0,0,,44934,44934
23,06-08-18,33,8:00,8:15,75.69,38.31,0,38.31,38.31,-1,-40534,103807,144341,63273,0,-880,11072,0,0,,11952,10192
23,06-08-18,34,8:15,8:30,45.04,,0,45.04,45.04,1,-44119,59656,103775,15537,0,0,216,0,0,,216,216
23,06-08-18,35,8:30,8:45,70.7,,0,70.7,70.7,1,-79916,48433,128349,-31483,0,0,13912,0,0,,13912,13912
23,06-08-18,36,8:45,9:00,99.12,,0,99.12,99.12,1,-90606,39490,130096,-51116,0,0,35013,0,0,,35013,35013
23,06-08-18,37,9:00,9:15,267.74,,0,267.74,267.74,1,-116269,44224,160493,-72045,0,0,48108,0,0,,48108,48108
23,06-08-18,38,9:15,9:30,83.12,,0,83.12,83.12,1,-107389,66161,173550,-41228,0,0,46961,0,0,,46961,46961
23,06-08-18,39,9:30,9:45,267.74,,0,267.74,267.74,1,-109689,47056,156745,-62633,0,0,54791,0,0,,54791,54791
23,06-08-18,40,9:45,10:00,267.74,,0,294.51,294.51,1,-147601,67566,215167,-80035,0,0,82155,0,45551,,127706,127706
23,06-08-18,41,10:00,10:15,257.68,,0,283.45,283.45,1,-138177,106821,244998,-31356,0,0,87413,0,100765,,188178,188178
23,06-08-18,42,10:15,10:30,179.05,,0,279.05,279.05,1,-125774,128489,254263,2715,0,0,65166,1250,100467,,166883,166883
23,06-08-18,43,10:30,10:45,53.12,,0,279.05,279.05,1,-137227,107526,244753,-29701,0,0,23902,0,66539,,90441,90441
23,06-08-18,44,10:45,11:00,99.12,,0,279.05,279.05,1,-138822,86455,225277,-52367,0,0,22580,0,20000,,42580,42580
23,06-08-18,45,11:00,11:15,99.12,,0,99.12,99.12,1,-105895,75098,180993,-30797,0,0,33174,0,0,,33174,33174
23,06-08-18,46,11:15,11:30,275.16,,0,275.16,275.16,1,-127809,54058,181867,-73751,0,0,46555,0,0,,46555,46555
23,06-08-18,47,11:30,11:45,275.16,,0,275.16,275.16,1,-131853,58362,190215,-73491,0,0,73540,0,0,,73540,73540
23,06-08-18,48,11:45,12:00,127.12,,0,127.12,127.12,1,-123915,70735,194650,-53180,0,0,66372,0,0,,66372,66372
23,06-08-18,49,12:00,12:15,267.34,,0,267.34,267.34,1,-159257,63816,223073,-95441,0,0,64004,0,0,,64004,64004
23,06-08-18,50,12:15,12:30,159.41,,0,159.41,159.41,1,-140030,78606,218636,-61424,0,0,75057,0,0,,75057,75057
23,06-08-18,51,12:30,12:45,60.12,,0,60.12,60.12,1,-130996,98426,229422,-32570,0,0,34490,0,0,,34490,34490
23,06-08-18,52,12:45,13:00,95.05,,0,95.05,95.05,1,-131957,92203,224160,-39754,0,0,36987,0,0,,36987,36987
23,06-08-18,53,13:00,13:15,256.68,,0,256.68,256.68,1,-119841,72753,192594,-47088,0,0,39022,0,0,,39022,39022
23,06-08-18,54,13:15,13:30,256.68,,0,256.68,256.68,1,-119922,80127,200049,-39795,0,0,57225,0,0,,57225,57225
23,06-08-18,55,13:30,13:45,71.81,,0,71.81,71.81,1,-123804,85678,209482,-38126,0,0,47721,0,0,,47721,47721
23,06-08-18,56,13:45,14:00,71.81,,0,71.81,71.81,1,-128543,90099,218642,-38444,0,0,47016,0,0,,47016,47016
23,06-08-18,57,14:00,14:15,127.12,,0,127.12,127.12,1,-146005,89489,235494,-56516,0,0,52563,0,0,,52563,52563
23,06-08-18,58,14:15,14:30,164.07,,0,164.07,164.07,1,-138890,113498,252388,-25392,0,0,44809,1250,0,,46059,46059
23,06-08-18,59,14:30,14:45,164.07,38.31,0,38.31,38.31,-1,-120709,134435,255144,13726,0,-458,8015,0,0,,8473,7557
23,06-08-18,60,14:45,15:00,,38.31,0,38.31,38.31,-1,-102353,142496,244849,40143,0,-977,0,0,0,,977,-977
23,06-08-18,61,15:00,15:15,52.33,38.31,0,52.33,52.33,1,-124330,117867,242197,-6463,0,-396,3380,0,0,,3776,2984
23,06-08-18,62,15:15,15:30,44.5,,0,44.5,44.5,1,-110789,127236,238025,16447,0,0,4137,0,0,,4137,4137
23,06-08-18,63,15:30,15:45,44.49,,0,44.49,44.49,1,-98807,105254,204061,6447,0,0,466,0,0,,466,466
23,06-08-18,64,15:45,16:00,42.31,,0,42.31,42.31,1,-99646,97524,197170,-2122,0,0,1782,0,0,,1782,1782
23,06-08-18,65,16:00,16:15,,,0,42.99,42.99,0,-79330,100844,180174,21514,0,0,8,0,0,,8,8
23,06-08-18,66,16:15,16:30,42.31,,0,42.31,42.31,1,-94072,95991,190063,1919,0,0,734,0,0,,734,734
23,06-08-18,67,16:30,16:45,42.31,,0,42.31,42.31,1,-83605,103556,187161,19951,0,0,314,0,0,,314,314
23,06-08-18,68,16:45,17:00,44.48,,0,44.48,44.48,1,-78687,82023,160710,3336,0,0,722,0,0,,722,722
23,06-08-18,69,17:00,17:15,,,0,43.11,43.11,0,-53464,100765,154229,47301,0,0,0,0,0,,0,0
23,06-08-18,70,17:15,17:30,,,0,43.09,43.09,0,-49775,79377,129152,29602,0,0,0,0,0,,0,0
23,06-08-18,71,17:30,17:45,,,0,43.09,43.09,0,-51096,96369,147465,45273,0,0,0,0,0,,0,0
23,06-08-18,72,17:45,18:00,,43.86,0,43.86,43.86,-1,-41976,117704,159680,75728,0,-292,0,0,0,,292,-292
23,06-08-18,73,18:00,18:15,,35.96,0,35.96,35.96,-1,-45001,71599,116600,26598,0,-7643,0,0,0,,7643,-7643
23,06-08-18,74,18:15,18:30,,38.31,0,38.31,38.31,-1,-51770,86742,138512,34972,0,-9603,0,0,0,,9603,-9603
23,06-08-18,75,18:30,18:45,,38.31,0,38.31,38.31,-1,-44693,108419,153112,63726,0,-872,0,0,0,,872,-872
23,06-08-18,76,18:45,19:00,,34.31,0,34.31,34.31,-1,-44576,118810,163386,74234,0,-1073,0,0,0,,1073,-1073
23,06-08-18,77,19:00,19:15,,34.31,0,34.31,34.31,-1,-35089,81428,116517,46339,0,-1336,0,0,0,,1336,-1336
23,06-08-18,78,19:15,19:30,,38.31,0,38.31,38.31,-1,-43400,86106,129506,42706,0,-552,0,0,0,,552,-552
23,06-08-18,79,19:30,19:45,,43.58,0,43.58,43.58,-1,-34374,99463,133837,65089,0,-994,0,0,0,,994,-994
23,06-08-18,80,19:45,20:00,,43.9,0,43.9,43.9,-1,-26292,105101,131393,78809,0,-1242,0,0,0,,1242,-1242
23,06-08-18,81,20:00,20:15,,43.09,0,43.09,43.09,-1,-41952,58644,100596,16692,0,-1258,0,0,0,,1258,-1258
23,06-08-18,82,20:15,20:30,,,0,43.07,43.07,0,-41411,47554,88965,6143,0,-50,0,0,0,,50,-50
23,06-08-18,83,20:30,20:45,,43.55,0,43.55,43.55,-1,-30772,58365,89137,27593,0,-80,0,0,0,,80,-80
23,06-08-18,84,20:45,21:00,,43.61,0,43.61,43.61,-1,-30649,66427,97076,35778,0,-992,0,0,0,,992,-992
23,06-08-18,85,21:00,21:15,56.2,43.28,0,56.2,43.05,2,-56885,41337,98222,-15548,0,-232,5377,0,0,,5609,5145
23,06-08-18,86,21:15,21:30,44.58,,0,44.58,44.58,1,-49832,55781,105613,5949,0,0,5581,0,0,,5581,5581
23,06-08-18,87,21:30,21:45,42.31,,0,42.31,42.31,1,-41433,78331,119764,36898,0,0,206,0,0,,206,206
23,06-08-18,88,21:45,22:00,,34.31,0,34.31,34.31,-1,-42049,86203,128252,44154,0,-909,0,0,0,,909,-909
23,06-08-18,89,22:00,22:15,,39.7,0,39.7,39.7,-1,-32428,54529,86957,22101,0,-1869,0,0,0,,1869,-1869
23,06-08-18,90,22:15,22:30,,43.29,0,43.29,43.29,-1,-33295,53856,87151,20561,0,-472,0,0,0,,472,-472
23,06-08-18,91,22:30,22:45,,43.44,0,43.44,43.44,-1,-31204,76446,107650,45242,0,-1127,0,0,0,,1127,-1127
23,06-08-18,92,22:45,23:00,,38.31,0,38.31,38.31,-1,-29799,91585,121384,61786,0,-716,0,0,0,,716,-716
23,06-08-18,93,23:00,23:15,349.12,37.78,0,349.12,349.12,1,-86272,24786,111058,-61486,0,-360,19345,0,0,,19705,18985
23,06-08-18,94,23:15,23:30,75.12,,0,75.12,75.12,1,-40636,32732,73368,-7904,0,0,28761,0,0,,28761,28761
23,06-08-18,95,23:30,23:45,75.12,43.6,0,43.6,43.6,-1,-37195,58860,96055,21665,0,-13,915,0,0,,928,902
23,06-08-18,96,23:45,0:00,53.85,43.35,0,53.85,42.85,2,-86061,57087,143148,-28974,0,-60,5189,0,0,,5249,5129
24,06-09-18,1,0:00,0:15,46.45,,0,46.45,46.45,1,-85838,81010,166848,-4828,0,0,1699,0,0,,1699,1699
24,06-09-18,2,0:15,0:30,50.45,,0,50.45,50.45,1,-66998,36284,103282,-30714,0,0,11312,0,0,,11312,11312
24,06-09-18,3,0:30,0:45,44.45,43.85,0,43.85,43.85,-1,-38713,31471,70184,-7242,0,-19,7256,0,0,,7275,7237
24,06-09-18,4,0:45,1:00,44.45,38.45,0,38.45,38.45,-1,-23592,37687,61279,14095,0,-342,46,0,0,,388,-296
24,06-09-18,5,1:00,1:15,68.02,34.45,0,68.02,34.45,2,-59457,53188,112645,-6269,0,-1390,2638,0,0,,4028,1248
24,06-09-18,6,1:15,1:30,97.32,,0,97.32,97.32,1,-56130,40863,96993,-15267,0,0,19766,0,0,,19766,19766
24,06-09-18,7,1:30,1:45,46.45,,0,46.45,46.45,1,-50718,40185,90903,-10533,0,0,2124,0,0,,2124,2124
24,06-09-18,8,1:45,2:00,53.02,,0,53.02,53.02,1,-72230,47606,119836,-24624,0,0,8566,0,0,,8566,8566
24,06-09-18,9,2:00,2:15,46.76,38.45,0,46.76,38.45,2,-43719,51907,95626,8188,0,-693,614,0,0,,1307,-79
24,06-09-18,10,2:15,2:30,115.45,,0,115.45,115.45,1,-54845,13059,67904,-41786,0,0,26433,0,0,,26433,26433
24,06-09-18,11,2:30,2:45,50.02,,0,50.02,50.02,1,-40526,12866,53392,-27660,0,0,27916,0,0,,27916,27916
24,06-09-18,12,2:45,3:00,44.77,43.33,0,43.33,43.33,-1,-22116,17847,39963,-4269,0,-174,10419,0,0,,10593,10245
24,06-09-18,13,3:00,3:15,46.45,43.34,0,46.45,43.06,2,-36893,22003,58896,-14890,0,-121,1997,0,0,,2118,1876
24,06-09-18,14,3:15,3:30,42.37,,0,42.37,42.37,1,-31028,31496,62524,468,0,0,1192,0,0,,1192,1192
24,06-09-18,15,3:30,3:45,44.82,,0,44.82,44.82,1,-29403,31351,60754,1948,0,0,1680,0,0,,1680,1680
24,06-09-18,16,3:45,4:00,,,0,43.08,43.08,0,-18125,40257,58382,22132,0,0,0,0,0,,0,0
24,06-09-18,17,4:00,4:15,42.37,,0,42.37,42.37,1,-35302,36162,71464,860,0,0,1223,0,0,,1223,1223
24,06-09-18,18,4:15,4:30,42.37,,0,42.37,42.37,1,-21822,40275,62097,18453,0,0,1356,0,0,,1356,1356
24,06-09-18,19,4:30,4:45,,,0,43.12,43.12,0,-16794,42834,59628,26040,0,0,0,0,0,,0,0
24,06-09-18,20,4:45,5:00,,,0,43.12,43.12,0,-9060,44762,53822,35702,0,0,0,0,0,,0,0
24,06-09-18,21,5:00,5:15,42.37,,0,42.37,42.37,1,-24391,30954,55345,6563,0,0,818,0,0,,818,818
24,06-09-18,22,5:15,5:30,42.37,,0,42.37,42.37,1,-20189,40985,61174,20796,0,0,332,0,0,,332,332
24,06-09-18,23,5:30,5:45,,,0,42.95,42.95,0,-7167,37487,44654,30320,0,0,0,0,0,,0,0
24,06-09-18,24,5:45,6:00,42.37,,0,42.37,42.37,1,-18368,37662,56030,19294,0,0,61,0,0,,61,61
24,06-09-18,25,6:00,6:15,,4.03,0,4.03,4.03,-1,-15939,75625,91564,59686,0,-10658,0,0,0,,10658,-10658
24,06-09-18,26,6:15,6:30,,34.17,0,34.17,34.17,-1,-16267,62519,78786,46252,0,-3888,0,0,0,,3888,-3888
24,06-09-18,27,6:30,6:45,,43.96,0,43.96,43.96,-1,-21539,60336,81875,38797,0,-927,0,0,0,,927,-927
24,06-09-18,28,6:45,7:00,,38.17,0,38.17,38.17,-1,-19176,73528,92704,54352,0,-60,0,0,0,,60,-60
24,06-09-18,29,7:00,7:15,,-34.83,0,-34.83,-34.83,-1,-12941,90505,103446,77564,0,-24347,0,0,0,,24347,-24347
24,06-09-18,30,7:15,7:30,,34.17,0,34.17,34.17,-1,-13240,45311,58551,32071,0,-9989,0,0,0,,9989,-9989
24,06-09-18,31,7:30,7:45,,,0,43.12,43.12,0,-8772,53029,61801,44257,0,0,0,0,0,,0,0
24,06-09-18,32,7:45,8:00,,,0,43.08,43.08,0,-14852,62163,77015,47311,0,0,0,0,0,,0,0
24,06-09-18,33,8:00,8:15,,28.03,0,28.03,28.03,-1,-26277,146699,172976,120422,0,-8670,0,0,0,,8670,-8670
24,06-09-18,34,8:15,8:30,,38.17,0,38.17,38.17,-1,-29192,99749,128941,70557,0,-5253,0,0,0,,5253,-5253
24,06-09-18,35,8:30,8:45,,,0,43.12,43.12,0,-26528,81184,107712,54656,0,0,0,0,0,,0,0
24,06-09-18,36,8:45,9:00,,,0,43.08,43.08,0,-25866,52368,78234,26502,0,0,0,0,0,,0,0
24,06-09-18,37,9:00,9:15,,,0,43.17,43.17,0,-24878,108083,132961,83205,0,0,0,0,0,,0,0
24,06-09-18,38,9:15,9:30,,,0,43.13,43.13,0,-21743,97859,119602,76116,0,0,0,0,0,,0,0
24,06-09-18,39,9:30,9:45,,15.17,0,15.17,15.17,-1,-25791,89407,115198,63616,0,-3976,0,0,0,,3976,-3976
24,06-09-18,40,9:45,10:00,,7.46,0,7.46,7.46,-1,-35690,77873,113563,42183,0,-20315,0,0,0,,20315,-20315
24,06-09-18,41,10:00,10:15,,38.17,0,38.17,38.17,-1,-44042,73057,117099,29015,0,-8910,0,0,0,,8910,-8910
24,06-09-18,42,10:15,10:30,,30.17,0,30.17,30.17,-1,-28887,87780,116667,58893,0,-579,0,0,0,,579,-579
24,06-09-18,43,10:30,10:45,,2.91,0,2.91,2.91,-1,-22612,96466,119078,73854,0,-19299,0,0,0,,19299,-19299
24,06-09-18,44,10:45,11:00,,5.74,0,5.74,5.74,-1,-39995,81106,121101,41111,0,-34847,0,0,0,,34847,-34847
24,06-09-18,45,11:00,11:15,,30,0,30,30,-1,-67613,109059,176672,41446,0,-17581,0,0,0,,17581,-17581
24,06-09-18,46,11:15,11:30,,5.73,0,5.73,5.73,-1,-54136,112653,166789,58517,0,-31868,0,0,0,,31868,-31868
24,06-09-18,47,11:30,11:45,,15.17,0,15.17,15.17,-1,-49832,104907,154739,55075,0,-24031,0,0,0,,24031,-24031
24,06-09-18,48,11:45,12:00,,15.17,0,15.17,15.17,-1,-47416,112077,159493,64661,0,-10385,0,0,0,,10385,-10385
24,06-09-18,49,12:00,12:15,,15.17,0,15.17,15.17,-1,-70421,88681,159102,18260,0,-18309,0,0,0,,18309,-18309
24,06-09-18,50,12:15,12:30,,38.17,0,38.17,38.17,-1,-66212,108653,174865,42441,0,-4413,0,0,0,,4413,-4413
24,06-09-18,51,12:30,12:45,,41.03,0,41.03,41.03,-1,-64590,138662,203252,74072,0,-2015,0,0,0,,2015,-2015
24,06-09-18,52,12:45,13:00,,30.17,0,30.17,30.17,-1,-64614,163880,228494,99266,0,-4000,0,0,0,,4000,-4000
24,06-09-18,53,13:00,13:15,46.17,43.54,0,46.17,43.09,2,-108118,103811,211929,-4307,0,-2323,1171,0,0,,3494,-1152
24,06-09-18,54,13:15,13:30,,,0,43.1,43.1,0,-93313,133172,226485,39859,0,0,16,0,0,,16,16
24,06-09-18,55,13:30,13:45,,44.1,0,44.1,44.1,-1,-134570,143652,278222,9082,0,-57,0,0,0,,57,-57
24,06-09-18,56,13:45,14:00,,38.17,0,38.17,38.17,-1,-158065,148599,306664,-9466,0,-732,0,0,0,,732,-732
24,06-09-18,57,14:00,14:15,,-150.03,0,-150.03,-150.03,-1,-144858,188523,333381,43665,0,-17577,0,0,0,,17577,-17577
24,06-09-18,58,14:15,14:30,,-150.03,0,-150.03,-150.03,-1,-137047,185969,323016,48922,0,-79724,0,0,0,,79724,-79724
24,06-09-18,59,14:30,14:45,,-14.03,0,-14.03,-14.03,-1,-165740,175851,341591,10111,0,-80542,0,0,0,,80542,-80542
24,06-09-18,60,14:45,15:00,,0.73,0,0.73,0.73,-1,-152677,160529,313206,7852,0,-68621,0,0,0,,68621,-68621
24,06-09-18,61,15:00,15:15,,,0,42.72,42.72,0,-120671,105031,225702,-15640,0,-13460,0,0,0,,13460,-13460
24,06-09-18,62,15:15,15:30,,,0,42.73,42.73,0,-91389,128353,219742,36964,0,0,0,0,0,,0,0
24,06-09-18,63,15:30,15:45,,43.39,0,43.39,43.39,-1,-81932,139879,221811,57947,0,-463,0,0,0,,463,-463
24,06-09-18,64,15:45,16:00,,43.43,0,43.43,43.43,-1,-59425,147174,206599,87749,0,-1047,0,0,0,,1047,-1047
24,06-09-18,65,16:00,16:15,,,0,42.73,42.73,0,-93783,136384,230167,42601,0,-205,0,0,0,,205,-205
24,06-09-18,66,16:15,16:30,,,0,42.73,42.73,0,-89974,134653,224627,44679,0,0,0,0,0,,0,0
24,06-09-18,67,16:30,16:45,,,0,42.73,42.73,0,-91206,116034,207240,24828,0,0,0,0,0,,0,0
24,06-09-18,68,16:45,17:00,42.09,,0,42.09,42.09,1,-99287,86302,185589,-12985,0,0,1142,0,0,,1142,1142
24,06-09-18,69,17:00,17:15,42.09,38.17,0,42.96,38.17,2,-62839,141768,204607,78929,0,-1231,339,0,0,,1570,-892
24,06-09-18,70,17:15,17:30,,,0,42.96,42.96,0,-72824,116561,189385,43737,0,-288,0,0,0,,288,-288
24,06-09-18,71,17:30,17:45,42.09,,0,42.09,42.09,1,-78433,86476,164909,8043,0,0,1,0,0,,1,1
24,06-09-18,72,17:45,18:00,50.17,,0,50.17,50.17,1,-84062,62636,146698,-21426,0,0,7283,0,0,,7283,7283
24,06-09-18,73,18:00,18:15,42.09,-34.83,0,-34.83,-34.83,-1,-42644,116647,159291,74003,0,-7626,2331,0,0,,9957,-5295
24,06-09-18,74,18:15,18:30,,-34.83,0,-34.83,-34.83,-1,-59141,84300,143441,25159,0,-27653,0,0,0,,27653,-27653
24,06-09-18,75,18:30,18:45,,,0,43.16,43.16,0,-69835,95269,165104,25434,0,-995,0,0,0,,995,-995
24,06-09-18,76,18:45,19:00,,,0,43.11,43.11,0,-75204,83247,158451,8043,0,0,0,0,0,,0,0
24,06-09-18,77,19:00,19:15,42.09,,0,42.09,42.09,1,-53304,59010,112314,5706,0,0,429,0,0,,429,429
24,06-09-18,78,19:15,19:30,50.17,,0,50.17,50.17,1,-60989,43221,104210,-17768,0,0,5558,0,0,,5558,5558
24,06-09-18,79,19:30,19:45,44.87,,0,44.87,44.87,1,-50016,45242,95258,-4774,0,0,6131,0,0,,6131,6131
24,06-09-18,80,19:45,20:00,44.95,,0,44.95,44.95,1,-50908,42228,93136,-8680,0,0,2825,0,0,,2825,2825
24,06-09-18,81,20:00,20:15,82.02,,0,82.02,82.02,1,-79076,52185,131261,-26891,0,0,12452,0,0,,12452,12452
24,06-09-18,82,20:15,20:30,46.79,,0,46.79,46.79,1,-69266,52806,122072,-16460,0,0,12523,0,0,,12523,12523
24,06-09-18,83,20:30,20:45,42.09,,0,42.09,42.09,1,-39283,54810,94093,15527,0,0,4743,0,0,,4743,4743
24,06-09-18,84,20:45,21:00,,44.16,0,44.16,44.16,-1,-35273,47596,82869,12323,0,-8,0,0,0,,8,-8
24,06-09-18,85,21:00,21:15,,38.17,0,38.17,38.17,-1,-23326,37031,60357,13705,0,-131,0,0,0,,131,-131
24,06-09-18,86,21:15,21:30,,,0,43.17,43.17,0,-21941,38400,60341,16459,0,0,0,0,0,,0,0
24,06-09-18,87,21:30,21:45,,,0,43.17,43.17,0,-29768,35951,65719,6183,0,0,0,0,0,,0,0
24,06-09-18,88,21:45,22:00,46.69,,0,46.69,46.69,1,-46249,31851,78100,-14398,0,0,4685,0,0,,4685,4685
24,06-09-18,89,22:00,22:15,42.09,,0,42.09,42.09,1,-31659,36668,68327,5009,0,0,1427,0,0,,1427,1427
24,06-09-18,90,22:15,22:30,53.02,,0,53.02,53.02,1,-55162,20055,75217,-35107,0,0,13983,0,0,,13983,13983
24,06-09-18,91,22:30,22:45,57.02,,0,57.02,57.02,1,-45659,23428,69087,-22231,0,0,21024,0,0,,21024,21024
24,06-09-18,92,22:45,23:00,45.4,44.24,0,44.24,44.24,-1,-38383,40983,79366,2600,0,-22,9841,0,0,,9863,9819
24,06-09-18,93,23:00,23:15,242.82,44.15,0,242.82,43.12,2,-58696,8086,66782,-50610,0,-17,16778,0,0,,16795,16761
24,06-09-18,94,23:15,23:30,60.02,,0,60.02,60.02,1,-46839,26411,73250,-20428,0,0,31320,0,0,,31320,31320
24,06-09-18,95,23:30,23:45,60.02,44.07,0,44.07,44.07,-1,-42790,38955,81745,-3835,0,-619,6797,0,0,,7416,6178
24,06-09-18,96,23:45,0:00,,38.17,0,38.17,38.17,-1,-49083,52223,101306,3140,0,-926,0,0,0,,926,-926
24,06-10-18,1,0:00,0:15,98.12,,0,98.12,98.12,1,-81974,48593,130567,-33381,0,0,9827,0,0,,9827,9827
24,06-10-18,2,0:15,0:30,110.78,43.95,0,110.78,43.3,2,-50610,37790,88400,-12820,0,-2,28867,0,0,,28869,28865
24,06-10-18,3,0:30,0:45,110.78,35.78,0,35.78,35.78,-1,-27470,47025,74495,19555,0,-1123,2668,0,0,,3791,1545
24,06-10-18,4,0:45,1:00,,38.64,0,38.64,38.64,-1,-27059,50630,77689,23571,0,-3934,0,0,0,,3934,-3934
24,06-10-18,5,1:00,1:15,,26.77,0,26.77,26.77,-1,-18663,136694,155357,118031,0,-18102,0,0,0,,18102,-18102
24,06-10-18,6,1:15,1:30,,43.16,0,43.16,43.16,-1,-17558,88353,105911,70795,0,-2965,0,0,0,,2965,-2965
24,06-10-18,7,1:30,1:45,,38.64,0,38.64,38.64,-1,-24065,68659,92724,44594,0,-151,0,0,0,,151,-151
24,06-10-18,8,1:45,2:00,,36.78,0,36.78,36.78,-1,-32296,41785,74081,9489,0,-816,0,0,0,,816,-816
24,06-10-18,9,2:00,2:15,42.64,,0,42.64,42.64,1,-34841,33608,68449,-1233,0,0,654,0,0,,654,654
24,06-10-18,10,2:15,2:30,42.64,,0,42.64,42.64,1,-27427,43382,70809,15955,0,0,1163,0,0,,1163,1163
24,06-10-18,11,2:30,2:45,,,0,43.04,43.04,0,-18045,43844,61889,25799,0,0,0,0,0,,0,0
24,06-10-18,12,2:45,3:00,,30.64,0,30.64,30.64,-1,-16784,49005,65789,32221,0,-10313,0,0,0,,10313,-10313
24,06-10-18,13,3:00,3:15,50.64,38.64,0,50.64,38.64,2,-47421,22661,70082,-24760,0,-3162,4393,0,0,,7555,1231
24,06-10-18,14,3:15,3:30,45.48,43.49,0,45.48,43.07,2,-36197,30156,66353,-6041,0,-10,5360,0,0,,5370,5350
24,06-10-18,15,3:30,3:45,45.48,37.78,0,37.78,37.78,-1,-28330,54936,83266,26606,0,-2075,17,0,0,,2092,-2058
24,06-10-18,16,3:45,4:00,,37.78,0,37.78,37.78,-1,-18594,56876,75470,38282,0,-1491,0,0,0,,1491,-1491
24,06-10-18,17,4:00,4:15,,43.66,0,43.66,43.66,-1,-27915,43213,71128,15298,0,-571,0,0,0,,571,-571
24,06-10-18,18,4:15,4:30,,,0,43.16,43.16,0,-12184,46238,58422,34054,0,0,0,0,0,,0,0
24,06-10-18,19,4:30,4:45,,43.71,0,43.71,43.71,-1,-9581,38283,47864,28702,0,-7,0,0,0,,7,-7
24,06-10-18,20,4:45,5:00,,37.78,0,37.78,37.78,-1,-8492,36345,44837,27853,0,-4483,0,0,0,,4483,-4483
24,06-10-18,21,5:00,5:15,52.12,42.79,0,52.12,42.79,2,-40785,19238,60023,-21547,0,-1753,4884,0,0,,6637,3131
24,06-10-18,22,5:15,5:30,45.26,,0,45.26,45.26,1,-23332,20864,44196,-2468,0,0,4129,0,0,,4129,4129
24,06-10-18,23,5:30,5:45,,,0,42.97,42.97,0,-20721,30280,51001,9559,0,0,0,0,0,,0,0
24,06-10-18,24,5:45,6:00,,43.11,0,43.11,43.11,-1,-15345,32505,47850,17160,0,-342,0,0,0,,342,-342
24,06-10-18,25,6:00,6:15,,38.6,0,38.6,38.6,-1,-26180,32890,59070,6710,0,-2578,0,0,0,,2578,-2578
24,06-10-18,26,6:15,6:30,,38.6,0,38.6,38.6,-1,-20226,47975,68201,27749,0,-3771,0,0,0,,3771,-3771
24,06-10-18,27,6:30,6:45,,38.6,0,38.6,38.6,-1,-23184,50715,73899,27531,0,-1726,0,0,0,,1726,-1726
24,06-10-18,28,6:45,7:00,,38.6,0,38.6,38.6,-1,-8595,53736,62331,45141,0,-3180,0,0,0,,3180,-3180
24,06-10-18,29,7:00,7:15,,43.83,0,43.83,43.83,-1,-13762,69549,83311,55787,0,-2168,0,0,0,,2168,-2168
24,06-10-18,30,7:15,7:30,,43.93,0,43.93,43.93,-1,-2632,67502,70134,64870,0,-380,0,0,0,,380,-380
24,06-10-18,31,7:30,7:45,,43.89,0,43.89,43.89,-1,-7498,56881,64379,49383,0,-283,0,0,0,,283,-283
24,06-10-18,32,7:45,8:00,,,0,43.21,43.21,0,-5046,73020,78066,67974,0,0,0,0,0,,0,0
24,06-10-18,33,8:00,8:15,,38.6,0,38.6,38.6,-1,-7382,67483,74865,60101,0,-601,0,0,0,,601,-601
24,06-10-18,34,8:15,8:30,,30.55,0,30.55,30.55,-1,-936,76440,77376,75504,0,-3980,0,0,0,,3980,-3980
24,06-10-18,35,8:30,8:45,,-13.78,0,-13.78,-13.78,-1,-1099,73763,74862,72664,0,-26404,0,0,0,,26404,-26404
24,06-10-18,36,8:45,9:00,,34.6,0,34.6,34.6,-1,-10658,63898,74556,53240,0,-17129,0,0,0,,17129,-17129
24,06-10-18,37,9:00,9:15,,38.6,0,38.6,38.6,-1,-58781,91842,150623,33061,0,-680,0,0,0,,680,-680
24,06-10-18,38,9:15,9:30,,40.78,0,40.78,40.78,-1,-82370,87030,169400,4660,0,-919,0,0,0,,919,-919
24,06-10-18,39,9:30,9:45,,38.6,0,38.6,38.6,-1,-35304,74685,109989,39381,0,-1609,0,0,0,,1609,-1609
24,06-10-18,40,9:45,10:00,,38.6,0,38.6,38.6,-1,-29532,55288,84820,25756,0,-728,0,0,0,,728,-728
24,06-10-18,41,10:00,10:15,,38.6,0,38.6,38.6,-1,-34548,48899,83447,14351,0,-83,0,0,0,,83,-83
24,06-10-18,42,10:15,10:30,,,0,43.35,43.35,0,-27380,52989,80369,25609,0,0,0,0,0,,0,0
24,06-10-18,43,10:30,10:45,,38.6,0,38.6,38.6,-1,-21959,65440,87399,43481,0,-1294,0,0,0,,1294,-1294
24,06-10-18,44,10:45,11:00,,43.71,0,43.71,43.71,-1,-23862,60211,84073,36349,0,-1971,0,0,0,,1971,-1971
24,06-10-18,45,11:00,11:15,,44.16,0,44.16,44.16,-1,-35269,64395,99664,29126,0,-261,0,0,0,,261,-261
24,06-10-18,46,11:15,11:30,,44.16,0,44.16,44.16,-1,-32374,64819,97193,32445,0,-47,0,0,0,,47,-47
24,06-10-18,47,11:30,11:45,,44.16,0,44.16,44.16,-1,-34499,57656,92155,23157,0,-341,0,0,0,,341,-341
24,06-10-18,48,11:45,12:00,,,0,43.35,43.35,0,-34881,57333,92214,22452,0,0,0,0,0,,0,0
24,06-10-18,49,12:00,12:15,50.6,,0,50.6,50.6,1,-66297,46652,112949,-19645,0,0,3584,0,0,,3584,3584
24,06-10-18,50,12:15,12:30,42.54,,0,42.54,42.54,1,-49432,58925,108357,9493,0,0,1189,0,0,,1189,1189
24,06-10-18,51,12:30,12:45,,,0,43.35,43.35,0,-44255,67582,111837,23327,0,0,0,0,0,,0,0
24,06-10-18,52,12:45,13:00,,37.78,0,37.78,37.78,-1,-35343,68086,103429,32743,0,-261,0,0,0,,261,-261
24,06-10-18,53,13:00,13:15,,37.78,0,37.78,37.78,-1,-48295,55205,103500,6910,0,-636,0,0,0,,636,-636
24,06-10-18,54,13:15,13:30,,,0,43.33,43.33,0,-38609,60499,99108,21890,0,0,0,0,0,,0,0
24,06-10-18,55,13:30,13:45,,,0,43.34,43.34,0,-34803,54885,89688,20082,0,0,0,0,0,,0,0
24,06-10-18,56,13:45,14:00,,37.78,0,37.78,37.78,-1,-15161,59663,74824,44502,0,-1999,0,0,0,,1999,-1999
24,06-10-18,57,14:00,14:15,,30.6,0,30.6,30.6,-1,-32484,61157,93641,28673,0,-4422,0,0,0,,4422,-4422
24,06-10-18,58,14:15,14:30,,20.78,0,20.78,20.78,-1,-25925,74813,100738,48888,0,-9049,0,0,0,,9049,-9049
24,06-10-18,59,14:30,14:45,,29.49,0,29.49,29.49,-1,-21711,68436,90147,46725,0,-23339,0,0,0,,23339,-23339
24,06-10-18,60,14:45,15:00,,27.17,0,27.17,27.17,-1,-20864,59996,80860,39132,0,-32026,0,0,0,,32026,-32026
24,06-10-18,61,15:00,15:15,,34.6,0,34.6,34.6,-1,-45981,92155,138136,46174,0,-27562,0,0,0,,27562,-27562
24,06-10-18,62,15:15,15:30,,34.6,0,34.6,34.6,-1,-41731,88100,129831,46369,0,-23439,0,0,0,,23439,-23439
24,06-10-18,63,15:30,15:45,,30.6,0,30.6,30.6,-1,-46617,95607,142224,48990,0,-19986,0,0,0,,19986,-19986
24,06-10-18,64,15:45,16:00,,10.18,0,10.18,10.18,-1,-40552,97265,137817,56713,0,-26084,0,0,0,,26084,-26084
24,06-10-18,65,16:00,16:15,,0.73,0,0.73,0.73,-1,-47464,82419,129883,34955,0,-38314,0,0,0,,38314,-38314
24,06-10-18,66,16:15,16:30,,,0,42.93,42.93,0,-74418,82534,156952,8116,0,-5366,0,0,0,,5366,-5366
24,06-10-18,67,16:30,16:45,,30.6,0,30.6,30.6,-1,-47157,80575,127732,33418,0,-4156,0,0,0,,4156,-4156
24,06-10-18,68,16:45,17:00,,38.6,0,38.6,38.6,-1,-61720,58415,120135,-3305,0,-1151,0,0,0,,1151,-1151
24,06-10-18,69,17:00,17:15,,11.53,0,11.53,11.53,-1,-24493,119368,143861,94875,0,-8647,0,0,0,,8647,-8647
24,06-10-18,70,17:15,17:30,,43.95,0,43.95,43.95,-1,-33380,107816,141196,74436,0,-1173,0,0,0,,1173,-1173
24,06-10-18,71,17:30,17:45,,,0,43.22,43.22,0,-35009,76148,111157,41139,0,0,0,0,0,,0,0
24,06-10-18,72,17:45,18:00,,,0,43.18,43.18,0,-62522,62766,125288,244,0,0,0,0,0,,0,0
24,06-10-18,73,18:00,18:15,,,0,43.32,43.32,0,-15884,61703,77587,45819,0,0,0,0,0,,0,0
24,06-10-18,74,18:15,18:30,,,0,43.32,43.32,0,-12026,62682,74708,50656,0,0,0,0,0,,0,0
24,06-10-18,75,18:30,18:45,,,0,43.32,43.32,0,-13939,60897,74836,46958,0,0,0,0,0,,0,0
24,06-10-18,76,18:45,19:00,,44.09,0,44.09,44.09,-1,-11909,80767,92676,68858,0,-11,0,0,0,,11,-11
24,06-10-18,77,19:00,19:15,,40.84,0,40.84,40.84,-1,-8606,95301,103907,86695,0,-367,0,0,0,,367,-367
24,06-10-18,78,19:15,19:30,,44.1,0,44.1,44.1,-1,-34119,74101,108220,39982,0,-413,0,0,0,,413,-413
24,06-10-18,79,19:30,19:45,,,0,43.37,43.37,0,-33086,72373,105459,39287,0,0,0,0,0,,0,0
24,06-10-18,80,19:45,20:00,,,0,43.36,43.36,0,-43639,64841,108480,21202,0,0,0,0,0,,0,0
24,06-10-18,81,20:00,20:15,,,0,43.37,43.37,0,-41821,60082,101903,18261,0,0,0,0,0,,0,0
24,06-10-18,82,20:15,20:30,42.54,,0,42.54,42.54,1,-38504,40470,78974,1966,0,0,592,0,0,,592,592
24,06-10-18,83,20:30,20:45,42.54,,0,42.54,42.54,1,-32121,52267,84388,20146,0,0,377,0,0,,377,377
24,06-10-18,84,20:45,21:00,46.6,,0,46.6,46.6,1,-42724,46185,88909,3461,0,0,725,0,0,,725,725
24,06-10-18,85,21:00,21:15,46.6,,0,46.6,46.6,1,-44905,34635,79540,-10270,0,0,4433,0,0,,4433,4433
24,06-10-18,86,21:15,21:30,46.6,,0,46.6,46.6,1,-36630,24900,61530,-11730,0,0,5751,0,0,,5751,5751
24,06-10-18,87,21:30,21:45,42.54,,0,42.54,42.54,1,-26359,28425,54784,2066,0,0,3509,0,0,,3509,3509
24,06-10-18,88,21:45,22:00,,,0,43.37,43.37,0,-25082,52009,77091,26927,0,0,105,0,0,,105,105
24,06-10-18,89,22:00,22:15,46.6,,0,46.6,46.6,1,-43375,43498,86873,123,0,0,1196,0,0,,1196,1196
24,06-10-18,90,22:15,22:30,77.12,,0,77.12,77.12,1,-61985,39531,101516,-22454,0,0,17294,0,0,,17294,17294
24,06-10-18,91,22:30,22:45,47.75,,0,47.75,47.75,1,-52829,35043,87872,-17786,0,0,11906,0,0,,11906,11906
24,06-10-18,92,22:45,23:00,46.72,,0,46.72,46.72,1,-54931,40124,95055,-14807,0,0,16910,0,0,,16910,16910
24,06-10-18,93,23:00,23:15,50.6,,0,50.6,50.6,1,-59981,24225,84206,-35756,0,0,18434,0,0,,18434,18434
24,06-10-18,94,23:15,23:30,42.54,43.71,0,43.71,43.71,-1,-44075,48242,92317,4167,0,-30,7202,0,0,,7232,7172
24,06-10-18,95,23:30,23:45,,38.6,0,38.6,38.6,-1,-31616,61574,93190,29958,0,-2320,0,0,0,,2320,-2320
24,06-10-18,96,23:45,0:00,,30.21,0,30.21,30.21,-1,-27163,66469,93632,39306,0,-3692,0,0,0,,3692,-3692
24,06-11-18,1,0:00,0:15,62.02,12.03,0,62.02,12.03,2,-46943,23446,70389,-23497,0,-4908,2326,0,0,,7234,-2582
24,06-11-18,2,0:15,0:30,42.6,,0,42.6,42.6,1,-24009,26806,50815,2797,0,0,1883,0,0,,1883,1883
24,06-11-18,3,0:30,0:45,,34.55,0,34.55,34.55,-1,-14653,74857,89510,60204,0,-256,0,0,0,,256,-256
24,06-11-18,4,0:45,1:00,,-150.03,0,-150.03,-150.03,-1,-26540,101018,127558,74478,0,-26477,0,0,0,,26477,-26477
24,06-11-18,5,1:00,1:15,53.02,34.55,0,53.02,34.55,2,-43408,17979,61387,-25429,0,-6398,1620,0,0,,8018,-4778
24,06-11-18,6,1:15,1:30,42.6,,0,42.6,42.6,1,-32416,37604,70020,5188,0,0,793,0,0,,793,793
24,06-11-18,7,1:30,1:45,42.6,,0,42.6,42.6,1,-30540,61656,92196,31116,0,0,259,0,0,,259,259
24,06-11-18,8,1:45,2:00,,34.55,0,34.55,34.55,-1,-20856,52073,72929,31217,0,-866,0,0,0,,866,-866
24,06-11-18,9,2:00,2:15,46.6,34.55,0,46.6,46.6,1,-43598,34985,78583,-8613,0,-636,2295,0,0,,2931,1659
24,06-11-18,10,2:15,2:30,42.6,,0,42.6,42.6,1,-30560,34720,65280,4160,0,0,2209,0,0,,2209,2209
24,06-11-18,11,2:30,2:45,,34.55,0,34.55,34.55,-1,-23193,32678,55871,9485,0,-730,0,0,0,,730,-730
24,06-11-18,12,2:45,3:00,,34.55,0,34.55,34.55,-1,-22068,39844,61912,17776,0,-6247,0,0,0,,6247,-6247
24,06-11-18,13,3:00,3:15,,38.4,0,38.4,38.4,-1,-35523,40205,75728,4682,0,-3125,0,0,0,,3125,-3125
24,06-11-18,14,3:15,3:30,,38.4,0,38.4,38.4,-1,-32843,42269,75112,9426,0,-1760,0,0,0,,1760,-1760
24,06-11-18,15,3:30,3:45,,34.55,0,34.55,34.55,-1,-22891,35192,58083,12301,0,-5924,0,0,0,,5924,-5924
24,06-11-18,16,3:45,4:00,,30.6,0,30.6,30.6,-1,-17106,47769,64875,30663,0,-16353,0,0,0,,16353,-16353
24,06-11-18,17,4:00,4:15,,38.4,0,38.4,38.4,-1,-35816,36502,72318,686,0,-9326,0,0,0,,9326,-9326
24,06-11-18,18,4:15,4:30,,,0,43.14,43.14,0,-20124,30863,50987,10739,0,-23,0,0,0,,23,-23
24,06-11-18,19,4:30,4:45,103.01,,0,103.01,103.01,1,-51694,20906,72600,-30788,0,0,13465,0,0,,13465,13465
24,06-11-18,20,4:45,5:00,51.02,,0,51.02,51.02,1,-39987,37397,77384,-2590,0,0,21271,0,0,,21271,21271
24,06-11-18,21,5:00,5:15,51.02,37.03,0,37.03,37.03,-1,-26486,40064,66550,13578,0,-1534,1754,0,0,,3288,220
24,06-11-18,22,5:15,5:30,,24.03,0,24.03,24.03,-1,-14998,51814,66812,36816,0,-16278,0,0,0,,16278,-16278
24,06-11-18,23,5:30,5:45,,34.55,0,34.55,34.55,-1,-12163,55352,67515,43189,0,-13375,0,0,0,,13375,-13375
24,06-11-18,24,5:45,6:00,,,0,42.81,42.81,0,-42308,79159,121467,36851,0,-1770,0,0,0,,1770,-1770
24,06-11-18,25,6:00,6:15,,-150.03,0,-150.03,-150.03,-1,-69812,140130,209942,70318,0,-21290,0,0,0,,21290,-21290
24,06-11-18,26,6:15,6:30,,29.93,0,29.93,29.93,-1,-24043,113000,137043,88957,0,-19600,0,0,0,,19600,-19600
24,06-11-18,27,6:30,6:45,,,0,43.41,43.41,0,-31350,59343,90693,27993,0,-4651,0,0,0,,4651,-4651
24,06-11-18,28,6:45,7:00,51.02,,0,51.02,51.02,1,-56291,39684,95975,-16607,0,0,6909,0,0,,6909,6909
24,06-11-18,29,7:00,7:15,42.53,-150.03,0,43.47,-150.03,2,-41621,146113,187734,104492,0,-17871,2803,0,0,,20674,-15068
24,06-11-18,30,7:15,7:30,,30.53,0,30.53,30.53,-1,-35183,102634,137817,67451,0,-15404,0,0,0,,15404,-15404
24,06-11-18,31,7:30,7:45,,,0,43.9,43.9,0,-38181,67366,105547,29185,0,-552,0,0,0,,552,-552
24,06-11-18,32,7:45,8:00,,38.34,0,38.34,38.34,-1,-40268,81797,122065,41529,0,-37,0,0,0,,37,-37
24,06-11-18,33,8:00,8:15,,34.48,0,34.48,34.48,-1,-54357,112545,166902,58188,0,-2538,0,0,0,,2538,-2538
24,06-11-18,34,8:15,8:30,,43.42,0,43.42,43.42,-1,-37007,93196,130203,56189,0,-1530,0,0,0,,1530,-1530
24,06-11-18,35,8:30,8:45,,34.48,0,34.48,34.48,-1,-35948,74998,110946,39050,0,-1949,0,0,0,,1949,-1949
24,06-11-18,36,8:45,9:00,,30.53,0,30.53,30.53,-1,-33554,62442,95996,28888,0,-5119,0,0,0,,5119,-5119
24,06-11-18,37,9:00,9:15,,43.61,0,43.61,43.61,-1,-26311,74850,101161,48539,0,-1624,0,0,0,,1624,-1624
24,06-11-18,38,9:15,9:30,,,0,43.86,43.86,0,-34332,80117,114449,45785,0,0,0,0,0,,0,0
24,06-11-18,39,9:30,9:45,,,0,43.88,43.88,0,-27236,107310,134546,80074,0,0,0,0,0,,0,0
24,06-11-18,40,9:45,10:00,,9.41,0,9.41,9.41,-1,-13575,124476,138051,110901,0,-7440,0,0,0,,7440,-7440
24,06-11-18,41,10:00,10:15,,38.34,0,38.34,38.34,-1,-92191,42647,134838,-49544,0,-4928,0,0,0,,4928,-4928
24,06-11-18,42,10:15,10:30,,,0,43.92,43.92,0,-55376,62891,118267,7515,0,0,0,0,0,,0,0
24,06-11-18,43,10:30,10:45,,,0,43.94,43.94,0,-69064,59905,128969,-9159,0,0,0,0,0,,0,0
24,06-11-18,44,10:45,11:00,,34.48,0,34.48,34.48,-1,-52822,53842,106664,1020,0,-990,0,0,0,,990,-990
24,06-11-18,45,11:00,11:15,,31.03,0,31.03,31.03,-1,-44784,57388,102172,12604,0,-2004,0,0,0,,2004,-2004
24,06-11-18,46,11:15,11:30,,44.31,0,44.31,44.31,-1,-52792,47411,100203,-5381,0,-50,0,0,0,,50,-50
24,06-11-18,47,11:30,11:45,,44.32,0,44.32,44.32,-1,-56625,60291,116916,3666,0,-124,0,0,0,,124,-124
24,06-11-18,48,11:45,12:00,43.55,,0,43.55,43.55,1,-64693,58165,122858,-6528,0,0,2,0,0,,2,2
24,06-11-18,49,12:00,12:15,43.55,,0,43.55,43.55,1,-78091,51664,129755,-26427,0,0,233,0,0,,233,233
24,06-11-18,50,12:15,12:30,43.02,,0,43.02,43.02,1,-71441,72787,144228,1346,0,0,23,0,0,,23,23
24,06-11-18,51,12:30,12:45,,38.03,0,38.03,38.03,-1,-69454,99342,168796,29888,0,-1153,0,0,0,,1153,-1153
24,06-11-18,52,12:45,13:00,,31.07,0,31.07,31.07,-1,-68754,104705,173459,35951,0,-6414,0,0,0,,6414,-6414
24,06-11-18,53,13:00,13:15,,30.53,0,30.53,30.53,-1,-66989,80141,147130,13152,0,-8464,0,0,0,,8464,-8464
24,06-11-18,54,13:15,13:30,43.55,38.34,0,43.71,38.34,2,-58945,68411,127356,9466,0,-328,469,0,0,,797,141
24,06-11-18,55,13:30,13:45,,31.62,0,31.62,31.62,-1,-58306,87291,145597,28985,0,-3464,0,0,0,,3464,-3464
24,06-11-18,56,13:45,14:00,,23.34,0,23.34,23.34,-1,-44437,102051,146488,57614,0,-23229,0,0,0,,23229,-23229
24,06-11-18,57,14:00,14:15,,34.48,0,34.48,34.48,-1,-56666,86020,142686,29354,0,-15217,0,0,0,,15217,-15217
24,06-11-18,58,14:15,14:30,,,0,43.55,43.55,0,-60356,85850,146206,25494,0,-245,0,0,0,,245,-245
24,06-11-18,59,14:30,14:45,,,0,43.55,43.55,0,-58936,100749,159685,41813,0,0,0,0,0,,0,0
24,06-11-18,60,14:45,15:00,,,0,43.55,43.55,0,-64427,98461,162888,34034,0,0,0,0,0,,0,0
24,06-11-18,61,15:00,15:15,45.01,,0,45.01,45.01,1,-76055,103569,179624,27514,0,0,97,0,0,,97,97
24,06-11-18,62,15:15,15:30,,,0,43.12,43.12,0,-65057,87244,152301,22187,0,0,0,0,0,,0,0
24,06-11-18,63,15:30,15:45,,,0,43.12,43.12,0,-62755,81493,144248,18738,0,0,0,0,0,,0,0
24,06-11-18,64,15:45,16:00,,,0,43.12,43.12,0,-52347,79030,131377,26683,0,0,0,0,0,,0,0
24,06-11-18,65,16:00,16:15,,,0,43.08,43.08,0,-59797,94235,154032,34438,0,0,0,0,0,,0,0
24,06-11-18,66,16:15,16:30,,,0,43.08,43.08,0,-58394,65218,123612,6824,0,0,0,0,0,,0,0
24,06-11-18,67,16:30,16:45,52.57,,0,52.57,52.57,1,-66322,44310,110632,-22012,0,0,1311,0,0,,1311,1311
24,06-11-18,68,16:45,17:00,59.58,,0,59.58,59.58,1,-80358,18408,98766,-61950,0,0,11553,0,0,,11553,11553
24,06-11-18,69,17:00,17:15,52.57,,0,52.57,52.57,1,-77571,40480,118051,-37091,0,0,9100,0,0,,9100,9100
24,06-11-18,70,17:15,17:30,52.57,,0,52.57,52.57,1,-73226,23968,97194,-49258,0,0,3331,0,0,,3331,3331
24,06-11-18,71,17:30,17:45,83.02,,0,83.02,83.02,1,-94217,20855,115072,-73362,0,0,22748,0,0,,22748,22748
24,06-11-18,72,17:45,18:00,78.95,,0,78.95,78.95,1,-81107,23976,105083,-57131,0,0,34084,0,0,,34084,34084
24,06-11-18,73,18:00,18:15,56.02,39.4,0,39.4,39.4,-1,-80170,68864,149034,-11306,0,-294,18753,0,0,,19047,18459
24,06-11-18,74,18:15,18:30,,,0,43.68,43.68,0,-57195,78023,135218,20828,0,-149,19,0,0,,168,-130
24,06-11-18,75,18:30,18:45,,,0,43.7,43.7,0,-38769,87884,126653,49115,0,0,0,0,0,,0,0
24,06-11-18,76,18:45,19:00,,,0,43.68,43.68,0,-46132,104353,150485,58221,0,0,0,0,0,,0,0
24,06-11-18,77,19:00,19:15,56.02,,0,56.02,56.02,1,-52679,43411,96090,-9268,0,0,3421,0,0,,3421,3421
24,06-11-18,78,19:15,19:30,56.02,,0,56.02,56.02,1,-65496,34129,99625,-31367,0,0,19539,0,0,,19539,19539
24,06-11-18,79,19:30,19:45,48.57,,0,48.57,48.57,1,-67461,42514,109975,-24947,0,0,24719,0,0,,24719,24719
24,06-11-18,80,19:45,20:00,46.42,,0,46.42,46.42,1,-62233,48428,110661,-13805,0,0,14376,0,0,,14376,14376
24,06-11-18,81,20:00,20:15,52.57,,0,52.57,52.57,1,-76254,46926,123180,-29328,0,0,11715,0,0,,11715,11715
24,06-11-18,82,20:15,20:30,48.74,,0,48.74,48.74,1,-81967,45276,127243,-36691,0,0,17490,0,0,,17490,17490
24,06-11-18,83,20:30,20:45,48.57,,0,48.57,48.57,1,-69562,55832,125394,-13730,0,0,15030,0,0,,15030,15030
24,06-11-18,84,20:45,21:00,48.57,40,0,40,40,-1,-49174,54576,103750,5402,0,-649,1829,0,0,,2478,1180
24,06-11-18,85,21:00,21:15,52.57,44.29,0,52.57,43.66,2,-59649,37514,97163,-22135,0,-236,3777,0,0,,4013,3541
24,06-11-18,86,21:15,21:30,43.55,,0,43.55,43.55,1,-65033,51023,116056,-14010,0,0,2546,0,0,,2546,2546
24,06-11-18,87,21:30,21:45,45.97,,0,45.97,45.97,1,-64546,63475,128021,-1071,0,0,1004,0,0,,1004,1004
24,06-11-18,88,21:45,22:00,48.57,,0,48.57,48.57,1,-95449,60814,156263,-34635,0,0,1181,0,0,,1181,1181
24,06-11-18,89,22:00,22:15,43.55,,0,43.55,43.55,1,-56167,48551,104718,-7616,0,0,1341,0,0,,1341,1341
24,06-11-18,90,22:15,22:30,52.57,,0,52.57,52.57,1,-63705,29622,93327,-34083,0,0,8755,0,0,,8755,8755
24,06-11-18,91,22:30,22:45,63.02,,0,63.02,63.02,1,-70432,35803,106235,-34629,0,0,4291,0,0,,4291,4291
24,06-11-18,92,22:45,23:00,83.81,40.03,0,83.81,27.19,2,-55027,59796,114823,4769,0,-153,9165,0,0,,9318,9012
24,06-11-18,93,23:00,23:15,151.02,38.03,0,151.02,38.03,2,-84986,42989,127975,-41997,0,-197,13873,0,0,,14070,13676
24,06-11-18,94,23:15,23:30,50,,0,50,50,1,-62758,37879,100637,-24879,0,0,25614,0,0,,25614,25614
24,06-11-18,95,23:30,23:45,44.91,43.38,0,43.38,43.38,-1,-49138,47860,96998,-1278,0,-131,9683,0,0,,9814,9552
24,06-11-18,96,23:45,0:00,52.57,38.34,0,52.57,38.34,2,-59364,61923,121287,2559,0,-895,802,0,0,,1697,-93
24,06-12-18,1,0:00,0:15,268.12,,0,268.12,268.12,1,-156985,23934,180919,-133051,0,0,35193,0,0,,35193,35193
24,06-12-18,2,0:15,0:30,47.12,38.78,0,38.78,38.78,-1,-48018,44565,92583,-3453,0,-185,10755,0,0,,10940,10570
24,06-12-18,3,0:30,0:45,,40.78,0,40.78,40.78,-1,-49710,50955,100665,1245,0,-951,0,0,0,,951,-951
24,06-12-18,4,0:45,1:00,,31.99,0,31.99,31.99,-1,-43622,62246,105868,18624,0,-11580,0,0,0,,11580,-11580
24,06-12-18,5,1:00,1:15,137.06,38.66,0,137.06,137.06,1,-99809,76135,175944,-23674,0,-6714,5230,0,0,,11944,-1484
24,06-12-18,6,1:15,1:30,209.12,38.66,0,209.12,209.12,1,-75902,49898,125800,-26004,0,-37,20997,0,0,,21034,20960
24,06-12-18,7,1:30,1:45,,,0,42.25,42.25,0,-76458,73063,149521,-3395,0,0,1160,0,0,,1160,1160
24,06-12-18,8,1:45,2:00,,,0,42.26,42.26,0,-84044,78105,162149,-5939,0,0,0,0,0,,0,0
24,06-12-18,9,2:00,2:15,73.84,,0,73.84,73.84,1,-104906,75404,180310,-29502,0,0,14016,0,0,,14016,14016
24,06-12-18,10,2:15,2:30,45.55,,0,45.55,45.55,1,-94464,82400,176864,-12064,0,0,13417,0,0,,13417,13417
24,06-12-18,11,2:30,2:45,44.54,,0,44.54,44.54,1,-91670,84600,176270,-7070,0,0,9244,0,0,,9244,9244
24,06-12-18,12,2:45,3:00,41.55,,0,41.55,41.55,1,-79232,88183,167415,8951,0,0,1966,0,0,,1966,1966
24,06-12-18,13,3:00,3:15,268.12,,0,268.12,268.12,1,-103870,61059,164929,-42811,0,0,22080,0,0,,22080,22080
24,06-12-18,14,3:15,3:30,41.55,38.66,0,42.03,38.66,2,-73227,80247,153474,7020,0,-1396,1469,0,0,,2865,73
24,06-12-18,15,3:30,3:45,45.31,42.04,0,45.31,42.03,2,-85412,77054,162466,-8358,0,-1338,257,0,0,,1595,-1081
24,06-12-18,16,3:45,4:00,45.29,42.04,0,45.29,45.29,1,-93670,84406,178076,-9264,0,-16,1662,0,0,,1678,1646
24,06-12-18,17,4:00,4:15,45.56,,0,45.56,45.56,1,-99223,85580,184803,-13643,0,0,5668,0,0,,5668,5668
24,06-12-18,18,4:15,4:30,47.99,,0,47.99,47.99,1,-102481,77419,179900,-25062,0,0,12160,0,0,,12160,12160
24,06-12-18,19,4:30,4:45,45.78,,0,45.78,45.78,1,-101118,83770,184888,-17348,0,0,16273,0,0,,16273,16273
24,06-12-18,20,4:45,5:00,50.96,,0,50.96,50.96,1,-92027,79240,171267,-12787,0,0,17474,0,0,,17474,17474
24,06-12-18,21,5:00,5:15,45.12,28.97,0,45.12,28.97,2,-66700,68721,135421,2021,0,-4001,8757,0,0,,12758,4756
24,06-12-18,22,5:15,5:30,,38.66,0,38.66,38.66,-1,-74539,82123,156662,7584,0,-6203,0,0,0,,6203,-6203
24,06-12-18,23,5:30,5:45,44.67,42.21,0,44.67,42.21,2,-83924,76121,160045,-7803,0,-3673,445,0,0,,4118,-3228
24,06-12-18,24,5:45,6:00,42.66,29.32,0,42.66,29.32,2,-64166,71848,136014,7682,0,-3191,86,0,0,,3277,-3105
24,06-12-18,25,6:00,6:15,,7.86,0,7.86,7.86,-1,-59504,119953,179457,60449,0,-41091,0,0,0,,41091,-41091
24,06-12-18,26,6:15,6:30,,30.01,0,30.01,30.01,-1,-60139,93542,153681,33403,0,-45908,0,0,0,,45908,-45908
24,06-12-18,27,6:30,6:45,102.12,38.01,0,102.12,102.12,1,-86696,64793,151489,-21903,0,-13381,2121,0,0,,15502,-11260
24,06-12-18,28,6:45,7:00,180,38.01,0,180,180,1,-106710,59001,165711,-47709,0,-9,37864,0,0,,37873,37855
24,06-12-18,29,7:00,7:15,180,-150.78,0,-150.78,-150.78,-1,-35068,172744,207812,137676,0,-24642,10973,0,0,,35615,-13669
24,06-12-18,30,7:15,7:30,,28.44,0,28.44,28.44,-1,-50436,86429,136865,35993,0,-30330,0,0,0,,30330,-30330
24,06-12-18,31,7:30,7:45,49.4,28.44,0,49.4,49.4,1,-76221,49571,125792,-26650,0,-2194,1894,0,0,,4088,-300
24,06-12-18,32,7:45,8:00,92.35,,0,92.35,92.35,1,-126503,43071,169574,-83432,0,0,12936,0,0,,12936,12936
24,06-12-18,33,8:00,8:15,45.47,38.78,0,38.78,38.78,-1,-80371,114889,195260,34518,0,-279,7015,0,0,,7294,6736
24,06-12-18,34,8:15,8:30,,38.78,0,38.78,38.78,-1,-74494,78511,153005,4017,0,-1183,0,0,0,,1183,-1183
24,06-12-18,35,8:30,8:45,46.09,,0,46.09,46.09,1,-92078,64777,156855,-27301,0,0,1890,0,0,,1890,1890
24,06-12-18,36,8:45,9:00,48.99,,0,48.99,48.99,1,-129855,54135,183990,-75720,0,0,7574,0,0,,7574,7574
24,06-12-18,37,9:00,9:15,50.99,,0,50.99,50.99,1,-113454,77235,190689,-36219,0,0,2438,0,0,,2438,2438
24,06-12-18,38,9:15,9:30,96.12,,0,96.12,96.12,1,-110109,73178,183287,-36931,0,0,25063,0,0,,25063,25063
24,06-12-18,39,9:30,9:45,46.01,,0,46.01,46.01,1,-90462,75621,166083,-14841,0,0,17138,0,0,,17138,17138
24,06-12-18,40,9:45,10:00,50.99,,0,50.99,50.99,1,-89917,67626,157543,-22291,0,0,9467,0,0,,9467,9467
24,06-12-18,41,10:00,10:15,69.12,,0,69.12,69.12,1,-118370,58840,177210,-59530,0,0,28782,0,0,,28782,28782
24,06-12-18,42,10:15,10:30,48.68,,0,48.68,48.68,1,-103575,65764,169339,-37811,0,0,18398,0,0,,18398,18398
24,06-12-18,43,10:30,10:45,60.12,,0,60.12,60.12,1,-100370,61609,161979,-38761,0,0,17649,0,0,,17649,17649
24,06-12-18,44,10:45,11:00,69.12,,0,69.12,69.12,1,-104561,57624,162185,-46937,0,0,28559,0,0,,28559,28559
24,06-12-18,45,11:00,11:15,145.12,,0,145.12,145.12,1,-118447,57975,176422,-60472,0,0,44175,0,0,,44175,44175
24,06-12-18,46,11:15,11:30,61.12,,0,61.12,61.12,1,-116107,79387,195494,-36720,0,0,41386,0,0,,41386,41386
24,06-12-18,47,11:30,11:45,50.2,,0,50.2,50.2,1,-117060,81723,198783,-35337,0,0,36099,0,0,,36099,36099
24,06-12-18,48,11:45,12:00,50.01,,0,50.01,50.01,1,-118330,85026,203356,-33304,0,0,30989,0,0,,30989,30989
24,06-12-18,49,12:00,12:15,151.12,,0,151.12,151.12,1,-156395,54576,210971,-101819,0,0,37013,0,0,,37013,37013
24,06-12-18,50,12:15,12:30,151.12,,0,151.12,151.12,1,-158224,73838,232062,-84386,0,0,54430,0,0,,54430,54430
24,06-12-18,51,12:30,12:45,63.15,,0,63.15,63.15,1,-138459,78174,216633,-60285,0,0,37983,0,0,,37983,37983
24,06-12-18,52,12:45,13:00,60.12,,0,60.12,60.12,1,-147222,76435,223657,-70787,0,0,25244,0,0,,25244,25244
24,06-12-18,53,13:00,13:15,173.04,,0,173.04,173.04,1,-171124,66610,237734,-104514,0,0,44478,0,0,,44478,44478
24,06-12-18,54,13:15,13:30,112.46,,0,112.46,112.46,1,-175845,81115,256960,-94730,0,0,50855,0,0,,50855,50855
24,06-12-18,55,13:30,13:45,61.52,,0,61.52,61.52,1,-167447,89217,256664,-78230,0,0,33183,0,0,,33183,33183
24,06-12-18,56,13:45,14:00,57.12,,0,57.12,57.12,1,-156306,85930,242236,-70376,0,0,33424,0,0,,33424,33424
24,06-12-18,57,14:00,14:15,46.01,,0,46.01,46.01,1,-151371,115123,266494,-36248,0,0,11395,0,0,,11395,11395
24,06-12-18,58,14:15,14:30,47.33,,0,47.33,47.33,1,-173538,112963,286501,-60575,0,0,1375,0,0,,1375,1375
24,06-12-18,59,14:30,14:45,41.95,,0,41.95,41.95,1,-169490,101666,271156,-67824,0,0,760,0,0,,760,760
24,06-12-18,60,14:45,15:00,41.95,,0,41.95,41.95,1,-164468,90392,254860,-74076,0,0,536,0,0,,536,536
24,06-12-18,61,15:00,15:15,41.95,,0,41.95,41.95,1,-129935,76425,206360,-53510,0,0,732,0,0,,732,732
24,06-12-18,62,15:15,15:30,41.95,,0,41.95,41.95,1,-147648,75952,223600,-71696,0,0,1289,0,0,,1289,1289
24,06-12-18,63,15:30,15:45,41.95,,0,41.95,41.95,1,-139096,79453,218549,-59643,0,0,2485,0,0,,2485,2485
24,06-12-18,64,15:45,16:00,41.95,,0,41.95,41.95,1,-117259,96209,213468,-21050,0,0,951,0,0,,951,951
24,06-12-18,65,16:00,16:15,121.58,,0,121.58,121.58,1,-124580,84961,209541,-39619,0,0,18430,0,0,,18430,18430
24,06-12-18,66,16:15,16:30,50.01,,0,50.01,50.01,1,-120038,104711,224749,-15327,0,0,19454,0,0,,19454,19454
24,06-12-18,67,16:30,16:45,50.01,43.29,0,43.29,43.29,-1,-99918,94740,194658,-5178,0,-251,839,0,0,,1090,588
24,06-12-18,68,16:45,17:00,46.01,,0,46.01,46.01,1,-107245,85410,192655,-21835,0,0,2666,0,0,,2666,2666
24,06-12-18,69,17:00,17:15,46.01,,0,46.01,46.01,1,-79788,67555,147343,-12233,0,0,1392,0,0,,1392,1392
24,06-12-18,70,17:15,17:30,,37.96,0,37.96,37.96,-1,-66499,82323,148822,15824,0,-2789,0,0,0,,2789,-2789
24,06-12-18,71,17:30,17:45,,38.01,0,38.01,38.01,-1,-65791,76252,142043,10461,0,-4045,0,0,0,,4045,-4045
24,06-12-18,72,17:45,18:00,,38.01,0,38.01,38.01,-1,-54568,81098,135666,26530,0,-2187,0,0,0,,2187,-2187
24,06-12-18,73,18:00,18:15,,40.96,0,40.96,40.96,-1,-53182,39027,92209,-14155,0,-874,0,0,0,,874,-874
24,06-12-18,74,18:15,18:30,,34.01,0,34.01,34.01,-1,-37399,64672,102071,27273,0,-11443,0,0,0,,11443,-11443
24,06-12-18,75,18:30,18:45,,34.01,0,34.01,34.01,-1,-30120,83244,113364,53124,0,-18218,0,0,0,,18218,-18218
24,06-12-18,76,18:45,19:00,,,0,42.44,42.44,0,-34764,95849,130613,61085,0,-3424,0,0,0,,3424,-3424
24,06-12-18,77,19:00,19:15,,,0,42.44,42.44,0,-66985,73575,140560,6590,0,0,0,0,0,,0,0
24,06-12-18,78,19:15,19:30,,,0,42.44,42.44,0,-58646,73329,131975,14683,0,0,0,0,0,,0,0
24,06-12-18,79,19:30,19:45,,,0,42.45,42.45,0,-53228,76276,129504,23048,0,0,0,0,0,,0,0
24,06-12-18,80,19:45,20:00,,43.84,0,43.84,43.84,-1,-46495,82030,128525,35535,0,-106,0,0,0,,106,-106
24,06-12-18,81,20:00,20:15,,43.8,0,43.8,43.8,-1,-58869,90144,149013,31275,0,-219,0,0,0,,219,-219
24,06-12-18,82,20:15,20:30,,,0,42.46,42.46,0,-80381,83771,164152,3390,0,0,0,0,0,,0,0
24,06-12-18,83,20:30,20:45,,,0,42.46,42.46,0,-72362,93078,165440,20716,0,0,0,0,0,,0,0
24,06-12-18,84,20:45,21:00,,,0,42.88,42.88,0,-66338,101113,167451,34775,0,0,0,0,0,,0,0
24,06-12-18,85,21:00,21:15,46.01,,0,46.01,46.01,1,-69908,63608,133516,-6300,0,0,730,0,0,,730,730
24,06-12-18,86,21:15,21:30,47.2,,0,47.2,47.2,1,-83746,88985,172731,5239,0,0,6199,0,0,,6199,6199
24,06-12-18,87,21:30,21:45,,,0,42.73,42.73,0,-57886,83435,141321,25549,0,0,278,0,0,,278,278
24,06-12-18,88,21:45,22:00,,,0,42.73,42.73,0,-34614,76002,110616,41388,0,0,0,0,0,,0,0
24,06-12-18,89,22:00,22:15,,5.4,0,5.4,5.4,-1,-20912,84456,105368,63544,0,-15925,0,0,0,,15925,-15925
24,06-12-18,90,22:15,22:30,,30.99,0,30.99,30.99,-1,-57769,78762,136531,20993,0,-23461,0,0,0,,23461,-23461
24,06-12-18,91,22:30,22:45,,,0,42.88,42.88,0,-58914,95147,154061,36233,0,-352,0,0,0,,352,-352
24,06-12-18,92,22:45,23:00,,,0,42.9,42.9,0,-40468,116241,156709,75773,0,0,0,0,0,,0,0
24,06-12-18,93,23:00,23:15,47.2,,0,47.2,47.2,1,-90058,64687,154745,-25371,0,0,3601,0,0,,3601,3601
24,06-12-18,94,23:15,23:30,70.12,,0,70.12,70.12,1,-79094,47886,126980,-31208,0,0,17556,0,0,,17556,17556
24,06-12-18,95,23:30,23:45,45.59,38.01,0,38.01,38.01,-1,-38960,64544,103504,25584,0,-379,8791,0,0,,9170,8412
24,06-12-18,96,23:45,0:00,41.95,38.01,0,41.95,41.95,1,-66116,68611,134727,2495,0,-9,123,0,0,,132,114
24,06/13/2018,1,0:00,0:15,,34.02,0,34.02,34.02,-1,-39211,78191,117402,38980,0,-680,0,0,0,,680,-680
24,06/13/2018,2,0:15,0:30,,,0,42.57,42.57,0,-70706,74251,144957,3545,0,0,0,0,0,,0,0
24,06/13/2018,3,0:30,0:45,42.02,,0,42.02,42.02,1,-72226,69737,141963,-2489,0,0,42,0,0,,42,42
24,06/13/2018,4,0:45,1:00,46.09,,0,46.09,46.09,1,-87239,65929,153168,-21310,0,0,3536,0,0,,3536,3536
24,06/13/2018,5,1:00,1:15,156.02,,0,156.02,156.02,1,-92451,57872,150323,-34579,0,0,15716,0,0,,15716,15716
24,06/13/2018,6,1:15,1:30,48.99,42.01,0,42.01,42.01,-1,-53295,60978,114273,7683,0,-55,12324,0,0,,12379,12269
24,06/13/2018,7,1:30,1:45,48.99,30.02,0,30.02,30.02,-1,-16015,75251,91266,59236,0,-634,186,0,0,,820,-448
24,06/13/2018,8,1:45,2:00,,25.03,0,25.03,25.03,-1,-25536,87875,113411,62339,0,-12738,0,0,0,,12738,-12738
24,06/13/2018,9,2:00,2:15,,13.03,0,13.03,13.03,-1,-29490,52053,81543,22563,0,-11123,0,0,0,,11123,-11123
24,06/13/2018,10,2:15,2:30,,34.02,0,34.02,34.02,-1,-28062,57149,85211,29087,0,-280,0,0,0,,280,-280
24,06/13/2018,11,2:30,2:45,,-43.03,0,-43.03,-43.03,-1,-27696,72201,99897,44505,0,-26262,0,0,0,,26262,-26262
24,06/13/2018,12,2:45,3:00,,30.02,0,30.02,30.02,-1,-46219,78878,125097,32659,0,-24485,0,0,0,,24485,-24485
24,06/13/2018,13,3:00,3:15,50.02,38.02,0,50.02,38.02,2,-76445,54285,130730,-22160,0,-8968,2433,0,0,,11401,-6535
24,06/13/2018,14,3:15,3:30,44.81,,0,44.81,44.81,1,-55700,82953,138653,27253,0,0,2319,0,0,,2319,2319
24,06/13/2018,15,3:30,3:45,42.02,,0,42.02,42.02,1,-51514,83035,134549,31521,0,0,21,0,0,,21,21
24,06/13/2018,16,3:45,4:00,,,0,42.4,42.4,0,-43457,86473,129930,43016,0,0,0,0,0,,0,0
24,06/13/2018,17,4:00,4:15,,,0,42.48,42.48,0,-48322,64365,112687,16043,0,0,0,0,0,,0,0
24,06/13/2018,18,4:15,4:30,,34.02,0,34.02,34.02,-1,-47092,67356,114448,20264,0,-1682,0,0,0,,1682,-1682
24,06/13/2018,19,4:30,4:45,,34.02,0,34.02,34.02,-1,-38534,70980,109514,32446,0,-3145,0,0,0,,3145,-3145
24,06/13/2018,20,4:45,5:00,,34.02,0,34.02,34.02,-1,-47703,58057,105760,10354,0,-5903,0,0,0,,5903,-5903
24,06/13/2018,21,5:00,5:15,,30.02,0,30.02,30.02,-1,-32715,51199,83914,18484,0,-5755,0,0,0,,5755,-5755
24,06/13/2018,22,5:15,5:30,,-32.03,0,-32.03,-32.03,-1,-15913,64355,80268,48442,0,-22271,0,0,0,,22271,-22271
24,06/13/2018,23,5:30,5:45,,34.02,0,34.02,34.02,-1,-22958,67632,90590,44674,0,-13917,0,0,0,,13917,-13917
24,06/13/2018,24,5:45,6:00,,29.13,0,29.13,29.13,-1,-17089,102628,119717,85539,0,-3373,0,0,0,,3373,-3373
24,06/13/2018,25,6:00,6:15,,34.46,0,34.46,34.46,-1,-22156,103004,125160,80848,0,-4121,0,0,0,,4121,-4121
24,06/13/2018,26,6:15,6:30,,38.46,0,38.46,38.46,-1,-21399,70147,91546,48748,0,-2023,0,0,0,,2023,-2023
24,06/13/2018,27,6:30,6:45,,,0,42.97,42.97,0,-38745,61589,100334,22844,0,-59,0,0,0,,59,-59
24,06/13/2018,28,6:45,7:00,,,0,42.97,42.97,0,-68877,80044,148921,11167,0,0,0,0,0,,0,0
24,06/13/2018,29,7:00,7:15,,43.9,0,43.9,43.9,-1,-34358,140881,175239,106523,0,-505,0,0,0,,505,-505
24,06/13/2018,30,7:15,7:30,,43.21,0,43.21,43.21,-1,-47003,93654,140657,46651,0,-1968,0,0,0,,1968,-1968
24,06/13/2018,31,7:30,7:45,46.46,42.94,0,46.46,42.94,2,-57707,49665,107372,-8042,0,-328,318,0,0,,646,-10
24,06/13/2018,32,7:45,8:00,212.02,,0,212.02,212.02,1,-110393,44661,155054,-65732,0,0,37624,0,0,,37624,37624
24,06/13/2018,33,8:00,8:15,46.46,43.07,0,43.07,43.07,-1,-83104,190131,273235,107027,0,-131,16065,0,0,,16196,15934
24,06/13/2018,34,8:15,8:30,,43.39,0,43.39,43.39,-1,-37060,133927,170987,96867,0,-1070,0,0,0,,1070,-1070
24,06/13/2018,35,8:30,8:45,,43.99,0,43.99,43.99,-1,-21821,110263,132084,88442,0,-96,0,0,0,,96,-96
24,06/13/2018,36,8:45,9:00,126.02,,0,126.02,126.02,1,-53101,81681,134782,28580,0,0,4891,0,0,,4891,4891
24,06/13/2018,37,9:00,9:15,350.02,,0,350.02,350.02,1,-156878,122904,279782,-33974,0,0,60767,0,0,,60767,60767
24,06/13/2018,38,9:15,9:30,356.09,,0,356.09,356.09,1,-165307,117875,283182,-47432,0,0,84166,5000,0,,89166,89166
24,06/13/2018,39,9:30,9:45,356.09,,0,356.09,356.09,1,-145343,164960,310303,19617,0,0,46751,5000,0,,51751,51751
24,06/13/2018,40,9:45,10:00,356.09,,0,356.09,356.09,1,-139193,171826,311019,32633,0,0,21375,1250,0,,22625,22625
24,06/13/2018,41,10:00,10:15,356.09,-143.03,0,-143.03,-143.03,-1,-31849,241061,272910,209212,0,-25070,5998,0,0,,31068,-19072
24,06/13/2018,42,10:15,10:30,,-143.03,0,-143.03,-143.03,-1,-84916,144600,229516,59684,0,-38794,0,0,0,,38794,-38794
24,06/13/2018,43,10:30,10:45,,38.46,0,38.46,38.46,-1,-57557,140868,198425,83311,0,-755,0,0,0,,755,-755
24,06/13/2018,44,10:45,11:00,,19.79,0,19.79,19.79,-1,-42114,136921,179035,94807,0,-17212,0,0,0,,17212,-17212
24,06/13/2018,45,11:00,11:15,,34.46,0,34.46,34.46,-1,-54049,95871,149920,41822,0,-12580,0,0,0,,12580,-12580
24,06/13/2018,46,11:15,11:30,,30.46,0,30.46,30.46,-1,-55664,113309,168973,57645,0,-901,0,0,0,,901,-901
24,06/13/2018,47,11:30,11:45,,-34.54,0,-34.54,-34.54,-1,-70914,110699,181613,39785,0,-22717,0,0,0,,22717,-22717
24,06/13/2018,48,11:45,12:00,,40.7,0,40.7,40.7,-1,-50050,109491,159541,59441,0,-4210,0,0,0,,4210,-4210
24,06/13/2018,49,12:00,12:15,60.02,,0,60.02,60.02,1,-155650,42450,198100,-113200,0,0,6409,0,0,,6409,6409
24,06/13/2018,50,12:15,12:30,45.73,,0,45.73,45.73,1,-128547,42664,171211,-85883,0,0,8936,0,0,,8936,8936
24,06/13/2018,51,12:30,12:45,,,0,43.19,43.19,0,-93304,60478,153782,-32826,0,0,229,0,0,,229,229
24,06/13/2018,52,12:45,13:00,,44.09,0,44.09,44.09,-1,-82629,42061,124690,-40568,0,-8,0,0,0,,8,-8
24,06/13/2018,53,13:00,13:15,,44.08,0,44.08,44.08,-1,-106470,44755,151225,-61715,0,-250,0,0,0,,250,-250
24,06/13/2018,54,13:15,13:30,45.85,44.07,0,45.85,43.17,2,-123314,26904,150218,-96410,0,-11,547,0,0,,558,536
24,06/13/2018,55,13:30,13:45,42.27,,0,42.27,42.27,1,-122530,41887,164417,-80643,0,0,792,0,0,,792,792
24,06/13/2018,56,13:45,14:00,42.27,,0,42.27,42.27,1,-121615,42871,164486,-78744,0,0,68,0,0,,68,68
24,06/13/2018,57,14:00,14:15,,30.46,0,30.46,30.46,-1,-50202,73137,123339,22935,0,-2131,0,0,0,,2131,-2131
24,06/13/2018,58,14:15,14:30,,28.78,0,28.78,28.78,-1,-53730,80792,134522,27062,0,-20492,0,0,0,,20492,-20492
24,06/13/2018,59,14:30,14:45,,34.46,0,34.46,34.46,-1,-48091,77228,125319,29137,0,-19825,0,0,0,,19825,-19825
24,06/13/2018,60,14:45,15:00,,30.46,0,30.46,30.46,-1,-44483,70344,114827,25861,0,-22907,0,0,0,,22907,-22907
24,06/13/2018,61,15:00,15:15,42.27,34.46,0,42.27,42.27,1,-59813,53013,112826,-6800,0,-12771,88,0,0,,12859,-12683
24,06/13/2018,62,15:15,15:30,44.39,34.46,0,44.39,44.39,1,-72538,44597,117135,-27941,0,-92,2099,0,0,,2191,2007
24,06/13/2018,63,15:30,15:45,42.27,,0,42.27,42.27,1,-72078,54115,126193,-17963,0,0,324,0,0,,324,324
24,06/13/2018,64,15:45,16:00,42.27,,0,42.27,42.27,1,-72228,52348,124576,-19880,0,0,14,0,0,,14,14
24,06/13/2018,65,16:00,16:15,,30.46,0,30.46,30.46,-1,-51839,73722,125561,21883,0,-1433,0,0,0,,1433,-1433
24,06/13/2018,66,16:15,16:30,,43.47,0,43.47,43.47,-1,-68612,74180,142792,5568,0,-1082,0,0,0,,1082,-1082
24,06/13/2018,67,16:30,16:45,,,0,43.14,43.14,0,-77956,58332,136288,-19624,0,0,0,0,0,,0,0
24,06/13/2018,68,16:45,17:00,,,0,43.13,43.13,0,-83746,61326,145072,-22420,0,0,0,0,0,,0,0
24,06/13/2018,69,17:00,17:15,,30.46,0,30.46,30.46,-1,-75789,89526,165315,13737,0,-4339,0,0,0,,4339,-4339
24,06/13/2018,70,17:15,17:30,46.68,43.6,0,46.68,46.68,1,-67356,52783,120139,-14573,0,-1350,846,0,0,,2196,-504
24,06/13/2018,71,17:30,17:45,46.84,,0,46.84,46.84,1,-62509,49765,112274,-12744,0,0,3471,0,0,,3471,3471
24,06/13/2018,72,17:45,18:00,49.55,,0,49.55,49.55,1,-66102,48071,114173,-18031,0,0,6557,0,0,,6557,6557
24,06/13/2018,73,18:00,18:15,51.02,43.02,0,51.02,43.02,2,-54338,36028,90366,-18310,0,-40,12840,0,0,,12880,12800
24,06/13/2018,74,18:15,18:30,51.02,28.77,0,28.77,28.77,-1,-35585,67861,103446,32276,0,-9386,1097,0,0,,10483,-8289
24,06/13/2018,75,18:30,18:45,,19.79,0,19.79,19.79,-1,-37166,70096,107262,32930,0,-29489,0,0,0,,29489,-29489
24,06/13/2018,76,18:45,19:00,,43.71,0,43.71,43.71,-1,-39362,68495,107857,29133,0,-7050,0,0,0,,7050,-7050
24,06/13/2018,77,19:00,19:15,,-52.03,0,-52.03,-52.03,-1,-11133,40181,51314,29048,0,-21984,0,0,0,,21984,-21984
24,06/13/2018,78,19:15,19:30,,29.31,0,29.31,29.31,-1,-18702,57806,76508,39104,0,-19722,0,0,0,,19722,-19722
24,06/13/2018,79,19:30,19:45,,26.83,0,26.83,26.83,-1,-20848,66581,87429,45733,0,-27337,0,0,0,,27337,-27337
24,06/13/2018,80,19:45,20:00,,34.46,0,34.46,34.46,-1,-27678,65124,92802,37446,0,-5418,0,0,0,,5418,-5418
24,06/13/2018,81,20:00,20:15,,34.46,0,34.46,34.46,-1,-17483,65824,83307,48341,0,-402,0,0,0,,402,-402
24,06/13/2018,82,20:15,20:30,,34.46,0,34.46,34.46,-1,-24902,62502,87404,37600,0,-408,0,0,0,,408,-408
24,06/13/2018,83,20:30,20:45,,29.47,0,29.47,29.47,-1,-24772,88587,113359,63815,0,-6277,0,0,0,,6277,-6277
24,06/13/2018,84,20:45,21:00,,-131.03,0,-131.03,-131.03,-1,-31261,86916,118177,55655,0,-33886,0,0,0,,33886,-33886
24,06/13/2018,85,21:00,21:15,,34.46,0,34.46,34.46,-1,-41395,45551,86946,4156,0,-13980,0,0,0,,13980,-13980
24,06/13/2018,86,21:15,21:30,,,0,43.09,43.09,0,-32542,55855,88397,23313,0,0,0,0,0,,0,0
24,06/13/2018,87,21:30,21:45,,,0,43.11,43.11,0,-28852,73185,102037,44333,0,0,0,0,0,,0,0
24,06/13/2018,88,21:45,22:00,,16.82,0,16.82,16.82,-1,-29832,79609,109441,49777,0,-2631,0,0,0,,2631,-2631
24,06/13/2018,89,22:00,22:15,46.46,-150.03,0,46.46,-150.03,2,-50408,21879,72287,-28529,0,-12919,421,0,0,,13340,-12498
24,06/13/2018,90,22:15,22:30,46.46,,0,46.46,46.46,1,-55843,33448,89291,-22395,0,0,2841,0,0,,2841,2841
24,06/13/2018,91,22:30,22:45,42.27,,0,42.27,42.27,1,-50274,47745,98019,-2529,0,0,1387,0,0,,1387,1387
24,06/13/2018,92,22:45,23:00,42.27,30.45,0,43.18,30.45,2,-41681,77691,119372,36010,0,-3199,205,0,0,,3404,-2994
24,06/13/2018,93,23:00,23:15,103.02,39.03,0,103.02,39.03,2,-77994,40302,118296,-37692,0,-1890,8936,0,0,,10826,7046
24,06/13/2018,94,23:15,23:30,46.46,38.46,0,38.46,38.46,-1,-53152,53812,106964,660,0,-184,7935,0,0,,8119,7751
24,06/13/2018,95,23:30,23:45,,34.46,0,34.46,34.46,-1,-44617,75893,120510,31276,0,-456,0,0,0,,456,-456
24,06/13/2018,96,23:45,0:00,,30.46,0,30.46,30.46,-1,-61006,89044,150050,28038,0,-1693,0,0,0,,1693,-1693
24,06/14/2018,1,0:00,0:15,,-5.78,0,-5.78,-5.78,-1,-98717,100300,199017,1583,0,-8660,0,0,0,,8660,-8660
24,06/14/2018,2,0:15,0:30,42.46,,0,42.46,42.46,1,-62339,55606,117945,-6733,0,0,650,0,0,,650,650
24,06/14/2018,3,0:30,0:45,42.46,34.46,0,34.46,34.46,-1,-70732,76508,147240,5776,0,-1655,11,0,0,,1666,-1644
24,06/14/2018,4,0:45,1:00,,13.78,0,13.78,13.78,-1,-82905,105086,187991,22181,0,-14019,0,0,0,,14019,-14019
24,06/14/2018,5,1:00,1:15,,-150.78,0,-150.78,-150.78,-1,-45794,108001,153795,62207,0,-50724,0,0,0,,50724,-50724
24,06/14/2018,6,1:15,1:30,96.84,29.29,0,96.84,29.29,2,-60270,57850,118120,-2420,0,-6296,1388,0,0,,7684,-4908
24,06/14/2018,7,1:30,1:45,,-150.78,0,-150.78,-150.78,-1,-29546,69115,98661,39569,0,-20270,0,0,0,,20270,-20270
24,06/14/2018,8,1:45,2:00,,13.78,0,13.78,13.78,-1,-49466,92112,141578,42646,0,-22222,0,0,0,,22222,-22222
24,06/14/2018,9,2:00,2:15,66.12,13.78,0,66.12,66.12,1,-82611,51543,134154,-31068,0,-6861,2555,0,0,,9416,-4306
24,06/14/2018,10,2:15,2:30,42.46,28.23,0,28.23,28.23,-1,-38894,61924,100818,23030,0,-1427,567,0,0,,1994,-860
24,06/14/2018,11,2:30,2:45,,16.78,0,16.78,16.78,-1,-30649,70098,100747,39449,0,-13097,0,0,0,,13097,-13097
24,06/14/2018,12,2:45,3:00,,23.17,0,23.17,23.17,-1,-32027,89508,121535,57481,0,-20190,0,0,0,,20190,-20190
24,06/14/2018,13,3:00,3:15,46.46,43.56,0,46.46,43.02,2,-53111,44083,97194,-9028,0,-5993,836,0,0,,6829,-5157
24,06/14/2018,14,3:15,3:30,,43.93,0,43.93,43.93,-1,-35775,63652,99427,27877,0,-417,0,0,0,,417,-417
24,06/14/2018,15,3:30,3:45,,28.78,0,28.78,28.78,-1,-35788,81941,117729,46153,0,-8686,0,0,0,,8686,-8686
24,06/14/2018,16,3:45,4:00,,34.46,0,34.46,34.46,-1,-32262,95667,127929,63405,0,-9610,0,0,0,,9610,-9610
24,06/14/2018,17,4:00,4:15,,43.63,0,43.63,43.63,-1,-27573,68107,95680,40534,0,-3491,0,0,0,,3491,-3491
24,06/14/2018,18,4:15,4:30,,34.46,0,34.46,34.46,-1,-29945,73340,103285,43395,0,-3217,0,0,0,,3217,-3217
24,06/14/2018,19,4:30,4:45,,30.06,0,30.06,30.06,-1,-15847,69604,85451,53757,0,-14943,0,0,0,,14943,-14943
24,06/14/2018,20,4:45,5:00,,30.35,0,30.35,30.35,-1,-13254,92362,105616,79108,0,-19951,0,0,0,,19951,-19951
24,06/14/2018,21,5:00,5:15,,-34.54,0,-34.54,-34.54,-1,-13189,100770,113959,87581,0,-30577,0,0,0,,30577,-30577
24,06/14/2018,22,5:15,5:30,,-150.78,0,-150.78,-150.78,-1,-22326,97410,119736,75084,0,-42730,0,0,0,,42730,-42730
24,06/14/2018,23,5:30,5:45,,-141.78,0,-141.78,-141.78,-1,-26590,73963,100553,47373,0,-49950,0,0,0,,49950,-49950
24,06/14/2018,24,5:45,6:00,,37.78,0,37.78,37.78,-1,-51236,77742,128978,26506,0,-9463,0,0,0,,9463,-9463
24,06/14/2018,25,6:00,6:15,,-3.95,0,-3.95,-3.95,-1,-43511,114459,157970,70948,0,-7454,0,0,0,,7454,-7454
24,06/14/2018,26,6:15,6:30,,29.87,0,29.87,29.87,-1,-43156,83453,126609,40297,0,-9416,0,0,0,,9416,-9416
24,06/14/2018,27,6:30,6:45,,,0,43.45,43.45,0,-58641,69360,128001,10719,0,-1469,0,0,0,,1469,-1469
24,06/14/2018,28,6:45,7:00,,39.17,0,39.17,39.17,-1,-51234,98229,149463,46995,0,-30,0,0,0,,30,-30
24,06/14/2018,29,7:00,7:15,,-150.78,0,-150.78,-150.78,-1,-32332,139077,171409,106745,0,-23857,0,0,0,,23857,-23857
24,06/14/2018,30,7:15,7:30,,28.74,0,28.74,28.74,-1,-30988,110562,141550,79574,0,-25964,0,0,0,,25964,-25964
24,06/14/2018,31,7:30,7:45,,41.78,0,41.78,41.78,-1,-31289,74758,106047,43469,0,-6712,0,0,0,,6712,-6712
24,06/14/2018,32,7:45,8:00,,43.57,0,43.57,43.57,-1,-28460,82127,110587,53667,0,-51,0,0,0,,51,-51
24,06/14/2018,33,8:00,8:15,,43.41,0,43.41,43.41,-1,-66724,131121,197845,64397,0,-234,0,0,0,,234,-234
24,06/14/2018,34,8:15,8:30,,-21.4,0,-21.4,-21.4,-1,-48016,126442,174458,78426,0,-6497,0,0,0,,6497,-6497
24,06/14/2018,35,8:30,8:45,,-124.78,0,-124.78,-124.78,-1,-35777,127565,163342,91788,0,-58015,0,0,0,,58015,-58015
24,06/14/2018,36,8:45,9:00,,4.69,0,4.69,4.69,-1,-44406,117251,161657,72845,0,-39289,0,0,0,,39289,-39289
24,06/14/2018,37,9:00,9:15,119.21,39.17,0,119.21,39.17,2,-101076,69790,170866,-31286,0,-1785,5951,0,0,,7736,4166
24,06/14/2018,38,9:15,9:30,119.21,-124.78,0,-124.78,-124.78,-1,-56306,120412,176718,64106,0,-28944,139,0,0,,29083,-28805
24,06/14/2018,39,9:30,9:45,,-124.78,0,-124.78,-124.78,-1,-61487,133267,194754,71780,0,-74035,0,0,0,,74035,-74035
24,06/14/2018,40,9:45,10:00,,-25.21,0,-25.21,-25.21,-1,-82110,150307,232417,68197,0,-66576,0,0,0,,66576,-66576
24,06/14/2018,41,10:00,10:15,,5.78,0,5.78,5.78,-1,-50184,177698,227882,127514,0,-43264,0,0,0,,43264,-43264
24,06/14/2018,42,10:15,10:30,,-4.84,0,-4.84,-4.84,-1,-62156,201357,263513,139201,0,-44570,0,0,0,,44570,-44570
24,06/14/2018,43,10:30,10:45,,18.78,0,18.78,18.78,-1,-77892,228121,306013,150229,0,-29904,0,0,0,,29904,-29904
24,06/14/2018,44,10:45,11:00,,-124.78,0,-124.78,-124.78,-1,-79719,198589,278308,118870,0,-61594,0,0,0,,61594,-61594
24,06/14/2018,45,11:00,11:15,55.12,11.75,0,55.12,55.12,1,-106534,118836,225370,12302,0,-20468,882,0,0,,21350,-19586
24,06/14/2018,46,11:15,11:30,59.12,,0,59.12,59.12,1,-113700,124384,238084,10684,0,0,5830,0,0,,5830,5830
24,06/14/2018,47,11:30,11:45,44.1,,0,44.1,44.1,1,-105064,126221,231285,21157,0,0,4144,0,0,,4144,4144
24,06/14/2018,48,11:45,12:00,51.17,,0,51.17,51.17,1,-98952,110301,209253,11349,0,0,2716,0,0,,2716,2716
24,06/14/2018,49,12:00,12:15,109.12,,0,109.12,109.12,1,-110312,77381,187693,-32931,0,0,23522,0,0,,23522,23522
24,06/14/2018,50,12:15,12:30,45.2,,0,45.2,45.2,1,-95714,85154,180868,-10560,0,0,9234,0,0,,9234,9234
24,06/14/2018,51,12:30,12:45,109.79,,0,109.79,109.79,1,-99101,64615,163716,-34486,0,0,17080,0,0,,17080,17080
24,06/14/2018,52,12:45,13:00,46.15,,0,46.15,46.15,1,-92946,82773,175719,-10173,0,0,13284,0,0,,13284,13284
24,06/14/2018,53,13:00,13:15,51.17,,0,51.17,51.17,1,-65617,79486,145103,13869,0,0,1468,0,0,,1468,1468
24,06/14/2018,54,13:15,13:30,100.12,,0,100.12,100.12,1,-93940,76494,170434,-17446,0,0,31020,0,0,,31020,31020
24,06/14/2018,55,13:30,13:45,51.17,,0,51.17,51.17,1,-85597,75616,161213,-9981,0,0,27918,0,0,,27918,27918
24,06/14/2018,56,13:45,14:00,289.12,,0,289.12,289.12,1,-103562,66361,169923,-37201,0,0,38662,0,0,,38662,38662
24,06/14/2018,57,14:00,14:15,282.12,40,0,40,40,-1,-64266,69158,133424,4892,0,-192,26520,0,0,,26712,26328
24,06/14/2018,58,14:15,14:30,,,0,42.88,42.88,0,-54629,80884,135513,26255,0,-158,0,0,0,,158,-158
24,06/14/2018,59,14:30,14:45,,,0,42.88,42.88,0,-63680,80343,144023,16663,0,0,0,0,0,,0,0
24,06/14/2018,60,14:45,15:00,,,0,42.88,42.88,0,-63596,83425,147021,19829,0,0,0,0,0,,0,0
24,06/14/2018,61,15:00,15:15,,,0,42.92,42.92,0,-57367,91148,148515,33781,0,0,0,0,0,,0,0
24,06/14/2018,62,15:15,15:30,44.77,,0,44.77,44.77,1,-62963,79525,142488,16562,0,0,417,0,0,,417,417
24,06/14/2018,63,15:30,15:45,,42.32,0,42.32,42.32,-1,-51067,81987,133054,30920,0,-194,0,0,0,,194,-194
24,06/14/2018,64,15:45,16:00,,39.17,0,39.17,39.17,-1,-51242,68999,120241,17757,0,-2157,0,0,0,,2157,-2157
24,06/14/2018,65,16:00,16:15,,31.17,0,31.17,31.17,-1,-42670,103222,145892,60552,0,-2286,0,0,0,,2286,-2286
24,06/14/2018,66,16:15,16:30,,42.86,0,42.86,42.86,-1,-51161,100149,151310,48988,0,-1164,0,0,0,,1164,-1164
24,06/14/2018,67,16:30,16:45,,26.74,0,26.74,26.74,-1,-45053,92133,137186,47080,0,-10580,0,0,0,,10580,-10580
24,06/14/2018,68,16:45,17:00,42.98,42.4,0,42.98,42.98,1,-48936,64750,113686,15814,0,-3102,141,0,0,,3243,-2961
24,06/14/2018,69,17:00,17:15,288.12,,0,288.12,288.12,1,-94022,44415,138437,-49607,0,0,19805,0,0,,19805,19805
24,06/14/2018,70,17:15,17:30,288.12,,0,288.12,288.12,1,-63475,66747,130222,3272,0,0,42487,0,0,,42487,42487
24,06/14/2018,71,17:30,17:45,57.85,42.05,0,57.85,42.05,2,-86155,96208,182363,10053,0,-139,3089,0,0,,3228,2950
24,06/14/2018,72,17:45,18:00,93.12,,0,93.12,93.12,1,-112078,112001,224079,-77,0,0,26340,0,0,,26340,26340
24,06/14/2018,73,18:00,18:15,42.98,23.04,0,23.04,23.04,-1,-81260,90990,172250,9730,0,-3552,7124,0,0,,10676,3572
24,06/14/2018,74,18:15,18:30,,15.78,0,15.78,15.78,-1,-55147,72260,127407,17113,0,-10845,0,0,0,,10845,-10845
24,06/14/2018,75,18:30,18:45,,39.17,0,39.17,39.17,-1,-51426,72333,123759,20907,0,-1076,0,0,0,,1076,-1076
24,06/14/2018,76,18:45,19:00,,43.11,0,43.11,43.11,-1,-61911,72864,134775,10953,0,-1441,0,0,0,,1441,-1441
24,06/14/2018,77,19:00,19:15,131.12,43.11,0,131.12,131.12,1,-83449,58277,141726,-25172,0,-90,11160,0,0,,11250,11070
24,06/14/2018,78,19:15,19:30,51.17,,0,51.17,51.17,1,-66279,62036,128315,-4243,0,0,13292,0,0,,13292,13292
24,06/14/2018,79,19:30,19:45,97.12,,0,97.12,97.12,1,-85952,56649,142601,-29303,0,0,29526,0,0,,29526,29526
24,06/14/2018,80,19:45,20:00,72.12,,0,72.12,72.12,1,-85686,46333,132019,-39353,0,0,37745,0,0,,37745,37745
24,06/14/2018,81,20:00,20:15,50.12,39.17,0,39.17,39.17,-1,-54463,98638,153101,44175,0,-660,17257,0,0,,17917,16597
24,06/14/2018,82,20:15,20:30,46.63,39.17,0,46.63,46.63,1,-80259,76121,156380,-4138,0,-110,1255,0,0,,1365,1145
24,06/14/2018,83,20:30,20:45,65,,0,65,65,1,-95718,62517,158235,-33201,0,0,13092,0,0,,13092,13092
24,06/14/2018,84,20:45,21:00,51.17,,0,51.17,51.17,1,-97969,55112,153081,-42857,0,0,22812,0,0,,22812,22812
24,06/14/2018,85,21:00,21:15,47.17,40,0,40,40,-1,-69127,98901,168028,29774,0,-394,12729,0,0,,13123,12335
24,06/14/2018,86,21:15,21:30,,,0,43.42,43.42,0,-73683,109169,182852,35486,0,-129,50,0,0,,179,-79
24,06/14/2018,87,21:30,21:45,,,0,43.42,43.42,0,-85612,101647,187259,16035,0,0,0,0,0,,0,0
24,06/14/2018,88,21:45,22:00,42.98,,0,42.98,42.98,1,-92020,104274,196294,12254,0,0,41,0,0,,41,41
24,06/14/2018,89,22:00,22:15,101.12,,0,101.12,101.12,1,-86893,46096,132989,-40797,0,0,19647,0,0,,19647,19647
24,06/14/2018,90,22:15,22:30,89.47,,0,89.47,89.47,1,-100405,52759,153164,-47646,0,0,41758,0,0,,41758,41758
24,06/14/2018,91,22:30,22:45,55.12,,0,55.12,55.12,1,-92019,68255,160274,-23764,0,0,30123,0,0,,30123,30123
24,06/14/2018,92,22:45,23:00,46,,0,46,46,1,-96958,86831,183789,-10127,0,0,5911,0,0,,5911,5911
24,06/14/2018,93,23:00,23:15,86.66,43.83,0,86.66,43.41,2,-119235,75938,195173,-43297,0,-40,4789,0,0,,4829,4749
24,06/14/2018,94,23:15,23:30,42.98,,0,42.98,42.98,1,-81496,77657,159153,-3839,0,0,1001,0,0,,1001,1001
24,06/14/2018,95,23:30,23:45,,,0,43.44,43.44,0,-82498,78100,160598,-4398,0,0,0,0,0,,0,0
24,06/14/2018,96,23:45,0:00,,-107.78,0,-107.78,-107.78,-1,-75147,102123,177270,26976,0,-10616,0,0,0,,10616,-10616
24,06/15/2018,1,0:00,0:15,164.02,-38.03,0,164.02,-38.03,2,-72788,19562,92350,-53226,0,-13516,4225,0,0,,17741,-9291
24,06/15/2018,2,0:15,0:30,49.24,,0,49.24,49.24,1,-50219,29143,79362,-21076,0,0,5873,0,0,,5873,5873
24,06/15/2018,3,0:30,0:45,49.24,40.2,0,40.2,40.2,-1,-46919,44656,91575,-2263,0,-74,132,0,0,,206,58
24,06/15/2018,4,0:45,1:00,,9.75,0,9.75,9.75,-1,-37752,58114,95866,20362,0,-14267,0,0,0,,14267,-14267
24,06/15/2018,5,1:00,1:15,45.93,18.03,0,45.93,18.03,2,-54740,69755,124495,15015,0,-11837,43,0,0,,11880,-11794
24,06/15/2018,6,1:15,1:30,53.24,18.03,0,53.24,53.24,1,-51045,20607,71652,-30438,0,-800,1968,0,0,,2768,1168
24,06/15/2018,7,1:30,1:45,,37.03,0,37.03,37.03,-1,-11946,30147,42093,18201,0,-2357,0,0,0,,2357,-2357
24,06/15/2018,8,1:45,2:00,,37.24,0,37.24,37.24,-1,-18449,36704,55153,18255,0,-5257,0,0,0,,5257,-5257
24,06/15/2018,9,2:00,2:15,44.2,37.24,0,44.2,37.24,2,-37120,34935,72055,-2185,0,-4973,58,0,0,,5031,-4915
24,06/15/2018,10,2:15,2:30,44.2,26.8,0,44.2,26.8,2,-23138,41627,64765,18489,0,-2956,189,0,0,,3145,-2767
24,06/15/2018,11,2:30,2:45,,26.68,0,26.68,26.68,-1,-28412,40967,69379,12555,0,-17474,0,0,0,,17474,-17474
24,06/15/2018,12,2:45,3:00,,42.4,0,42.4,42.4,-1,-41357,45128,86485,3771,0,-6653,0,0,0,,6653,-6653
24,06/15/2018,13,3:00,3:15,,37.24,0,37.24,37.24,-1,-32951,48951,81902,16000,0,-283,0,0,0,,283,-283
24,06/15/2018,14,3:15,3:30,,37.24,0,37.24,37.24,-1,-28187,43151,71338,14964,0,-2443,0,0,0,,2443,-2443
24,06/15/2018,15,3:30,3:45,,40.2,0,40.2,40.2,-1,-23860,41841,65701,17981,0,-2924,0,0,0,,2924,-2924
24,06/15/2018,16,3:45,4:00,,42.55,0,42.55,42.55,-1,-28063,45916,73979,17853,0,-1103,0,0,0,,1103,-1103
24,06/15/2018,17,4:00,4:15,,33.24,0,33.24,33.24,-1,-37364,25894,63258,-11470,0,-1028,0,0,0,,1028,-1028
24,06/15/2018,18,4:15,4:30,,33.24,0,33.24,33.24,-1,-37243,31426,68669,-5817,0,-2792,0,0,0,,2792,-2792
24,06/15/2018,19,4:30,4:45,,,0,43.62,43.62,0,-31444,33267,64711,1823,0,0,0,0,0,,0,0
24,06/15/2018,20,4:45,5:00,,42.6,0,42.6,42.6,-1,-24525,30826,55351,6301,0,-23,0,0,0,,23,-23
24,06/15/2018,21,5:00,5:15,,40.2,0,40.2,40.2,-1,-60936,54801,115737,-6135,0,-454,0,0,0,,454,-454
24,06/15/2018,22,5:15,5:30,,42.79,0,42.79,42.79,-1,-42190,55814,98004,13624,0,-1247,0,0,0,,1247,-1247
24,06/15/2018,23,5:30,5:45,,40.2,0,40.2,40.2,-1,-20563,35387,55950,14824,0,-2516,0,0,0,,2516,-2516
24,06/15/2018,24,5:45,6:00,,,0,43.62,43.62,0,-19567,44508,64075,24941,0,-7,0,0,0,,7,-7
24,06/15/2018,25,6:00,6:15,,,0,43.65,43.65,0,-72826,108532,181358,35706,0,0,0,0,0,,0,0
24,06/15/2018,26,6:15,6:30,,38,0,38,38,-1,-40227,74790,115017,34563,0,-1156,0,0,0,,1156,-1156
24,06/15/2018,27,6:30,6:45,60,42.81,0,60,42.81,2,-41219,28146,69365,-13073,0,-969,1911,0,0,,2880,942
24,06/15/2018,28,6:45,7:00,63,,0,63,63,1,-49878,30563,80441,-19315,0,0,11070,0,0,,11070,11070
24,06/15/2018,29,7:00,7:15,63,-150.03,0,-150.03,-150.03,-1,-40936,130942,171878,90006,0,-10198,3088,0,0,,13286,-7110
24,06/15/2018,30,7:15,7:30,,38,0,38,38,-1,-21675,88882,110557,67207,0,-13555,0,0,0,,13555,-13555
24,06/15/2018,31,7:30,7:45,45.3,38,0,45.3,45.3,1,-22774,35133,57907,12359,0,-1970,717,0,0,,2687,-1253
24,06/15/2018,32,7:45,8:00,63.02,,0,63.02,63.02,1,-39310,38291,77601,-1019,0,0,10277,0,0,,10277,10277
24,06/15/2018,33,8:00,8:15,63.02,-150.03,0,-150.03,-150.03,-1,-42074,111149,153223,69075,0,-32105,1063,0,0,,33168,-31042
24,06/15/2018,34,8:15,8:30,,29.83,0,29.83,29.83,-1,-21952,63306,85258,41354,0,-34917,0,0,0,,34917,-34917
24,06/15/2018,35,8:30,8:45,,38,0,38,38,-1,-28939,47851,76790,18912,0,-15688,0,0,0,,15688,-15688
24,06/15/2018,36,8:45,9:00,,38,0,38,38,-1,-35403,42365,77768,6962,0,-1639,0,0,0,,1639,-1639
24,06/15/2018,37,9:00,9:15,,29.85,0,29.85,29.85,-1,-19862,79020,98882,59158,0,-19356,0,0,0,,19356,-19356
24,06/15/2018,38,9:15,9:30,,34,0,34,34,-1,-24008,76055,100063,52047,0,-33431,0,0,0,,33431,-33431
24,06/15/2018,39,9:30,9:45,,19.78,0,19.78,19.78,-1,-32612,95699,128311,63087,0,-34269,0,0,0,,34269,-34269
24,06/15/2018,40,9:45,10:00,,-42.03,0,-42.03,-42.03,-1,-25969,94187,120156,68218,0,-39778,0,0,0,,39778,-39778
24,06/15/2018,41,10:00,10:15,54,-42.03,0,54,54,1,-66288,48382,114670,-17906,0,-11541,1464,0,0,,13005,-10077
24,06/15/2018,42,10:15,10:30,,28.07,0,28.07,28.07,-1,-41604,68748,110352,27144,0,-11013,0,0,0,,11013,-11013
24,06/15/2018,43,10:30,10:45,,25.03,0,25.03,25.03,-1,-41085,79430,120515,38345,0,-27165,0,0,0,,27165,-27165
24,06/15/2018,44,10:45,11:00,,21.03,0,21.03,21.03,-1,-46233,81226,127459,34993,0,-37562,0,0,0,,37562,-37562
24,06/15/2018,45,11:00,11:15,,38,0,38,38,-1,-82889,82826,165715,-63,0,-18756,0,0,0,,18756,-18756
24,06/15/2018,46,11:15,11:30,44.95,43.08,0,44.95,43.08,2,-74316,76326,150642,2010,0,-624,34,0,0,,658,-590
24,06/15/2018,47,11:30,11:45,,38,0,38,38,-1,-65439,67902,133341,2463,0,-2569,0,0,0,,2569,-2569
24,06/15/2018,48,11:45,12:00,,34.99,0,34.99,34.99,-1,-66060,72276,138336,6216,0,-14934,0,0,0,,14934,-14934
24,06/15/2018,49,12:00,12:15,,41.03,0,41.03,41.03,-1,-64443,47075,111518,-17368,0,-4870,0,0,0,,4870,-4870
24,06/15/2018,50,12:15,12:30,,,0,44.37,44.37,0,-56515,49538,106053,-6977,0,-15,0,0,0,,15,-15
24,06/15/2018,51,12:30,12:45,,40.95,0,40.95,40.95,-1,-53536,56178,109714,2642,0,-529,0,0,0,,529,-529
24,06/15/2018,52,12:45,13:00,,40.68,0,40.68,40.68,-1,-58801,47495,106296,-11306,0,-1164,0,0,0,,1164,-1164
24,06/15/2018,53,13:00,13:15,80.65,,0,80.65,80.65,1,-83257,50952,134209,-32305,0,0,8122,0,0,,8122,8122
24,06/15/2018,54,13:15,13:30,44.95,,0,44.95,44.95,1,-88499,44012,132511,-44487,0,0,3138,0,0,,3138,3138
24,06/15/2018,55,13:30,13:45,45.12,,0,45.12,45.12,1,-73076,42766,115842,-30310,0,0,550,0,0,,550,550
24,06/15/2018,56,13:45,14:00,44.95,,0,44.95,44.95,1,-69798,40836,110634,-28962,0,0,354,0,0,,354,354
24,06/15/2018,57,14:00,14:15,50,,0,50,50,1,-70699,56868,127567,-13831,0,0,8342,0,0,,8342,8342
24,06/15/2018,58,14:15,14:30,44.33,,0,44.33,44.33,1,-60447,56721,117168,-3726,0,0,2872,0,0,,2872,2872
24,06/15/2018,59,14:30,14:45,44.95,,0,44.95,44.95,1,-54704,55238,109942,534,0,0,2502,0,0,,2502,2502
24,06/15/2018,60,14:45,15:00,44.95,38,0,38,38,-1,-46925,56429,103354,9504,0,-3417,300,0,0,,3717,-3117
24,06/15/2018,61,15:00,15:15,,38,0,38,38,-1,-32315,49483,81798,17168,0,-2943,0,0,0,,2943,-2943
24,06/15/2018,62,15:15,15:30,,,0,43.68,43.68,0,-31323,55753,87076,24430,0,0,0,0,0,,0,0
24,06/15/2018,63,15:30,15:45,44.33,,0,44.33,44.33,1,-34855,50204,85059,15349,0,0,221,0,0,,221,221
24,06/15/2018,64,15:45,16:00,44.95,,0,44.95,44.95,1,-46421,51222,97643,4801,0,0,1173,0,0,,1173,1173
24,06/15/2018,65,16:00,16:15,44.3,,0,44.3,44.3,1,-22828,54907,77735,32079,0,0,108,0,0,,108,108
24,06/15/2018,66,16:15,16:30,,40.95,0,40.95,40.95,-1,-25117,54368,79485,29251,0,-363,0,0,0,,363,-363
24,06/15/2018,67,16:30,16:45,,34.99,0,34.99,34.99,-1,-20956,57923,78879,36967,0,-7748,0,0,0,,7748,-7748
24,06/15/2018,68,16:45,17:00,,38,0,38,38,-1,-31974,69062,101036,37088,0,-12093,0,0,0,,12093,-12093
24,06/15/2018,69,17:00,17:15,,38,0,38,38,-1,-59472,69461,128933,9989,0,-8653,0,0,0,,8653,-8653
24,06/15/2018,70,17:15,17:30,45.05,38,0,45.05,45.05,1,-54639,55582,110221,943,0,-599,316,0,0,,915,-283
24,06/15/2018,71,17:30,17:45,68.02,,0,68.02,68.02,1,-61719,37058,98777,-24661,0,0,6642,0,0,,6642,6642
24,06/15/2018,72,17:45,18:00,77.02,,0,77.02,77.02,1,-63270,37486,100756,-25784,0,0,25457,0,0,,25457,25457
24,06/15/2018,73,18:00,18:15,44.02,,0,44.02,44.02,1,-43429,32197,75626,-11232,0,0,6918,0,0,,6918,6918
24,06/15/2018,74,18:15,18:30,,43.87,0,43.87,43.87,-1,-30094,37078,67172,6984,0,-611,0,0,0,,611,-611
24,06/15/2018,75,18:30,18:45,,40.95,0,40.95,40.95,-1,-15400,47592,62992,32192,0,-779,0,0,0,,779,-779
24,06/15/2018,76,18:45,19:00,,,0,43.98,43.98,0,-9196,48909,58105,39713,0,0,0,0,0,,0,0
24,06/15/2018,77,19:00,19:15,,40.95,0,40.95,40.95,-1,-28652,39747,68399,11095,0,-851,0,0,0,,851,-851
24,06/15/2018,78,19:15,19:30,,42.03,0,42.03,42.03,-1,-29954,45314,75268,15360,0,-1686,0,0,0,,1686,-1686
24,06/15/2018,79,19:30,19:45,,43.51,0,43.51,43.51,-1,-20055,55275,75330,35220,0,-1469,0,0,0,,1469,-1469
24,06/15/2018,80,19:45,20:00,,38,0,38,38,-1,-18819,73343,92162,54524,0,-3376,0,0,0,,3376,-3376
24,06/15/2018,81,20:00,20:15,,38,0,38,38,-1,-22970,71027,93997,48057,0,-1740,0,0,0,,1740,-1740
24,06/15/2018,82,20:15,20:30,,38,0,38,38,-1,-29984,58602,88586,28618,0,-1771,0,0,0,,1771,-1771
24,06/15/2018,83,20:30,20:45,,28.78,0,28.78,28.78,-1,-26279,62952,89231,36673,0,-7200,0,0,0,,7200,-7200
24,06/15/2018,84,20:45,21:00,,9.7,0,9.7,9.7,-1,-42579,57721,100300,15142,0,-23321,0,0,0,,23321,-23321
24,06/15/2018,85,21:00,21:15,183.53,9.7,0,183.53,183.53,1,-84293,16536,100829,-67757,0,-1742,24364,0,0,,26106,22622
24,06/15/2018,86,21:15,21:30,60,40.95,0,40.95,40.95,-1,-49462,43716,93178,-5746,0,-90,20379,0,0,,20469,20289
24,06/15/2018,87,21:30,21:45,60,38,0,38,38,-1,-33962,67015,100977,33053,0,-1693,483,0,0,,2176,-1210
24,06/15/2018,88,21:45,22:00,,40.95,0,40.95,40.95,-1,-34336,80978,115314,46642,0,-2184,0,0,0,,2184,-2184
24,06/15/2018,89,22:00,22:15,,38,0,38,38,-1,-28081,58657,86738,30576,0,-2171,0,0,0,,2171,-2171
24,06/15/2018,90,22:15,22:30,45.29,38,0,45.29,45.29,1,-42036,39419,81455,-2617,0,-19,423,0,0,,442,404
24,06/15/2018,91,22:30,22:45,45.29,40.95,0,40.95,40.95,-1,-33263,48400,81663,15137,0,-34,3,0,0,,37,-31
24,06/15/2018,92,22:45,23:00,,38,0,38,38,-1,-28278,51065,79343,22787,0,-1689,0,0,0,,1689,-1689
24,06/15/2018,93,23:00,23:15,146.02,34.03,0,146.02,34.03,2,-66303,28872,95175,-37431,0,-1440,14550,0,0,,15990,13110
24,06/15/2018,94,23:15,23:30,54,,0,54,54,1,-51020,35276,86296,-15744,0,0,15520,0,0,,15520,15520
24,06/15/2018,95,23:30,23:45,54,40.95,0,40.95,40.95,-1,-34019,54139,88158,20120,0,-701,962,0,0,,1663,261
24,06/15/2018,96,23:45,0:00,,31.99,0,31.99,31.99,-1,-46716,53440,100156,6724,0,-13404,0,0,0,,13404,-13404
25,06/16/2018,1,0:00,0:15,48.21,-25.78,0,52.37,-25.78,2,-36993,67985,104978,30992,0,0,0,0,0,,0,0
25,06/16/2018,2,0:15,0:30,52.21,-25.78,0,52.21,52.21,1,-44484,26881,71365,-17603,0,0,0,0,0,,0,0
25,06/16/2018,3,0:30,0:45,52.21,60.55,0,60.55,60.55,-1,-47292,50740,98032,3448,0,0,0,0,0,,0,0
25,06/16/2018,4,0:45,1:00,,32.21,0,32.21,32.21,-1,-47483,53374,100857,5891,0,0,0,0,0,,0,0
25,06/16/2018,5,1:00,1:15,52.21,-150.78,0,52.21,-150.78,2,-65164,133531,198695,68367,0,0,0,0,0,,0,0
25,06/16/2018,6,1:15,1:30,228.12,-150.78,0,228.12,228.12,1,-60061,41148,101209,-18913,0,0,0,0,0,,0,0
25,06/16/2018,7,1:30,1:45,,,0,52.02,52.02,0,-37064,75871,112935,38807,0,0,0,0,0,,0,0
25,06/16/2018,8,1:45,2:00,,,0,52.03,52.03,0,-70353,54743,125096,-15610,0,0,0,0,0,,0,0
25,06/16/2018,9,2:00,2:15,44.21,,0,44.21,44.21,1,-47067,58639,105706,11572,0,0,0,0,0,,0,0
25,06/16/2018,10,2:15,2:30,44.21,,0,44.21,44.21,1,-42282,45425,87707,3143,0,0,0,0,0,,0,0
25,06/16/2018,11,2:30,2:45,,,0,52.06,52.06,0,-38024,49297,87321,11273,0,0,0,0,0,,0,0
25,06/16/2018,12,2:45,3:00,,41.66,0,41.66,41.66,-1,-34624,56720,91344,22096,0,0,0,0,0,,0,0
25,06/16/2018,13,3:00,3:15,55.91,60.12,0,55.91,52.12,2,-62686,36186,98872,-26500,0,0,0,0,0,,0,0
25,06/16/2018,14,3:15,3:30,52.21,,0,52.21,52.21,1,-62468,35162,97630,-27306,0,0,0,0,0,,0,0
25,06/16/2018,15,3:30,3:45,47.61,,0,47.61,47.61,1,-57985,52496,110481,-5489,0,0,0,0,0,,0,0
25,06/16/2018,16,3:45,4:00,48.21,60.21,0,52.17,52.17,2,-54266,44613,98879,-9653,0,0,0,0,0,,0,0
25,06/16/2018,17,4:00,4:15,69.96,,0,69.96,69.96,1,-83144,37615,120759,-45529,0,0,0,0,0,,0,0
25,06/16/2018,18,4:15,4:30,47.12,,0,47.12,47.12,1,-66398,51329,117727,-15069,0,0,0,0,0,,0,0
25,06/16/2018,19,4:30,4:45,47.12,60.24,0,60.24,60.24,-1,-46211,54142,100353,7931,0,0,0,0,0,,0,0
25,06/16/2018,20,4:45,5:00,,60.24,0,60.24,60.24,-1,-45501,50803,96304,5302,0,0,0,0,0,,0,0
25,06/16/2018,21,5:00,5:15,45.51,,0,45.51,45.51,1,-50412,39723,90135,-10689,0,0,0,0,0,,0,0
25,06/16/2018,22,5:15,5:30,44.21,,0,44.21,44.21,1,-34518,52826,87344,18308,0,0,0,0,0,,0,0
25,06/16/2018,23,5:30,5:45,,,0,52.1,52.1,0,-28183,59222,87405,31039,0,0,0,0,0,,0,0
25,06/16/2018,24,5:45,6:00,,43.78,0,43.78,43.78,-1,-21394,66450,87844,45056,0,0,0,0,0,,0,0
25,06/16/2018,25,6:00,6:15,,39.21,0,39.21,39.21,-1,-27488,80884,108372,53396,0,0,0,0,0,,0,0
25,06/16/2018,26,6:15,6:30,,39.21,0,39.21,39.21,-1,-28774,80130,108904,51356,0,0,0,0,0,,0,0
25,06/16/2018,27,6:30,6:45,,60.57,0,60.57,60.57,-1,-32543,76089,108632,43546,0,0,0,0,0,,0,0
25,06/16/2018,28,6:45,7:00,,60.53,0,60.53,60.53,-1,-31894,92649,124543,60755,0,0,0,0,0,,0,0
25,06/16/2018,29,7:00,7:15,,39.21,0,39.21,39.21,-1,-36803,101925,138728,65122,0,0,0,0,0,,0,0
25,06/16/2018,30,7:15,7:30,,43.55,0,43.55,43.55,-1,-38231,92457,130688,54226,0,0,0,0,0,,0,0
25,06/16/2018,31,7:30,7:45,,,0,52.12,52.12,0,-35809,77108,112917,41299,0,0,0,0,0,,0,0
25,06/16/2018,32,7:45,8:00,,,0,52.1,52.1,0,-40634,75642,116276,35008,0,0,0,0,0,,0,0
25,06/16/2018,33,8:00,8:15,,,0,52.15,52.15,0,-55922,99473,155395,43551,0,0,0,0,0,,0,0
25,06/16/2018,34,8:15,8:30,,,0,52.15,52.15,0,-53942,103644,157586,49702,0,0,0,0,0,,0,0
25,06/16/2018,35,8:30,8:45,,,0,52.14,52.14,0,-52711,102974,155685,50263,0,0,0,0,0,,0,0
25,06/16/2018,36,8:45,9:00,,,0,52.13,52.13,0,-63535,99113,162648,35578,0,0,0,0,0,,0,0
25,06/16/2018,37,9:00,9:15,,40.71,0,40.71,40.71,-1,-38289,103710,141999,65421,0,0,0,0,0,,0,0
25,06/16/2018,38,9:15,9:30,,35.21,0,35.21,35.21,-1,-25977,106625,132602,80648,0,0,0,0,0,,0,0
25,06/16/2018,39,9:30,9:45,,-3.78,0,-3.78,-3.78,-1,-26401,104075,130476,77674,0,0,0,0,0,,0,0
25,06/16/2018,40,9:45,10:00,,-33.79,0,-33.79,-33.79,-1,-28978,69258,98236,40280,0,0,0,0,0,,0,0
25,06/16/2018,41,10:00,10:15,,31.21,0,31.21,31.21,-1,-47019,83098,130117,36079,0,0,0,0,0,,0,0
25,06/16/2018,42,10:15,10:30,,-16.78,0,-16.78,-16.78,-1,-40761,79974,120735,39213,0,0,0,0,0,,0,0
25,06/16/2018,43,10:30,10:45,,30.69,0,30.69,30.69,-1,-41465,84135,125600,42670,0,0,0,0,0,,0,0
25,06/16/2018,44,10:45,11:00,,20.78,0,20.78,20.78,-1,-38804,84814,123618,46010,0,0,0,0,0,,0,0
25,06/16/2018,45,11:00,11:15,,39.21,0,39.21,39.21,-1,-67084,66208,133292,-876,0,0,0,0,0,,0,0
25,06/16/2018,46,11:15,11:30,43.08,43.82,0,52.2,43.82,2,-60719,68987,129706,8268,0,0,0,0,0,,0,0
25,06/16/2018,47,11:30,11:45,,41.78,0,41.78,41.78,-1,-62376,83262,145638,20886,0,0,0,0,0,,0,0
25,06/16/2018,48,11:45,12:00,,39.21,0,39.21,39.21,-1,-55701,98230,153931,42529,0,0,0,0,0,,0,0
25,06/16/2018,49,12:00,12:15,,,0,43.36,43.36,0,-57279,65124,122403,7845,0,0,0,0,0,,0,0
25,06/16/2018,50,12:15,12:30,,,0,43.36,43.36,0,-66552,79344,145896,12792,0,0,0,0,0,,0,0
25,06/16/2018,51,12:30,12:45,,,0,43.36,43.36,0,-62929,102522,165451,39593,0,0,0,0,0,,0,0
25,06/16/2018,52,12:45,13:00,,44.3,0,44.3,44.3,-1,-52399,110969,163368,58570,0,0,0,0,0,,0,0
25,06/16/2018,53,13:00,13:15,,39.21,0,39.21,39.21,-1,-24473,78318,102791,53845,0,0,0,0,0,,0,0
25,06/16/2018,54,13:15,13:30,,12.1,0,12.1,12.1,-1,-30094,87407,117501,57313,0,0,0,0,0,,0,0
25,06/16/2018,55,13:30,13:45,,34.15,0,34.15,34.15,-1,-30124,81692,111816,51568,0,0,0,0,0,,0,0
25,06/16/2018,56,13:45,14:00,,5.78,0,5.78,5.78,-1,-17496,78909,96405,61413,0,0,0,0,0,,0,0
25,06/16/2018,57,14:00,14:15,,28.6,0,28.6,28.6,-1,-19389,53417,72806,34028,0,0,0,0,0,,0,0
25,06/16/2018,58,14:15,14:30,,,0,43.26,43.26,0,-19037,96100,115137,77063,0,0,0,0,0,,0,0
25,06/16/2018,59,14:30,14:45,,-15.78,0,-15.78,-15.78,-1,-27108,103452,130560,76344,0,0,0,0,0,,0,0
25,06/16/2018,60,14:45,15:00,,-150.78,0,-150.78,-150.78,-1,-19146,71042,90188,51896,0,0,0,0,0,,0,0
25,06/16/2018,61,15:00,15:15,,39.21,0,39.21,39.21,-1,-36309,56023,92332,19714,0,0,0,0,0,,0,0
25,06/16/2018,62,15:15,15:30,,,0,43.23,43.23,0,-47805,73628,121433,25823,0,0,0,0,0,,0,0
25,06/16/2018,63,15:30,15:45,,,0,43.23,43.23,0,-48556,55051,103607,6495,0,0,0,0,0,,0,0
25,06/16/2018,64,15:45,16:00,,,0,43.23,43.23,0,-44568,56091,100659,11523,0,0,0,0,0,,0,0
25,06/16/2018,65,16:00,16:15,,,0,43.19,43.19,0,-47547,87511,135058,39964,0,0,0,0,0,,0,0
25,06/16/2018,66,16:15,16:30,,41.6,0,41.6,41.6,-1,-46576,85724,132300,39148,0,0,0,0,0,,0,0
25,06/16/2018,67,16:30,16:45,,38.9,0,38.9,38.9,-1,-52724,83304,136028,30580,0,0,0,0,0,,0,0
25,06/16/2018,68,16:45,17:00,,42.78,0,42.78,42.78,-1,-51732,64323,116055,12591,0,0,0,0,0,,0,0
25,06/16/2018,69,17:00,17:15,,40.91,0,40.91,40.91,-1,-33144,120677,153821,87533,0,0,0,0,0,,0,0
25,06/16/2018,70,17:15,17:30,,38.93,0,38.93,38.93,-1,-28618,106300,134918,77682,0,0,0,0,0,,0,0
25,06/16/2018,71,17:30,17:45,,,0,43.5,43.5,0,-37044,93327,130371,56283,0,0,0,0,0,,0,0
25,06/16/2018,72,17:45,18:00,,,0,43.5,43.5,0,-37285,69525,106810,32240,0,0,0,0,0,,0,0
25,06/16/2018,73,18:00,18:15,,40.78,0,40.78,40.78,-1,-39206,54520,93726,15314,0,0,0,0,0,,0,0
25,06/16/2018,74,18:15,18:30,,41.78,0,41.78,41.78,-1,-41107,42910,84017,1803,0,0,0,0,0,,0,0
25,06/16/2018,75,18:30,18:45,,44.04,0,44.04,44.04,-1,-55006,42988,97994,-12018,0,0,0,0,0,,0,0
25,06/16/2018,76,18:45,19:00,,44.42,0,44.42,44.42,-1,-62071,46359,108430,-15712,0,0,0,0,0,,0,0
25,06/16/2018,77,19:00,19:15,47.59,,0,47.59,47.59,1,-56615,47184,103799,-9431,0,0,0,0,0,,0,0
25,06/16/2018,78,19:15,19:30,43.08,,0,43.08,43.08,1,-53539,40167,93706,-13372,0,0,0,0,0,,0,0
25,06/16/2018,79,19:30,19:45,46.33,,0,46.33,46.33,1,-52912,37196,90108,-15716,0,0,0,0,0,,0,0
25,06/16/2018,80,19:45,20:00,44.49,,0,44.49,44.49,1,-56406,40908,97314,-15498,0,0,0,0,0,,0,0
25,06/16/2018,81,20:00,20:15,44.49,41.1,0,41.1,41.1,-1,-33654,92038,125692,58384,0,0,0,0,0,,0,0
25,06/16/2018,82,20:15,20:30,,40.37,0,40.37,40.37,-1,-36407,94607,131014,58200,0,0,0,0,0,,0,0
25,06/16/2018,83,20:30,20:45,,39.21,0,39.21,39.21,-1,-30716,98768,129484,68052,0,0,0,0,0,,0,0
25,06/16/2018,84,20:45,21:00,,39.21,0,39.21,39.21,-1,-26223,118067,144290,91844,0,0,0,0,0,,0,0
25,06/16/2018,85,21:00,21:15,,41.43,0,41.43,41.43,-1,-28622,107259,135881,78637,0,0,0,0,0,,0,0
25,06/16/2018,86,21:15,21:30,,41.05,0,41.05,41.05,-1,-29725,118983,148708,89258,0,0,0,0,0,,0,0
25,06/16/2018,87,21:30,21:45,,39.21,0,39.21,39.21,-1,-27464,144224,171688,116760,0,0,0,0,0,,0,0
25,06/16/2018,88,21:45,22:00,,40.08,0,40.08,40.08,-1,-24896,139252,164148,114356,0,0,0,0,0,,0,0
25,06/16/2018,89,22:00,22:15,,11.78,0,11.78,11.78,-1,-26333,142993,169326,116660,0,0,0,0,0,,0,0
25,06/16/2018,90,22:15,22:30,,-150.78,0,-150.78,-150.78,-1,-39799,83535,123334,43736,0,0,0,0,0,,0,0
25,06/16/2018,91,22:30,22:45,,39.6,0,39.6,39.6,-1,-31921,77246,109167,45325,0,0,0,0,0,,0,0
25,06/16/2018,92,22:45,23:00,,,0,43.23,43.23,0,-30721,122615,153336,91894,0,0,0,0,0,,0,0
25,06/16/2018,93,23:00,23:15,,43.55,0,43.55,43.55,-1,-53992,49011,103003,-4981,0,0,0,0,0,,0,0
25,06/16/2018,94,23:15,23:30,,39.21,0,39.21,39.21,-1,-46701,65187,111888,18486,0,0,0,0,0,,0,0
25,06/16/2018,95,23:30,23:45,,-8.53,0,-8.53,-8.53,-1,-43017,96563,139580,53546,0,0,0,0,0,,0,0
25,06/16/2018,96,23:45,0:00,,-71.78,0,-71.78,-71.78,-1,-48601,92386,140987,43785,0,0,0,0,0,,0,0
25,06/17/2018,1,0:00,0:15,,,0,39.45,39.45,0,-42148,90228,132376,48080,0,-2617,0,0,0,,2617,-2617
25,06/17/2018,2,0:15,0:30,,,0,39.45,39.45,0,-31909,109201,141110,77292,0,0,0,0,0,,0,0
25,06/17/2018,3,0:30,0:45,,,0,39.45,39.45,0,-34454,115303,149757,80849,0,0,0,0,0,,0,0
25,06/17/2018,4,0:45,1:00,,10.8,0,10.8,10.8,-1,-56663,113016,169679,56353,0,-17283,0,0,0,,17283,-17283
25,06/17/2018,5,1:00,1:15,,23.67,0,23.67,23.67,-1,-35117,67687,102804,32570,0,-20246,0,0,0,,20246,-20246
25,06/17/2018,6,1:15,1:30,,30.79,0,30.79,30.79,-1,-43455,65521,108976,22066,0,-2321,0,0,0,,2321,-2321
25,06/17/2018,7,1:30,1:45,,-41.03,0,-41.03,-41.03,-1,-44102,93472,137574,49370,0,-30630,0,0,0,,30630,-30630
25,06/17/2018,8,1:45,2:00,,-34.03,0,-34.03,-34.03,-1,-57572,117570,175142,59998,0,-48603,0,0,0,,48603,-48603
25,06/17/2018,9,2:00,2:15,38.43,29.24,0,38.43,29.24,2,-55668,69127,124795,13459,0,-34085,40,0,0,,34125,-34045
25,06/17/2018,10,2:15,2:30,46.79,32.03,0,46.79,32.03,2,-75787,88955,164742,13168,0,-6695,1382,0,0,,8077,-5313
25,06/17/2018,11,2:30,2:45,,30.79,0,30.79,30.79,-1,-76199,105261,181460,29062,0,-16186,0,0,0,,16186,-16186
25,06/17/2018,12,2:45,3:00,,-19.03,0,-19.03,-19.03,-1,-74685,131431,206116,56746,0,-39516,0,0,0,,39516,-39516
25,06/17/2018,13,3:00,3:15,,-150.03,0,-150.03,-150.03,-1,-39630,104731,144361,65101,0,-53961,0,0,0,,53961,-53961
25,06/17/2018,14,3:15,3:30,,-35.03,0,-35.03,-35.03,-1,-34876,103441,138317,68565,0,-46650,0,0,0,,46650,-46650
25,06/17/2018,15,3:30,3:45,,-25.03,0,-25.03,-25.03,-1,-54060,101541,155601,47481,0,-52215,0,0,0,,52215,-52215
25,06/17/2018,16,3:45,4:00,,11.37,0,11.37,11.37,-1,-66604,126202,192806,59598,0,-14289,0,0,0,,14289,-14289
25,06/17/2018,17,4:00,4:15,,-22.03,0,-22.03,-22.03,-1,-37978,90347,128325,52369,0,-21514,0,0,0,,21514,-21514
25,06/17/2018,18,4:15,4:30,,,0,38.05,38.05,0,-32825,108125,140950,75300,0,-759,0,0,0,,759,-759
25,06/17/2018,19,4:30,4:45,,,0,38.04,38.04,0,-37376,101920,139296,64544,0,0,0,0,0,,0,0
25,06/17/2018,20,4:45,5:00,,38.79,0,38.79,38.79,-1,-28051,92744,120795,64693,0,-1208,0,0,0,,1208,-1208
25,06/17/2018,21,5:00,5:15,42.79,38.79,0,42.79,42.79,1,-51530,46867,98397,-4663,0,-1119,427,0,0,,1546,-692
25,06/17/2018,22,5:15,5:30,42.79,,0,42.79,42.79,1,-50026,40656,90682,-9370,0,0,656,0,0,,656,656
25,06/17/2018,23,5:30,5:45,,,0,38.07,38.07,0,-52412,51341,103753,-1071,0,0,0,0,0,,0,0
25,06/17/2018,24,5:45,6:00,,,0,38.07,38.07,0,-65374,60396,125770,-4978,0,0,0,0,0,,0,0
25,06/17/2018,25,6:00,6:15,42.68,,0,42.68,42.68,1,-71972,65957,137929,-6015,0,0,131,0,0,,131,131
25,06/17/2018,26,6:15,6:30,42.68,,0,42.68,42.68,1,-89239,58689,147928,-30550,0,0,3630,0,0,,3630,3630
25,06/17/2018,27,6:30,6:45,50.68,,0,50.68,50.68,1,-93386,60823,154209,-32563,0,0,13784,0,0,,13784,13784
25,06/17/2018,28,6:45,7:00,42.68,,0,42.68,42.68,1,-98659,78393,177052,-20266,0,0,10060,0,0,,10060,10060
25,06/17/2018,29,7:00,7:15,37.39,38.68,0,38.68,38.68,-1,-93706,93767,187473,61,0,-41,3226,0,0,,3267,3185
25,06/17/2018,30,7:15,7:30,,38.68,0,38.68,38.68,-1,-86460,88226,174686,1766,0,-554,0,0,0,,554,-554
25,06/17/2018,31,7:30,7:45,,38.68,0,38.68,38.68,-1,-78008,76868,154876,-1140,0,-524,0,0,0,,524,-524
25,06/17/2018,32,7:45,8:00,,38.68,0,38.68,38.68,-1,-82699,84154,166853,1455,0,-413,0,0,0,,413,-413
25,06/17/2018,33,8:00,8:15,,18.03,0,18.03,18.03,-1,-56655,102713,159368,46058,0,-10466,0,0,0,,10466,-10466
25,06/17/2018,34,8:15,8:30,,30.68,0,30.68,30.68,-1,-46270,107643,153913,61373,0,-19314,0,0,0,,19314,-19314
25,06/17/2018,35,8:30,8:45,,35.03,0,35.03,35.03,-1,-56284,97053,153337,40769,0,-13919,0,0,0,,13919,-13919
25,06/17/2018,36,8:45,9:00,,,0,38.05,38.05,0,-81178,100516,181694,19338,0,-831,0,0,0,,831,-831
25,06/17/2018,37,9:00,9:15,,38.68,0,38.68,38.68,-1,-65678,79563,145241,13885,0,-24,0,0,0,,24,-24
25,06/17/2018,38,9:15,9:30,,34.92,0,34.92,34.92,-1,-59049,70129,129178,11080,0,-1764,0,0,0,,1764,-1764
25,06/17/2018,39,9:30,9:45,,36.86,0,36.86,36.86,-1,-62477,72476,134953,9999,0,-533,0,0,0,,533,-533
25,06/17/2018,40,9:45,10:00,43.59,,0,43.59,43.59,1,-72950,67069,140019,-5881,0,0,690,0,0,,690,690
25,06/17/2018,41,10:00,10:15,42.68,38.68,0,42.68,37.96,2,-69028,84085,153113,15057,0,-21,461,0,0,,482,440
25,06/17/2018,42,10:15,10:30,,34.68,0,34.68,34.68,-1,-50926,105902,156828,54976,0,-2773,0,0,0,,2773,-2773
25,06/17/2018,43,10:30,10:45,,38.68,0,38.68,38.68,-1,-41731,93731,135462,52000,0,-677,0,0,0,,677,-677
25,06/17/2018,44,10:45,11:00,,,0,37.98,37.98,0,-35399,81122,116521,45723,0,0,0,0,0,,0,0
25,06/17/2018,45,11:00,11:15,,,0,37.95,37.95,0,-55020,91735,146755,36715,0,0,0,0,0,,0,0
25,06/17/2018,46,11:15,11:30,,,0,37.97,37.97,0,-52037,61445,113482,9408,0,0,0,0,0,,0,0
25,06/17/2018,47,11:30,11:45,46.68,,0,46.68,46.68,1,-55879,47050,102929,-8829,0,0,4082,0,0,,4082,4082
25,06/17/2018,48,11:45,12:00,51.75,,0,51.75,51.75,1,-69117,33908,103025,-35209,0,0,23297,0,0,,23297,23297
25,06/17/2018,49,12:00,12:15,48.02,,0,48.02,48.02,1,-68333,46201,114534,-22132,0,0,26046,0,0,,26046,26046
25,06/17/2018,50,12:15,12:30,50.72,,0,50.72,50.72,1,-69763,42490,112253,-27273,0,0,14964,0,0,,14964,14964
25,06/17/2018,51,12:30,12:45,55.53,,0,55.53,55.53,1,-77943,40984,118927,-36959,0,0,34705,0,0,,34705,34705
25,06/17/2018,52,12:45,13:00,48.88,,0,48.88,48.88,1,-79924,44277,124201,-35647,0,0,31871,0,0,,31871,31871
25,06/17/2018,53,13:00,13:15,46.68,,0,46.68,46.68,1,-66762,60082,126844,-6680,0,0,19220,0,0,,19220,19220
25,06/17/2018,54,13:15,13:30,50.68,,0,50.68,50.68,1,-64056,41341,105397,-22715,0,0,8164,0,0,,8164,8164
25,06/17/2018,55,13:30,13:45,43.56,,0,43.56,43.56,1,-57451,46992,104443,-10459,0,0,11204,0,0,,11204,11204
25,06/17/2018,56,13:45,14:00,42.68,34.26,0,42.68,34.26,2,-45663,64129,109792,18466,0,-1252,2480,0,0,,3732,1228
25,06/17/2018,57,14:00,14:15,42.68,30.68,0,30.68,30.68,-1,-42690,37590,80280,-5100,0,-2489,8,0,0,,2497,-2481
25,06/17/2018,58,14:15,14:30,42.68,,0,42.68,42.68,1,-39921,37352,77273,-2569,0,0,545,0,0,,545,545
25,06/17/2018,59,14:30,14:45,46.68,,0,46.68,46.68,1,-43122,33118,76240,-10004,0,0,3357,0,0,,3357,3357
25,06/17/2018,60,14:45,15:00,46.68,,0,46.68,46.68,1,-47445,31873,79318,-15572,0,0,8230,0,0,,8230,8230
25,06/17/2018,61,15:00,15:15,42.02,,0,42.02,42.02,1,-34969,48093,83062,13124,0,0,2574,0,0,,2574,2574
25,06/17/2018,62,15:15,15:30,37.08,,0,37.08,37.08,1,-35382,43791,79173,8409,0,0,536,0,0,,536,536
25,06/17/2018,63,15:30,15:45,43.19,,0,43.19,43.19,1,-40917,39473,80390,-1444,0,0,1019,0,0,,1019,1019
25,06/17/2018,64,15:45,16:00,37.08,,0,37.08,37.08,1,-46137,46101,92238,-36,0,0,60,0,0,,60,60
25,06/17/2018,65,16:00,16:15,36.98,18.22,0,18.22,18.22,-1,-41239,88344,129583,47105,0,-3937,90,0,0,,4027,-3847
25,06/17/2018,66,16:15,16:30,,2.66,0,2.66,2.66,-1,-38635,94552,133187,55917,0,-31507,0,0,0,,31507,-31507
25,06/17/2018,67,16:30,16:45,,33.95,0,33.95,33.95,-1,-40686,75785,116471,35099,0,-23968,0,0,0,,23968,-23968
25,06/17/2018,68,16:45,17:00,46.07,33.95,0,46.07,46.07,1,-48270,46982,95252,-1288,0,-2288,1063,0,0,,3351,-1225
25,06/17/2018,69,17:00,17:15,,,0,37.79,37.79,0,-36550,56345,92895,19795,0,0,5,0,0,,5,5
25,06/17/2018,70,17:15,17:30,43.11,,0,43.11,43.11,1,-45198,40601,85799,-4597,0,0,933,0,0,,933,933
25,06/17/2018,71,17:30,17:45,50.68,,0,50.68,50.68,1,-54526,23016,77542,-31510,0,0,6719,0,0,,6719,6719
25,06/17/2018,72,17:45,18:00,75.02,,0,75.02,75.02,1,-63050,7982,71032,-55068,0,0,26952,0,0,,26952,26952
25,06/17/2018,73,18:00,18:15,52.62,-11.03,0,-11.03,-11.03,-1,-32369,87196,119565,54827,0,-5221,21509,0,0,,26730,16288
25,06/17/2018,74,18:15,18:30,52.62,-51.03,0,-51.03,-51.03,-1,-28669,71340,100009,42671,0,-30120,420,0,0,,30540,-29700
25,06/17/2018,75,18:30,18:45,,24.02,0,24.02,24.02,-1,-30290,78811,109101,48521,0,-18850,0,0,0,,18850,-18850
25,06/17/2018,76,18:45,19:00,,10.04,0,10.04,10.04,-1,-22801,78985,101786,56184,0,-40580,0,0,0,,40580,-40580
25,06/17/2018,77,19:00,19:15,,28.03,0,28.03,28.03,-1,-26888,94719,121607,67831,0,-40056,0,0,0,,40056,-40056
25,06/17/2018,78,19:15,19:30,,7.4,0,7.4,7.4,-1,-31549,94795,126344,63246,0,-54438,0,0,0,,54438,-54438
25,06/17/2018,79,19:30,19:45,,31.64,0,31.64,31.64,-1,-34340,81361,115701,47021,0,-43958,0,0,0,,43958,-43958
25,06/17/2018,80,19:45,20:00,,34.68,0,34.68,34.68,-1,-49145,68413,117558,19268,0,-29036,0,0,0,,29036,-29036
25,06/17/2018,81,20:00,20:15,,19.55,0,19.55,19.55,-1,-29800,77112,106912,47312,0,-21916,0,0,0,,21916,-21916
25,06/17/2018,82,20:15,20:30,,36.3,0,36.3,36.3,-1,-33076,61489,94565,28413,0,-26656,0,0,0,,26656,-26656
25,06/17/2018,83,20:30,20:45,,35.87,0,35.87,35.87,-1,-29917,62853,92770,32936,0,-27156,0,0,0,,27156,-27156
25,06/17/2018,84,20:45,21:00,,34.68,0,34.68,34.68,-1,-37151,50070,87221,12919,0,-24940,0,0,0,,24940,-24940
25,06/17/2018,85,21:00,21:15,237.02,34.68,0,237.02,237.02,1,-99078,28571,127649,-70507,0,-5371,23802,0,0,,29173,18431
25,06/17/2018,86,21:15,21:30,57.02,,0,57.02,57.02,1,-89916,66214,156130,-23702,0,0,23217,0,0,,23217,23217
25,06/17/2018,87,21:30,21:45,,,0,39.9,39.9,0,-89830,77783,167613,-12047,0,0,1187,0,0,,1187,1187
25,06/17/2018,88,21:45,22:00,,42.04,0,42.04,42.04,-1,-89690,84319,174009,-5371,0,-173,0,0,0,,173,-173
25,06/17/2018,89,22:00,22:15,,42.05,0,42.05,42.05,-1,-88049,118777,206826,30728,0,-587,0,0,0,,587,-587
25,06/17/2018,90,22:15,22:30,,,0,40.27,40.27,0,-93593,92407,186000,-1186,0,0,0,0,0,,0,0
25,06/17/2018,91,22:30,22:45,,38.68,0,38.68,38.68,-1,-93329,129419,222748,36090,0,-257,0,0,0,,257,-257
25,06/17/2018,92,22:45,23:00,,23.43,0,23.43,23.43,-1,-90989,166673,257662,75684,0,-21738,0,0,0,,21738,-21738
25,06/17/2018,93,23:00,23:15,80.59,34.68,0,80.59,80.59,1,-122157,112671,234828,-9486,0,-19130,99,0,0,,19229,-19031
25,06/17/2018,94,23:15,23:30,237.02,34.68,0,260.72,260.72,1,-240225,126202,366427,-114023,0,-387,27706,0,12500,,40593,39819
25,06/17/2018,95,23:30,23:45,42.68,-34.32,0,42.68,-34.32,2,-206038,263408,469446,57370,0,-22442,1896,0,6250,,30588,-14296
25,06/17/2018,96,23:45,0:00,,31.55,0,31.55,31.55,-1,-269006,271729,540735,2723,0,-22375,0,0,0,,22375,-22375
25,06/18/2018,1,0:00,0:15,217.29,31.55,0,217.29,217.29,1,-270712,190068,460780,-80644,0,-347,15703,0,0,,16050,15356
25,06/18/2018,2,0:15,0:30,59.12,,0,59.12,59.12,1,-262872,199463,462335,-63409,0,0,34173,0,0,,34173,34173
25,06/18/2018,3,0:30,0:45,36.95,,0,36.95,36.95,1,-261832,179704,441536,-82128,0,0,1938,0,0,,1938,1938
25,06/18/2018,4,0:45,1:00,43.32,,0,43.32,43.32,1,-257864,182883,440747,-74981,0,0,925,0,0,,925,925
25,06/18/2018,5,1:00,1:15,,25.53,0,25.53,25.53,-1,-81554,178311,259865,96757,0,-6552,0,0,0,,6552,-6552
25,06/18/2018,6,1:15,1:30,,,0,39.04,39.04,0,-75200,141594,216794,66394,0,-145,0,0,0,,145,-145
25,06/18/2018,7,1:30,1:45,,,0,39.05,39.05,0,-75302,135189,210491,59887,0,0,0,0,0,,0,0
25,06/18/2018,8,1:45,2:00,,35.23,0,35.23,35.23,-1,-74106,132611,206717,58505,0,-2896,0,0,0,,2896,-2896
25,06/18/2018,9,2:00,2:15,53.96,35.29,0,53.96,35.29,2,-129922,96287,226209,-33635,0,-2466,7429,0,0,,9895,4963
25,06/18/2018,10,2:15,2:30,43.16,,0,43.16,43.16,1,-124599,107119,231718,-17480,0,0,13440,0,0,,13440,13440
25,06/18/2018,11,2:30,2:45,46.68,,0,46.68,46.68,1,-121550,95409,216959,-26141,0,0,15874,0,0,,15874,15874
25,06/18/2018,12,2:45,3:00,43.12,41.23,0,41.23,41.23,-1,-106684,109233,215917,2549,0,-176,9117,0,0,,9293,8941
25,06/18/2018,13,3:00,3:15,36.96,41.58,0,39.27,39.27,2,-95939,94248,190187,-1691,0,-99,148,0,0,,247,49
25,06/18/2018,14,3:15,3:30,37.18,,0,37.18,37.18,1,-87858,89686,177544,1828,0,0,593,0,0,,593,593
25,06/18/2018,15,3:30,3:45,37.18,38.68,0,38.68,38.68,-1,-83119,101186,184305,18067,0,-58,65,0,0,,123,7
25,06/18/2018,16,3:45,4:00,,21.03,0,21.03,21.03,-1,-56129,110665,166794,54536,0,-5617,0,0,0,,5617,-5617
25,06/18/2018,17,4:00,4:15,,-150.78,0,-150.78,-150.78,-1,-67808,104779,172587,36971,0,-41459,0,0,0,,41459,-41459
25,06/18/2018,18,4:15,4:30,,30.68,0,30.68,30.68,-1,-59044,100843,159887,41799,0,-42110,0,0,0,,42110,-42110
25,06/18/2018,19,4:30,4:45,,-150.78,0,-150.78,-150.78,-1,-36587,101525,138112,64938,0,-51555,0,0,0,,51555,-51555
25,06/18/2018,20,4:45,5:00,,-150.78,0,-150.78,-150.78,-1,-14406,69074,83480,54668,0,-53531,0,0,0,,53531,-53531
25,06/18/2018,21,5:00,5:15,,41.43,0,41.43,41.43,-1,-69884,73278,143162,3394,0,-9187,0,0,0,,9187,-9187
25,06/18/2018,22,5:15,5:30,,,0,39.25,39.25,0,-59867,80119,139986,20252,0,0,0,0,0,,0,0
25,06/18/2018,23,5:30,5:45,,38.68,0,38.68,38.68,-1,-56539,73786,130325,17247,0,-988,0,0,0,,988,-988
25,06/18/2018,24,5:45,6:00,,-150.78,0,-150.78,-150.78,-1,-51664,111186,162850,59522,0,-12817,0,0,0,,12817,-12817
25,06/18/2018,25,6:00,6:15,54.34,38.69,0,54.34,38.69,2,-133131,111749,244880,-21382,0,-5925,3406,0,0,,9331,-2519
25,06/18/2018,26,6:15,6:30,54.34,38.69,0,38.69,38.69,-1,-59677,88762,148439,29085,0,-143,250,0,0,,393,107
25,06/18/2018,27,6:30,6:45,53.64,30.69,0,53.64,30.69,2,-64015,56510,120525,-7505,0,-9640,814,0,0,,10454,-8826
25,06/18/2018,28,6:45,7:00,132.79,44.7,0,132.79,41.06,2,-75674,53776,129450,-21898,0,-25,24299,0,0,,24324,24274
25,06/18/2018,29,7:00,7:15,132.79,17.57,0,17.57,17.57,-1,-89230,129677,218907,40447,0,-7715,1193,0,0,,8908,-6522
25,06/18/2018,30,7:15,7:30,,14.42,0,14.42,14.42,-1,-60890,74125,135015,13235,0,-24507,0,0,0,,24507,-24507
25,06/18/2018,31,7:30,7:45,44.3,41.36,0,44.3,41.36,2,-51967,71532,123499,19565,0,-2439,717,0,0,,3156,-1722
25,06/18/2018,32,7:45,8:00,,43.1,0,43.1,43.1,-1,-78357,106079,184436,27722,0,-779,0,0,0,,779,-779
25,06/18/2018,33,8:00,8:15,,38.69,0,38.69,38.69,-1,-94133,142854,236987,48721,0,-3504,0,0,0,,3504,-3504
25,06/18/2018,34,8:15,8:30,,42.59,0,42.59,42.59,-1,-61247,105553,166800,44306,0,-2803,0,0,0,,2803,-2803
25,06/18/2018,35,8:30,8:45,,43.8,0,43.8,43.8,-1,-59225,63787,123012,4562,0,-2356,0,0,0,,2356,-2356
25,06/18/2018,36,8:45,9:00,43.82,43.8,0,43.82,43.82,1,-68882,61621,130503,-7261,0,-95,864,0,0,,959,769
25,06/18/2018,37,9:00,9:15,43.78,38.69,0,43.81,38.69,2,-44931,57343,102274,12412,0,-1517,725,0,0,,2242,-792
25,06/18/2018,38,9:15,9:30,45.81,44.41,0,45.81,43.81,2,-46522,36856,83378,-9666,0,-489,1399,0,0,,1888,910
25,06/18/2018,39,9:30,9:45,,,0,43.81,43.81,0,-44719,44970,89689,251,0,0,458,0,0,,458,458
25,06/18/2018,40,9:45,10:00,43.14,,0,43.14,43.14,1,-43253,41846,85099,-1407,0,0,73,0,0,,73,73
25,06/18/2018,41,10:00,10:15,48.94,,0,48.94,48.94,1,-72295,61940,134235,-10355,0,0,3781,0,0,,3781,3781
25,06/18/2018,42,10:15,10:30,48.94,,0,48.94,48.94,1,-68976,61188,130164,-7788,0,0,1313,0,0,,1313,1313
25,06/18/2018,43,10:30,10:45,51.04,,0,51.04,51.04,1,-68326,45471,113797,-22855,0,0,14305,0,0,,14305,14305
25,06/18/2018,44,10:45,11:00,45.63,,0,45.63,45.63,1,-61429,47925,109354,-13504,0,0,15437,0,0,,15437,15437
25,06/18/2018,45,11:00,11:15,60.36,,0,60.36,60.36,1,-92329,60956,153285,-31373,0,0,15280,0,0,,15280,15280
25,06/18/2018,46,11:15,11:30,64.12,,0,64.12,64.12,1,-92864,49319,142183,-43545,0,0,34810,0,0,,34810,34810
25,06/18/2018,47,11:30,11:45,52.94,,0,52.94,52.94,1,-81995,47991,129986,-34004,0,0,38593,0,0,,38593,38593
25,06/18/2018,48,11:45,12:00,89.21,,0,89.21,89.21,1,-99875,55216,155091,-44659,0,0,30556,0,0,,30556,30556
25,06/18/2018,49,12:00,12:15,104.12,,0,104.12,104.12,1,-99844,41878,141722,-57966,0,0,42586,0,0,,42586,42586
25,06/18/2018,50,12:15,12:30,61.51,,0,61.51,61.51,1,-79347,48590,127937,-30757,0,0,42364,0,0,,42364,42364
25,06/18/2018,51,12:30,12:45,213.19,39.68,0,213.19,39.68,2,-55170,63786,118956,8616,0,-1211,12712,2500,0,,16423,14001
25,06/18/2018,52,12:45,13:00,54.32,41.46,0,54.32,54.32,1,-71241,51238,122479,-20003,0,-244,3679,0,0,,3923,3435
25,06/18/2018,53,13:00,13:15,52.94,,0,52.94,52.94,1,-96383,42294,138677,-54089,0,0,19548,0,0,,19548,19548
25,06/18/2018,54,13:15,13:30,48.94,,0,48.94,48.94,1,-98544,38828,137372,-59716,0,0,21751,0,0,,21751,21751
25,06/18/2018,55,13:30,13:45,154.83,,0,154.83,154.83,1,-114359,20738,135097,-93621,0,0,43557,0,0,,43557,43557
25,06/18/2018,56,13:45,14:00,60,,0,60,60,1,-114595,50918,165513,-63677,0,0,53299,0,0,,53299,53299
25,06/18/2018,57,14:00,14:15,43.82,40.69,0,43.82,40.69,2,-97090,88827,185917,-8263,0,-738,10190,0,0,,10928,9452
25,06/18/2018,58,14:15,14:30,44.35,,0,44.35,44.35,1,-90452,73874,164326,-16578,0,0,3053,0,0,,3053,3053
25,06/18/2018,59,14:30,14:45,,,0,42.69,42.69,0,-59626,70782,130408,11156,0,0,297,0,0,,297,297
25,06/18/2018,60,14:45,15:00,,,0,42.69,42.69,0,-61622,69293,130915,7671,0,0,0,0,0,,0,0
25,06/18/2018,61,15:00,15:15,,,0,42.58,42.58,0,-50136,96246,146382,46110,0,0,0,0,0,,0,0
25,06/18/2018,62,15:15,15:30,,,0,42.58,42.58,0,-50340,73875,124215,23535,0,0,0,0,0,,0,0
25,06/18/2018,63,15:30,15:45,,,0,42.59,42.59,0,-64031,59974,124005,-4057,0,0,0,0,0,,0,0
25,06/18/2018,64,15:45,16:00,,40.84,0,40.84,40.84,-1,-54837,67433,122270,12596,0,-433,0,0,0,,433,-433
25,06/18/2018,65,16:00,16:15,,40.78,0,40.78,40.78,-1,-52739,68966,121705,16227,0,-3499,0,0,0,,3499,-3499
25,06/18/2018,66,16:15,16:30,,41,0,41,41,-1,-46143,72158,118301,26015,0,-557,0,0,0,,557,-557
25,06/18/2018,67,16:30,16:45,,38.69,0,38.69,38.69,-1,-36875,68383,105258,31508,0,-2578,0,0,0,,2578,-2578
25,06/18/2018,68,16:45,17:00,,40.78,0,40.78,40.78,-1,-45095,75625,120720,30530,0,-1711,0,0,0,,1711,-1711
25,06/18/2018,69,17:00,17:15,,42.74,0,42.74,42.74,-1,-23506,87256,110762,63750,0,-928,0,0,0,,928,-928
25,06/18/2018,70,17:15,17:30,,44.01,0,44.01,44.01,-1,-22404,111575,133979,89171,0,-1788,0,0,0,,1788,-1788
25,06/18/2018,71,17:30,17:45,,38.69,0,38.69,38.69,-1,-24047,125535,149582,101488,0,-3153,0,0,0,,3153,-3153
25,06/18/2018,72,17:45,18:00,,44.8,0,44.8,44.8,-1,-28067,136741,164808,108674,0,-656,0,0,0,,656,-656
25,06/18/2018,73,18:00,18:15,,38.69,0,38.69,38.69,-1,-25813,123926,149739,98113,0,-2265,0,0,0,,2265,-2265
25,06/18/2018,74,18:15,18:30,,28.7,0,28.7,28.7,-1,-21951,177255,199206,155304,0,-16260,0,0,0,,16260,-16260
25,06/18/2018,75,18:30,18:45,,-42.51,0,-42.51,-42.51,-1,-24796,176413,201209,151617,0,-45025,0,0,0,,45025,-45025
25,06/18/2018,76,18:45,19:00,,38.69,0,38.69,38.69,-1,-28820,161160,189980,132340,0,-25517,0,0,0,,25517,-25517
25,06/18/2018,77,19:00,19:15,,,0,42.91,42.91,0,-23209,144194,167403,120985,0,-1797,0,0,0,,1797,-1797
25,06/18/2018,78,19:15,19:30,,43.4,0,43.4,43.4,-1,-26410,113779,140189,87369,0,-464,0,0,0,,464,-464
25,06/18/2018,79,19:30,19:45,,43.94,0,43.94,43.94,-1,-21849,136807,158656,114958,0,-442,0,0,0,,442,-442
25,06/18/2018,80,19:45,20:00,,38.69,0,38.69,38.69,-1,-14687,148682,163369,133995,0,-5783,0,0,0,,5783,-5783
25,06/18/2018,81,20:00,20:15,,37.14,0,37.14,37.14,-1,-15374,156220,171594,140846,0,-3888,0,0,0,,3888,-3888
25,06/18/2018,82,20:15,20:30,,-48.39,0,-48.39,-48.39,-1,-18212,161462,179674,143250,0,-19169,0,0,0,,19169,-19169
25,06/18/2018,83,20:30,20:45,,-47.71,0,-47.71,-47.71,-1,-34142,112307,146449,78165,0,-61085,0,0,0,,61085,-61085
25,06/18/2018,84,20:45,21:00,,38.36,0,38.36,38.36,-1,-62162,87969,150131,25807,0,-35027,0,0,0,,35027,-35027
25,06/18/2018,85,21:00,21:15,,30.69,0,30.69,30.69,-1,-25807,98587,124394,72780,0,-23392,0,0,0,,23392,-23392
25,06/18/2018,86,21:15,21:30,,2.36,0,2.36,2.36,-1,-27153,96570,123723,69417,0,-44192,0,0,0,,44192,-44192
25,06/18/2018,87,21:30,21:45,,5.7,0,5.7,5.7,-1,-26567,112125,138692,85558,0,-75174,0,0,0,,75174,-75174
25,06/18/2018,88,21:45,22:00,,9.33,0,9.33,9.33,-1,-30783,129394,160177,98611,0,-82970,0,0,0,,82970,-82970
25,06/18/2018,89,22:00,22:15,,10.97,0,10.97,10.97,-1,-33113,68667,101780,35554,0,-45307,0,0,0,,45307,-45307
25,06/18/2018,90,22:15,22:30,,,0,40.83,40.83,0,-33760,70091,103851,36331,0,-2,0,0,0,,2,-2
25,06/18/2018,91,22:30,22:45,,38.69,0,38.69,38.69,-1,-21878,89093,110971,67215,0,-1915,0,0,0,,1915,-1915
25,06/18/2018,92,22:45,23:00,,-20.54,0,-20.54,-20.54,-1,-21761,123922,145683,102161,0,-12606,0,0,0,,12606,-12606
25,06/18/2018,93,23:00,23:15,45.64,-67.99,0,45.64,45.64,1,-68534,62482,131016,-6052,0,-23196,884,0,0,,24080,-22312
25,06/18/2018,94,23:15,23:30,45.64,-2.8,0,-2.8,-2.8,-1,-30439,71558,101997,41119,0,-9805,245,0,0,,10050,-9560
25,06/18/2018,95,23:30,23:45,,-90.6,0,-90.6,-90.6,-1,-35295,91613,126908,56318,0,-57303,0,0,0,,57303,-57303
25,06/18/2018,96,23:45,0:00,,3.1,0,3.1,3.1,-1,-45779,114417,160196,68638,0,-47400,0,0,0,,47400,-47400
25,06/19/2018,1,0:00,0:15,,-150.03,0,-150.03,-150.03,-1,-12934,209834,222768,196900,0,-74759,0,0,0,,74759,-74759
25,06/19/2018,2,0:15,0:30,,-150.03,0,-150.03,-150.03,-1,-6607,135620,142227,129013,0,-69955,0,0,0,,69955,-69955
25,06/19/2018,3,0:30,0:45,,-150.03,0,-150.03,-150.03,-1,-16355,133876,150231,117521,0,-117502,0,0,0,,117502,-117502
25,06/19/2018,4,0:45,1:00,,-2.03,0,-2.03,-2.03,-1,-39556,170537,210093,130981,0,-115132,0,0,0,,115132,-115132
25,06/19/2018,5,1:00,1:15,,-1.38,0,-1.38,-1.38,-1,-59360,99011,158371,39651,0,-73061,0,0,0,,73061,-73061
25,06/19/2018,6,1:15,1:30,,,0,38.62,38.62,0,-47315,150324,197639,103009,0,-1243,0,0,0,,1243,-1243
25,06/19/2018,7,1:30,1:45,,,0,38.61,38.61,0,-44906,159783,204689,114877,0,0,0,0,0,,0,0
25,06/19/2018,8,1:45,2:00,,31.98,0,31.98,31.98,-1,-45126,162509,207635,117383,0,-3433,0,0,0,,3433,-3433
25,06/19/2018,9,2:00,2:15,,39.19,0,39.19,39.19,-1,-53410,92458,145868,39048,0,-1463,0,0,0,,1463,-1463
25,06/19/2018,10,2:15,2:30,,,0,38.68,38.68,0,-54483,73527,128010,19044,0,0,0,0,0,,0,0
25,06/19/2018,11,2:30,2:45,,,0,38.68,38.68,0,-59484,58532,118016,-952,0,0,0,0,0,,0,0
25,06/19/2018,12,2:45,3:00,37.22,38.89,0,38.71,38.71,2,-64224,64310,128534,86,0,-60,234,0,0,,294,174
25,06/19/2018,13,3:00,3:15,,38.2,0,38.2,38.2,-1,-21657,88006,109663,66349,0,-327,0,0,0,,327,-327
25,06/19/2018,14,3:15,3:30,,37.96,0,37.96,37.96,-1,-22772,109368,132140,86596,0,-1034,0,0,0,,1034,-1034
25,06/19/2018,15,3:30,3:45,,38.2,0,38.2,38.2,-1,-22086,97944,120030,75858,0,-3758,0,0,0,,3758,-3758
25,06/19/2018,16,3:45,4:00,,-5.6,0,-5.6,-5.6,-1,-21058,116926,137984,95868,0,-25897,0,0,0,,25897,-25897
25,06/19/2018,17,4:00,4:15,,33.58,0,33.58,33.58,-1,-2563,161735,164298,159172,0,-37792,0,0,0,,37792,-37792
25,06/19/2018,18,4:15,4:30,,37.02,0,37.02,37.02,-1,-2612,144384,146996,141772,0,-21731,0,0,0,,21731,-21731
25,06/19/2018,19,4:30,4:45,,38.71,0,38.71,38.71,-1,-2880,136185,139065,133305,0,-4796,0,0,0,,4796,-4796
25,06/19/2018,20,4:45,5:00,,34.89,0,34.89,34.89,-1,-4738,146609,151347,141871,0,-10519,0,0,0,,10519,-10519
25,06/19/2018,21,5:00,5:15,,5.03,0,5.03,5.03,-1,-23050,184816,207866,161766,0,-39189,0,0,0,,39189,-39189
25,06/19/2018,22,5:15,5:30,,18.3,0,18.3,18.3,-1,-22808,181200,204008,158392,0,-51056,0,0,0,,51056,-51056
25,06/19/2018,23,5:30,5:45,,28.96,0,28.96,28.96,-1,-22997,171296,194293,148299,0,-53155,0,0,0,,53155,-53155
25,06/19/2018,24,5:45,6:00,,5.03,0,5.03,5.03,-1,-31771,155097,186868,123326,0,-45216,0,0,0,,45216,-45216
25,06/19/2018,25,6:00,6:15,,5.03,0,5.03,5.03,-1,-64903,184277,249180,119374,0,-46822,0,0,0,,46822,-46822
25,06/19/2018,26,6:15,6:30,,30.31,0,30.31,30.31,-1,-26621,136557,163178,109936,0,-48312,0,0,0,,48312,-48312
25,06/19/2018,27,6:30,6:45,,,0,38.84,38.84,0,-27950,96373,124323,68423,0,-13922,0,0,0,,13922,-13922
25,06/19/2018,28,6:45,7:00,42.31,,0,42.31,42.31,1,-69421,111670,181091,42249,0,0,2,0,0,,2,2
25,06/19/2018,29,7:00,7:15,,,0,40.53,40.53,0,-123206,91130,214336,-32076,0,0,0,0,0,,0,0
25,06/19/2018,30,7:15,7:30,42.31,,0,42.31,42.31,1,-70329,55423,125752,-14906,0,0,452,0,0,,452,452
25,06/19/2018,31,7:30,7:45,50.89,,0,50.89,50.89,1,-55108,25300,80408,-29808,0,0,9513,0,0,,9513,9513
25,06/19/2018,32,7:45,8:00,45.86,,0,45.86,45.86,1,-74782,75223,150005,441,0,0,11655,0,0,,11655,11655
25,06/19/2018,33,8:00,8:15,45.86,43.59,0,43.59,43.59,-1,-68811,78760,147571,9949,0,-626,466,0,0,,1092,-160
25,06/19/2018,34,8:15,8:30,,43.59,0,43.59,43.59,-1,-48341,77593,125934,29252,0,-452,0,0,0,,452,-452
25,06/19/2018,35,8:30,8:45,52.33,43.59,0,52.33,40.81,2,-60352,36718,97070,-23634,0,-187,3053,0,0,,3240,2866
25,06/19/2018,36,8:45,9:00,174.02,43.59,0,174.02,174.02,1,-75422,29859,105281,-45563,0,-21,38718,0,0,,38739,38697
25,06/19/2018,37,9:00,9:15,46.24,32.45,0,46.24,32.45,2,-38213,53405,91618,15192,0,-2173,14551,0,0,,16724,12378
25,06/19/2018,38,9:15,9:30,218.16,,0,218.16,218.16,1,-90396,46359,136755,-44037,0,0,12183,0,0,,12183,12183
25,06/19/2018,39,9:30,9:45,218.16,38.93,0,38.93,38.93,-1,-50394,53723,104117,3329,0,-326,24359,0,0,,24685,24033
25,06/19/2018,40,9:45,10:00,42.78,32.45,0,43.5,32.45,2,-34528,41498,76026,6970,0,-6609,451,0,0,,7060,-6158
25,06/19/2018,41,10:00,10:15,89.02,,0,89.02,89.02,1,-71342,36632,107974,-34710,0,0,16087,0,0,,16087,16087
25,06/19/2018,42,10:15,10:30,48.33,,0,48.33,48.33,1,-50815,30255,81070,-20560,0,0,12213,0,0,,12213,12213
25,06/19/2018,43,10:30,10:45,57.13,,0,57.13,57.13,1,-71686,29021,100707,-42665,0,0,17869,0,0,,17869,17869
25,06/19/2018,44,10:45,11:00,65.02,,0,65.02,65.02,1,-71911,27371,99282,-44540,0,0,36032,0,0,,36032,36032
25,06/19/2018,45,11:00,11:15,48.33,,0,48.33,48.33,1,-81176,34214,115390,-46962,0,0,31515,0,0,,31515,31515
25,06/19/2018,46,11:15,11:30,206.74,,0,206.74,206.74,1,-110887,30891,141778,-79996,0,0,43220,0,0,,43220,43220
25,06/19/2018,47,11:30,11:45,89.02,,0,89.02,89.02,1,-101264,30733,131997,-70531,0,0,60692,0,0,,60692,60692
25,06/19/2018,48,11:45,12:00,225.12,,0,225.12,225.12,1,-111238,43514,154752,-67724,0,0,60118,2500,0,,62618,62618
25,06/19/2018,49,12:00,12:15,51.81,,0,51.81,51.81,1,-74465,57645,132110,-16820,0,0,27126,0,0,,27126,27126
25,06/19/2018,50,12:15,12:30,43.32,,0,43.32,43.32,1,-69549,56758,126307,-12791,0,0,71,0,0,,71,71
25,06/19/2018,51,12:30,12:45,74.76,,0,74.76,74.76,1,-73729,44476,118205,-29253,0,0,19082,0,0,,19082,19082
25,06/19/2018,52,12:45,13:00,48.33,,0,48.33,48.33,1,-69862,51670,121532,-18192,0,0,25663,0,0,,25663,25663
25,06/19/2018,53,13:00,13:15,45.02,,0,45.02,45.02,1,-79510,70352,149862,-9158,0,0,6773,0,0,,6773,6773
25,06/19/2018,54,13:15,13:30,60.49,,0,60.49,60.49,1,-89236,59821,149057,-29415,0,0,11019,0,0,,11019,11019
25,06/19/2018,55,13:30,13:45,61.02,,0,61.02,61.02,1,-92103,55864,147967,-36239,0,0,24662,0,0,,24662,24662
25,06/19/2018,56,13:45,14:00,120.02,,0,120.02,120.02,1,-104584,43235,147819,-61349,0,0,37459,0,0,,37459,37459
25,06/19/2018,57,14:00,14:15,250.09,,0,250.09,250.09,1,-122012,49505,171517,-72507,0,0,44266,0,0,,44266,44266
25,06/19/2018,58,14:15,14:30,88.92,,0,88.92,88.92,1,-108330,69679,178009,-38651,0,0,46703,0,0,,46703,46703
25,06/19/2018,59,14:30,14:45,48.33,,0,48.33,48.33,1,-96958,73760,170718,-23198,0,0,18231,0,0,,18231,18231
25,06/19/2018,60,14:45,15:00,65.02,,0,65.02,65.02,1,-112167,67572,179739,-44595,0,0,17325,0,0,,17325,17325
25,06/19/2018,61,15:00,15:15,56.6,,0,56.6,56.6,1,-104143,78907,183050,-25236,0,0,22273,0,0,,22273,22273
25,06/19/2018,62,15:15,15:30,47,,0,47,47,1,-94067,78996,173063,-15071,0,0,13653,0,0,,13653,13653
25,06/19/2018,63,15:30,15:45,56.6,,0,56.6,56.6,1,-104196,71420,175616,-32776,0,0,15919,0,0,,15919,15919
25,06/19/2018,64,15:45,16:00,48.33,,0,48.33,48.33,1,-101683,58276,159959,-43407,0,0,21498,0,0,,21498,21498
25,06/19/2018,65,16:00,16:15,48.33,,0,48.33,48.33,1,-86831,80277,167108,-6554,0,0,7631,0,0,,7631,7631
25,06/19/2018,66,16:15,16:30,83.28,,0,83.28,83.28,1,-90618,55939,146557,-34679,0,0,22453,0,0,,22453,22453
25,06/19/2018,67,16:30,16:45,48.33,,0,48.33,48.33,1,-86247,70731,156978,-15516,0,0,15533,0,0,,15533,15533
25,06/19/2018,68,16:45,17:00,65.02,,0,65.02,65.02,1,-103207,65284,168491,-37923,0,0,18218,0,0,,18218,18218
25,06/19/2018,69,17:00,17:15,47.02,43.56,0,43.56,43.56,-1,-74800,85958,160758,11158,0,-24,10834,0,0,,10858,10810
25,06/19/2018,70,17:15,17:30,48.33,43.57,0,48.33,42.96,2,-81165,63909,145074,-17256,0,-67,1931,0,0,,1998,1864
25,06/19/2018,71,17:30,17:45,52.33,,0,52.33,52.33,1,-91486,62782,154268,-28704,0,0,11581,0,0,,11581,11581
25,06/19/2018,72,17:45,18:00,44.02,44.23,0,44.23,44.23,-1,-74386,89979,164365,15593,0,-11,7468,0,0,,7479,7457
25,06/19/2018,73,18:00,18:15,44.02,44.25,0,44.25,44.25,-1,-72093,53544,125637,-18549,0,-19,26,0,0,,45,7
25,06/19/2018,74,18:15,18:30,,,0,42.94,42.94,0,-64828,74207,139035,9379,0,0,0,0,0,,0,0
25,06/19/2018,75,18:30,18:45,,,0,42.96,42.96,0,-66945,109337,176282,42392,0,0,0,0,0,,0,0
25,06/19/2018,76,18:45,19:00,,,0,42.96,42.96,0,-59294,107804,167098,48510,0,0,0,0,0,,0,0
25,06/19/2018,77,19:00,19:15,48.33,,0,48.33,48.33,1,-65190,58066,123256,-7124,0,0,2137,0,0,,2137,2137
25,06/19/2018,78,19:15,19:30,46.79,,0,46.79,46.79,1,-74365,60527,134892,-13838,0,0,6658,0,0,,6658,6658
25,06/19/2018,79,19:30,19:45,46.37,,0,46.37,46.37,1,-68823,55597,124420,-13226,0,0,7929,0,0,,7929,7929
25,06/19/2018,80,19:45,20:00,46.16,,0,46.16,46.16,1,-63137,52797,115934,-10340,0,0,5723,0,0,,5723,5723
25,06/19/2018,81,20:00,20:15,62.79,,0,62.79,62.79,1,-75842,34191,110033,-41651,0,0,10252,0,0,,10252,10252
25,06/19/2018,82,20:15,20:30,48.33,,0,48.33,48.33,1,-65939,33042,98981,-32897,0,0,16999,0,0,,16999,16999
25,06/19/2018,83,20:30,20:45,52.33,,0,52.33,52.33,1,-61866,35328,97194,-26538,0,0,14234,0,0,,14234,14234
25,06/19/2018,84,20:45,21:00,43.32,,0,43.32,43.32,1,-46012,42651,88663,-3361,0,0,6988,0,0,,6988,6988
25,06/19/2018,85,21:00,21:15,113.02,,0,113.02,113.02,1,-68538,23276,91814,-45262,0,0,11282,0,0,,11282,11282
25,06/19/2018,86,21:15,21:30,48.33,,0,48.33,48.33,1,-56419,34220,90639,-22199,0,0,16170,0,0,,16170,16170
25,06/19/2018,87,21:30,21:45,48.33,43.46,0,43.46,43.46,-1,-44760,54839,99599,10079,0,-690,1141,0,0,,1831,451
25,06/19/2018,88,21:45,22:00,,43.46,0,43.46,43.46,-1,-39113,57588,96701,18475,0,-804,0,0,0,,804,-804
25,06/19/2018,89,22:00,22:15,,44.24,0,44.24,44.24,-1,-45311,23037,68348,-22274,0,-261,0,0,0,,261,-261
25,06/19/2018,90,22:15,22:30,53.64,,0,53.64,53.64,1,-71848,21880,93728,-49968,0,0,3525,0,0,,3525,3525
25,06/19/2018,91,22:30,22:45,52.33,,0,52.33,52.33,1,-67747,26048,93795,-41699,0,0,15683,0,0,,15683,15683
25,06/19/2018,92,22:45,23:00,43.32,40.15,0,40.15,40.15,-1,-50883,59117,110000,8234,0,-546,9539,0,0,,10085,8993
25,06/19/2018,93,23:00,23:15,196.55,40.15,0,196.55,196.55,1,-88555,38687,127242,-49868,0,-155,17042,0,0,,17197,16887
25,06/19/2018,94,23:15,23:30,50.89,37.49,0,37.49,37.49,-1,-34103,45162,79265,11059,0,-203,15084,0,0,,15287,14881
25,06/19/2018,95,23:30,23:45,50.89,36.34,0,36.34,36.34,-1,-30475,75630,106105,45155,0,-584,258,0,0,,842,-326
25,06/19/2018,96,23:45,0:00,,16.78,0,16.78,16.78,-1,-51003,104211,155214,53208,0,-25340,0,0,0,,25340,-25340
25,06/20/2018,1,0:00,0:15,46.9,-150.78,0,46.9,-150.78,2,-61148,125016,186164,63868,0,-38956,112,0,0,,39068,-38844
25,06/20/2018,2,0:15,0:30,64.06,-150.78,0,64.06,64.06,1,-80715,56409,137124,-24306,0,-1024,12506,0,0,,13530,11482
25,06/20/2018,3,0:30,0:45,64.06,38.9,0,38.9,38.9,-1,-96291,98084,194375,1793,0,-861,665,0,0,,1526,-196
25,06/20/2018,4,0:45,1:00,,38.9,0,38.9,38.9,-1,-128805,132650,261455,3845,0,-1032,0,0,0,,1032,-1032
25,06/20/2018,5,1:00,1:15,,-150.78,0,-150.78,-150.78,-1,-36574,77836,114410,41262,0,-24243,0,0,0,,24243,-24243
25,06/20/2018,6,1:15,1:30,43.69,38.9,0,43.69,25.89,2,-68311,70565,138876,2254,0,-3473,378,0,0,,3851,-3095
25,06/20/2018,7,1:30,1:45,,13.78,0,13.78,13.78,-1,-79317,124502,203819,45185,0,-13293,0,0,0,,13293,-13293
25,06/20/2018,8,1:45,2:00,,-150.78,0,-150.78,-150.78,-1,-60731,141790,202521,81059,0,-82256,0,0,0,,82256,-82256
25,06/20/2018,9,2:00,2:15,,31.33,0,31.33,31.33,-1,-47967,83066,131033,35099,0,-47638,0,0,0,,47638,-47638
25,06/20/2018,10,2:15,2:30,,16.78,0,16.78,16.78,-1,-31634,91323,122957,59689,0,-32115,0,0,0,,32115,-32115
25,06/20/2018,11,2:30,2:45,,28.89,0,28.89,28.89,-1,-25710,88600,114310,62890,0,-53559,0,0,0,,53559,-53559
25,06/20/2018,12,2:45,3:00,,24.59,0,24.59,24.59,-1,-31709,104293,136002,72584,0,-55027,0,0,0,,55027,-55027
25,06/20/2018,13,3:00,3:15,,33.78,0,33.78,33.78,-1,-53720,72225,125945,18505,0,-37717,0,0,0,,37717,-37717
25,06/20/2018,14,3:15,3:30,,31.32,0,31.32,31.32,-1,-48931,87463,136394,38532,0,-24946,0,0,0,,24946,-24946
25,06/20/2018,15,3:30,3:45,,19.17,0,19.17,19.17,-1,-45865,107179,153044,61314,0,-51288,0,0,0,,51288,-51288
25,06/20/2018,16,3:45,4:00,,18.38,0,18.38,18.38,-1,-42998,113765,156763,70767,0,-66303,0,0,0,,66303,-66303
25,06/20/2018,17,4:00,4:15,,27.64,0,27.64,27.64,-1,-44088,84442,128530,40354,0,-60391,0,0,0,,60391,-60391
25,06/20/2018,18,4:15,4:30,,23.78,0,23.78,23.78,-1,-47786,96485,144271,48699,0,-42971,0,0,0,,42971,-42971
25,06/20/2018,19,4:30,4:45,,18.23,0,18.23,18.23,-1,-45544,107315,152859,61771,0,-63635,0,0,0,,63635,-63635
25,06/20/2018,20,4:45,5:00,,23.78,0,23.78,23.78,-1,-48952,114193,163145,65241,0,-69251,0,0,0,,69251,-69251
25,06/20/2018,21,5:00,5:15,,34.9,0,34.9,34.9,-1,-55767,91512,147279,35745,0,-31029,0,0,0,,31029,-31029
25,06/20/2018,22,5:15,5:30,,37.88,0,37.88,37.88,-1,-60240,97218,157458,36978,0,-6025,0,0,0,,6025,-6025
25,06/20/2018,23,5:30,5:45,,37.87,0,37.87,37.87,-1,-57004,83143,140147,26139,0,-10021,0,0,0,,10021,-10021
25,06/20/2018,24,5:45,6:00,36.01,37.87,0,36.01,36.01,1,-62141,81973,144114,19832,0,-606,15,0,0,,621,-591
25,06/20/2018,25,6:00,6:15,36.01,34.94,0,34.94,34.94,-1,-68885,81919,150804,13034,0,-7498,1,0,0,,7499,-7497
25,06/20/2018,26,6:15,6:30,,38.94,0,38.94,38.94,-1,-46051,54806,100857,8755,0,-13232,0,0,0,,13232,-13232
25,06/20/2018,27,6:30,6:45,42.55,44.5,0,42.55,42.55,1,-51171,40810,91981,-10361,0,-3624,10,0,0,,3634,-3614
25,06/20/2018,28,6:45,7:00,66.2,,0,66.2,66.2,1,-80461,42136,122597,-38325,0,0,15418,0,0,,15418,15418
25,06/20/2018,29,7:00,7:15,66.2,30.94,0,30.94,30.94,-1,-25816,112320,138136,86504,0,-7210,5148,0,0,,12358,-2062
25,06/20/2018,30,7:15,7:30,,44.8,0,44.8,44.8,-1,-22982,65567,88549,42585,0,-473,0,0,0,,473,-473
25,06/20/2018,31,7:30,7:45,,,0,43.82,43.82,0,-29411,39630,69041,10219,0,0,0,0,0,,0,0
25,06/20/2018,32,7:45,8:00,66.12,,0,66.12,66.12,1,-70736,42635,113371,-28101,0,0,12648,0,0,,12648,12648
25,06/20/2018,33,8:00,8:15,46.94,,0,46.94,46.94,1,-72539,52327,124866,-20212,0,0,10108,0,0,,10108,10108
25,06/20/2018,34,8:15,8:30,43.42,,0,43.42,43.42,1,-55823,36130,91953,-19693,0,0,1753,0,0,,1753,1753
25,06/20/2018,35,8:30,8:45,61.59,,0,61.59,61.59,1,-59003,23569,82572,-35434,0,0,16140,0,0,,16140,16140
25,06/20/2018,36,8:45,9:00,150.77,,0,150.77,150.77,1,-84760,10160,94920,-74600,0,0,41750,0,0,,41750,41750
25,06/20/2018,37,9:00,9:15,145.12,,0,145.12,145.12,1,-99070,27280,126350,-71790,0,0,61072,0,0,,61072,61072
25,06/20/2018,38,9:15,9:30,62.22,,0,62.22,62.22,1,-86661,33944,120605,-52717,0,0,51797,0,0,,51797,51797
25,06/20/2018,39,9:30,9:45,58.82,,0,58.82,58.82,1,-80936,32527,113463,-48409,0,0,46229,0,0,,46229,46229
25,06/20/2018,40,9:45,10:00,69.12,,0,69.12,69.12,1,-89874,35642,125516,-54232,0,0,48667,0,0,,48667,48667
25,06/20/2018,41,10:00,10:15,243.83,,0,243.83,243.83,1,-127578,14488,142066,-113090,0,0,70784,0,0,,70784,70784
25,06/20/2018,42,10:15,10:30,243.83,,0,268.21,268.21,1,-168468,29681,198149,-138787,0,0,94866,0,0,,94866,94866
25,06/20/2018,43,10:30,10:45,243.83,,0,268.21,268.21,1,-277103,21316,298419,-255787,0,0,97401,2500,63448,,163349,163349
25,06/20/2018,44,10:45,11:00,265.77,,0,292.35,292.35,1,-234461,29418,263879,-205043,0,0,97021,2500,106585,,206106,206106
25,06/20/2018,45,11:00,11:15,99.12,-94.46,0,-94.46,-94.46,-1,-240587,28817,269404,-211770,0,-1500,42220,0,111855,,155575,152575
25,06/20/2018,46,11:15,11:30,207.58,44.74,0,257.58,43.79,2,-225090,17552,242642,-207538,0,-9,9036,2500,93486,,105031,105013
25,06/20/2018,47,11:30,11:45,207.58,,0,257.58,257.58,1,-209644,43848,253492,-165796,0,0,20671,2500,59131,,82302,82302
25,06/20/2018,48,11:45,12:00,207.58,,0,257.58,257.58,1,-190765,57371,248136,-133394,0,0,4327,2500,37936,,44763,44763
25,06/20/2018,49,12:00,12:15,248.46,,0,248.46,248.46,1,-199696,39645,239341,-160051,0,0,42281,0,0,,42281,42281
25,06/20/2018,50,12:15,12:30,248.46,,0,248.46,248.46,1,-183618,53748,237366,-129870,0,0,85109,2500,0,,87609,87609
25,06/20/2018,51,12:30,12:45,248.46,,0,248.46,248.46,1,-139624,70941,210565,-68683,0,0,91008,2500,0,,93508,93508
25,06/20/2018,52,12:45,13:00,207.58,,0,207.58,207.58,1,-114657,69632,184289,-45025,0,0,32010,2500,0,,34510,34510
25,06/20/2018,53,13:00,13:15,61.59,,0,61.59,61.59,1,-70626,58938,129564,-11688,0,0,21936,0,0,,21936,21936
25,06/20/2018,54,13:15,13:30,105.96,,0,105.96,105.96,1,-91110,49180,140290,-41930,0,0,19085,0,0,,19085,19085
25,06/20/2018,55,13:30,13:45,54.67,,0,54.67,54.67,1,-84034,55259,139293,-28775,0,0,31970,0,0,,31970,31970
25,06/20/2018,56,13:45,14:00,46.94,,0,46.94,46.94,1,-77987,66647,144634,-11340,0,0,17704,0,0,,17704,17704
25,06/20/2018,57,14:00,14:15,57.12,44.63,0,57.12,39.99,2,-72434,48816,121250,-23618,0,-34,7181,0,0,,7215,7147
25,06/20/2018,58,14:15,14:30,69.12,,0,69.12,69.12,1,-92703,65997,158700,-26706,0,0,31470,0,0,,31470,31470
25,06/20/2018,59,14:30,14:45,44.16,41.78,0,41.78,41.78,-1,-74887,77678,152565,2791,0,-411,10750,0,0,,11161,10339
25,06/20/2018,60,14:45,15:00,44.8,41.78,0,44.8,44.8,1,-69255,62150,131405,-7105,0,-22,678,0,0,,700,656
25,06/20/2018,61,15:00,15:15,42.84,,0,42.84,42.84,1,-79423,87500,166923,8077,0,0,414,0,0,,414,414
25,06/20/2018,62,15:15,15:30,50.47,,0,50.47,50.47,1,-94495,84118,178613,-10377,0,0,3656,0,0,,3656,3656
25,06/20/2018,63,15:30,15:45,56.59,,0,56.59,56.59,1,-101274,71325,172599,-29949,0,0,15836,0,0,,15836,15836
25,06/20/2018,64,15:45,16:00,94.12,,0,94.12,94.12,1,-96717,51306,148023,-45411,0,0,41183,0,0,,41183,41183
25,06/20/2018,65,16:00,16:15,42.84,-41.25,0,42.84,-41.25,2,-27172,134762,161934,107590,0,-14363,13521,0,0,,27884,-842
25,06/20/2018,66,16:15,16:30,,38.94,0,38.94,38.94,-1,-29638,86847,116485,57209,0,-3814,0,0,0,,3814,-3814
25,06/20/2018,67,16:30,16:45,,44.57,0,44.57,44.57,-1,-56556,87710,144266,31154,0,-587,0,0,0,,587,-587
25,06/20/2018,68,16:45,17:00,61.59,,0,61.59,61.59,1,-107028,70003,177031,-37025,0,0,5283,0,0,,5283,5283
25,06/20/2018,69,17:00,17:15,68.2,,0,68.2,68.2,1,-98561,50676,149237,-47885,0,0,30382,0,0,,30382,30382
25,06/20/2018,70,17:15,17:30,54.23,,0,54.23,54.23,1,-95604,56045,151649,-39559,0,0,32257,0,0,,32257,32257
25,06/20/2018,71,17:30,17:45,50.94,,0,50.94,50.94,1,-95491,64420,159911,-31071,0,0,31488,0,0,,31488,31488
25,06/20/2018,72,17:45,18:00,52.59,,0,52.59,52.59,1,-106412,71409,177821,-35003,0,0,27977,0,0,,27977,27977
25,06/20/2018,73,18:00,18:15,50.12,,0,50.12,50.12,1,-104099,35962,140061,-68137,0,0,18946,0,0,,18946,18946
25,06/20/2018,74,18:15,18:30,,,0,43.71,43.71,0,-90497,53090,143587,-37407,0,0,824,0,0,,824,824
25,06/20/2018,75,18:30,18:45,,,0,43.7,43.7,0,-96756,72083,168839,-24673,0,0,0,0,0,,0,0
25,06/20/2018,76,18:45,19:00,43.15,,0,43.15,43.15,1,-109765,71055,180820,-38710,0,0,96,0,0,,96,96
25,06/20/2018,77,19:00,19:15,98.56,,0,98.56,98.56,1,-143634,83645,227279,-59989,0,0,13925,0,0,,13925,13925
25,06/20/2018,78,19:15,19:30,99.12,,0,99.12,99.12,1,-118324,72978,191302,-45346,0,0,36336,0,0,,36336,36336
25,06/20/2018,79,19:30,19:45,82.12,,0,82.12,82.12,1,-133921,72734,206655,-61187,0,0,9691,0,0,,9691,9691
25,06/20/2018,80,19:45,20:00,254.34,,0,254.34,254.34,1,-182130,83829,265959,-98301,0,0,59054,0,0,,59054,59054
25,06/20/2018,81,20:00,20:15,45.12,-8.21,0,45.12,-8.21,2,-37020,80895,117915,43875,0,-9231,23679,0,0,,32910,14448
25,06/20/2018,82,20:15,20:30,50.94,40.77,0,50.94,27.44,2,-62671,45633,108304,-17038,0,-5609,4705,0,0,,10314,-904
25,06/20/2018,83,20:30,20:45,54.12,,0,54.12,54.12,1,-110424,80933,191357,-29491,0,0,18042,0,0,,18042,18042
25,06/20/2018,84,20:45,21:00,61.59,,0,61.59,61.59,1,-124618,74611,199229,-50007,0,0,39157,0,0,,39157,39157
25,06/20/2018,85,21:00,21:15,50.4,,0,50.4,50.4,1,-111890,85797,197687,-26093,0,0,30784,0,0,,30784,30784
25,06/20/2018,86,21:15,21:30,47.04,,0,47.04,47.04,1,-99654,81058,180712,-18596,0,0,20566,0,0,,20566,20566
25,06/20/2018,87,21:30,21:45,47.04,37.41,0,37.41,37.41,-1,-42753,59209,101962,16456,0,-9736,2491,0,0,,12227,-7245
25,06/20/2018,88,21:45,22:00,43.04,40.77,0,43.04,43.04,1,-94006,85943,179949,-8063,0,-11122,164,0,0,,11286,-10958
25,06/20/2018,89,22:00,22:15,79.04,40.77,0,79.04,79.04,1,-77284,26706,103990,-50578,0,-110,4607,0,0,,4717,4497
25,06/20/2018,90,22:15,22:30,242.31,,0,242.31,242.31,1,-107374,17418,124792,-89956,0,0,66449,0,0,,66449,66449
25,06/20/2018,91,22:30,22:45,154.12,,0,154.12,154.12,1,-70345,32105,102450,-38240,0,0,66601,0,0,,66601,66601
25,06/20/2018,92,22:45,23:00,154.12,31.34,0,31.34,31.34,-1,-30778,63851,94629,33073,0,-13596,7077,0,0,,20673,-6519
25,06/20/2018,93,23:00,23:15,211.81,34.94,0,211.81,211.81,1,-84088,30732,114820,-53356,0,-14955,11128,0,0,,26083,-3827
25,06/20/2018,94,23:15,23:30,230.87,34.94,0,230.87,230.87,1,-69043,39940,108983,-29103,0,-42,39398,0,0,,39440,39356
25,06/20/2018,95,23:30,23:45,42.84,41.73,0,42.84,27.46,2,-38405,63431,101836,25026,0,-735,8019,0,0,,8754,7284
25,06/20/2018,96,23:45,0:00,,38.94,0,38.94,38.94,-1,-50316,76121,126437,25805,0,-6997,0,0,0,,6997,-6997
25,06/21/2018,1,0:00,0:15,302.1,35.03,0,302.1,302.1,1,-144107,61846,205953,-82261,0,-2175,18264,0,0,,20439,16089
25,06/21/2018,2,0:15,0:30,302.1,,0,302.1,302.1,1,-126354,35846,162200,-90508,0,0,78904,0,0,,78904,78904
25,06/21/2018,3,0:30,0:45,42.94,,0,42.94,42.94,1,-92651,46880,139531,-45771,0,0,20937,0,0,,20937,20937
25,06/21/2018,4,0:45,1:00,302.1,,0,302.1,302.1,1,-130080,44448,174528,-85632,0,0,23061,0,0,,23061,23061
25,06/21/2018,5,1:00,1:15,42.94,40.46,0,42.94,38.12,2,-46285,131198,177483,84913,0,-173,5574,0,0,,5747,5401
25,06/21/2018,6,1:15,1:30,112.26,40.46,0,112.26,112.26,1,-72735,26681,99416,-46054,0,-4,15300,0,0,,15304,15296
25,06/21/2018,7,1:30,1:45,49.49,,0,49.49,49.49,1,-74980,41145,116125,-33835,0,0,27139,0,0,,27139,27139
25,06/21/2018,8,1:45,2:00,46.94,,0,46.94,46.94,1,-72002,40400,112402,-31602,0,0,26399,0,0,,26399,26399
25,06/21/2018,9,2:00,2:15,60.39,,0,60.39,60.39,1,-72860,58875,131735,-13985,0,0,12307,0,0,,12307,12307
25,06/21/2018,10,2:15,2:30,115.94,,0,115.94,115.94,1,-85944,45158,131102,-40786,0,0,39407,0,0,,39407,39407
25,06/21/2018,11,2:30,2:45,42.94,40.47,0,40.47,40.47,-1,-55817,56187,112004,370,0,-38,11956,0,0,,11994,11918
25,06/21/2018,12,2:45,3:00,42.94,39.83,0,39.83,39.83,-1,-55049,57067,112116,2018,0,-1011,13,0,0,,1024,-998
25,06/21/2018,13,3:00,3:15,50.94,,0,50.94,50.94,1,-69759,47310,117069,-22449,0,0,8201,0,0,,8201,8201
25,06/21/2018,14,3:15,3:30,43.31,,0,43.31,43.31,1,-59979,47139,107118,-12840,0,0,5148,0,0,,5148,5148
25,06/21/2018,15,3:30,3:45,46.94,,0,46.94,46.94,1,-72872,45703,118575,-27169,0,0,4627,0,0,,4627,4627
25,06/21/2018,16,3:45,4:00,65.16,38.49,0,65.16,38.21,2,-84240,41433,125673,-42807,0,-40,21354,0,0,,21394,21314
25,06/21/2018,17,4:00,4:15,108.27,25.21,0,108.27,25.21,2,-99430,46757,146187,-52673,0,-1429,15033,0,0,,16462,13604
25,06/21/2018,18,4:15,4:30,108.99,39.41,0,108.99,38.23,2,-80854,67755,148609,-13099,0,-15,31189,0,0,,31204,31174
25,06/21/2018,19,4:30,4:45,108.99,7.03,0,7.03,7.03,-1,-67397,95598,162995,28201,0,-18641,2600,0,0,,21241,-16041
25,06/21/2018,20,4:45,5:00,,28.35,0,28.35,28.35,-1,-74478,104875,179353,30397,0,-29411,0,0,0,,29411,-29411
25,06/21/2018,21,5:00,5:15,54.35,38.94,0,54.35,38.94,2,-97096,78809,175905,-18287,0,-8488,2980,0,0,,11468,-5508
25,06/21/2018,22,5:15,5:30,54.35,-12.03,0,-12.03,-12.03,-1,-59221,100414,159635,41193,0,-16751,203,0,0,,16954,-16548
25,06/21/2018,23,5:30,5:45,,-12.72,0,-12.72,-12.72,-1,-38629,97676,136305,59047,0,-47752,0,0,0,,47752,-47752
25,06/21/2018,24,5:45,6:00,,-150.03,0,-150.03,-150.03,-1,-30339,124312,154651,93973,0,-67571,0,0,0,,67571,-67571
25,06/21/2018,25,6:00,6:15,,23.02,0,23.02,23.02,-1,-80744,130077,210821,49333,0,-42521,0,0,0,,42521,-42521
25,06/21/2018,26,6:15,6:30,,35.97,0,35.97,35.97,-1,-74877,125258,200135,50381,0,-12885,0,0,0,,12885,-12885
25,06/21/2018,27,6:30,6:45,,37.86,0,37.86,37.86,-1,-80122,116856,196978,36734,0,-5454,0,0,0,,5454,-5454
25,06/21/2018,28,6:45,7:00,,,0,38.34,38.34,0,-94405,128602,223007,34197,0,-670,0,0,0,,670,-670
25,06/21/2018,29,7:00,7:15,,40.05,0,40.05,40.05,-1,-172707,177380,350087,4673,0,-300,0,0,0,,300,-300
25,06/21/2018,30,7:15,7:30,79.36,,0,79.36,79.36,1,-192436,136250,328686,-56186,0,0,4694,0,0,,4694,4694
25,06/21/2018,31,7:30,7:45,353.02,,0,353.02,353.02,1,-194018,126088,320106,-67930,0,0,57549,0,0,,57549,57549
25,06/21/2018,32,7:45,8:00,46.27,34.35,0,34.35,34.35,-1,-135976,208716,344692,72740,0,-1390,23140,0,0,,24530,21750
25,06/21/2018,33,8:00,8:15,,,0,42.88,42.88,0,-94673,161144,255817,66471,0,-142,0,0,0,,142,-142
25,06/21/2018,34,8:15,8:30,,,0,42.88,42.88,0,-95896,147517,243413,51621,0,0,0,0,0,,0,0
25,06/21/2018,35,8:30,8:45,,38.27,0,38.27,38.27,-1,-80507,144869,225376,64362,0,-741,0,0,0,,741,-741
25,06/21/2018,36,8:45,9:00,,4.91,0,4.91,4.91,-1,-57533,175973,233506,118440,0,-15618,0,0,0,,15618,-15618
25,06/21/2018,37,9:00,9:15,,34.53,0,34.53,34.53,-1,-60082,153987,214069,93905,0,-18410,0,0,0,,18410,-18410
25,06/21/2018,38,9:15,9:30,,17.03,0,17.03,17.03,-1,-30133,192326,222459,162193,0,-21162,0,0,0,,21162,-21162
25,06/21/2018,39,9:30,9:45,,-36.44,0,-36.44,-36.44,-1,-10790,168210,179000,157420,0,-51317,0,0,0,,51317,-51317
25,06/21/2018,40,9:45,10:00,,-36.44,0,-36.44,-36.44,-1,-11531,206991,218522,195460,0,-73038,0,0,0,,73038,-73038
25,06/21/2018,41,10:00,10:15,,33.48,0,33.48,33.48,-1,-33423,158863,192286,125440,0,-30578,0,0,0,,30578,-30578
25,06/21/2018,42,10:15,10:30,,-30.31,0,-30.31,-30.31,-1,-29490,183396,212886,153906,0,-51728,0,0,0,,51728,-51728
25,06/21/2018,43,10:30,10:45,,-30.31,0,-30.31,-30.31,-1,-28049,185002,213051,156953,0,-69983,0,0,0,,69983,-69983
25,06/21/2018,44,10:45,11:00,,-150.03,0,-150.03,-150.03,-1,-25637,248149,273786,222512,0,-62125,0,0,0,,62125,-62125
25,06/21/2018,45,11:00,11:15,42.94,34.27,0,42.94,42.94,1,-103553,110492,214045,6939,0,-27428,400,0,0,,27828,-27028
25,06/21/2018,46,11:15,11:30,42.94,39.39,0,39.39,39.39,-1,-77739,139347,217086,61608,0,-295,25,0,0,,320,-270
25,06/21/2018,47,11:30,11:45,,,0,43.18,43.18,0,-68805,167980,236785,99175,0,-215,0,0,0,,215,-215
25,06/21/2018,48,11:45,12:00,,,0,43.2,43.2,0,-63605,174799,238404,111194,0,0,0,0,0,,0,0
25,06/21/2018,49,12:00,12:15,,30.27,0,30.27,30.27,-1,-73702,121732,195434,48030,0,-9639,0,0,0,,9639,-9639
25,06/21/2018,50,12:15,12:30,,28.9,0,28.9,28.9,-1,-61090,116505,177595,55415,0,-10607,0,0,0,,10607,-10607
25,06/21/2018,51,12:30,12:45,,11.33,0,11.33,11.33,-1,-53897,135645,189542,81748,0,-49733,0,0,0,,49733,-49733
25,06/21/2018,52,12:45,13:00,,27.9,0,27.9,27.9,-1,-63208,122723,185931,59515,0,-28696,0,0,0,,28696,-28696
25,06/21/2018,53,13:00,13:15,,21.26,0,21.26,21.26,-1,-59454,117563,177017,58109,0,-16215,0,0,0,,16215,-16215
25,06/21/2018,54,13:15,13:30,,,0,41.78,41.78,0,-56264,102815,159079,46551,0,-355,0,0,0,,355,-355
25,06/21/2018,55,13:30,13:45,,,0,38.69,38.69,0,-60602,97321,157923,36719,0,0,0,0,0,,0,0
25,06/21/2018,56,13:45,14:00,,,0,38.69,38.69,0,-70007,91522,161529,21515,0,0,0,0,0,,0,0
25,06/21/2018,57,14:00,14:15,46.27,,0,46.27,46.27,1,-82083,77021,159104,-5062,0,0,1269,0,0,,1269,1269
25,06/21/2018,58,14:15,14:30,53.33,,0,53.33,53.33,1,-92789,62030,154819,-30759,0,0,18783,0,0,,18783,18783
25,06/21/2018,59,14:30,14:45,46.27,,0,46.27,46.27,1,-82224,67310,149534,-14914,0,0,16157,0,0,,16157,16157
25,06/21/2018,60,14:45,15:00,53.03,,0,53.03,53.03,1,-95584,63869,159453,-31715,0,0,21337,0,0,,21337,21337
25,06/21/2018,61,15:00,15:15,46.02,39.05,0,39.05,39.05,-1,-64728,65284,130012,556,0,-230,12576,0,0,,12806,12346
25,06/21/2018,62,15:15,15:30,46.02,38.27,0,38.27,38.27,-1,-56895,68707,125602,11812,0,-1172,43,0,0,,1215,-1129
25,06/21/2018,63,15:30,15:45,46.27,,0,46.27,46.27,1,-79095,55614,134709,-23481,0,0,5071,0,0,,5071,5071
25,06/21/2018,64,15:45,16:00,42.26,24.15,0,24.15,24.15,-1,-74224,81103,155327,6879,0,-2467,2746,0,0,,5213,279
25,06/21/2018,65,16:00,16:15,,1.6,0,1.6,1.6,-1,-27628,99405,127033,71777,0,-40783,0,0,0,,40783,-40783
25,06/21/2018,66,16:15,16:30,,34.27,0,34.27,34.27,-1,-31525,111082,142607,79557,0,-31013,0,0,0,,31013,-31013
25,06/21/2018,67,16:30,16:45,,30.27,0,30.27,30.27,-1,-27809,125486,153295,97677,0,-25556,0,0,0,,25556,-25556
25,06/21/2018,68,16:45,17:00,,16.34,0,16.34,16.34,-1,-48924,121863,170787,72939,0,-24204,0,0,0,,24204,-24204
25,06/21/2018,69,17:00,17:15,,-1.96,0,-1.96,-1.96,-1,-33452,111077,144529,77625,0,-34826,0,0,0,,34826,-34826
25,06/21/2018,70,17:15,17:30,,38.27,0,38.27,38.27,-1,-45564,96725,142289,51161,0,-8807,0,0,0,,8807,-8807
25,06/21/2018,71,17:30,17:45,,7.25,0,7.25,7.25,-1,-40864,114940,155804,74076,0,-14184,0,0,0,,14184,-14184
25,06/21/2018,72,17:45,18:00,,35.98,0,35.98,35.98,-1,-53452,117432,170884,63980,0,-18015,0,0,0,,18015,-18015
25,06/21/2018,73,18:00,18:15,,17.03,0,17.03,17.03,-1,-44439,86853,131292,42414,0,-31838,0,0,0,,31838,-31838
25,06/21/2018,74,18:15,18:30,,13.78,0,13.78,13.78,-1,-43325,95374,138699,52049,0,-50695,0,0,0,,50695,-50695
25,06/21/2018,75,18:30,18:45,,38.27,0,38.27,38.27,-1,-41030,98931,139961,57901,0,-19561,0,0,0,,19561,-19561
25,06/21/2018,76,18:45,19:00,,30.27,0,30.27,30.27,-1,-47610,97506,145116,49896,0,-5266,0,0,0,,5266,-5266
25,06/21/2018,77,19:00,19:15,,36.85,0,36.85,36.85,-1,-58372,92222,150594,33850,0,-2618,0,0,0,,2618,-2618
25,06/21/2018,78,19:15,19:30,,26.2,0,26.2,26.2,-1,-59323,92428,151751,33105,0,-24101,0,0,0,,24101,-24101
25,06/21/2018,79,19:30,19:45,,13.79,0,13.79,13.79,-1,-43626,104790,148416,61164,0,-42656,0,0,0,,42656,-42656
25,06/21/2018,80,19:45,20:00,,31.8,0,31.8,31.8,-1,-56253,85273,141526,29020,0,-39074,0,0,0,,39074,-39074
25,06/21/2018,81,20:00,20:15,,32.94,0,32.94,32.94,-1,-31095,77745,108840,46650,0,-26346,0,0,0,,26346,-26346
25,06/21/2018,82,20:15,20:30,,38.27,0,38.27,38.27,-1,-33481,57886,91367,24405,0,-2063,0,0,0,,2063,-2063
25,06/21/2018,83,20:30,20:45,,26.47,0,26.47,26.47,-1,-27385,66999,94384,39614,0,-19585,0,0,0,,19585,-19585
25,06/21/2018,84,20:45,21:00,148.02,34.27,0,148.02,34.27,2,-96087,69170,165257,-26917,0,-21714,5642,0,0,,27356,-16072
25,06/21/2018,85,21:00,21:15,143.02,34.27,0,143.02,143.02,1,-102483,83375,185858,-19108,0,-314,17498,0,0,,17812,17184
25,06/21/2018,86,21:15,21:30,43.02,,0,43.02,43.02,1,-104363,103600,207963,-763,0,0,6596,0,0,,6596,6596
25,06/21/2018,87,21:30,21:45,,,0,38.68,38.68,0,-93651,103553,197204,9902,0,0,42,0,0,,42,42
25,06/21/2018,88,21:45,22:00,42.26,,0,42.26,42.26,1,-103616,95690,199306,-7926,0,0,1427,0,0,,1427,1427
25,06/21/2018,89,22:00,22:15,60.88,,0,60.88,60.88,1,-108301,79146,187447,-29155,0,0,15040,0,0,,15040,15040
25,06/21/2018,90,22:15,22:30,55.77,,0,55.77,55.77,1,-111382,72251,183633,-39131,0,0,28410,0,0,,28410,28410
25,06/21/2018,91,22:30,22:45,58.93,,0,58.93,58.93,1,-111372,69355,180727,-42017,0,0,35996,0,0,,35996,35996
25,06/21/2018,92,22:45,23:00,48.6,31.02,0,31.02,31.02,-1,-88320,106031,194351,17711,0,-1733,19673,0,0,,21406,17940
25,06/21/2018,93,23:00,23:15,227.62,31.02,0,227.62,227.62,1,-120789,38108,158897,-82681,0,-494,30154,0,0,,30648,29660
25,06/21/2018,94,23:15,23:30,227.62,,0,227.62,227.62,1,-111662,69254,180916,-42408,0,0,70486,0,0,,70486,70486
25,06/21/2018,95,23:30,23:45,41.87,17.74,0,42.54,17.74,2,-94926,115327,210253,20401,0,-5614,17178,0,0,,22792,11564
25,06/21/2018,96,23:45,0:00,,7.35,0,7.35,7.35,-1,-68483,128796,197279,60313,0,-22596,0,0,0,,22596,-22596
25,06/22/2018,1,0:00,0:15,,-149.43,0,-149.43,-149.43,-1,-24269,83345,107614,59076,0,-33308,0,0,0,,33308,-33308
25,06/22/2018,2,0:15,0:30,,-150.78,0,-150.78,-150.78,-1,-10761,74562,85323,63801,0,-15504,0,0,0,,15504,-15504
25,06/22/2018,3,0:30,0:45,,-150.78,0,-150.78,-150.78,-1,-26316,84061,110377,57745,0,-62337,0,0,0,,62337,-62337
25,06/22/2018,4,0:45,1:00,,-38.51,0,-38.51,-38.51,-1,-51368,131273,182641,79905,0,-61841,0,0,0,,61841,-61841
25,06/22/2018,5,1:00,1:15,,30.27,0,30.27,30.27,-1,-72467,90277,162744,17810,0,-32135,0,0,0,,32135,-32135
25,06/22/2018,6,1:15,1:30,,34.27,0,34.27,34.27,-1,-45649,68327,113976,22678,0,-541,0,0,0,,541,-541
25,06/22/2018,7,1:30,1:45,,33.09,0,33.09,33.09,-1,-57140,92586,149726,35446,0,-1710,0,0,0,,1710,-1710
25,06/22/2018,8,1:45,2:00,,34.27,0,34.27,34.27,-1,-72694,119698,192392,47004,0,-5356,0,0,0,,5356,-5356
25,06/22/2018,9,2:00,2:15,,40,0,40,40,-1,-43294,66005,109299,22711,0,-1944,0,0,0,,1944,-1944
25,06/22/2018,10,2:15,2:30,,36.66,0,36.66,36.66,-1,-18992,62999,81991,44007,0,-2413,0,0,0,,2413,-2413
25,06/22/2018,11,2:30,2:45,,34.27,0,34.27,34.27,-1,-32211,52922,85133,20711,0,-3683,0,0,0,,3683,-3683
25,06/22/2018,12,2:45,3:00,,38.27,0,38.27,38.27,-1,-38789,55976,94765,17187,0,-932,0,0,0,,932,-932
25,06/22/2018,13,3:00,3:15,43.05,38.59,0,43.05,38.41,2,-47683,37734,85417,-9949,0,-844,983,0,0,,1827,139
25,06/22/2018,14,3:15,3:30,42.27,,0,42.27,42.27,1,-26996,38659,65655,11663,0,0,1594,0,0,,1594,1594
25,06/22/2018,15,3:30,3:45,42.27,,0,42.27,42.27,1,-40766,41671,82437,905,0,0,1490,0,0,,1490,1490
25,06/22/2018,16,3:45,4:00,42.89,,0,42.89,42.89,1,-32170,42008,74178,9838,0,0,965,0,0,,965,965
25,06/22/2018,17,4:00,4:15,43.16,,0,43.16,43.16,1,-43804,36299,80103,-7505,0,0,445,0,0,,445,445
25,06/22/2018,18,4:15,4:30,42.27,,0,42.27,42.27,1,-39104,41600,80704,2496,0,0,387,0,0,,387,387
25,06/22/2018,19,4:30,4:45,36.61,,0,36.61,36.61,1,-29328,44295,73623,14967,0,0,250,0,0,,250,250
25,06/22/2018,20,4:45,5:00,36.66,,0,36.66,36.66,1,-29395,50995,80390,21600,0,0,368,0,0,,368,368
25,06/22/2018,21,5:00,5:15,36.74,,0,36.74,36.74,1,-19989,74799,94788,54810,0,0,19,0,0,,19,19
25,06/22/2018,22,5:15,5:30,,37.47,0,37.47,37.47,-1,-19965,93695,113660,73730,0,-1143,0,0,0,,1143,-1143
25,06/22/2018,23,5:30,5:45,,36.78,0,36.78,36.78,-1,-19951,74297,94248,54346,0,-2125,0,0,0,,2125,-2125
25,06/22/2018,24,5:45,6:00,,-14.71,0,-14.71,-14.71,-1,-10829,57170,67999,46341,0,-13380,0,0,0,,13380,-13380
25,06/22/2018,25,6:00,6:15,,-150.78,0,-150.78,-150.78,-1,-21490,113687,135177,92197,0,-58722,0,0,0,,58722,-58722
25,06/22/2018,26,6:15,6:30,,34.04,0,34.04,34.04,-1,-21683,109396,131079,87713,0,-25927,0,0,0,,25927,-25927
25,06/22/2018,27,6:30,6:45,,35.51,0,35.51,35.51,-1,-23055,95171,118226,72116,0,-24241,0,0,0,,24241,-24241
25,06/22/2018,28,6:45,7:00,,40.12,0,40.12,40.12,-1,-36180,79339,115519,43159,0,-8491,0,0,0,,8491,-8491
25,06/22/2018,29,7:00,7:15,,-150.78,0,-150.78,-150.78,-1,-29386,151926,181312,122540,0,-31564,0,0,0,,31564,-31564
25,06/22/2018,30,7:15,7:30,,-150.78,0,-150.78,-150.78,-1,-24624,108486,133110,83862,0,-59363,0,0,0,,59363,-59363
25,06/22/2018,31,7:30,7:45,,-6.75,0,-6.75,-6.75,-1,-34080,104426,138506,70346,0,-57913,0,0,0,,57913,-57913
25,06/22/2018,32,7:45,8:00,,8.55,0,8.55,8.55,-1,-47978,121407,169385,73429,0,-35879,0,0,0,,35879,-35879
25,06/22/2018,33,8:00,8:15,,4.63,0,4.63,4.63,-1,-53303,117487,170790,64184,0,-53231,0,0,0,,53231,-53231
25,06/22/2018,34,8:15,8:30,,34.09,0,34.09,34.09,-1,-49305,91142,140447,41837,0,-39360,0,0,0,,39360,-39360
25,06/22/2018,35,8:30,8:45,,38.04,0,38.04,38.04,-1,-52702,60193,112895,7491,0,-23300,0,0,0,,23300,-23300
25,06/22/2018,36,8:45,9:00,43.07,38.04,0,43.07,43.07,1,-58638,41284,99922,-17354,0,-1329,868,0,0,,2197,-461
25,06/22/2018,37,9:00,9:15,,,0,43.01,43.01,0,-44928,84303,129231,39375,0,0,4,0,0,,4,4
25,06/22/2018,38,9:15,9:30,,,0,42.98,42.98,0,-52569,77677,130246,25108,0,0,0,0,0,,0,0
25,06/22/2018,39,9:30,9:45,,34.52,0,34.52,34.52,-1,-54758,75642,130400,20884,0,-5284,0,0,0,,5284,-5284
25,06/22/2018,40,9:45,10:00,,34.04,0,34.04,34.04,-1,-46749,68045,114794,21296,0,-20111,0,0,0,,20111,-20111
25,06/22/2018,41,10:00,10:15,,34.04,0,34.04,34.04,-1,-27166,116915,144081,89749,0,-15019,0,0,0,,15019,-15019
25,06/22/2018,42,10:15,10:30,,39.78,0,39.78,39.78,-1,-31253,114326,145579,83073,0,-5834,0,0,0,,5834,-5834
25,06/22/2018,43,10:30,10:45,,-7.21,0,-7.21,-7.21,-1,-25491,98904,124395,73413,0,-8796,0,0,0,,8796,-8796
25,06/22/2018,44,10:45,11:00,37.12,-31.87,0,39.24,-31.87,2,-50575,63112,113687,12537,0,-30930,57,0,0,,30987,-30873
25,06/22/2018,45,11:00,11:15,,34.04,0,34.04,34.04,-1,-49105,81009,130114,31904,0,-11682,0,0,0,,11682,-11682
25,06/22/2018,46,11:15,11:30,,22.93,0,22.93,22.93,-1,-40512,88040,128552,47528,0,-25141,0,0,0,,25141,-25141
25,06/22/2018,47,11:30,11:45,,19.11,0,19.11,19.11,-1,-51800,84688,136488,32888,0,-38986,0,0,0,,38986,-38986
25,06/22/2018,48,11:45,12:00,,38.04,0,38.04,38.04,-1,-62185,97576,159761,35391,0,-13787,0,0,0,,13787,-13787
25,06/22/2018,49,12:00,12:15,46.04,40.34,0,46.04,40.34,2,-85664,74359,160023,-11305,0,-4317,2064,0,0,,6381,-2253
25,06/22/2018,50,12:15,12:30,,39.32,0,39.32,39.32,-1,-66061,80020,146081,13959,0,-936,0,0,0,,936,-936
25,06/22/2018,51,12:30,12:45,,40.52,0,40.52,40.52,-1,-74880,94768,169648,19888,0,-1570,0,0,0,,1570,-1570
25,06/22/2018,52,12:45,13:00,,31.34,0,31.34,31.34,-1,-68915,113107,182022,44192,0,-9154,0,0,0,,9154,-9154
25,06/22/2018,53,13:00,13:15,,30.04,0,30.04,30.04,-1,-63078,107197,170275,44119,0,-14382,0,0,0,,14382,-14382
25,06/22/2018,54,13:15,13:30,,40.52,0,40.52,40.52,-1,-52233,96976,149209,44743,0,-293,0,0,0,,293,-293
25,06/22/2018,55,13:30,13:45,,39.98,0,39.98,39.98,-1,-49982,96258,146240,46276,0,-241,0,0,0,,241,-241
25,06/22/2018,56,13:45,14:00,,,0,40.32,40.32,0,-70382,81978,152360,11596,0,0,0,0,0,,0,0
25,06/22/2018,57,14:00,14:15,,,0,40.18,40.18,0,-49159,78978,128137,29819,0,0,0,0,0,,0,0
25,06/22/2018,58,14:15,14:30,,,0,40.18,40.18,0,-48275,59661,107936,11386,0,0,0,0,0,,0,0
25,06/22/2018,59,14:30,14:45,,,0,40.18,40.18,0,-43884,70064,113948,26180,0,0,0,0,0,,0,0
25,06/22/2018,60,14:45,15:00,,40.52,0,40.52,40.52,-1,-46033,62160,108193,16127,0,-830,0,0,0,,830,-830
25,06/22/2018,61,15:00,15:15,,40.78,0,40.78,40.78,-1,-66116,65611,131727,-505,0,-479,0,0,0,,479,-479
25,06/22/2018,62,15:15,15:30,45.61,,0,45.61,45.61,1,-75358,66604,141962,-8754,0,0,1631,0,0,,1631,1631
25,06/22/2018,63,15:30,15:45,41.96,39.81,0,41.96,39.81,2,-68436,72320,140756,3884,0,-279,328,0,0,,607,49
25,06/22/2018,64,15:45,16:00,,36.45,0,36.45,36.45,-1,-48892,79112,128004,30220,0,-7575,0,0,0,,7575,-7575
25,06/22/2018,65,16:00,16:15,,34.03,0,34.03,34.03,-1,-45677,79170,124847,33493,0,-31317,0,0,0,,31317,-31317
25,06/22/2018,66,16:15,16:30,,38.22,0,38.22,38.22,-1,-52909,71297,124206,18388,0,-23490,0,0,0,,23490,-23490
25,06/22/2018,67,16:30,16:45,,38.78,0,38.78,38.78,-1,-60318,74423,134741,14105,0,-11877,0,0,0,,11877,-11877
25,06/22/2018,68,16:45,17:00,50.04,38.78,0,50.04,50.04,1,-74356,63870,138226,-10486,0,-1779,1608,0,0,,3387,-171
25,06/22/2018,69,17:00,17:15,46.12,,0,46.12,46.12,1,-66514,64040,130554,-2474,0,0,4778,0,0,,4778,4778
25,06/22/2018,70,17:15,17:30,46.04,,0,46.04,46.04,1,-83563,59144,142707,-24419,0,0,9915,0,0,,9915,9915
25,06/22/2018,71,17:30,17:45,42.53,,0,42.53,42.53,1,-84951,79133,164084,-5818,0,0,10652,0,0,,10652,10652
25,06/22/2018,72,17:45,18:00,43.65,,0,43.65,43.65,1,-86208,79224,165432,-6984,0,0,2080,0,0,,2080,2080
25,06/22/2018,73,18:00,18:15,43.65,38.04,0,38.04,38.04,-1,-40215,50767,90982,10552,0,-1396,106,0,0,,1502,-1290
25,06/22/2018,74,18:15,18:30,,38.04,0,38.04,38.04,-1,-53376,57477,110853,4101,0,-2992,0,0,0,,2992,-2992
25,06/22/2018,75,18:30,18:45,,34.04,0,34.04,34.04,-1,-48177,73268,121445,25091,0,-10311,0,0,0,,10311,-10311
25,06/22/2018,76,18:45,19:00,,40.78,0,40.78,40.78,-1,-72261,81029,153290,8768,0,-6054,0,0,0,,6054,-6054
25,06/22/2018,77,19:00,19:15,,,0,38.97,38.97,0,-29233,54174,83407,24941,0,-17,0,0,0,,17,-17
25,06/22/2018,78,19:15,19:30,,,0,38.97,38.97,0,-43626,52537,96163,8911,0,0,0,0,0,,0,0
25,06/22/2018,79,19:30,19:45,,,0,38.97,38.97,0,-51515,59681,111196,8166,0,0,0,0,0,,0,0
25,06/22/2018,80,19:45,20:00,76.12,,0,76.12,76.12,1,-65794,28737,94531,-37057,0,0,11459,0,0,,11459,11459
25,06/22/2018,81,20:00,20:15,46.04,41.35,0,41.35,41.35,-1,-26819,66887,93706,40068,0,-29,10378,0,0,,10407,10349
25,06/22/2018,82,20:15,20:30,,39.65,0,39.65,39.65,-1,-23253,76203,99456,52950,0,-2458,0,0,0,,2458,-2458
25,06/22/2018,83,20:30,20:45,,38.04,0,38.04,38.04,-1,-28393,73968,102361,45575,0,-5595,0,0,0,,5595,-5595
25,06/22/2018,84,20:45,21:00,,19.05,0,19.05,19.05,-1,-32371,62998,95369,30627,0,-23511,0,0,0,,23511,-23511
25,06/22/2018,85,21:00,21:15,,38.04,0,38.04,38.04,-1,-23533,55094,78627,31561,0,-10655,0,0,0,,10655,-10655
25,06/22/2018,86,21:15,21:30,,34.04,0,34.04,34.04,-1,-23443,45335,68778,21892,0,-13537,0,0,0,,13537,-13537
25,06/22/2018,87,21:30,21:45,,39.78,0,39.78,39.78,-1,-31071,47235,78306,16164,0,-12528,0,0,0,,12528,-12528
25,06/22/2018,88,21:45,22:00,,15.86,0,15.86,15.86,-1,-36230,91470,127700,55240,0,-24420,0,0,0,,24420,-24420
25,06/22/2018,89,22:00,22:15,,34.04,0,34.04,34.04,-1,-30573,64899,95472,34326,0,-30331,0,0,0,,30331,-30331
25,06/22/2018,90,22:15,22:30,,38.29,0,38.29,38.29,-1,-45600,57409,103009,11809,0,-15413,0,0,0,,15413,-15413
25,06/22/2018,91,22:30,22:45,41.96,38.29,0,41.96,41.96,1,-55078,53216,108294,-1862,0,-44,3,0,0,,47,-41
25,06/22/2018,92,22:45,23:00,,39.32,0,39.32,39.32,-1,-50633,70766,121399,20133,0,-1309,0,0,0,,1309,-1309
25,06/22/2018,93,23:00,23:15,208.8,39.32,0,208.8,208.8,1,-77275,13749,91024,-63526,0,-13,18825,0,0,,18838,18812
25,06/22/2018,94,23:15,23:30,67.12,,0,67.12,67.12,1,-66148,33443,99591,-32705,0,0,46462,0,0,,46462,46462
25,06/22/2018,95,23:30,23:45,67.12,39.78,0,39.78,39.78,-1,-41428,41658,83086,230,0,-1258,8099,0,0,,9357,6841
25,06/22/2018,96,23:45,0:00,72.12,,0,72.12,72.12,1,-73289,48501,121790,-24788,0,0,7429,0,0,,7429,7429
26,06/23/2018,1,0:00,0:15,89.01,,0,89.01,89.01,1,-99246,45705,144951,-53541,0,0,28160,0,0,,28160,28160
26,06/23/2018,2,0:15,0:30,49.86,,0,49.86,49.86,1,-91185,48451,139636,-42734,0,0,35119,0,0,,35119,35119
26,06/23/2018,3,0:30,0:45,97.02,,0,97.02,97.02,1,-118631,58424,177055,-60207,0,0,39347,0,0,,39347,39347
26,06/23/2018,4,0:45,1:00,193.31,,0,193.31,193.31,1,-156403,67947,224350,-88456,0,0,65249,0,0,,65249,65249
26,06/23/2018,5,1:00,1:15,63.02,,0,63.02,63.02,1,-108933,80680,189613,-28253,0,0,34526,0,0,,34526,34526
26,06/23/2018,6,1:15,1:30,175.92,,0,175.92,175.92,1,-88476,53498,141974,-34978,0,0,42035,0,0,,42035,42035
26,06/23/2018,7,1:30,1:45,43.28,38.44,0,43.28,37.98,2,-57402,50553,107955,-6849,0,-1020,9657,0,0,,10677,8637
26,06/23/2018,8,1:45,2:00,45.86,,0,45.86,45.86,1,-53944,55340,109284,1396,0,0,7099,0,0,,7099,7099
26,06/23/2018,9,2:00,2:15,82.44,,0,82.44,82.44,1,-75971,34916,110887,-41055,0,0,7138,0,0,,7138,7138
26,06/23/2018,10,2:15,2:30,89.86,,0,89.86,89.86,1,-61255,46994,108249,-14261,0,0,19583,0,0,,19583,19583
26,06/23/2018,11,2:30,2:45,89.86,39.92,0,39.92,39.92,-1,-46215,46725,92940,510,0,-24,1444,0,0,,1468,1420
26,06/23/2018,12,2:45,3:00,,31.76,0,31.76,31.76,-1,-30684,53100,83784,22416,0,-11620,0,0,0,,11620,-11620
26,06/23/2018,13,3:00,3:15,92.02,40.43,0,92.02,92.02,1,-60127,24799,84926,-35328,0,-3244,8694,0,0,,11938,5450
26,06/23/2018,14,3:15,3:30,46.19,,0,46.19,46.19,1,-43922,38206,82128,-5716,0,0,12016,0,0,,12016,12016
26,06/23/2018,15,3:30,3:45,,,0,38.04,38.04,0,-38073,49112,87185,11039,0,0,480,0,0,,480,480
26,06/23/2018,16,3:45,4:00,,37.03,0,37.03,37.03,-1,-35696,48554,84250,12858,0,-1827,0,0,0,,1827,-1827
26,06/23/2018,17,4:00,4:15,,40.35,0,40.35,40.35,-1,-37795,54188,91983,16393,0,-1033,0,0,0,,1033,-1033
26,06/23/2018,18,4:15,4:30,,,0,38,38,0,-45165,55645,100810,10480,0,0,0,0,0,,0,0
26,06/23/2018,19,4:30,4:45,,,0,38,38,0,-39005,40463,79468,1458,0,0,0,0,0,,0,0
26,06/23/2018,20,4:45,5:00,,,0,38,38,0,-37662,44051,81713,6389,0,0,0,0,0,,0,0
26,06/23/2018,21,5:00,5:15,49.86,,0,49.86,49.86,1,-52566,36952,89518,-15614,0,0,7086,0,0,,7086,7086
26,06/23/2018,22,5:15,5:30,,,0,37.98,37.98,0,-34844,51661,86505,16817,0,0,701,0,0,,701,701
26,06/23/2018,23,5:30,5:45,,,0,37.98,37.98,0,-38732,57155,95887,18423,0,0,0,0,0,,0,0
26,06/23/2018,24,5:45,6:00,35.67,,0,35.67,35.67,1,-45682,47437,93119,1755,0,0,88,0,0,,88,88
26,06/23/2018,25,6:00,6:15,,-150.03,0,-150.03,-150.03,-1,-30080,113589,143669,83509,0,-20007,0,0,0,,20007,-20007
26,06/23/2018,26,6:15,6:30,,27.85,0,27.85,27.85,-1,-48952,88052,137004,39100,0,-32284,0,0,0,,32284,-32284
26,06/23/2018,27,6:30,6:45,,36.03,0,36.03,36.03,-1,-48841,72674,121515,23833,0,-14061,0,0,0,,14061,-14061
26,06/23/2018,28,6:45,7:00,,,0,38.05,38.05,0,-49127,79382,128509,30255,0,-92,0,0,0,,92,-92
26,06/23/2018,29,7:00,7:15,,27.87,0,27.87,27.87,-1,-52614,109879,162493,57265,0,-3067,0,0,0,,3067,-3067
26,06/23/2018,30,7:15,7:30,,-12.03,0,-12.03,-12.03,-1,-45410,93589,138999,48179,0,-41567,0,0,0,,41567,-41567
26,06/23/2018,31,7:30,7:45,,25.53,0,25.53,25.53,-1,-49146,106067,155213,56921,0,-36444,0,0,0,,36444,-36444
26,06/23/2018,32,7:45,8:00,,38.15,0,38.15,38.15,-1,-56377,115411,171788,59034,0,-13240,0,0,0,,13240,-13240
26,06/23/2018,33,8:00,8:15,,-150.03,0,-150.03,-150.03,-1,-19910,93452,113362,73542,0,-20174,0,0,0,,20174,-20174
26,06/23/2018,34,8:15,8:30,,26.79,0,26.79,26.79,-1,-36139,69813,105952,33674,0,-37640,0,0,0,,37640,-37640
26,06/23/2018,35,8:30,8:45,36.34,37.99,0,36.34,36.34,1,-54816,61148,115964,6332,0,-15542,39,0,0,,15581,-15503
26,06/23/2018,36,8:45,9:00,54.18,37.99,0,54.18,54.18,1,-67074,41836,108910,-25238,0,-664,12448,0,0,,13112,11784
26,06/23/2018,37,9:00,9:15,45.18,40.42,0,45.18,38.68,2,-44935,70380,115315,25445,0,-98,9171,0,0,,9269,9073
26,06/23/2018,38,9:15,9:30,46.15,39.39,0,46.15,38.69,2,-69250,60014,129264,-9236,0,-718,704,0,0,,1422,-14
26,06/23/2018,39,9:30,9:45,50.15,,0,50.15,50.15,1,-83548,65432,148980,-18116,0,0,8330,0,0,,8330,8330
26,06/23/2018,40,9:45,10:00,42.15,38.15,0,42.15,38.15,2,-84439,71053,155492,-13386,0,-183,2633,0,0,,2816,2450
26,06/23/2018,41,10:00,10:15,86.87,,0,86.87,86.87,1,-64331,49474,113805,-14857,0,0,11034,0,0,,11034,11034
26,06/23/2018,42,10:15,10:30,42.36,,0,42.36,42.36,1,-63572,55135,118707,-8437,0,0,7287,0,0,,7287,7287
26,06/23/2018,43,10:30,10:45,46.33,,0,46.33,46.33,1,-67821,57280,125101,-10541,0,0,3250,0,0,,3250,3250
26,06/23/2018,44,10:45,11:00,48.21,,0,48.21,48.21,1,-62119,61561,123680,-558,0,0,5269,0,0,,5269,5269
26,06/23/2018,45,11:00,11:15,115.15,,0,115.15,115.15,1,-84045,39877,123922,-44168,0,0,23201,0,0,,23201,23201
26,06/23/2018,46,11:15,11:30,68.02,,0,68.02,68.02,1,-85676,43683,129359,-41993,0,0,44844,0,0,,44844,44844
26,06/23/2018,47,11:30,11:45,49.02,,0,49.02,49.02,1,-73474,59060,132534,-14414,0,0,27433,0,0,,27433,27433
26,06/23/2018,48,11:45,12:00,53.45,,0,53.45,53.45,1,-81236,62192,143428,-19044,0,0,6188,0,0,,6188,6188
26,06/23/2018,49,12:00,12:15,54.9,,0,54.9,54.9,1,-66226,58210,124436,-8016,0,0,7885,0,0,,7885,7885
26,06/23/2018,50,12:15,12:30,44.4,,0,44.4,44.4,1,-65821,58047,123868,-7774,0,0,1768,0,0,,1768,1768
26,06/23/2018,51,12:30,12:45,44.4,38.15,0,38.15,38.15,-1,-47898,71719,119617,23821,0,-554,315,0,0,,869,-239
26,06/23/2018,52,12:45,13:00,,34.15,0,34.15,34.15,-1,-47496,71917,119413,24421,0,-3297,0,0,0,,3297,-3297
26,06/23/2018,53,13:00,13:15,,40.85,0,40.85,40.85,-1,-63316,75586,138902,12270,0,-457,0,0,0,,457,-457
26,06/23/2018,54,13:15,13:30,,,0,38.15,38.15,0,-57384,75131,132515,17747,0,0,0,0,0,,0,0
26,06/23/2018,55,13:30,13:45,,40.88,0,40.88,40.88,-1,-52283,70961,123244,18678,0,-296,0,0,0,,296,-296
26,06/23/2018,56,13:45,14:00,,38.15,0,38.15,38.15,-1,-50038,76845,126883,26807,0,-1941,0,0,0,,1941,-1941
26,06/23/2018,57,14:00,14:15,,40.85,0,40.85,40.85,-1,-55118,60437,115555,5319,0,-906,0,0,0,,906,-906
26,06/23/2018,58,14:15,14:30,,,0,38.11,38.11,0,-56071,63359,119430,7288,0,0,0,0,0,,0,0
26,06/23/2018,59,14:30,14:45,,34.15,0,34.15,34.15,-1,-40548,77322,117870,36774,0,-6459,0,0,0,,6459,-6459
26,06/23/2018,60,14:45,15:00,,32.62,0,32.62,32.62,-1,-39908,68332,108240,28424,0,-18995,0,0,0,,18995,-18995
26,06/23/2018,61,15:00,15:15,,39.17,0,39.17,39.17,-1,-39813,73279,113092,33466,0,-4560,0,0,0,,4560,-4560
26,06/23/2018,62,15:15,15:30,,,0,38.16,38.16,0,-31446,91970,123416,60524,0,-11,0,0,0,,11,-11
26,06/23/2018,63,15:30,15:45,,,0,38.15,38.15,0,-30067,115916,145983,85849,0,0,0,0,0,,0,0
26,06/23/2018,64,15:45,16:00,,,0,38.16,38.16,0,-29850,114543,144393,84693,0,0,0,0,0,,0,0
26,06/23/2018,65,16:00,16:15,,26.82,0,26.82,26.82,-1,-30187,173747,203934,143560,0,-12426,0,0,0,,12426,-12426
26,06/23/2018,66,16:15,16:30,,34.15,0,34.15,34.15,-1,-28892,151805,180697,122913,0,-19145,0,0,0,,19145,-19145
26,06/23/2018,67,16:30,16:45,,,0,38.15,38.15,0,-30765,123433,154198,92668,0,-2840,0,0,0,,2840,-2840
26,06/23/2018,68,16:45,17:00,,,0,38.17,38.17,0,-31327,81186,112513,49859,0,0,0,0,0,,0,0
26,06/23/2018,69,17:00,17:15,,-150.03,0,-150.03,-150.03,-1,-15997,129289,145286,113292,0,-28294,0,0,0,,28294,-28294
26,06/23/2018,70,17:15,17:30,,30.15,0,30.15,30.15,-1,-29679,82834,112513,53155,0,-39993,0,0,0,,39993,-39993
26,06/23/2018,71,17:30,17:45,48.9,38.15,0,48.9,48.9,1,-48661,64036,112697,15375,0,-16155,471,0,0,,16626,-15684
26,06/23/2018,72,17:45,18:00,48.79,,0,48.79,48.79,1,-76490,56882,133372,-19608,0,0,3826,0,0,,3826,3826
26,06/23/2018,73,18:00,18:15,35.64,40.99,0,40.99,40.99,-1,-67083,94305,161388,27222,0,-8,971,0,0,,979,963
26,06/23/2018,74,18:15,18:30,,38.15,0,38.15,38.15,-1,-71830,90007,161837,18177,0,-2580,0,0,0,,2580,-2580
26,06/23/2018,75,18:30,18:45,42.15,39.79,0,42.15,38.32,2,-83347,82214,165561,-1133,0,-821,35,0,0,,856,-786
26,06/23/2018,76,18:45,19:00,50.15,,0,50.15,50.15,1,-89749,70210,159959,-19539,0,0,6652,0,0,,6652,6652
26,06/23/2018,77,19:00,19:15,,,0,38.31,38.31,0,-75162,82829,157991,7667,0,0,1634,0,0,,1634,1634
26,06/23/2018,78,19:15,19:30,58.13,,0,58.13,58.13,1,-90834,63679,154513,-27155,0,0,12017,0,0,,12017,12017
26,06/23/2018,79,19:30,19:45,47.02,,0,47.02,47.02,1,-89211,59930,149141,-29281,0,0,27379,0,0,,27379,27379
26,06/23/2018,80,19:45,20:00,60.02,,0,60.02,60.02,1,-92835,48875,141710,-43960,0,0,32590,0,0,,32590,32590
26,06/23/2018,81,20:00,20:15,46.15,41.05,0,41.05,41.05,-1,-73132,68281,141413,-4851,0,-24,18323,0,0,,18347,18299
26,06/23/2018,82,20:15,20:30,68.02,41.06,0,68.02,38.64,2,-85476,52343,137819,-33133,0,-32,8245,0,0,,8277,8213
26,06/23/2018,83,20:30,20:45,68.02,,0,68.02,68.02,1,-70973,63914,134887,-7059,0,0,17599,0,0,,17599,17599
26,06/23/2018,84,20:45,21:00,68.02,40.17,0,40.17,40.17,-1,-50932,55616,106548,4684,0,-312,1244,0,0,,1556,932
26,06/23/2018,85,21:00,21:15,42.15,,0,42.15,42.15,1,-46193,44173,90366,-2020,0,0,1151,0,0,,1151,1151
26,06/23/2018,86,21:15,21:30,42.15,,0,42.15,42.15,1,-47063,42551,89614,-4512,0,0,2347,0,0,,2347,2347
26,06/23/2018,87,21:30,21:45,43.49,,0,43.49,43.49,1,-47128,42848,89976,-4280,0,0,1479,0,0,,1479,1479
26,06/23/2018,88,21:45,22:00,43.49,38.15,0,38.15,38.15,-1,-39344,48768,88112,9424,0,-1996,1,0,0,,1997,-1995
26,06/23/2018,89,22:00,22:15,52.53,38.15,0,52.53,52.53,1,-66990,36715,103705,-30275,0,-124,8313,0,0,,8437,8189
26,06/23/2018,90,22:15,22:30,113.37,,0,113.37,113.37,1,-68000,18280,86280,-49720,0,0,33301,0,0,,33301,33301
26,06/23/2018,91,22:30,22:45,113.37,,0,113.37,113.37,1,-50650,23333,73983,-27317,0,0,45661,0,0,,45661,45661
26,06/23/2018,92,22:45,23:00,42.15,38.15,0,42.15,38.15,2,-37791,41996,79787,4205,0,-600,10216,0,0,,10816,9616
26,06/23/2018,93,23:00,23:15,250.78,,0,250.78,250.78,1,-72206,14907,87113,-57299,0,0,21119,0,0,,21119,21119
26,06/23/2018,94,23:15,23:30,53.02,,0,53.02,53.02,1,-63988,27042,91030,-36946,0,0,32243,0,0,,32243,32243
26,06/23/2018,95,23:30,23:45,46.15,39.03,0,39.03,39.03,-1,-51422,46997,98419,-4425,0,-290,18031,0,0,,18321,17741
26,06/23/2018,96,23:45,0:00,46.15,38.15,0,38.15,38.15,-1,-64330,64808,129138,478,0,-404,489,0,0,,893,85
26,06/24/2018,1,0:00,0:15,42.15,38.15,0,42.15,42.15,1,-43347,50749,94096,7402,0,-90,264,0,0,,354,174
26,06/24/2018,2,0:15,0:30,42.15,40.49,0,42.15,39.48,2,-47827,48702,96529,875,0,-28,2520,0,0,,2548,2492
26,06/24/2018,3,0:30,0:45,42.15,17.91,0,17.91,17.91,-1,-47363,83890,131253,36527,0,-6300,14,0,0,,6314,-6286
26,06/24/2018,4,0:45,1:00,,16.91,0,16.91,16.91,-1,-78977,100983,179960,22006,0,-31294,0,0,0,,31294,-31294
26,06/24/2018,5,1:00,1:15,44.39,40.8,0,44.39,38.73,2,-55541,41594,97135,-13947,0,-5831,937,0,0,,6768,-4894
26,06/24/2018,6,1:15,1:30,36.98,,0,36.98,36.98,1,-47280,36587,83867,-10693,0,0,547,0,0,,547,547
26,06/24/2018,7,1:30,1:45,36.98,37.78,0,37.78,37.78,-1,-45885,58383,104268,12498,0,-1112,103,0,0,,1215,-1009
26,06/24/2018,8,1:45,2:00,,35.64,0,35.64,35.64,-1,-45761,71955,117716,26194,0,-19157,0,0,0,,19157,-19157
26,06/24/2018,9,2:00,2:15,50.5,36.78,0,50.5,36.78,2,-43749,35572,79321,-8177,0,-12792,2253,0,0,,15045,-10539
26,06/24/2018,10,2:15,2:30,36.74,38.15,0,38.15,38.15,-1,-41082,57196,98278,16114,0,-129,655,0,0,,784,526
26,06/24/2018,11,2:30,2:45,,36.78,0,36.78,36.78,-1,-39874,66095,105969,26221,0,-1188,0,0,0,,1188,-1188
26,06/24/2018,12,2:45,3:00,,23.44,0,23.44,23.44,-1,-38997,75864,114861,36867,0,-20343,0,0,0,,20343,-20343
26,06/24/2018,13,3:00,3:15,61.63,37.78,0,61.63,37.78,2,-60312,33045,93357,-27267,0,-10765,4032,0,0,,14797,-6733
26,06/24/2018,14,3:15,3:30,42.15,37.78,0,42.15,42.15,1,-41064,34066,75130,-6998,0,-17,3622,0,0,,3639,3605
26,06/24/2018,15,3:30,3:45,42.15,38.15,0,38.15,38.15,-1,-33170,46044,79214,12874,0,-485,128,0,0,,613,-357
26,06/24/2018,16,3:45,4:00,,38.15,0,38.15,38.15,-1,-29923,41562,71485,11639,0,-1933,0,0,0,,1933,-1933
26,06/24/2018,17,4:00,4:15,48.84,39.34,0,48.84,38.67,2,-41878,20165,62043,-21713,0,-996,4099,0,0,,5095,3103
26,06/24/2018,18,4:15,4:30,42.15,,0,42.15,42.15,1,-40880,26220,67100,-14660,0,0,7421,0,0,,7421,7421
26,06/24/2018,19,4:30,4:45,42.15,,0,42.15,42.15,1,-37655,31749,69404,-5906,0,0,5015,0,0,,5015,5015
26,06/24/2018,20,4:45,5:00,,,0,38.67,38.67,0,-27862,48502,76364,20640,0,0,764,0,0,,764,764
26,06/24/2018,21,5:00,5:15,,,0,38.58,38.58,0,-41659,45238,86897,3579,0,0,0,0,0,,0,0
26,06/24/2018,22,5:15,5:30,,,0,38.58,38.58,0,-26466,52313,78779,25847,0,0,0,0,0,,0,0
26,06/24/2018,23,5:30,5:45,,,0,38.58,38.58,0,-28414,51605,80019,23191,0,0,0,0,0,,0,0
26,06/24/2018,24,5:45,6:00,,38.15,0,38.15,38.15,-1,-27915,73281,101196,45366,0,-818,0,0,0,,818,-818
26,06/24/2018,25,6:00,6:15,,39.18,0,39.18,39.18,-1,-22502,58271,80773,35769,0,-1401,0,0,0,,1401,-1401
26,06/24/2018,26,6:15,6:30,,,0,38.51,38.51,0,-42142,45568,87710,3426,0,-68,0,0,0,,68,-68
26,06/24/2018,27,6:30,6:45,,,0,38.51,38.51,0,-38829,48384,87213,9555,0,0,0,0,0,,0,0
26,06/24/2018,28,6:45,7:00,,38.24,0,38.24,38.24,-1,-17902,60845,78747,42943,0,-285,0,0,0,,285,-285
26,06/24/2018,29,7:00,7:15,,38.24,0,38.24,38.24,-1,-51014,55191,106205,4177,0,-1783,0,0,0,,1783,-1783
26,06/24/2018,30,7:15,7:30,,38.24,0,38.24,38.24,-1,-29212,53107,82319,23895,0,-1468,0,0,0,,1468,-1468
26,06/24/2018,31,7:30,7:45,,35.78,0,35.78,35.78,-1,-18363,57320,75683,38957,0,-7416,0,0,0,,7416,-7416
26,06/24/2018,32,7:45,8:00,,38.24,0,38.24,38.24,-1,-20769,66427,87196,45658,0,-12389,0,0,0,,12389,-12389
26,06/24/2018,33,8:00,8:15,,-2.78,0,-2.78,-2.78,-1,-29697,86396,116093,56699,0,-28809,0,0,0,,28809,-28809
26,06/24/2018,34,8:15,8:30,,20.78,0,20.78,20.78,-1,-26341,72029,98370,45688,0,-43953,0,0,0,,43953,-43953
26,06/24/2018,35,8:30,8:45,,33.85,0,33.85,33.85,-1,-31694,71846,103540,40152,0,-29807,0,0,0,,29807,-29807
26,06/24/2018,36,8:45,9:00,,,0,38.77,38.77,0,-47315,80229,127544,32914,0,-4785,0,0,0,,4785,-4785
26,06/24/2018,37,9:00,9:15,,-150.78,0,-150.78,-150.78,-1,-34192,113766,147958,79574,0,-20193,0,0,0,,20193,-20193
26,06/24/2018,38,9:15,9:30,,23.02,0,23.02,23.02,-1,-36844,77843,114687,40999,0,-44228,0,0,0,,44228,-44228
26,06/24/2018,39,9:30,9:45,,33.24,0,33.24,33.24,-1,-28755,72936,101691,44181,0,-34725,0,0,0,,34725,-34725
26,06/24/2018,40,9:45,10:00,,34.08,0,34.08,34.08,-1,-27200,75179,102379,47979,0,-34550,0,0,0,,34550,-34550
26,06/24/2018,41,10:00,10:15,,40.78,0,40.78,40.78,-1,-36653,57818,94471,21165,0,-13360,0,0,0,,13360,-13360
26,06/24/2018,42,10:15,10:30,,37.07,0,37.07,37.07,-1,-24389,66292,90681,41903,0,-11113,0,0,0,,11113,-11113
26,06/24/2018,43,10:30,10:45,,36.93,0,36.93,36.93,-1,-25022,67539,92561,42517,0,-22975,0,0,0,,22975,-22975
26,06/24/2018,44,10:45,11:00,,34.24,0,34.24,34.24,-1,-22527,84604,107131,62077,0,-21261,0,0,0,,21261,-21261
26,06/24/2018,45,11:00,11:15,,38.24,0,38.24,38.24,-1,-59542,85448,144990,25906,0,-3364,0,0,0,,3364,-3364
26,06/24/2018,46,11:15,11:30,,,0,38.49,38.49,0,-62591,84512,147103,21921,0,0,0,0,0,,0,0
26,06/24/2018,47,11:30,11:45,,,0,38.49,38.49,0,-67902,72882,140784,4980,0,0,0,0,0,,0,0
26,06/24/2018,48,11:45,12:00,55.73,,0,55.73,55.73,1,-74573,46454,121027,-28119,0,0,10421,0,0,,10421,10421
26,06/24/2018,49,12:00,12:15,42.62,11.3,0,11.3,11.3,-1,-36593,90175,126768,53582,0,-12070,4908,0,0,,16978,-7162
26,06/24/2018,50,12:15,12:30,,10.27,0,10.27,10.27,-1,-40291,71711,112002,31420,0,-31736,0,0,0,,31736,-31736
26,06/24/2018,51,12:30,12:45,,39.58,0,39.58,39.58,-1,-52716,75901,128617,23185,0,-13766,0,0,0,,13766,-13766
26,06/24/2018,52,12:45,13:00,,34.24,0,34.24,34.24,-1,-55480,85301,140781,29821,0,-5947,0,0,0,,5947,-5947
26,06/24/2018,53,13:00,13:15,42.78,39.34,0,42.78,38.81,2,-66366,55676,122042,-10690,0,-4829,989,0,0,,5818,-3840
26,06/24/2018,54,13:15,13:30,42.78,38.24,0,38.24,38.24,-1,-56529,66624,123153,10095,0,-4820,5,0,0,,4825,-4815
26,06/24/2018,55,13:30,13:45,,38.89,0,38.89,38.89,-1,-58175,79894,138069,21719,0,-14936,0,0,0,,14936,-14936
26,06/24/2018,56,13:45,14:00,,38.24,0,38.24,38.24,-1,-56437,83226,139663,26789,0,-20846,0,0,0,,20846,-20846
26,06/24/2018,57,14:00,14:15,41.25,38.71,0,41.25,41.25,1,-39601,55408,95009,15807,0,-14928,47,0,0,,14975,-14881
26,06/24/2018,58,14:15,14:30,41.25,38.71,0,41.25,41.25,1,-37952,62591,100543,24639,0,-454,72,0,0,,526,-382
26,06/24/2018,59,14:30,14:45,,,0,38.72,38.72,0,-57471,68807,126278,11336,0,0,0,0,0,,0,0
26,06/24/2018,60,14:45,15:00,42.24,,0,42.24,42.24,1,-70890,70952,141842,62,0,0,335,0,0,,335,335
26,06/24/2018,61,15:00,15:15,,,0,38.65,38.65,0,-30102,110275,140377,80173,0,0,43,0,0,,43,43
26,06/24/2018,62,15:15,15:30,,,0,38.65,38.65,0,-28079,106195,134274,78116,0,0,0,0,0,,0,0
26,06/24/2018,63,15:30,15:45,,41.78,0,41.78,41.78,-1,-21653,116749,138402,95096,0,-53,0,0,0,,53,-53
26,06/24/2018,64,15:45,16:00,,,0,38.65,38.65,0,-24129,120574,144703,96445,0,0,0,0,0,,0,0
26,06/24/2018,65,16:00,16:15,,40.09,0,40.09,40.09,-1,-25864,111920,137784,86056,0,-295,0,0,0,,295,-295
26,06/24/2018,66,16:15,16:30,,41.78,0,41.78,41.78,-1,-22273,112152,134425,89879,0,-221,0,0,0,,221,-221
26,06/24/2018,67,16:30,16:45,,,0,38.64,38.64,0,-24314,108212,132526,83898,0,0,0,0,0,,0,0
26,06/24/2018,68,16:45,17:00,,,0,38.66,38.66,0,-30127,81222,111349,51095,0,0,0,0,0,,0,0
26,06/24/2018,69,17:00,17:15,,38.24,0,38.24,38.24,-1,-25605,143475,169080,117870,0,-1448,0,0,0,,1448,-1448
26,06/24/2018,70,17:15,17:30,,40.78,0,40.78,40.78,-1,-28500,118028,146528,89528,0,-1131,0,0,0,,1131,-1131
26,06/24/2018,71,17:30,17:45,,,0,38.66,38.66,0,-43024,89891,132915,46867,0,-36,0,0,0,,36,-36
26,06/24/2018,72,17:45,18:00,,,0,38.67,38.67,0,-56678,62112,118790,5434,0,0,0,0,0,,0,0
26,06/24/2018,73,18:00,18:15,43.54,,0,43.54,43.54,1,-51634,48595,100229,-3039,0,0,2995,0,0,,2995,2995
26,06/24/2018,74,18:15,18:30,35.88,,0,35.88,35.88,1,-49408,44374,93782,-5034,0,0,1293,0,0,,1293,1293
26,06/24/2018,75,18:30,18:45,42.36,,0,42.36,42.36,1,-50255,44374,94629,-5881,0,0,668,0,0,,668,668
26,06/24/2018,76,18:45,19:00,43.51,,0,43.51,43.51,1,-45939,46598,92537,659,0,0,1439,0,0,,1439,1439
26,06/24/2018,77,19:00,19:15,,,0,38.84,38.84,0,-25811,54390,80201,28579,0,0,0,0,0,,0,0
26,06/24/2018,78,19:15,19:30,43.41,,0,43.41,43.41,1,-48365,43683,92048,-4682,0,0,348,0,0,,348,348
26,06/24/2018,79,19:30,19:45,42.24,,0,42.24,42.24,1,-47857,46767,94624,-1090,0,0,1223,0,0,,1223,1223
26,06/24/2018,80,19:45,20:00,46.24,,0,46.24,46.24,1,-54631,27471,82102,-27160,0,0,6128,0,0,,6128,6128
26,06/24/2018,81,20:00,20:15,36.33,38.78,0,39.06,38.78,2,-28281,46025,74306,17744,0,-2262,2064,0,0,,4326,-198
26,06/24/2018,82,20:15,20:30,,34.24,0,34.24,34.24,-1,-26127,43663,69790,17536,0,-5754,0,0,0,,5754,-5754
26,06/24/2018,83,20:30,20:45,,24.87,0,24.87,24.87,-1,-29350,73451,102801,44101,0,-35719,0,0,0,,35719,-35719
26,06/24/2018,84,20:45,21:00,,34.24,0,34.24,34.24,-1,-36001,72591,108592,36590,0,-28583,0,0,0,,28583,-28583
26,06/24/2018,85,21:00,21:15,,20.77,0,20.77,20.77,-1,-29843,75179,105022,45336,0,-38912,0,0,0,,38912,-38912
26,06/24/2018,86,21:15,21:30,,23.44,0,23.44,23.44,-1,-19550,70645,90195,51095,0,-37600,0,0,0,,37600,-37600
26,06/24/2018,87,21:30,21:45,,36.15,0,36.15,36.15,-1,-21159,49419,70578,28260,0,-31135,0,0,0,,31135,-31135
26,06/24/2018,88,21:45,22:00,,38.24,0,38.24,38.24,-1,-30205,48779,78984,18574,0,-22570,0,0,0,,22570,-22570
26,06/24/2018,89,22:00,22:15,,38.24,0,38.24,38.24,-1,-25509,59190,84699,33681,0,-19013,0,0,0,,19013,-19013
26,06/24/2018,90,22:15,22:30,42.94,38.24,0,42.94,42.94,1,-36702,25857,62559,-10845,0,-5794,835,0,0,,6629,-4959
26,06/24/2018,91,22:30,22:45,42.24,,0,42.24,42.24,1,-35482,31338,66820,-4144,0,0,848,0,0,,848,848
26,06/24/2018,92,22:45,23:00,42.24,40.12,0,42.24,39.49,2,-34041,43687,77728,9646,0,-430,1235,0,0,,1665,805
26,06/24/2018,93,23:00,23:15,49.49,40.12,0,49.49,49.49,1,-40994,22221,63215,-18773,0,-307,4973,0,0,,5280,4666
26,06/24/2018,94,23:15,23:30,36.59,38.24,0,38.24,38.24,-1,-31567,39528,71095,7961,0,-489,868,0,0,,1357,379
26,06/24/2018,95,23:30,23:45,,35.08,0,35.08,35.08,-1,-35205,59263,94468,24058,0,-17919,0,0,0,,17919,-17919
26,06/24/2018,96,23:45,0:00,,24.24,0,24.24,24.24,-1,-35935,84298,120233,48363,0,-30435,0,0,0,,30435,-30435
26,06/25/2018,1,0:00,0:15,50.24,34.24,0,50.24,34.24,2,-75664,29607,105271,-46057,0,-15433,1660,0,0,,17093,-13773
26,06/25/2018,2,0:15,0:30,43.71,34.24,0,43.71,43.71,1,-63489,27055,90544,-36434,0,-101,354,0,0,,455,253
26,06/25/2018,3,0:30,0:45,,38.24,0,38.24,38.24,-1,-40708,48732,89440,8024,0,-527,0,0,0,,527,-527
26,06/25/2018,4,0:45,1:00,,38.14,0,38.14,38.14,-1,-38883,62236,101119,23353,0,-5815,0,0,0,,5815,-5815
26,06/25/2018,5,1:00,1:15,67.93,38.14,0,67.93,67.93,1,-72951,37997,110948,-34954,0,-1375,8210,0,0,,9585,6835
26,06/25/2018,6,1:15,1:30,46.24,,0,46.24,46.24,1,-64942,46184,111126,-18758,0,0,12041,0,0,,12041,12041
26,06/25/2018,7,1:30,1:45,,,0,41.11,41.11,0,-55366,55387,110753,21,0,0,118,0,0,,118,118
26,06/25/2018,8,1:45,2:00,,,0,41.11,41.11,0,-56257,61750,118007,5493,0,0,0,0,0,,0,0
26,06/25/2018,9,2:00,2:15,56.02,,0,56.02,56.02,1,-69543,44861,114404,-24682,0,0,4838,0,0,,4838,4838
26,06/25/2018,10,2:15,2:30,72.02,,0,72.02,72.02,1,-61071,43779,104850,-17292,0,0,19518,0,0,,19518,19518
26,06/25/2018,11,2:30,2:45,35.83,,0,35.83,35.83,1,-53638,51213,104851,-2425,0,0,3865,0,0,,3865,3865
26,06/25/2018,12,2:45,3:00,44.18,,0,44.18,44.18,1,-59278,49595,108873,-9683,0,0,2995,0,0,,2995,2995
26,06/25/2018,13,3:00,3:15,42.25,,0,42.25,42.25,1,-55483,47727,103210,-7756,0,0,3488,0,0,,3488,3488
26,06/25/2018,14,3:15,3:30,46.24,,0,46.24,46.24,1,-53022,40968,93990,-12054,0,0,3553,0,0,,3553,3553
26,06/25/2018,15,3:30,3:45,50.24,,0,50.24,50.24,1,-59320,38243,97563,-21077,0,0,15752,0,0,,15752,15752
26,06/25/2018,16,3:45,4:00,43.73,,0,43.73,43.73,1,-58957,41355,100312,-17602,0,0,10202,0,0,,10202,10202
26,06/25/2018,17,4:00,4:15,134.28,,0,134.28,134.28,1,-105015,58646,163661,-46369,0,0,27047,0,0,,27047,27047
26,06/25/2018,18,4:15,4:30,47.74,,0,47.74,47.74,1,-85700,66037,151737,-19663,0,0,22623,0,0,,22623,22623
26,06/25/2018,19,4:30,4:45,42.24,,0,42.24,42.24,1,-65620,59309,124929,-6311,0,0,5836,0,0,,5836,5836
26,06/25/2018,20,4:45,5:00,42.24,,0,42.24,42.24,1,-40583,54378,94961,13795,0,0,669,0,0,,669,669
26,06/25/2018,21,5:00,5:15,57.58,,0,57.58,57.58,1,-76639,42775,119414,-33864,0,0,11785,0,0,,11785,11785
26,06/25/2018,22,5:15,5:30,35.94,,0,35.94,35.94,1,-57033,55568,112601,-1465,0,0,3072,0,0,,3072,3072
26,06/25/2018,23,5:30,5:45,,,0,40.49,40.49,0,-30760,35161,65921,4401,0,0,0,0,0,,0,0
26,06/25/2018,24,5:45,6:00,,,0,40.04,40.04,0,-39533,36731,76264,-2802,0,0,0,0,0,,0,0
26,06/25/2018,25,6:00,6:15,35.85,,0,35.85,35.85,1,-97262,60369,157631,-36893,0,0,313,0,0,,313,313
26,06/25/2018,26,6:15,6:30,46.69,,0,46.69,46.69,1,-75133,52720,127853,-22413,0,0,1844,0,0,,1844,1844
26,06/25/2018,27,6:30,6:45,52.15,,0,52.15,52.15,1,-33801,36129,69930,2328,0,0,5839,0,0,,5839,5839
26,06/25/2018,28,6:45,7:00,,,0,40.08,40.08,0,-41388,87461,128849,46073,0,0,0,0,0,,0,0
26,06/25/2018,29,7:00,7:15,,32.59,0,32.59,32.59,-1,-55960,87552,143512,31592,0,-5433,0,0,0,,5433,-5433
26,06/25/2018,30,7:15,7:30,,43.66,0,43.66,43.66,-1,-26231,70799,97030,44568,0,-632,0,0,0,,632,-632
26,06/25/2018,31,7:30,7:45,46.83,,0,46.83,46.83,1,-34275,35768,70043,1493,0,0,265,0,0,,265,265
26,06/25/2018,32,7:45,8:00,71.23,,0,71.23,71.23,1,-93237,68687,161924,-24550,0,0,20916,0,0,,20916,20916
26,06/25/2018,33,8:00,8:15,46.33,40.55,0,40.55,40.55,-1,-69835,71028,140863,1193,0,-217,14910,0,0,,15127,14693
26,06/25/2018,34,8:15,8:30,53.3,40,0,53.3,39.81,2,-80432,44831,125263,-35601,0,-111,9566,0,0,,9677,9455
26,06/25/2018,35,8:30,8:45,48.55,,0,48.55,48.55,1,-80936,38811,119747,-42125,0,0,21976,0,0,,21976,21976
26,06/25/2018,36,8:45,9:00,48.55,,0,48.55,48.55,1,-95392,45839,141231,-49553,0,0,21720,0,0,,21720,21720
26,06/25/2018,37,9:00,9:15,252.39,,0,252.39,252.39,1,-128511,48933,177444,-79578,0,0,44838,0,0,,44838,44838
26,06/25/2018,38,9:15,9:30,252.39,,0,252.39,252.39,1,-267797,58627,326424,-209170,0,0,77091,0,0,,77091,77091
26,06/25/2018,39,9:30,9:45,252.39,,0,277.63,277.63,1,-241184,47057,288241,-194127,0,0,96699,0,0,,96699,96699
26,06/25/2018,40,9:45,10:00,299.86,,0,329.85,329.85,1,-246010,39953,285963,-206057,0,0,95354,2500,75705,,173559,173559
26,06/25/2018,41,10:00,10:15,214.16,,0,264.16,264.16,1,-210965,74037,285002,-136928,0,0,33880,2500,107814,,144194,144194
26,06/25/2018,42,10:15,10:30,251.91,,0,251.91,251.91,1,-152786,76131,228917,-76655,0,0,19250,0,10000,,29250,29250
26,06/25/2018,43,10:30,10:45,85.02,,0,85.02,85.02,1,-92586,71068,163654,-21518,0,0,33397,0,0,,33397,33397
26,06/25/2018,44,10:45,11:00,52.55,39.59,0,52.55,39.59,2,-72406,48364,120770,-24042,0,-451,3634,0,0,,4085,3183
26,06/25/2018,45,11:00,11:15,175.02,,0,175.02,175.02,1,-101662,43811,145473,-57851,0,0,27837,0,0,,27837,27837
26,06/25/2018,46,11:15,11:30,,,0,40.38,40.38,0,-76615,70417,147032,-6198,0,0,5486,0,0,,5486,5486
26,06/25/2018,47,11:30,11:45,,40.16,0,40.16,40.16,-1,-47583,54088,101671,6505,0,-1214,0,0,0,,1214,-1214
26,06/25/2018,48,11:45,12:00,43.39,42.03,0,43.39,40.36,2,-45769,40070,85839,-5699,0,-579,285,0,0,,864,-294
26,06/25/2018,49,12:00,12:15,155.02,,0,155.02,155.02,1,-88996,48346,137342,-40650,0,0,19086,0,0,,19086,19086
26,06/25/2018,50,12:15,12:30,47.75,40.74,0,40.74,40.74,-1,-45965,68321,114286,22356,0,-115,9334,0,0,,9449,9219
26,06/25/2018,51,12:30,12:45,,40.76,0,40.76,40.76,-1,-63448,75935,139383,12487,0,-1073,0,0,0,,1073,-1073
26,06/25/2018,52,12:45,13:00,,43.65,0,43.65,43.65,-1,-44912,91804,136716,46892,0,-239,0,0,0,,239,-239
26,06/25/2018,53,13:00,13:15,,,0,39.8,39.8,0,-68217,105459,173676,37242,0,0,0,0,0,,0,0
26,06/25/2018,54,13:15,13:30,,,0,39.8,39.8,0,-71125,90102,161227,18977,0,0,0,0,0,,0,0
26,06/25/2018,55,13:30,13:45,,,0,39.79,39.79,0,-61180,92134,153314,30954,0,0,0,0,0,,0,0
26,06/25/2018,56,13:45,14:00,,43.62,0,43.62,43.62,-1,-74969,98634,173603,23665,0,-7,0,0,0,,7,-7
26,06/25/2018,57,14:00,14:15,48.55,43.53,0,48.55,48.55,1,-75656,67351,143007,-8305,0,-48,1843,0,0,,1891,1795
26,06/25/2018,58,14:15,14:30,42.41,,0,42.41,42.41,1,-74920,79877,154797,4957,0,0,2742,0,0,,2742,2742
26,06/25/2018,59,14:30,14:45,35.6,,0,35.6,35.6,1,-67371,91020,158391,23649,0,0,723,0,0,,723,723
26,06/25/2018,60,14:45,15:00,,38.52,0,38.52,38.52,-1,-48456,100792,149248,52336,0,-245,0,0,0,,245,-245
26,06/25/2018,61,15:00,15:15,,36.81,0,36.81,36.81,-1,-47807,93883,141690,46076,0,-1184,0,0,0,,1184,-1184
26,06/25/2018,62,15:15,15:30,,38.52,0,38.52,38.52,-1,-47783,94274,142057,46491,0,-608,0,0,0,,608,-608
26,06/25/2018,63,15:30,15:45,,38.52,0,38.52,38.52,-1,-56129,89591,145720,33462,0,-1936,0,0,0,,1936,-1936
26,06/25/2018,64,15:45,16:00,,22.63,0,22.63,22.63,-1,-51814,95186,147000,43372,0,-14143,0,0,0,,14143,-14143
26,06/25/2018,65,16:00,16:15,,40.63,0,40.63,40.63,-1,-46596,87081,133677,40485,0,-5126,0,0,0,,5126,-5126
26,06/25/2018,66,16:15,16:30,,34.52,0,34.52,34.52,-1,-51807,102394,154201,50587,0,-1806,0,0,0,,1806,-1806
26,06/25/2018,67,16:30,16:45,,18.83,0,18.83,18.83,-1,-63974,118048,182022,54074,0,-17644,0,0,0,,17644,-17644
26,06/25/2018,68,16:45,17:00,,38.52,0,38.52,38.52,-1,-67641,99598,167239,31957,0,-7044,0,0,0,,7044,-7044
26,06/25/2018,69,17:00,17:15,,34.52,0,34.52,34.52,-1,-94950,102934,197884,7984,0,-8250,0,0,0,,8250,-8250
26,06/25/2018,70,17:15,17:30,,,0,42.91,42.91,0,-96388,101498,197886,5110,0,-545,0,0,0,,545,-545
26,06/25/2018,71,17:30,17:45,48.55,,0,48.55,48.55,1,-103671,91764,195435,-11907,0,0,2882,0,0,,2882,2882
26,06/25/2018,72,17:45,18:00,43.39,,0,43.39,43.39,1,-96090,92507,188597,-3583,0,0,4788,0,0,,4788,4788
26,06/25/2018,73,18:00,18:15,43.39,34.52,0,43.39,34.52,2,-77471,92913,170384,15442,0,-2994,1911,0,0,,4905,-1083
26,06/25/2018,74,18:15,18:30,,38.28,0,38.28,38.28,-1,-78466,100919,179385,22453,0,-4478,0,0,0,,4478,-4478
26,06/25/2018,75,18:30,18:45,,30.52,0,30.52,30.52,-1,-74047,109384,183431,35337,0,-10584,0,0,0,,10584,-10584
26,06/25/2018,76,18:45,19:00,43.39,43.03,0,43.39,43.39,1,-98284,101034,199318,2750,0,-3412,193,0,0,,3605,-3219
26,06/25/2018,77,19:00,19:15,43.39,,0,43.39,43.39,1,-57199,62821,120020,5622,0,0,1198,0,0,,1198,1198
26,06/25/2018,78,19:15,19:30,48.55,,0,48.55,48.55,1,-74809,60917,135726,-13892,0,0,3830,0,0,,3830,3830
26,06/25/2018,79,19:30,19:45,44.73,,0,44.73,44.73,1,-69425,61352,130777,-8073,0,0,8578,0,0,,8578,8578
26,06/25/2018,80,19:45,20:00,45.72,,0,45.72,45.72,1,-77412,62622,140034,-14790,0,0,6059,0,0,,6059,6059
26,06/25/2018,81,20:00,20:15,54.9,,0,54.9,54.9,1,-65171,33067,98238,-32104,0,0,13846,0,0,,13846,13846
26,06/25/2018,82,20:15,20:30,45.96,,0,45.96,45.96,1,-67333,39853,107186,-27480,0,0,14939,0,0,,14939,14939
26,06/25/2018,83,20:30,20:45,41.66,43.57,0,43.57,43.57,-1,-56187,67846,124033,11659,0,-67,5150,0,0,,5217,5083
26,06/25/2018,84,20:45,21:00,,40.41,0,40.41,40.41,-1,-51607,75714,127321,24107,0,-1907,0,0,0,,1907,-1907
26,06/25/2018,85,21:00,21:15,,,0,27.02,27.02,0,-20809,42774,63583,21965,0,-76,0,0,0,,76,-76
26,06/25/2018,86,21:15,21:30,,,0,27.02,27.02,0,-35935,48604,84539,12669,0,0,0,0,0,,0,0
26,06/25/2018,87,21:30,21:45,,32.85,0,32.85,32.85,-1,-34092,69006,103098,34914,0,-4327,0,0,0,,4327,-4327
26,06/25/2018,88,21:45,22:00,,30.52,0,30.52,30.52,-1,-30778,78215,108993,47437,0,-30413,0,0,0,,30413,-30413
26,06/25/2018,89,22:00,22:15,46.08,40.13,0,46.08,46.08,1,-41318,30807,72125,-10511,0,-14077,800,0,0,,14877,-13277
26,06/25/2018,90,22:15,22:30,52.55,,0,52.55,52.55,1,-59731,23743,83474,-35988,0,0,8856,0,0,,8856,8856
26,06/25/2018,91,22:30,22:45,47.29,,0,47.29,47.29,1,-54671,24455,79126,-30216,0,0,18558,0,0,,18558,18558
26,06/25/2018,92,22:45,23:00,44.46,,0,44.46,44.46,1,-47648,48424,96072,776,0,0,10609,0,0,,10609,10609
26,06/25/2018,93,23:00,23:15,208.99,43.16,0,208.99,40.31,2,-57559,13872,71431,-43687,0,-118,13594,0,0,,13712,13476
26,06/25/2018,94,23:15,23:30,50.35,43.26,0,50.35,40.2,2,-34633,20111,54744,-14522,0,-13,21279,0,0,,21292,21266
26,06/25/2018,95,23:30,23:45,50.35,30.7,0,30.7,30.7,-1,-35787,61003,96790,25216,0,-10472,2673,0,0,,13145,-7799
26,06/25/2018,96,23:45,0:00,,34.52,0,34.52,34.52,-1,-63646,95554,159200,31908,0,-15750,0,0,0,,15750,-15750
26,06/26/2018,1,0:00,0:15,56.1,21.7,0,56.1,21.7,2,-47266,66206,113472,18940,0,-11236,1372,0,0,,12608,-9864
26,06/26/2018,2,0:15,0:30,90.89,41.52,0,90.89,40.56,2,-55747,39737,95484,-16010,0,-294,21632,0,0,,21926,21338
26,06/26/2018,3,0:30,0:45,90.89,33.46,0,33.46,33.46,-1,-48925,69000,117925,20075,0,-11995,1162,0,0,,13157,-10833
26,06/26/2018,4,0:45,1:00,,33.06,0,33.06,33.06,-1,-47588,96468,144056,48880,0,-24711,0,0,0,,24711,-24711
26,06/26/2018,5,1:00,1:15,152.12,35.05,0,152.12,152.12,1,-64257,19636,83893,-44621,0,-19786,7750,0,0,,27536,-12036
26,06/26/2018,6,1:15,1:30,45.46,35.05,0,45.46,45.46,1,-47332,21206,68538,-26126,0,-400,8291,0,0,,8691,7891
26,06/26/2018,7,1:30,1:45,,,0,42.03,42.03,0,-43340,32311,75651,-11029,0,0,0,0,0,,0,0
26,06/26/2018,8,1:45,2:00,,,0,42.05,42.05,0,-47027,48840,95867,1813,0,0,0,0,0,,0,0
26,06/26/2018,9,2:00,2:15,56.64,,0,56.64,56.64,1,-68670,30154,98824,-38516,0,0,10128,0,0,,10128,10128
26,06/26/2018,10,2:15,2:30,49.12,,0,49.12,49.12,1,-60698,26406,87104,-34292,0,0,28532,0,0,,28532,28532
26,06/26/2018,11,2:30,2:45,49.12,38.78,0,38.78,38.78,-1,-41259,37784,79043,-3475,0,-511,8160,0,0,,8671,7649
26,06/26/2018,12,2:45,3:00,,,0,42.02,42.02,0,-31350,43390,74740,12040,0,0,0,0,0,,0,0
26,06/26/2018,13,3:00,3:15,,,0,42.1,42.1,0,-36214,35340,71554,-874,0,0,0,0,0,,0,0
26,06/26/2018,14,3:15,3:30,,,0,42.1,42.1,0,-33120,41573,74693,8453,0,0,0,0,0,,0,0
26,06/26/2018,15,3:30,3:45,,,0,42.1,42.1,0,-35932,45322,81254,9390,0,0,0,0,0,,0,0
26,06/26/2018,16,3:45,4:00,,,0,42.09,42.09,0,-38739,45352,84091,6613,0,0,0,0,0,,0,0
26,06/26/2018,17,4:00,4:15,,,0,42.19,42.19,0,-37176,53736,90912,16560,0,0,0,0,0,,0,0
26,06/26/2018,18,4:15,4:30,,,0,42.19,42.19,0,-38567,43395,81962,4828,0,0,0,0,0,,0,0
26,06/26/2018,19,4:30,4:45,,,0,42.18,42.18,0,-35710,38547,74257,2837,0,0,0,0,0,,0,0
26,06/26/2018,20,4:45,5:00,,,0,42.18,42.18,0,-32792,44070,76862,11278,0,0,0,0,0,,0,0
26,06/26/2018,21,5:00,5:15,41.46,,0,41.46,41.46,1,-50691,45647,96338,-5044,0,0,253,0,0,,253,253
26,06/26/2018,22,5:15,5:30,41.46,36.78,0,42.25,36.78,2,-37569,54856,92425,17287,0,-4397,195,0,0,,4592,-4202
26,06/26/2018,23,5:30,5:45,,37.46,0,37.46,37.46,-1,-50942,37264,88206,-13678,0,-3584,0,0,0,,3584,-3584
26,06/26/2018,24,5:45,6:00,,37.46,0,37.46,37.46,-1,-34126,31878,66004,-2248,0,-318,0,0,0,,318,-318
26,06/26/2018,25,6:00,6:15,,37.12,0,37.12,37.12,-1,-92938,118807,211745,25869,0,-2562,0,0,0,,2562,-2562
26,06/26/2018,26,6:15,6:30,,33.17,0,33.17,33.17,-1,-65432,83632,149064,18200,0,-15667,0,0,0,,15667,-15667
26,06/26/2018,27,6:30,6:45,41.12,33.17,0,41.12,41.12,1,-71528,23302,94830,-48226,0,-1542,924,0,0,,2466,-618
26,06/26/2018,28,6:45,7:00,240.14,,0,240.14,240.14,1,-106297,15129,121426,-91168,0,0,28098,0,0,,28098,28098
26,06/26/2018,29,7:00,7:15,45.39,-21.42,0,50.69,-21.42,2,-52747,160699,213446,107952,0,-23316,9644,0,0,,32960,-13672
26,06/26/2018,30,7:15,7:30,,39.78,0,39.78,39.78,-1,-29174,96049,125223,66875,0,-9374,0,0,0,,9374,-9374
26,06/26/2018,31,7:30,7:45,,,0,50.63,50.63,0,-33056,54741,87797,21685,0,-153,0,0,0,,153,-153
26,06/26/2018,32,7:45,8:00,,,0,50.61,50.61,0,-60448,66905,127353,6457,0,0,0,0,0,,0,0
26,06/26/2018,33,8:00,8:15,,,0,50.69,50.69,0,-11277,119915,131192,108638,0,0,0,0,0,,0,0
26,06/26/2018,34,8:15,8:30,,,0,50.69,50.69,0,-22076,118304,140380,96228,0,0,0,0,0,,0,0
26,06/26/2018,35,8:30,8:45,,,0,50.64,50.64,0,-25787,139857,165644,114070,0,0,0,0,0,,0,0
26,06/26/2018,36,8:45,9:00,,,0,50.6,50.6,0,-28177,116734,144911,88557,0,0,0,0,0,,0,0
26,06/26/2018,37,9:00,9:15,,,0,50.67,50.67,0,-38972,70126,109098,31154,0,0,0,0,0,,0,0
26,06/26/2018,38,9:15,9:30,,,0,50.67,50.67,0,-44383,89583,133966,45200,0,0,0,0,0,,0,0
26,06/26/2018,39,9:30,9:45,,60.26,0,60.26,60.26,-1,-32748,110830,143578,78082,0,-8,0,0,0,,8,-8
26,06/26/2018,40,9:45,10:00,,33.12,0,33.12,33.12,-1,-26973,152593,179566,125620,0,-14433,0,0,0,,14433,-14433
26,06/26/2018,41,10:00,10:15,45.12,33.12,0,45.12,45.12,1,-51406,42394,93800,-9012,0,-2410,380,0,0,,2790,-2030
26,06/26/2018,42,10:15,10:30,,,0,50.71,50.71,0,-38170,59139,97309,20969,0,0,0,0,0,,0,0
26,06/26/2018,43,10:30,10:45,,,0,50.71,50.71,0,-34993,76197,111190,41204,0,0,0,0,0,,0,0
26,06/26/2018,44,10:45,11:00,,38.78,0,38.78,38.78,-1,-28893,102175,131068,73282,0,-3268,0,0,0,,3268,-3268
26,06/26/2018,45,11:00,11:15,,37.12,0,37.12,37.12,-1,-38766,60198,98964,21432,0,-6118,0,0,0,,6118,-6118
26,06/26/2018,46,11:15,11:30,,38.41,0,38.41,38.41,-1,-41484,74084,115568,32600,0,-15279,0,0,0,,15279,-15279
26,06/26/2018,47,11:30,11:45,,40.22,0,40.22,40.22,-1,-47055,96484,143539,49429,0,-10692,0,0,0,,10692,-10692
26,06/26/2018,48,11:45,12:00,,37.12,0,37.12,37.12,-1,-37101,104786,141887,67685,0,-3644,0,0,0,,3644,-3644
26,06/26/2018,49,12:00,12:15,,37.12,0,37.12,37.12,-1,-59466,61868,121334,2402,0,-3982,0,0,0,,3982,-3982
26,06/26/2018,50,12:15,12:30,,33.12,0,33.12,33.12,-1,-50033,79936,129969,29903,0,-2572,0,0,0,,2572,-2572
26,06/26/2018,51,12:30,12:45,,29.12,0,29.12,29.12,-1,-51170,108335,159505,57165,0,-9551,0,0,0,,9551,-9551
26,06/26/2018,52,12:45,13:00,,42,0,42,42,-1,-42996,97109,140105,54113,0,-2472,0,0,0,,2472,-2472
26,06/26/2018,53,13:00,13:15,,60.61,0,60.61,60.61,-1,-46888,96253,143141,49365,0,-486,0,0,0,,486,-486
26,06/26/2018,54,13:15,13:30,,40.5,0,40.5,40.5,-1,-45377,84084,129461,38707,0,-2348,0,0,0,,2348,-2348
26,06/26/2018,55,13:30,13:45,,38.87,0,38.87,38.87,-1,-50173,77565,127738,27392,0,-1827,0,0,0,,1827,-1827
26,06/26/2018,56,13:45,14:00,,29.12,0,29.12,29.12,-1,-59267,90697,149964,31430,0,-20539,0,0,0,,20539,-20539
26,06/26/2018,57,14:00,14:15,,39,0,39,39,-1,-57042,110024,167066,52982,0,-10272,0,0,0,,10272,-10272
26,06/26/2018,58,14:15,14:30,,,0,50.86,50.86,0,-60523,110761,171284,50238,0,-218,0,0,0,,218,-218
26,06/26/2018,59,14:30,14:45,,27.78,0,27.78,27.78,-1,-57937,123434,181371,65497,0,-8177,0,0,0,,8177,-8177
26,06/26/2018,60,14:45,15:00,,39,0,39,39,-1,-61484,110232,171716,48748,0,-14794,0,0,0,,14794,-14794
26,06/26/2018,61,15:00,15:15,,40.49,0,40.49,40.49,-1,-29864,93964,123828,64100,0,-8511,0,0,0,,8511,-8511
26,06/26/2018,62,15:15,15:30,,,0,50.73,50.73,0,-37706,90606,128312,52900,0,-75,0,0,0,,75,-75
26,06/26/2018,63,15:30,15:45,,,0,50.73,50.73,0,-44204,76925,121129,32721,0,0,0,0,0,,0,0
26,06/26/2018,64,15:45,16:00,,,0,50.74,50.74,0,-48536,62227,110763,13691,0,0,0,0,0,,0,0
26,06/26/2018,65,16:00,16:15,,,0,50.72,50.72,0,-35506,106523,142029,71017,0,0,0,0,0,,0,0
26,06/26/2018,66,16:15,16:30,,,0,50.72,50.72,0,-32439,97561,130000,65122,0,0,0,0,0,,0,0
26,06/26/2018,67,16:30,16:45,,,0,50.72,50.72,0,-29704,85804,115508,56100,0,0,0,0,0,,0,0
26,06/26/2018,68,16:45,17:00,,,0,42.85,42.85,0,-35584,57495,93079,21911,0,0,0,0,0,,0,0
26,06/26/2018,69,17:00,17:15,,43.57,0,43.57,43.57,-1,-18871,94054,112925,75183,0,-411,0,0,0,,411,-411
26,06/26/2018,70,17:15,17:30,,37.12,0,37.12,37.12,-1,-28266,98070,126336,69804,0,-5551,0,0,0,,5551,-5551
26,06/26/2018,71,17:30,17:45,,44.99,0,44.99,44.99,-1,-35060,82269,117329,47209,0,-1204,0,0,0,,1204,-1204
26,06/26/2018,72,17:45,18:00,,,0,42.02,42.02,0,-42248,64389,106637,22141,0,0,0,0,0,,0,0
26,06/26/2018,73,18:00,18:15,41.12,,0,41.12,41.12,1,-116879,37465,154344,-79414,0,0,807,0,0,,807,807
26,06/26/2018,74,18:15,18:30,45.65,,0,45.65,45.65,1,-109791,52611,162402,-57180,0,0,3329,0,0,,3329,3329
26,06/26/2018,75,18:30,18:45,59.65,,0,59.65,59.65,1,-121811,50508,172319,-71303,0,0,23730,0,0,,23730,23730
26,06/26/2018,76,18:45,19:00,56.17,,0,56.17,56.17,1,-97903,45343,143246,-52560,0,0,17803,0,0,,17803,17803
26,06/26/2018,77,19:00,19:15,54.37,,0,54.37,54.37,1,-82015,42616,124631,-39399,0,0,23286,0,0,,23286,23286
26,06/26/2018,78,19:15,19:30,49.12,,0,49.12,49.12,1,-95457,41501,136958,-53956,0,0,29433,0,0,,29433,29433
26,06/26/2018,79,19:30,19:45,45.12,,0,45.12,45.12,1,-93944,45644,139588,-48300,0,0,8211,0,0,,8211,8211
26,06/26/2018,80,19:45,20:00,49.12,,0,49.12,49.12,1,-104666,28902,133568,-75764,0,0,17414,0,0,,17414,17414
26,06/26/2018,81,20:00,20:15,49.12,,0,49.12,49.12,1,-75744,44182,119926,-31562,0,0,29748,0,0,,29748,29748
26,06/26/2018,82,20:15,20:30,46.45,,0,46.45,46.45,1,-72976,42623,115599,-30353,0,0,21617,0,0,,21617,21617
26,06/26/2018,83,20:30,20:45,41.12,,0,41.12,41.12,1,-65330,56612,121942,-8718,0,0,2563,0,0,,2563,2563
26,06/26/2018,84,20:45,21:00,41.12,,0,41.12,41.12,1,-67825,49118,116943,-18707,0,0,948,0,0,,948,948
26,06/26/2018,85,21:00,21:15,56,,0,56,56,1,-65085,34609,99694,-30476,0,0,8584,0,0,,8584,8584
26,06/26/2018,86,21:15,21:30,41.12,,0,41.12,41.12,1,-39479,39968,79447,489,0,0,3724,0,0,,3724,3724
26,06/26/2018,87,21:30,21:45,41.12,40.66,0,40.66,40.66,-1,-45735,54207,99942,8472,0,-1875,130,0,0,,2005,-1745
26,06/26/2018,88,21:45,22:00,,37.12,0,37.12,37.12,-1,-37016,65686,102702,28670,0,-25243,0,0,0,,25243,-25243
26,06/26/2018,89,22:00,22:15,45.12,39.21,0,45.12,45.12,1,-48776,45424,94200,-3352,0,-19211,536,0,0,,19747,-18675
26,06/26/2018,90,22:15,22:30,56,39.21,0,56,56,1,-63741,24839,88580,-38902,0,-358,19353,0,0,,19711,18995
26,06/26/2018,91,22:30,22:45,47.69,,0,47.69,47.69,1,-64328,25569,89897,-38759,0,0,26767,0,0,,26767,26767
26,06/26/2018,92,22:45,23:00,47.42,,0,47.42,47.42,1,-54662,39023,93685,-15639,0,0,25097,0,0,,25097,25097
26,06/26/2018,93,23:00,23:15,63.3,,0,63.3,63.3,1,-55424,15207,70631,-40217,0,0,18336,0,0,,18336,18336
26,06/26/2018,94,23:15,23:30,56,,0,56,56,1,-54322,17863,72185,-36459,0,0,33336,0,0,,33336,33336
26,06/26/2018,95,23:30,23:45,42.97,41.35,0,41.35,41.35,-1,-46177,42230,88407,-3947,0,-492,13417,0,0,,13909,12925
26,06/26/2018,96,23:45,0:00,41.12,45.09,0,41.95,41.95,2,-63016,76961,139977,13945,0,-39,197,0,0,,236,158
26,06/27/2018,1,0:00,0:15,61.25,34.17,0,61.25,26.76,2,-106254,78430,184684,-27824,0,-2580,2091,0,0,,4671,-489
26,06/27/2018,2,0:15,0:30,87.02,,0,87.02,87.02,1,-61809,43029,104838,-18780,0,0,16782,0,0,,16782,16782
26,06/27/2018,3,0:30,0:45,87.02,39.86,0,39.86,39.86,-1,-62978,61975,124953,-1003,0,-501,661,0,0,,1162,160
26,06/27/2018,4,0:45,1:00,,35.03,0,35.03,35.03,-1,-55554,69282,124836,13728,0,-8331,0,0,0,,8331,-8331
26,06/27/2018,5,1:00,1:15,,31.77,0,31.77,31.77,-1,-18050,69339,87389,51289,0,-7177,0,0,0,,7177,-7177
26,06/27/2018,6,1:15,1:30,,43.57,0,43.57,43.57,-1,-16241,56559,72800,40318,0,-169,0,0,0,,169,-169
26,06/27/2018,7,1:30,1:45,,43.6,0,43.6,43.6,-1,-66658,65486,132144,-1172,0,-100,0,0,0,,100,-100
26,06/27/2018,8,1:45,2:00,,43.31,0,43.31,43.31,-1,-59054,60126,119180,1072,0,-35,0,0,0,,35,-35
26,06/27/2018,9,2:00,2:15,,40.17,0,40.17,40.17,-1,-32019,38044,70063,6025,0,-822,0,0,0,,822,-822
26,06/27/2018,10,2:15,2:30,,,0,40.51,40.51,0,-25870,41753,67623,15883,0,-3,0,0,0,,3,-3
26,06/27/2018,11,2:30,2:45,,43.62,0,43.62,43.62,-1,-27187,51605,78792,24418,0,-188,0,0,0,,188,-188
26,06/27/2018,12,2:45,3:00,,38.17,0,38.17,38.17,-1,-18422,54603,73025,36181,0,-1362,0,0,0,,1362,-1362
26,06/27/2018,13,3:00,3:15,,43.25,0,43.25,43.25,-1,-33609,37011,70620,3402,0,-1940,0,0,0,,1940,-1940
26,06/27/2018,14,3:15,3:30,,40.4,0,40.4,40.4,-1,-31399,40941,72340,9542,0,-712,0,0,0,,712,-712
26,06/27/2018,15,3:30,3:45,,,0,40.51,40.51,0,-20162,40670,60832,20508,0,-80,0,0,0,,80,-80
26,06/27/2018,16,3:45,4:00,,43.73,0,43.73,43.73,-1,-16828,40798,57626,23970,0,-228,0,0,0,,228,-228
26,06/27/2018,17,4:00,4:15,,38.17,0,38.17,38.17,-1,-21366,29120,50486,7754,0,-2420,0,0,0,,2420,-2420
26,06/27/2018,18,4:15,4:30,,38.17,0,38.17,38.17,-1,-26438,31780,58218,5342,0,-4297,0,0,0,,4297,-4297
26,06/27/2018,19,4:30,4:45,,43.82,0,43.82,43.82,-1,-23769,31573,55342,7804,0,-346,0,0,0,,346,-346
26,06/27/2018,20,4:45,5:00,,43.81,0,43.81,43.81,-1,-18083,36644,54727,18561,0,-868,0,0,0,,868,-868
26,06/27/2018,21,5:00,5:15,,40.69,0,40.69,40.69,-1,-35017,45145,80162,10128,0,-358,0,0,0,,358,-358
26,06/27/2018,22,5:15,5:30,,39.49,0,39.49,39.49,-1,-19768,43992,63760,24224,0,-2241,0,0,0,,2241,-2241
26,06/27/2018,23,5:30,5:45,,37.05,0,37.05,37.05,-1,-37822,28617,66439,-9205,0,-5026,0,0,0,,5026,-5026
26,06/27/2018,24,5:45,6:00,,38.45,0,38.45,38.45,-1,-35178,22116,57294,-13062,0,-839,0,0,0,,839,-839
26,06/27/2018,25,6:00,6:15,,28.03,0,28.03,28.03,-1,-34224,86934,121158,52710,0,-19973,0,0,0,,19973,-19973
26,06/27/2018,26,6:15,6:30,,37.95,0,37.95,37.95,-1,-30144,47209,77353,17065,0,-13265,0,0,0,,13265,-13265
26,06/27/2018,27,6:30,6:45,45.98,37.95,0,45.98,37.95,2,-27574,25128,52702,-2446,0,-1192,732,0,0,,1924,-460
26,06/27/2018,28,6:45,7:00,114.95,,0,114.95,114.95,1,-71106,35910,107016,-35196,0,0,25861,0,0,,25861,25861
26,06/27/2018,29,7:00,7:15,114.95,8.49,0,8.49,8.49,-1,-42766,111375,154141,68609,0,-9844,7754,0,0,,17598,-2090
26,06/27/2018,30,7:15,7:30,,44.75,0,44.75,44.75,-1,-28695,72680,101375,43985,0,-1094,0,0,0,,1094,-1094
26,06/27/2018,31,7:30,7:45,,,0,43.72,43.72,0,-36491,52022,88513,15531,0,0,0,0,0,,0,0
26,06/27/2018,32,7:45,8:00,48,,0,48,48,1,-68660,53157,121817,-15503,0,0,3009,0,0,,3009,3009
26,06/27/2018,33,8:00,8:15,42.83,,0,42.83,42.83,1,-15659,87033,102692,71374,0,0,669,0,0,,669,669
26,06/27/2018,34,8:15,8:30,,,0,43.73,43.73,0,-14321,87958,102279,73637,0,0,0,0,0,,0,0
26,06/27/2018,35,8:30,8:45,,,0,43.71,43.71,0,-19526,64295,83821,44769,0,0,0,0,0,,0,0
26,06/27/2018,36,8:45,9:00,,,0,43.69,43.69,0,-33451,57930,91381,24479,0,0,0,0,0,,0,0
26,06/27/2018,37,9:00,9:15,,29.29,0,29.29,29.29,-1,-25787,75185,100972,49398,0,-4669,0,0,0,,4669,-4669
26,06/27/2018,38,9:15,9:30,,12.24,0,12.24,12.24,-1,-36114,66115,102229,30001,0,-30302,0,0,0,,30302,-30302
26,06/27/2018,39,9:30,9:45,,29.95,0,29.95,29.95,-1,-34252,74665,108917,40413,0,-19088,0,0,0,,19088,-19088
26,06/27/2018,40,9:45,10:00,,29.94,0,29.94,29.94,-1,-34233,74602,108835,40369,0,-29192,0,0,0,,29192,-29192
26,06/27/2018,41,10:00,10:15,49.22,38.72,0,49.22,38.72,2,-41830,35218,77048,-6612,0,-12250,2079,0,0,,14329,-10171
26,06/27/2018,42,10:15,10:30,,,0,42.16,42.16,0,-19440,39984,59424,20544,0,0,8,0,0,,8,8
26,06/27/2018,43,10:30,10:45,,,0,42.14,42.14,0,-12617,60854,73471,48237,0,0,0,0,0,,0,0
26,06/27/2018,44,10:45,11:00,,,0,42.14,42.14,0,-12672,65371,78043,52699,0,0,0,0,0,,0,0
26,06/27/2018,45,11:00,11:15,,34.99,0,34.99,34.99,-1,-18410,46041,64451,27631,0,-8722,0,0,0,,8722,-8722
26,06/27/2018,46,11:15,11:30,,33.95,0,33.95,33.95,-1,-14555,60614,75169,46059,0,-25949,0,0,0,,25949,-25949
26,06/27/2018,47,11:30,11:45,,35.02,0,35.02,35.02,-1,-14661,75320,89981,60659,0,-28401,0,0,0,,28401,-28401
26,06/27/2018,48,11:45,12:00,,38.59,0,38.59,38.59,-1,-19224,80032,99256,60808,0,-20497,0,0,0,,20497,-20497
26,06/27/2018,49,12:00,12:15,,41.47,0,41.47,41.47,-1,-25263,88391,113654,63128,0,-5771,0,0,0,,5771,-5771
26,06/27/2018,50,12:15,12:30,,34.99,0,34.99,34.99,-1,-23203,103679,126882,80476,0,-5754,0,0,0,,5754,-5754
26,06/27/2018,51,12:30,12:45,,36.06,0,36.06,36.06,-1,-22702,106930,129632,84228,0,-7554,0,0,0,,7554,-7554
26,06/27/2018,52,12:45,13:00,,13.92,0,13.92,13.92,-1,-18579,114236,132815,95657,0,-16971,0,0,0,,16971,-16971
26,06/27/2018,53,13:00,13:15,,37.95,0,37.95,37.95,-1,-36399,104248,140647,67849,0,-10154,0,0,0,,10154,-10154
26,06/27/2018,54,13:15,13:30,,40.27,0,40.27,40.27,-1,-32522,102544,135066,70022,0,-1024,0,0,0,,1024,-1024
26,06/27/2018,55,13:30,13:45,,37.95,0,37.95,37.95,-1,-41384,95906,137290,54522,0,-1734,0,0,0,,1734,-1734
26,06/27/2018,56,13:45,14:00,,40.71,0,40.71,40.71,-1,-33246,102210,135456,68964,0,-2065,0,0,0,,2065,-2065
26,06/27/2018,57,14:00,14:15,,,0,40.8,40.8,0,-37037,130535,167572,93498,0,-464,0,0,0,,464,-464
26,06/27/2018,58,14:15,14:30,,,0,40.8,40.8,0,-40434,133972,174406,93538,0,0,0,0,0,,0,0
26,06/27/2018,59,14:30,14:45,,,0,40.79,40.79,0,-41933,134890,176823,92957,0,0,0,0,0,,0,0
26,06/27/2018,60,14:45,15:00,,35.85,0,35.85,35.85,-1,-44752,128587,173339,83835,0,-2017,0,0,0,,2017,-2017
26,06/27/2018,61,15:00,15:15,,42,0,42,42,-1,-34081,125117,159198,91036,0,-793,0,0,0,,793,-793
26,06/27/2018,62,15:15,15:30,,40.56,0,40.56,40.56,-1,-37008,112730,149738,75722,0,-68,0,0,0,,68,-68
26,06/27/2018,63,15:30,15:45,,,0,40.61,40.61,0,-44726,107128,151854,62402,0,0,0,0,0,,0,0
26,06/27/2018,64,15:45,16:00,,,0,40.64,40.64,0,-43512,103037,146549,59525,0,0,0,0,0,,0,0
26,06/27/2018,65,16:00,16:15,,37.95,0,37.95,37.95,-1,-47415,104316,151731,56901,0,-1066,0,0,0,,1066,-1066
26,06/27/2018,66,16:15,16:30,,36.69,0,36.69,36.69,-1,-53259,86260,139519,33001,0,-6461,0,0,0,,6461,-6461
26,06/27/2018,67,16:30,16:45,,,0,40.48,40.48,0,-55673,81105,136778,25432,0,-270,0,0,0,,270,-270
26,06/27/2018,68,16:45,17:00,46.15,,0,46.15,46.15,1,-77378,71005,148383,-6373,0,0,396,0,0,,396,396
26,06/27/2018,69,17:00,17:15,,39.49,0,39.49,39.49,-1,-30501,71053,101554,40552,0,-2453,0,0,0,,2453,-2453
26,06/27/2018,70,17:15,17:30,,40.93,0,40.93,40.93,-1,-45948,52764,98712,6816,0,-4300,0,0,0,,4300,-4300
26,06/27/2018,71,17:30,17:45,,40.27,0,40.27,40.27,-1,-52800,61797,114597,8997,0,-3881,0,0,0,,3881,-3881
26,06/27/2018,72,17:45,18:00,,35.69,0,35.69,35.69,-1,-51196,73845,125041,22649,0,-7703,0,0,0,,7703,-7703
26,06/27/2018,73,18:00,18:15,,41.94,0,41.94,41.94,-1,-85276,43032,128308,-42244,0,-3485,0,0,0,,3485,-3485
26,06/27/2018,74,18:15,18:30,,40.93,0,40.93,40.93,-1,-46499,57736,104235,11237,0,-408,0,0,0,,408,-408
26,06/27/2018,75,18:30,18:45,,35.69,0,35.69,35.69,-1,-47721,79222,126943,31501,0,-7243,0,0,0,,7243,-7243
26,06/27/2018,76,18:45,19:00,,40.27,0,40.27,40.27,-1,-51946,80792,132738,28846,0,-2750,0,0,0,,2750,-2750
26,06/27/2018,77,19:00,19:15,,42.33,0,42.33,42.33,-1,-51176,29003,80179,-22173,0,-247,0,0,0,,247,-247
26,06/27/2018,78,19:15,19:30,47.19,,0,47.19,47.19,1,-66236,27202,93438,-39034,0,0,892,0,0,,892,892
26,06/27/2018,79,19:30,19:45,52,,0,52,52,1,-65312,30741,96053,-34571,0,0,12059,0,0,,12059,12059
26,06/27/2018,80,19:45,20:00,42.83,,0,42.83,42.83,1,-66521,25940,92461,-40581,0,0,7309,0,0,,7309,7309
26,06/27/2018,81,20:00,20:15,52,,0,52,52,1,-49897,17134,67031,-32763,0,0,14407,0,0,,14407,14407
26,06/27/2018,82,20:15,20:30,52,,0,52,52,1,-44081,22274,66355,-21807,0,0,26583,0,0,,26583,26583
26,06/27/2018,83,20:30,20:45,52,41.47,0,41.47,41.47,-1,-43039,40615,83654,-2424,0,-289,4192,0,0,,4481,3903
26,06/27/2018,84,20:45,21:00,,,0,40.98,40.98,0,-77141,46921,124062,-30220,0,0,0,0,0,,0,0
26,06/27/2018,85,21:00,21:15,51.11,,0,51.11,51.11,1,-52624,29505,82129,-23119,0,0,7111,0,0,,7111,7111
26,06/27/2018,86,21:15,21:30,38.09,,0,38.09,38.09,1,-41644,43816,85460,2172,0,0,630,0,0,,630,630
26,06/27/2018,87,21:30,21:45,,39.48,0,39.48,39.48,-1,-31724,62036,93760,30312,0,-253,0,0,0,,253,-253
26,06/27/2018,88,21:45,22:00,,27.45,0,27.45,27.45,-1,-34533,68601,103134,34068,0,-31460,0,0,0,,31460,-31460
26,06/27/2018,89,22:00,22:15,80.81,37.95,0,80.81,37.95,2,-58454,31698,90152,-26756,0,-15995,2553,0,0,,18548,-13442
26,06/27/2018,90,22:15,22:30,53.87,,0,53.87,53.87,1,-64904,35089,99993,-29815,0,0,7780,0,0,,7780,7780
26,06/27/2018,91,22:30,22:45,46.41,,0,46.41,46.41,1,-48810,45362,94172,-3448,0,0,12752,0,0,,12752,12752
26,06/27/2018,92,22:45,23:00,46.41,33.95,0,33.95,33.95,-1,-41096,66983,108079,25887,0,-9190,382,0,0,,9572,-8808
26,06/27/2018,93,23:00,23:15,,31.02,0,31.02,31.02,-1,-73037,85413,158450,12376,0,-12992,0,0,0,,12992,-12992
26,06/27/2018,94,23:15,23:30,,37.95,0,37.95,37.95,-1,-49874,64967,114841,15093,0,-1374,0,0,0,,1374,-1374
26,06/27/2018,95,23:30,23:45,,-10.14,0,-10.14,-10.14,-1,-31194,90348,121542,59154,0,-11033,0,0,0,,11033,-11033
26,06/27/2018,96,23:45,0:00,,-150.03,0,-150.03,-150.03,-1,-59494,95460,154954,35966,0,-54210,0,0,0,,54210,-54210
26,06/28/2018,1,0:00,0:15,,-60.68,0,-60.68,-60.68,-1,-60270,103518,163788,43248,0,-38336,0,0,0,,38336,-38336
26,06/28/2018,2,0:15,0:30,45.95,-60.68,0,45.95,45.95,1,-89978,41173,131151,-48805,0,-4492,1970,0,0,,6462,-2522
26,06/28/2018,3,0:30,0:45,42.77,,0,42.77,42.77,1,-84833,60379,145212,-24454,0,0,2645,0,0,,2645,2645
26,06/28/2018,4,0:45,1:00,42.77,33.95,0,33.95,33.95,-1,-54799,88019,142818,33220,0,-6704,103,0,0,,6807,-6601
26,06/28/2018,5,1:00,1:15,50.71,33.95,0,50.71,33.95,2,-55225,28015,83240,-27210,0,-12308,1492,0,0,,13800,-10816
26,06/28/2018,6,1:15,1:30,50.07,37.95,0,50.07,37.95,2,-46620,46572,93192,-48,0,-634,3879,0,0,,4513,3245
26,06/28/2018,7,1:30,1:45,,36.78,0,36.78,36.78,-1,-50995,52922,103917,1927,0,-2290,0,0,0,,2290,-2290
26,06/28/2018,8,1:45,2:00,,36.78,0,36.78,36.78,-1,-53994,66971,120965,12977,0,-6267,0,0,0,,6267,-6267
26,06/28/2018,9,2:00,2:15,52,40.78,0,52,39.37,2,-53296,32264,85560,-21032,0,-2827,5364,0,0,,8191,2537
26,06/28/2018,10,2:15,2:30,41.95,,0,41.95,41.95,1,-55829,44840,100669,-10989,0,0,5034,0,0,,5034,5034
26,06/28/2018,11,2:30,2:45,,,0,39.37,39.37,0,-57524,49932,107456,-7592,0,0,339,0,0,,339,339
26,06/28/2018,12,2:45,3:00,,,0,39.37,39.37,0,-51942,46254,98196,-5688,0,0,0,0,0,,0,0
26,06/28/2018,13,3:00,3:15,42.99,,0,42.99,42.99,1,-41880,36204,78084,-5676,0,0,1105,0,0,,1105,1105
26,06/28/2018,14,3:15,3:30,,,0,39.39,39.39,0,-38270,44412,82682,6142,0,0,12,0,0,,12,12
26,06/28/2018,15,3:30,3:45,,,0,39.39,39.39,0,-37083,43497,80580,6414,0,0,0,0,0,,0,0
26,06/28/2018,16,3:45,4:00,41.95,,0,41.95,41.95,1,-41407,34473,75880,-6934,0,0,663,0,0,,663,663
26,06/28/2018,17,4:00,4:15,36.03,,0,36.03,36.03,1,-31143,39602,70745,8459,0,0,272,0,0,,272,272
26,06/28/2018,18,4:15,4:30,36.04,,0,36.04,36.04,1,-35246,39572,74818,4326,0,0,142,0,0,,142,142
26,06/28/2018,19,4:30,4:45,41.95,,0,41.95,41.95,1,-35291,36924,72215,1633,0,0,1430,0,0,,1430,1430
26,06/28/2018,20,4:45,5:00,,,0,39.42,39.42,0,-33969,39667,73636,5698,0,0,0,0,0,,0,0
26,06/28/2018,21,5:00,5:15,42.54,,0,42.54,42.54,1,-41701,39964,81665,-1737,0,0,1151,0,0,,1151,1151
26,06/28/2018,22,5:15,5:30,,,0,39.42,39.42,0,-31912,45299,77211,13387,0,0,0,0,0,,0,0
26,06/28/2018,23,5:30,5:45,,42.78,0,42.78,42.78,-1,-32673,50183,82856,17510,0,-150,0,0,0,,150,-150
26,06/28/2018,24,5:45,6:00,,35.36,0,35.36,35.36,-1,-47601,86584,134185,38983,0,-2516,0,0,0,,2516,-2516
26,06/28/2018,25,6:00,6:15,,38.4,0,38.4,38.4,-1,-50821,55700,106521,4879,0,-8509,0,0,0,,8509,-8509
26,06/28/2018,26,6:15,6:30,,38.57,0,38.57,38.57,-1,-34326,56871,91197,22545,0,-13977,0,0,0,,13977,-13977
26,06/28/2018,27,6:30,6:45,47.66,40.78,0,47.66,47.66,1,-35542,28616,64158,-6926,0,-5676,1150,0,0,,6826,-4526
26,06/28/2018,28,6:45,7:00,60.12,40.78,0,60.12,60.12,1,-63449,25567,89016,-37882,0,-34,17220,0,0,,17254,17186
26,06/28/2018,29,7:00,7:15,42.57,38.75,0,43.58,38.75,2,-68741,99898,168639,31157,0,-1711,8228,0,0,,9939,6517
26,06/28/2018,30,7:15,7:30,,,0,43.19,43.19,0,-33493,66378,99871,32885,0,0,0,0,0,,0,0
26,06/28/2018,31,7:30,7:45,62.59,,0,62.59,62.59,1,-43748,26491,70239,-17257,0,0,2046,0,0,,2046,2046
26,06/28/2018,32,7:45,8:00,275.37,,0,275.37,275.37,1,-68943,30277,99220,-38666,0,0,36647,0,0,,36647,36647
26,06/28/2018,33,8:00,8:15,42.57,41,0,43.41,41,2,-11484,106907,118391,95423,0,-582,8689,0,0,,9271,8107
26,06/28/2018,34,8:15,8:30,,,0,43.41,43.41,0,-9141,77619,86760,68478,0,0,0,0,0,,0,0
26,06/28/2018,35,8:30,8:45,,,0,43.42,43.42,0,-26397,50398,76795,24001,0,0,0,0,0,,0,0
26,06/28/2018,36,8:45,9:00,,43.78,0,43.78,43.78,-1,-37369,39958,77327,2589,0,-23,0,0,0,,23,-23
26,06/28/2018,37,9:00,9:15,,43.78,0,43.78,43.78,-1,-36189,52001,88190,15812,0,-118,0,0,0,,118,-118
26,06/28/2018,38,9:15,9:30,,,0,43.67,43.67,0,-19461,54130,73591,34669,0,0,0,0,0,,0,0
26,06/28/2018,39,9:30,9:45,,,0,43.65,43.65,0,-23600,49690,73290,26090,0,0,0,0,0,,0,0
26,06/28/2018,40,9:45,10:00,,45,0,45,45,-1,-21859,50424,72283,28565,0,-35,0,0,0,,35,-35
26,06/28/2018,41,10:00,10:15,250.26,,0,250.26,250.26,1,-93584,27817,121401,-65767,0,0,19963,0,0,,19963,19963
26,06/28/2018,42,10:15,10:30,50.57,,0,50.57,50.57,1,-44476,35164,79640,-9312,0,0,19010,0,0,,19010,19010
26,06/28/2018,43,10:30,10:45,,,0,43.46,43.46,0,-54897,44272,99169,-10625,0,0,506,0,0,,506,506
26,06/28/2018,44,10:45,11:00,,45,0,45,45,-1,-61919,55740,117659,-6179,0,-133,0,0,0,,133,-133
26,06/28/2018,45,11:00,11:15,,45,0,45,45,-1,-111598,26698,138296,-84900,0,-127,0,0,0,,127,-127
26,06/28/2018,46,11:15,11:30,,,0,43.39,43.39,0,-105838,31011,136849,-74827,0,0,0,0,0,,0,0
26,06/28/2018,47,11:30,11:45,,,0,43.38,43.38,0,-97878,29714,127592,-68164,0,0,0,0,0,,0,0
26,06/28/2018,48,11:45,12:00,,,0,43.38,43.38,0,-96495,33730,130225,-62765,0,0,0,0,0,,0,0
26,06/28/2018,49,12:00,12:15,,,0,43.24,43.24,0,-99917,32067,131984,-67850,0,0,0,0,0,,0,0
26,06/28/2018,50,12:15,12:30,,,0,43.24,43.24,0,-98218,40025,138243,-58193,0,0,0,0,0,,0,0
26,06/28/2018,51,12:30,12:45,,,0,43.24,43.24,0,-83367,47445,130812,-35922,0,0,0,0,0,,0,0
26,06/28/2018,52,12:45,13:00,,,0,43.23,43.23,0,-76150,43181,119331,-32969,0,0,0,0,0,,0,0
26,06/28/2018,53,13:00,13:15,62.12,,0,62.12,62.12,1,-72396,50254,122650,-22142,0,0,5709,0,0,,5709,5709
26,06/28/2018,54,13:15,13:30,46.12,,0,46.12,46.12,1,-78918,51333,130251,-27585,0,0,16459,0,0,,16459,16459
26,06/28/2018,55,13:30,13:45,46.57,,0,46.57,46.57,1,-81649,50638,132287,-31011,0,0,18546,0,0,,18546,18546
26,06/28/2018,56,13:45,14:00,46.36,,0,46.36,46.36,1,-81403,54469,135872,-26934,0,0,11530,0,0,,11530,11530
26,06/28/2018,57,14:00,14:15,58.92,,0,58.92,58.92,1,-79707,58486,138193,-21221,0,0,6537,0,0,,6537,6537
26,06/28/2018,58,14:15,14:30,47.46,,0,47.46,47.46,1,-74963,49566,124529,-25397,0,0,20722,0,0,,20722,20722
26,06/28/2018,59,14:30,14:45,46.57,,0,46.57,46.57,1,-70601,58034,128635,-12567,0,0,14808,0,0,,14808,14808
26,06/28/2018,60,14:45,15:00,,,0,43.93,43.93,0,-65608,57363,122971,-8245,0,0,777,0,0,,777,777
26,06/28/2018,61,15:00,15:15,,44.78,0,44.78,44.78,-1,-59351,52287,111638,-7064,0,-41,0,0,0,,41,-41
26,06/28/2018,62,15:15,15:30,,,0,43.39,43.39,0,-50324,41968,92292,-8356,0,0,0,0,0,,0,0
26,06/28/2018,63,15:30,15:45,,,0,43.38,43.38,0,-65548,44968,110516,-20580,0,0,0,0,0,,0,0
26,06/28/2018,64,15:45,16:00,,,0,43.38,43.38,0,-60995,53754,114749,-7241,0,0,0,0,0,,0,0
26,06/28/2018,65,16:00,16:15,44.36,,0,44.36,44.36,1,-54586,35553,90139,-19033,0,0,485,0,0,,485,485
26,06/28/2018,66,16:15,16:30,40.96,,0,40.96,40.96,1,-64116,32067,96183,-32049,0,0,457,0,0,,457,457
26,06/28/2018,67,16:30,16:45,44.04,,0,44.04,44.04,1,-53627,34071,87698,-19556,0,0,688,0,0,,688,688
26,06/28/2018,68,16:45,17:00,115.57,,0,115.57,115.57,1,-75795,34954,110749,-40841,0,0,13787,0,0,,13787,13787
26,06/28/2018,69,17:00,17:15,45.55,45,0,45,45,-1,-30686,54930,85616,24244,0,-11,8031,0,0,,8042,8020
26,06/28/2018,70,17:15,17:30,45.55,43.78,0,43.78,43.78,-1,-35939,51901,87840,15962,0,-302,23,0,0,,325,-279
26,06/28/2018,71,17:30,17:45,,,0,43.1,43.1,0,-40846,45647,86493,4801,0,0,0,0,0,,0,0
26,06/28/2018,72,17:45,18:00,,,0,43.1,43.1,0,-42686,59283,101969,16597,0,0,0,0,0,,0,0
26,06/28/2018,73,18:00,18:15,,45,0,45,45,-1,-41729,33729,75458,-8000,0,-25,0,0,0,,25,-25
26,06/28/2018,74,18:15,18:30,,41,0,41,41,-1,-32417,47764,80181,15347,0,-1444,0,0,0,,1444,-1444
26,06/28/2018,75,18:30,18:45,,38.2,0,38.2,38.2,-1,-39090,68199,107289,29109,0,-10147,0,0,0,,10147,-10147
26,06/28/2018,76,18:45,19:00,,40.48,0,40.48,40.48,-1,-44702,76178,120880,31476,0,-4898,0,0,0,,4898,-4898
26,06/28/2018,77,19:00,19:15,47.14,41,0,47.14,47.14,1,-47515,47256,94771,-259,0,-1494,2031,0,0,,3525,537
26,06/28/2018,78,19:15,19:30,47.99,,0,47.99,47.99,1,-47418,34983,82401,-12435,0,0,6648,0,0,,6648,6648
26,06/28/2018,79,19:30,19:45,47.53,,0,47.53,47.53,1,-50330,27056,77386,-23274,0,0,18632,0,0,,18632,18632
26,06/28/2018,80,19:45,20:00,48.5,,0,48.5,48.5,1,-74755,34228,108983,-40527,0,0,18367,0,0,,18367,18367
26,06/28/2018,81,20:00,20:15,233.35,,0,233.35,233.35,1,-97585,22968,120553,-74617,0,0,29642,0,0,,29642,29642
26,06/28/2018,82,20:15,20:30,233.35,,0,233.35,233.35,1,-95004,26760,121764,-68244,0,0,82190,0,0,,82190,82190
26,06/28/2018,83,20:30,20:45,42.43,38.57,0,38.57,38.57,-1,-36897,29520,66417,-7377,0,-11,23193,0,0,,23204,23182
26,06/28/2018,84,20:45,21:00,42.43,,0,42.43,42.43,1,-51539,28980,80519,-22559,0,0,1018,0,0,,1018,1018
26,06/28/2018,85,21:00,21:15,163.12,,0,163.12,163.12,1,-81506,32876,114382,-48630,0,0,17231,0,0,,17231,17231
26,06/28/2018,86,21:15,21:30,207.61,,0,207.61,207.61,1,-64997,32055,97052,-32942,0,0,43702,0,0,,43702,43702
26,06/28/2018,87,21:30,21:45,45.58,40.46,0,40.46,40.46,-1,-35452,35830,71282,378,0,-774,14215,0,0,,14989,13441
26,06/28/2018,88,21:45,22:00,37.17,40.46,0,37.17,37.17,1,-53130,44511,97641,-8619,0,-16,37,0,0,,53,21
26,06/28/2018,89,22:00,22:15,,35.78,0,35.78,35.78,-1,-24453,50939,75392,26486,0,-5049,0,0,0,,5049,-5049
26,06/28/2018,90,22:15,22:30,,40.76,0,40.76,40.76,-1,-42984,37266,80250,-5718,0,-7800,0,0,0,,7800,-7800
26,06/28/2018,91,22:30,22:45,,,0,41.09,41.09,0,-43164,32735,75899,-10429,0,-460,0,0,0,,460,-460
26,06/28/2018,92,22:45,23:00,,40.78,0,40.78,40.78,-1,-34946,54753,89699,19807,0,-1657,0,0,0,,1657,-1657
26,06/28/2018,93,23:00,23:15,213.44,,0,213.44,213.44,1,-122329,43457,165786,-78872,0,0,24825,0,0,,24825,24825
26,06/28/2018,94,23:15,23:30,73.12,,0,73.12,73.12,1,-75599,36018,111617,-39581,0,0,37979,0,0,,37979,37979
26,06/28/2018,95,23:30,23:45,,,0,41.36,41.36,0,-56284,42030,98314,-14254,0,0,1253,0,0,,1253,1253
26,06/28/2018,96,23:45,0:00,,41,0,41,41,-1,-63419,49618,113037,-13801,0,-133,0,0,0,,133,-133
26,06/29/2018,1,0:00,0:15,50.57,37.97,0,50.57,37.97,2,-34069,28940,63009,-5129,0,-661,3222,0,0,,3883,2561
26,06/29/2018,2,0:15,0:30,37.24,,0,37.24,37.24,1,-23326,29769,53095,6443,0,0,1122,0,0,,1122,1122
26,06/29/2018,3,0:30,0:45,37.14,,0,37.14,37.14,1,-44211,40613,84824,-3598,0,0,18,0,0,,18,18
26,06/29/2018,4,0:45,1:00,,,0,39.1,39.1,0,-53667,57620,111287,3953,0,0,0,0,0,,0,0
26,06/29/2018,5,1:00,1:15,109.26,,0,109.26,109.26,1,-65356,17699,83055,-47657,0,0,18665,0,0,,18665,18665
26,06/29/2018,6,1:15,1:30,47.28,,0,47.28,47.28,1,-36215,35102,71317,-1113,0,0,15606,0,0,,15606,15606
26,06/29/2018,7,1:30,1:45,,,0,38.56,38.56,0,-31616,45554,77170,13938,0,0,224,0,0,,224,224
26,06/29/2018,8,1:45,2:00,36.2,,0,36.2,36.2,1,-42656,40927,83583,-1729,0,0,190,0,0,,190,190
26,06/29/2018,9,2:00,2:15,53.65,,0,53.65,53.65,1,-46972,31556,78528,-15416,0,0,6315,0,0,,6315,6315
26,06/29/2018,10,2:15,2:30,46.08,,0,46.08,46.08,1,-44413,26717,71130,-17696,0,0,17484,0,0,,17484,17484
26,06/29/2018,11,2:30,2:45,,,0,38.53,38.53,0,-34012,26550,60562,-7462,0,0,4418,0,0,,4418,4418
26,06/29/2018,12,2:45,3:00,,,0,38.53,38.53,0,-33424,29577,63001,-3847,0,0,0,0,0,,0,0
26,06/29/2018,13,3:00,3:15,52.56,,0,52.56,52.56,1,-50839,19448,70287,-31391,0,0,7612,0,0,,7612,7612
26,06/29/2018,14,3:15,3:30,44.22,,0,44.22,44.22,1,-48547,31837,80384,-16710,0,0,10444,0,0,,10444,10444
26,06/29/2018,15,3:30,3:45,44.1,,0,44.1,44.1,1,-44686,27082,71768,-17604,0,0,5986,0,0,,5986,5986
26,06/29/2018,16,3:45,4:00,45,,0,45,45,1,-42002,24585,66587,-17417,0,0,5317,0,0,,5317,5317
26,06/29/2018,17,4:00,4:15,50.57,,0,50.57,50.57,1,-48059,21347,69406,-26712,0,0,15807,0,0,,15807,15807
26,06/29/2018,18,4:15,4:30,42.99,,0,42.99,42.99,1,-41813,33202,75015,-8611,0,0,9105,0,0,,9105,9105
26,06/29/2018,19,4:30,4:45,42.57,,0,42.57,42.57,1,-48030,42770,90800,-5260,0,0,4525,0,0,,4525,4525
26,06/29/2018,20,4:45,5:00,36.01,,0,36.01,36.01,1,-47897,55978,103875,8081,0,0,1390,0,0,,1390,1390
26,06/29/2018,21,5:00,5:15,35.91,,0,35.91,35.91,1,-75733,59063,134796,-16670,0,0,58,0,0,,58,58
26,06/29/2018,22,5:15,5:30,36.13,,0,36.13,36.13,1,-54934,43989,98923,-10945,0,0,999,0,0,,999,999
26,06/29/2018,23,5:30,5:45,42.57,,0,42.57,42.57,1,-58057,36453,94510,-21604,0,0,971,0,0,,971,971
26,06/29/2018,24,5:45,6:00,50.57,,0,50.57,50.57,1,-68712,39169,107881,-29543,0,0,8401,0,0,,8401,8401
26,06/29/2018,25,6:00,6:15,43.02,,0,43.02,43.02,1,-67077,50151,117228,-16926,0,0,2630,0,0,,2630,2630
26,06/29/2018,26,6:15,6:30,43.78,40.14,0,43.78,39.73,2,-42209,43263,85472,1054,0,-805,446,0,0,,1251,-359
26,06/29/2018,27,6:30,6:45,102.02,,0,102.02,102.02,1,-72230,25014,97244,-47216,0,0,28152,0,0,,28152,28152
26,06/29/2018,28,6:45,7:00,53.02,,0,53.02,53.02,1,-71123,51953,123076,-19170,0,0,35598,0,0,,35598,35598
26,06/29/2018,29,7:00,7:15,53.02,38.82,0,38.82,38.82,-1,-87508,94516,182024,7008,0,-349,5218,0,0,,5567,4869
26,06/29/2018,30,7:15,7:30,51.89,,0,51.89,51.89,1,-62198,47468,109666,-14730,0,0,2189,0,0,,2189,2189
26,06/29/2018,31,7:30,7:45,163.02,,0,163.02,163.02,1,-91845,34690,126535,-57155,0,0,40650,0,0,,40650,40650
26,06/29/2018,32,7:45,8:00,135.02,,0,135.02,135.02,1,-119311,56145,175456,-63166,0,0,62812,0,0,,62812,62812
26,06/29/2018,33,8:00,8:15,46.82,38.37,0,38.37,38.37,-1,-48656,110336,158992,61680,0,-1636,26556,0,0,,28192,24920
26,06/29/2018,34,8:15,8:30,,,0,42.91,42.91,0,-50284,81009,131293,30725,0,-248,0,0,0,,248,-248
26,06/29/2018,35,8:30,8:45,50,,0,50,50,1,-75121,65913,141034,-9208,0,0,2136,0,0,,2136,2136
26,06/29/2018,36,8:45,9:00,50.05,,0,50.05,50.05,1,-79199,59609,138808,-19590,0,0,10195,0,0,,10195,10195
26,06/29/2018,37,9:00,9:15,,,0,43.02,43.02,0,-54230,111929,166159,57699,0,0,1846,0,0,,1846,1846
26,06/29/2018,38,9:15,9:30,,,0,43.02,43.02,0,-61830,104537,166367,42707,0,0,0,0,0,,0,0
26,06/29/2018,39,9:30,9:45,,,0,43.02,43.02,0,-59984,107431,167415,47447,0,0,0,0,0,,0,0
26,06/29/2018,40,9:45,10:00,,42.29,0,42.29,42.29,-1,-49082,111158,160240,62076,0,-47,0,0,0,,47,-47
26,06/29/2018,41,10:00,10:15,46.82,42.29,0,46.82,42.29,2,-83391,77136,160527,-6255,0,-135,1035,0,0,,1170,900
26,06/29/2018,42,10:15,10:30,42.73,,0,42.73,42.73,1,-68791,74936,143727,6145,0,0,1073,0,0,,1073,1073
26,06/29/2018,43,10:30,10:45,42.73,,0,42.73,42.73,1,-58499,78131,136630,19632,0,0,480,0,0,,480,480
26,06/29/2018,44,10:45,11:00,,,0,42.97,42.97,0,-59101,81225,140326,22124,0,0,0,0,0,,0,0
26,06/29/2018,45,11:00,11:15,46.82,,0,46.82,46.82,1,-90220,41265,131485,-48955,0,0,1299,0,0,,1299,1299
26,06/29/2018,46,11:15,11:30,50.82,,0,50.82,50.82,1,-95200,48454,143654,-46746,0,0,2964,0,0,,2964,2964
26,06/29/2018,47,11:30,11:45,42.73,,0,42.73,42.73,1,-102495,54147,156642,-48348,0,0,2225,0,0,,2225,2225
26,06/29/2018,48,11:45,12:00,42.68,,0,42.68,42.68,1,-89079,58379,147458,-30700,0,0,220,0,0,,220,220
26,06/29/2018,49,12:00,12:15,42.38,,0,42.38,42.38,1,-104740,52801,157541,-51939,0,0,745,0,0,,745,745
26,06/29/2018,50,12:15,12:30,,,0,42.71,42.71,0,-101444,57308,158752,-44136,0,0,49,0,0,,49,49
26,06/29/2018,51,12:30,12:45,42.73,,0,42.73,42.73,1,-82017,60508,142525,-21509,0,0,1564,0,0,,1564,1564
26,06/29/2018,52,12:45,13:00,46.82,,0,46.82,46.82,1,-90537,58718,149255,-31819,0,0,3219,0,0,,3219,3219
26,06/29/2018,53,13:00,13:15,233.3,,0,233.3,233.3,1,-101228,46112,147340,-55116,0,0,20822,0,0,,20822,20822
26,06/29/2018,54,13:15,13:30,64.05,41.22,0,41.22,41.22,-1,-70686,61151,131837,-9535,0,-19,29995,0,0,,30014,29976
26,06/29/2018,55,13:30,13:45,46.82,40.63,0,46.82,40.63,2,-71648,59563,131211,-12085,0,-449,3371,0,0,,3820,2922
26,06/29/2018,56,13:45,14:00,49.41,,0,49.41,49.41,1,-82136,59866,142002,-22270,0,0,9430,0,0,,9430,9430
26,06/29/2018,57,14:00,14:15,46.82,,0,46.82,46.82,1,-79634,59774,139408,-19860,0,0,10793,0,0,,10793,10793
26,06/29/2018,58,14:15,14:30,45.18,,0,45.18,45.18,1,-84718,72126,156844,-12592,0,0,7971,0,0,,7971,7971
26,06/29/2018,59,14:30,14:45,46.82,,0,46.82,46.82,1,-99772,81612,181384,-18160,0,0,2879,0,0,,2879,2879
26,06/29/2018,60,14:45,15:00,45.09,,0,45.09,45.09,1,-98008,88680,186688,-9328,0,0,4201,0,0,,4201,4201
26,06/29/2018,61,15:00,15:15,,,0,42.12,42.12,0,-67347,92158,159505,24811,0,0,537,0,0,,537,537
26,06/29/2018,62,15:15,15:30,,,0,42.11,42.11,0,-55920,106549,162469,50629,0,0,0,0,0,,0,0
26,06/29/2018,63,15:30,15:45,,,0,42.1,42.1,0,-54790,100994,155784,46204,0,0,0,0,0,,0,0
26,06/29/2018,64,15:45,16:00,,40.47,0,40.47,40.47,-1,-61445,107289,168734,45844,0,-73,0,0,0,,73,-73
26,06/29/2018,65,16:00,16:15,,38.82,0,38.82,38.82,-1,-64162,77895,142057,13733,0,-4026,0,0,0,,4026,-4026
26,06/29/2018,66,16:15,16:30,,38.82,0,38.82,38.82,-1,-67249,79802,147051,12553,0,-2626,0,0,0,,2626,-2626
26,06/29/2018,67,16:30,16:45,42.73,40.29,0,42.73,40.29,2,-74486,78757,153243,4271,0,-987,134,0,0,,1121,-853
26,06/29/2018,68,16:45,17:00,50.82,,0,50.82,50.82,1,-78908,59224,138132,-19684,0,0,6108,0,0,,6108,6108
26,06/29/2018,69,17:00,17:15,50.82,40.12,0,40.12,40.12,-1,-73547,98596,172143,25049,0,-195,1653,0,0,,1848,1458
26,06/29/2018,70,17:15,17:30,,41.56,0,41.56,41.56,-1,-69277,75675,144952,6398,0,-109,0,0,0,,109,-109
26,06/29/2018,71,17:30,17:45,42.73,,0,42.73,42.73,1,-73571,65356,138927,-8215,0,0,473,0,0,,473,473
26,06/29/2018,72,17:45,18:00,132.09,,0,132.09,132.09,1,-87050,50644,137694,-36406,0,0,22971,0,0,,22971,22971
26,06/29/2018,73,18:00,18:15,251.3,,0,251.3,251.3,1,-145954,36527,182481,-109427,0,0,60620,0,0,,60620,60620
26,06/29/2018,74,18:15,18:30,251.3,,0,251.3,251.3,1,-97405,62812,160217,-34593,0,0,66722,0,0,,66722,66722
26,06/29/2018,75,18:30,18:45,251.3,33.28,0,33.28,33.28,-1,-84088,99179,183267,15091,0,-2565,9901,0,0,,12466,7336
26,06/29/2018,76,18:45,19:00,65.02,,0,65.02,65.02,1,-104331,78905,183236,-25426,0,0,7500,0,0,,7500,7500
26,06/29/2018,77,19:00,19:15,,,0,42.56,42.56,0,-104718,97749,202467,-6969,0,0,1509,0,0,,1509,1509
26,06/29/2018,78,19:15,19:30,88.02,,0,88.02,88.02,1,-109476,63086,172562,-46390,0,0,6053,0,0,,6053,6053
26,06/29/2018,79,19:30,19:45,247.75,,0,247.75,247.75,1,-119287,48596,167883,-70691,0,0,55258,0,0,,55258,55258
26,06/29/2018,80,19:45,20:00,83.02,,0,83.02,83.02,1,-91863,64596,156459,-27267,0,0,42761,0,0,,42761,42761
26,06/29/2018,81,20:00,20:15,46.82,41.09,0,46.82,41.09,2,-81321,78421,159742,-2900,0,-139,3451,0,0,,3590,3312
26,06/29/2018,82,20:15,20:30,78.02,,0,78.02,78.02,1,-94199,58146,152345,-36053,0,0,24004,0,0,,24004,24004
26,06/29/2018,83,20:30,20:45,50.02,,0,50.02,50.02,1,-75593,53621,129214,-21972,0,0,28942,0,0,,28942,28942
26,06/29/2018,84,20:45,21:00,42.73,41.43,0,42.73,41.43,2,-62260,63201,125461,941,0,-248,8909,0,0,,9157,8661
26,06/29/2018,85,21:00,21:15,154.3,,0,154.3,154.3,1,-79988,26254,106242,-53734,0,0,18584,0,0,,18584,18584
26,06/29/2018,86,21:15,21:30,46.82,41.23,0,41.23,41.23,-1,-51355,49388,100743,-1967,0,-32,11183,0,0,,11215,11151
26,06/29/2018,87,21:30,21:45,46.82,38.82,0,38.82,38.82,-1,-42610,65260,107870,22650,0,-12968,3,0,0,,12971,-12965
26,06/29/2018,88,21:45,22:00,,38.82,0,38.82,38.82,-1,-54045,87434,141479,33389,0,-21409,0,0,0,,21409,-21409
26,06/29/2018,89,22:00,22:15,,38.82,0,38.82,38.82,-1,-65585,72991,138576,7406,0,-13343,0,0,0,,13343,-13343
26,06/29/2018,90,22:15,22:30,,40.29,0,40.29,40.29,-1,-67394,65902,133296,-1492,0,-2480,0,0,0,,2480,-2480
26,06/29/2018,91,22:30,22:45,,41.65,0,41.65,41.65,-1,-82832,71493,154325,-11339,0,-1652,0,0,0,,1652,-1652
26,06/29/2018,92,22:45,23:00,45.13,41.65,0,45.13,45.13,1,-73907,75867,149774,1960,0,-50,599,0,0,,649,549
26,06/29/2018,93,23:00,23:15,253.6,,0,253.6,253.6,1,-121531,51436,172967,-70095,0,0,20936,0,0,,20936,20936
26,06/29/2018,94,23:15,23:30,60.66,,0,60.66,60.66,1,-79667,59141,138808,-20526,0,0,31854,0,0,,31854,31854
26,06/29/2018,95,23:30,23:45,60.66,38.29,0,38.29,38.29,-1,-54249,58140,112389,3891,0,-2665,2718,0,0,,5383,53
26,06/29/2018,96,23:45,0:00,,18.72,0,18.72,18.72,-1,-45883,63737,109620,17854,0,-12519,0,0,0,,12519,-12519
27,06/30/2018,1,0:00,0:15,46.62,-10.79,0,46.62,-10.79,2,-65095,111074,176169,45979,0,-17085,153,0,0,,17238,-16932
27,06/30/2018,2,0:15,0:30,85.57,-10.79,0,85.57,85.57,1,-64781,39224,104005,-25557,0,-21,14968,0,0,,14989,14947
27,06/30/2018,3,0:30,0:45,80.07,,0,80.07,80.07,1,-73624,30718,104342,-42906,0,0,14987,0,0,,14987,14987
27,06/30/2018,4,0:45,1:00,85.77,,0,85.77,85.77,1,-100469,29286,129755,-71183,0,0,59436,0,0,,59436,59436
27,06/30/2018,5,1:00,1:15,42.62,31.07,0,42.62,31.07,2,-71468,106368,177836,34900,0,-2761,18818,0,0,,21579,16057
27,06/30/2018,6,1:15,1:30,71.05,31.07,0,71.05,71.05,1,-69493,44362,113855,-25131,0,-56,16322,0,0,,16378,16266
27,06/30/2018,7,1:30,1:45,49.48,,0,49.48,49.48,1,-65146,51752,116898,-13394,0,0,9642,0,0,,9642,9642
27,06/30/2018,8,1:45,2:00,47.79,,0,47.79,47.79,1,-84743,54908,139651,-29835,0,0,12492,0,0,,12492,12492
27,06/30/2018,9,2:00,2:15,44.12,,0,44.12,44.12,1,-61268,54633,115901,-6635,0,0,9570,0,0,,9570,9570
27,06/30/2018,10,2:15,2:30,42.62,,0,42.62,42.62,1,-68403,53533,121936,-14870,0,0,6437,0,0,,6437,6437
27,06/30/2018,11,2:30,2:45,41.91,,0,41.91,41.91,1,-72326,61233,133559,-11093,0,0,2268,0,0,,2268,2268
27,06/30/2018,12,2:45,3:00,41.87,,0,41.87,41.87,1,-67972,63476,131448,-4496,0,0,541,0,0,,541,541
27,06/30/2018,13,3:00,3:15,112.12,,0,112.12,112.12,1,-88889,41452,130341,-47437,0,0,20493,0,0,,20493,20493
27,06/30/2018,14,3:15,3:30,50.62,,0,50.62,50.62,1,-71838,43763,115601,-28075,0,0,30691,0,0,,30691,30691
27,06/30/2018,15,3:30,3:45,46.62,,0,46.62,46.62,1,-61114,48709,109823,-12405,0,0,16777,0,0,,16777,16777
27,06/30/2018,16,3:45,4:00,40.78,,0,40.78,40.78,1,-56919,56027,112946,-892,0,0,1363,0,0,,1363,1363
27,06/30/2018,17,4:00,4:15,46.03,,0,46.03,46.03,1,-68584,54636,123220,-13948,0,0,3330,0,0,,3330,3330
27,06/30/2018,18,4:15,4:30,45.92,,0,45.92,45.92,1,-62724,58897,121621,-3827,0,0,4537,0,0,,4537,4537
27,06/30/2018,19,4:30,4:45,,,0,40.6,40.6,0,-35498,61193,96691,25695,0,0,163,0,0,,163,163
27,06/30/2018,20,4:45,5:00,,38.62,0,38.62,38.62,-1,-20214,75700,95914,55486,0,-635,0,0,0,,635,-635
27,06/30/2018,21,5:00,5:15,,38.62,0,38.62,38.62,-1,-36227,74825,111052,38598,0,-1001,0,0,0,,1001,-1001
27,06/30/2018,22,5:15,5:30,,37.78,0,37.78,37.78,-1,-27103,86276,113379,59173,0,-1971,0,0,0,,1971,-1971
27,06/30/2018,23,5:30,5:45,,5.82,0,5.82,5.82,-1,-27362,89260,116622,61898,0,-27494,0,0,0,,27494,-27494
27,06/30/2018,24,5:45,6:00,,27.3,0,27.3,27.3,-1,-47977,77086,125063,29109,0,-40901,0,0,0,,40901,-40901
27,06/30/2018,25,6:00,6:15,,41.06,0,41.06,41.06,-1,-33358,76734,110092,43376,0,-6379,0,0,0,,6379,-6379
27,06/30/2018,26,6:15,6:30,,40.18,0,40.18,40.18,-1,-28584,65025,93609,36441,0,-1326,0,0,0,,1326,-1326
27,06/30/2018,27,6:30,6:45,,,0,41.64,41.64,0,-32434,49917,82351,17483,0,0,0,0,0,,0,0
27,06/30/2018,28,6:45,7:00,,,0,41.68,41.68,0,-25653,37913,63566,12260,0,0,0,0,0,,0,0
27,06/30/2018,29,7:00,7:15,,34.01,0,34.01,34.01,-1,-35557,88349,123906,52792,0,-5041,0,0,0,,5041,-5041
27,06/30/2018,30,7:15,7:30,,40.27,0,40.27,40.27,-1,-26861,62702,89563,35841,0,-5130,0,0,0,,5130,-5130
27,06/30/2018,31,7:30,7:45,,,0,41.22,41.22,0,-32345,44223,76568,11878,0,0,0,0,0,,0,0
27,06/30/2018,32,7:45,8:00,42.01,,0,42.01,42.01,1,-49499,50122,99621,623,0,0,1090,0,0,,1090,1090
27,06/30/2018,33,8:00,8:15,42.01,,0,42.01,42.01,1,-31778,47115,78893,15337,0,0,663,0,0,,663,663
27,06/30/2018,34,8:15,8:30,40.87,,0,40.87,40.87,1,-31519,44096,75615,12577,0,0,490,0,0,,490,490
27,06/30/2018,35,8:30,8:45,49.06,,0,49.06,49.06,1,-55388,32767,88155,-22621,0,0,5322,0,0,,5322,5322
27,06/30/2018,36,8:45,9:00,51.06,,0,51.06,51.06,1,-61710,30738,92448,-30972,0,0,16885,0,0,,16885,16885
27,06/30/2018,37,9:00,9:15,51.06,40.79,0,40.79,40.79,-1,-24851,56822,81673,31971,0,-576,4787,0,0,,5363,4211
27,06/30/2018,38,9:15,9:30,,40.79,0,40.79,40.79,-1,-37485,49766,87251,12281,0,-1367,0,0,0,,1367,-1367
27,06/30/2018,39,9:30,9:45,,,0,38.94,38.94,0,-45395,48172,93567,2777,0,-23,0,0,0,,23,-23
27,06/30/2018,40,9:45,10:00,42.17,,0,42.17,42.17,1,-45294,44893,90187,-401,0,0,616,0,0,,616,616
27,06/30/2018,41,10:00,10:15,45.95,,0,45.95,45.95,1,-48436,42378,90814,-6058,0,0,1543,0,0,,1543,1543
27,06/30/2018,42,10:15,10:30,42.01,,0,42.01,42.01,1,-43423,50433,93856,7010,0,0,894,0,0,,894,894
27,06/30/2018,43,10:30,10:45,36.28,,0,36.28,36.28,1,-39008,72274,111282,33266,0,0,325,0,0,,325,325
27,06/30/2018,44,10:45,11:00,,41.23,0,41.23,41.23,-1,-49505,81072,130577,31567,0,-6,0,0,0,,6,-6
27,06/30/2018,45,11:00,11:15,,40.13,0,40.13,40.13,-1,-45368,62469,107837,17101,0,-271,0,0,0,,271,-271
27,06/30/2018,46,11:15,11:30,,38.01,0,38.01,38.01,-1,-48382,75321,123703,26939,0,-1982,0,0,0,,1982,-1982
27,06/30/2018,47,11:30,11:45,,30.01,0,30.01,30.01,-1,-49649,98579,148228,48930,0,-15679,0,0,0,,15679,-15679
27,06/30/2018,48,11:45,12:00,,30.01,0,30.01,30.01,-1,-57983,104220,162203,46237,0,-17897,0,0,0,,17897,-17897
27,06/30/2018,49,12:00,12:15,,40.78,0,40.78,40.78,-1,-74338,90857,165195,16519,0,-5234,0,0,0,,5234,-5234
27,06/30/2018,50,12:15,12:30,,40.16,0,40.16,40.16,-1,-53923,94049,147972,40126,0,-372,0,0,0,,372,-372
27,06/30/2018,51,12:30,12:45,,39.55,0,39.55,39.55,-1,-56198,105383,161581,49185,0,-479,0,0,0,,479,-479
27,06/30/2018,52,12:45,13:00,,13.31,0,13.31,13.31,-1,-42630,113004,155634,70374,0,-10189,0,0,0,,10189,-10189
27,06/30/2018,53,13:00,13:15,,39.26,0,39.26,39.26,-1,-61637,90875,152512,29238,0,-5948,0,0,0,,5948,-5948
27,06/30/2018,54,13:15,13:30,,30.86,0,30.86,30.86,-1,-51111,93974,145085,42863,0,-4236,0,0,0,,4236,-4236
27,06/30/2018,55,13:30,13:45,,38.01,0,38.01,38.01,-1,-55820,95973,151793,40153,0,-20588,0,0,0,,20588,-20588
27,06/30/2018,56,13:45,14:00,,30.01,0,30.01,30.01,-1,-49210,100784,149994,51574,0,-27563,0,0,0,,27563,-27563
27,06/30/2018,57,14:00,14:15,,37.39,0,37.39,37.39,-1,-55495,85457,140952,29962,0,-21313,0,0,0,,21313,-21313
27,06/30/2018,58,14:15,14:30,,39.66,0,39.66,39.66,-1,-50565,84072,134637,33507,0,-1258,0,0,0,,1258,-1258
27,06/30/2018,59,14:30,14:45,,30.12,0,30.12,30.12,-1,-43771,101822,145593,58051,0,-15879,0,0,0,,15879,-15879
27,06/30/2018,60,14:45,15:00,,30.01,0,30.01,30.01,-1,-41415,120840,162255,79425,0,-35970,0,0,0,,35970,-35970
27,06/30/2018,61,15:00,15:15,,34.01,0,34.01,34.01,-1,-37482,127805,165287,90323,0,-34141,0,0,0,,34141,-34141
27,06/30/2018,62,15:15,15:30,,,0,39.63,39.63,0,-39629,133156,172785,93527,0,-2745,0,0,0,,2745,-2745
27,06/30/2018,63,15:30,15:45,,,0,39.63,39.63,0,-43354,135255,178609,91901,0,0,0,0,0,,0,0
27,06/30/2018,64,15:45,16:00,,40.92,0,40.92,40.92,-1,-40440,124884,165324,84444,0,-21,0,0,0,,21,-21
27,06/30/2018,65,16:00,16:15,,28.55,0,28.55,28.55,-1,-44024,166404,210428,122380,0,-12505,0,0,0,,12505,-12505
27,06/30/2018,66,16:15,16:30,,41.11,0,41.11,41.11,-1,-50793,155556,206349,104763,0,-2462,0,0,0,,2462,-2462
27,06/30/2018,67,16:30,16:45,,,0,39.65,39.65,0,-57954,128052,186006,70098,0,0,0,0,0,,0,0
27,06/30/2018,68,16:45,17:00,,,0,39.67,39.67,0,-67978,99873,167851,31895,0,0,0,0,0,,0,0
27,06/30/2018,69,17:00,17:15,,38.01,0,38.01,38.01,-1,-47755,136066,183821,88311,0,-1132,0,0,0,,1132,-1132
27,06/30/2018,70,17:15,17:30,,30.16,0,30.16,30.16,-1,-51131,133329,184460,82198,0,-7953,0,0,0,,7953,-7953
27,06/30/2018,71,17:30,17:45,,40.34,0,40.34,40.34,-1,-52328,118653,170981,66325,0,-1400,0,0,0,,1400,-1400
27,06/30/2018,72,17:45,18:00,,41.78,0,41.78,41.78,-1,-53739,101096,154835,47357,0,-279,0,0,0,,279,-279
27,06/30/2018,73,18:00,18:15,,26.76,0,26.76,26.76,-1,-88821,121610,210431,32789,0,-8164,0,0,0,,8164,-8164
27,06/30/2018,74,18:15,18:30,,24.44,0,24.44,24.44,-1,-58185,116711,174896,58526,0,-24446,0,0,0,,24446,-24446
27,06/30/2018,75,18:30,18:45,,,0,41.85,41.85,0,-49099,109182,158281,60083,0,-2786,0,0,0,,2786,-2786
27,06/30/2018,76,18:45,19:00,,,0,41.86,41.86,0,-32742,106822,139564,74080,0,0,0,0,0,,0,0
27,06/30/2018,77,19:00,19:15,,-42.64,0,-42.64,-42.64,-1,-20300,118825,139125,98525,0,-34422,0,0,0,,34422,-34422
27,06/30/2018,78,19:15,19:30,,13.37,0,13.37,13.37,-1,-30958,102545,133503,71587,0,-62080,0,0,0,,62080,-62080
27,06/30/2018,79,19:30,19:45,,38.01,0,38.01,38.01,-1,-41847,80200,122047,38353,0,-28358,0,0,0,,28358,-28358
27,06/30/2018,80,19:45,20:00,,,0,41.69,41.69,0,-46980,76974,123954,29994,0,-44,0,0,0,,44,-44
27,06/30/2018,81,20:00,20:15,46.2,,0,46.2,46.2,1,-46751,61864,108615,15113,0,0,26,0,0,,26,26
27,06/30/2018,82,20:15,20:30,,,0,41.7,41.7,0,-44835,59775,104610,14940,0,0,0,0,0,,0,0
27,06/30/2018,83,20:30,20:45,,,0,41.69,41.69,0,-39589,80230,119819,40641,0,0,0,0,0,,0,0
27,06/30/2018,84,20:45,21:00,44.66,,0,44.66,44.66,1,-41747,71541,113288,29794,0,0,301,0,0,,301,301
27,06/30/2018,85,21:00,21:15,57.24,,0,57.24,57.24,1,-99343,41843,141186,-57500,0,0,9719,0,0,,9719,9719
27,06/30/2018,86,21:15,21:30,44.85,,0,44.85,44.85,1,-79954,60865,140819,-19089,0,0,6097,0,0,,6097,6097
27,06/30/2018,87,21:30,21:45,,34.94,0,34.94,34.94,-1,-64703,81755,146458,17052,0,-5966,0,0,0,,5966,-5966
27,06/30/2018,88,21:45,22:00,,28.76,0,28.76,28.76,-1,-50738,88424,139162,37686,0,-27869,0,0,0,,27869,-27869
27,06/30/2018,89,22:00,22:15,50.2,38.01,0,50.2,38.01,2,-86011,76550,162561,-9461,0,-17824,1761,0,0,,19585,-16063
27,06/30/2018,90,22:15,22:30,41.85,41.78,0,41.85,41.78,2,-70712,56585,127297,-14127,0,-138,142,0,0,,280,4
27,06/30/2018,91,22:30,22:45,41.83,,0,41.83,41.83,1,-67880,62888,130768,-4992,0,0,42,0,0,,42,42
27,06/30/2018,92,22:45,23:00,41.79,,0,41.79,41.79,1,-69897,69409,139306,-488,0,0,164,0,0,,164,164
27,06/30/2018,93,23:00,23:15,208,,0,208,208,1,-107092,37345,144437,-69747,0,0,14220,0,0,,14220,14220
27,06/30/2018,94,23:15,23:30,50.2,38.5,0,50.2,38.5,2,-68672,56125,124797,-12547,0,-215,21168,0,0,,21383,20953
27,06/30/2018,95,23:30,23:45,50.2,33.22,0,33.22,33.22,-1,-53214,59998,113212,6784,0,-3287,1394,0,0,,4681,-1893
27,06/30/2018,96,23:45,0:00,,34.01,0,34.01,34.01,-1,-50106,82590,132696,32484,0,-14394,0,0,0,,14394,-14394
27,07-01-18,1,0:00,0:15,,29.85,0,29.85,29.85,-1,-65805,115273,181078,49468,0,-15608,0,0,0,,15608,-15608
27,07-01-18,2,0:15,0:30,,-150.03,0,-150.03,-150.03,-1,-22207,112991,135198,90784,0,-52121,0,0,0,,52121,-52121
27,07-01-18,3,0:30,0:45,,17.03,0,17.03,17.03,-1,-47319,114075,161394,66756,0,-58613,0,0,0,,58613,-58613
27,07-01-18,4,0:45,1:00,,29.85,0,29.85,29.85,-1,-70875,126062,196937,55187,0,-41863,0,0,0,,41863,-41863
27,07-01-18,5,1:00,1:15,,,0,38.99,38.99,0,-90321,92032,182353,1711,0,-9204,0,0,0,,9204,-9204
27,07-01-18,6,1:15,1:30,,29.85,0,29.85,29.85,-1,-68431,87716,156147,19285,0,-3298,0,0,0,,3298,-3298
27,07-01-18,7,1:30,1:45,,27.97,0,27.97,27.97,-1,-49927,101650,151577,51723,0,-16938,0,0,0,,16938,-16938
27,07-01-18,8,1:45,2:00,,-150.03,0,-150.03,-150.03,-1,-62120,98640,160760,36520,0,-53509,0,0,0,,53509,-53509
27,07-01-18,9,2:00,2:15,,40.45,0,40.45,40.45,-1,-38398,108862,147260,70464,0,-9478,0,0,0,,9478,-9478
27,07-01-18,10,2:15,2:30,,37.8,0,37.8,37.8,-1,-31998,102761,134759,70763,0,-114,0,0,0,,114,-114
27,07-01-18,11,2:30,2:45,,33.58,0,33.58,33.58,-1,-30827,111823,142650,80996,0,-1742,0,0,0,,1742,-1742
27,07-01-18,12,2:45,3:00,,8.73,0,8.73,8.73,-1,-36607,103714,140321,67107,0,-15042,0,0,0,,15042,-15042
27,07-01-18,13,3:00,3:15,,29.85,0,29.85,29.85,-1,-34166,96088,130254,61922,0,-26773,0,0,0,,26773,-26773
27,07-01-18,14,3:15,3:30,,,0,38.78,38.78,0,-32676,101858,134534,69182,0,-721,0,0,0,,721,-721
27,07-01-18,15,3:30,3:45,,,0,38.78,38.78,0,-36159,90965,127124,54806,0,0,0,0,0,,0,0
27,07-01-18,16,3:45,4:00,,,0,38.78,38.78,0,-29081,82673,111754,53592,0,0,0,0,0,,0,0
27,07-01-18,17,4:00,4:15,,,0,38.73,38.73,0,-51429,76409,127838,24980,0,0,0,0,0,,0,0
27,07-01-18,18,4:15,4:30,41.8,,0,41.8,41.8,1,-41666,56069,97735,14403,0,0,9,0,0,,9,9
27,07-01-18,19,4:30,4:45,,,0,38.73,38.73,0,-31471,63272,94743,31801,0,0,0,0,0,,0,0
27,07-01-18,20,4:45,5:00,,,0,38.73,38.73,0,-28566,60857,89423,32291,0,0,0,0,0,,0,0
27,07-01-18,21,5:00,5:15,,39.53,0,39.53,39.53,-1,-40637,49093,89730,8456,0,-88,0,0,0,,88,-88
27,07-01-18,22,5:15,5:30,,37.8,0,37.8,37.8,-1,-40485,64816,105301,24331,0,-4420,0,0,0,,4420,-4420
27,07-01-18,23,5:30,5:45,,33.8,0,33.8,33.8,-1,-38388,67140,105528,28752,0,-12455,0,0,0,,12455,-12455
27,07-01-18,24,5:45,6:00,,37.8,0,37.8,37.8,-1,-42849,68555,111404,25706,0,-6913,0,0,0,,6913,-6913
27,07-01-18,25,6:00,6:15,,15.07,0,15.07,15.07,-1,-40289,99370,139659,59081,0,-17364,0,0,0,,17364,-17364
27,07-01-18,26,6:15,6:30,,29.84,0,29.84,29.84,-1,-39575,102333,141908,62758,0,-50520,0,0,0,,50520,-50520
27,07-01-18,27,6:30,6:45,,27.63,0,27.63,27.63,-1,-38015,108661,146676,70646,0,-57858,0,0,0,,57858,-57858
27,07-01-18,28,6:45,7:00,,29.84,0,29.84,29.84,-1,-34791,112051,146842,77260,0,-39332,0,0,0,,39332,-39332
27,07-01-18,29,7:00,7:15,,35.22,0,35.22,35.22,-1,-42498,159446,201944,116948,0,-13242,0,0,0,,13242,-13242
27,07-01-18,30,7:15,7:30,,35.03,0,35.03,35.03,-1,-29581,153394,182975,123813,0,-12869,0,0,0,,12869,-12869
27,07-01-18,31,7:30,7:45,,37.8,0,37.8,37.8,-1,-27247,139345,166592,112098,0,-4698,0,0,0,,4698,-4698
27,07-01-18,32,7:45,8:00,,30.67,0,30.67,30.67,-1,-26141,150147,176288,124006,0,-4066,0,0,0,,4066,-4066
27,07-01-18,33,8:00,8:15,,3.83,0,3.83,3.83,-1,-16915,175039,191954,158124,0,-39734,0,0,0,,39734,-39734
27,07-01-18,34,8:15,8:30,,31.03,0,31.03,31.03,-1,-25942,169426,195368,143484,0,-35769,0,0,0,,35769,-35769
27,07-01-18,35,8:30,8:45,,33.8,0,33.8,33.8,-1,-28030,174734,202764,146704,0,-30987,0,0,0,,30987,-30987
27,07-01-18,36,8:45,9:00,,29.84,0,29.84,29.84,-1,-27396,187849,215245,160453,0,-37146,0,0,0,,37146,-37146
27,07-01-18,37,9:00,9:15,,-150.03,0,-150.03,-150.03,-1,-26077,233737,259814,207660,0,-68763,0,0,0,,68763,-68763
27,07-01-18,38,9:15,9:30,,-150.03,0,-150.03,-150.03,-1,-30382,247048,277430,216666,0,-80595,0,0,0,,80595,-80595
27,07-01-18,39,9:30,9:45,,-150.03,0,-150.03,-150.03,-1,-34275,263789,298064,229514,0,-96184,0,0,0,,96184,-96184
27,07-01-18,40,9:45,10:00,,-150.03,0,-150.03,-150.03,-1,-52574,280770,333344,228196,0,-104324,0,0,0,,104324,-104324
27,07-01-18,41,10:00,10:15,,3.83,0,3.83,3.83,-1,-57843,222618,280461,164775,0,-78012,0,0,0,,78012,-78012
27,07-01-18,42,10:15,10:30,,7.37,0,7.37,7.37,-1,-47490,236888,284378,189398,0,-61285,0,0,0,,61285,-61285
27,07-01-18,43,10:30,10:45,,-7.01,0,-7.01,-7.01,-1,-47014,247105,294119,200091,0,-85649,0,0,0,,85649,-85649
27,07-01-18,44,10:45,11:00,,-150.03,0,-150.03,-150.03,-1,-63807,251646,315453,187839,0,-91959,0,0,0,,91959,-91959
27,07-01-18,45,11:00,11:15,,-150.03,0,-150.03,-150.03,-1,-48772,201446,250218,152674,0,-66400,0,0,0,,66400,-66400
27,07-01-18,46,11:15,11:30,,-150.03,0,-150.03,-150.03,-1,-50583,182190,232773,131607,0,-60031,0,0,0,,60031,-60031
27,07-01-18,47,11:30,11:45,,-150.03,0,-150.03,-150.03,-1,-43288,181783,225071,138495,0,-74832,0,0,0,,74832,-74832
27,07-01-18,48,11:45,12:00,,-150.03,0,-150.03,-150.03,-1,-69911,164901,234812,94990,0,-76528,0,0,0,,76528,-76528
27,07-01-18,49,12:00,12:15,41.8,29.84,0,41.8,29.84,2,-116957,148680,265637,31723,0,-13805,52,0,0,,13857,-13753
27,07-01-18,50,12:15,12:30,,-150.03,0,-150.03,-150.03,-1,-106661,149886,256547,43225,0,-37963,0,0,0,,37963,-37963
27,07-01-18,51,12:30,12:45,,33.8,0,33.8,33.8,-1,-98836,153978,252814,55142,0,-21833,0,0,0,,21833,-21833
27,07-01-18,52,12:45,13:00,,-150.03,0,-150.03,-150.03,-1,-85257,157445,242702,72188,0,-44659,0,0,0,,44659,-44659
27,07-01-18,53,13:00,13:15,,15.07,0,15.07,15.07,-1,-64991,156054,221045,91063,0,-45913,0,0,0,,45913,-45913
27,07-01-18,54,13:15,13:30,,6.99,0,6.99,6.99,-1,-62092,149548,211640,87456,0,-51748,0,0,0,,51748,-51748
27,07-01-18,55,13:30,13:45,,-150.03,0,-150.03,-150.03,-1,-70035,171110,241145,101075,0,-78549,0,0,0,,78549,-78549
27,07-01-18,56,13:45,14:00,,3.68,0,3.68,3.68,-1,-71428,160833,232261,89405,0,-85994,0,0,0,,85994,-85994
27,07-01-18,57,14:00,14:15,,15.07,0,15.07,15.07,-1,-107842,153376,261218,45534,0,-60561,0,0,0,,60561,-60561
27,07-01-18,58,14:15,14:30,,,0,41.35,41.35,0,-99106,153768,252874,54662,0,-3769,0,0,0,,3769,-3769
27,07-01-18,59,14:30,14:45,,5.03,0,5.03,5.03,-1,-88808,154257,243065,65449,0,-22268,0,0,0,,22268,-22268
27,07-01-18,60,14:45,15:00,,29.84,0,29.84,29.84,-1,-98095,149040,247135,50945,0,-39385,0,0,0,,39385,-39385
27,07-01-18,61,15:00,15:15,,37.8,0,37.8,37.8,-1,-73098,148681,221779,75583,0,-17417,0,0,0,,17417,-17417
27,07-01-18,62,15:15,15:30,,,0,41.19,41.19,0,-57445,143764,201209,86319,0,-7,0,0,0,,7,-7
27,07-01-18,63,15:30,15:45,,,0,41.19,41.19,0,-58684,173053,231737,114369,0,0,0,0,0,,0,0
27,07-01-18,64,15:45,16:00,,41.19,0,41.19,41.19,-1,-63751,178831,242582,115080,0,-3,0,0,0,,3,-3
27,07-01-18,65,16:00,16:15,,-150.03,0,-150.03,-150.03,-1,-66144,238398,304542,172254,0,-32629,0,0,0,,32629,-32629
27,07-01-18,66,16:15,16:30,,29.84,0,29.84,29.84,-1,-57651,191623,249274,133972,0,-38493,0,0,0,,38493,-38493
27,07-01-18,67,16:30,16:45,,41.11,0,41.11,41.11,-1,-54369,157581,211950,103212,0,-7233,0,0,0,,7233,-7233
27,07-01-18,68,16:45,17:00,,41.11,0,41.11,41.11,-1,-55185,133476,188661,78291,0,-1161,0,0,0,,1161,-1161
27,07-01-18,69,17:00,17:15,,39.06,0,39.06,39.06,-1,-66292,185845,252137,119553,0,-918,0,0,0,,918,-918
27,07-01-18,70,17:15,17:30,,37.8,0,37.8,37.8,-1,-35263,164711,199974,129448,0,-1917,0,0,0,,1917,-1917
27,07-01-18,71,17:30,17:45,,40.83,0,40.83,40.83,-1,-34255,123974,158229,89719,0,-1905,0,0,0,,1905,-1905
27,07-01-18,72,17:45,18:00,,37.8,0,37.8,37.8,-1,-47852,97584,145436,49732,0,-913,0,0,0,,913,-913
27,07-01-18,73,18:00,18:15,,37.8,0,37.8,37.8,-1,-50759,96131,146890,45372,0,-631,0,0,0,,631,-631
27,07-01-18,74,18:15,18:30,,,0,41.52,41.52,0,-36591,76659,113250,40068,0,0,0,0,0,,0,0
27,07-01-18,75,18:30,18:45,,,0,41.52,41.52,0,-35802,69403,105205,33601,0,0,0,0,0,,0,0
27,07-01-18,76,18:45,19:00,45.8,,0,45.8,45.8,1,-48349,33793,82142,-14556,0,0,1373,0,0,,1373,1373
27,07-01-18,77,19:00,19:15,,37.67,0,37.67,37.67,-1,-31329,67113,98442,35784,0,-737,0,0,0,,737,-737
27,07-01-18,78,19:15,19:30,49.84,37.67,0,49.84,49.84,1,-63579,41828,105407,-21751,0,-302,1748,0,0,,2050,1446
27,07-01-18,79,19:30,19:45,49.84,,0,49.84,49.84,1,-61394,28624,90018,-32770,0,0,13204,0,0,,13204,13204
27,07-01-18,80,19:45,20:00,60.02,,0,60.02,60.02,1,-74697,22377,97074,-52320,0,0,37100,0,0,,37100,37100
27,07-01-18,81,20:00,20:15,50.19,,0,50.19,50.19,1,-53197,34480,87677,-18717,0,0,33327,0,0,,33327,33327
27,07-01-18,82,20:15,20:30,49.85,,0,49.85,49.85,1,-68874,29667,98541,-39207,0,0,15836,0,0,,15836,15836
27,07-01-18,83,20:30,20:45,49.84,,0,49.84,49.84,1,-75432,32467,107899,-42965,0,0,32663,0,0,,32663,32663
27,07-01-18,84,20:45,21:00,49.84,,0,49.84,49.84,1,-82023,43399,125422,-38624,0,0,33018,0,0,,33018,33018
27,07-01-18,85,21:00,21:15,53.02,,0,53.02,53.02,1,-101447,51418,152865,-50029,0,0,39836,0,0,,39836,39836
27,07-01-18,86,21:15,21:30,49.84,,0,49.84,49.84,1,-96822,53778,150600,-43044,0,0,42863,0,0,,42863,42863
27,07-01-18,87,21:30,21:45,49.84,,0,49.84,49.84,1,-89402,66443,155845,-22959,0,0,24954,0,0,,24954,24954
27,07-01-18,88,21:45,22:00,49.84,33.8,0,33.8,33.8,-1,-67947,80190,148137,12243,0,-6068,1190,0,0,,7258,-4878
27,07-01-18,89,22:00,22:15,41.8,37.8,0,41.8,41.8,1,-87519,74501,162020,-13018,0,-2267,38,0,0,,2305,-2229
27,07-01-18,90,22:15,22:30,68.02,,0,68.02,68.02,1,-117287,66682,183969,-50605,0,0,25047,0,0,,25047,25047
27,07-01-18,91,22:30,22:45,49.84,,0,49.84,49.84,1,-112205,64311,176516,-47894,0,0,32435,0,0,,32435,32435
27,07-01-18,92,22:45,23:00,46.85,41,0,41,41,-1,-78096,74015,152111,-4081,0,-71,20614,0,0,,20685,20543
27,07-01-18,93,23:00,23:15,154.58,40.93,0,154.58,40.93,2,-149584,78099,227683,-71485,0,-41,20127,0,0,,20168,20086
27,07-01-18,94,23:15,23:30,57.08,,0,57.08,57.08,1,-110400,85425,195825,-24975,0,0,35701,0,0,,35701,35701
27,07-01-18,95,23:30,23:45,57.08,33.8,0,33.8,33.8,-1,-84706,96889,181595,12183,0,-3376,4387,0,0,,7763,1011
27,07-01-18,96,23:45,0:00,,30.99,0,30.99,30.99,-1,-74168,121292,195460,47124,0,-29248,0,0,0,,29248,-29248
27,07-02-18,1,0:00,0:15,,35.78,0,35.78,35.78,-1,-79422,59514,138936,-19908,0,-17264,0,0,0,,17264,-17264
27,07-02-18,2,0:15,0:30,41.8,35.78,0,41.8,41.8,1,-66605,58396,125001,-8209,0,-284,876,0,0,,1160,592
27,07-02-18,3,0:30,0:45,41.8,37.8,0,37.8,37.8,-1,-46576,58005,104581,11429,0,-2449,13,0,0,,2462,-2436
27,07-02-18,4,0:45,1:00,,38.31,0,38.31,38.31,-1,-45153,50841,95994,5688,0,-2557,0,0,0,,2557,-2557
27,07-02-18,5,1:00,1:15,,37.8,0,37.8,37.8,-1,-68150,31838,99988,-36312,0,-618,0,0,0,,618,-618
27,07-02-18,6,1:15,1:30,37.39,,0,37.39,37.39,1,-64605,20848,85453,-43757,0,0,832,0,0,,832,832
27,07-02-18,7,1:30,1:45,37.38,,0,37.38,37.38,1,-57188,31898,89086,-25290,0,0,199,0,0,,199,199
27,07-02-18,8,1:45,2:00,,37.8,0,37.8,37.8,-1,-54101,44223,98324,-9878,0,-196,0,0,0,,196,-196
27,07-02-18,9,2:00,2:15,,33.8,0,33.8,33.8,-1,-52677,81804,134481,29127,0,-5616,0,0,0,,5616,-5616
27,07-02-18,10,2:15,2:30,,34.57,0,34.57,34.57,-1,-52062,69980,122042,17918,0,-5703,0,0,0,,5703,-5703
27,07-02-18,11,2:30,2:45,,32.41,0,32.41,32.41,-1,-39181,74459,113640,35278,0,-25378,0,0,0,,25378,-25378
27,07-02-18,12,2:45,3:00,,33.8,0,33.8,33.8,-1,-48283,69892,118175,21609,0,-29493,0,0,0,,29493,-29493
27,07-02-18,13,3:00,3:15,,35.78,0,35.78,35.78,-1,-41450,112430,153880,70980,0,-12447,0,0,0,,12447,-12447
27,07-02-18,14,3:15,3:30,,,0,38.68,38.68,0,-34379,96325,130704,61946,0,-218,0,0,0,,218,-218
27,07-02-18,15,3:30,3:45,,29.84,0,29.84,29.84,-1,-34344,88028,122372,53684,0,-2288,0,0,0,,2288,-2288
27,07-02-18,16,3:45,4:00,,-150.78,0,-150.78,-150.78,-1,-34369,93637,128006,59268,0,-44997,0,0,0,,44997,-44997
27,07-02-18,17,4:00,4:15,,22.26,0,22.26,22.26,-1,-41852,119316,161168,77464,0,-41300,0,0,0,,41300,-41300
27,07-02-18,18,4:15,4:30,,20.78,0,20.78,20.78,-1,-48699,117404,166103,68705,0,-56488,0,0,0,,56488,-56488
27,07-02-18,19,4:30,4:45,,29.84,0,29.84,29.84,-1,-53346,119515,172861,66169,0,-52885,0,0,0,,52885,-52885
27,07-02-18,20,4:45,5:00,,33.8,0,33.8,33.8,-1,-52480,127275,179755,74795,0,-36950,0,0,0,,36950,-36950
27,07-02-18,21,5:00,5:15,45.8,37.8,0,45.8,45.8,1,-104313,34901,139214,-69412,0,-12433,897,0,0,,13330,-11536
27,07-02-18,22,5:15,5:30,,,0,38.61,38.61,0,-65921,55991,121912,-9930,0,0,32,0,0,,32,32
27,07-02-18,23,5:30,5:45,,,0,38.69,38.69,0,-66813,46083,112896,-20730,0,0,0,0,0,,0,0
27,07-02-18,24,5:45,6:00,,37.74,0,37.74,37.74,-1,-54062,75961,130023,21899,0,-492,0,0,0,,492,-492
27,07-02-18,25,6:00,6:15,,29.69,0,29.69,29.69,-1,-99024,117700,216724,18676,0,-3650,0,0,0,,3650,-3650
27,07-02-18,26,6:15,6:30,,-8.99,0,-8.99,-8.99,-1,-55235,118457,173692,63222,0,-58361,0,0,0,,58361,-58361
27,07-02-18,27,6:30,6:45,45.84,36.78,0,45.84,36.78,2,-69393,50037,119430,-19356,0,-22370,1086,0,0,,23456,-21284
27,07-02-18,28,6:45,7:00,,,0,40.33,40.33,0,-86415,70632,157047,-15783,0,-107,45,0,0,,152,-62
27,07-02-18,29,7:00,7:15,,33.03,0,33.03,33.03,-1,-56752,91562,148314,34810,0,-3714,0,0,0,,3714,-3714
27,07-02-18,30,7:15,7:30,,29.69,0,29.69,29.69,-1,-43679,81816,125495,38137,0,-17193,0,0,0,,17193,-17193
27,07-02-18,31,7:30,7:45,,43.97,0,43.97,43.97,-1,-55692,75752,131444,20060,0,-502,0,0,0,,502,-502
27,07-02-18,32,7:45,8:00,45.65,,0,45.65,45.65,1,-85723,66659,152382,-19064,0,0,3271,0,0,,3271,3271
27,07-02-18,33,8:00,8:15,41.65,40.69,0,42.83,40.69,2,-81183,112829,194012,31646,0,-75,1057,0,0,,1132,982
27,07-02-18,34,8:15,8:30,,41.78,0,41.78,41.78,-1,-61346,82064,143410,20718,0,-616,0,0,0,,616,-616
27,07-02-18,35,8:30,8:45,,41.78,0,41.78,41.78,-1,-67912,67511,135423,-401,0,-202,0,0,0,,202,-202
27,07-02-18,36,8:45,9:00,41.65,,0,41.65,41.65,1,-79453,65718,145171,-13735,0,0,1776,0,0,,1776,1776
27,07-02-18,37,9:00,9:15,44.95,,0,44.95,44.95,1,-110953,91733,202686,-19220,0,0,5936,0,0,,5936,5936
27,07-02-18,38,9:15,9:30,41.65,,0,41.65,41.65,1,-77836,82762,160598,4926,0,0,2691,0,0,,2691,2691
27,07-02-18,39,9:30,9:45,41.65,39.88,0,41.72,39.88,2,-60570,82760,143330,22190,0,-1038,151,0,0,,1189,-887
27,07-02-18,40,9:45,10:00,,39.88,0,39.88,39.88,-1,-60644,86999,147643,26355,0,-1802,0,0,0,,1802,-1802
27,07-02-18,41,10:00,10:15,,39.88,0,39.88,39.88,-1,-56381,64828,121209,8447,0,-1221,0,0,0,,1221,-1221
27,07-02-18,42,10:15,10:30,,39.22,0,39.22,39.22,-1,-43532,62960,106492,19428,0,-2425,0,0,0,,2425,-2425
27,07-02-18,43,10:30,10:45,,33.65,0,33.65,33.65,-1,-36873,79034,115907,42161,0,-8319,0,0,0,,8319,-8319
27,07-02-18,44,10:45,11:00,,33.65,0,33.65,33.65,-1,-57038,97481,154519,40443,0,-20339,0,0,0,,20339,-20339
27,07-02-18,45,11:00,11:15,,29.69,0,29.69,29.69,-1,-68917,102548,171465,33631,0,-29572,0,0,0,,29572,-29572
27,07-02-18,46,11:15,11:30,,33.65,0,33.65,33.65,-1,-69824,109730,179554,39906,0,-27951,0,0,0,,27951,-27951
27,07-02-18,47,11:30,11:45,,29.69,0,29.69,29.69,-1,-72188,134060,206248,61872,0,-43594,0,0,0,,43594,-43594
27,07-02-18,48,11:45,12:00,,29.28,0,29.28,29.28,-1,-78900,145017,223917,66117,0,-47538,0,0,0,,47538,-47538
27,07-02-18,49,12:00,12:15,,24.85,0,24.85,24.85,-1,-76304,131880,208184,55576,0,-54845,0,0,0,,54845,-54845
27,07-02-18,50,12:15,12:30,,36.08,0,36.08,36.08,-1,-91425,113838,205263,22413,0,-33064,0,0,0,,33064,-33064
27,07-02-18,51,12:30,12:45,,37.65,0,37.65,37.65,-1,-71350,97787,169137,26437,0,-9366,0,0,0,,9366,-9366
27,07-02-18,52,12:45,13:00,,38.44,0,38.44,38.44,-1,-67272,88146,155418,20874,0,-8238,0,0,0,,8238,-8238
27,07-02-18,53,13:00,13:15,41.65,36.03,0,42.22,36.03,2,-56979,75562,132541,18583,0,-13810,2,0,0,,13812,-13808
27,07-02-18,54,13:15,13:30,41.65,41.27,0,42.24,41.27,2,-47384,64560,111944,17176,0,-1850,215,0,0,,2065,-1635
27,07-02-18,55,13:30,13:45,,40.78,0,40.78,40.78,-1,-56485,74534,131019,18049,0,-2218,0,0,0,,2218,-2218
27,07-02-18,56,13:45,14:00,,33.65,0,33.65,33.65,-1,-50840,89090,139930,38250,0,-12141,0,0,0,,12141,-12141
27,07-02-18,57,14:00,14:15,,32.68,0,32.68,32.68,-1,-71640,110398,182038,38758,0,-41428,0,0,0,,41428,-41428
27,07-02-18,58,14:15,14:30,,37.65,0,37.65,37.65,-1,-76120,107885,184005,31765,0,-31697,0,0,0,,31697,-31697
27,07-02-18,59,14:30,14:45,,37.65,0,37.65,37.65,-1,-91912,119132,211044,27220,0,-28864,0,0,0,,28864,-28864
27,07-02-18,60,14:45,15:00,,33.65,0,33.65,33.65,-1,-90004,125110,215114,35106,0,-39133,0,0,0,,39133,-39133
27,07-02-18,61,15:00,15:15,,38.78,0,38.78,38.78,-1,-90689,119490,210179,28801,0,-24029,0,0,0,,24029,-24029
27,07-02-18,62,15:15,15:30,,38.78,0,38.78,38.78,-1,-87382,111465,198847,24083,0,-20843,0,0,0,,20843,-20843
27,07-02-18,63,15:30,15:45,,38.81,0,38.81,38.81,-1,-81662,111758,193420,30096,0,-17933,0,0,0,,17933,-17933
27,07-02-18,64,15:45,16:00,,39.78,0,39.78,39.78,-1,-91193,103037,194230,11844,0,-14021,0,0,0,,14021,-14021
27,07-02-18,65,16:00,16:15,,33.65,0,33.65,33.65,-1,-76888,109088,185976,32200,0,-17766,0,0,0,,17766,-17766
27,07-02-18,66,16:15,16:30,,38.78,0,38.78,38.78,-1,-83227,110982,194209,27755,0,-23641,0,0,0,,23641,-23641
27,07-02-18,67,16:30,16:45,,36.33,0,36.33,36.33,-1,-81106,119708,200814,38602,0,-25887,0,0,0,,25887,-25887
27,07-02-18,68,16:45,17:00,,33.65,0,33.65,33.65,-1,-87038,106138,193176,19100,0,-24181,0,0,0,,24181,-24181
27,07-02-18,69,17:00,17:15,,-37.92,0,-37.92,-37.92,-1,-87226,129250,216476,42024,0,-41004,0,0,0,,41004,-41004
27,07-02-18,70,17:15,17:30,,39.78,0,39.78,39.78,-1,-87287,109368,196655,22081,0,-19623,0,0,0,,19623,-19623
27,07-02-18,71,17:30,17:45,,38.81,0,38.81,38.81,-1,-88713,117126,205839,28413,0,-14221,0,0,0,,14221,-14221
27,07-02-18,72,17:45,18:00,,33.65,0,33.65,33.65,-1,-85484,134241,219725,48757,0,-20372,0,0,0,,20372,-20372
27,07-02-18,73,18:00,18:15,41.65,38.78,0,41.65,41.65,1,-79486,76984,156470,-2502,0,-13382,8,0,0,,13390,-13374
27,07-02-18,74,18:15,18:30,,37.65,0,37.65,37.65,-1,-74560,100795,175355,26235,0,-8905,0,0,0,,8905,-8905
27,07-02-18,75,18:30,18:45,,40.42,0,40.42,40.42,-1,-73912,91994,165906,18082,0,-11419,0,0,0,,11419,-11419
27,07-02-18,76,18:45,19:00,,,0,27.05,27.05,0,-67864,106896,174760,39032,0,-885,0,0,0,,885,-885
27,07-02-18,77,19:00,19:15,64.93,,0,64.93,64.93,1,-86372,51715,138087,-34657,0,0,8315,0,0,,8315,8315
27,07-02-18,78,19:15,19:30,45.65,,0,45.65,45.65,1,-79178,64426,143604,-14752,0,0,12396,0,0,,12396,12396
27,07-02-18,79,19:30,19:45,49.68,,0,49.68,49.68,1,-83745,60875,144620,-22870,0,0,13742,0,0,,13742,13742
27,07-02-18,80,19:45,20:00,49.68,,0,49.68,49.68,1,-90263,51139,141402,-39124,0,0,26219,0,0,,26219,26219
27,07-02-18,81,20:00,20:15,49.68,,0,49.68,49.68,1,-81987,55776,137763,-26211,0,0,22457,0,0,,22457,22457
27,07-02-18,82,20:15,20:30,54.12,,0,54.12,54.12,1,-79815,35223,115038,-44592,0,0,32499,0,0,,32499,32499
27,07-02-18,83,20:30,20:45,64.93,,0,64.93,64.93,1,-85072,31849,116921,-53223,0,0,40039,0,0,,40039,40039
27,07-02-18,84,20:45,21:00,45.65,,0,45.65,45.65,1,-72326,45566,117892,-26760,0,0,15499,0,0,,15499,15499
27,07-02-18,85,21:00,21:15,153.12,,0,153.12,153.12,1,-108024,40108,148132,-67916,0,0,20683,0,0,,20683,20683
27,07-02-18,86,21:15,21:30,49.68,,0,49.68,49.68,1,-52566,61269,113835,8703,0,0,15823,0,0,,15823,15823
27,07-02-18,87,21:30,21:45,49.68,43.1,0,43.1,43.1,-1,-41161,88810,129971,47649,0,-718,51,0,0,,769,-667
27,07-02-18,88,21:45,22:00,,37.65,0,37.65,37.65,-1,-46402,114548,160950,68146,0,-1366,0,0,0,,1366,-1366
27,07-02-18,89,22:00,22:15,,28.24,0,28.24,28.24,-1,-46197,74411,120608,28214,0,-17692,0,0,0,,17692,-17692
27,07-02-18,90,22:15,22:30,49.68,43.98,0,49.68,49.68,1,-95423,48609,144032,-46814,0,-3613,1387,0,0,,5000,-2226
27,07-02-18,91,22:30,22:45,64.93,,0,64.93,64.93,1,-118999,52456,171455,-66543,0,0,31003,0,0,,31003,31003
27,07-02-18,92,22:45,23:00,114.93,,0,114.93,114.93,1,-144761,64714,209475,-80047,0,0,44388,0,0,,44388,44388
27,07-02-18,93,23:00,23:15,153.12,,0,153.12,153.12,1,-159635,60446,220081,-99189,0,0,48140,0,0,,48140,48140
27,07-02-18,94,23:15,23:30,153.12,,0,153.12,153.12,1,-133540,44977,178517,-88563,0,0,86495,0,0,,86495,86495
27,07-02-18,95,23:30,23:45,49.68,,0,49.68,49.68,1,-135075,80262,215337,-54813,0,0,38992,0,0,,38992,38992
27,07-02-18,96,23:45,0:00,49.68,,0,49.68,49.68,1,-159476,113090,272566,-46386,0,0,15502,0,0,,15502,15502
27,07-03-18,1,0:00,0:15,152.02,,0,152.02,152.02,1,-192073,54018,246091,-138055,0,0,42411,0,0,,42411,42411
27,07-03-18,2,0:15,0:30,150.02,,0,150.02,150.02,1,-184089,51050,235139,-133039,0,0,104072,0,0,,104072,104072
27,07-03-18,3,0:30,0:45,342.23,,0,342.23,342.23,1,-150258,106522,256780,-43736,0,0,80834,5000,0,,85834,85834
27,07-03-18,4,0:45,1:00,342.23,30.4,0,342.23,30.4,2,-182533,164426,346959,-18107,0,-1641,11208,0,0,,12849,9567
27,07-03-18,5,1:00,1:15,43.49,,0,43.49,43.49,1,-120117,111463,231580,-8654,0,0,4783,0,0,,4783,4783
27,07-03-18,6,1:15,1:30,53.2,,0,53.2,53.2,1,-140633,109825,250458,-30808,0,0,20289,0,0,,20289,20289
27,07-03-18,7,1:30,1:45,50.45,,0,50.45,50.45,1,-144164,106786,250950,-37378,0,0,20854,0,0,,20854,20854
27,07-03-18,8,1:45,2:00,49.49,,0,49.49,49.49,1,-134613,101202,235815,-33411,0,0,34320,0,0,,34320,34320
27,07-03-18,9,2:00,2:15,153.02,,0,153.02,153.02,1,-190061,51769,241830,-138292,0,0,68020,0,0,,68020,68020
27,07-03-18,10,2:15,2:30,153.02,,0,153.02,153.02,1,-193401,60032,253433,-133369,0,0,106671,0,0,,106671,106671
27,07-03-18,11,2:30,2:45,49.49,,0,49.49,49.49,1,-169053,92807,261860,-76246,0,0,26522,0,0,,26522,26522
27,07-03-18,12,2:45,3:00,49.49,,0,49.49,49.49,1,-172287,89963,262250,-82324,0,0,7669,0,0,,7669,7669
27,07-03-18,13,3:00,3:15,145.02,,0,145.02,145.02,1,-222043,61297,283340,-160746,0,0,35060,0,0,,35060,35060
27,07-03-18,14,3:15,3:30,145.02,,0,145.02,145.02,1,-195736,73168,268904,-122568,0,0,103554,0,0,,103554,103554
27,07-03-18,15,3:30,3:45,49.49,38.18,0,38.18,38.18,-1,-142383,112755,255138,-29628,0,-6,44610,0,0,,44616,44604
27,07-03-18,16,3:45,4:00,49.49,37.21,0,37.21,37.21,-1,-110677,115628,226305,4951,0,-132,75,0,0,,207,-57
27,07-03-18,17,4:00,4:15,,,0,40.46,40.46,0,-83727,106490,190217,22763,0,0,0,0,0,,0,0
27,07-03-18,18,4:15,4:30,41.21,,0,41.21,41.21,1,-79250,79553,158803,303,0,0,498,0,0,,498,498
27,07-03-18,19,4:30,4:45,37.66,,0,37.66,37.66,1,-42303,63628,105931,21325,0,0,500,0,0,,500,500
27,07-03-18,20,4:45,5:00,37.66,,0,37.66,37.66,1,-54108,63937,118045,9829,0,0,398,0,0,,398,398
27,07-03-18,21,5:00,5:15,,37.21,0,37.21,37.21,-1,-58945,83512,142457,24567,0,-1403,0,0,0,,1403,-1403
27,07-03-18,22,5:15,5:30,,43.26,0,43.26,43.26,-1,-59128,83319,142447,24191,0,-274,0,0,0,,274,-274
27,07-03-18,23,5:30,5:45,,36.8,0,36.8,36.8,-1,-56442,66299,122741,9857,0,-5391,0,0,0,,5391,-5391
27,07-03-18,24,5:45,6:00,,43.12,0,43.12,43.12,-1,-58662,53614,112276,-5048,0,-1497,0,0,0,,1497,-1497
27,07-03-18,25,6:00,6:15,,32.44,0,32.44,32.44,-1,-53363,104013,157376,50650,0,-7051,0,0,0,,7051,-7051
27,07-03-18,26,6:15,6:30,,35.84,0,35.84,35.84,-1,-51201,70796,121997,19595,0,-10562,0,0,0,,10562,-10562
27,07-03-18,27,6:30,6:45,49.37,35.84,0,49.37,49.37,1,-80395,47203,127598,-33192,0,-1439,1001,0,0,,2440,-438
27,07-03-18,28,6:45,7:00,49.58,,0,49.58,49.58,1,-98337,96375,194712,-1962,0,0,4920,0,0,,4920,4920
27,07-03-18,29,7:00,7:15,49.58,30.37,0,30.37,30.37,-1,-67198,147576,214774,80378,0,-14654,18,0,0,,14672,-14636
27,07-03-18,30,7:15,7:30,,39.81,0,39.81,39.81,-1,-64070,88911,152981,24841,0,-5453,0,0,0,,5453,-5453
27,07-03-18,31,7:30,7:45,42.36,,0,42.36,42.36,1,-75414,76152,151566,738,0,0,103,0,0,,103,103
27,07-03-18,32,7:45,8:00,54.39,,0,54.39,54.39,1,-86078,50902,136980,-35176,0,0,14742,0,0,,14742,14742
27,07-03-18,33,8:00,8:15,44.97,40.98,0,40.98,40.98,-1,-77141,107298,184439,30157,0,-470,7422,0,0,,7892,6952
27,07-03-18,34,8:15,8:30,,40.98,0,40.98,40.98,-1,-76886,84502,161388,7616,0,-1230,0,0,0,,1230,-1230
27,07-03-18,35,8:30,8:45,,44.36,0,44.36,44.36,-1,-85377,65093,150470,-20284,0,-337,0,0,0,,337,-337
27,07-03-18,36,8:45,9:00,,44.1,0,44.1,44.1,-1,-87041,56306,143347,-30735,0,-64,0,0,0,,64,-64
27,07-03-18,37,9:00,9:15,,42.1,0,42.1,42.1,-1,-68250,82570,150820,14320,0,-1122,0,0,0,,1122,-1122
27,07-03-18,38,9:15,9:30,,43.1,0,43.1,43.1,-1,-62619,72821,135440,10202,0,-1009,0,0,0,,1009,-1009
27,07-03-18,39,9:30,9:45,,41.58,0,41.58,41.58,-1,-70643,88814,159457,18171,0,-489,0,0,0,,489,-489
27,07-03-18,40,9:45,10:00,,39.55,0,39.55,39.55,-1,-71621,102111,173732,30490,0,-2696,0,0,0,,2696,-2696
27,07-03-18,41,10:00,10:15,42.36,39.55,0,42.36,42.36,1,-70698,64707,135405,-5991,0,-367,1036,0,0,,1403,669
27,07-03-18,42,10:15,10:30,42.36,43.1,0,43.1,43.1,-1,-59238,70467,129705,11229,0,-27,186,0,0,,213,159
27,07-03-18,43,10:30,10:45,,41.17,0,41.17,41.17,-1,-61356,79217,140573,17861,0,-544,0,0,0,,544,-544
27,07-03-18,44,10:45,11:00,,41.47,0,41.47,41.47,-1,-66597,92375,158972,25778,0,-702,0,0,0,,702,-702
27,07-03-18,45,11:00,11:15,50.54,43.1,0,50.54,50.54,1,-105265,56939,162204,-48326,0,-246,7277,0,0,,7523,7031
27,07-03-18,46,11:15,11:30,46.82,,0,46.82,46.82,1,-99113,61221,160334,-37892,0,0,21554,0,0,,21554,21554
27,07-03-18,47,11:30,11:45,46.36,,0,46.36,46.36,1,-99427,81054,180481,-18373,0,0,15585,0,0,,15585,15585
27,07-03-18,48,11:45,12:00,42.36,41.17,0,41.17,41.17,-1,-93782,87210,180992,-6572,0,-53,1623,0,0,,1676,1570
27,07-03-18,49,12:00,12:15,42.36,38.17,0,43.35,38.17,2,-97828,95395,193223,-2433,0,-711,167,0,0,,878,-544
27,07-03-18,50,12:15,12:30,42.36,40.95,0,43.35,40.95,2,-72385,85604,157989,13219,0,-83,1628,0,0,,1711,1545
27,07-03-18,51,12:30,12:45,,39.9,0,39.9,39.9,-1,-66084,94041,160125,27957,0,-3187,0,0,0,,3187,-3187
27,07-03-18,52,12:45,13:00,,41.34,0,41.34,41.34,-1,-69846,91917,161763,22071,0,-385,0,0,0,,385,-385
27,07-03-18,53,13:00,13:15,46,,0,46,46,1,-80938,83319,164257,2381,0,0,868,0,0,,868,868
27,07-03-18,54,13:15,13:30,46.12,,0,46.12,46.12,1,-81167,69986,151153,-11181,0,0,4565,0,0,,4565,4565
27,07-03-18,55,13:30,13:45,50.54,,0,50.54,50.54,1,-84993,68496,153489,-16497,0,0,10993,0,0,,10993,10993
27,07-03-18,56,13:45,14:00,45.95,,0,45.95,45.95,1,-84942,64231,149173,-20711,0,0,13837,0,0,,13837,13837
27,07-03-18,57,14:00,14:15,48.13,,0,48.13,48.13,1,-89750,62287,152037,-27463,0,0,18629,0,0,,18629,18629
27,07-03-18,58,14:15,14:30,50.54,,0,50.54,50.54,1,-91329,57268,148597,-34061,0,0,25492,0,0,,25492,25492
27,07-03-18,59,14:30,14:45,47.37,,0,47.37,47.37,1,-85423,68089,153512,-17334,0,0,23756,0,0,,23756,23756
27,07-03-18,60,14:45,15:00,49.69,,0,49.69,49.69,1,-87401,64183,151584,-23218,0,0,21243,0,0,,21243,21243
27,07-03-18,61,15:00,15:15,48.03,,0,48.03,48.03,1,-80708,63559,144267,-17149,0,0,26427,0,0,,26427,26427
27,07-03-18,62,15:15,15:30,50.54,,0,50.54,50.54,1,-78607,54959,133566,-23648,0,0,26189,0,0,,26189,26189
27,07-03-18,63,15:30,15:45,67.39,,0,67.39,67.39,1,-87111,48496,135607,-38615,0,0,40429,0,0,,40429,40429
27,07-03-18,64,15:45,16:00,57.02,,0,57.02,57.02,1,-86796,44113,130909,-42683,0,0,48873,0,0,,48873,48873
27,07-03-18,65,16:00,16:15,50.54,,0,50.54,50.54,1,-79125,64160,143285,-14965,0,0,30265,0,0,,30265,30265
27,07-03-18,66,16:15,16:30,46.36,,0,46.36,46.36,1,-81851,65716,147567,-16135,0,0,5818,0,0,,5818,5818
27,07-03-18,67,16:30,16:45,51.02,,0,51.02,51.02,1,-88180,62006,150186,-26174,0,0,11122,0,0,,11122,11122
27,07-03-18,68,16:45,17:00,67.4,,0,67.4,67.4,1,-94902,55805,150707,-39097,0,0,44515,0,0,,44515,44515
27,07-03-18,69,17:00,17:15,47.75,,0,47.75,47.75,1,-85146,62883,148029,-22263,0,0,20409,0,0,,20409,20409
27,07-03-18,70,17:15,17:30,56.37,,0,56.37,56.37,1,-87055,56410,143465,-30645,0,0,22851,0,0,,22851,22851
27,07-03-18,71,17:30,17:45,56.37,,0,56.37,56.37,1,-97154,58502,155656,-38652,0,0,31736,0,0,,31736,31736
27,07-03-18,72,17:45,18:00,56.37,,0,56.37,56.37,1,-100077,55177,155254,-44900,0,0,36015,0,0,,36015,36015
27,07-03-18,73,18:00,18:15,56.59,,0,56.59,56.59,1,-85239,49790,135029,-35449,0,0,35109,0,0,,35109,35109
27,07-03-18,74,18:15,18:30,45.47,42.1,0,42.1,42.1,-1,-66257,59533,125790,-6724,0,-265,13454,0,0,,13719,13189
27,07-03-18,75,18:30,18:45,46.59,44.1,0,46.59,43.04,2,-69388,50979,120367,-18409,0,-22,2851,0,0,,2873,2829
27,07-03-18,76,18:45,19:00,46.59,,0,46.59,46.59,1,-72623,49698,122321,-22925,0,0,11677,0,0,,11677,11677
27,07-03-18,77,19:00,19:15,42.36,,0,42.36,42.36,1,-60773,40062,100835,-20711,0,0,3393,0,0,,3393,3393
27,07-03-18,78,19:15,19:30,50.54,,0,50.54,50.54,1,-85575,37324,122899,-48251,0,0,9311,0,0,,9311,9311
27,07-03-18,79,19:30,19:45,50.54,,0,50.54,50.54,1,-86408,43570,129978,-42838,0,0,31694,0,0,,31694,31694
27,07-03-18,80,19:45,20:00,50.54,,0,50.54,50.54,1,-95874,47596,143470,-48278,0,0,40109,0,0,,40109,40109
27,07-03-18,81,20:00,20:15,154.02,,0,154.02,154.02,1,-103705,20236,123941,-83469,0,0,57764,0,0,,57764,57764
27,07-03-18,82,20:15,20:30,88.1,,0,88.1,88.1,1,-77835,28363,106198,-49472,0,0,66669,0,0,,66669,66669
27,07-03-18,83,20:30,20:45,88.1,42.1,0,42.1,42.1,-1,-54662,41504,96166,-13158,0,-124,12760,0,0,,12884,12636
27,07-03-18,84,20:45,21:00,67.39,,0,67.39,67.39,1,-71513,37469,108982,-34044,0,0,5565,0,0,,5565,5565
27,07-03-18,85,21:00,21:15,146.8,,0,146.8,146.8,1,-108031,24211,132242,-83820,0,0,60946,0,0,,60946,60946
27,07-03-18,86,21:15,21:30,67.39,,0,67.39,67.39,1,-74209,34278,108487,-39931,0,0,49657,0,0,,49657,49657
27,07-03-18,87,21:30,21:45,67.39,42.1,0,42.1,42.1,-1,-61487,47322,108809,-14165,0,-103,4460,0,0,,4563,4357
27,07-03-18,88,21:45,22:00,51.02,,0,51.02,51.02,1,-67272,33028,100300,-34244,0,0,15278,0,0,,15278,15278
27,07-03-18,89,22:00,22:15,67.39,,0,67.39,67.39,1,-81354,29785,111139,-51569,0,0,34542,0,0,,34542,34542
27,07-03-18,90,22:15,22:30,67.39,,0,67.39,67.39,1,-88640,23475,112115,-65165,0,0,51177,0,0,,51177,51177
27,07-03-18,91,22:30,22:45,67.39,,0,67.39,67.39,1,-89919,18226,108145,-71693,0,0,62461,0,0,,62461,62461
27,07-03-18,92,22:45,23:00,67.02,,0,67.02,67.02,1,-71234,29441,100675,-41793,0,0,49611,0,0,,49611,49611
27,07-03-18,93,23:00,23:15,146.02,,0,146.02,146.02,1,-143250,23262,166512,-119988,0,0,62660,0,0,,62660,62660
27,07-03-18,94,23:15,23:30,109.6,,0,109.6,109.6,1,-96577,29629,126206,-66948,0,0,84433,0,0,,84433,84433
27,07-03-18,95,23:30,23:45,38.74,42.1,0,41.42,41.42,2,-58424,37324,95748,-21100,0,-296,20146,0,0,,20442,19850
27,07-03-18,96,23:45,0:00,46.36,,0,46.36,46.36,1,-61878,45415,107293,-16463,0,0,4833,0,0,,4833,4833
27,07-04-18,1,0:00,0:15,130.12,,0,130.12,130.12,1,-108090,26647,134737,-81443,0,0,37367,0,0,,37367,37367
27,07-04-18,2,0:15,0:30,56.12,,0,56.12,56.12,1,-64402,22561,86963,-41841,0,0,45547,0,0,,45547,45547
27,07-04-18,3,0:30,0:45,42.86,39.68,0,42.86,39.68,2,-39192,32720,71912,-6472,0,-160,13570,0,0,,13730,13410
27,07-04-18,4,0:45,1:00,,,0,41.35,41.35,0,-35191,36131,71322,940,0,0,0,0,0,,0,0
27,07-04-18,5,1:00,1:15,146.12,,0,146.12,146.12,1,-93777,13322,107099,-80455,0,0,17124,0,0,,17124,17124
27,07-04-18,6,1:15,1:30,146.12,,0,146.12,146.12,1,-78822,24026,102848,-54796,0,0,52998,0,0,,52998,52998
27,07-04-18,7,1:30,1:45,46.84,,0,46.84,46.84,1,-48597,33693,82290,-14904,0,0,14229,0,0,,14229,14229
27,07-04-18,8,1:45,2:00,46.84,42.78,0,42.78,42.78,-1,-38496,33269,71765,-5227,0,-208,250,0,0,,458,42
27,07-04-18,9,2:00,2:15,67.91,42.78,0,67.91,67.91,1,-71529,33873,105402,-37656,0,-301,12559,0,0,,12860,12258
27,07-04-18,10,2:15,2:30,51.05,,0,51.05,51.05,1,-73418,42455,115873,-30963,0,0,34045,0,0,,34045,34045
27,07-04-18,11,2:30,2:45,46.12,,0,46.12,46.12,1,-53611,33371,86982,-20240,0,0,13121,0,0,,13121,13121
27,07-04-18,12,2:45,3:00,46.86,,0,46.86,46.86,1,-45220,28254,73474,-16966,0,0,2853,0,0,,2853,2853
27,07-04-18,13,3:00,3:15,46.86,,0,46.86,46.86,1,-71418,22226,93644,-49192,0,0,1395,0,0,,1395,1395
27,07-04-18,14,3:15,3:30,38.24,,0,38.24,38.24,1,-65353,21777,87130,-43576,0,0,1238,0,0,,1238,1238
27,07-04-18,15,3:30,3:45,38.24,,0,38.24,38.24,1,-61802,23522,85324,-38280,0,0,24,0,0,,24,24
27,07-04-18,16,3:45,4:00,38.24,,0,38.24,38.24,1,-57974,21983,79957,-35991,0,0,12,0,0,,12,12
27,07-04-18,17,4:00,4:15,38.21,,0,38.21,38.21,1,-62416,21331,83747,-41085,0,0,167,0,0,,167,167
27,07-04-18,18,4:15,4:30,51.05,,0,51.05,51.05,1,-52202,22156,74358,-30046,0,0,10508,0,0,,10508,10508
27,07-04-18,19,4:30,4:45,51.05,,0,51.05,51.05,1,-67531,30149,97680,-37382,0,0,27138,0,0,,27138,27138
27,07-04-18,20,4:45,5:00,48.9,,0,48.9,48.9,1,-66915,34917,101832,-31998,0,0,26331,0,0,,26331,26331
27,07-04-18,21,5:00,5:15,45.84,,0,45.84,45.84,1,-58078,24370,82448,-33708,0,0,9640,0,0,,9640,9640
27,07-04-18,22,5:15,5:30,42.86,,0,42.86,42.86,1,-57298,19613,76911,-37685,0,0,1472,0,0,,1472,1472
27,07-04-18,23,5:30,5:45,51.05,,0,51.05,51.05,1,-66128,18128,84256,-48000,0,0,3185,0,0,,3185,3185
27,07-04-18,24,5:45,6:00,51.36,,0,51.36,51.36,1,-86533,24959,111492,-61574,0,0,6365,0,0,,6365,6365
27,07-04-18,25,6:00,6:15,51.36,39.18,0,39.18,39.18,-1,-36339,67304,103643,30965,0,-2554,583,0,0,,3137,-1971
27,07-04-18,26,6:15,6:30,,38.26,0,38.26,38.26,-1,-45233,35222,80455,-10011,0,-8919,0,0,0,,8919,-8919
27,07-04-18,27,6:30,6:45,43.37,38.26,0,43.37,43.37,1,-91777,28938,120715,-62839,0,-48,510,0,0,,558,462
27,07-04-18,28,6:45,7:00,146.12,,0,146.12,146.12,1,-143498,29894,173392,-113604,0,0,17372,0,0,,17372,17372
27,07-04-18,29,7:00,7:15,47.37,31.39,0,47.37,31.39,2,-42979,124523,167502,81544,0,-6754,9166,0,0,,15920,2412
27,07-04-18,30,7:15,7:30,,41.78,0,41.78,41.78,-1,-35853,73467,109320,37614,0,-5835,0,0,0,,5835,-5835
27,07-04-18,31,7:30,7:45,,42.13,0,42.13,42.13,-1,-42429,43114,85543,685,0,-2320,0,0,0,,2320,-2320
27,07-04-18,32,7:45,8:00,118.45,42.13,0,118.45,118.45,1,-73916,33987,107903,-39929,0,-363,20049,0,0,,20412,19686
27,07-04-18,33,8:00,8:15,47.37,32.9,0,47.37,32.9,2,-32217,80098,112315,47881,0,-5499,9524,0,0,,15023,4025
27,07-04-18,34,8:15,8:30,,42.1,0,42.1,42.1,-1,-28186,62198,90384,34012,0,-5141,0,0,0,,5141,-5141
27,07-04-18,35,8:30,8:45,,42.17,0,42.17,42.17,-1,-28716,57685,86401,28969,0,-2928,0,0,0,,2928,-2928
27,07-04-18,36,8:45,9:00,,42.78,0,42.78,42.78,-1,-39072,47557,86629,8485,0,-1552,0,0,0,,1552,-1552
27,07-04-18,37,9:00,9:15,47.37,42.78,0,47.37,47.37,1,-72968,55951,128919,-17017,0,-17,4408,0,0,,4425,4391
27,07-04-18,38,9:15,9:30,47.02,,0,47.02,47.02,1,-64265,59208,123473,-5057,0,0,2408,0,0,,2408,2408
27,07-04-18,39,9:30,9:45,46.13,,0,46.13,46.13,1,-62139,56118,118257,-6021,0,0,2658,0,0,,2658,2658
27,07-04-18,40,9:45,10:00,46.92,,0,46.92,46.92,1,-54980,50989,105969,-3991,0,0,1276,0,0,,1276,1276
27,07-04-18,41,10:00,10:15,47.41,,0,47.41,47.41,1,-65760,42545,108305,-23215,0,0,1911,0,0,,1911,1911
27,07-04-18,42,10:15,10:30,43.1,,0,43.1,43.1,1,-48550,45130,93680,-3420,0,0,166,0,0,,166,166
27,07-04-18,43,10:30,10:45,,,0,43.6,43.6,0,-47508,50989,98497,3481,0,0,0,0,0,,0,0
27,07-04-18,44,10:45,11:00,47.37,,0,47.37,47.37,1,-51190,50834,102024,-356,0,0,698,0,0,,698,698
27,07-04-18,45,11:00,11:15,70,,0,70,70,1,-95885,53894,149779,-41991,0,0,29063,0,0,,29063,29063
27,07-04-18,46,11:15,11:30,48.73,,0,48.73,48.73,1,-78633,55296,133929,-23337,0,0,32738,0,0,,32738,32738
27,07-04-18,47,11:30,11:45,47.37,43.1,0,43.1,43.1,-1,-64539,57585,122124,-6954,0,-6,19651,0,0,,19657,19645
27,07-04-18,48,11:45,12:00,47.37,42.1,0,42.1,42.1,-1,-60451,72571,133022,12120,0,-662,1461,0,0,,2123,799
27,07-04-18,49,12:00,12:15,,,0,43.56,43.56,0,-67227,49186,116413,-18041,0,0,0,0,0,,0,0
27,07-04-18,50,12:15,12:30,,41.08,0,41.08,41.08,-1,-63494,46313,109807,-17181,0,-6309,0,0,0,,6309,-6309
27,07-04-18,51,12:30,12:45,,42.04,0,42.04,42.04,-1,-64187,47703,111890,-16484,0,-3194,0,0,0,,3194,-3194
27,07-04-18,52,12:45,13:00,,,0,43.55,43.55,0,-69412,45968,115380,-23444,0,0,0,0,0,,0,0
27,07-04-18,53,13:00,13:15,,42.04,0,42.04,42.04,-1,-86969,50590,137559,-36379,0,-173,0,0,0,,173,-173
27,07-04-18,54,13:15,13:30,,,0,43.52,43.52,0,-114403,42778,157181,-71625,0,0,0,0,0,,0,0
27,07-04-18,55,13:30,13:45,,,0,43.52,43.52,0,-107940,40535,148475,-67405,0,0,0,0,0,,0,0
27,07-04-18,56,13:45,14:00,,,0,43.52,43.52,0,-115507,40862,156369,-74645,0,0,0,0,0,,0,0
27,07-04-18,57,14:00,14:15,71.31,,0,71.31,71.31,1,-128839,30614,159453,-98225,0,0,6348,0,0,,6348,6348
27,07-04-18,58,14:15,14:30,71.31,,0,71.31,71.31,1,-104992,31345,136337,-73647,0,0,26077,0,0,,26077,26077
27,07-04-18,59,14:30,14:45,71.31,43.1,0,43.1,43.1,-1,-93191,43876,137067,-49315,0,-223,2660,0,0,,2883,2437
27,07-04-18,60,14:45,15:00,,,0,43.47,43.47,0,-98394,28247,126641,-70147,0,0,0,0,0,,0,0
27,07-04-18,61,15:00,15:15,,,0,43.49,43.49,0,-90874,44514,135388,-46360,0,0,0,0,0,,0,0
27,07-04-18,62,15:15,15:30,68.48,,0,68.48,68.48,1,-97632,26409,124041,-71223,0,0,9479,0,0,,9479,9479
27,07-04-18,63,15:30,15:45,68.48,,0,68.48,68.48,1,-101845,24064,125909,-77781,0,0,38172,0,0,,38172,38172
27,07-04-18,64,15:45,16:00,49.19,,0,49.19,49.19,1,-95828,21326,117154,-74502,0,0,29887,0,0,,29887,29887
27,07-04-18,65,16:00,16:15,,,0,43.51,43.51,0,-77606,34361,111967,-43245,0,0,7736,0,0,,7736,7736
27,07-04-18,66,16:15,16:30,43.37,,0,43.37,43.37,1,-79298,31409,110707,-47889,0,0,2,0,0,,2,2
27,07-04-18,67,16:30,16:45,47.43,,0,47.43,47.43,1,-106349,29751,136100,-76598,0,0,7277,0,0,,7277,7277
27,07-04-18,68,16:45,17:00,69.9,,0,69.9,69.9,1,-131373,31151,162524,-100222,0,0,31318,0,0,,31318,31318
27,07-04-18,69,17:00,17:15,61,,0,61,61,1,-105860,32176,138036,-73684,0,0,30771,0,0,,30771,30771
27,07-04-18,70,17:15,17:30,81,,0,81,81,1,-124024,32942,156966,-91082,0,0,44251,0,0,,44251,44251
27,07-04-18,71,17:30,17:45,81,,0,81,81,1,-119717,37341,157058,-82376,0,0,50039,0,0,,50039,50039
27,07-04-18,72,17:45,18:00,81,,0,81,81,1,-115855,39719,155574,-76136,0,0,54561,0,0,,54561,54561
27,07-04-18,73,18:00,18:15,81,-63.72,0,-63.72,-63.72,-1,-46596,76504,123100,29908,0,-20565,13725,0,0,,34290,-6840
27,07-04-18,74,18:15,18:30,,35.18,0,35.18,35.18,-1,-73197,41288,114485,-31909,0,-28074,0,0,0,,28074,-28074
27,07-04-18,75,18:30,18:45,,37.93,0,37.93,37.93,-1,-67904,52959,120863,-14945,0,-21843,0,0,0,,21843,-21843
27,07-04-18,76,18:45,19:00,43.37,37.93,0,43.37,43.37,1,-75712,45608,121320,-30104,0,-4034,99,0,0,,4133,-3935
27,07-04-18,77,19:00,19:15,47.37,,0,47.37,47.37,1,-99502,20536,120038,-78966,0,0,2177,0,0,,2177,2177
27,07-04-18,78,19:15,19:30,43.37,,0,43.37,43.37,1,-104158,18934,123092,-85224,0,0,1924,0,0,,1924,1924
27,07-04-18,79,19:30,19:45,43.37,,0,43.37,43.37,1,-120019,18921,138940,-101098,0,0,2126,0,0,,2126,2126
27,07-04-18,80,19:45,20:00,43.37,,0,43.37,43.37,1,-118579,17717,136296,-100862,0,0,2452,0,0,,2452,2452
27,07-04-18,81,20:00,20:15,51.57,,0,51.57,51.57,1,-119229,17545,136774,-101684,0,0,6103,0,0,,6103,6103
27,07-04-18,82,20:15,20:30,47.37,,0,47.37,47.37,1,-107720,22416,130136,-85304,0,0,3840,0,0,,3840,3840
27,07-04-18,83,20:30,20:45,43.37,,0,43.37,43.37,1,-96779,31523,128302,-65256,0,0,2965,0,0,,2965,2965
27,07-04-18,84,20:45,21:00,,,0,27.05,27.05,0,-94165,39536,133701,-54629,0,0,238,0,0,,238,238
27,07-04-18,85,21:00,21:15,145.12,,0,145.12,145.12,1,-142950,25228,168178,-117722,0,0,23592,0,0,,23592,23592
27,07-04-18,86,21:15,21:30,68.45,,0,68.45,68.45,1,-115352,28930,144282,-86422,0,0,51096,0,0,,51096,51096
27,07-04-18,87,21:30,21:45,43.37,41.78,0,43.52,41.78,2,-68116,11022,79138,-57094,0,-896,13574,0,0,,14470,12678
27,07-04-18,88,21:45,22:00,46.2,,0,46.2,46.2,1,-80428,23879,104307,-56549,0,0,1753,0,0,,1753,1753
27,07-04-18,89,22:00,22:15,52.12,,0,52.12,52.12,1,-114461,35821,150282,-78640,0,0,14220,0,0,,14220,14220
27,07-04-18,90,22:15,22:30,51.56,,0,51.56,51.56,1,-117730,25789,143519,-91941,0,0,30108,0,0,,30108,30108
27,07-04-18,91,22:30,22:45,50.73,,0,50.73,50.73,1,-105469,24602,130071,-80867,0,0,29225,0,0,,29225,29225
27,07-04-18,92,22:45,23:00,43.37,40.5,0,43.6,40.5,2,-84348,31092,115440,-53256,0,-2123,9347,0,0,,11470,7224
27,07-04-18,93,23:00,23:15,51.56,40.5,0,51.56,51.56,1,-144981,26521,171502,-118460,0,-278,7030,0,0,,7308,6752
27,07-04-18,94,23:15,23:30,47.23,,0,47.23,47.23,1,-148835,59544,208379,-89291,0,0,7926,0,0,,7926,7926
27,07-04-18,95,23:30,23:45,47.23,40.94,0,40.94,40.94,-1,-117081,59142,176223,-57939,0,-1099,297,0,0,,1396,-802
27,07-04-18,96,23:45,0:00,,31.39,0,31.39,31.39,-1,-85592,63164,148756,-22428,0,-35724,0,0,0,,35724,-35724
27,07-05-18,1,0:00,0:15,90.12,31.99,0,90.12,31.99,2,-132887,18565,151452,-114322,0,-23917,7706,0,0,,31623,-16211
27,07-05-18,2,0:15,0:30,43.37,,0,43.37,43.37,1,-85877,35924,121801,-49953,0,0,2930,0,0,,2930,2930
27,07-05-18,3,0:30,0:45,,36.98,0,36.98,36.98,-1,-49155,31911,81066,-17244,0,-2738,0,0,0,,2738,-2738
27,07-05-18,4,0:45,1:00,,39.18,0,39.18,39.18,-1,-57572,29407,86979,-28165,0,-10347,0,0,0,,10347,-10347
27,07-05-18,5,1:00,1:15,,36.73,0,36.73,36.73,-1,-103342,46458,149800,-56884,0,-7985,0,0,0,,7985,-7985
27,07-05-18,6,1:15,1:30,,39.18,0,39.18,39.18,-1,-49927,29439,79366,-20488,0,-1418,0,0,0,,1418,-1418
27,07-05-18,7,1:30,1:45,,39.18,0,39.18,39.18,-1,-46357,40914,87271,-5443,0,-1770,0,0,0,,1770,-1770
27,07-05-18,8,1:45,2:00,,29.37,0,29.37,29.37,-1,-36709,52690,89399,15981,0,-6108,0,0,0,,6108,-6108
27,07-05-18,9,2:00,2:15,,25.52,0,25.52,25.52,-1,-69491,21950,91441,-47541,0,-8929,0,0,0,,8929,-8929
27,07-05-18,10,2:15,2:30,,40.62,0,40.62,40.62,-1,-65795,36472,102267,-29323,0,-40,0,0,0,,40,-40
27,07-05-18,11,2:30,2:45,,39.18,0,39.18,39.18,-1,-55622,40567,96189,-15055,0,-1437,0,0,0,,1437,-1437
27,07-05-18,12,2:45,3:00,,34.71,0,34.71,34.71,-1,-54346,38627,92973,-15719,0,-9840,0,0,0,,9840,-9840
27,07-05-18,13,3:00,3:15,,39.18,0,39.18,39.18,-1,-64663,21435,86098,-43228,0,-8548,0,0,0,,8548,-8548
27,07-05-18,14,3:15,3:30,,,0,40.79,40.79,0,-63085,42446,105531,-20639,0,-37,0,0,0,,37,-37
27,07-05-18,15,3:30,3:45,,,0,40.77,40.77,0,-53891,45458,99349,-8433,0,0,0,0,0,,0,0
27,07-05-18,16,3:45,4:00,,,0,40.76,40.76,0,-57992,42915,100907,-15077,0,0,0,0,0,,0,0
27,07-05-18,17,4:00,4:15,,,0,40.79,40.79,0,-68687,41997,110684,-26690,0,0,0,0,0,,0,0
27,07-05-18,18,4:15,4:30,,,0,40.79,40.79,0,-56596,37007,93603,-19589,0,0,0,0,0,,0,0
27,07-05-18,19,4:30,4:45,,,0,40.81,40.81,0,-68126,34498,102624,-33628,0,0,0,0,0,,0,0
27,07-05-18,20,4:45,5:00,,39.99,0,39.99,39.99,-1,-55627,31411,87038,-24216,0,-1044,0,0,0,,1044,-1044
27,07-05-18,21,5:00,5:15,,29.36,0,29.36,29.36,-1,-55497,41055,96552,-14442,0,-17236,0,0,0,,17236,-17236
27,07-05-18,22,5:15,5:30,,34.72,0,34.72,34.72,-1,-61685,28194,89879,-33491,0,-40583,0,0,0,,40583,-40583
27,07-05-18,23,5:30,5:45,,35.18,0,35.18,35.18,-1,-67890,18726,86616,-49164,0,-41551,0,0,0,,41551,-41551
27,07-05-18,24,5:45,6:00,,15.77,0,15.77,15.77,-1,-84238,14427,98665,-69811,0,-28963,0,0,0,,28963,-28963
27,07-05-18,25,6:00,6:15,,16.04,0,16.04,16.04,-1,-108348,87170,195518,-21178,0,-50375,0,0,0,,50375,-50375
27,07-05-18,26,6:15,6:30,46.68,41.5,0,46.68,41.45,2,-84714,57042,141756,-27672,0,-6805,230,0,0,,7035,-6575
27,07-05-18,27,6:30,6:45,,40.75,0,40.75,40.75,-1,-91409,26932,118341,-64477,0,-1233,0,0,0,,1233,-1233
27,07-05-18,28,6:45,7:00,,41.99,0,41.99,41.99,-1,-121718,15751,137469,-105967,0,-400,0,0,0,,400,-400
27,07-05-18,29,7:00,7:15,,30.86,0,30.86,30.86,-1,-51295,76177,127472,24882,0,-11391,0,0,0,,11391,-11391
27,07-05-18,30,7:15,7:30,47.29,38.03,0,47.29,47.29,1,-77647,44485,122132,-33162,0,-20964,335,0,0,,21299,-20629
27,07-05-18,31,7:30,7:45,48.05,38.03,0,48.05,48.05,1,-99825,25785,125610,-74040,0,-575,985,0,0,,1560,410
27,07-05-18,32,7:45,8:00,96.49,,0,96.49,96.49,1,-117559,14814,132373,-102745,0,0,28796,0,0,,28796,28796
27,07-05-18,33,8:00,8:15,50.9,,0,50.9,50.9,1,-112333,44028,156361,-68305,0,0,31418,0,0,,31418,31418
27,07-05-18,34,8:15,8:30,48.04,,0,48.04,48.04,1,-96148,23522,119670,-72626,0,0,12302,0,0,,12302,12302
27,07-05-18,35,8:30,8:45,50.9,,0,50.9,50.9,1,-105131,8935,114066,-96196,0,0,13922,0,0,,13922,13922
27,07-05-18,36,8:45,9:00,52.23,,0,52.23,52.23,1,-126121,8908,135029,-117213,0,0,3708,0,0,,3708,3708
27,07-05-18,37,9:00,9:15,44.04,,0,44.04,44.04,1,-135334,26949,162283,-108385,0,0,2777,0,0,,2777,2777
27,07-05-18,38,9:15,9:30,,,0,43.16,43.16,0,-135157,21560,156717,-113597,0,0,0,0,0,,0,0
27,07-05-18,39,9:30,9:45,,,0,43.15,43.15,0,-129417,20902,150319,-108515,0,0,0,0,0,,0,0
27,07-05-18,40,9:45,10:00,,41.9,0,41.9,41.9,-1,-107639,20618,128257,-87021,0,-22,0,0,0,,22,-22
27,07-05-18,41,10:00,10:15,,40.3,0,40.3,40.3,-1,-110903,22838,133741,-88065,0,-325,0,0,0,,325,-325
27,07-05-18,42,10:15,10:30,,40.36,0,40.36,40.36,-1,-105764,21323,127087,-84441,0,-1830,0,0,0,,1830,-1830
27,07-05-18,43,10:30,10:45,,39.33,0,39.33,39.33,-1,-115056,17689,132745,-97367,0,-5585,0,0,0,,5585,-5585
27,07-05-18,44,10:45,11:00,,41.5,0,41.5,41.5,-1,-118912,16512,135424,-102400,0,-2996,0,0,0,,2996,-2996
27,07-05-18,45,11:00,11:15,,41.22,0,41.22,41.22,-1,-156294,13226,169520,-143068,0,-2532,0,0,0,,2532,-2532
27,07-05-18,46,11:15,11:30,,,0,43.03,43.03,0,-142788,16360,159148,-126428,0,-156,0,0,0,,156,-156
27,07-05-18,47,11:30,11:45,,42.29,0,42.29,42.29,-1,-135507,22439,157946,-113068,0,-1056,0,0,0,,1056,-1056
27,07-05-18,48,11:45,12:00,,42.3,0,42.3,42.3,-1,-124421,22521,146942,-101900,0,-393,0,0,0,,393,-393
27,07-05-18,49,12:00,12:15,,42.28,0,42.28,42.28,-1,-155891,21058,176949,-134833,0,-80,0,0,0,,80,-80
27,07-05-18,50,12:15,12:30,,42.31,0,42.31,42.31,-1,-145309,23374,168683,-121935,0,-22,0,0,0,,22,-22
27,07-05-18,51,12:30,12:45,,41.45,0,41.45,41.45,-1,-135097,36315,171412,-98782,0,-1504,0,0,0,,1504,-1504
27,07-05-18,52,12:45,13:00,,41.45,0,41.45,41.45,-1,-130944,31579,162523,-99365,0,-3350,0,0,0,,3350,-3350
27,07-05-18,53,13:00,13:15,,37.99,0,37.99,37.99,-1,-127343,32010,159353,-95333,0,-7922,0,0,0,,7922,-7922
27,07-05-18,54,13:15,13:30,,39.16,0,39.16,39.16,-1,-129050,34089,163139,-94961,0,-6581,0,0,0,,6581,-6581
27,07-05-18,55,13:30,13:45,,40.03,0,40.03,40.03,-1,-131097,32809,163906,-98288,0,-5815,0,0,0,,5815,-5815
27,07-05-18,56,13:45,14:00,,37.83,0,37.83,37.83,-1,-129239,37470,166709,-91769,0,-17452,0,0,0,,17452,-17452
27,07-05-18,57,14:00,14:15,,37.99,0,37.99,37.99,-1,-135860,27814,163674,-108046,0,-16837,0,0,0,,16837,-16837
27,07-05-18,58,14:15,14:30,,,0,42.79,42.79,0,-139443,38286,177729,-101157,0,-482,0,0,0,,482,-482
27,07-05-18,59,14:30,14:45,,38.84,0,38.84,38.84,-1,-127056,48133,175189,-78923,0,-314,0,0,0,,314,-314
27,07-05-18,60,14:45,15:00,,28.01,0,28.01,28.01,-1,-113707,36842,150549,-76865,0,-28273,0,0,0,,28273,-28273
27,07-05-18,61,15:00,15:15,,30.86,0,30.86,30.86,-1,-110684,33486,144170,-77198,0,-44059,0,0,0,,44059,-44059
27,07-05-18,62,15:15,15:30,,34.84,0,34.84,34.84,-1,-118484,32226,150710,-86258,0,-40402,0,0,0,,40402,-40402
27,07-05-18,63,15:30,15:45,,37.77,0,37.77,37.77,-1,-131221,41267,172488,-89954,0,-34472,0,0,0,,34472,-34472
27,07-05-18,64,15:45,16:00,,38.84,0,38.84,38.84,-1,-135585,32278,167863,-103307,0,-21507,0,0,0,,21507,-21507
27,07-05-18,65,16:00,16:15,,34.84,0,34.84,34.84,-1,-111143,41177,152320,-69966,0,-26083,0,0,0,,26083,-26083
27,07-05-18,66,16:15,16:30,,32.56,0,32.56,32.56,-1,-124321,29257,153578,-95064,0,-34210,0,0,0,,34210,-34210
27,07-05-18,67,16:30,16:45,,32.52,0,32.52,32.52,-1,-115303,36990,152293,-78313,0,-33235,0,0,0,,33235,-33235
27,07-05-18,68,16:45,17:00,,42.27,0,42.27,42.27,-1,-120632,44589,165221,-76043,0,-6126,0,0,0,,6126,-6126
27,07-05-18,69,17:00,17:15,,33.88,0,33.88,33.88,-1,-102887,46036,148923,-56851,0,-1949,0,0,0,,1949,-1949
27,07-05-18,70,17:15,17:30,,30.86,0,30.86,30.86,-1,-116767,23938,140705,-92829,0,-8619,0,0,0,,8619,-8619
27,07-05-18,71,17:30,17:45,,34.84,0,34.84,34.84,-1,-123150,26652,149802,-96498,0,-6709,0,0,0,,6709,-6709
27,07-05-18,72,17:45,18:00,,42.28,0,42.28,42.28,-1,-138419,31693,170112,-106726,0,-1849,0,0,0,,1849,-1849
27,07-05-18,73,18:00,18:15,,34.84,0,34.84,34.84,-1,-118788,9473,128261,-109315,0,-7672,0,0,0,,7672,-7672
27,07-05-18,74,18:15,18:30,,38.84,0,38.84,38.84,-1,-116374,14982,131356,-101392,0,-23519,0,0,0,,23519,-23519
27,07-05-18,75,18:30,18:45,,39.03,0,39.03,39.03,-1,-117351,16398,133749,-100953,0,-19557,0,0,0,,19557,-19557
27,07-05-18,76,18:45,19:00,,,0,40.94,40.94,0,-109315,19910,129225,-89405,0,-5519,0,0,0,,5519,-5519
27,07-05-18,77,19:00,19:15,,30.86,0,30.86,30.86,-1,-84979,16653,101632,-68326,0,-7132,0,0,0,,7132,-7132
27,07-05-18,78,19:15,19:30,,38.84,0,38.84,38.84,-1,-109661,15686,125347,-93975,0,-6955,0,0,0,,6955,-6955
27,07-05-18,79,19:30,19:45,,40.76,0,40.76,40.76,-1,-122978,12870,135848,-110108,0,-6831,0,0,0,,6831,-6831
27,07-05-18,80,19:45,20:00,,,0,42.83,42.83,0,-130716,10218,140934,-120498,0,-1132,0,0,0,,1132,-1132
27,07-05-18,81,20:00,20:15,,40.22,0,40.22,40.22,-1,-106017,6499,112516,-99518,0,-599,0,0,0,,599,-599
27,07-05-18,82,20:15,20:30,,42.28,0,42.28,42.28,-1,-109450,6690,116140,-102760,0,-1346,0,0,0,,1346,-1346
27,07-05-18,83,20:30,20:45,,42.03,0,42.03,42.03,-1,-102159,8854,111013,-93305,0,-2245,0,0,0,,2245,-2245
27,07-05-18,84,20:45,21:00,,34.84,0,34.84,34.84,-1,-101925,22173,124098,-79752,0,-9649,0,0,0,,9649,-9649
27,07-05-18,85,21:00,21:15,,39.86,0,39.86,39.86,-1,-100533,21807,122340,-78726,0,-7036,0,0,0,,7036,-7036
27,07-05-18,86,21:15,21:30,,37.99,0,37.99,37.99,-1,-74017,26434,100451,-47583,0,-1085,0,0,0,,1085,-1085
27,07-05-18,87,21:30,21:45,,34.84,0,34.84,34.84,-1,-57589,32477,90066,-25112,0,-3530,0,0,0,,3530,-3530
27,07-05-18,88,21:45,22:00,,30.86,0,30.86,30.86,-1,-56325,43538,99863,-12787,0,-9584,0,0,0,,9584,-9584
27,07-05-18,89,22:00,22:15,,16.47,0,16.47,16.47,-1,-105350,14038,119388,-91312,0,-40153,0,0,0,,40153,-40153
27,07-05-18,90,22:15,22:30,,41.23,0,41.23,41.23,-1,-119906,13425,133331,-106481,0,-9616,0,0,0,,9616,-9616
27,07-05-18,91,22:30,22:45,,41.24,0,41.24,41.24,-1,-104182,16331,120513,-87851,0,-432,0,0,0,,432,-432
27,07-05-18,92,22:45,23:00,,39.46,0,39.46,39.46,-1,-87051,19969,107020,-67082,0,-2061,0,0,0,,2061,-2061
27,07-05-18,93,23:00,23:15,44.04,42.03,0,44.04,42.03,2,-127373,11649,139022,-115724,0,-1186,787,0,0,,1973,-399
27,07-05-18,94,23:15,23:30,,34.84,0,34.84,34.84,-1,-81483,14171,95654,-67312,0,-3483,0,0,0,,3483,-3483
27,07-05-18,95,23:30,23:45,,30.86,0,30.86,30.86,-1,-60032,25014,85046,-35018,0,-12243,0,0,0,,12243,-12243
27,07-05-18,96,23:45,0:00,,14.93,0,14.93,14.93,-1,-69135,62490,131625,-6645,0,-53873,0,0,0,,53873,-53873
27,07-06-18,1,0:00,0:15,,10.59,0,10.59,10.59,-1,-85953,29561,115514,-56392,0,-54801,0,0,0,,54801,-54801
27,07-06-18,2,0:15,0:30,,-1.99,0,-1.99,-1.99,-1,-61241,12534,73775,-48707,0,-23836,0,0,0,,23836,-23836
27,07-06-18,3,0:30,0:45,,-4.47,0,-4.47,-4.47,-1,-61326,38197,99523,-23129,0,-81531,0,0,0,,81531,-81531
27,07-06-18,4,0:45,1:00,,-8.55,0,-8.55,-8.55,-1,-48684,27597,76281,-21087,0,-113831,0,0,0,,113831,-113831
27,07-06-18,5,1:00,1:15,,3.4,0,3.4,3.4,-1,-83300,19637,102937,-63663,0,-83769,0,0,0,,83769,-83769
27,07-06-18,6,1:15,1:30,,-72.05,0,-72.05,-72.05,-1,-62383,9872,72255,-52511,0,-23608,0,0,0,,23608,-23608
27,07-06-18,7,1:30,1:45,,-150.78,0,-150.78,-150.78,-1,-65891,20730,86621,-45161,0,-93050,0,0,0,,93050,-93050
27,07-06-18,8,1:45,2:00,,-2.27,0,-2.27,-2.27,-1,-79515,35972,115487,-43543,0,-112046,0,0,0,,112046,-112046
27,07-06-18,9,2:00,2:15,,18.09,0,18.09,18.09,-1,-127565,21585,149150,-105980,0,-56466,0,0,0,,56466,-56466
27,07-06-18,10,2:15,2:30,,34.87,0,34.87,34.87,-1,-81642,54290,135932,-27352,0,-856,0,0,0,,856,-856
27,07-06-18,11,2:30,2:45,,34.56,0,34.56,34.56,-1,-68426,40046,108472,-28380,0,-4742,0,0,0,,4742,-4742
27,07-06-18,12,2:45,3:00,,7.41,0,7.41,7.41,-1,-65687,22484,88171,-43203,0,-51649,0,0,0,,51649,-51649
27,07-06-18,13,3:00,3:15,,21.17,0,21.17,21.17,-1,-98236,14227,112463,-84009,0,-49596,0,0,0,,49596,-49596
27,07-06-18,14,3:15,3:30,,30.84,0,30.84,30.84,-1,-67759,34804,102563,-32955,0,-2225,0,0,0,,2225,-2225
27,07-06-18,15,3:30,3:45,,30.79,0,30.79,30.79,-1,-97921,18490,116411,-79431,0,-15798,0,0,0,,15798,-15798
27,07-06-18,16,3:45,4:00,,27.36,0,27.36,27.36,-1,-73332,20263,93595,-53069,0,-28618,0,0,0,,28618,-28618
27,07-06-18,17,4:00,4:15,,34.56,0,34.56,34.56,-1,-92227,17989,110216,-74238,0,-18678,0,0,0,,18678,-18678
27,07-06-18,18,4:15,4:30,,21.17,0,21.17,21.17,-1,-71745,9148,80893,-62597,0,-34223,0,0,0,,34223,-34223
27,07-06-18,19,4:30,4:45,,38.56,0,38.56,38.56,-1,-82457,24722,107179,-57735,0,-16229,0,0,0,,16229,-16229
27,07-06-18,20,4:45,5:00,,,0,40.78,40.78,0,-88288,25943,114231,-62345,0,-34,0,0,0,,34,-34
27,07-06-18,21,5:00,5:15,,,0,40.73,40.73,0,-74256,57955,132211,-16301,0,0,0,0,0,,0,0
27,07-06-18,22,5:15,5:30,,,0,40.73,40.73,0,-70843,46486,117329,-24357,0,0,0,0,0,,0,0
27,07-06-18,23,5:30,5:45,,,0,40.81,40.81,0,-76728,42554,119282,-34174,0,0,0,0,0,,0,0
27,07-06-18,24,5:45,6:00,,25.92,0,25.92,25.92,-1,-91487,36795,128282,-54692,0,-5676,0,0,0,,5676,-5676
27,07-06-18,25,6:00,6:15,145.12,11.8,0,145.12,11.8,2,-95657,57835,153492,-37822,0,-30927,7098,0,0,,38025,-23829
27,07-06-18,26,6:15,6:30,68.19,11.8,0,68.19,68.19,1,-68418,45150,113568,-23268,0,-396,5208,0,0,,5604,4812
27,07-06-18,27,6:30,6:45,68.19,,0,68.19,68.19,1,-84176,42109,126285,-42067,0,0,35693,0,0,,35693,35693
27,07-06-18,28,6:45,7:00,50.88,,0,50.88,50.88,1,-87792,42526,130318,-45266,0,0,34543,0,0,,34543,34543
27,07-06-18,29,7:00,7:15,46.65,34.65,0,34.65,34.65,-1,-63799,87531,151330,23732,0,-1287,21344,0,0,,22631,20057
27,07-06-18,30,7:15,7:30,46.65,30.69,0,30.69,30.69,-1,-58611,79294,137905,20683,0,-13765,949,0,0,,14714,-12816
27,07-06-18,31,7:30,7:45,70.12,30.69,0,70.12,70.12,1,-82742,50123,132865,-32619,0,-330,8713,0,0,,9043,8383
27,07-06-18,32,7:45,8:00,129.12,,0,129.12,129.12,1,-100173,52792,152965,-47381,0,0,50288,0,0,,50288,50288
27,07-06-18,33,8:00,8:15,46.65,39.43,0,39.43,39.43,-1,-87301,91787,179088,4486,0,-285,19673,0,0,,19958,19388
27,07-06-18,34,8:15,8:30,48.81,38.65,0,48.81,48.81,1,-80124,60222,140346,-19902,0,-261,4415,0,0,,4676,4154
27,07-06-18,35,8:30,8:45,50.88,,0,50.88,50.88,1,-80926,52097,133023,-28829,0,0,24228,0,0,,24228,24228
27,07-06-18,36,8:45,9:00,46.65,,0,46.65,46.65,1,-76574,53444,130018,-23130,0,0,13923,0,0,,13923,13923
27,07-06-18,37,9:00,9:15,46.65,,0,46.65,46.65,1,-70925,60727,131652,-10198,0,0,12770,0,0,,12770,12770
27,07-06-18,38,9:15,9:30,45.94,,0,45.94,45.94,1,-62027,57541,119568,-4486,0,0,2511,0,0,,2511,2511
27,07-06-18,39,9:30,9:45,42.65,,0,42.65,42.65,1,-46814,60665,107479,13851,0,0,820,0,0,,820,820
27,07-06-18,40,9:45,10:00,,,0,42.63,42.63,0,-43264,77810,121074,34546,0,0,0,0,0,,0,0
27,07-06-18,41,10:00,10:15,50.48,,0,50.48,50.48,1,-52875,32768,85643,-20107,0,0,7074,0,0,,7074,7074
27,07-06-18,42,10:15,10:30,42.89,,0,42.89,42.89,1,-42035,39971,82006,-2064,0,0,3253,0,0,,3253,3253
27,07-06-18,43,10:30,10:45,43.33,,0,43.33,43.33,1,-46781,40557,87338,-6224,0,0,1098,0,0,,1098,1098
27,07-06-18,44,10:45,11:00,44.04,,0,44.04,44.04,1,-45614,49205,94819,3591,0,0,815,0,0,,815,815
27,07-06-18,45,11:00,11:15,50.88,,0,50.88,50.88,1,-71012,22372,93384,-48640,0,0,5717,0,0,,5717,5717
27,07-06-18,46,11:15,11:30,50.88,,0,50.88,50.88,1,-68073,24654,92727,-43419,0,0,16027,0,0,,16027,16027
27,07-06-18,47,11:30,11:45,45.12,,0,45.12,45.12,1,-68653,29137,97790,-39516,0,0,15279,0,0,,15279,15279
27,07-06-18,48,11:45,12:00,42.65,,0,42.65,42.65,1,-63680,37000,100680,-26680,0,0,2587,0,0,,2587,2587
27,07-06-18,49,12:00,12:15,68.19,,0,68.19,68.19,1,-75146,11535,86681,-63611,0,0,15325,0,0,,15325,15325
27,07-06-18,50,12:15,12:30,50.88,,0,50.88,50.88,1,-80978,10820,91798,-70158,0,0,31511,0,0,,31511,31511
27,07-06-18,51,12:30,12:45,50.88,,0,50.88,50.88,1,-80436,12999,93435,-67437,0,0,38667,0,0,,38667,38667
27,07-06-18,52,12:45,13:00,50.88,,0,50.88,50.88,1,-98866,11640,110506,-87226,0,0,35940,0,0,,35940,35940
27,07-06-18,53,13:00,13:15,118.19,,0,118.19,118.19,1,-88297,13160,101457,-75137,0,0,48592,0,0,,48592,48592
27,07-06-18,54,13:15,13:30,68.19,,0,68.19,68.19,1,-93501,11385,104886,-82116,0,0,58332,0,0,,58332,58332
27,07-06-18,55,13:30,13:45,92.29,,0,92.29,92.29,1,-96530,11771,108301,-84759,0,0,66543,0,0,,66543,66543
27,07-06-18,56,13:45,14:00,92.29,,0,92.29,92.29,1,-94702,15614,110316,-79088,0,0,62558,0,0,,62558,62558
27,07-06-18,57,14:00,14:15,136.35,,0,136.35,136.35,1,-99721,19989,119710,-79732,0,0,78358,0,0,,78358,78358
27,07-06-18,58,14:15,14:30,62.78,,0,62.78,62.78,1,-82932,18931,101863,-64001,0,0,64901,0,0,,64901,64901
27,07-06-18,59,14:30,14:45,51.96,,0,51.96,51.96,1,-63434,23678,87112,-39756,0,0,50019,0,0,,50019,50019
27,07-06-18,60,14:45,15:00,50.88,,0,50.88,50.88,1,-73227,22810,96037,-50417,0,0,37178,0,0,,37178,37178
27,07-06-18,61,15:00,15:15,68.19,,0,68.19,68.19,1,-82565,26724,109289,-55841,0,0,41744,0,0,,41744,41744
27,07-06-18,62,15:15,15:30,84.67,,0,84.67,84.67,1,-94328,35027,129355,-59301,0,0,66592,0,0,,66592,66592
27,07-06-18,63,15:30,15:45,118.19,,0,118.19,118.19,1,-98307,25631,123938,-72676,0,0,46797,0,0,,46797,46797
27,07-06-18,64,15:45,16:00,145.12,,0,145.12,145.12,1,-149496,24777,174273,-124719,0,0,90794,0,0,,90794,90794
27,07-06-18,65,16:00,16:15,352.68,,0,352.68,352.68,1,-91552,42864,134416,-48688,0,0,87061,5000,0,,92061,92061
27,07-06-18,66,16:15,16:30,42.65,34.99,0,42.65,34.99,2,-69793,67940,137733,-1853,0,-2836,10561,0,0,,13397,7725
27,07-06-18,67,16:30,16:45,105.44,34.99,0,105.44,105.44,1,-93218,38446,131664,-54772,0,-21,26301,0,0,,26322,26280
27,07-06-18,68,16:45,17:00,105.44,,0,105.44,105.44,1,-115593,35727,151320,-79866,0,0,69422,0,0,,69422,69422
27,07-06-18,69,17:00,17:15,52.16,,0,52.16,52.16,1,-78979,39430,118409,-39549,0,0,55459,0,0,,55459,55459
27,07-06-18,70,17:15,17:30,68.19,,0,68.19,68.19,1,-101551,40044,141595,-61507,0,0,44947,0,0,,44947,44947
27,07-06-18,71,17:30,17:45,68.19,,0,68.19,68.19,1,-99689,36254,135943,-63435,0,0,58855,0,0,,58855,58855
27,07-06-18,72,17:45,18:00,68.19,,0,68.19,68.19,1,-108351,35701,144052,-72650,0,0,62113,0,0,,62113,62113
27,07-06-18,73,18:00,18:15,68.5,,0,68.5,68.5,1,-117932,30632,148564,-87300,0,0,62679,0,0,,62679,62679
27,07-06-18,74,18:15,18:30,68.5,,0,68.5,68.5,1,-113891,25661,139552,-88230,0,0,60995,0,0,,60995,60995
27,07-06-18,75,18:30,18:45,118.5,,0,118.5,118.5,1,-117786,22171,139957,-95615,0,0,61631,0,0,,61631,61631
27,07-06-18,76,18:45,19:00,88.12,,0,88.12,88.12,1,-106022,21003,127025,-85019,0,0,69294,0,0,,69294,69294
27,07-06-18,77,19:00,19:15,55.12,,0,55.12,55.12,1,-67066,30750,97816,-36316,0,0,50636,0,0,,50636,50636
27,07-06-18,78,19:15,19:30,68.19,,0,68.19,68.19,1,-99312,22851,122163,-76461,0,0,34362,0,0,,34362,34362
27,07-06-18,79,19:30,19:45,155.4,,0,155.4,155.4,1,-116854,19208,136062,-97646,0,0,61122,0,0,,61122,61122
27,07-06-18,80,19:45,20:00,110.09,,0,110.09,110.09,1,-121446,19036,140482,-102410,0,0,84146,0,0,,84146,84146
27,07-06-18,81,20:00,20:15,68.19,40.87,0,40.87,40.87,-1,-57447,44903,102350,-12544,0,-146,57110,0,0,,57256,56964
27,07-06-18,82,20:15,20:30,48.61,38.65,0,48.61,38.65,2,-57094,38267,95361,-18827,0,-1429,5592,0,0,,7021,4163
27,07-06-18,83,20:30,20:45,50.88,,0,50.88,50.88,1,-79329,38755,118084,-40574,0,0,31187,0,0,,31187,31187
27,07-06-18,84,20:45,21:00,46.65,,0,46.65,46.65,1,-69456,45420,114876,-24036,0,0,27479,0,0,,27479,27479
27,07-06-18,85,21:00,21:15,,,0,40.58,40.58,0,-57817,60408,118225,2591,0,0,6348,0,0,,6348,6348
27,07-06-18,86,21:15,21:30,,40.6,0,40.6,40.6,-1,-47525,66326,113851,18801,0,-206,0,0,0,,206,-206
27,07-06-18,87,21:30,21:45,,39.94,0,39.94,39.94,-1,-16647,85556,102203,68909,0,-3561,0,0,0,,3561,-3561
27,07-06-18,88,21:45,22:00,,38.65,0,38.65,38.65,-1,-11785,87884,99669,76099,0,-9061,0,0,0,,9061,-9061
27,07-06-18,89,22:00,22:15,46.65,38.65,0,46.65,46.65,1,-41778,19365,61143,-22413,0,-1785,1998,0,0,,3783,213
27,07-06-18,90,22:15,22:30,50.88,,0,50.88,50.88,1,-52857,15299,68156,-37558,0,0,29654,0,0,,29654,29654
27,07-06-18,91,22:30,22:45,68.19,,0,68.19,68.19,1,-72152,16146,88298,-56006,0,0,46734,0,0,,46734,46734
27,07-06-18,92,22:45,23:00,50.88,,0,50.88,50.88,1,-55004,25707,80711,-29297,0,0,42370,0,0,,42370,42370
27,07-06-18,93,23:00,23:15,83.12,,0,83.12,83.12,1,-80287,18413,98700,-61874,0,0,29524,0,0,,29524,29524
27,07-06-18,94,23:15,23:30,50.88,,0,50.88,50.88,1,-51385,23224,74609,-28161,0,0,38528,0,0,,38528,38528
27,07-06-18,95,23:30,23:45,43.32,,0,43.32,43.32,1,-46018,25214,71232,-20804,0,0,7178,0,0,,7178,7178
27,07-06-18,96,23:45,0:00,68.19,41.83,0,68.19,41.83,2,-94911,39501,134412,-55410,0,-8,9502,0,0,,9510,9494
28,07-07-18,1,0:00,0:15,65.98,-116.43,0,65.98,-116.43,2,-87338,73011,160349,-14327,0,-23672,1327,0,0,,24999,-22345
28,07-07-18,2,0:15,0:30,145.02,-116.43,0,145.02,145.02,1,-140556,11825,152381,-128731,0,-275,66471,0,0,,66746,66196
28,07-07-18,3,0:30,0:45,347.71,34.63,0,34.63,34.63,-1,-100763,77403,178166,-23360,0,-229,80737,5000,0,,85966,85508
28,07-07-18,4,0:45,1:00,347.71,-112.31,0,-112.31,-112.31,-1,-61781,86069,147850,24288,0,-20070,4472,0,0,,24542,-15598
28,07-07-18,5,1:00,1:15,52.62,34.1,0,52.62,34.1,2,-53963,67730,121693,13767,0,-13726,1406,0,0,,15132,-12320
28,07-07-18,6,1:15,1:30,106.6,34.1,0,106.6,106.6,1,-68933,22925,91858,-46008,0,-1028,38171,0,0,,39199,37143
28,07-07-18,7,1:30,1:45,64.14,,0,64.14,64.14,1,-76239,15344,91583,-60895,0,0,32367,0,0,,32367,32367
28,07-07-18,8,1:45,2:00,65.98,,0,65.98,65.98,1,-109290,17734,127024,-91556,0,0,53644,0,0,,53644,53644
28,07-07-18,9,2:00,2:15,50.79,,0,50.79,50.79,1,-62667,13154,75821,-49513,0,0,56760,0,0,,56760,56760
28,07-07-18,10,2:15,2:30,50.18,,0,50.18,50.18,1,-69205,12996,82201,-56209,0,0,49409,0,0,,49409,49409
28,07-07-18,11,2:30,2:45,46.82,,0,46.82,46.82,1,-66316,17363,83679,-48953,0,0,37551,0,0,,37551,37551
28,07-07-18,12,2:45,3:00,43.04,,0,43.04,43.04,1,-58684,19181,77865,-39503,0,0,13787,0,0,,13787,13787
28,07-07-18,13,3:00,3:15,144.02,,0,144.02,144.02,1,-115777,12362,128139,-103415,0,0,46930,0,0,,46930,46930
28,07-07-18,14,3:15,3:30,65.98,,0,65.98,65.98,1,-87298,12848,100146,-74450,0,0,82685,0,0,,82685,82685
28,07-07-18,15,3:30,3:45,47.02,,0,47.02,47.02,1,-66672,20286,86958,-46386,0,0,40064,0,0,,40064,40064
28,07-07-18,16,3:45,4:00,50.18,,0,50.18,50.18,1,-67008,22442,89450,-44566,0,0,25025,0,0,,25025,25025
28,07-07-18,17,4:00,4:15,65.98,,0,65.98,65.98,1,-90176,13389,103565,-76787,0,0,56838,0,0,,56838,56838
28,07-07-18,18,4:15,4:30,55.1,,0,55.1,55.1,1,-88358,13704,102062,-74654,0,0,70682,0,0,,70682,70682
28,07-07-18,19,4:30,4:45,52.62,,0,52.62,52.62,1,-84458,22619,107077,-61839,0,0,64095,0,0,,64095,64095
28,07-07-18,20,4:45,5:00,45.04,,0,45.04,45.04,1,-72078,28448,100526,-43630,0,0,25979,0,0,,25979,25979
28,07-07-18,21,5:00,5:15,60.86,,0,60.86,60.86,1,-79854,24280,104134,-55574,0,0,37491,0,0,,37491,37491
28,07-07-18,22,5:15,5:30,48.48,,0,48.48,48.48,1,-47063,26107,73170,-20956,0,0,33097,0,0,,33097,33097
28,07-07-18,23,5:30,5:45,,,0,41.93,41.93,0,-33377,32189,65566,-1188,0,0,3591,0,0,,3591,3591
28,07-07-18,24,5:45,6:00,,,0,41.93,41.93,0,-22804,32114,54918,9310,0,0,0,0,0,,0,0
28,07-07-18,25,6:00,6:15,46.82,,0,46.82,46.82,1,-48356,35939,84295,-12417,0,0,2818,0,0,,2818,2818
28,07-07-18,26,6:15,6:30,52.62,,0,52.62,52.62,1,-69652,25074,94726,-44578,0,0,30889,0,0,,30889,30889
28,07-07-18,27,6:30,6:45,50.42,,0,50.42,50.42,1,-76706,20572,97278,-56134,0,0,38399,0,0,,38399,38399
28,07-07-18,28,6:45,7:00,50.38,,0,50.38,50.38,1,-53919,29806,83725,-24113,0,0,35209,0,0,,35209,35209
28,07-07-18,29,7:00,7:15,50.38,34.3,0,34.3,34.3,-1,-14805,85467,100272,70662,0,-6726,2991,0,0,,9717,-3735
28,07-07-18,30,7:15,7:30,,40.03,0,40.03,40.03,-1,-24721,68468,93189,43747,0,-6385,0,0,0,,6385,-6385
28,07-07-18,31,7:30,7:45,,34.3,0,34.3,34.3,-1,-27679,56946,84625,29267,0,-7693,0,0,0,,7693,-7693
28,07-07-18,32,7:45,8:00,,41.33,0,41.33,41.33,-1,-21688,67041,88729,45353,0,-2573,0,0,0,,2573,-2573
28,07-07-18,33,8:00,8:15,,41.64,0,41.64,41.64,-1,-113390,45830,159220,-67560,0,-382,0,0,0,,382,-382
28,07-07-18,34,8:15,8:30,48.77,,0,48.77,48.77,1,-61430,28479,89909,-32951,0,0,9199,0,0,,9199,9199
28,07-07-18,35,8:30,8:45,50.38,,0,50.38,50.38,1,-52419,21045,73464,-31374,0,0,20295,0,0,,20295,20295
28,07-07-18,36,8:45,9:00,50.38,,0,50.38,50.38,1,-53614,17777,71391,-35837,0,0,34923,0,0,,34923,34923
28,07-07-18,37,9:00,9:15,50.38,,0,50.38,50.38,1,-68819,32839,101658,-35980,0,0,30998,0,0,,30998,30998
28,07-07-18,38,9:15,9:30,73.21,,0,73.21,73.21,1,-85381,31078,116459,-54303,0,0,29555,0,0,,29555,29555
28,07-07-18,39,9:30,9:45,124.02,,0,124.02,124.02,1,-90948,32726,123674,-58222,0,0,73211,0,0,,73211,73211
28,07-07-18,40,9:45,10:00,44.79,37.83,0,44.79,37.83,2,-59250,73498,132748,14248,0,-1529,22067,0,0,,23596,20538
28,07-07-18,41,10:00,10:15,145.02,37.83,0,145.02,145.02,1,-164446,21051,185497,-143395,0,-16,45288,0,0,,45304,45272
28,07-07-18,42,10:15,10:30,145.02,,0,145.02,145.02,1,-135550,25959,161509,-109591,0,0,112641,0,0,,112641,112641
28,07-07-18,43,10:30,10:45,80.45,,0,80.45,80.45,1,-109527,29527,139054,-80000,0,0,86108,0,0,,86108,86108
28,07-07-18,44,10:45,11:00,57.29,,0,57.29,57.29,1,-101350,36463,137813,-64887,0,0,63315,0,0,,63315,63315
28,07-07-18,45,11:00,11:15,136.02,,0,136.02,136.02,1,-116115,21146,137261,-94969,0,0,77057,0,0,,77057,77057
28,07-07-18,46,11:15,11:30,72.15,,0,72.15,72.15,1,-99593,28316,127909,-71277,0,0,81192,0,0,,81192,81192
28,07-07-18,47,11:30,11:45,61.02,,0,61.02,61.02,1,-96162,33081,129243,-63081,0,0,63516,0,0,,63516,63516
28,07-07-18,48,11:45,12:00,66.19,,0,66.19,66.19,1,-96638,33358,129996,-63280,0,0,60306,0,0,,60306,60306
28,07-07-18,49,12:00,12:15,145.02,,0,145.02,145.02,1,-142582,26217,168799,-116365,0,0,89664,0,0,,89664,89664
28,07-07-18,50,12:15,12:30,201.55,,0,201.55,201.55,1,-109854,31248,141102,-78606,0,0,94704,2500,0,,97204,97204
28,07-07-18,51,12:30,12:45,201.55,,0,201.55,201.55,1,-92141,58687,150828,-33454,0,0,43251,2500,0,,45751,45751
28,07-07-18,52,12:45,13:00,50.38,,0,50.38,50.38,1,-86078,53878,139956,-32200,0,0,15927,0,0,,15927,15927
28,07-07-18,53,13:00,13:15,54.02,,0,54.02,54.02,1,-103902,46159,150061,-57743,0,0,41116,0,0,,41116,41116
28,07-07-18,54,13:15,13:30,66.19,,0,66.19,66.19,1,-106794,32527,139321,-74267,0,0,47046,0,0,,47046,47046
28,07-07-18,55,13:30,13:45,71.99,,0,71.99,71.99,1,-99887,29779,129666,-70108,0,0,63171,0,0,,63171,63171
28,07-07-18,56,13:45,14:00,50.38,,0,50.38,50.38,1,-98510,29295,127805,-69215,0,0,47037,0,0,,47037,47037
28,07-07-18,57,14:00,14:15,116.19,,0,116.19,116.19,1,-144456,49576,194032,-94880,0,0,54140,0,0,,54140,54140
28,07-07-18,58,14:15,14:30,135.02,,0,135.02,135.02,1,-124104,54647,178751,-69457,0,0,75672,0,0,,75672,75672
28,07-07-18,59,14:30,14:45,66.19,,0,66.19,66.19,1,-119722,53926,173648,-65796,0,0,54457,0,0,,54457,54457
28,07-07-18,60,14:45,15:00,59.02,,0,59.02,59.02,1,-113192,62645,175837,-50547,0,0,53549,0,0,,53549,53549
28,07-07-18,61,15:00,15:15,43,39.26,0,39.26,39.26,-1,-75434,97003,172437,21569,0,-591,15705,0,0,,16296,15114
28,07-07-18,62,15:15,15:30,,,0,42.73,42.73,0,-84380,91369,175749,6989,0,-7,0,0,0,,7,-7
28,07-07-18,63,15:30,15:45,48.47,,0,48.47,48.47,1,-95030,72222,167252,-22808,0,0,8162,0,0,,8162,8162
28,07-07-18,64,15:45,16:00,50.38,,0,50.38,50.38,1,-96710,67977,164687,-28733,0,0,18069,0,0,,18069,18069
28,07-07-18,65,16:00,16:15,46.3,,0,46.3,46.3,1,-74697,46521,121218,-28176,0,0,17081,0,0,,17081,17081
28,07-07-18,66,16:15,16:30,43.03,,0,43.03,43.03,1,-75305,43939,119244,-31366,0,0,3909,0,0,,3909,3909
28,07-07-18,67,16:30,16:45,142.02,,0,142.02,142.02,1,-98182,26289,124471,-71893,0,0,22398,0,0,,22398,22398
28,07-07-18,68,16:45,17:00,141.02,,0,141.02,141.02,1,-115951,20794,136745,-95157,0,0,80734,0,0,,80734,80734
28,07-07-18,69,17:00,17:15,50.38,36.31,0,36.31,36.31,-1,-41052,53120,94172,12068,0,-1365,37482,0,0,,38847,36117
28,07-07-18,70,17:15,17:30,46.3,36.31,0,46.3,46.3,1,-54861,48373,103234,-6488,0,-220,2330,0,0,,2550,2110
28,07-07-18,71,17:30,17:45,50.38,,0,50.38,50.38,1,-71787,37849,109636,-33938,0,0,20262,0,0,,20262,20262
28,07-07-18,72,17:45,18:00,66.19,,0,66.19,66.19,1,-84940,29796,114736,-55144,0,0,42311,0,0,,42311,42311
28,07-07-18,73,18:00,18:15,46.3,,0,46.3,46.3,1,-59242,32593,91835,-26649,0,0,22135,0,0,,22135,22135
28,07-07-18,74,18:15,18:30,47.48,,0,47.48,47.48,1,-59414,26851,86265,-32563,0,0,16623,0,0,,16623,16623
28,07-07-18,75,18:30,18:45,50.38,,0,50.38,50.38,1,-67920,29278,97198,-38642,0,0,18545,0,0,,18545,18545
28,07-07-18,76,18:45,19:00,52.92,,0,52.92,52.92,1,-79895,29105,109000,-50790,0,0,44486,0,0,,44486,44486
28,07-07-18,77,19:00,19:15,50.38,,0,50.38,50.38,1,-103010,51718,154728,-51292,0,0,39239,0,0,,39239,39239
28,07-07-18,78,19:15,19:30,162.67,,0,162.67,162.67,1,-120745,38614,159359,-82131,0,0,51992,0,0,,51992,51992
28,07-07-18,79,19:30,19:45,81.64,,0,81.64,81.64,1,-121920,38780,160700,-83140,0,0,72930,0,0,,72930,72930
28,07-07-18,80,19:45,20:00,119.9,,0,119.9,119.9,1,-138073,40981,179054,-97092,0,0,78870,0,0,,78870,78870
28,07-07-18,81,20:00,20:15,61.02,,0,61.02,61.02,1,-96902,74843,171745,-22059,0,0,48089,0,0,,48089,48089
28,07-07-18,82,20:15,20:30,66.19,,0,66.19,66.19,1,-105474,55381,160855,-50093,0,0,25483,0,0,,25483,25483
28,07-07-18,83,20:30,20:45,50.38,,0,50.38,50.38,1,-99536,58491,158027,-41045,0,0,41910,0,0,,41910,41910
28,07-07-18,84,20:45,21:00,50.38,,0,50.38,50.38,1,-96499,53733,150232,-42766,0,0,37989,0,0,,37989,37989
28,07-07-18,85,21:00,21:15,50.38,,0,50.38,50.38,1,-85761,42437,128198,-43324,0,0,39561,0,0,,39561,39561
28,07-07-18,86,21:15,21:30,50.38,,0,50.38,50.38,1,-75985,35382,111367,-40603,0,0,37119,0,0,,37119,37119
28,07-07-18,87,21:30,21:45,46.3,,0,46.3,46.3,1,-54158,43198,97356,-10960,0,0,17575,0,0,,17575,17575
28,07-07-18,88,21:45,22:00,46.3,,0,46.3,46.3,1,-57167,49165,106332,-8002,0,0,1968,0,0,,1968,1968
28,07-07-18,89,22:00,22:15,83.95,,0,83.95,83.95,1,-97630,31864,129494,-65766,0,0,36752,0,0,,36752,36752
28,07-07-18,90,22:15,22:30,66.19,,0,66.19,66.19,1,-104241,31289,135530,-72952,0,0,68391,0,0,,68391,68391
28,07-07-18,91,22:30,22:45,61.19,,0,61.19,61.19,1,-102016,29150,131166,-72866,0,0,68669,0,0,,68669,68669
28,07-07-18,92,22:45,23:00,56.02,,0,56.02,56.02,1,-89333,32285,121618,-57048,0,0,59532,0,0,,59532,59532
28,07-07-18,93,23:00,23:15,131.29,,0,131.29,131.29,1,-118506,27202,145708,-91304,0,0,75242,0,0,,75242,75242
28,07-07-18,94,23:15,23:30,160.89,,0,160.89,160.89,1,-73978,38138,112116,-35840,0,0,66439,1250,0,,67689,67689
28,07-07-18,95,23:30,23:45,160.89,32.45,0,32.45,32.45,-1,-20392,58265,78657,37873,0,-2374,11353,0,0,,13727,8979
28,07-07-18,96,23:45,0:00,,16.19,0,16.19,16.19,-1,-27469,65616,93085,38147,0,-9580,0,0,0,,9580,-9580
28,07-08-18,1,0:00,0:15,,-0.45,0,-0.45,-0.45,-1,-84956,132564,217520,47608,0,-16355,0,0,0,,16355,-16355
28,07-08-18,2,0:15,0:30,61.19,-0.45,0,61.19,61.19,1,-83434,45361,128795,-38073,0,-52,14226,0,0,,14278,14174
28,07-08-18,3,0:30,0:45,46.34,39.52,0,39.52,39.52,-1,-45988,48139,94127,2151,0,-1010,10814,0,0,,11824,9804
28,07-08-18,4,0:45,1:00,46.34,39.78,0,39.78,39.78,-1,-36112,54848,90960,18736,0,-6612,18,0,0,,6630,-6594
28,07-08-18,5,1:00,1:15,,30.47,0,30.47,30.47,-1,-38945,88795,127740,49850,0,-11091,0,0,0,,11091,-11091
28,07-08-18,6,1:15,1:30,,,0,42.58,42.58,0,-46458,61119,107577,14661,0,-551,0,0,0,,551,-551
28,07-08-18,7,1:30,1:45,,38.78,0,38.78,38.78,-1,-42731,56341,99072,13610,0,-1627,0,0,0,,1627,-1627
28,07-08-18,8,1:45,2:00,,38.78,0,38.78,38.78,-1,-46029,58474,104503,12445,0,-4709,0,0,0,,4709,-4709
28,07-08-18,9,2:00,2:15,,38.79,0,38.79,38.79,-1,-49824,55178,105002,5354,0,-4715,0,0,0,,4715,-4715
28,07-08-18,10,2:15,2:30,45.55,38.79,0,45.55,45.55,1,-48842,40055,88897,-8787,0,-108,2647,0,0,,2755,2539
28,07-08-18,11,2:30,2:45,45.55,42.6,0,42.6,42.6,-1,-29257,50057,79314,20800,0,-37,147,0,0,,184,110
28,07-08-18,12,2:45,3:00,,39.57,0,39.57,39.57,-1,-39763,41544,81307,1781,0,-3765,0,0,0,,3765,-3765
28,07-08-18,13,3:00,3:15,46.34,42.2,0,46.34,42.2,2,-48531,42415,90946,-6116,0,-2347,3674,0,0,,6021,1327
28,07-08-18,14,3:15,3:30,42.34,,0,42.34,42.34,1,-36492,41469,77961,4977,0,0,1407,0,0,,1407,1407
28,07-08-18,15,3:30,3:45,43.49,,0,43.49,43.49,1,-40129,32182,72311,-7947,0,0,3592,0,0,,3592,3592
28,07-08-18,16,3:45,4:00,42.34,,0,42.34,42.34,1,-40297,47460,87757,7163,0,0,2200,0,0,,2200,2200
28,07-08-18,17,4:00,4:15,46.34,,0,46.34,46.34,1,-44623,38410,83033,-6213,0,0,864,0,0,,864,864
28,07-08-18,18,4:15,4:30,50.42,,0,50.42,50.42,1,-44883,21889,66772,-22994,0,0,14495,0,0,,14495,14495
28,07-08-18,19,4:30,4:45,45.61,,0,45.61,45.61,1,-43812,23789,67601,-20023,0,0,16184,0,0,,16184,16184
28,07-08-18,20,4:45,5:00,44.42,42.19,0,42.19,42.19,-1,-33129,31645,64774,-1484,0,-12,10372,0,0,,10384,10360
28,07-08-18,21,5:00,5:15,50.42,41.98,0,50.42,39.97,2,-57983,31604,89587,-26379,0,-28,7586,0,0,,7614,7558
28,07-08-18,22,5:15,5:30,45.79,,0,45.79,45.79,1,-39315,27549,66864,-11766,0,0,14077,0,0,,14077,14077
28,07-08-18,23,5:30,5:45,45.79,38.34,0,38.34,38.34,-1,-33650,42696,76346,9046,0,-1528,1419,0,0,,2947,-109
28,07-08-18,24,5:45,6:00,,37.95,0,37.95,37.95,-1,-29569,51199,80768,21630,0,-20106,0,0,0,,20106,-20106
28,07-08-18,25,6:00,6:15,,38.34,0,38.34,38.34,-1,-26032,41812,67844,15780,0,-23093,0,0,0,,23093,-23093
28,07-08-18,26,6:15,6:30,42.34,38.34,0,42.34,38.34,2,-22096,32888,54984,10792,0,-4099,670,0,0,,4769,-3429
28,07-08-18,27,6:30,6:45,,38.34,0,38.34,38.34,-1,-29613,34559,64172,4946,0,-5343,0,0,0,,5343,-5343
28,07-08-18,28,6:45,7:00,,34.34,0,34.34,34.34,-1,-31026,49474,80500,18448,0,-5477,0,0,0,,5477,-5477
28,07-08-18,29,7:00,7:15,,38.78,0,38.78,38.78,-1,-30060,51680,81740,21620,0,-4606,0,0,0,,4606,-4606
28,07-08-18,30,7:15,7:30,,,0,40.39,40.39,0,-24719,32440,57159,7721,0,-268,0,0,0,,268,-268
28,07-08-18,31,7:30,7:45,,41.9,0,41.9,41.9,-1,-37332,48036,85368,10704,0,-485,0,0,0,,485,-485
28,07-08-18,32,7:45,8:00,,42.63,0,42.63,42.63,-1,-25357,56193,81550,30836,0,-504,0,0,0,,504,-504
28,07-08-18,33,8:00,8:15,,39.78,0,39.78,39.78,-1,-32363,52010,84373,19647,0,-237,0,0,0,,237,-237
28,07-08-18,34,8:15,8:30,,43.64,0,43.64,43.64,-1,-27606,63534,91140,35928,0,-1055,0,0,0,,1055,-1055
28,07-08-18,35,8:30,8:45,,43.59,0,43.59,43.59,-1,-20478,75109,95587,54631,0,-353,0,0,0,,353,-353
28,07-08-18,36,8:45,9:00,,,0,40.79,40.79,0,-23815,82883,106698,59068,0,0,0,0,0,,0,0
28,07-08-18,37,9:00,9:15,,43.73,0,43.73,43.73,-1,-19974,84315,104289,64341,0,-197,0,0,0,,197,-197
28,07-08-18,38,9:15,9:30,,43.61,0,43.61,43.61,-1,-22413,85550,107963,63137,0,-235,0,0,0,,235,-235
28,07-08-18,39,9:30,9:45,,,0,40.95,40.95,0,-30492,64548,95040,34056,0,0,0,0,0,,0,0
28,07-08-18,40,9:45,10:00,,,0,40.94,40.94,0,-15177,77310,92487,62133,0,0,0,0,0,,0,0
28,07-08-18,41,10:00,10:15,42.34,,0,42.34,42.34,1,-38592,46114,84706,7522,0,0,316,0,0,,316,316
28,07-08-18,42,10:15,10:30,42.34,,0,42.34,42.34,1,-22362,36979,59341,14617,0,0,313,0,0,,313,313
28,07-08-18,43,10:30,10:45,42.34,,0,42.34,42.34,1,-20959,53009,73968,32050,0,0,35,0,0,,35,35
28,07-08-18,44,10:45,11:00,,,0,42.98,42.98,0,-17936,54114,72050,36178,0,0,0,0,0,,0,0
28,07-08-18,45,11:00,11:15,,36.06,0,36.06,36.06,-1,-25566,53172,78738,27606,0,-2171,0,0,0,,2171,-2171
28,07-08-18,46,11:15,11:30,,34.34,0,34.34,34.34,-1,-26884,46995,73879,20111,0,-10389,0,0,0,,10389,-10389
28,07-08-18,47,11:30,11:45,,34.69,0,34.69,34.69,-1,-28803,42153,70956,13350,0,-14885,0,0,0,,14885,-14885
28,07-08-18,48,11:45,12:00,,38.34,0,38.34,38.34,-1,-36243,41850,78093,5607,0,-3978,0,0,0,,3978,-3978
28,07-08-18,49,12:00,12:15,56.28,38.34,0,56.28,56.28,1,-56386,19840,76226,-36546,0,-70,15402,0,0,,15472,15332
28,07-08-18,50,12:15,12:30,46.53,,0,46.53,46.53,1,-55330,21057,76387,-34273,0,0,30718,0,0,,30718,30718
28,07-08-18,51,12:30,12:45,46.34,,0,46.34,46.34,1,-57308,31549,88857,-25759,0,0,27720,0,0,,27720,27720
28,07-08-18,52,12:45,13:00,45.12,,0,45.12,45.12,1,-46899,25619,72518,-21280,0,0,17928,0,0,,17928,17928
28,07-08-18,53,13:00,13:15,50.42,,0,50.42,50.42,1,-65095,35273,100368,-29822,0,0,21535,0,0,,21535,21535
28,07-08-18,54,13:15,13:30,46.34,,0,46.34,46.34,1,-53786,35184,88970,-18602,0,0,21850,0,0,,21850,21850
28,07-08-18,55,13:30,13:45,46.34,,0,46.34,46.34,1,-55896,35783,91679,-20113,0,0,9937,0,0,,9937,9937
28,07-08-18,56,13:45,14:00,44.68,43.06,0,44.68,41.17,2,-47632,41657,89289,-5975,0,-12,12385,0,0,,12397,12373
28,07-08-18,57,14:00,14:15,44.68,35.91,0,35.91,35.91,-1,-47562,57207,104769,9645,0,-592,592,0,0,,1184,0
28,07-08-18,58,14:15,14:30,,43.62,0,43.62,43.62,-1,-44366,57596,101962,13230,0,-208,0,0,0,,208,-208
28,07-08-18,59,14:30,14:45,,42.83,0,42.83,42.83,-1,-39540,69488,109028,29948,0,-1753,0,0,0,,1753,-1753
28,07-08-18,60,14:45,15:00,,33.25,0,33.25,33.25,-1,-25595,73122,98717,47527,0,-7300,0,0,0,,7300,-7300
28,07-08-18,61,15:00,15:15,,30.47,0,30.47,30.47,-1,-13348,103979,117327,90631,0,-9063,0,0,0,,9063,-9063
28,07-08-18,62,15:15,15:30,,43.6,0,43.6,43.6,-1,-8112,109708,117820,101596,0,-181,0,0,0,,181,-181
28,07-08-18,63,15:30,15:45,,35.18,0,35.18,35.18,-1,-8481,120198,128679,111717,0,-3825,0,0,0,,3825,-3825
28,07-08-18,64,15:45,16:00,,38.34,0,38.34,38.34,-1,-9595,102516,112111,92921,0,-2492,0,0,0,,2492,-2492
28,07-08-18,65,16:00,16:15,,-150.91,0,-150.91,-150.91,-1,-4969,181359,186328,176390,0,-33673,0,0,0,,33673,-33673
28,07-08-18,66,16:15,16:30,,16.23,0,16.23,16.23,-1,-15605,140849,156454,125244,0,-40634,0,0,0,,40634,-40634
28,07-08-18,67,16:30,16:45,,34.34,0,34.34,34.34,-1,-10968,122802,133770,111834,0,-27331,0,0,0,,27331,-27331
28,07-08-18,68,16:45,17:00,,34.91,0,34.91,34.91,-1,-11696,80162,91858,68466,0,-2696,0,0,0,,2696,-2696
28,07-08-18,69,17:00,17:15,,16.23,0,16.23,16.23,-1,-33593,84035,117628,50442,0,-14790,0,0,0,,14790,-14790
28,07-08-18,70,17:15,17:30,,30.47,0,30.47,30.47,-1,-25762,60728,86490,34966,0,-34091,0,0,0,,34091,-34091
28,07-08-18,71,17:30,17:45,,42.37,0,42.37,42.37,-1,-41188,40803,81991,-385,0,-8629,0,0,0,,8629,-8629
28,07-08-18,72,17:45,18:00,42.34,,0,42.34,42.34,1,-40123,36971,77094,-3152,0,0,164,0,0,,164,164
28,07-08-18,73,18:00,18:15,42.34,,0,42.34,42.34,1,-98869,22602,121471,-76267,0,0,313,0,0,,313,313
28,07-08-18,74,18:15,18:30,,,0,42.95,42.95,0,-79428,19691,99119,-59737,0,0,0,0,0,,0,0
28,07-08-18,75,18:30,18:45,,,0,42.95,42.95,0,-72645,9357,82002,-63288,0,0,0,0,0,,0,0
28,07-08-18,76,18:45,19:00,42.34,,0,42.34,42.34,1,-63502,3491,66993,-60011,0,0,127,0,0,,127,127
28,07-08-18,77,19:00,19:15,42.34,,0,42.34,42.34,1,-51144,20077,71221,-31067,0,0,1230,0,0,,1230,1230
28,07-08-18,78,19:15,19:30,42.34,,0,42.34,42.34,1,-81257,9505,90762,-71752,0,0,452,0,0,,452,452
28,07-08-18,79,19:30,19:45,46.34,,0,46.34,46.34,1,-105775,4875,110650,-100900,0,0,3714,0,0,,3714,3714
28,07-08-18,80,19:45,20:00,195.21,,0,195.21,195.21,1,-137876,1767,139643,-136109,0,0,26242,0,0,,26242,26242
28,07-08-18,81,20:00,20:15,65.46,,0,65.46,65.46,1,-47842,36920,84762,-10922,0,0,38499,0,0,,38499,38499
28,07-08-18,82,20:15,20:30,46.34,,0,46.34,46.34,1,-46176,27624,73800,-18552,0,0,6951,0,0,,6951,6951
28,07-08-18,83,20:30,20:45,73.72,,0,73.72,73.72,1,-63250,8419,71669,-54831,0,0,24658,0,0,,24658,24658
28,07-08-18,84,20:45,21:00,87.44,,0,87.44,87.44,1,-80960,12947,93907,-68013,0,0,66987,0,0,,66987,66987
28,07-08-18,85,21:00,21:15,50.42,41.3,0,41.3,41.3,-1,-49799,34373,84172,-15426,0,-74,30794,0,0,,30868,30720
28,07-08-18,86,21:15,21:30,46.62,41.3,0,46.62,41.04,2,-53374,27875,81249,-25499,0,-143,3445,0,0,,3588,3302
28,07-08-18,87,21:30,21:45,44.31,,0,44.31,44.31,1,-54049,36585,90634,-17464,0,0,9141,0,0,,9141,9141
28,07-08-18,88,21:45,22:00,42.34,,0,42.34,42.34,1,-36359,40131,76490,3772,0,0,2837,0,0,,2837,2837
28,07-08-18,89,22:00,22:15,53.4,,0,53.4,53.4,1,-70665,26389,97054,-44276,0,0,6530,0,0,,6530,6530
28,07-08-18,90,22:15,22:30,195.21,,0,195.21,195.21,1,-97687,26625,124312,-71062,0,0,51416,0,0,,51416,51416
28,07-08-18,91,22:30,22:45,60.73,,0,60.73,60.73,1,-80694,26557,107251,-54137,0,0,57300,0,0,,57300,57300
28,07-08-18,92,22:45,23:00,51.9,,0,51.9,51.9,1,-66349,27407,93756,-38942,0,0,42858,0,0,,42858,42858
28,07-08-18,93,23:00,23:15,97.32,,0,97.32,97.32,1,-92916,27578,120494,-65338,0,0,54339,0,0,,54339,54339
28,07-08-18,94,23:15,23:30,50.42,38.9,0,38.9,38.9,-1,-45602,33444,79046,-12158,0,-282,30161,0,0,,30443,29879
28,07-08-18,95,23:30,23:45,43.65,38.91,0,54.46,38.91,2,-38108,28769,66877,-9339,0,-806,833,0,0,,1639,27
28,07-08-18,96,23:45,0:00,50.42,42.01,0,54.48,42.01,2,-41843,40752,82595,-1091,0,-140,4998,0,0,,5138,4858
28,07-09-18,1,0:00,0:15,138.02,,0,138.02,138.02,1,-104049,21805,125854,-82244,0,0,30200,0,0,,30200,30200
28,07-09-18,2,0:15,0:30,51.07,,0,51.07,51.07,1,-64109,27629,91738,-36480,0,0,28174,0,0,,28174,28174
28,07-09-18,3,0:30,0:45,51.07,40.71,0,40.71,40.71,-1,-44977,28374,73351,-16603,0,-27,4001,0,0,,4028,3974
28,07-09-18,4,0:45,1:00,,38.34,0,38.34,38.34,-1,-34569,39624,74193,5055,0,-1767,0,0,0,,1767,-1767
28,07-09-18,5,1:00,1:15,50.42,35.82,0,50.42,35.82,2,-72475,37630,110105,-34845,0,-2105,4187,0,0,,6292,2082
28,07-09-18,6,1:15,1:30,50.42,,0,50.42,50.42,1,-80384,19667,100051,-60717,0,0,20962,0,0,,20962,20962
28,07-09-18,7,1:30,1:45,46.34,,0,46.34,46.34,1,-62117,22971,85088,-39146,0,0,21356,0,0,,21356,21356
28,07-09-18,8,1:45,2:00,43.47,,0,43.47,43.47,1,-53838,24024,77862,-29814,0,0,11910,0,0,,11910,11910
28,07-09-18,9,2:00,2:15,65.88,,0,65.88,65.88,1,-73295,13734,87029,-59561,0,0,17512,0,0,,17512,17512
28,07-09-18,10,2:15,2:30,50.42,,0,50.42,50.42,1,-71654,12698,84352,-58956,0,0,39631,0,0,,39631,39631
28,07-09-18,11,2:30,2:45,50.42,,0,50.42,50.42,1,-64168,12316,76484,-51852,0,0,36472,0,0,,36472,36472
28,07-09-18,12,2:45,3:00,,,0,40.69,40.69,0,-44451,19424,63875,-25027,0,0,8231,0,0,,8231,8231
28,07-09-18,13,3:00,3:15,66.23,,0,66.23,66.23,1,-69478,27525,97003,-41953,0,0,14709,0,0,,14709,14709
28,07-09-18,14,3:15,3:30,50.42,,0,50.42,50.42,1,-57962,28017,85979,-29945,0,0,28710,0,0,,28710,28710
28,07-09-18,15,3:30,3:45,43.15,,0,43.15,43.15,1,-51671,28594,80265,-23077,0,0,5001,0,0,,5001,5001
28,07-09-18,16,3:45,4:00,43.16,,0,43.16,43.16,1,-57558,28956,86514,-28602,0,0,1904,0,0,,1904,1904
28,07-09-18,17,4:00,4:15,43.21,,0,43.21,43.21,1,-67543,41470,109013,-26073,0,0,527,0,0,,527,527
28,07-09-18,18,4:15,4:30,,,0,40.8,40.8,0,-51624,42001,93625,-9623,0,0,0,0,0,,0,0
28,07-09-18,19,4:30,4:45,43.23,,0,43.23,43.23,1,-59203,40293,99496,-18910,0,0,731,0,0,,731,731
28,07-09-18,20,4:45,5:00,50.42,,0,50.42,50.42,1,-68487,44440,112927,-24047,0,0,6999,0,0,,6999,6999
28,07-09-18,21,5:00,5:15,46.34,,0,46.34,46.34,1,-82300,51026,133326,-31274,0,0,17265,0,0,,17265,17265
28,07-09-18,22,5:15,5:30,42.79,,0,42.79,42.79,1,-66459,43975,110434,-22484,0,0,8291,0,0,,8291,8291
28,07-09-18,23,5:30,5:45,46.34,,0,46.34,46.34,1,-71974,38329,110303,-33645,0,0,4748,0,0,,4748,4748
28,07-09-18,24,5:45,6:00,50.42,,0,50.42,50.42,1,-91251,34553,125804,-56698,0,0,19141,0,0,,19141,19141
28,07-09-18,25,6:00,6:15,50.5,,0,50.5,50.5,1,-139263,48344,187607,-90919,0,0,22880,0,0,,22880,22880
28,07-09-18,26,6:15,6:30,50.5,38.42,0,38.42,38.42,-1,-43067,32329,75396,-10738,0,-8,2641,0,0,,2649,2633
28,07-09-18,27,6:30,6:45,44.8,,0,44.8,44.8,1,-70193,33682,103875,-36511,0,0,154,0,0,,154,154
28,07-09-18,28,6:45,7:00,50.5,,0,50.5,50.5,1,-82133,18491,100624,-63642,0,0,2231,0,0,,2231,2231
28,07-09-18,29,7:00,7:15,42.42,,0,42.42,42.42,1,-112937,50929,163866,-62008,0,0,2391,0,0,,2391,2391
28,07-09-18,30,7:15,7:30,,,0,41.55,41.55,0,-83581,54957,138538,-28624,0,0,0,0,0,,0,0
28,07-09-18,31,7:30,7:45,45.15,,0,45.15,45.15,1,-85115,34819,119934,-50296,0,0,464,0,0,,464,464
28,07-09-18,32,7:45,8:00,116.32,,0,116.32,116.32,1,-113507,40218,153725,-73289,0,0,23347,0,0,,23347,23347
28,07-09-18,33,8:00,8:15,116.32,,0,116.32,116.32,1,-139210,54921,194131,-84289,0,0,29088,0,0,,29088,29088
28,07-09-18,34,8:15,8:30,,,0,41.44,41.44,0,-117174,35540,152714,-81634,0,0,272,0,0,,272,272
28,07-09-18,35,8:30,8:45,,,0,41.4,41.4,0,-106169,32928,139097,-73241,0,0,0,0,0,,0,0
28,07-09-18,36,8:45,9:00,,,0,41.36,41.36,0,-118749,35048,153797,-83701,0,0,0,0,0,,0,0
28,07-09-18,37,9:00,9:15,79.53,,0,79.53,79.53,1,-118611,44492,163103,-74119,0,0,16129,0,0,,16129,16129
28,07-09-18,38,9:15,9:30,66.32,,0,66.32,66.32,1,-125708,40650,166358,-85058,0,0,51085,0,0,,51085,51085
28,07-09-18,39,9:30,9:45,56.29,,0,56.29,56.29,1,-92699,42019,134718,-50680,0,0,47492,0,0,,47492,47492
28,07-09-18,40,9:45,10:00,,,0,43.1,43.1,0,-102911,41318,144229,-61593,0,0,6825,0,0,,6825,6825
28,07-09-18,41,10:00,10:15,,,0,43.09,43.09,0,-77706,55214,132920,-22492,0,0,0,0,0,,0,0
28,07-09-18,42,10:15,10:30,50.5,,0,50.5,50.5,1,-98082,55139,153221,-42943,0,0,10067,0,0,,10067,10067
28,07-09-18,43,10:30,10:45,48.59,,0,48.59,48.59,1,-100432,56493,156925,-43939,0,0,26420,0,0,,26420,26420
28,07-09-18,44,10:45,11:00,46.42,,0,46.42,46.42,1,-89320,64823,154143,-24497,0,0,16446,0,0,,16446,16446
28,07-09-18,45,11:00,11:15,44.55,,0,44.55,44.55,1,-101114,46743,147857,-54371,0,0,1347,0,0,,1347,1347
28,07-09-18,46,11:15,11:30,42.42,,0,42.42,42.42,1,-113403,46810,160213,-66593,0,0,323,0,0,,323,323
28,07-09-18,47,11:30,11:45,53.92,,0,53.92,53.92,1,-127680,40177,167857,-87503,0,0,16276,0,0,,16276,16276
28,07-09-18,48,11:45,12:00,56.29,,0,56.29,56.29,1,-137720,38003,175723,-99717,0,0,23844,0,0,,23844,23844
28,07-09-18,49,12:00,12:15,142.02,,0,142.02,142.02,1,-136895,27748,164643,-109147,0,0,71977,0,0,,71977,71977
28,07-09-18,50,12:15,12:30,67.21,,0,67.21,67.21,1,-110242,40152,150394,-70090,0,0,74926,0,0,,74926,74926
28,07-09-18,51,12:30,12:45,52.35,,0,52.35,52.35,1,-90873,42282,133155,-48591,0,0,38918,0,0,,38918,38918
28,07-09-18,52,12:45,13:00,142.02,,0,142.02,142.02,1,-136825,40534,177359,-96291,0,0,71140,0,0,,71140,71140
28,07-09-18,53,13:00,13:15,83.02,,0,83.02,83.02,1,-140349,52840,193189,-87509,0,0,86895,0,0,,86895,86895
28,07-09-18,54,13:15,13:30,57.75,,0,57.75,57.75,1,-141315,68010,209325,-73305,0,0,57842,0,0,,57842,57842
28,07-09-18,55,13:30,13:45,90.72,,0,90.72,90.72,1,-166172,69126,235298,-97046,0,0,65756,0,0,,65756,65756
28,07-09-18,56,13:45,14:00,66.32,,0,66.32,66.32,1,-157758,63377,221135,-94381,0,0,63850,0,0,,63850,63850
28,07-09-18,57,14:00,14:15,140.02,,0,140.02,140.02,1,-180508,65406,245914,-115102,0,0,75860,0,0,,75860,75860
28,07-09-18,58,14:15,14:30,97.4,,0,97.4,97.4,1,-158837,63807,222644,-95030,0,0,99342,0,0,,99342,99342
28,07-09-18,59,14:30,14:45,66.32,,0,66.32,66.32,1,-157304,74531,231835,-82773,0,0,77500,0,0,,77500,77500
28,07-09-18,60,14:45,15:00,66.32,,0,66.32,66.32,1,-156094,77233,233327,-78861,0,0,73768,0,0,,73768,73768
28,07-09-18,61,15:00,15:15,66.32,,0,66.32,66.32,1,-131747,51804,183551,-79943,0,0,61402,0,0,,61402,61402
28,07-09-18,62,15:15,15:30,116.32,,0,116.32,116.32,1,-157059,59466,216525,-97593,0,0,82434,0,0,,82434,82434
28,07-09-18,63,15:30,15:45,75.58,,0,75.58,75.58,1,-165067,75987,241054,-89080,0,0,89733,0,0,,89733,89733
28,07-09-18,64,15:45,16:00,66.32,,0,66.32,66.32,1,-144907,70239,215146,-74668,0,0,75387,0,0,,75387,75387
28,07-09-18,65,16:00,16:15,109.3,,0,109.3,109.3,1,-119837,46897,166734,-72940,0,0,76731,0,0,,76731,76731
28,07-09-18,66,16:15,16:30,66.32,,0,66.32,66.32,1,-121866,73052,194918,-48814,0,0,68831,0,0,,68831,68831
28,07-09-18,67,16:30,16:45,76.5,,0,76.5,76.5,1,-137794,75552,213346,-62242,0,0,65937,0,0,,65937,65937
28,07-09-18,68,16:45,17:00,97.48,,0,97.48,97.48,1,-163780,75624,239404,-88156,0,0,81533,0,0,,81533,81533
28,07-09-18,69,17:00,17:15,95.02,,0,95.02,95.02,1,-137164,80194,217358,-56970,0,0,71964,0,0,,71964,71964
28,07-09-18,70,17:15,17:30,141.02,,0,141.02,141.02,1,-176968,73184,250152,-103784,0,0,57168,0,0,,57168,57168
28,07-09-18,71,17:30,17:45,143.02,,0,143.02,143.02,1,-187545,79839,267384,-107706,0,0,103250,0,0,,103250,103250
28,07-09-18,72,17:45,18:00,152.58,,0,152.58,152.58,1,-153786,103173,256959,-50613,0,0,74059,1250,0,,75309,75309
28,07-09-18,73,18:00,18:15,46.42,16.32,0,16.32,16.32,-1,-109537,122701,232238,13164,0,-3004,16378,0,0,,19382,13374
28,07-09-18,74,18:15,18:30,46.42,10.29,0,10.29,10.29,-1,-71371,96340,167711,24969,0,-17879,125,0,0,,18004,-17754
28,07-09-18,75,18:30,18:45,40.08,40.15,0,41.94,40.15,2,-73904,79144,153048,5240,0,-2175,29,0,0,,2204,-2146
28,07-09-18,76,18:45,19:00,40.02,,0,40.02,40.02,1,-74836,100410,175246,25574,0,0,141,0,0,,141,141
28,07-09-18,77,19:00,19:15,66.32,,0,66.32,66.32,1,-118725,73122,191847,-45603,0,0,13092,0,0,,13092,13092
28,07-09-18,78,19:15,19:30,45.22,,0,45.22,45.22,1,-84505,81764,166269,-2741,0,0,6529,0,0,,6529,6529
28,07-09-18,79,19:30,19:45,43.12,,0,43.12,43.12,1,-69413,80086,149499,10673,0,0,2158,0,0,,2158,2158
28,07-09-18,80,19:45,20:00,42.42,,0,42.42,42.42,1,-54801,101293,156094,46492,0,0,308,0,0,,308,308
28,07-09-18,81,20:00,20:15,,41.81,0,41.81,41.81,-1,-67807,72734,140541,4927,0,-190,0,0,0,,190,-190
28,07-09-18,82,20:15,20:30,,41.89,0,41.89,41.89,-1,-67927,64460,132387,-3467,0,-1409,0,0,0,,1409,-1409
28,07-09-18,83,20:30,20:45,46.42,41.89,0,46.42,46.42,1,-64693,50443,115136,-14250,0,-43,4156,0,0,,4199,4113
28,07-09-18,84,20:45,21:00,38.57,38.42,0,40.56,38.42,2,-43185,107344,150529,64159,0,-2930,472,0,0,,3402,-2458
28,07-09-18,85,21:00,21:15,,35.98,0,35.98,35.98,-1,-63270,82432,145702,19162,0,-3658,0,0,0,,3658,-3658
28,07-09-18,86,21:15,21:30,,,0,40.46,40.46,0,-68892,92267,161159,23375,0,0,0,0,0,,0,0
28,07-09-18,87,21:30,21:45,,,0,40.47,40.47,0,-71524,111988,183512,40464,0,0,0,0,0,,0,0
28,07-09-18,88,21:45,22:00,,37.69,0,37.69,37.69,-1,-45760,112766,158526,67006,0,-1480,0,0,0,,1480,-1480
28,07-09-18,89,22:00,22:15,,30.55,0,30.55,30.55,-1,-65645,81397,147042,15752,0,-15268,0,0,0,,15268,-15268
28,07-09-18,90,22:15,22:30,,33.84,0,33.84,33.84,-1,-42598,73260,115858,30662,0,-20714,0,0,0,,20714,-20714
28,07-09-18,91,22:30,22:45,,16.32,0,16.32,16.32,-1,-41484,96741,138225,55257,0,-30662,0,0,0,,30662,-30662
28,07-09-18,92,22:45,23:00,,5.13,0,5.13,5.13,-1,-65399,128413,193812,63014,0,-68469,0,0,0,,68469,-68469
28,07-09-18,93,23:00,23:15,,30.55,0,30.55,30.55,-1,-44398,84947,129345,40549,0,-38139,0,0,0,,38139,-38139
28,07-09-18,94,23:15,23:30,,16.32,0,16.32,16.32,-1,-40507,87422,127929,46915,0,-25089,0,0,0,,25089,-25089
28,07-09-18,95,23:30,23:45,,14.21,0,14.21,14.21,-1,-31615,115936,147551,84321,0,-77906,0,0,0,,77906,-77906
28,07-09-18,96,23:45,0:00,,29.21,0,29.21,29.21,-1,-27072,100065,127137,72993,0,-76574,0,0,0,,76574,-76574
28,07-10-18,1,0:00,0:15,53.8,31.07,0,53.8,53.8,1,-46749,25992,72741,-20757,0,-32880,3640,0,0,,36520,-29240
28,07-10-18,2,0:15,0:30,53.8,35.03,0,35.03,35.03,-1,-29326,67106,96432,37780,0,-970,614,0,0,,1584,-356
28,07-10-18,3,0:30,0:45,,35.03,0,35.03,35.03,-1,-49008,74165,123173,25157,0,-15461,0,0,0,,15461,-15461
28,07-10-18,4,0:45,1:00,,39.03,0,39.03,39.03,-1,-42310,59399,101709,17089,0,-16325,0,0,0,,16325,-16325
28,07-10-18,5,1:00,1:15,44.69,39.95,0,44.69,44.69,1,-59846,65516,125362,5670,0,-7234,1222,0,0,,8456,-6012
28,07-10-18,6,1:15,1:30,47.03,,0,47.03,47.03,1,-54755,51705,106460,-3050,0,0,3199,0,0,,3199,3199
28,07-10-18,7,1:30,1:45,,38.8,0,38.8,38.8,-1,-35775,40954,76729,5179,0,-933,0,0,0,,933,-933
28,07-10-18,8,1:45,2:00,,36.15,0,36.15,36.15,-1,-36154,45565,81719,9411,0,-11862,0,0,0,,11862,-11862
28,07-10-18,9,2:00,2:15,51.47,36.15,0,51.47,51.47,1,-64772,17891,82663,-46881,0,-1758,4695,0,0,,6453,2937
28,07-10-18,10,2:15,2:30,42.8,,0,42.8,42.8,1,-48043,30704,78747,-17339,0,0,1230,0,0,,1230,1230
28,07-10-18,11,2:30,2:45,,,0,43.03,43.03,0,-47156,46247,93403,-909,0,0,0,0,0,,0,0
28,07-10-18,12,2:45,3:00,,37.78,0,37.78,37.78,-1,-38819,60179,98998,21360,0,-5255,0,0,0,,5255,-5255
28,07-10-18,13,3:00,3:15,51.51,40.25,0,51.51,51.51,1,-50242,37700,87942,-12542,0,-4542,4729,0,0,,9271,187
28,07-10-18,14,3:15,3:30,56.14,,0,56.14,56.14,1,-52856,42678,95534,-10178,0,0,18074,0,0,,18074,18074
28,07-10-18,15,3:30,3:45,,,0,42.97,42.97,0,-35745,46860,82605,11115,0,0,840,0,0,,840,840
28,07-10-18,16,3:45,4:00,,39.03,0,39.03,39.03,-1,-33465,55799,89264,22334,0,-235,0,0,0,,235,-235
28,07-10-18,17,4:00,4:15,,31.78,0,31.78,31.78,-1,-27245,88828,116073,61583,0,-16020,0,0,0,,16020,-16020
28,07-10-18,18,4:15,4:30,,16.51,0,16.51,16.51,-1,-19030,72993,92023,53963,0,-30334,0,0,0,,30334,-30334
28,07-10-18,19,4:30,4:45,,1.25,0,1.25,1.25,-1,-23910,84329,108239,60419,0,-55658,0,0,0,,55658,-55658
28,07-10-18,20,4:45,5:00,,35.93,0,35.93,35.93,-1,-28921,79756,108677,50835,0,-29013,0,0,0,,29013,-29013
28,07-10-18,21,5:00,5:15,,39.03,0,39.03,39.03,-1,-60256,63333,123589,3077,0,-16446,0,0,0,,16446,-16446
28,07-10-18,22,5:15,5:30,,39.77,0,39.77,39.77,-1,-40412,58002,98414,17590,0,-3324,0,0,0,,3324,-3324
28,07-10-18,23,5:30,5:45,,43.03,0,43.03,43.03,-1,-43418,48524,91942,5106,0,-1847,0,0,0,,1847,-1847
28,07-10-18,24,5:45,6:00,,41.54,0,41.54,41.54,-1,-56462,56040,112502,-422,0,-2028,0,0,0,,2028,-2028
28,07-10-18,25,6:00,6:15,,41.8,0,41.8,41.8,-1,-88510,85849,174359,-2661,0,-487,0,0,0,,487,-487
28,07-10-18,26,6:15,6:30,,40.78,0,40.78,40.78,-1,-38979,95522,134501,56543,0,-1732,0,0,0,,1732,-1732
28,07-10-18,27,6:30,6:45,,,0,42.41,42.41,0,-39474,76655,116129,37181,0,0,0,0,0,,0,0
28,07-10-18,28,6:45,7:00,,,0,42.33,42.33,0,-50303,103931,154234,53628,0,0,0,0,0,,0,0
28,07-10-18,29,7:00,7:15,,31.14,0,31.14,31.14,-1,-54787,142820,197607,88033,0,-13172,0,0,0,,13172,-13172
28,07-10-18,30,7:15,7:30,,40.78,0,40.78,40.78,-1,-77552,105987,183539,28435,0,-15547,0,0,0,,15547,-15547
28,07-10-18,31,7:30,7:45,47.38,40.78,0,47.38,47.38,1,-82244,55902,138146,-26342,0,-3656,979,0,0,,4635,-2677
28,07-10-18,32,7:45,8:00,53.78,,0,53.78,53.78,1,-114442,52877,167319,-61565,0,0,16683,0,0,,16683,16683
28,07-10-18,33,8:00,8:15,43.38,42.44,0,42.44,42.44,-1,-116999,130503,247502,13504,0,-226,6982,0,0,,7208,6756
28,07-10-18,34,8:15,8:30,,40.78,0,40.78,40.78,-1,-120704,130772,251476,10068,0,-1860,0,0,0,,1860,-1860
28,07-10-18,35,8:30,8:45,,41.78,0,41.78,41.78,-1,-145637,113582,259219,-32055,0,-1596,0,0,0,,1596,-1596
28,07-10-18,36,8:45,9:00,,,0,42.74,42.74,0,-159098,103561,262659,-55537,0,0,0,0,0,,0,0
28,07-10-18,37,9:00,9:15,,,0,43.02,43.02,0,-84988,69120,154108,-15868,0,0,0,0,0,,0,0
28,07-10-18,38,9:15,9:30,43.38,,0,43.38,43.38,1,-116752,47850,164602,-68902,0,0,187,0,0,,187,187
28,07-10-18,39,9:30,9:45,,,0,42.84,42.84,0,-126132,54533,180665,-71599,0,0,0,0,0,,0,0
28,07-10-18,40,9:45,10:00,43.38,,0,43.38,43.38,1,-127684,54407,182091,-73277,0,0,1435,0,0,,1435,1435
28,07-10-18,41,10:00,10:15,147.12,,0,147.12,147.12,1,-137034,65323,202357,-71711,0,0,33055,0,0,,33055,33055
28,07-10-18,42,10:15,10:30,56,,0,56,56,1,-124388,79071,203459,-45317,0,0,35457,0,0,,35457,35457
28,07-10-18,43,10:30,10:45,,,0,42.85,42.85,0,-126318,79756,206074,-46562,0,0,2412,0,0,,2412,2412
28,07-10-18,44,10:45,11:00,,,0,42.86,42.86,0,-128755,96363,225118,-32392,0,0,0,0,0,,0,0
28,07-10-18,45,11:00,11:15,43.38,,0,43.38,43.38,1,-134626,79056,213682,-55570,0,0,381,0,0,,381,381
28,07-10-18,46,11:15,11:30,83.85,,0,83.85,83.85,1,-134217,61338,195555,-72879,0,0,18386,0,0,,18386,18386
28,07-10-18,47,11:30,11:45,51.58,,0,51.58,51.58,1,-137037,82755,219792,-54282,0,0,22453,0,0,,22453,22453
28,07-10-18,48,11:45,12:00,43.38,,0,43.38,43.38,1,-140164,89606,229770,-50558,0,0,529,0,0,,529,529
28,07-10-18,49,12:00,12:15,67.08,,0,67.08,67.08,1,-164002,78558,242560,-85444,0,0,8767,0,0,,8767,8767
28,07-10-18,50,12:15,12:30,51.58,,0,51.58,51.58,1,-164337,101641,265978,-62696,0,0,7380,0,0,,7380,7380
28,07-10-18,51,12:30,12:45,66.58,,0,66.58,66.58,1,-148952,110376,259328,-38576,0,0,24481,0,0,,24481,24481
28,07-10-18,52,12:45,13:00,47.38,,0,47.38,47.38,1,-131192,123246,254438,-7946,0,0,16913,0,0,,16913,16913
28,07-10-18,53,13:00,13:15,115.12,,0,115.12,115.12,1,-199780,139509,339289,-60271,0,0,28234,0,0,,28234,28234
28,07-10-18,54,13:15,13:30,56.99,,0,56.99,56.99,1,-175118,130440,305558,-44678,0,0,56577,0,0,,56577,56577
28,07-10-18,55,13:30,13:45,56.99,39.78,0,39.78,39.78,-1,-134102,128499,262601,-5603,0,-436,13785,0,0,,14221,13349
28,07-10-18,56,13:45,14:00,,39.78,0,39.78,39.78,-1,-130332,157388,287720,27056,0,-3879,0,0,0,,3879,-3879
28,07-10-18,57,14:00,14:15,,42.36,0,42.36,42.36,-1,-124720,134330,259050,9610,0,-1528,0,0,0,,1528,-1528
28,07-10-18,58,14:15,14:30,,,0,42.66,42.66,0,-135876,149149,285025,13273,0,0,0,0,0,,0,0
28,07-10-18,59,14:30,14:45,,,0,44.03,44.03,0,-134715,149791,284506,15076,0,0,0,0,0,,0,0
28,07-10-18,60,14:45,15:00,,44.09,0,44.09,44.09,-1,-134866,146271,281137,11405,0,-735,0,0,0,,735,-735
28,07-10-18,61,15:00,15:15,,35.93,0,35.93,35.93,-1,-80584,128180,208764,47596,0,-11534,0,0,0,,11534,-11534
28,07-10-18,62,15:15,15:30,,36.53,0,36.53,36.53,-1,-89260,133524,222784,44264,0,-31959,0,0,0,,31959,-31959
28,07-10-18,63,15:30,15:45,,39.38,0,39.38,39.38,-1,-107244,128348,235592,21104,0,-25701,0,0,0,,25701,-25701
28,07-10-18,64,15:45,16:00,,38.61,0,38.61,38.61,-1,-114332,138508,252840,24176,0,-11850,0,0,0,,11850,-11850
28,07-10-18,65,16:00,16:15,,35.93,0,35.93,35.93,-1,-118861,166133,284994,47272,0,-15920,0,0,0,,15920,-15920
28,07-10-18,66,16:15,16:30,,31.56,0,31.56,31.56,-1,-134485,190914,325399,56429,0,-34463,0,0,0,,34463,-34463
28,07-10-18,67,16:30,16:45,,38.61,0,38.61,38.61,-1,-142298,199672,341970,57374,0,-27136,0,0,0,,27136,-27136
28,07-10-18,68,16:45,17:00,,38.61,0,38.61,38.61,-1,-152195,194584,346779,42389,0,-13909,0,0,0,,13909,-13909
28,07-10-18,69,17:00,17:15,,22.55,0,22.55,22.55,-1,-115628,200797,316425,85169,0,-41544,0,0,0,,41544,-41544
28,07-10-18,70,17:15,17:30,,36.53,0,36.53,36.53,-1,-115832,155034,270866,39202,0,-39160,0,0,0,,39160,-39160
28,07-10-18,71,17:30,17:45,,,0,42.48,42.48,0,-117668,166127,283795,48459,0,-4944,0,0,0,,4944,-4944
28,07-10-18,72,17:45,18:00,42.61,,0,42.61,42.61,1,-133192,156408,289600,23216,0,0,15,0,0,,15,15
28,07-10-18,73,18:00,18:15,,39.93,0,39.93,39.93,-1,-119780,122016,241796,2236,0,-794,0,0,0,,794,-794
28,07-10-18,74,18:15,18:30,,38.61,0,38.61,38.61,-1,-126552,134500,261052,7948,0,-5789,0,0,0,,5789,-5789
28,07-10-18,75,18:30,18:45,,45.05,0,45.05,45.05,-1,-127320,129692,257012,2372,0,-2118,0,0,0,,2118,-2118
28,07-10-18,76,18:45,19:00,,45.05,0,45.05,45.05,-1,-111079,128708,239787,17629,0,-1181,0,0,0,,1181,-1181
28,07-10-18,77,19:00,19:15,,31.56,0,31.56,31.56,-1,-100982,152156,253138,51174,0,-14786,0,0,0,,14786,-14786
28,07-10-18,78,19:15,19:30,,39.78,0,39.78,39.78,-1,-119855,124972,244827,5117,0,-14241,0,0,0,,14241,-14241
28,07-10-18,79,19:30,19:45,43.12,39.78,0,43.12,43.12,1,-124456,118021,242477,-6435,0,-483,1681,0,0,,2164,1198
28,07-10-18,80,19:45,20:00,,,0,43.85,43.85,0,-126017,119157,245174,-6860,0,0,18,0,0,,18,18
28,07-10-18,81,20:00,20:15,44,,0,44,44,1,-119690,108422,228112,-11268,0,0,924,0,0,,924,924
28,07-10-18,82,20:15,20:30,,40.78,0,40.78,40.78,-1,-96594,114129,210723,17535,0,-1576,0,0,0,,1576,-1576
28,07-10-18,83,20:30,20:45,,34.61,0,34.61,34.61,-1,-97876,133301,231177,35425,0,-23095,0,0,0,,23095,-23095
28,07-10-18,84,20:45,21:00,43.01,38.61,0,43.01,43.01,1,-119136,118642,237778,-494,0,-18286,251,0,0,,18537,-18035
28,07-10-18,85,21:00,21:15,46.61,38.61,0,46.61,46.61,1,-115695,71218,186913,-44477,0,-557,5093,0,0,,5650,4536
28,07-10-18,86,21:15,21:30,51.16,,0,51.16,51.16,1,-164196,95880,260076,-68316,0,0,6579,0,0,,6579,6579
28,07-10-18,87,21:30,21:45,,,0,43.83,43.83,0,-159120,95290,254410,-63830,0,0,242,0,0,,242,242
28,07-10-18,88,21:45,22:00,,,0,43.83,43.83,0,-140563,93474,234037,-47089,0,0,0,0,0,,0,0
28,07-10-18,89,22:00,22:15,42.99,,0,42.99,42.99,1,-154474,64361,218835,-90113,0,0,196,0,0,,196,196
28,07-10-18,90,22:15,22:30,147.12,,0,147.12,147.12,1,-203307,40125,243432,-163182,0,0,32441,0,0,,32441,32441
28,07-10-18,91,22:30,22:45,255.99,,0,255.99,255.99,1,-192111,54558,246669,-137553,0,0,91466,3750,0,,95216,95216
28,07-10-18,92,22:45,23:00,255.99,37.94,0,37.94,37.94,-1,-110976,98316,209292,-12660,0,-862,33062,3750,0,,37674,35950
28,07-10-18,93,23:00,23:15,42.65,23.78,0,43.69,23.78,2,-75405,102532,177937,27127,0,-6225,223,0,0,,6448,-6002
28,07-10-18,94,23:15,23:30,42.71,37.07,0,43.48,37.07,2,-56635,66894,123529,10259,0,-1407,1580,0,0,,2987,173
28,07-10-18,95,23:30,23:45,,34.61,0,34.61,34.61,-1,-50197,57623,107820,7426,0,-8382,0,0,0,,8382,-8382
28,07-10-18,96,23:45,0:00,,38.26,0,38.26,38.26,-1,-53199,59561,112760,6362,0,-8727,0,0,0,,8727,-8727
28,07-11-18,1,0:00,0:15,66.76,-6.92,0,66.76,-6.92,2,-56769,65674,122443,8905,0,-17000,1876,0,0,,18876,-15124
28,07-11-18,2,0:15,0:30,144.02,42.38,0,144.02,42.38,2,-58343,27794,86137,-30549,0,-36,23997,0,0,,24033,23961
28,07-11-18,3,0:30,0:45,144.02,42.38,0,42.38,42.38,-1,-81694,43966,125660,-37728,0,-492,348,0,0,,840,-144
28,07-11-18,4,0:45,1:00,,42.4,0,42.4,42.4,-1,-103462,51809,155271,-51653,0,-330,0,0,0,,330,-330
28,07-11-18,5,1:00,1:15,66.76,,0,66.76,66.76,1,-74227,23402,97629,-50825,0,0,12889,0,0,,12889,12889
28,07-11-18,6,1:15,1:30,46.61,,0,46.61,46.61,1,-46393,25220,71613,-21173,0,0,10450,0,0,,10450,10450
28,07-11-18,7,1:30,1:45,,,0,41.28,41.28,0,-45116,32139,77255,-12977,0,0,0,0,0,,0,0
28,07-11-18,8,1:45,2:00,,38.61,0,38.61,38.61,-1,-42410,48676,91086,6266,0,-1859,0,0,0,,1859,-1859
28,07-11-18,9,2:00,2:15,50.71,42.27,0,50.71,50.71,1,-67009,26893,93902,-40116,0,-955,8577,0,0,,9532,7622
28,07-11-18,10,2:15,2:30,45.44,,0,45.44,45.44,1,-67206,31248,98454,-35958,0,0,20853,0,0,,20853,20853
28,07-11-18,11,2:30,2:45,43.37,,0,43.37,43.37,1,-58512,33820,92332,-24692,0,0,14069,0,0,,14069,14069
28,07-11-18,12,2:45,3:00,43.37,,0,43.37,43.37,1,-48655,34370,83025,-14285,0,0,7141,0,0,,7141,7141
28,07-11-18,13,3:00,3:15,45.54,,0,45.54,45.54,1,-49886,24635,74521,-25251,0,0,6171,0,0,,6171,6171
28,07-11-18,14,3:15,3:30,43.38,,0,43.38,43.38,1,-44965,28715,73680,-16250,0,0,5957,0,0,,5957,5957
28,07-11-18,15,3:30,3:45,42.61,,0,42.61,42.61,1,-38161,37794,75955,-367,0,0,1573,0,0,,1573,1573
28,07-11-18,16,3:45,4:00,42.61,,0,42.61,42.61,1,-53641,35498,89139,-18143,0,0,1149,0,0,,1149,1149
28,07-11-18,17,4:00,4:15,40.02,,0,40.02,40.02,1,-38211,36330,74541,-1881,0,0,470,0,0,,470,470
28,07-11-18,18,4:15,4:30,,,0,41.13,41.13,0,-42638,35013,77651,-7625,0,0,0,0,0,,0,0
28,07-11-18,19,4:30,4:45,,,0,41.13,41.13,0,-46646,20834,67480,-25812,0,0,0,0,0,,0,0
28,07-11-18,20,4:45,5:00,43.37,,0,43.37,43.37,1,-47839,18336,66175,-29503,0,0,287,0,0,,287,287
28,07-11-18,21,5:00,5:15,43.49,,0,43.49,43.49,1,-52037,38730,90767,-13307,0,0,676,0,0,,676,676
28,07-11-18,22,5:15,5:30,50.71,,0,50.71,50.71,1,-56997,27134,84131,-29863,0,0,1915,0,0,,1915,1915
28,07-11-18,23,5:30,5:45,48.19,,0,48.19,48.19,1,-75543,23563,99106,-51980,0,0,3152,0,0,,3152,3152
28,07-11-18,24,5:45,6:00,40.02,,0,40.02,40.02,1,-92693,14655,107348,-78038,0,0,198,0,0,,198,198
28,07-11-18,25,6:00,6:15,43.21,,0,43.21,43.21,1,-67429,33863,101292,-33566,0,0,129,0,0,,129,129
28,07-11-18,26,6:15,6:30,,39.59,0,39.59,39.59,-1,-45554,38109,83663,-7445,0,-755,0,0,0,,755,-755
28,07-11-18,27,6:30,6:45,47.21,,0,47.21,47.21,1,-54897,17134,72031,-37763,0,0,1127,0,0,,1127,1127
28,07-11-18,28,6:45,7:00,67.37,,0,67.37,67.37,1,-101019,45836,146855,-55183,0,0,26138,0,0,,26138,26138
28,07-11-18,29,7:00,7:15,49.02,39.2,0,39.2,39.2,-1,-84396,81460,165856,-2936,0,-1117,18813,0,0,,19930,17696
28,07-11-18,30,7:15,7:30,49.02,37.05,0,37.05,37.05,-1,-89875,88804,178679,-1071,0,-2204,173,0,0,,2377,-2031
28,07-11-18,31,7:30,7:45,52.45,37.05,0,52.45,52.45,1,-89445,65611,155056,-23834,0,-53,2825,0,0,,2878,2772
28,07-11-18,32,7:45,8:00,146.02,,0,146.02,146.02,1,-105752,31410,137162,-74342,0,0,54813,0,0,,54813,54813
28,07-11-18,33,8:00,8:15,51.49,35.03,0,51.49,35.03,2,-83717,114671,198388,30954,0,-1875,27670,0,0,,29545,25795
28,07-11-18,34,8:15,8:30,51.49,43.06,0,43.06,43.06,-1,-72349,99336,171685,26987,0,-459,22,0,0,,481,-437
28,07-11-18,35,8:30,8:45,,43.03,0,43.03,43.03,-1,-82026,87068,169094,5042,0,-641,0,0,0,,641,-641
28,07-11-18,36,8:45,9:00,,36.08,0,36.08,36.08,-1,-46735,67160,113895,20425,0,-2190,0,0,0,,2190,-2190
28,07-11-18,37,9:00,9:15,,-64.83,0,-64.83,-64.83,-1,-17386,160701,178087,143315,0,-30784,0,0,0,,30784,-30784
28,07-11-18,38,9:15,9:30,,36.53,0,36.53,36.53,-1,-43288,88262,131550,44974,0,-16450,0,0,0,,16450,-16450
28,07-11-18,39,9:30,9:45,,35.21,0,35.21,35.21,-1,-24943,94111,119054,69168,0,-1950,0,0,0,,1950,-1950
28,07-11-18,40,9:45,10:00,,33.48,0,33.48,33.48,-1,-36058,112636,148694,76578,0,-2954,0,0,0,,2954,-2954
28,07-11-18,41,10:00,10:15,67.37,33.48,0,67.37,67.37,1,-143917,68955,212872,-74962,0,-35,11064,0,0,,11099,11029
28,07-11-18,42,10:15,10:30,44.69,,0,44.69,44.69,1,-91258,72066,163324,-19192,0,0,5388,0,0,,5388,5388
28,07-11-18,43,10:30,10:45,47.21,,0,47.21,47.21,1,-88716,62279,150995,-26437,0,0,7158,0,0,,7158,7158
28,07-11-18,44,10:45,11:00,47.21,,0,47.21,47.21,1,-69493,77665,147158,8172,0,0,7406,0,0,,7406,7406
28,07-11-18,45,11:00,11:15,51.32,,0,51.32,51.32,1,-139470,66092,205562,-73378,0,0,865,0,0,,865,865
28,07-11-18,46,11:15,11:30,67.37,,0,67.37,67.37,1,-123574,56452,180026,-67122,0,0,21296,0,0,,21296,21296
28,07-11-18,47,11:30,11:45,47.21,,0,47.21,47.21,1,-103764,67139,170903,-36625,0,0,21190,0,0,,21190,21190
28,07-11-18,48,11:45,12:00,47.21,,0,47.21,47.21,1,-74974,56108,131082,-18866,0,0,9554,0,0,,9554,9554
28,07-11-18,49,12:00,12:15,51.32,,0,51.32,51.32,1,-167806,54855,222661,-112951,0,0,20219,0,0,,20219,20219
28,07-11-18,50,12:15,12:30,43.65,,0,43.65,43.65,1,-142425,58595,201020,-83830,0,0,7484,0,0,,7484,7484
28,07-11-18,51,12:30,12:45,129.02,,0,129.02,129.02,1,-129856,65609,195465,-64247,0,0,21193,0,0,,21193,21193
28,07-11-18,52,12:45,13:00,51.32,,0,51.32,51.32,1,-127129,72133,199262,-54996,0,0,25339,0,0,,25339,25339
28,07-11-18,53,13:00,13:15,145.02,,0,145.02,145.02,1,-143311,67937,211248,-75374,0,0,28381,0,0,,28381,28381
28,07-11-18,54,13:15,13:30,66.02,,0,66.02,66.02,1,-137795,78411,216206,-59384,0,0,59376,0,0,,59376,59376
28,07-11-18,55,13:30,13:45,,,0,43.2,43.2,0,-118537,82077,200614,-36460,0,0,10332,0,0,,10332,10332
28,07-11-18,56,13:45,14:00,,,0,43.2,43.2,0,-104003,78591,182594,-25412,0,0,0,0,0,,0,0
28,07-11-18,57,14:00,14:15,43.21,39.21,0,43.21,43.21,1,-100368,74264,174632,-26104,0,-4,498,0,0,,502,494
28,07-11-18,58,14:15,14:30,43.21,,0,43.21,43.21,1,-94368,71039,165407,-23329,0,0,1138,0,0,,1138,1138
28,07-11-18,59,14:30,14:45,,42.97,0,42.97,42.97,-1,-73736,81138,154874,7402,0,-5,0,0,0,,5,-5
28,07-11-18,60,14:45,15:00,,39.21,0,39.21,39.21,-1,-78894,91856,170750,12962,0,-2096,0,0,0,,2096,-2096
28,07-11-18,61,15:00,15:15,,39.21,0,39.21,39.21,-1,-68937,81636,150573,12699,0,-2071,0,0,0,,2071,-2071
28,07-11-18,62,15:15,15:30,,,0,43.2,43.2,0,-71774,98954,170728,27180,0,0,0,0,0,,0,0
28,07-11-18,63,15:30,15:45,,,0,43.2,43.2,0,-64387,119242,183629,54855,0,0,0,0,0,,0,0
28,07-11-18,64,15:45,16:00,,35.21,0,35.21,35.21,-1,-49907,128254,178161,78347,0,-2230,0,0,0,,2230,-2230
28,07-11-18,65,16:00,16:15,,5.81,0,5.81,5.81,-1,-82872,145455,228327,62583,0,-35250,0,0,0,,35250,-35250
28,07-11-18,66,16:15,16:30,,31.32,0,31.32,31.32,-1,-81055,144456,225511,63401,0,-44849,0,0,0,,44849,-44849
28,07-11-18,67,16:30,16:45,,31.32,0,31.32,31.32,-1,-83073,137806,220879,54733,0,-44843,0,0,0,,44843,-44843
28,07-11-18,68,16:45,17:00,,35.03,0,35.03,35.03,-1,-94977,129552,224529,34575,0,-38540,0,0,0,,38540,-38540
28,07-11-18,69,17:00,17:15,,0.07,0,0.07,0.07,-1,-72248,164354,236602,92106,0,-55003,0,0,0,,55003,-55003
28,07-11-18,70,17:15,17:30,,19.78,0,19.78,19.78,-1,-101291,138431,239722,37140,0,-53690,0,0,0,,53690,-53690
28,07-11-18,71,17:30,17:45,,,0,43.2,43.2,0,-94333,124860,219193,30527,0,-3717,0,0,0,,3717,-3717
28,07-11-18,72,17:45,18:00,,,0,43.2,43.2,0,-86535,125519,212054,38984,0,0,0,0,0,,0,0
28,07-11-18,73,18:00,18:15,43.21,,0,43.21,43.21,1,-81839,71693,153532,-10146,0,0,3,0,0,,3,3
28,07-11-18,74,18:15,18:30,,43.08,0,43.08,43.08,-1,-68626,85123,153749,16497,0,-1393,0,0,0,,1393,-1393
28,07-11-18,75,18:30,18:45,,31.32,0,31.32,31.32,-1,-67297,101477,168774,34180,0,-8684,0,0,0,,8684,-8684
28,07-11-18,76,18:45,19:00,,,0,43.2,43.2,0,-74183,107057,181240,32874,0,-774,0,0,0,,774,-774
28,07-11-18,77,19:00,19:15,43.89,,0,43.89,43.89,1,-73961,72311,146272,-1650,0,0,332,0,0,,332,332
28,07-11-18,78,19:15,19:30,43.9,,0,43.9,43.9,1,-69290,57059,126349,-12231,0,0,1838,0,0,,1838,1838
28,07-11-18,79,19:30,19:45,47.21,,0,47.21,47.21,1,-72611,60880,133491,-11731,0,0,5600,0,0,,5600,5600
28,07-11-18,80,19:45,20:00,51.3,,0,51.3,51.3,1,-93990,61292,155282,-32698,0,0,19883,0,0,,19883,19883
28,07-11-18,81,20:00,20:15,43.21,43.06,0,43.06,43.06,-1,-56980,73204,130184,16224,0,-532,6437,0,0,,6969,5905
28,07-11-18,82,20:15,20:30,,43.08,0,43.08,43.08,-1,-67956,74292,142248,6336,0,-853,0,0,0,,853,-853
28,07-11-18,83,20:30,20:45,,41.17,0,41.17,41.17,-1,-71076,80672,151748,9596,0,-639,0,0,0,,639,-639
28,07-11-18,84,20:45,21:00,,,0,43.2,43.2,0,-83339,72455,155794,-10884,0,-209,0,0,0,,209,-209
28,07-11-18,85,21:00,21:15,47.21,,0,47.21,47.21,1,-88751,73596,162347,-15155,0,0,3063,0,0,,3063,3063
28,07-11-18,86,21:15,21:30,43.21,,0,43.21,43.21,1,-79517,78641,158158,-876,0,0,490,0,0,,490,490
28,07-11-18,87,21:30,21:45,,43.14,0,43.14,43.14,-1,-77894,86531,164425,8637,0,-5,0,0,0,,5,-5
28,07-11-18,88,21:45,22:00,,38.57,0,38.57,38.57,-1,-79491,90775,170266,11284,0,-4690,0,0,0,,4690,-4690
28,07-11-18,89,22:00,22:15,,43.19,0,43.19,43.19,-1,-99595,60072,159667,-39523,0,-376,0,0,0,,376,-376
28,07-11-18,90,22:15,22:30,,,0,26.6,26.6,0,-124544,51633,176177,-72911,0,0,0,0,0,,0,0
28,07-11-18,91,22:30,22:45,44.24,,0,44.24,44.24,1,-118625,76839,195464,-41786,0,0,675,0,0,,675,675
28,07-11-18,92,22:45,23:00,54.19,,0,54.19,54.19,1,-117828,67605,185433,-50223,0,0,10501,0,0,,10501,10501
28,07-11-18,93,23:00,23:15,51.3,,0,51.3,51.3,1,-125220,96882,222102,-28338,0,0,14386,0,0,,14386,14386
28,07-11-18,94,23:15,23:30,53.3,,0,53.3,53.3,1,-111900,57016,168916,-54884,0,0,28798,0,0,,28798,28798
28,07-11-18,95,23:30,23:45,53.3,39.21,0,39.21,39.21,-1,-102307,83297,185604,-19010,0,-12,5667,0,0,,5679,5655
28,07-11-18,96,23:45,0:00,,31.32,0,31.32,31.32,-1,-83362,116913,200275,33551,0,-9275,0,0,0,,9275,-9275
28,07-12-18,1,0:00,0:15,132.12,41.12,0,132.12,132.12,1,-129445,36699,166144,-92746,0,-5675,15301,0,0,,20976,9626
28,07-12-18,2,0:15,0:30,144.12,,0,144.12,144.12,1,-92356,48913,141269,-43443,0,0,58062,0,0,,58062,58062
28,07-12-18,3,0:30,0:45,,,0,44.5,44.5,0,-79104,33215,112319,-45889,0,0,5774,0,0,,5774,5774
28,07-12-18,4,0:45,1:00,,42.72,0,42.72,42.72,-1,-80642,55974,136616,-24668,0,-8,0,0,0,,8,-8
28,07-12-18,5,1:00,1:15,47.21,,0,47.21,47.21,1,-57345,40576,97921,-16769,0,0,3050,0,0,,3050,3050
28,07-12-18,6,1:15,1:30,43.21,,0,43.21,43.21,1,-37731,43319,81050,5588,0,0,1815,0,0,,1815,1815
28,07-12-18,7,1:30,1:45,,,0,43.45,43.45,0,-27544,65930,93474,38386,0,0,47,0,0,,47,47
28,07-12-18,8,1:45,2:00,,38.51,0,38.51,38.51,-1,-20839,79420,100259,58581,0,-5302,0,0,0,,5302,-5302
28,07-12-18,9,2:00,2:15,,42.51,0,42.51,42.51,-1,-38398,87021,125419,48623,0,-4358,0,0,0,,4358,-4358
28,07-12-18,10,2:15,2:30,,,0,43.45,43.45,0,-36039,72141,108180,36102,0,0,0,0,0,,0,0
28,07-12-18,11,2:30,2:45,,,0,43.45,43.45,0,-31633,75689,107322,44056,0,0,0,0,0,,0,0
28,07-12-18,12,2:45,3:00,,35.07,0,35.07,35.07,-1,-19771,76273,96044,56502,0,-5582,0,0,0,,5582,-5582
28,07-12-18,13,3:00,3:15,,33.66,0,33.66,33.66,-1,-32367,47782,80149,15415,0,-9091,0,0,0,,9091,-9091
28,07-12-18,14,3:15,3:30,,,0,44.5,44.5,0,-27545,62401,89946,34856,0,0,0,0,0,,0,0
28,07-12-18,15,3:30,3:45,,42.31,0,42.31,42.31,-1,-9624,66679,76303,57055,0,-545,0,0,0,,545,-545
28,07-12-18,16,3:45,4:00,,45.78,0,45.78,45.78,-1,-10565,70999,81564,60434,0,-38,0,0,0,,38,-38
28,07-12-18,17,4:00,4:15,,,0,44.5,44.5,0,-30928,64401,95329,33473,0,0,0,0,0,,0,0
28,07-12-18,18,4:15,4:30,,,0,44.5,44.5,0,-12232,72187,84419,59955,0,0,0,0,0,,0,0
28,07-12-18,19,4:30,4:45,,,0,44.5,44.5,0,-12226,58003,70229,45777,0,0,0,0,0,,0,0
28,07-12-18,20,4:45,5:00,,,0,44.5,44.5,0,-20066,45697,65763,25631,0,0,0,0,0,,0,0
28,07-12-18,21,5:00,5:15,47.21,,0,47.21,47.21,1,-52933,30349,83282,-22584,0,0,3237,0,0,,3237,3237
28,07-12-18,22,5:15,5:30,43.21,,0,43.21,43.21,1,-26340,48523,74863,22183,0,0,401,0,0,,401,401
28,07-12-18,23,5:30,5:45,,,0,44,44,0,-30264,41814,72078,11550,0,0,0,0,0,,0,0
28,07-12-18,24,5:45,6:00,43.21,,0,43.21,43.21,1,-23253,37899,61152,14646,0,0,1,0,0,,1,1
28,07-12-18,25,6:00,6:15,,3.21,0,3.21,3.21,-1,-18584,106597,125181,88013,0,-28623,0,0,0,,28623,-28623
28,07-12-18,26,6:15,6:30,,37.08,0,37.08,37.08,-1,-33628,77924,111552,44296,0,-43312,0,0,0,,43312,-43312
28,07-12-18,27,6:30,6:45,,42.68,0,42.68,42.68,-1,-55734,72282,128016,16548,0,-15259,0,0,0,,15259,-15259
28,07-12-18,28,6:45,7:00,,,0,42.95,42.95,0,-68050,92434,160484,24384,0,-1,0,0,0,,1,-1
28,07-12-18,29,7:00,7:15,46.72,41.68,0,41.68,41.68,-1,-85266,93954,179220,8688,0,-396,34,0,0,,430,-362
28,07-12-18,30,7:15,7:30,,38.72,0,38.72,38.72,-1,-49758,88035,137793,38277,0,-3838,0,0,0,,3838,-3838
28,07-12-18,31,7:30,7:45,,43.78,0,43.78,43.78,-1,-57566,68569,126135,11003,0,-312,0,0,0,,312,-312
28,07-12-18,32,7:45,8:00,48.52,,0,48.52,48.52,1,-67340,47552,114892,-19788,0,0,6351,0,0,,6351,6351
28,07-12-18,33,8:00,8:15,43.9,,0,43.9,43.9,1,-65251,52949,118200,-12302,0,0,2298,0,0,,2298,2298
28,07-12-18,34,8:15,8:30,46.72,,0,46.72,46.72,1,-90989,58453,149442,-32536,0,0,10391,0,0,,10391,10391
28,07-12-18,35,8:30,8:45,46.72,,0,46.72,46.72,1,-123942,76790,200732,-47152,0,0,9976,0,0,,9976,9976
28,07-12-18,36,8:45,9:00,,,0,43.75,43.75,0,-139102,66376,205478,-72726,0,0,78,0,0,,78,78
28,07-12-18,37,9:00,9:15,66.87,,0,66.87,66.87,1,-122908,66262,189170,-56646,0,0,14480,0,0,,14480,14480
28,07-12-18,38,9:15,9:30,50.82,,0,50.82,50.82,1,-99582,65489,165071,-34093,0,0,32776,0,0,,32776,32776
28,07-12-18,39,9:30,9:45,46.72,,0,46.72,46.72,1,-87131,68132,155263,-18999,0,0,19305,0,0,,19305,19305
28,07-12-18,40,9:45,10:00,46.72,,0,46.72,46.72,1,-80165,57410,137575,-22755,0,0,10503,0,0,,10503,10503
28,07-12-18,41,10:00,10:15,55.12,,0,55.12,55.12,1,-117937,78334,196271,-39603,0,0,30183,0,0,,30183,30183
28,07-12-18,42,10:15,10:30,46.72,,0,46.72,46.72,1,-113812,85621,199433,-28191,0,0,21682,0,0,,21682,21682
28,07-12-18,43,10:30,10:45,46.72,,0,46.72,46.72,1,-108340,78304,186644,-30036,0,0,18926,0,0,,18926,18926
28,07-12-18,44,10:45,11:00,43.84,,0,43.84,43.84,1,-96301,86973,183274,-9328,0,0,6343,0,0,,6343,6343
28,07-12-18,45,11:00,11:15,150.12,,0,150.12,150.12,1,-133768,42486,176254,-91282,0,0,33210,0,0,,33210,33210
28,07-12-18,46,11:15,11:30,55.66,,0,55.66,55.66,1,-103796,72239,176035,-31557,0,0,39264,0,0,,39264,39264
28,07-12-18,47,11:30,11:45,,,0,43.75,43.75,0,-88463,65168,153631,-23295,0,0,3907,0,0,,3907,3907
28,07-12-18,48,11:45,12:00,45.34,,0,45.34,45.34,1,-87346,73574,160920,-13772,0,0,1076,0,0,,1076,1076
28,07-12-18,49,12:00,12:15,46.72,,0,46.72,46.72,1,-95297,54710,150007,-40587,0,0,4902,0,0,,4902,4902
28,07-12-18,50,12:15,12:30,,,0,43.65,43.65,0,-88199,46414,134613,-41785,0,0,0,0,0,,0,0
28,07-12-18,51,12:30,12:45,50.82,,0,50.82,50.82,1,-91372,58397,149769,-32975,0,0,7083,0,0,,7083,7083
28,07-12-18,52,12:45,13:00,43.65,,0,43.65,43.65,1,-84572,71024,155596,-13548,0,0,3234,0,0,,3234,3234
28,07-12-18,53,13:00,13:15,50.82,,0,50.82,50.82,1,-77102,56881,133983,-20221,0,0,6202,0,0,,6202,6202
28,07-12-18,54,13:15,13:30,50.82,,0,50.82,50.82,1,-80892,56996,137888,-23896,0,0,28067,0,0,,28067,28067
28,07-12-18,55,13:30,13:45,,,0,43.63,43.63,0,-67271,60978,128249,-6293,0,0,6207,0,0,,6207,6207
28,07-12-18,56,13:45,14:00,42.72,,0,42.72,42.72,1,-76580,66072,142652,-10508,0,0,399,0,0,,399,399
28,07-12-18,57,14:00,14:15,46.72,,0,46.72,46.72,1,-69309,61775,131084,-7534,0,0,2917,0,0,,2917,2917
28,07-12-18,58,14:15,14:30,50.82,,0,50.82,50.82,1,-72151,49428,121579,-22723,0,0,21190,0,0,,21190,21190
28,07-12-18,59,14:30,14:45,,,0,43.61,43.61,0,-62403,49736,112139,-12667,0,0,4783,0,0,,4783,4783
28,07-12-18,60,14:45,15:00,,,0,43.61,43.61,0,-69705,55658,125363,-14047,0,0,0,0,0,,0,0
28,07-12-18,61,15:00,15:15,42.72,42.99,0,42.72,42.72,1,-50285,46055,96340,-4230,0,-46,169,0,0,,215,123
28,07-12-18,62,15:15,15:30,42.72,,0,42.72,42.72,1,-67598,44643,112241,-22955,0,0,2091,0,0,,2091,2091
28,07-12-18,63,15:30,15:45,43.4,,0,43.4,43.4,1,-73729,50065,123794,-23664,0,0,1522,0,0,,1522,1522
28,07-12-18,64,15:45,16:00,42.72,,0,42.72,42.72,1,-83947,50192,134139,-33755,0,0,1112,0,0,,1112,1112
28,07-12-18,65,16:00,16:15,,,0,43.63,43.63,0,-69364,86870,156234,17506,0,0,0,0,0,,0,0
28,07-12-18,66,16:15,16:30,,,0,43.63,43.63,0,-62401,91482,153883,29081,0,0,0,0,0,,0,0
28,07-12-18,67,16:30,16:45,,43,0,43,43,-1,-124048,79997,204045,-44051,0,-214,0,0,0,,214,-214
28,07-12-18,68,16:45,17:00,,,0,43.63,43.63,0,-179027,106937,285964,-72090,0,0,0,0,0,,0,0
28,07-12-18,69,17:00,17:15,,,0,43.65,43.65,0,-92680,110470,203150,17790,0,0,0,0,0,,0,0
28,07-12-18,70,17:15,17:30,46.72,,0,46.72,46.72,1,-112369,102410,214779,-9959,0,0,2590,0,0,,2590,2590
28,07-12-18,71,17:30,17:45,46.72,,0,46.72,46.72,1,-117367,97767,215134,-19600,0,0,6784,0,0,,6784,6784
28,07-12-18,72,17:45,18:00,66.87,,0,66.87,66.87,1,-129755,83625,213380,-46130,0,0,10624,0,0,,10624,10624
28,07-12-18,73,18:00,18:15,86.12,,0,86.12,86.12,1,-135384,70742,206126,-64642,0,0,45680,0,0,,45680,45680
28,07-12-18,74,18:15,18:30,50.82,,0,50.82,50.82,1,-118182,79014,197196,-39168,0,0,37221,0,0,,37221,37221
28,07-12-18,75,18:30,18:45,50.12,,0,50.12,50.12,1,-120619,85412,206031,-35207,0,0,26997,0,0,,26997,26997
28,07-12-18,76,18:45,19:00,50.9,,0,50.9,50.9,1,-124562,86551,211113,-38011,0,0,23125,0,0,,23125,23125
28,07-12-18,77,19:00,19:15,46.72,42.91,0,42.91,42.91,-1,-91328,96160,187488,4832,0,-22,12777,0,0,,12799,12755
28,07-12-18,78,19:15,19:30,46.72,41.89,0,41.89,41.89,-1,-101160,104628,205788,3468,0,-708,22,0,0,,730,-686
28,07-12-18,79,19:30,19:45,,43.78,0,43.78,43.78,-1,-104935,99278,204213,-5657,0,-1584,0,0,0,,1584,-1584
28,07-12-18,80,19:45,20:00,49.54,43.78,0,49.54,49.54,1,-119612,91366,210978,-28246,0,-10,1625,0,0,,1635,1615
28,07-12-18,81,20:00,20:15,150.12,,0,150.12,150.12,1,-204043,78077,282120,-125966,0,0,40422,0,0,,40422,40422
28,07-12-18,82,20:15,20:30,150.12,,0,150.12,150.12,1,-185745,94471,280216,-91274,0,0,92928,0,0,,92928,92928
28,07-12-18,83,20:30,20:45,46.72,,0,46.72,46.72,1,-163893,113251,277144,-50642,0,0,35456,0,0,,35456,35456
28,07-12-18,84,20:45,21:00,46.72,,0,46.72,46.72,1,-166632,120849,287481,-45783,0,0,15413,0,0,,15413,15413
28,07-12-18,85,21:00,21:15,147.25,,0,147.25,147.25,1,-161140,77877,239017,-83263,0,0,32791,0,0,,32791,32791
28,07-12-18,86,21:15,21:30,54.12,,0,54.12,54.12,1,-160085,105286,265371,-54799,0,0,47298,0,0,,47298,47298
28,07-12-18,87,21:30,21:45,50.82,,0,50.82,50.82,1,-155755,118142,273897,-37613,0,0,31462,0,0,,31462,31462
28,07-12-18,88,21:45,22:00,46.72,,0,46.72,46.72,1,-155771,117014,272785,-38757,0,0,12597,0,0,,12597,12597
28,07-12-18,89,22:00,22:15,,,0,43.81,43.81,0,-111973,97413,209386,-14560,0,0,2637,0,0,,2637,2637
28,07-12-18,90,22:15,22:30,,,0,43.81,43.81,0,-132884,54644,187528,-78240,0,0,0,0,0,,0,0
28,07-12-18,91,22:30,22:45,146.25,,0,146.25,146.25,1,-121519,62515,184034,-59004,0,0,19890,0,0,,19890,19890
28,07-12-18,92,22:45,23:00,50.82,,0,50.82,50.82,1,-114639,76286,190925,-38353,0,0,30790,0,0,,30790,30790
28,07-12-18,93,23:00,23:15,50.82,,0,50.82,50.82,1,-103246,81612,184858,-21634,0,0,12731,0,0,,12731,12731
28,07-12-18,94,23:15,23:30,66.87,42.75,0,66.87,42.75,2,-80757,65354,146111,-15403,0,-23,16772,0,0,,16795,16749
28,07-12-18,95,23:30,23:45,66.87,41.12,0,41.12,41.12,-1,-56594,78402,134996,21808,0,-423,677,0,0,,1100,254
28,07-12-18,96,23:45,0:00,,16.87,0,16.87,16.87,-1,-42574,117821,160395,75247,0,-15478,0,0,0,,15478,-15478
28,07/13/2018,1,0:00,0:15,139.15,11.95,0,139.15,139.15,1,-85988,40288,126276,-45700,0,-18649,5507,0,0,,24156,-13142
28,07/13/2018,2,0:15,0:30,139.15,,0,139.15,139.15,1,-103086,11085,114171,-92001,0,0,53714,0,0,,53714,53714
28,07/13/2018,3,0:30,0:45,116.87,,0,116.87,116.87,1,-127407,28488,155895,-98919,0,0,47796,0,0,,47796,47796
28,07/13/2018,4,0:45,1:00,43.11,,0,43.11,43.11,1,-111737,47246,158983,-64491,0,0,15501,0,0,,15501,15501
28,07/13/2018,5,1:00,1:15,62.45,,0,62.45,62.45,1,-106229,74966,181195,-31263,0,0,4146,0,0,,4146,4146
28,07/13/2018,6,1:15,1:30,66.87,,0,66.87,66.87,1,-84593,70081,154674,-14512,0,0,20559,0,0,,20559,20559
28,07/13/2018,7,1:30,1:45,139.15,,0,139.15,139.15,1,-210721,65009,275730,-145712,0,0,54685,0,0,,54685,54685
28,07/13/2018,8,1:45,2:00,343.91,,0,343.91,343.91,1,-164538,58730,223268,-105808,0,0,98256,8750,0,,107006,107006
28,07/13/2018,9,2:00,2:15,46.72,32.53,0,46.72,32.53,2,-70602,64831,135433,-5771,0,-1546,15066,0,0,,16612,13520
28,07/13/2018,10,2:15,2:30,67.71,,0,67.71,67.71,1,-121170,60239,181409,-60931,0,0,33235,0,0,,33235,33235
28,07/13/2018,11,2:30,2:45,51.59,,0,51.59,51.59,1,-125073,64272,189345,-60801,0,0,46664,0,0,,46664,46664
28,07/13/2018,12,2:45,3:00,50.82,,0,50.82,50.82,1,-123813,62299,186112,-61514,0,0,29790,0,0,,29790,29790
28,07/13/2018,13,3:00,3:15,57.47,,0,57.47,57.47,1,-87446,47613,135059,-39833,0,0,4663,0,0,,4663,4663
28,07/13/2018,14,3:15,3:30,66.87,,0,66.87,66.87,1,-84968,35654,120622,-49314,0,0,19599,0,0,,19599,19599
28,07/13/2018,15,3:30,3:45,42.72,,0,42.72,42.72,1,-87534,36842,124376,-50692,0,0,2059,0,0,,2059,2059
28,07/13/2018,16,3:45,4:00,42.72,,0,42.72,42.72,1,-79594,37186,116780,-42408,0,0,308,0,0,,308,308
28,07/13/2018,17,4:00,4:15,42.72,,0,42.72,42.72,1,-86990,33549,120539,-53441,0,0,166,0,0,,166,166
28,07/13/2018,18,4:15,4:30,42.72,,0,42.72,42.72,1,-86844,36308,123152,-50536,0,0,97,0,0,,97,97
28,07/13/2018,19,4:30,4:45,43.79,,0,43.79,43.79,1,-95746,33179,128925,-62567,0,0,990,0,0,,990,990
28,07/13/2018,20,4:45,5:00,51.32,,0,51.32,51.32,1,-66169,21989,88158,-44180,0,0,6084,0,0,,6084,6084
28,07/13/2018,21,5:00,5:15,58.93,,0,58.93,58.93,1,-95025,27018,122043,-68007,0,0,18805,0,0,,18805,18805
28,07/13/2018,22,5:15,5:30,50.82,,0,50.82,50.82,1,-76429,29858,106287,-46571,0,0,24725,0,0,,24725,24725
28,07/13/2018,23,5:30,5:45,44.17,,0,44.17,44.17,1,-74013,33516,107529,-40497,0,0,12445,0,0,,12445,12445
28,07/13/2018,24,5:45,6:00,46.72,,0,46.72,46.72,1,-44900,23601,68501,-21299,0,0,3683,0,0,,3683,3683
28,07/13/2018,25,6:00,6:15,43.11,,0,43.11,43.11,1,-91063,62453,153516,-28610,0,0,592,0,0,,592,592
28,07/13/2018,26,6:15,6:30,,34.28,0,34.28,34.28,-1,-23220,48137,71357,24917,0,-6827,0,0,0,,6827,-6827
28,07/13/2018,27,6:30,6:45,,37.74,0,37.74,37.74,-1,-35373,47624,82997,12251,0,-19139,0,0,0,,19139,-19139
28,07/13/2018,28,6:45,7:00,42.89,37.74,0,42.89,42.89,1,-73079,55495,128574,-17584,0,-2784,232,0,0,,3016,-2552
28,07/13/2018,29,7:00,7:15,,,0,43.87,43.87,0,-81918,58438,140356,-23480,0,0,0,0,0,,0,0
28,07/13/2018,30,7:15,7:30,,,0,43.83,43.83,0,-49196,39411,88607,-9785,0,0,0,0,0,,0,0
28,07/13/2018,31,7:30,7:45,66.42,,0,66.42,66.42,1,-55893,30766,86659,-25127,0,0,4027,0,0,,4027,4027
28,07/13/2018,32,7:45,8:00,105.02,,0,105.02,105.02,1,-78129,33631,111760,-44498,0,0,39976,0,0,,39976,39976
28,07/13/2018,33,8:00,8:15,48.24,,0,48.24,48.24,1,-107248,64271,171519,-42977,0,0,21959,0,0,,21959,21959
28,07/13/2018,34,8:15,8:30,,,0,43.35,43.35,0,-61515,39710,101225,-21805,0,0,500,0,0,,500,500
28,07/13/2018,35,8:30,8:45,66.42,,0,66.42,66.42,1,-82652,20683,103335,-61969,0,0,2238,0,0,,2238,2238
28,07/13/2018,36,8:45,9:00,147.02,,0,147.02,147.02,1,-89136,18389,107525,-70747,0,0,44862,0,0,,44862,44862
28,07/13/2018,37,9:00,9:15,50.38,,0,50.38,50.38,1,-57907,22014,79921,-35893,0,0,32044,0,0,,32044,32044
28,07/13/2018,38,9:15,9:30,50.38,,0,50.38,50.38,1,-60419,17900,78319,-42519,0,0,32371,0,0,,32371,32371
28,07/13/2018,39,9:30,9:45,50.38,,0,50.38,50.38,1,-55646,19649,75295,-35997,0,0,23632,0,0,,23632,23632
28,07/13/2018,40,9:45,10:00,,,0,43.33,43.33,0,-53227,18766,71993,-34461,0,0,923,0,0,,923,923
28,07/13/2018,41,10:00,10:15,50.38,,0,50.38,50.38,1,-63508,39895,103403,-23613,0,0,7757,0,0,,7757,7757
28,07/13/2018,42,10:15,10:30,43.17,,0,43.17,43.17,1,-68203,52006,120209,-16197,0,0,4847,0,0,,4847,4847
28,07/13/2018,43,10:30,10:45,46.19,,0,46.19,46.19,1,-62451,55250,117701,-7201,0,0,6949,0,0,,6949,6949
28,07/13/2018,44,10:45,11:00,42.28,,0,42.28,42.28,1,-54174,61208,115382,7034,0,0,472,0,0,,472,472
28,07/13/2018,45,11:00,11:15,50.38,,0,50.38,50.38,1,-80417,40555,120972,-39862,0,0,11634,0,0,,11634,11634
28,07/13/2018,46,11:15,11:30,52.89,,0,52.89,52.89,1,-75413,46369,121782,-29044,0,0,28216,0,0,,28216,28216
28,07/13/2018,47,11:30,11:45,46.28,,0,46.28,46.28,1,-69690,49124,118814,-20566,0,0,21823,0,0,,21823,21823
28,07/13/2018,48,11:45,12:00,44.09,,0,44.09,44.09,1,-63977,57202,121179,-6775,0,0,11267,0,0,,11267,11267
28,07/13/2018,49,12:00,12:15,50.38,,0,50.38,50.38,1,-71556,25892,97448,-45664,0,0,15428,0,0,,15428,15428
28,07/13/2018,50,12:15,12:30,44.59,,0,44.59,44.59,1,-47815,26444,74259,-21371,0,0,14242,0,0,,14242,14242
28,07/13/2018,51,12:30,12:45,44.59,41.48,0,41.48,41.48,-1,-34034,39490,73524,5456,0,-131,488,0,0,,619,357
28,07/13/2018,52,12:45,13:00,,,0,43.2,43.2,0,-32230,33433,65663,1203,0,0,0,0,0,,0,0
28,07/13/2018,53,13:00,13:15,,,0,43.16,43.16,0,-32798,58043,90841,25245,0,0,0,0,0,,0,0
28,07/13/2018,54,13:15,13:30,42.28,,0,42.28,42.28,1,-47114,50706,97820,3592,0,0,2,0,0,,2,2
28,07/13/2018,55,13:30,13:45,42.28,,0,42.28,42.28,1,-44274,56443,100717,12169,0,0,819,0,0,,819,819
28,07/13/2018,56,13:45,14:00,,,0,43.16,43.16,0,-40381,62853,103234,22472,0,0,0,0,0,,0,0
28,07/13/2018,57,14:00,14:15,42.28,,0,42.28,42.28,1,-37848,45478,83326,7630,0,0,55,0,0,,55,55
28,07/13/2018,58,14:15,14:30,42.89,,0,42.89,42.89,1,-41767,38666,80433,-3101,0,0,2277,0,0,,2277,2277
28,07/13/2018,59,14:30,14:45,42.28,,0,42.28,42.28,1,-44351,46466,90817,2115,0,0,805,0,0,,805,805
28,07/13/2018,60,14:45,15:00,42.28,,0,42.28,42.28,1,-43835,51359,95194,7524,0,0,153,0,0,,153,153
28,07/13/2018,61,15:00,15:15,,,0,43.16,43.16,0,-47070,58868,105938,11798,0,0,0,0,0,,0,0
28,07/13/2018,62,15:15,15:30,,,0,43.16,43.16,0,-50077,66880,116957,16803,0,0,0,0,0,,0,0
28,07/13/2018,63,15:30,15:45,43.76,,0,43.76,43.76,1,-44901,38446,83347,-6455,0,0,2846,0,0,,2846,2846
28,07/13/2018,64,15:45,16:00,43.34,,0,43.34,43.34,1,-39620,39959,79579,339,0,0,1673,0,0,,1673,1673
28,07/13/2018,65,16:00,16:15,46.28,,0,46.28,46.28,1,-59466,46247,105713,-13219,0,0,4701,0,0,,4701,4701
28,07/13/2018,66,16:15,16:30,46.28,,0,46.28,46.28,1,-53560,40599,94159,-12961,0,0,12013,0,0,,12013,12013
28,07/13/2018,67,16:30,16:45,42.28,,0,42.28,42.28,1,-35889,36714,72603,825,0,0,2601,0,0,,2601,2601
28,07/13/2018,68,16:45,17:00,43.34,,0,43.34,43.34,1,-44453,31876,76329,-12577,0,0,3719,0,0,,3719,3719
28,07/13/2018,69,17:00,17:15,50.38,,0,50.38,50.38,1,-59949,43284,103233,-16665,0,0,8890,0,0,,8890,8890
28,07/13/2018,70,17:15,17:30,50.38,,0,50.38,50.38,1,-66624,33025,99649,-33599,0,0,27075,0,0,,27075,27075
28,07/13/2018,71,17:30,17:45,50.38,,0,50.38,50.38,1,-71018,25015,96033,-46003,0,0,31220,0,0,,31220,31220
28,07/13/2018,72,17:45,18:00,51.82,,0,51.82,51.82,1,-83220,21703,104923,-61517,0,0,41875,0,0,,41875,41875
28,07/13/2018,73,18:00,18:15,50.38,,0,50.38,50.38,1,-65899,17001,82900,-48898,0,0,34783,0,0,,34783,34783
28,07/13/2018,74,18:15,18:30,50.38,,0,50.38,50.38,1,-57981,15221,73202,-42760,0,0,4512,0,0,,4512,4512
28,07/13/2018,75,18:30,18:45,47.64,,0,47.64,47.64,1,-55510,12732,68242,-42778,0,0,14183,0,0,,14183,14183
28,07/13/2018,76,18:45,19:00,44.03,,0,44.03,44.03,1,-53886,12904,66790,-40982,0,0,13800,0,0,,13800,13800
28,07/13/2018,77,19:00,19:15,,,0,36.99,36.99,0,-41782,16224,58006,-25558,0,0,3142,0,0,,3142,3142
28,07/13/2018,78,19:15,19:30,,,0,37,37,0,-70634,15725,86359,-54909,0,0,0,0,0,,0,0
28,07/13/2018,79,19:30,19:45,43.44,,0,43.44,43.44,1,-77090,13761,90851,-63329,0,0,688,0,0,,688,688
28,07/13/2018,80,19:45,20:00,44.41,,0,44.41,44.41,1,-78588,11695,90283,-66893,0,0,1714,0,0,,1714,1714
28,07/13/2018,81,20:00,20:15,46.36,,0,46.36,46.36,1,-34991,24431,59422,-10560,0,0,3651,0,0,,3651,3651
28,07/13/2018,82,20:15,20:30,46.28,,0,46.28,46.28,1,-35640,27635,63275,-8005,0,0,6328,0,0,,6328,6328
28,07/13/2018,83,20:30,20:45,46.28,42.7,0,42.7,42.7,-1,-21411,21426,42837,15,0,-73,245,0,0,,318,172
28,07/13/2018,84,20:45,21:00,,41.3,0,41.3,41.3,-1,-34309,37625,71934,3316,0,-1089,0,0,0,,1089,-1089
28,07/13/2018,85,21:00,21:15,42.28,41.3,0,42.28,42.28,1,-43769,10249,54018,-33520,0,-6,407,0,0,,413,401
28,07/13/2018,86,21:15,21:30,42.28,,0,42.28,42.28,1,-28255,21033,49288,-7222,0,0,848,0,0,,848,848
28,07/13/2018,87,21:30,21:45,42.28,,0,42.28,42.28,1,-37282,35797,73079,-1485,0,0,538,0,0,,538,538
28,07/13/2018,88,21:45,22:00,42.28,,0,42.28,42.28,1,-23681,44028,67709,20347,0,0,765,0,0,,765,765
28,07/13/2018,89,22:00,22:15,42.28,,0,42.28,42.28,1,-12882,26340,39222,13458,0,0,31,0,0,,31,31
28,07/13/2018,90,22:15,22:30,46.28,,0,46.28,46.28,1,-35096,13666,48762,-21430,0,0,3822,0,0,,3822,3822
28,07/13/2018,91,22:30,22:45,,,0,32.78,32.78,0,-31105,22619,53724,-8486,0,0,674,0,0,,674,674
28,07/13/2018,92,22:45,23:00,,41.03,0,41.03,41.03,-1,-37790,37307,75097,-483,0,-1875,0,0,0,,1875,-1875
28,07/13/2018,93,23:00,23:15,,,0,32.76,32.76,0,-59260,17911,77171,-41349,0,-712,0,0,0,,712,-712
28,07/13/2018,94,23:15,23:30,,45.35,0,45.35,45.35,-1,-33939,24280,58219,-9659,0,-18,0,0,0,,18,-18
28,07/13/2018,95,23:30,23:45,,42.12,0,42.12,42.12,-1,-25621,28095,53716,2474,0,-2205,0,0,0,,2205,-2205
28,07/13/2018,96,23:45,0:00,,41.3,0,41.3,41.3,-1,-41942,48912,90854,6970,0,-2207,0,0,0,,2207,-2207
29,07/14/2018,1,0:00,0:15,50.38,38.28,0,50.38,50.38,1,-49513,33136,82649,-16377,0,-639,2279,0,0,,2918,1640
29,07/14/2018,2,0:15,0:30,60.89,,0,60.89,60.89,1,-31420,31843,63263,423,0,0,9845,0,0,,9845,9845
29,07/14/2018,3,0:30,0:45,43.33,,0,43.33,43.33,1,-34354,33721,68075,-633,0,0,1023,0,0,,1023,1023
29,07/14/2018,4,0:45,1:00,43.42,,0,43.42,43.42,1,-65312,50436,115748,-14876,0,0,1998,0,0,,1998,1998
29,07/14/2018,5,1:00,1:15,50.38,,0,50.38,50.38,1,-59860,51382,111242,-8478,0,0,7403,0,0,,7403,7403
29,07/14/2018,6,1:15,1:30,54.12,42.57,0,54.12,42.57,2,-23753,25484,49237,1731,0,-56,15864,0,0,,15920,15808
29,07/14/2018,7,1:30,1:45,42.28,42.6,0,43.41,42.6,2,-24196,13814,38010,-10382,0,-329,508,0,0,,837,179
29,07/14/2018,8,1:45,2:00,46.28,,0,46.28,46.28,1,-35321,24892,60213,-10429,0,0,4900,0,0,,4900,4900
29,07/14/2018,9,2:00,2:15,57.36,,0,57.36,57.36,1,-51248,17621,68869,-33627,0,0,14923,0,0,,14923,14923
29,07/14/2018,10,2:15,2:30,50.38,,0,50.38,50.38,1,-50580,18503,69083,-32077,0,0,29541,0,0,,29541,29541
29,07/14/2018,11,2:30,2:45,44.02,,0,44.02,44.02,1,-23362,14210,37572,-9152,0,0,12246,0,0,,12246,12246
29,07/14/2018,12,2:45,3:00,,,0,43.41,43.41,0,-22056,17242,39298,-4814,0,0,331,0,0,,331,331
29,07/14/2018,13,3:00,3:15,50.38,,0,50.38,50.38,1,-52784,24227,77011,-28557,0,0,6007,0,0,,6007,6007
29,07/14/2018,14,3:15,3:30,43.98,,0,43.98,43.98,1,-40975,13840,54815,-27135,0,0,11095,0,0,,11095,11095
29,07/14/2018,15,3:30,3:45,43.02,,0,43.02,43.02,1,-33604,20201,53805,-13403,0,0,3684,0,0,,3684,3684
29,07/14/2018,16,3:45,4:00,43.03,,0,43.03,43.03,1,-34945,21453,56398,-13492,0,0,5790,0,0,,5790,5790
29,07/14/2018,17,4:00,4:15,50.23,,0,50.23,50.23,1,-32840,20256,53096,-12584,0,0,6390,0,0,,6390,6390
29,07/14/2018,18,4:15,4:30,50.38,,0,50.38,50.38,1,-41944,19014,60958,-22930,0,0,19115,0,0,,19115,19115
29,07/14/2018,19,4:30,4:45,44.02,,0,44.02,44.02,1,-29202,19762,48964,-9440,0,0,9780,0,0,,9780,9780
29,07/14/2018,20,4:45,5:00,46.28,,0,46.28,46.28,1,-35304,19165,54469,-16139,0,0,13050,0,0,,13050,13050
29,07/14/2018,21,5:00,5:15,60.04,,0,60.04,60.04,1,-64302,18211,82513,-46091,0,0,23898,0,0,,23898,23898
29,07/14/2018,22,5:15,5:30,50.26,,0,50.26,50.26,1,-50002,23517,73519,-26485,0,0,31147,0,0,,31147,31147
29,07/14/2018,23,5:30,5:45,42.28,40.15,0,43.43,40.15,2,-24115,24563,48678,448,0,-409,10704,0,0,,11113,10295
29,07/14/2018,24,5:45,6:00,42.28,,0,42.28,42.28,1,-28345,30608,58953,2263,0,0,1157,0,0,,1157,1157
29,07/14/2018,25,6:00,6:15,41.78,,0,41.78,41.78,1,-26120,42239,68359,16119,0,0,412,0,0,,412,412
29,07/14/2018,26,6:15,6:30,43.05,,0,43.05,43.05,1,-31127,32152,63279,1025,0,0,1866,0,0,,1866,1866
29,07/14/2018,27,6:30,6:45,49.88,,0,49.88,49.88,1,-37357,23820,61177,-13537,0,0,5424,0,0,,5424,5424
29,07/14/2018,28,6:45,7:00,49.63,,0,49.63,49.63,1,-51898,40066,91964,-11832,0,0,18506,0,0,,18506,18506
29,07/14/2018,29,7:00,7:15,49.88,,0,49.88,49.88,1,-65632,41218,106850,-24414,0,0,10389,0,0,,10389,10389
29,07/14/2018,30,7:15,7:30,45.12,,0,45.12,45.12,1,-41209,38981,80190,-2228,0,0,9305,0,0,,9305,9305
29,07/14/2018,31,7:30,7:45,43.87,,0,43.87,43.87,1,-28455,28353,56808,-102,0,0,1096,0,0,,1096,1096
29,07/14/2018,32,7:45,8:00,,,0,42.64,42.64,0,-23912,43687,67599,19775,0,0,232,0,0,,232,232
29,07/14/2018,33,8:00,8:15,43.2,,0,43.2,43.2,1,-54549,41287,95836,-13262,0,0,893,0,0,,893,893
29,07/14/2018,34,8:15,8:30,41.78,,0,41.78,41.78,1,-29745,32891,62636,3146,0,0,331,0,0,,331,331
29,07/14/2018,35,8:30,8:45,44.89,,0,44.89,44.89,1,-44396,24949,69345,-19447,0,0,4105,0,0,,4105,4105
29,07/14/2018,36,8:45,9:00,49.88,,0,49.88,49.88,1,-58441,29050,87491,-29391,0,0,14942,0,0,,14942,14942
29,07/14/2018,37,9:00,9:15,42.71,42.6,0,43.03,42.6,2,-23845,38238,62083,14393,0,-15,4305,0,0,,4320,4290
29,07/14/2018,38,9:15,9:30,46.71,,0,46.71,46.71,1,-41691,26788,68479,-14903,0,0,1699,0,0,,1699,1699
29,07/14/2018,39,9:30,9:45,50.84,,0,50.84,50.84,1,-55990,27904,83894,-28086,0,0,17639,0,0,,17639,17639
29,07/14/2018,40,9:45,10:00,43.42,,0,43.42,43.42,1,-49942,31143,81085,-18799,0,0,14038,0,0,,14038,14038
29,07/14/2018,41,10:00,10:15,43.06,,0,43.06,43.06,1,-54846,41734,96580,-13112,0,0,12020,0,0,,12020,12020
29,07/14/2018,42,10:15,10:30,43.05,,0,43.05,43.05,1,-47876,41317,89193,-6559,0,0,5423,0,0,,5423,5423
29,07/14/2018,43,10:30,10:45,42.71,,0,42.71,42.71,1,-49120,51446,100566,2326,0,0,2338,0,0,,2338,2338
29,07/14/2018,44,10:45,11:00,42.71,,0,42.71,42.71,1,-43766,62249,106015,18483,0,0,333,0,0,,333,333
29,07/14/2018,45,11:00,11:15,65.91,,0,65.91,65.91,1,-83505,33874,117379,-49631,0,0,19543,0,0,,19543,19543
29,07/14/2018,46,11:15,11:30,48.12,,0,48.12,48.12,1,-62718,39368,102086,-23350,0,0,27994,0,0,,27994,27994
29,07/14/2018,47,11:30,11:45,44.03,,0,44.03,44.03,1,-52904,44284,97188,-8620,0,0,13106,0,0,,13106,13106
29,07/14/2018,48,11:45,12:00,43.07,,0,43.07,43.07,1,-43250,50509,93759,7259,0,0,3903,0,0,,3903,3903
29,07/14/2018,49,12:00,12:15,65.91,,0,65.91,65.91,1,-84724,35223,119947,-49501,0,0,24404,0,0,,24404,24404
29,07/14/2018,50,12:15,12:30,50.84,,0,50.84,50.84,1,-65786,47386,113172,-18400,0,0,30706,0,0,,30706,30706
29,07/14/2018,51,12:30,12:45,50.84,39.78,0,39.78,39.78,-1,-31716,47681,79397,15965,0,-998,7083,0,0,,8081,6085
29,07/14/2018,52,12:45,13:00,,40.74,0,40.74,40.74,-1,-43556,51392,94948,7836,0,-455,0,0,0,,455,-455
29,07/14/2018,53,13:00,13:15,,42.09,0,42.09,42.09,-1,-32072,67324,99396,35252,0,-13,0,0,0,,13,-13
29,07/14/2018,54,13:15,13:30,,40.23,0,40.23,40.23,-1,-41248,66979,108227,25731,0,-1262,0,0,0,,1262,-1262
29,07/14/2018,55,13:30,13:45,,39.18,0,39.18,39.18,-1,-39240,72070,111310,32830,0,-3340,0,0,0,,3340,-3340
29,07/14/2018,56,13:45,14:00,,38.71,0,38.71,38.71,-1,-40531,77415,117946,36884,0,-16018,0,0,0,,16018,-16018
29,07/14/2018,57,14:00,14:15,,38.71,0,38.71,38.71,-1,-53398,60753,114151,7355,0,-12593,0,0,0,,12593,-12593
29,07/14/2018,58,14:15,14:30,42.71,38.71,0,42.71,42.71,1,-48656,51702,100358,3046,0,-143,2,0,0,,145,-141
29,07/14/2018,59,14:30,14:45,,,0,42.91,42.91,0,-42870,54171,97041,11301,0,0,0,0,0,,0,0
29,07/14/2018,60,14:45,15:00,,42.03,0,42.03,42.03,-1,-47068,55142,102210,8074,0,-151,0,0,0,,151,-151
29,07/14/2018,61,15:00,15:15,,41.92,0,41.92,41.92,-1,-37152,68206,105358,31054,0,-1433,0,0,0,,1433,-1433
29,07/14/2018,62,15:15,15:30,,43.08,0,43.08,43.08,-1,-37351,64802,102153,27451,0,-219,0,0,0,,219,-219
29,07/14/2018,63,15:30,15:45,,,0,42.9,42.9,0,-45815,66719,112534,20904,0,0,0,0,0,,0,0
29,07/14/2018,64,15:45,16:00,,34.71,0,34.71,34.71,-1,-34019,61147,95166,27128,0,-2821,0,0,0,,2821,-2821
29,07/14/2018,65,16:00,16:15,,41.98,0,41.98,41.98,-1,-42594,76888,119482,34294,0,-3042,0,0,0,,3042,-3042
29,07/14/2018,66,16:15,16:30,,,0,42.9,42.9,0,-49171,66056,115227,16885,0,0,0,0,0,,0,0
29,07/14/2018,67,16:30,16:45,43.03,,0,43.03,43.03,1,-70261,52974,123235,-17287,0,0,560,0,0,,560,560
29,07/14/2018,68,16:45,17:00,46.71,,0,46.71,46.71,1,-69395,36648,106043,-32747,0,0,3186,0,0,,3186,3186
29,07/14/2018,69,17:00,17:15,46.71,36.67,0,36.67,36.67,-1,-33082,79368,112450,46286,0,-4458,413,0,0,,4871,-4045
29,07/14/2018,70,17:15,17:30,,42.5,0,42.5,42.5,-1,-45833,66877,112710,21044,0,-1136,0,0,0,,1136,-1136
29,07/14/2018,71,17:30,17:45,44.89,42.47,0,44.89,44.89,1,-60874,51950,112824,-8924,0,-268,506,0,0,,774,238
29,07/14/2018,72,17:45,18:00,46.71,,0,46.71,46.71,1,-70546,40567,111113,-29979,0,0,10539,0,0,,10539,10539
29,07/14/2018,73,18:00,18:15,44.47,,0,44.47,44.47,1,-55963,59929,115892,3966,0,0,10924,0,0,,10924,10924
29,07/14/2018,74,18:15,18:30,44.47,42.61,0,42.61,42.61,-1,-54959,60504,115463,5545,0,-810,453,0,0,,1263,-357
29,07/14/2018,75,18:30,18:45,47.4,,0,47.4,47.4,1,-65526,52308,117834,-13218,0,0,1457,0,0,,1457,1457
29,07/14/2018,76,18:45,19:00,60.37,,0,60.37,60.37,1,-73731,44989,118720,-28742,0,0,21165,0,0,,21165,21165
29,07/14/2018,77,19:00,19:15,60.37,39.71,0,39.71,39.71,-1,-25665,66396,92061,40731,0,-872,5290,0,0,,6162,4418
29,07/14/2018,78,19:15,19:30,42.71,,0,42.71,42.71,1,-43256,46570,89826,3314,0,0,18,0,0,,18,18
29,07/14/2018,79,19:30,19:45,50.84,,0,50.84,50.84,1,-57364,40612,97976,-16752,0,0,3429,0,0,,3429,3429
29,07/14/2018,80,19:45,20:00,50.84,,0,50.84,50.84,1,-72364,35350,107714,-37014,0,0,17008,0,0,,17008,17008
29,07/14/2018,81,20:00,20:15,46.71,,0,46.71,46.71,1,-40154,30140,70294,-10014,0,0,12636,0,0,,12636,12636
29,07/14/2018,82,20:15,20:30,43.84,,0,43.84,43.84,1,-46817,26535,73352,-20282,0,0,3405,0,0,,3405,3405
29,07/14/2018,83,20:30,20:45,42.71,,0,42.71,42.71,1,-30940,29041,59981,-1899,0,0,1409,0,0,,1409,1409
29,07/14/2018,84,20:45,21:00,42.71,,0,42.71,42.71,1,-29198,30678,59876,1480,0,0,520,0,0,,520,520
29,07/14/2018,85,21:00,21:15,42.71,,0,42.71,42.71,1,-37006,37976,74982,970,0,0,573,0,0,,573,573
29,07/14/2018,86,21:15,21:30,,38.72,0,38.72,38.72,-1,-33352,50924,84276,17572,0,-1480,0,0,0,,1480,-1480
29,07/14/2018,87,21:30,21:45,,42.26,0,42.26,42.26,-1,-30232,50126,80358,19894,0,-812,0,0,0,,812,-812
29,07/14/2018,88,21:45,22:00,,38.71,0,38.71,38.71,-1,-29630,47704,77334,18074,0,-3824,0,0,0,,3824,-3824
29,07/14/2018,89,22:00,22:15,,42.26,0,42.26,42.26,-1,-43815,44566,88381,751,0,-1175,0,0,0,,1175,-1175
29,07/14/2018,90,22:15,22:30,44.04,,0,44.04,44.04,1,-59741,26851,86592,-32890,0,0,1145,0,0,,1145,1145
29,07/14/2018,91,22:30,22:45,44.03,,0,44.03,44.03,1,-56345,32100,88445,-24245,0,0,4297,0,0,,4297,4297
29,07/14/2018,92,22:45,23:00,42.71,,0,42.71,42.71,1,-43214,36249,79463,-6965,0,0,1704,0,0,,1704,1704
29,07/14/2018,93,23:00,23:15,56.92,,0,56.92,56.92,1,-73159,17067,90226,-56092,0,0,15426,0,0,,15426,15426
29,07/14/2018,94,23:15,23:30,43.93,,0,43.93,43.93,1,-51482,22934,74416,-28548,0,0,7967,0,0,,7967,7967
29,07/14/2018,95,23:30,23:45,,38.71,0,38.71,38.71,-1,-33787,38882,72669,5095,0,-1903,0,0,0,,1903,-1903
29,07/14/2018,96,23:45,0:00,,34.71,0,34.71,34.71,-1,-34874,76850,111724,41976,0,-22488,0,0,0,,22488,-22488
29,07/15/2018,1,0:00,0:15,46.71,30.78,0,46.71,30.78,2,-63009,56560,119569,-6449,0,-16099,339,0,0,,16438,-15760
29,07/15/2018,2,0:15,0:30,46.71,42.6,0,42.6,42.6,-1,-57318,45237,102555,-12081,0,-23,7,0,0,,30,-16
29,07/15/2018,3,0:30,0:45,44.62,42.67,0,44.62,42.67,2,-53157,26950,80107,-26207,0,-342,1197,0,0,,1539,855
29,07/15/2018,4,0:45,1:00,42.71,,0,42.71,42.71,1,-117530,41550,159080,-75980,0,0,606,0,0,,606,606
29,07/15/2018,5,1:00,1:15,73.02,,0,73.02,73.02,1,-52460,41142,93602,-11318,0,0,4553,0,0,,4553,4553
29,07/15/2018,6,1:15,1:30,118.36,,0,118.36,118.36,1,-46629,17711,64340,-28918,0,0,38971,0,0,,38971,38971
29,07/15/2018,7,1:30,1:45,118.36,41.47,0,41.47,41.47,-1,-26141,36226,62367,10085,0,-620,3748,0,0,,4368,3128
29,07/15/2018,8,1:45,2:00,,38.72,0,38.72,38.72,-1,-35387,44325,79712,8938,0,-2672,0,0,0,,2672,-2672
29,07/15/2018,9,2:00,2:15,,38.71,0,38.71,38.71,-1,-40273,58321,98594,18048,0,-2536,0,0,0,,2536,-2536
29,07/15/2018,10,2:15,2:30,,,0,42.57,42.57,0,-30194,31196,61390,1002,0,0,0,0,0,,0,0
29,07/15/2018,11,2:30,2:45,44.92,,0,44.92,44.92,1,-46432,27964,74396,-18468,0,0,2158,0,0,,2158,2158
29,07/15/2018,12,2:45,3:00,42.71,,0,42.71,42.71,1,-41969,32918,74887,-9051,0,0,1321,0,0,,1321,1321
29,07/15/2018,13,3:00,3:15,,,0,42.45,42.45,0,-22855,36640,59495,13785,0,0,0,0,0,,0,0
29,07/15/2018,14,3:15,3:30,,,0,42.45,42.45,0,-18101,35193,53294,17092,0,0,0,0,0,,0,0
29,07/15/2018,15,3:30,3:45,,35.3,0,35.3,35.3,-1,-17377,42070,59447,24693,0,-1722,0,0,0,,1722,-1722
29,07/15/2018,16,3:45,4:00,,34.71,0,34.71,34.71,-1,-21322,44395,65717,23073,0,-17522,0,0,0,,17522,-17522
29,07/15/2018,17,4:00,4:15,50.91,38.71,0,50.91,50.91,1,-30792,12362,43154,-18430,0,-8873,3946,0,0,,12819,-4927
29,07/15/2018,18,4:15,4:30,50.91,38.71,0,50.91,50.91,1,-36017,13128,49145,-22889,0,-4,10680,0,0,,10684,10676
29,07/15/2018,19,4:30,4:45,43.04,,0,43.04,43.04,1,-29041,15060,44101,-13981,0,0,1800,0,0,,1800,1800
29,07/15/2018,20,4:45,5:00,43.06,,0,43.06,43.06,1,-27587,14422,42009,-13165,0,0,4585,0,0,,4585,4585
29,07/15/2018,21,5:00,5:15,58.54,,0,58.54,58.54,1,-55733,4913,60646,-50820,0,0,16906,0,0,,16906,16906
29,07/15/2018,22,5:15,5:30,44.33,,0,44.33,44.33,1,-32053,14357,46410,-17696,0,0,14738,0,0,,14738,14738
29,07/15/2018,23,5:30,5:45,45.61,,0,45.61,45.61,1,-33515,24097,57612,-9418,0,0,13605,0,0,,13605,13605
29,07/15/2018,24,5:45,6:00,45.61,42.27,0,42.27,42.27,-1,-22324,33274,55598,10950,0,-602,2098,0,0,,2700,1496
29,07/15/2018,25,6:00,6:15,,42.17,0,42.17,42.17,-1,-28974,33765,62739,4791,0,-129,0,0,0,,129,-129
29,07/15/2018,26,6:15,6:30,,,0,42.42,42.42,0,-30330,35740,66070,5410,0,0,0,0,0,,0,0
29,07/15/2018,27,6:30,6:45,,,0,42.4,42.4,0,-32368,32737,65105,369,0,0,0,0,0,,0,0
29,07/15/2018,28,6:45,7:00,,,0,42.4,42.4,0,-38830,43950,82780,5120,0,0,0,0,0,,0,0
29,07/15/2018,29,7:00,7:15,50,,0,50,50,1,-57302,40740,98042,-16562,0,0,7312,0,0,,7312,7312
29,07/15/2018,30,7:15,7:30,,,0,41.64,41.64,0,-37438,48349,85787,10911,0,0,1294,0,0,,1294,1294
29,07/15/2018,31,7:30,7:45,44.87,,0,44.87,44.87,1,-57276,40354,97630,-16922,0,0,4069,0,0,,4069,4069
29,07/15/2018,32,7:45,8:00,44.96,,0,44.96,44.96,1,-71883,52971,124854,-18912,0,0,7653,0,0,,7653,7653
29,07/15/2018,33,8:00,8:15,47.8,,0,47.8,47.8,1,-69096,37516,106612,-31580,0,0,10467,0,0,,10467,10467
29,07/15/2018,34,8:15,8:30,45.15,,0,45.15,45.15,1,-60256,54083,114339,-6173,0,0,11708,0,0,,11708,11708
29,07/15/2018,35,8:30,8:45,45.15,42.16,0,42.16,42.16,-1,-56983,55776,112759,-1207,0,-806,374,0,0,,1180,-432
29,07/15/2018,36,8:45,9:00,45.74,,0,45.74,45.74,1,-73218,58806,132024,-14412,0,0,2191,0,0,,2191,2191
29,07/15/2018,37,9:00,9:15,43.11,,0,43.11,43.11,1,-88239,32591,120830,-55648,0,0,532,0,0,,532,532
29,07/15/2018,38,9:15,9:30,,,0,41.67,41.67,0,-57685,42263,99948,-15422,0,0,0,0,0,,0,0
29,07/15/2018,39,9:30,9:45,,38.7,0,38.7,38.7,-1,-54160,64643,118803,10483,0,-1515,0,0,0,,1515,-1515
29,07/15/2018,40,9:45,10:00,,42.26,0,42.26,42.26,-1,-50386,45211,95597,-5175,0,-1927,0,0,0,,1927,-1927
29,07/15/2018,41,10:00,10:15,,,0,41.62,41.62,0,-72941,25913,98854,-47028,0,-4,0,0,0,,4,-4
29,07/15/2018,42,10:15,10:30,,40.71,0,40.71,40.71,-1,-43963,29668,73631,-14295,0,-361,0,0,0,,361,-361
29,07/15/2018,43,10:30,10:45,,39.65,0,39.65,39.65,-1,-40480,39273,79753,-1207,0,-1664,0,0,0,,1664,-1664
29,07/15/2018,44,10:45,11:00,,38.21,0,38.21,38.21,-1,-37263,47915,85178,10652,0,-1483,0,0,0,,1483,-1483
29,07/15/2018,45,11:00,11:15,,35.76,0,35.76,35.76,-1,-37052,41095,78147,4043,0,-3909,0,0,0,,3909,-3909
29,07/15/2018,46,11:15,11:30,,38.7,0,38.7,38.7,-1,-34328,40112,74440,5784,0,-3712,0,0,0,,3712,-3712
29,07/15/2018,47,11:30,11:45,,42.28,0,42.28,42.28,-1,-42386,38598,80984,-3788,0,-1712,0,0,0,,1712,-1712
29,07/15/2018,48,11:45,12:00,,42.26,0,42.26,42.26,-1,-37803,39076,76879,1273,0,-886,0,0,0,,886,-886
29,07/15/2018,49,12:00,12:15,43.45,,0,43.45,43.45,1,-75917,37703,113620,-38214,0,0,983,0,0,,983,983
29,07/15/2018,50,12:15,12:30,42.7,,0,42.7,42.7,1,-67999,44232,112231,-23767,0,0,598,0,0,,598,598
29,07/15/2018,51,12:30,12:45,43.45,,0,43.45,43.45,1,-74115,48189,122304,-25926,0,0,2040,0,0,,2040,2040
29,07/15/2018,52,12:45,13:00,42.7,,0,42.7,42.7,1,-80865,49101,129966,-31764,0,0,713,0,0,,713,713
29,07/15/2018,53,13:00,13:15,42.7,,0,42.7,42.7,1,-53704,69730,123434,16026,0,0,1404,0,0,,1404,1404
29,07/15/2018,54,13:15,13:30,42.7,38.7,0,38.7,38.7,-1,-43608,63967,107575,20359,0,-1085,318,0,0,,1403,-767
29,07/15/2018,55,13:30,13:45,,38.46,0,38.46,38.46,-1,-48974,67934,116908,18960,0,-3301,0,0,0,,3301,-3301
29,07/15/2018,56,13:45,14:00,,41.59,0,41.59,41.59,-1,-37058,62691,99749,25633,0,-410,0,0,0,,410,-410
29,07/15/2018,57,14:00,14:15,,42.13,0,42.13,42.13,-1,-41498,55248,96746,13750,0,-503,0,0,0,,503,-503
29,07/15/2018,58,14:15,14:30,,,0,41.58,41.58,0,-35327,50287,85614,14960,0,0,0,0,0,,0,0
29,07/15/2018,59,14:30,14:45,,,0,41.58,41.58,0,-33403,51094,84497,17691,0,0,0,0,0,,0,0
29,07/15/2018,60,14:45,15:00,,,0,41.58,41.58,0,-37630,45422,83052,7792,0,0,0,0,0,,0,0
29,07/15/2018,61,15:00,15:15,,,0,41.6,41.6,0,-22874,53001,75875,30127,0,0,0,0,0,,0,0
29,07/15/2018,62,15:15,15:30,,,0,41.6,41.6,0,-26645,50547,77192,23902,0,0,0,0,0,,0,0
29,07/15/2018,63,15:30,15:45,,,0,41.6,41.6,0,-28275,50873,79148,22598,0,0,0,0,0,,0,0
29,07/15/2018,64,15:45,16:00,,,0,41.59,41.59,0,-27219,32139,59358,4920,0,0,0,0,0,,0,0
29,07/15/2018,65,16:00,16:15,,,0,41.65,41.65,0,-19915,67573,87488,47658,0,0,0,0,0,,0,0
29,07/15/2018,66,16:15,16:30,42.7,,0,42.7,42.7,1,-31178,48725,79903,17547,0,0,37,0,0,,37,37
29,07/15/2018,67,16:30,16:45,45.85,,0,45.85,45.85,1,-45710,32637,78347,-13073,0,0,4810,0,0,,4810,4810
29,07/15/2018,68,16:45,17:00,74.09,,0,74.09,74.09,1,-77105,18732,95837,-58373,0,0,27459,0,0,,27459,27459
29,07/15/2018,69,17:00,17:15,46.7,40.18,0,40.18,40.18,-1,-22817,73000,95817,50183,0,-891,15284,0,0,,16175,14393
29,07/15/2018,70,17:15,17:30,,,0,41.14,41.14,0,-36830,49610,86440,12780,0,-285,63,0,0,,348,-222
29,07/15/2018,71,17:30,17:45,46.7,,0,46.7,46.7,1,-58023,41205,99228,-16818,0,0,2412,0,0,,2412,2412
29,07/15/2018,72,17:45,18:00,72.59,,0,72.59,72.59,1,-89961,29086,119047,-60875,0,0,28849,0,0,,28849,28849
29,07/15/2018,73,18:00,18:15,50.9,37.2,0,37.2,37.2,-1,-43627,49267,92894,5640,0,-421,27726,0,0,,28147,27305
29,07/15/2018,74,18:15,18:30,50.9,34.7,0,34.7,34.7,-1,-37852,56881,94733,19029,0,-3001,1738,0,0,,4739,-1263
29,07/15/2018,75,18:30,18:45,,40.34,0,40.34,40.34,-1,-34251,36639,70890,2388,0,-2340,0,0,0,,2340,-2340
29,07/15/2018,76,18:45,19:00,,38.03,0,38.03,38.03,-1,-39030,34615,73645,-4415,0,-2012,0,0,0,,2012,-2012
29,07/15/2018,77,19:00,19:15,,40.64,0,40.64,40.64,-1,-49789,50745,100534,956,0,-1110,0,0,0,,1110,-1110
29,07/15/2018,78,19:15,19:30,,38.7,0,38.7,38.7,-1,-40314,26108,66422,-14206,0,-4902,0,0,0,,4902,-4902
29,07/15/2018,79,19:30,19:45,43.72,38.7,0,43.72,43.72,1,-63143,8750,71893,-54393,0,-160,221,0,0,,381,61
29,07/15/2018,80,19:45,20:00,55.23,,0,55.23,55.23,1,-84924,8516,93440,-76408,0,0,13652,0,0,,13652,13652
29,07/15/2018,81,20:00,20:15,50.9,,0,50.9,50.9,1,-63205,16792,79997,-46413,0,0,17628,0,0,,17628,17628
29,07/15/2018,82,20:15,20:30,50.9,,0,50.9,50.9,1,-79087,15225,94312,-63862,0,0,26737,0,0,,26737,26737
29,07/15/2018,83,20:30,20:45,50.9,,0,50.9,50.9,1,-77610,25194,102804,-52416,0,0,33776,0,0,,33776,33776
29,07/15/2018,84,20:45,21:00,50.9,,0,50.9,50.9,1,-75871,24193,100064,-51678,0,0,23730,0,0,,23730,23730
29,07/15/2018,85,21:00,21:15,115.9,,0,115.9,115.9,1,-90644,13182,103826,-77462,0,0,50202,0,0,,50202,50202
29,07/15/2018,86,21:15,21:30,57.5,,0,57.5,57.5,1,-62209,24159,86368,-38050,0,0,55147,0,0,,55147,55147
29,07/15/2018,87,21:30,21:45,57.5,39.66,0,39.66,39.66,-1,-43596,41718,85314,-1878,0,-738,13229,0,0,,13967,12491
29,07/15/2018,88,21:45,22:00,,,0,41.87,41.87,0,-45782,64522,110304,18740,0,0,0,0,0,,0,0
29,07/15/2018,89,22:00,22:15,45.81,,0,45.81,45.81,1,-55272,38253,93525,-17019,0,0,2299,0,0,,2299,2299
29,07/15/2018,90,22:15,22:30,51.11,,0,51.11,51.11,1,-74024,37964,111988,-36060,0,0,17274,0,0,,17274,17274
29,07/15/2018,91,22:30,22:45,50.9,,0,50.9,50.9,1,-71094,31548,102642,-39546,0,0,32217,0,0,,32217,32217
29,07/15/2018,92,22:45,23:00,50.54,,0,50.54,50.54,1,-63346,32536,95882,-30810,0,0,32832,0,0,,32832,32832
29,07/15/2018,93,23:00,23:15,141.02,,0,141.02,141.02,1,-119257,11708,130965,-107549,0,0,53262,0,0,,53262,53262
29,07/15/2018,94,23:15,23:30,141.02,,0,141.02,141.02,1,-69423,17429,86852,-51994,0,0,74263,0,0,,74263,74263
29,07/15/2018,95,23:30,23:45,141.02,33.46,0,33.46,33.46,-1,-39341,44387,83728,5046,0,-3769,14052,0,0,,17821,10283
29,07/15/2018,96,23:45,0:00,,38.7,0,38.7,38.7,-1,-35713,62664,98377,26951,0,-15261,0,0,0,,15261,-15261
29,07/16/2018,1,0:00,0:15,,,0,42.5,42.5,0,-60069,68882,128951,8813,0,-3754,0,0,0,,3754,-3754
29,07/16/2018,2,0:15,0:30,42.7,,0,42.7,42.7,1,-41442,59529,100971,18087,0,0,199,0,0,,199,199
29,07/16/2018,3,0:30,0:45,42.7,38.7,0,38.7,38.7,-1,-45877,74522,120399,28645,0,-548,154,0,0,,702,-394
29,07/16/2018,4,0:45,1:00,,27.64,0,27.64,27.64,-1,-37722,86365,124087,48643,0,-31372,0,0,0,,31372,-31372
29,07/16/2018,5,1:00,1:15,49.39,38.78,0,49.39,38.78,2,-60575,38488,99063,-22087,0,-15174,1811,0,0,,16985,-13363
29,07/16/2018,6,1:15,1:30,42.7,38.78,0,42.7,42.7,1,-52775,54580,107355,1805,0,-28,1620,0,0,,1648,1592
29,07/16/2018,7,1:30,1:45,42.7,41.9,0,41.9,41.9,-1,-43108,64315,107423,21207,0,-5,533,0,0,,538,528
29,07/16/2018,8,1:45,2:00,,35.06,0,35.06,35.06,-1,-31503,68651,100154,37148,0,-16513,0,0,0,,16513,-16513
29,07/16/2018,9,2:00,2:15,43.11,39.03,0,43.11,39.03,2,-53517,41172,94689,-12345,0,-12867,526,0,0,,13393,-12341
29,07/16/2018,10,2:15,2:30,43.11,40.14,0,40.14,40.14,-1,-51351,56094,107445,4743,0,-1923,19,0,0,,1942,-1904
29,07/16/2018,11,2:30,2:45,,39.98,0,39.98,39.98,-1,-56683,60770,117453,4087,0,-2052,0,0,0,,2052,-2052
29,07/16/2018,12,2:45,3:00,,39.78,0,39.78,39.78,-1,-55614,69619,125233,14005,0,-2848,0,0,0,,2848,-2848
29,07/16/2018,13,3:00,3:15,,,0,42.21,42.21,0,-41781,75349,117130,33568,0,-826,0,0,0,,826,-826
29,07/16/2018,14,3:15,3:30,,39.78,0,39.78,39.78,-1,-41505,64085,105590,22580,0,-565,0,0,0,,565,-565
29,07/16/2018,15,3:30,3:45,,40.59,0,40.59,40.59,-1,-45346,64009,109355,18663,0,-761,0,0,0,,761,-761
29,07/16/2018,16,3:45,4:00,,,0,42.19,42.19,0,-48522,70983,119505,22461,0,0,0,0,0,,0,0
29,07/16/2018,17,4:00,4:15,61.81,,0,61.81,61.81,1,-91761,35640,127401,-56121,0,0,16434,0,0,,16434,16434
29,07/16/2018,18,4:15,4:30,50.85,40.27,0,40.27,40.27,-1,-42870,46043,88913,3173,0,-282,19832,0,0,,20114,19550
29,07/16/2018,19,4:30,4:45,50.85,40.01,0,40.01,40.01,-1,-56769,45337,102106,-11432,0,-515,465,0,0,,980,-50
29,07/16/2018,20,4:45,5:00,50.85,,0,50.85,50.85,1,-63468,40208,103676,-23260,0,0,1282,0,0,,1282,1282
29,07/16/2018,21,5:00,5:15,50.85,,0,50.85,50.85,1,-66579,46718,113297,-19861,0,0,2447,0,0,,2447,2447
29,07/16/2018,22,5:15,5:30,,,0,42.36,42.36,0,-40280,50617,90897,10337,0,0,0,0,0,,0,0
29,07/16/2018,23,5:30,5:45,,,0,42.31,42.31,0,-43946,58287,102233,14341,0,0,0,0,0,,0,0
29,07/16/2018,24,5:45,6:00,,41.79,0,41.79,41.79,-1,-35266,40432,75698,5166,0,-34,0,0,0,,34,-34
29,07/16/2018,25,6:00,6:15,,22.73,0,22.73,22.73,-1,-51488,115369,166857,63881,0,-19548,0,0,0,,19548,-19548
29,07/16/2018,26,6:15,6:30,,34.84,0,34.84,34.84,-1,-43929,85445,129374,41516,0,-50875,0,0,0,,50875,-50875
29,07/16/2018,27,6:30,6:45,,39.78,0,39.78,39.78,-1,-46574,47979,94553,1405,0,-18991,0,0,0,,18991,-18991
29,07/16/2018,28,6:45,7:00,42.84,39.78,0,42.84,42.84,1,-57564,26999,84563,-30565,0,-357,565,0,0,,922,208
29,07/16/2018,29,7:00,7:15,42.84,22.82,0,22.82,22.82,-1,-46037,100221,146258,54184,0,-18524,96,0,0,,18620,-18428
29,07/16/2018,30,7:15,7:30,,38.84,0,38.84,38.84,-1,-73467,77008,150475,3541,0,-20595,0,0,0,,20595,-20595
29,07/16/2018,31,7:30,7:45,,42.78,0,42.78,42.78,-1,-78510,49202,127712,-29308,0,-122,0,0,0,,122,-122
29,07/16/2018,32,7:45,8:00,140.12,,0,140.12,140.12,1,-141505,35876,177381,-105629,0,0,22327,0,0,,22327,22327
29,07/16/2018,33,8:00,8:15,56.12,,0,56.12,56.12,1,-86523,46711,133234,-39812,0,0,22400,0,0,,22400,22400
29,07/16/2018,34,8:15,8:30,50.98,,0,50.98,50.98,1,-93343,34255,127598,-59088,0,0,1021,0,0,,1021,1021
29,07/16/2018,35,8:30,8:45,146.12,,0,146.12,146.12,1,-188426,20697,209123,-167729,0,0,43297,0,0,,43297,43297
29,07/16/2018,36,8:45,9:00,90.42,,0,90.42,90.42,1,-178778,15011,193789,-163767,0,0,51872,0,0,,51872,51872
29,07/16/2018,37,9:00,9:15,69.62,,0,69.62,69.62,1,-203639,56043,259682,-147596,0,0,58651,0,0,,58651,58651
29,07/16/2018,38,9:15,9:30,145.12,,0,145.12,145.12,1,-198088,64223,262311,-133865,0,0,82030,0,0,,82030,82030
29,07/16/2018,39,9:30,9:45,96.03,,0,96.03,96.03,1,-191644,94830,286474,-96814,0,0,70894,0,0,,70894,70894
29,07/16/2018,40,9:45,10:00,69.62,,0,69.62,69.62,1,-192405,100302,292707,-92103,0,0,47176,0,0,,47176,47176
29,07/16/2018,41,10:00,10:15,,,0,43.48,43.48,0,-192913,171888,364801,-21025,0,0,11521,0,0,,11521,11521
29,07/16/2018,42,10:15,10:30,47.63,,0,47.63,47.63,1,-180863,155966,336829,-24897,0,0,750,0,0,,750,750
29,07/16/2018,43,10:30,10:45,57.08,,0,57.08,57.08,1,-188307,141005,329312,-47302,0,0,5012,0,0,,5012,5012
29,07/16/2018,44,10:45,11:00,,,0,44.35,44.35,0,-187257,136249,323506,-51008,0,0,263,0,0,,263,263
29,07/16/2018,45,11:00,11:15,146.12,,0,146.12,146.12,1,-165088,82520,247608,-82568,0,0,27232,0,0,,27232,27232
29,07/16/2018,46,11:15,11:30,73.98,,0,73.98,73.98,1,-147177,84594,231771,-62583,0,0,49002,0,0,,49002,49002
29,07/16/2018,47,11:30,11:45,62.12,,0,62.12,62.12,1,-111972,81669,193641,-30303,0,0,40941,0,0,,40941,40941
29,07/16/2018,48,11:45,12:00,45.12,,0,45.12,45.12,1,-91240,80583,171823,-10657,0,0,10658,0,0,,10658,10658
29,07/16/2018,49,12:00,12:15,55.84,,0,55.84,55.84,1,-96559,88551,185110,-8008,0,0,1568,0,0,,1568,1568
29,07/16/2018,50,12:15,12:30,62.39,,0,62.39,62.39,1,-108997,83130,192127,-25867,0,0,17195,0,0,,17195,17195
29,07/16/2018,51,12:30,12:45,45.12,,0,45.12,45.12,1,-99525,88023,187548,-11502,0,0,6292,0,0,,6292,6292
29,07/16/2018,52,12:45,13:00,59.84,,0,59.84,59.84,1,-110144,86607,196751,-23537,0,0,6119,0,0,,6119,6119
29,07/16/2018,53,13:00,13:15,116.03,,0,116.03,116.03,1,-111909,51421,163330,-60488,0,0,45048,0,0,,45048,45048
29,07/16/2018,54,13:15,13:30,73.98,,0,73.98,73.98,1,-89871,44312,134183,-45559,0,0,47576,0,0,,47576,47576
29,07/16/2018,55,13:30,13:45,73.98,,0,73.98,73.98,1,-96925,49988,146913,-46937,0,0,43260,0,0,,43260,43260
29,07/16/2018,56,13:45,14:00,73.98,,0,73.98,73.98,1,-101966,50579,152545,-51387,0,0,44443,0,0,,44443,44443
29,07/16/2018,57,14:00,14:15,55.84,40.64,0,55.84,40.64,2,-59824,82422,142246,22598,0,-1328,22218,0,0,,23546,20890
29,07/16/2018,58,14:15,14:30,45.98,40.64,0,45.98,45.98,1,-85047,73662,158709,-11385,0,-345,126,0,0,,471,-219
29,07/16/2018,59,14:30,14:45,50.67,,0,50.67,50.67,1,-92469,74179,166648,-18290,0,0,1402,0,0,,1402,1402
29,07/16/2018,60,14:45,15:00,55.84,,0,55.84,55.84,1,-100582,72829,173411,-27753,0,0,3643,0,0,,3643,3643
29,07/16/2018,61,15:00,15:15,55.84,42.71,0,42.71,42.71,-1,-55661,111505,167166,55844,0,-59,593,0,0,,652,534
29,07/16/2018,62,15:15,15:30,,42.71,0,42.71,42.71,-1,-61201,103694,164895,42493,0,-531,0,0,0,,531,-531
29,07/16/2018,63,15:30,15:45,,,0,43.03,43.03,0,-88387,94829,183216,6442,0,0,0,0,0,,0,0
29,07/16/2018,64,15:45,16:00,,,0,43.03,43.03,0,-92318,82632,174950,-9686,0,0,0,0,0,,0,0
29,07/16/2018,65,16:00,16:15,,,0,43.03,43.03,0,-55524,97610,153134,42086,0,0,0,0,0,,0,0
29,07/16/2018,66,16:15,16:30,,,0,43.03,43.03,0,-65027,80589,145616,15562,0,0,0,0,0,,0,0
29,07/16/2018,67,16:30,16:45,,,0,43.03,43.03,0,-76725,74751,151476,-1974,0,0,0,0,0,,0,0
29,07/16/2018,68,16:45,17:00,42.84,,0,42.84,42.84,1,-110673,73566,184239,-37107,0,0,219,0,0,,219,219
29,07/16/2018,69,17:00,17:15,,30.94,0,30.94,30.94,-1,-34580,64483,99063,29903,0,-9463,0,0,0,,9463,-9463
29,07/16/2018,70,17:15,17:30,,42.6,0,42.6,42.6,-1,-61331,43724,105055,-17607,0,-1806,0,0,0,,1806,-1806
29,07/16/2018,71,17:30,17:45,50.98,,0,50.98,50.98,1,-72699,47099,119798,-25600,0,0,7726,0,0,,7726,7726
29,07/16/2018,72,17:45,18:00,50.98,,0,50.98,50.98,1,-94010,53472,147482,-40538,0,0,27380,0,0,,27380,27380
29,07/16/2018,73,18:00,18:15,66.03,,0,66.03,66.03,1,-99558,26523,126081,-73035,0,0,39865,0,0,,39865,39865
29,07/16/2018,74,18:15,18:30,48.03,,0,48.03,48.03,1,-74670,44724,119394,-29946,0,0,26832,0,0,,26832,26832
29,07/16/2018,75,18:30,18:45,50.71,,0,50.71,50.71,1,-70473,39072,109545,-31401,0,0,18827,0,0,,18827,18827
29,07/16/2018,76,18:45,19:00,50.98,,0,50.98,50.98,1,-76536,46509,123045,-30027,0,0,21183,0,0,,21183,21183
29,07/16/2018,77,19:00,19:15,46.84,,0,46.84,46.84,1,-77437,47045,124482,-30392,0,0,14063,0,0,,14063,14063
29,07/16/2018,78,19:15,19:30,46.49,,0,46.49,46.49,1,-88113,47620,135733,-40493,0,0,5801,0,0,,5801,5801
29,07/16/2018,79,19:30,19:45,101.12,,0,101.12,101.12,1,-99080,37506,136586,-61574,0,0,18986,0,0,,18986,18986
29,07/16/2018,80,19:45,20:00,116.03,,0,116.03,116.03,1,-110331,40971,151302,-69360,0,0,54131,0,0,,54131,54131
29,07/16/2018,81,20:00,20:15,149.12,,0,149.12,149.12,1,-168306,30223,198529,-138083,0,0,77835,0,0,,77835,77835
29,07/16/2018,82,20:15,20:30,117.4,,0,117.4,117.4,1,-126811,37904,164715,-88907,0,0,84453,0,0,,84453,84453
29,07/16/2018,83,20:30,20:45,49.12,,0,49.12,49.12,1,-98938,68316,167254,-30622,0,0,25193,0,0,,25193,25193
29,07/16/2018,84,20:45,21:00,,,0,43.48,43.48,0,-104022,81825,185847,-22197,0,0,200,0,0,,200,200
29,07/16/2018,85,21:00,21:15,50.98,,0,50.98,50.98,1,-72671,30262,102933,-42409,0,0,9479,0,0,,9479,9479
29,07/16/2018,86,21:15,21:30,50.98,,0,50.98,50.98,1,-76044,41754,117798,-34290,0,0,19563,0,0,,19563,19563
29,07/16/2018,87,21:30,21:45,,,0,43.49,43.49,0,-73881,69107,142988,-4774,0,0,4924,0,0,,4924,4924
29,07/16/2018,88,21:45,22:00,46.84,,0,46.84,46.84,1,-76499,68090,144589,-8409,0,0,1888,0,0,,1888,1888
29,07/16/2018,89,22:00,22:15,50.98,,0,50.98,50.98,1,-85308,57381,142689,-27927,0,0,12275,0,0,,12275,12275
29,07/16/2018,90,22:15,22:30,49.2,,0,49.2,49.2,1,-85965,50044,136009,-35921,0,0,12263,0,0,,12263,12263
29,07/16/2018,91,22:30,22:45,,,0,43.51,43.51,0,-69332,48137,117469,-21195,0,0,197,0,0,,197,197
29,07/16/2018,92,22:45,23:00,,,0,43.51,43.51,0,-56060,56001,112061,-59,0,0,0,0,0,,0,0
29,07/16/2018,93,23:00,23:15,66.03,,0,66.03,66.03,1,-128169,43812,171981,-84357,0,0,3008,0,0,,3008,3008
29,07/16/2018,94,23:15,23:30,85.12,,0,85.12,85.12,1,-81876,39947,121823,-41929,0,0,15208,0,0,,15208,15208
29,07/16/2018,95,23:30,23:45,85.12,34.84,0,34.84,34.84,-1,-44929,70087,115016,25158,0,-7094,14,0,0,,7108,-7080
29,07/16/2018,96,23:45,0:00,,30.94,0,30.94,30.94,-1,-39320,86033,125353,46713,0,-41769,0,0,0,,41769,-41769
29,07/17/2018,1,0:00,0:15,46,32.36,0,46,32.36,2,-92329,61317,153646,-31012,0,-24071,158,0,0,,24229,-23913
29,07/17/2018,2,0:15,0:30,46.06,39.8,0,46.06,39.8,2,-73944,66788,140732,-7156,0,-656,337,0,0,,993,-319
29,07/17/2018,3,0:30,0:45,,35.66,0,35.66,35.66,-1,-47483,73077,120560,25594,0,-8358,0,0,0,,8358,-8358
29,07/17/2018,4,0:45,1:00,,30.05,0,30.05,30.05,-1,-33563,83391,116954,49828,0,-43759,0,0,0,,43759,-43759
29,07/17/2018,5,1:00,1:15,107.38,34.11,0,107.38,107.38,1,-88098,46337,134435,-41761,0,-26295,7437,0,0,,33732,-18858
29,07/17/2018,6,1:15,1:30,116.03,34.11,0,116.03,116.03,1,-62361,55620,117981,-6741,0,-391,23403,0,0,,23794,23012
29,07/17/2018,7,1:30,1:45,116.03,42.33,0,42.33,42.33,-1,-54693,56051,110744,1358,0,-959,91,0,0,,1050,-868
29,07/17/2018,8,1:45,2:00,,42.33,0,42.33,42.33,-1,-51283,44585,95868,-6698,0,-328,0,0,0,,328,-328
29,07/17/2018,9,2:00,2:15,79.05,42.16,0,79.05,79.05,1,-85384,22298,107682,-63086,0,-29,11944,0,0,,11973,11915
29,07/17/2018,10,2:15,2:30,50.05,,0,50.05,50.05,1,-83224,19990,103214,-63234,0,0,21212,0,0,,21212,21212
29,07/17/2018,11,2:30,2:45,43.37,,0,43.37,43.37,1,-83674,21407,105081,-62267,0,0,1581,0,0,,1581,1581
29,07/17/2018,12,2:45,3:00,,,0,42.93,42.93,0,-75079,28297,103376,-46782,0,0,14,0,0,,14,14
29,07/17/2018,13,3:00,3:15,50.05,,0,50.05,50.05,1,-75667,33285,108952,-42382,0,0,5204,0,0,,5204,5204
29,07/17/2018,14,3:15,3:30,44.86,,0,44.86,44.86,1,-70475,36300,106775,-34175,0,0,4531,0,0,,4531,4531
29,07/17/2018,15,3:30,3:45,43.37,,0,43.37,43.37,1,-61283,38332,99615,-22951,0,0,5580,0,0,,5580,5580
29,07/17/2018,16,3:45,4:00,44.86,,0,44.86,44.86,1,-68162,42342,110504,-25820,0,0,7593,0,0,,7593,7593
29,07/17/2018,17,4:00,4:15,43.37,,0,43.37,43.37,1,-54065,41549,95614,-12516,0,0,4596,0,0,,4596,4596
29,07/17/2018,18,4:15,4:30,41.95,,0,41.95,41.95,1,-43400,38525,81925,-4875,0,0,1266,0,0,,1266,1266
29,07/17/2018,19,4:30,4:45,41.95,,0,41.95,41.95,1,-40688,36908,77596,-3780,0,0,302,0,0,,302,302
29,07/17/2018,20,4:45,5:00,43.31,,0,43.31,43.31,1,-51683,36506,88189,-15177,0,0,3159,0,0,,3159,3159
29,07/17/2018,21,5:00,5:15,43.37,,0,43.37,43.37,1,-71393,29443,100836,-41950,0,0,2657,0,0,,2657,2657
29,07/17/2018,22,5:15,5:30,45.95,,0,45.95,45.95,1,-64426,38167,102593,-26259,0,0,837,0,0,,837,837
29,07/17/2018,23,5:30,5:45,45.95,,0,45.95,45.95,1,-69643,38932,108575,-30711,0,0,746,0,0,,746,746
29,07/17/2018,24,5:45,6:00,45.95,,0,45.95,45.95,1,-90538,37460,127998,-53078,0,0,2733,0,0,,2733,2733
29,07/17/2018,25,6:00,6:15,42.7,30.8,0,42.94,30.8,2,-29784,75006,104790,45222,0,-10248,712,0,0,,10960,-9536
29,07/17/2018,26,6:15,6:30,,40.9,0,40.9,40.9,-1,-43934,41383,85317,-2551,0,-9432,0,0,0,,9432,-9432
29,07/17/2018,27,6:30,6:45,42.7,40.9,0,42.7,42.7,1,-84934,27674,112608,-57260,0,-162,26,0,0,,188,-136
29,07/17/2018,28,6:45,7:00,45.93,,0,45.93,45.93,1,-121289,19824,141113,-101465,0,0,1448,0,0,,1448,1448
29,07/17/2018,29,7:00,7:15,42.7,38.7,0,42.94,38.7,2,-50129,64946,115075,14817,0,-1776,748,0,0,,2524,-1028
29,07/17/2018,30,7:15,7:30,,42.97,0,42.97,42.97,-1,-67019,47458,114477,-19561,0,-1031,0,0,0,,1031,-1031
29,07/17/2018,31,7:30,7:45,66.8,,0,66.8,66.8,1,-110705,26467,137172,-84238,0,0,2353,0,0,,2353,2353
29,07/17/2018,32,7:45,8:00,143.11,,0,143.11,143.11,1,-128616,25589,154205,-103027,0,0,53400,0,0,,53400,53400
29,07/17/2018,33,8:00,8:15,66.32,38.98,0,38.98,38.98,-1,-49783,44426,94209,-5357,0,-557,38042,0,0,,38599,37485
29,07/17/2018,34,8:15,8:30,50.76,38.98,0,50.76,38.98,2,-73013,32834,105847,-40179,0,-700,7271,0,0,,7971,6571
29,07/17/2018,35,8:30,8:45,47.86,,0,47.86,47.86,1,-84997,27010,112007,-57987,0,0,4826,0,0,,4826,4826
29,07/17/2018,36,8:45,9:00,116.32,,0,116.32,116.32,1,-97989,34482,132471,-63507,0,0,20373,0,0,,20373,20373
29,07/17/2018,37,9:00,9:15,42.7,,0,42.7,42.7,1,-76825,49397,126222,-27428,0,0,4468,0,0,,4468,4468
29,07/17/2018,38,9:15,9:30,,,0,42.94,42.94,0,-82683,61248,143931,-21435,0,0,0,0,0,,0,0
29,07/17/2018,39,9:30,9:45,,40.24,0,40.24,40.24,-1,-75576,75768,151344,192,0,-1023,0,0,0,,1023,-1023
29,07/17/2018,40,9:45,10:00,,42.24,0,42.24,42.24,-1,-72960,76270,149230,3310,0,-1952,0,0,0,,1952,-1952
29,07/17/2018,41,10:00,10:15,,,0,42.94,42.94,0,-99073,50767,149840,-48306,0,-31,0,0,0,,31,-31
29,07/17/2018,42,10:15,10:30,,,0,42.94,42.94,0,-82649,43804,126453,-38845,0,0,0,0,0,,0,0
29,07/17/2018,43,10:30,10:45,,,0,42.94,42.94,0,-79674,45883,125557,-33791,0,0,0,0,0,,0,0
29,07/17/2018,44,10:45,11:00,,,0,42.94,42.94,0,-70427,53135,123562,-17292,0,0,0,0,0,,0,0
29,07/17/2018,45,11:00,11:15,,,0,42.93,42.93,0,-96989,21072,118061,-75917,0,0,0,0,0,,0,0
29,07/17/2018,46,11:15,11:30,,,0,42.93,42.93,0,-79369,29668,109037,-49701,0,0,0,0,0,,0,0
29,07/17/2018,47,11:30,11:45,,,0,42.93,42.93,0,-65480,33921,99401,-31559,0,0,0,0,0,,0,0
29,07/17/2018,48,11:45,12:00,48.25,,0,48.25,48.25,1,-69819,42784,112603,-27035,0,0,5196,0,0,,5196,5196
29,07/17/2018,49,12:00,12:15,50.76,,0,50.76,50.76,1,-105594,37247,142841,-68347,0,0,17053,0,0,,17053,17053
29,07/17/2018,50,12:15,12:30,,,0,42.88,42.88,0,-88140,40929,129069,-47211,0,0,2724,0,0,,2724,2724
29,07/17/2018,51,12:30,12:45,46.29,,0,46.29,46.29,1,-67154,47275,114429,-19879,0,0,374,0,0,,374,374
29,07/17/2018,52,12:45,13:00,,,0,42.88,42.88,0,-61530,43544,105074,-17986,0,0,42,0,0,,42,42
29,07/17/2018,53,13:00,13:15,42.7,,0,42.7,42.7,1,-64916,38717,103633,-26199,0,0,266,0,0,,266,266
29,07/17/2018,54,13:15,13:30,47.63,,0,47.63,47.63,1,-87708,42185,129893,-45523,0,0,2779,0,0,,2779,2779
29,07/17/2018,55,13:30,13:45,46.7,,0,46.7,46.7,1,-76070,48676,124746,-27394,0,0,3199,0,0,,3199,3199
29,07/17/2018,56,13:45,14:00,46.14,,0,46.14,46.14,1,-61983,57976,119959,-4007,0,0,3964,0,0,,3964,3964
29,07/17/2018,57,14:00,14:15,,,0,42.87,42.87,0,-49210,61018,110228,11808,0,0,259,0,0,,259,259
29,07/17/2018,58,14:15,14:30,,,0,42.87,42.87,0,-55060,68573,123633,13513,0,0,0,0,0,,0,0
29,07/17/2018,59,14:30,14:45,,42.97,0,42.97,42.97,-1,-51051,77627,128678,26576,0,-75,0,0,0,,75,-75
29,07/17/2018,60,14:45,15:00,,38.24,0,38.24,38.24,-1,-43070,87846,130916,44776,0,-9387,0,0,0,,9387,-9387
29,07/17/2018,61,15:00,15:15,,40.9,0,40.9,40.9,-1,-40133,109800,149933,69667,0,-7742,0,0,0,,7742,-7742
29,07/17/2018,62,15:15,15:30,,22.09,0,22.09,22.09,-1,-45027,133675,178702,88648,0,-10533,0,0,0,,10533,-10533
29,07/17/2018,63,15:30,15:45,,38.7,0,38.7,38.7,-1,-42490,136724,179214,94234,0,-11959,0,0,0,,11959,-11959
29,07/17/2018,64,15:45,16:00,,-43.16,0,-43.16,-43.16,-1,-45160,131727,176887,86567,0,-49819,0,0,0,,49819,-49819
29,07/17/2018,65,16:00,16:15,,34.06,0,34.06,34.06,-1,-67734,128684,196418,60950,0,-29918,0,0,0,,29918,-29918
29,07/17/2018,66,16:15,16:30,,34.7,0,34.7,34.7,-1,-58783,132105,190888,73322,0,-3899,0,0,0,,3899,-3899
29,07/17/2018,67,16:30,16:45,,,0,42.88,42.88,0,-61647,141942,203589,80295,0,-704,0,0,0,,704,-704
29,07/17/2018,68,16:45,17:00,,42.75,0,42.75,42.75,-1,-65420,138626,204046,73206,0,-304,0,0,0,,304,-304
29,07/17/2018,69,17:00,17:15,,6.84,0,6.84,6.84,-1,-51919,146455,198374,94536,0,-16719,0,0,0,,16719,-16719
29,07/17/2018,70,17:15,17:30,,39.03,0,39.03,39.03,-1,-49969,103251,153220,53282,0,-9930,0,0,0,,9930,-9930
29,07/17/2018,71,17:30,17:45,,,0,42.89,42.89,0,-47072,101366,148438,54294,0,-176,0,0,0,,176,-176
29,07/17/2018,72,17:45,18:00,,38.7,0,38.7,38.7,-1,-49574,100019,149593,50445,0,-376,0,0,0,,376,-376
29,07/17/2018,73,18:00,18:15,,29.45,0,29.45,29.45,-1,-57428,111854,169282,54426,0,-16660,0,0,0,,16660,-16660
29,07/17/2018,74,18:15,18:30,,29.45,0,29.45,29.45,-1,-50917,107328,158245,56411,0,-37676,0,0,0,,37676,-37676
29,07/17/2018,75,18:30,18:45,,,0,42.92,42.92,0,-57618,97859,155477,40241,0,-10257,0,0,0,,10257,-10257
29,07/17/2018,76,18:45,19:00,,,0,42.92,42.92,0,-47736,89824,137560,42088,0,0,0,0,0,,0,0
29,07/17/2018,77,19:00,19:15,,,0,42.94,42.94,0,-37856,73733,111589,35877,0,0,0,0,0,,0,0
29,07/17/2018,78,19:15,19:30,,,0,42.94,42.94,0,-56284,80056,136340,23772,0,0,0,0,0,,0,0
29,07/17/2018,79,19:30,19:45,42.7,,0,42.7,42.7,1,-69457,78007,147464,8550,0,0,2,0,0,,2,2
29,07/17/2018,80,19:45,20:00,46.49,,0,46.49,46.49,1,-91435,72955,164390,-18480,0,0,1218,0,0,,1218,1218
29,07/17/2018,81,20:00,20:15,42.7,,0,42.7,42.7,1,-52024,64931,116955,12907,0,0,519,0,0,,519,519
29,07/17/2018,82,20:15,20:30,42.7,,0,42.7,42.7,1,-54179,46428,100607,-7751,0,0,1350,0,0,,1350,1350
29,07/17/2018,83,20:30,20:45,42.7,,0,42.7,42.7,1,-58521,53841,112362,-4680,0,0,82,0,0,,82,82
29,07/17/2018,84,20:45,21:00,,39.44,0,39.44,39.44,-1,-57703,73496,131199,15793,0,-1422,0,0,0,,1422,-1422
29,07/17/2018,85,21:00,21:15,42.7,,0,42.7,42.7,1,-54380,48607,102987,-5773,0,0,8,0,0,,8,8
29,07/17/2018,86,21:15,21:30,46.29,,0,46.29,46.29,1,-50441,46590,97031,-3851,0,0,759,0,0,,759,759
29,07/17/2018,87,21:30,21:45,42.7,,0,42.7,42.7,1,-39592,49841,89433,10249,0,0,1921,0,0,,1921,1921
29,07/17/2018,88,21:45,22:00,,42.86,0,42.86,42.86,-1,-47525,58924,106449,11399,0,-5,0,0,0,,5,-5
29,07/17/2018,89,22:00,22:15,,39.03,0,39.03,39.03,-1,-44766,43475,88241,-1291,0,-440,0,0,0,,440,-440
29,07/17/2018,90,22:15,22:30,,42.75,0,42.75,42.75,-1,-48367,48922,97289,555,0,-14,0,0,0,,14,-14
29,07/17/2018,91,22:30,22:45,,42.75,0,42.75,42.75,-1,-37816,55982,93798,18166,0,-1072,0,0,0,,1072,-1072
29,07/17/2018,92,22:45,23:00,,30.8,0,30.8,30.8,-1,-27683,80402,108085,52719,0,-3391,0,0,0,,3391,-3391
29,07/17/2018,93,23:00,23:15,42.7,30.8,0,43.3,30.8,2,-50274,41674,91948,-8600,0,-5171,74,0,0,,5245,-5097
29,07/17/2018,94,23:15,23:30,,38.7,0,38.7,38.7,-1,-29073,55660,84733,26587,0,-1252,0,0,0,,1252,-1252
29,07/17/2018,95,23:30,23:45,,38.7,0,38.7,38.7,-1,-19832,64397,84229,44565,0,-4908,0,0,0,,4908,-4908
29,07/17/2018,96,23:45,0:00,,38.7,0,38.7,38.7,-1,-23374,83540,106914,60166,0,-12339,0,0,0,,12339,-12339
29,07/18/2018,1,0:00,0:15,46.65,35.78,0,46.65,35.78,2,-48667,59595,108262,10928,0,-7158,1590,0,0,,8748,-5568
29,07/18/2018,2,0:15,0:30,46.65,41.65,0,41.65,41.65,-1,-57377,68661,126038,11284,0,-41,333,0,0,,374,292
29,07/18/2018,3,0:30,0:45,,34.65,0,34.65,34.65,-1,-38535,91106,129641,52571,0,-9345,0,0,0,,9345,-9345
29,07/18/2018,4,0:45,1:00,,31.33,0,31.33,31.33,-1,-37595,61127,98722,23532,0,-31871,0,0,0,,31871,-31871
29,07/18/2018,5,1:00,1:15,46.98,31.33,0,46.98,46.98,1,-49143,35019,84162,-14124,0,-3704,4674,0,0,,8378,970
29,07/18/2018,6,1:15,1:30,42.34,41.07,0,41.07,41.07,-1,-40665,37187,77852,-3478,0,-6,2304,0,0,,2310,2298
29,07/18/2018,7,1:30,1:45,,41.09,0,41.09,41.09,-1,-79811,50767,130578,-29044,0,-40,0,0,0,,40,-40
29,07/18/2018,8,1:45,2:00,,,0,42.86,42.86,0,-63148,55130,118278,-8018,0,0,0,0,0,,0,0
29,07/18/2018,9,2:00,2:15,42.65,41.01,0,42.81,41.01,2,-47662,48508,96170,846,0,-137,609,0,0,,746,472
29,07/18/2018,10,2:15,2:30,42.65,35.78,0,35.78,35.78,-1,-36231,51568,87799,15337,0,-1064,96,0,0,,1160,-968
29,07/18/2018,11,2:30,2:45,,34.65,0,34.65,34.65,-1,-38534,64089,102623,25555,0,-19396,0,0,0,,19396,-19396
29,07/18/2018,12,2:45,3:00,,35.78,0,35.78,35.78,-1,-38642,65660,104302,27018,0,-24277,0,0,0,,24277,-24277
29,07/18/2018,13,3:00,3:15,46.65,36.32,0,46.65,36.32,2,-49165,47951,97116,-1214,0,-14356,1190,0,0,,15546,-13166
29,07/18/2018,14,3:15,3:30,46.65,40.98,0,40.98,40.98,-1,-49926,55810,105736,5884,0,-385,291,0,0,,676,-94
29,07/18/2018,15,3:30,3:45,,38.65,0,38.65,38.65,-1,-55651,68265,123916,12614,0,-1538,0,0,0,,1538,-1538
29,07/18/2018,16,3:45,4:00,,36.58,0,36.58,36.58,-1,-49049,66535,115584,17486,0,-8975,0,0,0,,8975,-8975
29,07/18/2018,17,4:00,4:15,,39.1,0,39.1,39.1,-1,-46546,63438,109984,16892,0,-6846,0,0,0,,6846,-6846
29,07/18/2018,18,4:15,4:30,,,0,42.85,42.85,0,-44261,73810,118071,29549,0,-85,0,0,0,,85,-85
29,07/18/2018,19,4:30,4:45,,38.65,0,38.65,38.65,-1,-34815,81261,116076,46446,0,-163,0,0,0,,163,-163
29,07/18/2018,20,4:45,5:00,,40.97,0,40.97,40.97,-1,-34585,86229,120814,51644,0,-204,0,0,0,,204,-204
29,07/18/2018,21,5:00,5:15,,39.98,0,39.98,39.98,-1,-76046,68623,144669,-7423,0,-2095,0,0,0,,2095,-2095
29,07/18/2018,22,5:15,5:30,,38.65,0,38.65,38.65,-1,-52500,64666,117166,12166,0,-4967,0,0,0,,4967,-4967
29,07/18/2018,23,5:30,5:45,,,0,42.85,42.85,0,-49638,64256,113894,14618,0,-741,0,0,0,,741,-741
29,07/18/2018,24,5:45,6:00,,,0,42.79,42.79,0,-46860,58415,105275,11555,0,0,0,0,0,,0,0
29,07/18/2018,25,6:00,6:15,,38.29,0,38.29,38.29,-1,-36739,63175,99914,26436,0,-1353,0,0,0,,1353,-1353
29,07/18/2018,26,6:15,6:30,,41.72,0,41.72,41.72,-1,-35328,36317,71645,989,0,-940,0,0,0,,940,-940
29,07/18/2018,27,6:30,6:45,46.29,41.72,0,46.29,46.29,1,-52201,13781,65982,-38420,0,-29,400,0,0,,429,371
29,07/18/2018,28,6:45,7:00,42.29,,0,42.29,42.29,1,-64688,13081,77769,-51607,0,0,1356,0,0,,1356,1356
29,07/18/2018,29,7:00,7:15,,34.29,0,34.29,34.29,-1,-68314,86766,155080,18452,0,-3034,0,0,0,,3034,-3034
29,07/18/2018,30,7:15,7:30,,26.5,0,26.5,26.5,-1,-49865,82359,132224,32494,0,-28761,0,0,0,,28761,-28761
29,07/18/2018,31,7:30,7:45,42.29,26.5,0,42.29,42.29,1,-70317,66324,136641,-3993,0,-4004,85,0,0,,4089,-3919
29,07/18/2018,32,7:45,8:00,47.04,,0,47.04,47.04,1,-99180,60505,159685,-38675,0,0,4684,0,0,,4684,4684
29,07/18/2018,33,8:00,8:15,47.04,31.62,0,31.62,31.62,-1,-35255,71799,107054,36544,0,-12637,284,0,0,,12921,-12353
29,07/18/2018,34,8:15,8:30,,39.44,0,39.44,39.44,-1,-66102,72078,138180,5976,0,-6132,0,0,0,,6132,-6132
29,07/18/2018,35,8:30,8:45,,41.95,0,41.95,41.95,-1,-68703,63716,132419,-4987,0,-2238,0,0,0,,2238,-2238
29,07/18/2018,36,8:45,9:00,,41.91,0,41.91,41.91,-1,-72112,57169,129281,-14943,0,-274,0,0,0,,274,-274
29,07/18/2018,37,9:00,9:15,50.34,,0,50.34,50.34,1,-91627,67076,158703,-24551,0,0,6405,0,0,,6405,6405
29,07/18/2018,38,9:15,9:30,46.29,,0,46.29,46.29,1,-86618,73205,159823,-13413,0,0,8863,0,0,,8863,8863
29,07/18/2018,39,9:30,9:45,42.29,39.22,0,42.75,39.22,2,-62349,71192,133541,8843,0,-1564,3122,0,0,,4686,1558
29,07/18/2018,40,9:45,10:00,45.35,39.22,0,45.35,45.35,1,-77744,73023,150767,-4721,0,-1,254,0,0,,255,253
29,07/18/2018,41,10:00,10:15,42.29,,0,42.29,42.29,1,-77670,70902,148572,-6768,0,0,326,0,0,,326,326
29,07/18/2018,42,10:15,10:30,,42.06,0,42.06,42.06,-1,-76324,75899,152223,-425,0,-112,0,0,0,,112,-112
29,07/18/2018,43,10:30,10:45,,42.06,0,42.06,42.06,-1,-76199,70479,146678,-5720,0,-201,0,0,0,,201,-201
29,07/18/2018,44,10:45,11:00,,42.06,0,42.06,42.06,-1,-68630,67739,136369,-891,0,-393,0,0,0,,393,-393
29,07/18/2018,45,11:00,11:15,71.83,,0,71.83,71.83,1,-82559,42492,125051,-40067,0,0,15076,0,0,,15076,15076
29,07/18/2018,46,11:15,11:30,54.15,,0,54.15,54.15,1,-82144,42289,124433,-39855,0,0,30640,0,0,,30640,30640
29,07/18/2018,47,11:30,11:45,60.15,,0,60.15,60.15,1,-80661,33040,113701,-47621,0,0,43728,0,0,,43728,43728
29,07/18/2018,48,11:45,12:00,60.46,,0,60.46,60.46,1,-83176,29490,112666,-53686,0,0,46395,0,0,,46395,46395
29,07/18/2018,49,12:00,12:15,65.34,,0,65.34,65.34,1,-102746,51756,154502,-50990,0,0,44515,0,0,,44515,44515
29,07/18/2018,50,12:15,12:30,65.34,,0,65.34,65.34,1,-102626,53426,156052,-49200,0,0,46143,0,0,,46143,46143
29,07/18/2018,51,12:30,12:45,50.34,,0,50.34,50.34,1,-95754,57159,152913,-38595,0,0,35588,0,0,,35588,35588
29,07/18/2018,52,12:45,13:00,50.34,,0,50.34,50.34,1,-78856,56384,135240,-22472,0,0,28118,0,0,,28118,28118
29,07/18/2018,53,13:00,13:15,144.15,,0,144.15,144.15,1,-129408,56922,186330,-72486,0,0,34515,0,0,,34515,34515
29,07/18/2018,54,13:15,13:30,144.15,,0,144.15,144.15,1,-123899,42114,166013,-81785,0,0,82932,0,0,,82932,82932
29,07/18/2018,55,13:30,13:45,66.23,,0,66.23,66.23,1,-106841,69374,176215,-37467,0,0,46506,0,0,,46506,46506
29,07/18/2018,56,13:45,14:00,54.15,,0,54.15,54.15,1,-113849,73065,186914,-40784,0,0,25328,0,0,,25328,25328
29,07/18/2018,57,14:00,14:15,116.23,,0,116.23,116.23,1,-115162,48982,164144,-66180,0,0,46498,0,0,,46498,46498
29,07/18/2018,58,14:15,14:30,133.15,,0,133.15,133.15,1,-107922,41357,149279,-66565,0,0,66416,0,0,,66416,66416
29,07/18/2018,59,14:30,14:45,66.23,,0,66.23,66.23,1,-117518,61836,179354,-55682,0,0,49354,0,0,,49354,49354
29,07/18/2018,60,14:45,15:00,146.12,,0,261.6,261.6,1,-246443,54711,301154,-191732,0,0,76115,0,16090,,92205,92205
29,07/18/2018,61,15:00,15:15,209.11,,0,259.11,259.11,1,-207958,105918,313876,-102040,0,0,88996,2500,41454,,132950,132950
29,07/18/2018,62,15:15,15:30,50.42,40.98,0,259.11,40.98,2,-172277,123199,295476,-49078,0,-288,16381,0,23828,,40497,39921
29,07/18/2018,63,15:30,15:45,145.12,,0,145.12,145.12,1,-206373,120097,326470,-86276,0,0,49610,0,0,,49610,49610
29,07/18/2018,64,15:45,16:00,129.12,,0,129.12,129.12,1,-207770,110752,318522,-97018,0,0,90186,0,0,,90186,90186
29,07/18/2018,65,16:00,16:15,115.9,39,0,39,39,-1,-153912,137711,291623,-16201,0,-487,53892,0,0,,54379,53405
29,07/18/2018,66,16:15,16:30,116.23,37.47,0,116.23,37.47,2,-155548,111085,266633,-44463,0,-573,13947,0,0,,14520,13374
29,07/18/2018,67,16:30,16:45,150.1,,0,150.1,150.1,1,-166167,108870,275037,-57297,0,0,56514,0,0,,56514,56514
29,07/18/2018,68,16:45,17:00,66.23,,0,66.23,66.23,1,-181227,106543,287770,-74684,0,0,56261,0,0,,56261,56261
29,07/18/2018,69,17:00,17:15,46.34,35.22,0,46.34,35.22,2,-131605,146844,278449,15239,0,-2615,21463,0,0,,24078,18848
29,07/18/2018,70,17:15,17:30,114.12,35.22,0,114.12,114.12,1,-177911,124750,302661,-53161,0,-5,28836,0,0,,28841,28831
29,07/18/2018,71,17:30,17:45,66.23,,0,66.23,66.23,1,-184993,128497,313490,-56496,0,0,50819,0,0,,50819,50819
29,07/18/2018,72,17:45,18:00,116.23,,0,116.23,116.23,1,-189807,115670,305477,-74137,0,0,66026,0,0,,66026,66026
29,07/18/2018,73,18:00,18:15,164.84,,0,164.84,164.84,1,-163127,51016,214143,-112111,0,0,80249,0,0,,80249,80249
29,07/18/2018,74,18:15,18:30,70.9,37.44,0,37.44,37.44,-1,-121038,97341,218379,-23697,0,-235,45641,0,0,,45876,45406
29,07/18/2018,75,18:30,18:45,50.9,34.35,0,50.9,34.35,2,-102440,83690,186130,-18750,0,-556,4277,0,0,,4833,3721
29,07/18/2018,76,18:45,19:00,46.59,,0,46.59,46.59,1,-100640,81803,182443,-18837,0,0,10294,0,0,,10294,10294
29,07/18/2018,77,19:00,19:15,48.44,,0,48.44,48.44,1,-132078,111812,243890,-20266,0,0,5456,0,0,,5456,5456
29,07/18/2018,78,19:15,19:30,46.46,,0,46.46,46.46,1,-146157,111674,257831,-34483,0,0,14085,0,0,,14085,14085
29,07/18/2018,79,19:30,19:45,46.73,,0,46.73,46.73,1,-149727,117324,267051,-32403,0,0,16712,0,0,,16712,16712
29,07/18/2018,80,19:45,20:00,49.37,,0,49.37,49.37,1,-144830,107961,252791,-36869,0,0,20573,0,0,,20573,20573
29,07/18/2018,81,20:00,20:15,49.37,39.78,0,39.78,39.78,-1,-42616,70736,113352,28120,0,-1542,7263,0,0,,8805,5721
29,07/18/2018,82,20:15,20:30,,40.96,0,40.96,40.96,-1,-60359,71673,132032,11314,0,-1799,0,0,0,,1799,-1799
29,07/18/2018,83,20:30,20:45,,41.96,0,41.96,41.96,-1,-40005,74180,114185,34175,0,-1704,0,0,0,,1704,-1704
29,07/18/2018,84,20:45,21:00,,41.97,0,41.97,41.97,-1,-34537,80638,115175,46101,0,-1889,0,0,0,,1889,-1889
29,07/18/2018,85,21:00,21:15,50.34,41.84,0,50.34,41.84,2,-71995,45205,117200,-26790,0,-1106,6292,0,0,,7398,5186
29,07/18/2018,86,21:15,21:30,42.29,,0,42.29,42.29,1,-61809,61943,123752,134,0,0,2337,0,0,,2337,2337
29,07/18/2018,87,21:30,21:45,,,0,42.78,42.78,0,-43889,50261,94150,6372,0,0,0,0,0,,0,0
29,07/18/2018,88,21:45,22:00,,,0,42.78,42.78,0,-47861,55280,103141,7419,0,0,0,0,0,,0,0
29,07/18/2018,89,22:00,22:15,146.12,,0,146.12,146.12,1,-105923,18535,124458,-87388,0,0,20594,0,0,,20594,20594
29,07/18/2018,90,22:15,22:30,146.12,,0,146.12,146.12,1,-105157,30778,135935,-74379,0,0,65092,0,0,,65092,65092
29,07/18/2018,91,22:30,22:45,46.3,40.78,0,40.78,40.78,-1,-65359,50651,116010,-14708,0,-573,20610,0,0,,21183,20037
29,07/18/2018,92,22:45,23:00,46.3,39.42,0,39.42,39.42,-1,-39095,60907,100002,21812,0,-3243,69,0,0,,3312,-3174
29,07/18/2018,93,23:00,23:15,65.34,39.42,0,65.34,65.34,1,-80139,21489,101628,-58650,0,-232,13056,0,0,,13288,12824
29,07/18/2018,94,23:15,23:30,46.3,41.74,0,41.74,41.74,-1,-67695,46608,114303,-21087,0,-8,14415,0,0,,14423,14407
29,07/18/2018,95,23:30,23:45,46.3,39.78,0,39.78,39.78,-1,-27700,48225,75925,20525,0,-1798,751,0,0,,2549,-1047
29,07/18/2018,96,23:45,0:00,,30.42,0,30.42,30.42,-1,-48709,75247,123956,26538,0,-12740,0,0,0,,12740,-12740
29,07/19/2018,1,0:00,0:15,68.39,15.93,0,68.39,15.93,2,-65920,59143,125063,-6777,0,-13158,3349,0,0,,16507,-9809
29,07/19/2018,2,0:15,0:30,140.02,30.6,0,140.02,27.05,2,-34245,41309,75554,7064,0,-519,28883,0,0,,29402,28364
29,07/19/2018,3,0:30,0:45,140.02,25.99,0,25.99,25.99,-1,-14792,77628,92420,62836,0,-8941,277,0,0,,9218,-8664
29,07/19/2018,4,0:45,1:00,,21.78,0,21.78,21.78,-1,-29751,67386,97137,37635,0,-36253,0,0,0,,36253,-36253
29,07/19/2018,5,1:00,1:15,42.69,38.2,0,42.69,27.05,2,-38967,36219,75186,-2748,0,-10461,1006,0,0,,11467,-9455
29,07/19/2018,6,1:15,1:30,42.69,39.21,0,39.21,39.21,-1,-29271,45631,74902,16360,0,-1933,5,0,0,,1938,-1928
29,07/19/2018,7,1:30,1:45,,37.81,0,37.81,37.81,-1,-27002,58250,85252,31248,0,-9585,0,0,0,,9585,-9585
29,07/19/2018,8,1:45,2:00,,39.6,0,39.6,39.6,-1,-26962,43228,70190,16266,0,-15155,0,0,0,,15155,-15155
29,07/19/2018,9,2:00,2:15,49.91,41.12,0,49.91,41.12,2,-38840,23404,62244,-15436,0,-6257,5493,0,0,,11750,-764
29,07/19/2018,10,2:15,2:30,42.35,,0,42.35,42.35,1,-32991,13302,46293,-19689,0,0,3723,0,0,,3723,3723
29,07/19/2018,11,2:30,2:45,,,0,42.96,42.96,0,-23037,21299,44336,-1738,0,0,0,0,0,,0,0
29,07/19/2018,12,2:45,3:00,,41.14,0,41.14,41.14,-1,-21441,21190,42631,-251,0,-933,0,0,0,,933,-933
29,07/19/2018,13,3:00,3:15,,41.12,0,41.12,41.12,-1,-37237,5138,42375,-32099,0,-65,0,0,0,,65,-65
29,07/19/2018,14,3:15,3:30,,,0,42.96,42.96,0,-25912,11158,37070,-14754,0,0,0,0,0,,0,0
29,07/19/2018,15,3:30,3:45,,,0,42.96,42.96,0,-20260,17981,38241,-2279,0,0,0,0,0,,0,0
29,07/19/2018,16,3:45,4:00,,41.13,0,41.13,41.13,-1,-15373,25736,41109,10363,0,-716,0,0,0,,716,-716
29,07/19/2018,17,4:00,4:15,,41.11,0,41.11,41.11,-1,-21482,26727,48209,5245,0,-2732,0,0,0,,2732,-2732
29,07/19/2018,18,4:15,4:30,,41.1,0,41.1,41.1,-1,-24481,20912,45393,-3569,0,-2539,0,0,0,,2539,-2539
29,07/19/2018,19,4:30,4:45,42.36,41.1,0,42.36,42.36,1,-19864,11989,31853,-7875,0,-107,577,0,0,,684,470
29,07/19/2018,20,4:45,5:00,45.46,,0,45.46,45.46,1,-25668,18177,43845,-7491,0,0,7044,0,0,,7044,7044
29,07/19/2018,21,5:00,5:15,41.81,,0,41.81,41.81,1,-49141,6041,55182,-43100,0,0,252,0,0,,252,252
29,07/19/2018,22,5:15,5:30,,,0,42.96,42.96,0,-33442,12608,46050,-20834,0,0,0,0,0,,0,0
29,07/19/2018,23,5:30,5:45,,,0,42.96,42.96,0,-25915,11189,37104,-14726,0,0,0,0,0,,0,0
29,07/19/2018,24,5:45,6:00,,,0,42.96,42.96,0,-36672,12493,49165,-24179,0,0,0,0,0,,0,0
29,07/19/2018,25,6:00,6:15,,,0,42.89,42.89,0,-75754,54879,130633,-20875,0,0,0,0,0,,0,0
29,07/19/2018,26,6:15,6:30,,41.99,0,41.99,41.99,-1,-17724,39268,56992,21544,0,-1083,0,0,0,,1083,-1083
29,07/19/2018,27,6:30,6:45,47.15,41.83,0,47.15,47.15,1,-31494,12034,43528,-19460,0,-171,1568,0,0,,1739,1397
29,07/19/2018,28,6:45,7:00,49.77,,0,49.77,49.77,1,-76957,12643,89600,-64314,0,0,13978,0,0,,13978,13978
29,07/19/2018,29,7:00,7:15,47.03,35.22,0,35.22,35.22,-1,-32644,47345,79989,14701,0,-2458,11294,0,0,,13752,8836
29,07/19/2018,30,7:15,7:30,45.54,35.22,0,45.54,45.54,1,-28716,37354,66070,8638,0,-5743,385,0,0,,6128,-5358
29,07/19/2018,31,7:30,7:45,50.76,,0,50.76,50.76,1,-64224,29490,93714,-34734,0,0,9306,0,0,,9306,9306
29,07/19/2018,32,7:45,8:00,133.18,,0,133.18,133.18,1,-91312,29163,120475,-62149,0,0,45990,0,0,,45990,45990
29,07/19/2018,33,8:00,8:15,45.69,40.65,0,45.69,40.65,2,-37798,44191,81989,6393,0,-746,14943,0,0,,15689,14197
29,07/19/2018,34,8:15,8:30,48.43,,0,48.43,48.43,1,-42887,27067,69954,-15820,0,0,2522,0,0,,2522,2522
29,07/19/2018,35,8:30,8:45,65.79,,0,65.79,65.79,1,-68480,16394,84874,-52086,0,0,33136,0,0,,33136,33136
29,07/19/2018,36,8:45,9:00,50.76,,0,50.76,50.76,1,-78208,20597,98805,-57611,0,0,41093,0,0,,41093,41093
29,07/19/2018,37,9:00,9:15,55.39,,0,55.39,55.39,1,-72835,31241,104076,-41594,0,0,41063,0,0,,41063,41063
29,07/19/2018,38,9:15,9:30,48.47,,0,48.47,48.47,1,-66900,32555,99455,-34345,0,0,24840,0,0,,24840,24840
29,07/19/2018,39,9:30,9:45,47.42,,0,47.42,47.42,1,-61719,41118,102837,-20601,0,0,22477,0,0,,22477,22477
29,07/19/2018,40,9:45,10:00,46.6,,0,46.6,46.6,1,-53453,41283,94736,-12170,0,0,4877,0,0,,4877,4877
29,07/19/2018,41,10:00,10:15,55.02,,0,55.02,55.02,1,-83323,45161,128484,-38162,0,0,23380,0,0,,23380,23380
29,07/19/2018,42,10:15,10:30,50.74,,0,50.74,50.74,1,-72140,34720,106860,-37420,0,0,29706,0,0,,29706,29706
29,07/19/2018,43,10:30,10:45,49.76,,0,49.76,49.76,1,-64660,32998,97658,-31662,0,0,28112,0,0,,28112,28112
29,07/19/2018,44,10:45,11:00,46.6,,0,46.6,46.6,1,-61400,46369,107769,-15031,0,0,18836,0,0,,18836,18836
29,07/19/2018,45,11:00,11:15,42.6,40.9,0,40.9,40.9,-1,-67689,60974,128663,-6715,0,-357,5833,0,0,,6190,5476
29,07/19/2018,46,11:15,11:30,,40.94,0,40.94,40.94,-1,-57926,36643,94569,-21283,0,-452,0,0,0,,452,-452
29,07/19/2018,47,11:30,11:45,,,0,43.33,43.33,0,-57588,33405,90993,-24183,0,0,0,0,0,,0,0
29,07/19/2018,48,11:45,12:00,,,0,43.33,43.33,0,-53224,31085,84309,-22139,0,0,0,0,0,,0,0
29,07/19/2018,49,12:00,12:15,,,0,43.29,43.29,0,-60083,20178,80261,-39905,0,0,0,0,0,,0,0
29,07/19/2018,50,12:15,12:30,,,0,43.29,43.29,0,-71449,23301,94750,-48148,0,0,0,0,0,,0,0
29,07/19/2018,51,12:30,12:45,50.73,,0,50.73,50.73,1,-63458,20700,84158,-42758,0,0,1319,0,0,,1319,1319
29,07/19/2018,52,12:45,13:00,50.73,,0,50.73,50.73,1,-74971,22216,97187,-52755,0,0,6825,0,0,,6825,6825
29,07/19/2018,53,13:00,13:15,,,0,43.26,43.26,0,-53671,47572,101243,-6099,0,0,0,0,0,,0,0
29,07/19/2018,54,13:15,13:30,42.6,,0,42.6,42.6,1,-69086,28716,97802,-40370,0,0,766,0,0,,766,766
29,07/19/2018,55,13:30,13:45,45.05,,0,45.05,45.05,1,-81448,28604,110052,-52844,0,0,1141,0,0,,1141,1141
29,07/19/2018,56,13:45,14:00,50.72,,0,50.72,50.72,1,-92228,18502,110730,-73726,0,0,2171,0,0,,2171,2171
29,07/19/2018,57,14:00,14:15,145.02,,0,145.02,145.02,1,-103435,21531,124966,-81904,0,0,11167,0,0,,11167,11167
29,07/19/2018,58,14:15,14:30,145.02,,0,145.02,145.02,1,-89625,28783,118408,-60842,0,0,59541,0,0,,59541,59541
29,07/19/2018,59,14:30,14:45,50.72,,0,50.72,50.72,1,-72217,31964,104181,-40253,0,0,16635,0,0,,16635,16635
29,07/19/2018,60,14:45,15:00,50.72,,0,50.72,50.72,1,-83797,27669,111466,-56128,0,0,25744,0,0,,25744,25744
29,07/19/2018,61,15:00,15:15,46.37,40.6,0,40.6,40.6,-1,-63173,63597,126770,424,0,-761,12613,0,0,,13374,11852
29,07/19/2018,62,15:15,15:30,42.6,40.6,0,42.6,42.6,1,-69515,56290,125805,-13225,0,-63,1613,0,0,,1676,1550
29,07/19/2018,63,15:30,15:45,42.6,,0,42.6,42.6,1,-72388,68454,140842,-3934,0,0,3032,0,0,,3032,3032
29,07/19/2018,64,15:45,16:00,,,0,43.23,43.23,0,-72588,67380,139968,-5208,0,0,0,0,0,,0,0
29,07/19/2018,65,16:00,16:15,,38.07,0,38.07,38.07,-1,-47537,90005,137542,42468,0,-4844,0,0,0,,4844,-4844
29,07/19/2018,66,16:15,16:30,,39.42,0,39.42,39.42,-1,-55580,84312,139892,28732,0,-15167,0,0,0,,15167,-15167
29,07/19/2018,67,16:30,16:45,,40.65,0,40.65,40.65,-1,-58295,84759,143054,26464,0,-10828,0,0,0,,10828,-10828
29,07/19/2018,68,16:45,17:00,,40.32,0,40.32,40.32,-1,-77650,82837,160487,5187,0,-1633,0,0,0,,1633,-1633
29,07/19/2018,69,17:00,17:15,,40.16,0,40.16,40.16,-1,-46735,58981,105716,12246,0,-4206,0,0,0,,4206,-4206
29,07/19/2018,70,17:15,17:30,,42.03,0,42.03,42.03,-1,-50450,52500,102950,2050,0,-1788,0,0,0,,1788,-1788
29,07/19/2018,71,17:30,17:45,,,0,43.22,43.22,0,-50546,67244,117790,16698,0,-110,0,0,0,,110,-110
29,07/19/2018,72,17:45,18:00,,,0,43.24,43.24,0,-56439,72440,128879,16001,0,0,0,0,0,,0,0
29,07/19/2018,73,18:00,18:15,,,0,43.26,43.26,0,-90704,40693,131397,-50011,0,0,0,0,0,,0,0
29,07/19/2018,74,18:15,18:30,,,0,43.26,43.26,0,-48119,52701,100820,4582,0,0,0,0,0,,0,0
29,07/19/2018,75,18:30,18:45,,,0,43.24,43.24,0,-52273,60440,112713,8167,0,0,0,0,0,,0,0
29,07/19/2018,76,18:45,19:00,42.6,,0,42.6,42.6,1,-61132,60882,122014,-250,0,0,1281,0,0,,1281,1281
29,07/19/2018,77,19:00,19:15,42.6,,0,42.6,42.6,1,-42898,69810,112708,26912,0,0,432,0,0,,432,432
29,07/19/2018,78,19:15,19:30,,,0,43.28,43.28,0,-48927,63334,112261,14407,0,0,0,0,0,,0,0
29,07/19/2018,79,19:30,19:45,,,0,43.28,43.28,0,-53180,61273,114453,8093,0,0,0,0,0,,0,0
29,07/19/2018,80,19:45,20:00,,,0,43.28,43.28,0,-61654,70952,132606,9298,0,0,0,0,0,,0,0
29,07/19/2018,81,20:00,20:15,42.6,,0,42.6,42.6,1,-38122,44729,82851,6607,0,0,9,0,0,,9,9
29,07/19/2018,82,20:15,20:30,42.6,,0,42.6,42.6,1,-40137,43121,83258,2984,0,0,1200,0,0,,1200,1200
29,07/19/2018,83,20:30,20:45,,,0,43.31,43.31,0,-30626,55992,86618,25366,0,0,44,0,0,,44,44
29,07/19/2018,84,20:45,21:00,,40.39,0,40.39,40.39,-1,-33371,61733,95104,28362,0,-582,0,0,0,,582,-582
29,07/19/2018,85,21:00,21:15,46.73,40.39,0,46.73,46.73,1,-32799,16573,49372,-16226,0,-119,4105,0,0,,4224,3986
29,07/19/2018,86,21:15,21:30,42.6,,0,42.6,42.6,1,-32429,33277,65706,848,0,0,1020,0,0,,1020,1020
29,07/19/2018,87,21:30,21:45,,41.34,0,41.34,41.34,-1,-30973,41111,72084,10138,0,-2529,0,0,0,,2529,-2529
29,07/19/2018,88,21:45,22:00,,42.06,0,42.06,42.06,-1,-37314,32083,69397,-5231,0,-868,0,0,0,,868,-868
29,07/19/2018,89,22:00,22:15,,,0,43.37,43.37,0,-71977,11704,83681,-60273,0,0,0,0,0,,0,0
29,07/19/2018,90,22:15,22:30,,,0,43.37,43.37,0,-80542,8241,88783,-72301,0,0,0,0,0,,0,0
29,07/19/2018,91,22:30,22:45,,,0,43.37,43.37,0,-57143,16530,73673,-40613,0,0,0,0,0,,0,0
29,07/19/2018,92,22:45,23:00,,,0,43.36,43.36,0,-33457,20970,54427,-12487,0,0,0,0,0,,0,0
29,07/19/2018,93,23:00,23:15,50.77,41.88,0,50.77,41.88,2,-48282,17632,65914,-30650,0,-41,3328,0,0,,3369,3287
29,07/19/2018,94,23:15,23:30,42.6,41.94,0,41.94,41.94,-1,-31412,24740,56152,-6672,0,-38,521,0,0,,559,483
29,07/19/2018,95,23:30,23:45,,30.73,0,30.73,30.73,-1,-10510,56332,66842,45822,0,-6871,0,0,0,,6871,-6871
29,07/19/2018,96,23:45,0:00,,26.8,0,26.8,26.8,-1,-14602,65875,80477,51273,0,-39836,0,0,0,,39836,-39836
29,07/20/2018,1,0:00,0:15,136.12,38.64,0,136.12,136.12,1,-72346,26018,98364,-46328,0,-16145,11650,0,0,,27795,-4495
29,07/20/2018,2,0:15,0:30,48.43,38.64,0,48.43,48.43,1,-39460,18376,57836,-21084,0,-22,17255,0,0,,17277,17233
29,07/20/2018,3,0:30,0:45,48.43,42.29,0,42.29,42.29,-1,-29765,27918,57683,-1847,0,-554,105,0,0,,659,-449
29,07/20/2018,4,0:45,1:00,,41.49,0,41.49,41.49,-1,-31563,54259,85822,22696,0,-3534,0,0,0,,3534,-3534
29,07/20/2018,5,1:00,1:15,67.29,41.88,0,67.29,67.29,1,-62155,25120,87275,-37035,0,-1678,7151,0,0,,8829,5473
29,07/20/2018,6,1:15,1:30,67.29,,0,67.29,67.29,1,-38551,24297,62848,-14254,0,0,18919,0,0,,18919,18919
29,07/20/2018,7,1:30,1:45,42.64,,0,42.64,42.64,1,-35645,32093,67738,-3552,0,0,901,0,0,,901,901
29,07/20/2018,8,1:45,2:00,42.64,,0,42.64,42.64,1,-31654,43758,75412,12104,0,0,151,0,0,,151,151
29,07/20/2018,9,2:00,2:15,,,0,43.37,43.37,0,-33589,38345,71934,4756,0,0,0,0,0,,0,0
29,07/20/2018,10,2:15,2:30,,,0,43.37,43.37,0,-33812,46313,80125,12501,0,0,0,0,0,,0,0
29,07/20/2018,11,2:30,2:45,,,0,42.81,42.81,0,-33121,40454,73575,7333,0,0,0,0,0,,0,0
29,07/20/2018,12,2:45,3:00,,,0,42.81,42.81,0,-31460,47218,78678,15758,0,0,0,0,0,,0,0
29,07/20/2018,13,3:00,3:15,45.77,,0,45.77,45.77,1,-45421,39536,84957,-5885,0,0,587,0,0,,587,587
29,07/20/2018,14,3:15,3:30,42.64,,0,42.64,42.64,1,-25145,40820,65965,15675,0,0,336,0,0,,336,336
29,07/20/2018,15,3:30,3:45,,,0,42.81,42.81,0,-15088,51846,66934,36758,0,0,0,0,0,,0,0
29,07/20/2018,16,3:45,4:00,,38.64,0,38.64,38.64,-1,-16176,58286,74462,42110,0,-1648,0,0,0,,1648,-1648
29,07/20/2018,17,4:00,4:15,,34.64,0,34.64,34.64,-1,-31800,58131,89931,26331,0,-16463,0,0,0,,16463,-16463
29,07/20/2018,18,4:15,4:30,,34.64,0,34.64,34.64,-1,-39030,63609,102639,24579,0,-19271,0,0,0,,19271,-19271
29,07/20/2018,19,4:30,4:45,,,0,42.81,42.81,0,-35163,63229,98392,28066,0,-2834,0,0,0,,2834,-2834
29,07/20/2018,20,4:45,5:00,,,0,42.81,42.81,0,-28895,64704,93599,35809,0,0,0,0,0,,0,0
29,07/20/2018,21,5:00,5:15,,38.07,0,38.07,38.07,-1,-55452,74315,129767,18863,0,-6808,0,0,0,,6808,-6808
29,07/20/2018,22,5:15,5:30,,39.78,0,39.78,39.78,-1,-46082,59042,105124,12960,0,-13508,0,0,0,,13508,-13508
29,07/20/2018,23,5:30,5:45,,40.09,0,40.09,40.09,-1,-41184,46527,87711,5343,0,-2212,0,0,0,,2212,-2212
29,07/20/2018,24,5:45,6:00,,38.78,0,38.78,38.78,-1,-42819,48233,91052,5414,0,-1370,0,0,0,,1370,-1370
29,07/20/2018,25,6:00,6:15,,22.4,0,22.4,22.4,-1,-60332,126597,186929,66265,0,-33251,0,0,0,,33251,-33251
29,07/20/2018,26,6:15,6:30,,16.91,0,16.91,16.91,-1,-58182,96975,155157,38793,0,-58985,0,0,0,,58985,-58985
29,07/20/2018,27,6:30,6:45,51.14,16.91,0,51.14,51.14,1,-46849,39397,86246,-7452,0,-7595,2256,0,0,,9851,-5339
29,07/20/2018,28,6:45,7:00,47.73,,0,47.73,47.73,1,-65847,29296,95143,-36551,0,0,2615,0,0,,2615,2615
29,07/20/2018,29,7:00,7:15,47.73,16.6,0,16.6,16.6,-1,-40796,114276,155072,73480,0,-25604,416,0,0,,26020,-25188
29,07/20/2018,30,7:15,7:30,,32.3,0,32.3,32.3,-1,-43079,83212,126291,40133,0,-39564,0,0,0,,39564,-39564
29,07/20/2018,31,7:30,7:45,43.36,32.3,0,43.36,43.36,1,-40328,50563,90891,10235,0,-4087,4,0,0,,4091,-4083
29,07/20/2018,32,7:45,8:00,47.11,,0,47.11,47.11,1,-74454,53674,128128,-20780,0,0,2715,0,0,,2715,2715
29,07/20/2018,33,8:00,8:15,47.11,39.11,0,39.11,39.11,-1,-55082,83630,138712,28548,0,-2396,77,0,0,,2473,-2319
29,07/20/2018,34,8:15,8:30,,42.78,0,42.78,42.78,-1,-68422,56657,125079,-11765,0,-500,0,0,0,,500,-500
29,07/20/2018,35,8:30,8:45,,,0,43.05,43.05,0,-57688,42234,99922,-15454,0,0,0,0,0,,0,0
29,07/20/2018,36,8:45,9:00,43.11,,0,43.11,43.11,1,-66971,37784,104755,-29187,0,0,186,0,0,,186,186
29,07/20/2018,37,9:00,9:15,43.11,,0,43.11,43.11,1,-80592,35381,115973,-45211,0,0,472,0,0,,472,472
29,07/20/2018,38,9:15,9:30,46.14,,0,46.14,46.14,1,-87325,31650,118975,-55675,0,0,2284,0,0,,2284,2284
29,07/20/2018,39,9:30,9:45,43.11,,0,43.11,43.11,1,-84091,30837,114928,-53254,0,0,1400,0,0,,1400,1400
29,07/20/2018,40,9:45,10:00,43.11,,0,43.11,43.11,1,-70834,29628,100462,-41206,0,0,1666,0,0,,1666,1666
29,07/20/2018,41,10:00,10:15,116.6,,0,116.6,116.6,1,-104548,19186,123734,-85362,0,0,19447,0,0,,19447,19447
29,07/20/2018,42,10:15,10:30,47.11,,0,47.11,47.11,1,-80428,40067,120495,-40361,0,0,23458,0,0,,23458,23458
29,07/20/2018,43,10:30,10:45,46.07,,0,46.07,46.07,1,-72051,41629,113680,-30422,0,0,8321,0,0,,8321,8321
29,07/20/2018,44,10:45,11:00,,,0,37.25,37.25,0,-66751,50751,117502,-16000,0,0,6,0,0,,6,6
29,07/20/2018,45,11:00,11:15,,,0,37.2,37.2,0,-78174,54765,132939,-23409,0,0,0,0,0,,0,0
29,07/20/2018,46,11:15,11:30,,,0,37.2,37.2,0,-84275,50484,134759,-33791,0,0,0,0,0,,0,0
29,07/20/2018,47,11:30,11:45,,,0,37.2,37.2,0,-90702,68613,159315,-22089,0,0,0,0,0,,0,0
29,07/20/2018,48,11:45,12:00,,,0,37.2,37.2,0,-87549,85995,173544,-1554,0,0,0,0,0,,0,0
29,07/20/2018,49,12:00,12:15,,41.66,0,41.66,41.66,-1,-62917,77943,140860,15026,0,-894,0,0,0,,894,-894
29,07/20/2018,50,12:15,12:30,,39.69,0,39.69,39.69,-1,-56382,77133,133515,20751,0,-8166,0,0,0,,8166,-8166
29,07/20/2018,51,12:30,12:45,43.11,40.78,0,43.11,37.18,2,-47495,54581,102076,7086,0,-9320,59,0,0,,9379,-9261
29,07/20/2018,52,12:45,13:00,43.11,42.65,0,43.11,37.16,2,-49420,58577,107997,9157,0,-171,39,0,0,,210,-132
29,07/20/2018,53,13:00,13:15,43.11,42.63,0,43.11,37.13,2,-58390,57723,116113,-667,0,-1017,83,0,0,,1100,-934
29,07/20/2018,54,13:15,13:30,45.82,,0,45.82,45.82,1,-63987,42693,106680,-21294,0,0,1465,0,0,,1465,1465
29,07/20/2018,55,13:30,13:45,47.11,,0,47.11,47.11,1,-66521,51901,118422,-14620,0,0,6680,0,0,,6680,6680
29,07/20/2018,56,13:45,14:00,43.11,,0,43.11,43.11,1,-56765,48542,105307,-8223,0,0,2604,0,0,,2604,2604
29,07/20/2018,57,14:00,14:15,45.81,,0,45.81,45.81,1,-61708,54979,116687,-6729,0,0,1377,0,0,,1377,1377
29,07/20/2018,58,14:15,14:30,45.81,,0,45.81,45.81,1,-72300,57784,130084,-14516,0,0,3290,0,0,,3290,3290
29,07/20/2018,59,14:30,14:45,45.82,,0,45.82,45.82,1,-73371,63561,136932,-9810,0,0,1888,0,0,,1888,1888
29,07/20/2018,60,14:45,15:00,43.11,,0,43.11,43.11,1,-67398,70106,137504,2708,0,0,719,0,0,,719,719
29,07/20/2018,61,15:00,15:15,,40.78,0,40.78,40.78,-1,-50860,84871,135731,34011,0,-3305,0,0,0,,3305,-3305
29,07/20/2018,62,15:15,15:30,,39.7,0,39.7,39.7,-1,-61650,89242,150892,27592,0,-7619,0,0,0,,7619,-7619
29,07/20/2018,63,15:30,15:45,,,0,37.1,37.1,0,-54948,86183,141131,31235,0,-491,0,0,0,,491,-491
29,07/20/2018,64,15:45,16:00,,39.11,0,39.11,39.11,-1,-60414,82209,142623,21795,0,-4661,0,0,0,,4661,-4661
29,07/20/2018,65,16:00,16:15,,40.75,0,40.75,40.75,-1,-36552,60990,97542,24438,0,-9170,0,0,0,,9170,-9170
29,07/20/2018,66,16:15,16:30,,41.03,0,41.03,41.03,-1,-44081,62460,106541,18379,0,-9464,0,0,0,,9464,-9464
29,07/20/2018,67,16:30,16:45,,41.85,0,41.85,41.85,-1,-50929,59224,110153,8295,0,-3465,0,0,0,,3465,-3465
29,07/20/2018,68,16:45,17:00,,42.52,0,42.52,42.52,-1,-68221,58744,126965,-9477,0,-2,0,0,0,,2,-2
29,07/20/2018,69,17:00,17:15,,42.63,0,42.63,42.63,-1,-53400,52062,105462,-1338,0,-412,0,0,0,,412,-412
29,07/20/2018,70,17:15,17:30,,42.62,0,42.62,42.62,-1,-53617,58209,111826,4592,0,-414,0,0,0,,414,-414
29,07/20/2018,71,17:30,17:45,47.93,,0,47.93,47.93,1,-71714,59576,131290,-12138,0,0,1887,0,0,,1887,1887
29,07/20/2018,72,17:45,18:00,49.12,,0,49.12,49.12,1,-75932,63403,139335,-12529,0,0,12213,0,0,,12213,12213
29,07/20/2018,73,18:00,18:15,43.11,,0,43.11,43.11,1,-65420,64508,129928,-912,0,0,2771,0,0,,2771,2771
29,07/20/2018,74,18:15,18:30,43.11,42.29,0,42.29,42.29,-1,-52763,89338,142101,36575,0,-949,127,0,0,,1076,-822
29,07/20/2018,75,18:30,18:45,,,0,37.19,37.19,0,-57475,99277,156752,41802,0,0,0,0,0,,0,0
29,07/20/2018,76,18:45,19:00,,,0,37.19,37.19,0,-56013,85952,141965,29939,0,0,0,0,0,,0,0
29,07/20/2018,77,19:00,19:15,,,0,37.23,37.23,0,-34906,63370,98276,28464,0,0,0,0,0,,0,0
29,07/20/2018,78,19:15,19:30,,,0,37.23,37.23,0,-44622,54500,99122,9878,0,0,0,0,0,,0,0
29,07/20/2018,79,19:30,19:45,43.11,,0,43.11,43.11,1,-53231,48331,101562,-4900,0,0,1360,0,0,,1360,1360
29,07/20/2018,80,19:45,20:00,46.34,,0,46.34,46.34,1,-61229,48986,110215,-12243,0,0,4271,0,0,,4271,4271
29,07/20/2018,81,20:00,20:15,51.14,,0,51.14,51.14,1,-90841,50394,141235,-40447,0,0,13575,0,0,,13575,13575
29,07/20/2018,82,20:15,20:30,43.11,,0,43.11,43.11,1,-92171,50905,143076,-41266,0,0,5904,0,0,,5904,5904
29,07/20/2018,83,20:30,20:45,,,0,37.26,37.26,0,-70633,59117,129750,-11516,0,0,12,0,0,,12,12
29,07/20/2018,84,20:45,21:00,,42.29,0,42.29,42.29,-1,-63377,67064,130441,3687,0,-644,0,0,0,,644,-644
29,07/20/2018,85,21:00,21:15,85.12,42.66,0,85.12,37.24,2,-99067,25299,124366,-73768,0,-327,12725,0,0,,13052,12398
29,07/20/2018,86,21:15,21:30,46.1,,0,46.1,46.1,1,-73000,35105,108105,-37895,0,0,4987,0,0,,4987,4987
29,07/20/2018,87,21:30,21:45,,,0,37.27,37.27,0,-62965,39244,102209,-23721,0,0,0,0,0,,0,0
29,07/20/2018,88,21:45,22:00,44.26,,0,44.26,44.26,1,-84035,40356,124391,-43679,0,0,1066,0,0,,1066,1066
29,07/20/2018,89,22:00,22:15,43.11,,0,43.11,43.11,1,-73467,30910,104377,-42557,0,0,515,0,0,,515,515
29,07/20/2018,90,22:15,22:30,,,0,37.28,37.28,0,-61759,45428,107187,-16331,0,0,0,0,0,,0,0
29,07/20/2018,91,22:30,22:45,,40.67,0,40.67,40.67,-1,-51596,70273,121869,18677,0,-4348,0,0,0,,4348,-4348
29,07/20/2018,92,22:45,23:00,,39.11,0,39.11,39.11,-1,-48067,77128,125195,29061,0,-22357,0,0,0,,22357,-22357
29,07/20/2018,93,23:00,23:15,43.11,40.78,0,43.11,37.27,2,-60994,65183,126177,4189,0,-14561,408,0,0,,14969,-14153
29,07/20/2018,94,23:15,23:30,43.11,35.82,0,43.11,35.82,2,-54201,78544,132745,24343,0,-3375,617,0,0,,3992,-2758
29,07/20/2018,95,23:30,23:45,,35.11,0,35.11,35.11,-1,-41751,96570,138321,54819,0,-13038,0,0,0,,13038,-13038
29,07/20/2018,96,23:45,0:00,,16.6,0,16.6,16.6,-1,-39056,114074,153130,75018,0,-39918,0,0,0,,39918,-39918
30,07/21/2018,1,0:00,0:15,101.15,35.58,0,101.15,35.58,2,-84606,47991,132597,-36615,0,-18675,7233,0,0,,25908,-11442
30,07/21/2018,2,0:15,0:30,43.4,,0,43.4,43.4,1,-54771,61467,116238,6696,0,0,1565,0,0,,1565,1565
30,07/21/2018,3,0:30,0:45,,42.2,0,42.2,42.2,-1,-36914,42565,79479,5651,0,-93,0,0,0,,93,-93
30,07/21/2018,4,0:45,1:00,,39.4,0,39.4,39.4,-1,-36362,36410,72772,48,0,-1368,0,0,0,,1368,-1368
30,07/21/2018,5,1:00,1:15,42.57,28.72,0,42.57,28.72,2,-45906,68535,114441,22629,0,-16181,3,0,0,,16184,-16178
30,07/21/2018,6,1:15,1:30,43.4,31.42,0,43.4,31.42,2,-42300,71711,114011,29411,0,-3311,261,0,0,,3572,-3050
30,07/21/2018,7,1:30,1:45,,27.16,0,27.16,27.16,-1,-38908,78927,117835,40019,0,-18674,0,0,0,,18674,-18674
30,07/21/2018,8,1:45,2:00,,38.19,0,38.19,38.19,-1,-56084,77372,133456,21288,0,-11318,0,0,0,,11318,-11318
30,07/21/2018,9,2:00,2:15,,33.1,0,33.1,33.1,-1,-42534,124165,166699,81631,0,-9775,0,0,0,,9775,-9775
30,07/21/2018,10,2:15,2:30,,39.4,0,39.4,39.4,-1,-41649,97433,139082,55784,0,-346,0,0,0,,346,-346
30,07/21/2018,11,2:30,2:45,,37.58,0,37.58,37.58,-1,-36125,89042,125167,52917,0,-1743,0,0,0,,1743,-1743
30,07/21/2018,12,2:45,3:00,,39.4,0,39.4,39.4,-1,-34238,95856,130094,61618,0,-179,0,0,0,,179,-179
30,07/21/2018,13,3:00,3:15,,39.4,0,39.4,39.4,-1,-30697,80887,111584,50190,0,-429,0,0,0,,429,-429
30,07/21/2018,14,3:15,3:30,,,0,41.43,41.43,0,-42144,86555,128699,44411,0,0,0,0,0,,0,0
30,07/21/2018,15,3:30,3:45,,,0,41.45,41.45,0,-46012,87164,133176,41152,0,0,0,0,0,,0,0
30,07/21/2018,16,3:45,4:00,,,0,41.45,41.45,0,-45848,70150,115998,24302,0,0,0,0,0,,0,0
30,07/21/2018,17,4:00,4:15,,,0,41.4,41.4,0,-42042,66259,108301,24217,0,0,0,0,0,,0,0
30,07/21/2018,18,4:15,4:30,,,0,41.39,41.39,0,-47182,61754,108936,14572,0,0,0,0,0,,0,0
30,07/21/2018,19,4:30,4:45,,,0,41.4,41.4,0,-61908,62364,124272,456,0,0,0,0,0,,0,0
30,07/21/2018,20,4:45,5:00,,,0,41.65,41.65,0,-47337,54430,101767,7093,0,0,0,0,0,,0,0
30,07/21/2018,21,5:00,5:15,43.4,,0,43.4,43.4,1,-62029,41540,103569,-20489,0,0,52,0,0,,52,52
30,07/21/2018,22,5:15,5:30,43.4,,0,43.4,43.4,1,-60147,59528,119675,-619,0,0,1071,0,0,,1071,1071
30,07/21/2018,23,5:30,5:45,,,0,41.64,41.64,0,-53670,68894,122564,15224,0,0,0,0,0,,0,0
30,07/21/2018,24,5:45,6:00,,,0,41.64,41.64,0,-47378,61299,108677,13921,0,0,0,0,0,,0,0
30,07/21/2018,25,6:00,6:15,,,0,41.63,41.63,0,-34741,85759,120500,51018,0,0,0,0,0,,0,0
30,07/21/2018,26,6:15,6:30,,,0,41.62,41.62,0,-34529,82686,117215,48157,0,0,0,0,0,,0,0
30,07/21/2018,27,6:30,6:45,,,0,41.57,41.57,0,-57633,63981,121614,6348,0,0,0,0,0,,0,0
30,07/21/2018,28,6:45,7:00,,,0,41.57,41.57,0,-40149,48616,88765,8467,0,0,0,0,0,,0,0
30,07/21/2018,29,7:00,7:15,,41.91,0,41.91,41.91,-1,-35380,79144,114524,43764,0,-51,0,0,0,,51,-51
30,07/21/2018,30,7:15,7:30,,41.9,0,41.9,41.9,-1,-38965,63967,102932,25002,0,-352,0,0,0,,352,-352
30,07/21/2018,31,7:30,7:45,,,0,41.7,41.7,0,-32745,43932,76677,11187,0,0,0,0,0,,0,0
30,07/21/2018,32,7:45,8:00,,,0,41.68,41.68,0,-19584,64708,84292,45124,0,0,0,0,0,,0,0
30,07/21/2018,33,8:00,8:15,,,0,41.95,41.95,0,-72076,57097,129173,-14979,0,0,0,0,0,,0,0
30,07/21/2018,34,8:15,8:30,,,0,41.93,41.93,0,-50745,43433,94178,-7312,0,0,0,0,0,,0,0
30,07/21/2018,35,8:30,8:45,,,0,41.92,41.92,0,-47697,40286,87983,-7411,0,0,0,0,0,,0,0
30,07/21/2018,36,8:45,9:00,45.39,,0,45.39,45.39,1,-54644,24292,78936,-30352,0,0,156,0,0,,156,156
30,07/21/2018,37,9:00,9:15,47.06,,0,47.06,47.06,1,-78929,45391,124320,-33538,0,0,1333,0,0,,1333,1333
30,07/21/2018,38,9:15,9:30,51.26,,0,51.26,51.26,1,-71979,36639,108618,-35340,0,0,17548,0,0,,17548,17548
30,07/21/2018,39,9:30,9:45,46.06,,0,46.06,46.06,1,-74912,31841,106753,-43071,0,0,10572,0,0,,10572,10572
30,07/21/2018,40,9:45,10:00,84.75,,0,84.75,84.75,1,-73400,25799,99199,-47601,0,0,23798,0,0,,23798,23798
30,07/21/2018,41,10:00,10:15,51.26,,0,51.26,51.26,1,-83079,41515,124594,-41564,0,0,38405,0,0,,38405,38405
30,07/21/2018,42,10:15,10:30,46.11,40.71,0,40.71,40.71,-1,-61327,55814,117141,-5513,0,-57,18767,0,0,,18824,18710
30,07/21/2018,43,10:30,10:45,46.11,39.85,0,39.85,39.85,-1,-52736,53570,106306,834,0,-690,893,0,0,,1583,203
30,07/21/2018,44,10:45,11:00,,42.25,0,42.25,42.25,-1,-50180,51924,102104,1744,0,-400,0,0,0,,400,-400
30,07/21/2018,45,11:00,11:15,,,0,36.01,36.01,0,-84981,39381,124362,-45600,0,0,0,0,0,,0,0
30,07/21/2018,46,11:15,11:30,,,0,36.02,36.02,0,-94955,54479,149434,-40476,0,0,0,0,0,,0,0
30,07/21/2018,47,11:30,11:45,,,0,36.03,36.03,0,-79969,55448,135417,-24521,0,0,0,0,0,,0,0
30,07/21/2018,48,11:45,12:00,45.75,,0,45.75,45.75,1,-71459,68622,140081,-2837,0,0,1333,0,0,,1333,1333
30,07/21/2018,49,12:00,12:15,47.38,,0,47.38,47.38,1,-87809,49534,137343,-38275,0,0,11797,0,0,,11797,11797
30,07/21/2018,50,12:15,12:30,41.02,40.33,0,40.33,40.33,-1,-81837,70441,152278,-11396,0,-343,4200,0,0,,4543,3857
30,07/21/2018,51,12:30,12:45,45.7,,0,45.7,45.7,1,-80675,59789,140464,-20886,0,0,1839,0,0,,1839,1839
30,07/21/2018,52,12:45,13:00,43.06,,0,43.06,43.06,1,-74931,67813,142744,-7118,0,0,1726,0,0,,1726,1726
30,07/21/2018,53,13:00,13:15,141.02,,0,141.02,141.02,1,-126646,49809,176455,-76837,0,0,24651,0,0,,24651,24651
30,07/21/2018,54,13:15,13:30,57.02,,0,57.02,57.02,1,-120485,61800,182285,-58685,0,0,27047,0,0,,27047,27047
30,07/21/2018,55,13:30,13:45,51.26,,0,51.26,51.26,1,-153523,58833,212356,-94690,0,0,3120,0,0,,3120,3120
30,07/21/2018,56,13:45,14:00,71.82,,0,71.82,71.82,1,-203962,69090,273052,-134872,0,0,12137,0,0,,12137,12137
30,07/21/2018,57,14:00,14:15,141.02,,0,141.02,141.02,1,-192512,55852,248364,-136660,0,0,82874,0,0,,82874,82874
30,07/21/2018,58,14:15,14:30,195,,0,195,195,1,-171772,59967,231739,-111805,0,0,110559,8750,0,,119309,119309
30,07/21/2018,59,14:30,14:45,195,33.39,0,33.39,33.39,-1,-148036,113852,261888,-34184,0,-67,35272,8750,0,,44089,43955
30,07/21/2018,60,14:45,15:00,,,0,41.39,41.39,0,-155474,81681,237155,-73793,0,0,0,0,0,,0,0
30,07/21/2018,61,15:00,15:15,,,0,41.39,41.39,0,-49303,80071,129374,30768,0,0,0,0,0,,0,0
30,07/21/2018,62,15:15,15:30,,,0,41.39,41.39,0,-63465,65241,128706,1776,0,0,0,0,0,,0,0
30,07/21/2018,63,15:30,15:45,49.85,,0,49.85,49.85,1,-79067,54240,133307,-24827,0,0,4090,0,0,,4090,4090
30,07/21/2018,64,15:45,16:00,47.06,,0,47.06,47.06,1,-91125,55256,146381,-35869,0,0,12615,0,0,,12615,12615
30,07/21/2018,65,16:00,16:15,,,0,41.48,41.48,0,-70796,69743,140539,-1053,0,0,1877,0,0,,1877,1877
30,07/21/2018,66,16:15,16:30,47.06,,0,47.06,47.06,1,-78839,64374,143213,-14465,0,0,2139,0,0,,2139,2139
30,07/21/2018,67,16:30,16:45,51.26,,0,51.26,51.26,1,-96163,59325,155488,-36838,0,0,23969,0,0,,23969,23969
30,07/21/2018,68,16:45,17:00,51.26,,0,51.26,51.26,1,-98442,50843,149285,-47599,0,0,33965,0,0,,33965,33965
30,07/21/2018,69,17:00,17:15,47.73,,0,47.73,47.73,1,-93580,53635,147215,-39945,0,0,23465,0,0,,23465,23465
30,07/21/2018,70,17:15,17:30,51.26,,0,51.26,51.26,1,-99301,51207,150508,-48094,0,0,2660,0,0,,2660,2660
30,07/21/2018,71,17:30,17:45,141.02,,0,141.02,141.02,1,-111974,31192,143166,-80782,0,0,28459,0,0,,28459,28459
30,07/21/2018,72,17:45,18:00,141.02,,0,141.02,141.02,1,-91730,36019,127749,-55711,0,0,48992,0,0,,48992,48992
30,07/21/2018,73,18:00,18:15,141.02,35.06,0,35.06,35.06,-1,-57904,84601,142505,26697,0,-4803,6214,0,0,,11017,1411
30,07/21/2018,74,18:15,18:30,,,0,41.65,41.65,0,-71021,57432,128453,-13589,0,-963,0,0,0,,963,-963
30,07/21/2018,75,18:30,18:45,47.06,,0,47.06,47.06,1,-74682,56852,131534,-17830,0,0,4649,0,0,,4649,4649
30,07/21/2018,76,18:45,19:00,45.76,,0,45.76,45.76,1,-73859,48108,121967,-25751,0,0,6190,0,0,,6190,6190
30,07/21/2018,77,19:00,19:15,,,0,41.64,41.64,0,-59153,65297,124450,6144,0,0,1605,0,0,,1605,1605
30,07/21/2018,78,19:15,19:30,43.06,,0,43.06,43.06,1,-70582,55710,126292,-14872,0,0,234,0,0,,234,234
30,07/21/2018,79,19:30,19:45,51.26,,0,51.26,51.26,1,-77506,43301,120807,-34205,0,0,15499,0,0,,15499,15499
30,07/21/2018,80,19:45,20:00,48.35,,0,48.35,48.35,1,-80182,32667,112849,-47515,0,0,25459,0,0,,25459,25459
30,07/21/2018,81,20:00,20:15,66.26,,0,66.26,66.26,1,-97937,50811,148748,-47126,0,0,21592,0,0,,21592,21592
30,07/21/2018,82,20:15,20:30,51.26,,0,51.26,51.26,1,-98738,52460,151198,-46278,0,0,34695,0,0,,34695,34695
30,07/21/2018,83,20:30,20:45,51.26,,0,51.26,51.26,1,-93671,47491,141162,-46180,0,0,17818,0,0,,17818,17818
30,07/21/2018,84,20:45,21:00,46.67,,0,46.67,46.67,1,-89067,53252,142319,-35815,0,0,11159,0,0,,11159,11159
30,07/21/2018,85,21:00,21:15,47.06,,0,47.06,47.06,1,-85539,55345,140884,-30194,0,0,1840,0,0,,1840,1840
30,07/21/2018,86,21:15,21:30,45.65,,0,45.65,45.65,1,-90122,45158,135280,-44964,0,0,2792,0,0,,2792,2792
30,07/21/2018,87,21:30,21:45,66.26,,0,66.26,66.26,1,-92800,40711,133511,-52089,0,0,23709,0,0,,23709,23709
30,07/21/2018,88,21:45,22:00,73.02,,0,73.02,73.02,1,-109843,36976,146819,-72867,0,0,47167,0,0,,47167,47167
30,07/21/2018,89,22:00,22:15,165.93,,0,165.93,165.93,1,-113910,28196,142106,-85714,0,0,65263,0,0,,65263,65263
30,07/21/2018,90,22:15,22:30,98.94,,0,98.94,98.94,1,-106885,36523,143408,-70362,0,0,75968,0,0,,75968,75968
30,07/21/2018,91,22:30,22:45,51.16,,0,51.16,51.16,1,-78093,40499,118592,-37594,0,0,35673,0,0,,35673,35673
30,07/21/2018,92,22:45,23:00,47.17,,0,47.17,47.17,1,-63782,49864,113646,-13918,0,0,15424,0,0,,15424,15424
30,07/21/2018,93,23:00,23:15,45.64,,0,45.64,45.64,1,-58166,50523,108689,-7643,0,0,3088,0,0,,3088,3088
30,07/21/2018,94,23:15,23:30,42.92,,0,42.92,42.92,1,-59263,55602,114865,-3661,0,0,258,0,0,,258,258
30,07/21/2018,95,23:30,23:45,41.02,,0,41.02,41.02,1,-55920,77679,133599,21759,0,0,34,0,0,,34,34
30,07/21/2018,96,23:45,0:00,,31.08,0,31.08,31.08,-1,-40914,80661,121575,39747,0,-14249,0,0,0,,14249,-14249
30,07/22/2018,1,0:00,0:15,142.89,36.83,0,142.89,142.89,1,-87044,35995,123039,-51049,0,-9764,10065,0,0,,19829,301
30,07/22/2018,2,0:15,0:30,142.89,42.26,0,142.89,41.19,2,-63192,40093,103285,-23099,0,-11,32716,0,0,,32727,32705
30,07/22/2018,3,0:30,0:45,142.89,39.06,0,39.06,39.06,-1,-66738,60097,126835,-6641,0,-241,512,0,0,,753,271
30,07/22/2018,4,0:45,1:00,116.26,,0,116.26,116.26,1,-123142,48862,172004,-74280,0,0,12774,0,0,,12774,12774
30,07/22/2018,5,1:00,1:15,51.26,,0,51.26,51.26,1,-47168,36615,83783,-10553,0,0,19473,0,0,,19473,19473
30,07/22/2018,6,1:15,1:30,47.5,,0,47.5,47.5,1,-42344,30510,72854,-11834,0,0,19926,0,0,,19926,19926
30,07/22/2018,7,1:30,1:45,47.5,40.19,0,40.19,40.19,-1,-37245,48157,85402,10912,0,-720,5373,0,0,,6093,4653
30,07/22/2018,8,1:45,2:00,,40.97,0,40.97,40.97,-1,-38500,56750,95250,18250,0,-336,0,0,0,,336,-336
30,07/22/2018,9,2:00,2:15,45.38,,0,45.38,45.38,1,-35305,31220,66525,-4085,0,0,981,0,0,,981,981
30,07/22/2018,10,2:15,2:30,,,0,42.1,42.1,0,-20784,31823,52607,11039,0,0,53,0,0,,53,53
30,07/22/2018,11,2:30,2:45,,,0,42.1,42.1,0,-13734,37502,51236,23768,0,0,0,0,0,,0,0
30,07/22/2018,12,2:45,3:00,,,0,42.11,42.11,0,-13509,35082,48591,21573,0,0,0,0,0,,0,0
30,07/22/2018,13,3:00,3:15,,,0,42.08,42.08,0,-21352,40683,62035,19331,0,0,0,0,0,,0,0
30,07/22/2018,14,3:15,3:30,,,0,42.08,42.08,0,-22117,31402,53519,9285,0,0,0,0,0,,0,0
30,07/22/2018,15,3:30,3:45,,,0,42.08,42.08,0,-23398,27177,50575,3779,0,0,0,0,0,,0,0
30,07/22/2018,16,3:45,4:00,45.4,,0,45.4,45.4,1,-28942,23589,52531,-5353,0,0,1563,0,0,,1563,1563
30,07/22/2018,17,4:00,4:15,45.38,,0,45.38,45.38,1,-31022,30259,61281,-763,0,0,2847,0,0,,2847,2847
30,07/22/2018,18,4:15,4:30,43.06,,0,43.06,43.06,1,-34582,28976,63558,-5606,0,0,2371,0,0,,2371,2371
30,07/22/2018,19,4:30,4:45,43.06,,0,43.06,43.06,1,-27848,33737,61585,5889,0,0,1505,0,0,,1505,1505
30,07/22/2018,20,4:45,5:00,43.06,,0,43.06,43.06,1,-33684,35903,69587,2219,0,0,1188,0,0,,1188,1188
30,07/22/2018,21,5:00,5:15,66.26,,0,66.26,66.26,1,-67553,27952,95505,-39601,0,0,24243,0,0,,24243,24243
30,07/22/2018,22,5:15,5:30,47.06,,0,47.06,47.06,1,-50041,36272,86313,-13769,0,0,19611,0,0,,19611,19611
30,07/22/2018,23,5:30,5:45,43.06,,0,43.06,43.06,1,-38055,32217,70272,-5838,0,0,4678,0,0,,4678,4678
30,07/22/2018,24,5:45,6:00,42.25,41.75,0,41.75,41.75,-1,-33035,39966,73001,6931,0,-44,763,0,0,,807,719
30,07/22/2018,25,6:00,6:15,42.68,41.74,0,42.68,42.68,1,-43880,38713,82593,-5167,0,-57,184,0,0,,241,127
30,07/22/2018,26,6:15,6:30,42.68,,0,42.68,42.68,1,-30872,39820,70692,8948,0,0,311,0,0,,311,311
30,07/22/2018,27,6:30,6:45,,,0,42,42,0,-31559,48816,80375,17257,0,0,0,0,0,,0,0
30,07/22/2018,28,6:45,7:00,,,0,41.98,41.98,0,-26551,55179,81730,28628,0,0,0,0,0,,0,0
30,07/22/2018,29,7:00,7:15,,40.47,0,40.47,40.47,-1,-46313,58487,104800,12174,0,-1374,0,0,0,,1374,-1374
30,07/22/2018,30,7:15,7:30,,39.13,0,39.13,39.13,-1,-33201,51778,84979,18577,0,-3408,0,0,0,,3408,-3408
30,07/22/2018,31,7:30,7:45,,39.13,0,39.13,39.13,-1,-17915,53985,71900,36070,0,-3316,0,0,0,,3316,-3316
30,07/22/2018,32,7:45,8:00,,,0,40.89,40.89,0,-21239,73736,94975,52497,0,-74,0,0,0,,74,-74
30,07/22/2018,33,8:00,8:15,,39.13,0,39.13,39.13,-1,-31373,34414,65787,3041,0,-459,0,0,0,,459,-459
30,07/22/2018,34,8:15,8:30,,39.13,0,39.13,39.13,-1,-29783,39470,69253,9687,0,-2104,0,0,0,,2104,-2104
30,07/22/2018,35,8:30,8:45,,41.84,0,41.84,41.84,-1,-44880,35322,80202,-9558,0,-953,0,0,0,,953,-953
30,07/22/2018,36,8:45,9:00,43.13,,0,43.13,43.13,1,-34332,47139,81471,12807,0,0,364,0,0,,364,364
30,07/22/2018,37,9:00,9:15,,,0,41.1,41.1,0,-105268,33070,138338,-72198,0,0,0,0,0,,0,0
30,07/22/2018,38,9:15,9:30,,,0,41.1,41.1,0,-105619,34579,140198,-71040,0,0,0,0,0,,0,0
30,07/22/2018,39,9:30,9:45,,,0,41.07,41.07,0,-111854,29900,141754,-81954,0,0,0,0,0,,0,0
30,07/22/2018,40,9:45,10:00,,,0,41.05,41.05,0,-112948,29790,142738,-83158,0,0,0,0,0,,0,0
30,07/22/2018,41,10:00,10:15,,,0,41.09,41.09,0,-56151,33574,89725,-22577,0,0,0,0,0,,0,0
30,07/22/2018,42,10:15,10:30,,,0,41.08,41.08,0,-74059,24436,98495,-49623,0,0,0,0,0,,0,0
30,07/22/2018,43,10:30,10:45,42.72,,0,42.72,42.72,1,-78414,26429,104843,-51985,0,0,344,0,0,,344,344
30,07/22/2018,44,10:45,11:00,42.67,,0,42.67,42.67,1,-76792,27109,103901,-49683,0,0,234,0,0,,234,234
30,07/22/2018,45,11:00,11:15,47.13,,0,47.13,47.13,1,-75783,32472,108255,-43311,0,0,2022,0,0,,2022,2022
30,07/22/2018,46,11:15,11:30,47.13,,0,47.13,47.13,1,-67344,40889,108233,-26455,0,0,2628,0,0,,2628,2628
30,07/22/2018,47,11:30,11:45,43.13,,0,43.13,43.13,1,-75645,24987,100632,-50658,0,0,1362,0,0,,1362,1362
30,07/22/2018,48,11:45,12:00,,,0,41.1,41.1,0,-63120,23940,87060,-39180,0,0,0,0,0,,0,0
30,07/22/2018,49,12:00,12:15,,,0,41.16,41.16,0,-69554,56079,125633,-13475,0,0,0,0,0,,0,0
30,07/22/2018,50,12:15,12:30,,,0,41.16,41.16,0,-59412,42789,102201,-16623,0,0,0,0,0,,0,0
30,07/22/2018,51,12:30,12:45,51.32,,0,51.32,51.32,1,-69982,38535,108517,-31447,0,0,5748,0,0,,5748,5748
30,07/22/2018,52,12:45,13:00,46.12,,0,46.12,46.12,1,-87168,41990,129158,-45178,0,0,9074,0,0,,9074,9074
30,07/22/2018,53,13:00,13:15,,,0,40.97,40.97,0,-47796,93901,141697,46105,0,0,272,0,0,,272,272
30,07/22/2018,54,13:15,13:30,,,0,40.97,40.97,0,-49325,52621,101946,3296,0,0,0,0,0,,0,0
30,07/22/2018,55,13:30,13:45,,,0,40.98,40.98,0,-49399,42112,91511,-7287,0,0,0,0,0,,0,0
30,07/22/2018,56,13:45,14:00,43.13,,0,43.13,43.13,1,-51150,40138,91288,-11012,0,0,565,0,0,,565,565
30,07/22/2018,57,14:00,14:15,51.32,,0,51.32,51.32,1,-54879,33195,88074,-21684,0,0,9903,0,0,,9903,9903
30,07/22/2018,58,14:15,14:30,47.13,,0,47.13,47.13,1,-52256,44582,96838,-7674,0,0,15351,0,0,,15351,15351
30,07/22/2018,59,14:30,14:45,48.77,,0,48.77,48.77,1,-59557,41875,101432,-17682,0,0,4673,0,0,,4673,4673
30,07/22/2018,60,14:45,15:00,53.02,,0,53.02,53.02,1,-78263,43301,121564,-34962,0,0,31472,0,0,,31472,31472
30,07/22/2018,61,15:00,15:15,43.13,41.74,0,41.74,41.74,-1,-61282,60447,121729,-835,0,-424,12194,0,0,,12618,11770
30,07/22/2018,62,15:15,15:30,45.07,41.73,0,45.07,40.93,2,-60452,49453,109905,-10999,0,-58,3375,0,0,,3433,3317
30,07/22/2018,63,15:30,15:45,43.12,,0,43.12,43.12,1,-71062,70939,142001,-123,0,0,3869,0,0,,3869,3869
30,07/22/2018,64,15:45,16:00,42.69,,0,42.69,42.69,1,-65910,80831,146741,14921,0,0,842,0,0,,842,842
30,07/22/2018,65,16:00,16:15,,37.93,0,37.93,37.93,-1,-40566,86709,127275,46143,0,-1238,0,0,0,,1238,-1238
30,07/22/2018,66,16:15,16:30,,35.13,0,35.13,35.13,-1,-47385,105076,152461,57691,0,-9425,0,0,0,,9425,-9425
30,07/22/2018,67,16:30,16:45,,39.13,0,39.13,39.13,-1,-49062,74921,123983,25859,0,-4701,0,0,0,,4701,-4701
30,07/22/2018,68,16:45,17:00,43.13,39.13,0,43.13,43.13,1,-48901,53704,102605,4803,0,-134,205,0,0,,339,71
30,07/22/2018,69,17:00,17:15,,38.38,0,38.38,38.38,-1,-84418,106766,191184,22348,0,-3731,0,0,0,,3731,-3731
30,07/22/2018,70,17:15,17:30,,38.78,0,38.78,38.78,-1,-47139,100470,147609,53331,0,-11245,0,0,0,,11245,-11245
30,07/22/2018,71,17:30,17:45,,,0,41.19,41.19,0,-56615,74595,131210,17980,0,-1776,0,0,0,,1776,-1776
30,07/22/2018,72,17:45,18:00,68.64,,0,68.64,68.64,1,-89319,54718,144037,-34601,0,0,6951,0,0,,6951,6951
30,07/22/2018,73,18:00,18:15,116.32,39.41,0,116.32,39.41,2,-65952,69688,135640,3736,0,-133,32284,0,0,,32417,32151
30,07/22/2018,74,18:15,18:30,116.32,39.27,0,39.27,39.27,-1,-45651,95776,141427,50125,0,-1828,1225,0,0,,3053,-603
30,07/22/2018,75,18:30,18:45,,,0,41.19,41.19,0,-53648,75006,128654,21358,0,0,0,0,0,,0,0
30,07/22/2018,76,18:45,19:00,45.38,,0,45.38,45.38,1,-64999,55740,120739,-9259,0,0,2043,0,0,,2043,2043
30,07/22/2018,77,19:00,19:15,45.38,21.92,0,21.92,21.92,-1,-19566,79238,98804,59672,0,-16246,155,0,0,,16401,-16091
30,07/22/2018,78,19:15,19:30,,39.13,0,39.13,39.13,-1,-39849,65539,105388,25690,0,-14191,0,0,0,,14191,-14191
30,07/22/2018,79,19:30,19:45,46.05,39.13,0,46.05,46.05,1,-55415,55518,110933,103,0,-197,116,0,0,,313,-81
30,07/22/2018,80,19:45,20:00,51.32,,0,51.32,51.32,1,-75034,43499,118533,-31535,0,0,15711,0,0,,15711,15711
30,07/22/2018,81,20:00,20:15,43.13,40.78,0,43.13,40.78,2,-35672,72256,107928,36584,0,-546,6873,0,0,,7419,6327
30,07/22/2018,82,20:15,20:30,,,0,41.67,41.67,0,-48386,57300,105686,8914,0,0,0,0,0,,0,0
30,07/22/2018,83,20:30,20:45,,,0,41.69,41.69,0,-51417,55947,107364,4530,0,0,0,0,0,,0,0
30,07/22/2018,84,20:45,21:00,46.21,,0,46.21,46.21,1,-52514,49336,101850,-3178,0,0,652,0,0,,652,652
30,07/22/2018,85,21:00,21:15,101.12,,0,101.12,101.12,1,-86716,31489,118205,-55227,0,0,25354,0,0,,25354,25354
30,07/22/2018,86,21:15,21:30,56.12,,0,56.12,56.12,1,-83424,29964,113388,-53460,0,0,49488,0,0,,49488,49488
30,07/22/2018,87,21:30,21:45,51.32,,0,51.32,51.32,1,-83210,30354,113564,-52856,0,0,47098,0,0,,47098,47098
30,07/22/2018,88,21:45,22:00,143.12,,0,143.12,143.12,1,-108363,24330,132693,-84033,0,0,56793,0,0,,56793,56793
30,07/22/2018,89,22:00,22:15,150.82,,0,150.82,150.82,1,-114390,24261,138651,-90129,0,0,83551,0,0,,83551,83551
30,07/22/2018,90,22:15,22:30,106.84,,0,106.84,106.84,1,-87015,27459,114474,-59556,0,0,73018,0,0,,73018,73018
30,07/22/2018,91,22:30,22:45,,,0,42.69,42.69,0,-62762,47157,109919,-15605,0,0,15102,0,0,,15102,15102
30,07/22/2018,92,22:45,23:00,46.96,,0,46.96,46.96,1,-61278,62714,123992,1436,0,0,241,0,0,,241,241
30,07/22/2018,93,23:00,23:15,147.54,,0,147.54,147.54,1,-95790,30019,125809,-65771,0,0,33060,0,0,,33060,33060
30,07/22/2018,94,23:15,23:30,56.12,,0,56.12,56.12,1,-71978,38456,110434,-33522,0,0,39502,0,0,,39502,39502
30,07/22/2018,95,23:30,23:45,46.79,,0,46.79,46.79,1,-56914,38966,95880,-17948,0,0,9931,0,0,,9931,9931
30,07/22/2018,96,23:45,0:00,46.79,42.33,0,42.33,42.33,-1,-52180,52883,105063,703,0,-53,1070,0,0,,1123,1017
30,07/23/2018,1,0:00,0:15,47.13,42.11,0,47.13,42.11,2,-49830,47797,97627,-2033,0,-70,1315,0,0,,1385,1245
30,07/23/2018,2,0:15,0:30,42.68,,0,42.68,42.68,1,-48688,43538,92226,-5150,0,0,414,0,0,,414,414
30,07/23/2018,3,0:30,0:45,,35.41,0,35.41,35.41,-1,-25624,40296,65920,14672,0,-4203,0,0,0,,4203,-4203
30,07/23/2018,4,0:45,1:00,,31.17,0,31.17,31.17,-1,-13338,49543,62881,36205,0,-28378,0,0,0,,28378,-28378
30,07/23/2018,5,1:00,1:15,47.13,31.17,0,47.13,47.13,1,-59978,18330,78308,-41648,0,-4936,1780,0,0,,6716,-3156
30,07/23/2018,6,1:15,1:30,47.4,,0,47.4,47.4,1,-44752,25398,70150,-19354,0,0,1520,0,0,,1520,1520
30,07/23/2018,7,1:30,1:45,,41.85,0,41.85,41.85,-1,-34975,34164,69139,-811,0,-11,0,0,0,,11,-11
30,07/23/2018,8,1:45,2:00,,37.63,0,37.63,37.63,-1,-23201,49121,72322,25920,0,-8188,0,0,0,,8188,-8188
30,07/23/2018,9,2:00,2:15,43.6,40.54,0,43.6,40.54,2,-45479,34828,80307,-10651,0,-4177,1178,0,0,,5355,-2999
30,07/23/2018,10,2:15,2:30,48.54,,0,48.54,48.54,1,-43274,23366,66640,-19908,0,0,10864,0,0,,10864,10864
30,07/23/2018,11,2:30,2:45,43.81,,0,43.81,43.81,1,-42719,23641,66360,-19078,0,0,9580,0,0,,9580,9580
30,07/23/2018,12,2:45,3:00,43.13,,0,43.13,43.13,1,-45782,25356,71138,-20426,0,0,4593,0,0,,4593,4593
30,07/23/2018,13,3:00,3:15,52.87,,0,52.87,52.87,1,-54871,17750,72621,-37121,0,0,17969,0,0,,17969,17969
30,07/23/2018,14,3:15,3:30,50.24,,0,50.24,50.24,1,-48873,23006,71879,-25867,0,0,25657,0,0,,25657,25657
30,07/23/2018,15,3:30,3:45,43.13,,0,43.13,43.13,1,-33429,23395,56824,-10034,0,0,8346,0,0,,8346,8346
30,07/23/2018,16,3:45,4:00,42.69,,0,42.69,42.69,1,-34604,24668,59272,-9936,0,0,452,0,0,,452,452
30,07/23/2018,17,4:00,4:15,43.69,,0,43.69,43.69,1,-68366,27045,95411,-41321,0,0,2101,0,0,,2101,2101
30,07/23/2018,18,4:15,4:30,43.13,,0,43.13,43.13,1,-59682,25336,85018,-34346,0,0,2785,0,0,,2785,2785
30,07/23/2018,19,4:30,4:45,43.13,39.13,0,39.13,39.13,-1,-31193,33109,64302,1916,0,-127,47,0,0,,174,-80
30,07/23/2018,20,4:45,5:00,,39.13,0,39.13,39.13,-1,-28190,26072,54262,-2118,0,-451,0,0,0,,451,-451
30,07/23/2018,21,5:00,5:15,51.26,,0,51.26,51.26,1,-111513,32346,143859,-79167,0,0,3418,0,0,,3418,3418
30,07/23/2018,22,5:15,5:30,47.13,,0,47.13,47.13,1,-87022,42272,129294,-44750,0,0,3463,0,0,,3463,3463
30,07/23/2018,23,5:30,5:45,53.2,,0,53.2,53.2,1,-64060,25468,89528,-38592,0,0,11955,0,0,,11955,11955
30,07/23/2018,24,5:45,6:00,47.13,31.17,0,47.13,31.17,2,-49663,24475,74138,-25188,0,-572,15790,0,0,,16362,15218
30,07/23/2018,25,6:00,6:15,47.13,31.25,0,31.25,31.25,-1,-70174,60551,130725,-9623,0,-3948,915,0,0,,4863,-3033
30,07/23/2018,26,6:15,6:30,,42.21,0,42.21,42.21,-1,-32507,38937,71444,6430,0,-286,0,0,0,,286,-286
30,07/23/2018,27,6:30,6:45,51.34,,0,51.34,51.34,1,-40657,35685,76342,-4972,0,0,2381,0,0,,2381,2381
30,07/23/2018,28,6:45,7:00,51.34,,0,51.34,51.34,1,-57342,39358,96700,-17984,0,0,13098,0,0,,13098,13098
30,07/23/2018,29,7:00,7:15,51.34,39.74,0,39.74,39.74,-1,-76714,65521,142235,-11193,0,-1321,2741,0,0,,4062,1420
30,07/23/2018,30,7:15,7:30,,41.51,0,41.51,41.51,-1,-25693,57854,83547,32161,0,-322,0,0,0,,322,-322
30,07/23/2018,31,7:30,7:45,47.2,,0,47.2,47.2,1,-53397,54047,107444,650,0,0,794,0,0,,794,794
30,07/23/2018,32,7:45,8:00,51.34,,0,51.34,51.34,1,-85303,61461,146764,-23842,0,0,19114,0,0,,19114,19114
30,07/23/2018,33,8:00,8:15,44.64,,0,44.64,44.64,1,-50527,41547,92074,-8980,0,0,4655,0,0,,4655,4655
30,07/23/2018,34,8:15,8:30,51.34,,0,51.34,51.34,1,-64685,37611,102296,-27074,0,0,14409,0,0,,14409,14409
30,07/23/2018,35,8:30,8:45,51.34,,0,51.34,51.34,1,-71600,37484,109084,-34116,0,0,21969,0,0,,21969,21969
30,07/23/2018,36,8:45,9:00,51.34,,0,51.34,51.34,1,-72862,38963,111825,-33899,0,0,23071,0,0,,23071,23071
30,07/23/2018,37,9:00,9:15,43.2,42.38,0,42.38,42.38,-1,-58140,39629,97769,-18511,0,-7,8614,0,0,,8621,8607
30,07/23/2018,38,9:15,9:30,,42.38,0,42.38,42.38,-1,-54957,50483,105440,-4474,0,-605,0,0,0,,605,-605
30,07/23/2018,39,9:30,9:45,,42.38,0,42.38,42.38,-1,-54706,60787,115493,6081,0,-345,0,0,0,,345,-345
30,07/23/2018,40,9:45,10:00,,42.38,0,42.38,42.38,-1,-56051,66812,122863,10761,0,-38,0,0,0,,38,-38
30,07/23/2018,41,10:00,10:15,,,0,42.69,42.69,0,-47771,50142,97913,2371,0,0,0,0,0,,0,0
30,07/23/2018,42,10:15,10:30,,,0,42.63,42.63,0,-32525,44286,76811,11761,0,0,0,0,0,,0,0
30,07/23/2018,43,10:30,10:45,,42.36,0,42.36,42.36,-1,-44482,45169,89651,687,0,-93,0,0,0,,93,-93
30,07/23/2018,44,10:45,11:00,,42.33,0,42.33,42.33,-1,-51728,22683,74411,-29045,0,-13,0,0,0,,13,-13
30,07/23/2018,45,11:00,11:15,43,,0,43,43,1,-78641,27426,106067,-51215,0,0,506,0,0,,506,506
30,07/23/2018,46,11:15,11:30,47.2,,0,47.2,47.2,1,-83847,28041,111888,-55806,0,0,2249,0,0,,2249,2249
30,07/23/2018,47,11:30,11:45,51.34,,0,51.34,51.34,1,-80154,28036,108190,-52118,0,0,10555,0,0,,10555,10555
30,07/23/2018,48,11:45,12:00,51.34,,0,51.34,51.34,1,-68963,31278,100241,-37685,0,0,27560,0,0,,27560,27560
30,07/23/2018,49,12:00,12:15,49.22,,0,49.22,49.22,1,-67872,30835,98707,-37037,0,0,24344,0,0,,24344,24344
30,07/23/2018,50,12:15,12:30,,,0,42.66,42.66,0,-59142,31114,90256,-28028,0,0,4132,0,0,,4132,4132
30,07/23/2018,51,12:30,12:45,59.8,,0,59.8,59.8,1,-69290,34703,103993,-34587,0,0,8532,0,0,,8532,8532
30,07/23/2018,52,12:45,13:00,47.2,,0,47.2,47.2,1,-64486,37681,102167,-26805,0,0,14529,0,0,,14529,14529
30,07/23/2018,53,13:00,13:15,47.2,42.38,0,42.38,42.38,-1,-44697,81165,125862,36468,0,-217,632,0,0,,849,415
30,07/23/2018,54,13:15,13:30,,,0,42.65,42.65,0,-57886,72467,130353,14581,0,0,0,0,0,,0,0
30,07/23/2018,55,13:30,13:45,42.91,,0,42.91,42.91,1,-68278,67050,135328,-1228,0,0,160,0,0,,160,160
30,07/23/2018,56,13:45,14:00,43.2,,0,43.2,43.2,1,-68035,62434,130469,-5601,0,0,1923,0,0,,1923,1923
30,07/23/2018,57,14:00,14:15,48.39,,0,48.39,48.39,1,-66176,48626,114802,-17550,0,0,5626,0,0,,5626,5626
30,07/23/2018,58,14:15,14:30,47.2,,0,47.2,47.2,1,-70935,48654,119589,-22281,0,0,10158,0,0,,10158,10158
30,07/23/2018,59,14:30,14:45,43.2,,0,43.2,43.2,1,-62800,54350,117150,-8450,0,0,5365,0,0,,5365,5365
30,07/23/2018,60,14:45,15:00,48.39,,0,48.39,48.39,1,-68764,42771,111535,-25993,0,0,6561,0,0,,6561,6561
30,07/23/2018,61,15:00,15:15,51.34,,0,51.34,51.34,1,-76255,34384,110639,-41871,0,0,15267,0,0,,15267,15267
30,07/23/2018,62,15:15,15:30,52.38,,0,52.38,52.38,1,-92480,33406,125886,-59074,0,0,30494,0,0,,30494,30494
30,07/23/2018,63,15:30,15:45,66.4,,0,66.4,66.4,1,-114300,34478,148778,-79822,0,0,44118,0,0,,44118,44118
30,07/23/2018,64,15:45,16:00,54.65,,0,54.65,54.65,1,-108089,32711,140800,-75378,0,0,45716,0,0,,45716,45716
30,07/23/2018,65,16:00,16:15,,,0,42.59,42.59,0,-76212,30849,107061,-45363,0,0,11475,0,0,,11475,11475
30,07/23/2018,66,16:15,16:30,51.95,,0,51.95,51.95,1,-103913,30726,134639,-73187,0,0,12756,0,0,,12756,12756
30,07/23/2018,67,16:30,16:45,55.65,,0,55.65,55.65,1,-102036,32690,134726,-69346,0,0,43267,0,0,,43267,43267
30,07/23/2018,68,16:45,17:00,66.4,,0,66.4,66.4,1,-117710,35655,153365,-82055,0,0,52486,0,0,,52486,52486
30,07/23/2018,69,17:00,17:15,51.34,,0,51.34,51.34,1,-65664,49824,115488,-15840,0,0,32528,0,0,,32528,32528
30,07/23/2018,70,17:15,17:30,51.34,,0,51.34,51.34,1,-76405,46255,122660,-30150,0,0,14486,0,0,,14486,14486
30,07/23/2018,71,17:30,17:45,66.4,,0,66.4,66.4,1,-96882,43724,140606,-53158,0,0,28240,0,0,,28240,28240
30,07/23/2018,72,17:45,18:00,97.22,,0,97.22,97.22,1,-106942,43105,150047,-63837,0,0,51899,0,0,,51899,51899
30,07/23/2018,73,18:00,18:15,66.4,,0,66.4,66.4,1,-106384,27309,133693,-79075,0,0,50763,0,0,,50763,50763
30,07/23/2018,74,18:15,18:30,51.49,,0,51.49,51.49,1,-87487,33996,121483,-53491,0,0,19780,0,0,,19780,19780
30,07/23/2018,75,18:30,18:45,66.4,,0,66.4,66.4,1,-93551,31553,125104,-61998,0,0,23972,0,0,,23972,23972
30,07/23/2018,76,18:45,19:00,81.22,,0,81.22,81.22,1,-98759,30588,129347,-68171,0,0,55359,0,0,,55359,55359
30,07/23/2018,77,19:00,19:15,51.34,,0,51.34,51.34,1,-78515,25457,103972,-53058,0,0,33754,0,0,,33754,33754
30,07/23/2018,78,19:15,19:30,47.2,,0,47.2,47.2,1,-92570,24953,117523,-67617,0,0,1223,0,0,,1223,1223
30,07/23/2018,79,19:30,19:45,149.22,,0,149.22,149.22,1,-103387,21292,124679,-82095,0,0,35042,0,0,,35042,35042
30,07/23/2018,80,19:45,20:00,66.4,,0,66.4,66.4,1,-95231,28605,123836,-66626,0,0,58879,0,0,,58879,58879
30,07/23/2018,81,20:00,20:15,66.4,,0,66.4,66.4,1,-90474,23351,113825,-67123,0,0,60401,0,0,,60401,60401
30,07/23/2018,82,20:15,20:30,66.4,,0,66.4,66.4,1,-99809,28304,128113,-71505,0,0,60927,0,0,,60927,60927
30,07/23/2018,83,20:30,20:45,66.4,,0,66.4,66.4,1,-90759,35038,125797,-55721,0,0,56423,0,0,,56423,56423
30,07/23/2018,84,20:45,21:00,43.16,,0,43.16,43.16,1,-88591,41785,130376,-46806,0,0,14526,0,0,,14526,14526
30,07/23/2018,85,21:00,21:15,66.4,,0,66.4,66.4,1,-76009,21019,97028,-54990,0,0,7881,0,0,,7881,7881
30,07/23/2018,86,21:15,21:30,49.36,,0,49.36,49.36,1,-70120,23470,93590,-46650,0,0,18499,0,0,,18499,18499
30,07/23/2018,87,21:30,21:45,51.34,,0,51.34,51.34,1,-70749,28976,99725,-41773,0,0,10983,0,0,,10983,10983
30,07/23/2018,88,21:45,22:00,51.34,,0,51.34,51.34,1,-69553,26185,95738,-43368,0,0,16259,0,0,,16259,16259
30,07/23/2018,89,22:00,22:15,53.86,,0,53.86,53.86,1,-111772,9920,121692,-101852,0,0,12137,0,0,,12137,12137
30,07/23/2018,90,22:15,22:30,47.2,,0,47.2,47.2,1,-115877,15377,131254,-100500,0,0,4282,0,0,,4282,4282
30,07/23/2018,91,22:30,22:45,51.34,,0,51.34,51.34,1,-98228,12327,110555,-85901,0,0,5078,0,0,,5078,5078
30,07/23/2018,92,22:45,23:00,43,,0,43,43,1,-66750,23314,90064,-43436,0,0,2122,0,0,,2122,2122
30,07/23/2018,93,23:00,23:15,150.22,,0,150.22,150.22,1,-138581,14884,153465,-123697,0,0,37431,0,0,,37431,37431
30,07/23/2018,94,23:15,23:30,113.22,,0,113.22,113.22,1,-94595,43022,137617,-51573,0,0,51843,0,0,,51843,51843
30,07/23/2018,95,23:30,23:45,,,0,42.61,42.61,0,-65764,60669,126433,-5095,0,0,661,0,0,,661,661
30,07/23/2018,96,23:45,0:00,,39.09,0,39.09,39.09,-1,-50342,77309,127651,26967,0,-2027,0,0,0,,2027,-2027
30,07/24/2018,1,0:00,0:15,149.12,39.09,0,149.12,149.12,1,-117664,12171,129835,-105493,0,-823,28744,0,0,,29567,27921
30,07/24/2018,2,0:15,0:30,63.12,,0,63.12,63.12,1,-87286,34278,121564,-53008,0,0,38954,0,0,,38954,38954
30,07/24/2018,3,0:30,0:45,63.12,38.92,0,38.92,38.92,-1,-57695,52244,109939,-5451,0,-24,555,0,0,,579,531
30,07/24/2018,4,0:45,1:00,,37.78,0,37.78,37.78,-1,-50244,76691,126935,26447,0,-5903,0,0,0,,5903,-5903
30,07/24/2018,5,1:00,1:15,66.4,41.46,0,66.4,66.4,1,-86112,26782,112894,-59330,0,-2308,7983,0,0,,10291,5675
30,07/24/2018,6,1:15,1:30,66.4,,0,66.4,66.4,1,-92686,43519,136205,-49167,0,0,39145,0,0,,39145,39145
30,07/24/2018,7,1:30,1:45,66.4,41.62,0,41.62,41.62,-1,-74551,59984,134535,-14567,0,-8,4243,0,0,,4251,4235
30,07/24/2018,8,1:45,2:00,,40.78,0,40.78,40.78,-1,-65669,71734,137403,6065,0,-464,0,0,0,,464,-464
30,07/24/2018,9,2:00,2:15,46.92,,0,46.92,46.92,1,-85405,65188,150593,-20217,0,0,2587,0,0,,2587,2587
30,07/24/2018,10,2:15,2:30,42.92,41.13,0,42.92,41.13,2,-72533,80507,153040,7974,0,-176,2085,0,0,,2261,1909
30,07/24/2018,11,2:30,2:45,,39.51,0,39.51,39.51,-1,-59254,84328,143582,25074,0,-1996,0,0,0,,1996,-1996
30,07/24/2018,12,2:45,3:00,,41.58,0,41.58,41.58,-1,-58613,70053,128666,11440,0,-4332,0,0,0,,4332,-4332
30,07/24/2018,13,3:00,3:15,,41.39,0,41.39,41.39,-1,-65261,56361,121622,-8900,0,-2401,0,0,0,,2401,-2401
30,07/24/2018,14,3:15,3:30,42.92,,0,42.92,42.92,1,-60161,47930,108091,-12231,0,0,1698,0,0,,1698,1698
30,07/24/2018,15,3:30,3:45,,,0,41.45,41.45,0,-53077,53702,106779,625,0,0,0,0,0,,0,0
30,07/24/2018,16,3:45,4:00,,41.47,0,41.47,41.47,-1,-54754,53697,108451,-1057,0,-200,0,0,0,,200,-200
30,07/24/2018,17,4:00,4:15,42.12,41.78,0,42.12,42.12,1,-69645,58616,128261,-11029,0,-338,5,0,0,,343,-333
30,07/24/2018,18,4:15,4:30,42.92,,0,42.92,42.92,1,-64043,56039,120082,-8004,0,0,736,0,0,,736,736
30,07/24/2018,19,4:30,4:45,42.83,,0,42.83,42.83,1,-62903,55473,118376,-7430,0,0,1781,0,0,,1781,1781
30,07/24/2018,20,4:45,5:00,44.12,,0,44.12,44.12,1,-60422,46927,107349,-13495,0,0,4149,0,0,,4149,4149
30,07/24/2018,21,5:00,5:15,51.1,,0,51.1,51.1,1,-82557,45117,127674,-37440,0,0,7869,0,0,,7869,7869
30,07/24/2018,22,5:15,5:30,51.1,,0,51.1,51.1,1,-84560,32785,117345,-51775,0,0,33613,0,0,,33613,33613
30,07/24/2018,23,5:30,5:45,47.53,,0,47.53,47.53,1,-79692,45659,125351,-34033,0,0,19080,0,0,,19080,19080
30,07/24/2018,24,5:45,6:00,42.92,,0,42.92,42.92,1,-94393,62250,156643,-32143,0,0,787,0,0,,787,787
30,07/24/2018,25,6:00,6:15,,41.26,0,41.26,41.26,-1,-71119,103212,174331,32093,0,-261,0,0,0,,261,-261
30,07/24/2018,26,6:15,6:30,,,0,41.12,41.12,0,-89519,73438,162957,-16081,0,0,0,0,0,,0,0
30,07/24/2018,27,6:30,6:45,116.68,,0,116.68,116.68,1,-128509,51271,179780,-77238,0,0,9882,0,0,,9882,9882
30,07/24/2018,28,6:45,7:00,149.12,,0,149.12,149.12,1,-136059,31834,167893,-104225,0,0,58595,0,0,,58595,58595
30,07/24/2018,29,7:00,7:15,42.12,27.65,0,42.12,27.65,2,-66210,102156,168366,35946,0,-5172,19531,0,0,,24703,14359
30,07/24/2018,30,7:15,7:30,,41.57,0,41.57,41.57,-1,-69413,70053,139466,640,0,-2950,0,0,0,,2950,-2950
30,07/24/2018,31,7:30,7:45,43.2,,0,43.2,43.2,1,-96583,55639,152222,-40944,0,0,739,0,0,,739,739
30,07/24/2018,32,7:45,8:00,68.56,,0,68.56,68.56,1,-125659,46393,172052,-79266,0,0,14921,0,0,,14921,14921
30,07/24/2018,33,8:00,8:15,68.56,32,0,32,32,-1,-63572,76442,140014,12870,0,-6296,1834,0,0,,8130,-4462
30,07/24/2018,34,8:15,8:30,,,0,46.98,46.98,0,-96425,79272,175697,-17153,0,-110,0,0,0,,110,-110
30,07/24/2018,35,8:30,8:45,,,0,46.98,46.98,0,-127764,68149,195913,-59615,0,0,0,0,0,,0,0
30,07/24/2018,36,8:45,9:00,47.2,,0,47.2,47.2,1,-148751,63459,212210,-85292,0,0,1346,0,0,,1346,1346
30,07/24/2018,37,9:00,9:15,47.2,41.03,0,47.2,41.03,2,-115697,60241,175938,-55456,0,-288,706,0,0,,994,418
30,07/24/2018,38,9:15,9:30,81.12,,0,81.12,81.12,1,-133244,64986,198230,-68258,0,0,23635,0,0,,23635,23635
30,07/24/2018,39,9:30,9:45,149.12,,0,149.12,149.12,1,-120621,60349,180970,-60272,0,0,64774,0,0,,64774,64774
30,07/24/2018,40,9:45,10:00,51.38,,0,51.38,51.38,1,-99799,63454,163253,-36345,0,0,23204,0,0,,23204,23204
30,07/24/2018,41,10:00,10:15,51.38,,0,51.38,51.38,1,-102321,69729,172050,-32592,0,0,15226,0,0,,15226,15226
30,07/24/2018,42,10:15,10:30,51.38,,0,51.38,51.38,1,-115456,76829,192285,-38627,0,0,9812,0,0,,9812,9812
30,07/24/2018,43,10:30,10:45,43.2,,0,43.2,43.2,1,-105168,80251,185419,-24917,0,0,7118,0,0,,7118,7118
30,07/24/2018,44,10:45,11:00,51.38,,0,51.38,51.38,1,-111924,76521,188445,-35403,0,0,14317,0,0,,14317,14317
30,07/24/2018,45,11:00,11:15,51.38,,0,51.38,51.38,1,-143374,64367,207741,-79007,0,0,26371,0,0,,26371,26371
30,07/24/2018,46,11:15,11:30,59.28,,0,59.28,59.28,1,-134919,71212,206131,-63707,0,0,45533,0,0,,45533,45533
30,07/24/2018,47,11:30,11:45,68.56,,0,68.56,68.56,1,-139849,83142,222991,-56707,0,0,54685,0,0,,54685,54685
30,07/24/2018,48,11:45,12:00,51.12,,0,51.12,51.12,1,-131502,93915,225417,-37587,0,0,34844,0,0,,34844,34844
30,07/24/2018,49,12:00,12:15,56.98,,0,56.98,56.98,1,-137461,81566,219027,-55895,0,0,35906,0,0,,35906,35906
30,07/24/2018,50,12:15,12:30,66.68,,0,66.68,66.68,1,-141988,74262,216250,-67726,0,0,47099,0,0,,47099,47099
30,07/24/2018,51,12:30,12:45,66.68,,0,66.68,66.68,1,-132496,74299,206795,-58197,0,0,31782,0,0,,31782,31782
30,07/24/2018,52,12:45,13:00,51.35,,0,51.35,51.35,1,-134682,72807,207489,-61875,0,0,39078,0,0,,39078,39078
30,07/24/2018,53,13:00,13:15,51.35,42.44,0,51.35,42.44,2,-97866,77278,175144,-20588,0,-94,7459,0,0,,7553,7365
30,07/24/2018,54,13:15,13:30,66.68,,0,66.68,66.68,1,-121772,74155,195927,-47617,0,0,31005,0,0,,31005,31005
30,07/24/2018,55,13:30,13:45,56.8,,0,56.8,56.8,1,-132004,75281,207285,-56723,0,0,49577,0,0,,49577,49577
30,07/24/2018,56,13:45,14:00,148.12,,0,148.12,148.12,1,-190056,75606,265662,-114450,0,0,60845,0,0,,60845,60845
30,07/24/2018,57,14:00,14:15,148.12,,0,148.12,148.12,1,-174875,99010,273885,-75865,0,0,80234,0,0,,80234,80234
30,07/24/2018,58,14:15,14:30,39.12,,0,39.12,39.12,1,-138894,105989,244883,-32905,0,0,17212,0,0,,17212,17212
30,07/24/2018,59,14:30,14:45,50.71,,0,50.71,50.71,1,-155999,94591,250590,-61408,0,0,4758,0,0,,4758,4758
30,07/24/2018,60,14:45,15:00,51.35,,0,51.35,51.35,1,-153973,92503,246476,-61470,0,0,4456,0,0,,4456,4456
30,07/24/2018,61,15:00,15:15,51.35,,0,51.35,51.35,1,-141201,122986,264187,-18215,0,0,13293,0,0,,13293,13293
30,07/24/2018,62,15:15,15:30,51.35,,0,51.35,51.35,1,-144035,114250,258285,-29785,0,0,17715,0,0,,17715,17715
30,07/24/2018,63,15:30,15:45,51.99,,0,51.99,51.99,1,-148993,100837,249830,-48156,0,0,32973,0,0,,32973,32973
30,07/24/2018,64,15:45,16:00,51.63,,0,51.63,51.63,1,-143628,90549,234177,-53079,0,0,40953,0,0,,40953,40953
30,07/24/2018,65,16:00,16:15,44.33,39.78,0,46.77,39.78,2,-79045,127552,206597,48507,0,-2023,16683,0,0,,18706,14660
30,07/24/2018,66,16:15,16:30,44.33,41.02,0,41.02,41.02,-1,-78591,116641,195232,38050,0,-303,3,0,0,,306,-300
30,07/24/2018,67,16:30,16:45,,,0,46.76,46.76,0,-80347,99890,180237,19543,0,0,0,0,0,,0,0
30,07/24/2018,68,16:45,17:00,,,0,46.76,46.76,0,-88895,87479,176374,-1416,0,0,0,0,0,,0,0
30,07/24/2018,69,17:00,17:15,43.33,,0,43.33,43.33,1,-93103,82210,175313,-10893,0,0,272,0,0,,272,272
30,07/24/2018,70,17:15,17:30,55.74,,0,55.74,55.74,1,-110473,69355,179828,-41118,0,0,17273,0,0,,17273,17273
30,07/24/2018,71,17:30,17:45,51.12,,0,51.12,51.12,1,-122572,74067,196639,-48505,0,0,21383,0,0,,21383,21383
30,07/24/2018,72,17:45,18:00,47.2,,0,47.2,47.2,1,-121927,84812,206739,-37115,0,0,17099,0,0,,17099,17099
30,07/24/2018,73,18:00,18:15,51.38,,0,51.38,51.38,1,-120348,91140,211488,-29208,0,0,19787,0,0,,19787,19787
30,07/24/2018,74,18:15,18:30,43.19,,0,43.19,43.19,1,-110054,96057,206111,-13997,0,0,6057,0,0,,6057,6057
30,07/24/2018,75,18:30,18:45,51.38,,0,51.38,51.38,1,-119857,91569,211426,-28288,0,0,15267,0,0,,15267,15267
30,07/24/2018,76,18:45,19:00,51.38,,0,51.38,51.38,1,-139186,99221,238407,-39965,0,0,31626,0,0,,31626,31626
30,07/24/2018,77,19:00,19:15,148.12,,0,148.12,148.12,1,-174751,71720,246471,-103031,0,0,65458,0,0,,65458,65458
30,07/24/2018,78,19:15,19:30,71.12,,0,71.12,71.12,1,-149556,93030,242586,-56526,0,0,66073,0,0,,66073,66073
30,07/24/2018,79,19:30,19:45,51.38,,0,51.38,51.38,1,-142736,95107,237843,-47629,0,0,37059,0,0,,37059,37059
30,07/24/2018,80,19:45,20:00,68.56,,0,68.56,68.56,1,-140822,86867,227689,-53955,0,0,40319,0,0,,40319,40319
30,07/24/2018,81,20:00,20:15,149.12,,0,149.12,149.12,1,-153176,35537,188713,-117639,0,0,63134,0,0,,63134,63134
30,07/24/2018,82,20:15,20:30,149.12,,0,149.12,149.12,1,-147744,44794,192538,-102950,0,0,78977,0,0,,78977,78977
30,07/24/2018,83,20:30,20:45,49.67,,0,49.67,49.67,1,-123407,52788,176195,-70619,0,0,20256,0,0,,20256,20256
30,07/24/2018,84,20:45,21:00,47.2,,0,47.2,47.2,1,-118208,56490,174698,-61718,0,0,13619,0,0,,13619,13619
30,07/24/2018,85,21:00,21:15,97.15,,0,97.15,97.15,1,-108266,55021,163287,-53245,0,0,14315,0,0,,14315,14315
30,07/24/2018,86,21:15,21:30,107.15,,0,107.15,107.15,1,-108847,55390,164237,-53457,0,0,46548,0,0,,46548,46548
30,07/24/2018,87,21:30,21:45,47.2,,0,47.2,47.2,1,-98696,57177,155873,-41519,0,0,23582,0,0,,23582,23582
30,07/24/2018,88,21:45,22:00,51.38,,0,51.38,51.38,1,-104830,56522,161352,-48308,0,0,13903,0,0,,13903,13903
30,07/24/2018,89,22:00,22:15,150.15,,0,150.15,150.15,1,-129500,51774,181274,-77726,0,0,47774,0,0,,47774,47774
30,07/24/2018,90,22:15,22:30,71.15,,0,71.15,71.15,1,-130195,54560,184755,-75635,0,0,74021,0,0,,74021,74021
30,07/24/2018,91,22:30,22:45,51.38,,0,51.38,51.38,1,-100799,66672,167471,-34127,0,0,33528,0,0,,33528,33528
30,07/24/2018,92,22:45,23:00,43.2,,0,43.2,43.2,1,-92663,78744,171407,-13919,0,0,2085,0,0,,2085,2085
30,07/24/2018,93,23:00,23:15,148.15,,0,148.15,148.15,1,-161350,65826,227176,-95524,0,0,39272,0,0,,39272,39272
30,07/24/2018,94,23:15,23:30,80.15,,0,80.15,80.15,1,-132069,82623,214692,-49446,0,0,56869,0,0,,56869,56869
30,07/24/2018,95,23:30,23:45,,,0,42.57,42.57,0,-94380,75768,170148,-18612,0,0,8799,0,0,,8799,8799
30,07/24/2018,96,23:45,0:00,,,0,42.57,42.57,0,-96630,97492,194122,862,0,0,0,0,0,,0,0
30,07/25/2018,1,0:00,0:15,152.02,,0,152.02,152.02,1,-114609,23338,137947,-91271,0,0,15591,0,0,,15591,15591
30,07/25/2018,2,0:15,0:30,47.2,,0,47.2,47.2,1,-75137,34238,109375,-40899,0,0,10041,0,0,,10041,10041
30,07/25/2018,3,0:30,0:45,,,0,48.48,48.48,0,-62738,39398,102136,-23340,0,0,0,0,0,,0,0
30,07/25/2018,4,0:45,1:00,,42.07,0,42.07,42.07,-1,-57804,53440,111244,-4364,0,-843,0,0,0,,843,-843
30,07/25/2018,5,1:00,1:15,51.31,41.75,0,51.31,51.31,1,-97581,49952,147533,-47629,0,-603,5346,0,0,,5949,4743
30,07/25/2018,6,1:15,1:30,45.41,,0,45.41,45.41,1,-77251,66196,143447,-11055,0,0,6575,0,0,,6575,6575
30,07/25/2018,7,1:30,1:45,,,0,48.49,48.49,0,-57264,66786,124050,9522,0,0,7,0,0,,7,7
30,07/25/2018,8,1:45,2:00,,,0,48.49,48.49,0,-59488,64643,124131,5155,0,0,0,0,0,,0,0
30,07/25/2018,9,2:00,2:15,68.56,,0,68.56,68.56,1,-68334,29540,97874,-38794,0,0,12653,0,0,,12653,12653
30,07/25/2018,10,2:15,2:30,49.83,,0,49.83,49.83,1,-59310,38868,98178,-20442,0,0,24030,0,0,,24030,24030
30,07/25/2018,11,2:30,2:45,47.2,40.34,0,48.47,40.34,2,-52218,43222,95440,-8996,0,-384,4414,0,0,,4798,4030
30,07/25/2018,12,2:45,3:00,51.31,,0,51.31,51.31,1,-59977,45282,105259,-14695,0,0,5084,0,0,,5084,5084
30,07/25/2018,13,3:00,3:15,68.56,,0,68.56,68.56,1,-73051,27391,100442,-45660,0,0,19086,0,0,,19086,19086
30,07/25/2018,14,3:15,3:30,51.31,,0,51.31,51.31,1,-58156,34335,92491,-23821,0,0,29181,0,0,,29181,29181
30,07/25/2018,15,3:30,3:45,47.2,,0,47.2,47.2,1,-60905,40341,101246,-20564,0,0,17034,0,0,,17034,17034
30,07/25/2018,16,3:45,4:00,43.2,,0,43.2,43.2,1,-45261,42232,87493,-3029,0,0,7963,0,0,,7963,7963
30,07/25/2018,17,4:00,4:15,51.31,,0,51.31,51.31,1,-66101,42771,108872,-23330,0,0,5404,0,0,,5404,5404
30,07/25/2018,18,4:15,4:30,45.83,,0,45.83,45.83,1,-59893,47390,107283,-12503,0,0,14618,0,0,,14618,14618
30,07/25/2018,19,4:30,4:45,47.2,,0,47.2,47.2,1,-64427,45767,110194,-18660,0,0,16083,0,0,,16083,16083
30,07/25/2018,20,4:45,5:00,51.31,,0,51.31,51.31,1,-67650,40966,108616,-26684,0,0,21437,0,0,,21437,21437
30,07/25/2018,21,5:00,5:15,47.63,,0,47.63,47.63,1,-90517,43760,134277,-46757,0,0,15028,0,0,,15028,15028
30,07/25/2018,22,5:15,5:30,51.31,,0,51.31,51.31,1,-92473,35504,127977,-56969,0,0,6269,0,0,,6269,6269
30,07/25/2018,23,5:30,5:45,51.31,,0,51.31,51.31,1,-80731,33462,114193,-47269,0,0,15464,0,0,,15464,15464
30,07/25/2018,24,5:45,6:00,51.31,,0,51.31,51.31,1,-75704,25455,101159,-50249,0,0,29746,0,0,,29746,29746
30,07/25/2018,25,6:00,6:15,42.94,31.78,0,48.44,31.78,2,-67108,79402,146510,12294,0,-3298,8185,0,0,,11483,4887
30,07/25/2018,26,6:15,6:30,43.03,,0,43.03,43.03,1,-103825,50486,154311,-53339,0,0,432,0,0,,432,432
30,07/25/2018,27,6:30,6:45,68.38,,0,68.38,68.38,1,-123605,20702,144307,-102903,0,0,5447,0,0,,5447,5447
30,07/25/2018,28,6:45,7:00,68.59,,0,68.59,68.59,1,-149708,14574,164282,-135134,0,0,31531,0,0,,31531,31531
30,07/25/2018,29,7:00,7:15,43.03,27.75,0,48.48,27.75,2,-62176,90445,152621,28269,0,-6151,13007,0,0,,19158,6856
30,07/25/2018,30,7:15,7:30,,42.54,0,42.54,42.54,-1,-89236,42550,131786,-46686,0,-396,0,0,0,,396,-396
30,07/25/2018,31,7:30,7:45,43.03,,0,43.03,43.03,1,-132799,45317,178116,-87482,0,0,87,0,0,,87,87
30,07/25/2018,32,7:45,8:00,150.12,,0,150.12,150.12,1,-161861,39114,200975,-122747,0,0,19432,0,0,,19432,19432
30,07/25/2018,33,8:00,8:15,43.03,,0,43.03,43.03,1,-111310,62405,173715,-48905,0,0,7078,0,0,,7078,7078
30,07/25/2018,34,8:15,8:30,47.03,,0,47.03,47.03,1,-121460,52274,173734,-69186,0,0,905,0,0,,905,905
30,07/25/2018,35,8:30,8:45,51.17,,0,51.17,51.17,1,-136904,32326,169230,-104578,0,0,7062,0,0,,7062,7062
30,07/25/2018,36,8:45,9:00,118.59,,0,118.59,118.59,1,-153314,31549,184863,-121765,0,0,29296,0,0,,29296,29296
30,07/25/2018,37,9:00,9:15,51.14,40.47,0,51.14,40.47,2,-133605,68605,202210,-65000,0,-1273,15001,0,0,,16274,13728
30,07/25/2018,38,9:15,9:30,149.12,,0,149.12,149.12,1,-149517,65667,215184,-83850,0,0,40198,0,0,,40198,40198
30,07/25/2018,39,9:30,9:45,52.92,,0,52.92,52.92,1,-100330,62034,162364,-38296,0,0,32364,0,0,,32364,32364
30,07/25/2018,40,9:45,10:00,68.38,,0,68.38,68.38,1,-105831,61001,166832,-44830,0,0,2959,0,0,,2959,2959
30,07/25/2018,41,10:00,10:15,133.12,,0,133.12,133.12,1,-109068,75241,184309,-33827,0,0,21582,0,0,,21582,21582
30,07/25/2018,42,10:15,10:30,43.42,,0,43.42,43.42,1,-95298,82860,178158,-12438,0,0,2271,0,0,,2271,2271
30,07/25/2018,43,10:30,10:45,51.14,,0,51.14,51.14,1,-106726,75809,182535,-30917,0,0,12654,0,0,,12654,12654
30,07/25/2018,44,10:45,11:00,46.25,,0,46.25,46.25,1,-102672,86134,188806,-16538,0,0,6428,0,0,,6428,6428
30,07/25/2018,45,11:00,11:15,,,0,42.77,42.77,0,-110067,116165,226232,6098,0,0,846,0,0,,846,846
30,07/25/2018,46,11:15,11:30,,,0,42.76,42.76,0,-125202,112248,237450,-12954,0,0,0,0,0,,0,0
30,07/25/2018,47,11:30,11:45,,,0,42.75,42.75,0,-124449,118565,243014,-5884,0,0,0,0,0,,0,0
30,07/25/2018,48,11:45,12:00,43.21,,0,43.21,43.21,1,-120278,110300,230578,-9978,0,0,1484,0,0,,1484,1484
30,07/25/2018,49,12:00,12:15,68.38,,0,68.38,68.38,1,-148448,92592,241040,-55856,0,0,19108,0,0,,19108,19108
30,07/25/2018,50,12:15,12:30,47.03,,0,47.03,47.03,1,-137722,104278,242000,-33444,0,0,16823,0,0,,16823,16823
30,07/25/2018,51,12:30,12:45,42.89,40.97,0,40.97,40.97,-1,-115990,107663,223653,-8327,0,-192,5806,0,0,,5998,5614
30,07/25/2018,52,12:45,13:00,,42.44,0,42.44,42.44,-1,-113434,112996,226430,-438,0,-428,0,0,0,,428,-428
30,07/25/2018,53,13:00,13:15,44.12,42.46,0,44.12,42.46,2,-115022,113961,228983,-1061,0,-547,195,0,0,,742,-352
30,07/25/2018,54,13:15,13:30,51.14,,0,51.14,51.14,1,-115018,95814,210832,-19204,0,0,10535,0,0,,10535,10535
30,07/25/2018,55,13:30,13:45,43.03,,0,43.03,43.03,1,-113700,103616,217316,-10084,0,0,5864,0,0,,5864,5864
30,07/25/2018,56,13:45,14:00,42.99,,0,42.99,42.99,1,-109131,108725,217856,-406,0,0,859,0,0,,859,859
30,07/25/2018,57,14:00,14:15,68.38,,0,68.38,68.38,1,-149937,109940,259877,-39997,0,0,17353,0,0,,17353,17353
30,07/25/2018,58,14:15,14:30,47.03,,0,47.03,47.03,1,-122305,111266,233571,-11039,0,0,11993,0,0,,11993,11993
30,07/25/2018,59,14:30,14:45,43.03,,0,43.03,43.03,1,-130571,111553,242124,-19018,0,0,4696,0,0,,4696,4696
30,07/25/2018,60,14:45,15:00,43.03,40.54,0,40.54,40.54,-1,-93125,134378,227503,41253,0,-488,1602,0,0,,2090,1114
30,07/25/2018,61,15:00,15:15,,,0,42.59,42.59,0,-86590,146714,233304,60124,0,0,0,0,0,,0,0
30,07/25/2018,62,15:15,15:30,,,0,42.59,42.59,0,-82650,150234,232884,67584,0,0,0,0,0,,0,0
30,07/25/2018,63,15:30,15:45,,,0,42.58,42.58,0,-83199,150029,233228,66830,0,0,0,0,0,,0,0
30,07/25/2018,64,15:45,16:00,,,0,42.56,42.56,0,-82994,145260,228254,62266,0,0,0,0,0,,0,0
30,07/25/2018,65,16:00,16:15,,,0,42.73,42.73,0,-83416,120840,204256,37424,0,0,0,0,0,,0,0
30,07/25/2018,66,16:15,16:30,,,0,42.73,42.73,0,-94364,119027,213391,24663,0,0,0,0,0,,0,0
30,07/25/2018,67,16:30,16:45,,,0,42.73,42.73,0,-104996,123476,228472,18480,0,0,0,0,0,,0,0
30,07/25/2018,68,16:45,17:00,51.14,,0,51.14,51.14,1,-116750,95168,211918,-21582,0,0,9095,0,0,,9095,9095
30,07/25/2018,69,17:00,17:15,51.14,39.03,0,39.03,39.03,-1,-99836,117192,217028,17356,0,-762,1879,0,0,,2641,1117
30,07/25/2018,70,17:15,17:30,,,0,42.73,42.73,0,-108099,112664,220763,4565,0,0,0,0,0,,0,0
30,07/25/2018,71,17:30,17:45,47.03,,0,47.03,47.03,1,-125098,105142,230240,-19956,0,0,2517,0,0,,2517,2517
30,07/25/2018,72,17:45,18:00,73.6,,0,73.6,73.6,1,-144814,96709,241523,-48105,0,0,29687,0,0,,29687,29687
30,07/25/2018,73,18:00,18:15,47.57,39.03,0,47.57,39.03,2,-105813,91434,197247,-14379,0,-637,16657,0,0,,17294,16020
30,07/25/2018,74,18:15,18:30,,,0,48.48,48.48,0,-96075,102120,198195,6045,0,-97,57,0,0,,154,-40
30,07/25/2018,75,18:30,18:45,,,0,48.48,48.48,0,-101216,105598,206814,4382,0,0,0,0,0,,0,0
30,07/25/2018,76,18:45,19:00,43.03,,0,43.03,43.03,1,-106080,106393,212473,313,0,0,67,0,0,,67,67
30,07/25/2018,77,19:00,19:15,43.29,,0,43.29,43.29,1,-107344,101166,208510,-6178,0,0,1658,0,0,,1658,1658
30,07/25/2018,78,19:15,19:30,51.04,,0,51.04,51.04,1,-112004,90075,202079,-21929,0,0,4471,0,0,,4471,4471
30,07/25/2018,79,19:30,19:45,51.14,,0,51.14,51.14,1,-109291,81438,190729,-27853,0,0,18337,0,0,,18337,18337
30,07/25/2018,80,19:45,20:00,47.03,,0,47.03,47.03,1,-119611,89337,208948,-30274,0,0,10740,0,0,,10740,10740
30,07/25/2018,81,20:00,20:15,155.02,,0,155.02,155.02,1,-149840,71164,221004,-78676,0,0,48900,0,0,,48900,48900
30,07/25/2018,82,20:15,20:30,68.38,,0,68.38,68.38,1,-131501,84825,216326,-46676,0,0,60089,0,0,,60089,60089
30,07/25/2018,83,20:30,20:45,68.38,39.26,0,39.26,39.26,-1,-96801,100745,197546,3944,0,-1662,11742,0,0,,13404,10080
30,07/25/2018,84,20:45,21:00,,39.03,0,39.03,39.03,-1,-98040,115185,213225,17145,0,-2877,0,0,0,,2877,-2877
30,07/25/2018,85,21:00,21:15,68.59,39.03,0,68.59,68.59,1,-128055,76535,204590,-51520,0,-67,17727,0,0,,17794,17660
30,07/25/2018,86,21:15,21:30,51.14,,0,51.14,51.14,1,-128834,74466,203300,-54368,0,0,35944,0,0,,35944,35944
30,07/25/2018,87,21:30,21:45,51.14,,0,51.14,51.14,1,-115375,71835,187210,-43540,0,0,37016,0,0,,37016,37016
30,07/25/2018,88,21:45,22:00,102.02,,0,102.02,102.02,1,-143408,64142,207550,-79266,0,0,51650,0,0,,51650,51650
30,07/25/2018,89,22:00,22:15,89.02,,0,89.02,89.02,1,-141417,56640,198057,-84777,0,0,69854,0,0,,69854,69854
30,07/25/2018,90,22:15,22:30,68.38,,0,68.38,68.38,1,-131441,62260,193701,-69181,0,0,58224,0,0,,58224,58224
30,07/25/2018,91,22:30,22:45,51.54,,0,51.54,51.54,1,-111867,76628,188495,-35239,0,0,42208,0,0,,42208,42208
30,07/25/2018,92,22:45,23:00,,,0,48.48,48.48,0,-103896,93940,197836,-9956,0,0,9167,0,0,,9167,9167
30,07/25/2018,93,23:00,23:15,155.02,,0,155.02,155.02,1,-164604,74519,239123,-90085,0,0,27686,0,0,,27686,27686
30,07/25/2018,94,23:15,23:30,68.38,40.7,0,40.7,40.7,-1,-124507,83149,207656,-41358,0,-10,41276,0,0,,41286,41266
30,07/25/2018,95,23:30,23:45,42.94,39.61,0,42.94,39.61,2,-94009,90256,184265,-3753,0,-750,1911,0,0,,2661,1161
30,07/25/2018,96,23:45,0:00,43.03,39.03,0,43.03,39.03,2,-62998,91715,154713,28717,0,-2185,98,0,0,,2283,-2087
30,07/26/2018,1,0:00,0:15,118.81,39.03,0,118.81,118.81,1,-137413,39894,177307,-97519,0,-6,20378,0,0,,20384,20372
30,07/26/2018,2,0:15,0:30,66.12,,0,66.12,66.12,1,-84500,50431,134931,-34069,0,0,49129,0,0,,49129,49129
30,07/26/2018,3,0:30,0:45,66.12,38.17,0,38.17,38.17,-1,-61521,64365,125886,2844,0,-1352,5775,0,0,,7127,4423
30,07/26/2018,4,0:45,1:00,,40.05,0,40.05,40.05,-1,-52946,74206,127152,21260,0,-5377,0,0,0,,5377,-5377
30,07/26/2018,5,1:00,1:15,70.12,42.78,0,70.12,42.78,2,-101779,55997,157776,-45782,0,-1934,14270,0,0,,16204,12336
30,07/26/2018,6,1:15,1:30,51.34,42.78,0,42.78,42.78,-1,-85450,86801,172251,1351,0,-7,13217,0,0,,13224,13210
30,07/26/2018,7,1:30,1:45,51.34,41.35,0,41.35,41.35,-1,-71764,67522,139286,-4242,0,-422,4,0,0,,426,-418
30,07/26/2018,8,1:45,2:00,,40.78,0,40.78,40.78,-1,-61812,71902,133714,10090,0,-2584,0,0,0,,2584,-2584
30,07/26/2018,9,2:00,2:15,51.34,40.78,0,51.34,51.34,1,-86917,58215,145132,-28702,0,-175,7725,0,0,,7900,7550
30,07/26/2018,10,2:15,2:30,43.23,,0,43.23,43.23,1,-82495,69024,151519,-13471,0,0,3532,0,0,,3532,3532
30,07/26/2018,11,2:30,2:45,,,0,48.27,48.27,0,-69338,58218,127556,-11120,0,0,0,0,0,,0,0
30,07/26/2018,12,2:45,3:00,,,0,48.27,48.27,0,-64749,61016,125765,-3733,0,0,0,0,0,,0,0
30,07/26/2018,13,3:00,3:15,47.23,,0,47.23,47.23,1,-81252,66124,147376,-15128,0,0,2757,0,0,,2757,2757
30,07/26/2018,14,3:15,3:30,43.23,,0,43.23,43.23,1,-83416,79668,163084,-3748,0,0,3123,0,0,,3123,3123
30,07/26/2018,15,3:30,3:45,42.85,,0,42.85,42.85,1,-79458,82210,161668,2752,0,0,679,0,0,,679,679
30,07/26/2018,16,3:45,4:00,,,0,48.27,48.27,0,-80343,76709,157052,-3634,0,0,0,0,0,,0,0
30,07/26/2018,17,4:00,4:15,,,0,48.24,48.24,0,-91825,62868,154693,-28957,0,0,0,0,0,,0,0
30,07/26/2018,18,4:15,4:30,42.85,,0,42.85,42.85,1,-91145,62608,153753,-28537,0,0,548,0,0,,548,548
30,07/26/2018,19,4:30,4:45,42.85,,0,42.85,42.85,1,-95402,64229,159631,-31173,0,0,1048,0,0,,1048,1048
30,07/26/2018,20,4:45,5:00,42.85,,0,42.85,42.85,1,-93187,64184,157371,-29003,0,0,871,0,0,,871,871
30,07/26/2018,21,5:00,5:15,42.85,,0,42.85,42.85,1,-107684,66987,174671,-40697,0,0,85,0,0,,85,85
30,07/26/2018,22,5:15,5:30,,,0,48.23,48.23,0,-109619,57029,166648,-52590,0,0,0,0,0,,0,0
30,07/26/2018,23,5:30,5:45,43.23,,0,43.23,43.23,1,-117522,58174,175696,-59348,0,0,1025,0,0,,1025,1025
30,07/26/2018,24,5:45,6:00,43.23,,0,43.23,43.23,1,-128048,61243,189291,-66805,0,0,2377,0,0,,2377,2377
30,07/26/2018,25,6:00,6:15,,,0,48.15,48.15,0,-85285,116432,201717,31147,0,0,0,0,0,,0,0
30,07/26/2018,26,6:15,6:30,,,0,48.15,48.15,0,-100836,88710,189546,-12126,0,0,0,0,0,,0,0
30,07/26/2018,27,6:30,6:45,68.35,,0,68.35,68.35,1,-129014,70725,199739,-58289,0,0,12344,0,0,,12344,12344
30,07/26/2018,28,6:45,7:00,51.11,,0,51.11,51.11,1,-155199,67878,223077,-87321,0,0,24411,0,0,,24411,24411
30,07/26/2018,29,7:00,7:15,51.11,-33.52,0,-33.52,-33.52,-1,-64499,115877,180376,51378,0,-18265,7389,0,0,,25654,-10876
30,07/26/2018,30,7:15,7:30,,41.78,0,41.78,41.78,-1,-86783,92969,179752,6186,0,-3738,0,0,0,,3738,-3738
30,07/26/2018,31,7:30,7:45,51.11,,0,51.11,51.11,1,-130749,90253,221002,-40496,0,0,3824,0,0,,3824,3824
30,07/26/2018,32,7:45,8:00,155.12,,0,155.12,155.12,1,-162570,84886,247456,-77684,0,0,48651,0,0,,48651,48651
30,07/26/2018,33,8:00,8:15,43,16.48,0,48.14,16.48,2,-74466,125545,200011,51079,0,-10187,17943,0,0,,28130,7756
30,07/26/2018,34,8:15,8:30,,41.5,0,41.5,41.5,-1,-93338,100779,194117,7441,0,-3623,0,0,0,,3623,-3623
30,07/26/2018,35,8:30,8:45,,,0,48.14,48.14,0,-108031,90680,198711,-17351,0,0,0,0,0,,0,0
30,07/26/2018,36,8:45,9:00,47,,0,47,47,1,-120098,69132,189230,-50966,0,0,1387,0,0,,1387,1387
30,07/26/2018,37,9:00,9:15,47,,0,47,47,1,-103979,95671,199650,-8308,0,0,3162,0,0,,3162,3162
30,07/26/2018,38,9:15,9:30,51.11,,0,51.11,51.11,1,-115150,84702,199852,-30448,0,0,16645,0,0,,16645,16645
30,07/26/2018,39,9:30,9:45,51.11,,0,51.11,51.11,1,-118677,85412,204089,-33265,0,0,24739,0,0,,24739,24739
30,07/26/2018,40,9:45,10:00,51.11,,0,51.11,51.11,1,-127368,84576,211944,-42792,0,0,27314,0,0,,27314,27314
30,07/26/2018,41,10:00,10:15,51.12,,0,51.12,51.12,1,-152792,86507,239299,-66285,0,0,34094,0,0,,34094,34094
30,07/26/2018,42,10:15,10:30,54.16,,0,54.16,54.16,1,-146083,85003,231086,-61080,0,0,32770,0,0,,32770,32770
30,07/26/2018,43,10:30,10:45,51.11,,0,51.11,51.11,1,-136920,86867,223787,-50053,0,0,29057,0,0,,29057,29057
30,07/26/2018,44,10:45,11:00,57.36,,0,57.36,57.36,1,-131061,85092,216153,-45969,0,0,43781,0,0,,43781,43781
30,07/26/2018,45,11:00,11:15,52.35,,0,52.35,52.35,1,-142723,90142,232865,-52581,0,0,39068,0,0,,39068,39068
30,07/26/2018,46,11:15,11:30,58.12,,0,58.12,58.12,1,-137355,83465,220820,-53890,0,0,43670,0,0,,43670,43670
30,07/26/2018,47,11:30,11:45,52.35,,0,52.35,52.35,1,-126544,84264,210808,-42280,0,0,43631,0,0,,43631,43631
30,07/26/2018,48,11:45,12:00,52.35,,0,52.35,52.35,1,-126387,84256,210643,-42131,0,0,40147,0,0,,40147,40147
30,07/26/2018,49,12:00,12:15,50.37,,0,50.37,50.37,1,-146907,89306,236213,-57601,0,0,30203,0,0,,30203,30203
30,07/26/2018,50,12:15,12:30,,,0,48.26,48.26,0,-144876,100367,245243,-44509,0,0,3386,0,0,,3386,3386
30,07/26/2018,51,12:30,12:45,65.94,,0,65.94,65.94,1,-149016,106905,255921,-42111,0,0,11671,0,0,,11671,11671
30,07/26/2018,52,12:45,13:00,50.37,,0,50.37,50.37,1,-157158,107004,264162,-50154,0,0,28102,0,0,,28102,28102
30,07/26/2018,53,13:00,13:15,,,0,48.27,48.27,0,-141577,128796,270373,-12781,0,0,9473,0,0,,9473,9473
30,07/26/2018,54,13:15,13:30,,42.45,0,42.45,42.45,-1,-136527,124152,260679,-12375,0,-2,0,0,0,,2,-2
30,07/26/2018,55,13:30,13:45,,,0,48.27,48.27,0,-128473,122578,251051,-5895,0,0,0,0,0,,0,0
30,07/26/2018,56,13:45,14:00,,41.58,0,41.58,41.58,-1,-124335,128880,253215,4545,0,-467,0,0,0,,467,-467
30,07/26/2018,57,14:00,14:15,,41.04,0,41.04,41.04,-1,-145446,152167,297613,6721,0,-1647,0,0,0,,1647,-1647
30,07/26/2018,58,14:15,14:30,,42.45,0,42.45,42.45,-1,-140487,159701,300188,19214,0,-697,0,0,0,,697,-697
30,07/26/2018,59,14:30,14:45,,42.45,0,42.45,42.45,-1,-150826,163586,314412,12760,0,-1568,0,0,0,,1568,-1568
30,07/26/2018,60,14:45,15:00,,42.45,0,42.45,42.45,-1,-165654,158976,324630,-6678,0,-717,0,0,0,,717,-717
30,07/26/2018,61,15:00,15:15,,42.45,0,42.45,42.45,-1,-176440,171635,348075,-4805,0,-750,0,0,0,,750,-750
30,07/26/2018,62,15:15,15:30,,,0,48.39,48.39,0,-211589,168846,380435,-42743,0,-25,0,0,0,,25,-25
30,07/26/2018,63,15:30,15:45,54.23,,0,54.23,54.23,1,-218543,161278,379821,-57265,0,0,9854,0,0,,9854,9854
30,07/26/2018,64,15:45,16:00,68.35,,0,68.35,68.35,1,-207123,174521,381644,-32602,0,0,36718,0,0,,36718,36718
30,07/26/2018,65,16:00,16:15,69.05,,0,69.05,69.05,1,-190364,142030,332394,-48334,0,0,33848,0,0,,33848,33848
30,07/26/2018,66,16:15,16:30,74.9,,0,74.9,74.9,1,-188975,145574,334549,-43401,0,0,41632,0,0,,41632,41632
30,07/26/2018,67,16:30,16:45,77.93,,0,77.93,77.93,1,-205280,141209,346489,-64071,0,0,45616,0,0,,45616,45616
30,07/26/2018,68,16:45,17:00,124.9,,0,124.9,124.9,1,-221117,138364,359481,-82753,0,0,75604,0,0,,75604,75604
30,07/26/2018,69,17:00,17:15,60.1,42.45,0,42.45,42.45,-1,-141653,128657,270310,-12996,0,-157,39350,0,0,,39507,39193
30,07/26/2018,70,17:15,17:30,80.1,41.78,0,80.1,41.78,2,-180749,126355,307104,-54394,0,-67,14032,0,0,,14099,13965
30,07/26/2018,71,17:30,17:45,80.1,,0,80.1,80.1,1,-195598,130290,325888,-65308,0,0,51517,0,0,,51517,51517
30,07/26/2018,72,17:45,18:00,78.29,,0,78.29,78.29,1,-202100,144664,346764,-57436,0,0,56068,0,0,,56068,56068
30,07/26/2018,73,18:00,18:15,69.02,,0,69.02,69.02,1,-200869,132291,333160,-68578,0,0,43897,0,0,,43897,43897
30,07/26/2018,74,18:15,18:30,54.5,,0,54.5,54.5,1,-179728,134876,314604,-44852,0,0,40644,0,0,,40644,40644
30,07/26/2018,75,18:30,18:45,54.5,,0,54.5,54.5,1,-173695,138558,312253,-35137,0,0,35391,0,0,,35391,35391
30,07/26/2018,76,18:45,19:00,69.02,,0,69.02,69.02,1,-181861,133059,314920,-48802,0,0,32151,0,0,,32151,32151
30,07/26/2018,77,19:00,19:15,57.97,,0,57.97,57.97,1,-139683,108861,248544,-30822,0,0,32224,0,0,,32224,32224
30,07/26/2018,78,19:15,19:30,46.25,42.45,0,42.45,42.45,-1,-142635,134245,276880,-8390,0,-23,11940,0,0,,11963,11917
30,07/26/2018,79,19:30,19:45,43.87,,0,43.87,43.87,1,-143672,139610,283282,-4062,0,0,694,0,0,,694,694
30,07/26/2018,80,19:45,20:00,47.97,,0,47.97,47.97,1,-144191,148779,292970,4588,0,0,2054,0,0,,2054,2054
30,07/26/2018,81,20:00,20:15,75.48,,0,75.48,75.48,1,-162911,109609,272520,-53302,0,0,29998,0,0,,29998,29998
30,07/26/2018,82,20:15,20:30,55.48,,0,55.48,55.48,1,-158208,121192,279400,-37016,0,0,35686,0,0,,35686,35686
30,07/26/2018,83,20:30,20:45,54.73,,0,54.73,54.73,1,-147703,129754,277457,-17949,0,0,27908,0,0,,27908,27908
30,07/26/2018,84,20:45,21:00,51.21,41.58,0,51.21,41.58,2,-133370,134372,267742,1002,0,-1294,5740,0,0,,7034,4446
30,07/26/2018,85,21:00,21:15,84.42,,0,84.42,84.42,1,-162032,96024,258056,-66008,0,0,37881,0,0,,37881,37881
30,07/26/2018,86,21:15,21:30,55.12,,0,55.12,55.12,1,-146215,105198,251413,-41017,0,0,34939,0,0,,34939,34939
30,07/26/2018,87,21:30,21:45,45.84,,0,45.84,45.84,1,-136788,115547,252335,-21241,0,0,7151,0,0,,7151,7151
30,07/26/2018,88,21:45,22:00,51.66,,0,51.66,51.66,1,-145413,120542,265955,-24871,0,0,13376,0,0,,13376,13376
30,07/26/2018,89,22:00,22:15,155.12,,0,155.12,155.12,1,-186289,93028,279317,-93261,0,0,41204,0,0,,41204,41204
30,07/26/2018,90,22:15,22:30,78.6,,0,78.6,78.6,1,-168677,104785,273462,-63892,0,0,60638,0,0,,60638,60638
30,07/26/2018,91,22:30,22:45,64.6,41.04,0,41.04,41.04,-1,-135153,131606,266759,-3547,0,-394,32361,0,0,,32755,31967
30,07/26/2018,92,22:45,23:00,44.3,41.04,0,44.3,41.04,2,-139700,145564,285264,5864,0,-612,942,0,0,,1554,330
30,07/26/2018,93,23:00,23:15,62.12,,0,62.12,62.12,1,-173627,148040,321667,-25587,0,0,15420,0,0,,15420,15420
30,07/26/2018,94,23:15,23:30,43,41.04,0,43,27.14,2,-139650,144763,284413,5113,0,-851,5472,0,0,,6323,4621
30,07/26/2018,95,23:30,23:45,,39,0,39,39,-1,-113960,137009,250969,23049,0,-1891,0,0,0,,1891,-1891
30,07/26/2018,96,23:45,0:00,,16.48,0,16.48,16.48,-1,-91152,156827,247979,65675,0,-31772,0,0,0,,31772,-31772
30,07/27/2018,1,0:00,0:15,136.02,31.44,0,136.02,136.02,1,-160639,96189,256828,-64450,0,-23928,9739,0,0,,33667,-14189
30,07/27/2018,2,0:15,0:30,47.33,31.44,0,47.33,47.33,1,-141254,131998,273252,-9256,0,-23,14891,0,0,,14914,14868
30,07/27/2018,3,0:30,0:45,47.33,41.18,0,41.18,41.18,-1,-95472,128721,224193,33249,0,-617,775,0,0,,1392,158
30,07/27/2018,4,0:45,1:00,,32.38,0,32.38,32.38,-1,-77606,126834,204440,49228,0,-4772,0,0,0,,4772,-4772
30,07/27/2018,5,1:00,1:15,84.02,32.38,0,84.02,84.02,1,-136966,79077,216043,-57889,0,-715,17875,0,0,,18590,17160
30,07/27/2018,6,1:15,1:30,49.59,,0,49.59,49.59,1,-113412,83312,196724,-30100,0,0,30017,0,0,,30017,30017
30,07/27/2018,7,1:30,1:45,49.59,41.39,0,41.39,41.39,-1,-90106,86411,176517,-3695,0,-226,6378,0,0,,6604,6152
30,07/27/2018,8,1:45,2:00,,39.32,0,39.32,39.32,-1,-65013,106493,171506,41480,0,-4078,0,0,0,,4078,-4078
30,07/27/2018,9,2:00,2:15,,35.33,0,35.33,35.33,-1,-80618,123420,204038,42802,0,-2311,0,0,0,,2311,-2311
30,07/27/2018,10,2:15,2:30,,,0,43.36,43.36,0,-71651,117523,189174,45872,0,-2,0,0,0,,2,-2
30,07/27/2018,11,2:30,2:45,,,0,43.36,43.36,0,-64218,105221,169439,41003,0,0,0,0,0,,0,0
30,07/27/2018,12,2:45,3:00,,39.33,0,39.33,39.33,-1,-64224,96161,160385,31937,0,-2910,0,0,0,,2910,-2910
30,07/27/2018,13,3:00,3:15,47.33,41.03,0,47.33,41.03,2,-67950,59141,127091,-8809,0,-1339,1705,0,0,,3044,366
30,07/27/2018,14,3:15,3:30,,,0,43.36,43.36,0,-48527,73051,121578,24524,0,0,0,0,0,,0,0
30,07/27/2018,15,3:30,3:45,,,0,43.36,43.36,0,-45029,75384,120413,30355,0,0,0,0,0,,0,0
30,07/27/2018,16,3:45,4:00,,31.44,0,31.44,31.44,-1,-43764,78948,122712,35184,0,-3454,0,0,0,,3454,-3454
30,07/27/2018,17,4:00,4:15,43.33,39.33,0,43.38,39.33,2,-76807,62509,139316,-14298,0,-3062,925,0,0,,3987,-2137
30,07/27/2018,18,4:15,4:30,43.33,,0,43.33,43.33,1,-82193,71722,153915,-10471,0,0,3320,0,0,,3320,3320
30,07/27/2018,19,4:30,4:45,45.42,,0,45.42,45.42,1,-77416,66232,143648,-11184,0,0,5756,0,0,,5756,5756
30,07/27/2018,20,4:45,5:00,45.42,,0,45.42,45.42,1,-90986,73077,164063,-17909,0,0,6789,0,0,,6789,6789
30,07/27/2018,21,5:00,5:15,43.04,,0,43.04,43.04,1,-86486,82786,169272,-3700,0,0,2734,0,0,,2734,2734
30,07/27/2018,22,5:15,5:30,51.44,,0,51.44,51.44,1,-90111,69374,159485,-20737,0,0,7786,0,0,,7786,7786
30,07/27/2018,23,5:30,5:45,45.27,,0,45.27,45.27,1,-94674,71205,165879,-23469,0,0,8029,0,0,,8029,8029
30,07/27/2018,24,5:45,6:00,43.33,,0,43.33,43.33,1,-102298,74624,176922,-27674,0,0,6286,0,0,,6286,6286
30,07/27/2018,25,6:00,6:15,43.33,40.4,0,40.4,40.4,-1,-92180,131200,223380,39020,0,-1291,610,0,0,,1901,-681
30,07/27/2018,26,6:15,6:30,,40.03,0,40.03,40.03,-1,-96475,108694,205169,12219,0,-2185,0,0,0,,2185,-2185
30,07/27/2018,27,6:30,6:45,51.46,40.03,0,51.46,51.46,1,-115110,88330,203440,-26780,0,-18,1865,0,0,,1883,1847
30,07/27/2018,28,6:45,7:00,52.02,,0,52.02,52.02,1,-137541,87496,225037,-50045,0,0,26068,0,0,,26068,26068
30,07/27/2018,29,7:00,7:15,52.02,-57.35,0,-57.35,-57.35,-1,-71593,140306,211899,68713,0,-23405,4660,0,0,,28065,-18745
30,07/27/2018,30,7:15,7:30,,39.03,0,39.03,39.03,-1,-78867,114610,193477,35743,0,-21037,0,0,0,,21037,-21037
30,07/27/2018,31,7:30,7:45,47.51,39.03,0,47.51,47.51,1,-109751,98155,207906,-11596,0,-3980,1918,0,0,,5898,-2062
30,07/27/2018,32,7:45,8:00,51.46,,0,51.46,51.46,1,-129577,90382,219959,-39195,0,0,24773,0,0,,24773,24773
30,07/27/2018,33,8:00,8:15,43.05,41.04,0,44.03,41.04,2,-91244,150764,242008,59520,0,-1444,10426,0,0,,11870,8982
30,07/27/2018,34,8:15,8:30,,,0,44.03,44.03,0,-91811,115062,206873,23251,0,0,0,0,0,,0,0
30,07/27/2018,35,8:30,8:45,51.46,,0,51.46,51.46,1,-107533,98943,206476,-8590,0,0,1411,0,0,,1411,1411
30,07/27/2018,36,8:45,9:00,102.02,,0,102.02,102.02,1,-129397,74962,204359,-54435,0,0,36645,0,0,,36645,36645
30,07/27/2018,37,9:00,9:15,43.35,40.03,0,44.02,40.03,2,-67312,135526,202838,68214,0,-2179,15831,0,0,,18010,13652
30,07/27/2018,38,9:15,9:30,,,0,44.02,44.02,0,-72169,120004,192173,47835,0,-7,0,0,0,,7,-7
30,07/27/2018,39,9:30,9:45,,,0,44.02,44.02,0,-68788,104139,172927,35351,0,0,0,0,0,,0,0
30,07/27/2018,40,9:45,10:00,43.35,,0,43.35,43.35,1,-66400,98614,165014,32214,0,0,77,0,0,,77,77
30,07/27/2018,41,10:00,10:15,155.02,,0,155.02,155.02,1,-149721,49510,199231,-100211,0,0,35214,0,0,,35214,35214
30,07/27/2018,42,10:15,10:30,78.98,,0,78.98,78.98,1,-124572,54268,178840,-70304,0,0,70812,0,0,,70812,70812
30,07/27/2018,43,10:30,10:45,59.02,,0,59.02,59.02,1,-110879,58040,168919,-52839,0,0,52133,0,0,,52133,52133
30,07/27/2018,44,10:45,11:00,58.98,,0,58.98,58.98,1,-109003,82244,191247,-26759,0,0,31558,0,0,,31558,31558
30,07/27/2018,45,11:00,11:15,56.47,,0,56.47,56.47,1,-116004,86971,202975,-29033,0,0,15960,0,0,,15960,15960
30,07/27/2018,46,11:15,11:30,56.47,,0,56.47,56.47,1,-115206,85316,200522,-29890,0,0,25188,0,0,,25188,25188
30,07/27/2018,47,11:30,11:45,47.35,,0,47.35,47.35,1,-101482,81598,183080,-19884,0,0,15360,0,0,,15360,15360
30,07/27/2018,48,11:45,12:00,56.47,,0,56.47,56.47,1,-106864,78842,185706,-28022,0,0,17632,0,0,,17632,17632
30,07/27/2018,49,12:00,12:15,47.35,,0,47.35,47.35,1,-107754,88455,196209,-19299,0,0,12494,0,0,,12494,12494
30,07/27/2018,50,12:15,12:30,43.76,,0,43.76,43.76,1,-99821,91282,191103,-8539,0,0,4922,0,0,,4922,4922
30,07/27/2018,51,12:30,12:45,43.35,,0,43.35,43.35,1,-95830,102034,197864,6204,0,0,725,0,0,,725,725
30,07/27/2018,52,12:45,13:00,43.35,42.45,0,42.45,42.45,-1,-90618,98900,189518,8282,0,-54,2,0,0,,56,-52
30,07/27/2018,53,13:00,13:15,,31.46,0,31.46,31.46,-1,-62160,169641,231801,107481,0,-6216,0,0,0,,6216,-6216
30,07/27/2018,54,13:15,13:30,,31.46,0,31.46,31.46,-1,-66156,144478,210634,78322,0,-16504,0,0,0,,16504,-16504
30,07/27/2018,55,13:30,13:45,,42.29,0,42.29,42.29,-1,-62902,133148,196050,70246,0,-763,0,0,0,,763,-763
30,07/27/2018,56,13:45,14:00,,31.46,0,31.46,31.46,-1,-71147,136595,207742,65448,0,-22953,0,0,0,,22953,-22953
30,07/27/2018,57,14:00,14:15,,38.33,0,38.33,38.33,-1,-90408,125676,216084,35268,0,-35808,0,0,0,,35808,-35808
30,07/27/2018,58,14:15,14:30,44.05,38.33,0,44.05,44.05,1,-100265,113372,213637,13107,0,-5969,99,0,0,,6068,-5870
30,07/27/2018,59,14:30,14:45,,42.52,0,42.52,42.52,-1,-99857,111647,211504,11790,0,-822,0,0,0,,822,-822
30,07/27/2018,60,14:45,15:00,,42.52,0,42.52,42.52,-1,-93437,107648,201085,14211,0,-2875,0,0,0,,2875,-2875
30,07/27/2018,61,15:00,15:15,,42.41,0,42.41,42.41,-1,-102818,64261,167079,-38557,0,-1460,0,0,0,,1460,-1460
30,07/27/2018,62,15:15,15:30,43.35,42.41,0,43.35,43.35,1,-95434,69313,164747,-26121,0,-19,1075,0,0,,1094,1056
30,07/27/2018,63,15:30,15:45,42.9,,0,42.9,42.9,1,-99050,72141,171191,-26909,0,0,1359,0,0,,1359,1359
30,07/27/2018,64,15:45,16:00,43.35,,0,43.35,43.35,1,-103643,74608,178251,-29035,0,0,8024,0,0,,8024,8024
30,07/27/2018,65,16:00,16:15,43.35,42.38,0,42.38,42.38,-1,-81494,103599,185093,22105,0,-713,1868,0,0,,2581,1155
30,07/27/2018,66,16:15,16:30,,41.82,0,41.82,41.82,-1,-90683,103880,194563,13197,0,-4368,0,0,0,,4368,-4368
30,07/27/2018,67,16:30,16:45,43.35,42.52,0,43.35,43.35,1,-97431,94564,191995,-2867,0,-1635,134,0,0,,1769,-1501
30,07/27/2018,68,16:45,17:00,127,,0,127,127,1,-112049,60419,172468,-51630,0,0,22242,0,0,,22242,22242
30,07/27/2018,69,17:00,17:15,377.15,,0,377.15,377.15,1,-158289,33790,192079,-124499,0,0,79503,0,0,,79503,79503
30,07/27/2018,70,17:15,17:30,73.15,,0,73.15,73.15,1,-129081,56722,185803,-72359,0,0,42916,0,0,,42916,42916
30,07/27/2018,71,17:30,17:45,377.15,,0,377.15,377.15,1,-152179,25423,177602,-126756,0,0,61591,0,0,,61591,61591
30,07/27/2018,72,17:45,18:00,375.16,,0,375.16,375.16,1,-183307,23393,206700,-159914,0,0,102799,0,0,,102799,102799
30,07/27/2018,73,18:00,18:15,375.16,,0,375.16,375.16,1,-135849,68893,204742,-66956,0,0,90761,0,0,,90761,90761
30,07/27/2018,74,18:15,18:30,44.55,42.45,0,44.55,42.45,2,-101610,80991,182601,-20619,0,-277,14602,0,0,,14879,14325
30,07/27/2018,75,18:30,18:45,76.59,,0,76.59,76.59,1,-113093,69419,182512,-43674,0,0,21098,0,0,,21098,21098
30,07/27/2018,76,18:45,19:00,71.8,,0,71.8,71.8,1,-119753,59212,178965,-60541,0,0,45393,0,0,,45393,45393
30,07/27/2018,77,19:00,19:15,51.46,,0,51.46,51.46,1,-117074,94806,211880,-22268,0,0,26106,0,0,,26106,26106
30,07/27/2018,78,19:15,19:30,68.73,,0,68.73,68.73,1,-113651,80586,194237,-33065,0,0,12643,0,0,,12643,12643
30,07/27/2018,79,19:30,19:45,68.73,,0,68.73,68.73,1,-124067,76192,200259,-47875,0,0,41221,0,0,,41221,41221
30,07/27/2018,80,19:45,20:00,118.94,,0,118.94,118.94,1,-143625,76109,219734,-67516,0,0,49500,0,0,,49500,49500
30,07/27/2018,81,20:00,20:15,140.16,,0,140.16,140.16,1,-164971,38529,203500,-126442,0,0,87654,0,0,,87654,87654
30,07/27/2018,82,20:15,20:30,140.16,,0,140.16,140.16,1,-147395,51477,198872,-95918,0,0,95265,0,0,,95265,95265
30,07/27/2018,83,20:30,20:45,78.16,42.52,0,42.52,42.52,-1,-112251,76430,188681,-35821,0,-3,59720,0,0,,59723,59717
30,07/27/2018,84,20:45,21:00,78.16,41.82,0,41.82,41.82,-1,-86596,96158,182754,9562,0,-1450,4015,0,0,,5465,2565
30,07/27/2018,85,21:00,21:15,,-94.22,0,-94.22,-94.22,-1,-83910,97007,180917,13097,0,-1551,0,0,0,,1551,-1551
30,07/27/2018,86,21:15,21:30,,35.35,0,35.35,35.35,-1,-75529,115996,191525,40467,0,-14943,0,0,0,,14943,-14943
30,07/27/2018,87,21:30,21:45,,38.83,0,38.83,38.83,-1,-74225,119393,193618,45168,0,-18942,0,0,0,,18942,-18942
30,07/27/2018,88,21:45,22:00,,-106.52,0,-106.52,-106.52,-1,-69346,130113,199459,60767,0,-56497,0,0,0,,56497,-56497
30,07/27/2018,89,22:00,22:15,,1.68,0,1.68,1.68,-1,-101814,96199,198013,-5615,0,-55040,0,0,0,,55040,-55040
30,07/27/2018,90,22:15,22:30,,-106.49,0,-106.49,-106.49,-1,-90713,104792,195505,14079,0,-52695,0,0,0,,52695,-52695
30,07/27/2018,91,22:30,22:45,,-47.43,0,-47.43,-47.43,-1,-109272,111167,220439,1895,0,-73867,0,0,0,,73867,-73867
30,07/27/2018,92,22:45,23:00,,-106.49,0,-106.49,-106.49,-1,-110136,154278,264414,44142,0,-50625,0,0,0,,50625,-50625
30,07/27/2018,93,23:00,23:15,68.73,-106.47,0,68.73,-106.47,2,-89552,113959,203511,24407,0,-66933,281,0,0,,67214,-66652
30,07/27/2018,94,23:15,23:30,68.73,-47.72,0,68.73,-47.72,2,-54302,170173,224475,115871,0,-14634,327,0,0,,14961,-14307
30,07/27/2018,95,23:30,23:45,,-47.74,0,-47.74,-47.74,-1,-49849,175507,225356,125658,0,-41775,0,0,0,,41775,-41775
30,07/27/2018,96,23:45,0:00,,-47.78,0,-47.78,-47.78,-1,-53581,234340,287921,180759,0,-39135,0,0,0,,39135,-39135
31,07/28/2018,1,0:00,0:15,160.12,34.53,0,160.12,160.12,1,-99776,66049,165825,-33727,0,-17346,10169,0,0,,27515,-7177
31,07/28/2018,2,0:15,0:30,160.12,,0,160.12,160.12,1,-107721,67322,175043,-40399,0,0,57408,0,0,,57408,57408
31,07/28/2018,3,0:30,0:45,160.12,39.78,0,39.78,39.78,-1,-62001,105529,167530,43528,0,-1562,6551,0,0,,8113,4989
31,07/28/2018,4,0:45,1:00,,42.51,0,42.51,42.51,-1,-59139,100732,159871,41593,0,-240,0,0,0,,240,-240
31,07/28/2018,5,1:00,1:15,153.12,41.27,0,153.12,153.12,1,-106670,44509,151179,-62161,0,-138,18161,0,0,,18299,18023
31,07/28/2018,6,1:15,1:30,152.12,,0,152.12,152.12,1,-106550,51145,157695,-55405,0,0,69160,0,0,,69160,69160
31,07/28/2018,7,1:30,1:45,50.81,42.04,0,50.81,42.04,2,-81597,61217,142814,-20380,0,-1256,17190,0,0,,18446,15934
31,07/28/2018,8,1:45,2:00,50.81,,0,50.81,50.81,1,-91378,47364,138742,-44014,0,0,15421,0,0,,15421,15421
31,07/28/2018,9,2:00,2:15,73.2,,0,73.2,73.2,1,-108020,70847,178867,-37173,0,0,21541,0,0,,21541,21541
31,07/28/2018,10,2:15,2:30,93.14,,0,93.14,93.14,1,-109772,58368,168140,-51404,0,0,45446,0,0,,45446,45446
31,07/28/2018,11,2:30,2:45,73.2,,0,73.2,73.2,1,-93908,26373,120281,-67535,0,0,52780,0,0,,52780,52780
31,07/28/2018,12,2:45,3:00,66.15,,0,66.15,66.15,1,-92780,26501,119281,-66279,0,0,53728,0,0,,53728,53728
31,07/28/2018,13,3:00,3:15,50.72,,0,50.72,50.72,1,-84447,39268,123715,-45179,0,0,39135,0,0,,39135,39135
31,07/28/2018,14,3:15,3:30,50.72,,0,50.72,50.72,1,-80791,40287,121078,-40504,0,0,31441,0,0,,31441,31441
31,07/28/2018,15,3:30,3:45,66.15,,0,66.15,66.15,1,-85359,32131,117490,-53228,0,0,38956,0,0,,38956,38956
31,07/28/2018,16,3:45,4:00,66.15,,0,66.15,66.15,1,-90773,19000,109773,-71773,0,0,48332,0,0,,48332,48332
31,07/28/2018,17,4:00,4:15,93.14,,0,93.14,93.14,1,-105760,23449,129209,-82311,0,0,48579,0,0,,48579,48579
31,07/28/2018,18,4:15,4:30,148.18,,0,148.18,148.18,1,-111072,18778,129850,-92294,0,0,62747,0,0,,62747,62747
31,07/28/2018,19,4:30,4:45,170.77,,0,170.77,170.77,1,-84631,39079,123710,-45552,0,0,40152,8750,0,,48902,48902
31,07/28/2018,20,4:45,5:00,50.72,41.01,0,50.72,41.01,2,-70067,50806,120873,-19261,0,-120,5231,0,0,,5351,5111
31,07/28/2018,21,5:00,5:15,66.43,,0,66.43,66.43,1,-86290,64646,150936,-21644,0,0,24471,0,0,,24471,24471
31,07/28/2018,22,5:15,5:30,50.72,,0,50.72,50.72,1,-82627,66347,148974,-16280,0,0,7760,0,0,,7760,7760
31,07/28/2018,23,5:30,5:45,46.53,,0,46.53,46.53,1,-86389,75012,161401,-11377,0,0,9641,0,0,,9641,9641
31,07/28/2018,24,5:45,6:00,50.72,,0,50.72,50.72,1,-84091,56923,141014,-27168,0,0,12145,0,0,,12145,12145
31,07/28/2018,25,6:00,6:15,42.53,,0,42.53,42.53,1,-64265,62438,126703,-1827,0,0,3249,0,0,,3249,3249
31,07/28/2018,26,6:15,6:30,,,0,42.3,42.3,0,-76665,67897,144562,-8768,0,0,0,0,0,,0,0
31,07/28/2018,27,6:30,6:45,42.69,,0,42.69,42.69,1,-82670,69577,152247,-13093,0,0,2137,0,0,,2137,2137
31,07/28/2018,28,6:45,7:00,50.72,,0,50.72,50.72,1,-103706,54932,158638,-48774,0,0,24439,0,0,,24439,24439
31,07/28/2018,29,7:00,7:15,50.72,41.58,0,50.72,41.58,2,-51649,56373,108022,4724,0,-1405,14170,0,0,,15575,12765
31,07/28/2018,30,7:15,7:30,56.2,41.58,0,56.2,56.2,1,-70095,41558,111653,-28537,0,-104,3349,0,0,,3453,3245
31,07/28/2018,31,7:30,7:45,66.43,,0,66.43,66.43,1,-102692,40687,143379,-62005,0,0,36937,0,0,,36937,36937
31,07/28/2018,32,7:45,8:00,51.12,,0,51.12,51.12,1,-127196,67095,194291,-60101,0,0,45765,0,0,,45765,45765
31,07/28/2018,33,8:00,8:15,56.2,,0,56.2,56.2,1,-100825,65364,166189,-35461,0,0,25825,0,0,,25825,25825
31,07/28/2018,34,8:15,8:30,66.15,,0,66.15,66.15,1,-113558,62336,175894,-51222,0,0,15276,0,0,,15276,15276
31,07/28/2018,35,8:30,8:45,66.43,,0,66.43,66.43,1,-142847,56549,199396,-86298,0,0,42038,0,0,,42038,42038
31,07/28/2018,36,8:45,9:00,155.12,,0,155.12,155.12,1,-159594,64519,224113,-95075,0,0,63660,0,0,,63660,63660
31,07/28/2018,37,9:00,9:15,85.22,,0,85.22,85.22,1,-115208,57180,172388,-58028,0,0,66587,0,0,,66587,66587
31,07/28/2018,38,9:15,9:30,66.15,,0,66.15,66.15,1,-124886,61486,186372,-63400,0,0,51178,0,0,,51178,51178
31,07/28/2018,39,9:30,9:45,107.12,,0,107.12,107.12,1,-154849,58655,213504,-96194,0,0,72009,0,0,,72009,72009
31,07/28/2018,40,9:45,10:00,70.12,,0,70.12,70.12,1,-155211,63470,218681,-91741,0,0,68279,0,0,,68279,68279
31,07/28/2018,41,10:00,10:15,51.6,41.44,0,51.6,41.44,2,-113033,62446,175479,-50587,0,-1415,11295,0,0,,12710,9880
31,07/28/2018,42,10:15,10:30,77.66,,0,77.66,77.66,1,-135941,47336,183277,-88605,0,0,28047,0,0,,28047,28047
31,07/28/2018,43,10:30,10:45,46.53,,0,46.53,46.53,1,-143231,52627,195858,-90604,0,0,9699,0,0,,9699,9699
31,07/28/2018,44,10:45,11:00,71.6,,0,71.6,71.6,1,-120308,55518,175826,-64790,0,0,15945,0,0,,15945,15945
31,07/28/2018,45,11:00,11:15,43.2,41.27,0,43.2,41.27,2,-103099,90504,193603,-12595,0,-3,4800,0,0,,4803,4797
31,07/28/2018,46,11:15,11:30,43.2,34.53,0,34.53,34.53,-1,-87109,111310,198419,24201,0,-6083,204,0,0,,6287,-5879
31,07/28/2018,47,11:30,11:45,,34.53,0,34.53,34.53,-1,-73570,107645,181215,34075,0,-11534,0,0,0,,11534,-11534
31,07/28/2018,48,11:45,12:00,,39.87,0,39.87,39.87,-1,-68770,120111,188881,51341,0,-553,0,0,0,,553,-553
31,07/28/2018,49,12:00,12:15,,38.53,0,38.53,38.53,-1,-93392,94591,187983,1199,0,-1987,0,0,0,,1987,-1987
31,07/28/2018,50,12:15,12:30,,38.53,0,38.53,38.53,-1,-78272,92394,170666,14122,0,-13407,0,0,0,,13407,-13407
31,07/28/2018,51,12:30,12:45,,42.51,0,42.51,42.51,-1,-87525,108165,195690,20640,0,-3810,0,0,0,,3810,-3810
31,07/28/2018,52,12:45,13:00,,40.44,0,40.44,40.44,-1,-102050,127724,229774,25674,0,-2172,0,0,0,,2172,-2172
31,07/28/2018,53,13:00,13:15,50.67,40.87,0,50.67,40.87,2,-97892,45460,143352,-52432,0,-477,5474,0,0,,5951,4997
31,07/28/2018,54,13:15,13:30,46.53,41.92,0,46.53,41.92,2,-69043,57544,126587,-11499,0,-19,9666,0,0,,9685,9647
31,07/28/2018,55,13:30,13:45,46.53,40.78,0,40.78,40.78,-1,-63666,72989,136655,9323,0,-403,240,0,0,,643,-163
31,07/28/2018,56,13:45,14:00,,41.97,0,41.97,41.97,-1,-83292,100970,184262,17678,0,-1116,0,0,0,,1116,-1116
31,07/28/2018,57,14:00,14:15,50.67,41.97,0,50.67,50.67,1,-155257,31051,186308,-124206,0,-94,6848,0,0,,6942,6754
31,07/28/2018,58,14:15,14:30,42.53,,0,42.53,42.53,1,-122260,47851,170111,-74409,0,0,904,0,0,,904,904
31,07/28/2018,59,14:30,14:45,,,0,42.01,42.01,0,-87506,64214,151720,-23292,0,0,0,0,0,,0,0
31,07/28/2018,60,14:45,15:00,,,0,42.05,42.05,0,-101178,83826,185004,-17352,0,0,0,0,0,,0,0
31,07/28/2018,61,15:00,15:15,42.78,,0,42.78,42.78,1,-147529,43923,191452,-103606,0,0,149,0,0,,149,149
31,07/28/2018,62,15:15,15:30,,38.41,0,38.41,38.41,-1,-104727,76900,181627,-27827,0,-99,0,0,0,,99,-99
31,07/28/2018,63,15:30,15:45,,30.81,0,30.81,30.81,-1,-83737,133518,217255,49781,0,-15476,0,0,0,,15476,-15476
31,07/28/2018,64,15:45,16:00,,16.43,0,16.43,16.43,-1,-67001,138887,205888,71886,0,-25116,0,0,0,,25116,-25116
31,07/28/2018,65,16:00,16:15,42.53,16.43,0,42.53,42.53,1,-28816,61058,89874,32242,0,-7151,122,0,0,,7273,-7029
31,07/28/2018,66,16:15,16:30,,,0,40.53,40.53,0,-36188,74164,110352,37976,0,0,0,0,0,,0,0
31,07/28/2018,67,16:30,16:45,46.53,,0,46.53,46.53,1,-65792,55714,121506,-10078,0,0,2679,0,0,,2679,2679
31,07/28/2018,68,16:45,17:00,53.13,,0,53.13,53.13,1,-75378,29260,104638,-46118,0,0,21284,0,0,,21284,21284
31,07/28/2018,69,17:00,17:15,53.13,36.74,0,36.74,36.74,-1,-52085,69571,121656,17486,0,-2972,2262,0,0,,5234,-710
31,07/28/2018,70,17:15,17:30,,38.53,0,38.53,38.53,-1,-64981,78444,143425,13463,0,-4998,0,0,0,,4998,-4998
31,07/28/2018,71,17:30,17:45,,,0,40.61,40.61,0,-64461,57705,122166,-6756,0,-862,0,0,0,,862,-862
31,07/28/2018,72,17:45,18:00,,34.53,0,34.53,34.53,-1,-40623,58583,99206,17960,0,-1101,0,0,0,,1101,-1101
31,07/28/2018,73,18:00,18:15,,-58.66,0,-58.66,-58.66,-1,-29302,98692,127994,69390,0,-27103,0,0,0,,27103,-27103
31,07/28/2018,74,18:15,18:30,43.69,-76.18,0,43.69,43.69,1,-58545,64251,122796,5706,0,-35032,164,0,0,,35196,-34868
31,07/28/2018,75,18:30,18:45,43.65,26.09,0,43.65,26.09,2,-40552,87852,128404,47300,0,-15533,188,0,0,,15721,-15345
31,07/28/2018,76,18:45,19:00,,34.53,0,34.53,34.53,-1,-30281,76578,106859,46297,0,-19645,0,0,0,,19645,-19645
31,07/28/2018,77,19:00,19:15,,,0,42.43,42.43,0,-39820,109843,149663,70023,0,-311,0,0,0,,311,-311
31,07/28/2018,78,19:15,19:30,,,0,42.41,42.41,0,-36763,90376,127139,53613,0,0,0,0,0,,0,0
31,07/28/2018,79,19:30,19:45,,,0,42.42,42.42,0,-49528,74461,123989,24933,0,0,0,0,0,,0,0
31,07/28/2018,80,19:45,20:00,50.67,,0,50.67,50.67,1,-67435,41597,109032,-25838,0,0,9926,0,0,,9926,9926
31,07/28/2018,81,20:00,20:15,,,0,42.46,42.46,0,-56313,102219,158532,45906,0,0,2317,0,0,,2317,2317
31,07/28/2018,82,20:15,20:30,,,0,42.45,42.45,0,-63853,87721,151574,23868,0,0,0,0,0,,0,0
31,07/28/2018,83,20:30,20:45,43.85,,0,43.85,43.85,1,-80248,67263,147511,-12985,0,0,3516,0,0,,3516,3516
31,07/28/2018,84,20:45,21:00,46.53,,0,46.53,46.53,1,-79045,67943,146988,-11102,0,0,8779,0,0,,8779,8779
31,07/28/2018,85,21:00,21:15,46.53,42.5,0,42.5,42.5,-1,-55991,97620,153611,41629,0,-314,2344,0,0,,2658,2030
31,07/28/2018,86,21:15,21:30,,,0,42.48,42.48,0,-57871,100415,158286,42544,0,-51,0,0,0,,51,-51
31,07/28/2018,87,21:30,21:45,,,0,42.47,42.47,0,-70519,93987,164506,23468,0,0,0,0,0,,0,0
31,07/28/2018,88,21:45,22:00,42.53,,0,42.53,42.53,1,-93191,73580,166771,-19611,0,0,732,0,0,,732,732
31,07/28/2018,89,22:00,22:15,44.17,,0,44.17,44.17,1,-70493,93142,163635,22649,0,0,1703,0,0,,1703,1703
31,07/28/2018,90,22:15,22:30,,34.53,0,34.53,34.53,-1,-64019,108985,173004,44966,0,-3448,0,0,0,,3448,-3448
31,07/28/2018,91,22:30,22:45,,40.52,0,40.52,40.52,-1,-60888,110168,171056,49280,0,-2151,0,0,0,,2151,-2151
31,07/28/2018,92,22:45,23:00,,,0,42.48,42.48,0,-64595,132968,197563,68373,0,0,0,0,0,,0,0
31,07/28/2018,93,23:00,23:15,,42.34,0,42.34,42.34,-1,-76083,142297,218380,66214,0,-42,0,0,0,,42,-42
31,07/28/2018,94,23:15,23:30,,30.81,0,30.81,30.81,-1,-75759,127511,203270,51752,0,-10085,0,0,0,,10085,-10085
31,07/28/2018,95,23:30,23:45,,30.81,0,30.81,30.81,-1,-90911,104654,195565,13743,0,-20296,0,0,0,,20296,-20296
31,07/28/2018,96,23:45,0:00,,16.43,0,16.43,16.43,-1,-80685,95024,175709,14339,0,-9738,0,0,0,,9738,-9738
31,07/29/2018,1,0:00,0:15,42.13,-94.2,0,42.25,-94.2,2,-44116,84718,128834,40602,0,-17023,10,0,0,,17033,-17013
31,07/29/2018,2,0:15,0:30,43.04,37.8,0,43.04,37.8,2,-64251,75686,139937,11435,0,-414,830,0,0,,1244,416
31,07/29/2018,3,0:30,0:45,,33.16,0,33.16,33.16,-1,-62825,88977,151802,26152,0,-9524,0,0,0,,9524,-9524
31,07/29/2018,4,0:45,1:00,,34.13,0,34.13,34.13,-1,-72488,83310,155798,10822,0,-17325,0,0,0,,17325,-17325
31,07/29/2018,5,1:00,1:15,190.11,34.13,0,190.11,190.11,1,-79202,30134,109336,-49068,0,-3996,23340,0,0,,27336,19344
31,07/29/2018,6,1:15,1:30,190.11,,0,190.11,190.11,1,-86224,57533,143757,-28691,0,0,50561,0,0,,50561,50561
31,07/29/2018,7,1:30,1:45,190.11,38.13,0,38.13,38.13,-1,-65225,76502,141727,11277,0,-1388,4608,0,0,,5996,3220
31,07/29/2018,8,1:45,2:00,43.83,,0,43.83,43.83,1,-71936,60134,132070,-11802,0,0,1263,0,0,,1263,1263
31,07/29/2018,9,2:00,2:15,42.72,,0,42.72,42.72,1,-72563,85386,157949,12823,0,0,1011,0,0,,1011,1011
31,07/29/2018,10,2:15,2:30,50.35,,0,50.35,50.35,1,-76280,58969,135249,-17311,0,0,13648,0,0,,13648,13648
31,07/29/2018,11,2:30,2:45,40.02,,0,40.02,40.02,1,-63267,67777,131044,4510,0,0,3207,0,0,,3207,3207
31,07/29/2018,12,2:45,3:00,,41.18,0,41.18,41.18,-1,-62409,68850,131259,6441,0,-1179,0,0,0,,1179,-1179
31,07/29/2018,13,3:00,3:15,42.78,42.12,0,42.78,41.07,2,-51549,35009,86558,-16540,0,-790,841,0,0,,1631,51
31,07/29/2018,14,3:15,3:30,42.79,,0,42.79,42.79,1,-61912,51619,113531,-10293,0,0,695,0,0,,695,695
31,07/29/2018,15,3:30,3:45,43.75,,0,43.75,43.75,1,-62430,54707,117137,-7723,0,0,3678,0,0,,3678,3678
31,07/29/2018,16,3:45,4:00,43.67,,0,43.67,43.67,1,-70799,63629,134428,-7170,0,0,6173,0,0,,6173,6173
31,07/29/2018,17,4:00,4:15,,,0,41.05,41.05,0,-64264,77934,142198,13670,0,0,705,0,0,,705,705
31,07/29/2018,18,4:15,4:30,,40.86,0,40.86,40.86,-1,-49514,67589,117103,18075,0,-173,0,0,0,,173,-173
31,07/29/2018,19,4:30,4:45,,38.13,0,38.13,38.13,-1,-50358,60517,110875,10159,0,-3953,0,0,0,,3953,-3953
31,07/29/2018,20,4:45,5:00,,39.36,0,39.36,39.36,-1,-55065,56322,111387,1257,0,-4808,0,0,0,,4808,-4808
31,07/29/2018,21,5:00,5:15,,42.06,0,42.06,42.06,-1,-68084,85038,153122,16954,0,-998,0,0,0,,998,-998
31,07/29/2018,22,5:15,5:30,,42.11,0,42.11,42.11,-1,-66716,62445,129161,-4271,0,-380,0,0,0,,380,-380
31,07/29/2018,23,5:30,5:45,,42.16,0,42.16,42.16,-1,-49040,46892,95932,-2148,0,-9,0,0,0,,9,-9
31,07/29/2018,24,5:45,6:00,,30.42,0,30.42,30.42,-1,-33214,63292,96506,30078,0,-5694,0,0,0,,5694,-5694
31,07/29/2018,25,6:00,6:15,,38.09,0,38.09,38.09,-1,-40226,58245,98471,18019,0,-5272,0,0,0,,5272,-5272
31,07/29/2018,26,6:15,6:30,,,0,41.08,41.08,0,-26387,92049,118436,65662,0,0,0,0,0,,0,0
31,07/29/2018,27,6:30,6:45,,38.09,0,38.09,38.09,-1,-28547,92099,120646,63552,0,-826,0,0,0,,826,-826
31,07/29/2018,28,6:45,7:00,,38.09,0,38.09,38.09,-1,-27658,87245,114903,59587,0,-1507,0,0,0,,1507,-1507
31,07/29/2018,29,7:00,7:15,,30.38,0,30.38,30.38,-1,-19575,115768,135343,96193,0,-5437,0,0,0,,5437,-5437
31,07/29/2018,30,7:15,7:30,,37.85,0,37.85,37.85,-1,-19438,111870,131308,92432,0,-3494,0,0,0,,3494,-3494
31,07/29/2018,31,7:30,7:45,,38.5,0,38.5,38.5,-1,-21834,107354,129188,85520,0,-75,0,0,0,,75,-75
31,07/29/2018,32,7:45,8:00,,,0,39.24,39.24,0,-27500,118696,146196,91196,0,0,0,0,0,,0,0
31,07/29/2018,33,8:00,8:15,,34.09,0,34.09,34.09,-1,-22602,74366,96968,51764,0,-4235,0,0,0,,4235,-4235
31,07/29/2018,34,8:15,8:30,,38.09,0,38.09,38.09,-1,-39894,53742,93636,13848,0,-1049,0,0,0,,1049,-1049
31,07/29/2018,35,8:30,8:45,,,0,39.31,39.31,0,-41093,48022,89115,6929,0,0,0,0,0,,0,0
31,07/29/2018,36,8:45,9:00,,,0,39.27,39.27,0,-42005,60418,102423,18413,0,0,0,0,0,,0,0
31,07/29/2018,37,9:00,9:15,39.34,,0,39.34,39.34,1,-76026,46806,122832,-29220,0,0,356,0,0,,356,356
31,07/29/2018,38,9:15,9:30,39.32,,0,39.32,39.32,1,-67151,54467,121618,-12684,0,0,6,0,0,,6,6
31,07/29/2018,39,9:30,9:45,,41.9,0,41.9,41.9,-1,-52960,68349,121309,15389,0,-29,0,0,0,,29,-29
31,07/29/2018,40,9:45,10:00,,30.38,0,30.38,30.38,-1,-25736,90520,116256,64784,0,-1403,0,0,0,,1403,-1403
31,07/29/2018,41,10:00,10:15,,-150.03,0,-150.03,-150.03,-1,-43368,72519,115887,29151,0,-41787,0,0,0,,41787,-41787
31,07/29/2018,42,10:15,10:30,43.39,30.38,0,43.39,30.38,2,-57337,80741,138078,23404,0,-5420,167,0,0,,5587,-5253
31,07/29/2018,43,10:30,10:45,,30.03,0,30.03,30.03,-1,-40837,91844,132681,51007,0,-31229,0,0,0,,31229,-31229
31,07/29/2018,44,10:45,11:00,,30.38,0,30.38,30.38,-1,-51144,113060,164204,61916,0,-46258,0,0,0,,46258,-46258
31,07/29/2018,45,11:00,11:15,,31.39,0,31.39,31.39,-1,-76557,102048,178605,25491,0,-38273,0,0,0,,38273,-38273
31,07/29/2018,46,11:15,11:30,,30.38,0,30.38,30.38,-1,-82005,122136,204141,40131,0,-36673,0,0,0,,36673,-36673
31,07/29/2018,47,11:30,11:45,,30.38,0,30.38,30.38,-1,-78601,126835,205436,48234,0,-48256,0,0,0,,48256,-48256
31,07/29/2018,48,11:45,12:00,,30.38,0,30.38,30.38,-1,-77265,131376,208641,54111,0,-43618,0,0,0,,43618,-43618
31,07/29/2018,49,12:00,12:15,,30.38,0,30.38,30.38,-1,-75340,104868,180208,29528,0,-30107,0,0,0,,30107,-30107
31,07/29/2018,50,12:15,12:30,,38.09,0,38.09,38.09,-1,-78634,101287,179921,22653,0,-3035,0,0,0,,3035,-3035
31,07/29/2018,51,12:30,12:45,,37.12,0,37.12,37.12,-1,-70347,91769,162116,21422,0,-1742,0,0,0,,1742,-1742
31,07/29/2018,52,12:45,13:00,,,0,39.32,39.32,0,-87135,94570,181705,7435,0,0,0,0,0,,0,0
31,07/29/2018,53,13:00,13:15,,,0,39.41,39.41,0,-82393,68825,151218,-13568,0,0,0,0,0,,0,0
31,07/29/2018,54,13:15,13:30,,,0,40.07,40.07,0,-95747,45896,141643,-49851,0,0,0,0,0,,0,0
31,07/29/2018,55,13:30,13:45,,,0,40.07,40.07,0,-106140,37535,143675,-68605,0,0,0,0,0,,0,0
31,07/29/2018,56,13:45,14:00,,,0,40.07,40.07,0,-124581,33961,158542,-90620,0,0,0,0,0,,0,0
31,07/29/2018,57,14:00,14:15,44.76,,0,44.76,44.76,1,-119365,51198,170563,-68167,0,0,2480,0,0,,2480,2480
31,07/29/2018,58,14:15,14:30,39.5,,0,39.5,39.5,1,-149634,42513,192147,-107121,0,0,1150,0,0,,1150,1150
31,07/29/2018,59,14:30,14:45,43.56,,0,43.56,43.56,1,-161039,22842,183881,-138197,0,0,546,0,0,,546,546
31,07/29/2018,60,14:45,15:00,57.48,,0,57.48,57.48,1,-201712,10872,212584,-190840,0,0,28663,0,0,,28663,28663
31,07/29/2018,61,15:00,15:15,50.35,,0,50.35,50.35,1,-129792,27391,157183,-102401,0,0,42022,0,0,,42022,42022
31,07/29/2018,62,15:15,15:30,54.47,,0,54.47,54.47,1,-147483,35540,183023,-111943,0,0,48778,0,0,,48778,48778
31,07/29/2018,63,15:30,15:45,66.03,,0,66.03,66.03,1,-152440,48372,200812,-104068,0,0,67991,0,0,,67991,67991
31,07/29/2018,64,15:45,16:00,65.75,,0,65.75,65.75,1,-164108,79399,243507,-84709,0,0,57714,0,0,,57714,57714
31,07/29/2018,65,16:00,16:15,65.71,,0,65.71,65.71,1,-121521,62941,184462,-58580,0,0,44755,0,0,,44755,44755
31,07/29/2018,66,16:15,16:30,50.35,39.75,0,39.75,39.75,-1,-93632,86109,179741,-7523,0,-510,26219,0,0,,26729,25709
31,07/29/2018,67,16:30,16:45,50.35,38.09,0,50.35,38.09,2,-95835,67372,163207,-28463,0,-246,11659,0,0,,11905,11413
31,07/29/2018,68,16:45,17:00,46.09,,0,46.09,46.09,1,-113808,91675,205483,-22133,0,0,17728,0,0,,17728,17728
31,07/29/2018,69,17:00,17:15,46.09,38.01,0,38.01,38.01,-1,-84398,93887,178285,9489,0,-1003,4399,0,0,,5402,3396
31,07/29/2018,70,17:15,17:30,50.31,38.01,0,50.31,50.31,1,-102379,67781,170160,-34598,0,-13,4915,0,0,,4928,4902
31,07/29/2018,71,17:30,17:45,66.03,,0,66.03,66.03,1,-133105,55538,188643,-77567,0,0,50726,0,0,,50726,50726
31,07/29/2018,72,17:45,18:00,142.44,,0,142.44,142.44,1,-148368,48895,197263,-99473,0,0,75072,0,0,,75072,75072
31,07/29/2018,73,18:00,18:15,91.44,,0,91.44,91.44,1,-120741,72276,193017,-48465,0,0,56750,0,0,,56750,56750
31,07/29/2018,74,18:15,18:30,,,0,42.19,42.19,0,-92185,74774,166959,-17411,0,0,1847,0,0,,1847,1847
31,07/29/2018,75,18:30,18:45,50.61,,0,50.61,50.61,1,-85999,60141,146140,-25858,0,0,3457,0,0,,3457,3457
31,07/29/2018,76,18:45,19:00,52.34,,0,52.34,52.34,1,-80961,75326,156287,-5635,0,0,8277,0,0,,8277,8277
31,07/29/2018,77,19:00,19:15,52.34,38.09,0,38.09,38.09,-1,-56682,90724,147406,34042,0,-555,21,0,0,,576,-534
31,07/29/2018,78,19:15,19:30,42.09,42.39,0,42.24,42.24,2,-61606,69099,130705,7493,0,-580,4,0,0,,584,-576
31,07/29/2018,79,19:30,19:45,42.09,,0,42.09,42.09,1,-73923,72997,146920,-926,0,0,2086,0,0,,2086,2086
31,07/29/2018,80,19:45,20:00,66.03,,0,66.03,66.03,1,-106631,72102,178733,-34529,0,0,10927,0,0,,10927,10927
31,07/29/2018,81,20:00,20:15,50.81,40.61,0,50.81,40.61,2,-95734,109143,204877,13409,0,-519,12728,0,0,,13247,12209
31,07/29/2018,82,20:15,20:30,,,0,42.57,42.57,0,-77741,94320,172061,16579,0,-72,80,0,0,,152,8
31,07/29/2018,83,20:30,20:45,,,0,42.6,42.6,0,-45877,95006,140883,49129,0,0,0,0,0,,0,0
31,07/29/2018,84,20:45,21:00,,,0,42.61,42.61,0,-43769,107757,151526,63988,0,0,0,0,0,,0,0
31,07/29/2018,85,21:00,21:15,,,0,42.63,42.63,0,-45994,92492,138486,46498,0,0,0,0,0,,0,0
31,07/29/2018,86,21:15,21:30,,,0,42.63,42.63,0,-50944,85638,136582,34694,0,0,0,0,0,,0,0
31,07/29/2018,87,21:30,21:45,,,0,42.63,42.63,0,-55257,63842,119099,8585,0,0,0,0,0,,0,0
31,07/29/2018,88,21:45,22:00,53.64,,0,53.64,53.64,1,-81814,47662,129476,-34152,0,0,12423,0,0,,12423,12423
31,07/29/2018,89,22:00,22:15,46.74,,0,46.74,46.74,1,-91084,47676,138760,-43408,0,0,9394,0,0,,9394,9394
31,07/29/2018,90,22:15,22:30,43.97,,0,43.97,43.97,1,-91905,29826,121731,-62079,0,0,371,0,0,,371,371
31,07/29/2018,91,22:30,22:45,66.03,,0,66.03,66.03,1,-94511,35886,130397,-58625,0,0,8506,0,0,,8506,8506
31,07/29/2018,92,22:45,23:00,50.81,,0,50.81,50.81,1,-91021,42066,133087,-48955,0,0,17988,0,0,,17988,17988
31,07/29/2018,93,23:00,23:15,50.81,,0,50.81,50.81,1,-126086,24082,150168,-102004,0,0,8544,0,0,,8544,8544
31,07/29/2018,94,23:15,23:30,46.74,,0,46.74,46.74,1,-99978,30252,130230,-69726,0,0,5223,0,0,,5223,5223
31,07/29/2018,95,23:30,23:45,,,0,42.56,42.56,0,-82018,39023,121041,-42995,0,0,0,0,0,,0,0
31,07/29/2018,96,23:45,0:00,,,0,42.57,42.57,0,-80953,56054,137007,-24899,0,0,0,0,0,,0,0
31,07/30/2018,1,0:00,0:15,237.16,,0,237.16,237.16,1,-154986,9647,164633,-145339,0,0,27509,0,0,,27509,27509
31,07/30/2018,2,0:15,0:30,58.16,,0,58.16,58.16,1,-115405,14135,129540,-101270,0,0,38106,0,0,,38106,38106
31,07/30/2018,3,0:30,0:45,,,0,42.02,42.02,0,-109985,25886,135871,-84099,0,0,2063,0,0,,2063,2063
31,07/30/2018,4,0:45,1:00,,,0,42.05,42.05,0,-103734,35783,139517,-67951,0,0,0,0,0,,0,0
31,07/30/2018,5,1:00,1:15,237.12,,0,237.12,237.12,1,-138931,19516,158447,-119415,0,0,21466,0,0,,21466,21466
31,07/30/2018,6,1:15,1:30,237.12,,0,237.12,237.12,1,-126676,21601,148277,-105075,0,0,94676,0,0,,94676,94676
31,07/30/2018,7,1:30,1:45,50.78,,0,50.78,50.78,1,-87169,37329,124498,-49840,0,0,47793,0,0,,47793,47793
31,07/30/2018,8,1:45,2:00,,,0,41.41,41.41,0,-77476,27722,105198,-49754,0,0,1143,0,0,,1143,1143
31,07/30/2018,9,2:00,2:15,237.12,,0,237.12,237.12,1,-120764,21282,142046,-99482,0,0,24963,0,0,,24963,24963
31,07/30/2018,10,2:15,2:30,245.04,,0,245.04,245.04,1,-116043,30445,146488,-85598,0,0,48635,3750,0,,52385,52385
31,07/30/2018,11,2:30,2:45,66.22,,0,66.22,66.22,1,-83595,32812,116407,-50783,0,0,3654,0,0,,3654,3654
31,07/30/2018,12,2:45,3:00,116.22,,0,116.22,116.22,1,-79334,42970,122304,-36364,0,0,25000,0,0,,25000,25000
31,07/30/2018,13,3:00,3:15,,,0,41.28,41.28,0,-73808,67394,141202,-6414,0,0,1522,0,0,,1522,1522
31,07/30/2018,14,3:15,3:30,43.17,,0,43.17,43.17,1,-101250,49327,150577,-51923,0,0,2324,0,0,,2324,2324
31,07/30/2018,15,3:30,3:45,42.74,,0,42.74,42.74,1,-100704,46587,147291,-54117,0,0,2897,0,0,,2897,2897
31,07/30/2018,16,3:45,4:00,46.74,,0,46.74,46.74,1,-94528,43071,137599,-51457,0,0,3864,0,0,,3864,3864
31,07/30/2018,17,4:00,4:15,46.74,,0,46.74,46.74,1,-91542,40274,131816,-51268,0,0,2413,0,0,,2413,2413
31,07/30/2018,18,4:15,4:30,46.74,,0,46.74,46.74,1,-96767,39466,136233,-57301,0,0,4749,0,0,,4749,4749
31,07/30/2018,19,4:30,4:45,43.44,,0,43.44,43.44,1,-105689,37348,143037,-68341,0,0,2731,0,0,,2731,2731
31,07/30/2018,20,4:45,5:00,66.22,,0,66.22,66.22,1,-105073,39032,144105,-66041,0,0,13216,0,0,,13216,13216
31,07/30/2018,21,5:00,5:15,66.22,39.97,0,39.97,39.97,-1,-106480,33181,139661,-73299,0,-303,2531,0,0,,2834,2228
31,07/30/2018,22,5:15,5:30,,,0,41.36,41.36,0,-107943,29276,137219,-78667,0,0,0,0,0,,0,0
31,07/30/2018,23,5:30,5:45,,,0,41.32,41.32,0,-146772,25854,172626,-120918,0,0,0,0,0,,0,0
31,07/30/2018,24,5:45,6:00,,,0,41.31,41.31,0,-187597,30719,218316,-156878,0,0,0,0,0,,0,0
31,07/30/2018,25,6:00,6:15,,42.3,0,42.3,42.3,-1,-124119,34357,158476,-89762,0,-399,0,0,0,,399,-399
31,07/30/2018,26,6:15,6:30,,,0,41.69,41.69,0,-150725,31938,182663,-118787,0,-1,0,0,0,,1,-1
31,07/30/2018,27,6:30,6:45,,,0,41.63,41.63,0,-173332,28896,202228,-144436,0,0,0,0,0,,0,0
31,07/30/2018,28,6:45,7:00,46.87,,0,46.87,46.87,1,-152231,28477,180708,-123754,0,0,1490,0,0,,1490,1490
31,07/30/2018,29,7:00,7:15,,,0,41.82,41.82,0,-126361,47944,174305,-78417,0,0,114,0,0,,114,114
31,07/30/2018,30,7:15,7:30,43.22,,0,43.22,43.22,1,-113923,37207,151130,-76716,0,0,345,0,0,,345,345
31,07/30/2018,31,7:30,7:45,43.11,,0,43.11,43.11,1,-139481,31205,170686,-108276,0,0,2168,0,0,,2168,2168
31,07/30/2018,32,7:45,8:00,51.1,,0,51.1,51.1,1,-158864,49168,208032,-109696,0,0,8832,0,0,,8832,8832
31,07/30/2018,33,8:00,8:15,68.42,,0,68.42,68.42,1,-176540,37471,214011,-139069,0,0,21454,0,0,,21454,21454
31,07/30/2018,34,8:15,8:30,50.5,,0,50.5,50.5,1,-135828,29224,165052,-106604,0,0,22662,0,0,,22662,22662
31,07/30/2018,35,8:30,8:45,,,0,41.95,41.95,0,-128046,30241,158287,-97805,0,0,1325,0,0,,1325,1325
31,07/30/2018,36,8:45,9:00,118.42,,0,118.42,118.42,1,-140672,25173,165845,-115499,0,0,16973,0,0,,16973,16973
31,07/30/2018,37,9:00,9:15,118.42,16.35,0,16.35,16.35,-1,-91048,68168,159216,-22880,0,-7403,4931,0,0,,12334,-2472
31,07/30/2018,38,9:15,9:30,,,0,41.95,41.95,0,-93775,60363,154138,-33412,0,-58,0,0,0,,58,-58
31,07/30/2018,39,9:30,9:45,,,0,42.5,42.5,0,-88466,69368,157834,-19098,0,0,0,0,0,,0,0
31,07/30/2018,40,9:45,10:00,,42.78,0,42.78,42.78,-1,-84307,89342,173649,5035,0,-12,0,0,0,,12,-12
31,07/30/2018,41,10:00,10:15,,42.4,0,42.4,42.4,-1,-52919,84578,137497,31659,0,-1381,0,0,0,,1381,-1381
31,07/30/2018,42,10:15,10:30,,42.4,0,42.4,42.4,-1,-55030,91534,146564,36504,0,-521,0,0,0,,521,-521
31,07/30/2018,43,10:30,10:45,,42.43,0,42.43,42.43,-1,-62398,82838,145236,20440,0,-910,0,0,0,,910,-910
31,07/30/2018,44,10:45,11:00,46.21,,0,46.21,46.21,1,-128529,80645,209174,-47884,0,0,2033,0,0,,2033,2033
31,07/30/2018,45,11:00,11:15,42.21,,0,42.21,42.21,1,-125370,66468,191838,-58902,0,0,1704,0,0,,1704,1704
31,07/30/2018,46,11:15,11:30,,,0,42.3,42.3,0,-114364,82093,196457,-32271,0,0,0,0,0,,0,0
31,07/30/2018,47,11:30,11:45,,,0,42.3,42.3,0,-119470,81874,201344,-37596,0,0,0,0,0,,0,0
31,07/30/2018,48,11:45,12:00,,,0,42.31,42.31,0,-110746,115965,226711,5219,0,0,0,0,0,,0,0
31,07/30/2018,49,12:00,12:15,,38.21,0,38.21,38.21,-1,-94351,105073,199424,10722,0,-613,0,0,0,,613,-613
31,07/30/2018,50,12:15,12:30,,38.21,0,38.21,38.21,-1,-127770,130364,258134,2594,0,-4703,0,0,0,,4703,-4703
31,07/30/2018,51,12:30,12:45,,42.35,0,42.35,42.35,-1,-114287,127101,241388,12814,0,-803,0,0,0,,803,-803
31,07/30/2018,52,12:45,13:00,,42.34,0,42.34,42.34,-1,-118311,126007,244318,7696,0,-93,0,0,0,,93,-93
31,07/30/2018,53,13:00,13:15,,42.3,0,42.3,42.3,-1,-118157,118800,236957,643,0,-694,0,0,0,,694,-694
31,07/30/2018,54,13:15,13:30,,,0,42.23,42.23,0,-136819,115192,252011,-21627,0,0,0,0,0,,0,0
31,07/30/2018,55,13:30,13:45,42.7,,0,42.7,42.7,1,-135704,114166,249870,-21538,0,0,390,0,0,,390,390
31,07/30/2018,56,13:45,14:00,42.21,,0,42.21,42.21,1,-134558,111969,246527,-22589,0,0,177,0,0,,177,177
31,07/30/2018,57,14:00,14:15,50.5,,0,50.5,50.5,1,-142887,115615,258502,-27272,0,0,14474,0,0,,14474,14474
31,07/30/2018,58,14:15,14:30,199.12,,0,199.12,199.12,1,-158993,92794,251787,-66199,0,0,33703,0,0,,33703,33703
31,07/30/2018,59,14:30,14:45,199.12,,0,199.12,199.12,1,-139921,78368,218289,-61553,0,0,53872,0,0,,53872,53872
31,07/30/2018,60,14:45,15:00,47.99,,0,47.99,47.99,1,-128383,104843,233226,-23540,0,0,20454,0,0,,20454,20454
31,07/30/2018,61,15:00,15:15,252.12,,0,252.12,252.12,1,-157447,76744,234191,-80703,0,0,16544,0,0,,16544,16544
31,07/30/2018,62,15:15,15:30,46.21,,0,46.21,46.21,1,-100291,76837,177128,-23454,0,0,11870,0,0,,11870,11870
31,07/30/2018,63,15:30,15:45,50.5,,0,50.5,50.5,1,-115034,98953,213987,-16081,0,0,4691,0,0,,4691,4691
31,07/30/2018,64,15:45,16:00,253.12,,0,253.12,253.12,1,-150055,79989,230044,-70066,0,0,47159,0,0,,47159,47159
31,07/30/2018,65,16:00,16:15,50.5,39.41,0,50.5,39.41,2,-82157,96775,178932,14618,0,-1406,26725,0,0,,28131,25319
31,07/30/2018,66,16:15,16:30,47.48,39.41,0,47.48,47.48,1,-112300,94799,207099,-17501,0,-63,3374,0,0,,3437,3311
31,07/30/2018,67,16:30,16:45,78.12,,0,78.12,78.12,1,-141655,86769,228424,-54886,0,0,39957,0,0,,39957,39957
31,07/30/2018,68,16:45,17:00,68.42,,0,68.42,68.42,1,-161001,82873,243874,-78128,0,0,55496,0,0,,55496,55496
31,07/30/2018,69,17:00,17:15,43.27,33.16,0,43.27,33.16,2,-97281,122672,219953,25391,0,-2788,20794,0,0,,23582,18006
31,07/30/2018,70,17:15,17:30,42.21,42.33,0,42.21,41.95,2,-120665,116831,237496,-3834,0,-215,242,0,0,,457,27
31,07/30/2018,71,17:30,17:45,43.18,,0,43.18,43.18,1,-132193,118980,251173,-13213,0,0,1207,0,0,,1207,1207
31,07/30/2018,72,17:45,18:00,42.21,,0,42.21,42.21,1,-142266,147516,289782,5250,0,0,112,0,0,,112,112
31,07/30/2018,73,18:00,18:15,43.29,,0,43.29,43.29,1,-136811,113337,250148,-23474,0,0,2222,0,0,,2222,2222
31,07/30/2018,74,18:15,18:30,50.5,,0,50.5,50.5,1,-138401,99913,238314,-38488,0,0,5567,0,0,,5567,5567
31,07/30/2018,75,18:30,18:45,51.99,,0,51.99,51.99,1,-125478,107962,233440,-17516,0,0,17897,0,0,,17897,17897
31,07/30/2018,76,18:45,19:00,46.21,,0,46.21,46.21,1,-123638,132965,256603,9327,0,0,8032,0,0,,8032,8032
31,07/30/2018,77,19:00,19:15,46.21,42.3,0,42.3,42.3,-1,-85104,141957,227061,56853,0,-458,6,0,0,,464,-452
31,07/30/2018,78,19:15,19:30,,,0,42.5,42.5,0,-80312,152677,232989,72365,0,0,0,0,0,,0,0
31,07/30/2018,79,19:30,19:45,,,0,42.5,42.5,0,-70643,149004,219647,78361,0,0,0,0,0,,0,0
31,07/30/2018,80,19:45,20:00,,,0,42.5,42.5,0,-68190,112918,181108,44728,0,0,0,0,0,,0,0
31,07/30/2018,81,20:00,20:15,,,0,42.5,42.5,0,-46749,116016,162765,69267,0,0,0,0,0,,0,0
31,07/30/2018,82,20:15,20:30,,38.21,0,38.21,38.21,-1,-43170,101103,144273,57933,0,-2753,0,0,0,,2753,-2753
31,07/30/2018,83,20:30,20:45,,36.99,0,36.99,36.99,-1,-35539,95986,131525,60447,0,-8361,0,0,0,,8361,-8361
31,07/30/2018,84,20:45,21:00,,30.31,0,30.31,30.31,-1,-31077,76794,107871,45717,0,-27485,0,0,0,,27485,-27485
31,07/30/2018,85,21:00,21:15,46.21,39.51,0,46.21,46.21,1,-46205,44946,91151,-1259,0,-14765,785,0,0,,15550,-13980
31,07/30/2018,86,21:15,21:30,,,0,26.89,26.89,0,-42952,71869,114821,28917,0,-35,71,0,0,,106,36
31,07/30/2018,87,21:30,21:45,,34.21,0,34.21,34.21,-1,-49923,121133,171056,71210,0,-5570,0,0,0,,5570,-5570
31,07/30/2018,88,21:45,22:00,,39.51,0,39.51,39.51,-1,-78957,145401,224358,66444,0,-5577,0,0,0,,5577,-5577
31,07/30/2018,89,22:00,22:15,,30.31,0,30.31,30.31,-1,-75078,139110,214188,64032,0,-2050,0,0,0,,2050,-2050
31,07/30/2018,90,22:15,22:30,,-21.58,0,-21.58,-21.58,-1,-43569,181719,225288,138150,0,-26471,0,0,0,,26471,-26471
31,07/30/2018,91,22:30,22:45,,-12.84,0,-12.84,-12.84,-1,-40927,180225,221152,139298,0,-30717,0,0,0,,30717,-30717
31,07/30/2018,92,22:45,23:00,,-0.96,0,-0.96,-0.96,-1,-41518,175273,216791,133755,0,-8654,0,0,0,,8654,-8654
31,07/30/2018,93,23:00,23:15,47.42,-43.21,0,47.42,47.42,1,-82493,110032,192525,27539,0,-18180,941,0,0,,19121,-17239
31,07/30/2018,94,23:15,23:30,54.78,,0,54.78,54.78,1,-100751,84602,185353,-16149,0,0,16930,0,0,,16930,16930
31,07/30/2018,95,23:30,23:45,54.78,38.21,0,38.21,38.21,-1,-58408,75305,133713,16897,0,-3984,1275,0,0,,5259,-2709
31,07/30/2018,96,23:45,0:00,,34.21,0,34.21,34.21,-1,-52738,93729,146467,40991,0,-22797,0,0,0,,22797,-22797
31,07/31/2018,1,0:00,0:15,43.35,38.03,0,43.48,38.03,2,-65372,50122,115494,-15250,0,-13169,272,0,0,,13441,-12897
31,07/31/2018,2,0:15,0:30,43.35,38.87,0,43.54,38.87,2,-49220,89306,138526,40086,0,-245,1657,0,0,,1902,1412
31,07/31/2018,3,0:30,0:45,,1.92,0,1.92,1.92,-1,-35824,115253,151077,79429,0,-16678,0,0,0,,16678,-16678
31,07/31/2018,4,0:45,1:00,,-10.03,0,-10.03,-10.03,-1,-35094,107898,142992,72804,0,-63333,0,0,0,,63333,-63333
31,07/31/2018,5,1:00,1:15,,34.87,0,34.87,34.87,-1,-62527,106671,169198,44144,0,-30752,0,0,0,,30752,-30752
31,07/31/2018,6,1:15,1:30,,14.03,0,14.03,14.03,-1,-36879,115779,152658,78900,0,-24953,0,0,0,,24953,-24953
31,07/31/2018,7,1:30,1:45,,30.91,0,30.91,30.91,-1,-36415,92548,128963,56133,0,-41995,0,0,0,,41995,-41995
31,07/31/2018,8,1:45,2:00,,30.91,0,30.91,30.91,-1,-30045,85327,115372,55282,0,-47718,0,0,0,,47718,-47718
31,07/31/2018,9,2:00,2:15,118.42,38.87,0,118.42,38.87,2,-61590,35770,97360,-25820,0,-20217,6430,0,0,,26647,-13787
31,07/31/2018,10,2:15,2:30,42.79,,0,42.79,42.79,1,-40920,41895,82815,975,0,0,1691,0,0,,1691,1691
31,07/31/2018,11,2:30,2:45,,35.81,0,35.81,35.81,-1,-39273,63786,103059,24513,0,-7907,0,0,0,,7907,-7907
31,07/31/2018,12,2:45,3:00,43.35,35.03,0,43.35,35.03,2,-41160,44758,85918,3598,0,-16785,248,0,0,,17033,-16537
31,07/31/2018,13,3:00,3:15,43.62,35.03,0,43.62,43.62,1,-53639,33953,87592,-19686,0,-450,2022,0,0,,2472,1572
31,07/31/2018,14,3:15,3:30,43.35,,0,43.35,43.35,1,-46397,23073,69470,-23324,0,0,2599,0,0,,2599,2599
31,07/31/2018,15,3:30,3:45,44.64,,0,44.64,44.64,1,-42491,30139,72630,-12352,0,0,6986,0,0,,6986,6986
31,07/31/2018,16,3:45,4:00,43.75,,0,43.75,43.75,1,-45042,22391,67433,-22651,0,0,9095,0,0,,9095,9095
31,07/31/2018,17,4:00,4:15,44.63,,0,44.63,44.63,1,-28439,13200,41639,-15239,0,0,9470,0,0,,9470,9470
31,07/31/2018,18,4:15,4:30,43.35,,0,43.35,43.35,1,-30444,19887,50331,-10557,0,0,6824,0,0,,6824,6824
31,07/31/2018,19,4:30,4:45,48.47,,0,48.47,48.47,1,-32940,11858,44798,-21082,0,0,15125,0,0,,15125,15125
31,07/31/2018,20,4:45,5:00,47.35,,0,47.35,47.35,1,-40194,21157,61351,-19037,0,0,18819,0,0,,18819,18819
31,07/31/2018,21,5:00,5:15,42.87,,0,42.87,42.87,1,-45082,28889,73971,-16193,0,0,5374,0,0,,5374,5374
31,07/31/2018,22,5:15,5:30,44.84,,0,44.84,44.84,1,-48398,18442,66840,-29956,0,0,3030,0,0,,3030,3030
31,07/31/2018,23,5:30,5:45,57.03,,0,57.03,57.03,1,-64271,18928,83199,-45343,0,0,21417,0,0,,21417,21417
31,07/31/2018,24,5:45,6:00,48.02,,0,48.02,48.02,1,-72645,27565,100210,-45080,0,0,18946,0,0,,18946,18946
31,07/31/2018,25,6:00,6:15,48.02,40.77,0,40.77,40.77,-1,-60394,64165,124559,3771,0,-135,921,0,0,,1056,786
31,07/31/2018,26,6:15,6:30,,40.77,0,40.77,40.77,-1,-35345,45717,81062,10372,0,-595,0,0,0,,595,-595
31,07/31/2018,27,6:30,6:45,45.36,,0,45.36,45.36,1,-50893,41957,92850,-8936,0,0,1023,0,0,,1023,1023
31,07/31/2018,28,6:45,7:00,47.44,,0,47.44,47.44,1,-57701,34191,91892,-23510,0,0,8002,0,0,,8002,8002
31,07/31/2018,29,7:00,7:15,,,0,42.95,42.95,0,-21838,116247,138085,94409,0,0,283,0,0,,283,283
31,07/31/2018,30,7:15,7:30,,,0,42.95,42.95,0,-30923,77997,108920,47074,0,0,0,0,0,,0,0
31,07/31/2018,31,7:30,7:45,44.87,,0,44.87,44.87,1,-47458,55281,102739,7823,0,0,313,0,0,,313,313
31,07/31/2018,32,7:45,8:00,51.63,,0,51.63,51.63,1,-79572,45206,124778,-34366,0,0,19068,0,0,,19068,19068
31,07/31/2018,33,8:00,8:15,,,0,42.98,42.98,0,-56790,50328,107118,-6462,0,0,7255,0,0,,7255,7255
31,07/31/2018,34,8:15,8:30,43.63,,0,43.63,43.63,1,-67532,34282,101814,-33250,0,0,41,0,0,,41,41
31,07/31/2018,35,8:30,8:45,68.52,,0,68.52,68.52,1,-90776,26692,117468,-64084,0,0,10422,0,0,,10422,10422
31,07/31/2018,36,8:45,9:00,69.02,,0,69.02,69.02,1,-95390,23519,118909,-71871,0,0,43397,0,0,,43397,43397
31,07/31/2018,37,9:00,9:15,47.44,,0,47.44,47.44,1,-101507,26829,128336,-74678,0,0,20798,0,0,,20798,20798
31,07/31/2018,38,9:15,9:30,,,0,42.98,42.98,0,-95154,29382,124536,-65772,0,0,0,0,0,,0,0
31,07/31/2018,39,9:30,9:45,43.61,,0,43.61,43.61,1,-89970,13715,103685,-76255,0,0,1379,0,0,,1379,1379
31,07/31/2018,40,9:45,10:00,43.44,,0,43.44,43.44,1,-92840,22268,115108,-70572,0,0,1166,0,0,,1166,1166
31,07/31/2018,41,10:00,10:15,,,0,42.93,42.93,0,-102808,19380,122188,-83428,0,0,0,0,0,,0,0
31,07/31/2018,42,10:15,10:30,,,0,42.93,42.93,0,-82808,29155,111963,-53653,0,0,0,0,0,,0,0
31,07/31/2018,43,10:30,10:45,,,0,42.93,42.93,0,-74065,48067,122132,-25998,0,0,0,0,0,,0,0
31,07/31/2018,44,10:45,11:00,,40.44,0,40.44,40.44,-1,-55429,64713,120142,9284,0,-702,0,0,0,,702,-702
31,07/31/2018,45,11:00,11:15,,38.52,0,38.52,38.52,-1,-63043,70998,134041,7955,0,-1795,0,0,0,,1795,-1795
31,07/31/2018,46,11:15,11:30,,36.99,0,36.99,36.99,-1,-44058,103161,147219,59103,0,-15299,0,0,0,,15299,-15299
31,07/31/2018,47,11:30,11:45,,34.96,0,34.96,34.96,-1,-42451,128839,171290,86388,0,-18663,0,0,0,,18663,-18663
31,07/31/2018,48,11:45,12:00,,34.96,0,34.96,34.96,-1,-38767,144255,183022,105488,0,-20544,0,0,0,,20544,-20544
31,07/31/2018,49,12:00,12:15,,40.44,0,40.44,40.44,-1,-46553,117073,163626,70520,0,-2580,0,0,0,,2580,-2580
31,07/31/2018,50,12:15,12:30,,-105.73,0,-105.73,-105.73,-1,-29287,183547,212834,154260,0,-22128,0,0,0,,22128,-22128
31,07/31/2018,51,12:30,12:45,,-105.73,0,-105.73,-105.73,-1,-51664,173179,224843,121515,0,-73987,0,0,0,,73987,-73987
31,07/31/2018,52,12:45,13:00,,-105.73,0,-105.73,-105.73,-1,-33744,182872,216616,149128,0,-76419,0,0,0,,76419,-76419
31,07/31/2018,53,13:00,13:15,,16.44,0,16.44,16.44,-1,-91302,120682,211984,29380,0,-63711,0,0,0,,63711,-63711
31,07/31/2018,54,13:15,13:30,,41.5,0,41.5,41.5,-1,-76956,122817,199773,45861,0,-1316,0,0,0,,1316,-1316
31,07/31/2018,55,13:30,13:45,,40.38,0,40.38,40.38,-1,-68004,113574,181578,45570,0,-203,0,0,0,,203,-203
31,07/31/2018,56,13:45,14:00,,41.25,0,41.25,41.25,-1,-52143,85438,137581,33295,0,-1962,0,0,0,,1962,-1962
31,07/31/2018,57,14:00,14:15,,,0,42.58,42.58,0,-109480,101949,211429,-7531,0,-28,0,0,0,,28,-28
31,07/31/2018,58,14:15,14:30,42.91,,0,42.91,42.91,1,-117728,97917,215645,-19811,0,0,89,0,0,,89,89
31,07/31/2018,59,14:30,14:45,43.44,,0,43.44,43.44,1,-104807,77670,182477,-27137,0,0,2271,0,0,,2271,2271
31,07/31/2018,60,14:45,15:00,47.44,,0,47.44,47.44,1,-103047,56229,159276,-46818,0,0,3331,0,0,,3331,3331
31,07/31/2018,61,15:00,15:15,,,0,42.59,42.59,0,-64414,78788,143202,14374,0,0,0,0,0,,0,0
31,07/31/2018,62,15:15,15:30,,,0,42.48,42.48,0,-65500,90388,155888,24888,0,0,0,0,0,,0,0
31,07/31/2018,63,15:30,15:45,,,0,42.47,42.47,0,-69065,83924,152989,14859,0,0,0,0,0,,0,0
31,07/31/2018,64,15:45,16:00,,42.04,0,42.04,42.04,-1,-71178,81240,152418,10062,0,-23,0,0,0,,23,-23
31,07/31/2018,65,16:00,16:15,,35.49,0,35.49,35.49,-1,-50401,157767,208168,107366,0,-6763,0,0,0,,6763,-6763
31,07/31/2018,66,16:15,16:30,,34.96,0,34.96,34.96,-1,-52855,154123,206978,101268,0,-17892,0,0,0,,17892,-17892
31,07/31/2018,67,16:30,16:45,,34.96,0,34.96,34.96,-1,-51690,131800,183490,80110,0,-18549,0,0,0,,18549,-18549
31,07/31/2018,68,16:45,17:00,,31,0,31,31,-1,-59642,121675,181317,62033,0,-3242,0,0,0,,3242,-3242
31,07/31/2018,69,17:00,17:15,,1.87,0,1.87,1.87,-1,-52206,162514,214720,110308,0,-54629,0,0,0,,54629,-54629
31,07/31/2018,70,17:15,17:30,,38.96,0,38.96,38.96,-1,-57940,144096,202036,86156,0,-32439,0,0,0,,32439,-32439
31,07/31/2018,71,17:30,17:45,,39.03,0,39.03,39.03,-1,-56265,131095,187360,74830,0,-11694,0,0,0,,11694,-11694
31,07/31/2018,72,17:45,18:00,,45.15,0,45.15,45.15,-1,-50627,124173,174800,73546,0,-710,0,0,0,,710,-710
31,07/31/2018,73,18:00,18:15,,9.89,0,9.89,9.89,-1,-47796,116212,164008,68416,0,-31672,0,0,0,,31672,-31672
31,07/31/2018,74,18:15,18:30,,32.07,0,32.07,32.07,-1,-51568,111754,163322,60186,0,-51187,0,0,0,,51187,-51187
31,07/31/2018,75,18:30,18:45,,42.43,0,42.43,42.43,-1,-56871,115614,172485,58743,0,-17112,0,0,0,,17112,-17112
31,07/31/2018,76,18:45,19:00,,42.48,0,42.48,42.48,-1,-56142,92691,148833,36549,0,-200,0,0,0,,200,-200
31,07/31/2018,77,19:00,19:15,,39.03,0,39.03,39.03,-1,-43632,89023,132655,45391,0,-1488,0,0,0,,1488,-1488
31,07/31/2018,78,19:15,19:30,,,0,42.93,42.93,0,-49315,68890,118205,19575,0,0,0,0,0,,0,0
31,07/31/2018,79,19:30,19:45,,40.28,0,40.28,40.28,-1,-54761,64114,118875,9353,0,-1167,0,0,0,,1167,-1167
31,07/31/2018,80,19:45,20:00,,,0,42.98,42.98,0,-63150,53203,116353,-9947,0,-125,0,0,0,,125,-125
31,07/31/2018,81,20:00,20:15,47.44,,0,47.44,47.44,1,-37877,31686,69563,-6191,0,0,4250,0,0,,4250,4250
31,07/31/2018,82,20:15,20:30,43.44,,0,43.44,43.44,1,-40058,40344,80402,286,0,0,754,0,0,,754,754
31,07/31/2018,83,20:30,20:45,43.44,,0,43.44,43.44,1,-43113,47471,90584,4358,0,0,816,0,0,,816,816
31,07/31/2018,84,20:45,21:00,,34.96,0,34.96,34.96,-1,-42262,75207,117469,32945,0,-10397,0,0,0,,10397,-10397
31,07/31/2018,85,21:00,21:15,,34.96,0,34.96,34.96,-1,-39656,91644,131300,51988,0,-14662,0,0,0,,14662,-14662
31,07/31/2018,86,21:15,21:30,,,0,44.34,44.34,0,-42616,89092,131708,46476,0,-72,0,0,0,,72,-72
31,07/31/2018,87,21:30,21:45,,,0,44.34,44.34,0,-43355,85090,128445,41735,0,0,0,0,0,,0,0
31,07/31/2018,88,21:45,22:00,43.44,,0,43.44,43.44,1,-58842,62618,121460,3776,0,0,3,0,0,,3,3
31,07/31/2018,89,22:00,22:15,43.44,,0,43.44,43.44,1,-46954,25404,72358,-21550,0,0,147,0,0,,147,147
31,07/31/2018,90,22:15,22:30,,40.34,0,40.34,40.34,-1,-35859,42087,77946,6228,0,-767,0,0,0,,767,-767
31,07/31/2018,91,22:30,22:45,,40.03,0,40.03,40.03,-1,-29640,59718,89358,30078,0,-1205,0,0,0,,1205,-1205
31,07/31/2018,92,22:45,23:00,,35.67,0,35.67,35.67,-1,-26785,80277,107062,53492,0,-4473,0,0,0,,4473,-4473
31,07/31/2018,93,23:00,23:15,68.52,41.03,0,68.52,41.03,2,-61296,26605,87901,-34691,0,-2574,10130,0,0,,12704,7556
31,07/31/2018,94,23:15,23:30,46.37,44.89,0,44.89,44.89,-1,-44485,28763,73248,-15722,0,-76,8392,0,0,,8468,8316
31,07/31/2018,95,23:30,23:45,,41.32,0,41.32,41.32,-1,-34851,37521,72372,2670,0,-1503,0,0,0,,1503,-1503
31,07/31/2018,96,23:45,0:00,,34.59,0,34.59,34.59,-1,-29052,77670,106722,48618,0,-9535,0,0,0,,9535,-9535
31,08-01-18,1,0:00,0:15,51.19,31.19,0,51.19,31.19,2,-92715,39031,131746,-53684,0,-11302,1172,0,0,,12474,-10130
31,08-01-18,2,0:15,0:30,68.52,,0,68.52,68.52,1,-44071,27601,71672,-16470,0,0,16863,0,0,,16863,16863
31,08-01-18,3,0:30,0:45,68.52,37.61,0,37.61,37.61,-1,-23723,39528,63251,15805,0,-2838,1133,0,0,,3971,-1705
31,08-01-18,4,0:45,1:00,,33.06,0,33.06,33.06,-1,-20875,55780,76655,34905,0,-27736,0,0,0,,27736,-27736
31,08-01-18,5,1:00,1:15,81.21,38.03,0,81.21,81.21,1,-55972,32318,88290,-23654,0,-13710,5923,0,0,,19633,-7787
31,08-01-18,6,1:15,1:30,82.59,38.03,0,82.59,82.59,1,-25100,18601,43701,-6499,0,-21,11748,0,0,,11769,11727
31,08-01-18,7,1:30,1:45,,,0,41.65,41.65,0,-16298,28603,44901,12305,0,0,53,0,0,,53,53
31,08-01-18,8,1:45,2:00,,40.3,0,40.3,40.3,-1,-8271,50452,58723,42181,0,-200,0,0,0,,200,-200
31,08-01-18,9,2:00,2:15,46.92,41.7,0,46.92,46.92,1,-30961,19793,50754,-11168,0,-95,2201,0,0,,2296,2106
31,08-01-18,10,2:15,2:30,45.46,,0,45.46,45.46,1,-25685,13557,39242,-12128,0,0,8389,0,0,,8389,8389
31,08-01-18,11,2:30,2:45,45.53,,0,45.53,45.53,1,-19800,16570,36370,-3230,0,0,7785,0,0,,7785,7785
31,08-01-18,12,2:45,3:00,,,0,40.4,40.4,0,-14544,23711,38255,9167,0,0,405,0,0,,405,405
31,08-01-18,13,3:00,3:15,46.96,,0,46.96,46.96,1,-32846,21111,53957,-11735,0,0,4176,0,0,,4176,4176
31,08-01-18,14,3:15,3:30,45.46,,0,45.46,45.46,1,-22243,18318,40561,-3925,0,0,6612,0,0,,6612,6612
31,08-01-18,15,3:30,3:45,38.75,,0,38.75,38.75,1,-15910,17861,33771,1951,0,0,949,0,0,,949,949
31,08-01-18,16,3:45,4:00,38.75,,0,38.75,38.75,1,-14927,19440,34367,4513,0,0,20,0,0,,20,20
31,08-01-18,17,4:00,4:15,42.96,,0,42.96,42.96,1,-25938,19723,45661,-6215,0,0,2309,0,0,,2309,2309
31,08-01-18,18,4:15,4:30,42.96,,0,42.96,42.96,1,-25986,17791,43777,-8195,0,0,2628,0,0,,2628,2628
31,08-01-18,19,4:30,4:45,45.7,,0,45.7,45.7,1,-32148,18216,50364,-13932,0,0,4775,0,0,,4775,4775
31,08-01-18,20,4:45,5:00,42.96,,0,42.96,42.96,1,-24668,20187,44855,-4481,0,0,2772,0,0,,2772,2772
31,08-01-18,21,5:00,5:15,,,0,41.63,41.63,0,-48795,23545,72340,-25250,0,0,163,0,0,,163,163
31,08-01-18,22,5:15,5:30,,,0,41.62,41.62,0,-35652,14251,49903,-21401,0,0,0,0,0,,0,0
31,08-01-18,23,5:30,5:45,68.52,,0,68.52,68.52,1,-53457,9144,62601,-44313,0,0,4807,0,0,,4807,4807
31,08-01-18,24,5:45,6:00,68.52,,0,68.52,68.52,1,-49520,15844,65364,-33676,0,0,22288,0,0,,22288,22288
31,08-01-18,25,6:00,6:15,68.52,40.09,0,40.09,40.09,-1,-46820,85844,132664,39024,0,-1212,6625,0,0,,7837,5413
31,08-01-18,26,6:15,6:30,,38.98,0,38.98,38.98,-1,-27604,57450,85054,29846,0,-4139,0,0,0,,4139,-4139
31,08-01-18,27,6:30,6:45,42.98,42.03,0,42.98,41.76,2,-40541,42736,83277,2195,0,-2107,17,0,0,,2124,-2090
31,08-01-18,28,6:45,7:00,46.98,42.32,0,46.98,41.76,2,-54883,39286,94169,-15597,0,-35,6370,0,0,,6405,6335
31,08-01-18,29,7:00,7:15,46.98,38.52,0,38.52,38.52,-1,-11060,70027,81087,58967,0,-8776,188,0,0,,8964,-8588
31,08-01-18,30,7:15,7:30,,41.03,0,41.03,41.03,-1,-23456,54471,77927,31015,0,-6726,0,0,0,,6726,-6726
31,08-01-18,31,7:30,7:45,,,0,44.13,44.13,0,-38224,58290,96514,20066,0,-24,0,0,0,,24,-24
31,08-01-18,32,7:45,8:00,,,0,44.13,44.13,0,-60996,59833,120829,-1163,0,0,0,0,0,,0,0
31,08-01-18,33,8:00,8:15,42.98,,0,42.98,42.98,1,-44684,39984,84668,-4700,0,0,197,0,0,,197,197
31,08-01-18,34,8:15,8:30,51.25,,0,51.25,51.25,1,-52791,27804,80595,-24987,0,0,2966,0,0,,2966,2966
31,08-01-18,35,8:30,8:45,51.25,,0,51.25,51.25,1,-68685,31113,99798,-37572,0,0,22144,0,0,,22144,22144
31,08-01-18,36,8:45,9:00,51.25,,0,51.25,51.25,1,-73625,38392,112017,-35233,0,0,27862,0,0,,27862,27862
31,08-01-18,37,9:00,9:15,45.81,39.03,0,45.81,39.03,2,-59219,43499,102718,-15720,0,-1426,7437,0,0,,8863,6011
31,08-01-18,38,9:15,9:30,46.98,,0,46.98,46.98,1,-55429,43220,98649,-12209,0,0,4699,0,0,,4699,4699
31,08-01-18,39,9:30,9:45,42.98,,0,42.98,42.98,1,-46751,43161,89912,-3590,0,0,3268,0,0,,3268,3268
31,08-01-18,40,9:45,10:00,42.98,,0,42.98,42.98,1,-34328,43047,77375,8719,0,0,71,0,0,,71,71
31,08-01-18,41,10:00,10:15,42.98,,0,42.98,42.98,1,-50593,37009,87602,-13584,0,0,21,0,0,,21,21
31,08-01-18,42,10:15,10:30,,,0,44.14,44.14,0,-46587,32722,79309,-13865,0,0,0,0,0,,0,0
31,08-01-18,43,10:30,10:45,,,0,44.14,44.14,0,-41259,37657,78916,-3602,0,0,0,0,0,,0,0
31,08-01-18,44,10:45,11:00,42.98,,0,42.98,42.98,1,-39901,37103,77004,-2798,0,0,298,0,0,,298,298
31,08-01-18,45,11:00,11:15,42.98,,0,42.98,42.98,1,-75270,24373,99643,-50897,0,0,1129,0,0,,1129,1129
31,08-01-18,46,11:15,11:30,46.98,,0,46.98,46.98,1,-76454,23342,99796,-53112,0,0,3020,0,0,,3020,3020
31,08-01-18,47,11:30,11:45,45.93,,0,45.93,45.93,1,-70965,29036,100001,-41929,0,0,7252,0,0,,7252,7252
31,08-01-18,48,11:45,12:00,51.25,,0,51.25,51.25,1,-78036,37525,115561,-40511,0,0,14236,0,0,,14236,14236
31,08-01-18,49,12:00,12:15,46.98,,0,46.98,46.98,1,-86252,28953,115205,-57299,0,0,10576,0,0,,10576,10576
31,08-01-18,50,12:15,12:30,,,0,44.13,44.13,0,-77002,33805,110807,-43197,0,0,2553,0,0,,2553,2553
31,08-01-18,51,12:30,12:45,118.98,,0,118.98,118.98,1,-74317,26142,100459,-48175,0,0,19049,0,0,,19049,19049
31,08-01-18,52,12:45,13:00,51.25,,0,51.25,51.25,1,-75627,42684,118311,-32943,0,0,28887,0,0,,28887,28887
31,08-01-18,53,13:00,13:15,51.25,,0,51.25,51.25,1,-55563,32101,87664,-23462,0,0,5824,0,0,,5824,5824
31,08-01-18,54,13:15,13:30,51.25,,0,51.25,51.25,1,-66188,39737,105925,-26451,0,0,12109,0,0,,12109,12109
31,08-01-18,55,13:30,13:45,45.68,,0,45.68,45.68,1,-69203,42899,112102,-26304,0,0,526,0,0,,526,526
31,08-01-18,56,13:45,14:00,47.08,,0,47.08,47.08,1,-71516,42144,113660,-29372,0,0,4562,0,0,,4562,4562
31,08-01-18,57,14:00,14:15,42.98,,0,42.98,42.98,1,-44386,60817,105203,16431,0,0,2448,0,0,,2448,2448
31,08-01-18,58,14:15,14:30,42.98,,0,42.98,42.98,1,-52367,52269,104636,-98,0,0,157,0,0,,157,157
31,08-01-18,59,14:30,14:45,46.98,,0,46.98,46.98,1,-53889,41741,95630,-12148,0,0,3878,0,0,,3878,3878
31,08-01-18,60,14:45,15:00,51.25,,0,51.25,51.25,1,-60599,25589,86188,-35010,0,0,21015,0,0,,21015,21015
31,08-01-18,61,15:00,15:15,51.25,,0,51.25,51.25,1,-59849,24428,84277,-35421,0,0,28294,0,0,,28294,28294
31,08-01-18,62,15:15,15:30,51.25,,0,51.25,51.25,1,-61309,20727,82036,-40582,0,0,32363,0,0,,32363,32363
31,08-01-18,63,15:30,15:45,68.98,,0,68.98,68.98,1,-70090,17018,87108,-53072,0,0,44409,0,0,,44409,44409
31,08-01-18,64,15:45,16:00,52.02,,0,52.02,52.02,1,-69715,19084,88799,-50631,0,0,46201,0,0,,46201,46201
31,08-01-18,65,16:00,16:15,51.25,38.03,0,38.03,38.03,-1,-57723,66125,123848,8402,0,-1804,22312,0,0,,24116,20508
31,08-01-18,66,16:15,16:30,,,0,42.99,42.99,0,-55942,56520,112462,578,0,-317,49,0,0,,366,-268
31,08-01-18,67,16:30,16:45,46.58,,0,46.58,46.58,1,-61104,55079,116183,-6025,0,0,1254,0,0,,1254,1254
31,08-01-18,68,16:45,17:00,46.98,,0,46.98,46.98,1,-72890,44661,117551,-28229,0,0,9533,0,0,,9533,9533
31,08-01-18,69,17:00,17:15,,,0,42.99,42.99,0,-57806,45716,103522,-12090,0,0,2669,0,0,,2669,2669
31,08-01-18,70,17:15,17:30,,,0,42.99,42.99,0,-67357,20032,87389,-47325,0,0,0,0,0,,0,0
31,08-01-18,71,17:30,17:45,118.98,,0,118.98,118.98,1,-66567,18908,85475,-47659,0,0,17721,0,0,,17721,17721
31,08-01-18,72,17:45,18:00,51.25,,0,51.25,51.25,1,-50401,17261,67662,-33140,0,0,31696,0,0,,31696,31696
31,08-01-18,73,18:00,18:15,51.25,,0,51.25,51.25,1,-64712,20025,84737,-44687,0,0,27631,0,0,,27631,27631
31,08-01-18,74,18:15,18:30,50.02,,0,50.02,50.02,1,-53343,32851,86194,-20492,0,0,28947,0,0,,28947,28947
31,08-01-18,75,18:30,18:45,46.98,,0,46.98,46.98,1,-45763,36355,82118,-9408,0,0,7621,0,0,,7621,7621
31,08-01-18,76,18:45,19:00,51.25,,0,51.25,51.25,1,-47632,25275,72907,-22357,0,0,16940,0,0,,16940,16940
31,08-01-18,77,19:00,19:15,46.23,40.15,0,40.15,40.15,-1,-50937,58577,109514,7640,0,-469,7969,0,0,,8438,7500
31,08-01-18,78,19:15,19:30,,,0,44.14,44.14,0,-50042,52907,102949,2865,0,-81,0,0,0,,81,-81
31,08-01-18,79,19:30,19:45,,41.75,0,41.75,41.75,-1,-44069,53111,97180,9042,0,-1539,0,0,0,,1539,-1539
31,08-01-18,80,19:45,20:00,,41.75,0,41.75,41.75,-1,-45554,46581,92135,1027,0,-2669,0,0,0,,2669,-2669
31,08-01-18,81,20:00,20:15,,,0,44.13,44.13,0,-40006,32221,72227,-7785,0,-448,0,0,0,,448,-448
31,08-01-18,82,20:15,20:30,42.98,,0,42.98,42.98,1,-40344,21744,62088,-18600,0,0,43,0,0,,43,43
31,08-01-18,83,20:30,20:45,46.98,,0,46.98,46.98,1,-44368,23508,67876,-20860,0,0,4616,0,0,,4616,4616
31,08-01-18,84,20:45,21:00,42.98,,0,42.98,42.98,1,-35991,28092,64083,-7899,0,0,1113,0,0,,1113,1113
31,08-01-18,85,21:00,21:15,68.98,,0,68.98,68.98,1,-53361,25030,78391,-28331,0,0,9806,0,0,,9806,9806
31,08-01-18,86,21:15,21:30,48.09,,0,48.09,48.09,1,-52527,23625,76152,-28902,0,0,20474,0,0,,20474,20474
31,08-01-18,87,21:30,21:45,49.36,,0,49.36,49.36,1,-57040,26662,83702,-30378,0,0,23964,0,0,,23964,23964
31,08-01-18,88,21:45,22:00,128.02,,0,128.02,128.02,1,-95005,19187,114192,-75818,0,0,41853,0,0,,41853,41853
31,08-01-18,89,22:00,22:15,46.98,,0,46.98,46.98,1,-77170,22576,99746,-54594,0,0,24517,0,0,,24517,24517
31,08-01-18,90,22:15,22:30,,,0,44.13,44.13,0,-48002,25091,73093,-22911,0,0,898,0,0,,898,898
31,08-01-18,91,22:30,22:45,,42.24,0,42.24,42.24,-1,-38609,38610,77219,1,0,-271,0,0,0,,271,-271
31,08-01-18,92,22:45,23:00,42.98,42.99,0,44.14,42.99,2,-44414,52193,96607,7779,0,-546,11,0,0,,557,-535
31,08-01-18,93,23:00,23:15,51.25,,0,51.25,51.25,1,-61720,40929,102649,-20791,0,0,4914,0,0,,4914,4914
31,08-01-18,94,23:15,23:30,42.98,,0,42.98,42.98,1,-37918,34862,72780,-3056,0,0,966,0,0,,966,966
31,08-01-18,95,23:30,23:45,,,0,44.04,44.04,0,-30534,34031,64565,3497,0,0,0,0,0,,0,0
31,08-01-18,96,23:45,0:00,,34.98,0,34.98,34.98,-1,-19776,53540,73316,33764,0,-4944,0,0,0,,4944,-4944
31,08-02-18,1,0:00,0:15,,36.99,0,36.99,36.99,-1,-34679,47571,82250,12892,0,-5557,0,0,0,,5557,-5557
31,08-02-18,2,0:15,0:30,,,0,41.12,41.12,0,-27270,51751,79021,24481,0,0,0,0,0,,0,0
31,08-02-18,3,0:30,0:45,,31.25,0,31.25,31.25,-1,-13662,75412,89074,61750,0,-4715,0,0,0,,4715,-4715
31,08-02-18,4,0:45,1:00,,13.82,0,13.82,13.82,-1,-16017,81700,97717,65683,0,-61455,0,0,0,,61455,-61455
31,08-02-18,5,1:00,1:15,51.25,38.98,0,51.25,38.98,2,-43341,32205,75546,-11136,0,-20085,1723,0,0,,21808,-18362
31,08-02-18,6,1:15,1:30,51.25,44.31,0,44.31,44.31,-1,-29485,48623,78108,19138,0,-13,1,0,0,,14,-12
31,08-02-18,7,1:30,1:45,,41.29,0,41.29,41.29,-1,-17348,59189,76537,41841,0,-1544,0,0,0,,1544,-1544
31,08-02-18,8,1:45,2:00,,31.13,0,31.13,31.13,-1,-22018,70471,92489,48453,0,-26548,0,0,0,,26548,-26548
31,08-02-18,9,2:00,2:15,51.25,37.78,0,51.25,37.78,2,-57119,42523,99642,-14596,0,-11304,4397,0,0,,15701,-6907
31,08-02-18,10,2:15,2:30,42.98,37.78,0,42.98,42.98,1,-45034,40043,85077,-4991,0,-11,3348,0,0,,3359,3337
31,08-02-18,11,2:30,2:45,41.12,,0,41.12,41.12,1,-48186,46021,94207,-2165,0,0,1019,0,0,,1019,1019
31,08-02-18,12,2:45,3:00,41.12,38.98,0,38.98,38.98,-1,-46834,52361,99195,5527,0,-2809,150,0,0,,2959,-2659
31,08-02-18,13,3:00,3:15,42.98,38.98,0,42.98,42.98,1,-50159,38676,88835,-11483,0,-1103,300,0,0,,1403,-803
31,08-02-18,14,3:15,3:30,38.89,,0,38.89,38.89,1,-43161,43468,86629,307,0,0,233,0,0,,233,233
31,08-02-18,15,3:30,3:45,38.89,,0,38.89,38.89,1,-46156,54760,100916,8604,0,0,40,0,0,,40,40
31,08-02-18,16,3:45,4:00,,,0,41.56,41.56,0,-43446,48114,91560,4668,0,0,0,0,0,,0,0
31,08-02-18,17,4:00,4:15,,,0,41.57,41.57,0,-53467,56377,109844,2910,0,0,0,0,0,,0,0
31,08-02-18,18,4:15,4:30,,44.24,0,44.24,44.24,-1,-54058,50457,104515,-3601,0,-3,0,0,0,,3,-3
31,08-02-18,19,4:30,4:45,45.65,,0,45.65,45.65,1,-56239,41164,97403,-15075,0,0,403,0,0,,403,403
31,08-02-18,20,4:45,5:00,46.98,,0,46.98,46.98,1,-57041,39084,96125,-17957,0,0,4058,0,0,,4058,4058
31,08-02-18,21,5:00,5:15,46.98,,0,46.98,46.98,1,-75016,39371,114387,-35645,0,0,3386,0,0,,3386,3386
31,08-02-18,22,5:15,5:30,42.98,,0,42.98,42.98,1,-64469,40916,105385,-23553,0,0,408,0,0,,408,408
31,08-02-18,23,5:30,5:45,51.25,,0,51.25,51.25,1,-71383,27412,98795,-43971,0,0,5162,0,0,,5162,5162
31,08-02-18,24,5:45,6:00,52.01,,0,52.01,52.01,1,-87360,28323,115683,-59037,0,0,23868,0,0,,23868,23868
31,08-02-18,25,6:00,6:15,77.7,,0,77.7,77.7,1,-153127,66785,219912,-86342,0,0,15049,0,0,,15049,15049
31,08-02-18,26,6:15,6:30,223.12,,0,223.12,223.12,1,-227182,60489,287671,-166693,0,0,63612,0,0,,63612,63612
31,08-02-18,27,6:30,6:45,69.12,,0,69.12,69.12,1,-185267,57021,242288,-128246,0,0,46519,0,0,,46519,46519
31,08-02-18,28,6:45,7:00,68.4,,0,68.4,68.4,1,-193047,49010,242057,-144037,0,0,26550,0,0,,26550,26550
31,08-02-18,29,7:00,7:15,51.08,,0,51.08,51.08,1,-167906,118874,286780,-49032,0,0,16982,0,0,,16982,16982
31,08-02-18,30,7:15,7:30,51.08,,0,51.08,51.08,1,-181188,85118,266306,-96070,0,0,562,0,0,,562,562
31,08-02-18,31,7:30,7:45,223.12,,0,223.12,223.12,1,-209355,49275,258630,-160080,0,0,40951,0,0,,40951,40951
31,08-02-18,32,7:45,8:00,223.12,,0,223.12,223.12,1,-214572,55215,269787,-159357,0,0,85297,0,0,,85297,85297
31,08-02-18,33,8:00,8:15,223.12,-55.88,0,-55.88,-55.88,-1,-26699,155267,181966,128568,0,-12240,27868,0,0,,40108,15628
31,08-02-18,34,8:15,8:30,,40.78,0,40.78,40.78,-1,-38766,85149,123915,46383,0,-6489,0,0,0,,6489,-6489
31,08-02-18,35,8:30,8:45,,45.31,0,45.31,45.31,-1,-64441,75328,139769,10887,0,-1013,0,0,0,,1013,-1013
31,08-02-18,36,8:45,9:00,54.12,,0,54.12,54.12,1,-84374,62113,146487,-22261,0,0,9756,0,0,,9756,9756
31,08-02-18,37,9:00,9:15,42.85,,0,42.85,42.85,1,-84033,63466,147499,-20567,0,0,4831,0,0,,4831,4831
31,08-02-18,38,9:15,9:30,68.4,,0,68.4,68.4,1,-91447,49304,140751,-42143,0,0,19535,0,0,,19535,19535
31,08-02-18,39,9:30,9:45,48.03,,0,48.03,48.03,1,-70765,53326,124091,-17439,0,0,16030,0,0,,16030,16030
31,08-02-18,40,9:45,10:00,42.85,,0,42.85,42.85,1,-50779,43488,94267,-7291,0,0,833,0,0,,833,833
31,08-02-18,41,10:00,10:15,42.85,,0,42.85,42.85,1,-62748,77027,139775,14279,0,0,47,0,0,,47,47
31,08-02-18,42,10:15,10:30,46.11,,0,46.11,46.11,1,-49037,50885,99922,1848,0,0,1127,0,0,,1127,1127
31,08-02-18,43,10:30,10:45,,,0,42.92,42.92,0,-42413,49419,91832,7006,0,0,195,0,0,,195,195
31,08-02-18,44,10:45,11:00,,41.78,0,41.78,41.78,-1,-37575,50547,88122,12972,0,-195,0,0,0,,195,-195
31,08-02-18,45,11:00,11:15,,,0,42.82,42.82,0,-97744,75833,173577,-21911,0,0,0,0,0,,0,0
31,08-02-18,46,11:15,11:30,45.8,,0,45.8,45.8,1,-89187,61022,150209,-28165,0,0,551,0,0,,551,551
31,08-02-18,47,11:30,11:45,51.08,,0,51.08,51.08,1,-88598,37334,125932,-51264,0,0,3355,0,0,,3355,3355
31,08-02-18,48,11:45,12:00,94.12,,0,94.12,94.12,1,-83943,37535,121478,-46408,0,0,16787,0,0,,16787,16787
31,08-02-18,49,12:00,12:15,223.12,,0,223.12,223.12,1,-134617,8454,143071,-126163,0,0,34345,0,0,,34345,34345
31,08-02-18,50,12:15,12:30,51.08,,0,51.08,51.08,1,-88840,25995,114835,-62845,0,0,23672,0,0,,23672,23672
31,08-02-18,51,12:30,12:45,51.08,,0,51.08,51.08,1,-67113,27341,94454,-39772,0,0,3746,0,0,,3746,3746
31,08-02-18,52,12:45,13:00,45.84,,0,45.84,45.84,1,-61314,25441,86755,-35873,0,0,3351,0,0,,3351,3351
31,08-02-18,53,13:00,13:15,68.4,,0,68.4,68.4,1,-65693,47099,112792,-18594,0,0,5405,0,0,,5405,5405
31,08-02-18,54,13:15,13:30,78.12,,0,78.12,78.12,1,-73445,31746,105191,-41699,0,0,34049,0,0,,34049,34049
31,08-02-18,55,13:30,13:45,68.4,,0,68.4,68.4,1,-79690,30091,109781,-49599,0,0,34925,0,0,,34925,34925
31,08-02-18,56,13:45,14:00,51.08,,0,51.08,51.08,1,-80819,32204,113023,-48615,0,0,38231,0,0,,38231,38231
31,08-02-18,57,14:00,14:15,46.85,,0,46.85,46.85,1,-84767,35543,120310,-49224,0,0,14875,0,0,,14875,14875
31,08-02-18,58,14:15,14:30,51.08,,0,51.08,51.08,1,-80817,36509,117326,-44308,0,0,6803,0,0,,6803,6803
31,08-02-18,59,14:30,14:45,46.85,,0,46.85,46.85,1,-80609,37566,118175,-43043,0,0,2154,0,0,,2154,2154
31,08-02-18,60,14:45,15:00,51.08,,0,51.08,51.08,1,-98048,36668,134716,-61380,0,0,17615,0,0,,17615,17615
31,08-02-18,61,15:00,15:15,51.08,40.99,0,40.99,40.99,-1,-60024,64693,124717,4669,0,-412,7129,0,0,,7541,6717
31,08-02-18,62,15:15,15:30,46.85,,0,46.85,46.85,1,-65533,61214,126747,-4319,0,0,849,0,0,,849,849
31,08-02-18,63,15:30,15:45,51.08,,0,51.08,51.08,1,-84000,58928,142928,-25072,0,0,19130,0,0,,19130,19130
31,08-02-18,64,15:45,16:00,46.85,,0,46.85,46.85,1,-89165,59333,148498,-29832,0,0,20871,0,0,,20871,20871
31,08-02-18,65,16:00,16:15,46.85,40.78,0,40.78,40.78,-1,-48216,57323,105539,9107,0,-1028,4860,0,0,,5888,3832
31,08-02-18,66,16:15,16:30,,,0,42.92,42.92,0,-66302,50330,116632,-15972,0,0,0,0,0,,0,0
31,08-02-18,67,16:30,16:45,42.85,,0,42.85,42.85,1,-76619,63521,140140,-13098,0,0,863,0,0,,863,863
31,08-02-18,68,16:45,17:00,45.76,,0,45.76,45.76,1,-91831,66937,158768,-24894,0,0,2957,0,0,,2957,2957
31,08-02-18,69,17:00,17:15,45.76,42.58,0,42.58,42.58,-1,-56354,54066,110420,-2288,0,-198,81,0,0,,279,-117
31,08-02-18,70,17:15,17:30,68.4,,0,68.4,68.4,1,-78022,26835,104857,-51187,0,0,6061,0,0,,6061,6061
31,08-02-18,71,17:30,17:45,223.12,,0,223.12,223.12,1,-100640,26477,127117,-74163,0,0,24899,0,0,,24899,24899
31,08-02-18,72,17:45,18:00,223.12,,0,223.12,223.12,1,-102378,38945,141323,-63433,0,0,62024,0,0,,62024,62024
31,08-02-18,73,18:00,18:15,51.08,,0,51.08,51.08,1,-76470,14350,90820,-62120,0,0,29129,0,0,,29129,29129
31,08-02-18,74,18:15,18:30,,,0,42.92,42.92,0,-81134,10558,91692,-70576,0,0,1050,0,0,,1050,1050
31,08-02-18,75,18:30,18:45,223.12,,0,223.12,223.12,1,-104798,13622,118420,-91176,0,0,35022,0,0,,35022,35022
31,08-02-18,76,18:45,19:00,223.12,,0,223.12,223.12,1,-90457,21691,112148,-68766,0,0,75292,0,0,,75292,75292
31,08-02-18,77,19:00,19:15,51.08,,0,51.08,51.08,1,-88067,38045,126112,-50022,0,0,31548,0,0,,31548,31548
31,08-02-18,78,19:15,19:30,223.12,,0,223.12,223.12,1,-104004,21124,125128,-82880,0,0,50484,0,0,,50484,50484
31,08-02-18,79,19:30,19:45,100.12,,0,100.12,100.12,1,-90567,27644,118211,-62923,0,0,60628,0,0,,60628,60628
31,08-02-18,80,19:45,20:00,100.12,,0,100.12,100.12,1,-93560,20262,113822,-73298,0,0,57185,0,0,,57185,57185
31,08-02-18,81,20:00,20:15,68.4,,0,68.4,68.4,1,-88091,54747,142838,-33344,0,0,43616,0,0,,43616,43616
31,08-02-18,82,20:15,20:30,46.85,,0,46.85,46.85,1,-81532,32585,114117,-48947,0,0,15184,0,0,,15184,15184
31,08-02-18,83,20:30,20:45,46.85,,0,46.85,46.85,1,-92069,16739,108808,-75330,0,0,10936,0,0,,10936,10936
31,08-02-18,84,20:45,21:00,46.01,,0,46.01,46.01,1,-99491,13291,112782,-86200,0,0,3932,0,0,,3932,3932
31,08-02-18,85,21:00,21:15,46.85,,0,46.85,46.85,1,-123296,15861,139157,-107435,0,0,5845,0,0,,5845,5845
31,08-02-18,86,21:15,21:30,46.14,,0,46.14,46.14,1,-120938,15383,136321,-105555,0,0,5426,0,0,,5426,5426
31,08-02-18,87,21:30,21:45,46.85,,0,46.85,46.85,1,-125624,12892,138516,-112732,0,0,11147,0,0,,11147,11147
31,08-02-18,88,21:45,22:00,174.12,,0,174.12,174.12,1,-150440,10764,161204,-139676,0,0,41038,0,0,,41038,41038
31,08-02-18,89,22:00,22:15,68.4,,0,68.4,68.4,1,-152882,6191,159073,-146691,0,0,55502,0,0,,55502,55502
31,08-02-18,90,22:15,22:30,51.08,,0,51.08,51.08,1,-120931,7287,128218,-113644,0,0,26131,0,0,,26131,26131
31,08-02-18,91,22:30,22:45,,,0,42.92,42.92,0,-98424,7881,106305,-90543,0,0,798,0,0,,798,798
31,08-02-18,92,22:45,23:00,,,0,42.92,42.92,0,-70009,15471,85480,-54538,0,0,0,0,0,,0,0
31,08-02-18,93,23:00,23:15,223.12,,0,223.12,223.12,1,-156879,9353,166232,-147526,0,0,19199,0,0,,19199,19199
31,08-02-18,94,23:15,23:30,223.12,,0,223.12,223.12,1,-126006,12716,138722,-113290,0,0,41403,0,0,,41403,41403
31,08-02-18,95,23:30,23:45,223.12,40.23,0,40.23,40.23,-1,-85230,40941,126171,-44289,0,-50,3323,0,0,,3373,3273
31,08-02-18,96,23:45,0:00,,40.79,0,40.79,40.79,-1,-57524,59950,117474,2426,0,-1829,0,0,0,,1829,-1829
31,08-03-18,1,0:00,0:15,222.02,40.79,0,222.02,222.02,1,-87356,25739,113095,-61617,0,-236,17310,0,0,,17546,17074
31,08-03-18,2,0:15,0:30,68.4,,0,68.4,68.4,1,-75890,26215,102105,-49675,0,0,35775,0,0,,35775,35775
31,08-03-18,3,0:30,0:45,68.4,37.74,0,37.74,37.74,-1,-38876,35046,73922,-3830,0,-3795,12002,0,0,,15797,8207
31,08-03-18,4,0:45,1:00,,39.07,0,39.07,39.07,-1,-36693,49478,86171,12785,0,-4385,0,0,0,,4385,-4385
31,08-03-18,5,1:00,1:15,223.02,39.07,0,223.02,223.02,1,-96336,14092,110428,-82244,0,-449,26827,0,0,,27276,26378
31,08-03-18,6,1:15,1:30,68.4,,0,68.4,68.4,1,-63101,25678,88779,-37423,0,0,41073,0,0,,41073,41073
31,08-03-18,7,1:30,1:45,68.4,39.75,0,39.75,39.75,-1,-46276,44188,90464,-2088,0,-109,6792,0,0,,6901,6683
31,08-03-18,8,1:45,2:00,,41.72,0,41.72,41.72,-1,-43918,58225,102143,14307,0,-147,0,0,0,,147,-147
31,08-03-18,9,2:00,2:15,223.02,41.57,0,223.02,40.97,2,-87750,30015,117765,-57735,0,-72,18481,0,0,,18553,18409
31,08-03-18,10,2:15,2:30,52.02,,0,52.02,52.02,1,-83036,34822,117858,-48214,0,0,44434,0,0,,44434,44434
31,08-03-18,11,2:30,2:45,46.85,,0,46.85,46.85,1,-78556,39537,118093,-39019,0,0,26140,0,0,,26140,26140
31,08-03-18,12,2:45,3:00,,,0,40.98,40.98,0,-67909,43455,111364,-24454,0,0,5781,0,0,,5781,5781
31,08-03-18,13,3:00,3:15,68.4,,0,68.4,68.4,1,-76123,44754,120877,-31369,0,0,7158,0,0,,7158,7158
31,08-03-18,14,3:15,3:30,68.4,,0,68.4,68.4,1,-77568,43844,121412,-33724,0,0,24479,0,0,,24479,24479
31,08-03-18,15,3:30,3:45,,,0,40.97,40.97,0,-60958,51843,112801,-9115,0,0,2587,0,0,,2587,2587
31,08-03-18,16,3:45,4:00,,40.33,0,40.33,40.33,-1,-56731,51645,108376,-5086,0,-12,0,0,0,,12,-12
31,08-03-18,17,4:00,4:15,47.13,,0,47.13,47.13,1,-71770,38132,109902,-33638,0,0,2753,0,0,,2753,2753
31,08-03-18,18,4:15,4:30,47.18,,0,47.18,47.18,1,-66037,38798,104835,-27239,0,0,6538,0,0,,6538,6538
31,08-03-18,19,4:30,4:45,51.08,,0,51.08,51.08,1,-81438,37476,118914,-43962,0,0,15604,0,0,,15604,15604
31,08-03-18,20,4:45,5:00,51.08,,0,51.08,51.08,1,-76552,40502,117054,-36050,0,0,28936,0,0,,28936,28936
31,08-03-18,21,5:00,5:15,46.85,,0,46.85,46.85,1,-78745,44824,123569,-33921,0,0,14228,0,0,,14228,14228
31,08-03-18,22,5:15,5:30,46.85,,0,46.85,46.85,1,-88054,31672,119726,-56382,0,0,1519,0,0,,1519,1519
31,08-03-18,23,5:30,5:45,118.4,,0,118.4,118.4,1,-106713,32510,139223,-74203,0,0,18278,0,0,,18278,18278
31,08-03-18,24,5:45,6:00,223.02,,0,223.02,223.02,1,-101909,36725,138634,-65184,0,0,60017,0,0,,60017,60017
31,08-03-18,25,6:00,6:15,45.03,33.03,0,45.03,33.03,2,-34835,69023,103858,34188,0,-3889,20354,0,0,,24243,16465
31,08-03-18,26,6:15,6:30,,,0,42.68,42.68,0,-64428,54226,118654,-10202,0,-203,0,0,0,,203,-203
31,08-03-18,27,6:30,6:45,68.67,,0,68.67,68.67,1,-102384,49485,151869,-52899,0,0,1735,0,0,,1735,1735
31,08-03-18,28,6:45,7:00,118.67,,0,118.67,118.67,1,-111234,44930,156164,-66304,0,0,20968,0,0,,20968,20968
31,08-03-18,29,7:00,7:15,43.39,24.25,0,44.15,24.25,2,-46935,93119,140054,46184,0,-13688,9003,0,0,,22691,-4685
31,08-03-18,30,7:15,7:30,,38.37,0,38.37,38.37,-1,-58422,78697,137119,20275,0,-20974,0,0,0,,20974,-20974
31,08-03-18,31,7:30,7:45,43.39,38.37,0,43.39,43.39,1,-82442,78520,160962,-3922,0,-4176,439,0,0,,4615,-3737
31,08-03-18,32,7:45,8:00,69.27,,0,69.27,69.27,1,-107468,80795,188263,-26673,0,0,12842,0,0,,12842,12842
31,08-03-18,33,8:00,8:15,43.39,,0,43.39,43.39,1,-71964,60824,132788,-11140,0,0,4710,0,0,,4710,4710
31,08-03-18,34,8:15,8:30,70.57,,0,70.57,70.57,1,-97837,50307,148144,-47530,0,0,10639,0,0,,10639,10639
31,08-03-18,35,8:30,8:45,223.02,,0,223.02,223.02,1,-138945,43693,182638,-95252,0,0,47893,0,0,,47893,47893
31,08-03-18,36,8:45,9:00,106.02,,0,106.02,106.02,1,-136832,55897,192729,-80935,0,0,56258,0,0,,56258,56258
31,08-03-18,37,9:00,9:15,223.02,,0,223.02,223.02,1,-117101,38005,155106,-79096,0,0,61485,0,0,,61485,61485
31,08-03-18,38,9:15,9:30,88.02,,0,88.02,88.02,1,-107411,42215,149626,-65196,0,0,65155,0,0,,65155,65155
31,08-03-18,39,9:30,9:45,106.02,,0,106.02,106.02,1,-119279,42350,161629,-76929,0,0,62983,0,0,,62983,62983
31,08-03-18,40,9:45,10:00,163.02,,0,163.02,163.02,1,-124887,44033,168920,-80854,0,0,55350,0,0,,55350,55350
31,08-03-18,41,10:00,10:15,47.57,38.24,0,38.24,38.24,-1,-48142,119995,168137,71853,0,-2107,24485,0,0,,26592,22378
31,08-03-18,42,10:15,10:30,,,0,43.07,43.07,0,-65489,80833,146322,15344,0,-173,0,0,0,,173,-173
31,08-03-18,43,10:30,10:45,,,0,43.07,43.07,0,-77088,79168,156256,2080,0,0,0,0,0,,0,0
31,08-03-18,44,10:45,11:00,73.02,,0,73.02,73.02,1,-99474,75479,174953,-23995,0,0,13665,0,0,,13665,13665
31,08-03-18,45,11:00,11:15,223.02,,0,223.02,223.02,1,-217696,34111,251807,-183585,0,0,71374,0,0,,71374,71374
31,08-03-18,46,11:15,11:30,223.02,,0,223.02,223.02,1,-165637,43887,209524,-121750,0,0,89966,0,0,,89966,89966
31,08-03-18,47,11:30,11:45,223.02,,0,223.02,223.02,1,-142993,53274,196267,-89719,0,0,88815,0,0,,88815,88815
31,08-03-18,48,11:45,12:00,223.02,,0,223.02,223.02,1,-131448,55675,187123,-75773,0,0,70996,0,0,,70996,70996
31,08-03-18,49,12:00,12:15,223.02,,0,270.28,270.28,1,-200685,73365,274050,-127320,0,0,83675,0,0,,83675,83675
31,08-03-18,50,12:15,12:30,223.02,,0,270.28,270.28,1,-238496,71496,309992,-167000,0,0,89918,0,50751,,140669,140669
31,08-03-18,51,12:30,12:45,163.02,,0,270.28,270.28,1,-202174,82715,284889,-119459,0,0,56046,0,83250,,139296,139296
31,08-03-18,52,12:45,13:00,51.78,,0,270.28,270.28,1,-191943,77168,269111,-114775,0,0,6909,0,83250,,90159,90159
31,08-03-18,53,13:00,13:15,69.77,,0,269.77,269.77,1,-211377,96118,307495,-115259,0,0,25034,0,83250,,108284,108284
31,08-03-18,54,13:15,13:30,69.77,,0,269.77,269.77,1,-201503,76576,278079,-124927,0,0,44945,0,69416,,114361,114361
31,08-03-18,55,13:30,13:45,69.77,,0,269.77,269.77,1,-195488,80164,275652,-115324,0,0,45912,0,62499,,108411,108411
31,08-03-18,56,13:45,14:00,51.78,,0,269.77,269.77,1,-178273,74404,252677,-103869,0,0,37430,0,62499,,99929,99929
31,08-03-18,57,14:00,14:15,51.78,,0,269.13,269.13,1,-163166,61346,224512,-101820,0,0,28096,0,62499,,90595,90595
31,08-03-18,58,14:15,14:30,54.02,,0,269.13,269.13,1,-158090,59099,217189,-98991,0,0,34187,0,62499,,96686,96686
31,08-03-18,59,14:30,14:45,51.78,,0,269.13,269.13,1,-149448,64666,214114,-84782,0,0,27183,0,62499,,89682,89682
31,08-03-18,60,14:45,15:00,51.78,,0,269.13,269.13,1,-166244,60315,226559,-105929,0,0,4127,0,62499,,66626,66626
31,08-03-18,61,15:00,15:15,222.02,,0,222.02,222.02,1,-108154,38223,146377,-69931,0,0,14188,0,0,,14188,14188
31,08-03-18,62,15:15,15:30,222.02,,0,222.02,222.02,1,-97263,44238,141501,-53025,0,0,49022,0,0,,49022,49022
31,08-03-18,63,15:30,15:45,118.67,,0,118.67,118.67,1,-103632,38099,141731,-65533,0,0,56503,0,0,,56503,56503
31,08-03-18,64,15:45,16:00,73.02,,0,73.02,73.02,1,-114325,45040,159365,-69285,0,0,63087,0,0,,63087,63087
31,08-03-18,65,16:00,16:15,68.67,32.05,0,32.05,32.05,-1,-35131,123560,158691,88429,0,-3087,35651,0,0,,38738,32564
31,08-03-18,66,16:15,16:30,45.88,32.05,0,45.88,45.88,1,-44084,53616,97700,9532,0,-858,775,0,0,,1633,-83
31,08-03-18,67,16:30,16:45,51.78,,0,51.78,51.78,1,-68994,54896,123890,-14098,0,0,3863,0,0,,3863,3863
31,08-03-18,68,16:45,17:00,154.02,,0,154.02,154.02,1,-100673,43689,144362,-56984,0,0,44622,0,0,,44622,44622
31,08-03-18,69,17:00,17:15,51.78,35.65,0,35.65,35.65,-1,-43044,147912,190956,104868,0,-3378,26876,0,0,,30254,23498
31,08-03-18,70,17:15,17:30,,,0,43.07,43.07,0,-49606,90218,139824,40612,0,-523,2,0,0,,525,-521
31,08-03-18,71,17:30,17:45,,,0,43.07,43.07,0,-54131,80022,134153,25891,0,0,0,0,0,,0,0
31,08-03-18,72,17:45,18:00,51.78,,0,51.78,51.78,1,-73443,72915,146358,-528,0,0,2236,0,0,,2236,2236
31,08-03-18,73,18:00,18:15,70.51,,0,70.51,70.51,1,-78691,39621,118312,-39070,0,0,18117,0,0,,18117,18117
31,08-03-18,74,18:15,18:30,70.51,,0,70.51,70.51,1,-80470,42021,122491,-38449,0,0,10057,0,0,,10057,10057
31,08-03-18,75,18:30,18:45,144.02,,0,144.02,144.02,1,-100596,45468,146064,-55128,0,0,49804,0,0,,49804,49804
31,08-03-18,76,18:45,19:00,94.02,,0,94.02,94.02,1,-109116,56685,165801,-52431,0,0,42331,0,0,,42331,42331
31,08-03-18,77,19:00,19:15,223.02,,0,223.02,223.02,1,-141173,31584,172757,-109589,0,0,70413,0,0,,70413,70413
31,08-03-18,78,19:15,19:30,75.49,,0,75.49,75.49,1,-115582,64584,180166,-50998,0,0,46498,0,0,,46498,46498
31,08-03-18,79,19:30,19:45,144.02,,0,144.02,144.02,1,-116460,56697,173157,-59763,0,0,36667,0,0,,36667,36667
31,08-03-18,80,19:45,20:00,185.02,,0,185.02,185.02,1,-124135,61901,186036,-62234,0,0,62188,0,0,,62188,62188
31,08-03-18,81,20:00,20:15,120.35,,0,120.35,120.35,1,-122822,43686,166508,-79136,0,0,47554,0,0,,47554,47554
31,08-03-18,82,20:15,20:30,120.35,,0,120.35,120.35,1,-125523,45780,171303,-79743,0,0,68679,0,0,,68679,68679
31,08-03-18,83,20:30,20:45,70.35,,0,70.35,70.35,1,-141538,43570,185108,-97968,0,0,54628,0,0,,54628,54628
31,08-03-18,84,20:45,21:00,51.78,,0,51.78,51.78,1,-142283,34531,176814,-107752,0,0,55107,0,0,,55107,55107
31,08-03-18,85,21:00,21:15,51.78,,0,51.78,51.78,1,-116730,4544,121274,-112186,0,0,32049,0,0,,32049,32049
31,08-03-18,86,21:15,21:30,43.39,,0,43.39,43.39,1,-122257,6110,128367,-116147,0,0,16564,0,0,,16564,16564
31,08-03-18,87,21:30,21:45,43.39,,0,43.39,43.39,1,-126494,9148,135642,-117346,0,0,21762,0,0,,21762,21762
31,08-03-18,88,21:45,22:00,44.02,,0,44.02,44.02,1,-143021,13115,156136,-129906,0,0,27758,0,0,,27758,27758
31,08-03-18,89,22:00,22:15,51.78,,0,51.78,51.78,1,-143625,12864,156489,-130761,0,0,38722,0,0,,38722,38722
31,08-03-18,90,22:15,22:30,45.02,,0,45.02,45.02,1,-113713,12634,126347,-101079,0,0,22162,0,0,,22162,22162
31,08-03-18,91,22:30,22:45,,,0,42.38,42.38,0,-74766,14091,88857,-60675,0,0,391,0,0,,391,391
31,08-03-18,92,22:45,23:00,,41.03,0,41.03,41.03,-1,-50916,38994,89910,-11922,0,-148,0,0,0,,148,-148
31,08-03-18,93,23:00,23:15,,,0,42.38,42.38,0,-114508,101499,216007,-13009,0,0,0,0,0,,0,0
31,08-03-18,94,23:15,23:30,,40.03,0,40.03,40.03,-1,-94432,106488,200920,12056,0,-3501,0,0,0,,3501,-3501
31,08-03-18,95,23:30,23:45,,35.59,0,35.59,35.59,-1,-88242,128908,217150,40666,0,-24094,0,0,0,,24094,-24094
31,08-03-18,96,23:45,0:00,,31.78,0,31.78,31.78,-1,-85694,135406,221100,49712,0,-42463,0,0,0,,42463,-42463
32,08-04-18,1,0:00,0:15,76.21,38.5,0,76.21,38.5,2,-85808,34565,120373,-51243,0,-20249,8500,0,0,,28749,-11749
32,08-04-18,2,0:15,0:30,38.12,,0,38.12,38.12,1,-69040,37174,106214,-31866,0,0,7752,0,0,,7752,7752
32,08-04-18,3,0:30,0:45,,,0,39.45,39.45,0,-38100,46527,84627,8427,0,0,442,0,0,,442,442
32,08-04-18,4,0:45,1:00,,41.78,0,41.78,41.78,-1,-25087,64919,90006,39832,0,-267,0,0,0,,267,-267
32,08-04-18,5,1:00,1:15,66.39,,0,66.39,66.39,1,-84209,40665,124874,-43544,0,0,11217,0,0,,11217,11217
32,08-04-18,6,1:15,1:30,66.39,,0,66.39,66.39,1,-82248,34162,116410,-48086,0,0,45829,0,0,,45829,45829
32,08-04-18,7,1:30,1:45,,,0,39.45,39.45,0,-81250,43069,124319,-38181,0,0,7847,0,0,,7847,7847
32,08-04-18,8,1:45,2:00,,,0,39.45,39.45,0,-125621,51543,177164,-74078,0,0,0,0,0,,0,0
32,08-04-18,9,2:00,2:15,116.39,,0,116.39,116.39,1,-96926,21504,118430,-75422,0,0,13733,0,0,,13733,13733
32,08-04-18,10,2:15,2:30,116.39,,0,116.39,116.39,1,-93578,21633,115211,-71945,0,0,35870,0,0,,35870,35870
32,08-04-18,11,2:30,2:45,38.12,,0,38.12,38.12,1,-76316,23885,100201,-52431,0,0,4410,0,0,,4410,4410
32,08-04-18,12,2:45,3:00,37.12,,0,37.12,37.12,1,-81220,21889,103109,-59331,0,0,4682,0,0,,4682,4682
32,08-04-18,13,3:00,3:15,116.39,,0,116.39,116.39,1,-126264,19214,145478,-107050,0,0,41830,0,0,,41830,41830
32,08-04-18,14,3:15,3:30,116.39,,0,116.39,116.39,1,-119433,19699,139132,-99734,0,0,92283,0,0,,92283,92283
32,08-04-18,15,3:30,3:45,66.39,,0,66.39,66.39,1,-117653,25014,142667,-92639,0,0,76572,0,0,,76572,76572
32,08-04-18,16,3:45,4:00,66.39,,0,66.39,66.39,1,-132877,24734,157611,-108143,0,0,69137,0,0,,69137,69137
32,08-04-18,17,4:00,4:15,116.39,,0,116.39,116.39,1,-137063,27964,165027,-109099,0,0,80462,0,0,,80462,80462
32,08-04-18,18,4:15,4:30,116.39,,0,116.39,116.39,1,-126669,29910,156579,-96759,0,0,86811,0,0,,86811,86811
32,08-04-18,19,4:30,4:45,66.39,,0,66.39,66.39,1,-127717,32990,160707,-94727,0,0,77343,0,0,,77343,77343
32,08-04-18,20,4:45,5:00,50.58,,0,50.58,50.58,1,-128494,32489,160983,-96005,0,0,66139,0,0,,66139,66139
32,08-04-18,21,5:00,5:15,66.39,,0,66.39,66.39,1,-117122,43338,160460,-73784,0,0,65534,0,0,,65534,65534
32,08-04-18,22,5:15,5:30,50.58,,0,50.58,50.58,1,-107927,40536,148463,-67391,0,0,63891,0,0,,63891,63891
32,08-04-18,23,5:30,5:45,92.12,,0,92.12,92.12,1,-111043,38825,149868,-72218,0,0,63181,0,0,,63181,63181
32,08-04-18,24,5:45,6:00,66.39,,0,66.39,66.39,1,-87693,34746,122439,-52947,0,0,51494,0,0,,51494,51494
32,08-04-18,25,6:00,6:15,50.77,,0,50.77,50.77,1,-66828,22131,88959,-44697,0,0,29453,0,0,,29453,29453
32,08-04-18,26,6:15,6:30,50.77,,0,50.77,50.77,1,-64733,21957,86690,-42776,0,0,15966,0,0,,15966,15966
32,08-04-18,27,6:30,6:45,50.77,,0,50.77,50.77,1,-70178,25244,95422,-44934,0,0,31130,0,0,,31130,31130
32,08-04-18,28,6:45,7:00,66.59,,0,66.59,66.59,1,-94363,29268,123631,-65095,0,0,38531,0,0,,38531,38531
32,08-04-18,29,7:00,7:15,49.06,39.74,0,49.06,39.74,2,-35069,51935,87004,16866,0,-2372,19148,0,0,,21520,16776
32,08-04-18,30,7:15,7:30,42.69,39.74,0,42.69,42.69,1,-44667,42126,86793,-2541,0,-330,29,0,0,,359,-301
32,08-04-18,31,7:30,7:45,47.43,,0,47.43,47.43,1,-57388,38000,95388,-19388,0,0,4610,0,0,,4610,4610
32,08-04-18,32,7:45,8:00,50.77,,0,50.77,50.77,1,-62133,43170,105303,-18963,0,0,15091,0,0,,15091,15091
32,08-04-18,33,8:00,8:15,46.69,,0,46.69,46.69,1,-58648,30308,88956,-28340,0,0,8021,0,0,,8021,8021
32,08-04-18,34,8:15,8:30,66.59,,0,66.59,66.59,1,-66018,26727,92745,-39291,0,0,9994,0,0,,9994,9994
32,08-04-18,35,8:30,8:45,50.77,,0,50.77,50.77,1,-68626,26610,95236,-42016,0,0,27309,0,0,,27309,27309
32,08-04-18,36,8:45,9:00,50.77,,0,50.77,50.77,1,-70011,26353,96364,-43658,0,0,30984,0,0,,30984,30984
32,08-04-18,37,9:00,9:15,,,0,40.91,40.91,0,-60805,22154,82959,-38651,0,0,8158,0,0,,8158,8158
32,08-04-18,38,9:15,9:30,50.77,,0,50.77,50.77,1,-71321,20590,91911,-50731,0,0,2779,0,0,,2779,2779
32,08-04-18,39,9:30,9:45,50.77,,0,50.77,50.77,1,-76431,20707,97138,-55724,0,0,2935,0,0,,2935,2935
32,08-04-18,40,9:45,10:00,47.45,,0,47.45,47.45,1,-86647,22540,109187,-64107,0,0,1940,0,0,,1940,1940
32,08-04-18,41,10:00,10:15,66.59,,0,66.59,66.59,1,-97514,15150,112664,-82364,0,0,15359,0,0,,15359,15359
32,08-04-18,42,10:15,10:30,50.77,,0,50.77,50.77,1,-87526,13577,101103,-73949,0,0,4814,0,0,,4814,4814
32,08-04-18,43,10:30,10:45,50.77,,0,50.77,50.77,1,-74469,16518,90987,-57951,0,0,6575,0,0,,6575,6575
32,08-04-18,44,10:45,11:00,46.69,,0,46.69,46.69,1,-70091,18798,88889,-51293,0,0,1639,0,0,,1639,1639
32,08-04-18,45,11:00,11:15,42.69,,0,42.69,42.69,1,-81284,18860,100144,-62424,0,0,1938,0,0,,1938,1938
32,08-04-18,46,11:15,11:30,42.69,,0,42.69,42.69,1,-80269,22848,103117,-57421,0,0,36,0,0,,36,36
32,08-04-18,47,11:30,11:45,42.69,,0,42.69,42.69,1,-77272,28064,105336,-49208,0,0,1090,0,0,,1090,1090
32,08-04-18,48,11:45,12:00,66.59,,0,66.59,66.59,1,-78325,34024,112349,-44301,0,0,12112,0,0,,12112,12112
32,08-04-18,49,12:00,12:15,66.59,,0,66.59,66.59,1,-109708,21139,130847,-88569,0,0,15686,0,0,,15686,15686
32,08-04-18,50,12:15,12:30,50.77,,0,50.77,50.77,1,-100464,24960,125424,-75504,0,0,16723,0,0,,16723,16723
32,08-04-18,51,12:30,12:45,223.12,,0,223.12,223.12,1,-93201,27502,120703,-65699,0,0,31145,0,0,,31145,31145
32,08-04-18,52,12:45,13:00,50.77,,0,50.77,50.77,1,-63615,37115,100730,-26500,0,0,31322,0,0,,31322,31322
32,08-04-18,53,13:00,13:15,66.59,,0,66.59,66.59,1,-83616,41817,125433,-41799,0,0,28115,0,0,,28115,28115
32,08-04-18,54,13:15,13:30,50.77,,0,50.77,50.77,1,-80718,41654,122372,-39064,0,0,38111,0,0,,38111,38111
32,08-04-18,55,13:30,13:45,48.69,,0,48.69,48.69,1,-73748,50838,124586,-22910,0,0,26404,0,0,,26404,26404
32,08-04-18,56,13:45,14:00,46.69,,0,46.69,46.69,1,-70389,51151,121540,-19238,0,0,7092,0,0,,7092,7092
32,08-04-18,57,14:00,14:15,116.59,,0,116.59,116.59,1,-88415,53104,141519,-35311,0,0,17736,0,0,,17736,17736
32,08-04-18,58,14:15,14:30,116.59,,0,116.59,116.59,1,-94519,50872,145391,-43647,0,0,39358,0,0,,39358,39358
32,08-04-18,59,14:30,14:45,223.12,,0,246.78,246.78,1,-176768,49872,226640,-126896,0,0,62587,0,0,,62587,62587
32,08-04-18,60,14:45,15:00,223.12,40.99,0,40.99,40.99,-1,-123185,83666,206851,-39519,0,-77,71447,0,14679,,86203,86049
32,08-04-18,61,15:00,15:15,66.59,32.93,0,245.05,32.93,2,-132578,94053,226631,-38525,0,-2268,8085,0,11700,,22053,17517
32,08-04-18,62,15:15,15:30,146.12,,0,146.12,146.12,1,-156214,97331,253545,-58883,0,0,44715,0,0,,44715,44715
32,08-04-18,63,15:30,15:45,62.12,,0,62.12,62.12,1,-161251,100810,262061,-60441,0,0,43387,0,0,,43387,43387
32,08-04-18,64,15:45,16:00,186.12,,0,186.12,186.12,1,-186274,100600,286874,-85674,0,0,56797,0,0,,56797,56797
32,08-04-18,65,16:00,16:15,66.12,,0,66.12,66.12,1,-116335,80137,196472,-36198,0,0,30897,0,0,,30897,30897
32,08-04-18,66,16:15,16:30,,,0,42.54,42.54,0,-141913,66003,207916,-75910,0,0,152,0,0,,152,152
32,08-04-18,67,16:30,16:45,223.12,,0,223.12,223.12,1,-171426,52844,224270,-118582,0,0,19032,0,0,,19032,19032
32,08-04-18,68,16:45,17:00,223.12,,0,223.12,223.12,1,-177940,58480,236420,-119460,0,0,77083,0,0,,77083,77083
32,08-04-18,69,17:00,17:15,50.77,33.82,0,50.77,33.82,2,-58057,85287,143344,27230,0,-2062,32801,0,0,,34863,30739
32,08-04-18,70,17:15,17:30,,41.75,0,41.75,41.75,-1,-72705,90320,163025,17615,0,-607,0,0,0,,607,-607
32,08-04-18,71,17:30,17:45,48.4,41.75,0,48.4,48.4,1,-98985,73292,172277,-25693,0,-28,6176,0,0,,6204,6148
32,08-04-18,72,17:45,18:00,66.59,,0,66.59,66.59,1,-124783,65998,190781,-58785,0,0,27027,0,0,,27027,27027
32,08-04-18,73,18:00,18:15,55.12,,0,55.12,55.12,1,-137023,95579,232602,-41444,0,0,30807,0,0,,30807,30807
32,08-04-18,74,18:15,18:30,46.69,,0,46.69,46.69,1,-148657,96754,245411,-51903,0,0,15587,0,0,,15587,15587
32,08-04-18,75,18:30,18:45,50.77,,0,50.77,50.77,1,-157366,82888,240254,-74478,0,0,1416,0,0,,1416,1416
32,08-04-18,76,18:45,19:00,223.12,,0,223.12,223.12,1,-167336,69309,236645,-98027,0,0,45860,0,0,,45860,45860
32,08-04-18,77,19:00,19:15,46.65,,0,46.65,46.65,1,-126622,57684,184306,-68938,0,0,23479,0,0,,23479,23479
32,08-04-18,78,19:15,19:30,66.59,,0,66.59,66.59,1,-143849,44250,188099,-99599,0,0,1062,0,0,,1062,1062
32,08-04-18,79,19:30,19:45,223.12,,0,223.12,223.12,1,-154256,36849,191105,-117407,0,0,48628,0,0,,48628,48628
32,08-04-18,80,19:45,20:00,50.77,,0,50.77,50.77,1,-167491,35792,203283,-131699,0,0,39382,0,0,,39382,39382
32,08-04-18,81,20:00,20:15,46.69,,0,46.69,46.69,1,-124157,38869,163026,-85288,0,0,12665,0,0,,12665,12665
32,08-04-18,82,20:15,20:30,45.96,,0,45.96,45.96,1,-131366,31619,162985,-99747,0,0,1127,0,0,,1127,1127
32,08-04-18,83,20:30,20:45,46.69,,0,46.69,46.69,1,-134168,32020,166188,-102148,0,0,6535,0,0,,6535,6535
32,08-04-18,84,20:45,21:00,42.69,,0,42.69,42.69,1,-118507,38936,157443,-79571,0,0,1507,0,0,,1507,1507
32,08-04-18,85,21:00,21:15,,,0,42.68,42.68,0,-96909,82955,179864,-13954,0,0,0,0,0,,0,0
32,08-04-18,86,21:15,21:30,45.58,,0,45.58,45.58,1,-107331,70206,177537,-37125,0,0,494,0,0,,494,494
32,08-04-18,87,21:30,21:45,52.12,,0,52.12,52.12,1,-114206,75896,190102,-38310,0,0,19668,0,0,,19668,19668
32,08-04-18,88,21:45,22:00,223.12,,0,223.12,223.12,1,-133439,61113,194552,-72326,0,0,46809,0,0,,46809,46809
32,08-04-18,89,22:00,22:15,223.12,,0,223.12,223.12,1,-156123,50841,206964,-105282,0,0,76700,0,0,,76700,76700
32,08-04-18,90,22:15,22:30,175.12,,0,175.12,175.12,1,-112164,65096,177260,-47068,0,0,64574,0,0,,64574,64574
32,08-04-18,91,22:30,22:45,50.77,,0,50.77,50.77,1,-83047,59096,142143,-23951,0,0,11033,0,0,,11033,11033
32,08-04-18,92,22:45,23:00,46.69,,0,46.69,46.69,1,-74619,63734,138353,-10885,0,0,10190,0,0,,10190,10190
32,08-04-18,93,23:00,23:15,42.69,,0,42.69,42.69,1,-84185,77671,161856,-6514,0,0,1783,0,0,,1783,1783
32,08-04-18,94,23:15,23:30,42.69,,0,42.69,42.69,1,-67812,65697,133509,-2115,0,0,1622,0,0,,1622,1622
32,08-04-18,95,23:30,23:45,,38.69,0,38.69,38.69,-1,-54181,78297,132478,24116,0,-1161,0,0,0,,1161,-1161
32,08-04-18,96,23:45,0:00,,30.77,0,30.77,30.77,-1,-50534,88367,138901,37833,0,-10651,0,0,0,,10651,-10651
32,08-05-18,1,0:00,0:15,73.02,38.07,0,73.02,73.02,1,-87542,40851,128393,-46691,0,-7842,6990,0,0,,14832,-852
32,08-05-18,2,0:15,0:30,47.89,,0,47.89,47.89,1,-72383,40488,112871,-31895,0,0,9100,0,0,,9100,9100
32,08-05-18,3,0:30,0:45,,,0,42.67,42.67,0,-71896,59446,131342,-12450,0,0,0,0,0,,0,0
32,08-05-18,4,0:45,1:00,46.64,,0,46.64,46.64,1,-92300,75593,167893,-16707,0,0,901,0,0,,901,901
32,08-05-18,5,1:00,1:15,50.73,,0,50.73,50.73,1,-97024,101979,199003,4955,0,0,2298,0,0,,2298,2298
32,08-05-18,6,1:15,1:30,50.73,,0,50.73,50.73,1,-95063,83061,178124,-12002,0,0,11138,0,0,,11138,11138
32,08-05-18,7,1:30,1:45,50.73,,0,50.73,50.73,1,-88697,56316,145013,-32381,0,0,9038,0,0,,9038,9038
32,08-05-18,8,1:45,2:00,46.64,40.6,0,40.6,40.6,-1,-60626,63648,124274,3022,0,-835,5554,0,0,,6389,4719
32,08-05-18,9,2:00,2:15,,38.64,0,38.64,38.64,-1,-39057,96008,135065,56951,0,-1480,0,0,0,,1480,-1480
32,08-05-18,10,2:15,2:30,46.64,,0,46.64,46.64,1,-56025,44896,100921,-11129,0,0,4187,0,0,,4187,4187
32,08-05-18,11,2:30,2:45,42.64,,0,42.64,42.64,1,-55198,51710,106908,-3488,0,0,1574,0,0,,1574,1574
32,08-05-18,12,2:45,3:00,42.64,,0,42.64,42.64,1,-50550,48606,99156,-1944,0,0,450,0,0,,450,450
32,08-05-18,13,3:00,3:15,46.56,,0,46.56,46.56,1,-43662,36456,80118,-7206,0,0,3342,0,0,,3342,3342
32,08-05-18,14,3:15,3:30,50.73,,0,50.73,50.73,1,-56436,33770,90206,-22666,0,0,11161,0,0,,11161,11161
32,08-05-18,15,3:30,3:45,46.64,,0,46.64,46.64,1,-45485,34202,79687,-11283,0,0,5462,0,0,,5462,5462
32,08-05-18,16,3:45,4:00,50.73,,0,50.73,50.73,1,-62029,36700,98729,-25329,0,0,16052,0,0,,16052,16052
32,08-05-18,17,4:00,4:15,46.64,,0,46.64,46.64,1,-66391,46706,113097,-19685,0,0,6443,0,0,,6443,6443
32,08-05-18,18,4:15,4:30,46.64,,0,46.64,46.64,1,-69642,47341,116983,-22301,0,0,13906,0,0,,13906,13906
32,08-05-18,19,4:30,4:45,46.64,,0,46.64,46.64,1,-70743,48820,119563,-21923,0,0,15773,0,0,,15773,15773
32,08-05-18,20,4:45,5:00,42.64,,0,42.64,42.64,1,-67642,51564,119206,-16078,0,0,5516,0,0,,5516,5516
32,08-05-18,21,5:00,5:15,39.56,,0,39.56,39.56,1,-76734,46089,122823,-30645,0,0,213,0,0,,213,213
32,08-05-18,22,5:15,5:30,,,0,40.85,40.85,0,-73398,40178,113576,-33220,0,0,0,0,0,,0,0
32,08-05-18,23,5:30,5:45,,,0,40.85,40.85,0,-67744,38223,105967,-29521,0,0,0,0,0,,0,0
32,08-05-18,24,5:45,6:00,,,0,40.86,40.86,0,-58328,43578,101906,-14750,0,0,0,0,0,,0,0
32,08-05-18,25,6:00,6:15,,,0,40.87,40.87,0,-61830,32575,94405,-29255,0,0,0,0,0,,0,0
32,08-05-18,26,6:15,6:30,,,0,40.88,40.88,0,-63484,37969,101453,-25515,0,0,0,0,0,,0,0
32,08-05-18,27,6:30,6:45,,,0,40.88,40.88,0,-50552,36527,87079,-14025,0,0,0,0,0,,0,0
32,08-05-18,28,6:45,7:00,,,0,40.87,40.87,0,-48678,33402,82080,-15276,0,0,0,0,0,,0,0
32,08-05-18,29,7:00,7:15,42.65,,0,42.65,42.65,1,-42174,32564,74738,-9610,0,0,391,0,0,,391,391
32,08-05-18,30,7:15,7:30,46.65,,0,46.65,46.65,1,-42570,30587,73157,-11983,0,0,5597,0,0,,5597,5597
32,08-05-18,31,7:30,7:45,46.65,,0,46.65,46.65,1,-51512,38405,89917,-13107,0,0,8731,0,0,,8731,8731
32,08-05-18,32,7:45,8:00,46.65,,0,46.65,46.65,1,-59316,56498,115814,-2818,0,0,3358,0,0,,3358,3358
32,08-05-18,33,8:00,8:15,164.02,,0,164.02,164.02,1,-84980,16542,101522,-68438,0,0,32323,0,0,,32323,32323
32,08-05-18,34,8:15,8:30,46.65,38.93,0,46.65,38.93,2,-28676,37328,66004,8652,0,-1178,15129,0,0,,16307,13951
32,08-05-18,35,8:30,8:45,,,0,42.58,42.58,0,-37132,50940,88072,13808,0,-7,8,0,0,,15,1
32,08-05-18,36,8:45,9:00,,,0,42.58,42.58,0,-48344,55530,103874,7186,0,0,0,0,0,,0,0
32,08-05-18,37,9:00,9:15,,,0,42.6,42.6,0,-49129,26876,76005,-22253,0,0,0,0,0,,0,0
32,08-05-18,38,9:15,9:30,42.65,,0,42.65,42.65,1,-46326,24569,70895,-21757,0,0,456,0,0,,456,456
32,08-05-18,39,9:30,9:45,42.65,,0,42.65,42.65,1,-37940,27987,65927,-9953,0,0,494,0,0,,494,494
32,08-05-18,40,9:45,10:00,,,0,42.59,42.59,0,-31931,30406,62337,-1525,0,0,0,0,0,,0,0
32,08-05-18,41,10:00,10:15,,,0,41,41,0,-24871,37147,62018,12276,0,0,0,0,0,,0,0
32,08-05-18,42,10:15,10:30,,38.65,0,38.65,38.65,-1,-19337,40798,60135,21461,0,-3381,0,0,0,,3381,-3381
32,08-05-18,43,10:30,10:45,,40.27,0,40.27,40.27,-1,-16089,47128,63217,31039,0,-4470,0,0,0,,4470,-4470
32,08-05-18,44,10:45,11:00,,42.12,0,42.12,42.12,-1,-17754,49599,67353,31845,0,-1644,0,0,0,,1644,-1644
32,08-05-18,45,11:00,11:15,,33.66,0,33.66,33.66,-1,-20322,47248,67570,26926,0,-12482,0,0,0,,12482,-12482
32,08-05-18,46,11:15,11:30,,38.03,0,38.03,38.03,-1,-25453,54577,80030,29124,0,-18552,0,0,0,,18552,-18552
32,08-05-18,47,11:30,11:45,,38.03,0,38.03,38.03,-1,-23495,59997,83492,36502,0,-24540,0,0,0,,24540,-24540
32,08-05-18,48,11:45,12:00,,38.03,0,38.03,38.03,-1,-26413,61414,87827,35001,0,-25069,0,0,0,,25069,-25069
32,08-05-18,49,12:00,12:15,,38.65,0,38.65,38.65,-1,-8734,37408,46142,28674,0,-17723,0,0,0,,17723,-17723
32,08-05-18,50,12:15,12:30,,38.65,0,38.65,38.65,-1,-14849,41278,56127,26429,0,-17148,0,0,0,,17148,-17148
32,08-05-18,51,12:30,12:45,,38.03,0,38.03,38.03,-1,-14413,56626,71039,42213,0,-15418,0,0,0,,15418,-15418
32,08-05-18,52,12:45,13:00,,31.41,0,31.41,31.41,-1,-18313,59792,78105,41479,0,-15232,0,0,0,,15232,-15232
32,08-05-18,53,13:00,13:15,,34.65,0,34.65,34.65,-1,-16472,66714,83186,50242,0,-23446,0,0,0,,23446,-23446
32,08-05-18,54,13:15,13:30,,30.74,0,30.74,30.74,-1,-17480,71921,89401,54441,0,-26289,0,0,0,,26289,-26289
32,08-05-18,55,13:30,13:45,,30.74,0,30.74,30.74,-1,-15148,81995,97143,66847,0,-50321,0,0,0,,50321,-50321
32,08-05-18,56,13:45,14:00,,30.67,0,30.67,30.67,-1,-13005,86752,99757,73747,0,-64460,0,0,0,,64460,-64460
32,08-05-18,57,14:00,14:15,,30.74,0,30.74,30.74,-1,-17382,74437,91819,57055,0,-37314,0,0,0,,37314,-37314
32,08-05-18,58,14:15,14:30,,38.17,0,38.17,38.17,-1,-20240,68972,89212,48732,0,-721,0,0,0,,721,-721
32,08-05-18,59,14:30,14:45,,34.65,0,34.65,34.65,-1,-24215,69389,93604,45174,0,-1044,0,0,0,,1044,-1044
32,08-05-18,60,14:45,15:00,,41.57,0,41.57,41.57,-1,-17982,67678,85660,49696,0,-673,0,0,0,,673,-673
32,08-05-18,61,15:00,15:15,,41.48,0,41.48,41.48,-1,-40507,48548,89055,8041,0,-2134,0,0,0,,2134,-2134
32,08-05-18,62,15:15,15:30,,,0,41.13,41.13,0,-40525,45806,86331,5281,0,-32,0,0,0,,32,-32
32,08-05-18,63,15:30,15:45,42.65,,0,42.65,42.65,1,-42551,42061,84612,-490,0,0,1405,0,0,,1405,1405
32,08-05-18,64,15:45,16:00,42.65,,0,42.65,42.65,1,-37953,36601,74554,-1352,0,0,1772,0,0,,1772,1772
32,08-05-18,65,16:00,16:15,,,0,41.16,41.16,0,-27153,61117,88270,33964,0,0,214,0,0,,214,214
32,08-05-18,66,16:15,16:30,42.65,,0,42.65,42.65,1,-35465,45409,80874,9944,0,0,15,0,0,,15,15
32,08-05-18,67,16:30,16:45,46.65,,0,46.65,46.65,1,-42035,32515,74550,-9520,0,0,1436,0,0,,1436,1436
32,08-05-18,68,16:45,17:00,50.74,,0,50.74,50.74,1,-48701,22420,71121,-26281,0,0,16976,0,0,,16976,16976
32,08-05-18,69,17:00,17:15,50.74,3.79,0,3.79,3.79,-1,-25323,89765,115088,64442,0,-16120,5801,0,0,,21921,-10319
32,08-05-18,70,17:15,17:30,42.65,38.65,0,42.65,42.65,1,-37677,41953,79630,4276,0,-11059,12,0,0,,11071,-11047
32,08-05-18,71,17:30,17:45,50.74,38.65,0,50.74,50.74,1,-47835,26486,74321,-21349,0,-54,8697,0,0,,8751,8643
32,08-05-18,72,17:45,18:00,50.74,,0,50.74,50.74,1,-57408,25897,83305,-31511,0,0,21978,0,0,,21978,21978
32,08-05-18,73,18:00,18:15,104.02,,0,104.02,104.02,1,-95422,52475,147897,-42947,0,0,27798,0,0,,27798,27798
32,08-05-18,74,18:15,18:30,66.6,,0,66.6,66.6,1,-85807,34864,120671,-50943,0,0,20277,0,0,,20277,20277
32,08-05-18,75,18:30,18:45,66.6,,0,66.6,66.6,1,-57294,38339,95633,-18955,0,0,26450,0,0,,26450,26450
32,08-05-18,76,18:45,19:00,50.74,,0,50.74,50.74,1,-52819,56991,109810,4172,0,0,2755,0,0,,2755,2755
32,08-05-18,77,19:00,19:15,50.74,,0,50.74,50.74,1,-98350,18103,116453,-80247,0,0,1613,0,0,,1613,1613
32,08-05-18,78,19:15,19:30,50.74,,0,50.74,50.74,1,-107136,15258,122394,-91878,0,0,1580,0,0,,1580,1580
32,08-05-18,79,19:30,19:45,50.74,,0,50.74,50.74,1,-129184,15504,144688,-113680,0,0,18368,0,0,,18368,18368
32,08-05-18,80,19:45,20:00,155.02,,0,155.02,155.02,1,-152170,15293,167463,-136877,0,0,39778,0,0,,39778,39778
32,08-05-18,81,20:00,20:15,50.74,,0,50.74,50.74,1,-66436,16243,82679,-50193,0,0,20748,0,0,,20748,20748
32,08-05-18,82,20:15,20:30,,,0,42.67,42.67,0,-77048,10716,87764,-66332,0,0,21,0,0,,21,21
32,08-05-18,83,20:30,20:45,,,0,42.67,42.67,0,-81031,7752,88783,-73279,0,0,0,0,0,,0,0
32,08-05-18,84,20:45,21:00,,,0,42.67,42.67,0,-77785,8106,85891,-69679,0,0,0,0,0,,0,0
32,08-05-18,85,21:00,21:15,,,0,42.67,42.67,0,-67758,22591,90349,-45167,0,0,0,0,0,,0,0
32,08-05-18,86,21:15,21:30,,,0,42.67,42.67,0,-70256,19028,89284,-51228,0,0,0,0,0,,0,0
32,08-05-18,87,21:30,21:45,223.02,,0,223.02,223.02,1,-96825,15432,112257,-81393,0,0,18069,0,0,,18069,18069
32,08-05-18,88,21:45,22:00,223.02,,0,223.02,223.02,1,-125810,16374,142184,-109436,0,0,79098,0,0,,79098,79098
32,08-05-18,89,22:00,22:15,,,0,42.67,42.67,0,-85033,17855,102888,-67178,0,0,21794,0,0,,21794,21794
32,08-05-18,90,22:15,22:30,,,0,42.67,42.67,0,-69323,16902,86225,-52421,0,0,0,0,0,,0,0
32,08-05-18,91,22:30,22:45,,,0,42.67,42.67,0,-59080,24887,83967,-34193,0,0,0,0,0,,0,0
32,08-05-18,92,22:45,23:00,,,0,42.68,42.68,0,-54974,30245,85219,-24729,0,0,0,0,0,,0,0
32,08-05-18,93,23:00,23:15,120.02,,0,120.02,120.02,1,-111444,35354,146798,-76090,0,0,14116,0,0,,14116,14116
32,08-05-18,94,23:15,23:30,50.74,,0,50.74,50.74,1,-75380,37507,112887,-37873,0,0,14390,0,0,,14390,14390
32,08-05-18,95,23:30,23:45,50.74,40.73,0,40.73,40.73,-1,-57085,53542,110627,-3543,0,-660,4,0,0,,664,-656
32,08-05-18,96,23:45,0:00,,30.74,0,30.74,30.74,-1,-41404,70721,112125,29317,0,-19119,0,0,0,,19119,-19119
32,08-06-18,1,0:00,0:15,136.12,31.79,0,136.12,136.12,1,-82433,72618,155051,-9815,0,-16760,4703,0,0,,21463,-12057
32,08-06-18,2,0:15,0:30,164.12,31.79,0,164.12,164.12,1,-51741,53974,105715,2233,0,-12,13105,0,0,,13117,13093
32,08-06-18,3,0:30,0:45,164.12,44.14,0,44.14,44.14,-1,-40814,52410,93224,11596,0,-38,56,0,0,,94,18
32,08-06-18,4,0:45,1:00,,31.79,0,31.79,31.79,-1,-36724,75163,111887,38439,0,-20152,0,0,0,,20152,-20152
32,08-06-18,5,1:00,1:15,66.8,38.01,0,66.8,38.01,2,-67841,40377,108218,-27464,0,-14761,5891,0,0,,20652,-8870
32,08-06-18,6,1:15,1:30,43.32,43.97,0,43.97,43.97,-1,-58637,47049,105686,-11588,0,-138,3278,0,0,,3416,3140
32,08-06-18,7,1:30,1:45,,41.78,0,41.78,41.78,-1,-42087,48451,90538,6364,0,-606,0,0,0,,606,-606
32,08-06-18,8,1:45,2:00,,39.78,0,39.78,39.78,-1,-38800,51877,90677,13077,0,-3218,0,0,0,,3218,-3218
32,08-06-18,9,2:00,2:15,45.16,39.78,0,45.16,45.16,1,-60582,39599,100181,-20983,0,-194,1235,0,0,,1429,1041
32,08-06-18,10,2:15,2:30,42.76,,0,42.76,42.76,1,-47607,38949,86556,-8658,0,0,321,0,0,,321,321
32,08-06-18,11,2:30,2:45,,40.88,0,40.88,40.88,-1,-43790,45369,89159,1579,0,-505,0,0,0,,505,-505
32,08-06-18,12,2:45,3:00,,39.58,0,39.58,39.58,-1,-37483,53844,91327,16361,0,-16894,0,0,0,,16894,-16894
32,08-06-18,13,3:00,3:15,47.55,42.78,0,47.55,41.94,2,-45184,30406,75590,-14778,0,-7960,1836,0,0,,9796,-6124
32,08-06-18,14,3:15,3:30,39.69,,0,39.69,39.69,1,-52480,44553,97033,-7927,0,0,467,0,0,,467,467
32,08-06-18,15,3:30,3:45,,,0,41.94,41.94,0,-42606,55278,97884,12672,0,0,0,0,0,,0,0
32,08-06-18,16,3:45,4:00,,43.83,0,43.83,43.83,-1,-41790,60662,102452,18872,0,-740,0,0,0,,740,-740
32,08-06-18,17,4:00,4:15,,,0,41.9,41.9,0,-63296,20388,83684,-42908,0,-62,0,0,0,,62,-62
32,08-06-18,18,4:15,4:30,,,0,41.89,41.89,0,-50506,28963,79469,-21543,0,0,0,0,0,,0,0
32,08-06-18,19,4:30,4:45,,43.9,0,43.9,43.9,-1,-45230,48553,93783,3323,0,-296,0,0,0,,296,-296
32,08-06-18,20,4:45,5:00,,43.87,0,43.87,43.87,-1,-45455,61719,107174,16264,0,-817,0,0,0,,817,-817
32,08-06-18,21,5:00,5:15,,40.12,0,40.12,40.12,-1,-48695,47981,96676,-714,0,-811,0,0,0,,811,-811
32,08-06-18,22,5:15,5:30,,39.46,0,39.46,39.46,-1,-37378,51558,88936,14180,0,-6521,0,0,0,,6521,-6521
32,08-06-18,23,5:30,5:45,,44.15,0,44.15,44.15,-1,-43941,62235,106176,18294,0,-2153,0,0,0,,2153,-2153
32,08-06-18,24,5:45,6:00,,16.8,0,16.8,16.8,-1,-50309,118506,168815,68197,0,-5248,0,0,0,,5248,-5248
32,08-06-18,25,6:00,6:15,,-106.52,0,-106.52,-106.52,-1,-35177,97469,132646,62292,0,-52846,0,0,0,,52846,-52846
32,08-06-18,26,6:15,6:30,,31.79,0,31.79,31.79,-1,-47547,84859,132406,37312,0,-48702,0,0,0,,48702,-48702
32,08-06-18,27,6:30,6:45,,44.67,0,44.67,44.67,-1,-54058,94679,148737,40621,0,-8830,0,0,0,,8830,-8830
32,08-06-18,28,6:45,7:00,,44.77,0,44.77,44.77,-1,-72306,80002,152308,7696,0,-535,0,0,0,,535,-535
32,08-06-18,29,7:00,7:15,,31.79,0,31.79,31.79,-1,-56790,85926,142716,29136,0,-7436,0,0,0,,7436,-7436
32,08-06-18,30,7:15,7:30,,24.74,0,24.74,24.74,-1,-35431,57888,93319,22457,0,-32063,0,0,0,,32063,-32063
32,08-06-18,31,7:30,7:45,,,0,44.15,44.15,0,-67814,52137,119951,-15677,0,-1970,0,0,0,,1970,-1970
32,08-06-18,32,7:45,8:00,43.65,,0,43.65,43.65,1,-95544,57423,152967,-38121,0,0,648,0,0,,648,648
32,08-06-18,33,8:00,8:15,43.6,,0,43.6,43.6,1,-56454,44690,101144,-11764,0,0,1310,0,0,,1310,1310
32,08-06-18,34,8:15,8:30,43.07,,0,43.07,43.07,1,-62514,23562,86076,-38952,0,0,280,0,0,,280,280
32,08-06-18,35,8:30,8:45,43.31,,0,43.31,43.31,1,-69330,26156,95486,-43174,0,0,194,0,0,,194,194
32,08-06-18,36,8:45,9:00,51.8,,0,51.8,51.8,1,-95330,28771,124101,-66559,0,0,4305,0,0,,4305,4305
32,08-06-18,37,9:00,9:15,68.34,,0,68.34,68.34,1,-65685,32972,98657,-32713,0,0,15737,0,0,,15737,15737
32,08-06-18,38,9:15,9:30,51.8,,0,51.8,51.8,1,-62490,37731,100221,-24759,0,0,5776,0,0,,5776,5776
32,08-06-18,39,9:30,9:45,43.83,,0,43.83,43.83,1,-79554,34065,113619,-45489,0,0,4606,0,0,,4606,4606
32,08-06-18,40,9:45,10:00,43.6,,0,43.6,43.6,1,-79755,29734,109489,-50021,0,0,15,0,0,,15,15
32,08-06-18,41,10:00,10:15,47.6,,0,47.6,47.6,1,-53432,42157,95589,-11275,0,0,3167,0,0,,3167,3167
32,08-06-18,42,10:15,10:30,43.6,,0,43.6,43.6,1,-45975,37646,83621,-8329,0,0,3465,0,0,,3465,3465
32,08-06-18,43,10:30,10:45,,,0,44.17,44.17,0,-50247,33610,83857,-16637,0,0,779,0,0,,779,779
32,08-06-18,44,10:45,11:00,47.6,,0,47.6,47.6,1,-62041,35136,97177,-26905,0,0,1721,0,0,,1721,1721
32,08-06-18,45,11:00,11:15,42.83,,0,42.83,42.83,1,-58193,36374,94567,-21819,0,0,938,0,0,,938,938
32,08-06-18,46,11:15,11:30,43.6,,0,43.6,43.6,1,-62817,34909,97726,-27908,0,0,1110,0,0,,1110,1110
32,08-06-18,47,11:30,11:45,43.6,,0,43.6,43.6,1,-64599,34798,99397,-29801,0,0,2098,0,0,,2098,2098
32,08-06-18,48,11:45,12:00,42.83,,0,42.83,42.83,1,-64117,40037,104154,-24080,0,0,152,0,0,,152,152
32,08-06-18,49,12:00,12:15,43.6,,0,43.6,43.6,1,-36306,32350,68656,-3956,0,0,538,0,0,,538,538
32,08-06-18,50,12:15,12:30,,,0,44.06,44.06,0,-35194,37654,72848,2460,0,0,0,0,0,,0,0
32,08-06-18,51,12:30,12:45,42.75,,0,42.75,42.75,1,-35767,46171,81938,10404,0,0,8,0,0,,8,8
32,08-06-18,52,12:45,13:00,46.12,,0,46.12,46.12,1,-47251,40003,87254,-7248,0,0,2767,0,0,,2767,2767
32,08-06-18,53,13:00,13:15,,,0,43.97,43.97,0,-38950,48660,87610,9710,0,0,333,0,0,,333,333
32,08-06-18,54,13:15,13:30,43.6,,0,43.6,43.6,1,-43918,37888,81806,-6030,0,0,1763,0,0,,1763,1763
32,08-06-18,55,13:30,13:45,47.6,,0,47.6,47.6,1,-54225,33554,87779,-20671,0,0,4972,0,0,,4972,4972
32,08-06-18,56,13:45,14:00,42.74,,0,42.74,42.74,1,-64343,31309,95652,-33034,0,0,1977,0,0,,1977,1977
32,08-06-18,57,14:00,14:15,43.6,,0,43.6,43.6,1,-48271,29260,77531,-19011,0,0,832,0,0,,832,832
32,08-06-18,58,14:15,14:30,47.6,,0,47.6,47.6,1,-57943,27228,85171,-30715,0,0,4961,0,0,,4961,4961
32,08-06-18,59,14:30,14:45,68.06,,0,68.06,68.06,1,-73782,29385,103167,-44397,0,0,15726,0,0,,15726,15726
32,08-06-18,60,14:45,15:00,51.8,,0,51.8,51.8,1,-76841,26910,103751,-49931,0,0,38316,0,0,,38316,38316
32,08-06-18,61,15:00,15:15,47.6,,0,47.6,47.6,1,-61113,33271,94384,-27842,0,0,19545,0,0,,19545,19545
32,08-06-18,62,15:15,15:30,51.8,,0,51.8,51.8,1,-57685,26630,84315,-31055,0,0,13897,0,0,,13897,13897
32,08-06-18,63,15:30,15:45,68.06,,0,68.06,68.06,1,-68658,21220,89878,-47438,0,0,40207,0,0,,40207,40207
32,08-06-18,64,15:45,16:00,70.12,,0,70.12,70.12,1,-81204,18993,100197,-62211,0,0,43389,0,0,,43389,43389
32,08-06-18,65,16:00,16:15,54.82,40.55,0,40.55,40.55,-1,-38821,41555,80376,2734,0,-135,30479,0,0,,30614,30344
32,08-06-18,66,16:15,16:30,54.82,40.55,0,40.55,40.55,-1,-41976,38261,80237,-3715,0,-548,673,0,0,,1221,125
32,08-06-18,67,16:30,16:45,54.82,,0,54.82,54.82,1,-50716,27705,78421,-23011,0,0,5884,0,0,,5884,5884
32,08-06-18,68,16:45,17:00,68.06,,0,68.06,68.06,1,-68485,30181,98666,-38304,0,0,36019,0,0,,36019,36019
32,08-06-18,69,17:00,17:15,68.06,10.78,0,10.78,10.78,-1,-44984,87235,132219,42251,0,-14792,11451,0,0,,26243,-3341
32,08-06-18,70,17:15,17:30,,,0,44.38,44.38,0,-57065,34793,91858,-22272,0,-2147,0,0,0,,2147,-2147
32,08-06-18,71,17:30,17:45,44.53,,0,44.53,44.53,1,-50900,37342,88242,-13558,0,0,1160,0,0,,1160,1160
32,08-06-18,72,17:45,18:00,53.25,,0,53.25,53.25,1,-62861,45745,108606,-17116,0,0,12470,0,0,,12470,12470
32,08-06-18,73,18:00,18:15,58.12,,0,58.12,58.12,1,-82151,32653,114804,-49498,0,0,13101,0,0,,13101,13101
32,08-06-18,74,18:15,18:30,53.6,,0,53.6,53.6,1,-71739,39630,111369,-32109,0,0,1013,0,0,,1013,1013
32,08-06-18,75,18:30,18:45,75.12,,0,75.12,75.12,1,-69486,49280,118766,-20206,0,0,21490,0,0,,21490,21490
32,08-06-18,76,18:45,19:00,58.12,,0,58.12,58.12,1,-69276,53364,122640,-15912,0,0,12309,0,0,,12309,12309
32,08-06-18,77,19:00,19:15,90.67,,0,90.67,90.67,1,-82313,30045,112358,-52268,0,0,32857,0,0,,32857,32857
32,08-06-18,78,19:15,19:30,70.67,,0,70.67,70.67,1,-76654,26892,103546,-49762,0,0,51470,0,0,,51470,51470
32,08-06-18,79,19:30,19:45,70.67,,0,70.67,70.67,1,-64228,33692,97920,-30536,0,0,40740,0,0,,40740,40740
32,08-06-18,80,19:45,20:00,60.67,,0,60.67,60.67,1,-62878,31791,94669,-31087,0,0,22448,0,0,,22448,22448
32,08-06-18,81,20:00,20:15,166.12,,0,166.12,166.12,1,-111638,14412,126050,-97226,0,0,54581,0,0,,54581,54581
32,08-06-18,82,20:15,20:30,166.12,,0,166.12,166.12,1,-86461,23700,110161,-62761,0,0,81088,0,0,,81088,81088
32,08-06-18,83,20:30,20:45,44.49,45.42,0,45.42,45.42,-1,-67587,52451,120038,-15136,0,-36,21038,0,0,,21074,21002
32,08-06-18,84,20:45,21:00,43.6,,0,43.6,43.6,1,-60421,57790,118211,-2631,0,0,1070,0,0,,1070,1070
32,08-06-18,85,21:00,21:15,47.6,,0,47.6,47.6,1,-64692,68176,132868,3484,0,0,511,0,0,,511,511
32,08-06-18,86,21:15,21:30,63.12,,0,63.12,63.12,1,-93959,56751,150710,-37208,0,0,24441,0,0,,24441,24441
32,08-06-18,87,21:30,21:45,53.47,,0,53.47,53.47,1,-86386,43155,129541,-43231,0,0,29570,0,0,,29570,29570
32,08-06-18,88,21:45,22:00,51.45,,0,51.45,51.45,1,-93763,40124,133887,-53639,0,0,21343,0,0,,21343,21343
32,08-06-18,89,22:00,22:15,51.45,40.78,0,40.78,40.78,-1,-68008,65672,133680,-2336,0,-717,4854,0,0,,5571,4137
32,08-06-18,90,22:15,22:30,,41.78,0,41.78,41.78,-1,-53798,57488,111286,3690,0,-3477,0,0,0,,3477,-3477
32,08-06-18,91,22:30,22:45,,41.21,0,41.21,41.21,-1,-38876,66398,105274,27522,0,-4376,0,0,0,,4376,-4376
32,08-06-18,92,22:45,23:00,,31.8,0,31.8,31.8,-1,-28980,77190,106170,48210,0,-17430,0,0,0,,17430,-17430
32,08-06-18,93,23:00,23:15,42.9,39.6,0,42.9,42.9,1,-65798,64117,129915,-1681,0,-14931,136,0,0,,15067,-14795
32,08-06-18,94,23:15,23:30,42.91,36.44,0,44.17,36.44,2,-52764,74502,127266,21738,0,-3441,36,0,0,,3477,-3405
32,08-06-18,95,23:30,23:45,,35.78,0,35.78,35.78,-1,-53759,84035,137794,30276,0,-15014,0,0,0,,15014,-15014
32,08-06-18,96,23:45,0:00,,-80.12,0,-80.12,-80.12,-1,-32273,101097,133370,68824,0,-34221,0,0,0,,34221,-34221
32,08-07-18,1,0:00,0:15,150.02,-30.99,0,150.02,150.02,1,-111646,8434,120080,-103212,0,-25241,5157,0,0,,30398,-20084
32,08-07-18,2,0:15,0:30,160.02,-30.99,0,160.02,160.02,1,-58999,21162,80161,-37837,0,-23,43870,0,0,,43893,43847
32,08-07-18,3,0:30,0:45,160.02,41.02,0,41.02,41.02,-1,-28105,35425,63530,7320,0,-548,6230,0,0,,6778,5682
32,08-07-18,4,0:45,1:00,,38.76,0,38.76,38.76,-1,-36105,56581,92686,20476,0,-3569,0,0,0,,3569,-3569
32,08-07-18,5,1:00,1:15,51.06,38.76,0,51.06,51.06,1,-60796,24356,85152,-36440,0,-519,7059,0,0,,7578,6540
32,08-07-18,6,1:15,1:30,46.23,,0,46.23,46.23,1,-38840,28158,66998,-10682,0,0,12035,0,0,,12035,12035
32,08-07-18,7,1:30,1:45,46.23,41.35,0,41.35,41.35,-1,-23433,33096,56529,9663,0,-863,1206,0,0,,2069,343
32,08-07-18,8,1:45,2:00,,38.76,0,38.76,38.76,-1,-25690,41545,67235,15855,0,-8060,0,0,0,,8060,-8060
32,08-07-18,9,2:00,2:15,46.76,39.67,0,46.76,39.67,2,-45767,29610,75377,-16157,0,-5776,2576,0,0,,8352,-3200
32,08-07-18,10,2:15,2:30,45.84,39.67,0,45.84,45.84,1,-43534,41545,85079,-1989,0,-1,1627,0,0,,1628,1626
32,08-07-18,11,2:30,2:45,,38.76,0,38.76,38.76,-1,-39129,46021,85150,6892,0,-1057,0,0,0,,1057,-1057
32,08-07-18,12,2:45,3:00,,38.76,0,38.76,38.76,-1,-39914,46919,86833,7005,0,-6061,0,0,0,,6061,-6061
32,08-07-18,13,3:00,3:15,49.42,38.76,0,49.42,49.42,1,-50397,21696,72093,-28701,0,-1429,3649,0,0,,5078,2220
32,08-07-18,14,3:15,3:30,42.76,44.69,0,44.69,44.69,-1,-39096,56343,95439,17247,0,-21,515,0,0,,536,494
32,08-07-18,15,3:30,3:45,,41.73,0,41.73,41.73,-1,-50463,60772,111235,10309,0,-1151,0,0,0,,1151,-1151
32,08-07-18,16,3:45,4:00,,37.18,0,37.18,37.18,-1,-35341,65630,100971,30289,0,-10365,0,0,0,,10365,-10365
32,08-07-18,17,4:00,4:15,,41.09,0,41.09,41.09,-1,-37433,61440,98873,24007,0,-6540,0,0,0,,6540,-6540
32,08-07-18,18,4:15,4:30,,,0,42.85,42.85,0,-45582,62352,107934,16770,0,0,0,0,0,,0,0
32,08-07-18,19,4:30,4:45,,,0,42.85,42.85,0,-37794,68840,106634,31046,0,0,0,0,0,,0,0
32,08-07-18,20,4:45,5:00,46.76,,0,46.76,46.76,1,-44530,54941,99471,10411,0,0,534,0,0,,534,534
32,08-07-18,21,5:00,5:15,46.76,,0,46.76,46.76,1,-35310,25039,60349,-10271,0,0,1228,0,0,,1228,1228
32,08-07-18,22,5:15,5:30,46.76,,0,46.76,46.76,1,-49236,32813,82049,-16423,0,0,6118,0,0,,6118,6118
32,08-07-18,23,5:30,5:45,69.01,,0,69.01,69.01,1,-80532,31317,111849,-49215,0,0,34305,0,0,,34305,34305
32,08-07-18,24,5:45,6:00,51.06,,0,51.06,51.06,1,-86358,36662,123020,-49696,0,0,44663,0,0,,44663,44663
32,08-07-18,25,6:00,6:15,51.06,35.64,0,35.64,35.64,-1,-27971,58369,86340,30398,0,-3842,10302,0,0,,14144,6460
32,08-07-18,26,6:15,6:30,,40.03,0,40.03,40.03,-1,-23747,37320,61067,13573,0,-3399,0,0,0,,3399,-3399
32,08-07-18,27,6:30,6:45,48.23,40.03,0,48.23,48.23,1,-52432,37574,90006,-14858,0,-77,1802,0,0,,1879,1725
32,08-07-18,28,6:45,7:00,69.34,,0,69.34,69.34,1,-85718,38961,124679,-46757,0,0,33498,0,0,,33498,33498
32,08-07-18,29,7:00,7:15,48.23,-30.66,0,-30.66,-30.66,-1,-6440,135081,141521,128641,0,-18582,19350,0,0,,37932,768
32,08-07-18,30,7:15,7:30,,-104.9,0,-104.9,-104.9,-1,-22994,59115,82109,36121,0,-46902,0,0,0,,46902,-46902
32,08-07-18,31,7:30,7:45,44.23,-104.9,0,44.23,44.23,1,-49048,39128,88176,-9920,0,-5754,920,0,0,,6674,-4834
32,08-07-18,32,7:45,8:00,46.42,,0,46.42,46.42,1,-82629,60702,143331,-21927,0,0,778,0,0,,778,778
32,08-07-18,33,8:00,8:15,,36.03,0,36.03,36.03,-1,-27398,58698,86096,31300,0,-9828,0,0,0,,9828,-9828
32,08-07-18,34,8:15,8:30,44.23,42.8,0,44.23,44.23,1,-57025,33987,91012,-23038,0,-3567,183,0,0,,3750,-3384
32,08-07-18,35,8:30,8:45,55,,0,55,55,1,-55322,33956,89278,-21366,0,0,10251,0,0,,10251,10251
32,08-07-18,36,8:45,9:00,165.02,,0,165.02,165.02,1,-67291,46135,113426,-21156,0,0,10528,0,0,,10528,10528
32,08-07-18,37,9:00,9:15,165.02,40.72,0,165.02,40.72,2,-35220,50895,86115,15675,0,-204,40011,0,0,,40215,39807
32,08-07-18,38,9:15,9:30,165.02,40.03,0,40.03,40.03,-1,-25873,72006,97879,46133,0,-376,290,0,0,,666,-86
32,08-07-18,39,9:30,9:45,,,0,43.24,43.24,0,-39833,61205,101038,21372,0,0,0,0,0,,0,0
32,08-07-18,40,9:45,10:00,46.73,,0,46.73,46.73,1,-48136,55804,103940,7668,0,0,802,0,0,,802,802
32,08-07-18,41,10:00,10:15,43.33,,0,43.33,43.33,1,-50036,67729,117765,17693,0,0,416,0,0,,416,416
32,08-07-18,42,10:15,10:30,46.35,,0,46.35,46.35,1,-55080,54356,109436,-724,0,0,974,0,0,,974,974
32,08-07-18,43,10:30,10:45,,,0,43.18,43.18,0,-50270,56877,107147,6607,0,0,0,0,0,,0,0
32,08-07-18,44,10:45,11:00,,,0,43.18,43.18,0,-55851,62731,118582,6880,0,0,0,0,0,,0,0
32,08-07-18,45,11:00,11:15,,,0,43.16,43.16,0,-93116,63792,156908,-29324,0,0,0,0,0,,0,0
32,08-07-18,46,11:15,11:30,,,0,43.16,43.16,0,-80685,66194,146879,-14491,0,0,0,0,0,,0,0
32,08-07-18,47,11:30,11:45,,,0,43.16,43.16,0,-88887,68900,157787,-19987,0,0,0,0,0,,0,0
32,08-07-18,48,11:45,12:00,44.23,,0,44.23,44.23,1,-84964,66834,151798,-18130,0,0,23,0,0,,23,23
32,08-07-18,49,12:00,12:15,43.44,,0,43.44,43.44,1,-84419,55016,139435,-29403,0,0,942,0,0,,942,942
32,08-07-18,50,12:15,12:30,43.2,,0,43.2,43.2,1,-92137,56087,148224,-36050,0,0,1147,0,0,,1147,1147
32,08-07-18,51,12:30,12:45,52.42,,0,52.42,52.42,1,-78958,57602,136560,-21356,0,0,8751,0,0,,8751,8751
32,08-07-18,52,12:45,13:00,46.22,,0,46.22,46.22,1,-84713,71380,156093,-13333,0,0,5408,0,0,,5408,5408
32,08-07-18,53,13:00,13:15,48.23,,0,48.23,48.23,1,-78880,70547,149427,-8333,0,0,2936,0,0,,2936,2936
32,08-07-18,54,13:15,13:30,44.23,,0,44.23,44.23,1,-86065,67340,153405,-18725,0,0,4133,0,0,,4133,4133
32,08-07-18,55,13:30,13:45,52.42,,0,52.42,52.42,1,-92734,59629,152363,-33105,0,0,5812,0,0,,5812,5812
32,08-07-18,56,13:45,14:00,46.93,,0,46.93,46.93,1,-90610,64036,154646,-26574,0,0,8842,0,0,,8842,8842
32,08-07-18,57,14:00,14:15,48.23,,0,48.23,48.23,1,-63947,52122,116069,-11825,0,0,9864,0,0,,9864,9864
32,08-07-18,58,14:15,14:30,69.34,,0,69.34,69.34,1,-80158,42180,122338,-37978,0,0,33244,0,0,,33244,33244
32,08-07-18,59,14:30,14:45,52.42,,0,52.42,52.42,1,-76506,47286,123792,-29220,0,0,32838,0,0,,32838,32838
32,08-07-18,60,14:45,15:00,48.23,,0,48.23,48.23,1,-83374,43791,127165,-39583,0,0,15366,0,0,,15366,15366
32,08-07-18,61,15:00,15:15,119.34,,0,119.34,119.34,1,-54035,28669,82704,-25366,0,0,8600,0,0,,8600,8600
32,08-07-18,62,15:15,15:30,165.02,,0,165.02,165.02,1,-64034,24146,88180,-39888,0,0,47036,0,0,,47036,47036
32,08-07-18,63,15:30,15:45,58.26,,0,58.26,58.26,1,-58603,23754,82357,-34849,0,0,41730,0,0,,41730,41730
32,08-07-18,64,15:45,16:00,53.13,,0,53.13,53.13,1,-64272,28289,92561,-35983,0,0,43803,0,0,,43803,43803
32,08-07-18,65,16:00,16:15,44.23,42.94,0,42.94,42.94,-1,-58893,62960,121853,4067,0,-211,12596,0,0,,12807,12385
32,08-07-18,66,16:15,16:30,48.23,,0,48.23,48.23,1,-83077,59654,142731,-23423,0,0,2704,0,0,,2704,2704
32,08-07-18,67,16:30,16:45,53.38,,0,53.38,53.38,1,-83341,53905,137246,-29436,0,0,14091,0,0,,14091,14091
32,08-07-18,68,16:45,17:00,70.51,,0,70.51,70.51,1,-109586,54825,164411,-54761,0,0,34444,0,0,,34444,34444
32,08-07-18,69,17:00,17:15,165.02,,0,165.02,165.02,1,-112508,46834,159342,-65674,0,0,55847,0,0,,55847,55847
32,08-07-18,70,17:15,17:30,57.67,,0,57.67,57.67,1,-105755,63732,169487,-42023,0,0,29529,0,0,,29529,29529
32,08-07-18,71,17:30,17:45,74.99,,0,74.99,74.99,1,-108915,66446,175361,-42469,0,0,31056,0,0,,31056,31056
32,08-07-18,72,17:45,18:00,124.99,,0,124.99,124.99,1,-120516,67845,188361,-52671,0,0,51906,0,0,,51906,51906
32,08-07-18,73,18:00,18:15,55.93,,0,55.93,55.93,1,-106366,64861,171227,-41505,0,0,23229,0,0,,23229,23229
32,08-07-18,74,18:15,18:30,,,0,43.55,43.55,0,-112116,57763,169879,-54353,0,0,73,0,0,,73,73
32,08-07-18,75,18:30,18:45,,,0,43.55,43.55,0,-113247,43229,156476,-70018,0,0,0,0,0,,0,0
32,08-07-18,76,18:45,19:00,,,0,43.55,43.55,0,-129243,39361,168604,-89882,0,0,0,0,0,,0,0
32,08-07-18,77,19:00,19:15,80.95,,0,80.95,80.95,1,-131323,73547,204870,-57776,0,0,9595,0,0,,9595,9595
32,08-07-18,78,19:15,19:30,60.95,,0,60.95,60.95,1,-114435,61556,175991,-52879,0,0,30375,0,0,,30375,30375
32,08-07-18,79,19:30,19:45,50.95,,0,50.95,50.95,1,-114106,73543,187649,-40563,0,0,11770,0,0,,11770,11770
32,08-07-18,80,19:45,20:00,50.95,,0,50.95,50.95,1,-114287,80300,194587,-33987,0,0,8111,0,0,,8111,8111
32,08-07-18,81,20:00,20:15,165.02,,0,165.02,165.02,1,-117576,59196,176772,-58380,0,0,27598,0,0,,27598,27598
32,08-07-18,82,20:15,20:30,165.02,40.03,0,40.03,40.03,-1,-85329,73214,158543,-12115,0,-1373,4750,0,0,,6123,3377
32,08-07-18,83,20:30,20:45,,43.05,0,43.05,43.05,-1,-78294,63307,141601,-14987,0,-3,0,0,0,,3,-3
32,08-07-18,84,20:45,21:00,,38.03,0,38.03,38.03,-1,-69779,82226,152005,12447,0,-9989,0,0,0,,9989,-9989
32,08-07-18,85,21:00,21:15,44.23,38.03,0,44.23,44.23,1,-105060,76763,181823,-28297,0,-2280,959,0,0,,3239,-1321
32,08-07-18,86,21:15,21:30,46.72,,0,46.72,46.72,1,-95821,82167,177988,-13654,0,0,2734,0,0,,2734,2734
32,08-07-18,87,21:30,21:45,,,0,44.67,44.67,0,-111071,77488,188559,-33583,0,0,0,0,0,,0,0
32,08-07-18,88,21:45,22:00,,,0,44.67,44.67,0,-94817,85468,180285,-9349,0,0,0,0,0,,0,0
32,08-07-18,89,22:00,22:15,,,0,44.51,44.51,0,-108331,67394,175725,-40937,0,0,0,0,0,,0,0
32,08-07-18,90,22:15,22:30,,36.14,0,36.14,36.14,-1,-71670,67731,139401,-3939,0,-1924,0,0,0,,1924,-1924
32,08-07-18,91,22:30,22:45,,19.34,0,19.34,19.34,-1,-41994,109425,151419,67431,0,-52609,0,0,0,,52609,-52609
32,08-07-18,92,22:45,23:00,,-105.28,0,-105.28,-105.28,-1,-44490,154746,199236,110256,0,-96804,0,0,0,,96804,-96804
32,08-07-18,93,23:00,23:15,,13.78,0,13.78,13.78,-1,-68658,109094,177752,40436,0,-56857,0,0,0,,56857,-56857
32,08-07-18,94,23:15,23:30,,32.42,0,32.42,32.42,-1,-57591,200304,257895,142713,0,-1030,0,0,0,,1030,-1030
32,08-07-18,95,23:30,23:45,,-85.15,0,-85.15,-85.15,-1,-26680,237576,264256,210896,0,-61644,0,0,0,,61644,-61644
32,08-07-18,96,23:45,0:00,,-85.31,0,-85.31,-85.31,-1,-16739,247523,264262,230784,0,-116251,0,0,0,,116251,-116251
32,08-08-18,1,0:00,0:15,62.74,-32.77,0,62.74,62.74,1,-86364,105298,191662,18934,0,-82587,1688,0,0,,84275,-80899
32,08-08-18,2,0:15,0:30,62.74,-32.77,0,62.74,62.74,1,-51327,110476,161803,59149,0,-1454,4080,0,0,,5534,2626
32,08-08-18,3,0:30,0:45,,,0,42.41,42.41,0,-46782,106673,153455,59891,0,0,0,0,0,,0,0
32,08-08-18,4,0:45,1:00,,,0,42.41,42.41,0,-81761,98257,180018,16496,0,0,0,0,0,,0,0
32,08-08-18,5,1:00,1:15,164.12,,0,164.12,164.12,1,-110206,51569,161775,-58637,0,0,20095,0,0,,20095,20095
32,08-08-18,6,1:15,1:30,49.64,42.64,0,42.64,42.64,-1,-58641,79903,138544,21262,0,-94,10763,0,0,,10857,10669
32,08-08-18,7,1:30,1:45,,42.65,0,42.65,42.65,-1,-39125,85997,125122,46872,0,-396,0,0,0,,396,-396
32,08-08-18,8,1:45,2:00,,,0,42.38,42.38,0,-41849,81050,122899,39201,0,0,0,0,0,,0,0
32,08-08-18,9,2:00,2:15,,,0,42.37,42.37,0,-38054,88439,126493,50385,0,0,0,0,0,,0,0
32,08-08-18,10,2:15,2:30,,,0,42.37,42.37,0,-64513,62400,126913,-2113,0,0,0,0,0,,0,0
32,08-08-18,11,2:30,2:45,,,0,42.37,42.37,0,-135256,46154,181410,-89102,0,0,0,0,0,,0,0
32,08-08-18,12,2:45,3:00,46.55,,0,46.55,46.55,1,-146931,37375,184306,-109556,0,0,1165,0,0,,1165,1165
32,08-08-18,13,3:00,3:15,146.12,,0,146.12,146.12,1,-140352,58223,198575,-82129,0,0,30078,0,0,,30078,30078
32,08-08-18,14,3:15,3:30,51.78,,0,51.78,51.78,1,-107341,56154,163495,-51187,0,0,33798,0,0,,33798,33798
32,08-08-18,15,3:30,3:45,,,0,42.32,42.32,0,-89480,31043,120523,-58437,0,0,3127,0,0,,3127,3127
32,08-08-18,16,3:45,4:00,,,0,42.31,42.31,0,-111519,23052,134571,-88467,0,0,0,0,0,,0,0
32,08-08-18,17,4:00,4:15,,,0,42.28,42.28,0,-91057,23535,114592,-67522,0,0,0,0,0,,0,0
32,08-08-18,18,4:15,4:30,,,0,42.28,42.28,0,-84982,20825,105807,-64157,0,0,0,0,0,,0,0
32,08-08-18,19,4:30,4:45,51.85,,0,51.85,51.85,1,-61638,26923,88561,-34715,0,0,5376,0,0,,5376,5376
32,08-08-18,20,4:45,5:00,,,0,42.28,42.28,0,-33105,41883,74988,8778,0,0,27,0,0,,27,27
32,08-08-18,21,5:00,5:15,,17.23,0,17.23,17.23,-1,-40785,104593,145378,63808,0,-25920,0,0,0,,25920,-25920
32,08-08-18,22,5:15,5:30,,39.74,0,39.74,39.74,-1,-54733,82228,136961,27495,0,-27161,0,0,0,,27161,-27161
32,08-08-18,23,5:30,5:45,47.9,39.74,0,47.9,47.9,1,-74916,53182,128098,-21734,0,-1681,766,0,0,,2447,-915
32,08-08-18,24,5:45,6:00,51.78,,0,51.78,51.78,1,-102272,56364,158636,-45908,0,0,7815,0,0,,7815,7815
32,08-08-18,25,6:00,6:15,51.77,,0,51.77,51.77,1,-102123,129993,232116,27870,0,0,4343,0,0,,4343,4343
32,08-08-18,26,6:15,6:30,,,0,42.93,42.93,0,-101246,135578,236824,34332,0,0,0,0,0,,0,0
32,08-08-18,27,6:30,6:45,,,0,42.93,42.93,0,-99944,149906,249850,49962,0,0,0,0,0,,0,0
32,08-08-18,28,6:45,7:00,,,0,42.93,42.93,0,-102319,131296,233615,28977,0,0,0,0,0,,0,0
32,08-08-18,29,7:00,7:15,46.88,,0,46.88,46.88,1,-155503,126936,282439,-28567,0,0,198,0,0,,198,198
32,08-08-18,30,7:15,7:30,,,0,44.24,44.24,0,-130208,117969,248177,-12239,0,0,0,0,0,,0,0
32,08-08-18,31,7:30,7:45,,,0,44.24,44.24,0,-141932,118706,260638,-23226,0,0,0,0,0,,0,0
32,08-08-18,32,7:45,8:00,51.77,,0,51.77,51.77,1,-136370,106319,242689,-30051,0,0,7552,0,0,,7552,7552
32,08-08-18,33,8:00,8:15,,,0,44.24,44.24,0,-103950,82341,186291,-21609,0,0,1095,0,0,,1095,1095
32,08-08-18,34,8:15,8:30,,,0,44.24,44.24,0,-74408,85931,160339,11523,0,0,0,0,0,,0,0
32,08-08-18,35,8:30,8:45,,39.37,0,39.37,39.37,-1,-60492,92875,153367,32383,0,-5497,0,0,0,,5497,-5497
32,08-08-18,36,8:45,9:00,,41.95,0,41.95,41.95,-1,-68113,70521,138634,2408,0,-4319,0,0,0,,4319,-4319
32,08-08-18,37,9:00,9:15,,,0,44.24,44.24,0,-64917,84433,149350,19516,0,0,0,0,0,,0,0
32,08-08-18,38,9:15,9:30,,43.32,0,43.32,43.32,-1,-53383,104750,158133,51367,0,-1063,0,0,0,,1063,-1063
32,08-08-18,39,9:30,9:45,,39.37,0,39.37,39.37,-1,-55104,102254,157358,47150,0,-1036,0,0,0,,1036,-1036
32,08-08-18,40,9:45,10:00,,35.73,0,35.73,35.73,-1,-56740,113249,169989,56509,0,-25225,0,0,0,,25225,-25225
32,08-08-18,41,10:00,10:15,48.26,39.38,0,48.26,39.38,2,-98595,72641,171236,-25954,0,-16721,1520,0,0,,18241,-15201
32,08-08-18,42,10:15,10:30,,,0,44.24,44.24,0,-96855,80238,177093,-16617,0,-83,93,0,0,,176,10
32,08-08-18,43,10:30,10:45,,,0,44.24,44.24,0,-105160,86512,191672,-18648,0,0,0,0,0,,0,0
32,08-08-18,44,10:45,11:00,,,0,44.24,44.24,0,-92523,87782,180305,-4741,0,0,0,0,0,,0,0
32,08-08-18,45,11:00,11:15,46.3,,0,46.3,46.3,1,-130738,80264,211002,-50474,0,0,1068,0,0,,1068,1068
32,08-08-18,46,11:15,11:30,47.73,,0,47.73,47.73,1,-137259,71629,208888,-65630,0,0,4787,0,0,,4787,4787
32,08-08-18,47,11:30,11:45,,,0,42.93,42.93,0,-147745,76275,224020,-71470,0,0,57,0,0,,57,57
32,08-08-18,48,11:45,12:00,46.7,,0,46.7,46.7,1,-137637,76514,214151,-61123,0,0,221,0,0,,221,221
32,08-08-18,49,12:00,12:15,96.12,,0,96.12,96.12,1,-137604,58902,196506,-78702,0,0,17960,0,0,,17960,17960
32,08-08-18,50,12:15,12:30,43.73,,0,43.73,43.73,1,-93924,71955,165879,-21969,0,0,3633,0,0,,3633,3633
32,08-08-18,51,12:30,12:45,,,0,44.24,44.24,0,-59239,76505,135744,17266,0,0,0,0,0,,0,0
32,08-08-18,52,12:45,13:00,43.73,,0,43.73,43.73,1,-73473,71074,144547,-2399,0,0,13,0,0,,13,13
32,08-08-18,53,13:00,13:15,,,0,44.24,44.24,0,-58298,81525,139823,23227,0,0,0,0,0,,0,0
32,08-08-18,54,13:15,13:30,,,0,44.24,44.24,0,-74044,66925,140969,-7119,0,0,0,0,0,,0,0
32,08-08-18,55,13:30,13:45,43.73,,0,43.73,43.73,1,-96553,52548,149101,-44005,0,0,657,0,0,,657,657
32,08-08-18,56,13:45,14:00,46.55,,0,46.55,46.55,1,-131180,39202,170382,-91978,0,0,3558,0,0,,3558,3558
32,08-08-18,57,14:00,14:15,53.45,,0,53.45,53.45,1,-145969,33491,179460,-112478,0,0,4209,0,0,,4209,4209
32,08-08-18,58,14:15,14:30,67.22,,0,67.22,67.22,1,-165335,35898,201233,-129437,0,0,31024,0,0,,31024,31024
32,08-08-18,59,14:30,14:45,51.77,,0,51.77,51.77,1,-171692,51340,223032,-120352,0,0,11567,0,0,,11567,11567
32,08-08-18,60,14:45,15:00,48.7,,0,48.7,48.7,1,-179690,50442,230132,-129248,0,0,18491,0,0,,18491,18491
32,08-08-18,61,15:00,15:15,47.5,,0,47.5,47.5,1,-127936,70671,198607,-57265,0,0,12156,0,0,,12156,12156
32,08-08-18,62,15:15,15:30,,,0,44.24,44.24,0,-120606,77219,197825,-43387,0,0,550,0,0,,550,550
32,08-08-18,63,15:30,15:45,51.77,,0,51.77,51.77,1,-141557,73646,215203,-67911,0,0,1646,0,0,,1646,1646
32,08-08-18,64,15:45,16:00,52.12,,0,52.12,52.12,1,-119951,73601,193552,-46350,0,0,4301,0,0,,4301,4301
32,08-08-18,65,16:00,16:15,,,0,44.24,44.24,0,-61925,71476,133401,9551,0,0,0,0,0,,0,0
32,08-08-18,66,16:15,16:30,,43.28,0,43.28,43.28,-1,-61952,64932,126884,2980,0,-186,0,0,0,,186,-186
32,08-08-18,67,16:30,16:45,,43.16,0,43.16,43.16,-1,-57168,87088,144256,29920,0,-1032,0,0,0,,1032,-1032
32,08-08-18,68,16:45,17:00,,,0,44.24,44.24,0,-67069,56814,123883,-10255,0,-16,0,0,0,,16,-16
32,08-08-18,69,17:00,17:15,,39.73,0,39.73,39.73,-1,-60165,77725,137890,17560,0,-3517,0,0,0,,3517,-3517
32,08-08-18,70,17:15,17:30,,41.29,0,41.29,41.29,-1,-49857,60002,109859,10145,0,-5148,0,0,0,,5148,-5148
32,08-08-18,71,17:30,17:45,,43.44,0,43.44,43.44,-1,-42849,67667,110516,24818,0,-1521,0,0,0,,1521,-1521
32,08-08-18,72,17:45,18:00,,,0,44.24,44.24,0,-45857,77216,123073,31359,0,-61,0,0,0,,61,-61
32,08-08-18,73,18:00,18:15,,40.74,0,40.74,40.74,-1,-52816,58535,111351,5719,0,-527,0,0,0,,527,-527
32,08-08-18,74,18:15,18:30,,39.73,0,39.73,39.73,-1,-35570,80411,115981,44841,0,-9810,0,0,0,,9810,-9810
32,08-08-18,75,18:30,18:45,,,0,44.24,44.24,0,-30606,113929,144535,83323,0,-2071,0,0,0,,2071,-2071
32,08-08-18,76,18:45,19:00,,,0,44.24,44.24,0,-25567,106916,132483,81349,0,0,0,0,0,,0,0
32,08-08-18,77,19:00,19:15,,39.37,0,39.37,39.37,-1,-12448,160724,173172,148276,0,-4002,0,0,0,,4002,-4002
32,08-08-18,78,19:15,19:30,,36.52,0,36.52,36.52,-1,-12660,162301,174961,149641,0,-20120,0,0,0,,20120,-20120
32,08-08-18,79,19:30,19:45,,,0,44.24,44.24,0,-16167,136290,152457,120123,0,-3831,0,0,0,,3831,-3831
32,08-08-18,80,19:45,20:00,,,0,44.24,44.24,0,-18785,120290,139075,101505,0,0,0,0,0,,0,0
32,08-08-18,81,20:00,20:15,,-90.14,0,-90.14,-90.14,-1,-31827,101590,133417,69763,0,-26350,0,0,0,,26350,-26350
32,08-08-18,82,20:15,20:30,,39.73,0,39.73,39.73,-1,-52554,94467,147021,41913,0,-32978,0,0,0,,32978,-32978
32,08-08-18,83,20:30,20:45,,39.73,0,39.73,39.73,-1,-60581,105221,165802,44640,0,-29481,0,0,0,,29481,-29481
32,08-08-18,84,20:45,21:00,,39.73,0,39.73,39.73,-1,-58560,100121,158681,41561,0,-31772,0,0,0,,31772,-31772
32,08-08-18,85,21:00,21:15,,40.74,0,40.74,40.74,-1,-60142,104616,164758,44474,0,-19812,0,0,0,,19812,-19812
32,08-08-18,86,21:15,21:30,,40.78,0,40.78,40.78,-1,-59693,89445,149138,29752,0,-14114,0,0,0,,14114,-14114
32,08-08-18,87,21:30,21:45,43.73,42.64,0,43.73,43.73,1,-73103,66172,139275,-6931,0,-7847,12,0,0,,7859,-7835
32,08-08-18,88,21:45,22:00,47.2,42.64,0,47.2,47.2,1,-90369,57829,148198,-32540,0,-159,290,0,0,,449,131
32,08-08-18,89,22:00,22:15,,,0,44.24,44.24,0,-89940,52181,142121,-37759,0,0,0,0,0,,0,0
32,08-08-18,90,22:15,22:30,,,0,44.24,44.24,0,-77759,53601,131360,-24158,0,0,0,0,0,,0,0
32,08-08-18,91,22:30,22:45,,43,0,43,43,-1,-56770,55357,112127,-1413,0,-68,0,0,0,,68,-68
32,08-08-18,92,22:45,23:00,,39.73,0,39.73,39.73,-1,-41859,65623,107482,23764,0,-6251,0,0,0,,6251,-6251
32,08-08-18,93,23:00,23:15,47.73,42.37,0,47.73,42.37,2,-48983,43934,92917,-5049,0,-4057,607,0,0,,4664,-3450
32,08-08-18,94,23:15,23:30,,,0,44.24,44.24,0,-54343,47686,102029,-6657,0,0,0,0,0,,0,0
32,08-08-18,95,23:30,23:45,,34.92,0,34.92,34.92,-1,-27470,62003,89473,34533,0,-15177,0,0,0,,15177,-15177
32,08-08-18,96,23:45,0:00,,32.92,0,32.92,32.92,-1,-40320,82857,123177,42537,0,-41396,0,0,0,,41396,-41396
32,08-09-18,1,0:00,0:15,44.06,29.64,0,44.06,29.64,2,-34325,60036,94361,25711,0,-25463,113,0,0,,25576,-25350
32,08-09-18,2,0:15,0:30,46.72,17.55,0,46.72,17.55,2,-18656,64867,83523,46211,0,-4846,664,0,0,,5510,-4182
32,08-09-18,3,0:30,0:45,,-0.65,0,-0.65,-0.65,-1,-8380,91677,100057,83297,0,-58759,0,0,0,,58759,-58759
32,08-09-18,4,0:45,1:00,,32.1,0,32.1,32.1,-1,-26677,110124,136801,83447,0,-59015,0,0,0,,59015,-59015
32,08-09-18,5,1:00,1:15,43.65,17.55,0,43.65,43.65,1,-18075,27007,45082,8932,0,-31621,100,0,0,,31721,-31521
32,08-09-18,6,1:15,1:30,43.66,9.28,0,43.66,9.28,2,-4523,65857,70380,61334,0,-7400,50,0,0,,7450,-7350
32,08-09-18,7,1:30,1:45,,-150.03,0,-150.03,-150.03,-1,-18817,87186,106003,68369,0,-65326,0,0,0,,65326,-65326
32,08-09-18,8,1:45,2:00,,32.1,0,32.1,32.1,-1,-24133,95657,119790,71524,0,-52028,0,0,0,,52028,-52028
32,08-09-18,9,2:00,2:15,53.01,33.16,0,53.01,53.01,1,-35531,31840,67371,-3691,0,-28786,1886,0,0,,30672,-26900
32,08-09-18,10,2:15,2:30,53.01,27.81,0,27.81,27.81,-1,-13410,70989,84399,57579,0,-7554,242,0,0,,7796,-7312
32,08-09-18,11,2:30,2:45,,20.24,0,20.24,20.24,-1,-21384,65809,87193,44425,0,-24684,0,0,0,,24684,-24684
32,08-09-18,12,2:45,3:00,,42.87,0,42.87,42.87,-1,-20777,78331,99108,57554,0,-339,0,0,0,,339,-339
32,08-09-18,13,3:00,3:15,,42.78,0,42.78,42.78,-1,-22214,40839,63053,18625,0,-429,0,0,0,,429,-429
32,08-09-18,14,3:15,3:30,,,0,42.16,42.16,0,-20433,33622,54055,13189,0,0,0,0,0,,0,0
32,08-09-18,15,3:30,3:45,,,0,42.16,42.16,0,-21418,39506,60924,18088,0,0,0,0,0,,0,0
32,08-09-18,16,3:45,4:00,,,0,42.16,42.16,0,-24015,36501,60516,12486,0,0,0,0,0,,0,0
32,08-09-18,17,4:00,4:15,43.91,,0,43.91,43.91,1,-28924,22953,51877,-5971,0,0,591,0,0,,591,591
32,08-09-18,18,4:15,4:30,,,0,42.16,42.16,0,-28226,53424,81650,25198,0,0,86,0,0,,86,86
32,08-09-18,19,4:30,4:45,,,0,42.16,42.16,0,-29111,36401,65512,7290,0,0,0,0,0,,0,0
32,08-09-18,20,4:45,5:00,,,0,42.15,42.15,0,-28967,31474,60441,2507,0,0,0,0,0,,0,0
32,08-09-18,21,5:00,5:15,,,0,42.88,42.88,0,-33411,56088,89499,22677,0,0,0,0,0,,0,0
32,08-09-18,22,5:15,5:30,,43.1,0,43.1,43.1,-1,-24864,32364,57228,7500,0,-171,0,0,0,,171,-171
32,08-09-18,23,5:30,5:45,46.69,,0,46.69,46.69,1,-40960,22280,63240,-18680,0,0,657,0,0,,657,657
32,08-09-18,24,5:45,6:00,,,0,42.88,42.88,0,-37171,35619,72790,-1552,0,0,0,0,0,,0,0
32,08-09-18,25,6:00,6:15,,35.9,0,35.9,35.9,-1,-50967,130458,181425,79491,0,-5711,0,0,0,,5711,-5711
32,08-09-18,26,6:15,6:30,,41.72,0,41.72,41.72,-1,-38634,110033,148667,71399,0,-1449,0,0,0,,1449,-1449
32,08-09-18,27,6:30,6:45,,41.18,0,41.18,41.18,-1,-28049,88920,116969,60871,0,-1268,0,0,0,,1268,-1268
32,08-09-18,28,6:45,7:00,,39.9,0,39.9,39.9,-1,-27788,61086,88874,33298,0,-858,0,0,0,,858,-858
32,08-09-18,29,7:00,7:15,,-92.32,0,-92.32,-92.32,-1,-14808,149710,164518,134902,0,-57756,0,0,0,,57756,-57756
32,08-09-18,30,7:15,7:30,,17.4,0,17.4,17.4,-1,-31169,107298,138467,76129,0,-67433,0,0,0,,67433,-67433
32,08-09-18,31,7:30,7:45,,17.4,0,17.4,17.4,-1,-24514,99456,123970,74942,0,-24894,0,0,0,,24894,-24894
32,08-09-18,32,7:45,8:00,,40.03,0,40.03,40.03,-1,-35923,89405,125328,53482,0,-10704,0,0,0,,10704,-10704
32,08-09-18,33,8:00,8:15,,39.9,0,39.9,39.9,-1,-68999,94070,163069,25071,0,-4176,0,0,0,,4176,-4176
32,08-09-18,34,8:15,8:30,,39.9,0,39.9,39.9,-1,-59344,60165,119509,821,0,-4906,0,0,0,,4906,-4906
32,08-09-18,35,8:30,8:45,43.9,39.9,0,43.9,43.9,1,-76855,37548,114403,-39307,0,-27,841,0,0,,868,814
32,08-09-18,36,8:45,9:00,47.9,,0,47.9,47.9,1,-87252,41374,128626,-45878,0,0,606,0,0,,606,606
32,08-09-18,37,9:00,9:15,,,0,44.32,44.32,0,-37264,54694,91958,17430,0,0,0,0,0,,0,0
32,08-09-18,38,9:15,9:30,,43.4,0,43.4,43.4,-1,-50259,62431,112690,12172,0,-377,0,0,0,,377,-377
32,08-09-18,39,9:30,9:45,,43.4,0,43.4,43.4,-1,-70723,52185,122908,-18538,0,-470,0,0,0,,470,-470
32,08-09-18,40,9:45,10:00,47.9,,0,47.9,47.9,1,-82837,49396,132233,-33441,0,0,307,0,0,,307,307
32,08-09-18,41,10:00,10:15,,,0,44.32,44.32,0,-88331,64519,152850,-23812,0,0,0,0,0,,0,0
32,08-09-18,42,10:15,10:30,,,0,44.32,44.32,0,-88789,81297,170086,-7492,0,0,0,0,0,,0,0
32,08-09-18,43,10:30,10:45,,,0,44.32,44.32,0,-81074,74230,155304,-6844,0,0,0,0,0,,0,0
32,08-09-18,44,10:45,11:00,,,0,44.32,44.32,0,-88017,66914,154931,-21103,0,0,0,0,0,,0,0
32,08-09-18,45,11:00,11:15,,,0,44.32,44.32,0,-82760,58332,141092,-24428,0,0,0,0,0,,0,0
32,08-09-18,46,11:15,11:30,,,0,44.32,44.32,0,-82113,55554,137667,-26559,0,0,0,0,0,,0,0
32,08-09-18,47,11:30,11:45,,,0,44.32,44.32,0,-85887,55129,141016,-30758,0,0,0,0,0,,0,0
32,08-09-18,48,11:45,12:00,,,0,44.32,44.32,0,-80127,53918,134045,-26209,0,0,0,0,0,,0,0
32,08-09-18,49,12:00,12:15,,,0,44.32,44.32,0,-84805,49423,134228,-35382,0,0,0,0,0,,0,0
32,08-09-18,50,12:15,12:30,,,0,44.32,44.32,0,-99837,37951,137788,-61886,0,0,0,0,0,,0,0
32,08-09-18,51,12:30,12:45,,,0,44.32,44.32,0,-119189,39296,158485,-79893,0,0,0,0,0,,0,0
32,08-09-18,52,12:45,13:00,51.95,,0,51.95,51.95,1,-152013,31489,183502,-120524,0,0,5045,0,0,,5045,5045
32,08-09-18,53,13:00,13:15,165.02,,0,165.02,165.02,1,-168360,63642,232002,-104718,0,0,31514,0,0,,31514,31514
32,08-09-18,54,13:15,13:30,51.95,,0,51.95,51.95,1,-154927,82722,237649,-72205,0,0,19889,0,0,,19889,19889
32,08-09-18,55,13:30,13:45,,,0,44.32,44.32,0,-158401,72651,231052,-85750,0,0,279,0,0,,279,279
32,08-09-18,56,13:45,14:00,67.4,,0,67.4,67.4,1,-181249,45103,226352,-136146,0,0,9740,0,0,,9740,9740
32,08-09-18,57,14:00,14:15,164.02,,0,164.02,164.02,1,-131731,49209,180940,-82522,0,0,32750,0,0,,32750,32750
32,08-09-18,58,14:15,14:30,164.02,,0,164.02,164.02,1,-127315,42752,170067,-84563,0,0,80990,0,0,,80990,80990
32,08-09-18,59,14:30,14:45,47.9,,0,47.9,47.9,1,-110134,64548,174682,-45586,0,0,18446,0,0,,18446,18446
32,08-09-18,60,14:45,15:00,49.08,,0,49.08,49.08,1,-103591,60798,164389,-42793,0,0,2661,0,0,,2661,2661
32,08-09-18,61,15:00,15:15,51.95,,0,51.95,51.95,1,-105467,74460,179927,-31007,0,0,9828,0,0,,9828,9828
32,08-09-18,62,15:15,15:30,46.95,,0,46.95,46.95,1,-94408,66393,160801,-28015,0,0,6091,0,0,,6091,6091
32,08-09-18,63,15:30,15:45,,43.5,0,43.5,43.5,-1,-81390,72879,154269,-8511,0,-217,0,0,0,,217,-217
32,08-09-18,64,15:45,16:00,,39.9,0,39.9,39.9,-1,-83150,80456,163606,-2694,0,-1698,0,0,0,,1698,-1698
32,08-09-18,65,16:00,16:15,43.9,39.9,0,43.9,43.9,1,-86405,84575,170980,-1830,0,-1712,18,0,0,,1730,-1694
32,08-09-18,66,16:15,16:30,47.9,,0,47.9,47.9,1,-97526,55415,152941,-42111,0,0,3443,0,0,,3443,3443
32,08-09-18,67,16:30,16:45,47.9,,0,47.9,47.9,1,-85838,53760,139598,-32078,0,0,5028,0,0,,5028,5028
32,08-09-18,68,16:45,17:00,43.9,,0,43.9,43.9,1,-71849,69440,141289,-2409,0,0,2217,0,0,,2217,2217
32,08-09-18,69,17:00,17:15,46.99,,0,46.99,46.99,1,-105582,45854,151436,-59728,0,0,1092,0,0,,1092,1092
32,08-09-18,70,17:15,17:30,43.9,,0,43.9,43.9,1,-113281,30850,144131,-82431,0,0,2371,0,0,,2371,2371
32,08-09-18,71,17:30,17:45,43.9,,0,43.9,43.9,1,-87856,55054,142910,-32802,0,0,597,0,0,,597,597
32,08-09-18,72,17:45,18:00,46.99,,0,46.99,46.99,1,-133403,92197,225600,-41206,0,0,477,0,0,,477,477
32,08-09-18,73,18:00,18:15,,,0,44.32,44.32,0,-153650,110410,264060,-43240,0,0,0,0,0,,0,0
32,08-09-18,74,18:15,18:30,,,0,44.32,44.32,0,-124730,125527,250257,797,0,0,0,0,0,,0,0
32,08-09-18,75,18:30,18:45,,33.1,0,33.1,33.1,-1,-76962,121278,198240,44316,0,-11226,0,0,0,,11226,-11226
32,08-09-18,76,18:45,19:00,,39.9,0,39.9,39.9,-1,-63752,124366,188118,60614,0,-15415,0,0,0,,15415,-15415
32,08-09-18,77,19:00,19:15,,36.7,0,36.7,36.7,-1,-93188,113909,207097,20721,0,-17914,0,0,0,,17914,-17914
32,08-09-18,78,19:15,19:30,43.9,36.7,0,43.9,43.9,1,-99528,79668,179196,-19860,0,-3633,1001,0,0,,4634,-2632
32,08-09-18,79,19:30,19:45,43.9,33.1,0,33.1,33.1,-1,-59114,93587,152701,34473,0,-10116,328,0,0,,10444,-9788
32,08-09-18,80,19:45,20:00,,33.1,0,33.1,33.1,-1,-59828,88233,148061,28405,0,-25247,0,0,0,,25247,-25247
32,08-09-18,81,20:00,20:15,51.95,33.1,0,51.95,51.95,1,-106146,62405,168551,-43741,0,-2227,5931,0,0,,8158,3704
32,08-09-18,82,20:15,20:30,43.9,,0,43.9,43.9,1,-60292,57253,117545,-3039,0,0,1254,0,0,,1254,1254
32,08-09-18,83,20:30,20:45,,35.9,0,35.9,35.9,-1,-27973,72626,100599,44653,0,-12875,0,0,0,,12875,-12875
32,08-09-18,84,20:45,21:00,,39.31,0,39.31,39.31,-1,-42395,97165,139560,54770,0,-29160,0,0,0,,29160,-29160
32,08-09-18,85,21:00,21:15,46.49,43.19,0,46.49,43.19,2,-85367,60319,145686,-25048,0,-8388,938,0,0,,9326,-7450
32,08-09-18,86,21:15,21:30,46.49,39.13,0,39.13,39.13,-1,-47396,77626,125022,30230,0,-9028,1,0,0,,9029,-9027
32,08-09-18,87,21:30,21:45,,39.13,0,39.13,39.13,-1,-20248,96395,116643,76147,0,-19104,0,0,0,,19104,-19104
32,08-09-18,88,21:45,22:00,,35.9,0,35.9,35.9,-1,-17058,118124,135182,101066,0,-19675,0,0,0,,19675,-19675
32,08-09-18,89,22:00,22:15,,31.95,0,31.95,31.95,-1,-39408,116389,155797,76981,0,-25971,0,0,0,,25971,-25971
32,08-09-18,90,22:15,22:30,,32.64,0,32.64,32.64,-1,-42013,87110,129123,45097,0,-31977,0,0,0,,31977,-31977
32,08-09-18,91,22:30,22:45,,35.03,0,35.03,35.03,-1,-29320,118767,148087,89447,0,-36258,0,0,0,,36258,-36258
32,08-09-18,92,22:45,23:00,,-109.97,0,-109.97,-109.97,-1,-48717,173785,222502,125068,0,-43319,0,0,0,,43319,-43319
32,08-09-18,93,23:00,23:15,,-120.02,0,-120.02,-120.02,-1,-103953,93128,197081,-10825,0,-39796,0,0,0,,39796,-39796
32,08-09-18,94,23:15,23:30,,32.34,0,32.34,32.34,-1,-79766,106305,186071,26539,0,-12282,0,0,0,,12282,-12282
32,08-09-18,95,23:30,23:45,,39.9,0,39.9,39.9,-1,-82177,91221,173398,9044,0,-10374,0,0,0,,10374,-10374
32,08-09-18,96,23:45,0:00,,28.33,0,28.33,28.33,-1,-68228,105113,173341,36885,0,-23869,0,0,0,,23869,-23869
32,08-10-18,1,0:00,0:15,67.68,39.51,0,67.68,67.68,1,-155438,76123,231561,-79315,0,-9966,4005,0,0,,13971,-5961
32,08-10-18,2,0:15,0:30,132.12,,0,132.12,132.12,1,-137119,60990,198109,-76129,0,0,22894,0,0,,22894,22894
32,08-10-18,3,0:30,0:45,,,0,41.27,41.27,0,-114962,68776,183738,-46186,0,0,530,0,0,,530,530
32,08-10-18,4,0:45,1:00,44.03,,0,44.03,44.03,1,-139875,72414,212289,-67461,0,0,724,0,0,,724,724
32,08-10-18,5,1:00,1:15,,35.51,0,35.51,35.51,-1,-61441,96815,158256,35374,0,-3109,0,0,0,,3109,-3109
32,08-10-18,6,1:15,1:30,,43.06,0,43.06,43.06,-1,-86283,77450,163733,-8833,0,-398,0,0,0,,398,-398
32,08-10-18,7,1:30,1:45,51.62,,0,51.62,51.62,1,-104548,78106,182654,-26442,0,0,10594,0,0,,10594,10594
32,08-10-18,8,1:45,2:00,57.24,,0,57.24,57.24,1,-115153,62048,177201,-53105,0,0,30966,0,0,,30966,30966
32,08-10-18,9,2:00,2:15,58.46,,0,58.46,58.46,1,-81864,47298,129162,-34566,0,0,21409,0,0,,21409,21409
32,08-10-18,10,2:15,2:30,67.68,,0,67.68,67.68,1,-87605,37052,124657,-50553,0,0,40358,0,0,,40358,40358
32,08-10-18,11,2:30,2:45,47.51,,0,47.51,47.51,1,-85707,48790,134497,-36917,0,0,13968,0,0,,13968,13968
32,08-10-18,12,2:45,3:00,39.47,39.51,0,39.51,39.51,-1,-76312,74302,150614,-2010,0,-41,2350,0,0,,2391,2309
32,08-10-18,13,3:00,3:15,,38.57,0,38.57,38.57,-1,-43612,71585,115197,27973,0,-2178,0,0,0,,2178,-2178
32,08-10-18,14,3:15,3:30,,39.51,0,39.51,39.51,-1,-65647,67689,133336,2042,0,-197,0,0,0,,197,-197
32,08-10-18,15,3:30,3:45,59.43,,0,59.43,59.43,1,-96484,57281,153765,-39203,0,0,8403,0,0,,8403,8403
32,08-10-18,16,3:45,4:00,54.16,,0,54.16,54.16,1,-105618,56556,162174,-49062,0,0,34719,0,0,,34719,34719
32,08-10-18,17,4:00,4:15,47.51,,0,47.51,47.51,1,-81458,59823,141281,-21635,0,0,20630,0,0,,20630,20630
32,08-10-18,18,4:15,4:30,50.16,,0,50.16,50.16,1,-96134,56727,152861,-39407,0,0,14654,0,0,,14654,14654
32,08-10-18,19,4:30,4:45,51.62,,0,51.62,51.62,1,-110483,56567,167050,-53916,0,0,35176,0,0,,35176,35176
32,08-10-18,20,4:45,5:00,47.51,,0,47.51,47.51,1,-115305,71787,187092,-43518,0,0,34499,0,0,,34499,34499
32,08-10-18,21,5:00,5:15,43.51,37.35,0,43.51,37.35,2,-43114,82506,125620,39392,0,-329,11241,0,0,,11570,10912
32,08-10-18,22,5:15,5:30,43.51,,0,43.51,43.51,1,-69904,72488,142392,2584,0,0,81,0,0,,81,81
32,08-10-18,23,5:30,5:45,72.27,,0,72.27,72.27,1,-104815,48180,152995,-56635,0,0,27757,0,0,,27757,27757
32,08-10-18,24,5:45,6:00,72.27,,0,72.27,72.27,1,-122424,48088,170512,-74336,0,0,73708,0,0,,73708,73708
32,08-10-18,25,6:00,6:15,58.12,,0,58.12,58.12,1,-91325,61959,153284,-29366,0,0,36495,0,0,,36495,36495
32,08-10-18,26,6:15,6:30,58.12,42.68,0,42.68,42.68,-1,-53076,73868,126944,20792,0,-1342,3,0,0,,1345,-1339
32,08-10-18,27,6:30,6:45,,42.92,0,42.92,42.92,-1,-41791,66731,108522,24940,0,-930,0,0,0,,930,-930
32,08-10-18,28,6:45,7:00,,,0,43.27,43.27,0,-60372,75531,135903,15159,0,0,0,0,0,,0,0
32,08-10-18,29,7:00,7:15,,35.21,0,35.21,35.21,-1,-80477,102066,182543,21589,0,-11300,0,0,0,,11300,-11300
32,08-10-18,30,7:15,7:30,,17.38,0,17.38,17.38,-1,-55011,107545,162556,52534,0,-40839,0,0,0,,40839,-40839
32,08-10-18,31,7:30,7:45,,24.81,0,24.81,24.81,-1,-35102,93907,129009,58805,0,-37666,0,0,0,,37666,-37666
32,08-10-18,32,7:45,8:00,,32.02,0,32.02,32.02,-1,-28447,101746,130193,73299,0,-41688,0,0,0,,41688,-41688
32,08-10-18,33,8:00,8:15,,42.45,0,42.45,42.45,-1,-118905,135968,254873,17063,0,-16977,0,0,0,,16977,-16977
32,08-10-18,34,8:15,8:30,,17.38,0,17.38,17.38,-1,-75159,135952,211111,60793,0,-20108,0,0,0,,20108,-20108
32,08-10-18,35,8:30,8:45,,32.34,0,32.34,32.34,-1,-58952,144043,202995,85091,0,-30750,0,0,0,,30750,-30750
32,08-10-18,36,8:45,9:00,,17.38,0,17.38,17.38,-1,-55259,138112,193371,82853,0,-36006,0,0,0,,36006,-36006
32,08-10-18,37,9:00,9:15,,32.34,0,32.34,32.34,-1,-58240,128312,186552,70072,0,-31307,0,0,0,,31307,-31307
32,08-10-18,38,9:15,9:30,,38.98,0,38.98,38.98,-1,-62943,124643,187586,61700,0,-24052,0,0,0,,24052,-24052
32,08-10-18,39,9:30,9:45,,17.7,0,17.7,17.7,-1,-56139,143324,199463,87185,0,-37549,0,0,0,,37549,-37549
32,08-10-18,40,9:45,10:00,,-33.15,0,-33.15,-33.15,-1,-52719,153427,206146,100708,0,-70823,0,0,0,,70823,-70823
32,08-10-18,41,10:00,10:15,,28.53,0,28.53,28.53,-1,-78895,138291,217186,59396,0,-46351,0,0,0,,46351,-46351
32,08-10-18,42,10:15,10:30,,25.34,0,25.34,25.34,-1,-86628,112892,199520,26264,0,-37944,0,0,0,,37944,-37944
32,08-10-18,43,10:30,10:45,,36.18,0,36.18,36.18,-1,-86170,108401,194571,22231,0,-11516,0,0,0,,11516,-11516
32,08-10-18,44,10:45,11:00,,39.49,0,39.49,39.49,-1,-105338,124979,230317,19641,0,-14090,0,0,0,,14090,-14090
32,08-10-18,45,11:00,11:15,,36.18,0,36.18,36.18,-1,-113377,120361,233738,6984,0,-9827,0,0,0,,9827,-9827
32,08-10-18,46,11:15,11:30,,35.78,0,35.78,35.78,-1,-104740,141373,246113,36633,0,-23728,0,0,0,,23728,-23728
32,08-10-18,47,11:30,11:45,,11.1,0,11.1,11.1,-1,-97934,157143,255077,59209,0,-31675,0,0,0,,31675,-31675
32,08-10-18,48,11:45,12:00,,-13.2,0,-13.2,-13.2,-1,-106979,139076,246055,32097,0,-41013,0,0,0,,41013,-41013
32,08-10-18,49,12:00,12:15,,,0,43.45,43.45,0,-64072,69466,133538,5394,0,-1839,0,0,0,,1839,-1839
32,08-10-18,50,12:15,12:30,,,0,43.45,43.45,0,-100449,43682,144131,-56767,0,0,0,0,0,,0,0
32,08-10-18,51,12:30,12:45,46.39,,0,46.39,46.39,1,-117295,56702,173997,-60593,0,0,1318,0,0,,1318,1318
32,08-10-18,52,12:45,13:00,43.49,,0,43.49,43.49,1,-115716,73226,188942,-42490,0,0,1886,0,0,,1886,1886
32,08-10-18,53,13:00,13:15,,,0,41.38,41.38,0,-60172,70465,130637,10293,0,0,0,0,0,,0,0
32,08-10-18,54,13:15,13:30,,39.49,0,39.49,39.49,-1,-18954,79850,98804,60896,0,-166,0,0,0,,166,-166
32,08-10-18,55,13:30,13:45,,43.14,0,43.14,43.14,-1,-15558,111515,127073,95957,0,-250,0,0,0,,250,-250
32,08-10-18,56,13:45,14:00,,39.49,0,39.49,39.49,-1,-28394,74189,102583,45795,0,-541,0,0,0,,541,-541
32,08-10-18,57,14:00,14:15,,39.49,0,39.49,39.49,-1,-20563,101349,121912,80786,0,-680,0,0,0,,680,-680
32,08-10-18,58,14:15,14:30,,42.59,0,42.59,42.59,-1,-18673,87536,106209,68863,0,-26,0,0,0,,26,-26
32,08-10-18,59,14:30,14:45,,10.59,0,10.59,10.59,-1,-11707,106536,118243,94829,0,-4305,0,0,0,,4305,-4305
32,08-10-18,60,14:45,15:00,,-150.78,0,-150.78,-150.78,-1,-20136,120736,140872,100600,0,-72295,0,0,0,,72295,-72295
32,08-10-18,61,15:00,15:15,,0.88,0,0.88,0.88,-1,-50516,146882,197398,96366,0,-78927,0,0,0,,78927,-78927
32,08-10-18,62,15:15,15:30,,32.34,0,32.34,32.34,-1,-39979,93885,133864,53906,0,-25600,0,0,0,,25600,-25600
32,08-10-18,63,15:30,15:45,,17.38,0,17.38,17.38,-1,-26448,89268,115716,62820,0,-24870,0,0,0,,24870,-24870
32,08-10-18,64,15:45,16:00,,42.48,0,42.48,42.48,-1,-38039,62812,100851,24773,0,-7043,0,0,0,,7043,-7043
32,08-10-18,65,16:00,16:15,,,0,43.42,43.42,0,-82842,74715,157557,-8127,0,0,0,0,0,,0,0
32,08-10-18,66,16:15,16:30,,,0,43.42,43.42,0,-80026,57862,137888,-22164,0,0,0,0,0,,0,0
32,08-10-18,67,16:30,16:45,,,0,43.42,43.42,0,-25089,78777,103866,53688,0,0,0,0,0,,0,0
32,08-10-18,68,16:45,17:00,,,0,43.42,43.42,0,-25112,69393,94505,44281,0,0,0,0,0,,0,0
32,08-10-18,69,17:00,17:15,,,0,43.5,43.5,0,-82175,125226,207401,43051,0,0,0,0,0,,0,0
32,08-10-18,70,17:15,17:30,,,0,43.5,43.5,0,-65276,85011,150287,19735,0,0,0,0,0,,0,0
32,08-10-18,71,17:30,17:45,,,0,43.49,43.49,0,-58669,73108,131777,14439,0,0,0,0,0,,0,0
32,08-10-18,72,17:45,18:00,,42.28,0,42.28,42.28,-1,-34150,104197,138347,70047,0,-50,0,0,0,,50,-50
32,08-10-18,73,18:00,18:15,,-116.08,0,-116.08,-116.08,-1,-48735,88032,136767,39297,0,-26317,0,0,0,,26317,-26317
32,08-10-18,74,18:15,18:30,,32.34,0,32.34,32.34,-1,-87698,61406,149104,-26292,0,-19643,0,0,0,,19643,-19643
32,08-10-18,75,18:30,18:45,,38.78,0,38.78,38.78,-1,-55076,71644,126720,16568,0,-4073,0,0,0,,4073,-4073
32,08-10-18,76,18:45,19:00,43.49,43.5,0,43.49,43.49,1,-68988,59492,128480,-9496,0,-624,279,0,0,,903,-345
32,08-10-18,77,19:00,19:15,43.49,,0,43.49,43.49,1,-83128,56541,139669,-26587,0,0,3023,0,0,,3023,3023
32,08-10-18,78,19:15,19:30,48.2,,0,48.2,48.2,1,-96510,42454,138964,-54056,0,0,4319,0,0,,4319,4319
32,08-10-18,79,19:30,19:45,117.38,,0,117.38,117.38,1,-111081,39718,150799,-71363,0,0,18959,0,0,,18959,18959
32,08-10-18,80,19:45,20:00,165.12,,0,165.12,165.12,1,-94204,50055,144259,-44149,0,0,53211,0,0,,53211,53211
32,08-10-18,81,20:00,20:15,43.49,32.34,0,43.49,32.34,2,-89813,111386,201199,21573,0,-8706,7231,0,0,,15937,-1475
32,08-10-18,82,20:15,20:30,,-6.08,0,-6.08,-6.08,-1,-56878,110504,167382,53626,0,-27447,0,0,0,,27447,-27447
32,08-10-18,83,20:30,20:45,,-112.78,0,-112.78,-112.78,-1,-27725,128621,156346,100896,0,-89819,0,0,0,,89819,-89819
32,08-10-18,84,20:45,21:00,,21.64,0,21.64,21.64,-1,-39614,89765,129379,50151,0,-60145,0,0,0,,60145,-60145
32,08-10-18,85,21:00,21:15,48.18,43.08,0,48.18,43.08,2,-113044,65639,178683,-47405,0,-12713,262,0,0,,12975,-12451
32,08-10-18,86,21:15,21:30,49.39,,0,49.39,49.39,1,-93190,72196,165386,-20994,0,0,7089,0,0,,7089,7089
32,08-10-18,87,21:30,21:45,47.38,,0,47.38,47.38,1,-80403,57003,137406,-23400,0,0,5079,0,0,,5079,5079
32,08-10-18,88,21:45,22:00,43.49,,0,43.49,43.49,1,-88957,74750,163707,-14207,0,0,397,0,0,,397,397
32,08-10-18,89,22:00,22:15,,,0,43.49,43.49,0,-86858,74857,161715,-12001,0,0,0,0,0,,0,0
32,08-10-18,90,22:15,22:30,,36.18,0,36.18,36.18,-1,-88749,106933,195682,18184,0,-6696,0,0,0,,6696,-6696
32,08-10-18,91,22:30,22:45,,36.18,0,36.18,36.18,-1,-79675,112344,192019,32669,0,-20449,0,0,0,,20449,-20449
32,08-10-18,92,22:45,23:00,,-116.08,0,-116.08,-116.08,-1,-62463,127342,189805,64879,0,-26836,0,0,0,,26836,-26836
32,08-10-18,93,23:00,23:15,,-40.79,0,-40.79,-40.79,-1,-102376,141806,244182,39430,0,-44584,0,0,0,,44584,-44584
32,08-10-18,94,23:15,23:30,,,0,43.51,43.51,0,-95650,77682,173332,-17968,0,-1461,0,0,0,,1461,-1461
32,08-10-18,95,23:30,23:45,,,0,43.51,43.51,0,-111724,74212,185936,-37512,0,0,0,0,0,,0,0
32,08-10-18,96,23:45,0:00,,,0,43.51,43.51,0,-109022,53862,162884,-55160,0,0,0,0,0,,0,0
33,08-11-18,1,0:00,0:15,45.24,46.06,0,45.24,43.67,2,-80622,38803,119425,-41819,0,-159,965,0,0,,1124,806
33,08-11-18,2,0:15,0:30,47.21,,0,47.21,47.21,1,-126529,44441,170970,-82088,0,0,4563,0,0,,4563,4563
33,08-11-18,3,0:30,0:45,,,0,43.68,43.68,0,-125159,37492,162651,-87667,0,0,127,0,0,,127,127
33,08-11-18,4,0:45,1:00,,,0,43.68,43.68,0,-108880,59356,168236,-49524,0,0,0,0,0,,0,0
33,08-11-18,5,1:00,1:15,,,0,42.75,42.75,0,-77089,56344,133433,-20745,0,0,0,0,0,,0,0
33,08-11-18,6,1:15,1:30,52.17,,0,52.17,52.17,1,-105763,52372,158135,-53391,0,0,7121,0,0,,7121,7121
33,08-11-18,7,1:30,1:45,67.38,,0,67.38,67.38,1,-115027,56220,171247,-58807,0,0,32165,0,0,,32165,32165
33,08-11-18,8,1:45,2:00,67.38,41.78,0,41.78,41.78,-1,-74858,77698,152556,2840,0,-470,5839,0,0,,6309,5369
33,08-11-18,9,2:00,2:15,52.17,,0,52.17,52.17,1,-87090,62922,150012,-24168,0,0,6208,0,0,,6208,6208
33,08-11-18,10,2:15,2:30,44.02,,0,44.02,44.02,1,-87247,88755,176002,1508,0,0,5493,0,0,,5493,5493
33,08-11-18,11,2:30,2:45,39.39,,0,39.39,39.39,1,-76156,86445,162601,10289,0,0,80,0,0,,80,80
33,08-11-18,12,2:45,3:00,39.4,,0,39.4,39.4,1,-87931,77782,165713,-10149,0,0,456,0,0,,456,456
33,08-11-18,13,3:00,3:15,,,0,41.12,41.12,0,-40827,96829,137656,56002,0,0,3,0,0,,3,3
33,08-11-18,14,3:15,3:30,,,0,41.12,41.12,0,-45158,50910,96068,5752,0,0,0,0,0,,0,0
33,08-11-18,15,3:30,3:45,,,0,41.12,41.12,0,-48794,67695,116489,18901,0,0,0,0,0,,0,0
33,08-11-18,16,3:45,4:00,,,0,41.12,41.12,0,-47204,78552,125756,31348,0,0,0,0,0,,0,0
33,08-11-18,17,4:00,4:15,,,0,41.1,41.1,0,-49513,78755,128268,29242,0,0,0,0,0,,0,0
33,08-11-18,18,4:15,4:30,,,0,41.1,41.1,0,-46780,75443,122223,28663,0,0,0,0,0,,0,0
33,08-11-18,19,4:30,4:45,,,0,41.1,41.1,0,-39394,78562,117956,39168,0,0,0,0,0,,0,0
33,08-11-18,20,4:45,5:00,,,0,41.1,41.1,0,-41181,60995,102176,19814,0,0,0,0,0,,0,0
33,08-11-18,21,5:00,5:15,,,0,41.1,41.1,0,-30334,57534,87868,27200,0,0,0,0,0,,0,0
33,08-11-18,22,5:15,5:30,,,0,41.08,41.08,0,-34620,54810,89430,20190,0,0,0,0,0,,0,0
33,08-11-18,23,5:30,5:45,,,0,41.08,41.08,0,-35846,74289,110135,38443,0,0,0,0,0,,0,0
33,08-11-18,24,5:45,6:00,,,0,41.08,41.08,0,-31596,37677,69273,6081,0,0,0,0,0,,0,0
33,08-11-18,25,6:00,6:15,,,0,41.08,41.08,0,-39427,79255,118682,39828,0,0,0,0,0,,0,0
33,08-11-18,26,6:15,6:30,,,0,41.07,41.07,0,-17594,92078,109672,74484,0,0,0,0,0,,0,0
33,08-11-18,27,6:30,6:45,,39.29,0,39.29,39.29,-1,-18854,75956,94810,57102,0,-1538,0,0,0,,1538,-1538
33,08-11-18,28,6:45,7:00,,25.15,0,25.15,25.15,-1,-27938,81011,108949,53073,0,-9054,0,0,0,,9054,-9054
33,08-11-18,29,7:00,7:15,,35.29,0,35.29,35.29,-1,-66289,77571,143860,11282,0,-8926,0,0,0,,8926,-8926
33,08-11-18,30,7:15,7:30,,19.74,0,19.74,19.74,-1,-25717,79248,104965,53531,0,-20935,0,0,0,,20935,-20935
33,08-11-18,31,7:30,7:45,,,0,22.9,22.9,0,-26873,65238,92111,38365,0,-2851,0,0,0,,2851,-2851
33,08-11-18,32,7:45,8:00,,,0,22.9,22.9,0,-33139,68418,101557,35279,0,0,0,0,0,,0,0
33,08-11-18,33,8:00,8:15,,39.29,0,39.29,39.29,-1,-67530,95366,162896,27836,0,-188,0,0,0,,188,-188
33,08-11-18,34,8:15,8:30,,32.25,0,32.25,32.25,-1,-45875,120873,166748,74998,0,-6003,0,0,0,,6003,-6003
33,08-11-18,35,8:30,8:45,,17.46,0,17.46,17.46,-1,-33606,106438,140044,72832,0,-27217,0,0,0,,27217,-27217
33,08-11-18,36,8:45,9:00,,17.46,0,17.46,17.46,-1,-37151,85203,122354,48052,0,-34654,0,0,0,,34654,-34654
33,08-11-18,37,9:00,9:15,,39.29,0,39.29,39.29,-1,-43485,73968,117453,30483,0,-18822,0,0,0,,18822,-18822
33,08-11-18,38,9:15,9:30,,46.12,0,46.12,46.12,-1,-37441,97007,134448,59566,0,-1879,0,0,0,,1879,-1879
33,08-11-18,39,9:30,9:45,,-46.73,0,-46.73,-46.73,-1,-51697,113897,165594,62200,0,-27442,0,0,0,,27442,-27442
33,08-11-18,40,9:45,10:00,,17.46,0,17.46,17.46,-1,-34064,99938,134002,65874,0,-44626,0,0,0,,44626,-44626
33,08-11-18,41,10:00,10:15,,29.53,0,29.53,29.53,-1,-57536,86929,144465,29393,0,-36231,0,0,0,,36231,-36231
33,08-11-18,42,10:15,10:30,,39.98,0,39.98,39.98,-1,-56993,99776,156769,42783,0,-1917,0,0,0,,1917,-1917
33,08-11-18,43,10:30,10:45,,36.26,0,36.26,36.26,-1,-67857,118526,186383,50669,0,-2803,0,0,0,,2803,-2803
33,08-11-18,44,10:45,11:00,39.57,39.98,0,42.73,39.98,2,-75049,105093,180142,30044,0,-1496,23,0,0,,1519,-1473
33,08-11-18,45,11:00,11:15,43.72,32.42,0,43.72,32.42,2,-84722,100682,185404,15960,0,-1353,355,0,0,,1708,-998
33,08-11-18,46,11:15,11:30,,12.7,0,12.7,12.7,-1,-71194,115451,186645,44257,0,-33239,0,0,0,,33239,-33239
33,08-11-18,47,11:30,11:45,,36.26,0,36.26,36.26,-1,-80050,130486,210536,50436,0,-23456,0,0,0,,23456,-23456
33,08-11-18,48,11:45,12:00,,46.06,0,46.06,46.06,-1,-85922,131830,217752,45908,0,-6870,0,0,0,,6870,-6870
33,08-11-18,49,12:00,12:15,,43.2,0,43.2,43.2,-1,-57859,94180,152039,36321,0,-376,0,0,0,,376,-376
33,08-11-18,50,12:15,12:30,,36.26,0,36.26,36.26,-1,-54853,89872,144725,35019,0,-13886,0,0,0,,13886,-13886
33,08-11-18,51,12:30,12:45,,39.34,0,39.34,39.34,-1,-65780,96816,162596,31036,0,-13195,0,0,0,,13195,-13195
33,08-11-18,52,12:45,13:00,,32.42,0,32.42,32.42,-1,-59667,111469,171136,51802,0,-30175,0,0,0,,30175,-30175
33,08-11-18,53,13:00,13:15,,1.52,0,1.52,1.52,-1,-49312,128746,178058,79434,0,-56694,0,0,0,,56694,-56694
33,08-11-18,54,13:15,13:30,,17.46,0,17.46,17.46,-1,-49325,127553,176878,78228,0,-72087,0,0,0,,72087,-72087
33,08-11-18,55,13:30,13:45,,17.46,0,17.46,17.46,-1,-48389,131655,180044,83266,0,-81642,0,0,0,,81642,-81642
33,08-11-18,56,13:45,14:00,,20.45,0,20.45,20.45,-1,-52358,124074,176432,71716,0,-71270,0,0,0,,71270,-71270
33,08-11-18,57,14:00,14:15,,22.03,0,22.03,22.03,-1,-36762,121216,157978,84454,0,-49184,0,0,0,,49184,-49184
33,08-11-18,58,14:15,14:30,,39.4,0,39.4,39.4,-1,-45904,108521,154425,62617,0,-13218,0,0,0,,13218,-13218
33,08-11-18,59,14:30,14:45,,-104.95,0,-104.95,-104.95,-1,-51827,113596,165423,61769,0,-37067,0,0,0,,37067,-37067
33,08-11-18,60,14:45,15:00,,29.04,0,29.04,29.04,-1,-54489,105853,160342,51364,0,-44058,0,0,0,,44058,-44058
33,08-11-18,61,15:00,15:15,,26.03,0,26.03,26.03,-1,-35204,136357,171561,101153,0,-37931,0,0,0,,37931,-37931
33,08-11-18,62,15:15,15:30,,,0,22.86,22.86,0,-33532,127478,161010,93946,0,-2115,0,0,0,,2115,-2115
33,08-11-18,63,15:30,15:45,,39.98,0,39.98,39.98,-1,-31889,100359,132248,68470,0,-1612,0,0,0,,1612,-1612
33,08-11-18,64,15:45,16:00,,37.03,0,37.03,37.03,-1,-31766,97045,128811,65279,0,-5987,0,0,0,,5987,-5987
33,08-11-18,65,16:00,16:15,,-87.48,0,-87.48,-87.48,-1,-23815,184093,207908,160278,0,-45889,0,0,0,,45889,-45889
33,08-11-18,66,16:15,16:30,,32.42,0,32.42,32.42,-1,-32719,132905,165624,100186,0,-27899,0,0,0,,27899,-27899
33,08-11-18,67,16:30,16:45,,31.41,0,31.41,31.41,-1,-28843,123739,152582,94896,0,-9736,0,0,0,,9736,-9736
33,08-11-18,68,16:45,17:00,,32.16,0,32.16,32.16,-1,-35744,85667,121411,49923,0,-10596,0,0,0,,10596,-10596
33,08-11-18,69,17:00,17:15,,40.03,0,40.03,40.03,-1,-43788,153120,196908,109332,0,-7396,0,0,0,,7396,-7396
33,08-11-18,70,17:15,17:30,,39.38,0,39.38,39.38,-1,-52310,160279,212589,107969,0,-10163,0,0,0,,10163,-10163
33,08-11-18,71,17:30,17:45,,,0,43.62,43.62,0,-63778,113847,177625,50069,0,-760,0,0,0,,760,-760
33,08-11-18,72,17:45,18:00,117.46,,0,117.46,117.46,1,-101105,89967,191072,-11138,0,0,3030,0,0,,3030,3030
33,08-11-18,73,18:00,18:15,43.98,-48.78,0,-48.78,-48.78,-1,-69706,138890,208596,69184,0,-9135,2253,0,0,,11388,-6882
33,08-11-18,74,18:15,18:30,,-73.83,0,-73.83,-73.83,-1,-65009,122337,187346,57328,0,-54731,0,0,0,,54731,-54731
33,08-11-18,75,18:30,18:45,,32.42,0,32.42,32.42,-1,-64340,125417,189757,61077,0,-32658,0,0,0,,32658,-32658
33,08-11-18,76,18:45,19:00,,,0,43.62,43.62,0,-65035,102646,167681,37611,0,-4799,0,0,0,,4799,-4799
33,08-11-18,77,19:00,19:15,,-95.55,0,-95.55,-95.55,-1,-44479,157925,202404,113446,0,-20096,0,0,0,,20096,-20096
33,08-11-18,78,19:15,19:30,,32.42,0,32.42,32.42,-1,-52565,127635,180200,75070,0,-18438,0,0,0,,18438,-18438
33,08-11-18,79,19:30,19:45,,,0,43.62,43.62,0,-70297,125826,196123,55529,0,-792,0,0,0,,792,-792
33,08-11-18,80,19:45,20:00,,46.21,0,46.21,46.21,-1,-64470,116547,181017,52077,0,-2,0,0,0,,2,-2
33,08-11-18,81,20:00,20:15,,37,0,37,37,-1,-42252,95423,137675,53171,0,-5691,0,0,0,,5691,-5691
33,08-11-18,82,20:15,20:30,,36.26,0,36.26,36.26,-1,-48059,92607,140666,44548,0,-15890,0,0,0,,15890,-15890
33,08-11-18,83,20:30,20:45,,40.03,0,40.03,40.03,-1,-49981,102357,152338,52376,0,-10031,0,0,0,,10031,-10031
33,08-11-18,84,20:45,21:00,,32.42,0,32.42,32.42,-1,-49221,106111,155332,56890,0,-15353,0,0,0,,15353,-15353
33,08-11-18,85,21:00,21:15,,19.6,0,19.6,19.6,-1,-35773,104343,140116,68570,0,-39925,0,0,0,,39925,-39925
33,08-11-18,86,21:15,21:30,,39.38,0,39.38,39.38,-1,-59522,66563,126085,7041,0,-22580,0,0,0,,22580,-22580
33,08-11-18,87,21:30,21:45,48.26,39.38,0,48.26,48.26,1,-64162,44508,108670,-19654,0,-522,6433,0,0,,6955,5911
33,08-11-18,88,21:45,22:00,43.98,,0,43.98,43.98,1,-58627,47517,106144,-11110,0,0,4425,0,0,,4425,4425
33,08-11-18,89,22:00,22:15,43.98,43.48,0,43.98,43.48,2,-37626,41043,78669,3417,0,-1112,480,0,0,,1592,-632
33,08-11-18,90,22:15,22:30,,40.03,0,40.03,40.03,-1,-44461,44074,88535,-387,0,-2628,0,0,0,,2628,-2628
33,08-11-18,91,22:30,22:45,,39.9,0,39.9,39.9,-1,-31679,56126,87805,24447,0,-7898,0,0,0,,7898,-7898
33,08-11-18,92,22:45,23:00,,32.42,0,32.42,32.42,-1,-31316,68310,99626,36994,0,-17779,0,0,0,,17779,-17779
33,08-11-18,93,23:00,23:15,52.42,45.43,0,52.42,43.63,2,-63189,29733,92922,-33456,0,-5527,5266,0,0,,10793,-261
33,08-11-18,94,23:15,23:30,,,0,43.62,43.62,0,-41275,36661,77936,-4614,0,0,179,0,0,,179,179
33,08-11-18,95,23:30,23:45,,39.98,0,39.98,39.98,-1,-41248,51984,93232,10736,0,-1034,0,0,0,,1034,-1034
33,08-11-18,96,23:45,0:00,,17.46,0,17.46,17.46,-1,-22296,71480,93776,49184,0,-30637,0,0,0,,30637,-30637
33,08-12-18,1,0:00,0:15,,8.21,0,8.21,8.21,-1,-54157,102741,156898,48584,0,-30049,0,0,0,,30049,-30049
33,08-12-18,2,0:15,0:30,43.29,38.95,0,43.29,38.95,2,-42316,55397,97713,13081,0,-1122,240,0,0,,1362,-882
33,08-12-18,3,0:30,0:45,,37.78,0,37.78,37.78,-1,-40453,65834,106287,25381,0,-9883,0,0,0,,9883,-9883
33,08-12-18,4,0:45,1:00,,39.38,0,39.38,39.38,-1,-52159,70824,122983,18665,0,-17837,0,0,0,,17837,-17837
33,08-12-18,5,1:00,1:15,,32.38,0,32.38,32.38,-1,-17159,59334,76493,42175,0,-18944,0,0,0,,18944,-18944
33,08-12-18,6,1:15,1:30,,28.89,0,28.89,28.89,-1,-22859,70402,93261,47543,0,-12903,0,0,0,,12903,-12903
33,08-12-18,7,1:30,1:45,,28.76,0,28.76,28.76,-1,-27713,72591,100304,44878,0,-34779,0,0,0,,34779,-34779
33,08-12-18,8,1:45,2:00,,35.29,0,35.29,35.29,-1,-57586,91099,148685,33513,0,-35382,0,0,0,,35382,-35382
33,08-12-18,9,2:00,2:15,47.54,34.07,0,47.54,47.54,1,-34230,36342,70572,2112,0,-19100,1181,0,0,,20281,-17919
33,08-12-18,10,2:15,2:30,47.54,39.29,0,39.29,39.29,-1,-26995,41355,68350,14360,0,-741,1764,0,0,,2505,1023
33,08-12-18,11,2:30,2:45,,37.78,0,37.78,37.78,-1,-21258,42622,63880,21364,0,-3853,0,0,0,,3853,-3853
33,08-12-18,12,2:45,3:00,,35.29,0,35.29,35.29,-1,-21747,49199,70946,27452,0,-14713,0,0,0,,14713,-14713
33,08-12-18,13,3:00,3:15,50.39,36.78,0,50.39,50.39,1,-28723,23571,52294,-5152,0,-11824,1851,0,0,,13675,-9973
33,08-12-18,14,3:15,3:30,132.12,36.78,0,132.12,132.12,1,-82347,29514,111861,-52833,0,-105,37460,0,0,,37565,37355
33,08-12-18,15,3:30,3:45,45.54,39.29,0,39.29,39.29,-1,-56289,54835,111124,-1454,0,-115,12795,0,0,,12910,12680
33,08-12-18,16,3:45,4:00,45.54,36.78,0,36.78,36.78,-1,-53303,55447,108750,2144,0,-4316,102,0,0,,4418,-4214
33,08-12-18,17,4:00,4:15,47.54,36.78,0,47.54,47.54,1,-73191,55898,129089,-17293,0,-299,6836,0,0,,7135,6537
33,08-12-18,18,4:15,4:30,44.58,39.29,0,39.29,39.29,-1,-68349,66932,135281,-1417,0,-44,7974,0,0,,8018,7930
33,08-12-18,19,4:30,4:45,44.58,37.26,0,37.26,37.26,-1,-64523,69907,134430,5384,0,-2628,1,0,0,,2629,-2627
33,08-12-18,20,4:45,5:00,,39.29,0,39.29,39.29,-1,-69757,64578,134335,-5179,0,-131,0,0,0,,131,-131
33,08-12-18,21,5:00,5:15,,35.78,0,35.78,35.78,-1,-54425,67375,121800,12950,0,-4425,0,0,0,,4425,-4425
33,08-12-18,22,5:15,5:30,,35.29,0,35.29,35.29,-1,-53312,66759,120071,13447,0,-6892,0,0,0,,6892,-6892
33,08-12-18,23,5:30,5:45,,37.3,0,37.3,37.3,-1,-60475,70403,130878,9928,0,-6829,0,0,0,,6829,-6829
33,08-12-18,24,5:45,6:00,,39.29,0,39.29,39.29,-1,-69975,76409,146384,6434,0,-3144,0,0,0,,3144,-3144
33,08-12-18,25,6:00,6:15,43.38,,0,43.38,43.38,1,-80243,48048,128291,-32195,0,0,72,0,0,,72,72
33,08-12-18,26,6:15,6:30,,,0,39.37,39.37,0,-47394,51286,98680,3892,0,0,0,0,0,,0,0
33,08-12-18,27,6:30,6:45,,35.78,0,35.78,35.78,-1,-41933,53721,95654,11788,0,-4555,0,0,0,,4555,-4555
33,08-12-18,28,6:45,7:00,,32.23,0,32.23,32.23,-1,-29739,70732,100471,40993,0,-27673,0,0,0,,27673,-27673
33,08-12-18,29,7:00,7:15,,35.38,0,35.38,35.38,-1,-15186,59678,74864,44492,0,-30041,0,0,0,,30041,-30041
33,08-12-18,30,7:15,7:30,,,0,42.65,42.65,0,-23649,44244,67893,20595,0,-4865,0,0,0,,4865,-4865
33,08-12-18,31,7:30,7:45,,,0,42.64,42.64,0,-24805,56716,81521,31911,0,0,0,0,0,,0,0
33,08-12-18,32,7:45,8:00,,,0,42.63,42.63,0,-30107,63535,93642,33428,0,0,0,0,0,,0,0
33,08-12-18,33,8:00,8:15,46,,0,46,46,1,-74475,51850,126325,-22625,0,0,1261,0,0,,1261,1261
33,08-12-18,34,8:15,8:30,52.23,,0,52.23,52.23,1,-73288,50209,123497,-23079,0,0,13497,0,0,,13497,13497
33,08-12-18,35,8:30,8:45,47.38,,0,47.38,47.38,1,-78053,49282,127335,-28771,0,0,14383,0,0,,14383,14383
33,08-12-18,36,8:45,9:00,47.63,,0,47.63,47.63,1,-80072,50114,130186,-29958,0,0,22925,0,0,,22925,22925
33,08-12-18,37,9:00,9:15,39.81,37.22,0,39.81,37.22,2,-40304,66180,106484,25876,0,-306,7588,0,0,,7894,7282
33,08-12-18,38,9:15,9:30,,,0,39.49,39.49,0,-35787,47182,82969,11395,0,0,0,0,0,,0,0
33,08-12-18,39,9:30,9:45,46.86,,0,46.86,46.86,1,-41772,32417,74189,-9355,0,0,4864,0,0,,4864,4864
33,08-12-18,40,9:45,10:00,39.58,,0,39.58,39.58,1,-36038,57753,93791,21715,0,0,504,0,0,,504,504
33,08-12-18,41,10:00,10:15,52.23,,0,52.23,52.23,1,-61327,37580,98907,-23747,0,0,9792,0,0,,9792,9792
33,08-12-18,42,10:15,10:30,43.38,39.38,0,39.38,39.38,-1,-43836,52646,96482,8810,0,-70,6015,0,0,,6085,5945
33,08-12-18,43,10:30,10:45,,38.66,0,38.66,38.66,-1,-47380,48394,95774,1014,0,-1264,0,0,0,,1264,-1264
33,08-12-18,44,10:45,11:00,,36.66,0,36.66,36.66,-1,-41999,47348,89347,5349,0,-2659,0,0,0,,2659,-2659
33,08-12-18,45,11:00,11:15,,32.23,0,32.23,32.23,-1,-43926,62435,106361,18509,0,-8488,0,0,0,,8488,-8488
33,08-12-18,46,11:15,11:30,,32.23,0,32.23,32.23,-1,-47795,67188,114983,19393,0,-22006,0,0,0,,22006,-22006
33,08-12-18,47,11:30,11:45,,-36.11,0,-36.11,-36.11,-1,-48965,114043,163008,65078,0,-43100,0,0,0,,43100,-43100
33,08-12-18,48,11:45,12:00,,-36.11,0,-36.11,-36.11,-1,-47940,125745,173685,77805,0,-58558,0,0,0,,58558,-58558
33,08-12-18,49,12:00,12:15,,-19.78,0,-19.78,-19.78,-1,-60422,111116,171538,50694,0,-60208,0,0,0,,60208,-60208
33,08-12-18,50,12:15,12:30,,-4.78,0,-4.78,-4.78,-1,-38171,118293,156464,80122,0,-64935,0,0,0,,64935,-64935
33,08-12-18,51,12:30,12:45,,17.55,0,17.55,17.55,-1,-44857,115352,160209,70495,0,-53127,0,0,0,,53127,-53127
33,08-12-18,52,12:45,13:00,,-32.45,0,-32.45,-32.45,-1,-48733,120665,169398,71932,0,-56033,0,0,0,,56033,-56033
33,08-12-18,53,13:00,13:15,,34.7,0,34.7,34.7,-1,-61781,113820,175601,52039,0,-29385,0,0,0,,29385,-29385
33,08-12-18,54,13:15,13:30,,-65.98,0,-65.98,-65.98,-1,-52757,121803,174560,69046,0,-25881,0,0,0,,25881,-25881
33,08-12-18,55,13:30,13:45,,-150.78,0,-150.78,-150.78,-1,-66214,102759,168973,36545,0,-45460,0,0,0,,45460,-45460
33,08-12-18,56,13:45,14:00,,-63.3,0,-63.3,-63.3,-1,-60771,114045,174816,53274,0,-41780,0,0,0,,41780,-41780
33,08-12-18,57,14:00,14:15,,35.78,0,35.78,35.78,-1,-50862,89579,140441,38717,0,-14686,0,0,0,,14686,-14686
33,08-12-18,58,14:15,14:30,,,0,41.36,41.36,0,-48688,92058,140746,43370,0,-64,0,0,0,,64,-64
33,08-12-18,59,14:30,14:45,,,0,41.36,41.36,0,-42767,114362,157129,71595,0,0,0,0,0,,0,0
33,08-12-18,60,14:45,15:00,,,0,41.35,41.35,0,-46676,115919,162595,69243,0,0,0,0,0,,0,0
33,08-12-18,61,15:00,15:15,,,0,41.32,41.32,0,-86778,131635,218413,44857,0,0,0,0,0,,0,0
33,08-12-18,62,15:15,15:30,,,0,41.32,41.32,0,-55765,114866,170631,59101,0,0,0,0,0,,0,0
33,08-12-18,63,15:30,15:45,,,0,41.31,41.31,0,-50299,109992,160291,59693,0,0,0,0,0,,0,0
33,08-12-18,64,15:45,16:00,,,0,41.3,41.3,0,-66205,99230,165435,33025,0,0,0,0,0,,0,0
33,08-12-18,65,16:00,16:15,52.23,,0,52.23,52.23,1,-111188,86850,198038,-24338,0,0,7336,0,0,,7336,7336
33,08-12-18,66,16:15,16:30,,,0,41.67,41.67,0,-62393,89025,151418,26632,0,0,1053,0,0,,1053,1053
33,08-12-18,67,16:30,16:45,48.47,,0,48.47,48.47,1,-54656,48750,103406,-5906,0,0,2220,0,0,,2220,2220
33,08-12-18,68,16:45,17:00,161.12,,0,161.12,161.12,1,-101634,18162,119796,-83472,0,0,49222,0,0,,49222,49222
33,08-12-18,69,17:00,17:15,43.38,32.23,0,43.38,32.23,2,-23736,150260,173996,126524,0,-2328,15810,0,0,,18138,13482
33,08-12-18,70,17:15,17:30,,39.38,0,39.38,39.38,-1,-24277,88783,113060,64506,0,-1582,0,0,0,,1582,-1582
33,08-12-18,71,17:30,17:45,109.04,,0,109.04,109.04,1,-73359,27364,100723,-45995,0,0,10613,0,0,,10613,10613
33,08-12-18,72,17:45,18:00,160.12,,0,160.12,160.12,1,-88870,12672,101542,-76198,0,0,68040,0,0,,68040,68040
33,08-12-18,73,18:00,18:15,161.12,,0,161.12,161.12,1,-123187,30357,153544,-92830,0,0,58275,0,0,,58275,58275
33,08-12-18,74,18:15,18:30,57.57,,0,57.57,57.57,1,-74000,24595,98595,-49405,0,0,19504,0,0,,19504,19504
33,08-12-18,75,18:30,18:45,67.55,,0,67.55,67.55,1,-81485,28070,109555,-53415,0,0,42527,0,0,,42527,42527
33,08-12-18,76,18:45,19:00,67.55,,0,67.55,67.55,1,-81653,26234,107887,-55419,0,0,46888,0,0,,46888,46888
33,08-12-18,77,19:00,19:15,47.13,36.62,0,36.62,36.62,-1,-46812,71001,117813,24189,0,-2182,14167,0,0,,16349,11985
33,08-12-18,78,19:15,19:30,,44.85,0,44.85,44.85,-1,-47885,57369,105254,9484,0,-2899,0,0,0,,2899,-2899
33,08-12-18,79,19:30,19:45,45.93,46.22,0,45.93,43.73,2,-46868,36573,83441,-10295,0,-1317,628,0,0,,1945,-689
33,08-12-18,80,19:45,20:00,67.55,,0,67.55,67.55,1,-88205,46658,134863,-41547,0,0,26869,0,0,,26869,26869
33,08-12-18,81,20:00,20:15,48.35,41.39,0,48.35,41.39,2,-28630,41776,70406,13146,0,-665,12077,0,0,,12742,11412
33,08-12-18,82,20:15,20:30,,,0,43.73,43.73,0,-77309,52981,130290,-24328,0,0,0,0,0,,0,0
33,08-12-18,83,20:30,20:45,43.93,,0,43.93,43.93,1,-71739,52446,124185,-19293,0,0,362,0,0,,362,362
33,08-12-18,84,20:45,21:00,43.93,,0,43.93,43.93,1,-74643,50511,125154,-24132,0,0,1070,0,0,,1070,1070
33,08-12-18,85,21:00,21:15,,,0,43.73,43.73,0,-41885,92202,134087,50317,0,0,161,0,0,,161,161
33,08-12-18,86,21:15,21:30,48.35,,0,48.35,48.35,1,-56943,56715,113658,-228,0,0,1111,0,0,,1111,1111
33,08-12-18,87,21:30,21:45,52.5,,0,52.5,52.5,1,-80523,50209,130732,-30314,0,0,16258,0,0,,16258,16258
33,08-12-18,88,21:45,22:00,52.5,,0,52.5,52.5,1,-77356,41305,118661,-36051,0,0,24228,0,0,,24228,24228
33,08-12-18,89,22:00,22:15,90.12,,0,90.12,90.12,1,-108333,22576,130909,-85757,0,0,18828,0,0,,18828,18828
33,08-12-18,90,22:15,22:30,52.5,,0,52.5,52.5,1,-95094,19065,114159,-76029,0,0,26450,0,0,,26450,26450
33,08-12-18,91,22:30,22:45,48.35,,0,48.35,48.35,1,-73518,19234,92752,-54284,0,0,14316,0,0,,14316,14316
33,08-12-18,92,22:45,23:00,46.32,,0,46.32,46.32,1,-52695,38095,90790,-14600,0,0,10810,0,0,,10810,10810
33,08-12-18,93,23:00,23:15,166.12,,0,166.12,166.12,1,-74892,8233,83125,-66659,0,0,20512,0,0,,20512,20512
33,08-12-18,94,23:15,23:30,64.12,,0,64.12,64.12,1,-70973,17227,88200,-53746,0,0,31700,0,0,,31700,31700
33,08-12-18,95,23:30,23:45,48.35,,0,48.35,48.35,1,-68194,31699,99893,-36495,0,0,2958,0,0,,2958,2958
33,08-12-18,96,23:45,0:00,43.93,43.53,0,43.53,43.53,-1,-54111,41676,95787,-12435,0,-2,1078,0,0,,1080,1076
33,08/13/2018,1,0:00,0:15,52.23,37.91,0,52.23,37.91,2,-38366,35455,73821,-2911,0,-440,2977,0,0,,3417,2537
33,08/13/2018,2,0:15,0:30,57.02,,0,57.02,57.02,1,-61863,27259,89122,-34604,0,0,19348,0,0,,19348,19348
33,08/13/2018,3,0:30,0:45,,,0,42.07,42.07,0,-66560,36541,103101,-30019,0,0,5010,0,0,,5010,5010
33,08/13/2018,4,0:45,1:00,,,0,43.25,43.25,0,-65867,49739,115606,-16128,0,0,0,0,0,,0,0
33,08/13/2018,5,1:00,1:15,67.55,,0,67.55,67.55,1,-74458,22414,96872,-52044,0,0,8790,0,0,,8790,8790
33,08/13/2018,6,1:15,1:30,52.23,,0,52.23,52.23,1,-64886,25360,90246,-39526,0,0,27079,0,0,,27079,27079
33,08/13/2018,7,1:30,1:45,47.16,,0,47.16,47.16,1,-45022,35559,80581,-9463,0,0,16348,0,0,,16348,16348
33,08/13/2018,8,1:45,2:00,47.16,42.12,0,42.12,42.12,-1,-41294,39470,80764,-1824,0,-165,650,0,0,,815,485
33,08/13/2018,9,2:00,2:15,46.02,,0,46.02,46.02,1,-46584,35116,81700,-11468,0,0,1880,0,0,,1880,1880
33,08/13/2018,10,2:15,2:30,46.02,,0,46.02,46.02,1,-51110,32958,84068,-18152,0,0,6568,0,0,,6568,6568
33,08/13/2018,11,2:30,2:45,46.11,,0,46.11,46.11,1,-65842,31882,97724,-33960,0,0,6295,0,0,,6295,6295
33,08/13/2018,12,2:45,3:00,47.38,,0,47.38,47.38,1,-91722,35630,127352,-56092,0,0,4307,0,0,,4307,4307
33,08/13/2018,13,3:00,3:15,52.23,,0,52.23,52.23,1,-80813,37830,118643,-42983,0,0,5525,0,0,,5525,5525
33,08/13/2018,14,3:15,3:30,53.03,,0,53.03,53.03,1,-72927,28389,101316,-44538,0,0,25644,0,0,,25644,25644
33,08/13/2018,15,3:30,3:45,47.38,,0,47.38,47.38,1,-86882,36089,122971,-50793,0,0,18398,0,0,,18398,18398
33,08/13/2018,16,3:45,4:00,,,0,41.16,41.16,0,-85643,42330,127973,-43313,0,0,356,0,0,,356,356
33,08/13/2018,17,4:00,4:15,,,0,41.14,41.14,0,-76500,43409,119909,-33091,0,0,0,0,0,,0,0
33,08/13/2018,18,4:15,4:30,43.93,,0,43.93,43.93,1,-127141,38342,165483,-88799,0,0,593,0,0,,593,593
33,08/13/2018,19,4:30,4:45,43.89,,0,43.89,43.89,1,-123692,33781,157473,-89911,0,0,1037,0,0,,1037,1037
33,08/13/2018,20,4:45,5:00,48.27,,0,48.27,48.27,1,-77250,56273,133523,-20977,0,0,4950,0,0,,4950,4950
33,08/13/2018,21,5:00,5:15,44.02,,0,44.02,44.02,1,-92668,57432,150100,-35236,0,0,1577,0,0,,1577,1577
33,08/13/2018,22,5:15,5:30,,,0,43.12,43.12,0,-91820,54906,146726,-36914,0,0,0,0,0,,0,0
33,08/13/2018,23,5:30,5:45,43.38,,0,43.38,43.38,1,-78492,49750,128242,-28742,0,0,337,0,0,,337,337
33,08/13/2018,24,5:45,6:00,43.68,,0,43.68,43.68,1,-64598,75858,140456,11260,0,0,2028,0,0,,2028,2028
33,08/13/2018,25,6:00,6:15,153.02,,0,153.02,153.02,1,-187970,48050,236020,-139920,0,0,19933,0,0,,19933,19933
33,08/13/2018,26,6:15,6:30,153.02,,0,153.02,153.02,1,-146079,32387,178466,-113692,0,0,43064,0,0,,43064,43064
33,08/13/2018,27,6:30,6:45,67.71,,0,67.71,67.71,1,-93802,22636,116438,-71166,0,0,22518,0,0,,22518,22518
33,08/13/2018,28,6:45,7:00,43.54,,0,43.54,43.54,1,-93303,22855,116158,-70448,0,0,495,0,0,,495,495
33,08/13/2018,29,7:00,7:15,43.97,,0,43.97,43.97,1,-95410,52105,147515,-43305,0,0,393,0,0,,393,393
33,08/13/2018,30,7:15,7:30,,,0,45.14,45.14,0,-80165,30821,110986,-49344,0,0,58,0,0,,58,58
33,08/13/2018,31,7:30,7:45,67.71,,0,67.71,67.71,1,-111848,18031,129879,-93817,0,0,2286,0,0,,2286,2286
33,08/13/2018,32,7:45,8:00,152.02,,0,152.02,152.02,1,-120516,10433,130949,-110083,0,0,48452,0,0,,48452,48452
33,08/13/2018,33,8:00,8:15,152.02,32.58,0,32.58,32.58,-1,-56006,94446,150452,38440,0,-3749,12279,0,0,,16028,8530
33,08/13/2018,34,8:15,8:30,44.22,46.05,0,44.22,44.22,1,-74438,62600,137038,-11838,0,-1074,42,0,0,,1116,-1032
33,08/13/2018,35,8:30,8:45,48.22,,0,48.22,48.22,1,-104921,46954,151875,-57967,0,0,7212,0,0,,7212,7212
33,08/13/2018,36,8:45,9:00,152.02,,0,152.02,152.02,1,-129068,49837,178905,-79231,0,0,27228,0,0,,27228,27228
33,08/13/2018,37,9:00,9:15,45.61,,0,45.61,45.61,1,-94540,53280,147820,-41260,0,0,9560,0,0,,9560,9560
33,08/13/2018,38,9:15,9:30,52.26,,0,52.26,52.26,1,-98489,47321,145810,-51168,0,0,15255,0,0,,15255,15255
33,08/13/2018,39,9:30,9:45,45.03,,0,45.03,45.03,1,-89375,50948,140323,-38427,0,0,15768,0,0,,15768,15768
33,08/13/2018,40,9:45,10:00,52.26,,0,52.26,52.26,1,-98654,43576,142230,-55078,0,0,17653,0,0,,17653,17653
33,08/13/2018,41,10:00,10:15,45.47,,0,45.47,45.47,1,-132206,51454,183660,-80752,0,0,10529,0,0,,10529,10529
33,08/13/2018,42,10:15,10:30,48.22,,0,48.22,48.22,1,-139912,61197,201109,-78715,0,0,3530,0,0,,3530,3530
33,08/13/2018,43,10:30,10:45,152.02,,0,152.02,152.02,1,-147662,45833,193495,-101829,0,0,31997,0,0,,31997,31997
33,08/13/2018,44,10:45,11:00,52.26,,0,52.26,52.26,1,-145866,53623,199489,-92243,0,0,40101,0,0,,40101,40101
33,08/13/2018,45,11:00,11:15,47.02,,0,47.02,47.02,1,-147011,35612,182623,-111399,0,0,18185,0,0,,18185,18185
33,08/13/2018,46,11:15,11:30,44.24,,0,44.24,44.24,1,-146053,50119,196172,-95934,0,0,7347,0,0,,7347,7347
33,08/13/2018,47,11:30,11:45,48.22,,0,48.22,48.22,1,-146906,49202,196108,-97704,0,0,6578,0,0,,6578,6578
33,08/13/2018,48,11:45,12:00,44.22,,0,44.22,44.22,1,-138027,50476,188503,-87551,0,0,2132,0,0,,2132,2132
33,08/13/2018,49,12:00,12:15,44.75,,0,44.75,44.75,1,-137782,43916,181698,-93866,0,0,3513,0,0,,3513,3513
33,08/13/2018,50,12:15,12:30,44.22,,0,44.22,44.22,1,-130987,47556,178543,-83431,0,0,3012,0,0,,3012,3012
33,08/13/2018,51,12:30,12:45,44.04,,0,44.04,44.04,1,-118450,53865,172315,-64585,0,0,800,0,0,,800,800
33,08/13/2018,52,12:45,13:00,44.04,,0,44.04,44.04,1,-115087,66801,181888,-48286,0,0,403,0,0,,403,403
33,08/13/2018,53,13:00,13:15,152.02,,0,152.02,152.02,1,-137669,53285,190954,-84384,0,0,27334,0,0,,27334,27334
33,08/13/2018,54,13:15,13:30,67.71,,0,67.71,67.71,1,-130591,60783,191374,-69808,0,0,27456,0,0,,27456,27456
33,08/13/2018,55,13:30,13:45,,,0,45.1,45.1,0,-136517,59670,196187,-76847,0,0,42,0,0,,42,42
33,08/13/2018,56,13:45,14:00,156.02,,0,156.02,156.02,1,-161441,25000,186441,-136441,0,0,13729,0,0,,13729,13729
33,08/13/2018,57,14:00,14:15,152.02,,0,152.02,152.02,1,-190720,20413,211133,-170307,0,0,74250,0,0,,74250,74250
33,08/13/2018,58,14:15,14:30,156.02,,0,258.05,258.05,1,-152403,28287,180690,-124116,0,0,81413,0,18334,,99747,99747
33,08/13/2018,59,14:30,14:45,45.02,,0,45.02,45.02,1,-119591,29323,148914,-90268,0,0,12509,0,9167,,21676,21676
33,08/13/2018,60,14:45,15:00,52.26,,0,52.26,52.26,1,-145788,26504,172292,-119284,0,0,17468,0,0,,17468,17468
33,08/13/2018,61,15:00,15:15,156.02,,0,156.02,156.02,1,-112354,31987,144341,-80367,0,0,42967,0,0,,42967,42967
33,08/13/2018,62,15:15,15:30,156.02,,0,156.02,156.02,1,-113767,26683,140450,-87084,0,0,66130,0,0,,66130,66130
33,08/13/2018,63,15:30,15:45,156.02,,0,156.02,156.02,1,-129617,30531,160148,-99086,0,0,76299,0,0,,76299,76299
33,08/13/2018,64,15:45,16:00,147.02,,0,147.02,147.02,1,-126102,34396,160498,-91706,0,0,69705,0,0,,69705,69705
33,08/13/2018,65,16:00,16:15,44.68,39.02,0,45.02,39.02,2,-62617,52634,115251,-9983,0,-672,10254,0,0,,10926,9582
33,08/13/2018,66,16:15,16:30,67.71,,0,67.71,67.71,1,-88680,46669,135349,-42011,0,0,12152,0,0,,12152,12152
33,08/13/2018,67,16:30,16:45,49.47,,0,49.47,49.47,1,-79822,53333,133155,-26489,0,0,20581,0,0,,20581,20581
33,08/13/2018,68,16:45,17:00,49.47,41.1,0,49.47,41.1,2,-77221,49850,127071,-27371,0,-52,19871,0,0,,19923,19819
33,08/13/2018,69,17:00,17:15,49.47,23.14,0,23.14,23.14,-1,-48021,113170,161191,65149,0,-14416,1989,0,0,,16405,-12427
33,08/13/2018,70,17:15,17:30,,40.22,0,40.22,40.22,-1,-61269,89781,151050,28512,0,-9719,0,0,0,,9719,-9719
33,08/13/2018,71,17:30,17:45,,,0,45.1,45.1,0,-71835,92108,163943,20273,0,-600,0,0,0,,600,-600
33,08/13/2018,72,17:45,18:00,53.22,,0,53.22,53.22,1,-91685,101915,193600,10230,0,0,1291,0,0,,1291,1291
33,08/13/2018,73,18:00,18:15,152.02,,0,152.02,152.02,1,-150859,43623,194482,-107236,0,0,38552,0,0,,38552,38552
33,08/13/2018,74,18:15,18:30,53.22,,0,53.22,53.22,1,-116494,77897,194391,-38597,0,0,22430,0,0,,22430,22430
33,08/13/2018,75,18:30,18:45,49.22,,0,49.22,49.22,1,-107133,85019,192152,-22114,0,0,11106,0,0,,11106,11106
33,08/13/2018,76,18:45,19:00,46.79,,0,46.79,46.79,1,-97763,91484,189247,-6279,0,0,11204,0,0,,11204,11204
33,08/13/2018,77,19:00,19:15,,,0,45.17,45.17,0,-75979,79592,155571,3613,0,0,1335,0,0,,1335,1335
33,08/13/2018,78,19:15,19:30,,,0,45.17,45.17,0,-83355,102162,185517,18807,0,0,0,0,0,,0,0
33,08/13/2018,79,19:30,19:45,,,0,45.18,45.18,0,-85578,94678,180256,9100,0,0,0,0,0,,0,0
33,08/13/2018,80,19:45,20:00,44.05,,0,44.05,44.05,1,-87947,86241,174188,-1706,0,0,23,0,0,,23,23
33,08/13/2018,81,20:00,20:15,57.26,,0,57.26,57.26,1,-96639,71609,168248,-25030,0,0,9692,0,0,,9692,9692
33,08/13/2018,82,20:15,20:30,49.22,,0,49.22,49.22,1,-101264,81766,183030,-19498,0,0,16162,0,0,,16162,16162
33,08/13/2018,83,20:30,20:45,49.22,,0,49.22,49.22,1,-97636,91274,188910,-6362,0,0,12251,0,0,,12251,12251
33,08/13/2018,84,20:45,21:00,,,0,45.12,45.12,0,-101846,108441,210287,6595,0,0,2474,0,0,,2474,2474
33,08/13/2018,85,21:00,21:15,,,0,45.1,45.1,0,-71507,95682,167189,24175,0,0,0,0,0,,0,0
33,08/13/2018,86,21:15,21:30,,,0,45.11,45.11,0,-84171,91992,176163,7821,0,0,0,0,0,,0,0
33,08/13/2018,87,21:30,21:45,44.18,,0,44.18,44.18,1,-90019,80182,170201,-9837,0,0,345,0,0,,345,345
33,08/13/2018,88,21:45,22:00,43.89,,0,43.89,43.89,1,-79341,87478,166819,8137,0,0,510,0,0,,510,510
33,08/13/2018,89,22:00,22:15,43.62,,0,43.62,43.62,1,-104638,42227,146865,-62411,0,0,330,0,0,,330,330
33,08/13/2018,90,22:15,22:30,,,0,44.96,44.96,0,-96607,50738,147345,-45869,0,0,0,0,0,,0,0
33,08/13/2018,91,22:30,22:45,,,0,44.97,44.97,0,-75457,63915,139372,-11542,0,0,0,0,0,,0,0
33,08/13/2018,92,22:45,23:00,,40.22,0,40.22,40.22,-1,-69558,70319,139877,761,0,-284,0,0,0,,284,-284
33,08/13/2018,93,23:00,23:15,79.02,36.22,0,79.02,36.22,2,-56358,37967,94325,-18391,0,-2544,3724,0,0,,6268,1180
33,08/13/2018,94,23:15,23:30,131.02,,0,131.02,131.02,1,-65859,47792,113651,-18067,0,0,17143,0,0,,17143,17143
33,08/13/2018,95,23:30,23:45,,,0,44.72,44.72,0,-70739,73177,143916,2438,0,0,210,0,0,,210,210
33,08/13/2018,96,23:45,0:00,,40.22,0,40.22,40.22,-1,-72258,89649,161907,17391,0,-1566,0,0,0,,1566,-1566
33,08/14/2018,1,0:00,0:15,,31.65,0,31.65,31.65,-1,-24808,109403,134211,84595,0,-3469,0,0,0,,3469,-3469
33,08/14/2018,2,0:15,0:30,,32.78,0,32.78,32.78,-1,-12990,58020,71010,45030,0,-8109,0,0,0,,8109,-8109
33,08/14/2018,3,0:30,0:45,,17.71,0,17.71,17.71,-1,-22422,86971,109393,64549,0,-16730,0,0,0,,16730,-16730
33,08/14/2018,4,0:45,1:00,,-3.1,0,-3.1,-3.1,-1,-20029,114458,134487,94429,0,-65421,0,0,0,,65421,-65421
33,08/14/2018,5,1:00,1:15,47.54,32.79,0,47.54,47.54,1,-49875,48361,98236,-1514,0,-35610,116,0,0,,35726,-35494
33,08/14/2018,6,1:15,1:30,47.54,35.42,0,47.54,35.42,2,-41088,61240,102328,20152,0,-4208,198,0,0,,4406,-4010
33,08/14/2018,7,1:30,1:45,,31.65,0,31.65,31.65,-1,-29516,84694,114210,55178,0,-44087,0,0,0,,44087,-44087
33,08/14/2018,8,1:45,2:00,,28.23,0,28.23,28.23,-1,-29130,108444,137574,79314,0,-71789,0,0,0,,71789,-71789
33,08/14/2018,9,2:00,2:15,39.51,28.23,0,39.51,39.51,1,-65597,68044,133641,2447,0,-34044,48,0,0,,34092,-33996
33,08/14/2018,10,2:15,2:30,,41.05,0,41.05,41.05,-1,-55585,73251,128836,17666,0,-1376,0,0,0,,1376,-1376
33,08/14/2018,11,2:30,2:45,,39.54,0,39.54,39.54,-1,-51903,66557,118460,14654,0,-13335,0,0,0,,13335,-13335
33,08/14/2018,12,2:45,3:00,,,0,41.75,41.75,0,-59689,62002,121691,2313,0,-3467,0,0,0,,3467,-3467
33,08/14/2018,13,3:00,3:15,54.25,,0,54.25,54.25,1,-74324,43935,118259,-30389,0,0,8162,0,0,,8162,8162
33,08/14/2018,14,3:15,3:30,48.85,,0,48.85,48.85,1,-63459,48267,111726,-15192,0,0,15127,0,0,,15127,15127
33,08/14/2018,15,3:30,3:45,48.85,43.76,0,43.76,43.76,-1,-56807,71065,127872,14258,0,-1107,1867,0,0,,2974,760
33,08/14/2018,16,3:45,4:00,,40.96,0,40.96,40.96,-1,-53724,84308,138032,30584,0,-8807,0,0,0,,8807,-8807
33,08/14/2018,17,4:00,4:15,,43.89,0,43.89,43.89,-1,-60171,81818,141989,21647,0,-2547,0,0,0,,2547,-2547
33,08/14/2018,18,4:15,4:30,,,0,41.72,41.72,0,-55828,88788,144616,32960,0,0,0,0,0,,0,0
33,08/14/2018,19,4:30,4:45,,,0,41.72,41.72,0,-47029,81536,128565,34507,0,0,0,0,0,,0,0
33,08/14/2018,20,4:45,5:00,,,0,41.72,41.72,0,-47683,98189,145872,50506,0,0,0,0,0,,0,0
33,08/14/2018,21,5:00,5:15,,-93.11,0,-93.11,-93.11,-1,-41362,167419,208781,126057,0,-31509,0,0,0,,31509,-31509
33,08/14/2018,22,5:15,5:30,,-90.56,0,-90.56,-90.56,-1,-43791,182413,226204,138622,0,-84020,0,0,0,,84020,-84020
33,08/14/2018,23,5:30,5:45,,31.65,0,31.65,31.65,-1,-39932,159921,199853,119989,0,-44173,0,0,0,,44173,-44173
33,08/14/2018,24,5:45,6:00,,,0,41.79,41.79,0,-46632,105948,152580,59316,0,-3106,0,0,0,,3106,-3106
33,08/14/2018,25,6:00,6:15,,32.72,0,32.72,32.72,-1,-44746,160414,205160,115668,0,-7673,0,0,0,,7673,-7673
33,08/14/2018,26,6:15,6:30,,-122.08,0,-122.08,-122.08,-1,-56937,167756,224693,110819,0,-39454,0,0,0,,39454,-39454
33,08/14/2018,27,6:30,6:45,,32.72,0,32.72,32.72,-1,-50810,97689,148499,46879,0,-30440,0,0,0,,30440,-30440
33,08/14/2018,28,6:45,7:00,,36.61,0,36.61,36.61,-1,-51038,116526,167564,65488,0,-3477,0,0,0,,3477,-3477
33,08/14/2018,29,7:00,7:15,,5.71,0,5.71,5.71,-1,-80582,153869,234451,73287,0,-28602,0,0,0,,28602,-28602
33,08/14/2018,30,7:15,7:30,,43.78,0,43.78,43.78,-1,-84977,123895,208872,38918,0,-4753,0,0,0,,4753,-4753
33,08/14/2018,31,7:30,7:45,48.61,,0,48.61,48.61,1,-78869,76089,154958,-2780,0,0,997,0,0,,997,997
33,08/14/2018,32,7:45,8:00,48.61,,0,48.61,48.61,1,-71294,61067,132361,-10227,0,0,5606,0,0,,5606,5606
33,08/14/2018,33,8:00,8:15,48.61,37.1,0,37.1,37.1,-1,-73253,103402,176655,30149,0,-7448,421,0,0,,7869,-7027
33,08/14/2018,34,8:15,8:30,,36.61,0,36.61,36.61,-1,-60344,101790,162134,41446,0,-30699,0,0,0,,30699,-30699
33,08/14/2018,35,8:30,8:45,,32.72,0,32.72,32.72,-1,-65835,119904,185739,54069,0,-16243,0,0,0,,16243,-16243
33,08/14/2018,36,8:45,9:00,,30.1,0,30.1,30.1,-1,-63768,142159,205927,78391,0,-24336,0,0,0,,24336,-24336
33,08/14/2018,37,9:00,9:15,,18.81,0,18.81,18.81,-1,-79225,137818,217043,58593,0,-46623,0,0,0,,46623,-46623
33,08/14/2018,38,9:15,9:30,,32.72,0,32.72,32.72,-1,-76749,131340,208089,54591,0,-47151,0,0,0,,47151,-47151
33,08/14/2018,39,9:30,9:45,,32.72,0,32.72,32.72,-1,-72405,133765,206170,61360,0,-52931,0,0,0,,52931,-52931
33,08/14/2018,40,9:45,10:00,,35.82,0,35.82,35.82,-1,-73767,118080,191847,44313,0,-48550,0,0,0,,48550,-48550
33,08/14/2018,41,10:00,10:15,68.81,41.78,0,68.81,41.78,2,-99351,31603,130954,-67748,0,-15581,1918,0,0,,17499,-13663
33,08/14/2018,42,10:15,10:30,,,0,43.89,43.89,0,-93488,92417,185905,-1071,0,0,0,0,0,,0,0
33,08/14/2018,43,10:30,10:45,,39.86,0,39.86,39.86,-1,-68164,96159,164323,27995,0,-9753,0,0,0,,9753,-9753
33,08/14/2018,44,10:45,11:00,,36.61,0,36.61,36.61,-1,-65253,102573,167826,37320,0,-33485,0,0,0,,33485,-33485
33,08/14/2018,45,11:00,11:15,44.61,44.31,0,44.61,43.92,2,-98226,89190,187416,-9036,0,-9703,866,0,0,,10569,-8837
33,08/14/2018,46,11:15,11:30,,,0,43.92,43.92,0,-96959,77241,174200,-19718,0,0,2,0,0,,2,2
33,08/14/2018,47,11:30,11:45,,42.78,0,42.78,42.78,-1,-96290,121521,217811,25231,0,-1199,0,0,0,,1199,-1199
33,08/14/2018,48,11:45,12:00,,42.77,0,42.77,42.77,-1,-92882,119397,212279,26515,0,-3283,0,0,0,,3283,-3283
33,08/14/2018,49,12:00,12:15,155.12,42.77,0,155.12,155.12,1,-262732,109741,372473,-152991,0,-789,36069,0,0,,36858,35280
33,08/14/2018,50,12:15,12:30,57.1,,0,57.1,57.1,1,-241230,137214,378444,-104016,0,0,36074,0,0,,36074,36074
33,08/14/2018,51,12:30,12:45,155.12,,0,155.12,155.12,1,-228328,143990,372318,-84338,0,0,31313,0,0,,31313,31313
33,08/14/2018,52,12:45,13:00,52.7,,0,52.7,52.7,1,-216780,160298,377078,-56482,0,0,29157,0,0,,29157,29157
33,08/14/2018,53,13:00,13:15,52.7,,0,52.7,52.7,1,-195852,160674,356526,-35178,0,0,5216,0,0,,5216,5216
33,08/14/2018,54,13:15,13:30,118.81,,0,118.81,118.81,1,-206328,148810,355138,-57518,0,0,46481,0,0,,46481,46481
33,08/14/2018,55,13:30,13:45,47.12,,0,47.12,47.12,1,-208421,135586,344007,-72835,0,0,21740,0,0,,21740,21740
33,08/14/2018,56,13:45,14:00,47.12,46.85,0,46.85,46.85,-1,-210296,120716,331012,-89580,0,-19,13005,0,0,,13024,12986
33,08/14/2018,57,14:00,14:15,47.12,-116.26,0,-116.26,-116.26,-1,-14096,140112,154208,126016,0,-24696,632,0,0,,25328,-24064
33,08/14/2018,58,14:15,14:30,,11.51,0,11.51,11.51,-1,-39737,130962,170699,91225,0,-30334,0,0,0,,30334,-30334
33,08/14/2018,59,14:30,14:45,,32.72,0,32.72,32.72,-1,-51504,110514,162018,59010,0,-47792,0,0,0,,47792,-47792
33,08/14/2018,60,14:45,15:00,,36.61,0,36.61,36.61,-1,-46954,95848,142802,48894,0,-42130,0,0,0,,42130,-42130
33,08/14/2018,61,15:00,15:15,,40.61,0,40.61,40.61,-1,-46126,108433,154559,62307,0,-20936,0,0,0,,20936,-20936
33,08/14/2018,62,15:15,15:30,,39.26,0,39.26,39.26,-1,-54144,103766,157910,49622,0,-669,0,0,0,,669,-669
33,08/14/2018,63,15:30,15:45,,27.19,0,27.19,27.19,-1,-62553,92636,155189,30083,0,-20985,0,0,0,,20985,-20985
33,08/14/2018,64,15:45,16:00,44.61,27.19,0,44.61,44.61,1,-96575,94173,190748,-2402,0,-7606,786,0,0,,8392,-6820
33,08/14/2018,65,16:00,16:15,,34.43,0,34.43,34.43,-1,-60723,109264,169987,48541,0,-3582,0,0,0,,3582,-3582
33,08/14/2018,66,16:15,16:30,,43.88,0,43.88,43.88,-1,-72820,87358,160178,14538,0,-460,0,0,0,,460,-460
33,08/14/2018,67,16:30,16:45,,,0,41.84,41.84,0,-90085,85902,175987,-4183,0,0,0,0,0,,0,0
33,08/14/2018,68,16:45,17:00,,,0,41.83,41.83,0,-116263,87309,203572,-28954,0,0,0,0,0,,0,0
33,08/14/2018,69,17:00,17:15,118.81,,0,118.81,118.81,1,-82187,57905,140092,-24282,0,0,30993,0,0,,30993,30993
33,08/14/2018,70,17:15,17:30,68.81,,0,68.81,68.81,1,-82373,59620,141993,-22753,0,0,29012,0,0,,29012,29012
33,08/14/2018,71,17:30,17:45,118.81,,0,118.81,118.81,1,-86275,51690,137965,-34585,0,0,58717,0,0,,58717,58717
33,08/14/2018,72,17:45,18:00,68.81,,0,68.81,68.81,1,-94768,47825,142593,-46943,0,0,58913,0,0,,58913,58913
33,08/14/2018,73,18:00,18:15,48.12,43.67,0,48.12,43.67,2,-64122,79103,143225,14981,0,-181,17540,0,0,,17721,17359
33,08/14/2018,74,18:15,18:30,48.01,,0,48.01,48.01,1,-107674,79217,186891,-28457,0,0,544,0,0,,544,544
33,08/14/2018,75,18:30,18:45,48.12,,0,48.12,48.12,1,-139121,85761,224882,-53360,0,0,8348,0,0,,8348,8348
33,08/14/2018,76,18:45,19:00,68.81,,0,68.81,68.81,1,-151479,87474,238953,-64005,0,0,18980,0,0,,18980,18980
33,08/14/2018,77,19:00,19:15,118.81,,0,118.81,118.81,1,-120828,69222,190050,-51606,0,0,58345,0,0,,58345,58345
33,08/14/2018,78,19:15,19:30,68.81,,0,68.81,68.81,1,-80977,66544,147521,-14433,0,0,77976,0,0,,77976,77976
33,08/14/2018,79,19:30,19:45,58.09,,0,58.09,58.09,1,-90140,68022,158162,-22118,0,0,46296,0,0,,46296,46296
33,08/14/2018,80,19:45,20:00,118.81,,0,118.81,118.81,1,-105951,59515,165466,-46436,0,0,13821,0,0,,13821,13821
33,08/14/2018,81,20:00,20:15,48.61,,0,48.61,48.61,1,-91200,108381,199581,17181,0,0,13508,0,0,,13508,13508
33,08/14/2018,82,20:15,20:30,,,0,27.89,27.89,0,-110324,101224,211548,-9100,0,0,0,0,0,,0,0
33,08/14/2018,83,20:30,20:45,,,0,27.89,27.89,0,-123921,101650,225571,-22271,0,0,0,0,0,,0,0
33,08/14/2018,84,20:45,21:00,,,0,27.34,27.34,0,-130091,102763,232854,-27328,0,0,0,0,0,,0,0
33,08/14/2018,85,21:00,21:15,40.12,,0,40.12,40.12,1,-113296,91525,204821,-21771,0,0,945,0,0,,945,945
33,08/14/2018,86,21:15,21:30,118.81,,0,118.81,118.81,1,-129127,62943,192070,-66184,0,0,31566,0,0,,31566,31566
33,08/14/2018,87,21:30,21:45,49.12,,0,49.12,49.12,1,-119527,68212,187739,-51315,0,0,29642,0,0,,29642,29642
33,08/14/2018,88,21:45,22:00,48.61,,0,48.61,48.61,1,-119327,95811,215138,-23516,0,0,9881,0,0,,9881,9881
33,08/14/2018,89,22:00,22:15,68.81,,0,68.81,68.81,1,-119288,66669,185957,-52619,0,0,15710,0,0,,15710,15710
33,08/14/2018,90,22:15,22:30,48.12,42.53,0,42.53,42.53,-1,-87357,85343,172700,-2014,0,-251,9226,0,0,,9477,8975
33,08/14/2018,91,22:30,22:45,48.12,42.53,0,42.53,42.53,-1,-88801,119803,208604,31002,0,-2326,26,0,0,,2352,-2300
33,08/14/2018,92,22:45,23:00,,18.56,0,18.56,18.56,-1,-56261,138970,195231,82709,0,-19468,0,0,0,,19468,-19468
33,08/14/2018,93,23:00,23:15,49.69,40.61,0,49.69,40.61,2,-109783,87800,197583,-21983,0,-11384,3148,0,0,,14532,-8236
33,08/14/2018,94,23:15,23:30,44.61,40.61,0,40.61,40.61,-1,-96245,112386,208631,16141,0,-840,1136,0,0,,1976,296
33,08/14/2018,95,23:30,23:45,,37.1,0,37.1,37.1,-1,-71587,131006,202593,59419,0,-4942,0,0,0,,4942,-4942
33,08/14/2018,96,23:45,0:00,,32.72,0,32.72,32.72,-1,-64094,141644,205738,77550,0,-27393,0,0,0,,27393,-27393
33,08/15/2018,1,0:00,0:15,53.7,41.6,0,53.7,53.7,1,-86712,33767,120479,-52945,0,-10005,7345,0,0,,17350,-2660
33,08/15/2018,2,0:15,0:30,49.6,,0,49.6,49.6,1,-76965,57000,133965,-19965,0,0,14304,0,0,,14304,14304
33,08/15/2018,3,0:30,0:45,49.6,33.84,0,33.84,33.84,-1,-65254,96184,161438,30930,0,-5339,668,0,0,,6007,-4671
33,08/15/2018,4,0:45,1:00,,33.81,0,33.81,33.81,-1,-77515,114235,191750,36720,0,-31404,0,0,0,,31404,-31404
33,08/15/2018,5,1:00,1:15,125.02,38.03,0,125.02,125.02,1,-114182,74298,188480,-39884,0,-17052,7421,0,0,,24473,-9631
33,08/15/2018,6,1:15,1:30,148.02,38.03,0,148.02,148.02,1,-91033,75404,166437,-15629,0,-43,19010,0,0,,19053,18967
33,08/15/2018,7,1:30,1:45,51.06,,0,51.06,51.06,1,-76843,58128,134971,-18715,0,0,7559,0,0,,7559,7559
33,08/15/2018,8,1:45,2:00,44.75,44.39,0,44.93,44.39,2,-69424,81065,150489,11641,0,-463,2435,0,0,,2898,1972
33,08/15/2018,9,2:00,2:15,154.02,44.82,0,154.02,154.02,1,-108635,39943,148578,-68692,0,-152,20484,0,0,,20636,20332
33,08/15/2018,10,2:15,2:30,58.47,,0,58.47,58.47,1,-109360,54625,163985,-54735,0,0,40607,0,0,,40607,40607
33,08/15/2018,11,2:30,2:45,60.04,,0,60.04,60.04,1,-111032,62860,173892,-48172,0,0,29662,0,0,,29662,29662
33,08/15/2018,12,2:45,3:00,53.7,,0,53.7,53.7,1,-88563,64897,153460,-23666,0,0,21522,0,0,,21522,21522
33,08/15/2018,13,3:00,3:15,50.36,,0,50.36,50.36,1,-70121,58666,128787,-11455,0,0,2859,0,0,,2859,2859
33,08/15/2018,14,3:15,3:30,,,0,42.31,42.31,0,-44832,61898,106730,17066,0,0,114,0,0,,114,114
33,08/15/2018,15,3:30,3:45,39.7,,0,39.7,39.7,1,-52768,57468,110236,4700,0,0,51,0,0,,51,51
33,08/15/2018,16,3:45,4:00,39.7,,0,39.7,39.7,1,-51369,47213,98582,-4156,0,0,250,0,0,,250,250
33,08/15/2018,17,4:00,4:15,39.71,,0,39.71,39.71,1,-42659,52660,95319,10001,0,0,250,0,0,,250,250
33,08/15/2018,18,4:15,4:30,46.57,,0,46.57,46.57,1,-54785,43324,98109,-11461,0,0,1944,0,0,,1944,1944
33,08/15/2018,19,4:30,4:45,49.6,,0,49.6,49.6,1,-54790,38621,93411,-16169,0,0,3717,0,0,,3717,3717
33,08/15/2018,20,4:45,5:00,53.7,,0,53.7,53.7,1,-64948,37325,102273,-27623,0,0,24299,0,0,,24299,24299
33,08/15/2018,21,5:00,5:15,51.02,42.01,0,42.01,42.01,-1,-46596,54511,101107,7915,0,-461,14855,0,0,,15316,14394
33,08/15/2018,22,5:15,5:30,51.06,42.01,0,51.06,42.01,2,-49202,38793,87995,-10409,0,-1242,1904,0,0,,3146,662
33,08/15/2018,23,5:30,5:45,53.7,,0,53.7,53.7,1,-57708,19607,77315,-38101,0,0,22436,0,0,,22436,22436
33,08/15/2018,24,5:45,6:00,68.81,,0,68.81,68.81,1,-82270,12863,95133,-69407,0,0,37056,0,0,,37056,37056
33,08/15/2018,25,6:00,6:15,49.86,44.49,0,44.49,44.49,-1,-74251,94437,168688,20186,0,-216,16555,0,0,,16771,16339
33,08/15/2018,26,6:15,6:30,,,0,43.62,43.62,0,-86926,60283,147209,-26643,0,0,0,0,0,,0,0
33,08/15/2018,27,6:30,6:45,69.74,,0,69.74,69.74,1,-92766,40990,133756,-51776,0,0,7727,0,0,,7727,7727
33,08/15/2018,28,6:45,7:00,69.74,,0,69.74,69.74,1,-100995,49746,150741,-51249,0,0,25484,0,0,,25484,25484
33,08/15/2018,29,7:00,7:15,45.66,38.53,0,38.53,38.53,-1,-62971,97933,160904,34962,0,-3904,8784,0,0,,12688,4880
33,08/15/2018,30,7:15,7:30,50.53,44.13,0,50.53,50.53,1,-73409,61345,134754,-12064,0,-4291,1156,0,0,,5447,-3135
33,08/15/2018,31,7:30,7:45,73.02,,0,73.02,73.02,1,-87907,38516,126423,-49391,0,0,32055,0,0,,32055,32055
33,08/15/2018,32,7:45,8:00,69.02,,0,69.02,69.02,1,-93677,47968,141645,-45709,0,0,49316,0,0,,49316,49316
33,08/15/2018,33,8:00,8:15,50.53,44.9,0,50.53,44.9,2,-87033,83631,170664,-3402,0,-340,12533,0,0,,12873,12193
33,08/15/2018,34,8:15,8:30,76.02,,0,76.02,76.02,1,-87385,46072,133457,-41313,0,0,26434,0,0,,26434,26434
33,08/15/2018,35,8:30,8:45,71.02,,0,71.02,71.02,1,-99851,21796,121647,-78055,0,0,51332,0,0,,51332,51332
33,08/15/2018,36,8:45,9:00,87.02,,0,87.02,87.02,1,-109626,13984,123610,-95642,0,0,53562,0,0,,53562,53562
33,08/15/2018,37,9:00,9:15,56.15,,0,56.15,56.15,1,-73442,31314,104756,-42128,0,0,40778,0,0,,40778,40778
33,08/15/2018,38,9:15,9:30,69.74,,0,69.74,69.74,1,-77157,24945,102102,-52212,0,0,37412,0,0,,37412,37412
33,08/15/2018,39,9:30,9:45,89.02,,0,89.02,89.02,1,-71656,19852,91508,-51804,0,0,52416,0,0,,52416,52416
33,08/15/2018,40,9:45,10:00,53.95,,0,53.95,53.95,1,-63579,31041,94620,-32538,0,0,31435,0,0,,31435,31435
33,08/15/2018,41,10:00,10:15,45.66,42.84,0,45.66,42.84,2,-65611,91730,157341,26119,0,-1134,7975,0,0,,9109,6841
33,08/15/2018,42,10:15,10:30,,,0,45.62,45.62,0,-66424,76854,143278,10430,0,0,0,0,0,,0,0
33,08/15/2018,43,10:30,10:45,,,0,45.62,45.62,0,-71193,85325,156518,14132,0,0,0,0,0,,0,0
33,08/15/2018,44,10:45,11:00,,,0,45.62,45.62,0,-70018,82847,152865,12829,0,0,0,0,0,,0,0
33,08/15/2018,45,11:00,11:15,50.25,,0,50.25,50.25,1,-53934,30054,83988,-23880,0,0,2678,0,0,,2678,2678
33,08/15/2018,46,11:15,11:30,49.51,,0,49.51,49.51,1,-54852,36643,91495,-18209,0,0,1974,0,0,,1974,1974
33,08/15/2018,47,11:30,11:45,49.57,,0,49.57,49.57,1,-53292,44188,97480,-9104,0,0,4306,0,0,,4306,4306
33,08/15/2018,48,11:45,12:00,49.64,,0,49.64,49.64,1,-51215,43326,94541,-7889,0,0,2606,0,0,,2606,2606
33,08/15/2018,49,12:00,12:15,159.02,,0,159.02,159.02,1,-87763,25974,113737,-61789,0,0,28637,0,0,,28637,28637
33,08/15/2018,50,12:15,12:30,56.02,,0,56.02,56.02,1,-73025,50642,123667,-22383,0,0,32274,0,0,,32274,32274
33,08/15/2018,51,12:30,12:45,49.06,,0,49.06,49.06,1,-62308,56631,118939,-5677,0,0,9939,0,0,,9939,9939
33,08/15/2018,52,12:45,13:00,51.06,,0,51.06,51.06,1,-69252,56974,126226,-12278,0,0,1233,0,0,,1233,1233
33,08/15/2018,53,13:00,13:15,54.63,,0,54.63,54.63,1,-101577,69288,170865,-32289,0,0,10198,0,0,,10198,10198
33,08/15/2018,54,13:15,13:30,54.63,,0,54.63,54.63,1,-114042,65222,179264,-48820,0,0,20104,0,0,,20104,20104
33,08/15/2018,55,13:30,13:45,54.63,,0,54.63,54.63,1,-120974,64108,185082,-56866,0,0,20044,0,0,,20044,20044
33,08/15/2018,56,13:45,14:00,119.74,,0,119.74,119.74,1,-110215,50584,160799,-59631,0,0,46232,0,0,,46232,46232
33,08/15/2018,57,14:00,14:15,63.02,,0,63.02,63.02,1,-94403,52499,146902,-41904,0,0,30587,0,0,,30587,30587
33,08/15/2018,58,14:15,14:30,56.81,,0,56.81,56.81,1,-104376,56817,161193,-47559,0,0,26743,0,0,,26743,26743
33,08/15/2018,59,14:30,14:45,50.53,,0,50.53,50.53,1,-103264,62336,165600,-40928,0,0,18096,0,0,,18096,18096
33,08/15/2018,60,14:45,15:00,69.74,,0,69.74,69.74,1,-118226,62479,180705,-55747,0,0,18871,0,0,,18871,18871
33,08/15/2018,61,15:00,15:15,74.02,,0,74.02,74.02,1,-121804,76232,198036,-45572,0,0,37811,0,0,,37811,37811
33,08/15/2018,62,15:15,15:30,69.74,,0,69.74,69.74,1,-127452,74775,202227,-52677,0,0,50513,0,0,,50513,50513
33,08/15/2018,63,15:30,15:45,54.94,,0,54.94,54.94,1,-118053,78239,196292,-39814,0,0,43447,0,0,,43447,43447
33,08/15/2018,64,15:45,16:00,54.63,,0,54.63,54.63,1,-124475,89934,214409,-34541,0,0,38772,0,0,,38772,38772
33,08/15/2018,65,16:00,16:15,69.74,,0,69.74,69.74,1,-120385,66297,186682,-54088,0,0,44875,0,0,,44875,44875
33,08/15/2018,66,16:15,16:30,53.28,,0,53.28,53.28,1,-110441,83921,194362,-26520,0,0,32821,0,0,,32821,32821
33,08/15/2018,67,16:30,16:45,50.02,43.39,0,43.39,43.39,-1,-94756,100529,195285,5773,0,-514,13682,0,0,,14196,13168
33,08/15/2018,68,16:45,17:00,50.53,43.39,0,50.53,50.53,1,-117980,87837,205817,-30143,0,-111,1693,0,0,,1804,1582
33,08/15/2018,69,17:00,17:15,69.74,43.7,0,69.74,43.7,2,-81406,73165,154571,-8241,0,-71,17480,0,0,,17551,17409
33,08/15/2018,70,17:15,17:30,51.55,34.74,0,51.55,34.74,2,-79092,68348,147440,-10744,0,-3671,3241,0,0,,6912,-430
33,08/15/2018,71,17:30,17:45,54.63,,0,54.63,54.63,1,-91691,76585,168276,-15106,0,0,11148,0,0,,11148,11148
33,08/15/2018,72,17:45,18:00,45.66,38.53,0,45.66,38.53,2,-83385,113168,196553,29783,0,-1200,2282,0,0,,3482,1082
33,08/15/2018,73,18:00,18:15,,42.53,0,42.53,42.53,-1,-95670,88780,184450,-6890,0,-2737,0,0,0,,2737,-2737
33,08/15/2018,74,18:15,18:30,,38.53,0,38.53,38.53,-1,-70860,93666,164526,22806,0,-14653,0,0,0,,14653,-14653
33,08/15/2018,75,18:30,18:45,,42.03,0,42.03,42.03,-1,-64693,92348,157041,27655,0,-13897,0,0,0,,13897,-13897
33,08/15/2018,76,18:45,19:00,49.36,42.03,0,49.36,49.36,1,-85378,99265,184643,13887,0,-1584,472,0,0,,2056,-1112
33,08/15/2018,77,19:00,19:15,45.66,,0,45.66,45.66,1,-84238,66920,151158,-17318,0,0,608,0,0,,608,608
33,08/15/2018,78,19:15,19:30,69.74,,0,69.74,69.74,1,-101674,57090,158764,-44584,0,0,11158,0,0,,11158,11158
33,08/15/2018,79,19:30,19:45,50.53,,0,50.53,50.53,1,-93913,76164,170077,-17749,0,0,15673,0,0,,15673,15673
33,08/15/2018,80,19:45,20:00,51.98,,0,51.98,51.98,1,-110072,96916,206988,-13156,0,0,3597,0,0,,3597,3597
33,08/15/2018,81,20:00,20:15,51.3,,0,51.3,51.3,1,-90421,75346,165767,-15075,0,0,6492,0,0,,6492,6492
33,08/15/2018,82,20:15,20:30,45.66,,0,45.66,45.66,1,-81933,81138,163071,-795,0,0,2280,0,0,,2280,2280
33,08/15/2018,83,20:30,20:45,45.66,,0,45.66,45.66,1,-64034,79866,143900,15832,0,0,104,0,0,,104,104
33,08/15/2018,84,20:45,21:00,49.64,,0,49.64,49.64,1,-75184,73794,148978,-1390,0,0,118,0,0,,118,118
33,08/15/2018,85,21:00,21:15,,,0,45.63,45.63,0,-56253,65818,122071,9565,0,0,0,0,0,,0,0
33,08/15/2018,86,21:15,21:30,89.02,,0,89.02,89.02,1,-85354,41383,126737,-43971,0,0,13932,0,0,,13932,13932
33,08/15/2018,87,21:30,21:45,54.63,,0,54.63,54.63,1,-76449,42393,118842,-34056,0,0,26189,0,0,,26189,26189
33,08/15/2018,88,21:45,22:00,,,0,27.8,27.8,0,-89759,50458,140217,-39301,0,0,6015,0,0,,6015,6015
33,08/15/2018,89,22:00,22:15,45.66,,0,45.66,45.66,1,-106661,11166,117827,-95495,0,0,300,0,0,,300,300
33,08/15/2018,90,22:15,22:30,45.66,,0,45.66,45.66,1,-96300,20555,116855,-75745,0,0,429,0,0,,429,429
33,08/15/2018,91,22:30,22:45,49.88,,0,49.88,49.88,1,-69401,46456,115857,-22945,0,0,761,0,0,,761,761
33,08/15/2018,92,22:45,23:00,,34.74,0,34.74,34.74,-1,-41985,75534,117519,33549,0,-4759,0,0,0,,4759,-4759
33,08/15/2018,93,23:00,23:15,69.74,20.32,0,69.74,20.32,2,-81925,39836,121761,-42089,0,-11405,2973,0,0,,14378,-8432
33,08/15/2018,94,23:15,23:30,69.74,34.74,0,34.74,34.74,-1,-56096,64069,120165,7973,0,-2435,7856,0,0,,10291,5421
33,08/15/2018,95,23:30,23:45,,34.74,0,34.74,34.74,-1,-22429,77639,100068,55210,0,-7273,0,0,0,,7273,-7273
33,08/15/2018,96,23:45,0:00,,-122.33,0,-122.33,-122.33,-1,-21067,109478,130545,88411,0,-51944,0,0,0,,51944,-51944
33,08/16/2018,1,0:00,0:15,,,0,45.17,45.17,0,-17993,85012,103005,67019,0,-34330,0,0,0,,34330,-34330
33,08/16/2018,2,0:15,0:30,,,0,45.17,45.17,0,-24425,82844,107269,58419,0,0,0,0,0,,0,0
33,08/16/2018,3,0:30,0:45,,19.69,0,19.69,19.69,-1,-42680,108467,151147,65787,0,-3340,0,0,0,,3340,-3340
33,08/16/2018,4,0:45,1:00,,-95.08,0,-95.08,-95.08,-1,-29627,119849,149476,90222,0,-58859,0,0,0,,58859,-58859
33,08/16/2018,5,1:00,1:15,,33.57,0,33.57,33.57,-1,-45548,68362,113910,22814,0,-17930,0,0,0,,17930,-17930
33,08/16/2018,6,1:15,1:30,,33.57,0,33.57,33.57,-1,-32185,82023,114208,49838,0,-2822,0,0,0,,2822,-2822
33,08/16/2018,7,1:30,1:45,,33.57,0,33.57,33.57,-1,-33361,103034,136395,69673,0,-7410,0,0,0,,7410,-7410
33,08/16/2018,8,1:45,2:00,,17.92,0,17.92,17.92,-1,-30090,100733,130823,70643,0,-36793,0,0,0,,36793,-36793
33,08/16/2018,9,2:00,2:15,,35.78,0,35.78,35.78,-1,-40239,44280,84519,4041,0,-16220,0,0,0,,16220,-16220
33,08/16/2018,10,2:15,2:30,,41.46,0,41.46,41.46,-1,-33199,65191,98390,31992,0,-482,0,0,0,,482,-482
33,08/16/2018,11,2:30,2:45,,41.06,0,41.06,41.06,-1,-30490,82271,112761,51781,0,-2398,0,0,0,,2398,-2398
33,08/16/2018,12,2:45,3:00,,22.52,0,22.52,22.52,-1,-28772,113361,142133,84589,0,-11444,0,0,0,,11444,-11444
33,08/16/2018,13,3:00,3:15,,41.42,0,41.42,41.42,-1,-37330,78290,115620,40960,0,-7241,0,0,0,,7241,-7241
33,08/16/2018,14,3:15,3:30,,,0,42.13,42.13,0,-33353,84468,117821,51115,0,-63,0,0,0,,63,-63
33,08/16/2018,15,3:30,3:45,,33.57,0,33.57,33.57,-1,-30320,87874,118194,57554,0,-4339,0,0,0,,4339,-4339
33,08/16/2018,16,3:45,4:00,,28.48,0,28.48,28.48,-1,-31896,96757,128653,64861,0,-40570,0,0,0,,40570,-40570
33,08/16/2018,17,4:00,4:15,,33.57,0,33.57,33.57,-1,-38552,80668,119220,42116,0,-30360,0,0,0,,30360,-30360
33,08/16/2018,18,4:15,4:30,,,0,42.11,42.11,0,-47308,87325,134633,40017,0,-915,0,0,0,,915,-915
33,08/16/2018,19,4:30,4:45,,,0,42.11,42.11,0,-35947,90608,126555,54661,0,0,0,0,0,,0,0
33,08/16/2018,20,4:45,5:00,,,0,42.11,42.11,0,-29497,108710,138207,79213,0,0,0,0,0,,0,0
33,08/16/2018,21,5:00,5:15,,,0,45.13,45.13,0,-34457,81214,115671,46757,0,0,0,0,0,,0,0
33,08/16/2018,22,5:15,5:30,,,0,45.12,45.12,0,-37903,92804,130707,54901,0,0,0,0,0,,0,0
33,08/16/2018,23,5:30,5:45,,,0,45.12,45.12,0,-46238,108329,154567,62091,0,0,0,0,0,,0,0
33,08/16/2018,24,5:45,6:00,,,0,43.44,43.44,0,-40157,105530,145687,65373,0,0,0,0,0,,0,0
33,08/16/2018,25,6:00,6:15,48.88,33.22,0,48.88,33.22,2,-53691,73875,127566,20184,0,-2717,52,0,0,,2769,-2665
33,08/16/2018,26,6:15,6:30,,21.26,0,21.26,21.26,-1,-54724,62601,117325,7877,0,-16316,0,0,0,,16316,-16316
33,08/16/2018,27,6:30,6:45,49.11,21.26,0,49.11,49.11,1,-65434,43039,108473,-22395,0,-255,1129,0,0,,1384,874
33,08/16/2018,28,6:45,7:00,49.11,,0,49.11,49.11,1,-71480,60614,132094,-10866,0,0,2625,0,0,,2625,2625
33,08/16/2018,29,7:00,7:15,49.11,32.05,0,32.05,32.05,-1,-68289,108117,176406,39828,0,-16968,24,0,0,,16992,-16944
33,08/16/2018,30,7:15,7:30,,41.11,0,41.11,41.11,-1,-60761,90639,151400,29878,0,-16047,0,0,0,,16047,-16047
33,08/16/2018,31,7:30,7:45,45.11,41.11,0,45.11,45.11,1,-67627,68917,136544,1290,0,-444,53,0,0,,497,-391
33,08/16/2018,32,7:45,8:00,49.11,,0,49.11,49.11,1,-76004,47112,123116,-28892,0,0,1679,0,0,,1679,1679
33,08/16/2018,33,8:00,8:15,49.11,44.78,0,44.78,44.78,-1,-72830,62945,135775,-9885,0,-54,388,0,0,,442,334
33,08/16/2018,34,8:15,8:30,,,0,45.27,45.27,0,-66711,48650,115361,-18061,0,0,0,0,0,,0,0
33,08/16/2018,35,8:30,8:45,,,0,45.27,45.27,0,-78354,46083,124437,-32271,0,0,0,0,0,,0,0
33,08/16/2018,36,8:45,9:00,,,0,45.26,45.26,0,-76276,41658,117934,-34618,0,0,0,0,0,,0,0
33,08/16/2018,37,9:00,9:15,49.11,,0,49.11,49.11,1,-58569,49746,108315,-8823,0,0,1003,0,0,,1003,1003
33,08/16/2018,38,9:15,9:30,49.11,,0,49.11,49.11,1,-56800,47623,104423,-9177,0,0,1715,0,0,,1715,1715
33,08/16/2018,39,9:30,9:45,49.11,,0,49.11,49.11,1,-57763,54993,112756,-2770,0,0,2741,0,0,,2741,2741
33,08/16/2018,40,9:45,10:00,,,0,45.27,45.27,0,-48235,66823,115058,18588,0,0,0,0,0,,0,0
33,08/16/2018,41,10:00,10:15,,,0,43.71,43.71,0,-52237,56711,108948,4474,0,0,0,0,0,,0,0
33,08/16/2018,42,10:15,10:30,,44.3,0,44.3,44.3,-1,-49669,62022,111691,12353,0,-55,0,0,0,,55,-55
33,08/16/2018,43,10:30,10:45,,42.88,0,42.88,42.88,-1,-90241,55833,146074,-34408,0,-1104,0,0,0,,1104,-1104
33,08/16/2018,44,10:45,11:00,,44.88,0,44.88,44.88,-1,-91862,52861,144723,-39001,0,-490,0,0,0,,490,-490
33,08/16/2018,45,11:00,11:15,49.16,44.88,0,49.16,49.16,1,-82694,44311,127005,-38383,0,-11,2414,0,0,,2425,2403
33,08/16/2018,46,11:15,11:30,53.2,,0,53.2,53.2,1,-105113,40562,145675,-64551,0,0,17500,0,0,,17500,17500
33,08/16/2018,47,11:30,11:45,92.12,,0,92.12,92.12,1,-128300,34808,163108,-93492,0,0,46877,0,0,,46877,46877
33,08/16/2018,48,11:45,12:00,139.12,,0,139.12,139.12,1,-131271,32094,163365,-99177,0,0,67940,0,0,,67940,67940
33,08/16/2018,49,12:00,12:15,148.12,,0,148.12,148.12,1,-100863,44813,145676,-56050,0,0,60504,0,0,,60504,60504
33,08/16/2018,50,12:15,12:30,49.52,,0,49.52,49.52,1,-93566,39955,133521,-53611,0,0,9006,0,0,,9006,9006
33,08/16/2018,51,12:30,12:45,56.18,,0,56.18,56.18,1,-90842,44771,135613,-46071,0,0,12205,0,0,,12205,12205
33,08/16/2018,52,12:45,13:00,49.11,,0,49.11,49.11,1,-87530,44139,131669,-43391,0,0,13953,0,0,,13953,13953
33,08/16/2018,53,13:00,13:15,45.11,,0,45.11,45.11,1,-61342,74004,135346,12662,0,0,1401,0,0,,1401,1401
33,08/16/2018,54,13:15,13:30,45.11,,0,45.11,45.11,1,-63236,74777,138013,11541,0,0,594,0,0,,594,594
33,08/16/2018,55,13:30,13:45,,,0,45.77,45.77,0,-49783,71307,121090,21524,0,0,0,0,0,,0,0
33,08/16/2018,56,13:45,14:00,,,0,45.77,45.77,0,-48308,69934,118242,21626,0,0,0,0,0,,0,0
33,08/16/2018,57,14:00,14:15,,,0,45.76,45.76,0,-44174,102119,146293,57945,0,0,0,0,0,,0,0
33,08/16/2018,58,14:15,14:30,,,0,45.76,45.76,0,-40010,90732,130742,50722,0,0,0,0,0,,0,0
33,08/16/2018,59,14:30,14:45,,,0,45.76,45.76,0,-37080,78431,115511,41351,0,0,0,0,0,,0,0
33,08/16/2018,60,14:45,15:00,,,0,45.76,45.76,0,-49358,66642,116000,17284,0,0,0,0,0,,0,0
33,08/16/2018,61,15:00,15:15,49.11,,0,49.11,49.11,1,-80559,71765,152324,-8794,0,0,1076,0,0,,1076,1076
33,08/16/2018,62,15:15,15:30,,40.43,0,40.43,40.43,-1,-56093,73250,129343,17157,0,-5806,0,0,0,,5806,-5806
33,08/16/2018,63,15:30,15:45,,43.52,0,43.52,43.52,-1,-60731,64815,125546,4084,0,-4758,0,0,0,,4758,-4758
33,08/16/2018,64,15:45,16:00,,45.87,0,45.87,45.87,-1,-76931,50994,127925,-25937,0,-291,0,0,0,,291,-291
33,08/16/2018,65,16:00,16:15,49.11,,0,49.11,49.11,1,-64551,15873,80424,-48678,0,0,394,0,0,,394,394
33,08/16/2018,66,16:15,16:30,53.43,,0,53.43,53.43,1,-88704,13555,102259,-75149,0,0,4784,0,0,,4784,4784
33,08/16/2018,67,16:30,16:45,157.12,,0,157.12,157.12,1,-110338,17972,128310,-92366,0,0,25610,0,0,,25610,25610
33,08/16/2018,68,16:45,17:00,157.12,,0,157.12,157.12,1,-160079,21706,181785,-138373,0,0,80515,0,0,,80515,80515
33,08/16/2018,69,17:00,17:15,212.44,,0,212.44,212.44,1,-98856,53982,152838,-44874,0,0,51519,2500,0,,54019,54019
33,08/16/2018,70,17:15,17:30,69.32,41.11,0,69.32,41.11,2,-95073,59701,154774,-35372,0,-2,2705,0,0,,2707,2703
33,08/16/2018,71,17:30,17:45,157.12,,0,157.12,157.12,1,-91262,48490,139752,-42772,0,0,39901,0,0,,39901,39901
33,08/16/2018,72,17:45,18:00,52.23,,0,52.23,52.23,1,-76787,68221,145008,-8566,0,0,25572,0,0,,25572,25572
33,08/16/2018,73,18:00,18:15,52.23,43.01,0,43.01,43.01,-1,-42640,95135,137775,52495,0,-770,3138,0,0,,3908,2368
33,08/16/2018,74,18:15,18:30,,,0,45.28,45.28,0,-34257,68805,103062,34548,0,0,0,0,0,,0,0
33,08/16/2018,75,18:30,18:45,,,0,45.28,45.28,0,-48487,70116,118603,21629,0,0,0,0,0,,0,0
33,08/16/2018,76,18:45,19:00,45.11,,0,45.11,45.11,1,-57255,60403,117658,3148,0,0,87,0,0,,87,87
33,08/16/2018,77,19:00,19:15,45.11,,0,45.11,45.11,1,-44961,61982,106943,17021,0,0,211,0,0,,211,211
33,08/16/2018,78,19:15,19:30,53.2,,0,53.2,53.2,1,-73326,46324,119650,-27002,0,0,15031,0,0,,15031,15031
33,08/16/2018,79,19:30,19:45,50.42,,0,50.42,50.42,1,-82382,70181,152563,-12201,0,0,17920,0,0,,17920,17920
33,08/16/2018,80,19:45,20:00,53.2,,0,53.2,53.2,1,-97644,62888,160532,-34756,0,0,9139,0,0,,9139,9139
33,08/16/2018,81,20:00,20:15,51.12,,0,51.12,51.12,1,-85953,76023,161976,-9930,0,0,11752,0,0,,11752,11752
33,08/16/2018,82,20:15,20:30,,,0,27.72,27.72,0,-103304,87435,190739,-15869,0,0,1680,0,0,,1680,1680
33,08/16/2018,83,20:30,20:45,,,0,27.72,27.72,0,-113915,72092,186007,-41823,0,0,0,0,0,,0,0
33,08/16/2018,84,20:45,21:00,49.11,,0,49.11,49.11,1,-123769,75239,199008,-48530,0,0,451,0,0,,451,451
33,08/16/2018,85,21:00,21:15,53.2,,0,53.2,53.2,1,-110450,92465,202915,-17985,0,0,5188,0,0,,5188,5188
33,08/16/2018,86,21:15,21:30,69.32,,0,69.32,69.32,1,-146265,92813,239078,-53452,0,0,36703,0,0,,36703,36703
33,08/16/2018,87,21:30,21:45,50.02,,0,50.02,50.02,1,-123503,95178,218681,-28325,0,0,21935,0,0,,21935,21935
33,08/16/2018,88,21:45,22:00,50.02,42.78,0,42.78,42.78,-1,-88182,107898,196080,19716,0,-464,2194,0,0,,2658,1730
33,08/16/2018,89,22:00,22:15,49.36,42.78,0,49.36,42.78,2,-108670,91600,200270,-17070,0,-856,1978,0,0,,2834,1122
33,08/16/2018,90,22:15,22:30,49.36,33.22,0,33.22,33.22,-1,-92569,114814,207383,22245,0,-10688,28,0,0,,10716,-10660
33,08/16/2018,91,22:30,22:45,,33.22,0,33.22,33.22,-1,-46707,108328,155035,61621,0,-41993,0,0,0,,41993,-41993
33,08/16/2018,92,22:45,23:00,,-18.06,0,-18.06,-18.06,-1,-33815,136806,170621,102991,0,-45612,0,0,0,,45612,-45612
33,08/16/2018,93,23:00,23:15,,31.78,0,31.78,31.78,-1,-88010,95979,183989,7969,0,-32562,0,0,0,,32562,-32562
33,08/16/2018,94,23:15,23:30,49.11,43.76,0,49.11,43.76,2,-78626,92958,171584,14332,0,-195,7,0,0,,202,-188
33,08/16/2018,95,23:30,23:45,,44.71,0,44.71,44.71,-1,-70440,90354,160794,19914,0,-632,0,0,0,,632,-632
33,08/16/2018,96,23:45,0:00,,35.8,0,35.8,35.8,-1,-53681,90833,144514,37152,0,-4950,0,0,0,,4950,-4950
33,08/17/2018,1,0:00,0:15,,33.53,0,33.53,33.53,-1,-67861,108307,176168,40446,0,-4861,0,0,0,,4861,-4861
33,08/17/2018,2,0:15,0:30,,,0,46.16,46.16,0,-75894,93737,169631,17843,0,0,0,0,0,,0,0
33,08/17/2018,3,0:30,0:45,45.48,,0,45.48,45.48,1,-59835,72456,132291,12621,0,0,42,0,0,,42,42
33,08/17/2018,4,0:45,1:00,49.48,,0,49.48,49.48,1,-80232,67740,147972,-12492,0,0,1348,0,0,,1348,1348
33,08/17/2018,5,1:00,1:15,49.48,,0,49.48,49.48,1,-59402,58561,117963,-841,0,0,425,0,0,,425,425
33,08/17/2018,6,1:15,1:30,45.48,,0,45.48,45.48,1,-35055,27042,62097,-8013,0,0,1543,0,0,,1543,1543
33,08/17/2018,7,1:30,1:45,,,0,44.62,44.62,0,-18844,43479,62323,24635,0,0,40,0,0,,40,40
33,08/17/2018,8,1:45,2:00,,39.74,0,39.74,39.74,-1,-28735,52304,81039,23569,0,-4346,0,0,0,,4346,-4346
33,08/17/2018,9,2:00,2:15,53.99,39.74,0,53.99,53.99,1,-50305,27568,77873,-22737,0,-689,6524,0,0,,7213,5835
33,08/17/2018,10,2:15,2:30,53.99,,0,53.99,53.99,1,-44981,30105,75086,-14876,0,0,20651,0,0,,20651,20651
33,08/17/2018,11,2:30,2:45,53.99,42.45,0,42.45,42.45,-1,-32481,37075,69556,4594,0,-1023,2906,0,0,,3929,1883
33,08/17/2018,12,2:45,3:00,,41.74,0,41.74,41.74,-1,-21644,41589,63233,19945,0,-4186,0,0,0,,4186,-4186
33,08/17/2018,13,3:00,3:15,45.48,44.08,0,45.48,45.48,1,-30241,31213,61454,972,0,-1769,454,0,0,,2223,-1315
33,08/17/2018,14,3:15,3:30,45.48,,0,45.48,45.48,1,-34505,21222,55727,-13283,0,0,1184,0,0,,1184,1184
33,08/17/2018,15,3:30,3:45,45.48,,0,45.48,45.48,1,-44950,23348,68298,-21602,0,0,2310,0,0,,2310,2310
33,08/17/2018,16,3:45,4:00,39.54,,0,39.54,39.54,1,-50355,28979,79334,-21376,0,0,923,0,0,,923,923
33,08/17/2018,17,4:00,4:15,49.48,,0,49.48,49.48,1,-52761,12962,65723,-39799,0,0,1442,0,0,,1442,1442
33,08/17/2018,18,4:15,4:30,68.99,,0,68.99,68.99,1,-64205,19535,83740,-44670,0,0,25429,0,0,,25429,25429
33,08/17/2018,19,4:30,4:45,53.99,,0,53.99,53.99,1,-55059,16158,71217,-38901,0,0,30384,0,0,,30384,30384
33,08/17/2018,20,4:45,5:00,49.48,,0,49.48,49.48,1,-52340,12294,64634,-40046,0,0,14887,0,0,,14887,14887
33,08/17/2018,21,5:00,5:15,,,0,46.08,46.08,0,-56939,23155,80094,-33784,0,0,508,0,0,,508,508
33,08/17/2018,22,5:15,5:30,45.48,,0,45.48,45.48,1,-48724,14464,63188,-34260,0,0,33,0,0,,33,33
33,08/17/2018,23,5:30,5:45,154.02,,0,154.02,154.02,1,-81179,10904,92083,-70275,0,0,11002,0,0,,11002,11002
33,08/17/2018,24,5:45,6:00,156.02,,0,156.02,156.02,1,-97354,19033,116387,-78321,0,0,65873,0,0,,65873,65873
33,08/17/2018,25,6:00,6:15,54.46,,0,54.46,54.46,1,-38039,26667,64706,-11372,0,0,24752,0,0,,24752,24752
33,08/17/2018,26,6:15,6:30,49.95,,0,49.95,49.95,1,-42448,17313,59761,-25135,0,0,2112,0,0,,2112,2112
33,08/17/2018,27,6:30,6:45,69.46,,0,69.46,69.46,1,-67831,7804,75635,-60027,0,0,18489,0,0,,18489,18489
33,08/17/2018,28,6:45,7:00,152.02,,0,152.02,152.02,1,-99311,14912,114223,-84399,0,0,50044,0,0,,50044,50044
33,08/17/2018,29,7:00,7:15,58.14,37.41,0,37.41,37.41,-1,-42588,49404,91992,6816,0,-1593,26961,0,0,,28554,25368
33,08/17/2018,30,7:15,7:30,54.46,34,0,54.46,34,2,-58752,49384,108136,-9368,0,-5111,839,0,0,,5950,-4272
33,08/17/2018,31,7:30,7:45,86.02,,0,86.02,86.02,1,-91835,36881,128716,-54954,0,0,36732,0,0,,36732,36732
33,08/17/2018,32,7:45,8:00,119.46,,0,119.46,119.46,1,-106952,38954,145906,-67998,0,0,60266,0,0,,60266,60266
33,08/17/2018,33,8:00,8:15,49.95,,0,49.95,49.95,1,-74246,56465,130711,-17781,0,0,15281,0,0,,15281,15281
33,08/17/2018,34,8:15,8:30,157.02,,0,157.02,157.02,1,-114879,43172,158051,-71707,0,0,15241,0,0,,15241,15241
33,08/17/2018,35,8:30,8:45,156.02,,0,156.02,156.02,1,-120051,37275,157326,-82776,0,0,59596,0,0,,59596,59596
33,08/17/2018,36,8:45,9:00,77.02,,0,77.02,77.02,1,-111480,32432,143912,-79048,0,0,62310,0,0,,62310,62310
33,08/17/2018,37,9:00,9:15,69.46,,0,69.46,69.46,1,-106846,31344,138190,-75502,0,0,61931,0,0,,61931,61931
33,08/17/2018,38,9:15,9:30,69.46,,0,69.46,69.46,1,-106808,31333,138141,-75475,0,0,59238,0,0,,59238,59238
33,08/17/2018,39,9:30,9:45,69.46,,0,69.46,69.46,1,-98095,35730,133825,-62365,0,0,52706,0,0,,52706,52706
33,08/17/2018,40,9:45,10:00,54.46,,0,54.46,54.46,1,-85237,38266,123503,-46971,0,0,35941,0,0,,35941,35941
33,08/17/2018,41,10:00,10:15,155.02,,0,155.02,155.02,1,-103371,28014,131385,-75357,0,0,51719,0,0,,51719,51719
33,08/17/2018,42,10:15,10:30,54.46,,0,54.46,54.46,1,-82879,42386,125265,-40493,0,0,39290,0,0,,39290,39290
33,08/17/2018,43,10:30,10:45,54.46,,0,54.46,54.46,1,-76703,49171,125874,-27532,0,0,31257,0,0,,31257,31257
33,08/17/2018,44,10:45,11:00,49.95,,0,49.95,49.95,1,-71891,58444,130335,-13447,0,0,8347,0,0,,8347,8347
33,08/17/2018,45,11:00,11:15,155.02,,0,155.02,155.02,1,-158870,30148,189018,-128722,0,0,42411,0,0,,42411,42411
33,08/17/2018,46,11:15,11:30,152.02,,0,262.82,262.82,1,-206200,68936,275136,-137264,0,0,84285,0,13166,,97451,97451
33,08/17/2018,47,11:30,11:45,49.58,39.02,0,262.82,39.02,2,-162377,121309,283686,-41068,0,-189,23844,0,19749,,43782,43404
33,08/17/2018,48,11:45,12:00,69.46,,0,69.46,69.46,1,-155842,111508,267350,-44334,0,0,12672,0,6583,,19255,19255
33,08/17/2018,49,12:00,12:15,54.46,,0,54.46,54.46,1,-119109,83367,202476,-35742,0,0,16744,0,0,,16744,16744
33,08/17/2018,50,12:15,12:30,,,0,44.65,44.65,0,-81580,74623,156203,-6957,0,0,4399,0,0,,4399,4399
33,08/17/2018,51,12:30,12:45,,41.95,0,41.95,41.95,-1,-69869,73134,143003,3265,0,-1746,0,0,0,,1746,-1746
33,08/17/2018,52,12:45,13:00,,37.65,0,37.65,37.65,-1,-53167,70361,123528,17194,0,-4507,0,0,0,,4507,-4507
33,08/17/2018,53,13:00,13:15,,34,0,34,34,-1,-29423,108740,138163,79317,0,-23276,0,0,0,,23276,-23276
33,08/17/2018,54,13:15,13:30,,39.33,0,39.33,39.33,-1,-55508,83326,138834,27818,0,-14863,0,0,0,,14863,-14863
33,08/17/2018,55,13:30,13:45,,38.33,0,38.33,38.33,-1,-49199,83118,132317,33919,0,-15757,0,0,0,,15757,-15757
33,08/17/2018,56,13:45,14:00,,39.1,0,39.1,39.1,-1,-53650,86174,139824,32524,0,-17198,0,0,0,,17198,-17198
33,08/17/2018,57,14:00,14:15,69.46,41.95,0,69.46,69.46,1,-75822,41470,117292,-34352,0,-6800,4499,0,0,,11299,-2301
33,08/17/2018,58,14:15,14:30,49.95,,0,49.95,49.95,1,-92174,52506,144680,-39668,0,0,15046,0,0,,15046,15046
33,08/17/2018,59,14:30,14:45,45.95,,0,45.95,45.95,1,-84749,55366,140115,-29383,0,0,3699,0,0,,3699,3699
33,08/17/2018,60,14:45,15:00,,,0,44.86,44.86,0,-81540,61808,143348,-19732,0,0,0,0,0,,0,0
33,08/17/2018,61,15:00,15:15,48.3,,0,48.3,48.3,1,-84132,45491,129623,-38641,0,0,742,0,0,,742,742
33,08/17/2018,62,15:15,15:30,48.66,,0,48.66,48.66,1,-93586,50711,144297,-42875,0,0,3064,0,0,,3064,3064
33,08/17/2018,63,15:30,15:45,69.46,,0,69.46,69.46,1,-100022,47024,147046,-52998,0,0,16370,0,0,,16370,16370
33,08/17/2018,64,15:45,16:00,49.03,,0,49.03,49.03,1,-89554,44843,134397,-44711,0,0,7293,0,0,,7293,7293
33,08/17/2018,65,16:00,16:15,,,0,44.86,44.86,0,-106971,51425,158396,-55546,0,0,0,0,0,,0,0
33,08/17/2018,66,16:15,16:30,,,0,44.86,44.86,0,-97871,41212,139083,-56659,0,0,0,0,0,,0,0
33,08/17/2018,67,16:30,16:45,48.7,,0,48.7,48.7,1,-106662,40937,147599,-65725,0,0,473,0,0,,473,473
33,08/17/2018,68,16:45,17:00,54.46,,0,54.46,54.46,1,-122225,41559,163784,-80666,0,0,3813,0,0,,3813,3813
33,08/17/2018,69,17:00,17:15,,,0,44.88,44.88,0,-46270,44684,90954,-1586,0,0,171,0,0,,171,171
33,08/17/2018,70,17:15,17:30,,,0,44.86,44.86,0,-62400,35020,97420,-27380,0,0,0,0,0,,0,0
33,08/17/2018,71,17:30,17:45,156.02,,0,263,263,1,-306965,27125,334090,-279840,0,0,27980,0,20833,,48813,48813
33,08/17/2018,72,17:45,18:00,450,,0,495,495,1,-313638,68983,382621,-244655,0,0,73498,0,121319,,194817,194817
33,08/17/2018,73,18:00,18:15,450,27.26,0,27.26,27.26,-1,-233113,92891,326004,-140222,0,-4079,8077,0,146600,,158756,150598
33,08/17/2018,74,18:15,18:30,69.46,27.26,0,264.46,264.46,1,-233643,104428,338071,-129215,0,-118,2689,0,23332,,26139,25903
33,08/17/2018,75,18:30,18:45,169.46,,0,169.46,169.46,1,-230798,79993,310791,-150805,0,0,53343,0,0,,53343,53343
33,08/17/2018,76,18:45,19:00,169.46,,0,169.46,169.46,1,-230179,66981,297160,-163198,0,0,87684,0,0,,87684,87684
33,08/17/2018,77,19:00,19:15,169.46,31.87,0,31.87,31.87,-1,-41536,89380,130916,47844,0,-1712,31993,0,0,,33705,30281
33,08/17/2018,78,19:15,19:30,48.51,31.87,0,48.51,48.51,1,-80084,40783,120867,-39301,0,-37,174,0,0,,211,137
33,08/17/2018,79,19:30,19:45,69.46,,0,69.46,69.46,1,-112950,46576,159526,-66374,0,0,5785,0,0,,5785,5785
33,08/17/2018,80,19:45,20:00,145.02,,0,145.02,145.02,1,-129833,47898,177731,-81935,0,0,50831,0,0,,50831,50831
33,08/17/2018,81,20:00,20:15,145.02,,0,145.02,145.02,1,-100994,49770,150764,-51224,0,0,55304,0,0,,55304,55304
33,08/17/2018,82,20:15,20:30,48.77,,0,48.77,48.77,1,-86562,46322,132884,-40240,0,0,10963,0,0,,10963,10963
33,08/17/2018,83,20:30,20:45,49.95,,0,49.95,49.95,1,-88692,41756,130448,-46936,0,0,3049,0,0,,3049,3049
33,08/17/2018,84,20:45,21:00,49.95,,0,49.95,49.95,1,-103534,50913,154447,-52621,0,0,4388,0,0,,4388,4388
33,08/17/2018,85,21:00,21:15,119.46,,0,119.46,119.46,1,-92017,43664,135681,-48353,0,0,18704,0,0,,18704,18704
33,08/17/2018,86,21:15,21:30,156.02,,0,156.02,156.02,1,-122102,35261,157363,-86841,0,0,74864,0,0,,74864,74864
33,08/17/2018,87,21:30,21:45,108.02,,0,108.02,108.02,1,-85123,48888,134011,-36235,0,0,57973,0,0,,57973,57973
33,08/17/2018,88,21:45,22:00,108.02,43.45,0,43.45,43.45,-1,-70012,76082,146094,6070,0,-487,3991,0,0,,4478,3504
33,08/17/2018,89,22:00,22:15,45.95,,0,45.95,45.95,1,-93939,24823,118762,-69116,0,0,169,0,0,,169,169
33,08/17/2018,90,22:15,22:30,,,0,45.47,45.47,0,-80944,40873,121817,-40071,0,0,0,0,0,,0,0
33,08/17/2018,91,22:30,22:45,,,0,45.47,45.47,0,-66041,66363,132404,322,0,0,0,0,0,,0,0
33,08/17/2018,92,22:45,23:00,,33.66,0,33.66,33.66,-1,-73059,82088,155147,9029,0,-4253,0,0,0,,4253,-4253
33,08/17/2018,93,23:00,23:15,45.95,19.46,0,45.95,45.95,1,-90681,57356,148037,-33325,0,-8198,658,0,0,,8856,-7540
33,08/17/2018,94,23:15,23:30,45.95,41.95,0,41.95,41.95,-1,-81102,94770,175872,13668,0,-630,473,0,0,,1103,-157
33,08/17/2018,95,23:30,23:45,,40.08,0,40.08,40.08,-1,-92919,109123,202042,16204,0,-2867,0,0,0,,2867,-2867
33,08/17/2018,96,23:45,0:00,,34,0,34,34,-1,-86011,122282,208293,36271,0,-34794,0,0,0,,34794,-34794
34,08/18/2018,1,0:00,0:15,,7.19,0,7.19,7.19,-1,-50580,71991,122571,21411,0,-26660,0,0,0,,26660,-26660
34,08/18/2018,2,0:15,0:30,48.18,7.19,0,48.18,48.18,1,-52048,66600,118648,14552,0,-55,36,0,0,,91,-19
34,08/18/2018,3,0:30,0:45,,41.29,0,41.29,41.29,-1,-44603,71160,115763,26557,0,-2376,0,0,0,,2376,-2376
34,08/18/2018,4,0:45,1:00,,40.41,0,40.41,40.41,-1,-86460,87469,173929,1009,0,-6564,0,0,0,,6564,-6564
34,08/18/2018,5,1:00,1:15,,40,0,40,40,-1,-73786,96847,170633,23061,0,-3662,0,0,0,,3662,-3662
34,08/18/2018,6,1:15,1:30,,,0,43.55,43.55,0,-74498,38108,112606,-36390,0,-446,0,0,0,,446,-446
34,08/18/2018,7,1:30,1:45,,,0,43.55,43.55,0,-67101,47865,114966,-19236,0,0,0,0,0,,0,0
34,08/18/2018,8,1:45,2:00,,,0,43.55,43.55,0,-89827,62482,152309,-27345,0,0,0,0,0,,0,0
34,08/18/2018,9,2:00,2:15,,,0,43.32,43.32,0,-60218,73182,133400,12964,0,0,0,0,0,,0,0
34,08/18/2018,10,2:15,2:30,,37.29,0,37.29,37.29,-1,-46512,84302,130814,37790,0,-3188,0,0,0,,3188,-3188
34,08/18/2018,11,2:30,2:45,,41.83,0,41.83,41.83,-1,-50642,90456,141098,39814,0,-3346,0,0,0,,3346,-3346
34,08/18/2018,12,2:45,3:00,,37.29,0,37.29,37.29,-1,-46777,101088,147865,54311,0,-5673,0,0,0,,5673,-5673
34,08/18/2018,13,3:00,3:15,,44.13,0,44.13,44.13,-1,-52049,68084,120133,16035,0,-1564,0,0,0,,1564,-1564
34,08/18/2018,14,3:15,3:30,,,0,41.9,41.9,0,-44716,68759,113475,24043,0,0,0,0,0,,0,0
34,08/18/2018,15,3:30,3:45,,,0,41.91,41.91,0,-42471,81804,124275,39333,0,0,0,0,0,,0,0
34,08/18/2018,16,3:45,4:00,,44.39,0,44.39,44.39,-1,-42143,83181,125324,41038,0,-161,0,0,0,,161,-161
34,08/18/2018,17,4:00,4:15,,44.35,0,44.35,44.35,-1,-40561,67352,107913,26791,0,-320,0,0,0,,320,-320
34,08/18/2018,18,4:15,4:30,,44.36,0,44.36,44.36,-1,-36619,74221,110840,37602,0,-132,0,0,0,,132,-132
34,08/18/2018,19,4:30,4:45,,44.36,0,44.36,44.36,-1,-34236,88594,122830,54358,0,-200,0,0,0,,200,-200
34,08/18/2018,20,4:45,5:00,,44.14,0,44.14,44.14,-1,-36761,107386,144147,70625,0,-499,0,0,0,,499,-499
34,08/18/2018,21,5:00,5:15,,39.78,0,39.78,39.78,-1,-57697,110200,167897,52503,0,-4628,0,0,0,,4628,-4628
34,08/18/2018,22,5:15,5:30,,41.29,0,41.29,41.29,-1,-59678,92807,152485,33129,0,-3649,0,0,0,,3649,-3649
34,08/18/2018,23,5:30,5:45,,43.12,0,43.12,43.12,-1,-58982,100352,159334,41370,0,-2214,0,0,0,,2214,-2214
34,08/18/2018,24,5:45,6:00,,,0,41.85,41.85,0,-59089,92682,151771,33593,0,-375,0,0,0,,375,-375
34,08/18/2018,25,6:00,6:15,,,0,41.84,41.84,0,-55155,108731,163886,53576,0,0,0,0,0,,0,0
34,08/18/2018,26,6:15,6:30,,,0,41.84,41.84,0,-50067,115456,165523,65389,0,0,0,0,0,,0,0
34,08/18/2018,27,6:30,6:45,,,0,41.84,41.84,0,-54170,100694,154864,46524,0,0,0,0,0,,0,0
34,08/18/2018,28,6:45,7:00,,,0,41.84,41.84,0,-53988,106554,160542,52566,0,0,0,0,0,,0,0
34,08/18/2018,29,7:00,7:15,,19.84,0,19.84,19.84,-1,-35278,115387,150665,80109,0,-13457,0,0,0,,13457,-13457
34,08/18/2018,30,7:15,7:30,,41.78,0,41.78,41.78,-1,-37288,103350,140638,66062,0,-8472,0,0,0,,8472,-8472
34,08/18/2018,31,7:30,7:45,,,0,43.27,43.27,0,-39484,90531,130015,51047,0,0,0,0,0,,0,0
34,08/18/2018,32,7:45,8:00,,,0,43.27,43.27,0,-37208,103240,140448,66032,0,0,0,0,0,,0,0
34,08/18/2018,33,8:00,8:15,,,0,43.47,43.47,0,-67164,78391,145555,11227,0,0,0,0,0,,0,0
34,08/18/2018,34,8:15,8:30,,,0,43.47,43.47,0,-57191,67980,125171,10789,0,0,0,0,0,,0,0
34,08/18/2018,35,8:30,8:45,,,0,43.46,43.46,0,-47658,50481,98139,2823,0,0,0,0,0,,0,0
34,08/18/2018,36,8:45,9:00,,,0,43.46,43.46,0,-42200,52404,94604,10204,0,0,0,0,0,,0,0
34,08/18/2018,37,9:00,9:15,,,0,43.5,43.5,0,-64266,121161,185427,56895,0,0,0,0,0,,0,0
34,08/18/2018,38,9:15,9:30,,,0,43.5,43.5,0,-66006,122607,188613,56601,0,0,0,0,0,,0,0
34,08/18/2018,39,9:30,9:45,,37.66,0,37.66,37.66,-1,-59191,114473,173664,55282,0,-2067,0,0,0,,2067,-2067
34,08/18/2018,40,9:45,10:00,,37.66,0,37.66,37.66,-1,-57313,88231,145544,30918,0,-8730,0,0,0,,8730,-8730
34,08/18/2018,41,10:00,10:15,,41.78,0,41.78,41.78,-1,-49434,88251,137685,38817,0,-8224,0,0,0,,8224,-8224
34,08/18/2018,42,10:15,10:30,,42.37,0,42.37,42.37,-1,-45640,87269,132909,41629,0,-6380,0,0,0,,6380,-6380
34,08/18/2018,43,10:30,10:45,,37.66,0,37.66,37.66,-1,-48868,85283,134151,36415,0,-10092,0,0,0,,10092,-10092
34,08/18/2018,44,10:45,11:00,,37.66,0,37.66,37.66,-1,-56429,103734,160163,47305,0,-30912,0,0,0,,30912,-30912
34,08/18/2018,45,11:00,11:15,45.66,38.45,0,45.66,45.66,1,-72769,67054,139823,-5715,0,-23038,261,0,0,,23299,-22777
34,08/18/2018,46,11:15,11:30,45.66,43.25,0,45.66,43.25,2,-72526,75524,148050,2998,0,-782,357,0,0,,1139,-425
34,08/18/2018,47,11:30,11:45,,44.53,0,44.53,44.53,-1,-76457,73540,149997,-2917,0,-232,0,0,0,,232,-232
34,08/18/2018,48,11:45,12:00,,44.57,0,44.57,44.57,-1,-74116,60913,135029,-13203,0,-304,0,0,0,,304,-304
34,08/18/2018,49,12:00,12:15,,44.56,0,44.56,44.56,-1,-66446,29715,96161,-36731,0,-250,0,0,0,,250,-250
34,08/18/2018,50,12:15,12:30,,44.56,0,44.56,44.56,-1,-61534,45643,107177,-15891,0,-280,0,0,0,,280,-280
34,08/18/2018,51,12:30,12:45,45.66,44.58,0,45.66,43.35,2,-70306,60835,131141,-9471,0,-350,110,0,0,,460,-240
34,08/18/2018,52,12:45,13:00,52.1,,0,52.1,52.1,1,-77462,30854,108316,-46608,0,0,6159,0,0,,6159,6159
34,08/18/2018,53,13:00,13:15,54.7,,0,54.7,54.7,1,-93507,27190,120697,-66317,0,0,14258,0,0,,14258,14258
34,08/18/2018,54,13:15,13:30,47.35,,0,47.35,47.35,1,-101960,46489,148449,-55471,0,0,12182,0,0,,12182,12182
34,08/18/2018,55,13:30,13:45,46.15,,0,46.15,46.15,1,-81385,51027,132412,-30358,0,0,1705,0,0,,1705,1705
34,08/18/2018,56,13:45,14:00,45.66,,0,45.66,45.66,1,-78682,49357,128039,-29325,0,0,962,0,0,,962,962
34,08/18/2018,57,14:00,14:15,119.84,,0,119.84,119.84,1,-95494,26037,121531,-69457,0,0,24415,0,0,,24415,24415
34,08/18/2018,58,14:15,14:30,58.12,,0,58.12,58.12,1,-65002,43876,108878,-21126,0,0,32405,0,0,,32405,32405
34,08/18/2018,59,14:30,14:45,46.15,,0,46.15,46.15,1,-60753,47706,108459,-13047,0,0,3106,0,0,,3106,3106
34,08/18/2018,60,14:45,15:00,,,0,43.4,43.4,0,-49576,40055,89631,-9521,0,0,38,0,0,,38,38
34,08/18/2018,61,15:00,15:15,,,0,43.28,43.28,0,-50191,85625,135816,35434,0,0,0,0,0,,0,0
34,08/18/2018,62,15:15,15:30,,,0,43.28,43.28,0,-42813,80287,123100,37474,0,0,0,0,0,,0,0
34,08/18/2018,63,15:30,15:45,,,0,43.28,43.28,0,-47173,60573,107746,13400,0,0,0,0,0,,0,0
34,08/18/2018,64,15:45,16:00,,,0,43.28,43.28,0,-53497,65600,119097,12103,0,0,0,0,0,,0,0
34,08/18/2018,65,16:00,16:15,,33.09,0,33.09,33.09,-1,-24279,113608,137887,89329,0,-14826,0,0,0,,14826,-14826
34,08/18/2018,66,16:15,16:30,,39.84,0,39.84,39.84,-1,-27435,78332,105767,50897,0,-13765,0,0,0,,13765,-13765
34,08/18/2018,67,16:30,16:45,,,0,43.27,43.27,0,-33649,58044,91693,24395,0,-143,0,0,0,,143,-143
34,08/18/2018,68,16:45,17:00,45.66,,0,45.66,45.66,1,-41584,45816,87400,4232,0,0,736,0,0,,736,736
34,08/18/2018,69,17:00,17:15,45.66,,0,45.66,45.66,1,-74912,31132,106044,-43780,0,0,2002,0,0,,2002,2002
34,08/18/2018,70,17:15,17:30,48.31,,0,48.31,48.31,1,-71867,60831,132698,-11036,0,0,2401,0,0,,2401,2401
34,08/18/2018,71,17:30,17:45,69.84,,0,69.84,69.84,1,-99819,59644,159463,-40175,0,0,14920,0,0,,14920,14920
34,08/18/2018,72,17:45,18:00,119.84,,0,119.84,119.84,1,-102406,45345,147751,-57061,0,0,38905,0,0,,38905,38905
34,08/18/2018,73,18:00,18:15,151.12,,0,151.12,151.12,1,-163997,38509,202506,-125488,0,0,57431,0,0,,57431,57431
34,08/18/2018,74,18:15,18:30,119.84,,0,119.84,119.84,1,-121601,59500,181101,-62101,0,0,27420,0,0,,27420,27420
34,08/18/2018,75,18:30,18:45,119.84,,0,119.84,119.84,1,-111266,56576,167842,-54690,0,0,37961,0,0,,37961,37961
34,08/18/2018,76,18:45,19:00,70.12,,0,70.12,70.12,1,-111021,53042,164063,-57979,0,0,40352,0,0,,40352,40352
34,08/18/2018,77,19:00,19:15,53.77,42.78,0,42.78,42.78,-1,-56099,54301,110400,-1798,0,-654,21238,0,0,,21892,20584
34,08/18/2018,78,19:15,19:30,49.66,42.78,0,49.66,49.66,1,-65676,43684,109360,-21992,0,-195,368,0,0,,563,173
34,08/18/2018,79,19:30,19:45,69.84,,0,69.84,69.84,1,-76371,33764,110135,-42607,0,0,29731,0,0,,29731,29731
34,08/18/2018,80,19:45,20:00,69.84,,0,69.84,69.84,1,-94165,30507,124672,-63658,0,0,51676,0,0,,51676,51676
34,08/18/2018,81,20:00,20:15,69.84,43.52,0,43.52,43.52,-1,-32982,71770,104752,38788,0,-258,16176,0,0,,16434,15918
34,08/18/2018,82,20:15,20:30,,42.78,0,42.78,42.78,-1,-36415,66981,103396,30566,0,-581,0,0,0,,581,-581
34,08/18/2018,83,20:30,20:45,,44.33,0,44.33,44.33,-1,-31467,65011,96478,33544,0,-792,0,0,0,,792,-792
34,08/18/2018,84,20:45,21:00,,44.62,0,44.62,44.62,-1,-40695,55606,96301,14911,0,-1571,0,0,0,,1571,-1571
34,08/18/2018,85,21:00,21:15,,44.88,0,44.88,44.88,-1,-46276,58649,104925,12373,0,-281,0,0,0,,281,-281
34,08/18/2018,86,21:15,21:30,50.99,,0,50.99,50.99,1,-68795,30643,99438,-38152,0,0,2411,0,0,,2411,2411
34,08/18/2018,87,21:30,21:45,58.69,,0,58.69,58.69,1,-71359,33913,105272,-37446,0,0,28961,0,0,,28961,28961
34,08/18/2018,88,21:45,22:00,49.66,,0,49.66,49.66,1,-70152,48725,118877,-21427,0,0,18141,0,0,,18141,18141
34,08/18/2018,89,22:00,22:15,,,0,43.49,43.49,0,-105914,23150,129064,-82764,0,0,1993,0,0,,1993,1993
34,08/18/2018,90,22:15,22:30,,,0,43.5,43.5,0,-112281,33296,145577,-78985,0,0,0,0,0,,0,0
34,08/18/2018,91,22:30,22:45,53.77,,0,53.77,53.77,1,-84481,41363,125844,-43118,0,0,5924,0,0,,5924,5924
34,08/18/2018,92,22:45,23:00,57.55,,0,57.55,57.55,1,-80729,52811,133540,-27918,0,0,26231,0,0,,26231,26231
34,08/18/2018,93,23:00,23:15,119.84,,0,119.84,119.84,1,-88289,34415,122704,-53874,0,0,27645,0,0,,27645,27645
34,08/18/2018,94,23:15,23:30,53.77,,0,53.77,53.77,1,-63963,32491,96454,-31472,0,0,28733,0,0,,28733,28733
34,08/18/2018,95,23:30,23:45,53.77,43.65,0,43.65,43.65,-1,-50015,59087,109102,9072,0,-96,1549,0,0,,1645,1453
34,08/18/2018,96,23:45,0:00,,42.78,0,42.78,42.78,-1,-53419,69356,122775,15937,0,-2079,0,0,0,,2079,-2079
34,08/19/2018,1,0:00,0:15,142.02,42.78,0,142.02,142.02,1,-93973,38844,132817,-55129,0,-42,14584,0,0,,14626,14542
34,08/19/2018,2,0:15,0:30,52.98,,0,52.98,52.98,1,-43786,34477,78263,-9309,0,0,17310,0,0,,17310,17310
34,08/19/2018,3,0:30,0:45,149.02,,0,149.02,149.02,1,-99182,29107,128289,-70075,0,0,18065,0,0,,18065,18065
34,08/19/2018,4,0:45,1:00,150.02,,0,150.02,150.02,1,-125262,40001,165263,-85261,0,0,28066,0,0,,28066,28066
34,08/19/2018,5,1:00,1:15,119.84,,0,119.84,119.84,1,-117268,99185,216453,-18083,0,0,4653,0,0,,4653,4653
34,08/19/2018,6,1:15,1:30,149.02,,0,149.02,149.02,1,-88585,28608,117193,-59977,0,0,49096,0,0,,49096,49096
34,08/19/2018,7,1:30,1:45,54.76,,0,54.76,54.76,1,-80608,50770,131378,-29838,0,0,27422,0,0,,27422,27422
34,08/19/2018,8,1:45,2:00,54.76,44.63,0,54.76,44.63,2,-53424,52801,106225,-623,0,-40,18832,0,0,,18872,18792
34,08/19/2018,9,2:00,2:15,99.02,42.8,0,99.02,42.01,2,-106974,65326,172300,-41648,0,-201,11212,0,0,,11413,11011
34,08/19/2018,10,2:15,2:30,99.02,,0,99.02,99.02,1,-105536,58380,163916,-47156,0,0,39564,0,0,,39564,39564
34,08/19/2018,11,2:30,2:45,56.57,,0,56.57,56.57,1,-95486,43942,139428,-51544,0,0,41895,0,0,,41895,41895
34,08/19/2018,12,2:45,3:00,54.76,,0,54.76,54.76,1,-116427,41205,157632,-75222,0,0,33894,0,0,,33894,33894
34,08/19/2018,13,3:00,3:15,50.63,,0,50.63,50.63,1,-74833,49130,123963,-25703,0,0,13716,0,0,,13716,13716
34,08/19/2018,14,3:15,3:30,51.08,,0,51.08,51.08,1,-73701,26199,99900,-47502,0,0,20904,0,0,,20904,20904
34,08/19/2018,15,3:30,3:45,50.63,,0,50.63,50.63,1,-57868,29050,86918,-28818,0,0,18508,0,0,,18508,18508
34,08/19/2018,16,3:45,4:00,48.11,,0,48.11,48.11,1,-59994,33804,93798,-26190,0,0,8378,0,0,,8378,8378
34,08/19/2018,17,4:00,4:15,48.11,,0,48.11,48.11,1,-51654,45184,96838,-6470,0,0,3165,0,0,,3165,3165
34,08/19/2018,18,4:15,4:30,50.63,,0,50.63,50.63,1,-48689,34218,82907,-14471,0,0,3995,0,0,,3995,3995
34,08/19/2018,19,4:30,4:45,54.76,,0,54.76,54.76,1,-68134,31496,99630,-36638,0,0,21256,0,0,,21256,21256
34,08/19/2018,20,4:45,5:00,48.63,,0,48.63,48.63,1,-61863,41031,102894,-20832,0,0,11653,0,0,,11653,11653
34,08/19/2018,21,5:00,5:15,52.32,,0,52.32,52.32,1,-52979,31120,84099,-21859,0,0,13947,0,0,,13947,13947
34,08/19/2018,22,5:15,5:30,52.32,44.49,0,44.49,44.49,-1,-44081,56688,100769,12607,0,-55,3422,0,0,,3477,3367
34,08/19/2018,23,5:30,5:45,,44.48,0,44.48,44.48,-1,-47942,77723,125665,29781,0,-108,0,0,0,,108,-108
34,08/19/2018,24,5:45,6:00,,44.49,0,44.49,44.49,-1,-44860,88487,133347,43627,0,-318,0,0,0,,318,-318
34,08/19/2018,25,6:00,6:15,50.67,,0,50.67,50.67,1,-56990,30756,87746,-26234,0,0,4848,0,0,,4848,4848
34,08/19/2018,26,6:15,6:30,46.67,,0,46.67,46.67,1,-43101,25851,68952,-17250,0,0,9185,0,0,,9185,9185
34,08/19/2018,27,6:30,6:45,,,0,41.96,41.96,0,-44885,31365,76250,-13520,0,0,1532,0,0,,1532,1532
34,08/19/2018,28,6:45,7:00,,42.67,0,42.67,42.67,-1,-32521,37494,70015,4973,0,-1096,0,0,0,,1096,-1096
34,08/19/2018,29,7:00,7:15,,,0,41.94,41.94,0,-59216,58359,117575,-857,0,-8,0,0,0,,8,-8
34,08/19/2018,30,7:15,7:30,,,0,41.94,41.94,0,-52967,54034,107001,1067,0,0,0,0,0,,0,0
34,08/19/2018,31,7:30,7:45,45.05,,0,45.05,45.05,1,-61618,58901,120519,-2717,0,0,238,0,0,,238,238
34,08/19/2018,32,7:45,8:00,45.59,,0,45.59,45.59,1,-52384,62001,114385,9617,0,0,1285,0,0,,1285,1285
34,08/19/2018,33,8:00,8:15,,,0,42,42,0,-70543,101710,172253,31167,0,0,0,0,0,,0,0
34,08/19/2018,34,8:15,8:30,39.54,,0,39.54,39.54,1,-71582,91417,162999,19835,0,0,60,0,0,,60,60
34,08/19/2018,35,8:30,8:45,39.52,,0,39.52,39.52,1,-78759,91818,170577,13059,0,0,250,0,0,,250,250
34,08/19/2018,36,8:45,9:00,41.02,,0,41.02,41.02,1,-92087,95993,188080,3906,0,0,446,0,0,,446,446
34,08/19/2018,37,9:00,9:15,42.02,,0,42.02,42.02,1,-67219,91296,158515,24077,0,0,555,0,0,,555,555
34,08/19/2018,38,9:15,9:30,39.53,,0,39.53,39.53,1,-71568,82355,153923,10787,0,0,316,0,0,,316,316
34,08/19/2018,39,9:30,9:45,,,0,42.02,42.02,0,-72798,80449,153247,7651,0,0,0,0,0,,0,0
34,08/19/2018,40,9:45,10:00,,,0,42.01,42.01,0,-74299,84070,158369,9771,0,0,0,0,0,,0,0
34,08/19/2018,41,10:00,10:15,,38.67,0,38.67,38.67,-1,-27595,109673,137268,82078,0,-760,0,0,0,,760,-760
34,08/19/2018,42,10:15,10:30,,41.22,0,41.22,41.22,-1,-39809,112041,151850,72232,0,-475,0,0,0,,475,-475
34,08/19/2018,43,10:30,10:45,,-150.03,0,-150.03,-150.03,-1,-37006,127819,164825,90813,0,-17877,0,0,0,,17877,-17877
34,08/19/2018,44,10:45,11:00,,-150.03,0,-150.03,-150.03,-1,-53352,109398,162750,56046,0,-60560,0,0,0,,60560,-60560
34,08/19/2018,45,11:00,11:15,54.81,-150.03,0,54.81,54.81,1,-115885,92353,208238,-23532,0,-10865,5107,0,0,,15972,-5758
34,08/19/2018,46,11:15,11:30,46.67,34.85,0,34.85,34.85,-1,-70102,93288,163390,23186,0,-1965,2534,0,0,,4499,569
34,08/19/2018,47,11:30,11:45,,34.85,0,34.85,34.85,-1,-50038,93126,143164,43088,0,-22274,0,0,0,,22274,-22274
34,08/19/2018,48,11:45,12:00,,19.89,0,19.89,19.89,-1,-37398,101776,139174,64378,0,-40406,0,0,0,,40406,-40406
34,08/19/2018,49,12:00,12:15,46.67,38.67,0,46.67,46.67,1,-125722,97321,223043,-28401,0,-18675,443,0,0,,19118,-18232
34,08/19/2018,50,12:15,12:30,46.67,38.37,0,38.37,38.37,-1,-76839,97298,174137,20459,0,-4522,33,0,0,,4555,-4489
34,08/19/2018,51,12:30,12:45,,36.87,0,36.87,36.87,-1,-55622,105301,160923,49679,0,-27722,0,0,0,,27722,-27722
34,08/19/2018,52,12:45,13:00,,33.12,0,33.12,33.12,-1,-51598,107997,159595,56399,0,-33312,0,0,0,,33312,-33312
34,08/19/2018,53,13:00,13:15,,19.89,0,19.89,19.89,-1,-51790,128578,180368,76788,0,-24454,0,0,0,,24454,-24454
34,08/19/2018,54,13:15,13:30,,19.89,0,19.89,19.89,-1,-52662,126005,178667,73343,0,-1835,0,0,0,,1835,-1835
34,08/19/2018,55,13:30,13:45,,-150.03,0,-150.03,-150.03,-1,-37670,129648,167318,91978,0,-55004,0,0,0,,55004,-55004
34,08/19/2018,56,13:45,14:00,,-80.75,0,-80.75,-80.75,-1,-32613,135591,168204,102978,0,-83900,0,0,0,,83900,-83900
34,08/19/2018,57,14:00,14:15,,-5.59,0,-5.59,-5.59,-1,-25598,126162,151760,100564,0,-51492,0,0,0,,51492,-51492
34,08/19/2018,58,14:15,14:30,,-64.65,0,-64.65,-64.65,-1,-17564,142903,160467,125339,0,-7796,0,0,0,,7796,-7796
34,08/19/2018,59,14:30,14:45,,-150.03,0,-150.03,-150.03,-1,-26886,91323,118209,64437,0,-47131,0,0,0,,47131,-47131
34,08/19/2018,60,14:45,15:00,,-77.68,0,-77.68,-77.68,-1,-33131,122794,155925,89663,0,-49877,0,0,0,,49877,-49877
34,08/19/2018,61,15:00,15:15,,19.89,0,19.89,19.89,-1,-37550,168711,206261,131161,0,-45062,0,0,0,,45062,-45062
34,08/19/2018,62,15:15,15:30,,19.89,0,19.89,19.89,-1,-40898,153418,194316,112520,0,-12343,0,0,0,,12343,-12343
34,08/19/2018,63,15:30,15:45,,19.89,0,19.89,19.89,-1,-31455,161111,192566,129656,0,-27781,0,0,0,,27781,-27781
34,08/19/2018,64,15:45,16:00,,-8.59,0,-8.59,-8.59,-1,-46309,147924,194233,101615,0,-44519,0,0,0,,44519,-44519
34,08/19/2018,65,16:00,16:15,,-30.11,0,-30.11,-30.11,-1,-65539,164475,230014,98936,0,-51732,0,0,0,,51732,-51732
34,08/19/2018,66,16:15,16:30,,19.89,0,19.89,19.89,-1,-76975,140183,217158,63208,0,-65300,0,0,0,,65300,-65300
34,08/19/2018,67,16:30,16:45,,34.85,0,34.85,34.85,-1,-78272,105322,183594,27050,0,-25851,0,0,0,,25851,-25851
34,08/19/2018,68,16:45,17:00,,,0,42.1,42.1,0,-85945,105306,191251,19361,0,0,0,0,0,,0,0
34,08/19/2018,69,17:00,17:15,,34.75,0,34.75,34.75,-1,-49836,117461,167297,67625,0,-4592,0,0,0,,4592,-4592
34,08/19/2018,70,17:15,17:30,,37.62,0,37.62,37.62,-1,-64438,112843,177281,48405,0,-8683,0,0,0,,8683,-8683
34,08/19/2018,71,17:30,17:45,,,0,44.7,44.7,0,-92866,105147,198013,12281,0,-468,0,0,0,,468,-468
34,08/19/2018,72,17:45,18:00,44.87,,0,44.87,44.87,1,-111003,121226,232229,10223,0,0,34,0,0,,34,34
34,08/19/2018,73,18:00,18:15,46.67,,0,46.67,46.67,1,-150529,75299,225828,-75230,0,0,689,0,0,,689,689
34,08/19/2018,74,18:15,18:30,48.37,,0,48.37,48.37,1,-119355,74426,193781,-44929,0,0,98,0,0,,98,98
34,08/19/2018,75,18:30,18:45,46.67,,0,46.67,46.67,1,-97127,67480,164607,-29647,0,0,674,0,0,,674,674
34,08/19/2018,76,18:45,19:00,50.67,,0,50.67,50.67,1,-84661,76347,161008,-8314,0,0,2424,0,0,,2424,2424
34,08/19/2018,77,19:00,19:15,54.81,,0,54.81,54.81,1,-115038,83572,198610,-31466,0,0,13177,0,0,,13177,13177
34,08/19/2018,78,19:15,19:30,50.67,,0,50.67,50.67,1,-85651,83560,169211,-2091,0,0,2096,0,0,,2096,2096
34,08/19/2018,79,19:30,19:45,54.81,,0,54.81,54.81,1,-106989,79040,186029,-27949,0,0,12701,0,0,,12701,12701
34,08/19/2018,80,19:45,20:00,69.89,,0,69.89,69.89,1,-124291,73899,198190,-50392,0,0,28046,0,0,,28046,28046
34,08/19/2018,81,20:00,20:15,53.68,,0,53.68,53.68,1,-91807,69092,160899,-22715,0,0,19009,0,0,,19009,19009
34,08/19/2018,82,20:15,20:30,119.89,,0,119.89,119.89,1,-123774,65531,189305,-58243,0,0,4846,0,0,,4846,4846
34,08/19/2018,83,20:30,20:45,152.02,,0,152.02,152.02,1,-121130,64274,185404,-56856,0,0,34057,0,0,,34057,34057
34,08/19/2018,84,20:45,21:00,54.81,,0,54.81,54.81,1,-124144,66226,190370,-57918,0,0,24628,0,0,,24628,24628
34,08/19/2018,85,21:00,21:15,50.67,,0,50.67,50.67,1,-92755,95635,188390,2880,0,0,13701,0,0,,13701,13701
34,08/19/2018,86,21:15,21:30,152.02,,0,152.02,152.02,1,-136225,75137,211362,-61088,0,0,30877,0,0,,30877,30877
34,08/19/2018,87,21:30,21:45,152.02,,0,152.02,152.02,1,-130828,75865,206693,-54963,0,0,63813,0,0,,63813,63813
34,08/19/2018,88,21:45,22:00,49.12,42.67,0,42.67,42.67,-1,-40784,59513,100297,18729,0,-24,13787,0,0,,13811,13763
34,08/19/2018,89,22:00,22:15,50,42.67,0,50,26.52,2,-50349,34923,85272,-15426,0,-618,1143,0,0,,1761,525
34,08/19/2018,90,22:15,22:30,49.46,,0,49.46,49.46,1,-65935,57403,123338,-8532,0,0,3852,0,0,,3852,3852
34,08/19/2018,91,22:30,22:45,,,0,43.03,43.03,0,-54416,73541,127957,19125,0,0,87,0,0,,87,87
34,08/19/2018,92,22:45,23:00,,,0,26.52,26.52,0,-47667,91107,138774,43440,0,0,0,0,0,,0,0
34,08/19/2018,93,23:00,23:15,69.89,,0,69.89,69.89,1,-106237,73275,179512,-32962,0,0,9801,0,0,,9801,9801
34,08/19/2018,94,23:15,23:30,50.98,,0,50.98,50.98,1,-86496,72191,158687,-14305,0,0,18500,0,0,,18500,18500
34,08/19/2018,95,23:30,23:45,50.98,44.58,0,44.58,44.58,-1,-62332,73900,136232,11568,0,-279,2125,0,0,,2404,1846
34,08/19/2018,96,23:45,0:00,46.67,42.67,0,46.67,42.67,2,-59547,81085,140632,21538,0,-2940,19,0,0,,2959,-2921
34,08/20/2018,1,0:00,0:15,152.12,42.67,0,152.12,152.12,1,-183303,27165,210468,-156138,0,-348,34852,0,0,,35200,34504
34,08/20/2018,2,0:15,0:30,279.09,,0,279.09,279.09,1,-119665,14231,133896,-105434,0,0,87009,3750,0,,90759,90759
34,08/20/2018,3,0:30,0:45,79.09,,0,79.09,79.09,1,-64454,24528,88982,-39926,0,0,36429,0,0,,36429,36429
34,08/20/2018,4,0:45,1:00,158.12,,0,158.12,158.12,1,-108743,36433,145176,-72310,0,0,54068,0,0,,54068,54068
34,08/20/2018,5,1:00,1:15,46.36,42.8,0,46.36,26.82,2,-18785,52807,71592,34022,0,-323,12012,0,0,,12335,11689
34,08/20/2018,6,1:15,1:30,39.76,,0,39.76,39.76,1,-53488,36947,90435,-16541,0,0,114,0,0,,114,114
34,08/20/2018,7,1:30,1:45,49.44,,0,49.44,49.44,1,-67729,38995,106724,-28734,0,0,1091,0,0,,1091,1091
34,08/20/2018,8,1:45,2:00,46.36,,0,46.36,46.36,1,-84167,29654,113821,-54513,0,0,2104,0,0,,2104,2104
34,08/20/2018,9,2:00,2:15,69.89,,0,69.89,69.89,1,-84455,52383,136838,-32072,0,0,23204,0,0,,23204,23204
34,08/20/2018,10,2:15,2:30,54.73,,0,54.73,54.73,1,-76730,33305,110035,-43425,0,0,42991,0,0,,42991,42991
34,08/20/2018,11,2:30,2:45,50.36,,0,50.36,50.36,1,-74688,30870,105558,-43818,0,0,24033,0,0,,24033,24033
34,08/20/2018,12,2:45,3:00,46.36,,0,46.36,46.36,1,-83180,29804,112984,-53376,0,0,8028,0,0,,8028,8028
34,08/20/2018,13,3:00,3:15,69.89,,0,69.89,69.89,1,-79634,28321,107955,-51313,0,0,17455,0,0,,17455,17455
34,08/20/2018,14,3:15,3:30,54.73,,0,54.73,54.73,1,-78432,29129,107561,-49303,0,0,43850,0,0,,43850,43850
34,08/20/2018,15,3:30,3:45,58.81,,0,58.81,58.81,1,-86186,20478,106664,-65708,0,0,50381,0,0,,50381,50381
34,08/20/2018,16,3:45,4:00,54.73,,0,54.73,54.73,1,-70659,28628,99287,-42031,0,0,42450,0,0,,42450,42450
34,08/20/2018,17,4:00,4:15,50.26,,0,50.26,50.26,1,-88911,33761,122672,-55150,0,0,24612,0,0,,24612,24612
34,08/20/2018,18,4:15,4:30,54.73,,0,54.73,54.73,1,-79136,23251,102387,-55885,0,0,29372,0,0,,29372,29372
34,08/20/2018,19,4:30,4:45,54.65,,0,54.65,54.65,1,-89046,40608,129654,-48438,0,0,34419,0,0,,34419,34419
34,08/20/2018,20,4:45,5:00,54.73,,0,54.73,54.73,1,-108125,64733,172858,-43392,0,0,30548,0,0,,30548,30548
34,08/20/2018,21,5:00,5:15,75.38,,0,75.38,75.38,1,-181695,27424,209119,-154271,0,0,32295,0,0,,32295,32295
34,08/20/2018,22,5:15,5:30,50.36,,0,50.36,50.36,1,-119690,19991,139681,-99699,0,0,17051,0,0,,17051,17051
34,08/20/2018,23,5:30,5:45,69.89,,0,69.89,69.89,1,-113982,10814,124796,-103168,0,0,4982,0,0,,4982,4982
34,08/20/2018,24,5:45,6:00,158.12,,0,158.12,158.12,1,-109947,19913,129860,-90034,0,0,65104,0,0,,65104,65104
34,08/20/2018,25,6:00,6:15,158.12,,0,158.12,158.12,1,-195586,28511,224097,-167075,0,0,85367,0,0,,85367,85367
34,08/20/2018,26,6:15,6:30,70.06,,0,70.06,70.06,1,-96471,53447,149918,-43024,0,0,50801,0,0,,50801,50801
34,08/20/2018,27,6:30,6:45,55.06,,0,55.06,55.06,1,-73853,44661,118514,-29192,0,0,9453,0,0,,9453,9453
34,08/20/2018,28,6:45,7:00,72.09,,0,72.09,72.09,1,-75773,40644,116417,-35129,0,0,23192,0,0,,23192,23192
34,08/20/2018,29,7:00,7:15,72.09,43.78,0,43.78,43.78,-1,-83123,64400,147523,-18723,0,-287,3407,0,0,,3694,3120
34,08/20/2018,30,7:15,7:30,,,0,47.33,47.33,0,-64718,52658,117376,-12060,0,0,0,0,0,,0,0
34,08/20/2018,31,7:30,7:45,72.09,,0,72.09,72.09,1,-102764,30698,133462,-72066,0,0,2271,0,0,,2271,2271
34,08/20/2018,32,7:45,8:00,158.12,,0,158.12,158.12,1,-155992,33332,189324,-122660,0,0,61363,0,0,,61363,61363
34,08/20/2018,33,8:00,8:15,,,0,47.37,47.37,0,-60493,41301,101794,-19192,0,0,39287,0,0,,39287,39287
34,08/20/2018,34,8:15,8:30,,,0,47.37,47.37,0,-61630,24813,86443,-36817,0,0,0,0,0,,0,0
34,08/20/2018,35,8:30,8:45,,,0,47.37,47.37,0,-74345,22271,96616,-52074,0,0,0,0,0,,0,0
34,08/20/2018,36,8:45,9:00,46.76,,0,46.76,46.76,1,-115437,21732,137169,-93705,0,0,91,0,0,,91,91
34,08/20/2018,37,9:00,9:15,158.12,,0,158.12,158.12,1,-124692,26380,151072,-98312,0,0,44243,0,0,,44243,44243
34,08/20/2018,38,9:15,9:30,122.32,,0,122.32,122.32,1,-107896,40624,148520,-67272,0,0,78837,0,0,,78837,78837
34,08/20/2018,39,9:30,9:45,158.12,,0,158.12,158.12,1,-113187,42242,155429,-70945,0,0,64354,0,0,,64354,64354
34,08/20/2018,40,9:45,10:00,158.12,,0,158.12,158.12,1,-119919,40452,160371,-79467,0,0,73850,0,0,,73850,73850
34,08/20/2018,41,10:00,10:15,158.12,,0,158.12,158.12,1,-133052,19850,152902,-113202,0,0,86465,0,0,,86465,86465
34,08/20/2018,42,10:15,10:30,369.9,,0,369.9,369.9,1,-115115,41985,157100,-73130,0,0,82859,5000,0,,87859,87859
34,08/20/2018,43,10:30,10:45,369.9,,0,369.9,369.9,1,-101592,54826,156418,-46766,0,0,39677,5000,0,,44677,44677
34,08/20/2018,44,10:45,11:00,55.06,,0,55.06,55.06,1,-96311,54224,150535,-42087,0,0,30595,0,0,,30595,30595
34,08/20/2018,45,11:00,11:15,99.12,,0,99.12,99.12,1,-99564,45053,144617,-54511,0,0,39750,0,0,,39750,39750
34,08/20/2018,46,11:15,11:30,55.12,,0,55.12,55.12,1,-97201,55688,152889,-41513,0,0,38943,0,0,,38943,38943
34,08/20/2018,47,11:30,11:45,55.06,,0,55.06,55.06,1,-93285,55114,148399,-38171,0,0,34615,0,0,,34615,34615
34,08/20/2018,48,11:45,12:00,55.12,,0,55.12,55.12,1,-93332,49520,142852,-43812,0,0,42036,0,0,,42036,42036
34,08/20/2018,49,12:00,12:15,55.06,,0,55.06,55.06,1,-98289,71257,169546,-27032,0,0,26190,0,0,,26190,26190
34,08/20/2018,50,12:15,12:30,74.51,,0,74.51,74.51,1,-106152,62287,168439,-43865,0,0,34192,0,0,,34192,34192
34,08/20/2018,51,12:30,12:45,55.06,,0,55.06,55.06,1,-107329,73490,180819,-33839,0,0,31245,0,0,,31245,31245
34,08/20/2018,52,12:45,13:00,52.04,,0,52.04,52.04,1,-100020,74265,174285,-25755,0,0,27251,0,0,,27251,27251
34,08/20/2018,53,13:00,13:15,158.12,,0,158.12,158.12,1,-103686,40682,144368,-63004,0,0,34035,0,0,,34035,34035
34,08/20/2018,54,13:15,13:30,75.71,,0,75.71,75.71,1,-92136,38948,131084,-53188,0,0,50553,0,0,,50553,50553
34,08/20/2018,55,13:30,13:45,75.71,,0,75.71,75.71,1,-89302,31414,120716,-57888,0,0,52738,0,0,,52738,52738
34,08/20/2018,56,13:45,14:00,55.71,,0,55.71,55.71,1,-78341,43198,121539,-35143,0,0,38945,0,0,,38945,38945
34,08/20/2018,57,14:00,14:15,83,,0,83,83,1,-86108,37802,123910,-48306,0,0,31134,0,0,,31134,31134
34,08/20/2018,58,14:15,14:30,63,,0,63,63,1,-72378,47377,119755,-25001,0,0,28862,0,0,,28862,28862
34,08/20/2018,59,14:30,14:45,56.12,,0,56.12,56.12,1,-71376,40777,112153,-30599,0,0,24232,0,0,,24232,24232
34,08/20/2018,60,14:45,15:00,53,,0,53,53,1,-79038,46877,125915,-32161,0,0,27272,0,0,,27272,27272
34,08/20/2018,61,15:00,15:15,50.93,43.78,0,43.78,43.78,-1,-64732,82562,147294,17830,0,-789,12739,0,0,,13528,11950
34,08/20/2018,62,15:15,15:30,60.39,43.78,0,60.39,60.39,1,-72192,57692,129884,-14500,0,-113,2560,0,0,,2673,2447
34,08/20/2018,63,15:30,15:45,60.39,,0,60.39,60.39,1,-87461,60178,147639,-27283,0,0,24505,0,0,,24505,24505
34,08/20/2018,64,15:45,16:00,60.39,,0,60.39,60.39,1,-96754,56803,153557,-39951,0,0,27918,0,0,,27918,27918
34,08/20/2018,65,16:00,16:15,158.12,,0,158.12,158.12,1,-95210,17722,112932,-77488,0,0,52152,0,0,,52152,52152
34,08/20/2018,66,16:15,16:30,105.12,,0,105.12,105.12,1,-79924,19199,99123,-60725,0,0,71317,0,0,,71317,71317
34,08/20/2018,67,16:30,16:45,55.06,,0,55.06,55.06,1,-68279,41548,109827,-26731,0,0,23752,0,0,,23752,23752
34,08/20/2018,68,16:45,17:00,125,,0,125,125,1,-93306,35655,128961,-57651,0,0,40563,0,0,,40563,40563
34,08/20/2018,69,17:00,17:15,125,39.16,0,39.16,39.16,-1,-37815,68178,105993,30363,0,-3096,12963,0,0,,16059,9867
34,08/20/2018,70,17:15,17:30,49.03,39.16,0,49.03,49.03,1,-67169,35388,102557,-31781,0,-52,447,0,0,,499,395
34,08/20/2018,71,17:30,17:45,72.09,,0,72.09,72.09,1,-98581,42468,141049,-56113,0,0,13168,0,0,,13168,13168
34,08/20/2018,72,17:45,18:00,122.32,,0,122.32,122.32,1,-92161,48200,140361,-43961,0,0,42805,0,0,,42805,42805
34,08/20/2018,73,18:00,18:15,55.06,,0,55.06,55.06,1,-70920,39491,110411,-31429,0,0,26145,0,0,,26145,26145
34,08/20/2018,74,18:15,18:30,46.76,44.36,0,47.39,44.36,2,-51522,49590,101112,-1932,0,-242,1328,0,0,,1570,1086
34,08/20/2018,75,18:30,18:45,51.06,,0,51.06,51.06,1,-73062,56193,129255,-16869,0,0,5079,0,0,,5079,5079
34,08/20/2018,76,18:45,19:00,55.06,,0,55.06,55.06,1,-82282,58386,140668,-23896,0,0,18810,0,0,,18810,18810
34,08/20/2018,77,19:00,19:15,122.32,,0,122.32,122.32,1,-121967,41830,163797,-80137,0,0,49031,0,0,,49031,49031
34,08/20/2018,78,19:15,19:30,72.09,,0,72.09,72.09,1,-92120,45825,137945,-46295,0,0,49840,0,0,,49840,49840
34,08/20/2018,79,19:30,19:45,55.06,,0,55.06,55.06,1,-85618,49119,134737,-36499,0,0,39028,0,0,,39028,39028
34,08/20/2018,80,19:45,20:00,55.06,,0,55.06,55.06,1,-87231,52085,139316,-35146,0,0,21213,0,0,,21213,21213
34,08/20/2018,81,20:00,20:15,84.12,,0,84.12,84.12,1,-101008,58576,159584,-42432,0,0,39382,0,0,,39382,39382
34,08/20/2018,82,20:15,20:30,53.19,,0,53.19,53.19,1,-77139,52799,129938,-24340,0,0,26613,0,0,,26613,26613
34,08/20/2018,83,20:30,20:45,94.12,,0,94.12,94.12,1,-96978,47832,144810,-49146,0,0,22163,0,0,,22163,22163
34,08/20/2018,84,20:45,21:00,122.32,,0,122.32,122.32,1,-107471,52302,159773,-55169,0,0,40843,0,0,,40843,40843
34,08/20/2018,85,21:00,21:15,158.12,,0,158.12,158.12,1,-96403,34955,131358,-61448,0,0,44890,0,0,,44890,44890
34,08/20/2018,86,21:15,21:30,158.12,,0,158.12,158.12,1,-122186,33935,156121,-88251,0,0,78324,0,0,,78324,78324
34,08/20/2018,87,21:30,21:45,84.12,,0,84.12,84.12,1,-80581,42454,123035,-38127,0,0,54994,0,0,,54994,54994
34,08/20/2018,88,21:45,22:00,84.12,44.36,0,44.36,44.36,-1,-78751,58687,137438,-20064,0,-208,3560,0,0,,3768,3352
34,08/20/2018,89,22:00,22:15,85.91,,0,85.91,85.91,1,-84094,19391,103485,-64703,0,0,21124,0,0,,21124,21124
34,08/20/2018,90,22:15,22:30,70.56,,0,70.56,70.56,1,-88318,18931,107249,-69387,0,0,44123,0,0,,44123,44123
34,08/20/2018,91,22:30,22:45,55.06,,0,55.06,55.06,1,-74826,27341,102167,-47485,0,0,41966,0,0,,41966,41966
34,08/20/2018,92,22:45,23:00,46.76,42.54,0,42.54,42.54,-1,-65214,46624,111838,-18590,0,-8,11736,0,0,,11744,11728
34,08/20/2018,93,23:00,23:15,,42.54,0,42.54,42.54,-1,-72897,81489,154386,8592,0,-65,0,0,0,,65,-65
34,08/20/2018,94,23:15,23:30,51.06,,0,51.06,51.06,1,-57881,41142,99023,-16739,0,0,6596,0,0,,6596,6596
34,08/20/2018,95,23:30,23:45,51.06,,0,51.06,51.06,1,-75466,52334,127800,-23132,0,0,15310,0,0,,15310,15310
34,08/20/2018,96,23:45,0:00,55.06,,0,55.06,55.06,1,-87328,62686,150014,-24642,0,0,22944,0,0,,22944,22944
34,08/21/2018,1,0:00,0:15,159.02,,0,159.02,159.02,1,-89146,13140,102286,-76006,0,0,37568,0,0,,37568,37568
34,08/21/2018,2,0:15,0:30,159.02,,0,159.02,159.02,1,-58592,19136,77728,-39456,0,0,55644,0,0,,55644,55644
34,08/21/2018,3,0:30,0:45,,,0,48.8,48.8,0,-27704,28899,56603,1195,0,0,4790,0,0,,4790,4790
34,08/21/2018,4,0:45,1:00,,42.85,0,42.85,42.85,-1,-23071,55250,78321,32179,0,-2522,0,0,0,,2522,-2522
34,08/21/2018,5,1:00,1:15,159.02,42.85,0,159.02,159.02,1,-76357,19166,95523,-57191,0,-361,13371,0,0,,13732,13010
34,08/21/2018,6,1:15,1:30,55.06,,0,55.06,55.06,1,-46517,35137,81654,-11380,0,0,23667,0,0,,23667,23667
34,08/21/2018,7,1:30,1:45,50.77,,0,50.77,50.77,1,-41490,31620,73110,-9870,0,0,3856,0,0,,3856,3856
34,08/21/2018,8,1:45,2:00,46.85,,0,46.85,46.85,1,-36542,39263,75805,2721,0,0,1252,0,0,,1252,1252
34,08/21/2018,9,2:00,2:15,72.09,,0,72.09,72.09,1,-61166,21925,83091,-39241,0,0,13108,0,0,,13108,13108
34,08/21/2018,10,2:15,2:30,55.06,,0,55.06,55.06,1,-62227,18065,80292,-44162,0,0,36649,0,0,,36649,36649
34,08/21/2018,11,2:30,2:45,55.06,,0,55.06,55.06,1,-62395,20167,82562,-42228,0,0,25227,0,0,,25227,25227
34,08/21/2018,12,2:45,3:00,55.06,,0,55.06,55.06,1,-56653,22595,79248,-34058,0,0,26789,0,0,,26789,26789
34,08/21/2018,13,3:00,3:15,72.09,,0,72.09,72.09,1,-74254,18665,92919,-55589,0,0,33115,0,0,,33115,33115
34,08/21/2018,14,3:15,3:30,55.06,,0,55.06,55.06,1,-65376,12804,78180,-52572,0,0,40669,0,0,,40669,40669
34,08/21/2018,15,3:30,3:45,55.06,,0,55.06,55.06,1,-59112,12825,71937,-46287,0,0,39100,0,0,,39100,39100
34,08/21/2018,16,3:45,4:00,55.06,,0,55.06,55.06,1,-53233,14113,67346,-39120,0,0,30936,0,0,,30936,30936
34,08/21/2018,17,4:00,4:15,55.06,,0,55.06,55.06,1,-55397,8479,63876,-46918,0,0,20899,0,0,,20899,20899
34,08/21/2018,18,4:15,4:30,55.06,,0,55.06,55.06,1,-53955,5497,59452,-48458,0,0,29212,0,0,,29212,29212
34,08/21/2018,19,4:30,4:45,53.44,,0,53.44,53.44,1,-54418,8512,62930,-45906,0,0,19865,0,0,,19865,19865
34,08/21/2018,20,4:45,5:00,142.02,,0,142.02,142.02,1,-78895,11365,90260,-67530,0,0,38798,0,0,,38798,38798
34,08/21/2018,21,5:00,5:15,56.02,,0,56.02,56.02,1,-42746,31241,73987,-11505,0,0,20396,0,0,,20396,20396
34,08/21/2018,22,5:15,5:30,,42.85,0,42.85,42.85,-1,-48469,26835,75304,-21634,0,-8,0,0,0,,8,-8
34,08/21/2018,23,5:30,5:45,50.92,,0,50.92,50.92,1,-68009,10901,78910,-57108,0,0,967,0,0,,967,967
34,08/21/2018,24,5:45,6:00,159.02,,0,159.02,159.02,1,-99839,13688,113527,-86151,0,0,25259,0,0,,25259,25259
34,08/21/2018,25,6:00,6:15,50.44,,0,50.44,50.44,1,-14792,80130,94922,65338,0,0,13668,0,0,,13668,13668
34,08/21/2018,26,6:15,6:30,,,0,48.65,48.65,0,-37242,64784,102026,27542,0,0,0,0,0,,0,0
34,08/21/2018,27,6:30,6:45,54.77,,0,54.77,54.77,1,-63216,55304,118520,-7912,0,0,2332,0,0,,2332,2332
34,08/21/2018,28,6:45,7:00,122.01,,0,122.01,122.01,1,-96067,54686,150753,-41381,0,0,20017,0,0,,20017,20017
34,08/21/2018,29,7:00,7:15,159.02,,0,159.02,159.02,1,-37119,70290,107409,33171,0,0,51078,0,0,,51078,51078
34,08/21/2018,30,7:15,7:30,49.92,42.74,0,49.92,42.74,2,-35598,42197,77795,6599,0,-412,4152,0,0,,4564,3740
34,08/21/2018,31,7:30,7:45,125.14,,0,125.14,125.14,1,-76511,35906,112417,-40605,0,0,18710,0,0,,18710,18710
34,08/21/2018,32,7:45,8:00,142.02,,0,142.02,142.02,1,-103956,50050,154006,-53906,0,0,60680,0,0,,60680,60680
34,08/21/2018,33,8:00,8:15,46.55,42.74,0,46.55,25.37,2,-26169,56211,82380,30042,0,-478,14275,0,0,,14753,13797
34,08/21/2018,34,8:15,8:30,50.62,,0,50.62,50.62,1,-61916,49047,110963,-12869,0,0,460,0,0,,460,460
34,08/21/2018,35,8:30,8:45,89.02,,0,89.02,89.02,1,-106819,48291,155110,-58528,0,0,30878,0,0,,30878,30878
34,08/21/2018,36,8:45,9:00,125.9,,0,125.9,125.9,1,-136925,46631,183556,-90294,0,0,57045,0,0,,57045,57045
34,08/21/2018,37,9:00,9:15,63.82,,0,63.82,63.82,1,-93421,85530,178951,-7891,0,0,25970,0,0,,25970,25970
34,08/21/2018,38,9:15,9:30,53.82,,0,53.82,53.82,1,-85674,66096,151770,-19578,0,0,2986,0,0,,2986,2986
34,08/21/2018,39,9:30,9:45,50.21,,0,50.21,50.21,1,-80463,67220,147683,-13243,0,0,2272,0,0,,2272,2272
34,08/21/2018,40,9:45,10:00,50.91,,0,50.91,50.91,1,-84374,63978,148352,-20396,0,0,2306,0,0,,2306,2306
34,08/21/2018,41,10:00,10:15,159.02,,0,159.02,159.02,1,-110525,48819,159344,-61706,0,0,28332,0,0,,28332,28332
34,08/21/2018,42,10:15,10:30,60.97,44.48,0,44.48,44.48,-1,-55719,60814,116533,5095,0,-165,11975,0,0,,12140,11810
34,08/21/2018,43,10:30,10:45,60.97,49.16,0,49.16,49.16,-1,-57494,66797,124291,9303,0,-60,41,0,0,,101,-19
34,08/21/2018,44,10:45,11:00,,42.74,0,42.74,42.74,-1,-48038,67551,115589,19513,0,-1433,0,0,0,,1433,-1433
34,08/21/2018,45,11:00,11:15,,46.74,0,46.74,46.74,-1,-53042,61124,114166,8082,0,-509,0,0,0,,509,-509
34,08/21/2018,46,11:15,11:30,,50.74,0,50.74,50.74,-1,-56490,63536,120026,7046,0,-11,0,0,0,,11,-11
34,08/21/2018,47,11:30,11:45,,46.89,0,46.89,46.89,-1,-56974,62410,119384,5436,0,-482,0,0,0,,482,-482
34,08/21/2018,48,11:45,12:00,,46.74,0,46.74,46.74,-1,-55852,62978,118830,7126,0,-2262,0,0,0,,2262,-2262
34,08/21/2018,49,12:00,12:15,46.55,49.14,0,46.55,25.37,2,-58325,24257,82582,-34068,0,-694,37,0,0,,731,-657
34,08/21/2018,50,12:15,12:30,46.55,,0,46.55,46.55,1,-80033,37715,117748,-42318,0,0,2739,0,0,,2739,2739
34,08/21/2018,51,12:30,12:45,55.05,,0,55.05,55.05,1,-68193,54563,122756,-13630,0,0,7297,0,0,,7297,7297
34,08/21/2018,52,12:45,13:00,50.64,,0,50.64,50.64,1,-64660,49817,114477,-14843,0,0,5998,0,0,,5998,5998
34,08/21/2018,53,13:00,13:15,159.02,,0,159.02,159.02,1,-92488,35310,127798,-57178,0,0,28789,0,0,,28789,28789
34,08/21/2018,54,13:15,13:30,94.02,,0,94.02,94.02,1,-101692,33770,135462,-67922,0,0,63200,0,0,,63200,63200
34,08/21/2018,55,13:30,13:45,76.29,,0,76.29,76.29,1,-91433,33699,125132,-57734,0,0,54169,0,0,,54169,54169
34,08/21/2018,56,13:45,14:00,66.02,,0,66.02,66.02,1,-81666,33998,115664,-47668,0,0,38585,0,0,,38585,38585
34,08/21/2018,57,14:00,14:15,159.02,,0,159.02,159.02,1,-84654,31868,116522,-52786,0,0,25480,0,0,,25480,25480
34,08/21/2018,58,14:15,14:30,74.41,,0,74.41,74.41,1,-81635,28697,110332,-52938,0,0,51598,0,0,,51598,51598
34,08/21/2018,59,14:30,14:45,59.02,,0,59.02,59.02,1,-77544,29643,107187,-47901,0,0,47426,0,0,,47426,47426
34,08/21/2018,60,14:45,15:00,50.25,,0,50.25,50.25,1,-90793,27658,118451,-63135,0,0,14176,0,0,,14176,14176
34,08/21/2018,61,15:00,15:15,54.77,,0,54.77,54.77,1,-78356,52515,130871,-25841,0,0,949,0,0,,949,949
34,08/21/2018,62,15:15,15:30,54.77,,0,54.77,54.77,1,-100246,50658,150904,-49588,0,0,15653,0,0,,15653,15653
34,08/21/2018,63,15:30,15:45,155.02,,0,155.02,155.02,1,-108319,44947,153266,-63372,0,0,50841,0,0,,50841,50841
34,08/21/2018,64,15:45,16:00,81.02,,0,81.02,81.02,1,-106728,44670,151398,-62058,0,0,61841,0,0,,61841,61841
34,08/21/2018,65,16:00,16:15,50.62,,0,50.62,50.62,1,-62371,56269,118640,-6102,0,0,19158,0,0,,19158,19158
34,08/21/2018,66,16:15,16:30,50.92,,0,50.92,50.92,1,-73252,54378,127630,-18874,0,0,3471,0,0,,3471,3471
34,08/21/2018,67,16:30,16:45,54.77,,0,54.77,54.77,1,-71903,49507,121410,-22396,0,0,10418,0,0,,10418,10418
34,08/21/2018,68,16:45,17:00,71.79,,0,71.79,71.79,1,-97421,46497,143918,-50924,0,0,33163,0,0,,33163,33163
34,08/21/2018,69,17:00,17:15,55.03,,0,55.03,55.03,1,-95171,35560,130731,-59611,0,0,25545,0,0,,25545,25545
34,08/21/2018,70,17:15,17:30,141.02,,0,141.02,141.02,1,-101850,28738,130588,-73112,0,0,26601,0,0,,26601,26601
34,08/21/2018,71,17:30,17:45,159.02,,0,159.02,159.02,1,-98261,28046,126307,-70215,0,0,56745,0,0,,56745,56745
34,08/21/2018,72,17:45,18:00,75.03,,0,75.03,75.03,1,-95801,40668,136469,-55133,0,0,61534,0,0,,61534,61534
34,08/21/2018,73,18:00,18:15,75.02,,0,75.02,75.02,1,-125947,41246,167193,-84701,0,0,39575,0,0,,39575,39575
34,08/21/2018,74,18:15,18:30,124.9,,0,124.9,124.9,1,-86437,39612,126049,-46825,0,0,9900,0,0,,9900,9900
34,08/21/2018,75,18:30,18:45,133.02,,0,133.02,133.02,1,-72661,42862,115523,-29799,0,0,30186,0,0,,30186,30186
34,08/21/2018,76,18:45,19:00,54.9,,0,54.9,54.9,1,-66640,40331,106971,-26309,0,0,24179,0,0,,24179,24179
34,08/21/2018,77,19:00,19:15,126.52,,0,126.52,126.52,1,-89247,26612,115859,-62635,0,0,47315,0,0,,47315,47315
34,08/21/2018,78,19:15,19:30,76.52,,0,76.52,76.52,1,-74212,22979,97191,-51233,0,0,55040,0,0,,55040,55040
34,08/21/2018,79,19:30,19:45,56.52,,0,56.52,56.52,1,-66414,25162,91576,-41252,0,0,42417,0,0,,42417,42417
34,08/21/2018,80,19:45,20:00,76.52,,0,76.52,76.52,1,-88899,27825,116724,-61074,0,0,49865,0,0,,49865,49865
34,08/21/2018,81,20:00,20:15,75.54,,0,75.54,75.54,1,-83138,25289,108427,-57849,0,0,51224,0,0,,51224,51224
34,08/21/2018,82,20:15,20:30,55.54,,0,55.54,55.54,1,-88685,23832,112517,-64853,0,0,31456,0,0,,31456,31456
34,08/21/2018,83,20:30,20:45,100.02,,0,100.02,100.02,1,-105622,20768,126390,-84854,0,0,15763,0,0,,15763,15763
34,08/21/2018,84,20:45,21:00,75.54,,0,75.54,75.54,1,-109975,18074,128049,-91901,0,0,40782,0,0,,40782,40782
34,08/21/2018,85,21:00,21:15,155.02,,0,155.02,155.02,1,-121727,12160,133887,-109567,0,0,50613,0,0,,50613,50613
34,08/21/2018,86,21:15,21:30,155.02,,0,155.02,155.02,1,-145167,9210,154377,-135957,0,0,88472,0,0,,88472,88472
34,08/21/2018,87,21:30,21:45,159.02,,0,159.02,159.02,1,-99072,10992,110064,-88080,0,0,78004,5000,0,,83004,83004
34,08/21/2018,88,21:45,22:00,159.02,46.74,0,46.74,46.74,-1,-37415,30942,68357,-6473,0,-101,10052,0,0,,10153,9951
34,08/21/2018,89,22:00,22:15,155.02,,0,155.02,155.02,1,-146455,5380,151835,-141075,0,0,19701,0,0,,19701,19701
34,08/21/2018,90,22:15,22:30,54.77,,0,54.77,54.77,1,-103305,4436,107741,-98869,0,0,25541,0,0,,25541,25541
34,08/21/2018,91,22:30,22:45,46.55,,0,46.55,46.55,1,-84939,9616,94555,-75323,0,0,2914,0,0,,2914,2914
34,08/21/2018,92,22:45,23:00,46.55,,0,46.55,46.55,1,-67291,29891,97182,-37400,0,0,1034,0,0,,1034,1034
34,08/21/2018,93,23:00,23:15,155.02,,0,155.02,155.02,1,-144683,24976,169659,-119707,0,0,35267,0,0,,35267,35267
34,08/21/2018,94,23:15,23:30,155.02,,0,155.02,155.02,1,-115248,29536,144784,-85712,0,0,86718,0,0,,86718,86718
34,08/21/2018,95,23:30,23:45,54.77,42.55,0,42.55,42.55,-1,-46355,41361,87716,-4994,0,-171,28653,0,0,,28824,28482
34,08/21/2018,96,23:45,0:00,,37.42,0,37.42,37.42,-1,-35932,56399,92331,20467,0,-16907,0,0,0,,16907,-16907
34,08/22/2018,1,0:00,0:15,151.12,37.42,0,151.12,151.12,1,-172364,36972,209336,-135392,0,-7165,23805,0,0,,30970,16640
34,08/22/2018,2,0:15,0:30,266.84,,0,266.84,266.84,1,-165297,33796,199093,-131501,0,0,85000,3750,0,,88750,88750
34,08/22/2018,3,0:30,0:45,266.84,38.15,0,38.15,38.15,-1,-56142,50569,106711,-5573,0,-393,39781,3750,0,,43924,43138
34,08/22/2018,4,0:45,1:00,,34.43,0,34.43,34.43,-1,-41483,71232,112715,29749,0,-15422,0,0,0,,15422,-15422
34,08/22/2018,5,1:00,1:15,119.77,48.68,0,119.77,119.77,1,-74319,27026,101345,-47293,0,-2541,10411,0,0,,12952,7870
34,08/22/2018,6,1:15,1:30,54.69,,0,54.69,54.69,1,-64363,33961,98324,-30402,0,0,16940,0,0,,16940,16940
34,08/22/2018,7,1:30,1:45,50.55,,0,50.55,50.55,1,-56233,35617,91850,-20616,0,0,4060,0,0,,4060,4060
34,08/22/2018,8,1:45,2:00,54.69,,0,54.69,54.69,1,-52592,35056,87648,-17536,0,0,3332,0,0,,3332,3332
34,08/22/2018,9,2:00,2:15,69.77,,0,69.77,69.77,1,-86684,25838,112522,-60846,0,0,23766,0,0,,23766,23766
34,08/22/2018,10,2:15,2:30,54.69,,0,54.69,54.69,1,-72824,34500,107324,-38324,0,0,28950,0,0,,28950,28950
34,08/22/2018,11,2:30,2:45,50.13,,0,50.13,50.13,1,-81893,28360,110253,-53533,0,0,5533,0,0,,5533,5533
34,08/22/2018,12,2:45,3:00,50.14,,0,50.14,50.14,1,-77165,30633,107798,-46532,0,0,549,0,0,,549,549
34,08/22/2018,13,3:00,3:15,72.12,,0,72.12,72.12,1,-89322,33568,122890,-55754,0,0,13228,0,0,,13228,13228
34,08/22/2018,14,3:15,3:30,77.12,,0,77.12,77.12,1,-74445,25465,99910,-48980,0,0,33216,0,0,,33216,33216
34,08/22/2018,15,3:30,3:45,46.26,,0,46.26,46.26,1,-68257,29534,97791,-38723,0,0,7604,0,0,,7604,7604
34,08/22/2018,16,3:45,4:00,,48.38,0,48.38,48.38,-1,-62505,36222,98727,-26283,0,-8,0,0,0,,8,-8
34,08/22/2018,17,4:00,4:15,,,0,48.5,48.5,0,-71060,25221,96281,-45839,0,0,0,0,0,,0,0
34,08/22/2018,18,4:15,4:30,54.69,,0,54.69,54.69,1,-65460,21871,87331,-43589,0,0,2332,0,0,,2332,2332
34,08/22/2018,19,4:30,4:45,50.55,,0,50.55,50.55,1,-73514,16606,90120,-56908,0,0,6631,0,0,,6631,6631
34,08/22/2018,20,4:45,5:00,50.55,,0,50.55,50.55,1,-76053,12915,88968,-63138,0,0,7644,0,0,,7644,7644
34,08/22/2018,21,5:00,5:15,46.26,,0,46.26,46.26,1,-69988,37696,107684,-32292,0,0,1371,0,0,,1371,1371
34,08/22/2018,22,5:15,5:30,,,0,48.5,48.5,0,-76713,32988,109701,-43725,0,0,0,0,0,,0,0
34,08/22/2018,23,5:30,5:45,46.26,,0,46.26,46.26,1,-94943,27639,122582,-67304,0,0,816,0,0,,816,816
34,08/22/2018,24,5:45,6:00,157.12,,0,157.12,157.12,1,-123673,23437,147110,-100236,0,0,19355,0,0,,19355,19355
34,08/22/2018,25,6:00,6:15,55.05,,0,55.05,55.05,1,-72026,48101,120127,-23925,0,0,15258,0,0,,15258,15258
34,08/22/2018,26,6:15,6:30,157.12,,0,157.12,157.12,1,-101543,24290,125833,-77253,0,0,16395,0,0,,16395,16395
34,08/22/2018,27,6:30,6:45,157.12,,0,157.12,157.12,1,-105721,20645,126366,-85076,0,0,65072,0,0,,65072,65072
34,08/22/2018,28,6:45,7:00,157.12,,0,157.12,157.12,1,-101986,22253,124239,-79733,0,0,72937,0,0,,72937,72937
34,08/22/2018,29,7:00,7:15,157.12,-150.78,0,-150.78,-150.78,-1,-3063,132252,135315,129189,0,-22077,15121,0,0,,37198,-6956
34,08/22/2018,30,7:15,7:30,,37.62,0,37.62,37.62,-1,-32583,60466,93049,27883,0,-33480,0,0,0,,33480,-33480
34,08/22/2018,31,7:30,7:45,55.05,37.62,0,55.05,55.05,1,-65478,42156,107634,-23322,0,-3489,1235,0,0,,4724,-2254
34,08/22/2018,32,7:45,8:00,73.12,,0,73.12,73.12,1,-92729,42278,135007,-50451,0,0,30257,0,0,,30257,30257
34,08/22/2018,33,8:00,8:15,46.7,44.83,0,46.7,44.83,2,-53791,52463,106254,-1328,0,-406,12338,0,0,,12744,11932
34,08/22/2018,34,8:15,8:30,154.12,,0,154.12,154.12,1,-92566,36966,129532,-55600,0,0,24490,0,0,,24490,24490
34,08/22/2018,35,8:30,8:45,72.41,,0,72.41,72.41,1,-93066,39598,132664,-53468,0,0,52160,0,0,,52160,52160
34,08/22/2018,36,8:45,9:00,72.41,,0,72.41,72.41,1,-88998,37476,126474,-51522,0,0,51181,0,0,,51181,51181
34,08/22/2018,37,9:00,9:15,55.05,,0,55.05,55.05,1,-71346,59092,130438,-12254,0,0,29218,0,0,,29218,29218
34,08/22/2018,38,9:15,9:30,55.05,,0,55.05,55.05,1,-74580,51579,126159,-23001,0,0,9607,0,0,,9607,9607
34,08/22/2018,39,9:30,9:45,50.92,,0,50.92,50.92,1,-59236,51363,110599,-7873,0,0,12033,0,0,,12033,12033
34,08/22/2018,40,9:45,10:00,50.07,46.74,0,50.07,46.74,2,-52000,57768,109768,5768,0,-708,327,0,0,,1035,-381
34,08/22/2018,41,10:00,10:15,134.12,,0,134.12,134.12,1,-100478,33977,134455,-66501,0,0,26063,0,0,,26063,26063
34,08/22/2018,42,10:15,10:30,54.7,,0,54.7,54.7,1,-61933,59099,121032,-2834,0,0,16135,0,0,,16135,16135
34,08/22/2018,43,10:30,10:45,,,0,48.72,48.72,0,-54651,67159,121810,12508,0,0,250,0,0,,250,250
34,08/22/2018,44,10:45,11:00,,50.74,0,50.74,50.74,-1,-58770,68879,127649,10109,0,-12,0,0,0,,12,-12
34,08/22/2018,45,11:00,11:15,53.46,,0,53.46,53.46,1,-85798,64041,149839,-21757,0,0,3394,0,0,,3394,3394
34,08/22/2018,46,11:15,11:30,50.92,,0,50.92,50.92,1,-74104,61480,135584,-12624,0,0,7061,0,0,,7061,7061
34,08/22/2018,47,11:30,11:45,74.59,,0,74.59,74.59,1,-90060,58400,148460,-31660,0,0,19527,0,0,,19527,19527
34,08/22/2018,48,11:45,12:00,55.05,,0,55.05,55.05,1,-82939,66488,149427,-16451,0,0,14765,0,0,,14765,14765
34,08/22/2018,49,12:00,12:15,159.12,,0,159.12,159.12,1,-100968,44485,145453,-56483,0,0,51789,0,0,,51789,51789
34,08/22/2018,50,12:15,12:30,101.12,,0,101.12,101.12,1,-58568,74228,132796,15660,0,0,62027,0,0,,62027,62027
34,08/22/2018,51,12:30,12:45,79.63,,0,79.63,79.63,1,-47960,91575,139535,43615,0,0,14298,0,0,,14298,14298
34,08/22/2018,52,12:45,13:00,85.12,,0,85.12,85.12,1,-57009,87255,144264,30246,0,0,36310,0,0,,36310,36310
34,08/22/2018,53,13:00,13:15,52.64,,0,52.64,52.64,1,-69347,74585,143932,5238,0,0,20146,0,0,,20146,20146
34,08/22/2018,54,13:15,13:30,55.74,,0,55.74,55.74,1,-78660,63827,142487,-14833,0,0,6689,0,0,,6689,6689
34,08/22/2018,55,13:30,13:45,55.74,,0,55.74,55.74,1,-78134,66375,144509,-11759,0,0,11834,0,0,,11834,11834
34,08/22/2018,56,13:45,14:00,51.86,,0,51.86,51.86,1,-81853,76970,158823,-4883,0,0,16464,0,0,,16464,16464
34,08/22/2018,57,14:00,14:15,51.86,46.74,0,46.74,46.74,-1,-82703,101577,184280,18874,0,-412,969,0,0,,1381,557
34,08/22/2018,58,14:15,14:30,,46.74,0,46.74,46.74,-1,-90657,95638,186295,4981,0,-334,0,0,0,,334,-334
34,08/22/2018,59,14:30,14:45,50.32,,0,50.32,50.32,1,-90176,88037,178213,-2139,0,0,684,0,0,,684,684
34,08/22/2018,60,14:45,15:00,,,0,48.72,48.72,0,-89489,99615,189104,10126,0,0,0,0,0,,0,0
34,08/22/2018,61,15:00,15:15,,,0,48.72,48.72,0,-65912,87613,153525,21701,0,0,0,0,0,,0,0
34,08/22/2018,62,15:15,15:30,46.7,,0,46.7,46.7,1,-79863,86369,166232,6506,0,0,661,0,0,,661,661
34,08/22/2018,63,15:30,15:45,55.05,,0,55.05,55.05,1,-81583,62222,143805,-19361,0,0,11633,0,0,,11633,11633
34,08/22/2018,64,15:45,16:00,51.43,,0,51.43,51.43,1,-87444,67503,154947,-19941,0,0,20368,0,0,,20368,20368
34,08/22/2018,65,16:00,16:15,50.92,43.78,0,43.78,43.78,-1,-67612,80124,147736,12512,0,-327,10597,0,0,,10924,10270
34,08/22/2018,66,16:15,16:30,50.92,43.78,0,50.92,50.92,1,-85087,72380,157467,-12707,0,-33,578,0,0,,611,545
34,08/22/2018,67,16:30,16:45,55.05,,0,55.05,55.05,1,-96274,64482,160756,-31792,0,0,17416,0,0,,17416,17416
34,08/22/2018,68,16:45,17:00,72.12,,0,72.12,72.12,1,-116967,59220,176187,-57747,0,0,44209,0,0,,44209,44209
34,08/22/2018,69,17:00,17:15,,,0,48.72,48.72,0,-56093,45547,101640,-10546,0,0,14218,0,0,,14218,14218
34,08/22/2018,70,17:15,17:30,,,0,48.72,48.72,0,-85247,43546,128793,-41701,0,0,0,0,0,,0,0
34,08/22/2018,71,17:30,17:45,55.05,,0,55.05,55.05,1,-104029,35946,139975,-68083,0,0,1109,0,0,,1109,1109
34,08/22/2018,72,17:45,18:00,127.12,,0,127.12,127.12,1,-102449,45012,147461,-57437,0,0,32392,0,0,,32392,32392
34,08/22/2018,73,18:00,18:15,77.15,,0,77.15,77.15,1,-131824,54448,186272,-77376,0,0,17553,0,0,,17553,17553
34,08/22/2018,74,18:15,18:30,127.15,,0,127.15,127.15,1,-102812,36130,138942,-66682,0,0,44088,0,0,,44088,44088
34,08/22/2018,75,18:30,18:45,77.15,,0,77.15,77.15,1,-97729,47105,144834,-50624,0,0,52651,0,0,,52651,52651
34,08/22/2018,76,18:45,19:00,77.15,,0,77.15,77.15,1,-89598,51783,141381,-37815,0,0,40285,0,0,,40285,40285
34,08/22/2018,77,19:00,19:15,159.12,,0,159.12,159.12,1,-154976,35006,189982,-119970,0,0,71724,0,0,,71724,71724
34,08/22/2018,78,19:15,19:30,133.93,,0,133.93,133.93,1,-120817,44204,165021,-76613,0,0,80856,0,0,,80856,80856
34,08/22/2018,79,19:30,19:45,80.12,,0,80.12,80.12,1,-99171,45200,144371,-53971,0,0,53739,0,0,,53739,53739
34,08/22/2018,80,19:45,20:00,63.93,,0,63.93,63.93,1,-112233,47834,160067,-64399,0,0,27497,0,0,,27497,27497
34,08/22/2018,81,20:00,20:15,156.12,,0,156.12,156.12,1,-218708,50381,269089,-168327,0,0,47047,0,0,,47047,47047
34,08/22/2018,82,20:15,20:30,109.12,,0,109.12,109.12,1,-185670,56537,242207,-129133,0,0,57441,0,0,,57441,57441
34,08/22/2018,83,20:30,20:45,50.92,,0,50.92,50.92,1,-174182,50795,224977,-123387,0,0,29756,0,0,,29756,29756
34,08/22/2018,84,20:45,21:00,48.24,,0,48.24,48.24,1,-173837,44295,218132,-129542,0,0,16571,0,0,,16571,16571
34,08/22/2018,85,21:00,21:15,156.12,,0,156.12,156.12,1,-135490,47070,182560,-88420,0,0,31879,0,0,,31879,31879
34,08/22/2018,86,21:15,21:30,156.12,,0,156.12,156.12,1,-141438,48713,190151,-92725,0,0,84086,0,0,,84086,84086
34,08/22/2018,87,21:30,21:45,375.8,34.82,0,34.82,34.82,-1,-78874,74246,153120,-4628,0,-4211,21604,5000,0,,30815,22393
34,08/22/2018,88,21:45,22:00,,43.78,0,43.78,43.78,-1,-59474,43924,103398,-15550,0,-4573,0,0,0,,4573,-4573
34,08/22/2018,89,22:00,22:15,123.62,,0,123.62,123.62,1,-162511,20778,183289,-141733,0,0,17452,0,0,,17452,17452
34,08/22/2018,90,22:15,22:30,51.74,,0,51.74,51.74,1,-116208,40664,156872,-75544,0,0,12421,0,0,,12421,12421
34,08/22/2018,91,22:30,22:45,50.92,,0,50.92,50.92,1,-68820,46244,115064,-22576,0,0,798,0,0,,798,798
34,08/22/2018,92,22:45,23:00,,,0,48.72,48.72,0,-67629,59618,127247,-8011,0,0,0,0,0,,0,0
34,08/22/2018,93,23:00,23:15,,43.86,0,43.86,43.86,-1,-105377,123296,228673,17919,0,-2738,0,0,0,,2738,-2738
34,08/22/2018,94,23:15,23:30,,43.78,0,43.78,43.78,-1,-80314,96067,176381,15753,0,-10120,0,0,0,,10120,-10120
34,08/22/2018,95,23:30,23:45,,45.06,0,45.06,45.06,-1,-85024,86031,171055,1007,0,-5058,0,0,0,,5058,-5058
34,08/22/2018,96,23:45,0:00,,34.82,0,34.82,34.82,-1,-58902,95785,154687,36883,0,-24352,0,0,0,,24352,-24352
34,08/23/2018,1,0:00,0:15,160.02,34.82,0,160.02,160.02,1,-133257,70203,203460,-63054,0,-14339,20042,0,0,,34381,5703
34,08/23/2018,2,0:15,0:30,55.85,,0,55.85,55.85,1,-94436,70383,164819,-24053,0,0,38353,0,0,,38353,38353
34,08/23/2018,3,0:30,0:45,55.85,42.03,0,42.03,42.03,-1,-67918,77417,145335,9499,0,-1266,2547,0,0,,3813,1281
34,08/23/2018,4,0:45,1:00,,29.64,0,29.64,29.64,-1,-43342,86089,129431,42747,0,-32714,0,0,0,,32714,-32714
34,08/23/2018,5,1:00,1:15,158.02,43.32,0,158.02,158.02,1,-137542,27659,165201,-109883,0,-13360,15771,0,0,,29131,2411
34,08/23/2018,6,1:15,1:30,158.02,,0,158.02,158.02,1,-108747,40369,149116,-68378,0,0,62992,0,0,,62992,62992
34,08/23/2018,7,1:30,1:45,49.48,,0,49.48,49.48,1,-66877,60065,126942,-6812,0,0,12965,0,0,,12965,12965
34,08/23/2018,8,1:45,2:00,49.48,41.03,0,41.03,41.03,-1,-54333,69922,124255,15589,0,-3798,1096,0,0,,4894,-2702
34,08/23/2018,9,2:00,2:15,123.15,43.32,0,123.15,123.15,1,-96224,36723,132947,-59501,0,-3279,17016,0,0,,20295,13737
34,08/23/2018,10,2:15,2:30,55.85,,0,55.85,55.85,1,-69268,42108,111376,-27160,0,0,35718,0,0,,35718,35718
34,08/23/2018,11,2:30,2:45,47.66,,0,47.66,47.66,1,-62379,53738,116117,-8641,0,0,9940,0,0,,9940,9940
34,08/23/2018,12,2:45,3:00,47.17,,0,47.17,47.17,1,-55937,54765,110702,-1172,0,0,4142,0,0,,4142,4142
34,08/23/2018,13,3:00,3:15,47.66,,0,47.66,47.66,1,-71102,60177,131279,-10925,0,0,5243,0,0,,5243,5243
34,08/23/2018,14,3:15,3:30,50.12,,0,50.12,50.12,1,-68987,60805,129792,-8182,0,0,4828,0,0,,4828,4828
34,08/23/2018,15,3:30,3:45,46.78,,0,46.78,46.78,1,-58676,58795,117471,119,0,0,2449,0,0,,2449,2449
34,08/23/2018,16,3:45,4:00,46.78,44.29,0,44.29,44.29,-1,-57850,61139,118989,3289,0,-1109,182,0,0,,1291,-927
34,08/23/2018,17,4:00,4:15,50.12,45.55,0,50.12,45.55,2,-61425,50378,111803,-11047,0,-687,880,0,0,,1567,193
34,08/23/2018,18,4:15,4:30,50.64,,0,50.64,50.64,1,-63506,52394,115900,-11112,0,0,2925,0,0,,2925,2925
34,08/23/2018,19,4:30,4:45,47.66,,0,47.66,47.66,1,-55449,50931,106380,-4518,0,0,2077,0,0,,2077,2077
34,08/23/2018,20,4:45,5:00,50.64,,0,50.64,50.64,1,-62799,45806,108605,-16993,0,0,5556,0,0,,5556,5556
34,08/23/2018,21,5:00,5:15,47.66,,0,47.66,47.66,1,-37076,39847,76923,2771,0,0,2713,0,0,,2713,2713
34,08/23/2018,22,5:15,5:30,50.23,,0,50.23,50.23,1,-49599,42254,91853,-7345,0,0,1142,0,0,,1142,1142
34,08/23/2018,23,5:30,5:45,55.85,,0,55.85,55.85,1,-63950,32201,96151,-31749,0,0,3836,0,0,,3836,3836
34,08/23/2018,24,5:45,6:00,72.92,,0,72.92,72.92,1,-79892,36595,116487,-43297,0,0,24950,0,0,,24950,24950
34,08/23/2018,25,6:00,6:15,52.55,44.06,0,44.06,44.06,-1,-69117,54299,123416,-14818,0,-182,13041,0,0,,13223,12859
34,08/23/2018,26,6:15,6:30,48.36,44.06,0,48.36,44.06,2,-55630,36708,92338,-18922,0,-133,226,0,0,,359,93
34,08/23/2018,27,6:30,6:45,60.74,,0,60.74,60.74,1,-91667,38311,129978,-53356,0,0,10302,0,0,,10302,10302
34,08/23/2018,28,6:45,7:00,123.88,,0,123.88,123.88,1,-122466,47515,169981,-74951,0,0,54216,0,0,,54216,54216
34,08/23/2018,29,7:00,7:15,123.88,29.96,0,29.96,29.96,-1,-52660,78189,130849,25529,0,-4767,19567,0,0,,24334,14800
34,08/23/2018,30,7:15,7:30,,,0,47.57,47.57,0,-74387,38573,112960,-35814,0,-7,0,0,0,,7,-7
34,08/23/2018,31,7:30,7:45,52.55,,0,52.55,52.55,1,-111954,27865,139819,-84089,0,0,357,0,0,,357,357
34,08/23/2018,32,7:45,8:00,160.02,,0,160.02,160.02,1,-139388,15974,155362,-123414,0,0,22246,0,0,,22246,22246
34,08/23/2018,33,8:00,8:15,73.77,,0,73.77,73.77,1,-87165,59573,146738,-27592,0,0,45236,0,0,,45236,45236
34,08/23/2018,34,8:15,8:30,56.55,48.45,0,56.55,48.45,2,-81363,63483,144846,-17880,0,-184,6532,0,0,,6716,6348
34,08/23/2018,35,8:30,8:45,73.77,,0,73.77,73.77,1,-96010,42621,138631,-53389,0,0,34514,0,0,,34514,34514
34,08/23/2018,36,8:45,9:00,67.02,,0,67.02,67.02,1,-104408,42037,146445,-62371,0,0,49678,0,0,,49678,49678
34,08/23/2018,37,9:00,9:15,60.74,,0,60.74,60.74,1,-116060,23235,139295,-92825,0,0,50666,0,0,,50666,50666
34,08/23/2018,38,9:15,9:30,159.02,,0,159.02,159.02,1,-131969,31230,163199,-100739,0,0,60633,0,0,,60633,60633
34,08/23/2018,39,9:30,9:45,159.02,,0,159.02,159.02,1,-113127,34337,147464,-78790,0,0,81600,0,0,,81600,81600
34,08/23/2018,40,9:45,10:00,73.65,,0,73.65,73.65,1,-108496,41666,150162,-66830,0,0,46958,0,0,,46958,46958
34,08/23/2018,41,10:00,10:15,123.88,,0,123.88,123.88,1,-133899,38255,172154,-95644,0,0,60198,0,0,,60198,60198
34,08/23/2018,42,10:15,10:30,56.55,,0,56.55,56.55,1,-122238,44516,166754,-77722,0,0,41830,0,0,,41830,41830
34,08/23/2018,43,10:30,10:45,56.55,44.01,0,44.01,44.01,-1,-134899,47281,182180,-87618,0,-146,7684,0,0,,7830,7538
34,08/23/2018,44,10:45,11:00,,44.01,0,44.01,44.01,-1,-145910,51048,196958,-94862,0,-208,0,0,0,,208,-208
34,08/23/2018,45,11:00,11:15,56.55,,0,56.55,56.55,1,-160707,42645,203352,-118062,0,0,7537,0,0,,7537,7537
34,08/23/2018,46,11:15,11:30,102.02,,0,102.02,102.02,1,-155283,49779,205062,-105504,0,0,44503,0,0,,44503,44503
34,08/23/2018,47,11:30,11:45,56.55,-124.67,0,56.55,-124.67,2,-156198,50026,206224,-106172,0,-687,25571,0,0,,26258,24884
34,08/23/2018,48,11:45,12:00,155.02,,0,155.02,155.02,1,-167335,54177,221512,-113158,0,0,42151,0,0,,42151,42151
34,08/23/2018,49,12:00,12:15,123.88,,0,123.88,123.88,1,-129678,82196,211874,-47482,0,0,63655,0,0,,63655,63655
34,08/23/2018,50,12:15,12:30,52.55,,0,52.55,52.55,1,-109044,95114,204158,-13930,0,0,9976,0,0,,9976,9976
34,08/23/2018,51,12:30,12:45,49.91,36.13,0,49.91,36.13,2,-98976,81719,180695,-17257,0,-5802,1797,0,0,,7599,-4005
34,08/23/2018,52,12:45,13:00,,36.13,0,36.13,36.13,-1,-114631,94533,209164,-20098,0,-43431,0,0,0,,43431,-43431
34,08/23/2018,53,13:00,13:15,,40.93,0,40.93,40.93,-1,-129704,93846,223550,-35858,0,-37101,0,0,0,,37101,-37101
34,08/23/2018,54,13:15,13:30,,45.33,0,45.33,45.33,-1,-142971,94262,237233,-48709,0,-7485,0,0,0,,7485,-7485
34,08/23/2018,55,13:30,13:45,,45.33,0,45.33,45.33,-1,-122585,100271,222856,-22314,0,-2856,0,0,0,,2856,-2856
34,08/23/2018,56,13:45,14:00,,45.69,0,45.69,45.69,-1,-96707,104892,201599,8185,0,-520,0,0,0,,520,-520
34,08/23/2018,57,14:00,14:15,48.33,45.81,0,48.33,45.81,2,-90267,87921,178188,-2346,0,-170,49,0,0,,219,-121
34,08/23/2018,58,14:15,14:30,48.33,,0,48.33,48.33,1,-94465,89441,183906,-5024,0,0,522,0,0,,522,522
34,08/23/2018,59,14:30,14:45,45.02,45.45,0,47.88,45.45,2,-86625,89694,176319,3069,0,-482,126,0,0,,608,-356
34,08/23/2018,60,14:45,15:00,,41.05,0,41.05,41.05,-1,-72938,96844,169782,23906,0,-8000,0,0,0,,8000,-8000
34,08/23/2018,61,15:00,15:15,123.88,44.01,0,123.88,123.88,1,-134985,86734,221719,-48251,0,-7100,10963,0,0,,18063,3863
34,08/23/2018,62,15:15,15:30,159.02,,0,159.02,159.02,1,-133082,93005,226087,-40077,0,0,51837,0,0,,51837,51837
34,08/23/2018,63,15:30,15:45,56.74,,0,56.74,56.74,1,-130240,88835,219075,-41405,0,0,36213,0,0,,36213,36213
34,08/23/2018,64,15:45,16:00,60.74,,0,60.74,60.74,1,-132864,87469,220333,-45395,0,0,28405,0,0,,28405,28405
34,08/23/2018,65,16:00,16:15,159.02,,0,159.02,159.02,1,-147198,68825,216023,-78373,0,0,17033,0,0,,17033,17033
34,08/23/2018,66,16:15,16:30,159.02,,0,159.02,159.02,1,-154999,65413,220412,-89586,0,0,57500,0,0,,57500,57500
34,08/23/2018,67,16:30,16:45,73.65,,0,73.65,73.65,1,-143762,74546,218308,-69216,0,0,56547,0,0,,56547,56547
34,08/23/2018,68,16:45,17:00,159.02,,0,159.02,159.02,1,-161944,72591,234535,-89353,0,0,69182,0,0,,69182,69182
34,08/23/2018,69,17:00,17:15,159.02,24.56,0,24.56,24.56,-1,-133616,176861,310477,43245,0,-3533,23764,0,0,,27297,20231
34,08/23/2018,70,17:15,17:30,60.74,24.56,0,60.74,60.74,1,-153117,118385,271502,-34732,0,-44,8579,0,0,,8623,8535
34,08/23/2018,71,17:30,17:45,63.02,,0,63.02,63.02,1,-158867,118047,276914,-40820,0,0,29830,0,0,,29830,29830
34,08/23/2018,72,17:45,18:00,89.02,,0,89.02,89.02,1,-188262,125152,313414,-63110,0,0,50454,0,0,,50454,50454
34,08/23/2018,73,18:00,18:15,56.55,,0,56.55,56.55,1,-192743,105082,297825,-87661,0,0,28579,0,0,,28579,28579
34,08/23/2018,74,18:15,18:30,73.65,,0,73.65,73.65,1,-163773,106301,270074,-57472,0,0,4423,0,0,,4423,4423
34,08/23/2018,75,18:30,18:45,123.88,,0,123.88,123.88,1,-175941,113916,289857,-62025,0,0,27064,0,0,,27064,27064
34,08/23/2018,76,18:45,19:00,150.02,,0,150.02,150.02,1,-191562,133597,325159,-57965,0,0,55675,0,0,,55675,55675
34,08/23/2018,77,19:00,19:15,56.02,,0,56.02,56.02,1,-159743,147385,307128,-12358,0,0,23174,0,0,,23174,23174
34,08/23/2018,78,19:15,19:30,56.02,44.01,0,44.01,44.01,-1,-138042,153435,291477,15393,0,-3467,2,0,0,,3469,-3465
34,08/23/2018,79,19:30,19:45,,44.34,0,44.34,44.34,-1,-121516,138770,260286,17254,0,-3889,0,0,0,,3889,-3889
34,08/23/2018,80,19:45,20:00,,44.01,0,44.01,44.01,-1,-151795,141614,293409,-10181,0,-2236,0,0,0,,2236,-2236
34,08/23/2018,81,20:00,20:15,,20.37,0,20.37,20.37,-1,-81487,160802,242289,79315,0,-12194,0,0,0,,12194,-12194
34,08/23/2018,82,20:15,20:30,,46.5,0,46.5,46.5,-1,-98958,133889,232847,34931,0,-1918,0,0,0,,1918,-1918
34,08/23/2018,83,20:30,20:45,,,0,30.37,30.37,0,-126779,135060,261839,8281,0,-38,0,0,0,,38,-38
34,08/23/2018,84,20:45,21:00,,45.95,0,45.95,45.95,-1,-135296,133985,269281,-1311,0,-398,0,0,0,,398,-398
34,08/23/2018,85,21:00,21:15,,45.2,0,45.2,45.2,-1,-125157,137612,262769,12455,0,-411,0,0,0,,411,-411
34,08/23/2018,86,21:15,21:30,,,0,30.37,30.37,0,-139633,138497,278130,-1136,0,0,0,0,0,,0,0
34,08/23/2018,87,21:30,21:45,,49.83,0,49.83,49.83,-1,-137041,133413,270454,-3628,0,-133,0,0,0,,133,-133
34,08/23/2018,88,21:45,22:00,,42.74,0,42.74,42.74,-1,-104483,124508,228991,20025,0,-8287,0,0,0,,8287,-8287
34,08/23/2018,89,22:00,22:15,48.36,44.01,0,48.36,48.36,1,-89949,74163,164112,-15786,0,-9433,51,0,0,,9484,-9382
34,08/23/2018,90,22:15,22:30,48.36,43.23,0,49.55,43.23,2,-65345,79365,144710,14020,0,-2429,228,0,0,,2657,-2201
34,08/23/2018,91,22:30,22:45,,39.67,0,39.67,39.67,-1,-49220,96639,145859,47419,0,-26208,0,0,0,,26208,-26208
34,08/23/2018,92,22:45,23:00,,17.62,0,17.62,17.62,-1,-42954,117612,160566,74658,0,-59836,0,0,0,,59836,-59836
34,08/23/2018,93,23:00,23:15,73.65,21.55,0,73.65,73.65,1,-79733,77982,157715,-1751,0,-45903,521,0,0,,46424,-45382
34,08/23/2018,94,23:15,23:30,100.02,21.55,0,100.02,100.02,1,-77419,56829,134248,-20590,0,-1,10977,0,0,,10978,10976
34,08/23/2018,95,23:30,23:45,48.36,29.77,0,29.77,29.77,-1,-40494,80647,121141,40153,0,-13564,903,0,0,,14467,-12661
34,08/23/2018,96,23:45,0:00,,29.77,0,29.77,29.77,-1,-69840,83241,153081,13401,0,-36861,0,0,0,,36861,-36861
34,08/24/2018,1,0:00,0:15,52.44,29.77,0,52.44,52.44,1,-109755,67821,177576,-41934,0,-5218,2874,0,0,,8092,-2344
34,08/24/2018,2,0:15,0:30,61.89,,0,61.89,61.89,1,-149048,45916,194964,-103132,0,0,37702,0,0,,37702,37702
34,08/24/2018,3,0:30,0:45,150.12,,0,150.12,150.12,1,-165486,28328,193814,-137158,0,0,76228,0,0,,76228,76228
34,08/24/2018,4,0:45,1:00,151.12,,0,151.12,151.12,1,-175581,47033,222614,-128548,0,0,71688,0,0,,71688,71688
34,08/24/2018,5,1:00,1:15,47.86,,0,47.86,47.86,1,-129281,66263,195544,-63018,0,0,8197,0,0,,8197,8197
34,08/24/2018,6,1:15,1:30,52.99,,0,52.99,52.99,1,-116189,60487,176676,-55702,0,0,920,0,0,,920,920
34,08/24/2018,7,1:30,1:45,47.86,,0,47.86,47.86,1,-114371,72832,187203,-41539,0,0,518,0,0,,518,518
34,08/24/2018,8,1:45,2:00,47.86,,0,47.86,47.86,1,-82172,77533,159705,-4639,0,0,986,0,0,,986,986
34,08/24/2018,9,2:00,2:15,121.4,,0,121.4,121.4,1,-116927,48439,165366,-68488,0,0,14879,0,0,,14879,14879
34,08/24/2018,10,2:15,2:30,54.55,,0,54.55,54.55,1,-77461,49878,127339,-27583,0,0,25146,0,0,,25146,25146
34,08/24/2018,11,2:30,2:45,54.55,45.74,0,45.74,45.74,-1,-44371,56944,101315,12573,0,-729,6040,0,0,,6769,5311
34,08/24/2018,12,2:45,3:00,,,0,49.89,49.89,0,-36240,59079,95319,22839,0,0,0,0,0,,0,0
34,08/24/2018,13,3:00,3:15,55.98,,0,55.98,55.98,1,-71796,48870,120666,-22926,0,0,1283,0,0,,1283,1283
34,08/24/2018,14,3:15,3:30,60.74,,0,60.74,60.74,1,-61106,42526,103632,-18580,0,0,13217,0,0,,13217,13217
34,08/24/2018,15,3:30,3:45,60.74,30.78,0,30.78,30.78,-1,-28568,73518,102086,44950,0,-4407,97,0,0,,4504,-4310
34,08/24/2018,16,3:45,4:00,,-140.83,0,-140.83,-140.83,-1,-22352,101282,123634,78930,0,-65296,0,0,0,,65296,-65296
34,08/24/2018,17,4:00,4:15,,39.86,0,39.86,39.86,-1,-72159,83950,156109,11791,0,-30280,0,0,0,,30280,-30280
34,08/24/2018,18,4:15,4:30,,,0,46.43,46.43,0,-56122,58415,114537,2293,0,-2785,0,0,0,,2785,-2785
34,08/24/2018,19,4:30,4:45,,42.92,0,42.92,42.92,-1,-49149,60747,109896,11598,0,-6429,0,0,0,,6429,-6429
34,08/24/2018,20,4:45,5:00,47.86,42.92,0,47.86,47.86,1,-72813,33711,106524,-39102,0,-143,109,0,0,,252,-34
34,08/24/2018,21,5:00,5:15,55.98,,0,55.98,55.98,1,-126965,27909,154874,-99056,0,0,2411,0,0,,2411,2411
34,08/24/2018,22,5:15,5:30,55.98,,0,55.98,55.98,1,-126516,21293,147809,-105223,0,0,7637,0,0,,7637,7637
34,08/24/2018,23,5:30,5:45,159.12,,0,159.12,159.12,1,-110864,17346,128210,-93518,0,0,12800,0,0,,12800,12800
34,08/24/2018,24,5:45,6:00,159.12,,0,159.12,159.12,1,-114063,31516,145579,-82547,0,0,62195,0,0,,62195,62195
34,08/24/2018,25,6:00,6:15,57.8,,0,57.8,57.8,1,-113314,41498,154812,-71816,0,0,22571,0,0,,22571,22571
34,08/24/2018,26,6:15,6:30,82.12,,0,82.12,82.12,1,-89543,34719,124262,-54824,0,0,31547,0,0,,31547,31547
34,08/24/2018,27,6:30,6:45,47.88,,0,47.88,47.88,1,-67534,59977,127511,-7557,0,0,8059,0,0,,8059,8059
34,08/24/2018,28,6:45,7:00,,43.88,0,43.88,43.88,-1,-56816,58248,115064,1432,0,-787,0,0,0,,787,-787
34,08/24/2018,29,7:00,7:15,,-28.58,0,-28.58,-28.58,-1,-55558,144139,199697,88581,0,-40001,0,0,0,,40001,-40001
34,08/24/2018,30,7:15,7:30,,32.42,0,32.42,32.42,-1,-45665,103031,148696,57366,0,-50041,0,0,0,,50041,-50041
34,08/24/2018,31,7:30,7:45,,44.78,0,44.78,44.78,-1,-63989,98924,162913,34935,0,-14857,0,0,0,,14857,-14857
34,08/24/2018,32,7:45,8:00,,,0,48.3,48.3,0,-94609,97447,192056,2838,0,-593,0,0,0,,593,-593
34,08/24/2018,33,8:00,8:15,,52.51,0,52.51,52.51,-1,-70681,116443,187124,45762,0,-552,0,0,0,,552,-552
34,08/24/2018,34,8:15,8:30,54.77,52.52,0,54.77,54.77,1,-77635,88889,166524,11254,0,-275,671,0,0,,946,396
34,08/24/2018,35,8:30,8:45,75.12,,0,75.12,75.12,1,-115137,80259,195396,-34878,0,0,30988,0,0,,30988,30988
34,08/24/2018,36,8:45,9:00,56.35,49.71,0,49.71,49.71,-1,-91021,94211,185232,3190,0,-33,25984,0,0,,26017,25951
34,08/24/2018,37,9:00,9:15,56.35,43.36,0,43.36,43.36,-1,-99171,60089,159260,-39082,0,-2769,1644,0,0,,4413,-1125
34,08/24/2018,38,9:15,9:30,,,0,50.31,50.31,0,-66582,69677,136259,3095,0,0,0,0,0,,0,0
34,08/24/2018,39,9:30,9:45,,24.93,0,24.93,24.93,-1,-26723,106355,133078,79632,0,-6498,0,0,0,,6498,-6498
34,08/24/2018,40,9:45,10:00,,21.42,0,21.42,21.42,-1,-18902,120420,139322,101518,0,-51201,0,0,0,,51201,-51201
34,08/24/2018,41,10:00,10:15,,39.88,0,39.88,39.88,-1,-55518,99604,155122,44086,0,-34943,0,0,0,,34943,-34943
34,08/24/2018,42,10:15,10:30,,36,0,36,36,-1,-33271,87809,121080,54538,0,-34515,0,0,0,,34515,-34515
34,08/24/2018,43,10:30,10:45,52.2,45.64,0,52.2,45.64,2,-89955,63509,153464,-26446,0,-11881,235,0,0,,12116,-11646
34,08/24/2018,44,10:45,11:00,,,0,50.3,50.3,0,-134909,106479,241388,-28430,0,0,0,0,0,,0,0
34,08/24/2018,45,11:00,11:15,,,0,48.93,48.93,0,-128853,94334,223187,-34519,0,0,0,0,0,,0,0
34,08/24/2018,46,11:15,11:30,,,0,48.59,48.59,0,-90954,101170,192124,10216,0,0,0,0,0,,0,0
34,08/24/2018,47,11:30,11:45,,,0,48.59,48.59,0,-139727,119973,259700,-19754,0,0,0,0,0,,0,0
34,08/24/2018,48,11:45,12:00,,43.88,0,43.88,43.88,-1,-111142,123787,234929,12645,0,-239,0,0,0,,239,-239
34,08/24/2018,49,12:00,12:15,,-27.32,0,-27.32,-27.32,-1,-86715,147220,233935,60505,0,-34361,0,0,0,,34361,-34361
34,08/24/2018,50,12:15,12:30,,24.28,0,24.28,24.28,-1,-84058,148865,232923,64807,0,-35635,0,0,0,,35635,-35635
34,08/24/2018,51,12:30,12:45,,21.42,0,21.42,21.42,-1,-83467,140569,224036,57102,0,-69185,0,0,0,,69185,-69185
34,08/24/2018,52,12:45,13:00,,40.33,0,40.33,40.33,-1,-98424,125821,224245,27397,0,-25537,0,0,0,,25537,-25537
34,08/24/2018,53,13:00,13:15,,17.41,0,17.41,17.41,-1,-46855,132880,179735,86025,0,-50111,0,0,0,,50111,-50111
34,08/24/2018,54,13:15,13:30,,38.78,0,38.78,38.78,-1,-66288,120345,186633,54057,0,-42452,0,0,0,,42452,-42452
34,08/24/2018,55,13:30,13:45,,-28.58,0,-28.58,-28.58,-1,-31453,125530,156983,94077,0,-81701,0,0,0,,81701,-81701
34,08/24/2018,56,13:45,14:00,,21.42,0,21.42,21.42,-1,-29221,137382,166603,108161,0,-90316,0,0,0,,90316,-90316
34,08/24/2018,57,14:00,14:15,,-108.76,0,-108.76,-108.76,-1,-52548,165806,218354,113258,0,-109574,0,0,0,,109574,-109574
34,08/24/2018,58,14:15,14:30,,21.42,0,21.42,21.42,-1,-47529,151807,199336,104278,0,-98416,0,0,0,,98416,-98416
34,08/24/2018,59,14:30,14:45,,28.78,0,28.78,28.78,-1,-57212,123563,180775,66351,0,-81043,0,0,0,,81043,-81043
34,08/24/2018,60,14:45,15:00,,38.78,0,38.78,38.78,-1,-53545,118126,171671,64581,0,-69756,0,0,0,,69756,-69756
34,08/24/2018,61,15:00,15:15,71.42,39.88,0,71.42,71.42,1,-71374,98843,170217,27469,0,-48024,3,0,0,,48027,-48021
34,08/24/2018,62,15:15,15:30,152.12,48.74,0,152.12,45.97,2,-142474,102331,244805,-40143,0,-10548,30431,0,0,,40979,19883
34,08/24/2018,63,15:30,15:45,152.12,43.36,0,43.36,43.36,-1,-89414,104393,193807,14979,0,-4831,1129,0,0,,5960,-3702
34,08/24/2018,64,15:45,16:00,,41.74,0,41.74,41.74,-1,-74704,102854,177558,28150,0,-14976,0,0,0,,14976,-14976
34,08/24/2018,65,16:00,16:15,,43.88,0,43.88,43.88,-1,-91165,93989,185154,2824,0,-16301,0,0,0,,16301,-16301
34,08/24/2018,66,16:15,16:30,52.2,43.88,0,52.2,52.2,1,-94108,79698,173806,-14410,0,-713,1381,0,0,,2094,668
34,08/24/2018,67,16:30,16:45,52.2,45.85,0,52.2,45.85,2,-66576,72396,138972,5820,0,-1323,1447,0,0,,2770,124
34,08/24/2018,68,16:45,17:00,,36.4,0,36.4,36.4,-1,-87994,116517,204511,28523,0,-12343,0,0,0,,12343,-12343
34,08/24/2018,69,17:00,17:15,,36,0,36,36,-1,-45023,104274,149297,59251,0,-32351,0,0,0,,32351,-32351
34,08/24/2018,70,17:15,17:30,48.2,47.31,0,48.2,48.2,1,-79817,86898,166715,7081,0,-11441,276,0,0,,11717,-11165
34,08/24/2018,71,17:30,17:45,48.2,48.63,0,48.63,48.63,-1,-75280,103447,178727,28167,0,-743,42,0,0,,785,-701
34,08/24/2018,72,17:45,18:00,,40.86,0,40.86,40.86,-1,-68642,153370,222012,84728,0,-7482,0,0,0,,7482,-7482
34,08/24/2018,73,18:00,18:15,,4.95,0,4.95,4.95,-1,-69278,141402,210680,72124,0,-39869,0,0,0,,39869,-39869
34,08/24/2018,74,18:15,18:30,,6.32,0,6.32,6.32,-1,-83408,167971,251379,84563,0,-77201,0,0,0,,77201,-77201
34,08/24/2018,75,18:30,18:45,,37.07,0,37.07,37.07,-1,-76740,158431,235171,81691,0,-77105,0,0,0,,77105,-77105
34,08/24/2018,76,18:45,19:00,,38.39,0,38.39,38.39,-1,-79914,143306,223220,63392,0,-70901,0,0,0,,70901,-70901
34,08/24/2018,77,19:00,19:15,50.2,45.78,0,50.2,50.2,1,-71756,71914,143670,158,0,-21971,630,0,0,,22601,-21341
34,08/24/2018,78,19:15,19:30,50.2,44.12,0,44.12,44.12,-1,-49326,75774,125100,26448,0,-11657,27,0,0,,11684,-11630
34,08/24/2018,79,19:30,19:45,,45.89,0,45.89,45.89,-1,-52776,95428,148204,42652,0,-16526,0,0,0,,16526,-16526
34,08/24/2018,80,19:45,20:00,,45.78,0,45.78,45.78,-1,-64194,107494,171688,43300,0,-16364,0,0,0,,16364,-16364
34,08/24/2018,81,20:00,20:15,,-2.08,0,-2.08,-2.08,-1,-30890,132142,163032,101252,0,-57187,0,0,0,,57187,-57187
34,08/24/2018,82,20:15,20:30,,40.93,0,40.93,40.93,-1,-58885,103239,162124,44354,0,-35934,0,0,0,,35934,-35934
34,08/24/2018,83,20:30,20:45,,43.88,0,43.88,43.88,-1,-58199,98485,156684,40286,0,-30373,0,0,0,,30373,-30373
34,08/24/2018,84,20:45,21:00,127.12,48.88,0,127.12,127.12,1,-109572,49089,158661,-60483,0,-8390,7348,0,0,,15738,-1042
34,08/24/2018,85,21:00,21:15,153.12,48.88,0,153.12,153.12,1,-71769,61914,133683,-9855,0,-9,32686,0,0,,32695,32677
34,08/24/2018,86,21:15,21:30,153.12,-21.13,0,-21.13,-21.13,-1,-43911,121597,165508,77686,0,-35706,2449,0,0,,38155,-33257
34,08/24/2018,87,21:30,21:45,,-28.58,0,-28.58,-28.58,-1,-52716,116080,168796,63364,0,-76301,0,0,0,,76301,-76301
34,08/24/2018,88,21:45,22:00,,32.42,0,32.42,32.42,-1,-30940,107872,138812,76932,0,-70751,0,0,0,,70751,-70751
34,08/24/2018,89,22:00,22:15,48.2,41.66,0,48.2,48.2,1,-83424,73360,156784,-10064,0,-28020,14,0,0,,28034,-28006
34,08/24/2018,90,22:15,22:30,48.2,,0,48.2,48.2,1,-132510,80718,213228,-51792,0,0,1114,0,0,,1114,1114
34,08/24/2018,91,22:30,22:45,48.2,46.52,0,46.52,46.52,-1,-75067,79670,154737,4603,0,-612,137,0,0,,749,-475
34,08/24/2018,92,22:45,23:00,,45.78,0,45.78,45.78,-1,-72165,82437,154602,10272,0,-11363,0,0,0,,11363,-11363
34,08/24/2018,93,23:00,23:15,,52.24,0,52.24,52.24,-1,-100343,42964,143307,-57379,0,-2356,0,0,0,,2356,-2356
34,08/24/2018,94,23:15,23:30,48.2,,0,48.2,48.2,1,-112791,40495,153286,-72296,0,0,1616,0,0,,1616,1616
34,08/24/2018,95,23:30,23:45,56.35,,0,56.35,56.35,1,-97563,41136,138699,-56427,0,0,5040,0,0,,5040,5040
34,08/24/2018,96,23:45,0:00,56.35,52.44,0,52.44,52.44,-1,-87128,69548,156676,-17580,0,-3,483,0,0,,486,480
35,08/25/2018,1,0:00,0:15,,35.63,0,35.63,35.63,-1,-119813,137437,257250,17624,0,-8826,0,0,0,,8826,-8826
35,08/25/2018,2,0:15,0:30,47.33,35.63,0,47.33,47.33,1,-110098,82647,192745,-27451,0,-93,1138,0,0,,1231,1045
35,08/25/2018,3,0:30,0:45,,,0,49.44,49.44,0,-94748,67558,162306,-27190,0,0,0,0,0,,0,0
35,08/25/2018,4,0:45,1:00,51.33,,0,51.33,51.33,1,-144756,91975,236731,-52781,0,0,1278,0,0,,1278,1278
35,08/25/2018,5,1:00,1:15,,51.46,0,51.46,51.46,-1,-93256,97555,190811,4299,0,-268,0,0,0,,268,-268
35,08/25/2018,6,1:15,1:30,,,0,47.75,47.75,0,-103765,81424,185189,-22341,0,0,0,0,0,,0,0
35,08/25/2018,7,1:30,1:45,55.63,,0,55.63,55.63,1,-118282,71259,189541,-47023,0,0,5993,0,0,,5993,5993
35,08/25/2018,8,1:45,2:00,55.63,,0,55.63,55.63,1,-141802,58152,199954,-83650,0,0,15366,0,0,,15366,15366
35,08/25/2018,9,2:00,2:15,55.63,47.06,0,47.06,47.06,-1,-85185,101036,186221,15851,0,-884,1392,0,0,,2276,508
35,08/25/2018,10,2:15,2:30,,51.27,0,51.27,51.27,-1,-87166,77581,164747,-9585,0,-603,0,0,0,,603,-603
35,08/25/2018,11,2:30,2:45,,,0,47.15,47.15,0,-88217,63136,151353,-25081,0,0,0,0,0,,0,0
35,08/25/2018,12,2:45,3:00,,,0,47.15,47.15,0,-103227,53078,156305,-50149,0,0,0,0,0,,0,0
35,08/25/2018,13,3:00,3:15,57.8,,0,57.8,57.8,1,-138432,36864,175296,-101568,0,0,9748,0,0,,9748,9748
35,08/25/2018,14,3:15,3:30,49.33,,0,49.33,49.33,1,-146685,33177,179862,-113508,0,0,8899,0,0,,8899,8899
35,08/25/2018,15,3:30,3:45,71.61,,0,71.61,71.61,1,-155782,35221,191003,-120561,0,0,18083,0,0,,18083,18083
35,08/25/2018,16,3:45,4:00,55.63,,0,55.63,55.63,1,-146696,40508,187204,-106188,0,0,36411,0,0,,36411,36411
35,08/25/2018,17,4:00,4:15,55.63,,0,55.63,55.63,1,-139629,60049,199678,-79580,0,0,40775,0,0,,40775,40775
35,08/25/2018,18,4:15,4:30,51.33,,0,51.33,51.33,1,-115428,72054,187482,-43374,0,0,22865,0,0,,22865,22865
35,08/25/2018,19,4:30,4:45,55.63,,0,55.63,55.63,1,-126190,87326,213516,-38864,0,0,13927,0,0,,13927,13927
35,08/25/2018,20,4:45,5:00,55.63,,0,55.63,55.63,1,-143530,85153,228683,-58377,0,0,30749,0,0,,30749,30749
35,08/25/2018,21,5:00,5:15,55.63,,0,55.63,55.63,1,-134939,70127,205066,-64812,0,0,38255,0,0,,38255,38255
35,08/25/2018,22,5:15,5:30,52.2,,0,52.2,52.2,1,-127243,64786,192029,-62457,0,0,33573,0,0,,33573,33573
35,08/25/2018,23,5:30,5:45,50.04,,0,50.04,50.04,1,-119420,83126,202546,-36294,0,0,16407,0,0,,16407,16407
35,08/25/2018,24,5:45,6:00,55.63,,0,55.63,55.63,1,-130290,82932,213222,-47358,0,0,666,0,0,,666,666
35,08/25/2018,25,6:00,6:15,121.53,,0,121.53,121.53,1,-142218,43296,185514,-98922,0,0,49717,0,0,,49717,49717
35,08/25/2018,26,6:15,6:30,59.67,,0,59.67,59.67,1,-130294,47226,177520,-83068,0,0,49622,0,0,,49622,49622
35,08/25/2018,27,6:30,6:45,52.02,,0,52.02,52.02,1,-122482,53698,176180,-68784,0,0,27525,0,0,,27525,27525
35,08/25/2018,28,6:45,7:00,,,0,43.96,43.96,0,-121409,39259,160668,-82150,0,0,2108,0,0,,2108,2108
35,08/25/2018,29,7:00,7:15,116.47,,0,116.47,116.47,1,-197438,50463,247901,-146975,0,0,15358,0,0,,15358,15358
35,08/25/2018,30,7:15,7:30,54.11,,0,54.11,54.11,1,-158438,43838,202276,-114600,0,0,22989,0,0,,22989,22989
35,08/25/2018,31,7:30,7:45,79.01,,0,79.01,79.01,1,-148113,50160,198273,-97953,0,0,31999,0,0,,31999,31999
35,08/25/2018,32,7:45,8:00,73.98,,0,73.98,73.98,1,-145276,109824,255100,-35452,0,0,48343,0,0,,48343,48343
35,08/25/2018,33,8:00,8:15,66.48,,0,66.48,66.48,1,-188435,93803,282238,-94632,0,0,30147,0,0,,30147,30147
35,08/25/2018,34,8:15,8:30,81.06,,0,81.06,81.06,1,-173762,82602,256364,-91160,0,0,63176,0,0,,63176,63176
35,08/25/2018,35,8:30,8:45,87.02,,0,87.02,87.02,1,-165081,54524,219605,-110557,0,0,95318,0,0,,95318,95318
35,08/25/2018,36,8:45,9:00,71.31,,0,71.31,71.31,1,-141441,56865,198306,-84576,0,0,83494,0,0,,83494,83494
35,08/25/2018,37,9:00,9:15,51.25,47.46,0,51.25,47.38,2,-79147,86281,165428,7134,0,-162,21191,0,0,,21353,21029
35,08/25/2018,38,9:15,9:30,,,0,47.37,47.37,0,-77129,93106,170235,15977,0,0,0,0,0,,0,0
35,08/25/2018,39,9:30,9:45,47.25,,0,47.25,47.25,1,-82737,78773,161510,-3964,0,0,266,0,0,,266,266
35,08/25/2018,40,9:45,10:00,46.02,,0,46.02,46.02,1,-69917,87917,157834,18000,0,0,231,0,0,,231,231
35,08/25/2018,41,10:00,10:15,,39.25,0,39.25,39.25,-1,-69075,89581,158656,20506,0,-8744,0,0,0,,8744,-8744
35,08/25/2018,42,10:15,10:30,,21.31,0,21.31,21.31,-1,-63537,118313,181850,54776,0,-35925,0,0,0,,35925,-35925
35,08/25/2018,43,10:30,10:45,,21.31,0,21.31,21.31,-1,-56530,107291,163821,50761,0,-48966,0,0,0,,48966,-48966
35,08/25/2018,44,10:45,11:00,,20.15,0,20.15,20.15,-1,-28130,109298,137428,81168,0,-69361,0,0,0,,69361,-69361
35,08/25/2018,45,11:00,11:15,,26.52,0,26.52,26.52,-1,-41204,87103,128307,45899,0,-42463,0,0,0,,42463,-42463
35,08/25/2018,46,11:15,11:30,,21.31,0,21.31,21.31,-1,-44742,75639,120381,30897,0,-43558,0,0,0,,43558,-43558
35,08/25/2018,47,11:30,11:45,,35.49,0,35.49,35.49,-1,-47703,87246,134949,39543,0,-27451,0,0,0,,27451,-27451
35,08/25/2018,48,11:45,12:00,,39.25,0,39.25,39.25,-1,-42394,71121,113515,28727,0,-28003,0,0,0,,28003,-28003
35,08/25/2018,49,12:00,12:15,,35.49,0,35.49,35.49,-1,-54600,89140,143740,34540,0,-31267,0,0,0,,31267,-31267
35,08/25/2018,50,12:15,12:30,,39.25,0,39.25,39.25,-1,-62494,70654,133148,8160,0,-25096,0,0,0,,25096,-25096
35,08/25/2018,51,12:30,12:45,55.49,39.25,0,55.49,55.49,1,-61629,49025,110654,-12604,0,-2999,6344,0,0,,9343,3345
35,08/25/2018,52,12:45,13:00,48.69,47.93,0,48.69,45.48,2,-49152,45909,95061,-3243,0,-75,144,0,0,,219,69
35,08/25/2018,53,13:00,13:15,60.71,,0,60.71,60.71,1,-96012,51565,147577,-44447,0,0,22996,0,0,,22996,22996
35,08/25/2018,54,13:15,13:30,51.25,30.82,0,51.25,30.82,2,-64662,77061,141723,12399,0,-1841,21685,0,0,,23526,19844
35,08/25/2018,55,13:30,13:45,51.25,31.03,0,31.03,31.03,-1,-74977,80029,155006,5052,0,-4958,817,0,0,,5775,-4141
35,08/25/2018,56,13:45,14:00,51.25,43.25,0,51.25,43.25,2,-52332,51552,103884,-780,0,-4770,273,0,0,,5043,-4497
35,08/25/2018,57,14:00,14:15,71.31,43.25,0,71.31,71.31,1,-76637,31864,108501,-44773,0,-324,28191,0,0,,28515,27867
35,08/25/2018,58,14:15,14:30,52.13,45.02,0,45.02,45.02,-1,-53900,51350,105250,-2550,0,-177,23910,0,0,,24087,23733
35,08/25/2018,59,14:30,14:45,52.13,42.44,0,42.44,42.44,-1,-58882,65076,123958,6194,0,-1171,1032,0,0,,2203,-139
35,08/25/2018,60,14:45,15:00,,30.59,0,30.59,30.59,-1,-70718,102239,172957,31521,0,-10089,0,0,0,,10089,-10089
35,08/25/2018,61,15:00,15:15,,-28.47,0,-28.47,-28.47,-1,-60179,111762,171941,51583,0,-57952,0,0,0,,57952,-57952
35,08/25/2018,62,15:15,15:30,75.1,-28.47,0,75.1,75.1,1,-67362,43538,110900,-23824,0,-6282,8823,0,0,,15105,2541
35,08/25/2018,63,15:30,15:45,75.1,36.88,0,36.88,36.88,-1,-46781,72618,119399,25837,0,-12493,179,0,0,,12672,-12314
35,08/25/2018,64,15:45,16:00,,21.31,0,21.31,21.31,-1,-48171,96301,144472,48130,0,-22891,0,0,0,,22891,-22891
35,08/25/2018,65,16:00,16:15,,21.31,0,21.31,21.31,-1,-34916,70400,105316,35484,0,-40208,0,0,0,,40208,-40208
35,08/25/2018,66,16:15,16:30,,43.03,0,43.03,43.03,-1,-44935,60536,105471,15601,0,-21087,0,0,0,,21087,-21087
35,08/25/2018,67,16:30,16:45,48.8,41.5,0,48.8,41.5,2,-75772,78666,154438,2894,0,-12162,180,0,0,,12342,-11982
35,08/25/2018,68,16:45,17:00,49.27,34.03,0,49.27,34.03,2,-80977,105950,186927,24973,0,-8161,935,0,0,,9096,-7226
35,08/25/2018,69,17:00,17:15,,36.24,0,36.24,36.24,-1,-65687,100998,166685,35311,0,-22281,0,0,0,,22281,-22281
35,08/25/2018,70,17:15,17:30,51.25,43.25,0,51.25,43.25,2,-56562,58625,115187,2063,0,-19901,109,0,0,,20010,-19792
35,08/25/2018,71,17:30,17:45,88.05,43.25,0,88.05,88.05,1,-115319,63399,178718,-51920,0,-2293,32207,0,0,,34500,29914
35,08/25/2018,72,17:45,18:00,55.49,,0,55.49,55.49,1,-126528,93101,219629,-33427,0,0,37144,0,0,,37144,37144
35,08/25/2018,73,18:00,18:15,49.42,-44.1,0,49.42,-44.1,2,-37274,93279,130553,56005,0,-17070,11401,0,0,,28471,-5669
35,08/25/2018,74,18:15,18:30,48.84,42.61,0,48.84,48.84,1,-83644,52080,135724,-31564,0,-9489,238,0,0,,9727,-9251
35,08/25/2018,75,18:30,18:45,51.25,,0,51.25,51.25,1,-106651,64339,170990,-42312,0,0,1769,0,0,,1769,1769
35,08/25/2018,76,18:45,19:00,51.25,,0,51.25,51.25,1,-74947,39527,114474,-35420,0,0,4360,0,0,,4360,4360
35,08/25/2018,77,19:00,19:15,49.54,,0,49.54,49.54,1,-110514,76177,186691,-34337,0,0,4562,0,0,,4562,4562
35,08/25/2018,78,19:15,19:30,55.49,,0,55.49,55.49,1,-93603,57483,151086,-36120,0,0,3881,0,0,,3881,3881
35,08/25/2018,79,19:30,19:45,61.32,,0,61.32,61.32,1,-90492,61415,151907,-29077,0,0,23735,0,0,,23735,23735
35,08/25/2018,80,19:45,20:00,49.15,35.49,0,35.49,35.49,-1,-68124,81109,149233,12985,0,-1676,7619,0,0,,9295,5943
35,08/25/2018,81,20:00,20:15,49.15,-46.08,0,-46.08,-46.08,-1,-23080,83317,106397,60237,0,-29549,12,0,0,,29561,-29537
35,08/25/2018,82,20:15,20:30,,39.25,0,39.25,39.25,-1,-48841,82244,131085,33403,0,-9716,0,0,0,,9716,-9716
35,08/25/2018,83,20:30,20:45,,37.25,0,37.25,37.25,-1,-62533,80685,143218,18152,0,-15008,0,0,0,,15008,-15008
35,08/25/2018,84,20:45,21:00,121.53,37.25,0,121.53,121.53,1,-111594,75065,186659,-36529,0,-3667,11069,0,0,,14736,7402
35,08/25/2018,85,21:00,21:15,55.49,45.2,0,55.49,45.2,2,-79427,75774,155201,-3653,0,-545,7733,0,0,,8278,7188
35,08/25/2018,86,21:15,21:30,161.02,,0,161.02,161.02,1,-89730,51788,141518,-37942,0,0,34883,0,0,,34883,34883
35,08/25/2018,87,21:30,21:45,161.02,23.62,0,23.62,23.62,-1,-65740,97512,163252,31772,0,-17317,4287,0,0,,21604,-13030
35,08/25/2018,88,21:45,22:00,,39.25,0,39.25,39.25,-1,-80279,93433,173712,13154,0,-20172,0,0,0,,20172,-20172
35,08/25/2018,89,22:00,22:15,,33.3,0,33.3,33.3,-1,-81051,119329,200380,38278,0,-37344,0,0,0,,37344,-37344
35,08/25/2018,90,22:15,22:30,,43.25,0,43.25,43.25,-1,-84431,92815,177246,8384,0,-14644,0,0,0,,14644,-14644
35,08/25/2018,91,22:30,22:45,,43.25,0,43.25,43.25,-1,-82852,99058,181910,16206,0,-5383,0,0,0,,5383,-5383
35,08/25/2018,92,22:45,23:00,,35.49,0,35.49,35.49,-1,-71796,113130,184926,41334,0,-23805,0,0,0,,23805,-23805
35,08/25/2018,93,23:00,23:15,,39.25,0,39.25,39.25,-1,-83640,87994,171634,4354,0,-21361,0,0,0,,21361,-21361
35,08/25/2018,94,23:15,23:30,,12.2,0,12.2,12.2,-1,-54283,98581,152864,44298,0,-13196,0,0,0,,13196,-13196
35,08/25/2018,95,23:30,23:45,,21.31,0,21.31,21.31,-1,-52447,84898,137345,32451,0,-38111,0,0,0,,38111,-38111
35,08/25/2018,96,23:45,0:00,,20.15,0,20.15,20.15,-1,-45329,114345,159674,69016,0,-39376,0,0,0,,39376,-39376
35,08/26/2018,1,0:00,0:15,,-147.07,0,-147.07,-147.07,-1,-61316,103591,164907,42275,0,-58800,0,0,0,,58800,-58800
35,08/26/2018,2,0:15,0:30,56.02,19.97,0,56.02,19.97,2,-44921,95614,140535,50693,0,-12298,398,0,0,,12696,-11900
35,08/26/2018,3,0:30,0:45,,5.42,0,5.42,5.42,-1,-50152,85056,135208,34904,0,-44296,0,0,0,,44296,-44296
35,08/26/2018,4,0:45,1:00,,40.78,0,40.78,40.78,-1,-65778,92503,158281,26725,0,-27389,0,0,0,,27389,-27389
35,08/26/2018,5,1:00,1:15,,36.02,0,36.02,36.02,-1,-29445,59670,89115,30225,0,-35857,0,0,0,,35857,-35857
35,08/26/2018,6,1:15,1:30,51.72,12.27,0,51.72,12.27,2,-22530,68320,90850,45790,0,-11913,701,0,0,,12614,-11212
35,08/26/2018,7,1:30,1:45,,13.02,0,13.02,13.02,-1,-29321,86426,115747,57105,0,-54320,0,0,0,,54320,-54320
35,08/26/2018,8,1:45,2:00,,40.78,0,40.78,40.78,-1,-39625,88962,128587,49337,0,-49514,0,0,0,,49514,-49514
35,08/26/2018,9,2:00,2:15,,38.78,0,38.78,38.78,-1,-72503,99913,172416,27410,0,-28487,0,0,0,,28487,-28487
35,08/26/2018,10,2:15,2:30,,47.03,0,47.03,47.03,-1,-55872,68767,124639,12895,0,-9739,0,0,0,,9739,-9739
35,08/26/2018,11,2:30,2:45,,45.8,0,45.8,45.8,-1,-48749,61847,110596,13098,0,-8046,0,0,0,,8046,-8046
35,08/26/2018,12,2:45,3:00,,44.78,0,44.78,44.78,-1,-67015,75235,142250,8220,0,-12397,0,0,0,,12397,-12397
35,08/26/2018,13,3:00,3:15,,43.72,0,43.72,43.72,-1,-41517,70797,112314,29280,0,-8948,0,0,0,,8948,-8948
35,08/26/2018,14,3:15,3:30,,,0,47.41,47.41,0,-47785,56350,104135,8565,0,-2516,0,0,0,,2516,-2516
35,08/26/2018,15,3:30,3:45,,43.72,0,43.72,43.72,-1,-43077,50884,93961,7807,0,-124,0,0,0,,124,-124
35,08/26/2018,16,3:45,4:00,,36.02,0,36.02,36.02,-1,-31450,53327,84777,21877,0,-16946,0,0,0,,16946,-16946
35,08/26/2018,17,4:00,4:15,,39.72,0,39.72,39.72,-1,-12980,86995,99975,74015,0,-15563,0,0,0,,15563,-15563
35,08/26/2018,18,4:15,4:30,,,0,45.65,45.65,0,-25334,79378,104712,54044,0,-197,0,0,0,,197,-197
35,08/26/2018,19,4:30,4:45,,,0,45.66,45.66,0,-36592,72986,109578,36394,0,0,0,0,0,,0,0
35,08/26/2018,20,4:45,5:00,,,0,45.66,45.66,0,-46167,73104,119271,26937,0,0,0,0,0,,0,0
35,08/26/2018,21,5:00,5:15,,,0,45.65,45.65,0,-38724,93614,132338,54890,0,0,0,0,0,,0,0
35,08/26/2018,22,5:15,5:30,,45.45,0,45.45,45.45,-1,-40624,92306,132930,51682,0,-1405,0,0,0,,1405,-1405
35,08/26/2018,23,5:30,5:45,,43.72,0,43.72,43.72,-1,-37355,93384,130739,56029,0,-2105,0,0,0,,2105,-2105
35,08/26/2018,24,5:45,6:00,,48.17,0,48.17,48.17,-1,-47720,70860,118580,23140,0,-502,0,0,0,,502,-502
35,08/26/2018,25,6:00,6:15,,48.08,0,48.08,48.08,-1,-41746,88536,130282,46790,0,-323,0,0,0,,323,-323
35,08/26/2018,26,6:15,6:30,,,0,44.06,44.06,0,-38904,73311,112215,34407,0,0,0,0,0,,0,0
35,08/26/2018,27,6:30,6:45,,,0,44.06,44.06,0,-28658,81322,109980,52664,0,0,0,0,0,,0,0
35,08/26/2018,28,6:45,7:00,,,0,44.06,44.06,0,-25560,82431,107991,56871,0,0,0,0,0,,0,0
35,08/26/2018,29,7:00,7:15,,43.81,0,43.81,43.81,-1,-11180,94789,105969,83609,0,-1480,0,0,0,,1480,-1480
35,08/26/2018,30,7:15,7:30,,47.61,0,47.61,47.61,-1,-18746,76952,95698,58206,0,-1501,0,0,0,,1501,-1501
35,08/26/2018,31,7:30,7:45,,47.85,0,47.85,47.85,-1,-16601,86673,103274,70072,0,-1121,0,0,0,,1121,-1121
35,08/26/2018,32,7:45,8:00,,47.97,0,47.97,47.97,-1,-16013,115009,131022,98996,0,-25,0,0,0,,25,-25
35,08/26/2018,33,8:00,8:15,,31.28,0,31.28,31.28,-1,-38658,86641,125299,47983,0,-22941,0,0,0,,22941,-22941
35,08/26/2018,34,8:15,8:30,,36.11,0,36.11,36.11,-1,-28962,89304,118266,60342,0,-26296,0,0,0,,26296,-26296
35,08/26/2018,35,8:30,8:45,,36.11,0,36.11,36.11,-1,-29557,77547,107104,47990,0,-34358,0,0,0,,34358,-34358
35,08/26/2018,36,8:45,9:00,,42.98,0,42.98,42.98,-1,-17880,79214,97094,61334,0,-28846,0,0,0,,28846,-28846
35,08/26/2018,37,9:00,9:15,,42.98,0,42.98,42.98,-1,-38594,100628,139222,62034,0,-21856,0,0,0,,21856,-21856
35,08/26/2018,38,9:15,9:30,,47.98,0,47.98,47.98,-1,-42087,115724,157811,73637,0,-2141,0,0,0,,2141,-2141
35,08/26/2018,39,9:30,9:45,,39.83,0,39.83,39.83,-1,-49428,142261,191689,92833,0,-5569,0,0,0,,5569,-5569
35,08/26/2018,40,9:45,10:00,,36.06,0,36.06,36.06,-1,-41356,166311,207667,124955,0,-37997,0,0,0,,37997,-37997
35,08/26/2018,41,10:00,10:15,,36.06,0,36.06,36.06,-1,-36001,135713,171714,99712,0,-46572,0,0,0,,46572,-46572
35,08/26/2018,42,10:15,10:30,,-2.96,0,-2.96,-2.96,-1,-30746,167274,198020,136528,0,-67003,0,0,0,,67003,-67003
35,08/26/2018,43,10:30,10:45,,-40.97,0,-40.97,-40.97,-1,-33560,146645,180205,113085,0,-106917,0,0,0,,106917,-106917
35,08/26/2018,44,10:45,11:00,,-27.9,0,-27.9,-27.9,-1,-27901,160795,188696,132894,0,-102999,0,0,0,,102999,-102999
35,08/26/2018,45,11:00,11:15,,-99.98,0,-99.98,-99.98,-1,-19246,123661,142907,104415,0,-98470,0,0,0,,98470,-98470
35,08/26/2018,46,11:15,11:30,,31.34,0,31.34,31.34,-1,-12666,137779,150445,125113,0,-58946,0,0,0,,58946,-58946
35,08/26/2018,47,11:30,11:45,,36.06,0,36.06,36.06,-1,-11962,158238,170200,146276,0,-30076,0,0,0,,30076,-30076
35,08/26/2018,48,11:45,12:00,,2.51,0,2.51,2.51,-1,-9075,180390,189465,171315,0,-31588,0,0,0,,31588,-31588
35,08/26/2018,49,12:00,12:15,,-41.2,0,-41.2,-41.2,-1,-5220,121917,127137,116697,0,-45294,0,0,0,,45294,-45294
35,08/26/2018,50,12:15,12:30,,-46.08,0,-46.08,-46.08,-1,-4271,139307,143578,135036,0,-67118,0,0,0,,67118,-67118
35,08/26/2018,51,12:30,12:45,,29.78,0,29.78,29.78,-1,-3184,152317,155501,149133,0,-61908,0,0,0,,61908,-61908
35,08/26/2018,52,12:45,13:00,,12.75,0,12.75,12.75,-1,-16458,140223,156681,123765,0,-62181,0,0,0,,62181,-62181
35,08/26/2018,53,13:00,13:15,,-77.44,0,-77.44,-77.44,-1,-20280,134085,154365,113805,0,-45638,0,0,0,,45638,-45638
35,08/26/2018,54,13:15,13:30,,-130.94,0,-130.94,-130.94,-1,-19165,113784,132949,94619,0,-61614,0,0,0,,61614,-61614
35,08/26/2018,55,13:30,13:45,,34.78,0,34.78,34.78,-1,-70319,119241,189560,48922,0,-49441,0,0,0,,49441,-49441
35,08/26/2018,56,13:45,14:00,,21.88,0,21.88,21.88,-1,-78993,162099,241092,83106,0,-65710,0,0,0,,65710,-65710
35,08/26/2018,57,14:00,14:15,,21.88,0,21.88,21.88,-1,-76031,136290,212321,60259,0,-44802,0,0,0,,44802,-44802
35,08/26/2018,58,14:15,14:30,47.81,43.81,0,47.81,42.12,2,-113442,100131,213573,-13311,0,-106,253,0,0,,359,147
35,08/26/2018,59,14:30,14:45,,36.06,0,36.06,36.06,-1,-85078,113186,198264,28108,0,-9907,0,0,0,,9907,-9907
35,08/26/2018,60,14:45,15:00,,36.06,0,36.06,36.06,-1,-90185,109002,199187,18817,0,-19958,0,0,0,,19958,-19958
35,08/26/2018,61,15:00,15:15,,36.06,0,36.06,36.06,-1,-76384,108460,184844,32076,0,-21525,0,0,0,,21525,-21525
35,08/26/2018,62,15:15,15:30,,36.06,0,36.06,36.06,-1,-83883,100854,184737,16971,0,-5593,0,0,0,,5593,-5593
35,08/26/2018,63,15:30,15:45,,36.06,0,36.06,36.06,-1,-82213,109959,192172,27746,0,-15177,0,0,0,,15177,-15177
35,08/26/2018,64,15:45,16:00,,38.88,0,38.88,38.88,-1,-93688,110083,203771,16395,0,-12625,0,0,0,,12625,-12625
35,08/26/2018,65,16:00,16:15,,44.78,0,44.78,44.78,-1,-56047,73665,129712,17618,0,-11334,0,0,0,,11334,-11334
35,08/26/2018,66,16:15,16:30,,47.82,0,47.82,47.82,-1,-92313,65899,158212,-26414,0,-1201,0,0,0,,1201,-1201
35,08/26/2018,67,16:30,16:45,47.81,,0,47.81,47.81,1,-120226,69203,189429,-51023,0,0,156,0,0,,156,156
35,08/26/2018,68,16:45,17:00,,,0,44.11,44.11,0,-159706,69855,229561,-89851,0,0,0,0,0,,0,0
35,08/26/2018,69,17:00,17:15,,39.81,0,39.81,39.81,-1,-34914,89902,124816,54988,0,-2316,0,0,0,,2316,-2316
35,08/26/2018,70,17:15,17:30,,37.85,0,37.85,37.85,-1,-51899,89773,141672,37874,0,-8471,0,0,0,,8471,-8471
35,08/26/2018,71,17:30,17:45,,,0,46.1,46.1,0,-79006,87758,166764,8752,0,-248,0,0,0,,248,-248
35,08/26/2018,72,17:45,18:00,47.81,,0,47.81,47.81,1,-88657,110290,198947,21633,0,0,3,0,0,,3,3
35,08/26/2018,73,18:00,18:15,51.83,,0,51.83,51.83,1,-108360,42634,150994,-65726,0,0,6689,0,0,,6689,6689
35,08/26/2018,74,18:15,18:30,47.81,,0,47.81,47.81,1,-47986,75084,123070,27098,0,0,3969,0,0,,3969,3969
35,08/26/2018,75,18:30,18:45,47.81,39.81,0,39.81,39.81,-1,-48956,105446,154402,56490,0,-1332,6,0,0,,1338,-1326
35,08/26/2018,76,18:45,19:00,,,0,47.93,47.93,0,-47533,121611,169144,74078,0,0,0,0,0,,0,0
35,08/26/2018,77,19:00,19:15,,47.03,0,47.03,47.03,-1,-66708,83205,149913,16497,0,-420,0,0,0,,420,-420
35,08/26/2018,78,19:15,19:30,,,0,47.93,47.93,0,-60922,89057,149979,28135,0,0,0,0,0,,0,0
35,08/26/2018,79,19:30,19:45,,,0,47.93,47.93,0,-47134,90102,137236,42968,0,0,0,0,0,,0,0
35,08/26/2018,80,19:45,20:00,,,0,47.93,47.93,0,-36887,93509,130396,56622,0,0,0,0,0,,0,0
35,08/26/2018,81,20:00,20:15,,51.73,0,51.73,51.73,-1,-63065,92937,156002,29872,0,-22,0,0,0,,22,-22
35,08/26/2018,82,20:15,20:30,,45.78,0,45.78,45.78,-1,-87653,80253,167906,-7400,0,-1549,0,0,0,,1549,-1549
35,08/26/2018,83,20:30,20:45,,,0,47.93,47.93,0,-85645,77242,162887,-8403,0,0,0,0,0,,0,0
35,08/26/2018,84,20:45,21:00,53.38,,0,53.38,53.38,1,-72983,66367,139350,-6616,0,0,1015,0,0,,1015,1015
35,08/26/2018,85,21:00,21:15,47.81,,0,47.81,47.81,1,-85079,105861,190940,20782,0,0,943,0,0,,943,943
35,08/26/2018,86,21:15,21:30,,,0,47.92,47.92,0,-44118,122276,166394,78158,0,0,56,0,0,,56,56
35,08/26/2018,87,21:30,21:45,,-61.45,0,-61.45,-61.45,-1,-39001,132103,171104,93102,0,-5729,0,0,0,,5729,-5729
35,08/26/2018,88,21:45,22:00,,-127.84,0,-127.84,-127.84,-1,-52103,98425,150528,46322,0,-38723,0,0,0,,38723,-38723
35,08/26/2018,89,22:00,22:15,122.1,46.08,0,122.1,46.08,2,-130091,43306,173397,-86785,0,-6740,7904,0,0,,14644,1164
35,08/26/2018,90,22:15,22:30,56.06,,0,56.06,56.06,1,-113084,47706,160790,-65378,0,0,13038,0,0,,13038,13038
35,08/26/2018,91,22:30,22:45,51.81,,0,51.81,51.81,1,-72108,60943,133051,-11165,0,0,10704,0,0,,10704,10704
35,08/26/2018,92,22:45,23:00,51.81,39.81,0,39.81,39.81,-1,-68883,110552,179435,41669,0,-8217,980,0,0,,9197,-7237
35,08/26/2018,93,23:00,23:15,51.81,48.25,0,51.81,44.3,2,-144066,58187,202253,-85879,0,-907,1380,0,0,,2287,473
35,08/26/2018,94,23:15,23:30,,,0,44.3,44.3,0,-141118,73958,215076,-67160,0,0,97,0,0,,97,97
35,08/26/2018,95,23:30,23:45,,,0,44.31,44.31,0,-114174,82075,196249,-32099,0,0,0,0,0,,0,0
35,08/26/2018,96,23:45,0:00,,39.81,0,39.81,39.81,-1,-91627,105830,197457,14203,0,-3487,0,0,0,,3487,-3487
35,08/27/2018,1,0:00,0:15,60.71,38.92,0,60.71,38.92,2,-80446,55313,135759,-25133,0,-4056,3550,0,0,,7606,-506
35,08/27/2018,2,0:15,0:30,70.81,46.04,0,70.81,45.51,2,-67612,55088,122700,-12524,0,-31,20163,0,0,,20194,20132
35,08/27/2018,3,0:30,0:45,70.81,22.1,0,22.1,22.1,-1,-56142,100263,156405,44121,0,-28169,931,0,0,,29100,-27238
35,08/27/2018,4,0:45,1:00,,-29.78,0,-29.78,-29.78,-1,-66376,95443,161819,29067,0,-44049,0,0,0,,44049,-44049
35,08/27/2018,5,1:00,1:15,76.91,-150.03,0,76.91,-150.03,2,-72585,63799,136384,-8786,0,-36267,2612,0,0,,38879,-33655
35,08/27/2018,6,1:15,1:30,120.31,-150.03,0,120.31,120.31,1,-70373,53024,123397,-17349,0,-197,19640,0,0,,19837,19443
35,08/27/2018,7,1:30,1:45,120.31,47.63,0,47.63,47.63,-1,-65421,68543,133964,3122,0,-21,292,0,0,,313,271
35,08/27/2018,8,1:45,2:00,49.34,44.71,0,49.34,44.08,2,-84687,61349,146036,-23338,0,-697,732,0,0,,1429,35
35,08/27/2018,9,2:00,2:15,,-159.73,0,-159.73,-159.73,-1,-65876,149343,215219,83467,0,-31790,0,0,0,,31790,-31790
35,08/27/2018,10,2:15,2:30,,-5.5,0,-5.5,-5.5,-1,-68379,115851,184230,47472,0,-42880,0,0,0,,42880,-42880
35,08/27/2018,11,2:30,2:45,,33.03,0,33.03,33.03,-1,-77978,123772,201750,45794,0,-41729,0,0,0,,41729,-41729
35,08/27/2018,12,2:45,3:00,,35.93,0,35.93,35.93,-1,-101545,122795,224340,21250,0,-37654,0,0,0,,37654,-37654
35,08/27/2018,13,3:00,3:15,47.81,35.93,0,47.81,47.81,1,-69161,67770,136931,-1391,0,-6251,2076,0,0,,8327,-4175
35,08/27/2018,14,3:15,3:30,53.52,,0,53.52,53.52,1,-73673,52274,125947,-21399,0,0,10358,0,0,,10358,10358
35,08/27/2018,15,3:30,3:45,47.81,,0,47.81,47.81,1,-68429,57566,125995,-10863,0,0,13482,0,0,,13482,13482
35,08/27/2018,16,3:45,4:00,57.1,,0,57.1,57.1,1,-92855,58143,150998,-34712,0,0,17876,0,0,,17876,17876
35,08/27/2018,17,4:00,4:15,57.1,-55.74,0,-55.74,-55.74,-1,-49520,93483,143003,43963,0,-15338,5939,0,0,,21277,-9399
35,08/27/2018,18,4:15,4:30,,38.53,0,38.53,38.53,-1,-61996,79725,141721,17729,0,-13761,0,0,0,,13761,-13761
35,08/27/2018,19,4:30,4:45,,38.77,0,38.77,38.77,-1,-60254,65658,125912,5404,0,-13003,0,0,0,,13003,-13003
35,08/27/2018,20,4:45,5:00,45.02,22.1,0,45.02,22.1,2,-62040,63767,125807,1727,0,-3208,1612,0,0,,4820,-1596
35,08/27/2018,21,5:00,5:15,,-150.03,0,-150.03,-150.03,-1,-27696,136882,164578,109186,0,-68682,0,0,0,,68682,-68682
35,08/27/2018,22,5:15,5:30,,-53.11,0,-53.11,-53.11,-1,-52574,105969,158543,53395,0,-74162,0,0,0,,74162,-74162
35,08/27/2018,23,5:30,5:45,,36.11,0,36.11,36.11,-1,-79295,101477,180772,22182,0,-27636,0,0,0,,27636,-27636
35,08/27/2018,24,5:45,6:00,51.26,36.11,0,51.26,51.26,1,-109176,90790,199966,-18386,0,-6283,951,0,0,,7234,-5332
35,08/27/2018,25,6:00,6:15,237.8,,0,237.8,237.8,1,-145402,47091,192493,-98311,0,0,46138,0,0,,46138,46138
35,08/27/2018,26,6:15,6:30,66.02,40.06,0,40.06,40.06,-1,-56421,66368,122789,9947,0,-972,28791,0,0,,29763,27819
35,08/27/2018,27,6:30,6:45,,36.36,0,36.36,36.36,-1,-44066,65124,109190,21058,0,-9996,0,0,0,,9996,-9996
35,08/27/2018,28,6:45,7:00,,36.36,0,36.36,36.36,-1,-47517,80701,128218,33184,0,-16941,0,0,0,,16941,-16941
35,08/27/2018,29,7:00,7:15,,-11.11,0,-11.11,-11.11,-1,-36840,105078,141918,68238,0,-52288,0,0,0,,52288,-52288
35,08/27/2018,30,7:15,7:30,,40.06,0,40.06,40.06,-1,-47697,56091,103788,8394,0,-18595,0,0,0,,18595,-18595
35,08/27/2018,31,7:30,7:45,57.37,48.37,0,57.37,57.37,1,-68841,45018,113859,-23823,0,-814,1584,0,0,,2398,770
35,08/27/2018,32,7:45,8:00,57.37,,0,57.37,57.37,1,-111747,66477,178224,-45270,0,0,9651,0,0,,9651,9651
35,08/27/2018,33,8:00,8:15,82.67,,0,82.67,82.67,1,-131613,63725,195338,-67888,0,0,30841,0,0,,30841,30841
35,08/27/2018,34,8:15,8:30,53.14,,0,53.14,53.14,1,-90663,69535,160198,-21128,0,0,16353,0,0,,16353,16353
35,08/27/2018,35,8:30,8:45,57.37,,0,57.37,57.37,1,-109560,73875,183435,-35685,0,0,18916,0,0,,18916,18916
35,08/27/2018,36,8:45,9:00,122.37,,0,122.37,122.37,1,-124146,65332,189478,-58814,0,0,34112,0,0,,34112,34112
35,08/27/2018,37,9:00,9:15,152.02,,0,152.02,152.02,1,-115392,53218,168610,-62174,0,0,53445,0,0,,53445,53445
35,08/27/2018,38,9:15,9:30,57.37,,0,57.37,57.37,1,-116153,63221,179374,-52932,0,0,46768,0,0,,46768,46768
35,08/27/2018,39,9:30,9:45,57.37,,0,57.37,57.37,1,-98960,70430,169390,-28530,0,0,34645,0,0,,34645,34645
35,08/27/2018,40,9:45,10:00,57.37,46.89,0,46.89,46.89,-1,-76380,69658,146038,-6722,0,-1524,6458,0,0,,7982,4934
35,08/27/2018,41,10:00,10:15,57.37,43.03,0,57.37,43.03,2,-64848,76728,141576,11880,0,-1726,3377,0,0,,5103,1651
35,08/27/2018,42,10:15,10:30,48.96,,0,48.96,48.96,1,-56345,74855,131200,18510,0,0,3289,0,0,,3289,3289
35,08/27/2018,43,10:30,10:45,48.02,40.82,0,48.02,40.82,2,-42913,80636,123549,37723,0,-1746,645,0,0,,2391,-1101
35,08/27/2018,44,10:45,11:00,,36.89,0,36.89,36.89,-1,-40838,89270,130108,48432,0,-18960,0,0,0,,18960,-18960
35,08/27/2018,45,11:00,11:15,,36.89,0,36.89,36.89,-1,-43793,68517,112310,24724,0,-28045,0,0,0,,28045,-28045
35,08/27/2018,46,11:15,11:30,49.93,45.03,0,49.93,49.93,1,-46688,63090,109778,16402,0,-13425,918,0,0,,14343,-12507
35,08/27/2018,47,11:30,11:45,48.96,45.03,0,48.96,48.96,1,-43675,61963,105638,18288,0,-205,556,0,0,,761,351
35,08/27/2018,48,11:45,12:00,48.02,40.25,0,40.25,40.25,-1,-35968,81147,117115,45179,0,-2995,158,0,0,,3153,-2837
35,08/27/2018,49,12:00,12:15,,27.52,0,27.52,27.52,-1,-46319,74841,121160,28522,0,-31250,0,0,0,,31250,-31250
35,08/27/2018,50,12:15,12:30,,40.82,0,40.82,40.82,-1,-40830,76730,117560,35900,0,-31633,0,0,0,,31633,-31633
35,08/27/2018,51,12:30,12:45,,40.82,0,40.82,40.82,-1,-48780,70020,118800,21240,0,-35041,0,0,0,,35041,-35041
35,08/27/2018,52,12:45,13:00,,44.82,0,44.82,44.82,-1,-48181,63999,112180,15818,0,-21142,0,0,0,,21142,-21142
35,08/27/2018,53,13:00,13:15,51.37,49.85,0,51.37,47.44,2,-57545,58636,116181,1091,0,-7099,1684,0,0,,8783,-5415
35,08/27/2018,54,13:15,13:30,48.96,,0,48.96,48.96,1,-49040,53172,102212,4132,0,0,1591,0,0,,1591,1591
35,08/27/2018,55,13:30,13:45,53.14,,0,53.14,53.14,1,-55930,42110,98040,-13820,0,0,7634,0,0,,7634,7634
35,08/27/2018,56,13:45,14:00,53.14,,0,53.14,53.14,1,-58871,41249,100120,-17622,0,0,19934,0,0,,19934,19934
35,08/27/2018,57,14:00,14:15,57.37,,0,57.37,57.37,1,-65399,37121,102520,-28278,0,0,23618,0,0,,23618,23618
35,08/27/2018,58,14:15,14:30,48.96,46.85,0,46.85,46.85,-1,-45240,41157,86397,-4083,0,-446,10039,0,0,,10485,9593
35,08/27/2018,59,14:30,14:45,48.96,,0,48.96,48.96,1,-57570,42391,99961,-15179,0,0,1231,0,0,,1231,1231
35,08/27/2018,60,14:45,15:00,53.14,,0,53.14,53.14,1,-57393,48692,106085,-8701,0,0,7902,0,0,,7902,7902
35,08/27/2018,61,15:00,15:15,57.37,48.13,0,57.37,46.41,2,-57200,98245,155445,41045,0,-208,5367,0,0,,5575,5159
35,08/27/2018,62,15:15,15:30,72.28,,0,72.28,72.28,1,-50635,72396,123031,21761,0,0,22205,0,0,,22205,22205
35,08/27/2018,63,15:30,15:45,72.28,,0,72.28,72.28,1,-72871,57219,130090,-15652,0,0,54258,0,0,,54258,54258
35,08/27/2018,64,15:45,16:00,152.02,,0,152.02,152.02,1,-91409,57537,148946,-33872,0,0,76270,0,0,,76270,76270
35,08/27/2018,65,16:00,16:15,152.02,40.82,0,40.82,40.82,-1,-71925,93197,165122,21272,0,-2269,19518,0,0,,21787,17249
35,08/27/2018,66,16:15,16:30,57.37,40.82,0,57.37,57.37,1,-84212,56370,140582,-27842,0,-176,7242,0,0,,7418,7066
35,08/27/2018,67,16:30,16:45,50.27,,0,50.27,50.27,1,-74939,68127,143066,-6812,0,0,7321,0,0,,7321,7321
35,08/27/2018,68,16:45,17:00,49.89,,0,49.89,49.89,1,-86323,69777,156100,-16546,0,0,3983,0,0,,3983,3983
35,08/27/2018,69,17:00,17:15,48.59,30.97,0,48.59,30.97,2,-41459,98855,140314,57396,0,-12874,695,0,0,,13569,-12179
35,08/27/2018,70,17:15,17:30,72.28,44.82,0,72.28,72.28,1,-76547,68293,144840,-8254,0,-7341,5717,0,0,,13058,-1624
35,08/27/2018,71,17:30,17:45,72.28,,0,72.28,72.28,1,-74632,53789,128421,-20843,0,0,15781,0,0,,15781,15781
35,08/27/2018,72,17:45,18:00,72.28,,0,72.28,72.28,1,-98629,61114,159743,-37515,0,0,16215,0,0,,16215,16215
35,08/27/2018,73,18:00,18:15,152.02,,0,152.02,152.02,1,-126407,49706,176113,-76701,0,0,46027,0,0,,46027,46027
35,08/27/2018,74,18:15,18:30,72.28,,0,72.28,72.28,1,-114072,61490,175562,-52582,0,0,29740,0,0,,29740,29740
35,08/27/2018,75,18:30,18:45,57.37,,0,57.37,57.37,1,-103956,62925,166881,-41031,0,0,35471,0,0,,35471,35471
35,08/27/2018,76,18:45,19:00,57.37,,0,57.37,57.37,1,-104425,74401,178826,-30024,0,0,30448,0,0,,30448,30448
35,08/27/2018,77,19:00,19:15,140.02,,0,140.02,140.02,1,-114725,40164,154889,-74561,0,0,53240,0,0,,53240,53240
35,08/27/2018,78,19:15,19:30,140.02,,0,140.02,140.02,1,-124095,39135,163230,-84960,0,0,66221,0,0,,66221,66221
35,08/27/2018,79,19:30,19:45,140.02,,0,140.02,140.02,1,-114297,44959,159256,-69338,0,0,72562,0,0,,72562,72562
35,08/27/2018,80,19:45,20:00,72.28,,0,72.28,72.28,1,-111304,46931,158235,-64373,0,0,55806,0,0,,55806,55806
35,08/27/2018,81,20:00,20:15,63.02,35.93,0,35.93,35.93,-1,-68205,86585,154790,18380,0,-3962,26479,0,0,,30441,22517
35,08/27/2018,82,20:15,20:30,76.88,28.67,0,76.88,76.88,1,-83077,59689,142766,-23388,0,-5829,4315,0,0,,10144,-1514
35,08/27/2018,83,20:30,20:45,80.02,,0,80.02,80.02,1,-86556,49032,135588,-37524,0,0,33253,0,0,,33253,33253
35,08/27/2018,84,20:45,21:00,80.02,,0,80.02,80.02,1,-87679,35596,123275,-52083,0,0,40916,0,0,,40916,40916
35,08/27/2018,85,21:00,21:15,70.31,,0,70.31,70.31,1,-85487,51590,137077,-33897,0,0,35863,0,0,,35863,35863
35,08/27/2018,86,21:15,21:30,53.53,,0,53.53,53.53,1,-77002,56219,133221,-20783,0,0,16863,0,0,,16863,16863
35,08/27/2018,87,21:30,21:45,50.31,40.89,0,50.31,40.89,2,-51292,68284,119576,16992,0,-7277,1830,0,0,,9107,-5447
35,08/27/2018,88,21:45,22:00,,36.35,0,36.35,36.35,-1,-56784,78072,134856,21288,0,-19068,0,0,0,,19068,-19068
35,08/27/2018,89,22:00,22:15,,22.14,0,22.14,22.14,-1,-60394,104994,165388,44600,0,-30143,0,0,0,,30143,-30143
35,08/27/2018,90,22:15,22:30,,40.82,0,40.82,40.82,-1,-55044,74392,129436,19348,0,-23215,0,0,0,,23215,-23215
35,08/27/2018,91,22:30,22:45,,40.82,0,40.82,40.82,-1,-43890,89135,133025,45245,0,-24921,0,0,0,,24921,-24921
35,08/27/2018,92,22:45,23:00,,21.03,0,21.03,21.03,-1,-46041,121546,167587,75505,0,-47073,0,0,0,,47073,-47073
35,08/27/2018,93,23:00,23:15,,37.24,0,37.24,37.24,-1,-92068,116404,208472,24336,0,-35162,0,0,0,,35162,-35162
35,08/27/2018,94,23:15,23:30,,36.89,0,36.89,36.89,-1,-61041,101106,162147,40065,0,-26548,0,0,0,,26548,-26548
35,08/27/2018,95,23:30,23:45,,37.37,0,37.37,37.37,-1,-71022,110729,181751,39707,0,-40109,0,0,0,,40109,-40109
35,08/27/2018,96,23:45,0:00,,22.14,0,22.14,22.14,-1,-59954,130763,190717,70809,0,-53543,0,0,0,,53543,-53543
35,08/28/2018,1,0:00,0:15,137.12,22.14,0,137.12,137.12,1,-83869,16088,99957,-67781,0,-14178,11858,0,0,,26036,-2320
35,08/28/2018,2,0:15,0:30,137.12,40.55,0,40.55,40.55,-1,-31865,47466,79331,15601,0,-2349,1042,0,0,,3391,-1307
35,08/28/2018,3,0:30,0:45,,36.89,0,36.89,36.89,-1,-27193,71354,98547,44161,0,-33105,0,0,0,,33105,-33105
35,08/28/2018,4,0:45,1:00,,42,0,42,42,-1,-22934,79299,102233,56365,0,-41623,0,0,0,,41623,-41623
35,08/28/2018,5,1:00,1:15,,27.08,0,27.08,27.08,-1,-31182,74737,105919,43555,0,-52716,0,0,0,,52716,-52716
35,08/28/2018,6,1:15,1:30,,37.08,0,37.08,37.08,-1,-11414,58623,70037,47209,0,-46818,0,0,0,,46818,-46818
35,08/28/2018,7,1:30,1:45,,40.55,0,40.55,40.55,-1,-8935,36880,45815,27945,0,-37950,0,0,0,,37950,-37950
35,08/28/2018,8,1:45,2:00,,44.08,0,44.08,44.08,-1,-16690,50151,66841,33461,0,-27381,0,0,0,,27381,-27381
35,08/28/2018,9,2:00,2:15,71.89,44.55,0,71.89,71.89,1,-71900,42167,114067,-29733,0,-14886,4791,0,0,,19677,-10095
35,08/28/2018,10,2:15,2:30,49.08,44.55,0,49.08,49.08,1,-44993,37905,82898,-7088,0,-54,7812,0,0,,7866,7758
35,08/28/2018,11,2:30,2:45,,,0,48.6,48.6,0,-47760,39527,87287,-8233,0,0,303,0,0,,303,303
35,08/28/2018,12,2:45,3:00,47.95,,0,47.95,47.95,1,-52933,34663,87596,-18270,0,0,717,0,0,,717,717
35,08/28/2018,13,3:00,3:15,52.55,,0,52.55,52.55,1,-72131,39761,111892,-32370,0,0,6885,0,0,,6885,6885
35,08/28/2018,14,3:15,3:30,49.93,,0,49.93,49.93,1,-69759,43193,112952,-26566,0,0,12528,0,0,,12528,12528
35,08/28/2018,15,3:30,3:45,48.55,,0,48.55,48.55,1,-68398,47318,115716,-21080,0,0,8271,0,0,,8271,8271
35,08/28/2018,16,3:45,4:00,48.13,,0,48.13,48.13,1,-61723,51113,112836,-10610,0,0,2590,0,0,,2590,2590
35,08/28/2018,17,4:00,4:15,52.55,,0,52.55,52.55,1,-90909,51237,142146,-39672,0,0,1827,0,0,,1827,1827
35,08/28/2018,18,4:15,4:30,57.1,,0,57.1,57.1,1,-89530,49903,139433,-39627,0,0,15717,0,0,,15717,15717
35,08/28/2018,19,4:30,4:45,57.1,,0,57.1,57.1,1,-93578,64884,158462,-28694,0,0,15658,0,0,,15658,15658
35,08/28/2018,20,4:45,5:00,66.12,49.76,0,66.12,45.16,2,-93244,86583,179827,-6661,0,-30,21656,0,0,,21686,21626
35,08/28/2018,21,5:00,5:15,66.12,44.55,0,44.55,44.55,-1,-79342,78399,157741,-943,0,-1126,2481,0,0,,3607,1355
35,08/28/2018,22,5:15,5:30,,43.17,0,43.17,43.17,-1,-57101,65194,122295,8093,0,-6950,0,0,0,,6950,-6950
35,08/28/2018,23,5:30,5:45,49.29,43.17,0,49.29,49.29,1,-67429,54452,121881,-12977,0,-424,808,0,0,,1232,384
35,08/28/2018,24,5:45,6:00,154.12,,0,257.54,257.54,1,-135558,54181,189739,-81377,0,0,16066,0,0,,16066,16066
35,08/28/2018,25,6:00,6:15,114.12,,0,264.69,264.69,1,-174401,76910,251311,-97491,0,0,62243,0,19500,,81743,81743
35,08/28/2018,26,6:15,6:30,52.17,,0,52.17,52.17,1,-150595,116574,267169,-34021,0,0,28540,0,6500,,35040,35040
35,08/28/2018,27,6:30,6:45,154.12,,0,154.12,154.12,1,-186097,78966,265063,-107131,0,0,53737,0,0,,53737,53737
35,08/28/2018,28,6:45,7:00,53.38,,0,53.38,53.38,1,-210362,81140,291502,-129222,0,0,96778,0,0,,96778,96778
35,08/28/2018,29,7:00,7:15,370,45.2,0,370,45.2,2,-133153,143207,276360,10054,0,-413,32757,5000,0,,38170,37344
35,08/28/2018,30,7:15,7:30,,51.07,0,51.07,51.07,-1,-109831,124059,233890,14228,0,-294,0,0,0,,294,-294
35,08/28/2018,31,7:30,7:45,55.49,,0,55.49,55.49,1,-140648,90538,231186,-50110,0,0,10115,0,0,,10115,10115
35,08/28/2018,32,7:45,8:00,53.38,,0,53.38,53.38,1,-187378,73348,260726,-114030,0,0,72826,0,0,,72826,72826
35,08/28/2018,33,8:00,8:15,172.18,-77.27,0,172.18,-77.27,2,-10259,89185,99444,78926,0,-1948,13631,1250,0,,16829,12933
35,08/28/2018,34,8:15,8:30,,,0,45.61,45.61,0,-21900,80047,101947,58147,0,0,0,0,0,,0,0
35,08/28/2018,35,8:30,8:45,,,0,45.6,45.6,0,-32529,57662,90191,25133,0,0,0,0,0,,0,0
35,08/28/2018,36,8:45,9:00,,,0,45.6,45.6,0,-48424,38705,87129,-9719,0,0,0,0,0,,0,0
35,08/28/2018,37,9:00,9:15,42.12,37.02,0,45.6,37.02,2,-86802,39138,125940,-47664,0,-5512,204,0,0,,5716,-5308
35,08/28/2018,38,9:15,9:30,59.75,37.02,0,59.75,59.75,1,-75368,37075,112443,-38293,0,-12,22262,0,0,,22274,22250
35,08/28/2018,39,9:30,9:45,49.98,,0,49.98,49.98,1,-84745,40137,124882,-44608,0,0,38267,0,0,,38267,38267
35,08/28/2018,40,9:45,10:00,49.07,,0,49.07,49.07,1,-59722,43632,103354,-16090,0,0,25389,0,0,,25389,25389
35,08/28/2018,41,10:00,10:15,56,,0,56,56,1,-113034,39659,152693,-73375,0,0,24754,0,0,,24754,24754
35,08/28/2018,42,10:15,10:30,48.85,,0,48.85,48.85,1,-91597,39283,130880,-52314,0,0,24549,0,0,,24549,24549
35,08/28/2018,43,10:30,10:45,49.07,,0,49.07,49.07,1,-67044,43089,110133,-23955,0,0,11642,0,0,,11642,11642
35,08/28/2018,44,10:45,11:00,48.57,,0,48.57,48.57,1,-34830,39045,73875,4215,0,0,1336,0,0,,1336,1336
35,08/28/2018,45,11:00,11:15,,37.02,0,37.02,37.02,-1,-39101,71631,110732,32530,0,-13918,0,0,0,,13918,-13918
35,08/28/2018,46,11:15,11:30,48.82,40.83,0,48.82,48.82,1,-39296,43255,82551,3959,0,-17633,172,0,0,,17805,-17461
35,08/28/2018,47,11:30,11:45,48.22,24.94,0,49.64,24.94,2,-35405,80428,115833,45023,0,-15081,44,0,0,,15125,-15037
35,08/28/2018,48,11:45,12:00,48.81,25.62,0,48.81,48.81,1,-36393,42108,78501,5715,0,-22840,119,0,0,,22959,-22721
35,08/28/2018,49,12:00,12:15,59.75,25.62,0,59.75,59.75,1,-57742,42292,100034,-15450,0,-95,8336,0,0,,8431,8241
35,08/28/2018,50,12:15,12:30,53.38,,0,53.38,53.38,1,-49846,48811,98657,-1035,0,0,3402,0,0,,3402,3402
35,08/28/2018,51,12:30,12:45,48.42,,0,48.42,48.42,1,-43730,55583,99313,11853,0,0,2169,0,0,,2169,2169
35,08/28/2018,52,12:45,13:00,53.38,51.06,0,53.38,49.62,2,-56767,52515,109282,-4252,0,-2,2512,0,0,,2514,2510
35,08/28/2018,53,13:00,13:15,53.38,44.83,0,53.38,44.83,2,-65213,57727,122940,-7486,0,-571,680,0,0,,1251,109
35,08/28/2018,54,13:15,13:30,72.38,,0,72.38,72.38,1,-91732,45634,137366,-46098,0,0,21387,0,0,,21387,21387
35,08/28/2018,55,13:30,13:45,50.78,,0,50.78,50.78,1,-94935,46621,141556,-48314,0,0,11433,0,0,,11433,11433
35,08/28/2018,56,13:45,14:00,49.07,,0,49.07,49.07,1,-96689,47209,143898,-49480,0,0,6687,0,0,,6687,6687
35,08/28/2018,57,14:00,14:15,72.38,,0,72.38,72.38,1,-127871,38187,166058,-89684,0,0,17927,0,0,,17927,17927
35,08/28/2018,58,14:15,14:30,59,,0,59,59,1,-125027,35816,160843,-89211,0,0,21627,0,0,,21627,21627
35,08/28/2018,59,14:30,14:45,65,,0,65,65,1,-126860,27493,154353,-99367,0,0,8013,0,0,,8013,8013
35,08/28/2018,60,14:45,15:00,53.38,49.27,0,53.38,49.27,2,-124380,25795,150175,-98585,0,-38,5217,0,0,,5255,5179
35,08/28/2018,61,15:00,15:15,47.97,44.83,0,49.52,44.83,2,-102756,28268,131024,-74488,0,-574,581,0,0,,1155,7
35,08/28/2018,62,15:15,15:30,59.75,,0,59.75,59.75,1,-112386,31176,143562,-81210,0,0,3801,0,0,,3801,3801
35,08/28/2018,63,15:30,15:45,83.12,,0,83.12,83.12,1,-103481,34410,137891,-69071,0,0,24304,0,0,,24304,24304
35,08/28/2018,64,15:45,16:00,53.38,,0,53.38,53.38,1,-97753,45080,142833,-52673,0,0,15938,0,0,,15938,15938
35,08/28/2018,65,16:00,16:15,53.38,46.23,0,46.23,46.23,-1,-57640,57477,115117,-163,0,-62,2805,0,0,,2867,2743
35,08/28/2018,66,16:15,16:30,49.07,,0,49.07,49.07,1,-58791,53285,112076,-5506,0,0,12,0,0,,12,12
35,08/28/2018,67,16:30,16:45,49.07,,0,49.07,49.07,1,-59234,60613,119847,1379,0,0,1297,0,0,,1297,1297
35,08/28/2018,68,16:45,17:00,59.75,,0,59.75,59.75,1,-89459,69477,158936,-19982,0,0,6236,0,0,,6236,6236
35,08/28/2018,69,17:00,17:15,53.38,,0,53.38,53.38,1,-56812,46442,103254,-10370,0,0,5285,0,0,,5285,5285
35,08/28/2018,70,17:15,17:30,53.38,,0,53.38,53.38,1,-59367,41419,100786,-17948,0,0,7348,0,0,,7348,7348
35,08/28/2018,71,17:30,17:45,59.75,,0,59.75,59.75,1,-68562,46129,114691,-22433,0,0,14398,0,0,,14398,14398
35,08/28/2018,72,17:45,18:00,53.38,,0,53.38,53.38,1,-44534,59798,104332,15264,0,0,8592,0,0,,8592,8592
35,08/28/2018,73,18:00,18:15,49.07,,0,49.07,49.07,1,-73858,21067,94925,-52791,0,0,409,0,0,,409,409
35,08/28/2018,74,18:15,18:30,48.54,,0,48.54,48.54,1,-55853,51343,107196,-4510,0,0,62,0,0,,62,62
35,08/28/2018,75,18:30,18:45,49.34,,0,49.34,49.34,1,-52811,51896,104707,-915,0,0,2336,0,0,,2336,2336
35,08/28/2018,76,18:45,19:00,50.11,,0,50.11,50.11,1,-53174,48024,101198,-5150,0,0,3027,0,0,,3027,3027
35,08/28/2018,77,19:00,19:15,53.38,,0,53.38,53.38,1,-66539,29310,95849,-37229,0,0,2784,0,0,,2784,2784
35,08/28/2018,78,19:15,19:30,53.38,,0,53.38,53.38,1,-71661,29183,100844,-42478,0,0,2746,0,0,,2746,2746
35,08/28/2018,79,19:30,19:45,59.75,,0,59.75,59.75,1,-65629,32502,98131,-33127,0,0,17150,0,0,,17150,17150
35,08/28/2018,80,19:45,20:00,59.75,,0,59.75,59.75,1,-75022,31712,106734,-43310,0,0,21842,0,0,,21842,21842
35,08/28/2018,81,20:00,20:15,49.07,,0,49.07,49.07,1,-62394,39184,101578,-23210,0,0,2725,0,0,,2725,2725
35,08/28/2018,82,20:15,20:30,,,0,50.07,50.07,0,-70033,39591,109624,-30442,0,0,0,0,0,,0,0
35,08/28/2018,83,20:30,20:45,49.07,,0,49.07,49.07,1,-91826,33038,124864,-58788,0,0,16,0,0,,16,16
35,08/28/2018,84,20:45,21:00,82.51,,0,82.51,82.51,1,-131105,25661,156766,-105444,0,0,5079,0,0,,5079,5079
35,08/28/2018,85,21:00,21:15,161.12,,0,161.12,161.12,1,-96060,33180,129240,-62880,0,0,48359,0,0,,48359,48359
35,08/28/2018,86,21:15,21:30,59.75,48.64,0,48.64,48.64,-1,-73803,46450,120253,-27353,0,-168,24640,0,0,,24808,24472
35,08/28/2018,87,21:30,21:45,59.75,44.83,0,44.83,44.83,-1,-53946,44938,98884,-9008,0,-135,36,0,0,,171,-99
35,08/28/2018,88,21:45,22:00,,44.83,0,44.83,44.83,-1,-43903,59793,103696,15890,0,-4965,0,0,0,,4965,-4965
35,08/28/2018,89,22:00,22:15,,44.83,0,44.83,44.83,-1,-78663,61721,140384,-16942,0,-7461,0,0,0,,7461,-7461
35,08/28/2018,90,22:15,22:30,,44.83,0,44.83,44.83,-1,-66678,65999,132677,-679,0,-5547,0,0,0,,5547,-5547
35,08/28/2018,91,22:30,22:45,,37.02,0,37.02,37.02,-1,-35151,72209,107360,37058,0,-27896,0,0,0,,27896,-27896
35,08/28/2018,92,22:45,23:00,,35.22,0,35.22,35.22,-1,-19293,82030,101323,62737,0,-60414,0,0,0,,60414,-60414
35,08/28/2018,93,23:00,23:15,,37.02,0,37.02,37.02,-1,-53712,69759,123471,16047,0,-32118,0,0,0,,32118,-32118
35,08/28/2018,94,23:15,23:30,,30.62,0,30.62,30.62,-1,-20444,72452,92896,52008,0,-43533,0,0,0,,43533,-43533
35,08/28/2018,95,23:30,23:45,,37.02,0,37.02,37.02,-1,-23213,68301,91514,45088,0,-52856,0,0,0,,52856,-52856
35,08/28/2018,96,23:45,0:00,,-52.54,0,-52.54,-52.54,-1,-11104,98148,109252,87044,0,-75003,0,0,0,,75003,-75003
35,08/29/2018,1,0:00,0:15,,-98.27,0,-98.27,-98.27,-1,-64989,130528,195517,65539,0,-84901,0,0,0,,84901,-84901
35,08/29/2018,2,0:15,0:30,,22.38,0,22.38,22.38,-1,-36457,89981,126438,53524,0,-34060,0,0,0,,34060,-34060
35,08/29/2018,3,0:30,0:45,,-0.03,0,-0.03,-0.03,-1,-24620,93905,118525,69285,0,-66583,0,0,0,,66583,-66583
35,08/29/2018,4,0:45,1:00,,22.38,0,22.38,22.38,-1,-36777,110658,147435,73881,0,-64975,0,0,0,,64975,-64975
35,08/29/2018,5,1:00,1:15,,22.38,0,22.38,22.38,-1,-70170,93030,163200,22860,0,-56223,0,0,0,,56223,-56223
35,08/29/2018,6,1:15,1:30,48.83,34.8,0,48.83,34.8,2,-72255,86809,159064,14554,0,-5983,27,0,0,,6010,-5956
35,08/29/2018,7,1:30,1:45,,-27.62,0,-27.62,-27.62,-1,-56762,106683,163445,49921,0,-40275,0,0,0,,40275,-40275
35,08/29/2018,8,1:45,2:00,,35.18,0,35.18,35.18,-1,-56471,114543,171014,58072,0,-52141,0,0,0,,52141,-52141
35,08/29/2018,9,2:00,2:15,52.83,37.27,0,52.83,52.83,1,-66979,53529,120508,-13450,0,-31765,77,0,0,,31842,-31688
35,08/29/2018,10,2:15,2:30,52.83,44.88,0,52.83,44.88,2,-61523,59377,120900,-2146,0,-718,262,0,0,,980,-456
35,08/29/2018,11,2:30,2:45,,41.15,0,41.15,41.15,-1,-63952,63332,127284,-620,0,-7230,0,0,0,,7230,-7230
35,08/29/2018,12,2:45,3:00,,44.88,0,44.88,44.88,-1,-72980,63615,136595,-9365,0,-976,0,0,0,,976,-976
35,08/29/2018,13,3:00,3:15,,,0,46.44,46.44,0,-58206,55550,113756,-2656,0,-162,0,0,0,,162,-162
35,08/29/2018,14,3:15,3:30,52.89,,0,52.89,52.89,1,-76487,58228,134715,-18259,0,0,4164,0,0,,4164,4164
35,08/29/2018,15,3:30,3:45,41.65,,0,41.65,41.65,1,-66208,67693,133901,1485,0,0,1394,0,0,,1394,1394
35,08/29/2018,16,3:45,4:00,41.65,,0,41.65,41.65,1,-66410,72184,138594,5774,0,0,111,0,0,,111,111
35,08/29/2018,17,4:00,4:15,,,0,45.59,45.59,0,-31752,85479,117231,53727,0,0,0,0,0,,0,0
35,08/29/2018,18,4:15,4:30,,50.98,0,50.98,50.98,-1,-35241,88089,123330,52848,0,-175,0,0,0,,175,-175
35,08/29/2018,19,4:30,4:45,,46.03,0,46.03,46.03,-1,-39477,83664,123141,44187,0,-593,0,0,0,,593,-593
35,08/29/2018,20,4:45,5:00,,51.23,0,51.23,51.23,-1,-39135,75034,114169,35899,0,-129,0,0,0,,129,-129
35,08/29/2018,21,5:00,5:15,,22.38,0,22.38,22.38,-1,-27119,91782,118901,64663,0,-24565,0,0,0,,24565,-24565
35,08/29/2018,22,5:15,5:30,,37.55,0,37.55,37.55,-1,-26198,65497,91695,39299,0,-19435,0,0,0,,19435,-19435
35,08/29/2018,23,5:30,5:45,,44.88,0,44.88,44.88,-1,-30674,49299,79973,18625,0,-1240,0,0,0,,1240,-1240
35,08/29/2018,24,5:45,6:00,,,0,47.23,47.23,0,-42169,60137,102306,17968,0,0,0,0,0,,0,0
35,08/29/2018,25,6:00,6:15,,39.02,0,39.02,39.02,-1,-20185,71082,91267,50897,0,-1995,0,0,0,,1995,-1995
35,08/29/2018,26,6:15,6:30,,34.34,0,34.34,34.34,-1,-18539,59183,77722,40644,0,-18080,0,0,0,,18080,-18080
35,08/29/2018,27,6:30,6:45,49.96,46.01,0,49.96,49.96,1,-40731,38047,78778,-2684,0,-12435,5,0,0,,12440,-12430
35,08/29/2018,28,6:45,7:00,52.61,46.01,0,52.61,52.61,1,-54935,18434,73369,-36501,0,-690,436,0,0,,1126,-254
35,08/29/2018,29,7:00,7:15,,-150.03,0,-150.03,-150.03,-1,-25573,126676,152249,101103,0,-35731,0,0,0,,35731,-35731
35,08/29/2018,30,7:15,7:30,,38.53,0,38.53,38.53,-1,-35273,69931,105204,34658,0,-31636,0,0,0,,31636,-31636
35,08/29/2018,31,7:30,7:45,,42.3,0,42.3,42.3,-1,-53803,72609,126412,18806,0,-26232,0,0,0,,26232,-26232
35,08/29/2018,32,7:45,8:00,53.6,42.3,0,53.6,53.6,1,-75753,78066,153819,2313,0,-3213,231,0,0,,3444,-2982
35,08/29/2018,33,8:00,8:15,,46.3,0,46.3,46.3,-1,-66579,96397,162976,29818,0,-523,0,0,0,,523,-523
35,08/29/2018,34,8:15,8:30,,,0,64.57,64.57,0,-62848,79081,141929,16233,0,0,0,0,0,,0,0
35,08/29/2018,35,8:30,8:45,,,0,64.57,64.57,0,-67236,57356,124592,-9880,0,0,0,0,0,,0,0
35,08/29/2018,36,8:45,9:00,60.21,,0,60.21,60.21,1,-59594,37531,97125,-22063,0,0,3540,0,0,,3540,3540
35,08/29/2018,37,9:00,9:15,54.45,,0,54.45,54.45,1,-62414,59164,121578,-3250,0,0,3556,0,0,,3556,3556
35,08/29/2018,38,9:15,9:30,50.3,,0,50.3,50.3,1,-57461,53004,110465,-4457,0,0,228,0,0,,228,228
35,08/29/2018,39,9:30,9:45,54.45,,0,54.45,54.45,1,-62322,54259,116581,-8063,0,0,1623,0,0,,1623,1623
35,08/29/2018,40,9:45,10:00,54.45,,0,54.45,54.45,1,-65429,46287,111716,-19142,0,0,3251,0,0,,3251,3251
35,08/29/2018,41,10:00,10:15,54.63,,0,54.63,54.63,1,-60776,53717,114493,-7059,0,0,6143,0,0,,6143,6143
35,08/29/2018,42,10:15,10:30,54.73,,0,54.73,54.73,1,-56699,45836,102535,-10863,0,0,2847,0,0,,2847,2847
35,08/29/2018,43,10:30,10:45,84.05,,0,84.05,84.05,1,-74378,39161,113539,-35217,0,0,26530,0,0,,26530,26530
35,08/29/2018,44,10:45,11:00,55.78,,0,55.78,55.78,1,-65201,39384,104585,-25817,0,0,22348,0,0,,22348,22348
35,08/29/2018,45,11:00,11:15,54.45,-24.04,0,-24.04,-24.04,-1,-67106,107345,174451,40239,0,-12196,10174,0,0,,22370,-2022
35,08/29/2018,46,11:15,11:30,,38.53,0,38.53,38.53,-1,-80184,109074,189258,28890,0,-22173,0,0,0,,22173,-22173
35,08/29/2018,47,11:30,11:45,,38.53,0,38.53,38.53,-1,-91807,102916,194723,11109,0,-23537,0,0,0,,23537,-23537
35,08/29/2018,48,11:45,12:00,,,0,64.61,64.61,0,-94349,100116,194465,5767,0,-1331,0,0,0,,1331,-1331
35,08/29/2018,49,12:00,12:15,,78.57,0,78.57,78.57,-1,-100618,103861,204479,3243,0,-235,0,0,0,,235,-235
35,08/29/2018,50,12:15,12:30,,46.3,0,46.3,46.3,-1,-94929,102640,197569,7711,0,-2031,0,0,0,,2031,-2031
35,08/29/2018,51,12:30,12:45,54.45,46.3,0,64.62,46.3,2,-98031,95110,193141,-2921,0,-1621,886,0,0,,2507,-735
35,08/29/2018,52,12:45,13:00,60.21,,0,60.21,60.21,1,-114796,91932,206728,-22864,0,0,10141,0,0,,10141,10141
35,08/29/2018,53,13:00,13:15,79.34,,0,79.34,79.34,1,-119885,86342,206227,-33543,0,0,20522,0,0,,20522,20522
35,08/29/2018,54,13:15,13:30,155.18,,0,155.18,155.18,1,-162242,69198,231440,-93044,0,0,61655,0,0,,61655,61655
35,08/29/2018,55,13:30,13:45,89.46,,0,89.46,89.46,1,-141735,65225,206960,-76510,0,0,56930,0,0,,56930,56930
35,08/29/2018,56,13:45,14:00,97.18,,0,97.18,97.18,1,-141255,61915,203170,-79340,0,0,57174,0,0,,57174,57174
35,08/29/2018,57,14:00,14:15,155.18,,0,155.18,155.18,1,-124350,17663,142013,-106687,0,0,58911,0,0,,58911,58911
35,08/29/2018,58,14:15,14:30,97.18,,0,97.18,97.18,1,-110516,22299,132815,-88217,0,0,68441,0,0,,68441,68441
35,08/29/2018,59,14:30,14:45,78.11,,0,78.11,78.11,1,-93923,40117,134040,-53806,0,0,48828,0,0,,48828,48828
35,08/29/2018,60,14:45,15:00,60.21,,0,60.21,60.21,1,-97689,60013,157702,-37676,0,0,27476,0,0,,27476,27476
35,08/29/2018,61,15:00,15:15,60.21,38.53,0,38.53,38.53,-1,-83033,86072,169105,3039,0,-4103,4077,0,0,,8180,-26
35,08/29/2018,62,15:15,15:30,50.3,42.3,0,51.44,42.3,2,-91141,100604,191745,9463,0,-1176,488,0,0,,1664,-688
35,08/29/2018,63,15:30,15:45,,38.53,0,38.53,38.53,-1,-86479,101318,187797,14839,0,-17012,0,0,0,,17012,-17012
35,08/29/2018,64,15:45,16:00,,-44.48,0,-44.48,-44.48,-1,-85316,126221,211537,40905,0,-7591,0,0,0,,7591,-7591
35,08/29/2018,65,16:00,16:15,134.18,-44.48,0,134.18,-44.48,2,-92181,64089,156270,-28092,0,-10633,5857,0,0,,16490,-4776
35,08/29/2018,66,16:15,16:30,54.34,24.02,0,24.02,24.02,-1,-48901,116466,165367,67565,0,-6144,2343,0,0,,8487,-3801
35,08/29/2018,67,16:30,16:45,,24.02,0,24.02,24.02,-1,-76208,118379,194587,42171,0,-12959,0,0,0,,12959,-12959
35,08/29/2018,68,16:45,17:00,,38.53,0,38.53,38.53,-1,-66818,134588,201406,67770,0,-5401,0,0,0,,5401,-5401
35,08/29/2018,69,17:00,17:15,74.07,38.53,0,74.07,74.07,1,-77202,51702,128904,-25500,0,-1098,9395,0,0,,10493,8297
35,08/29/2018,70,17:15,17:30,53.39,,0,53.39,53.39,1,-51702,88710,140412,37008,0,0,3875,0,0,,3875,3875
35,08/29/2018,71,17:30,17:45,,,0,64.63,64.63,0,-71734,109963,181697,38229,0,0,0,0,0,,0,0
35,08/29/2018,72,17:45,18:00,,,0,64.63,64.63,0,-58954,114540,173494,55586,0,0,0,0,0,,0,0
35,08/29/2018,73,18:00,18:15,53.48,,0,53.48,53.48,1,-160170,59548,219718,-100622,0,0,537,0,0,,537,537
35,08/29/2018,74,18:15,18:30,155.18,,0,155.18,155.18,1,-154021,60339,214360,-93682,0,0,7789,0,0,,7789,7789
35,08/29/2018,75,18:30,18:45,60.21,,0,60.21,60.21,1,-115030,61385,176415,-53645,0,0,9839,0,0,,9839,9839
35,08/29/2018,76,18:45,19:00,75.19,,0,75.19,75.19,1,-117794,64725,182519,-53069,0,0,10782,0,0,,10782,10782
35,08/29/2018,77,19:00,19:15,74.9,,0,74.9,74.9,1,-134199,59549,193748,-74650,0,0,17133,0,0,,17133,17133
35,08/29/2018,78,19:15,19:30,155.18,,0,155.18,155.18,1,-164720,56991,221711,-107729,0,0,13994,0,0,,13994,13994
35,08/29/2018,79,19:30,19:45,155.18,,0,155.18,155.18,1,-144689,57463,202152,-87226,0,0,38112,0,0,,38112,38112
35,08/29/2018,80,19:45,20:00,92.18,,0,92.18,92.18,1,-155719,57558,213277,-98161,0,0,30698,0,0,,30698,30698
35,08/29/2018,81,20:00,20:15,124.18,,0,124.18,124.18,1,-101189,63118,164307,-38071,0,0,41335,0,0,,41335,41335
35,08/29/2018,82,20:15,20:30,58.02,,0,58.02,58.02,1,-113508,60327,173835,-53181,0,0,24061,0,0,,24061,24061
35,08/29/2018,83,20:30,20:45,54.86,,0,54.86,54.86,1,-149656,55446,205102,-94210,0,0,4406,0,0,,4406,4406
35,08/29/2018,84,20:45,21:00,60.21,,0,60.21,60.21,1,-167051,54196,221247,-112855,0,0,15436,0,0,,15436,15436
35,08/29/2018,85,21:00,21:15,386.18,,0,386.18,386.18,1,-122751,47530,170281,-75221,0,0,34651,0,0,,34651,34651
35,08/29/2018,86,21:15,21:30,60.21,,0,60.21,60.21,1,-84165,51933,136098,-32232,0,0,11951,0,0,,11951,11951
35,08/29/2018,87,21:30,21:45,60.21,52.46,0,52.46,52.46,-1,-54569,37298,91867,-17271,0,-15,1172,0,0,,1187,1157
35,08/29/2018,88,21:45,22:00,,52.46,0,52.46,52.46,-1,-56373,41096,97469,-15277,0,-768,0,0,0,,768,-768
35,08/29/2018,89,22:00,22:15,50.3,46.03,0,50.94,46.03,2,-84940,80779,165719,-4161,0,-2518,112,0,0,,2630,-2406
35,08/29/2018,90,22:15,22:30,53.04,46.3,0,53.04,46.3,2,-64604,67243,131847,2639,0,-67,1677,0,0,,1744,1610
35,08/29/2018,91,22:30,22:45,,10.83,0,10.83,10.83,-1,-29339,99269,128608,69930,0,-36362,0,0,0,,36362,-36362
35,08/29/2018,92,22:45,23:00,,13.1,0,13.1,13.1,-1,-33137,116952,150089,83815,0,-76729,0,0,0,,76729,-76729
35,08/29/2018,93,23:00,23:15,123.53,-60.02,0,123.53,-60.02,2,-87960,68241,156201,-19719,0,-55636,1726,0,0,,57362,-53910
35,08/29/2018,94,23:15,23:30,138.18,-70.92,0,138.18,-70.92,2,-36442,87875,124317,51433,0,-8382,7330,0,0,,15712,-1052
35,08/29/2018,95,23:30,23:45,,-76.8,0,-76.8,-76.8,-1,-29628,125346,154974,95718,0,-78574,0,0,0,,78574,-78574
35,08/29/2018,96,23:45,0:00,,-76.8,0,-76.8,-76.8,-1,-26788,160773,187561,133985,0,-113413,0,0,0,,113413,-113413
35,08/30/2018,1,0:00,0:15,123.53,-25.26,0,123.53,123.53,1,-108910,82397,191307,-26513,0,-58055,1009,0,0,,59064,-57046
35,08/30/2018,2,0:15,0:30,350.12,48,0,350.12,46.35,2,-73311,48429,121740,-24882,0,-237,23811,0,0,,24048,23574
35,08/30/2018,3,0:30,0:45,350.12,-26.47,0,-26.47,-26.47,-1,-30595,98951,129546,68356,0,-35076,306,0,0,,35382,-34770
35,08/30/2018,4,0:45,1:00,,36.67,0,36.67,36.67,-1,-29799,61641,91440,31842,0,-52720,0,0,0,,52720,-52720
35,08/30/2018,5,1:00,1:15,72.24,36.67,0,72.24,72.24,1,-80383,43204,123587,-37179,0,-5970,15295,0,0,,21265,9325
35,08/30/2018,6,1:15,1:30,72.24,,0,72.24,72.24,1,-84615,37932,122547,-46683,0,0,41922,0,0,,41922,41922
35,08/30/2018,7,1:30,1:45,49.44,,0,49.44,49.44,1,-77128,47076,124204,-30052,0,0,15584,0,0,,15584,15584
35,08/30/2018,8,1:45,2:00,,,0,46.34,46.34,0,-69979,52146,122125,-17833,0,0,289,0,0,,289,289
35,08/30/2018,9,2:00,2:15,63.58,,0,63.58,63.58,1,-85146,55251,140397,-29895,0,0,12849,0,0,,12849,12849
35,08/30/2018,10,2:15,2:30,50.37,,0,50.37,50.37,1,-67160,55739,122899,-11421,0,0,7929,0,0,,7929,7929
35,08/30/2018,11,2:30,2:45,,,0,46.37,46.37,0,-74859,72679,147538,-2180,0,0,12,0,0,,12,12
35,08/30/2018,12,2:45,3:00,,,0,46.37,46.37,0,-78297,86751,165048,8454,0,0,0,0,0,,0,0
35,08/30/2018,13,3:00,3:15,,,0,46.39,46.39,0,-67196,75228,142424,8032,0,0,0,0,0,,0,0
35,08/30/2018,14,3:15,3:30,,,0,46.4,46.4,0,-47191,67485,114676,20294,0,0,0,0,0,,0,0
35,08/30/2018,15,3:30,3:45,,,0,46.39,46.39,0,-53846,59606,113452,5760,0,0,0,0,0,,0,0
35,08/30/2018,16,3:45,4:00,,,0,46.39,46.39,0,-54380,58755,113135,4375,0,0,0,0,0,,0,0
35,08/30/2018,17,4:00,4:15,40.81,,0,40.81,40.81,1,-57385,59164,116549,1779,0,0,87,0,0,,87,87
35,08/30/2018,18,4:15,4:30,40.81,,0,40.81,40.81,1,-60193,59556,119749,-637,0,0,480,0,0,,480,480
35,08/30/2018,19,4:30,4:45,49.24,,0,49.24,49.24,1,-57383,51384,108767,-5999,0,0,2155,0,0,,2155,2155
35,08/30/2018,20,4:45,5:00,53.24,,0,53.24,53.24,1,-54562,41868,96430,-12694,0,0,7402,0,0,,7402,7402
35,08/30/2018,21,5:00,5:15,45.12,,0,45.12,45.12,1,-50050,60217,110267,10167,0,0,2058,0,0,,2058,2058
35,08/30/2018,22,5:15,5:30,53.24,48,0,53.24,47.56,2,-70178,50814,120992,-19364,0,-950,180,0,0,,1130,-770
35,08/30/2018,23,5:30,5:45,350.12,,0,350.12,350.12,1,-89004,33780,122784,-55224,0,0,25790,0,0,,25790,25790
35,08/30/2018,24,5:45,6:00,54.55,,0,54.55,54.55,1,-68707,69288,137995,581,0,0,22942,0,0,,22942,22942
35,08/30/2018,25,6:00,6:15,54.55,37.18,0,37.18,37.18,-1,-75368,95767,171135,20399,0,-17335,2247,0,0,,19582,-15088
35,08/30/2018,26,6:15,6:30,71.89,48.83,0,71.89,71.89,1,-107308,59147,166455,-48161,0,-5901,11061,0,0,,16962,5160
35,08/30/2018,27,6:30,6:45,71.89,,0,71.89,71.89,1,-98593,47756,146349,-50837,0,0,45673,0,0,,45673,45673
35,08/30/2018,28,6:45,7:00,56.27,51.94,0,51.94,51.94,-1,-91222,60061,151283,-31161,0,-12,29206,0,0,,29218,29194
35,08/30/2018,29,7:00,7:15,56.27,37.74,0,37.74,37.74,-1,-99297,154673,253970,55376,0,-13591,1589,0,0,,15180,-12002
35,08/30/2018,30,7:15,7:30,,37.74,0,37.74,37.74,-1,-39719,99288,139007,59569,0,-30966,0,0,0,,30966,-30966
35,08/30/2018,31,7:30,7:45,,,0,50.79,50.79,0,-33548,74733,108281,41185,0,-5199,0,0,0,,5199,-5199
35,08/30/2018,32,7:45,8:00,,,0,50.79,50.79,0,-51667,82542,134209,30875,0,0,0,0,0,,0,0
35,08/30/2018,33,8:00,8:15,50.89,,0,50.89,50.89,1,-103103,59701,162804,-43402,0,0,2000,0,0,,2000,2000
35,08/30/2018,34,8:15,8:30,143.12,,0,143.12,143.12,1,-109791,30680,140471,-79111,0,0,35111,0,0,,35111,35111
35,08/30/2018,35,8:30,8:45,72.61,,0,72.61,72.61,1,-104472,33919,138391,-70553,0,0,46941,0,0,,46941,46941
35,08/30/2018,36,8:45,9:00,123.16,,0,123.16,123.16,1,-102912,21976,124888,-80936,0,0,43857,0,0,,43857,43857
35,08/30/2018,37,9:00,9:15,58.16,47.33,0,47.33,47.33,-1,-57800,57417,115217,-383,0,-386,27322,0,0,,27708,26936
35,08/30/2018,38,9:15,9:30,58.16,44.76,0,44.76,44.76,-1,-43464,57087,100551,13623,0,-4698,176,0,0,,4874,-4522
35,08/30/2018,39,9:30,9:45,57.11,41.61,0,57.11,41.61,2,-83413,70375,153788,-13038,0,-9620,2138,0,0,,11758,-7482
35,08/30/2018,40,9:45,10:00,50.03,41.61,0,50.03,50.03,1,-107596,85518,193114,-22078,0,-125,4835,0,0,,4960,4710
35,08/30/2018,41,10:00,10:15,72.61,,0,72.61,72.61,1,-103717,70432,174149,-33285,0,0,19114,0,0,,19114,19114
35,08/30/2018,42,10:15,10:30,49.61,52.34,0,52.34,52.34,-1,-86030,78369,164399,-7661,0,-77,5431,0,0,,5508,5354
35,08/30/2018,43,10:30,10:45,,52.34,0,52.34,52.34,-1,-78578,71341,149919,-7237,0,-250,0,0,0,,250,-250
35,08/30/2018,44,10:45,11:00,,52.35,0,52.35,52.35,-1,-74559,63791,138350,-10768,0,-62,0,0,0,,62,-62
35,08/30/2018,45,11:00,11:15,49.61,,0,49.61,49.61,1,-132855,87281,220136,-45574,0,0,335,0,0,,335,335
35,08/30/2018,46,11:15,11:30,49.61,,0,49.61,49.61,1,-132602,94852,227454,-37750,0,0,1519,0,0,,1519,1519
35,08/30/2018,47,11:30,11:45,,,0,50.98,50.98,0,-129166,115268,244434,-13898,0,0,163,0,0,,163,163
35,08/30/2018,48,11:45,12:00,49.61,,0,49.61,49.61,1,-135493,125515,261008,-9978,0,0,40,0,0,,40,40
35,08/30/2018,49,12:00,12:15,53.61,47.92,0,53.61,47.92,2,-132075,118042,250117,-14033,0,-183,1718,0,0,,1901,1535
35,08/30/2018,50,12:15,12:30,,45.61,0,45.61,45.61,-1,-129370,118432,247802,-10938,0,-1192,0,0,0,,1192,-1192
35,08/30/2018,51,12:30,12:45,49.61,,0,49.61,49.61,1,-115307,104725,220032,-10582,0,0,346,0,0,,346,346
35,08/30/2018,52,12:45,13:00,,,0,47.56,47.56,0,-115721,99145,214866,-16576,0,0,35,0,0,,35,35
35,08/30/2018,53,13:00,13:15,72.61,,0,72.61,72.61,1,-111954,60266,172220,-51688,0,0,11395,0,0,,11395,11395
35,08/30/2018,54,13:15,13:30,53.12,,0,53.12,53.12,1,-113706,61103,174809,-52603,0,0,18192,0,0,,18192,18192
35,08/30/2018,55,13:30,13:45,60.12,,0,60.12,60.12,1,-114777,55847,170624,-58930,0,0,26513,0,0,,26513,26513
35,08/30/2018,56,13:45,14:00,54.55,,0,54.55,54.55,1,-119888,57591,177479,-62297,0,0,30521,0,0,,30521,30521
35,08/30/2018,57,14:00,14:15,54.55,-2.04,0,-2.04,-2.04,-1,-42549,109423,151972,66874,0,-12219,11033,0,0,,23252,-1186
35,08/30/2018,58,14:15,14:30,,42.78,0,42.78,42.78,-1,-62028,88821,150849,26793,0,-21400,0,0,0,,21400,-21400
35,08/30/2018,59,14:30,14:45,,43.34,0,43.34,43.34,-1,-66079,97412,163491,31333,0,-25848,0,0,0,,25848,-25848
35,08/30/2018,60,14:45,15:00,,42.97,0,42.97,42.97,-1,-70273,101196,171469,30923,0,-26327,0,0,0,,26327,-26327
35,08/30/2018,61,15:00,15:15,,45.61,0,45.61,45.61,-1,-82509,98259,180768,15750,0,-20289,0,0,0,,20289,-20289
35,08/30/2018,62,15:15,15:30,,45.61,0,45.61,45.61,-1,-77320,94705,172025,17385,0,-15775,0,0,0,,15775,-15775
35,08/30/2018,63,15:30,15:45,57.25,48,0,57.25,57.25,1,-82552,67278,149830,-15274,0,-8109,2382,0,0,,10491,-5727
35,08/30/2018,64,15:45,16:00,54.12,48,0,54.12,54.12,1,-87869,67032,154901,-20837,0,-42,10639,0,0,,10681,10597
35,08/30/2018,65,16:00,16:15,54.12,39.92,0,39.92,39.92,-1,-62499,81629,144128,19130,0,-4464,2730,0,0,,7194,-1734
35,08/30/2018,66,16:15,16:30,,51.05,0,51.05,51.05,-1,-70731,71501,142232,770,0,-493,0,0,0,,493,-493
35,08/30/2018,67,16:30,16:45,,41.61,0,41.61,41.61,-1,-64266,78639,142905,14373,0,-6425,0,0,0,,6425,-6425
35,08/30/2018,68,16:45,17:00,,44.03,0,44.03,44.03,-1,-78000,92751,170751,14751,0,-10890,0,0,0,,10890,-10890
35,08/30/2018,69,17:00,17:15,,45.61,0,45.61,45.61,-1,-89206,94691,183897,5485,0,-4801,0,0,0,,4801,-4801
35,08/30/2018,70,17:15,17:30,,48,0,48,48,-1,-81727,82629,164356,902,0,-3011,0,0,0,,3011,-3011
35,08/30/2018,71,17:30,17:45,49.61,48,0,50.85,48,2,-96049,93095,189144,-2954,0,-733,139,0,0,,872,-594
35,08/30/2018,72,17:45,18:00,52.99,,0,52.99,52.99,1,-106476,91035,197511,-15441,0,0,4532,0,0,,4532,4532
35,08/30/2018,73,18:00,18:15,58.16,,0,58.16,58.16,1,-86863,44041,130904,-42822,0,0,13031,0,0,,13031,13031
35,08/30/2018,74,18:15,18:30,58.16,,0,58.16,58.16,1,-83661,47940,131601,-35721,0,0,16063,0,0,,16063,16063
35,08/30/2018,75,18:30,18:45,58.16,,0,58.16,58.16,1,-87478,52461,139939,-35017,0,0,25943,0,0,,25943,25943
35,08/30/2018,76,18:45,19:00,58.16,,0,58.16,58.16,1,-89652,47780,137432,-41872,0,0,37201,0,0,,37201,37201
35,08/30/2018,77,19:00,19:15,56.02,,0,56.02,56.02,1,-68094,40892,108986,-27202,0,0,25245,0,0,,25245,25245
35,08/30/2018,78,19:15,19:30,72.61,,0,72.61,72.61,1,-77580,32198,109778,-45382,0,0,29723,0,0,,29723,29723
35,08/30/2018,79,19:30,19:45,58.16,,0,58.16,58.16,1,-65175,40215,105390,-24960,0,0,28430,0,0,,28430,28430
35,08/30/2018,80,19:45,20:00,58.16,,0,58.16,58.16,1,-73122,36633,109755,-36489,0,0,28947,0,0,,28947,28947
35,08/30/2018,81,20:00,20:15,53.12,,0,53.12,53.12,1,-83574,57224,140798,-26350,0,0,21006,0,0,,21006,21006
35,08/30/2018,82,20:15,20:30,53.61,,0,53.61,53.61,1,-82339,56848,139187,-25491,0,0,14999,0,0,,14999,14999
35,08/30/2018,83,20:30,20:45,74.12,,0,74.12,74.12,1,-89811,35159,124970,-54652,0,0,31964,0,0,,31964,31964
35,08/30/2018,84,20:45,21:00,143.12,,0,143.12,143.12,1,-118420,33552,151972,-84868,0,0,62579,0,0,,62579,62579
35,08/30/2018,85,21:00,21:15,72.61,,0,72.61,72.61,1,-91463,43930,135393,-47533,0,0,49424,0,0,,49424,49424
35,08/30/2018,86,21:15,21:30,58.16,,0,58.16,58.16,1,-86333,50543,136876,-35790,0,0,38126,0,0,,38126,38126
35,08/30/2018,87,21:30,21:45,53.61,,0,53.61,53.61,1,-80053,68463,148516,-11590,0,0,22560,0,0,,22560,22560
35,08/30/2018,88,21:45,22:00,53.61,37.74,0,37.74,37.74,-1,-64404,79450,143854,15046,0,-6422,2592,0,0,,9014,-3830
35,08/30/2018,89,22:00,22:15,,23.16,0,23.16,23.16,-1,-52505,104173,156678,51668,0,-38375,0,0,0,,38375,-38375
35,08/30/2018,90,22:15,22:30,,43.92,0,43.92,43.92,-1,-38533,42946,81479,4413,0,-20273,0,0,0,,20273,-20273
35,08/30/2018,91,22:30,22:45,,36.94,0,36.94,36.94,-1,-25152,69677,94829,44525,0,-21284,0,0,0,,21284,-21284
35,08/30/2018,92,22:45,23:00,,36.94,0,36.94,36.94,-1,-22435,84948,107383,62513,0,-52306,0,0,0,,52306,-52306
35,08/30/2018,93,23:00,23:15,123.16,37.74,0,123.16,123.16,1,-96769,48113,144882,-48656,0,-27867,6184,0,0,,34051,-21683
35,08/30/2018,94,23:15,23:30,142.12,41.61,0,142.12,41.61,2,-54770,45435,100205,-9335,0,-186,35363,0,0,,35549,35177
35,08/30/2018,95,23:30,23:45,142.12,13.56,0,13.56,13.56,-1,-31300,76481,107781,45181,0,-26172,235,0,0,,26407,-25937
35,08/30/2018,96,23:45,0:00,,35.26,0,35.26,35.26,-1,-28722,104934,133656,76212,0,-28519,0,0,0,,28519,-28519
35,08/31/2018,1,0:00,0:15,,-7.59,0,-7.59,-7.59,-1,-37535,98061,135596,60526,0,-55818,0,0,0,,55818,-55818
35,08/31/2018,2,0:15,0:30,,38.44,0,38.44,38.44,-1,-23431,69137,92568,45706,0,-48191,0,0,0,,48191,-48191
35,08/31/2018,3,0:30,0:45,,38.44,0,38.44,38.44,-1,-32040,88318,120358,56278,0,-48705,0,0,0,,48705,-48705
35,08/31/2018,4,0:45,1:00,,20.13,0,20.13,20.13,-1,-26807,125019,151826,98212,0,-83412,0,0,0,,83412,-83412
35,08/31/2018,5,1:00,1:15,,23.88,0,23.88,23.88,-1,-39910,64490,104400,24580,0,-52265,0,0,0,,52265,-52265
35,08/31/2018,6,1:15,1:30,,38.44,0,38.44,38.44,-1,-31405,69218,100623,37813,0,-22764,0,0,0,,22764,-22764
35,08/31/2018,7,1:30,1:45,,33.47,0,33.47,33.47,-1,-30819,97048,127867,66229,0,-51392,0,0,0,,51392,-51392
35,08/31/2018,8,1:45,2:00,,32.03,0,32.03,32.03,-1,-34374,106677,141051,72303,0,-77633,0,0,0,,77633,-77633
35,08/31/2018,9,2:00,2:15,,38.44,0,38.44,38.44,-1,-27266,61810,89076,34544,0,-33985,0,0,0,,33985,-33985
35,08/31/2018,10,2:15,2:30,,46.31,0,46.31,46.31,-1,-26942,65553,92495,38611,0,-531,0,0,0,,531,-531
35,08/31/2018,11,2:30,2:45,,38.44,0,38.44,38.44,-1,-22679,78271,100950,55592,0,-10890,0,0,0,,10890,-10890
35,08/31/2018,12,2:45,3:00,,23.88,0,23.88,23.88,-1,-25631,78992,104623,53361,0,-47005,0,0,0,,47005,-47005
35,08/31/2018,13,3:00,3:15,,38.44,0,38.44,38.44,-1,-24132,64055,88187,39923,0,-35890,0,0,0,,35890,-35890
35,08/31/2018,14,3:15,3:30,,42.31,0,42.31,42.31,-1,-25655,64385,90040,38730,0,-23309,0,0,0,,23309,-23309
35,08/31/2018,15,3:30,3:45,,46.03,0,46.03,46.03,-1,-24722,79996,104718,55274,0,-18265,0,0,0,,18265,-18265
35,08/31/2018,16,3:45,4:00,,42.31,0,42.31,42.31,-1,-25772,80013,105785,54241,0,-28168,0,0,0,,28168,-28168
35,08/31/2018,17,4:00,4:15,,42.31,0,42.31,42.31,-1,-27408,76466,103874,49058,0,-24661,0,0,0,,24661,-24661
35,08/31/2018,18,4:15,4:30,,46.31,0,46.31,46.31,-1,-28358,74756,103114,46398,0,-5785,0,0,0,,5785,-5785
35,08/31/2018,19,4:30,4:45,,,0,46.36,46.36,0,-29658,64906,94564,35248,0,-322,0,0,0,,322,-322
35,08/31/2018,20,4:45,5:00,,46.31,0,46.31,46.31,-1,-27758,71673,99431,43915,0,-511,0,0,0,,511,-511
35,08/31/2018,21,5:00,5:15,,42.31,0,42.31,42.31,-1,-55690,94674,150364,38984,0,-16116,0,0,0,,16116,-16116
35,08/31/2018,22,5:15,5:30,,44.51,0,44.51,44.51,-1,-31777,61479,93256,29702,0,-25223,0,0,0,,25223,-25223
35,08/31/2018,23,5:30,5:45,,,0,46.37,46.37,0,-33031,53200,86231,20169,0,-4545,0,0,0,,4545,-4545
35,08/31/2018,24,5:45,6:00,50.31,,0,50.31,50.31,1,-41462,42457,83919,995,0,0,11,0,0,,11,11
35,08/31/2018,25,6:00,6:15,,39.61,0,39.61,39.61,-1,-76881,95575,172456,18694,0,-2868,0,0,0,,2868,-2868
35,08/31/2018,26,6:15,6:30,,-18.51,0,-18.51,-18.51,-1,-25752,77361,103113,51609,0,-44678,0,0,0,,44678,-44678
35,08/31/2018,27,6:30,6:45,,48.03,0,48.03,48.03,-1,-48824,42965,91789,-5859,0,-5360,0,0,0,,5360,-5360
35,08/31/2018,28,6:45,7:00,49.28,,0,49.28,49.28,1,-64941,34935,99876,-30006,0,0,680,0,0,,680,680
35,08/31/2018,29,7:00,7:15,49.56,39.61,0,49.56,39.61,2,-51525,104787,156312,53262,0,-15141,302,0,0,,15443,-14839
35,08/31/2018,30,7:15,7:30,,47.03,0,47.03,47.03,-1,-50116,58660,108776,8544,0,-15237,0,0,0,,15237,-15237
35,08/31/2018,31,7:30,7:45,60.06,47.03,0,60.06,60.06,1,-61770,39637,101407,-22133,0,-124,2972,0,0,,3096,2848
35,08/31/2018,32,7:45,8:00,60.06,,0,60.06,60.06,1,-83002,30351,113353,-52651,0,0,27381,0,0,,27381,27381
35,08/31/2018,33,8:00,8:15,53.14,,0,53.14,53.14,1,-80966,67377,148343,-13589,0,0,13238,0,0,,13238,13238
35,08/31/2018,34,8:15,8:30,51.48,50.79,0,51.63,50.79,2,-61247,50501,111748,-10746,0,-326,585,0,0,,911,259
35,08/31/2018,35,8:30,8:45,60.06,,0,60.06,60.06,1,-88653,54041,142694,-34612,0,0,19655,0,0,,19655,19655
35,08/31/2018,36,8:45,9:00,55.48,,0,55.48,55.48,1,-97694,43558,141252,-54136,0,0,28404,0,0,,28404,28404
35,08/31/2018,37,9:00,9:15,74.83,,0,74.83,74.83,1,-103607,37430,141037,-66177,0,0,37478,0,0,,37478,37478
35,08/31/2018,38,9:15,9:30,55.48,,0,55.48,55.48,1,-90161,42874,133035,-47287,0,0,30118,0,0,,30118,30118
35,08/31/2018,39,9:30,9:45,55.48,,0,55.48,55.48,1,-75498,59118,134616,-16380,0,0,23015,0,0,,23015,23015
35,08/31/2018,40,9:45,10:00,55.48,51,0,51,51,-1,-59234,58156,117390,-1078,0,-160,3165,0,0,,3325,3005
35,08/31/2018,41,10:00,10:15,74.83,,0,74.83,74.83,1,-83814,34218,118032,-49596,0,0,12776,0,0,,12776,12776
35,08/31/2018,42,10:15,10:30,55.48,,0,55.48,55.48,1,-60268,51412,111680,-8856,0,0,15422,0,0,,15422,15422
35,08/31/2018,43,10:30,10:45,,,0,51.13,51.13,0,-60066,58091,118157,-1975,0,0,3096,0,0,,3096,3096
35,08/31/2018,44,10:45,11:00,,,0,51.91,51.91,0,-65611,50213,115824,-15398,0,0,0,0,0,,0,0
35,08/31/2018,45,11:00,11:15,51.48,,0,51.48,51.48,1,-116065,37395,153460,-78670,0,0,253,0,0,,253,253
35,08/31/2018,46,11:15,11:30,49.47,,0,49.47,49.47,1,-112075,30796,142871,-81279,0,0,6,0,0,,6,6
35,08/31/2018,47,11:30,11:45,51.48,,0,51.48,51.48,1,-107457,37296,144753,-70161,0,0,757,0,0,,757,757
35,08/31/2018,48,11:45,12:00,50.19,,0,50.19,50.19,1,-97738,45468,143206,-52270,0,0,2345,0,0,,2345,2345
35,08/31/2018,49,12:00,12:15,51.48,,0,51.48,51.48,1,-117541,18681,136222,-98860,0,0,2377,0,0,,2377,2377
35,08/31/2018,50,12:15,12:30,49.91,,0,49.91,49.91,1,-110509,23317,133826,-87192,0,0,2664,0,0,,2664,2664
35,08/31/2018,51,12:30,12:45,,,0,50.77,50.77,0,-74026,29891,103917,-44135,0,0,444,0,0,,444,444
35,08/31/2018,52,12:45,13:00,,,0,50.77,50.77,0,-69874,39091,108965,-30783,0,0,0,0,0,,0,0
35,08/31/2018,53,13:00,13:15,125.06,,0,125.06,125.06,1,-87248,36135,123383,-51113,0,0,11245,0,0,,11245,11245
35,08/31/2018,54,13:15,13:30,60.06,,0,60.06,60.06,1,-121569,41563,163132,-80006,0,0,24638,0,0,,24638,24638
35,08/31/2018,55,13:30,13:45,60.06,,0,60.06,60.06,1,-101709,37960,139669,-63749,0,0,23663,0,0,,23663,23663
35,08/31/2018,56,13:45,14:00,55.48,,0,55.48,55.48,1,-148379,36019,184398,-112360,0,0,10104,0,0,,10104,10104
35,08/31/2018,57,14:00,14:15,51.94,,0,51.94,51.94,1,-127979,41424,169403,-86555,0,0,15330,0,0,,15330,15330
35,08/31/2018,58,14:15,14:30,60.06,,0,60.06,60.06,1,-127886,37491,165377,-90395,0,0,25220,0,0,,25220,25220
35,08/31/2018,59,14:30,14:45,55.48,,0,55.48,55.48,1,-110299,37022,147321,-73277,0,0,20703,0,0,,20703,20703
35,08/31/2018,60,14:45,15:00,51.28,,0,51.28,51.28,1,-129435,37696,167131,-91739,0,0,3079,0,0,,3079,3079
35,08/31/2018,61,15:00,15:15,50.73,,0,50.73,50.73,1,-44716,59261,103977,14545,0,0,764,0,0,,764,764
35,08/31/2018,62,15:15,15:30,,,0,50.79,50.79,0,-41430,62432,103862,21002,0,0,0,0,0,,0,0
35,08/31/2018,63,15:30,15:45,,,0,50.79,50.79,0,-50361,59054,109415,8693,0,0,0,0,0,,0,0
35,08/31/2018,64,15:45,16:00,51.48,,0,51.48,51.48,1,-59846,46691,106537,-13155,0,0,973,0,0,,973,973
35,08/31/2018,65,16:00,16:15,52.13,,0,52.13,52.13,1,-58827,52924,111751,-5903,0,0,2285,0,0,,2285,2285
35,08/31/2018,66,16:15,16:30,51.48,,0,51.48,51.48,1,-62250,56833,119083,-5417,0,0,2645,0,0,,2645,2645
35,08/31/2018,67,16:30,16:45,52.64,,0,52.64,52.64,1,-62047,50057,112104,-11990,0,0,4599,0,0,,4599,4599
35,08/31/2018,68,16:45,17:00,51.48,,0,51.48,51.48,1,-68411,41624,110035,-26787,0,0,7616,0,0,,7616,7616
35,08/31/2018,69,17:00,17:15,50.35,,0,50.35,50.35,1,-54888,45454,100342,-9434,0,0,5793,0,0,,5793,5793
35,08/31/2018,70,17:15,17:30,60.06,,0,60.06,60.06,1,-66624,41353,107977,-25271,0,0,6277,0,0,,6277,6277
35,08/31/2018,71,17:30,17:45,60.06,,0,60.06,60.06,1,-60194,32675,92869,-27519,0,0,19247,0,0,,19247,19247
35,08/31/2018,72,17:45,18:00,60.06,,0,60.06,60.06,1,-69561,40288,109849,-29273,0,0,23408,0,0,,23408,23408
35,08/31/2018,73,18:00,18:15,60.06,,0,60.06,60.06,1,-97176,37601,134777,-59575,0,0,25255,0,0,,25255,25255
35,08/31/2018,74,18:15,18:30,55.48,,0,55.48,55.48,1,-75485,52956,128441,-22529,0,0,18015,0,0,,18015,18015
35,08/31/2018,75,18:30,18:45,50.91,,0,50.91,50.91,1,-70090,62604,132694,-7486,0,0,2093,0,0,,2093,2093
35,08/31/2018,76,18:45,19:00,51.48,,0,51.48,51.48,1,-65396,68955,134351,3559,0,0,2051,0,0,,2051,2051
35,08/31/2018,77,19:00,19:15,51.48,,0,51.48,51.48,1,-92180,54382,146562,-37798,0,0,1327,0,0,,1327,1327
35,08/31/2018,78,19:15,19:30,55.48,,0,55.48,55.48,1,-81731,55730,137461,-26001,0,0,8416,0,0,,8416,8416
35,08/31/2018,79,19:30,19:45,55.48,,0,55.48,55.48,1,-71020,57974,128994,-13046,0,0,16643,0,0,,16643,16643
35,08/31/2018,80,19:45,20:00,51.8,,0,51.8,51.8,1,-72925,55153,128078,-17772,0,0,9700,0,0,,9700,9700
35,08/31/2018,81,20:00,20:15,51.79,,0,51.79,51.79,1,-74793,60277,135070,-14516,0,0,10637,0,0,,10637,10637
35,08/31/2018,82,20:15,20:30,74.83,,0,74.83,74.83,1,-93031,51721,144752,-41310,0,0,23827,0,0,,23827,23827
35,08/31/2018,83,20:30,20:45,60.06,,0,60.06,60.06,1,-99020,39290,138310,-59730,0,0,42391,0,0,,42391,42391
35,08/31/2018,84,20:45,21:00,60.06,,0,60.06,60.06,1,-126464,34629,161093,-91835,0,0,41860,0,0,,41860,41860
35,08/31/2018,85,21:00,21:15,80.39,,0,80.39,80.39,1,-85462,31070,116532,-54392,0,0,42113,0,0,,42113,42113
35,08/31/2018,86,21:15,21:30,55.48,,0,55.48,55.48,1,-78426,40276,118702,-38150,0,0,27188,0,0,,27188,27188
35,08/31/2018,87,21:30,21:45,55.48,49.94,0,49.94,49.94,-1,-54754,41769,96523,-12985,0,-102,5405,0,0,,5507,5303
35,08/31/2018,88,21:45,22:00,,47.48,0,47.48,47.48,-1,-54910,51314,106224,-3596,0,-790,0,0,0,,790,-790
35,08/31/2018,89,22:00,22:15,,39.61,0,39.61,39.61,-1,-61451,74597,136048,13146,0,-7422,0,0,0,,7422,-7422
35,08/31/2018,90,22:15,22:30,,,0,50.69,50.69,0,-47583,25649,73232,-21934,0,-4,0,0,0,,4,-4
35,08/31/2018,91,22:30,22:45,,,0,50.69,50.69,0,-41127,36602,77729,-4525,0,0,0,0,0,,0,0
35,08/31/2018,92,22:45,23:00,,47.48,0,47.48,47.48,-1,-22523,45360,67883,22837,0,-1473,0,0,0,,1473,-1473
35,08/31/2018,93,23:00,23:15,125.06,25.06,0,125.06,25.06,2,-51294,38018,89312,-13276,0,-16545,2721,0,0,,19266,-13824
35,08/31/2018,94,23:15,23:30,159.02,47.48,0,159.02,47.48,2,-43725,33811,77536,-9914,0,-154,25988,0,0,,26142,25834
35,08/31/2018,95,23:30,23:45,159.02,39.61,0,39.61,39.61,-1,-31061,70264,101325,39203,0,-19103,66,0,0,,19169,-19037
35,08/31/2018,96,23:45,0:00,,31.62,0,31.62,31.62,-1,-16846,83377,100223,66531,0,-52214,0,0,0,,52214,-52214
36,09-01-18,1,0:00,0:15,125.06,30.03,0,125.06,125.06,1,-96373,44324,140697,-52049,0,-31799,4042,0,0,,35841,-27757
36,09-01-18,2,0:15,0:30,144.02,30.03,0,144.02,144.02,1,-43228,12367,55595,-30861,0,-30,27279,0,0,,27309,27249
36,09-01-18,3,0:30,0:45,144.02,50.53,0,50.53,50.53,-1,-22616,35977,58593,13361,0,-1326,1991,0,0,,3317,665
36,09-01-18,4,0:45,1:00,,43.41,0,43.41,43.41,-1,-17265,42783,60048,25518,0,-15120,0,0,0,,15120,-15120
36,09-01-18,5,1:00,1:15,51.14,50.66,0,51.14,51.14,1,-87063,43222,130285,-43841,0,-7277,337,0,0,,7614,-6940
36,09-01-18,6,1:15,1:30,51.16,50.66,0,51.16,51.16,1,-63741,46469,110210,-17272,0,-1,1505,0,0,,1506,1504
36,09-01-18,7,1:30,1:45,51.16,47.48,0,47.48,47.48,-1,-43680,53647,97327,9967,0,-2544,105,0,0,,2649,-2439
36,09-01-18,8,1:45,2:00,,47.48,0,47.48,47.48,-1,-34608,30597,65205,-4011,0,-6339,0,0,0,,6339,-6339
36,09-01-18,9,2:00,2:15,,,0,48.4,48.4,0,-65789,62957,128746,-2832,0,-231,0,0,0,,231,-231
36,09-01-18,10,2:15,2:30,,,0,48.4,48.4,0,-64681,46548,111229,-18133,0,0,0,0,0,,0,0
36,09-01-18,11,2:30,2:45,,52.95,0,52.95,52.95,-1,-50708,48240,98948,-2468,0,-117,0,0,0,,117,-117
36,09-01-18,12,2:45,3:00,,47.48,0,47.48,47.48,-1,-44426,45852,90278,1426,0,-7339,0,0,0,,7339,-7339
36,09-01-18,13,3:00,3:15,51.48,53.63,0,51.48,48.33,2,-45109,36963,82072,-8146,0,-2943,900,0,0,,3843,-2043
36,09-01-18,14,3:15,3:30,51.48,,0,51.48,51.48,1,-42640,34494,77134,-8146,0,0,2343,0,0,,2343,2343
36,09-01-18,15,3:30,3:45,,,0,48.33,48.33,0,-32060,35688,67748,3628,0,0,66,0,0,,66,66
36,09-01-18,16,3:45,4:00,51.37,,0,51.37,51.37,1,-36949,35877,72826,-1072,0,0,1404,0,0,,1404,1404
36,09-01-18,17,4:00,4:15,51.48,,0,51.48,51.48,1,-36413,25097,61510,-11316,0,0,2504,0,0,,2504,2504
36,09-01-18,18,4:15,4:30,52.21,,0,52.21,52.21,1,-41503,23638,65141,-17865,0,0,5067,0,0,,5067,5067
36,09-01-18,19,4:30,4:45,51.48,,0,51.48,51.48,1,-37506,25352,62858,-12154,0,0,5388,0,0,,5388,5388
36,09-01-18,20,4:45,5:00,,,0,48.27,48.27,0,-29398,26954,56352,-2444,0,0,519,0,0,,519,519
36,09-01-18,21,5:00,5:15,,49.44,0,49.44,49.44,-1,-26630,33217,59847,6587,0,-301,0,0,0,,301,-301
36,09-01-18,22,5:15,5:30,,47.48,0,47.48,47.48,-1,-26197,33092,59289,6895,0,-2844,0,0,0,,2844,-2844
36,09-01-18,23,5:30,5:45,,49.25,0,49.25,49.25,-1,-32647,29246,61893,-3401,0,-3032,0,0,0,,3032,-3032
36,09-01-18,24,5:45,6:00,51.48,49.25,0,51.48,51.48,1,-41730,23355,65085,-18375,0,-498,743,0,0,,1241,245
36,09-01-18,25,6:00,6:15,51.42,,0,51.42,51.42,1,-69975,50303,120278,-19672,0,0,3067,0,0,,3067,3067
36,09-01-18,26,6:15,6:30,50.71,,0,50.71,50.71,1,-53637,40705,94342,-12932,0,0,3218,0,0,,3218,3218
36,09-01-18,27,6:30,6:45,50.71,,0,50.71,50.71,1,-43679,30391,74070,-13288,0,0,4756,0,0,,4756,4756
36,09-01-18,28,6:45,7:00,50.71,46.71,0,46.71,46.71,-1,-21615,40773,62388,19158,0,-1518,657,0,0,,2175,-861
36,09-01-18,29,7:00,7:15,,48.13,0,48.13,48.13,-1,-49375,40057,89432,-9318,0,-644,0,0,0,,644,-644
36,09-01-18,30,7:15,7:30,,,0,48.59,48.59,0,-58327,43571,101898,-14756,0,0,0,0,0,,0,0
36,09-01-18,31,7:30,7:45,,,0,48.59,48.59,0,-58132,37593,95725,-20539,0,0,0,0,0,,0,0
36,09-01-18,32,7:45,8:00,54.71,,0,54.71,54.71,1,-50838,35765,86603,-15073,0,0,4338,0,0,,4338,4338
36,09-01-18,33,8:00,8:15,,,0,52.47,52.47,0,-75185,50707,125892,-24478,0,0,60,0,0,,60,60
36,09-01-18,34,8:15,8:30,,,0,52.47,52.47,0,-85073,51906,136979,-33167,0,0,0,0,0,,0,0
36,09-01-18,35,8:30,8:45,54.71,,0,54.71,54.71,1,-73681,41943,115624,-31738,0,0,6475,0,0,,6475,6475
36,09-01-18,36,8:45,9:00,53.04,,0,53.04,53.04,1,-68862,34150,103012,-34712,0,0,16986,0,0,,16986,16986
36,09-01-18,37,9:00,9:15,54.71,,0,54.71,54.71,1,-86540,16847,103387,-69693,0,0,17889,0,0,,17889,17889
36,09-01-18,38,9:15,9:30,52.55,,0,52.55,52.55,1,-61054,35074,96128,-25980,0,0,16345,0,0,,16345,16345
36,09-01-18,39,9:30,9:45,51.65,,0,51.65,51.65,1,-62876,40792,103668,-22084,0,0,11263,0,0,,11263,11263
36,09-01-18,40,9:45,10:00,,,0,49.12,49.12,0,-62098,42497,104595,-19601,0,0,1798,0,0,,1798,1798
36,09-01-18,41,10:00,10:15,58.8,,0,58.8,58.8,1,-76900,32018,108918,-44882,0,0,5257,0,0,,5257,5257
36,09-01-18,42,10:15,10:30,51.69,,0,51.69,51.69,1,-66681,39467,106148,-27214,0,0,5015,0,0,,5015,5015
36,09-01-18,43,10:30,10:45,,,0,49.12,49.12,0,-78142,50052,128194,-28090,0,0,69,0,0,,69,69
36,09-01-18,44,10:45,11:00,,52.09,0,52.09,52.09,-1,-58192,55519,113711,-2673,0,-260,0,0,0,,260,-260
36,09-01-18,45,11:00,11:15,,,0,49.12,49.12,0,-65249,55031,120280,-10218,0,-91,0,0,0,,91,-91
36,09-01-18,46,11:15,11:30,,50.04,0,50.04,50.04,-1,-52804,61209,114013,8405,0,-1167,0,0,0,,1167,-1167
36,09-01-18,47,11:30,11:45,,46.71,0,46.71,46.71,-1,-38941,63301,102242,24360,0,-10263,0,0,0,,10263,-10263
36,09-01-18,48,11:45,12:00,,48.03,0,48.03,48.03,-1,-40683,65930,106613,25247,0,-13672,0,0,0,,13672,-13672
36,09-01-18,49,12:00,12:15,,51.06,0,51.06,51.06,-1,-49123,41625,90748,-7498,0,-5821,0,0,0,,5821,-5821
36,09-01-18,50,12:15,12:30,44.02,51.06,0,44.02,44.02,1,-54182,44562,98744,-9620,0,-18,110,0,0,,128,92
36,09-01-18,51,12:30,12:45,,,0,49.12,49.12,0,-32649,44879,77528,12230,0,0,0,0,0,,0,0
36,09-01-18,52,12:45,13:00,,,0,49.12,49.12,0,-31554,54337,85891,22783,0,0,0,0,0,,0,0
36,09-01-18,53,13:00,13:15,,,0,49.01,49.01,0,-50188,96253,146441,46065,0,0,0,0,0,,0,0
36,09-01-18,54,13:15,13:30,,,0,49.01,49.01,0,-65995,74837,140832,8842,0,0,0,0,0,,0,0
36,09-01-18,55,13:30,13:45,,,0,49.01,49.01,0,-62196,65275,127471,3079,0,0,0,0,0,,0,0
36,09-01-18,56,13:45,14:00,,53.04,0,53.04,53.04,-1,-59198,72713,131911,13515,0,-486,0,0,0,,486,-486
36,09-01-18,57,14:00,14:15,50.71,48.9,0,50.71,48.9,2,-52599,42383,94982,-10216,0,-730,55,0,0,,785,-675
36,09-01-18,58,14:15,14:30,51.8,,0,51.8,51.8,1,-58740,36475,95215,-22265,0,0,4430,0,0,,4430,4430
36,09-01-18,59,14:30,14:45,51.14,,0,51.14,51.14,1,-75205,39795,115000,-35410,0,0,7948,0,0,,7948,7948
36,09-01-18,60,14:45,15:00,,,0,48.94,48.94,0,-73013,40238,113251,-32775,0,0,1754,0,0,,1754,1754
36,09-01-18,61,15:00,15:15,74.28,,0,74.28,74.28,1,-83389,28279,111668,-55110,0,0,14188,0,0,,14188,14188
36,09-01-18,62,15:15,15:30,74.28,,0,74.28,74.28,1,-75673,29652,105325,-46021,0,0,26560,0,0,,26560,26560
36,09-01-18,63,15:30,15:45,58.8,,0,58.8,58.8,1,-80057,31472,111529,-48585,0,0,25777,0,0,,25777,25777
36,09-01-18,64,15:45,16:00,54.71,52.81,0,54.71,48.9,2,-80343,30350,110693,-49993,0,-45,18977,0,0,,19022,18932
36,09-01-18,65,16:00,16:15,54.71,48.87,0,48.87,48.87,-1,-18407,54296,72703,35889,0,-356,832,0,0,,1188,476
36,09-01-18,66,16:15,16:30,,,0,48.92,48.92,0,-30612,46070,76682,15458,0,0,0,0,0,,0,0
36,09-01-18,67,16:30,16:45,,,0,48.92,48.92,0,-27037,40100,67137,13063,0,0,0,0,0,,0,0
36,09-01-18,68,16:45,17:00,51.14,,0,51.14,51.14,1,-61646,34538,96184,-27108,0,0,2088,0,0,,2088,2088
36,09-01-18,69,17:00,17:15,44.02,51.59,0,49.12,49.12,2,-28469,77462,105931,48993,0,-444,177,0,0,,621,-267
36,09-01-18,70,17:15,17:30,,51.06,0,51.06,51.06,-1,-37691,58273,95964,20582,0,-2111,0,0,0,,2111,-2111
36,09-01-18,71,17:30,17:45,57.73,51.06,0,57.73,57.73,1,-59887,41186,101073,-18701,0,-20,4240,0,0,,4260,4220
36,09-01-18,72,17:45,18:00,74.28,,0,74.28,74.28,1,-89645,36952,126597,-52693,0,0,35132,0,0,,35132,35132
36,09-01-18,73,18:00,18:15,58.8,,0,58.8,58.8,1,-55380,25618,80998,-29762,0,0,19930,0,0,,19930,19930
36,09-01-18,74,18:15,18:30,,,0,49.12,49.12,0,-64515,23673,88188,-40842,0,0,0,0,0,,0,0
36,09-01-18,75,18:30,18:45,144.02,,0,144.02,144.02,1,-86423,23612,110035,-62811,0,0,13589,0,0,,13589,13589
36,09-01-18,76,18:45,19:00,144.02,,0,144.02,144.02,1,-71727,26697,98424,-45030,0,0,42456,0,0,,42456,42456
36,09-01-18,77,19:00,19:15,53.8,53.25,0,53.8,49.12,2,-37913,49697,87610,11784,0,-384,15708,0,0,,16092,15324
36,09-01-18,78,19:15,19:30,58.8,,0,58.8,58.8,1,-64530,42728,107258,-21802,0,0,5415,0,0,,5415,5415
36,09-01-18,79,19:30,19:45,54.74,,0,54.74,54.74,1,-69838,42918,112756,-26920,0,0,18358,0,0,,18358,18358
36,09-01-18,80,19:45,20:00,74.28,,0,74.28,74.28,1,-90027,42717,132744,-47310,0,0,30986,0,0,,30986,30986
36,09-01-18,81,20:00,20:15,52.19,,0,52.19,52.19,1,-45729,36204,81933,-9525,0,0,11201,0,0,,11201,11201
36,09-01-18,82,20:15,20:30,,53.31,0,53.31,53.31,-1,-48300,30696,78996,-17604,0,-216,0,0,0,,216,-216
36,09-01-18,83,20:30,20:45,,53.25,0,53.25,53.25,-1,-61722,24953,86675,-36769,0,-7,0,0,0,,7,-7
36,09-01-18,84,20:45,21:00,,,0,49.12,49.12,0,-97901,19997,117898,-77904,0,0,0,0,0,,0,0
36,09-01-18,85,21:00,21:15,58.8,,0,58.8,58.8,1,-66890,36656,103546,-30234,0,0,8092,0,0,,8092,8092
36,09-01-18,86,21:15,21:30,51.94,,0,51.94,51.94,1,-57213,39743,96956,-17470,0,0,5888,0,0,,5888,5888
36,09-01-18,87,21:30,21:45,51.94,42.71,0,42.71,42.71,-1,-34269,50319,84588,16050,0,-1815,472,0,0,,2287,-1343
36,09-01-18,88,21:45,22:00,,41.99,0,41.99,41.99,-1,-38253,64237,102490,25984,0,-15069,0,0,0,,15069,-15069
36,09-01-18,89,22:00,22:15,52.18,47.06,0,52.46,47.06,2,-45013,39039,84052,-5974,0,-9131,1395,0,0,,10526,-7736
36,09-01-18,90,22:15,22:30,52.18,46.71,0,46.71,46.71,-1,-53462,58805,112267,5343,0,-1797,16,0,0,,1813,-1781
36,09-01-18,91,22:30,22:45,,42.41,0,42.41,42.41,-1,-54093,72131,126224,18038,0,-2637,0,0,0,,2637,-2637
36,09-01-18,92,22:45,23:00,,40.11,0,40.11,40.11,-1,-59124,97193,156317,38069,0,-26086,0,0,0,,26086,-26086
36,09-01-18,93,23:00,23:15,54.71,24.05,0,54.71,24.05,2,-59612,71732,131344,12120,0,-30453,201,0,0,,30654,-30252
36,09-01-18,94,23:15,23:30,124.28,24.05,0,124.28,124.28,1,-52308,28629,80937,-23679,0,-1691,15705,0,0,,17396,14014
36,09-01-18,95,23:30,23:45,124.28,35.6,0,35.6,35.6,-1,-27328,48694,76022,21366,0,-3652,593,0,0,,4245,-3059
36,09-01-18,96,23:45,0:00,,30.59,0,30.59,30.59,-1,-56216,58574,114790,2358,0,-25301,0,0,0,,25301,-25301
36,09-02-18,1,0:00,0:15,,45.98,0,45.98,45.98,-1,-34496,138595,173091,104099,0,-3080,0,0,0,,3080,-3080
36,09-02-18,2,0:15,0:30,,,0,52.1,52.1,0,-28119,39628,67747,11509,0,0,0,0,0,,0,0
36,09-02-18,3,0:30,0:45,,38.16,0,38.16,38.16,-1,-16747,48693,65440,31946,0,-2405,0,0,0,,2405,-2405
36,09-02-18,4,0:45,1:00,,24.05,0,24.05,24.05,-1,-51791,58059,109850,6268,0,-24538,0,0,0,,24538,-24538
36,09-02-18,5,1:00,1:15,,24.05,0,24.05,24.05,-1,-45315,142211,187526,96896,0,-22334,0,0,0,,22334,-22334
36,09-02-18,6,1:15,1:30,,37.23,0,37.23,37.23,-1,-35029,71773,106802,36744,0,-11669,0,0,0,,11669,-11669
36,09-02-18,7,1:30,1:45,,31.1,0,31.1,31.1,-1,-40563,75615,116178,35052,0,-25749,0,0,0,,25749,-25749
36,09-02-18,8,1:45,2:00,,38.16,0,38.16,38.16,-1,-43920,86316,130236,42396,0,-31306,0,0,0,,31306,-31306
36,09-02-18,9,2:00,2:15,53.98,45.42,0,53.98,53.98,1,-67659,54516,122175,-13143,0,-12603,1001,0,0,,13604,-11602
36,09-02-18,10,2:15,2:30,53.98,45.42,0,53.98,53.98,1,-63391,52712,116103,-10679,0,-45,4538,0,0,,4583,4493
36,09-02-18,11,2:30,2:45,50.86,,0,50.86,50.86,1,-61387,49677,111064,-11710,0,0,3736,0,0,,3736,3736
36,09-02-18,12,2:45,3:00,50.86,,0,50.86,50.86,1,-49699,52146,101845,2447,0,0,3116,0,0,,3116,3116
36,09-02-18,13,3:00,3:15,,,0,46.82,46.82,0,-37328,29972,67300,-7356,0,0,0,0,0,,0,0
36,09-02-18,14,3:15,3:30,,,0,46.83,46.83,0,-46538,32255,78793,-14283,0,0,0,0,0,,0,0
36,09-02-18,15,3:30,3:45,,49.63,0,49.63,49.63,-1,-40185,34100,74285,-6085,0,-185,0,0,0,,185,-185
36,09-02-18,16,3:45,4:00,,48.3,0,48.3,48.3,-1,-43323,35176,78499,-8147,0,-660,0,0,0,,660,-660
36,09-02-18,17,4:00,4:15,,49.15,0,49.15,49.15,-1,-30307,43993,74300,13686,0,-501,0,0,0,,501,-501
36,09-02-18,18,4:15,4:30,,49.16,0,49.16,49.16,-1,-33538,44425,77963,10887,0,-1178,0,0,0,,1178,-1178
36,09-02-18,19,4:30,4:45,,38.16,0,38.16,38.16,-1,-27163,45355,72518,18192,0,-10757,0,0,0,,10757,-10757
36,09-02-18,20,4:45,5:00,,41.98,0,41.98,41.98,-1,-23852,46324,70176,22472,0,-13007,0,0,0,,13007,-13007
36,09-02-18,21,5:00,5:15,,45.98,0,45.98,45.98,-1,-19098,67597,86695,48499,0,-8658,0,0,0,,8658,-8658
36,09-02-18,22,5:15,5:30,,,0,46.56,46.56,0,-20796,67384,88180,46588,0,-65,0,0,0,,65,-65
36,09-02-18,23,5:30,5:45,,,0,46.56,46.56,0,-24932,68408,93340,43476,0,0,0,0,0,,0,0
36,09-02-18,24,5:45,6:00,,48.98,0,48.98,48.98,-1,-23754,75095,98849,51341,0,-288,0,0,0,,288,-288
36,09-02-18,25,6:00,6:15,,35.37,0,35.37,35.37,-1,-30045,75875,105920,45830,0,-8732,0,0,0,,8732,-8732
36,09-02-18,26,6:15,6:30,,,0,46.57,46.57,0,-28657,83409,112066,54752,0,-694,0,0,0,,694,-694
36,09-02-18,27,6:30,6:45,,,0,46.58,46.58,0,-24167,97303,121470,73136,0,0,0,0,0,,0,0
36,09-02-18,28,6:45,7:00,,-64.58,0,-64.58,-64.58,-1,-22275,132761,155036,110486,0,-10686,0,0,0,,10686,-10686
36,09-02-18,29,7:00,7:15,,-150.25,0,-150.25,-150.25,-1,-26279,123780,150059,97501,0,-57738,0,0,0,,57738,-57738
36,09-02-18,30,7:15,7:30,,24.03,0,24.03,24.03,-1,-35245,116390,151635,81145,0,-68689,0,0,0,,68689,-68689
36,09-02-18,31,7:30,7:45,,24.03,0,24.03,24.03,-1,-37712,104292,142004,66580,0,-62528,0,0,0,,62528,-62528
36,09-02-18,32,7:45,8:00,,38.14,0,38.14,38.14,-1,-36722,97855,134577,61133,0,-32164,0,0,0,,32164,-32164
36,09-02-18,33,8:00,8:15,,,0,44.6,44.6,0,-62415,65617,128032,3202,0,-3568,0,0,0,,3568,-3568
36,09-02-18,34,8:15,8:30,49.96,,0,49.96,49.96,1,-50884,49286,100170,-1598,0,0,599,0,0,,599,599
36,09-02-18,35,8:30,8:45,51.54,,0,51.54,51.54,1,-41442,30287,71729,-11155,0,0,1211,0,0,,1211,1211
36,09-02-18,36,8:45,9:00,54.64,,0,54.64,54.64,1,-36486,25374,61860,-11112,0,0,12485,0,0,,12485,12485
36,09-02-18,37,9:00,9:15,68.41,,0,68.41,68.41,1,-78860,20703,99563,-58157,0,0,23592,0,0,,23592,23592
36,09-02-18,38,9:15,9:30,55.54,,0,55.54,55.54,1,-50650,21025,71675,-29625,0,0,30312,0,0,,30312,30312
36,09-02-18,39,9:30,9:45,49.96,50.05,0,49.96,47.4,2,-31105,23483,54588,-7622,0,-435,8437,0,0,,8872,8002
36,09-02-18,40,9:45,10:00,51.4,,0,51.4,51.4,1,-32520,15315,47835,-17205,0,0,2095,0,0,,2095,2095
36,09-02-18,41,10:00,10:15,,,0,47.04,47.04,0,-50243,29471,79714,-20772,0,0,301,0,0,,301,301
36,09-02-18,42,10:15,10:30,,,0,47.04,47.04,0,-46058,35778,81836,-10280,0,0,0,0,0,,0,0
36,09-02-18,43,10:30,10:45,,50.04,0,50.04,50.04,-1,-41519,40197,81716,-1322,0,-172,0,0,0,,172,-172
36,09-02-18,44,10:45,11:00,,47.09,0,47.09,47.09,-1,-32889,34295,67184,1406,0,-652,0,0,0,,652,-652
36,09-02-18,45,11:00,11:15,,50.15,0,50.15,50.15,-1,-47001,33407,80408,-13594,0,-1170,0,0,0,,1170,-1170
36,09-02-18,46,11:15,11:30,,47.49,0,47.49,47.49,-1,-36989,41593,78582,4604,0,-4320,0,0,0,,4320,-4320
36,09-02-18,47,11:30,11:45,,46.09,0,46.09,46.09,-1,-30929,44673,75602,13744,0,-7458,0,0,0,,7458,-7458
36,09-02-18,48,11:45,12:00,,45.96,0,45.96,45.96,-1,-31384,46363,77747,14979,0,-6099,0,0,0,,6099,-6099
36,09-02-18,49,12:00,12:15,,48.08,0,48.08,48.08,-1,-42280,40992,83272,-1288,0,-2256,0,0,0,,2256,-2256
36,09-02-18,50,12:15,12:30,44.12,,0,44.12,44.12,1,-43605,45851,89456,2246,0,0,75,0,0,,75,75
36,09-02-18,51,12:30,12:45,44.12,,0,44.12,44.12,1,-39985,47313,87298,7328,0,0,250,0,0,,250,250
36,09-02-18,52,12:45,13:00,49.96,,0,49.96,49.96,1,-41582,36013,77595,-5569,0,0,1221,0,0,,1221,1221
36,09-02-18,53,13:00,13:15,51.16,,0,51.16,51.16,1,-42337,36169,78506,-6168,0,0,3393,0,0,,3393,3393
36,09-02-18,54,13:15,13:30,51.16,,0,51.16,51.16,1,-49103,29298,78401,-19805,0,0,6837,0,0,,6837,6837
36,09-02-18,55,13:30,13:45,51.16,,0,51.16,51.16,1,-49966,37828,87794,-12138,0,0,5165,0,0,,5165,5165
36,09-02-18,56,13:45,14:00,,,0,47.34,47.34,0,-55094,48317,103411,-6777,0,0,662,0,0,,662,662
36,09-02-18,57,14:00,14:15,53.96,,0,53.96,53.96,1,-60186,41454,101640,-18732,0,0,3945,0,0,,3945,3945
36,09-02-18,58,14:15,14:30,54.94,,0,54.94,54.94,1,-71914,32681,104595,-39233,0,0,22642,0,0,,22642,22642
36,09-02-18,59,14:30,14:45,52.36,,0,52.36,52.36,1,-71664,35974,107638,-35690,0,0,20890,0,0,,20890,20890
36,09-02-18,60,14:45,15:00,51.16,,0,51.16,51.16,1,-67023,40769,107792,-26254,0,0,13272,0,0,,13272,13272
36,09-02-18,61,15:00,15:15,43.83,,0,43.83,43.83,1,-32475,69185,101660,36710,0,0,1883,0,0,,1883,1883
36,09-02-18,62,15:15,15:30,,,0,47.13,47.13,0,-32517,70101,102618,37584,0,0,0,0,0,,0,0
36,09-02-18,63,15:30,15:45,,,0,47.13,47.13,0,-45757,84528,130285,38771,0,0,0,0,0,,0,0
36,09-02-18,64,15:45,16:00,,,0,47.13,47.13,0,-57192,92701,149893,35509,0,0,0,0,0,,0,0
36,09-02-18,65,16:00,16:15,,27.61,0,27.61,27.61,-1,-28087,137443,165530,109356,0,-10211,0,0,0,,10211,-10211
36,09-02-18,66,16:15,16:30,,38.14,0,38.14,38.14,-1,-25833,130323,156156,104490,0,-7364,0,0,0,,7364,-7364
36,09-02-18,67,16:30,16:45,,45.73,0,45.73,45.73,-1,-33804,115376,149180,81572,0,-5055,0,0,0,,5055,-5055
36,09-02-18,68,16:45,17:00,,,0,49.11,49.11,0,-46821,92050,138871,45229,0,-83,0,0,0,,83,-83
36,09-02-18,69,17:00,17:15,,41.6,0,41.6,41.6,-1,-36903,138010,174913,101107,0,-2189,0,0,0,,2189,-2189
36,09-02-18,70,17:15,17:30,,45.96,0,45.96,45.96,-1,-23191,121664,144855,98473,0,-1716,0,0,0,,1716,-1716
36,09-02-18,71,17:30,17:45,,,0,46.91,46.91,0,-39105,78975,118080,39870,0,0,0,0,0,,0,0
36,09-02-18,72,17:45,18:00,,,0,46.91,46.91,0,-51298,84915,136213,33617,0,0,0,0,0,,0,0
36,09-02-18,73,18:00,18:15,53.96,,0,53.96,53.96,1,-81348,35233,116581,-46115,0,0,1414,0,0,,1414,1414
36,09-02-18,74,18:15,18:30,,,0,49.19,49.19,0,-59092,60374,119466,1282,0,0,0,0,0,,0,0
36,09-02-18,75,18:30,18:45,53.96,,0,53.96,53.96,1,-68396,62081,130477,-6315,0,0,1138,0,0,,1138,1138
36,09-02-18,76,18:45,19:00,58.14,,0,58.14,58.14,1,-68946,73756,142702,4810,0,0,7735,0,0,,7735,7735
36,09-02-18,77,19:00,19:15,58.08,,0,58.08,58.08,1,-91209,30394,121603,-60815,0,0,14090,0,0,,14090,14090
36,09-02-18,78,19:15,19:30,73.92,,0,73.92,73.92,1,-81238,37409,118647,-43829,0,0,26371,0,0,,26371,26371
36,09-02-18,79,19:30,19:45,124.03,,0,124.03,124.03,1,-100968,49731,150699,-51237,0,0,46206,0,0,,46206,46206
36,09-02-18,80,19:45,20:00,58.08,,0,58.08,58.08,1,-116982,52513,169495,-64469,0,0,39006,0,0,,39006,39006
36,09-02-18,81,20:00,20:15,49.96,48.21,0,52.1,48.21,2,-75453,80602,156055,5149,0,-1215,9825,0,0,,11040,8610
36,09-02-18,82,20:15,20:30,52.65,,0,52.65,52.65,1,-97005,24495,121500,-72510,0,0,808,0,0,,808,808
36,09-02-18,83,20:30,20:45,58.08,,0,58.08,58.08,1,-115102,22848,137950,-92254,0,0,2720,0,0,,2720,2720
36,09-02-18,84,20:45,21:00,73.69,,0,73.69,73.69,1,-144619,18806,163425,-125813,0,0,30308,0,0,,30308,30308
36,09-02-18,85,21:00,21:15,52.61,,0,52.61,52.61,1,-83687,54020,137707,-29667,0,0,11060,0,0,,11060,11060
36,09-02-18,86,21:15,21:30,,,0,52.1,52.1,0,-81782,50577,132359,-31205,0,0,0,0,0,,0,0
36,09-02-18,87,21:30,21:45,,50.25,0,50.25,50.25,-1,-61629,53670,115299,-7959,0,-534,0,0,0,,534,-534
36,09-02-18,88,21:45,22:00,,45.96,0,45.96,45.96,-1,-48536,78973,127509,30437,0,-4925,0,0,0,,4925,-4925
36,09-02-18,89,22:00,22:15,,45.96,0,45.96,45.96,-1,-63285,71926,135211,8641,0,-6050,0,0,0,,6050,-6050
36,09-02-18,90,22:15,22:30,,38.14,0,38.14,38.14,-1,-48342,77001,125343,28659,0,-4541,0,0,0,,4541,-4541
36,09-02-18,91,22:30,22:45,,38.14,0,38.14,38.14,-1,-37825,82561,120386,44736,0,-18991,0,0,0,,18991,-18991
36,09-02-18,92,22:45,23:00,,45.96,0,45.96,45.96,-1,-39615,111712,151327,72097,0,-5139,0,0,0,,5139,-5139
36,09-02-18,93,23:00,23:15,,45.11,0,45.11,45.11,-1,-55547,153446,208993,97899,0,-1447,0,0,0,,1447,-1447
36,09-02-18,94,23:15,23:30,,24.03,0,24.03,24.03,-1,-29548,132851,162399,103303,0,-8301,0,0,0,,8301,-8301
36,09-02-18,95,23:30,23:45,,24.03,0,24.03,24.03,-1,-21029,112072,133101,91043,0,-29978,0,0,0,,29978,-29978
36,09-02-18,96,23:45,0:00,,-142.78,0,-142.78,-142.78,-1,-17986,136104,154090,118118,0,-53387,0,0,0,,53387,-53387
36,09-03-18,1,0:00,0:15,127.97,-95.96,0,127.97,127.97,1,-135484,12100,147584,-123384,0,-38454,9807,0,0,,48261,-28647
36,09-03-18,2,0:15,0:30,58.14,,0,58.14,58.14,1,-71768,37051,108819,-34717,0,0,18648,0,0,,18648,18648
36,09-03-18,3,0:30,0:45,49.96,41.96,0,41.96,41.96,-1,-40648,46872,87520,6224,0,-2144,2597,0,0,,4741,453
36,09-03-18,4,0:45,1:00,,38.14,0,38.14,38.14,-1,-34633,69882,104515,35249,0,-31477,0,0,0,,31477,-31477
36,09-03-18,5,1:00,1:15,74.03,26.47,0,74.03,26.47,2,-55513,22862,78375,-32651,0,-24235,3754,0,0,,27989,-20481
36,09-03-18,6,1:15,1:30,75.45,26.47,0,75.45,75.45,1,-45647,25663,71310,-19984,0,-19,7776,0,0,,7795,7757
36,09-03-18,7,1:30,1:45,49.96,,0,49.96,49.96,1,-48215,26894,75109,-21321,0,0,29,0,0,,29,29
36,09-03-18,8,1:45,2:00,49.96,,0,49.96,49.96,1,-56833,22110,78943,-34723,0,0,151,0,0,,151,151
36,09-03-18,9,2:00,2:15,58.14,,0,58.14,58.14,1,-56417,29113,85530,-27304,0,0,14577,0,0,,14577,14577
36,09-03-18,10,2:15,2:30,53.96,,0,53.96,53.96,1,-58491,19933,78424,-38558,0,0,18508,0,0,,18508,18508
36,09-03-18,11,2:30,2:45,,,0,51.65,51.65,0,-66912,19672,86584,-47240,0,0,1656,0,0,,1656,1656
36,09-03-18,12,2:45,3:00,,,0,51.64,51.64,0,-79870,18885,98755,-60985,0,0,0,0,0,,0,0
36,09-03-18,13,3:00,3:15,53.96,,0,53.96,53.96,1,-54522,14536,69058,-39986,0,0,1346,0,0,,1346,1346
36,09-03-18,14,3:15,3:30,53.96,,0,53.96,53.96,1,-65728,15890,81618,-49838,0,0,1980,0,0,,1980,1980
36,09-03-18,15,3:30,3:45,51.02,,0,51.02,51.02,1,-65509,22812,88321,-42697,0,0,3296,0,0,,3296,3296
36,09-03-18,16,3:45,4:00,58.14,,0,58.14,58.14,1,-80755,27500,108255,-53255,0,0,16256,0,0,,16256,16256
36,09-03-18,17,4:00,4:15,51.05,,0,51.05,51.05,1,-59428,18042,77470,-41386,0,0,7870,0,0,,7870,7870
36,09-03-18,18,4:15,4:30,,,0,51.48,51.48,0,-64684,10672,75356,-54012,0,0,0,0,0,,0,0
36,09-03-18,19,4:30,4:45,63.24,,0,63.24,63.24,1,-74525,14771,89296,-59754,0,0,7376,0,0,,7376,7376
36,09-03-18,20,4:45,5:00,67.33,,0,67.33,67.33,1,-88250,17714,105964,-70536,0,0,38651,0,0,,38651,38651
36,09-03-18,21,5:00,5:15,49.96,,0,49.96,49.96,1,-83184,42298,125482,-40886,0,0,10743,0,0,,10743,10743
36,09-03-18,22,5:15,5:30,,,0,49.82,49.82,0,-88079,50017,138096,-38062,0,0,0,0,0,,0,0
36,09-03-18,23,5:30,5:45,,,0,49.76,49.76,0,-106696,25335,132031,-81361,0,0,0,0,0,,0,0
36,09-03-18,24,5:45,6:00,53.96,,0,53.96,53.96,1,-121080,26511,147591,-94569,0,0,2701,0,0,,2701,2701
36,09-03-18,25,6:00,6:15,57.47,,0,57.47,57.47,1,-97650,57594,155244,-40056,0,0,2957,0,0,,2957,2957
36,09-03-18,26,6:15,6:30,,,0,52.07,52.07,0,-101868,43855,145723,-58013,0,0,0,0,0,,0,0
36,09-03-18,27,6:30,6:45,124.09,,0,124.09,124.09,1,-136094,21882,157976,-114212,0,0,25333,0,0,,25333,25333
36,09-03-18,28,6:45,7:00,58.2,,0,58.2,58.2,1,-103058,42430,145488,-60628,0,0,34305,0,0,,34305,34305
36,09-03-18,29,7:00,7:15,58.2,,0,58.2,58.2,1,-128544,69092,197636,-59452,0,0,30687,0,0,,30687,30687
36,09-03-18,30,7:15,7:30,124.09,,0,124.09,124.09,1,-119937,44305,164242,-75632,0,0,36751,0,0,,36751,36751
36,09-03-18,31,7:30,7:45,124.09,,0,124.09,124.09,1,-164055,32806,196861,-131249,0,0,78998,0,0,,78998,78998
36,09-03-18,32,7:45,8:00,124.09,,0,124.09,124.09,1,-189182,43301,232483,-145881,0,0,88261,0,0,,88261,88261
36,09-03-18,33,8:00,8:15,124.09,,0,124.09,124.09,1,-119241,70868,190109,-48373,0,0,48004,0,0,,48004,48004
36,09-03-18,34,8:15,8:30,,,0,52.1,52.1,0,-110410,45127,155537,-65283,0,0,15,0,0,,15,15
36,09-03-18,35,8:30,8:45,74.09,,0,74.09,74.09,1,-155244,36893,192137,-118351,0,0,8232,0,0,,8232,8232
36,09-03-18,36,8:45,9:00,124.09,,0,124.09,124.09,1,-181741,26640,208381,-155101,0,0,60284,0,0,,60284,60284
36,09-03-18,37,9:00,9:15,74.09,,0,74.09,74.09,1,-132076,40825,172901,-91251,0,0,50517,0,0,,50517,50517
36,09-03-18,38,9:15,9:30,124.09,,0,124.09,124.09,1,-156862,44102,200964,-112760,0,0,62453,0,0,,62453,62453
36,09-03-18,39,9:30,9:45,67.84,,0,67.84,67.84,1,-120091,53273,173364,-66818,0,0,36898,0,0,,36898,36898
36,09-03-18,40,9:45,10:00,124.09,,0,124.09,124.09,1,-117315,39133,156448,-78182,0,0,10706,0,0,,10706,10706
36,09-03-18,41,10:00,10:15,124.09,,0,124.09,124.09,1,-154792,46765,201557,-108027,0,0,63792,0,0,,63792,63792
36,09-03-18,42,10:15,10:30,66.15,,0,66.15,66.15,1,-130509,77270,207779,-53239,0,0,46424,0,0,,46424,46424
36,09-03-18,43,10:30,10:45,74.09,,0,74.09,74.09,1,-143440,75815,219255,-67625,0,0,49536,0,0,,49536,49536
36,09-03-18,44,10:45,11:00,74.09,,0,74.09,74.09,1,-133419,77616,211035,-55803,0,0,38914,0,0,,38914,38914
36,09-03-18,45,11:00,11:15,124.09,,0,124.09,124.09,1,-210761,48804,259565,-161957,0,0,47258,0,0,,47258,47258
36,09-03-18,46,11:15,11:30,68.85,,0,68.85,68.85,1,-203882,68137,272019,-135745,0,0,54757,0,0,,54757,54757
36,09-03-18,47,11:30,11:45,58.7,,0,58.7,58.7,1,-191971,76496,268467,-115475,0,0,38379,0,0,,38379,38379
36,09-03-18,48,11:45,12:00,59.57,,0,59.57,59.57,1,-188169,67745,255914,-120424,0,0,32784,0,0,,32784,32784
36,09-03-18,49,12:00,12:15,124.09,,0,124.09,124.09,1,-239592,82273,321865,-157319,0,0,50341,0,0,,50341,50341
36,09-03-18,50,12:15,12:30,65.48,,0,65.48,65.48,1,-196522,96321,292843,-100201,0,0,46775,0,0,,46775,46775
36,09-03-18,51,12:30,12:45,,,0,52.05,52.05,0,-169736,107467,277203,-62269,0,0,6378,0,0,,6378,6378
36,09-03-18,52,12:45,13:00,,,0,52.07,52.07,0,-171020,83651,254671,-87369,0,0,0,0,0,,0,0
36,09-03-18,53,13:00,13:15,124.09,,0,124.09,124.09,1,-173019,91800,264819,-81219,0,0,22538,0,0,,22538,22538
36,09-03-18,54,13:15,13:30,74.09,,0,74.09,74.09,1,-177048,83327,260375,-93721,0,0,54711,0,0,,54711,54711
36,09-03-18,55,13:30,13:45,57.85,,0,57.85,57.85,1,-176126,71684,247810,-104442,0,0,25506,0,0,,25506,25506
36,09-03-18,56,13:45,14:00,54.02,,0,54.02,54.02,1,-160380,71768,232148,-88612,0,0,17075,0,0,,17075,17075
36,09-03-18,57,14:00,14:15,124.09,,0,124.09,124.09,1,-168169,74929,243098,-93240,0,0,31509,0,0,,31509,31509
36,09-03-18,58,14:15,14:30,58.2,,0,58.2,58.2,1,-154957,81961,236918,-72996,0,0,51503,0,0,,51503,51503
36,09-03-18,59,14:30,14:45,58.2,,0,58.2,58.2,1,-148302,103105,251407,-45197,0,0,33766,0,0,,33766,33766
36,09-03-18,60,14:45,15:00,51.17,,0,51.17,51.17,1,-142739,117633,260372,-25106,0,0,7416,0,0,,7416,7416
36,09-03-18,61,15:00,15:15,,,0,52.02,52.02,0,-114962,138541,253503,23579,0,0,9,0,0,,9,9
36,09-03-18,62,15:15,15:30,,,0,52.02,52.02,0,-128238,124690,252928,-3548,0,0,0,0,0,,0,0
36,09-03-18,63,15:30,15:45,51.15,,0,51.15,51.15,1,-124358,114881,239239,-9477,0,0,1078,0,0,,1078,1078
36,09-03-18,64,15:45,16:00,51.15,,0,51.15,51.15,1,-127463,122025,249488,-5438,0,0,1604,0,0,,1604,1604
36,09-03-18,65,16:00,16:15,50.02,,0,50.02,50.02,1,-106849,85603,192452,-21246,0,0,14,0,0,,14,14
36,09-03-18,66,16:15,16:30,,,0,52.1,52.1,0,-77765,62645,140410,-15120,0,0,0,0,0,,0,0
36,09-03-18,67,16:30,16:45,51.17,,0,51.17,51.17,1,-73698,47822,121520,-25876,0,0,965,0,0,,965,965
36,09-03-18,68,16:45,17:00,58.2,,0,58.2,58.2,1,-137513,47832,185345,-89681,0,0,2973,0,0,,2973,2973
36,09-03-18,69,17:00,17:15,124.09,,0,124.09,124.09,1,-256693,36373,293066,-220320,0,0,49614,0,0,,49614,49614
36,09-03-18,70,17:15,17:30,124.09,,0,270.81,270.81,1,-232872,34219,267091,-198653,0,0,82144,0,20856,,103000,103000
36,09-03-18,71,17:30,17:45,124.09,,0,270.81,270.81,1,-209157,53952,263109,-155205,0,0,46500,0,86871,,133371,133371
36,09-03-18,72,17:45,18:00,74.09,,0,270.81,270.81,1,-212150,74349,286499,-137801,0,0,58194,0,48733,,106927,106927
36,09-03-18,73,18:00,18:15,124.09,,0,272.3,272.3,1,-270962,41617,312579,-229345,0,0,66294,0,56199,,122493,122493
36,09-03-18,74,18:15,18:30,124.09,,0,272.3,272.3,1,-327333,59131,386464,-268202,0,0,78080,0,81198,,159278,159278
36,09-03-18,75,18:30,18:45,124.09,,0,272.3,272.3,1,-332735,57022,389757,-275713,0,0,83021,0,129225,,212246,212246
36,09-03-18,76,18:45,19:00,124.09,,0,272.3,272.3,1,-318770,78982,397752,-239788,0,0,75479,0,173695,,249174,249174
36,09-03-18,77,19:00,19:15,124.09,49.67,0,49.67,49.67,-1,-245508,69129,314637,-176379,0,-234,18313,0,169376,,187923,187455
36,09-03-18,78,19:15,19:30,124.09,,0,272.99,272.99,1,-229044,92994,322038,-136050,0,0,21395,0,69476,,90871,90871
36,09-03-18,79,19:30,19:45,124.09,,0,124.09,124.09,1,-191776,98486,290262,-93290,0,0,61075,0,0,,61075,61075
36,09-03-18,80,19:45,20:00,124.09,,0,124.09,124.09,1,-179627,71260,250887,-108367,0,0,63092,0,0,,63092,63092
36,09-03-18,81,20:00,20:15,74.09,,0,74.09,74.09,1,-161743,81709,243452,-80034,0,0,15015,0,0,,15015,15015
36,09-03-18,82,20:15,20:30,124.09,,0,124.09,124.09,1,-155701,63050,218751,-92651,0,0,42247,0,0,,42247,42247
36,09-03-18,83,20:30,20:45,124.09,,0,124.09,124.09,1,-184582,44244,228826,-140338,0,0,73132,0,0,,73132,73132
36,09-03-18,84,20:45,21:00,69.37,,0,69.37,69.37,1,-140802,41460,182262,-99342,0,0,38851,0,0,,38851,38851
36,09-03-18,85,21:00,21:15,450,,0,450,450,1,-143295,47035,190330,-96260,0,0,24935,0,0,,24935,24935
36,09-03-18,86,21:15,21:30,57.87,,0,57.87,57.87,1,-100427,60507,160934,-39920,0,0,20540,0,0,,20540,20540
36,09-03-18,87,21:30,21:45,57.87,54.17,0,54.17,54.17,-1,-80732,70714,151446,-10018,0,-78,632,0,0,,710,554
36,09-03-18,88,21:45,22:00,,46.02,0,46.02,46.02,-1,-87085,100878,187963,13793,0,-4109,0,0,0,,4109,-4109
36,09-03-18,89,22:00,22:15,124.09,53.41,0,124.09,124.09,1,-176147,57954,234101,-118193,0,-729,27279,0,0,,28008,26550
36,09-03-18,90,22:15,22:30,124.09,,0,124.09,124.09,1,-142399,63729,206128,-78670,0,0,80025,0,0,,80025,80025
36,09-03-18,91,22:30,22:45,58.2,,0,58.2,58.2,1,-120934,84991,205925,-35943,0,0,45997,0,0,,45997,45997
36,09-03-18,92,22:45,23:00,54.02,,0,54.02,54.02,1,-105562,76214,181776,-29348,0,0,15194,0,0,,15194,15194
36,09-03-18,93,23:00,23:15,124.09,,0,124.09,124.09,1,-143290,89930,233220,-53360,0,0,17041,0,0,,17041,17041
36,09-03-18,94,23:15,23:30,124.09,,0,124.09,124.09,1,-117614,64588,182202,-53026,0,0,51976,0,0,,51976,51976
36,09-03-18,95,23:30,23:45,59.16,,0,59.16,59.16,1,-101845,52303,154148,-49542,0,0,47125,0,0,,47125,47125
36,09-03-18,96,23:45,0:00,58.2,,0,58.2,58.2,1,-101219,66093,167312,-35126,0,0,36974,0,0,,36974,36974
36,09-04-18,1,0:00,0:15,155.12,,0,155.12,155.12,1,-119428,29056,148484,-90372,0,0,31586,0,0,,31586,31586
36,09-04-18,2,0:15,0:30,155.12,,0,155.12,155.12,1,-107635,23512,131147,-84123,0,0,40489,0,0,,40489,40489
36,09-04-18,3,0:30,0:45,73.02,,0,73.02,73.02,1,-76785,28402,105187,-48383,0,0,23261,0,0,,23261,23261
36,09-04-18,4,0:45,1:00,,,0,49.7,49.7,0,-85538,41611,127149,-43927,0,0,4205,0,0,,4205,4205
36,09-04-18,5,1:00,1:15,155.12,,0,155.12,155.12,1,-105289,28659,133948,-76630,0,0,14354,0,0,,14354,14354
36,09-04-18,6,1:15,1:30,155.12,,0,155.12,155.12,1,-80187,34740,114927,-45447,0,0,46537,0,0,,46537,46537
36,09-04-18,7,1:30,1:45,49.97,,0,49.97,49.97,1,-59936,41085,101021,-18851,0,0,2103,0,0,,2103,2103
36,09-04-18,8,1:45,2:00,49.97,,0,49.97,49.97,1,-72439,50819,123258,-21620,0,0,458,0,0,,458,458
36,09-04-18,9,2:00,2:15,49.97,,0,49.97,49.97,1,-39798,55608,95406,15810,0,0,14,0,0,,14,14
36,09-04-18,10,2:15,2:30,66.65,,0,66.65,66.65,1,-66994,30978,97972,-36016,0,0,16470,0,0,,16470,16470
36,09-04-18,11,2:30,2:45,52.99,,0,52.99,52.99,1,-60654,32841,93495,-27813,0,0,11708,0,0,,11708,11708
36,09-04-18,12,2:45,3:00,,,0,49.58,49.58,0,-58330,33478,91808,-24852,0,0,297,0,0,,297,297
36,09-04-18,13,3:00,3:15,73.02,,0,73.02,73.02,1,-82087,33437,115524,-48650,0,0,7106,0,0,,7106,7106
36,09-04-18,14,3:15,3:30,73.02,,0,73.02,73.02,1,-87866,36149,124015,-51717,0,0,14858,0,0,,14858,14858
36,09-04-18,15,3:30,3:45,51.58,,0,51.58,51.58,1,-93111,32955,126066,-60156,0,0,1382,0,0,,1382,1382
36,09-04-18,16,3:45,4:00,49.97,,0,49.97,49.97,1,-88783,32316,121099,-56467,0,0,236,0,0,,236,236
36,09-04-18,17,4:00,4:15,49.97,,0,49.97,49.97,1,-95584,39062,134646,-56522,0,0,239,0,0,,239,239
36,09-04-18,18,4:15,4:30,49.97,,0,49.97,49.97,1,-97225,37676,134901,-59549,0,0,9,0,0,,9,9
36,09-04-18,19,4:30,4:45,49.97,,0,49.97,49.97,1,-93543,35797,129340,-57746,0,0,58,0,0,,58,58
36,09-04-18,20,4:45,5:00,49.97,,0,49.97,49.97,1,-96944,41586,138530,-55358,0,0,647,0,0,,647,647
36,09-04-18,21,5:00,5:15,49.97,,0,49.97,49.97,1,-141135,57911,199046,-83224,0,0,126,0,0,,126,126
36,09-04-18,22,5:15,5:30,73.02,,0,73.02,73.02,1,-127458,57281,184739,-70177,0,0,10402,0,0,,10402,10402
36,09-04-18,23,5:30,5:45,73.02,,0,73.02,73.02,1,-100777,45653,146430,-55124,0,0,33869,0,0,,33869,33869
36,09-04-18,24,5:45,6:00,53.97,47.72,0,47.72,47.72,-1,-67016,65644,132660,-1372,0,-354,15587,0,0,,15941,15233
36,09-04-18,25,6:00,6:15,,,0,50.37,50.37,0,-136637,77273,213910,-59364,0,0,9,0,0,,9,9
36,09-04-18,26,6:15,6:30,73.46,,0,73.46,73.46,1,-150941,49394,200335,-101547,0,0,3314,0,0,,3314,3314
36,09-04-18,27,6:30,6:45,153.12,,0,153.12,153.12,1,-185608,35832,221440,-149776,0,0,57849,0,0,,57849,57849
36,09-04-18,28,6:45,7:00,153.12,,0,153.12,153.12,1,-192230,50440,242670,-141790,0,0,82161,0,0,,82161,82161
36,09-04-18,29,7:00,7:15,153.12,41.41,0,41.41,41.41,-1,-114974,124623,239597,9649,0,-2667,31739,0,0,,34406,29072
36,09-04-18,30,7:15,7:30,50.41,41.41,0,50.41,50.41,1,-104148,45299,149447,-58849,0,-31,83,0,0,,114,52
36,09-04-18,31,7:30,7:45,150.12,,0,150.12,150.12,1,-160112,32680,192792,-127432,0,0,18433,0,0,,18433,18433
36,09-04-18,32,7:45,8:00,150.12,,0,150.12,150.12,1,-216541,31864,248405,-184677,0,0,74131,0,0,,74131,74131
36,09-04-18,33,8:00,8:15,127.12,,0,127.12,127.12,1,-135099,76914,212013,-58185,0,0,57200,0,0,,57200,57200
36,09-04-18,34,8:15,8:30,74.68,,0,74.68,74.68,1,-130323,58082,188405,-72241,0,0,57044,0,0,,57044,57044
36,09-04-18,35,8:30,8:45,152.12,,0,152.12,152.12,1,-146442,48917,195359,-97525,0,0,73757,0,0,,73757,73757
36,09-04-18,36,8:45,9:00,152.12,,0,152.12,152.12,1,-175602,49102,224704,-126500,0,0,80745,0,0,,80745,80745
36,09-04-18,37,9:00,9:15,152.12,,0,152.12,152.12,1,-173512,55866,229378,-117646,0,0,29750,0,0,,29750,29750
36,09-04-18,38,9:15,9:30,152.12,,0,152.12,152.12,1,-177073,58451,235524,-118622,0,0,64089,0,0,,64089,64089
36,09-04-18,39,9:30,9:45,224.91,,0,224.91,224.91,1,-178265,80966,259231,-97299,0,0,82283,2500,0,,84783,84783
36,09-04-18,40,9:45,10:00,124.91,,0,124.91,124.91,1,-167390,86153,253543,-81237,0,0,78255,0,0,,78255,78255
36,09-04-18,41,10:00,10:15,273.92,46.41,0,46.41,46.41,-1,-97223,92014,189237,-5209,0,-388,34566,3750,0,,38704,37928
36,09-04-18,42,10:15,10:30,50.41,46.41,0,50.41,46.41,2,-99314,95972,195286,-3342,0,-4286,208,0,0,,4494,-4078
36,09-04-18,43,10:30,10:45,64.91,,0,64.91,64.91,1,-120174,85767,205941,-34407,0,0,9380,0,0,,9380,9380
36,09-04-18,44,10:45,11:00,73.92,,0,73.92,73.92,1,-117234,75472,192706,-41762,0,0,32931,0,0,,32931,32931
36,09-04-18,45,11:00,11:15,73.46,,0,73.46,73.46,1,-124137,64350,188487,-59787,0,0,42347,0,0,,42347,42347
36,09-04-18,46,11:15,11:30,58.46,,0,58.46,58.46,1,-110092,57317,167409,-52775,0,0,36302,0,0,,36302,36302
36,09-04-18,47,11:30,11:45,64.55,,0,64.55,64.55,1,-128449,62302,190751,-66147,0,0,39888,0,0,,39888,39888
36,09-04-18,48,11:45,12:00,58.46,50.32,0,50.32,50.32,-1,-86537,69644,156181,-16893,0,-2,32637,0,0,,32639,32635
36,09-04-18,49,12:00,12:15,52.57,50.32,0,52.57,49.72,2,-77635,58889,136524,-18746,0,-157,3803,0,0,,3960,3646
36,09-04-18,50,12:15,12:30,50.41,,0,50.41,50.41,1,-74758,63250,138008,-11508,0,0,1387,0,0,,1387,1387
36,09-04-18,51,12:30,12:45,,50.32,0,50.32,50.32,-1,-68741,74529,143270,5788,0,-992,0,0,0,,992,-992
36,09-04-18,52,12:45,13:00,,48.91,0,48.91,48.91,-1,-66800,75683,142483,8883,0,-676,0,0,0,,676,-676
36,09-04-18,53,13:00,13:15,50.41,48.91,0,50.41,48.91,2,-49435,45197,94632,-4238,0,-743,150,0,0,,893,-593
36,09-04-18,54,13:15,13:30,50.41,,0,50.41,50.41,1,-68285,46445,114730,-21840,0,0,2088,0,0,,2088,2088
36,09-04-18,55,13:30,13:45,49.12,,0,49.12,49.12,1,-62720,49951,112671,-12769,0,0,568,0,0,,568,568
36,09-04-18,56,13:45,14:00,,,0,50.37,50.37,0,-64203,52192,116395,-12011,0,0,0,0,0,,0,0
36,09-04-18,57,14:00,14:15,151.12,,0,151.12,151.12,1,-116597,62376,178973,-54221,0,0,12627,0,0,,12627,12627
36,09-04-18,58,14:15,14:30,151.12,,0,151.12,151.12,1,-107360,61535,168895,-45825,0,0,36662,0,0,,36662,36662
36,09-04-18,59,14:30,14:45,50.87,,0,50.87,50.87,1,-99036,68078,167114,-30958,0,0,8361,0,0,,8361,8361
36,09-04-18,60,14:45,15:00,54.41,,0,54.41,54.41,1,-102038,60399,162437,-41639,0,0,4264,0,0,,4264,4264
36,09-04-18,61,15:00,15:15,53.78,,0,53.78,53.78,1,-73136,61876,135012,-11260,0,0,2203,0,0,,2203,2203
36,09-04-18,62,15:15,15:30,50.89,,0,50.89,50.89,1,-83470,46755,130225,-36715,0,0,1363,0,0,,1363,1363
36,09-04-18,63,15:30,15:45,53.78,,0,53.78,53.78,1,-102225,44155,146380,-58070,0,0,2521,0,0,,2521,2521
36,09-04-18,64,15:45,16:00,50.41,,0,50.41,50.41,1,-115992,38041,154033,-77951,0,0,292,0,0,,292,292
36,09-04-18,65,16:00,16:15,51,,0,51,51,1,-62509,44495,107004,-18014,0,0,844,0,0,,844,844
36,09-04-18,66,16:15,16:30,50.41,,0,50.41,50.41,1,-70603,41697,112300,-28906,0,0,971,0,0,,971,971
36,09-04-18,67,16:30,16:45,51,,0,51,51,1,-64548,43179,107727,-21369,0,0,3590,0,0,,3590,3590
36,09-04-18,68,16:45,17:00,51,,0,51,51,1,-90424,26983,117407,-63441,0,0,3191,0,0,,3191,3191
36,09-04-18,69,17:00,17:15,73.46,,0,73.46,73.46,1,-116879,70704,187583,-46175,0,0,8283,0,0,,8283,8283
36,09-04-18,70,17:15,17:30,151.12,,0,151.12,151.12,1,-122315,68554,190869,-53761,0,0,50854,0,0,,50854,50854
36,09-04-18,71,17:30,17:45,58.46,,0,58.46,58.46,1,-106603,60855,167458,-45748,0,0,38768,0,0,,38768,38768
36,09-04-18,72,17:45,18:00,123.46,,0,123.46,123.46,1,-116878,55965,172843,-60913,0,0,47196,0,0,,47196,47196
36,09-04-18,73,18:00,18:15,151.12,,0,151.12,151.12,1,-220488,32749,253237,-187739,0,0,72190,0,0,,72190,72190
36,09-04-18,74,18:15,18:30,151.12,,0,151.12,151.12,1,-179010,43114,222124,-135896,0,0,73720,0,0,,73720,73720
36,09-04-18,75,18:30,18:45,151.12,,0,151.12,151.12,1,-157703,58978,216681,-98725,0,0,81655,0,0,,81655,81655
36,09-04-18,76,18:45,19:00,273.99,,0,273.99,273.99,1,-147077,92123,239200,-54954,0,0,67587,3750,0,,71337,71337
36,09-04-18,77,19:00,19:15,273.99,47.87,0,47.87,47.87,-1,-42018,59018,101036,17000,0,-422,8408,0,0,,8830,7986
36,09-04-18,78,19:15,19:30,52.87,,0,52.87,52.87,1,-61526,56523,118049,-5003,0,0,1330,0,0,,1330,1330
36,09-04-18,79,19:30,19:45,52.87,,0,52.87,52.87,1,-69121,58721,127842,-10400,0,0,4448,0,0,,4448,4448
36,09-04-18,80,19:45,20:00,70.69,,0,70.69,70.69,1,-87036,53365,140401,-33671,0,0,11683,0,0,,11683,11683
36,09-04-18,81,20:00,20:15,75,,0,75,75,1,-100958,57326,158284,-43632,0,0,36468,0,0,,36468,36468
36,09-04-18,82,20:15,20:30,450,,0,450,450,1,-121517,46781,168298,-74736,0,0,45143,0,0,,45143,45143
36,09-04-18,83,20:30,20:45,151.12,,0,151.12,151.12,1,-155713,39549,195262,-116164,0,0,73788,0,0,,73788,73788
36,09-04-18,84,20:45,21:00,151.12,,0,151.12,151.12,1,-126098,45229,171327,-80869,0,0,79692,0,0,,79692,79692
36,09-04-18,85,21:00,21:15,223.06,,0,223.06,223.06,1,-146814,49280,196094,-97534,0,0,63195,2500,0,,65695,65695
36,09-04-18,86,21:15,21:30,273.06,,0,273.06,273.06,1,-149907,70774,220681,-79133,0,0,76270,3750,0,,80020,80020
36,09-04-18,87,21:30,21:45,58.46,,0,58.46,58.46,1,-132872,87345,220217,-45527,0,0,43024,0,0,,43024,43024
36,09-04-18,88,21:45,22:00,58.46,,0,58.46,58.46,1,-131409,103132,234541,-28277,0,0,26106,0,0,,26106,26106
36,09-04-18,89,22:00,22:15,151.12,,0,151.12,151.12,1,-166511,63523,230034,-102988,0,0,49699,0,0,,49699,49699
36,09-04-18,90,22:15,22:30,73.46,,0,73.46,73.46,1,-118746,68611,187357,-50135,0,0,56775,0,0,,56775,56775
36,09-04-18,91,22:30,22:45,55.41,49.57,0,49.57,49.57,-1,-92523,83935,176458,-8588,0,-59,20784,0,0,,20843,20725
36,09-04-18,92,22:45,23:00,55.41,46.96,0,46.96,46.96,-1,-96723,102741,199464,6018,0,-1458,873,0,0,,2331,-585
36,09-04-18,93,23:00,23:15,51.32,46.41,0,51.32,31.74,2,-107370,104769,212139,-2601,0,-1290,1244,0,0,,2534,-46
36,09-04-18,94,23:15,23:30,50.41,,0,50.41,50.41,1,-98809,72949,171758,-25860,0,0,230,0,0,,230,230
36,09-04-18,95,23:30,23:45,50.41,,0,50.41,50.41,1,-78393,79674,158067,1281,0,0,23,0,0,,23,23
36,09-04-18,96,23:45,0:00,,40.73,0,40.73,40.73,-1,-56125,89620,145745,33495,0,-9066,0,0,0,,9066,-9066
36,09-05-18,1,0:00,0:15,54.41,23.46,0,54.41,23.46,2,-72320,109471,181791,37151,0,-13740,388,0,0,,14128,-13352
36,09-05-18,2,0:15,0:30,73.46,23.46,0,73.46,73.46,1,-90957,62501,153458,-28456,0,-98,19040,0,0,,19138,18942
36,09-05-18,3,0:30,0:45,51.1,46.41,0,46.41,46.41,-1,-59392,77996,137388,18604,0,-548,4527,0,0,,5075,3979
36,09-05-18,4,0:45,1:00,,36.72,0,36.72,36.72,-1,-41543,96813,138356,55270,0,-35985,0,0,0,,35985,-35985
36,09-05-18,5,1:00,1:15,52.03,39.83,0,52.03,52.03,1,-53862,60938,114800,7076,0,-19265,245,0,0,,19510,-19020
36,09-05-18,6,1:15,1:30,54.41,49.57,0,54.41,49.57,2,-40140,55390,95530,15250,0,-267,2495,0,0,,2762,2228
36,09-05-18,7,1:30,1:45,,46.53,0,46.53,46.53,-1,-21639,67661,89300,46022,0,-439,0,0,0,,439,-439
36,09-05-18,8,1:45,2:00,,42.41,0,42.41,42.41,-1,-22982,79132,102114,56150,0,-2399,0,0,0,,2399,-2399
36,09-05-18,9,2:00,2:15,,39.74,0,39.74,39.74,-1,-43387,52121,95508,8734,0,-4616,0,0,0,,4616,-4616
36,09-05-18,10,2:15,2:30,,,0,50.5,50.5,0,-23563,33861,57424,10298,0,0,0,0,0,,0,0
36,09-05-18,11,2:30,2:45,50.41,,0,50.41,50.41,1,-34348,29240,63588,-5108,0,0,5,0,0,,5,5
36,09-05-18,12,2:45,3:00,50.41,,0,50.41,50.41,1,-40801,28255,69056,-12546,0,0,614,0,0,,614,614
36,09-05-18,13,3:00,3:15,54.6,,0,54.6,54.6,1,-42653,22153,64806,-20500,0,0,3432,0,0,,3432,3432
36,09-05-18,14,3:15,3:30,51.02,,0,51.02,51.02,1,-41858,16740,58598,-25118,0,0,6670,0,0,,6670,6670
36,09-05-18,15,3:30,3:45,51.04,,0,51.04,51.04,1,-34772,15609,50381,-19163,0,0,6146,0,0,,6146,6146
36,09-05-18,16,3:45,4:00,,,0,50.5,50.5,0,-27893,16157,44050,-11736,0,0,359,0,0,,359,359
36,09-05-18,17,4:00,4:15,54.41,,0,54.41,54.41,1,-39051,25638,64689,-13413,0,0,1945,0,0,,1945,1945
36,09-05-18,18,4:15,4:30,50.41,,0,50.41,50.41,1,-32001,26124,58125,-5877,0,0,865,0,0,,865,865
36,09-05-18,19,4:30,4:45,52.03,,0,52.03,52.03,1,-34454,23455,57909,-10999,0,0,3792,0,0,,3792,3792
36,09-05-18,20,4:45,5:00,51,,0,51,51,1,-38665,17040,55705,-21625,0,0,4559,0,0,,4559,4559
36,09-05-18,21,5:00,5:15,51.1,,0,51.1,51.1,1,-55015,50532,105547,-4483,0,0,2123,0,0,,2123,2123
36,09-05-18,22,5:15,5:30,,48.25,0,48.25,48.25,-1,-33773,39661,73434,5888,0,-1787,0,0,0,,1787,-1787
36,09-05-18,23,5:30,5:45,64.99,49.61,0,64.99,64.99,1,-47056,18409,65465,-28647,0,-994,4480,0,0,,5474,3486
36,09-05-18,24,5:45,6:00,63.47,,0,63.47,63.47,1,-45290,28424,73714,-16866,0,0,14569,0,0,,14569,14569
36,09-05-18,25,6:00,6:15,63.47,47.05,0,47.05,47.05,-1,-57053,90995,148048,33942,0,-4744,356,0,0,,5100,-4388
36,09-05-18,26,6:15,6:30,,47.05,0,47.05,47.05,-1,-43792,66720,110512,22928,0,-8402,0,0,0,,8402,-8402
36,09-05-18,27,6:30,6:45,74.1,47.05,0,74.1,74.1,1,-80081,44831,124912,-35250,0,-1021,5984,0,0,,7005,4963
36,09-05-18,28,6:45,7:00,154.02,,0,154.02,154.02,1,-125441,54616,180057,-70825,0,0,53852,0,0,,53852,53852
36,09-05-18,29,7:00,7:15,154.02,39.4,0,39.4,39.4,-1,-80948,108699,189647,27751,0,-3910,17427,0,0,,21337,13517
36,09-05-18,30,7:15,7:30,,50.7,0,50.7,50.7,-1,-102678,68890,171568,-33788,0,-280,0,0,0,,280,-280
36,09-05-18,31,7:30,7:45,157.02,,0,157.02,157.02,1,-169910,42764,212674,-127146,0,0,14843,0,0,,14843,14843
36,09-05-18,32,7:45,8:00,157.02,,0,157.02,157.02,1,-193880,36534,230414,-157346,0,0,73819,0,0,,73819,73819
36,09-05-18,33,8:00,8:15,122.02,47.64,0,47.64,47.64,-1,-96160,97142,193302,982,0,-398,40127,0,0,,40525,39729
36,09-05-18,34,8:15,8:30,76.76,47.64,0,76.76,76.76,1,-106158,66684,172842,-39474,0,-22,6791,0,0,,6813,6769
36,09-05-18,35,8:30,8:45,126.76,,0,126.76,126.76,1,-147383,60440,207823,-86943,0,0,44992,0,0,,44992,44992
36,09-05-18,36,8:45,9:00,62.03,,0,62.03,62.03,1,-181737,66138,247875,-115599,0,0,40400,0,0,,40400,40400
36,09-05-18,37,9:00,9:15,156.02,,0,156.02,156.02,1,-193226,76813,270039,-116413,0,0,60760,0,0,,60760,60760
36,09-05-18,38,9:15,9:30,156.02,,0,156.02,156.02,1,-182353,75590,257943,-106763,0,0,82432,0,0,,82432,82432
36,09-05-18,39,9:30,9:45,180.1,,0,180.1,180.1,1,-158444,82306,240750,-76138,0,0,79450,1250,0,,80700,80700
36,09-05-18,40,9:45,10:00,80.1,,0,80.1,80.1,1,-146014,92247,238261,-53767,0,0,53405,0,0,,53405,53405
36,09-05-18,41,10:00,10:15,500.03,,0,500.03,500.03,1,-179355,51804,231159,-127551,0,0,70676,0,0,,70676,70676
36,09-05-18,42,10:15,10:30,499.99,,0,499.99,499.99,1,-149467,78204,227671,-71263,0,0,80974,0,0,,80974,80974
36,09-05-18,43,10:30,10:45,65.92,,0,65.92,65.92,1,-111760,77691,189451,-34069,0,0,44446,0,0,,44446,44446
36,09-05-18,44,10:45,11:00,65.1,,0,65.1,65.1,1,-101029,80565,181594,-20464,0,0,27171,0,0,,27171,27171
36,09-05-18,45,11:00,11:15,76.51,,0,76.51,76.51,1,-117799,78583,196382,-39216,0,0,28757,0,0,,28757,28757
36,09-05-18,46,11:15,11:30,59.1,,0,59.1,59.1,1,-118506,84274,202780,-34232,0,0,39342,0,0,,39342,39342
36,09-05-18,47,11:30,11:45,63.81,,0,63.81,63.81,1,-102592,68395,170987,-34197,0,0,35017,0,0,,35017,35017
36,09-05-18,48,11:45,12:00,59.1,,0,59.1,59.1,1,-93414,61759,155173,-31655,0,0,32015,0,0,,32015,32015
36,09-05-18,49,12:00,12:15,74.64,,0,74.64,74.64,1,-92493,44621,137114,-47872,0,0,33756,0,0,,33756,33756
36,09-05-18,50,12:15,12:30,59.1,,0,59.1,59.1,1,-81907,33905,115812,-48002,0,0,43134,0,0,,43134,43134
36,09-05-18,51,12:30,12:45,59.1,,0,59.1,59.1,1,-68433,39248,107681,-29185,0,0,33616,0,0,,33616,33616
36,09-05-18,52,12:45,13:00,59.1,,0,59.1,59.1,1,-70495,30214,100709,-40281,0,0,27961,0,0,,27961,27961
36,09-05-18,53,13:00,13:15,59.1,,0,59.1,59.1,1,-49959,32447,82406,-17512,0,0,30173,0,0,,30173,30173
36,09-05-18,54,13:15,13:30,59.1,,0,59.1,59.1,1,-47251,24152,71403,-23099,0,0,24135,0,0,,24135,24135
36,09-05-18,55,13:30,13:45,55.05,,0,55.05,55.05,1,-36660,32357,69017,-4303,0,0,16823,0,0,,16823,16823
36,09-05-18,56,13:45,14:00,54.02,,0,54.02,54.02,1,-31134,37837,68971,6703,0,0,6013,0,0,,6013,6013
36,09-05-18,57,14:00,14:15,55.05,,0,55.05,55.05,1,-58120,34425,92545,-23695,0,0,8241,0,0,,8241,8241
36,09-05-18,58,14:15,14:30,59.1,,0,59.1,59.1,1,-64529,35562,100091,-28967,0,0,21474,0,0,,21474,21474
36,09-05-18,59,14:30,14:45,55.02,,0,55.02,55.02,1,-68148,42561,110709,-25587,0,0,21511,0,0,,21511,21511
36,09-05-18,60,14:45,15:00,59.1,,0,59.1,59.1,1,-73956,41106,115062,-32850,0,0,17115,0,0,,17115,17115
36,09-05-18,61,15:00,15:15,54.66,47.4,0,54.66,47.4,2,-51720,55116,106836,3396,0,-1316,12856,0,0,,14172,11540
36,09-05-18,62,15:15,15:30,59.1,47.4,0,59.1,59.1,1,-62279,39606,101885,-22673,0,-281,8270,0,0,,8551,7989
36,09-05-18,63,15:30,15:45,74.1,,0,74.1,74.1,1,-79743,29808,109551,-49935,0,0,34376,0,0,,34376,34376
36,09-05-18,64,15:45,16:00,156.02,,0,156.02,156.02,1,-105774,26153,131927,-79621,0,0,63618,0,0,,63618,63618
36,09-05-18,65,16:00,16:15,156.02,49.11,0,49.11,49.11,-1,-62726,50204,112930,-12522,0,-343,27168,0,0,,27511,26825
36,09-05-18,66,16:15,16:30,59.1,49.11,0,59.1,59.1,1,-83250,45512,128762,-37738,0,-2,1603,0,0,,1605,1601
36,09-05-18,67,16:30,16:45,59.1,,0,59.1,59.1,1,-81697,45650,127347,-36047,0,0,8360,0,0,,8360,8360
36,09-05-18,68,16:45,17:00,61.58,,0,61.58,61.58,1,-92932,36181,129113,-56751,0,0,19407,0,0,,19407,19407
36,09-05-18,69,17:00,17:15,51.05,50.03,0,52.48,50.03,2,-57390,77764,135154,20374,0,-699,6726,0,0,,7425,6027
36,09-05-18,70,17:15,17:30,,50.6,0,50.6,50.6,-1,-64442,80375,144817,15933,0,-1771,0,0,0,,1771,-1771
36,09-05-18,71,17:30,17:45,,52.34,0,52.34,52.34,-1,-64158,71214,135372,7056,0,-208,0,0,0,,208,-208
36,09-05-18,72,17:45,18:00,,,0,52.45,52.45,0,-59588,70221,129809,10633,0,0,0,0,0,,0,0
36,09-05-18,73,18:00,18:15,59.1,50.59,0,59.1,50.59,2,-82414,79972,162386,-2442,0,-67,3855,0,0,,3922,3788
36,09-05-18,74,18:15,18:30,63.53,,0,63.53,63.53,1,-66308,76460,142768,10152,0,0,17345,0,0,,17345,17345
36,09-05-18,75,18:30,18:45,76.76,,0,76.76,76.76,1,-93041,82435,175476,-10606,0,0,11329,0,0,,11329,11329
36,09-05-18,76,18:45,19:00,156.02,,0,156.02,156.02,1,-117682,83636,201318,-34046,0,0,30444,0,0,,30444,30444
36,09-05-18,77,19:00,19:15,156.02,,0,279.62,279.62,1,-180918,42556,223474,-138362,0,0,70042,0,0,,70042,70042
36,09-05-18,78,19:15,19:30,54.11,50.64,0,50.64,50.64,-1,-183899,42242,226141,-141657,0,-30,33878,0,0,,33908,33848
36,09-05-18,79,19:30,19:45,53.28,50.69,0,279.62,50.69,2,-133201,47568,180769,-85633,0,-754,211,0,0,,965,-543
36,09-05-18,80,19:45,20:00,79.62,,0,79.62,79.62,1,-137293,53318,190611,-83975,0,0,20755,0,0,,20755,20755
36,09-05-18,81,20:00,20:15,156.02,,0,156.02,156.02,1,-132872,54678,187550,-78194,0,0,58109,0,0,,58109,58109
36,09-05-18,82,20:15,20:30,156.02,,0,156.02,156.02,1,-149595,55938,205533,-93657,0,0,71218,0,0,,71218,71218
36,09-05-18,83,20:30,20:45,156.02,,0,279.33,279.33,1,-180907,44687,225594,-136220,0,0,80428,0,0,,80428,80428
36,09-05-18,84,20:45,21:00,156.02,,0,279.33,279.33,1,-214052,48468,262520,-165584,0,0,76549,0,0,,76549,76549
36,09-05-18,85,21:00,21:15,151.02,,0,280.1,280.1,1,-248988,7935,256923,-241053,0,0,76534,0,0,,76534,76534
36,09-05-18,86,21:15,21:30,151.02,,0,280.1,280.1,1,-214259,12808,227067,-201451,0,0,80587,0,0,,80587,80587
36,09-05-18,87,21:30,21:45,51.05,50.23,0,280.1,50.23,2,-154891,28003,182894,-126888,0,-145,29731,0,0,,29876,29586
36,09-05-18,88,21:45,22:00,130.1,,0,280.1,280.1,1,-175340,29078,204418,-146262,0,0,5294,0,0,,5294,5294
36,09-05-18,89,22:00,22:15,150.02,,0,150.02,150.02,1,-155359,40837,196196,-114522,0,0,48229,0,0,,48229,48229
36,09-05-18,90,22:15,22:30,74.1,,0,74.1,74.1,1,-98966,43323,142289,-55643,0,0,58724,0,0,,58724,58724
36,09-05-18,91,22:30,22:45,55.05,50.69,0,55.05,50.69,2,-76460,65894,142354,-10566,0,-129,17130,0,0,,17259,17001
36,09-05-18,92,22:45,23:00,,,0,52.1,52.1,0,-68496,60363,128859,-8133,0,0,0,0,0,,0,0
36,09-05-18,93,23:00,23:15,153.02,,0,153.02,153.02,1,-117274,21307,138581,-95967,0,0,29422,0,0,,29422,29422
36,09-05-18,94,23:15,23:30,153.02,,0,153.02,153.02,1,-83456,43543,126999,-39913,0,0,58948,0,0,,58948,58948
36,09-05-18,95,23:30,23:45,153.02,46.89,0,46.89,46.89,-1,-56644,61094,117738,4450,0,-972,6769,0,0,,7741,5797
36,09-05-18,96,23:45,0:00,,46.89,0,46.89,46.89,-1,-73026,82690,155716,9664,0,-7301,0,0,0,,7301,-7301
36,09-06-18,1,0:00,0:15,77.97,49.88,0,77.97,77.97,1,-92227,63823,156050,-28404,0,-824,6255,0,0,,7079,5431
36,09-06-18,2,0:15,0:30,69.39,,0,69.39,69.39,1,-44794,32485,77279,-12309,0,0,15599,0,0,,15599,15599
36,09-06-18,3,0:30,0:45,59.49,,0,59.49,59.49,1,-45476,22755,68231,-22721,0,0,6993,0,0,,6993,6993
36,09-06-18,4,0:45,1:00,53.01,,0,53.01,53.01,1,-40983,35194,76177,-5789,0,0,7137,0,0,,7137,7137
36,09-06-18,5,1:00,1:15,52.7,,0,52.7,52.7,1,-67901,55241,123142,-12660,0,0,928,0,0,,928,928
36,09-06-18,6,1:15,1:30,58.28,,0,58.28,58.28,1,-62266,41871,104137,-20395,0,0,11620,0,0,,11620,11620
36,09-06-18,7,1:30,1:45,51.09,,0,51.09,51.09,1,-51935,45779,97714,-6156,0,0,3873,0,0,,3873,3873
36,09-06-18,8,1:45,2:00,,46.92,0,46.92,46.92,-1,-47744,63272,111016,15528,0,-2985,0,0,0,,2985,-2985
36,09-06-18,9,2:00,2:15,51.09,46.92,0,51.09,51.09,1,-73230,60930,134160,-12300,0,-239,62,0,0,,301,-177
36,09-06-18,10,2:15,2:30,52.54,,0,52.54,52.54,1,-64131,48990,113121,-15141,0,0,3157,0,0,,3157,3157
36,09-06-18,11,2:30,2:45,55.1,,0,55.1,55.1,1,-69497,44759,114256,-24738,0,0,8381,0,0,,8381,8381
36,09-06-18,12,2:45,3:00,51.45,,0,51.45,51.45,1,-75366,43823,119189,-31543,0,0,4840,0,0,,4840,4840
36,09-06-18,13,3:00,3:15,104.73,,0,104.73,104.73,1,-72176,24857,97033,-47319,0,0,21202,0,0,,21202,21202
36,09-06-18,14,3:15,3:30,67.01,,0,67.01,67.01,1,-80975,20493,101468,-60482,0,0,46635,0,0,,46635,46635
36,09-06-18,15,3:30,3:45,59.49,,0,59.49,59.49,1,-80158,19884,100042,-60274,0,0,38598,0,0,,38598,38598
36,09-06-18,16,3:45,4:00,59.49,,0,59.49,59.49,1,-71263,20037,91300,-51226,0,0,34497,0,0,,34497,34497
36,09-06-18,17,4:00,4:15,55.12,,0,55.12,55.12,1,-47219,25108,72327,-22111,0,0,16915,0,0,,16915,16915
36,09-06-18,18,4:15,4:30,55.1,,0,55.1,55.1,1,-50093,18861,68954,-31232,0,0,782,0,0,,782,782
36,09-06-18,19,4:30,4:45,59.49,,0,59.49,59.49,1,-52367,20595,72962,-31772,0,0,8944,0,0,,8944,8944
36,09-06-18,20,4:45,5:00,58.91,,0,58.91,58.91,1,-61620,20336,81956,-41284,0,0,22738,0,0,,22738,22738
36,09-06-18,21,5:00,5:15,51.52,43.05,0,43.05,43.05,-1,-75711,76421,152132,710,0,-2188,9518,0,0,,11706,7330
36,09-06-18,22,5:15,5:30,,47.05,0,47.05,47.05,-1,-51864,59882,111746,8018,0,-10434,0,0,0,,10434,-10434
36,09-06-18,23,5:30,5:45,55.1,47.05,0,55.1,55.1,1,-60849,46587,107436,-14262,0,-1177,1751,0,0,,2928,574
36,09-06-18,24,5:45,6:00,51.09,39.1,0,39.1,39.1,-1,-54604,48370,102974,-6234,0,-654,1180,0,0,,1834,526
36,09-06-18,25,6:00,6:15,,38.98,0,38.98,38.98,-1,-67537,131764,199301,64227,0,-30782,0,0,0,,30782,-30782
36,09-06-18,26,6:15,6:30,,48.06,0,48.06,48.06,-1,-55517,85402,140919,29885,0,-15504,0,0,0,,15504,-15504
36,09-06-18,27,6:30,6:45,61.73,48.06,0,61.73,61.73,1,-71811,60404,132215,-11407,0,-17,3828,0,0,,3845,3811
36,09-06-18,28,6:45,7:00,75.83,,0,75.83,75.83,1,-149431,60665,210096,-88766,0,0,29647,0,0,,29647,29647
36,09-06-18,29,7:00,7:15,58.18,33.36,0,58.18,33.36,2,-72897,130038,202935,57141,0,-5329,16341,0,0,,21670,11012
36,09-06-18,30,7:15,7:30,59.37,51.12,0,59.37,51.12,2,-85191,75051,160242,-10140,0,-1176,2516,0,0,,3692,1340
36,09-06-18,31,7:30,7:45,54.98,,0,54.98,54.98,1,-110379,56070,166449,-54309,0,0,11097,0,0,,11097,11097
36,09-06-18,32,7:45,8:00,156.12,,0,156.12,156.12,1,-162878,47170,210048,-115708,0,0,31970,0,0,,31970,31970
36,09-06-18,33,8:00,8:15,59.37,50.25,0,50.25,50.25,-1,-92466,122740,215206,30274,0,-254,18003,0,0,,18257,17749
36,09-06-18,34,8:15,8:30,50.97,50.25,0,50.97,50.97,1,-105377,107017,212394,1640,0,-2,1,0,0,,3,-1
36,09-06-18,35,8:30,8:45,127.84,,0,127.84,127.84,1,-142488,96408,238896,-46080,0,0,17789,0,0,,17789,17789
36,09-06-18,36,8:45,9:00,155.12,,0,155.12,155.12,1,-170204,96519,266723,-73685,0,0,66118,0,0,,66118,66118
36,09-06-18,37,9:00,9:15,155.12,,0,155.12,155.12,1,-133961,107181,241142,-26780,0,0,61252,0,0,,61252,61252
36,09-06-18,38,9:15,9:30,155.12,,0,155.12,155.12,1,-151379,92277,243656,-59102,0,0,77968,0,0,,77968,77968
36,09-06-18,39,9:30,9:45,378.25,,0,416.08,416.08,1,-131262,106374,237636,-24888,0,0,69943,5000,18334,,93277,93277
36,09-06-18,40,9:45,10:00,378.25,50.25,0,416.08,50.25,2,-85574,116329,201903,30755,0,-312,8818,5000,27501,,41631,41007
36,09-06-18,41,10:00,10:15,156.12,,0,156.12,156.12,1,-193908,58369,252277,-135539,0,0,40841,0,9167,,50008,50008
36,09-06-18,42,10:15,10:30,450,,0,450,450,1,-188923,79804,268727,-109119,0,0,81817,0,0,,81817,81817
36,09-06-18,43,10:30,10:45,450,,0,450,450,1,-179316,92265,271581,-87051,0,0,80149,5000,0,,85149,85149
36,09-06-18,44,10:45,11:00,156.12,,0,156.12,156.12,1,-172619,102307,274926,-70312,0,0,63730,0,0,,63730,63730
36,09-06-18,45,11:00,11:15,156.12,,0,156.12,156.12,1,-157713,91758,249471,-65955,0,0,65745,0,0,,65745,65745
36,09-06-18,46,11:15,11:30,66.12,,0,66.12,66.12,1,-143094,105035,248129,-38059,0,0,43728,0,0,,43728,43728
36,09-06-18,47,11:30,11:45,79.3,,0,79.3,79.3,1,-158349,101127,259476,-57222,0,0,41823,0,0,,41823,41823
36,09-06-18,48,11:45,12:00,65.99,,0,65.99,65.99,1,-151224,105047,256271,-46177,0,0,47017,0,0,,47017,47017
36,09-06-18,49,12:00,12:15,155.12,,0,155.12,155.12,1,-167318,84926,252244,-82392,0,0,58511,0,0,,58511,58511
36,09-06-18,50,12:15,12:30,78.12,,0,78.12,78.12,1,-156033,95099,251132,-60934,0,0,63851,0,0,,63851,63851
36,09-06-18,51,12:30,12:45,59.37,,0,59.37,59.37,1,-139385,104081,243466,-35304,0,0,29096,0,0,,29096,29096
36,09-06-18,52,12:45,13:00,65.85,,0,65.85,65.85,1,-153582,102085,255667,-51497,0,0,31609,0,0,,31609,31609
36,09-06-18,53,13:00,13:15,162.12,,0,162.12,162.12,1,-155291,77890,233181,-77401,0,0,47411,0,0,,47411,47411
36,09-06-18,54,13:15,13:30,95.12,,0,95.12,95.12,1,-162730,87318,250048,-75412,0,0,66886,0,0,,66886,66886
36,09-06-18,55,13:30,13:45,78.41,,0,78.41,78.41,1,-162091,87763,249854,-74328,0,0,70939,0,0,,70939,70939
36,09-06-18,56,13:45,14:00,78.12,,0,78.12,78.12,1,-144198,95560,239758,-48638,0,0,52361,0,0,,52361,52361
36,09-06-18,57,14:00,14:15,162.12,,0,162.12,162.12,1,-180058,66912,246970,-113146,0,0,55401,0,0,,55401,55401
36,09-06-18,58,14:15,14:30,162.12,,0,162.12,162.12,1,-176826,78301,255127,-98525,0,0,83476,0,0,,83476,83476
36,09-06-18,59,14:30,14:45,272.78,,0,272.78,272.78,1,-144934,104317,249251,-40617,0,0,64802,3750,0,,68552,68552
36,09-06-18,60,14:45,15:00,51.81,,0,51.81,51.81,1,-125630,116599,242229,-9031,0,0,8826,0,0,,8826,8826
36,09-06-18,61,15:00,15:15,,,0,52.4,52.4,0,-122135,142249,264384,20114,0,0,126,0,0,,126,126
36,09-06-18,62,15:15,15:30,,53.77,0,53.77,53.77,-1,-119079,125002,244081,5923,0,-140,0,0,0,,140,-140
36,09-06-18,63,15:30,15:45,,53.77,0,53.77,53.77,-1,-118386,119290,237676,904,0,-270,0,0,0,,270,-270
36,09-06-18,64,15:45,16:00,,,0,52.4,52.4,0,-117036,112411,229447,-4625,0,0,0,0,0,,0,0
36,09-06-18,65,16:00,16:15,,,0,52.4,52.4,0,-104567,78711,183278,-25856,0,0,0,0,0,,0,0
36,09-06-18,66,16:15,16:30,,,0,52.4,52.4,0,-106481,78730,185211,-27751,0,0,0,0,0,,0,0
36,09-06-18,67,16:30,16:45,50.97,,0,50.97,50.97,1,-110201,77836,188037,-32365,0,0,54,0,0,,54,54
36,09-06-18,68,16:45,17:00,50.97,,0,50.97,50.97,1,-120268,77010,197278,-43258,0,0,2344,0,0,,2344,2344
36,09-06-18,69,17:00,17:15,59.37,,0,59.37,59.37,1,-95379,75865,171244,-19514,0,0,2894,0,0,,2894,2894
36,09-06-18,70,17:15,17:30,59.37,,0,59.37,59.37,1,-108967,74591,183558,-34376,0,0,12787,0,0,,12787,12787
36,09-06-18,71,17:30,17:45,59.37,,0,59.37,59.37,1,-116460,79152,195612,-37308,0,0,15711,0,0,,15711,15711
36,09-06-18,72,17:45,18:00,63.67,,0,63.67,63.67,1,-104537,78975,183512,-25562,0,0,22521,0,0,,22521,22521
36,09-06-18,73,18:00,18:15,50.97,39.47,0,52.4,39.47,2,-79223,102021,181244,22798,0,-7565,6314,0,0,,13879,-1251
36,09-06-18,74,18:15,18:30,,50.67,0,50.67,50.67,-1,-70874,97615,168489,26741,0,-6607,0,0,0,,6607,-6607
36,09-06-18,75,18:30,18:45,,,0,52.4,52.4,0,-55514,95879,151393,40365,0,-158,0,0,0,,158,-158
36,09-06-18,76,18:45,19:00,,46.93,0,46.93,46.93,-1,-34551,93270,127821,58719,0,-3820,0,0,0,,3820,-3820
36,09-06-18,77,19:00,19:15,63.99,49.77,0,63.99,49.77,2,-95652,53625,149277,-42027,0,-771,8806,0,0,,9577,8035
36,09-06-18,78,19:15,19:30,59.37,,0,59.37,59.37,1,-89782,53977,143759,-35805,0,0,21093,0,0,,21093,21093
36,09-06-18,79,19:30,19:45,59.37,,0,59.37,59.37,1,-90948,50490,141438,-40458,0,0,28621,0,0,,28621,28621
36,09-06-18,80,19:45,20:00,127.84,,0,127.84,127.84,1,-117169,37865,155034,-79304,0,0,41144,0,0,,41144,41144
36,09-06-18,81,20:00,20:15,50.97,50.67,0,52.47,50.67,2,-68746,91033,159779,22287,0,-520,13485,0,0,,14005,12965
36,09-06-18,82,20:15,20:30,77.84,,0,77.84,77.84,1,-84998,62203,147201,-22795,0,0,11248,0,0,,11248,11248
36,09-06-18,83,20:30,20:45,59.37,,0,59.37,59.37,1,-85022,55091,140113,-29931,0,0,30541,0,0,,30541,30541
36,09-06-18,84,20:45,21:00,59.37,,0,59.37,59.37,1,-73316,65616,138932,-7700,0,0,26544,0,0,,26544,26544
36,09-06-18,85,21:00,21:15,450,,0,450,450,1,-134714,25228,159942,-109486,0,0,47159,0,0,,47159,47159
36,09-06-18,86,21:15,21:30,129.12,44.12,0,44.12,44.12,-1,-56488,61546,118034,5058,0,-456,38572,0,0,,39028,38116
36,09-06-18,87,21:30,21:45,129.12,38.98,0,38.98,38.98,-1,-37596,69674,107270,32078,0,-5088,16,0,0,,5104,-5072
36,09-06-18,88,21:45,22:00,,38.98,0,38.98,38.98,-1,-42669,82422,125091,39753,0,-15901,0,0,0,,15901,-15901
36,09-06-18,89,22:00,22:15,162.12,47.25,0,162.12,162.12,1,-107987,9452,117439,-98535,0,-7930,21518,0,0,,29448,13588
36,09-06-18,90,22:15,22:30,162.12,,0,162.12,162.12,1,-96504,28574,125078,-67930,0,0,76708,0,0,,76708,76708
36,09-06-18,91,22:30,22:45,59.37,51.12,0,59.37,51.12,2,-55677,61928,117605,6251,0,-207,21993,0,0,,22200,21786
36,09-06-18,92,22:45,23:00,,45.21,0,45.21,45.21,-1,-40186,77952,118138,37766,0,-2126,0,0,0,,2126,-2126
36,09-06-18,93,23:00,23:15,153.12,38.98,0,153.12,38.98,2,-90447,39272,129719,-51175,0,-5735,8701,0,0,,14436,2966
36,09-06-18,94,23:15,23:30,159.12,,0,159.12,159.12,1,-64423,16837,81260,-47586,0,0,26872,0,0,,26872,26872
36,09-06-18,95,23:30,23:45,50.97,,0,50.97,50.97,1,-44474,20455,64929,-24019,0,0,2543,0,0,,2543,2543
36,09-06-18,96,23:45,0:00,,38.98,0,38.98,38.98,-1,-43540,50409,93949,6869,0,-1735,0,0,0,,1735,-1735
36,09-07-18,1,0:00,0:15,59.2,39.2,0,59.2,39.2,2,-95468,75012,170480,-20456,0,-3798,5710,0,0,,9508,1912
36,09-07-18,2,0:15,0:30,55.15,,0,55.15,55.15,1,-62417,30127,92544,-32290,0,0,16334,0,0,,16334,16334
36,09-07-18,3,0:30,0:45,55.15,50.52,0,50.52,50.52,-1,-48233,33232,81465,-15001,0,-14,3605,0,0,,3619,3591
36,09-07-18,4,0:45,1:00,,49.65,0,49.65,49.65,-1,-32751,37042,69793,4291,0,-1478,0,0,0,,1478,-1478
36,09-07-18,5,1:00,1:15,69.65,50.18,0,69.65,69.65,1,-86634,47204,133838,-39430,0,-810,6900,0,0,,7710,6090
36,09-07-18,6,1:15,1:30,74.2,,0,74.2,74.2,1,-75839,38823,114662,-37016,0,0,13645,0,0,,13645,13645
36,09-07-18,7,1:30,1:45,,,0,30.77,30.77,0,-56214,40136,96350,-16078,0,0,2,0,0,,2,2
36,09-07-18,8,1:45,2:00,,50.39,0,50.39,50.39,-1,-50754,40947,91701,-9807,0,-113,0,0,0,,113,-113
36,09-07-18,9,2:00,2:15,74.2,50.15,0,74.2,74.2,1,-89551,48902,138453,-40649,0,-191,6655,0,0,,6846,6464
36,09-07-18,10,2:15,2:30,74.2,,0,74.2,74.2,1,-81502,45620,127122,-35882,0,0,26432,0,0,,26432,26432
36,09-07-18,11,2:30,2:45,55.15,,0,55.15,55.15,1,-61068,48227,109295,-12841,0,0,19648,0,0,,19648,19648
36,09-07-18,12,2:45,3:00,55.15,43.15,0,43.15,43.15,-1,-38677,60473,99150,21796,0,-8438,2824,0,0,,11262,-5614
36,09-07-18,13,3:00,3:15,74.2,50.03,0,74.2,50.03,2,-71419,36206,107625,-35213,0,-5058,11169,0,0,,16227,6111
36,09-07-18,14,3:15,3:30,55.15,,0,55.15,55.15,1,-65637,41333,106970,-24304,0,0,19282,0,0,,19282,19282
36,09-07-18,15,3:30,3:45,51.43,,0,51.43,51.43,1,-50523,43011,93534,-7512,0,0,8783,0,0,,8783,8783
36,09-07-18,16,3:45,4:00,,,0,51.34,51.34,0,-41808,50877,92685,9069,0,0,57,0,0,,57,57
36,09-07-18,17,4:00,4:15,,,0,51.35,51.35,0,-44247,55629,99876,11382,0,0,0,0,0,,0,0
36,09-07-18,18,4:15,4:30,,50.22,0,50.22,50.22,-1,-34559,64750,99309,30191,0,-5,0,0,0,,5,-5
36,09-07-18,19,4:30,4:45,,50.2,0,50.2,50.2,-1,-24401,88646,113047,64245,0,-1340,0,0,0,,1340,-1340
36,09-07-18,20,4:45,5:00,,51.54,0,51.54,51.54,-1,-17207,77952,95159,60745,0,-462,0,0,0,,462,-462
36,09-07-18,21,5:00,5:15,,47.15,0,47.15,47.15,-1,-35521,64291,99812,28770,0,-4171,0,0,0,,4171,-4171
36,09-07-18,22,5:15,5:30,51.15,47.15,0,51.15,51.15,1,-34708,48475,83183,13767,0,-742,3,0,0,,745,-739
36,09-07-18,23,5:30,5:45,92.69,,0,92.69,92.69,1,-72255,27477,99732,-44778,0,0,15236,0,0,,15236,15236
36,09-07-18,24,5:45,6:00,89.02,,0,89.02,89.02,1,-72790,24706,97496,-48084,0,0,43534,0,0,,43534,43534
36,09-07-18,25,6:00,6:15,53.26,25.32,0,53.36,25.32,2,-40635,100486,141121,59851,0,-11665,13127,0,0,,24792,1462
36,09-07-18,26,6:15,6:30,,48.27,0,48.27,48.27,-1,-27096,74644,101740,47548,0,-15314,0,0,0,,15314,-15314
36,09-07-18,27,6:30,6:45,52.27,48.27,0,52.27,52.27,1,-56572,61067,117639,4495,0,-1813,380,0,0,,2193,-1433
36,09-07-18,28,6:45,7:00,56.27,,0,56.27,56.27,1,-98447,66864,165311,-31583,0,0,8247,0,0,,8247,8247
36,09-07-18,29,7:00,7:15,56.27,-19.95,0,-19.95,-19.95,-1,-25705,109011,134716,83306,0,-24704,2470,0,0,,27174,-22234
36,09-07-18,30,7:15,7:30,52.35,50.03,0,52.35,52.35,1,-54742,38577,93319,-16165,0,-4436,152,0,0,,4588,-4284
36,09-07-18,31,7:30,7:45,60.32,,0,60.32,60.32,1,-92422,24852,117274,-67570,0,0,10617,0,0,,10617,10617
36,09-07-18,32,7:45,8:00,159.02,,0,159.02,159.02,1,-143113,22001,165114,-121112,0,0,22436,0,0,,22436,22436
36,09-07-18,33,8:00,8:15,82.48,,0,82.48,82.48,1,-96538,46536,143074,-50002,0,0,15164,0,0,,15164,15164
36,09-07-18,34,8:15,8:30,158.02,,0,158.02,158.02,1,-88515,44763,133278,-43752,0,0,52091,0,0,,52091,52091
36,09-07-18,35,8:30,8:45,56.27,,0,56.27,56.27,1,-93389,89220,182609,-4169,0,0,15906,0,0,,15906,15906
36,09-07-18,36,8:45,9:00,56.27,,0,56.27,56.27,1,-125140,106914,232054,-18226,0,0,1901,0,0,,1901,1901
36,09-07-18,37,9:00,9:15,82.05,,0,82.05,82.05,1,-145563,111919,257482,-33644,0,0,21413,0,0,,21413,21413
36,09-07-18,38,9:15,9:30,52.27,50.18,0,54.18,50.18,2,-93072,129531,222603,36459,0,-689,4583,0,0,,5272,3894
36,09-07-18,39,9:30,9:45,,20.14,0,20.14,20.14,-1,-54109,126991,181100,72882,0,-19438,0,0,0,,19438,-19438
36,09-07-18,40,9:45,10:00,,21.51,0,21.51,21.51,-1,-70296,124326,194622,54030,0,-56708,0,0,0,,56708,-56708
36,09-07-18,41,10:00,10:15,,,0,54.13,54.13,0,-78290,119083,197373,40793,0,-15231,0,0,0,,15231,-15231
36,09-07-18,42,10:15,10:30,,,0,54.13,54.13,0,-59429,113139,172568,53710,0,0,0,0,0,,0,0
36,09-07-18,43,10:30,10:45,,38.16,0,38.16,38.16,-1,-31562,133824,165386,102262,0,-18502,0,0,0,,18502,-18502
36,09-07-18,44,10:45,11:00,,46.35,0,46.35,46.35,-1,-40108,155140,195248,115032,0,-35996,0,0,0,,35996,-35996
36,09-07-18,45,11:00,11:15,65.8,51.12,0,65.8,51.12,2,-120524,34319,154843,-86205,0,-12197,3901,0,0,,16098,-8296
36,09-07-18,46,11:15,11:30,52.27,,0,52.27,52.27,1,-73218,61933,135151,-11285,0,0,1434,0,0,,1434,1434
36,09-07-18,47,11:30,11:45,,40.32,0,40.32,40.32,-1,-58489,156912,215401,98423,0,-13837,0,0,0,,13837,-13837
36,09-07-18,48,11:45,12:00,,35.98,0,35.98,35.98,-1,-40062,149166,189228,109104,0,-36985,0,0,0,,36985,-36985
36,09-07-18,49,12:00,12:15,61.44,44.18,0,61.44,61.44,1,-67682,51283,118965,-16399,0,-29158,1453,0,0,,30611,-27705
36,09-07-18,50,12:15,12:30,61.65,44.18,0,61.65,61.65,1,-77706,52409,130115,-25297,0,-516,1872,0,0,,2388,1356
36,09-07-18,51,12:30,12:45,,44.27,0,44.27,44.27,-1,-65264,90935,156199,25671,0,-6552,0,0,0,,6552,-6552
36,09-07-18,52,12:45,13:00,,40.32,0,40.32,40.32,-1,-64602,129863,194465,65261,0,-48431,0,0,0,,48431,-48431
36,09-07-18,53,13:00,13:15,,40.32,0,40.32,40.32,-1,-89974,108937,198911,18963,0,-43323,0,0,0,,43323,-43323
36,09-07-18,54,13:15,13:30,,-115.09,0,-115.09,-115.09,-1,-46318,144945,191263,98627,0,-45342,0,0,0,,45342,-45342
36,09-07-18,55,13:30,13:45,,-112.38,0,-112.38,-112.38,-1,-45569,127438,173007,81869,0,-85522,0,0,0,,85522,-85522
36,09-07-18,56,13:45,14:00,,-23.76,0,-23.76,-23.76,-1,-48179,146693,194872,98514,0,-89716,0,0,0,,89716,-89716
36,09-07-18,57,14:00,14:15,,39.1,0,39.1,39.1,-1,-67272,134190,201462,66918,0,-69191,0,0,0,,69191,-69191
36,09-07-18,58,14:15,14:30,,-8.69,0,-8.69,-8.69,-1,-43245,139807,183052,96562,0,-76617,0,0,0,,76617,-76617
36,09-07-18,59,14:30,14:45,,-27.19,0,-27.19,-27.19,-1,-44675,152220,196895,107545,0,-96437,0,0,0,,96437,-96437
36,09-07-18,60,14:45,15:00,,-27.19,0,-27.19,-27.19,-1,-66370,128391,194761,62021,0,-82511,0,0,0,,82511,-82511
36,09-07-18,61,15:00,15:15,,-8.74,0,-8.74,-8.74,-1,-59253,119982,179235,60729,0,-35195,0,0,0,,35195,-35195
36,09-07-18,62,15:15,15:30,,-47.2,0,-47.2,-47.2,-1,-70388,124293,194681,53905,0,-63381,0,0,0,,63381,-63381
36,09-07-18,63,15:30,15:45,,-38.5,0,-38.5,-38.5,-1,-65838,152176,218014,86338,0,-61823,0,0,0,,61823,-61823
36,09-07-18,64,15:45,16:00,,35.51,0,35.51,35.51,-1,-73358,140834,214192,67476,0,-65358,0,0,0,,65358,-65358
36,09-07-18,65,16:00,16:15,,37.88,0,37.88,37.88,-1,-69434,146284,215718,76850,0,-64915,0,0,0,,64915,-64915
36,09-07-18,66,16:15,16:30,,39.4,0,39.4,39.4,-1,-78889,166419,245308,87530,0,-59477,0,0,0,,59477,-59477
36,09-07-18,67,16:30,16:45,,40.32,0,40.32,40.32,-1,-66523,138444,204967,71921,0,-50346,0,0,0,,50346,-50346
36,09-07-18,68,16:45,17:00,,38.79,0,38.79,38.79,-1,-83810,140663,224473,56853,0,-48057,0,0,0,,48057,-48057
36,09-07-18,69,17:00,17:15,,31.67,0,31.67,31.67,-1,-24898,165802,190700,140904,0,-42115,0,0,0,,42115,-42115
36,09-07-18,70,17:15,17:30,56.27,44.27,0,56.27,56.27,1,-58766,91010,149776,32244,0,-27225,164,0,0,,27389,-27061
36,09-07-18,71,17:30,17:45,75.32,44.27,0,75.32,75.32,1,-100455,74497,174952,-25958,0,-534,12491,0,0,,13025,11957
36,09-07-18,72,17:45,18:00,58.85,,0,58.85,58.85,1,-80791,65784,146575,-15007,0,0,26599,0,0,,26599,26599
36,09-07-18,73,18:00,18:15,52.27,40.32,0,40.32,40.32,-1,-42525,69362,111887,26837,0,-3139,8105,0,0,,11244,4966
36,09-07-18,74,18:15,18:30,,34.79,0,34.79,34.79,-1,-27055,72478,99533,45423,0,-22398,0,0,0,,22398,-22398
36,09-07-18,75,18:30,18:45,,40.32,0,40.32,40.32,-1,-43605,85429,129034,41824,0,-29431,0,0,0,,29431,-29431
36,09-07-18,76,18:45,19:00,52.55,40.32,0,52.55,52.55,1,-78983,53764,132747,-25219,0,-4823,1210,0,0,,6033,-3613
36,09-07-18,77,19:00,19:15,,49.79,0,49.79,49.79,-1,-70950,75066,146016,4116,0,-538,0,0,0,,538,-538
36,09-07-18,78,19:15,19:30,,50.45,0,50.45,50.45,-1,-60362,73663,134025,13301,0,-2242,0,0,0,,2242,-2242
36,09-07-18,79,19:30,19:45,,41.46,0,41.46,41.46,-1,-40295,80418,120713,40123,0,-18203,0,0,0,,18203,-18203
36,09-07-18,80,19:45,20:00,,48.27,0,48.27,48.27,-1,-40794,76370,117164,35576,0,-20522,0,0,0,,20522,-20522
36,09-07-18,81,20:00,20:15,,25.32,0,25.32,25.32,-1,-30018,119069,149087,89051,0,-26566,0,0,0,,26566,-26566
36,09-07-18,82,20:15,20:30,52.27,49.43,0,52.27,52.27,1,-69125,74295,143420,5170,0,-11564,124,0,0,,11688,-11440
36,09-07-18,83,20:30,20:45,54.41,49.43,0,54.41,54.41,1,-92017,61238,153255,-30779,0,-104,2328,0,0,,2432,2224
36,09-07-18,84,20:45,21:00,75.32,,0,75.32,75.32,1,-119791,53423,173214,-66368,0,0,13175,0,0,,13175,13175
36,09-07-18,85,21:00,21:15,157.02,,0,157.02,157.02,1,-119873,56297,176170,-63576,0,0,29646,0,0,,29646,29646
36,09-07-18,86,21:15,21:30,158.02,49.79,0,158.02,49.79,2,-62059,65463,127522,3404,0,-115,45151,0,0,,45266,45036
36,09-07-18,87,21:30,21:45,158.02,40.32,0,40.32,40.32,-1,-74023,109780,183803,35757,0,-9877,694,0,0,,10571,-9183
36,09-07-18,88,21:45,22:00,,50.25,0,50.25,50.25,-1,-101681,129279,230960,27598,0,-8861,0,0,0,,8861,-8861
36,09-07-18,89,22:00,22:15,52.27,48.27,0,53.55,48.27,2,-85620,82114,167734,-3506,0,-6320,788,0,0,,7108,-5532
36,09-07-18,90,22:15,22:30,75.32,48.27,0,75.32,75.32,1,-113043,79062,192105,-33981,0,-122,10394,0,0,,10516,10272
36,09-07-18,91,22:30,22:45,75.32,44.27,0,44.27,44.27,-1,-106989,112150,219139,5161,0,-604,17221,0,0,,17825,16617
36,09-07-18,92,22:45,23:00,75.32,20.67,0,20.67,20.67,-1,-99871,147051,246922,47180,0,-34532,657,0,0,,35189,-33875
36,09-07-18,93,23:00,23:15,56.27,44.27,0,56.27,44.27,2,-70179,65892,136071,-4287,0,-15896,1097,0,0,,16993,-14799
36,09-07-18,94,23:15,23:30,56.27,54.79,0,54.79,54.79,-1,-85049,80455,165504,-4594,0,-35,34,0,0,,69,-1
36,09-07-18,95,23:30,23:45,52.27,50.36,0,53.63,50.36,2,-81536,80433,161969,-1103,0,-1,647,0,0,,648,646
36,09-07-18,96,23:45,0:00,,41.51,0,41.51,41.51,-1,-83323,102283,185606,18960,0,-15020,0,0,0,,15020,-15020
37,09-08-18,1,0:00,0:15,126.26,41.51,0,126.26,126.26,1,-142991,106560,249551,-36431,0,-2461,6791,0,0,,9252,4330
37,09-08-18,2,0:15,0:30,134.82,,0,134.82,134.82,1,-87968,45954,133922,-42014,0,0,36237,0,0,,36237,36237
37,09-08-18,3,0:30,0:45,60.28,,0,60.28,60.28,1,-116855,24969,141824,-91886,0,0,27498,0,0,,27498,27498
37,09-08-18,4,0:45,1:00,55,,0,55,55,1,-156939,35502,192441,-121437,0,0,14022,0,0,,14022,14022
37,09-08-18,5,1:00,1:15,60.28,,0,60.28,60.28,1,-86507,86537,173044,30,0,0,6004,0,0,,6004,6004
37,09-08-18,6,1:15,1:30,56.4,,0,56.4,56.4,1,-89990,37488,127478,-52502,0,0,16119,0,0,,16119,16119
37,09-08-18,7,1:30,1:45,55,,0,55,55,1,-77693,35644,113337,-42049,0,0,10736,0,0,,10736,10736
37,09-08-18,8,1:45,2:00,,,0,52.44,52.44,0,-81399,32691,114090,-48708,0,0,202,0,0,,202,202
37,09-08-18,9,2:00,2:15,158.12,,0,158.12,158.12,1,-139201,78449,217650,-60752,0,0,28483,0,0,,28483,28483
37,09-08-18,10,2:15,2:30,158.12,,0,158.12,158.12,1,-129011,77455,206466,-51556,0,0,69722,0,0,,69722,69722
37,09-08-18,11,2:30,2:45,57.54,52.38,0,57.54,52.38,2,-83126,84982,168108,1856,0,-133,15387,0,0,,15520,15254
37,09-08-18,12,2:45,3:00,,44.09,0,44.09,44.09,-1,-62766,81122,143888,18356,0,-7725,0,0,0,,7725,-7725
37,09-08-18,13,3:00,3:15,61.62,48.09,0,61.62,61.62,1,-54123,50323,104446,-3800,0,-6485,1829,0,0,,8314,-4656
37,09-08-18,14,3:15,3:30,90.61,,0,90.61,90.61,1,-66641,42174,108815,-24467,0,0,24202,0,0,,24202,24202
37,09-08-18,15,3:30,3:45,52.09,,0,52.09,52.09,1,-58782,62521,121303,3739,0,0,4085,0,0,,4085,4085
37,09-08-18,16,3:45,4:00,56.09,,0,56.09,56.09,1,-64112,48947,113059,-15165,0,0,3611,0,0,,3611,3611
37,09-08-18,17,4:00,4:15,52.09,52.12,0,52.12,52.12,-1,-54123,74033,128156,19910,0,-21,951,0,0,,972,930
37,09-08-18,18,4:15,4:30,,40.28,0,40.28,40.28,-1,-41294,66004,107298,24710,0,-6074,0,0,0,,6074,-6074
37,09-08-18,19,4:30,4:45,,40.28,0,40.28,40.28,-1,-37522,52004,89526,14482,0,-16193,0,0,0,,16193,-16193
37,09-08-18,20,4:45,5:00,,36.92,0,36.92,36.92,-1,-35780,69582,105362,33802,0,-19160,0,0,0,,19160,-19160
37,09-08-18,21,5:00,5:15,52.09,40.28,0,52.09,52.09,1,-63985,66873,130858,2888,0,-18254,63,0,0,,18317,-18191
37,09-08-18,22,5:15,5:30,52.09,40.28,0,52.09,40.28,2,-52471,72942,125413,20471,0,-4547,332,0,0,,4879,-4215
37,09-08-18,23,5:30,5:45,,38.46,0,38.46,38.46,-1,-48348,69489,117837,21141,0,-21799,0,0,0,,21799,-21799
37,09-08-18,24,5:45,6:00,69.86,52.01,0,69.86,69.86,1,-54653,37465,92118,-17188,0,-5356,6507,0,0,,11863,1151
37,09-08-18,25,6:00,6:15,77.35,,0,77.35,77.35,1,-75401,45944,121345,-29457,0,0,25731,0,0,,25731,25731
37,09-08-18,26,6:15,6:30,61.35,,0,61.35,61.35,1,-74530,34824,109354,-39706,0,0,25219,0,0,,25219,25219
37,09-08-18,27,6:30,6:45,59.08,,0,59.08,59.08,1,-63530,32459,95989,-31071,0,0,30833,0,0,,30833,30833
37,09-08-18,28,6:45,7:00,56.12,,0,56.12,56.12,1,-56348,47679,104027,-8669,0,0,23880,0,0,,23880,23880
37,09-08-18,29,7:00,7:15,56.12,49.37,0,49.37,49.37,-1,-72254,77985,150239,5731,0,-2495,4501,0,0,,6996,2006
37,09-08-18,30,7:15,7:30,,,0,54.52,54.52,0,-36842,68001,104843,31159,0,-741,0,0,0,,741,-741
37,09-08-18,31,7:30,7:45,,45.6,0,45.6,45.6,-1,-36353,92996,129349,56643,0,-2608,0,0,0,,2608,-2608
37,09-08-18,32,7:45,8:00,,55.77,0,55.77,55.77,-1,-42856,145544,188400,102688,0,-969,0,0,0,,969,-969
37,09-08-18,33,8:00,8:15,,27.35,0,27.35,27.35,-1,-24251,138176,162427,113925,0,-8230,0,0,0,,8230,-8230
37,09-08-18,34,8:15,8:30,,-48.58,0,-48.58,-48.58,-1,-36275,94971,131246,58696,0,-35597,0,0,0,,35597,-35597
37,09-08-18,35,8:30,8:45,,49.15,0,49.15,49.15,-1,-50488,96024,146512,45536,0,-3425,0,0,0,,3425,-3425
37,09-08-18,36,8:45,9:00,,54.21,0,54.21,54.21,-1,-57588,87035,144623,29447,0,-4356,0,0,0,,4356,-4356
37,09-08-18,37,9:00,9:15,,35.35,0,35.35,35.35,-1,-59979,107459,167438,47480,0,-21072,0,0,0,,21072,-21072
37,09-08-18,38,9:15,9:30,,27.35,0,27.35,27.35,-1,-56677,85854,142531,29177,0,-38819,0,0,0,,38819,-38819
37,09-08-18,39,9:30,9:45,,38.26,0,38.26,38.26,-1,-37164,89371,126535,52207,0,-25560,0,0,0,,25560,-25560
37,09-08-18,40,9:45,10:00,,41.35,0,41.35,41.35,-1,-31115,81154,112269,50039,0,-44820,0,0,0,,44820,-44820
37,09-08-18,41,10:00,10:15,58.31,45.15,0,58.31,58.31,1,-60052,49267,109319,-10785,0,-21143,832,0,0,,21975,-20311
37,09-08-18,42,10:15,10:30,58.31,45.15,0,58.31,58.31,1,-62177,52445,114622,-9732,0,-53,1421,0,0,,1474,1368
37,09-08-18,43,10:30,10:45,58.31,41.35,0,41.35,41.35,-1,-49758,79424,129182,29666,0,-7114,4,0,0,,7118,-7110
37,09-08-18,44,10:45,11:00,,41.35,0,41.35,41.35,-1,-62813,68749,131562,5936,0,-21683,0,0,0,,21683,-21683
37,09-08-18,45,11:00,11:15,83.47,41.35,0,83.47,83.47,1,-72373,44943,117316,-27430,0,-4885,13836,0,0,,18721,8951
37,09-08-18,46,11:15,11:30,60.42,53,0,60.42,53,2,-67724,58916,126640,-8808,0,-3,27368,0,0,,27371,27365
37,09-08-18,47,11:30,11:45,60.42,27.35,0,27.35,27.35,-1,-41640,78541,120181,36901,0,-17019,4256,0,0,,21275,-12763
37,09-08-18,48,11:45,12:00,,-21.02,0,-21.02,-21.02,-1,-27744,94279,122023,66535,0,-39964,0,0,0,,39964,-39964
37,09-08-18,49,12:00,12:15,,-53.57,0,-53.57,-53.57,-1,-14004,81180,95184,67176,0,-67387,0,0,0,,67387,-67387
37,09-08-18,50,12:15,12:30,,3,0,3,3,-1,-24459,101143,125602,76684,0,-56431,0,0,0,,56431,-56431
37,09-08-18,51,12:30,12:45,,-13.06,0,-13.06,-13.06,-1,-31873,118139,150012,86266,0,-76522,0,0,0,,76522,-76522
37,09-08-18,52,12:45,13:00,,27.35,0,27.35,27.35,-1,-39811,123305,163116,83494,0,-79045,0,0,0,,79045,-79045
37,09-08-18,53,13:00,13:15,,41.35,0,41.35,41.35,-1,-56094,90944,147038,34850,0,-44935,0,0,0,,44935,-44935
37,09-08-18,54,13:15,13:30,,47.63,0,47.63,47.63,-1,-39144,110091,149235,70947,0,-9159,0,0,0,,9159,-9159
37,09-08-18,55,13:30,13:45,,47.94,0,47.94,47.94,-1,-42218,107382,149600,65164,0,-2750,0,0,0,,2750,-2750
37,09-08-18,56,13:45,14:00,,45.15,0,45.15,45.15,-1,-33629,99418,133047,65789,0,-3315,0,0,0,,3315,-3315
37,09-08-18,57,14:00,14:15,,44.17,0,44.17,44.17,-1,-47233,72236,119469,25003,0,-14143,0,0,0,,14143,-14143
37,09-08-18,58,14:15,14:30,,52.39,0,52.39,52.39,-1,-53367,53433,106800,66,0,-2519,0,0,0,,2519,-2519
37,09-08-18,59,14:30,14:45,53.15,,0,53.15,53.15,1,-53972,54972,108944,1000,0,0,1044,0,0,,1044,1044
37,09-08-18,60,14:45,15:00,,41.35,0,41.35,41.35,-1,-49051,69974,119025,20923,0,-10530,0,0,0,,10530,-10530
37,09-08-18,61,15:00,15:15,,39.55,0,39.55,39.55,-1,-40488,106345,146833,65857,0,-49590,0,0,0,,49590,-49590
37,09-08-18,62,15:15,15:30,,42.38,0,42.38,42.38,-1,-64037,85540,149577,21503,0,-42267,0,0,0,,42267,-42267
37,09-08-18,63,15:30,15:45,55,42.38,0,55,55,1,-69852,64396,134248,-5456,0,-3979,883,0,0,,4862,-3096
37,09-08-18,64,15:45,16:00,61.35,,0,61.35,61.35,1,-77532,50531,128063,-27001,0,0,9170,0,0,,9170,9170
37,09-08-18,65,16:00,16:15,61.35,,0,61.35,61.35,1,-69699,57251,126950,-12448,0,0,16026,0,0,,16026,16026
37,09-08-18,66,16:15,16:30,53.15,,0,53.15,53.15,1,-68814,65955,134769,-2859,0,0,5245,0,0,,5245,5245
37,09-08-18,67,16:30,16:45,84.07,,0,84.07,84.07,1,-95434,56396,151830,-39038,0,0,12921,0,0,,12921,12921
37,09-08-18,68,16:45,17:00,158.12,,0,158.12,158.12,1,-99596,33971,133567,-65625,0,0,64565,0,0,,64565,64565
37,09-08-18,69,17:00,17:15,158.12,35.35,0,35.35,35.35,-1,-49416,113041,162457,63625,0,-3035,30580,0,0,,33615,27545
37,09-08-18,70,17:15,17:30,,35.35,0,35.35,35.35,-1,-33237,89951,123188,56714,0,-8618,0,0,0,,8618,-8618
37,09-08-18,71,17:30,17:45,53.86,,0,53.86,53.86,1,-53585,64072,117657,10487,0,0,200,0,0,,200,200
37,09-08-18,72,17:45,18:00,61.35,,0,61.35,61.35,1,-73662,45749,119411,-27913,0,0,18013,0,0,,18013,18013
37,09-08-18,73,18:00,18:15,61.35,,0,61.35,61.35,1,-59190,38194,97384,-20996,0,0,26930,0,0,,26930,26930
37,09-08-18,74,18:15,18:30,58.1,,0,58.1,58.1,1,-57513,48836,106349,-8677,0,0,24648,0,0,,24648,24648
37,09-08-18,75,18:30,18:45,57.15,,0,57.15,57.15,1,-63873,57028,120901,-6845,0,0,16993,0,0,,16993,16993
37,09-08-18,76,18:45,19:00,61.35,,0,61.35,61.35,1,-71270,58596,129866,-12674,0,0,24324,0,0,,24324,24324
37,09-08-18,77,19:00,19:15,57.15,55.55,0,55.55,55.55,-1,-64303,52232,116535,-12071,0,-235,17192,0,0,,17427,16957
37,09-08-18,78,19:15,19:30,57.15,53.37,0,53.37,53.37,-1,-46312,59248,105560,12936,0,-492,464,0,0,,956,-28
37,09-08-18,79,19:30,19:45,,,0,54.94,54.94,0,-47178,60840,108018,13662,0,0,0,0,0,,0,0
37,09-08-18,80,19:45,20:00,53.15,,0,53.15,53.15,1,-52323,70523,122846,18200,0,0,168,0,0,,168,168
37,09-08-18,81,20:00,20:15,,,0,54.94,54.94,0,-33073,92606,125679,59533,0,0,0,0,0,,0,0
37,09-08-18,82,20:15,20:30,54.77,,0,54.77,54.77,1,-45709,68916,114625,23207,0,0,416,0,0,,416,416
37,09-08-18,83,20:30,20:45,57.15,,0,57.15,57.15,1,-68456,56218,124674,-12238,0,0,6125,0,0,,6125,6125
37,09-08-18,84,20:45,21:00,53.15,,0,53.15,53.15,1,-73835,73984,147819,149,0,0,2413,0,0,,2413,2413
37,09-08-18,85,21:00,21:15,61.35,,0,61.35,61.35,1,-78239,54432,132671,-23807,0,0,8672,0,0,,8672,8672
37,09-08-18,86,21:15,21:30,54.71,,0,54.71,54.71,1,-64457,50740,115197,-13717,0,0,4823,0,0,,4823,4823
37,09-08-18,87,21:30,21:45,56.56,,0,56.56,56.56,1,-56183,41006,97189,-15177,0,0,1659,0,0,,1659,1659
37,09-08-18,88,21:45,22:00,53.15,,0,53.15,53.15,1,-44822,41876,86698,-2946,0,0,217,0,0,,217,217
37,09-08-18,89,22:00,22:15,56.98,,0,56.98,56.98,1,-64780,51061,115841,-13719,0,0,1675,0,0,,1675,1675
37,09-08-18,90,22:15,22:30,56.98,45.15,0,45.15,45.15,-1,-58262,75431,133693,17169,0,-3882,449,0,0,,4331,-3433
37,09-08-18,91,22:30,22:45,,44.2,0,44.2,44.2,-1,-73720,90442,164162,16722,0,-14563,0,0,0,,14563,-14563
37,09-08-18,92,22:45,23:00,,41.35,0,41.35,41.35,-1,-69920,106301,176221,36381,0,-22674,0,0,0,,22674,-22674
37,09-08-18,93,23:00,23:15,56.6,23.19,0,56.6,23.19,2,-64379,75859,140238,11480,0,-31263,91,0,0,,31354,-31172
37,09-08-18,94,23:15,23:30,77.35,23.19,0,77.35,77.35,1,-84443,63397,147840,-21046,0,-1037,11773,0,0,,12810,10736
37,09-08-18,95,23:30,23:45,159.12,,0,159.12,159.12,1,-121402,72224,193626,-49178,0,0,21775,0,0,,21775,21775
37,09-08-18,96,23:45,0:00,96.96,,0,96.96,96.96,1,-160281,87668,247949,-72613,0,0,57283,0,0,,57283,57283
37,09-09-18,1,0:00,0:15,69.82,,0,69.82,69.82,1,-103156,52255,155411,-50901,0,0,36629,0,0,,36629,36629
37,09-09-18,2,0:15,0:30,88.89,,0,88.89,88.89,1,-84608,18221,102829,-66387,0,0,54784,0,0,,54784,54784
37,09-09-18,3,0:30,0:45,61.35,,0,61.35,61.35,1,-83276,20419,103695,-62857,0,0,36256,0,0,,36256,36256
37,09-09-18,4,0:45,1:00,53.15,,0,53.15,53.15,1,-77412,26083,103495,-51329,0,0,9370,0,0,,9370,9370
37,09-09-18,5,1:00,1:15,77.35,52.61,0,77.35,52.61,2,-59063,32572,91635,-26491,0,-21,4276,0,0,,4297,4255
37,09-09-18,6,1:15,1:30,82.31,,0,82.31,82.31,1,-56552,24455,81007,-32097,0,0,23237,0,0,,23237,23237
37,09-09-18,7,1:30,1:45,53.46,,0,53.46,53.46,1,-58358,35093,93451,-23265,0,0,10539,0,0,,10539,10539
37,09-09-18,8,1:45,2:00,53.15,,0,53.15,53.15,1,-62962,43702,106664,-19260,0,0,2899,0,0,,2899,2899
37,09-09-18,9,2:00,2:15,66.22,,0,66.22,66.22,1,-57974,26084,84058,-31890,0,0,8413,0,0,,8413,8413
37,09-09-18,10,2:15,2:30,76.64,,0,76.64,76.64,1,-44919,29926,74845,-14993,0,0,22540,0,0,,22540,22540
37,09-09-18,11,2:30,2:45,56.46,,0,56.46,56.46,1,-48623,33533,82156,-15090,0,0,6433,0,0,,6433,6433
37,09-09-18,12,2:45,3:00,53.41,52.61,0,52.61,52.61,-1,-40648,40482,81130,-166,0,-118,2996,0,0,,3114,2878
37,09-09-18,13,3:00,3:15,61.35,52.38,0,61.35,52.38,2,-61194,37363,98557,-23831,0,-285,6176,0,0,,6461,5891
37,09-09-18,14,3:15,3:30,61.35,,0,61.35,61.35,1,-70741,36066,106807,-34675,0,0,22452,0,0,,22452,22452
37,09-09-18,15,3:30,3:45,61.35,,0,61.35,61.35,1,-73645,36228,109873,-37417,0,0,35594,0,0,,35594,35594
37,09-09-18,16,3:45,4:00,57.15,,0,57.15,57.15,1,-70484,39920,110404,-30564,0,0,25439,0,0,,25439,25439
37,09-09-18,17,4:00,4:15,61.35,,0,61.35,61.35,1,-68093,34592,102685,-33501,0,0,26984,0,0,,26984,26984
37,09-09-18,18,4:15,4:30,57.15,,0,57.15,57.15,1,-60385,34605,94990,-25780,0,0,23266,0,0,,23266,23266
37,09-09-18,19,4:30,4:45,61.35,,0,61.35,61.35,1,-64511,27677,92188,-36834,0,0,22137,0,0,,22137,22137
37,09-09-18,20,4:45,5:00,57.15,,0,57.15,57.15,1,-55552,18756,74308,-36796,0,0,28480,0,0,,28480,28480
37,09-09-18,21,5:00,5:15,54.7,,0,54.7,54.7,1,-40716,35460,76176,-5256,0,0,14493,0,0,,14493,14493
37,09-09-18,22,5:15,5:30,77.35,,0,77.35,77.35,1,-69427,22808,92235,-46619,0,0,15706,0,0,,15706,15706
37,09-09-18,23,5:30,5:45,77.35,,0,77.35,77.35,1,-62314,20196,82510,-42118,0,0,46142,0,0,,46142,46142
37,09-09-18,24,5:45,6:00,61.35,,0,61.35,61.35,1,-74651,20911,95562,-53740,0,0,36440,0,0,,36440,36440
37,09-09-18,25,6:00,6:15,60.13,,0,60.13,60.13,1,-92171,49340,141511,-42831,0,0,37876,0,0,,37876,37876
37,09-09-18,26,6:15,6:30,58.06,,0,58.06,58.06,1,-84455,47834,132289,-36621,0,0,35568,0,0,,35568,35568
37,09-09-18,27,6:30,6:45,61.87,,0,61.87,61.87,1,-90753,46862,137615,-43891,0,0,32948,0,0,,32948,32948
37,09-09-18,28,6:45,7:00,61.87,,0,61.87,61.87,1,-70888,50196,121084,-20692,0,0,36693,0,0,,36693,36693
37,09-09-18,29,7:00,7:15,61.87,49.67,0,49.67,49.67,-1,-56462,83145,139607,26683,0,-814,3938,0,0,,4752,3124
37,09-09-18,30,7:15,7:30,53.67,,0,53.67,53.67,1,-70420,57711,128131,-12709,0,0,1561,0,0,,1561,1561
37,09-09-18,31,7:30,7:45,61.87,,0,61.87,61.87,1,-84513,48293,132806,-36220,0,0,15157,0,0,,15157,15157
37,09-09-18,32,7:45,8:00,77.88,,0,77.88,77.88,1,-87598,56519,144117,-31079,0,0,35031,0,0,,35031,35031
37,09-09-18,33,8:00,8:15,57.67,,0,57.67,57.67,1,-72406,43520,115926,-28886,0,0,8477,0,0,,8477,8477
37,09-09-18,34,8:15,8:30,61.87,,0,61.87,61.87,1,-71919,41300,113219,-30619,0,0,12437,0,0,,12437,12437
37,09-09-18,35,8:30,8:45,61.87,,0,61.87,61.87,1,-88163,37340,125503,-50823,0,0,35456,0,0,,35456,35456
37,09-09-18,36,8:45,9:00,61.87,,0,61.87,61.87,1,-90051,36043,126094,-54008,0,0,44167,0,0,,44167,44167
37,09-09-18,37,9:00,9:15,64.7,,0,64.7,64.7,1,-102307,48282,150589,-54025,0,0,44632,0,0,,44632,44632
37,09-09-18,38,9:15,9:30,77.88,,0,77.88,77.88,1,-126504,47628,174132,-78876,0,0,55184,0,0,,55184,55184
37,09-09-18,39,9:30,9:45,73.25,,0,73.25,73.25,1,-110659,44901,155560,-65758,0,0,60322,0,0,,60322,60322
37,09-09-18,40,9:45,10:00,61.87,,0,61.87,61.87,1,-88043,46832,134875,-41211,0,0,37099,0,0,,37099,37099
37,09-09-18,41,10:00,10:15,72.56,,0,72.56,72.56,1,-97745,42885,140630,-54860,0,0,20961,0,0,,20961,20961
37,09-09-18,42,10:15,10:30,53.67,,0,53.67,53.67,1,-83659,43812,127471,-39847,0,0,10488,0,0,,10488,10488
37,09-09-18,43,10:30,10:45,53.67,,0,53.67,53.67,1,-58498,55179,113677,-3319,0,0,4045,0,0,,4045,4045
37,09-09-18,44,10:45,11:00,,,0,53.01,53.01,0,-46565,82902,129467,36337,0,0,43,0,0,,43,43
37,09-09-18,45,11:00,11:15,,-67.12,0,-67.12,-67.12,-1,-25318,105648,130966,80330,0,-19529,0,0,0,,19529,-19529
37,09-09-18,46,11:15,11:30,,34.78,0,34.78,34.78,-1,-40564,97715,138279,57151,0,-43184,0,0,0,,43184,-43184
37,09-09-18,47,11:30,11:45,,27.88,0,27.88,27.88,-1,-26899,114902,141801,88003,0,-45390,0,0,0,,45390,-45390
37,09-09-18,48,11:45,12:00,,41.87,0,41.87,41.87,-1,-34542,121302,155844,86760,0,-17170,0,0,0,,17170,-17170
37,09-09-18,49,12:00,12:15,,41.87,0,41.87,41.87,-1,-40117,108475,148592,68358,0,-11949,0,0,0,,11949,-11949
37,09-09-18,50,12:15,12:30,,27.88,0,27.88,27.88,-1,-36087,123428,159515,87341,0,-30431,0,0,0,,30431,-30431
37,09-09-18,51,12:30,12:45,,41.87,0,41.87,41.87,-1,-48175,135761,183936,87586,0,-21589,0,0,0,,21589,-21589
37,09-09-18,52,12:45,13:00,,-59.92,0,-59.92,-59.92,-1,-48740,129101,177841,80361,0,-10262,0,0,0,,10262,-10262
37,09-09-18,53,13:00,13:15,53.74,42.23,0,53.74,42.23,2,-82639,63960,146599,-18679,0,-5961,306,0,0,,6267,-5655
37,09-09-18,54,13:15,13:30,,-63.78,0,-63.78,-63.78,-1,-75101,115077,190178,39976,0,-7703,0,0,0,,7703,-7703
37,09-09-18,55,13:30,13:45,,-74.78,0,-74.78,-74.78,-1,-71647,97357,169004,25710,0,-31330,0,0,0,,31330,-31330
37,09-09-18,56,13:45,14:00,,-70.23,0,-70.23,-70.23,-1,-80614,128246,208860,47632,0,-42057,0,0,0,,42057,-42057
37,09-09-18,57,14:00,14:15,,32.05,0,32.05,32.05,-1,-74867,113231,188098,38364,0,-42449,0,0,0,,42449,-42449
37,09-09-18,58,14:15,14:30,,,0,51.48,51.48,0,-93452,109712,203164,16260,0,-5479,0,0,0,,5479,-5479
37,09-09-18,59,14:30,14:45,,41.87,0,41.87,41.87,-1,-97466,130004,227470,32538,0,-2056,0,0,0,,2056,-2056
37,09-09-18,60,14:45,15:00,,27.88,0,27.88,27.88,-1,-85827,124943,210770,39116,0,-27595,0,0,0,,27595,-27595
37,09-09-18,61,15:00,15:15,,-74.01,0,-74.01,-74.01,-1,-50988,142130,193118,91142,0,-43843,0,0,0,,43843,-43843
37,09-09-18,62,15:15,15:30,,41.87,0,41.87,41.87,-1,-59434,119142,178576,59708,0,-12617,0,0,0,,12617,-12617
37,09-09-18,63,15:30,15:45,,,0,52.84,52.84,0,-71805,88758,160563,16953,0,-2434,0,0,0,,2434,-2434
37,09-09-18,64,15:45,16:00,,,0,52.79,52.79,0,-66223,78998,145221,12775,0,0,0,0,0,,0,0
37,09-09-18,65,16:00,16:15,,27.88,0,27.88,27.88,-1,-20254,101837,122091,81583,0,-6667,0,0,0,,6667,-6667
37,09-09-18,66,16:15,16:30,,41.87,0,41.87,41.87,-1,-31373,67507,98880,36134,0,-13496,0,0,0,,13496,-13496
37,09-09-18,67,16:30,16:45,61.87,51.99,0,61.87,61.87,1,-57694,45178,102872,-12516,0,-4215,3687,0,0,,7902,-528
37,09-09-18,68,16:45,17:00,56.35,,0,56.35,56.35,1,-73537,45852,119389,-27685,0,0,14768,0,0,,14768,14768
37,09-09-18,69,17:00,17:15,61.87,,0,61.87,61.87,1,-115424,43929,159353,-71495,0,0,14969,0,0,,14969,14969
37,09-09-18,70,17:15,17:30,157.02,,0,157.02,157.02,1,-110223,22920,133143,-87303,0,0,18908,0,0,,18908,18908
37,09-09-18,71,17:30,17:45,156.02,,0,156.02,156.02,1,-130956,10903,141859,-120053,0,0,72988,0,0,,72988,72988
37,09-09-18,72,17:45,18:00,161.82,,0,161.82,161.82,1,-135392,9982,145374,-125410,0,0,85216,3750,0,,88966,88966
37,09-09-18,73,18:00,18:15,158.02,49.9,0,49.9,49.9,-1,-76910,72408,149318,-4502,0,-124,45587,0,0,,45711,45463
37,09-09-18,74,18:15,18:30,53.67,49.9,0,53.67,53.67,1,-57098,58386,115484,1288,0,-92,9,0,0,,101,-83
37,09-09-18,75,18:30,18:45,61.87,,0,61.87,61.87,1,-55615,38949,94564,-16666,0,0,3650,0,0,,3650,3650
37,09-09-18,76,18:45,19:00,65.31,,0,65.31,65.31,1,-67302,37241,104543,-30061,0,0,24442,0,0,,24442,24442
37,09-09-18,77,19:00,19:15,61.87,,0,61.87,61.87,1,-90494,47093,137587,-43401,0,0,22771,0,0,,22771,22771
37,09-09-18,78,19:15,19:30,160.02,,0,160.02,160.02,1,-110124,28180,138304,-81944,0,0,51185,0,0,,51185,51185
37,09-09-18,79,19:30,19:45,160.02,,0,160.02,160.02,1,-93700,26496,120196,-67204,0,0,72345,0,0,,72345,72345
37,09-09-18,80,19:45,20:00,77.88,,0,77.88,77.88,1,-103369,31332,134701,-72037,0,0,55219,0,0,,55219,55219
37,09-09-18,81,20:00,20:15,61.87,,0,61.87,61.87,1,-86060,60966,147026,-25094,0,0,27178,0,0,,27178,27178
37,09-09-18,82,20:15,20:30,160.02,,0,160.02,160.02,1,-115640,26246,141886,-89394,0,0,13221,0,0,,13221,13221
37,09-09-18,83,20:30,20:45,160.02,,0,160.02,160.02,1,-125152,21518,146670,-103634,0,0,75828,0,0,,75828,75828
37,09-09-18,84,20:45,21:00,77.88,,0,77.88,77.88,1,-96421,32604,129025,-63817,0,0,65992,0,0,,65992,65992
37,09-09-18,85,21:00,21:15,53.67,56.66,0,55.17,55.17,2,-50312,46331,96643,-3981,0,-53,12763,0,0,,12816,12710
37,09-09-18,86,21:15,21:30,,,0,55.18,55.18,0,-41241,58042,99283,16801,0,0,0,0,0,,0,0
37,09-09-18,87,21:30,21:45,,,0,55.2,55.2,0,-34425,88612,123037,54187,0,0,0,0,0,,0,0
37,09-09-18,88,21:45,22:00,,41.35,0,41.35,41.35,-1,-48953,94049,143002,45096,0,-3425,0,0,0,,3425,-3425
37,09-09-18,89,22:00,22:15,160.02,41.35,0,160.02,160.02,1,-96714,24715,121429,-71999,0,-701,13771,0,0,,14472,13070
37,09-09-18,90,22:15,22:30,127.88,,0,127.88,127.88,1,-95800,28506,124306,-67294,0,0,32700,0,0,,32700,32700
37,09-09-18,91,22:30,22:45,61.87,,0,61.87,61.87,1,-74663,35697,110360,-38966,0,0,19262,0,0,,19262,19262
37,09-09-18,92,22:45,23:00,56.45,53.11,0,53.11,53.11,-1,-58802,62102,120904,3300,0,-1,12910,0,0,,12911,12909
37,09-09-18,93,23:00,23:15,159.02,55.74,0,159.02,55.15,2,-124194,44229,168423,-79965,0,-261,14263,0,0,,14524,14002
37,09-09-18,94,23:15,23:30,159.02,,0,159.02,159.02,1,-98527,43832,142359,-54695,0,0,55411,0,0,,55411,55411
37,09-09-18,95,23:30,23:45,159.02,41.87,0,41.87,41.87,-1,-58538,73225,131763,14687,0,-5576,3871,0,0,,9447,-1705
37,09-09-18,96,23:45,0:00,,45.67,0,45.67,45.67,-1,-67818,80451,148269,12633,0,-11381,0,0,0,,11381,-11381
37,09-10-18,1,0:00,0:15,157.12,49.67,0,157.12,157.12,1,-132684,44576,177260,-88108,0,-5463,18003,0,0,,23466,12540
37,09-10-18,2,0:15,0:30,157.12,,0,157.12,157.12,1,-119484,44056,163540,-75428,0,0,71892,0,0,,71892,71892
37,09-10-18,3,0:30,0:45,61.87,,0,61.87,61.87,1,-83028,49220,132248,-33808,0,0,30250,0,0,,30250,30250
37,09-10-18,4,0:45,1:00,127.88,,0,127.88,127.88,1,-78444,31664,110108,-46780,0,0,26673,0,0,,26673,26673
37,09-10-18,5,1:00,1:15,57.67,,0,57.67,57.67,1,-58857,44218,103075,-14639,0,0,14931,0,0,,14931,14931
37,09-10-18,6,1:15,1:30,57.98,,0,57.98,57.98,1,-70281,33097,103378,-37184,0,0,3826,0,0,,3826,3826
37,09-10-18,7,1:30,1:45,77.88,,0,77.88,77.88,1,-94124,31799,125923,-62325,0,0,13130,0,0,,13130,13130
37,09-10-18,8,1:45,2:00,61.87,,0,61.87,61.87,1,-84980,34462,119442,-50518,0,0,23034,0,0,,23034,23034
37,09-10-18,9,2:00,2:15,77.88,,0,77.88,77.88,1,-89242,40357,129599,-48885,0,0,22740,0,0,,22740,22740
37,09-10-18,10,2:15,2:30,61.87,,0,61.87,61.87,1,-97307,33545,130852,-63762,0,0,35664,0,0,,35664,35664
37,09-10-18,11,2:30,2:45,77.88,,0,77.88,77.88,1,-109031,29325,138356,-79706,0,0,42290,0,0,,42290,42290
37,09-10-18,12,2:45,3:00,53.67,,0,53.67,53.67,1,-101176,24872,126048,-76304,0,0,10255,0,0,,10255,10255
37,09-10-18,13,3:00,3:15,77.88,,0,77.88,77.88,1,-87091,28875,115966,-58216,0,0,9634,0,0,,9634,9634
37,09-10-18,14,3:15,3:30,57.67,,0,57.67,57.67,1,-90574,23809,114383,-66765,0,0,11273,0,0,,11273,11273
37,09-10-18,15,3:30,3:45,,,0,53.1,53.1,0,-102787,26052,128839,-76735,0,0,337,0,0,,337,337
37,09-10-18,16,3:45,4:00,,,0,53.09,53.09,0,-83111,36562,119673,-46549,0,0,0,0,0,,0,0
37,09-10-18,17,4:00,4:15,,,0,53.13,53.13,0,-84461,55832,140293,-28629,0,0,0,0,0,,0,0
37,09-10-18,18,4:15,4:30,,,0,53.11,53.11,0,-83568,48520,132088,-35048,0,0,0,0,0,,0,0
37,09-10-18,19,4:30,4:45,53.4,,0,53.4,53.4,1,-74354,56171,130525,-18183,0,0,16,0,0,,16,16
37,09-10-18,20,4:45,5:00,53.36,49.67,0,53.36,49.67,2,-73282,68039,141321,-5243,0,-173,718,0,0,,891,545
37,09-10-18,21,5:00,5:15,,41.87,0,41.87,41.87,-1,-61197,70271,131468,9074,0,-3245,0,0,0,,3245,-3245
37,09-10-18,22,5:15,5:30,,41.87,0,41.87,41.87,-1,-66505,88672,155177,22167,0,-23003,0,0,0,,23003,-23003
37,09-10-18,23,5:30,5:45,55.37,51.76,0,55.37,51.76,2,-88054,66745,154799,-21309,0,-7324,887,0,0,,8211,-6437
37,09-10-18,24,5:45,6:00,59.96,,0,59.96,59.96,1,-89643,74173,163816,-15470,0,0,5365,0,0,,5365,5365
37,09-10-18,25,6:00,6:15,63.14,,0,63.14,63.14,1,-101032,67239,168271,-33793,0,0,9014,0,0,,9014,9014
37,09-10-18,26,6:15,6:30,63.14,,0,63.14,63.14,1,-69712,59590,129302,-10122,0,0,2428,0,0,,2428,2428
37,09-10-18,27,6:30,6:45,158.12,,0,158.12,158.12,1,-133510,39894,173404,-93616,0,0,50908,0,0,,50908,50908
37,09-10-18,28,6:45,7:00,228.35,51.4,0,51.4,51.4,-1,-105721,107711,213432,1990,0,-84,48532,2500,0,,51116,50948
37,09-10-18,29,7:00,7:15,228.35,27.91,0,27.91,27.91,-1,-73986,166960,240946,92974,0,-9280,99,0,0,,9379,-9181
37,09-10-18,30,7:15,7:30,,53.11,0,53.11,53.11,-1,-47919,70885,118804,22966,0,-1910,0,0,0,,1910,-1910
37,09-10-18,31,7:30,7:45,58.91,53,0,58.91,53,2,-71405,43996,115401,-27409,0,-396,1059,0,0,,1455,663
37,09-10-18,32,7:45,8:00,63.14,52.94,0,63.14,52.94,2,-94396,42340,136736,-52056,0,-13,7191,0,0,,7204,7178
37,09-10-18,33,8:00,8:15,63.14,41.9,0,41.9,41.9,-1,-56745,58448,115193,1703,0,-8047,172,0,0,,8219,-7875
37,09-10-18,34,8:15,8:30,,53.32,0,53.32,53.32,-1,-48974,54065,103039,5091,0,-688,0,0,0,,688,-688
37,09-10-18,35,8:30,8:45,54.91,,0,54.91,54.91,1,-86051,42909,128960,-43142,0,0,641,0,0,,641,641
37,09-10-18,36,8:45,9:00,54.91,,0,54.91,54.91,1,-118246,43798,162044,-74448,0,0,1149,0,0,,1149,1149
37,09-10-18,37,9:00,9:15,153.12,,0,153.12,153.12,1,-167489,37089,204578,-130400,0,0,18966,0,0,,18966,18966
37,09-10-18,38,9:15,9:30,281.16,,0,281.16,281.16,1,-123681,95874,219555,-27807,0,0,55162,3750,0,,58912,58912
37,09-10-18,39,9:30,9:45,281.16,41.9,0,41.9,41.9,-1,-100373,141378,241751,41005,0,-2010,2677,0,0,,4687,667
37,09-10-18,40,9:45,10:00,,53.04,0,53.04,53.04,-1,-91023,133385,224408,42362,0,-358,0,0,0,,358,-358
37,09-10-18,41,10:00,10:15,,49.7,0,49.7,49.7,-1,-60033,95496,155529,35463,0,-1436,0,0,0,,1436,-1436
37,09-10-18,42,10:15,10:30,,41.9,0,41.9,41.9,-1,-27741,97039,124780,69298,0,-27578,0,0,0,,27578,-27578
37,09-10-18,43,10:30,10:45,,49.7,0,49.7,49.7,-1,-51246,95647,146893,44401,0,-23700,0,0,0,,23700,-23700
37,09-10-18,44,10:45,11:00,,50.78,0,50.78,50.78,-1,-49495,85526,135021,36031,0,-14059,0,0,0,,14059,-14059
37,09-10-18,45,11:00,11:15,58.91,50.78,0,58.91,58.91,1,-107447,34613,142060,-72834,0,-3864,2613,0,0,,6477,-1251
37,09-10-18,46,11:15,11:30,,,0,52.92,52.92,0,-88582,40215,128797,-48367,0,0,0,0,0,,0,0
37,09-10-18,47,11:30,11:45,,,0,52.92,52.92,0,-79647,41419,121066,-38228,0,0,0,0,0,,0,0
37,09-10-18,48,11:45,12:00,58.01,,0,58.01,58.01,1,-93655,41980,135635,-51675,0,0,116,0,0,,116,116
37,09-10-18,49,12:00,12:15,151.12,,0,151.12,151.12,1,-147529,21026,168555,-126503,0,0,21876,0,0,,21876,21876
37,09-10-18,50,12:15,12:30,63.14,,0,63.14,63.14,1,-94839,28473,123312,-66366,0,0,31387,0,0,,31387,31387
37,09-10-18,51,12:30,12:45,,,0,55.34,55.34,0,-83499,42608,126107,-40891,0,0,2859,0,0,,2859,2859
37,09-10-18,52,12:45,13:00,,,0,55.34,55.34,0,-86492,58832,145324,-27660,0,0,0,0,0,,0,0
37,09-10-18,53,13:00,13:15,59.32,,0,59.32,59.32,1,-92983,42801,135784,-50182,0,0,2810,0,0,,2810,2810
37,09-10-18,54,13:15,13:30,63.14,,0,63.14,63.14,1,-98454,43374,141828,-55080,0,0,11420,0,0,,11420,11420
37,09-10-18,55,13:30,13:45,58.91,,0,58.91,58.91,1,-121123,51372,172495,-69751,0,0,10886,0,0,,10886,10886
37,09-10-18,56,13:45,14:00,58.91,,0,58.91,58.91,1,-143226,56377,199603,-86849,0,0,19748,0,0,,19748,19748
37,09-10-18,57,14:00,14:15,63.14,,0,63.14,63.14,1,-115587,82989,198576,-32598,0,0,11270,0,0,,11270,11270
37,09-10-18,58,14:15,14:30,142.12,,0,142.12,142.12,1,-135799,75701,211500,-60098,0,0,31779,0,0,,31779,31779
37,09-10-18,59,14:30,14:45,59.56,,0,59.56,59.56,1,-124341,77347,201688,-46994,0,0,16867,0,0,,16867,16867
37,09-10-18,60,14:45,15:00,63.14,,0,63.14,63.14,1,-149678,75873,225551,-73805,0,0,32800,0,0,,32800,32800
37,09-10-18,61,15:00,15:15,63.12,,0,63.12,63.12,1,-95905,64795,160700,-31110,0,0,24562,0,0,,24562,24562
37,09-10-18,62,15:15,15:30,54.91,52.74,0,54.91,52.74,2,-98972,73051,172023,-25921,0,-73,1357,0,0,,1430,1284
37,09-10-18,63,15:30,15:45,63.14,,0,63.14,63.14,1,-112128,56773,168901,-55355,0,0,12623,0,0,,12623,12623
37,09-10-18,64,15:45,16:00,64.12,,0,64.12,64.12,1,-127361,60426,187787,-66935,0,0,31901,0,0,,31901,31901
37,09-10-18,65,16:00,16:15,57.37,,0,57.37,57.37,1,-86890,54379,141269,-32511,0,0,12955,0,0,,12955,12955
37,09-10-18,66,16:15,16:30,54.91,,0,54.91,54.91,1,-91913,31455,123368,-60458,0,0,33,0,0,,33,33
37,09-10-18,67,16:30,16:45,128.16,,0,128.16,128.16,1,-133081,31931,165012,-101150,0,0,16142,0,0,,16142,16142
37,09-10-18,68,16:45,17:00,153.12,,0,153.12,153.12,1,-133416,43539,176955,-89877,0,0,62346,0,0,,62346,62346
37,09-10-18,69,17:00,17:15,57.49,51.42,0,57.49,51.42,2,-64229,71359,135588,7130,0,-569,16095,0,0,,16664,15526
37,09-10-18,70,17:15,17:30,78.16,,0,78.16,78.16,1,-87302,51126,138428,-36176,0,0,16215,0,0,,16215,16215
37,09-10-18,71,17:30,17:45,63.14,,0,63.14,63.14,1,-91524,67110,158634,-24414,0,0,24616,0,0,,24616,24616
37,09-10-18,72,17:45,18:00,58.58,52.92,0,52.92,52.92,-1,-66417,76707,143124,10290,0,-157,13977,0,0,,14134,13820
37,09-10-18,73,18:00,18:15,54.91,52.91,0,55.34,52.91,2,-98383,55491,153874,-42892,0,-64,803,0,0,,867,739
37,09-10-18,74,18:15,18:30,,,0,55.31,55.31,0,-66751,73256,140007,6505,0,0,19,0,0,,19,19
37,09-10-18,75,18:30,18:45,58.91,,0,58.91,58.91,1,-68838,66957,135795,-1881,0,0,1436,0,0,,1436,1436
37,09-10-18,76,18:45,19:00,58.91,,0,58.91,58.91,1,-77385,80293,157678,2908,0,0,1963,0,0,,1963,1963
37,09-10-18,77,19:00,19:15,58.91,,0,58.91,58.91,1,-75027,94005,169032,18978,0,0,1966,0,0,,1966,1966
37,09-10-18,78,19:15,19:30,57.78,,0,57.78,57.78,1,-83218,86334,169552,3116,0,0,1124,0,0,,1124,1124
37,09-10-18,79,19:30,19:45,54.91,,0,54.91,54.91,1,-70295,75035,145330,4740,0,0,1699,0,0,,1699,1699
37,09-10-18,80,19:45,20:00,63.14,,0,63.14,63.14,1,-89247,67912,157159,-21335,0,0,7746,0,0,,7746,7746
37,09-10-18,81,20:00,20:15,63.14,,0,63.14,63.14,1,-84749,48541,133290,-36208,0,0,21997,0,0,,21997,21997
37,09-10-18,82,20:15,20:30,156.12,,0,156.12,156.12,1,-111041,36023,147064,-75018,0,0,50384,0,0,,50384,50384
37,09-10-18,83,20:30,20:45,156.12,,0,156.12,156.12,1,-116144,42247,158391,-73897,0,0,74212,0,0,,74212,74212
37,09-10-18,84,20:45,21:00,60.12,45.44,0,45.44,45.44,-1,-65450,56298,121748,-9152,0,-1102,24004,0,0,,25106,22902
37,09-10-18,85,21:00,21:15,57.51,52.89,0,57.51,52.89,2,-43563,54479,98042,10916,0,-1074,825,0,0,,1899,-249
37,09-10-18,86,21:15,21:30,54.91,27.91,0,27.91,27.91,-1,-39391,82217,121608,42826,0,-5108,507,0,0,,5615,-4601
37,09-10-18,87,21:30,21:45,,27.91,0,27.91,27.91,-1,-22500,105912,128412,83412,0,-16440,0,0,0,,16440,-16440
37,09-10-18,88,21:45,22:00,,-59.13,0,-59.13,-59.13,-1,-33074,124378,157452,91304,0,-56344,0,0,0,,56344,-56344
37,09-10-18,89,22:00,22:15,58.91,49.7,0,58.91,49.7,2,-118664,16818,135482,-101846,0,-10947,642,0,0,,11589,-10305
37,09-10-18,90,22:15,22:30,,,0,53.9,53.9,0,-72583,42612,115195,-29971,0,0,0,0,0,,0,0
37,09-10-18,91,22:30,22:45,,45.47,0,45.47,45.47,-1,-43093,66314,109407,23221,0,-5442,0,0,0,,5442,-5442
37,09-10-18,92,22:45,23:00,,41.9,0,41.9,41.9,-1,-55085,85301,140386,30216,0,-25072,0,0,0,,25072,-25072
37,09-10-18,93,23:00,23:15,63.14,35.78,0,63.14,35.78,2,-87453,82580,170033,-4873,0,-19164,2199,0,0,,21363,-16965
37,09-10-18,94,23:15,23:30,53.12,35.78,0,53.12,53.12,1,-66911,48506,115417,-18405,0,-272,590,0,0,,862,318
37,09-10-18,95,23:30,23:45,,,0,53.85,53.85,0,-41353,46604,87957,5251,0,0,0,0,0,,0,0
37,09-10-18,96,23:45,0:00,,51.55,0,51.55,51.55,-1,-59536,42611,102147,-16925,0,-73,0,0,0,,73,-73
37,09-11-18,1,0:00,0:15,,24.66,0,24.66,24.66,-1,-35653,89617,125270,53964,0,-7662,0,0,0,,7662,-7662
37,09-11-18,2,0:15,0:30,55.55,24.66,0,55.55,55.55,1,-65164,9342,74506,-55822,0,-7,1239,0,0,,1246,1232
37,09-11-18,3,0:30,0:45,53.77,,0,53.77,53.77,1,-87177,34727,121904,-52450,0,0,904,0,0,,904,904
37,09-11-18,4,0:45,1:00,,,0,54.14,54.14,0,-92333,26035,118368,-66298,0,0,0,0,0,,0,0
37,09-11-18,5,1:00,1:15,78.24,,0,78.24,78.24,1,-108360,36492,144852,-71868,0,0,25473,0,0,,25473,25473
37,09-11-18,6,1:15,1:30,62.01,,0,62.01,62.01,1,-69483,24699,94182,-44784,0,0,18791,0,0,,18791,18791
37,09-11-18,7,1:30,1:45,55.67,,0,55.67,55.67,1,-60919,29770,90689,-31149,0,0,237,0,0,,237,237
37,09-11-18,8,1:45,2:00,,49.77,0,49.77,49.77,-1,-30302,41007,71309,10705,0,-1565,0,0,0,,1565,-1565
37,09-11-18,9,2:00,2:15,61.85,49.77,0,61.85,61.85,1,-96700,13350,110050,-83350,0,-21,2992,0,0,,3013,2971
37,09-11-18,10,2:15,2:30,,,0,51.77,51.77,0,-82237,17097,99334,-65140,0,0,38,0,0,,38,38
37,09-11-18,11,2:30,2:45,,,0,51.77,51.77,0,-69483,36023,105506,-33460,0,0,0,0,0,,0,0
37,09-11-18,12,2:45,3:00,,45.77,0,45.77,45.77,-1,-63513,64386,127899,873,0,-393,0,0,0,,393,-393
37,09-11-18,13,3:00,3:15,57.24,45.77,0,57.24,57.24,1,-67220,49151,116371,-18069,0,-361,651,0,0,,1012,290
37,09-11-18,14,3:15,3:30,57.77,,0,57.77,57.77,1,-72829,38429,111258,-34400,0,0,6200,0,0,,6200,6200
37,09-11-18,15,3:30,3:45,53.77,,0,53.77,53.77,1,-91970,44142,136112,-47828,0,0,1082,0,0,,1082,1082
37,09-11-18,16,3:45,4:00,53.77,,0,53.77,53.77,1,-89623,61029,150652,-28594,0,0,43,0,0,,43,43
37,09-11-18,17,4:00,4:15,56.19,,0,56.19,56.19,1,-108095,47248,155343,-60847,0,0,1442,0,0,,1442,1442
37,09-11-18,18,4:15,4:30,56.42,,0,56.42,56.42,1,-94584,46077,140661,-48507,0,0,1720,0,0,,1720,1720
37,09-11-18,19,4:30,4:45,53.77,,0,53.77,53.77,1,-91551,44946,136497,-46605,0,0,287,0,0,,287,287
37,09-11-18,20,4:45,5:00,55.55,,0,55.55,55.55,1,-61483,50607,112090,-10876,0,0,549,0,0,,549,549
37,09-11-18,21,5:00,5:15,57.77,,0,57.77,57.77,1,-122630,33810,156440,-88820,0,0,441,0,0,,441,441
37,09-11-18,22,5:15,5:30,,,0,47.53,47.53,0,-102247,32970,135217,-69277,0,0,0,0,0,,0,0
37,09-11-18,23,5:30,5:45,,,0,49.28,49.28,0,-93003,22112,115115,-70891,0,0,0,0,0,,0,0
37,09-11-18,24,5:45,6:00,,,0,48.78,48.78,0,-103105,25178,128283,-77927,0,0,0,0,0,,0,0
37,09-11-18,25,6:00,6:15,63.22,,0,63.22,63.22,1,-151476,50547,202023,-100929,0,0,4697,0,0,,4697,4697
37,09-11-18,26,6:15,6:30,49.02,,0,49.02,49.02,1,-118895,48459,167354,-70436,0,0,216,0,0,,216,216
37,09-11-18,27,6:30,6:45,146.02,,0,146.02,146.02,1,-140393,33023,173416,-107370,0,0,9622,0,0,,9622,9622
37,09-11-18,28,6:45,7:00,146.02,,0,146.02,146.02,1,-143498,74669,218167,-68829,0,0,57958,0,0,,57958,57958
37,09-11-18,29,7:00,7:15,56.07,29.47,0,29.47,29.47,-1,-88341,113262,201603,24921,0,-5006,10603,0,0,,15609,5597
37,09-11-18,30,7:15,7:30,,2.36,0,2.36,2.36,-1,-41602,85979,127581,44377,0,-41050,0,0,0,,41050,-41050
37,09-11-18,31,7:30,7:45,,46.97,0,46.97,46.97,-1,-66206,85480,151686,19274,0,-21085,0,0,0,,21085,-21085
37,09-11-18,32,7:45,8:00,60.12,46.97,0,60.12,60.12,1,-92858,74911,167769,-17947,0,-6234,3099,0,0,,9333,-3135
37,09-11-18,33,8:00,8:15,54.97,43.22,0,54.97,43.22,2,-66486,97271,163757,30785,0,-7670,971,0,0,,8641,-6699
37,09-11-18,34,8:15,8:30,,50.97,0,50.97,50.97,-1,-76023,92658,168681,16635,0,-13356,0,0,0,,13356,-13356
37,09-11-18,35,8:30,8:45,,50.97,0,50.97,50.97,-1,-63538,79898,143436,16360,0,-15525,0,0,0,,15525,-15525
37,09-11-18,36,8:45,9:00,,43.22,0,43.22,43.22,-1,-62830,83393,146223,20563,0,-13451,0,0,0,,13451,-13451
37,09-11-18,37,9:00,9:15,102.02,-15.87,0,102.02,-15.87,2,-92546,68345,160891,-24201,0,-24292,1907,0,0,,26199,-22385
37,09-11-18,38,9:15,9:30,103.02,49.03,0,49.03,49.03,-1,-62381,76382,138763,14001,0,-2878,2077,0,0,,4955,-801
37,09-11-18,39,9:30,9:45,,46.97,0,46.97,46.97,-1,-70506,91806,162312,21300,0,-12243,0,0,0,,12243,-12243
37,09-11-18,40,9:45,10:00,,46.97,0,46.97,46.97,-1,-71601,99355,170956,27754,0,-20185,0,0,0,,20185,-20185
37,09-11-18,41,10:00,10:15,147.02,46.97,0,147.02,147.02,1,-126445,42740,169185,-83705,0,-7541,22927,0,0,,30468,15386
37,09-11-18,42,10:15,10:30,67.02,55.27,0,55.27,55.27,-1,-81240,77820,159060,-3420,0,-10,21234,0,0,,21244,21224
37,09-11-18,43,10:30,10:45,,23.74,0,23.74,23.74,-1,-56249,101192,157441,44943,0,-22544,0,0,0,,22544,-22544
37,09-11-18,44,10:45,11:00,,20.43,0,20.43,20.43,-1,-56832,109840,166672,53008,0,-40465,0,0,0,,40465,-40465
37,09-11-18,45,11:00,11:15,,24.03,0,24.03,24.03,-1,-47586,69199,116785,21613,0,-33428,0,0,0,,33428,-33428
37,09-11-18,46,11:15,11:30,,29.47,0,29.47,29.47,-1,-36447,84057,120504,47610,0,-27400,0,0,0,,27400,-27400
37,09-11-18,47,11:30,11:45,,29.47,0,29.47,29.47,-1,-29815,90375,120190,60560,0,-53032,0,0,0,,53032,-53032
37,09-11-18,48,11:45,12:00,,29.47,0,29.47,29.47,-1,-29316,93495,122811,64179,0,-57405,0,0,0,,57405,-57405
37,09-11-18,49,12:00,12:15,,41.03,0,41.03,41.03,-1,-51020,87196,138216,36176,0,-45891,0,0,0,,45891,-45891
37,09-11-18,50,12:15,12:30,,-12.69,0,-12.69,-12.69,-1,-31956,89319,121275,57363,0,-40389,0,0,0,,40389,-40389
37,09-11-18,51,12:30,12:45,,-24.68,0,-24.68,-24.68,-1,-41326,65756,107082,24430,0,-44430,0,0,0,,44430,-44430
37,09-11-18,52,12:45,13:00,,12.54,0,12.54,12.54,-1,-50867,97521,148388,46654,0,-19452,0,0,0,,19452,-19452
37,09-11-18,53,13:00,13:15,,46.97,0,46.97,46.97,-1,-81667,98815,180482,17148,0,-21699,0,0,0,,21699,-21699
37,09-11-18,54,13:15,13:30,58.97,50.97,0,58.97,50.7,2,-89462,91782,181244,2320,0,-11994,467,0,0,,12461,-11527
37,09-11-18,55,13:30,13:45,58.97,55.37,0,58.97,50.7,2,-85699,89649,175348,3950,0,-1741,618,0,0,,2359,-1123
37,09-11-18,56,13:45,14:00,62.56,55.37,0,62.56,62.56,1,-91996,75885,167881,-16111,0,-128,3406,0,0,,3534,3278
37,09-11-18,57,14:00,14:15,63.22,,0,63.22,63.22,1,-71579,46612,118191,-24967,0,0,15895,0,0,,15895,15895
37,09-11-18,58,14:15,14:30,63.22,,0,63.22,63.22,1,-84034,49116,133150,-34918,0,0,26621,0,0,,26621,26621
37,09-11-18,59,14:30,14:45,63.22,,0,63.22,63.22,1,-91111,45420,136531,-45691,0,0,40357,0,0,,40357,40357
37,09-11-18,60,14:45,15:00,63.22,,0,63.22,63.22,1,-79767,38922,118689,-40845,0,0,36744,0,0,,36744,36744
37,09-11-18,61,15:00,15:15,63.22,2.36,0,2.36,2.36,-1,-46830,87083,133913,40253,0,-9124,14996,0,0,,24120,5872
37,09-11-18,62,15:15,15:30,65.75,50.97,0,65.75,50.69,2,-81745,58493,140238,-23252,0,-4887,7713,0,0,,12600,2826
37,09-11-18,63,15:30,15:45,146.02,,0,146.02,146.02,1,-101852,46860,148712,-54992,0,0,34898,0,0,,34898,34898
37,09-11-18,64,15:45,16:00,146.02,,0,146.02,146.02,1,-127079,51708,178787,-75371,0,0,77235,0,0,,77235,77235
37,09-11-18,65,16:00,16:15,50.02,52.98,0,51.16,51.16,2,-78468,72683,151151,-5785,0,-464,36161,0,0,,36625,35697
37,09-11-18,66,16:15,16:30,63.22,52.98,0,63.22,63.22,1,-70842,45815,116657,-25027,0,-5,8166,0,0,,8171,8161
37,09-11-18,67,16:30,16:45,79.47,,0,79.47,79.47,1,-81740,35589,117329,-46151,0,0,29002,0,0,,29002,29002
37,09-11-18,68,16:45,17:00,147.02,,0,147.02,147.02,1,-98534,33037,131571,-65497,0,0,62104,0,0,,62104,62104
37,09-11-18,69,17:00,17:15,65.66,50.05,0,50.05,50.05,-1,-83031,94327,177358,11296,0,-1373,26072,0,0,,27445,24699
37,09-11-18,70,17:15,17:30,138.02,50.05,0,138.02,138.02,1,-93938,52938,146876,-41000,0,-159,13815,0,0,,13974,13656
37,09-11-18,71,17:30,17:45,147.02,,0,147.02,147.02,1,-100102,49846,149948,-50256,0,0,50718,0,0,,50718,50718
37,09-11-18,72,17:45,18:00,65.66,,0,65.66,65.66,1,-111804,55251,167055,-56553,0,0,49816,0,0,,49816,49816
37,09-11-18,73,18:00,18:15,65.66,29.47,0,29.47,29.47,-1,-96253,119499,215752,23246,0,-3701,19651,0,0,,23352,15950
37,09-11-18,74,18:15,18:30,,,0,50.67,50.67,0,-114815,112648,227463,-2167,0,-149,0,0,0,,149,-149
37,09-11-18,75,18:30,18:45,61.11,,0,61.11,61.11,1,-121083,116315,237398,-4768,0,0,347,0,0,,347,347
37,09-11-18,76,18:45,19:00,62.6,,0,62.6,62.6,1,-121931,111013,232944,-10918,0,0,4443,0,0,,4443,4443
37,09-11-18,77,19:00,19:15,54.02,50.97,0,50.97,50.97,-1,-78387,122760,201147,44373,0,-306,918,0,0,,1224,612
37,09-11-18,78,19:15,19:30,,50.97,0,50.97,50.97,-1,-74142,112074,186216,37932,0,-1048,0,0,0,,1048,-1048
37,09-11-18,79,19:30,19:45,,,0,32.69,32.69,0,-93162,105359,198521,12197,0,0,0,0,0,,0,0
37,09-11-18,80,19:45,20:00,63.22,,0,63.22,63.22,1,-113847,99975,213822,-13872,0,0,3895,0,0,,3895,3895
37,09-11-18,81,20:00,20:15,52.02,,0,52.02,52.02,1,-68527,159030,227557,90503,0,0,670,0,0,,670,670
37,09-11-18,82,20:15,20:30,61.19,,0,61.19,61.19,1,-94978,100323,195301,5345,0,0,668,0,0,,668,668
37,09-11-18,83,20:30,20:45,65.88,,0,65.88,65.88,1,-100974,97615,198589,-3359,0,0,3160,0,0,,3160,3160
37,09-11-18,84,20:45,21:00,,,0,51.7,51.7,0,-98990,91379,190369,-7611,0,0,0,0,0,,0,0
37,09-11-18,85,21:00,21:15,148.02,,0,148.02,148.02,1,-117334,47141,164475,-70193,0,0,19531,0,0,,19531,19531
37,09-11-18,86,21:15,21:30,64.59,,0,64.59,64.59,1,-100673,43739,144412,-56934,0,0,30719,0,0,,30719,30719
37,09-11-18,87,21:30,21:45,54.97,55.26,0,55.26,55.26,-1,-65903,57891,123794,-8012,0,-18,6693,0,0,,6711,6675
37,09-11-18,88,21:45,22:00,54.97,46.97,0,46.97,46.97,-1,-58765,70508,129273,11743,0,-8639,148,0,0,,8787,-8491
37,09-11-18,89,22:00,22:15,148.02,46.97,0,148.02,148.02,1,-89785,20373,110158,-69412,0,-1229,13791,0,0,,15020,12562
37,09-11-18,90,22:15,22:30,147.02,,0,147.02,147.02,1,-68124,29974,98098,-38150,0,0,28925,0,0,,28925,28925
37,09-11-18,91,22:30,22:45,54.97,53.41,0,54.97,51.22,2,-76288,71081,147369,-5207,0,-248,1794,0,0,,2042,1546
37,09-11-18,92,22:45,23:00,54.97,55.34,0,54.97,50.72,2,-76712,77447,154159,735,0,-22,504,0,0,,526,482
37,09-11-18,93,23:00,23:15,64.26,43.22,0,64.26,43.22,2,-106844,107248,214092,404,0,-6893,1267,0,0,,8160,-5626
37,09-11-18,94,23:15,23:30,109.02,,0,109.02,109.02,1,-96558,65750,162308,-30808,0,0,24116,0,0,,24116,24116
37,09-11-18,95,23:30,23:45,82.02,,0,82.02,82.02,1,-102254,59157,161411,-43097,0,0,24398,0,0,,24398,24398
37,09-11-18,96,23:45,0:00,63.22,,0,63.22,63.22,1,-115651,51706,167357,-63945,0,0,39478,0,0,,39478,39478
37,09-12-18,1,0:00,0:15,148.12,,0,148.12,148.12,1,-136955,66229,203184,-70726,0,0,58849,0,0,,58849,58849
37,09-12-18,2,0:15,0:30,79.47,,0,79.47,79.47,1,-127518,48830,176348,-78688,0,0,63197,0,0,,63197,63197
37,09-12-18,3,0:30,0:45,99.26,,0,99.26,99.26,1,-137654,47378,185032,-90276,0,0,77899,0,0,,77899,77899
37,09-12-18,4,0:45,1:00,76.18,,0,76.18,76.18,1,-130537,57340,187877,-73197,0,0,70356,0,0,,70356,70356
37,09-12-18,5,1:00,1:15,73.24,,0,73.24,73.24,1,-107532,40357,147889,-67175,0,0,57285,0,0,,57285,57285
37,09-12-18,6,1:15,1:30,63.22,,0,63.22,63.22,1,-93014,36395,129409,-56619,0,0,50743,0,0,,50743,50743
37,09-12-18,7,1:30,1:45,62.36,,0,62.36,62.36,1,-85074,50221,135295,-34853,0,0,32596,0,0,,32596,32596
37,09-12-18,8,1:45,2:00,63.22,,0,63.22,63.22,1,-111607,48733,160340,-62874,0,0,31961,0,0,,31961,31961
37,09-12-18,9,2:00,2:15,54.97,54.74,0,54.74,54.74,-1,-40572,55617,96189,15045,0,-233,10625,0,0,,10858,10392
37,09-12-18,10,2:15,2:30,63.22,,0,63.22,63.22,1,-63818,15924,79742,-47894,0,0,9875,0,0,,9875,9875
37,09-12-18,11,2:30,2:45,,,0,49.55,49.55,0,-57170,21462,78632,-35708,0,0,1002,0,0,,1002,1002
37,09-12-18,12,2:45,3:00,,,0,49.55,49.55,0,-69089,22602,91691,-46487,0,0,0,0,0,,0,0
37,09-12-18,13,3:00,3:15,93.41,,0,93.41,93.41,1,-102988,21321,124309,-81667,0,0,23911,0,0,,23911,23911
37,09-12-18,14,3:15,3:30,59.81,,0,59.81,59.81,1,-92108,27406,119514,-64702,0,0,22110,0,0,,22110,22110
37,09-12-18,15,3:30,3:45,,,0,49.55,49.55,0,-91410,26834,118244,-64576,0,0,840,0,0,,840,840
37,09-12-18,16,3:45,4:00,,,0,49.55,49.55,0,-90110,28196,118306,-61914,0,0,0,0,0,,0,0
37,09-12-18,17,4:00,4:15,65.66,,0,65.66,65.66,1,-92166,31848,124014,-60318,0,0,14200,0,0,,14200,14200
37,09-12-18,18,4:15,4:30,58.77,,0,58.77,58.77,1,-84457,34108,118565,-50349,0,0,15485,0,0,,15485,15485
37,09-12-18,19,4:30,4:45,56.77,,0,56.77,56.77,1,-87926,31641,119567,-56285,0,0,4099,0,0,,4099,4099
37,09-12-18,20,4:45,5:00,56.75,,0,56.75,56.75,1,-89117,32330,121447,-56787,0,0,3445,0,0,,3445,3445
37,09-12-18,21,5:00,5:15,,,0,55.12,55.12,0,-80391,46746,127137,-33645,0,0,830,0,0,,830,830
37,09-12-18,22,5:15,5:30,,,0,55.11,55.11,0,-71468,50351,121819,-21117,0,0,0,0,0,,0,0
37,09-12-18,23,5:30,5:45,63.22,,0,63.22,63.22,1,-85146,52956,138102,-32190,0,0,1900,0,0,,1900,1900
37,09-12-18,24,5:45,6:00,59.12,,0,59.12,59.12,1,-62222,99360,161582,37138,0,0,2864,0,0,,2864,2864
37,09-12-18,25,6:00,6:15,52.12,56.06,0,52.32,52.32,2,-130864,66291,197155,-64573,0,-28,337,0,0,,365,309
37,09-12-18,26,6:15,6:30,,30.08,0,30.08,30.08,-1,-41811,70075,111886,28264,0,-20576,0,0,0,,20576,-20576
37,09-12-18,27,6:30,6:45,58.65,50.65,0,58.65,58.65,1,-71341,62017,133358,-9324,0,-4945,464,0,0,,5409,-4481
37,09-12-18,28,6:45,7:00,62.06,,0,62.06,62.06,1,-121096,70569,191665,-50527,0,0,11867,0,0,,11867,11867
37,09-12-18,29,7:00,7:15,55.88,38.81,0,56.23,38.81,2,-63441,133859,197300,70418,0,-12771,4994,0,0,,17765,-7777
37,09-12-18,30,7:15,7:30,,46.27,0,46.27,46.27,-1,-37896,120353,158249,82457,0,-36873,0,0,0,,36873,-36873
37,09-12-18,31,7:30,7:45,,44.07,0,44.07,44.07,-1,-61929,99494,161423,37565,0,-24692,0,0,0,,24692,-24692
37,09-12-18,32,7:45,8:00,60.92,44.07,0,60.92,60.92,1,-79259,67676,146935,-11583,0,-625,226,0,0,,851,-399
37,09-12-18,33,8:00,8:15,,47.88,0,47.88,47.88,-1,-77268,101385,178653,24117,0,-3852,0,0,0,,3852,-3852
37,09-12-18,34,8:15,8:30,,55.93,0,55.93,55.93,-1,-66267,71888,138155,5621,0,-2537,0,0,0,,2537,-2537
37,09-12-18,35,8:30,8:45,61.05,,0,61.05,61.05,1,-87065,63623,150688,-23442,0,0,2189,0,0,,2189,2189
37,09-12-18,36,8:45,9:00,79.13,,0,79.13,79.13,1,-104679,69459,174138,-35220,0,0,19069,0,0,,19069,19069
37,09-12-18,37,9:00,9:15,64.09,,0,64.09,64.09,1,-83722,79861,163583,-3861,0,0,14806,0,0,,14806,14806
37,09-12-18,38,9:15,9:30,59.88,,0,59.88,59.88,1,-68896,65976,134872,-2920,0,0,1585,0,0,,1585,1585
37,09-12-18,39,9:30,9:45,59.88,51.88,0,51.88,51.88,-1,-55924,76709,132633,20785,0,-1333,38,0,0,,1371,-1295
37,09-12-18,40,9:45,10:00,,47.88,0,47.88,47.88,-1,-52030,71317,123347,19287,0,-14797,0,0,0,,14797,-14797
37,09-12-18,41,10:00,10:15,69.25,47.88,0,69.25,69.25,1,-87864,65874,153738,-21990,0,-1550,6826,0,0,,8376,5276
37,09-12-18,42,10:15,10:30,69.25,,0,69.25,69.25,1,-96178,68383,164561,-27795,0,0,21275,0,0,,21275,21275
37,09-12-18,43,10:30,10:45,69.25,,0,69.25,69.25,1,-103948,76836,180784,-27112,0,0,22342,0,0,,22342,22342
37,09-12-18,44,10:45,11:00,139.25,,0,139.25,139.25,1,-127684,80887,208571,-46797,0,0,42843,0,0,,42843,42843
37,09-12-18,45,11:00,11:15,68.12,,0,68.12,68.12,1,-108810,72886,181696,-35924,0,0,40432,0,0,,40432,40432
37,09-12-18,46,11:15,11:30,64.58,,0,64.58,64.58,1,-99182,78782,177964,-20400,0,0,12538,0,0,,12538,12538
37,09-12-18,47,11:30,11:45,68.15,,0,68.15,68.15,1,-109187,84957,194144,-24230,0,0,21226,0,0,,21226,21226
37,09-12-18,48,11:45,12:00,61.85,,0,61.85,61.85,1,-92384,77600,169984,-14784,0,0,20590,0,0,,20590,20590
37,09-12-18,49,12:00,12:15,66.85,56.47,0,66.85,56.18,2,-71261,47201,118462,-24060,0,-48,10466,0,0,,10514,10418
37,09-12-18,50,12:15,12:30,86.85,,0,86.85,86.85,1,-74063,43000,117063,-31063,0,0,25908,0,0,,25908,25908
37,09-12-18,51,12:30,12:45,62.03,50.96,0,50.96,50.96,-1,-57499,71893,129392,14394,0,-3171,13949,0,0,,17120,10778
37,09-12-18,52,12:45,13:00,55.88,50.96,0,56.23,50.96,2,-52882,52630,105512,-252,0,-6493,103,0,0,,6596,-6390
37,09-12-18,53,13:00,13:15,59.88,,0,59.88,59.88,1,-56078,50653,106731,-5425,0,0,2068,0,0,,2068,2068
37,09-12-18,54,13:15,13:30,61.93,,0,61.93,61.93,1,-60468,46211,106679,-14257,0,0,9745,0,0,,9745,9745
37,09-12-18,55,13:30,13:45,65.57,,0,65.57,65.57,1,-62993,47791,110784,-15202,0,0,11824,0,0,,11824,11824
37,09-12-18,56,13:45,14:00,59.88,54.68,0,59.88,54.68,2,-57254,54867,112121,-2387,0,-716,6218,0,0,,6934,5502
37,09-12-18,57,14:00,14:15,61.66,56.57,0,61.66,56.23,2,-59029,45926,104955,-13103,0,-116,3675,0,0,,3791,3559
37,09-12-18,58,14:15,14:30,61.66,,0,61.66,61.66,1,-57192,44196,101388,-12996,0,0,8459,0,0,,8459,8459
37,09-12-18,59,14:30,14:45,59.88,,0,59.88,59.88,1,-57088,52877,109965,-4211,0,0,6765,0,0,,6765,6765
37,09-12-18,60,14:45,15:00,55.88,,0,55.88,55.88,1,-61290,61324,122614,34,0,0,948,0,0,,948,948
37,09-12-18,61,15:00,15:15,,,0,56.23,56.23,0,-53266,69341,122607,16075,0,0,33,0,0,,33,33
37,09-12-18,62,15:15,15:30,59.88,56.57,0,59.88,56.23,2,-52343,41830,94173,-10513,0,-563,135,0,0,,698,-428
37,09-12-18,63,15:30,15:45,64.09,,0,64.09,64.09,1,-65422,45177,110599,-20245,0,0,6595,0,0,,6595,6595
37,09-12-18,64,15:45,16:00,59.88,,0,59.88,59.88,1,-63337,51170,114507,-12167,0,0,4877,0,0,,4877,4877
37,09-12-18,65,16:00,16:15,59.88,55.01,0,55.01,55.01,-1,-44213,56779,100992,12566,0,-1178,732,0,0,,1910,-446
37,09-12-18,66,16:15,16:30,,54.62,0,54.62,54.62,-1,-42497,56745,99242,14248,0,-1964,0,0,0,,1964,-1964
37,09-12-18,67,16:30,16:45,,,0,56.03,56.03,0,-36694,55840,92534,19146,0,0,0,0,0,,0,0
37,09-12-18,68,16:45,17:00,,55.22,0,55.22,55.22,-1,-48265,51421,99686,3156,0,-61,0,0,0,,61,-61
37,09-12-18,69,17:00,17:15,,51.88,0,51.88,51.88,-1,-40482,62326,102808,21844,0,-3993,0,0,0,,3993,-3993
37,09-12-18,70,17:15,17:30,61.71,53.88,0,61.71,53.88,2,-55525,43819,99344,-11706,0,-2402,995,0,0,,3397,-1407
37,09-12-18,71,17:30,17:45,62.73,,0,62.73,62.73,1,-58792,47530,106322,-11262,0,0,5437,0,0,,5437,5437
37,09-12-18,72,17:45,18:00,59.88,,0,59.88,59.88,1,-52900,51591,104491,-1309,0,0,5565,0,0,,5565,5565
37,09-12-18,73,18:00,18:15,64.75,,0,64.75,64.75,1,-77628,37298,114926,-40330,0,0,8580,0,0,,8580,8580
37,09-12-18,74,18:15,18:30,64.75,56.5,0,56.5,56.5,-1,-41125,47424,88549,6299,0,-398,513,0,0,,911,115
37,09-12-18,75,18:30,18:45,,53.78,0,53.78,53.78,-1,-30988,68751,99739,37763,0,-802,0,0,0,,802,-802
37,09-12-18,76,18:45,19:00,,,0,56.21,56.21,0,-27134,60296,87430,33162,0,0,0,0,0,,0,0
37,09-12-18,77,19:00,19:15,,54.56,0,54.56,54.56,-1,-44018,44593,88611,575,0,-798,0,0,0,,798,-798
37,09-12-18,78,19:15,19:30,64.09,,0,64.09,64.09,1,-50583,17193,67776,-33390,0,0,3627,0,0,,3627,3627
37,09-12-18,79,19:30,19:45,61.25,,0,61.25,61.25,1,-46687,21100,67787,-25587,0,0,3665,0,0,,3665,3665
37,09-12-18,80,19:45,20:00,59.88,,0,59.88,59.88,1,-68722,17693,86415,-51029,0,0,3913,0,0,,3913,3913
37,09-12-18,81,20:00,20:15,61.36,,0,61.36,61.36,1,-37769,29968,67737,-7801,0,0,5875,0,0,,5875,5875
37,09-12-18,82,20:15,20:30,61.34,,0,61.34,61.34,1,-43680,32581,76261,-11099,0,0,6284,0,0,,6284,6284
37,09-12-18,83,20:30,20:45,61.34,51.88,0,51.88,51.88,-1,-25889,39473,65362,13584,0,-5778,415,0,0,,6193,-5363
37,09-12-18,84,20:45,21:00,,44.07,0,44.07,44.07,-1,-11936,31066,43002,19130,0,-8528,0,0,0,,8528,-8528
37,09-12-18,85,21:00,21:15,,44.07,0,44.07,44.07,-1,-27163,52911,80074,25748,0,-12012,0,0,0,,12012,-12012
37,09-12-18,86,21:15,21:30,,,0,56.15,56.15,0,-23320,70720,94040,47400,0,-222,0,0,0,,222,-222
37,09-12-18,87,21:30,21:45,,50.15,0,50.15,50.15,-1,-19349,106276,125625,86927,0,-2009,0,0,0,,2009,-2009
37,09-12-18,88,21:45,22:00,,-26.59,0,-26.59,-26.59,-1,-18874,139267,158141,120393,0,-37449,0,0,0,,37449,-37449
37,09-12-18,89,22:00,22:15,79.13,-120.51,0,79.13,79.13,1,-68127,33166,101293,-34961,0,-37625,3031,0,0,,40656,-34594
37,09-12-18,90,22:15,22:30,59.88,44.07,0,44.07,44.07,-1,-28099,45685,73784,17586,0,-3927,1714,0,0,,5641,-2213
37,09-12-18,91,22:30,22:45,,44.07,0,44.07,44.07,-1,-21363,69682,91045,48319,0,-8112,0,0,0,,8112,-8112
37,09-12-18,92,22:45,23:00,,51.88,0,51.88,51.88,-1,-24680,83929,108609,59249,0,-1775,0,0,0,,1775,-1775
37,09-12-18,93,23:00,23:15,55.88,44.07,0,55.88,55.88,1,-47048,64049,111097,17001,0,-2654,701,0,0,,3355,-1953
37,09-12-18,94,23:15,23:30,59.88,54.98,0,59.88,54.98,2,-35301,38160,73461,2859,0,-300,2292,0,0,,2592,1992
37,09-12-18,95,23:30,23:45,,54.99,0,54.99,54.99,-1,-25556,69315,94871,43759,0,-385,0,0,0,,385,-385
37,09-12-18,96,23:45,0:00,,43.76,0,43.76,43.76,-1,-25089,70178,95267,45089,0,-17787,0,0,0,,17787,-17787
37,09/13/2018,1,0:00,0:15,,47.25,0,47.25,47.25,-1,-26194,76533,102727,50339,0,-14807,0,0,0,,14807,-14807
37,09/13/2018,2,0:15,0:30,,47.25,0,47.25,47.25,-1,-12886,60391,73277,47505,0,-853,0,0,0,,853,-853
37,09/13/2018,3,0:30,0:45,,29.5,0,29.5,29.5,-1,-14114,74795,88909,60681,0,-40984,0,0,0,,40984,-40984
37,09/13/2018,4,0:45,1:00,,44.4,0,44.4,44.4,-1,-15317,82888,98205,67571,0,-60656,0,0,0,,60656,-60656
37,09/13/2018,5,1:00,1:15,59.72,44.4,0,59.72,44.4,2,-42506,28940,71446,-13566,0,-19174,934,0,0,,20108,-18240
37,09/13/2018,6,1:15,1:30,55.25,51.25,0,55.25,51.25,2,-24884,40087,64971,15203,0,-975,122,0,0,,1097,-853
37,09/13/2018,7,1:30,1:45,,53.35,0,53.35,53.35,-1,-33432,57130,90562,23698,0,-648,0,0,0,,648,-648
37,09/13/2018,8,1:45,2:00,,51.25,0,51.25,51.25,-1,-42697,62735,105432,20038,0,-8629,0,0,0,,8629,-8629
37,09/13/2018,9,2:00,2:15,,51.21,0,51.21,51.21,-1,-17754,37768,55522,20014,0,-6727,0,0,0,,6727,-6727
37,09/13/2018,10,2:15,2:30,55.25,51.21,0,55.25,55.25,1,-39812,36217,76029,-3595,0,-41,1324,0,0,,1365,1283
37,09/13/2018,11,2:30,2:45,55.25,,0,55.25,55.25,1,-44799,37052,81851,-7747,0,0,2126,0,0,,2126,2126
37,09/13/2018,12,2:45,3:00,,53.13,0,53.13,53.13,-1,-41008,45601,86609,4593,0,-78,0,0,0,,78,-78
37,09/13/2018,13,3:00,3:15,,51.9,0,51.9,51.9,-1,-35840,38426,74266,2586,0,-1444,0,0,0,,1444,-1444
37,09/13/2018,14,3:15,3:30,,51.25,0,51.25,51.25,-1,-35356,43761,79117,8405,0,-1951,0,0,0,,1951,-1951
37,09/13/2018,15,3:30,3:45,,51.25,0,51.25,51.25,-1,-31832,43585,75417,11753,0,-4616,0,0,0,,4616,-4616
37,09/13/2018,16,3:45,4:00,,51.03,0,51.03,51.03,-1,-23296,45919,69215,22623,0,-6672,0,0,0,,6672,-6672
37,09/13/2018,17,4:00,4:15,,52.86,0,52.86,52.86,-1,-45032,41377,86409,-3655,0,-3465,0,0,0,,3465,-3465
37,09/13/2018,18,4:15,4:30,,51.25,0,51.25,51.25,-1,-32616,42242,74858,9626,0,-3136,0,0,0,,3136,-3136
37,09/13/2018,19,4:30,4:45,,52.99,0,52.99,52.99,-1,-33682,38207,71889,4525,0,-152,0,0,0,,152,-152
37,09/13/2018,20,4:45,5:00,,51.25,0,51.25,51.25,-1,-39373,54101,93474,14728,0,-778,0,0,0,,778,-778
37,09/13/2018,21,5:00,5:15,,40.43,0,40.43,40.43,-1,-41537,85504,127041,43967,0,-23726,0,0,0,,23726,-23726
37,09/13/2018,22,5:15,5:30,54.8,46.78,0,54.8,54.8,1,-56811,58581,115392,1770,0,-27759,5,0,0,,27764,-27754
37,09/13/2018,23,5:30,5:45,55.25,46.78,0,55.25,55.25,1,-60925,39047,99972,-21878,0,-765,286,0,0,,1051,-479
37,09/13/2018,24,5:45,6:00,55.04,47.25,0,55.04,47.25,2,-36894,33835,70729,-3059,0,-275,1301,0,0,,1576,1026
37,09/13/2018,25,6:00,6:15,55.04,27.78,0,27.78,27.78,-1,-57317,93834,151151,36517,0,-21216,4,0,0,,21220,-21212
37,09/13/2018,26,6:15,6:30,,54.36,0,54.36,54.36,-1,-42891,52876,95767,9985,0,-1690,0,0,0,,1690,-1690
37,09/13/2018,27,6:30,6:45,61.78,,0,61.78,61.78,1,-69764,51959,121723,-17805,0,0,1505,0,0,,1505,1505
37,09/13/2018,28,6:45,7:00,156.02,,0,156.02,156.02,1,-102605,22195,124800,-80410,0,0,50398,0,0,,50398,50398
37,09/13/2018,29,7:00,7:15,156.02,48.8,0,48.8,48.8,-1,-46340,98441,144781,52101,0,-1879,24292,0,0,,26171,22413
37,09/13/2018,30,7:15,7:30,,,0,56.42,56.42,0,-35616,75248,110864,39632,0,0,0,0,0,,0,0
37,09/13/2018,31,7:30,7:45,,,0,54.5,54.5,0,-52602,82646,135248,30044,0,0,0,0,0,,0,0
37,09/13/2018,32,7:45,8:00,58.78,,0,58.78,58.78,1,-86920,86495,173415,-425,0,0,426,0,0,,426,426
37,09/13/2018,33,8:00,8:15,54.78,,0,54.78,54.78,1,-47588,38123,85711,-9465,0,0,927,0,0,,927,927
37,09/13/2018,34,8:15,8:30,59.52,,0,59.52,59.52,1,-47596,37066,84662,-10530,0,0,7230,0,0,,7230,7230
37,09/13/2018,35,8:30,8:45,140.02,,0,140.02,140.02,1,-114869,36142,151011,-78727,0,0,18676,0,0,,18676,18676
37,09/13/2018,36,8:45,9:00,65.75,,0,65.75,65.75,1,-108310,42953,151263,-65357,0,0,32096,0,0,,32096,32096
37,09/13/2018,37,9:00,9:15,63.01,,0,63.01,63.01,1,-106653,60463,167116,-46190,0,0,25009,0,0,,25009,25009
37,09/13/2018,38,9:15,9:30,59.01,,0,59.01,59.01,1,-86540,71977,158517,-14563,0,0,13876,0,0,,13876,13876
37,09/13/2018,39,9:30,9:45,,,0,54.54,54.54,0,-59578,80346,139924,20768,0,0,293,0,0,,293,293
37,09/13/2018,40,9:45,10:00,,51.23,0,51.23,51.23,-1,-45742,94012,139754,48270,0,-360,0,0,0,,360,-360
37,09/13/2018,41,10:00,10:15,,50.78,0,50.78,50.78,-1,-13301,79855,93156,66554,0,-216,0,0,0,,216,-216
37,09/13/2018,42,10:15,10:30,,14.04,0,14.04,14.04,-1,-11574,106263,117837,94689,0,-10476,0,0,0,,10476,-10476
37,09/13/2018,43,10:30,10:45,,-9.96,0,-9.96,-9.96,-1,-20555,101042,121597,80487,0,-39392,0,0,0,,39392,-39392
37,09/13/2018,44,10:45,11:00,,26.38,0,26.38,26.38,-1,-31832,116588,148420,84756,0,-60539,0,0,0,,60539,-60539
37,09/13/2018,45,11:00,11:15,58.78,26.38,0,58.78,58.78,1,-89054,32909,121963,-56145,0,-17099,321,0,0,,17420,-16778
37,09/13/2018,46,11:15,11:30,58.78,,0,58.78,58.78,1,-63910,61758,125668,-2152,0,0,1699,0,0,,1699,1699
37,09/13/2018,47,11:30,11:45,,50.78,0,50.78,50.78,-1,-53783,81446,135229,27663,0,-233,0,0,0,,233,-233
37,09/13/2018,48,11:45,12:00,,46.78,0,46.78,46.78,-1,-42722,99971,142693,57249,0,-5307,0,0,0,,5307,-5307
37,09/13/2018,49,12:00,12:15,60.07,50.78,0,60.07,50.78,2,-69218,53410,122628,-15808,0,-3563,3216,0,0,,6779,-347
37,09/13/2018,50,12:15,12:30,54.78,42.82,0,42.82,42.82,-1,-57851,88239,146090,30388,0,-2635,577,0,0,,3212,-2058
37,09/13/2018,51,12:30,12:45,,28.03,0,28.03,28.03,-1,-60632,110579,171211,49947,0,-30706,0,0,0,,30706,-30706
37,09/13/2018,52,12:45,13:00,,28.03,0,28.03,28.03,-1,-62533,125320,187853,62787,0,-35390,0,0,0,,35390,-35390
37,09/13/2018,53,13:00,13:15,,28.03,0,28.03,28.03,-1,-63249,88545,151794,25296,0,-40902,0,0,0,,40902,-40902
37,09/13/2018,54,13:15,13:30,,42.82,0,42.82,42.82,-1,-61578,99336,160914,37758,0,-18721,0,0,0,,18721,-18721
37,09/13/2018,55,13:30,13:45,,46.78,0,46.78,46.78,-1,-61970,89510,151480,27540,0,-24566,0,0,0,,24566,-24566
37,09/13/2018,56,13:45,14:00,,49.03,0,49.03,49.03,-1,-78971,82479,161450,3508,0,-18363,0,0,0,,18363,-18363
37,09/13/2018,57,14:00,14:15,58.59,49.03,0,58.59,58.59,1,-90981,93583,184564,2602,0,-1164,1317,0,0,,2481,153
37,09/13/2018,58,14:15,14:30,58.55,,0,58.55,58.55,1,-88290,82884,171174,-5406,0,0,2219,0,0,,2219,2219
37,09/13/2018,59,14:30,14:45,54.78,,0,54.78,54.78,1,-85701,84163,169864,-1538,0,0,3252,0,0,,3252,3252
37,09/13/2018,60,14:45,15:00,54.78,,0,54.78,54.78,1,-90319,80334,170653,-9985,0,0,868,0,0,,868,868
37,09/13/2018,61,15:00,15:15,58.78,,0,58.78,58.78,1,-93808,93180,186988,-628,0,0,3071,0,0,,3071,3071
37,09/13/2018,62,15:15,15:30,63.01,,0,63.01,63.01,1,-102167,82155,184322,-20012,0,0,6153,0,0,,6153,6153
37,09/13/2018,63,15:30,15:45,63.01,,0,63.01,63.01,1,-102756,64653,167409,-38103,0,0,22610,0,0,,22610,22610
37,09/13/2018,64,15:45,16:00,63.01,,0,63.01,63.01,1,-101544,57260,158804,-44284,0,0,34805,0,0,,34805,34805
37,09/13/2018,65,16:00,16:15,59.02,51.25,0,51.25,51.25,-1,-66497,120626,187123,54129,0,-827,15176,0,0,,16003,14349
37,09/13/2018,66,16:15,16:30,,,0,54.54,54.54,0,-69468,88221,157689,18753,0,-77,0,0,0,,77,-77
37,09/13/2018,67,16:30,16:45,,,0,54.5,54.5,0,-64129,78724,142853,14595,0,0,0,0,0,,0,0
37,09/13/2018,68,16:45,17:00,59.77,,0,59.77,59.77,1,-72700,53558,126258,-19142,0,0,8224,0,0,,8224,8224
37,09/13/2018,69,17:00,17:15,,,0,54.55,54.55,0,-42801,89948,132749,47147,0,0,2355,0,0,,2355,2355
37,09/13/2018,70,17:15,17:30,,,0,54.53,54.53,0,-45898,62873,108771,16975,0,0,0,0,0,,0,0
37,09/13/2018,71,17:30,17:45,54.78,,0,54.78,54.78,1,-56116,62122,118238,6006,0,0,28,0,0,,28,28
37,09/13/2018,72,17:45,18:00,58.78,,0,58.78,58.78,1,-66559,56410,122969,-10149,0,0,2275,0,0,,2275,2275
37,09/13/2018,73,18:00,18:15,54.78,36.61,0,54.78,36.61,2,-61578,27362,88940,-34216,0,-5102,186,0,0,,5288,-4916
37,09/13/2018,74,18:15,18:30,78.03,54.28,0,78.03,78.03,1,-67306,34369,101675,-32937,0,-215,5706,0,0,,5921,5491
37,09/13/2018,75,18:30,18:45,78.03,,0,78.03,78.03,1,-63586,36798,100384,-26788,0,0,24296,0,0,,24296,24296
37,09/13/2018,76,18:45,19:00,63.01,,0,63.01,63.01,1,-69542,34768,104310,-34774,0,0,27624,0,0,,27624,27624
37,09/13/2018,77,19:00,19:15,395.02,,0,395.02,395.02,1,-99501,24206,123707,-75295,0,0,54381,0,0,,54381,54381
37,09/13/2018,78,19:15,19:30,71.02,,0,71.02,71.02,1,-66836,46846,113682,-19990,0,0,29800,0,0,,29800,29800
37,09/13/2018,79,19:30,19:45,58.99,,0,58.99,58.99,1,-59928,41905,101833,-18023,0,0,8083,0,0,,8083,8083
37,09/13/2018,80,19:45,20:00,63.01,,0,63.01,63.01,1,-84841,35480,120321,-49361,0,0,26576,0,0,,26576,26576
37,09/13/2018,81,20:00,20:15,61.45,,0,61.45,61.45,1,-65253,63490,128743,-1763,0,0,17822,0,0,,17822,17822
37,09/13/2018,82,20:15,20:30,85,,0,85,85,1,-110923,18088,129011,-92835,0,0,11795,0,0,,11795,11795
37,09/13/2018,83,20:30,20:45,59.55,,0,59.55,59.55,1,-112365,29283,141648,-83082,0,0,14821,0,0,,14821,14821
37,09/13/2018,84,20:45,21:00,58.78,,0,58.78,58.78,1,-120392,24638,145030,-95754,0,0,2188,0,0,,2188,2188
37,09/13/2018,85,21:00,21:15,395.02,,0,395.02,395.02,1,-53931,19883,73814,-34048,0,0,22894,0,0,,22894,22894
37,09/13/2018,86,21:15,21:30,63.01,41.84,0,41.84,41.84,-1,-25637,50687,76324,25050,0,-3486,10537,0,0,,14023,7051
37,09/13/2018,87,21:30,21:45,,42.82,0,42.82,42.82,-1,-24564,75387,99951,50823,0,-28866,0,0,0,,28866,-28866
37,09/13/2018,88,21:45,22:00,,31.1,0,31.1,31.1,-1,-24482,97695,122177,73213,0,-63675,0,0,0,,63675,-63675
37,09/13/2018,89,22:00,22:15,,42.82,0,42.82,42.82,-1,-42148,45971,88119,3823,0,-27669,0,0,0,,27669,-27669
37,09/13/2018,90,22:15,22:30,,42.82,0,42.82,42.82,-1,-41339,70122,111461,28783,0,-6688,0,0,0,,6688,-6688
37,09/13/2018,91,22:30,22:45,,42.82,0,42.82,42.82,-1,-28379,82723,111102,54344,0,-28982,0,0,0,,28982,-28982
37,09/13/2018,92,22:45,23:00,,24.8,0,24.8,24.8,-1,-23803,120742,144545,96939,0,-43526,0,0,0,,43526,-43526
37,09/13/2018,93,23:00,23:15,140.02,42.82,0,140.02,140.02,1,-75182,27645,102827,-47537,0,-22426,8623,0,0,,31049,-13803
37,09/13/2018,94,23:15,23:30,63.01,,0,63.01,63.01,1,-38847,44027,82874,5180,0,0,10432,0,0,,10432,10432
37,09/13/2018,95,23:30,23:45,,50.78,0,50.78,50.78,-1,-34243,55856,90099,21613,0,-2115,0,0,0,,2115,-2115
37,09/13/2018,96,23:45,0:00,,46.78,0,46.78,46.78,-1,-25471,58439,83910,32968,0,-14566,0,0,0,,14566,-14566
37,09/14/2018,1,0:00,0:15,57.19,49.78,0,57.19,49.78,2,-61096,61389,122485,293,0,-9237,883,0,0,,10120,-8354
37,09/14/2018,2,0:15,0:30,57.78,49.78,0,57.78,57.78,1,-52909,41180,94089,-11729,0,-23,1808,0,0,,1831,1785
37,09/14/2018,3,0:30,0:45,60.63,,0,60.63,60.63,1,-79776,63545,143321,-16231,0,0,4528,0,0,,4528,4528
37,09/14/2018,4,0:45,1:00,60.63,51.36,0,51.36,51.36,-1,-69791,91226,161017,21435,0,-2394,213,0,0,,2607,-2181
37,09/14/2018,5,1:00,1:15,62.02,51.36,0,62.02,62.02,1,-56693,23831,80524,-32862,0,-61,7264,0,0,,7325,7203
37,09/14/2018,6,1:15,1:30,57.28,,0,57.28,57.28,1,-40366,38090,78456,-2276,0,0,3663,0,0,,3663,3663
37,09/14/2018,7,1:30,1:45,,,0,53.13,53.13,0,-38163,57483,95646,19320,0,0,0,0,0,,0,0
37,09/14/2018,8,1:45,2:00,,45.78,0,45.78,45.78,-1,-32413,62698,95111,30285,0,-9162,0,0,0,,9162,-9162
37,09/14/2018,9,2:00,2:15,63.25,42.88,0,63.25,63.25,1,-53798,33700,87498,-20098,0,-14111,3532,0,0,,17643,-10579
37,09/14/2018,10,2:15,2:30,62.12,42.88,0,62.12,62.12,1,-44364,35153,79517,-9211,0,-99,7359,0,0,,7458,7260
37,09/14/2018,11,2:30,2:45,,,0,53.03,53.03,0,-36636,38852,75488,2216,0,0,1,0,0,,1,1
37,09/14/2018,12,2:45,3:00,,48.44,0,48.44,48.44,-1,-33867,47546,81413,13679,0,-4608,0,0,0,,4608,-4608
37,09/14/2018,13,3:00,3:15,,52.23,0,52.23,52.23,-1,-58848,37824,96672,-21024,0,-1877,0,0,0,,1877,-1877
37,09/14/2018,14,3:15,3:30,,52.23,0,52.23,52.23,-1,-53280,41468,94748,-11812,0,-14,0,0,0,,14,-14
37,09/14/2018,15,3:30,3:45,,52.24,0,52.24,52.24,-1,-46693,54264,100957,7571,0,-1671,0,0,0,,1671,-1671
37,09/14/2018,16,3:45,4:00,,46.02,0,46.02,46.02,-1,-46024,66211,112235,20187,0,-7901,0,0,0,,7901,-7901
37,09/14/2018,17,4:00,4:15,,52.3,0,52.3,52.3,-1,-51977,49189,101166,-2788,0,-2773,0,0,0,,2773,-2773
37,09/14/2018,18,4:15,4:30,,49.78,0,49.78,49.78,-1,-46594,55310,101904,8716,0,-2136,0,0,0,,2136,-2136
37,09/14/2018,19,4:30,4:45,,52.3,0,52.3,52.3,-1,-45265,44894,90159,-371,0,-318,0,0,0,,318,-318
37,09/14/2018,20,4:45,5:00,,52.3,0,52.3,52.3,-1,-44645,36850,81495,-7795,0,-1600,0,0,0,,1600,-1600
37,09/14/2018,21,5:00,5:15,,45.78,0,45.78,45.78,-1,-73791,63127,136918,-10664,0,-2000,0,0,0,,2000,-2000
37,09/14/2018,22,5:15,5:30,,37.85,0,37.85,37.85,-1,-53936,93371,147307,39435,0,-35186,0,0,0,,35186,-35186
37,09/14/2018,23,5:30,5:45,,45.78,0,45.78,45.78,-1,-46614,65962,112576,19348,0,-31238,0,0,0,,31238,-31238
37,09/14/2018,24,5:45,6:00,,,0,53.1,53.1,0,-42925,69365,112290,26440,0,-4082,0,0,0,,4082,-4082
37,09/14/2018,25,6:00,6:15,,8.92,0,8.92,8.92,-1,-45920,127915,173835,81995,0,-34863,0,0,0,,34863,-34863
37,09/14/2018,26,6:15,6:30,,44.47,0,44.47,44.47,-1,-34375,90186,124561,55811,0,-36810,0,0,0,,36810,-36810
37,09/14/2018,27,6:30,6:45,57.89,51.78,0,57.89,57.89,1,-68651,79441,148092,10790,0,-9703,663,0,0,,10366,-9040
37,09/14/2018,28,6:45,7:00,58.78,50.22,0,50.22,50.22,-1,-82091,90418,172509,8327,0,-79,1285,0,0,,1364,1206
37,09/14/2018,29,7:00,7:15,,-87.9,0,-87.9,-87.9,-1,-31340,162585,193925,131245,0,-38435,0,0,0,,38435,-38435
37,09/14/2018,30,7:15,7:30,,50.32,0,50.32,50.32,-1,-45360,124138,169498,78778,0,-10180,0,0,0,,10180,-10180
37,09/14/2018,31,7:30,7:45,,53.28,0,53.28,53.28,-1,-36052,111040,147092,74988,0,-322,0,0,0,,322,-322
37,09/14/2018,32,7:45,8:00,,,0,53.36,53.36,0,-68756,108130,176886,39374,0,0,0,0,0,,0,0
37,09/14/2018,33,8:00,8:15,,53.38,0,53.38,53.38,-1,-29697,128943,158640,99246,0,-669,0,0,0,,669,-669
37,09/14/2018,34,8:15,8:30,,51.78,0,51.78,51.78,-1,-28977,113190,142167,84213,0,-230,0,0,0,,230,-230
37,09/14/2018,35,8:30,8:45,,45.47,0,45.47,45.47,-1,-24298,102649,126947,78351,0,-7221,0,0,0,,7221,-7221
37,09/14/2018,36,8:45,9:00,,52.27,0,52.27,52.27,-1,-30254,97754,128008,67500,0,-3520,0,0,0,,3520,-3520
37,09/14/2018,37,9:00,9:15,,53.31,0,53.31,53.31,-1,-49774,71711,121485,21937,0,-572,0,0,0,,572,-572
37,09/14/2018,38,9:15,9:30,,53.26,0,53.26,53.26,-1,-42243,68021,110264,25778,0,-58,0,0,0,,58,-58
37,09/14/2018,39,9:30,9:45,,49.47,0,49.47,49.47,-1,-40857,92696,133553,51839,0,-4559,0,0,0,,4559,-4559
37,09/14/2018,40,9:45,10:00,,34.11,0,34.11,34.11,-1,-44541,105623,150164,61082,0,-32856,0,0,0,,32856,-32856
37,09/14/2018,41,10:00,10:15,,50.78,0,50.78,50.78,-1,-82043,78569,160612,-3474,0,-12386,0,0,0,,12386,-12386
37,09/14/2018,42,10:15,10:30,,49.47,0,49.47,49.47,-1,-67133,93410,160543,26277,0,-2721,0,0,0,,2721,-2721
37,09/14/2018,43,10:30,10:45,61.7,49.47,0,61.7,49.47,2,-104426,76274,180700,-28152,0,-10045,334,0,0,,10379,-9711
37,09/14/2018,44,10:45,11:00,77.45,49.47,0,277.45,277.45,1,-204483,99274,303757,-105209,0,-496,16475,0,2873,,19844,18852
37,09/14/2018,45,11:00,11:15,57.47,,0,275.96,275.96,1,-227127,129885,357012,-97242,0,0,4325,0,22414,,26739,26739
37,09/14/2018,46,11:15,11:30,,,0,54.74,54.74,0,-224849,157819,382668,-67030,0,0,0,0,8483,,8483,8483
37,09/14/2018,47,11:30,11:45,,,0,54.74,54.74,0,-217786,166312,384098,-51474,0,0,0,0,0,,0,0
37,09/14/2018,48,11:45,12:00,53.47,,0,53.47,53.47,1,-218726,162595,381321,-56131,0,0,1145,0,0,,1145,1145
37,09/14/2018,49,12:00,12:15,53.47,41.66,0,41.66,41.66,-1,-59835,148129,207964,88294,0,-5660,175,0,0,,5835,-5485
37,09/14/2018,50,12:15,12:30,,33.89,0,33.89,33.89,-1,-54010,154015,208025,100005,0,-25533,0,0,0,,25533,-25533
37,09/14/2018,51,12:30,12:45,,30.07,0,30.07,30.07,-1,-73451,149696,223147,76245,0,-59723,0,0,0,,59723,-59723
37,09/14/2018,52,12:45,13:00,,26.72,0,26.72,26.72,-1,-95803,194497,290300,98694,0,-53650,0,0,0,,53650,-53650
37,09/14/2018,53,13:00,13:15,,-3.77,0,-3.77,-3.77,-1,-59725,89544,149269,29819,0,-44286,0,0,0,,44286,-44286
37,09/14/2018,54,13:15,13:30,53.47,-3.77,0,53.47,53.47,1,-81725,85227,166952,3502,0,-598,803,0,0,,1401,205
37,09/14/2018,55,13:30,13:45,53.47,50,0,50,50,-1,-57462,88404,145866,30942,0,-4452,9,0,0,,4461,-4443
37,09/14/2018,56,13:45,14:00,,51.25,0,51.25,51.25,-1,-61366,83534,144900,22168,0,-12703,0,0,0,,12703,-12703
37,09/14/2018,57,14:00,14:15,,51.17,0,51.17,51.17,-1,-65817,106667,172484,40850,0,-8866,0,0,0,,8866,-8866
37,09/14/2018,58,14:15,14:30,,,0,53.06,53.06,0,-61906,69478,131384,7572,0,-1183,0,0,0,,1183,-1183
37,09/14/2018,59,14:30,14:45,,49.47,0,49.47,49.47,-1,-42158,90291,132449,48133,0,-3613,0,0,0,,3613,-3613
37,09/14/2018,60,14:45,15:00,,49.02,0,49.02,49.02,-1,-40882,108981,149863,68099,0,-21138,0,0,0,,21138,-21138
37,09/14/2018,61,15:00,15:15,53.47,51.5,0,53.47,53.47,1,-67914,48256,116170,-19658,0,-10021,272,0,0,,10293,-9749
37,09/14/2018,62,15:15,15:30,53.47,51.5,0,53.47,53.47,1,-114496,51255,165751,-63241,0,-63,1991,0,0,,2054,1928
37,09/14/2018,63,15:30,15:45,50.12,,0,50.12,50.12,1,-75178,61243,136421,-13935,0,0,380,0,0,,380,380
37,09/14/2018,64,15:45,16:00,,52.67,0,52.67,52.67,-1,-64636,62963,127599,-1673,0,-7,0,0,0,,7,-7
37,09/14/2018,65,16:00,16:15,,52.69,0,52.69,52.69,-1,-98342,83886,182228,-14456,0,-304,0,0,0,,304,-304
37,09/14/2018,66,16:15,16:30,,52.69,0,52.69,52.69,-1,-73421,82442,155863,9021,0,-1033,0,0,0,,1033,-1033
37,09/14/2018,67,16:30,16:45,,51.78,0,51.78,51.78,-1,-86110,88172,174282,2062,0,-1653,0,0,0,,1653,-1653
37,09/14/2018,68,16:45,17:00,,,0,53.06,53.06,0,-107115,99958,207073,-7157,0,0,0,0,0,,0,0
37,09/14/2018,69,17:00,17:15,,,0,54.06,54.06,0,-102338,106252,208590,3914,0,0,0,0,0,,0,0
37,09/14/2018,70,17:15,17:30,,,0,53.06,53.06,0,-81356,73198,154554,-8158,0,0,0,0,0,,0,0
37,09/14/2018,71,17:30,17:45,57.47,,0,57.47,57.47,1,-84104,69923,154027,-14181,0,0,1448,0,0,,1448,1448
37,09/14/2018,72,17:45,18:00,57.47,,0,57.47,57.47,1,-98324,71721,170045,-26603,0,0,4780,0,0,,4780,4780
37,09/14/2018,73,18:00,18:15,56.12,,0,56.12,56.12,1,-114815,46137,160952,-68678,0,0,5431,0,0,,5431,5431
37,09/14/2018,74,18:15,18:30,53.47,,0,53.47,53.47,1,-93080,53183,146263,-39897,0,0,811,0,0,,811,811
37,09/14/2018,75,18:30,18:45,,,0,54.74,54.74,0,-89576,62732,152308,-26844,0,0,0,0,0,,0,0
37,09/14/2018,76,18:45,19:00,57.99,,0,57.99,57.99,1,-85805,77422,163227,-8383,0,0,1913,0,0,,1913,1913
37,09/14/2018,77,19:00,19:15,58.06,,0,58.06,58.06,1,-75047,57513,132560,-17534,0,0,2102,0,0,,2102,2102
37,09/14/2018,78,19:15,19:30,,,0,54.74,54.74,0,-74248,53237,127485,-21011,0,0,0,0,0,,0,0
37,09/14/2018,79,19:30,19:45,,,0,54.74,54.74,0,-86351,35822,122173,-50529,0,0,0,0,0,,0,0
37,09/14/2018,80,19:45,20:00,59.46,,0,59.46,59.46,1,-112093,24168,136261,-87925,0,0,1971,0,0,,1971,1971
37,09/14/2018,81,20:00,20:15,57.47,,0,57.47,57.47,1,-54602,25557,80159,-29045,0,0,4008,0,0,,4008,4008
37,09/14/2018,82,20:15,20:30,76.72,,0,76.72,76.72,1,-84570,18772,103342,-65798,0,0,9063,0,0,,9063,9063
37,09/14/2018,83,20:30,20:45,,,0,54.74,54.74,0,-65744,27810,93554,-37934,0,0,919,0,0,,919,919
37,09/14/2018,84,20:45,21:00,,52,0,52,52,-1,-50200,50248,100448,48,0,-514,0,0,0,,514,-514
37,09/14/2018,85,21:00,21:15,76.72,49.47,0,76.72,49.47,2,-61510,68509,130019,6999,0,-1243,5395,0,0,,6638,4152
37,09/14/2018,86,21:15,21:30,58.34,49.47,0,49.47,49.47,-1,-38783,81328,120111,42545,0,-690,7102,0,0,,7792,6412
37,09/14/2018,87,21:30,21:45,,49.78,0,49.78,49.78,-1,-23879,102037,125916,78158,0,-2688,0,0,0,,2688,-2688
37,09/14/2018,88,21:45,22:00,,44.85,0,44.85,44.85,-1,-19706,117515,137221,97809,0,-22129,0,0,0,,22129,-22129
37,09/14/2018,89,22:00,22:15,,49.54,0,49.54,49.54,-1,-66183,57278,123461,-8905,0,-18021,0,0,0,,18021,-18021
37,09/14/2018,90,22:15,22:30,53.47,50,0,54.74,50,2,-47111,61824,108935,14713,0,-1017,228,0,0,,1245,-789
37,09/14/2018,91,22:30,22:45,,49.92,0,49.92,49.92,-1,-36988,68780,105768,31792,0,-4357,0,0,0,,4357,-4357
37,09/14/2018,92,22:45,23:00,,41.66,0,41.66,41.66,-1,-29729,81512,111241,51783,0,-13499,0,0,0,,13499,-13499
37,09/14/2018,93,23:00,23:15,,31.78,0,31.78,31.78,-1,-74828,115603,190431,40775,0,-22703,0,0,0,,22703,-22703
37,09/14/2018,94,23:15,23:30,,,0,51.06,51.06,0,-83937,92699,176636,8762,0,-417,0,0,0,,417,-417
37,09/14/2018,95,23:30,23:45,55.64,,0,55.64,55.64,1,-130395,102255,232650,-28140,0,0,2390,0,0,,2390,2390
37,09/14/2018,96,23:45,0:00,61.7,,0,61.7,61.7,1,-152320,73281,225601,-79039,0,0,9121,0,0,,9121,9121
38,09/15/2018,1,0:00,0:15,57.47,,0,57.47,57.47,1,-108208,111174,219382,2966,0,0,6229,0,0,,6229,6229
38,09/15/2018,2,0:15,0:30,61.7,,0,61.7,61.7,1,-95347,70294,165641,-25053,0,0,16158,0,0,,16158,16158
38,09/15/2018,3,0:30,0:45,61.7,,0,61.7,61.7,1,-82836,63807,146643,-19029,0,0,23931,0,0,,23931,23931
38,09/15/2018,4,0:45,1:00,61.7,,0,61.7,61.7,1,-97718,56678,154396,-41040,0,0,21855,0,0,,21855,21855
38,09/15/2018,5,1:00,1:15,55.58,49.32,0,49.32,49.32,-1,-59179,80066,139245,20887,0,-12,12918,0,0,,12930,12906
38,09/15/2018,6,1:15,1:30,53.47,49.42,0,53.47,45.25,2,-75247,58013,133260,-17234,0,-73,1280,0,0,,1353,1207
38,09/15/2018,7,1:30,1:45,51.43,,0,51.43,51.43,1,-61748,49250,110998,-12498,0,0,3327,0,0,,3327,3327
38,09/15/2018,8,1:45,2:00,50.49,49.47,0,49.47,49.47,-1,-43176,48129,91305,4953,0,-159,2477,0,0,,2636,2318
38,09/15/2018,9,2:00,2:15,51.41,49.4,0,51.41,45.25,2,-50359,47252,97611,-3107,0,-580,805,0,0,,1385,225
38,09/15/2018,10,2:15,2:30,51.48,,0,51.48,51.48,1,-46596,51857,98453,5261,0,0,699,0,0,,699,699
38,09/15/2018,11,2:30,2:45,,41.64,0,41.64,41.64,-1,-34776,61649,96425,26873,0,-6628,0,0,0,,6628,-6628
38,09/15/2018,12,2:45,3:00,,41.64,0,41.64,41.64,-1,-30907,57918,88825,27011,0,-26513,0,0,0,,26513,-26513
38,09/15/2018,13,3:00,3:15,,41.64,0,41.64,41.64,-1,-23917,67718,91635,43801,0,-23945,0,0,0,,23945,-23945
38,09/15/2018,14,3:15,3:30,,,0,45.25,45.25,0,-55234,74341,129575,19107,0,-1960,0,0,0,,1960,-1960
38,09/15/2018,15,3:30,3:45,,45.83,0,45.83,45.83,-1,-33519,67852,101371,34333,0,-1691,0,0,0,,1691,-1691
38,09/15/2018,16,3:45,4:00,,41.64,0,41.64,41.64,-1,-34693,79294,113987,44601,0,-8331,0,0,0,,8331,-8331
38,09/15/2018,17,4:00,4:15,50.42,45.47,0,50.42,50.42,1,-42954,51757,94711,8803,0,-8693,12,0,0,,8705,-8681
38,09/15/2018,18,4:15,4:30,51.32,45.47,0,51.32,51.32,1,-49423,41471,90894,-7952,0,-44,330,0,0,,374,286
38,09/15/2018,19,4:30,4:45,44.02,,0,44.02,44.02,1,-53441,53327,106768,-114,0,0,162,0,0,,162,162
38,09/15/2018,20,4:45,5:00,,47.66,0,47.66,47.66,-1,-50064,60115,110179,10051,0,-410,0,0,0,,410,-410
38,09/15/2018,21,5:00,5:15,,42.3,0,42.3,42.3,-1,-41616,54453,96069,12837,0,-9293,0,0,0,,9293,-9293
38,09/15/2018,22,5:15,5:30,,48.9,0,48.9,48.9,-1,-55566,43917,99483,-11649,0,-7014,0,0,0,,7014,-7014
38,09/15/2018,23,5:30,5:45,41.02,48.9,0,41.02,41.02,1,-77133,36377,113510,-40756,0,-143,3,0,0,,146,-140
38,09/15/2018,24,5:45,6:00,56.75,,0,56.75,56.75,1,-80278,19139,99417,-61139,0,0,5997,0,0,,5997,5997
38,09/15/2018,25,6:00,6:15,,,0,45.08,45.08,0,-71194,55847,127041,-15347,0,0,633,0,0,,633,633
38,09/15/2018,26,6:15,6:30,51.67,,0,51.67,51.67,1,-84180,38332,122512,-45848,0,0,993,0,0,,993,993
38,09/15/2018,27,6:30,6:45,141.02,,0,141.02,141.02,1,-117371,18166,135537,-99205,0,0,26649,0,0,,26649,26649
38,09/15/2018,28,6:45,7:00,141.02,,0,141.02,141.02,1,-98850,21546,120396,-77304,0,0,66250,0,0,,66250,66250
38,09/15/2018,29,7:00,7:15,141.02,40.38,0,40.38,40.38,-1,-39240,72503,111743,33263,0,-3375,13171,0,0,,16546,9796
38,09/15/2018,30,7:15,7:30,,47.67,0,47.67,47.67,-1,-61958,51197,113155,-10761,0,-3872,0,0,0,,3872,-3872
38,09/15/2018,31,7:30,7:45,,,0,45.09,45.09,0,-66805,38229,105034,-28576,0,0,0,0,0,,0,0
38,09/15/2018,32,7:45,8:00,55.67,,0,55.67,55.67,1,-72233,35289,107522,-36944,0,0,6496,0,0,,6496,6496
38,09/15/2018,33,8:00,8:15,141.02,,0,141.02,141.02,1,-163194,18545,181739,-144649,0,0,39965,0,0,,39965,39965
38,09/15/2018,34,8:15,8:30,74.91,,0,74.91,74.91,1,-90802,18941,109743,-71861,0,0,47986,0,0,,47986,47986
38,09/15/2018,35,8:30,8:45,142.02,,0,142.02,142.02,1,-111299,24952,136251,-86347,0,0,52100,0,0,,52100,52100
38,09/15/2018,36,8:45,9:00,78.02,,0,78.02,78.02,1,-114903,45069,159972,-69834,0,0,49246,0,0,,49246,49246
38,09/15/2018,37,9:00,9:15,59.89,,0,59.89,59.89,1,-92892,45851,138743,-47041,0,0,30325,0,0,,30325,30325
38,09/15/2018,38,9:15,9:30,74.91,,0,74.91,74.91,1,-89111,36411,125522,-52700,0,0,37126,0,0,,37126,37126
38,09/15/2018,39,9:30,9:45,51.67,43.67,0,51.67,43.67,2,-61228,58614,119842,-2614,0,-497,11328,0,0,,11825,10831
38,09/15/2018,40,9:45,10:00,,,0,46.48,46.48,0,-65104,52009,117113,-13095,0,0,0,0,0,,0,0
38,09/15/2018,41,10:00,10:15,59.89,,0,59.89,59.89,1,-75998,41433,117431,-34565,0,0,8651,0,0,,8651,8651
38,09/15/2018,42,10:15,10:30,51.67,,0,51.67,51.67,1,-74187,64379,138566,-9808,0,0,2369,0,0,,2369,2369
38,09/15/2018,43,10:30,10:45,,,0,47.02,47.02,0,-74133,74231,148364,98,0,0,379,0,0,,379,379
38,09/15/2018,44,10:45,11:00,54.13,50.04,0,54.13,46.53,2,-74342,71481,145823,-2861,0,-246,17,0,0,,263,-229
38,09/15/2018,45,11:00,11:15,143.02,,0,143.02,143.02,1,-162069,24464,186533,-137605,0,0,34569,0,0,,34569,34569
38,09/15/2018,46,11:15,11:30,143.02,,0,143.02,143.02,1,-130005,34291,164296,-95714,0,0,68657,0,0,,68657,68657
38,09/15/2018,47,11:30,11:45,58.4,,0,58.4,58.4,1,-106118,54697,160815,-51421,0,0,24363,0,0,,24363,24363
38,09/15/2018,48,11:45,12:00,59.89,,0,59.89,59.89,1,-100801,56265,157066,-44536,0,0,9532,0,0,,9532,9532
38,09/15/2018,49,12:00,12:15,74.91,,0,74.91,74.91,1,-94340,37254,131594,-57086,0,0,37244,0,0,,37244,37244
38,09/15/2018,50,12:15,12:30,57.7,48.08,0,48.08,48.08,-1,-60770,64116,124886,3346,0,-267,19528,0,0,,19795,19261
38,09/15/2018,51,12:30,12:45,57.7,47.67,0,47.67,47.67,-1,-40972,69170,110142,28198,0,-271,84,0,0,,355,-187
38,09/15/2018,52,12:45,13:00,,,0,46.53,46.53,0,-54204,69228,123432,15024,0,0,0,0,0,,0,0
38,09/15/2018,53,13:00,13:15,,,0,46.54,46.54,0,-31105,67719,98824,36614,0,0,0,0,0,,0,0
38,09/15/2018,54,13:15,13:30,,47.19,0,47.19,47.19,-1,-38838,95905,134743,57067,0,-796,0,0,0,,796,-796
38,09/15/2018,55,13:30,13:45,,44.11,0,44.11,44.11,-1,-44953,94746,139699,49793,0,-4225,0,0,0,,4225,-4225
38,09/15/2018,56,13:45,14:00,,47.67,0,47.67,47.67,-1,-51342,100601,151943,49259,0,-3314,0,0,0,,3314,-3314
38,09/15/2018,57,14:00,14:15,,43.67,0,43.67,43.67,-1,-51826,112846,164672,61020,0,-1689,0,0,0,,1689,-1689
38,09/15/2018,58,14:15,14:30,,,0,46.53,46.53,0,-59085,83314,142399,24229,0,0,0,0,0,,0,0
38,09/15/2018,59,14:30,14:45,,47.67,0,47.67,47.67,-1,-62247,95290,157537,33043,0,-585,0,0,0,,585,-585
38,09/15/2018,60,14:45,15:00,,43.67,0,43.67,43.67,-1,-64282,107163,171445,42881,0,-2767,0,0,0,,2767,-2767
38,09/15/2018,61,15:00,15:15,,49.68,0,49.68,49.68,-1,-48735,121728,170463,72993,0,-1505,0,0,0,,1505,-1505
38,09/15/2018,62,15:15,15:30,,,0,45.85,45.85,0,-59143,105558,164701,46415,0,0,0,0,0,,0,0
38,09/15/2018,63,15:30,15:45,,49.68,0,49.68,49.68,-1,-57353,86340,143693,28987,0,-1,0,0,0,,1,-1
38,09/15/2018,64,15:45,16:00,,49.66,0,49.66,49.66,-1,-47427,86929,134356,39502,0,-124,0,0,0,,124,-124
38,09/15/2018,65,16:00,16:15,,39.83,0,39.83,39.83,-1,-23444,111110,134554,87666,0,-4958,0,0,0,,4958,-4958
38,09/15/2018,66,16:15,16:30,,32.31,0,32.31,32.31,-1,-51569,110781,162350,59212,0,-23796,0,0,0,,23796,-23796
38,09/15/2018,67,16:30,16:45,,44.92,0,44.92,44.92,-1,-90372,91673,182045,1301,0,-18361,0,0,0,,18361,-18361
38,09/15/2018,68,16:45,17:00,143.02,44.92,0,143.02,143.02,1,-141002,63476,204478,-77526,0,-1394,20250,0,0,,21644,18856
38,09/15/2018,69,17:00,17:15,55.4,24.91,0,24.91,24.91,-1,-19242,160242,179484,141000,0,-9146,6649,0,0,,15795,-2497
38,09/15/2018,70,17:15,17:30,,6.96,0,6.96,6.96,-1,-36668,126349,163017,89681,0,-53925,0,0,0,,53925,-53925
38,09/15/2018,71,17:30,17:45,50.02,39.83,0,50.02,50.02,1,-75124,84323,159447,9199,0,-23878,61,0,0,,23939,-23817
38,09/15/2018,72,17:45,18:00,55.67,39.83,0,55.67,55.67,1,-99160,73472,172632,-25688,0,-102,2435,0,0,,2537,2333
38,09/15/2018,73,18:00,18:15,51.67,43.67,0,51.67,43.67,2,-46789,58137,104926,11348,0,-1899,1741,0,0,,3640,-158
38,09/15/2018,74,18:15,18:30,59.89,50.04,0,59.89,59.89,1,-84472,52689,137161,-31783,0,-677,2591,0,0,,3268,1914
38,09/15/2018,75,18:30,18:45,74.91,,0,74.91,74.91,1,-99004,46002,145006,-53002,0,0,34653,0,0,,34653,34653
38,09/15/2018,76,18:45,19:00,74.91,,0,74.91,74.91,1,-91948,43930,135878,-48018,0,0,44214,0,0,,44214,44214
38,09/15/2018,77,19:00,19:15,59.89,,0,59.89,59.89,1,-100237,32698,132935,-67539,0,0,34839,0,0,,34839,34839
38,09/15/2018,78,19:15,19:30,57.36,,0,57.36,57.36,1,-52556,23264,75820,-29292,0,0,19944,0,0,,19944,19944
38,09/15/2018,79,19:30,19:45,74.91,,0,74.91,74.91,1,-64006,26462,90468,-37544,0,0,5207,0,0,,5207,5207
38,09/15/2018,80,19:45,20:00,144.02,,0,144.02,144.02,1,-93692,16571,110263,-77121,0,0,55140,0,0,,55140,55140
38,09/15/2018,81,20:00,20:15,59.89,,0,59.89,59.89,1,-61930,21972,83902,-39958,0,0,31757,0,0,,31757,31757
38,09/15/2018,82,20:15,20:30,144.02,,0,144.02,144.02,1,-115703,18520,134223,-97183,0,0,54467,0,0,,54467,54467
38,09/15/2018,83,20:30,20:45,144.02,,0,144.02,144.02,1,-97461,19469,116930,-77992,0,0,73714,0,0,,73714,73714
38,09/15/2018,84,20:45,21:00,55.2,,0,55.2,55.2,1,-68830,34853,103683,-33977,0,0,19182,0,0,,19182,19182
38,09/15/2018,85,21:00,21:15,107.02,,0,107.02,107.02,1,-69268,21155,90423,-48113,0,0,10596,0,0,,10596,10596
38,09/15/2018,86,21:15,21:30,58.04,,0,58.04,58.04,1,-67316,30179,97495,-37137,0,0,17640,0,0,,17640,17640
38,09/15/2018,87,21:30,21:45,51.67,,0,51.67,51.67,1,-54522,44101,98623,-10421,0,0,7119,0,0,,7119,7119
38,09/15/2018,88,21:45,22:00,,49.28,0,49.28,49.28,-1,-55042,50405,105447,-4637,0,-332,0,0,0,,332,-332
38,09/15/2018,89,22:00,22:15,155.02,,0,155.02,155.02,1,-148301,14278,162579,-134023,0,0,16927,0,0,,16927,16927
38,09/15/2018,90,22:15,22:30,74.91,,0,74.91,74.91,1,-121471,21923,143394,-99548,0,0,48254,0,0,,48254,48254
38,09/15/2018,91,22:30,22:45,74.91,,0,74.91,74.91,1,-109460,32411,141871,-77049,0,0,25273,0,0,,25273,25273
38,09/15/2018,92,22:45,23:00,59.89,,0,59.89,59.89,1,-96709,44619,141328,-52090,0,0,23726,0,0,,23726,23726
38,09/15/2018,93,23:00,23:15,152.02,,0,152.02,152.02,1,-179633,13151,192784,-166482,0,0,25084,0,0,,25084,25084
38,09/15/2018,94,23:15,23:30,152.02,,0,152.02,152.02,1,-144263,20093,164356,-124170,0,0,50683,0,0,,50683,50683
38,09/15/2018,95,23:30,23:45,51.67,,0,51.67,51.67,1,-132027,39735,171762,-92292,0,0,7134,0,0,,7134,7134
38,09/15/2018,96,23:45,0:00,51.67,,0,51.67,51.67,1,-122707,61720,184427,-60987,0,0,193,0,0,,193,193
38,09/16/2018,1,0:00,0:15,51.65,,0,51.65,51.65,1,-146806,102565,249371,-44241,0,0,72,0,0,,72,72
38,09/16/2018,2,0:15,0:30,158.12,,0,158.12,158.12,1,-152248,24307,176555,-127941,0,0,36231,0,0,,36231,36231
38,09/16/2018,3,0:30,0:45,51.65,,0,51.65,51.65,1,-145044,41632,186676,-103412,0,0,21378,0,0,,21378,21378
38,09/16/2018,4,0:45,1:00,74.89,,0,74.89,74.89,1,-180711,36068,216779,-144643,0,0,6698,0,0,,6698,6698
38,09/16/2018,5,1:00,1:15,143.12,,0,143.12,143.12,1,-181257,33473,214730,-147784,0,0,15674,0,0,,15674,15674
38,09/16/2018,6,1:15,1:30,143.12,,0,143.12,143.12,1,-207849,16798,224647,-191051,0,0,82463,0,0,,82463,82463
38,09/16/2018,7,1:30,1:45,250.02,,0,250.02,250.02,1,-211802,58375,270177,-153427,0,0,78118,3750,0,,81868,81868
38,09/16/2018,8,1:45,2:00,250.02,,0,250.02,250.02,1,-184568,124422,308990,-60146,0,0,12139,5000,0,,17139,17139
38,09/16/2018,9,2:00,2:15,59.87,,0,59.87,59.87,1,-57223,69739,126962,12516,0,0,1843,0,0,,1843,1843
38,09/16/2018,10,2:15,2:30,51.65,,0,51.65,51.65,1,-64908,61717,126625,-3191,0,0,1049,0,0,,1049,1049
38,09/16/2018,11,2:30,2:45,58.09,,0,58.09,58.09,1,-71763,63254,135017,-8509,0,0,3087,0,0,,3087,3087
38,09/16/2018,12,2:45,3:00,58.09,40.27,0,40.27,40.27,-1,-60144,69673,129817,9529,0,-699,364,0,0,,1063,-335
38,09/16/2018,13,3:00,3:15,,47.65,0,47.65,47.65,-1,-53415,51342,104757,-2073,0,-269,0,0,0,,269,-269
38,09/16/2018,14,3:15,3:30,,,0,45.39,45.39,0,-59089,76345,135434,17256,0,0,0,0,0,,0,0
38,09/16/2018,15,3:30,3:45,,47.65,0,47.65,47.65,-1,-54618,79725,134343,25107,0,-23,0,0,0,,23,-23
38,09/16/2018,16,3:45,4:00,,40.15,0,40.15,40.15,-1,-46471,93070,139541,46599,0,-2395,0,0,0,,2395,-2395
38,09/16/2018,17,4:00,4:15,104.89,40.15,0,104.89,104.89,1,-105609,54054,159663,-51555,0,-42,14443,0,0,,14485,14401
38,09/16/2018,18,4:15,4:30,73.12,,0,73.12,73.12,1,-95989,68487,164476,-27502,0,0,23973,0,0,,23973,23973
38,09/16/2018,19,4:30,4:45,43.12,43.65,0,43.65,43.65,-1,-85807,71895,157702,-13912,0,-5,4729,0,0,,4734,4724
38,09/16/2018,20,4:45,5:00,53.81,,0,53.81,53.81,1,-84794,86074,170868,1280,0,0,1356,0,0,,1356,1356
38,09/16/2018,21,5:00,5:15,47.12,,0,47.12,47.12,1,-73288,92551,165839,19263,0,0,157,0,0,,157,157
38,09/16/2018,22,5:15,5:30,,47.65,0,47.65,47.65,-1,-75585,91838,167423,16253,0,-52,0,0,0,,52,-52
38,09/16/2018,23,5:30,5:45,,43.65,0,43.65,43.65,-1,-72058,90019,162077,17961,0,-270,0,0,0,,270,-270
38,09/16/2018,24,5:45,6:00,,47.65,0,47.65,47.65,-1,-80212,92301,172513,12089,0,-8,0,0,0,,8,-8
38,09/16/2018,25,6:00,6:15,,25.21,0,25.21,25.21,-1,-41322,99874,141196,58552,0,-10001,0,0,0,,10001,-10001
38,09/16/2018,26,6:15,6:30,,34.78,0,34.78,34.78,-1,-44328,101274,145602,56946,0,-31361,0,0,0,,31361,-31361
38,09/16/2018,27,6:30,6:45,,39.37,0,39.37,39.37,-1,-44704,94294,138998,49590,0,-25640,0,0,0,,25640,-25640
38,09/16/2018,28,6:45,7:00,,40.11,0,40.11,40.11,-1,-44744,102666,147410,57922,0,-7383,0,0,0,,7383,-7383
38,09/16/2018,29,7:00,7:15,,5.78,0,5.78,5.78,-1,-27917,97786,125703,69869,0,-31690,0,0,0,,31690,-31690
38,09/16/2018,30,7:15,7:30,,40.11,0,40.11,40.11,-1,-32417,56362,88779,23945,0,-19626,0,0,0,,19626,-19626
38,09/16/2018,31,7:30,7:45,,43.97,0,43.97,43.97,-1,-32896,54707,87603,21811,0,-723,0,0,0,,723,-723
38,09/16/2018,32,7:45,8:00,,,0,48.09,48.09,0,-45745,63046,108791,17301,0,0,0,0,0,,0,0
38,09/16/2018,33,8:00,8:15,,47.97,0,47.97,47.97,-1,-37382,54642,92024,17260,0,-68,0,0,0,,68,-68
38,09/16/2018,34,8:15,8:30,,40.11,0,40.11,40.11,-1,-31631,49725,81356,18094,0,-6988,0,0,0,,6988,-6988
38,09/16/2018,35,8:30,8:45,,47.97,0,47.97,47.97,-1,-56777,52037,108814,-4740,0,-1154,0,0,0,,1154,-1154
38,09/16/2018,36,8:45,9:00,54.95,,0,54.95,54.95,1,-65312,52086,117398,-13226,0,0,673,0,0,,673,673
38,09/16/2018,37,9:00,9:15,,43.97,0,43.97,43.97,-1,-44538,77247,121785,32709,0,-746,0,0,0,,746,-746
38,09/16/2018,38,9:15,9:30,,,0,48.09,48.09,0,-49739,76937,126676,27198,0,0,0,0,0,,0,0
38,09/16/2018,39,9:30,9:45,,40.11,0,40.11,40.11,-1,-57710,91191,148901,33481,0,-2204,0,0,0,,2204,-2204
38,09/16/2018,40,9:45,10:00,,47.97,0,47.97,47.97,-1,-56435,75479,131914,19044,0,-650,0,0,0,,650,-650
38,09/16/2018,41,10:00,10:15,53.84,,0,53.84,53.84,1,-66455,57385,123840,-9070,0,0,1498,0,0,,1498,1498
38,09/16/2018,42,10:15,10:30,53.84,,0,53.84,53.84,1,-69261,55103,124364,-14158,0,0,1280,0,0,,1280,1280
38,09/16/2018,43,10:30,10:45,,,0,48.09,48.09,0,-63821,51985,115806,-11836,0,0,0,0,0,,0,0
38,09/16/2018,44,10:45,11:00,51.97,,0,51.97,51.97,1,-53391,48596,101987,-4795,0,0,71,0,0,,71,71
38,09/16/2018,45,11:00,11:15,59.24,,0,59.24,59.24,1,-99657,29394,129051,-70263,0,0,6364,0,0,,6364,6364
38,09/16/2018,46,11:15,11:30,51.97,,0,51.97,51.97,1,-76575,45287,121862,-31288,0,0,1231,0,0,,1231,1231
38,09/16/2018,47,11:30,11:45,60.19,,0,60.19,60.19,1,-108542,34888,143430,-73654,0,0,6802,0,0,,6802,6802
38,09/16/2018,48,11:45,12:00,51.97,,0,51.97,51.97,1,-70449,56297,126746,-14152,0,0,2653,0,0,,2653,2653
38,09/16/2018,49,12:00,12:15,166.21,,0,166.21,166.21,1,-126147,37953,164100,-88194,0,0,32198,0,0,,32198,32198
38,09/16/2018,50,12:15,12:30,60.19,41.58,0,41.58,41.58,-1,-78459,78830,157289,371,0,-11,22621,0,0,,22632,22610
38,09/16/2018,51,12:30,12:45,60.19,41.58,0,41.58,41.58,-1,-54242,69309,123551,15067,0,-98,106,0,0,,204,8
38,09/16/2018,52,12:45,13:00,51.97,,0,51.97,51.97,1,-49502,60160,109662,10658,0,0,378,0,0,,378,378
38,09/16/2018,53,13:00,13:15,51.97,,0,51.97,51.97,1,-52691,85472,138163,32781,0,0,141,0,0,,141,141
38,09/16/2018,54,13:15,13:30,,25.21,0,25.21,25.21,-1,-49233,90796,140029,41563,0,-2829,0,0,0,,2829,-2829
38,09/16/2018,55,13:30,13:45,,-8.21,0,-8.21,-8.21,-1,-45284,72601,117885,27317,0,-26718,0,0,0,,26718,-26718
38,09/16/2018,56,13:45,14:00,,37.61,0,37.61,37.61,-1,-37469,61482,98951,24013,0,-13475,0,0,0,,13475,-13475
38,09/16/2018,57,14:00,14:15,,-150.21,0,-150.21,-150.21,-1,-43131,116695,159826,73564,0,-30609,0,0,0,,30609,-30609
38,09/16/2018,58,14:15,14:30,,25.21,0,25.21,25.21,-1,-25694,94607,120301,68913,0,-20941,0,0,0,,20941,-20941
38,09/16/2018,59,14:30,14:45,,40.11,0,40.11,40.11,-1,-31056,97793,128849,66737,0,-26708,0,0,0,,26708,-26708
38,09/16/2018,60,14:45,15:00,,39.42,0,39.42,39.42,-1,-28216,90818,119034,62602,0,-21349,0,0,0,,21349,-21349
38,09/16/2018,61,15:00,15:15,,,0,45.04,45.04,0,-38572,62506,101078,23934,0,-2051,0,0,0,,2051,-2051
38,09/16/2018,62,15:15,15:30,,,0,45.06,45.06,0,-39716,82191,121907,42475,0,0,0,0,0,,0,0
38,09/16/2018,63,15:30,15:45,51.97,,0,51.97,51.97,1,-53588,72763,126351,19175,0,0,3,0,0,,3,3
38,09/16/2018,64,15:45,16:00,51.97,,0,51.97,51.97,1,-66337,62487,128824,-3850,0,0,409,0,0,,409,409
38,09/16/2018,65,16:00,16:15,60.19,,0,60.19,60.19,1,-75750,40960,116710,-34790,0,0,10992,0,0,,10992,10992
38,09/16/2018,66,16:15,16:30,75.21,,0,75.21,75.21,1,-64888,28888,93776,-36000,0,0,7962,0,0,,7962,7962
38,09/16/2018,67,16:30,16:45,94.21,,0,94.21,94.21,1,-74665,37777,112442,-36888,0,0,32490,0,0,,32490,32490
38,09/16/2018,68,16:45,17:00,55.97,,0,55.97,55.97,1,-98403,55610,154013,-42793,0,0,21253,0,0,,21253,21253
38,09/16/2018,69,17:00,17:15,60.19,,0,60.19,60.19,1,-41271,54656,95927,13385,0,0,19059,0,0,,19059,19059
38,09/16/2018,70,17:15,17:30,53.72,41.32,0,53.72,41.32,2,-43627,54242,97869,10615,0,-912,2178,0,0,,3090,1266
38,09/16/2018,71,17:30,17:45,54.56,,0,54.56,54.56,1,-40207,30686,70893,-9521,0,0,1832,0,0,,1832,1832
38,09/16/2018,72,17:45,18:00,350.21,,0,350.21,350.21,1,-73414,20804,94218,-52610,0,0,31048,0,0,,31048,31048
38,09/16/2018,73,18:00,18:15,350.21,,0,350.21,350.21,1,-203034,49012,252046,-154022,0,0,78273,0,0,,78273,78273
38,09/16/2018,74,18:15,18:30,350.21,41.58,0,41.58,41.58,-1,-65163,64081,129244,-1082,0,-21,29211,0,0,,29232,29190
38,09/16/2018,75,18:30,18:45,55.12,,0,55.12,55.12,1,-51861,52107,103968,246,0,0,214,0,0,,214,214
38,09/16/2018,76,18:45,19:00,55.97,,0,55.97,55.97,1,-62554,63154,125708,600,0,0,1027,0,0,,1027,1027
38,09/16/2018,77,19:00,19:15,55.97,,0,55.97,55.97,1,-49671,61118,110789,11447,0,0,367,0,0,,367,367
38,09/16/2018,78,19:15,19:30,51.97,,0,51.97,51.97,1,-37803,39848,77651,2045,0,0,1049,0,0,,1049,1049
38,09/16/2018,79,19:30,19:45,55.97,,0,55.97,55.97,1,-49159,45814,94973,-3345,0,0,2551,0,0,,2551,2551
38,09/16/2018,80,19:45,20:00,145.21,,0,145.21,145.21,1,-89733,45378,135111,-44355,0,0,14340,0,0,,14340,14340
38,09/16/2018,81,20:00,20:15,350.21,,0,350.21,350.21,1,-150267,41245,191512,-109022,0,0,54783,0,0,,54783,54783
38,09/16/2018,82,20:15,20:30,350.21,,0,350.21,350.21,1,-151190,33456,184646,-117734,0,0,81417,0,0,,81417,81417
38,09/16/2018,83,20:30,20:45,350.21,,0,350.21,350.21,1,-79172,41752,120924,-37420,0,0,56213,0,0,,56213,56213
38,09/16/2018,84,20:45,21:00,58.42,,0,58.42,58.42,1,-70678,63911,134589,-6767,0,0,5780,0,0,,5780,5780
38,09/16/2018,85,21:00,21:15,198.21,,0,198.21,198.21,1,-77694,23923,101617,-53771,0,0,27486,0,0,,27486,27486
38,09/16/2018,86,21:15,21:30,81.56,,0,81.56,81.56,1,-70446,40934,111380,-29512,0,0,36005,0,0,,36005,36005
38,09/16/2018,87,21:30,21:45,60.01,,0,60.01,60.01,1,-76107,60483,136590,-15624,0,0,10755,0,0,,10755,10755
38,09/16/2018,88,21:45,22:00,75.97,,0,75.97,75.97,1,-86485,73145,159630,-13340,0,0,2734,0,0,,2734,2734
38,09/16/2018,89,22:00,22:15,350.21,,0,350.21,350.21,1,-233987,42184,276171,-191803,0,0,44983,0,0,,44983,44983
38,09/16/2018,90,22:15,22:30,350.21,,0,350.21,350.21,1,-160253,47148,207401,-113105,0,0,81940,0,0,,81940,81940
38,09/16/2018,91,22:30,22:45,125.21,,0,125.21,125.21,1,-109561,83284,192845,-26277,0,0,49206,0,0,,49206,49206
38,09/16/2018,92,22:45,23:00,125.21,42.04,0,42.04,42.04,-1,-96721,119255,215976,22534,0,-1545,1297,0,0,,2842,-248
38,09/16/2018,93,23:00,23:15,350.21,42.04,0,350.21,350.21,1,-147064,92101,239165,-54963,0,-8,15339,0,0,,15347,15331
38,09/16/2018,94,23:15,23:30,80.19,,0,80.19,80.19,1,-103765,74412,178177,-29353,0,0,33876,0,0,,33876,33876
38,09/16/2018,95,23:30,23:45,60.22,,0,60.22,60.22,1,-93523,77723,171246,-15800,0,0,9454,0,0,,9454,9454
38,09/16/2018,96,23:45,0:00,95.21,,0,95.21,95.21,1,-111410,56569,167979,-54841,0,0,27089,0,0,,27089,27089
38,09/17/2018,1,0:00,0:15,54.08,42.88,0,54.08,42.88,2,-84197,105987,190184,21790,0,-595,13999,0,0,,14594,13404
38,09/17/2018,2,0:15,0:30,149.02,,0,149.02,149.02,1,-90961,33000,123961,-57961,0,0,29275,0,0,,29275,29275
38,09/17/2018,3,0:30,0:45,60.19,,0,60.19,60.19,1,-58445,39625,98070,-18820,0,0,27570,0,0,,27570,27570
38,09/17/2018,4,0:45,1:00,60.19,40.48,0,40.48,40.48,-1,-65459,65104,130563,-355,0,-2631,1553,0,0,,4184,-1078
38,09/17/2018,5,1:00,1:15,143.02,53.06,0,143.02,143.02,1,-99187,53118,152305,-46069,0,-562,13703,0,0,,14265,13141
38,09/17/2018,6,1:15,1:30,60.19,39.1,0,39.1,39.1,-1,-56431,63898,120329,7467,0,-236,19885,0,0,,20121,19649
38,09/17/2018,7,1:30,1:45,60.19,39.1,0,39.1,39.1,-1,-58712,76057,134769,17345,0,-4172,95,0,0,,4267,-4077
38,09/17/2018,8,1:45,2:00,,46.88,0,46.88,46.88,-1,-55243,64099,119342,8856,0,-5957,0,0,0,,5957,-5957
38,09/17/2018,9,2:00,2:15,143.02,46.88,0,143.02,143.02,1,-105817,51966,157783,-53851,0,-2916,11890,0,0,,14806,8974
38,09/17/2018,10,2:15,2:30,143.02,39.1,0,39.1,39.1,-1,-63890,73401,137291,9511,0,-330,20965,0,0,,21295,20635
38,09/17/2018,11,2:30,2:45,143.02,37.5,0,37.5,37.5,-1,-54990,75300,130290,20310,0,-7539,23,0,0,,7562,-7516
38,09/17/2018,12,2:45,3:00,,39.1,0,39.1,39.1,-1,-59391,75538,134929,16147,0,-14961,0,0,0,,14961,-14961
38,09/17/2018,13,3:00,3:15,,37.38,0,37.38,37.38,-1,-40458,91102,131560,50644,0,-15812,0,0,0,,15812,-15812
38,09/17/2018,14,3:15,3:30,,39.2,0,39.2,39.2,-1,-46849,88525,135374,41676,0,-2079,0,0,0,,2079,-2079
38,09/17/2018,15,3:30,3:45,,37.51,0,37.51,37.51,-1,-50993,88455,139448,37462,0,-19588,0,0,0,,19588,-19588
38,09/17/2018,16,3:45,4:00,,39.1,0,39.1,39.1,-1,-53430,82602,136032,29172,0,-27588,0,0,0,,27588,-27588
38,09/17/2018,17,4:00,4:15,,0.03,0,0.03,0.03,-1,-39800,98739,138539,58939,0,-50490,0,0,0,,50490,-50490
38,09/17/2018,18,4:15,4:30,,34.18,0,34.18,34.18,-1,-46081,90952,137033,44871,0,-43829,0,0,0,,43829,-43829
38,09/17/2018,19,4:30,4:45,,8.03,0,8.03,8.03,-1,-33884,103325,137209,69441,0,-63100,0,0,0,,63100,-63100
38,09/17/2018,20,4:45,5:00,,25.21,0,25.21,25.21,-1,-42479,86474,128953,43995,0,-51598,0,0,0,,51598,-51598
38,09/17/2018,21,5:00,5:15,43.02,36.44,0,47.5,36.44,2,-51607,72075,123682,20468,0,-6774,38,0,0,,6812,-6736
38,09/17/2018,22,5:15,5:30,,-47.36,0,-47.36,-47.36,-1,-31521,63493,95014,31972,0,-18686,0,0,0,,18686,-18686
38,09/17/2018,23,5:30,5:45,,,0,47,47,0,-54241,81342,135583,27101,0,-650,0,0,0,,650,-650
38,09/17/2018,24,5:45,6:00,,39.5,0,39.5,39.5,-1,-39611,149435,189046,109824,0,-1793,0,0,0,,1793,-1793
38,09/17/2018,25,6:00,6:15,,39.26,0,39.26,39.26,-1,-31366,62287,93653,30921,0,-3949,0,0,0,,3949,-3949
38,09/17/2018,26,6:15,6:30,,39.26,0,39.26,39.26,-1,-43989,67599,111588,23610,0,-5714,0,0,0,,5714,-5714
38,09/17/2018,27,6:30,6:45,52.14,39.26,0,52.14,52.14,1,-68403,70006,138409,1603,0,-22,191,0,0,,213,169
38,09/17/2018,28,6:45,7:00,125.38,,0,125.38,125.38,1,-98781,67750,166531,-31031,0,0,23782,0,0,,23782,23782
38,09/17/2018,29,7:00,7:15,52.14,47.09,0,52.14,47.09,2,-17331,130450,147781,113119,0,-577,6509,0,0,,7086,5932
38,09/17/2018,30,7:15,7:30,,,0,51.28,51.28,0,-34311,131583,165894,97272,0,0,0,0,0,,0,0
38,09/17/2018,31,7:30,7:45,,47.04,0,47.04,47.04,-1,-42482,79660,122142,37178,0,-2255,0,0,0,,2255,-2255
38,09/17/2018,32,7:45,8:00,,49.93,0,49.93,49.93,-1,-57915,47951,105866,-9964,0,-1075,0,0,0,,1075,-1075
38,09/17/2018,33,8:00,8:15,,,0,49.78,49.78,0,-68689,65542,134231,-3147,0,0,0,0,0,,0,0
38,09/17/2018,34,8:15,8:30,,50.04,0,50.04,50.04,-1,-63043,57320,120363,-5723,0,-71,0,0,0,,71,-71
38,09/17/2018,35,8:30,8:45,,,0,51.62,51.62,0,-74735,43394,118129,-31341,0,0,0,0,0,,0,0
38,09/17/2018,36,8:45,9:00,,,0,51.62,51.62,0,-98212,29459,127671,-68753,0,0,0,0,0,,0,0
38,09/17/2018,37,9:00,9:15,,,0,51.62,51.62,0,-77987,68271,146258,-9716,0,0,0,0,0,,0,0
38,09/17/2018,38,9:15,9:30,,55.22,0,55.22,55.22,-1,-78642,68136,146778,-10506,0,-2,0,0,0,,2,-2
38,09/17/2018,39,9:30,9:45,,50.07,0,50.07,50.07,-1,-73141,69045,142186,-4096,0,-571,0,0,0,,571,-571
38,09/17/2018,40,9:45,10:00,,,0,51.62,51.62,0,-78723,57571,136294,-21152,0,0,0,0,0,,0,0
38,09/17/2018,41,10:00,10:15,54.38,,0,54.38,54.38,1,-85449,44924,130373,-40525,0,0,1033,0,0,,1033,1033
38,09/17/2018,42,10:15,10:30,75.38,,0,75.38,75.38,1,-95837,49952,145789,-45885,0,0,13767,0,0,,13767,13767
38,09/17/2018,43,10:30,10:45,148.02,,0,148.02,148.02,1,-151765,60579,212344,-91186,0,0,27735,0,0,,27735,27735
38,09/17/2018,44,10:45,11:00,56.76,,0,56.76,56.76,1,-123714,86153,209867,-37561,0,0,22217,0,0,,22217,22217
38,09/17/2018,45,11:00,11:15,53.91,,0,53.91,53.91,1,-148068,106083,254151,-41985,0,0,5196,0,0,,5196,5196
38,09/17/2018,46,11:15,11:30,53.91,,0,53.91,53.91,1,-137701,107278,244979,-30423,0,0,1782,0,0,,1782,1782
38,09/17/2018,47,11:30,11:45,48.02,,0,48.02,48.02,1,-144956,113729,258685,-31227,0,0,121,0,0,,121,121
38,09/17/2018,48,11:45,12:00,56.14,,0,56.14,56.14,1,-147092,103275,250367,-43817,0,0,2617,0,0,,2617,2617
38,09/17/2018,49,12:00,12:15,,,0,51.62,51.62,0,-91923,90683,182606,-1240,0,0,209,0,0,,209,209
38,09/17/2018,50,12:15,12:30,,49.16,0,49.16,49.16,-1,-90964,94884,185848,3920,0,-433,0,0,0,,433,-433
38,09/17/2018,51,12:30,12:45,,43.65,0,43.65,43.65,-1,-77386,105635,183021,28249,0,-10547,0,0,0,,10547,-10547
38,09/17/2018,52,12:45,13:00,,46.22,0,46.22,46.22,-1,-76481,119853,196334,43372,0,-22319,0,0,0,,22319,-22319
38,09/17/2018,53,13:00,13:15,,46.99,0,46.99,46.99,-1,-105399,114016,219415,8617,0,-17327,0,0,0,,17327,-17327
38,09/17/2018,54,13:15,13:30,,48.35,0,48.35,48.35,-1,-108532,113296,221828,4764,0,-2034,0,0,0,,2034,-2034
38,09/17/2018,55,13:30,13:45,,48.2,0,48.2,48.2,-1,-105571,114562,220133,8991,0,-4538,0,0,0,,4538,-4538
38,09/17/2018,56,13:45,14:00,,48.68,0,48.68,48.68,-1,-111770,119322,231092,7552,0,-3282,0,0,0,,3282,-3282
38,09/17/2018,57,14:00,14:15,,46.99,0,46.99,46.99,-1,-70932,114848,185780,43916,0,-10683,0,0,0,,10683,-10683
38,09/17/2018,58,14:15,14:30,,49.84,0,49.84,49.84,-1,-72291,108975,181266,36684,0,-6742,0,0,0,,6742,-6742
38,09/17/2018,59,14:30,14:45,,42.99,0,42.99,42.99,-1,-57919,113233,171152,55314,0,-10592,0,0,0,,10592,-10592
38,09/17/2018,60,14:45,15:00,,42.99,0,42.99,42.99,-1,-58479,102289,160768,43810,0,-26992,0,0,0,,26992,-26992
38,09/17/2018,61,15:00,15:15,,39.22,0,39.22,39.22,-1,-56165,123165,179330,67000,0,-31635,0,0,0,,31635,-31635
38,09/17/2018,62,15:15,15:30,,42.99,0,42.99,42.99,-1,-55070,107104,162174,52034,0,-39845,0,0,0,,39845,-39845
38,09/17/2018,63,15:30,15:45,,55.22,0,55.22,55.22,-1,-63676,84806,148482,21130,0,-8485,0,0,0,,8485,-8485
38,09/17/2018,64,15:45,16:00,53.85,,0,53.85,53.85,1,-71370,82709,154079,11339,0,0,16,0,0,,16,16
38,09/17/2018,65,16:00,16:15,,50.07,0,50.07,50.07,-1,-59694,106982,166676,47288,0,-272,0,0,0,,272,-272
38,09/17/2018,66,16:15,16:30,,,0,51.62,51.62,0,-75743,83392,159135,7649,0,0,0,0,0,,0,0
38,09/17/2018,67,16:30,16:45,60.36,,0,60.36,60.36,1,-83782,63815,147597,-19967,0,0,7035,0,0,,7035,7035
38,09/17/2018,68,16:45,17:00,60.36,,0,60.36,60.36,1,-101492,59795,161287,-41697,0,0,24224,0,0,,24224,24224
38,09/17/2018,69,17:00,17:15,54.64,,0,54.64,54.64,1,-78173,73609,151782,-4564,0,0,11275,0,0,,11275,11275
38,09/17/2018,70,17:15,17:30,148.02,,0,148.02,148.02,1,-104219,61954,166173,-42265,0,0,13132,0,0,,13132,13132
38,09/17/2018,71,17:30,17:45,148.02,,0,148.02,148.02,1,-111663,38423,150086,-73240,0,0,40269,0,0,,40269,40269
38,09/17/2018,72,17:45,18:00,148.02,,0,148.02,148.02,1,-95481,34921,130402,-60560,0,0,55474,0,0,,55474,55474
38,09/17/2018,73,18:00,18:15,56.14,,0,56.14,56.14,1,-93727,55115,148842,-38612,0,0,18234,0,0,,18234,18234
38,09/17/2018,74,18:15,18:30,60.36,,0,60.36,60.36,1,-93335,49125,142460,-44210,0,0,1258,0,0,,1258,1258
38,09/17/2018,75,18:30,18:45,64.02,,0,64.02,64.02,1,-78180,40547,118727,-37633,0,0,12268,0,0,,12268,12268
38,09/17/2018,76,18:45,19:00,60.56,,0,60.56,60.56,1,-63219,37097,100316,-26122,0,0,27539,0,0,,27539,27539
38,09/17/2018,77,19:00,19:15,69.62,,0,69.62,69.62,1,-67020,27327,94347,-39693,0,0,30882,0,0,,30882,30882
38,09/17/2018,78,19:15,19:30,69.62,,0,69.62,69.62,1,-55811,25073,80884,-30738,0,0,27463,0,0,,27463,27463
38,09/17/2018,79,19:30,19:45,69.62,,0,69.62,69.62,1,-70604,26181,96785,-44423,0,0,36763,0,0,,36763,36763
38,09/17/2018,80,19:45,20:00,69.62,,0,69.62,69.62,1,-64577,15068,79645,-49509,0,0,41308,0,0,,41308,41308
38,09/17/2018,81,20:00,20:15,81.82,,0,81.82,81.82,1,-69008,42749,111757,-26259,0,0,30969,0,0,,30969,30969
38,09/17/2018,82,20:15,20:30,222.02,,0,222.02,222.02,1,-96790,25695,122485,-71095,0,0,57487,0,0,,57487,57487
38,09/17/2018,83,20:30,20:45,381.82,47.13,0,381.82,47.13,2,-46435,37625,84060,-8810,0,-1036,22562,5000,0,,28598,26526
38,09/17/2018,84,20:45,21:00,,42.99,0,42.99,42.99,-1,-7936,67341,75277,59405,0,-20127,0,0,0,,20127,-20127
38,09/17/2018,85,21:00,21:15,350.02,47.03,0,350.02,350.02,1,-146446,20739,167185,-125707,0,-11088,11656,0,0,,22744,568
38,09/17/2018,86,21:15,21:30,350.02,,0,350.02,350.02,1,-78546,21738,100284,-56808,0,0,53504,0,0,,53504,53504
38,09/17/2018,87,21:30,21:45,52.14,49.18,0,52.14,32.61,2,-24526,41795,66321,17269,0,-1163,4482,0,0,,5645,3319
38,09/17/2018,88,21:45,22:00,,39.22,0,39.22,39.22,-1,-19091,79315,98406,60224,0,-18911,0,0,0,,18911,-18911
38,09/17/2018,89,22:00,22:15,134.02,46.22,0,134.02,134.02,1,-125064,12495,137559,-112569,0,-13226,7518,0,0,,20744,-5708
38,09/17/2018,90,22:15,22:30,133.02,46.22,0,133.02,133.02,1,-68346,28304,96650,-40042,0,-15,12549,0,0,,12564,12534
38,09/17/2018,91,22:30,22:45,,44.79,0,44.79,44.79,-1,-24694,41437,66131,16743,0,-2130,0,0,0,,2130,-2130
38,09/17/2018,92,22:45,23:00,,25.38,0,25.38,25.38,-1,-21393,74468,95861,53075,0,-25021,0,0,0,,25021,-25021
38,09/17/2018,93,23:00,23:15,54.14,-57.78,0,54.14,-57.78,2,-92017,153730,245747,61713,0,-28234,278,0,0,,28512,-27956
38,09/17/2018,94,23:15,23:30,54.56,45.89,0,54.56,45.89,2,-80606,80248,160854,-358,0,-1537,610,0,0,,2147,-927
38,09/17/2018,95,23:30,23:45,,21.25,0,21.25,21.25,-1,-44137,120020,164157,75883,0,-23619,0,0,0,,23619,-23619
38,09/17/2018,96,23:45,0:00,,-51.73,0,-51.73,-51.73,-1,-61007,122871,183878,61864,0,-67490,0,0,0,,67490,-67490
38,09/18/2018,1,0:00,0:15,,25.38,0,25.38,25.38,-1,-59732,143148,202880,83416,0,-33646,0,0,0,,33646,-33646
38,09/18/2018,2,0:15,0:30,,46.99,0,46.99,46.99,-1,-47162,103341,150503,56179,0,-136,0,0,0,,136,-136
38,09/18/2018,3,0:30,0:45,,-24.62,0,-24.62,-24.62,-1,-43860,77428,121288,33568,0,-20981,0,0,0,,20981,-20981
38,09/18/2018,4,0:45,1:00,,42.99,0,42.99,42.99,-1,-91936,101469,193405,9533,0,-17636,0,0,0,,17636,-17636
38,09/18/2018,5,1:00,1:15,,39.46,0,39.46,39.46,-1,-83906,105989,189895,22083,0,-16894,0,0,0,,16894,-16894
38,09/18/2018,6,1:15,1:30,,42.99,0,42.99,42.99,-1,-83595,87423,171018,3828,0,-2669,0,0,0,,2669,-2669
38,09/18/2018,7,1:30,1:45,,36.58,0,36.58,36.58,-1,-65084,90843,155927,25759,0,-14491,0,0,0,,14491,-14491
38,09/18/2018,8,1:45,2:00,,39.57,0,39.57,39.57,-1,-80313,105188,185501,24875,0,-6601,0,0,0,,6601,-6601
38,09/18/2018,9,2:00,2:15,,39.24,0,39.24,39.24,-1,-48457,76143,124600,27686,0,-2749,0,0,0,,2749,-2749
38,09/18/2018,10,2:15,2:30,,,0,45.56,45.56,0,-56260,72440,128700,16180,0,0,0,0,0,,0,0
38,09/18/2018,11,2:30,2:45,,,0,45.56,45.56,0,-62414,66303,128717,3889,0,0,0,0,0,,0,0
38,09/18/2018,12,2:45,3:00,,,0,45.56,45.56,0,-57503,64337,121840,6834,0,0,0,0,0,,0,0
38,09/18/2018,13,3:00,3:15,,,0,45.56,45.56,0,-37796,52674,90470,14878,0,0,0,0,0,,0,0
38,09/18/2018,14,3:15,3:30,,39.22,0,39.22,39.22,-1,-30254,48742,78996,18488,0,-3564,0,0,0,,3564,-3564
38,09/18/2018,15,3:30,3:45,,39.22,0,39.22,39.22,-1,-31090,59034,90124,27944,0,-16911,0,0,0,,16911,-16911
38,09/18/2018,16,3:45,4:00,,39.22,0,39.22,39.22,-1,-28022,61787,89809,33765,0,-25890,0,0,0,,25890,-25890
38,09/18/2018,17,4:00,4:15,,39.22,0,39.22,39.22,-1,-32348,63723,96071,31375,0,-24127,0,0,0,,24127,-24127
38,09/18/2018,18,4:15,4:30,,39.22,0,39.22,39.22,-1,-33998,69506,103504,35508,0,-27767,0,0,0,,27767,-27767
38,09/18/2018,19,4:30,4:45,,39.22,0,39.22,39.22,-1,-35448,66580,102028,31132,0,-19539,0,0,0,,19539,-19539
38,09/18/2018,20,4:45,5:00,,36.41,0,36.41,36.41,-1,-35906,74900,110806,38994,0,-18639,0,0,0,,18639,-18639
38,09/18/2018,21,5:00,5:15,,39.22,0,39.22,39.22,-1,-34907,79553,114460,44646,0,-4986,0,0,0,,4986,-4986
38,09/18/2018,22,5:15,5:30,,39.22,0,39.22,39.22,-1,-41172,63902,105074,22730,0,-5796,0,0,0,,5796,-5796
38,09/18/2018,23,5:30,5:45,56.39,,0,56.39,56.39,1,-42388,49181,91569,6793,0,0,3056,0,0,,3056,3056
38,09/18/2018,24,5:45,6:00,54.99,,0,54.99,54.99,1,-62227,40387,102614,-21840,0,0,331,0,0,,331,331
38,09/18/2018,25,6:00,6:15,,37.58,0,37.58,37.58,-1,-57318,92467,149785,35149,0,-4927,0,0,0,,4927,-4927
38,09/18/2018,26,6:15,6:30,,27.05,0,27.05,27.05,-1,-36727,95287,132014,58560,0,-21686,0,0,0,,21686,-21686
38,09/18/2018,27,6:30,6:45,52.62,27.05,0,52.62,52.62,1,-63463,70025,133488,6562,0,-674,551,0,0,,1225,-123
38,09/18/2018,28,6:45,7:00,56.62,,0,56.62,56.62,1,-73765,101637,175402,27872,0,0,1383,0,0,,1383,1383
38,09/18/2018,29,7:00,7:15,144.12,,0,144.12,144.12,1,-149677,80490,230167,-69187,0,0,22063,0,0,,22063,22063
38,09/18/2018,30,7:15,7:30,52.62,,0,52.62,52.62,1,-77053,69178,146231,-7875,0,0,5177,0,0,,5177,5177
38,09/18/2018,31,7:30,7:45,77.05,,0,77.05,77.05,1,-83284,41502,124786,-41782,0,0,4823,0,0,,4823,4823
38,09/18/2018,32,7:45,8:00,144.12,,0,144.12,144.12,1,-110376,43110,153486,-67266,0,0,48866,0,0,,48866,48866
38,09/18/2018,33,8:00,8:15,57.55,,0,57.55,57.55,1,-67981,58804,126785,-9177,0,0,17844,0,0,,17844,17844
38,09/18/2018,34,8:15,8:30,61.97,,0,61.97,61.97,1,-71980,50092,122072,-21888,0,0,3493,0,0,,3493,3493
38,09/18/2018,35,8:30,8:45,58.95,,0,58.95,58.95,1,-83922,36683,120605,-47239,0,0,17202,0,0,,17202,17202
38,09/18/2018,36,8:45,9:00,77.05,,0,77.05,77.05,1,-109653,31905,141558,-77748,0,0,33959,0,0,,33959,33959
38,09/18/2018,37,9:00,9:15,61.97,,0,61.97,61.97,1,-56842,53445,110287,-3397,0,0,22232,0,0,,22232,22232
38,09/18/2018,38,9:15,9:30,53.81,51.77,0,54.79,51.77,2,-47681,57681,105362,10000,0,-126,1235,0,0,,1361,1109
38,09/18/2018,39,9:30,9:45,53.81,,0,53.81,53.81,1,-48426,85953,134379,37527,0,0,664,0,0,,664,664
38,09/18/2018,40,9:45,10:00,,,0,54.79,54.79,0,-38758,96080,134838,57322,0,0,0,0,0,,0,0
38,09/18/2018,41,10:00,10:15,57.81,,0,57.81,57.81,1,-60748,45744,106492,-15004,0,0,3034,0,0,,3034,3034
38,09/18/2018,42,10:15,10:30,53.81,,0,53.81,53.81,1,-39757,60431,100188,20674,0,0,152,0,0,,152,152
38,09/18/2018,43,10:30,10:45,,45.81,0,45.81,45.81,-1,-40646,85856,126502,45210,0,-171,0,0,0,,171,-171
38,09/18/2018,44,10:45,11:00,,45.81,0,45.81,45.81,-1,-51559,107593,159152,56034,0,-317,0,0,0,,317,-317
38,09/18/2018,45,11:00,11:15,56.65,,0,56.65,56.65,1,-84289,39277,123566,-45012,0,0,960,0,0,,960,960
38,09/18/2018,46,11:15,11:30,,,0,49.4,49.4,0,-73512,55230,128742,-18282,0,0,0,0,0,,0,0
38,09/18/2018,47,11:30,11:45,,49.81,0,49.81,49.81,-1,-68627,72367,140994,3740,0,-17,0,0,0,,17,-17
38,09/18/2018,48,11:45,12:00,,42.18,0,42.18,42.18,-1,-64186,82280,146466,18094,0,-2142,0,0,0,,2142,-2142
38,09/18/2018,49,12:00,12:15,57.81,49.81,0,57.81,49.81,2,-83729,34836,118565,-48893,0,-611,1742,0,0,,2353,1131
38,09/18/2018,50,12:15,12:30,,,0,54.7,54.7,0,-84580,53220,137800,-31360,0,0,582,0,0,,582,582
38,09/18/2018,51,12:30,12:45,,45.81,0,45.81,45.81,-1,-74937,83095,158032,8158,0,-1149,0,0,0,,1149,-1149
38,09/18/2018,52,12:45,13:00,,41.99,0,41.99,41.99,-1,-76888,96326,173214,19438,0,-11993,0,0,0,,11993,-11993
38,09/18/2018,53,13:00,13:15,57.81,45.81,0,57.81,57.81,1,-106093,68317,174410,-37776,0,-7354,250,0,0,,7604,-7104
38,09/18/2018,54,13:15,13:30,53.81,45.81,0,53.81,53.81,1,-113639,92054,205693,-21585,0,-33,273,0,0,,306,240
38,09/18/2018,55,13:30,13:45,,,0,54.68,54.68,0,-105291,85531,190822,-19760,0,0,0,0,0,,0,0
38,09/18/2018,56,13:45,14:00,53.81,,0,53.81,53.81,1,-101711,84699,186410,-17012,0,0,7,0,0,,7,7
38,09/18/2018,57,14:00,14:15,,41.99,0,41.99,41.99,-1,-74574,90131,164705,15557,0,-2240,0,0,0,,2240,-2240
38,09/18/2018,58,14:15,14:30,,41.13,0,41.13,41.13,-1,-74914,86318,161232,11404,0,-16772,0,0,0,,16772,-16772
38,09/18/2018,59,14:30,14:45,53.81,41.13,0,53.81,53.81,1,-98678,65648,164326,-33030,0,-885,306,0,0,,1191,-579
38,09/18/2018,60,14:45,15:00,53.81,,0,53.81,53.81,1,-71557,63283,134840,-8274,0,0,700,0,0,,700,700
38,09/18/2018,61,15:00,15:15,,,0,51.81,51.81,0,-53222,89805,143027,36583,0,0,0,0,0,,0,0
38,09/18/2018,62,15:15,15:30,,,0,51.81,51.81,0,-49823,83519,133342,33696,0,0,0,0,0,,0,0
38,09/18/2018,63,15:30,15:45,,47.78,0,47.78,47.78,-1,-43663,88963,132626,45300,0,-1387,0,0,0,,1387,-1387
38,09/18/2018,64,15:45,16:00,,45.81,0,45.81,45.81,-1,-52724,99144,151868,46420,0,-2441,0,0,0,,2441,-2441
38,09/18/2018,65,16:00,16:15,,-72.55,0,-72.55,-72.55,-1,-77580,111405,188985,33825,0,-23356,0,0,0,,23356,-23356
38,09/18/2018,66,16:15,16:30,53.81,-72.55,0,53.81,53.81,1,-96241,103675,199916,7434,0,-1265,179,0,0,,1444,-1086
38,09/18/2018,67,16:30,16:45,57.81,,0,57.81,57.81,1,-92681,89306,181987,-3375,0,0,2129,0,0,,2129,2129
38,09/18/2018,68,16:45,17:00,61.97,,0,61.97,61.97,1,-83329,67410,150739,-15919,0,0,4724,0,0,,4724,4724
38,09/18/2018,69,17:00,17:15,77.05,,0,77.05,77.05,1,-127837,107610,235447,-20227,0,0,16395,0,0,,16395,16395
38,09/18/2018,70,17:15,17:30,77.05,49.81,0,49.81,49.81,-1,-66317,74252,140569,7935,0,-292,1454,0,0,,1746,1162
38,09/18/2018,71,17:30,17:45,56.83,,0,56.83,56.83,1,-62790,59617,122407,-3173,0,0,231,0,0,,231,231
38,09/18/2018,72,17:45,18:00,57.7,,0,57.7,57.7,1,-72898,64864,137762,-8034,0,0,3104,0,0,,3104,3104
38,09/18/2018,73,18:00,18:15,,,0,52.15,52.15,0,-77051,69157,146208,-7894,0,0,489,0,0,,489,489
38,09/18/2018,74,18:15,18:30,57.81,,0,57.81,57.81,1,-72542,58032,130574,-14510,0,0,1825,0,0,,1825,1825
38,09/18/2018,75,18:30,18:45,156.12,,0,156.12,156.12,1,-83225,46044,129269,-37181,0,0,16624,0,0,,16624,16624
38,09/18/2018,76,18:45,19:00,156.12,,0,156.12,156.12,1,-90300,53747,144047,-36553,0,0,44940,0,0,,44940,44940
38,09/18/2018,77,19:00,19:15,60.96,27.05,0,27.05,27.05,-1,-45649,57972,103621,12323,0,-1425,19945,0,0,,21370,18520
38,09/18/2018,78,19:15,19:30,57.9,27.05,0,57.9,27.05,2,-51616,51402,103018,-214,0,-7058,778,0,0,,7836,-6280
38,09/18/2018,79,19:30,19:45,57.91,,0,57.91,57.91,1,-62837,53815,116652,-9022,0,0,1164,0,0,,1164,1164
38,09/18/2018,80,19:45,20:00,156.12,,0,156.12,156.12,1,-98050,25931,123981,-72119,0,0,20311,0,0,,20311,20311
38,09/18/2018,81,20:00,20:15,74.12,,0,74.12,74.12,1,-67019,45431,112450,-21588,0,0,39138,0,0,,39138,39138
38,09/18/2018,82,20:15,20:30,58.88,,0,58.88,58.88,1,-65472,50702,116174,-14770,0,0,16620,0,0,,16620,16620
38,09/18/2018,83,20:30,20:45,58.88,47.78,0,47.78,47.78,-1,-51039,54704,105743,3665,0,-348,1388,0,0,,1736,1040
38,09/18/2018,84,20:45,21:00,,49.81,0,49.81,49.81,-1,-58369,55520,113889,-2849,0,-166,0,0,0,,166,-166
38,09/18/2018,85,21:00,21:15,,45.81,0,45.81,45.81,-1,-52434,88127,140561,35693,0,-1514,0,0,0,,1514,-1514
38,09/18/2018,86,21:15,21:30,,41.99,0,41.99,41.99,-1,-58958,80151,139109,21193,0,-1703,0,0,0,,1703,-1703
38,09/18/2018,87,21:30,21:45,,41.85,0,41.85,41.85,-1,-81172,94985,176157,13813,0,-2650,0,0,0,,2650,-2650
38,09/18/2018,88,21:45,22:00,,38.84,0,38.84,38.84,-1,-81459,73974,155433,-7485,0,-10249,0,0,0,,10249,-10249
38,09/18/2018,89,22:00,22:15,136.12,45.81,0,136.12,45.81,2,-64353,38912,103265,-25441,0,-556,7783,0,0,,8339,7227
38,09/18/2018,90,22:15,22:30,155.12,41.99,0,155.12,41.99,2,-43579,38113,81692,-5466,0,-23,30441,0,0,,30464,30418
38,09/18/2018,91,22:30,22:45,155.12,41.99,0,41.99,41.99,-1,-51081,97523,148604,46442,0,-351,336,0,0,,687,-15
38,09/18/2018,92,22:45,23:00,,46.78,0,46.78,46.78,-1,-57981,104194,162175,46213,0,-1642,0,0,0,,1642,-1642
38,09/18/2018,93,23:00,23:15,77.05,49.81,0,77.05,77.05,1,-70205,70670,140875,465,0,-846,2743,0,0,,3589,1897
38,09/18/2018,94,23:15,23:30,143.12,,0,143.12,143.12,1,-72706,39859,112565,-32847,0,0,33204,0,0,,33204,33204
38,09/18/2018,95,23:30,23:45,56.84,,0,56.84,56.84,1,-57860,60403,118263,2543,0,0,9029,0,0,,9029,9029
38,09/18/2018,96,23:45,0:00,117.12,,0,117.12,117.12,1,-118511,62702,181213,-55809,0,0,19009,0,0,,19009,19009
38,09/19/2018,1,0:00,0:15,144.02,,0,144.02,144.02,1,-93993,43901,137894,-50092,0,0,43344,0,0,,43344,43344
38,09/19/2018,2,0:15,0:30,144.02,,0,144.02,144.02,1,-98463,21850,120313,-76613,0,0,73086,0,0,,73086,73086
38,09/19/2018,3,0:30,0:45,61.34,,0,61.34,61.34,1,-75377,39935,115312,-35442,0,0,34692,0,0,,34692,34692
38,09/19/2018,4,0:45,1:00,144.02,,0,144.02,144.02,1,-134671,46322,180993,-88349,0,0,52050,0,0,,52050,52050
38,09/19/2018,5,1:00,1:15,133.02,,0,133.02,133.02,1,-85752,50459,136211,-35293,0,0,41257,0,0,,41257,41257
38,09/19/2018,6,1:15,1:30,54.02,,0,54.02,54.02,1,-71617,57114,128731,-14503,0,0,5140,0,0,,5140,5140
38,09/19/2018,7,1:30,1:45,,,0,46.32,46.32,0,-62855,40735,103590,-22120,0,0,57,0,0,,57,57
38,09/19/2018,8,1:45,2:00,47.02,,0,47.02,47.02,1,-62045,36096,98141,-25949,0,0,438,0,0,,438,438
38,09/19/2018,9,2:00,2:15,56.62,,0,56.62,56.62,1,-70246,45114,115360,-25132,0,0,3703,0,0,,3703,3703
38,09/19/2018,10,2:15,2:30,52.62,,0,52.62,52.62,1,-72519,62513,135032,-10006,0,0,3022,0,0,,3022,3022
38,09/19/2018,11,2:30,2:45,51.02,,0,51.02,51.02,1,-64956,56475,121431,-8481,0,0,292,0,0,,292,292
38,09/19/2018,12,2:45,3:00,51.02,,0,51.02,51.02,1,-67758,59810,127568,-7948,0,0,863,0,0,,863,863
38,09/19/2018,13,3:00,3:15,57.83,,0,57.83,57.83,1,-84422,54219,138641,-30203,0,0,5830,0,0,,5830,5830
38,09/19/2018,14,3:15,3:30,52.62,,0,52.62,52.62,1,-68127,54882,123009,-13245,0,0,9753,0,0,,9753,9753
38,09/19/2018,15,3:30,3:45,40.96,,0,40.96,40.96,1,-59966,60596,120562,630,0,0,933,0,0,,933,933
38,09/19/2018,16,3:45,4:00,56.62,,0,56.62,56.62,1,-65391,58416,123807,-6975,0,0,6413,0,0,,6413,6413
38,09/19/2018,17,4:00,4:15,56.62,,0,56.62,56.62,1,-79641,56422,136063,-23219,0,0,1618,0,0,,1618,1618
38,09/19/2018,18,4:15,4:30,56.62,,0,56.62,56.62,1,-78407,52956,131363,-25451,0,0,5261,0,0,,5261,5261
38,09/19/2018,19,4:30,4:45,61.34,,0,61.34,61.34,1,-83335,52001,135336,-31334,0,0,19947,0,0,,19947,19947
38,09/19/2018,20,4:45,5:00,77.05,,0,77.05,77.05,1,-97502,43807,141309,-53695,0,0,44102,0,0,,44102,44102
38,09/19/2018,21,5:00,5:15,77.05,40.86,0,40.86,40.86,-1,-45596,71284,116880,25688,0,-380,16057,0,0,,16437,15677
38,09/19/2018,22,5:15,5:30,,,0,45.82,45.82,0,-55007,65608,120615,10601,0,0,0,0,0,,0,0
38,09/19/2018,23,5:30,5:45,56.53,,0,56.53,56.53,1,-64752,62858,127610,-1894,0,0,1217,0,0,,1217,1217
38,09/19/2018,24,5:45,6:00,,,0,45.82,45.82,0,-68212,115760,183972,47548,0,0,0,0,0,,0,0
38,09/19/2018,25,6:00,6:15,56.02,,0,56.02,56.02,1,-140637,114245,254882,-26392,0,0,349,0,0,,349,349
38,09/19/2018,26,6:15,6:30,56.02,48.02,0,48.02,48.02,-1,-69465,92300,161765,22835,0,-638,52,0,0,,690,-586
38,09/19/2018,27,6:30,6:45,,48.02,0,48.02,48.02,-1,-61231,65616,126847,4385,0,-1515,0,0,0,,1515,-1515
38,09/19/2018,28,6:45,7:00,52.02,,0,52.02,52.02,1,-77617,81928,159545,4311,0,0,381,0,0,,381,381
38,09/19/2018,29,7:00,7:15,57.19,,0,57.19,57.19,1,-98224,73545,171769,-24679,0,0,2644,0,0,,2644,2644
38,09/19/2018,30,7:15,7:30,,,0,47.03,47.03,0,-71003,68783,139786,-2220,0,0,0,0,0,,0,0
38,09/19/2018,31,7:30,7:45,58.16,,0,58.16,58.16,1,-106693,79422,186115,-27271,0,0,1250,0,0,,1250,1250
38,09/19/2018,32,7:45,8:00,144.02,,0,144.02,144.02,1,-127415,79485,206900,-47930,0,0,29315,0,0,,29315,29315
38,09/19/2018,33,8:00,8:15,144.02,45.19,0,45.19,45.19,-1,-68683,66879,135562,-1804,0,-65,8284,0,0,,8349,8219
38,09/19/2018,34,8:15,8:30,57.19,,0,57.19,57.19,1,-61861,51685,113546,-10176,0,0,1066,0,0,,1066,1066
38,09/19/2018,35,8:30,8:45,83,,0,83,83,1,-80653,53458,134111,-27195,0,0,7692,0,0,,7692,7692
38,09/19/2018,36,8:45,9:00,92.02,,0,92.02,92.02,1,-107433,61250,168683,-46183,0,0,34866,0,0,,34866,34866
38,09/19/2018,37,9:00,9:15,61.35,,0,61.35,61.35,1,-80738,62225,142963,-18513,0,0,33728,0,0,,33728,33728
38,09/19/2018,38,9:15,9:30,61.35,39.37,0,39.37,39.37,-1,-59857,70732,130589,10875,0,-3352,5350,0,0,,8702,1998
38,09/19/2018,39,9:30,9:45,,40.49,0,40.49,40.49,-1,-42700,66563,109263,23863,0,-8544,0,0,0,,8544,-8544
38,09/19/2018,40,9:45,10:00,,41.37,0,41.37,41.37,-1,-33989,67427,101416,33438,0,-24670,0,0,0,,24670,-24670
38,09/19/2018,41,10:00,10:15,147.02,41.37,0,147.02,147.02,1,-126284,57124,183408,-69160,0,-5655,17087,0,0,,22742,11432
38,09/19/2018,42,10:15,10:30,58.3,49.19,0,58.3,49.19,2,-72026,78852,150878,6826,0,-262,4691,0,0,,4953,4429
38,09/19/2018,43,10:30,10:45,,45.19,0,45.19,45.19,-1,-68085,78059,146144,9974,0,-1316,0,0,0,,1316,-1316
38,09/19/2018,44,10:45,11:00,,41.37,0,41.37,41.37,-1,-58224,86062,144286,27838,0,-15017,0,0,0,,15017,-15017
38,09/19/2018,45,11:00,11:15,53.19,46.22,0,53.19,53.19,1,-98177,81571,179748,-16606,0,-10342,153,0,0,,10495,-10189
38,09/19/2018,46,11:15,11:30,53.19,42.07,0,54.21,42.07,2,-91113,112107,203220,20994,0,-7378,18,0,0,,7396,-7360
38,09/19/2018,47,11:30,11:45,,41.37,0,41.37,41.37,-1,-59885,93104,152989,33219,0,-18140,0,0,0,,18140,-18140
38,09/19/2018,48,11:45,12:00,,26.43,0,26.43,26.43,-1,-62315,115483,177798,53168,0,-44630,0,0,0,,44630,-44630
38,09/19/2018,49,12:00,12:15,,6.03,0,6.03,6.03,-1,-111286,139286,250572,28000,0,-38289,0,0,0,,38289,-38289
38,09/19/2018,50,12:15,12:30,,26.43,0,26.43,26.43,-1,-86899,139697,226596,52798,0,-32109,0,0,0,,32109,-32109
38,09/19/2018,51,12:30,12:45,,26.43,0,26.43,26.43,-1,-88469,161802,250271,73333,0,-56556,0,0,0,,56556,-56556
38,09/19/2018,52,12:45,13:00,143.02,-6.7,0,143.02,-6.7,2,-180630,145354,325984,-35276,0,-53948,3550,0,0,,57498,-50398
38,09/19/2018,53,13:00,13:15,142.02,-6.7,0,249.9,249.9,1,-257556,139083,396639,-118473,0,-2606,62828,0,23332,,88766,83554
38,09/19/2018,54,13:15,13:30,142.02,-71.15,0,-71.15,-71.15,-1,-183987,224528,408515,40541,0,-10070,28559,0,23332,,61961,41821
38,09/19/2018,55,13:30,13:45,,40.87,0,40.87,40.87,-1,-186163,205421,391584,19258,0,-5359,0,0,0,,5359,-5359
38,09/19/2018,56,13:45,14:00,,40.45,0,40.45,40.45,-1,-187562,211708,399270,24146,0,-17038,0,0,0,,17038,-17038
38,09/19/2018,57,14:00,14:15,,41.37,0,41.37,41.37,-1,-93222,119270,212492,26048,0,-18481,0,0,0,,18481,-18481
38,09/19/2018,58,14:15,14:30,,45.19,0,45.19,45.19,-1,-97539,121857,219396,24318,0,-7595,0,0,0,,7595,-7595
38,09/19/2018,59,14:30,14:45,,49.19,0,49.19,49.19,-1,-98844,116705,215549,17861,0,-3833,0,0,0,,3833,-3833
38,09/19/2018,60,14:45,15:00,,41.37,0,41.37,41.37,-1,-92854,106749,199603,13895,0,-7443,0,0,0,,7443,-7443
38,09/19/2018,61,15:00,15:15,,41.37,0,41.37,41.37,-1,-21903,90945,112848,69042,0,-6456,0,0,0,,6456,-6456
38,09/19/2018,62,15:15,15:30,,49.19,0,49.19,49.19,-1,-28143,78533,106676,50390,0,-580,0,0,0,,580,-580
38,09/19/2018,63,15:30,15:45,,49.19,0,49.19,49.19,-1,-51619,80923,132542,29304,0,-64,0,0,0,,64,-64
38,09/19/2018,64,15:45,16:00,,,0,47.61,47.61,0,-58126,68130,126256,10004,0,0,0,0,0,,0,0
38,09/19/2018,65,16:00,16:15,145.02,,0,145.02,145.02,1,-152351,98563,250914,-53788,0,0,21472,0,0,,21472,21472
38,09/19/2018,66,16:15,16:30,61.44,,0,61.44,61.44,1,-145602,114595,260197,-31007,0,0,31042,0,0,,31042,31042
38,09/19/2018,67,16:30,16:45,61.35,,0,61.35,61.35,1,-140976,106930,247906,-34046,0,0,31549,0,0,,31549,31549
38,09/19/2018,68,16:45,17:00,76.43,,0,76.43,76.43,1,-158959,107871,266830,-51088,0,0,42568,0,0,,42568,42568
38,09/19/2018,69,17:00,17:15,76.43,,0,76.43,76.43,1,-107454,43555,151009,-63899,0,0,25341,0,0,,25341,25341
38,09/19/2018,70,17:15,17:30,146.02,,0,146.02,146.02,1,-131250,47336,178586,-83914,0,0,14017,0,0,,14017,14017
38,09/19/2018,71,17:30,17:45,146.02,,0,146.02,146.02,1,-146032,62859,208891,-83173,0,0,61609,0,0,,61609,61609
38,09/19/2018,72,17:45,18:00,146.02,,0,146.02,146.02,1,-161523,70090,231613,-91433,0,0,80104,0,0,,80104,80104
38,09/19/2018,73,18:00,18:15,146.02,40.51,0,40.51,40.51,-1,-114969,91680,206649,-23289,0,-539,33401,0,0,,33940,32862
38,09/19/2018,74,18:15,18:30,,41.62,0,41.62,41.62,-1,-102924,119014,221938,16090,0,-3288,0,0,0,,3288,-3288
38,09/19/2018,75,18:30,18:45,57.19,45.19,0,57.19,45.19,2,-87026,80168,167194,-6858,0,-404,98,0,0,,502,-306
38,09/19/2018,76,18:45,19:00,146.02,,0,146.02,146.02,1,-110087,63890,173977,-46197,0,0,29424,0,0,,29424,29424
38,09/19/2018,77,19:00,19:15,61.35,45.19,0,45.19,45.19,-1,-62547,64737,127284,2190,0,-91,14232,0,0,,14323,14141
38,09/19/2018,78,19:15,19:30,61.35,45.19,0,61.35,61.35,1,-60814,49288,110102,-11526,0,-11,2560,0,0,,2571,2549
38,09/19/2018,79,19:30,19:45,61.35,,0,61.35,61.35,1,-71838,48214,120052,-23624,0,0,7601,0,0,,7601,7601
38,09/19/2018,80,19:45,20:00,146.02,,0,146.02,146.02,1,-152312,32168,184480,-120144,0,0,50254,0,0,,50254,50254
38,09/19/2018,81,20:00,20:15,450,,0,450,450,1,-168210,64349,232559,-103861,0,0,82817,0,0,,82817,82817
38,09/19/2018,82,20:15,20:30,450,41.37,0,41.37,41.37,-1,-106350,101319,207669,-5031,0,-194,35825,0,0,,36019,35631
38,09/19/2018,83,20:30,20:45,,41.37,0,41.37,41.37,-1,-83926,96100,180026,12174,0,-3500,0,0,0,,3500,-3500
38,09/19/2018,84,20:45,21:00,,41.37,0,41.37,41.37,-1,-60183,83853,144036,23670,0,-15971,0,0,0,,15971,-15971
38,09/19/2018,85,21:00,21:15,,41.37,0,41.37,41.37,-1,-55883,80704,136587,24821,0,-11979,0,0,0,,11979,-11979
38,09/19/2018,86,21:15,21:30,,39.61,0,39.61,39.61,-1,-53101,79506,132607,26405,0,-11845,0,0,0,,11845,-11845
38,09/19/2018,87,21:30,21:45,,-23.57,0,-23.57,-23.57,-1,-41207,101486,142693,60279,0,-37093,0,0,0,,37093,-37093
38,09/19/2018,88,21:45,22:00,,-11.03,0,-11.03,-11.03,-1,-60391,137320,197711,76929,0,-68367,0,0,0,,68367,-68367
38,09/19/2018,89,22:00,22:15,81.02,20.03,0,81.02,20.03,2,-115745,73282,189027,-42463,0,-43783,1213,0,0,,44996,-42570
38,09/19/2018,90,22:15,22:30,146.02,20.03,0,146.02,146.02,1,-92449,51784,144233,-40665,0,-214,30446,0,0,,30660,30232
38,09/19/2018,91,22:30,22:45,56.02,26.43,0,56.02,26.43,2,-70689,96241,166930,25552,0,-9146,4892,0,0,,14038,-4254
38,09/19/2018,92,22:45,23:00,,26.43,0,26.43,26.43,-1,-98389,133928,232317,35539,0,-24075,0,0,0,,24075,-24075
38,09/19/2018,93,23:00,23:15,126.43,26.43,0,126.43,26.43,2,-144681,78812,223493,-65869,0,-20716,5221,0,0,,25937,-15495
38,09/19/2018,94,23:15,23:30,377.17,26.43,0,377.17,377.17,1,-123600,63297,186897,-60303,0,-96,48672,5000,0,,53768,53576
38,09/19/2018,95,23:30,23:45,377.17,-56.85,0,-56.85,-56.85,-1,-70069,102741,172810,32672,0,-12721,9417,0,0,,22138,-3304
38,09/19/2018,96,23:45,0:00,,40.25,0,40.25,40.25,-1,-56190,82686,138876,26496,0,-21703,0,0,0,,21703,-21703
38,09/20/2018,1,0:00,0:15,50.12,40.25,0,50.12,50.12,1,-44855,48046,92901,3191,0,-15978,14,0,0,,15992,-15964
38,09/20/2018,2,0:15,0:30,60.25,40.25,0,60.25,60.25,1,-60904,45248,106152,-15656,0,-859,6799,0,0,,7658,5940
38,09/20/2018,3,0:30,0:45,52.02,40.25,0,40.25,40.25,-1,-40100,43694,83794,3594,0,-658,3483,0,0,,4141,2825
38,09/20/2018,4,0:45,1:00,52.02,38.48,0,38.48,38.48,-1,-33645,52993,86638,19348,0,-20083,70,0,0,,20153,-20013
38,09/20/2018,5,1:00,1:15,41.02,26.43,0,44.52,26.43,2,-63752,87465,151217,23713,0,-18666,88,0,0,,18754,-18578
38,09/20/2018,6,1:15,1:30,41.02,26.43,0,41.02,41.02,1,-56409,80807,137216,24398,0,-127,96,0,0,,223,-31
38,09/20/2018,7,1:30,1:45,,,0,44.52,44.52,0,-54312,82716,137028,28404,0,0,0,0,0,,0,0
38,09/20/2018,8,1:45,2:00,,40.25,0,40.25,40.25,-1,-58396,101503,159899,43107,0,-579,0,0,0,,579,-579
38,09/20/2018,9,2:00,2:15,,40.25,0,40.25,40.25,-1,-40268,29866,70134,-10402,0,-2868,0,0,0,,2868,-2868
38,09/20/2018,10,2:15,2:30,56.02,,0,56.02,56.02,1,-46772,30146,76918,-16626,0,0,2885,0,0,,2885,2885
38,09/20/2018,11,2:30,2:45,,,0,44.52,44.52,0,-49275,33732,83007,-15543,0,0,43,0,0,,43,43
38,09/20/2018,12,2:45,3:00,41.02,,0,41.02,41.02,1,-42398,38167,80565,-4231,0,0,30,0,0,,30,30
38,09/20/2018,13,3:00,3:15,56.02,,0,56.02,56.02,1,-49917,38497,88414,-11420,0,0,3941,0,0,,3941,3941
38,09/20/2018,14,3:15,3:30,56.02,,0,56.02,56.02,1,-54323,39681,94004,-14642,0,0,5141,0,0,,5141,5141
38,09/20/2018,15,3:30,3:45,52.02,,0,52.02,52.02,1,-47181,29753,76934,-17428,0,0,4185,0,0,,4185,4185
38,09/20/2018,16,3:45,4:00,52.02,48.02,0,48.02,48.02,-1,-73904,46771,120675,-27133,0,-12,895,0,0,,907,883
38,09/20/2018,17,4:00,4:15,,40.25,0,40.25,40.25,-1,-47983,58550,106533,10567,0,-715,0,0,0,,715,-715
38,09/20/2018,18,4:15,4:30,52.02,48.02,0,52.02,45.57,2,-57405,48827,106232,-8578,0,-1156,55,0,0,,1211,-1101
38,09/20/2018,19,4:30,4:45,59.64,,0,59.64,59.64,1,-60347,39611,99958,-20736,0,0,10598,0,0,,10598,10598
38,09/20/2018,20,4:45,5:00,56.75,,0,56.75,56.75,1,-50123,31557,81680,-18566,0,0,11208,0,0,,11208,11208
38,09/20/2018,21,5:00,5:15,54.12,48.02,0,48.02,48.02,-1,-41754,69847,111601,28093,0,-32,6555,0,0,,6587,6523
38,09/20/2018,22,5:15,5:30,54.12,48.02,0,48.02,48.02,-1,-37749,72014,109763,34265,0,-1550,13,0,0,,1563,-1537
38,09/20/2018,23,5:30,5:45,,40.25,0,40.25,40.25,-1,-57951,65084,123035,7133,0,-5205,0,0,0,,5205,-5205
38,09/20/2018,24,5:45,6:00,,36.54,0,36.54,36.54,-1,-77112,159290,236402,82178,0,-10436,0,0,0,,10436,-10436
38,09/20/2018,25,6:00,6:15,,-88.65,0,-88.65,-88.65,-1,-80127,135952,216079,55825,0,-32937,0,0,0,,32937,-32937
38,09/20/2018,26,6:15,6:30,,50.87,0,50.87,50.87,-1,-53044,115447,168491,62403,0,-9658,0,0,0,,9658,-9658
38,09/20/2018,27,6:30,6:45,52.34,50.87,0,52.34,52.34,1,-43422,68671,112093,25249,0,-645,145,0,0,,790,-500
38,09/20/2018,28,6:45,7:00,52.34,,0,52.34,52.34,1,-72242,86986,159228,14744,0,0,1323,0,0,,1323,1323
38,09/20/2018,29,7:00,7:15,52.34,,0,52.34,52.34,1,-80057,41780,121837,-38277,0,0,631,0,0,,631,631
38,09/20/2018,30,7:15,7:30,,,0,52.55,52.55,0,-53174,45388,98562,-7786,0,0,121,0,0,,121,121
38,09/20/2018,31,7:30,7:45,,,0,52.52,52.52,0,-74037,16316,90353,-57721,0,0,0,0,0,,0,0
38,09/20/2018,32,7:45,8:00,52.34,,0,52.34,52.34,1,-99007,16029,115036,-82978,0,0,1061,0,0,,1061,1061
38,09/20/2018,33,8:00,8:15,,52.76,0,52.76,52.76,-1,-83459,63219,146678,-20240,0,-1060,0,0,0,,1060,-1060
38,09/20/2018,34,8:15,8:30,,52.76,0,52.76,52.76,-1,-76504,47581,124085,-28923,0,-233,0,0,0,,233,-233
38,09/20/2018,35,8:30,8:45,,,0,53.14,53.14,0,-78231,28536,106767,-49695,0,0,0,0,0,,0,0
38,09/20/2018,36,8:45,9:00,53.52,,0,53.52,53.52,1,-88925,30746,119671,-58179,0,0,14,0,0,,14,14
38,09/20/2018,37,9:00,9:15,155.12,,0,155.12,155.12,1,-127422,23256,150678,-104166,0,0,11767,0,0,,11767,11767
38,09/20/2018,38,9:15,9:30,155.12,,0,155.12,155.12,1,-90295,56332,146627,-33963,0,0,44941,0,0,,44941,44941
38,09/20/2018,39,9:30,9:45,59.1,,0,59.1,59.1,1,-71235,58750,129985,-12485,0,0,6656,0,0,,6656,6656
38,09/20/2018,40,9:45,10:00,58.05,,0,58.05,58.05,1,-56735,58949,115684,2214,0,0,5133,0,0,,5133,5133
38,09/20/2018,41,10:00,10:15,154.12,,0,154.12,154.12,1,-136467,49074,185541,-87393,0,0,39273,0,0,,39273,39273
38,09/20/2018,42,10:15,10:30,76.76,,0,76.76,76.76,1,-128351,93647,221998,-34704,0,0,41115,0,0,,41115,41115
38,09/20/2018,43,10:30,10:45,57.88,,0,57.88,57.88,1,-119436,93587,213023,-25849,0,0,16129,0,0,,16129,16129
38,09/20/2018,44,10:45,11:00,350.15,52.65,0,350.15,52.65,2,-110180,96008,206188,-14172,0,-1242,1082,0,0,,2324,-160
38,09/20/2018,45,11:00,11:15,350.15,52.65,0,385.17,385.17,1,-271097,80219,351316,-190878,0,-96,54321,0,8397,,62814,62622
38,09/20/2018,46,11:15,11:30,350.15,,0,385.17,385.17,1,-254850,117130,371980,-137720,0,0,80570,0,52692,,133262,133262
38,09/20/2018,47,11:30,11:45,76.76,,0,260,260,1,-199715,124185,323900,-75530,0,0,28301,0,44295,,72596,72596
38,09/20/2018,48,11:45,12:00,350.15,,0,350.15,350.15,1,-198939,132682,331621,-66257,0,0,46319,0,9167,,55486,55486
38,09/20/2018,49,12:00,12:15,42.54,42.63,0,48.73,42.63,2,-135164,125815,260979,-9349,0,-3147,9675,0,0,,12822,6528
38,09/20/2018,50,12:15,12:30,57.85,,0,57.85,57.85,1,-152536,98818,251354,-53718,0,0,3503,0,0,,3503,3503
38,09/20/2018,51,12:30,12:45,42.54,,0,42.54,42.54,1,-149811,111145,260956,-38666,0,0,688,0,0,,688,688
38,09/20/2018,52,12:45,13:00,63.3,,0,63.3,63.3,1,-148996,98833,247829,-50163,0,0,2947,0,0,,2947,2947
38,09/20/2018,53,13:00,13:15,110.74,,0,110.74,110.74,1,-157563,105638,263201,-51925,0,0,30054,0,0,,30054,30054
38,09/20/2018,54,13:15,13:30,76.15,,0,76.15,76.15,1,-143403,118968,262371,-24435,0,0,30914,0,0,,30914,30914
38,09/20/2018,55,13:30,13:45,59.67,,0,59.67,59.67,1,-115166,112867,228033,-2299,0,0,14471,0,0,,14471,14471
38,09/20/2018,56,13:45,14:00,54.02,50.44,0,54.02,49.56,2,-90202,100578,190780,10376,0,-655,908,0,0,,1563,253
38,09/20/2018,57,14:00,14:15,96.76,,0,96.76,96.76,1,-144504,99095,243599,-45409,0,0,28379,0,0,,28379,28379
38,09/20/2018,58,14:15,14:30,81.7,,0,81.7,81.7,1,-131461,87177,218638,-44284,0,0,37623,0,0,,37623,37623
38,09/20/2018,59,14:30,14:45,77.52,,0,77.52,77.52,1,-120888,81384,202272,-39504,0,0,44577,0,0,,44577,44577
38,09/20/2018,60,14:45,15:00,73.52,40.58,0,40.58,40.58,-1,-101741,84369,186110,-17372,0,-255,24053,0,0,,24308,23798
38,09/20/2018,61,15:00,15:15,73.52,8.76,0,8.76,8.76,-1,-65757,109029,174786,43272,0,-29995,836,0,0,,30831,-29159
38,09/20/2018,62,15:15,15:30,96.76,8.76,0,96.76,96.76,1,-89118,63386,152504,-25732,0,-4978,12138,0,0,,17116,7160
38,09/20/2018,63,15:30,15:45,73.52,,0,73.52,73.52,1,-95274,64681,159955,-30593,0,0,23752,0,0,,23752,23752
38,09/20/2018,64,15:45,16:00,96.76,,0,96.76,96.76,1,-114383,54924,169307,-59459,0,0,36666,0,0,,36666,36666
38,09/20/2018,65,16:00,16:15,96.76,26.76,0,26.76,26.76,-1,-75976,105563,181539,29587,0,-12534,10095,0,0,,22629,-2439
38,09/20/2018,66,16:15,16:30,61.7,26.76,0,61.7,61.7,1,-113493,83703,197196,-29790,0,-766,7339,0,0,,8105,6573
38,09/20/2018,67,16:30,16:45,145.15,,0,145.15,145.15,1,-170463,71050,241513,-99413,0,0,22828,0,0,,22828,22828
38,09/20/2018,68,16:45,17:00,350.15,,0,350.15,350.15,1,-197843,87504,285347,-110339,0,0,70722,0,0,,70722,70722
38,09/20/2018,69,17:00,17:15,350.15,,0,350.15,350.15,1,-284191,82809,367000,-201382,0,0,56531,0,0,,56531,56531
38,09/20/2018,70,17:15,17:30,350.15,,0,385.17,385.17,1,-267755,77361,345116,-190394,0,0,80749,0,2708,,83457,83457
38,09/20/2018,71,17:30,17:45,372.67,,0,409.94,409.94,1,-229697,103774,333471,-125923,0,0,81422,18750,24674,,124846,124846
38,09/20/2018,72,17:45,18:00,372.67,,0,409.94,409.94,1,-216666,107548,324214,-109118,0,0,64218,18750,24774,,107742,107742
38,09/20/2018,73,18:00,18:15,375.01,48.41,0,412.51,48.41,2,-121155,76878,198033,-44277,0,-1747,23040,18750,24774,,68311,64817
38,09/20/2018,74,18:15,18:30,350.15,48.41,0,350.15,350.15,1,-184130,96332,280462,-87798,0,-7,12700,0,0,,12707,12693
38,09/20/2018,75,18:30,18:45,350.15,,0,350.15,350.15,1,-191632,106867,298499,-84765,0,0,72229,0,0,,72229,72229
38,09/20/2018,76,18:45,19:00,375.01,,0,375.01,375.01,1,-200738,91376,292114,-109362,0,0,81770,18750,0,,100520,100520
38,09/20/2018,77,19:00,19:15,61.45,,0,61.45,61.45,1,-95910,60599,156509,-35311,0,0,42079,0,0,,42079,42079
38,09/20/2018,78,19:15,19:30,350.15,,0,350.15,350.15,1,-121259,59676,180935,-61583,0,0,38304,0,0,,38304,38304
38,09/20/2018,79,19:30,19:45,156.12,,0,156.12,156.12,1,-148762,58398,207160,-90364,0,0,68432,0,0,,68432,68432
38,09/20/2018,80,19:45,20:00,156.12,,0,156.12,156.12,1,-194801,59385,254186,-135416,0,0,80154,0,0,,80154,80154
38,09/20/2018,81,20:00,20:15,156.12,,0,156.12,156.12,1,-114047,79950,193997,-34097,0,0,62365,0,0,,62365,62365
38,09/20/2018,82,20:15,20:30,61.72,,0,61.72,61.72,1,-123186,83035,206221,-40151,0,0,17189,0,0,,17189,17189
38,09/20/2018,83,20:30,20:45,57.52,,0,57.52,57.52,1,-116554,90757,207311,-25797,0,0,7159,0,0,,7159,7159
38,09/20/2018,84,20:45,21:00,,52.76,0,52.76,52.76,-1,-106591,114873,221464,8282,0,-306,0,0,0,,306,-306
38,09/20/2018,85,21:00,21:15,450,52.76,0,450,450,1,-259704,79644,339348,-180060,0,-9,32408,0,0,,32417,32399
38,09/20/2018,86,21:15,21:30,350.12,,0,350.12,350.12,1,-170355,89768,260123,-80587,0,0,77493,0,0,,77493,77493
38,09/20/2018,87,21:30,21:45,350.12,52.64,0,52.64,52.64,-1,-134563,128464,263027,-6099,0,-90,20779,0,0,,20869,20689
38,09/20/2018,88,21:45,22:00,,50.85,0,50.85,50.85,-1,-145407,153008,298415,7601,0,-459,0,0,0,,459,-459
38,09/20/2018,89,22:00,22:15,350.12,50.85,0,350.12,350.12,1,-150254,90187,240441,-60067,0,-92,16061,0,0,,16153,15969
38,09/20/2018,90,22:15,22:30,72.12,40.58,0,40.58,40.58,-1,-92891,100874,193765,7983,0,-875,22617,0,0,,23492,21742
38,09/20/2018,91,22:30,22:45,72.12,-3.39,0,-3.39,-3.39,-1,-79419,108220,187639,28801,0,-24861,29,0,0,,24890,-24832
38,09/20/2018,92,22:45,23:00,,51.35,0,51.35,51.35,-1,-93916,93720,187636,-196,0,-6021,0,0,0,,6021,-6021
38,09/20/2018,93,23:00,23:15,86.12,51.35,0,86.12,86.12,1,-177067,139300,316367,-37767,0,-80,12464,0,0,,12544,12384
38,09/20/2018,94,23:15,23:30,76.76,,0,76.76,76.76,1,-119730,83476,203206,-36254,0,0,35742,0,0,,35742,35742
38,09/20/2018,95,23:30,23:45,63.49,,0,63.49,63.49,1,-127359,85324,212683,-42035,0,0,32128,0,0,,32128,32128
38,09/20/2018,96,23:45,0:00,60.58,49.7,0,49.7,49.7,-1,-121050,115529,236579,-5521,0,-526,23224,0,0,,23750,22698
38,09/21/2018,1,0:00,0:15,56.34,40.58,0,56.34,40.58,2,-103020,73532,176552,-29488,0,-883,4250,0,0,,5133,3367
38,09/21/2018,2,0:15,0:30,57.02,,0,57.02,57.02,1,-65081,31395,96476,-33686,0,0,8171,0,0,,8171,8171
38,09/21/2018,3,0:30,0:45,,,0,47.18,47.18,0,-70818,54495,125313,-16323,0,0,51,0,0,,51,51
38,09/21/2018,4,0:45,1:00,,44.34,0,44.34,44.34,-1,-74190,57469,131659,-16721,0,-909,0,0,0,,909,-909
38,09/21/2018,5,1:00,1:15,145.02,48.34,0,145.02,145.02,1,-135839,49493,185332,-86346,0,-484,17493,0,0,,17977,17009
38,09/21/2018,6,1:15,1:30,145.02,,0,145.02,145.02,1,-86383,47150,133533,-39233,0,0,40728,0,0,,40728,40728
38,09/21/2018,7,1:30,1:45,145.02,38.28,0,38.28,38.28,-1,-40661,67547,108208,26886,0,-2065,165,0,0,,2230,-1900
38,09/21/2018,8,1:45,2:00,,39.69,0,39.69,39.69,-1,-38735,50319,89054,11584,0,-5068,0,0,0,,5068,-5068
38,09/21/2018,9,2:00,2:15,,27.03,0,27.03,27.03,-1,-49175,131757,180932,82582,0,-3424,0,0,0,,3424,-3424
38,09/21/2018,10,2:15,2:30,,,0,44.68,44.68,0,-50594,43938,94532,-6656,0,0,0,0,0,,0,0
38,09/21/2018,11,2:30,2:45,41.02,48.34,0,44.68,44.68,2,-41905,39743,81648,-2162,0,-51,1066,0,0,,1117,1015
38,09/21/2018,12,2:45,3:00,,26.76,0,26.76,26.76,-1,-35521,47668,83189,12147,0,-5421,0,0,0,,5421,-5421
38,09/21/2018,13,3:00,3:15,,26.76,0,26.76,26.76,-1,-35850,127019,162869,91169,0,-9244,0,0,0,,9244,-9244
38,09/21/2018,14,3:15,3:30,,,0,44.69,44.69,0,-29262,98348,127610,69086,0,-24,0,0,0,,24,-24
38,09/21/2018,15,3:30,3:45,,,0,44.71,44.71,0,-24514,90974,115488,66460,0,0,0,0,0,,0,0
38,09/21/2018,16,3:45,4:00,,48.34,0,48.34,48.34,-1,-22470,82012,104482,59542,0,-161,0,0,0,,161,-161
38,09/21/2018,17,4:00,4:15,,48.34,0,48.34,48.34,-1,-44171,64330,108501,20159,0,-1041,0,0,0,,1041,-1041
38,09/21/2018,18,4:15,4:30,,44.34,0,44.34,44.34,-1,-26839,73217,100056,46378,0,-1829,0,0,0,,1829,-1829
38,09/21/2018,19,4:30,4:45,,38.81,0,38.81,38.81,-1,-22323,82697,105020,60374,0,-1399,0,0,0,,1399,-1399
38,09/21/2018,20,4:45,5:00,,48.34,0,48.34,48.34,-1,-24098,82940,107038,58842,0,-1601,0,0,0,,1601,-1601
38,09/21/2018,21,5:00,5:15,,44.34,0,44.34,44.34,-1,-80898,45847,126745,-35051,0,-125,0,0,0,,125,-125
38,09/21/2018,22,5:15,5:30,,39.15,0,39.15,39.15,-1,-33019,44179,77198,11160,0,-9483,0,0,0,,9483,-9483
38,09/21/2018,23,5:30,5:45,144.02,39.15,0,144.02,144.02,1,-160416,32202,192618,-128214,0,-350,48718,0,0,,49068,48368
38,09/21/2018,24,5:45,6:00,146.57,,0,146.57,146.57,1,-97339,50105,147444,-47234,0,0,70361,13750,0,,84111,84111
38,09/21/2018,25,6:00,6:15,146.57,29.24,0,29.24,29.24,-1,-85554,136755,222309,51201,0,-3356,3884,0,0,,7240,528
38,09/21/2018,26,6:15,6:30,,43,0,43,43,-1,-57727,104583,162310,46856,0,-2550,0,0,0,,2550,-2550
38,09/21/2018,27,6:30,6:45,57.8,43,0,57.8,43,2,-63273,53895,117168,-9378,0,-2570,299,0,0,,2869,-2271
38,09/21/2018,28,6:45,7:00,57.4,,0,57.4,57.4,1,-92831,98092,190923,5261,0,0,972,0,0,,972,972
38,09/21/2018,29,7:00,7:15,58.72,,0,58.72,58.72,1,-107599,75438,183037,-32161,0,0,900,0,0,,900,900
38,09/21/2018,30,7:15,7:30,63.87,,0,63.87,63.87,1,-118737,91788,210525,-26949,0,0,5042,0,0,,5042,5042
38,09/21/2018,31,7:30,7:45,161.02,,0,161.02,161.02,1,-137965,61329,199294,-76636,0,0,46053,0,0,,46053,46053
38,09/21/2018,32,7:45,8:00,146.02,,0,146.02,146.02,1,-144657,55991,200648,-88666,0,0,72451,0,0,,72451,72451
38,09/21/2018,33,8:00,8:15,157.02,,0,157.02,157.02,1,-166596,71393,237989,-95203,0,0,78122,0,0,,78122,78122
38,09/21/2018,34,8:15,8:30,157.02,,0,157.02,157.02,1,-170223,65010,235233,-105213,0,0,82449,0,0,,82449,82449
38,09/21/2018,35,8:30,8:45,385.14,,0,385.14,385.14,1,-181806,68795,250601,-113011,0,0,82477,0,0,,82477,82477
38,09/21/2018,36,8:45,9:00,385.14,,0,385.14,385.14,1,-189555,78816,268371,-110739,0,0,82400,0,0,,82400,82400
38,09/21/2018,37,9:00,9:15,385.14,52.88,0,52.88,52.88,-1,-114665,111235,225900,-3430,0,-12,46527,2500,0,,49039,49015
38,09/21/2018,38,9:15,9:30,106.14,51.98,0,106.14,51.98,2,-128966,97140,226106,-31826,0,-45,9290,0,0,,9335,9245
38,09/21/2018,39,9:30,9:45,113.14,,0,113.14,113.14,1,-126390,101737,228127,-24653,0,0,32761,0,0,,32761,32761
38,09/21/2018,40,9:45,10:00,74.56,,0,74.56,74.56,1,-128711,105167,233878,-23544,0,0,13319,0,0,,13319,13319
38,09/21/2018,41,10:00,10:15,79.24,,0,79.24,79.24,1,-109052,71678,180730,-37374,0,0,23836,0,0,,23836,23836
38,09/21/2018,42,10:15,10:30,59.98,,0,59.98,59.98,1,-96676,71406,168082,-25270,0,0,19077,0,0,,19077,19077
38,09/21/2018,43,10:30,10:45,60.05,,0,60.05,60.05,1,-88823,68679,157502,-20144,0,0,17518,0,0,,17518,17518
38,09/21/2018,44,10:45,11:00,60.05,51.98,0,51.98,51.98,-1,-83829,84521,168350,692,0,-394,3303,0,0,,3697,2909
38,09/21/2018,45,11:00,11:15,79.24,51.98,0,79.24,51.98,2,-104631,64307,168938,-40324,0,-380,9790,0,0,,10170,9410
38,09/21/2018,46,11:15,11:30,59.98,,0,59.98,59.98,1,-88423,65142,153565,-23281,0,0,12399,0,0,,12399,12399
38,09/21/2018,47,11:30,11:45,56.75,,0,56.75,56.75,1,-79907,74258,154165,-5649,0,0,7773,0,0,,7773,7773
38,09/21/2018,48,11:45,12:00,56.75,47.98,0,47.98,47.98,-1,-80248,84015,164263,3767,0,-398,793,0,0,,1191,395
38,09/21/2018,49,12:00,12:15,57.36,,0,57.36,57.36,1,-120298,57711,178009,-62587,0,0,1667,0,0,,1667,1667
38,09/21/2018,50,12:15,12:30,55.98,,0,55.98,55.98,1,-81897,52864,134761,-29033,0,0,921,0,0,,921,921
38,09/21/2018,51,12:30,12:45,,51.98,0,51.98,51.98,-1,-67321,59091,126412,-8230,0,-137,0,0,0,,137,-137
38,09/21/2018,52,12:45,13:00,,51.98,0,51.98,51.98,-1,-80651,65713,146364,-14938,0,-248,0,0,0,,248,-248
38,09/21/2018,53,13:00,13:15,64.22,51.98,0,64.22,64.22,1,-78644,45800,124444,-32844,0,-98,2406,0,0,,2504,2308
38,09/21/2018,54,13:15,13:30,64.22,,0,64.22,64.22,1,-71651,79489,151140,7838,0,0,5669,0,0,,5669,5669
38,09/21/2018,55,13:30,13:45,,,0,53.98,53.98,0,-56163,95274,151437,39111,0,0,0,0,0,,0,0
38,09/21/2018,56,13:45,14:00,,-73.12,0,-73.12,-73.12,-1,-32562,112494,145056,79932,0,-7301,0,0,0,,7301,-7301
38,09/21/2018,57,14:00,14:15,,-145.45,0,-145.45,-145.45,-1,-70615,105718,176333,35103,0,-30716,0,0,0,,30716,-30716
38,09/21/2018,58,14:15,14:30,,,0,53.98,53.98,0,-42195,97293,139488,55098,0,-666,0,0,0,,666,-666
38,09/21/2018,59,14:30,14:45,,,0,53.98,53.98,0,-23382,107945,131327,84563,0,0,0,0,0,,0,0
38,09/21/2018,60,14:45,15:00,,,0,53.98,53.98,0,-20237,121600,141837,101363,0,0,0,0,0,,0,0
38,09/21/2018,61,15:00,15:15,,51.98,0,51.98,51.98,-1,-22720,140790,163510,118070,0,-153,0,0,0,,153,-153
38,09/21/2018,62,15:15,15:30,,-15.63,0,-15.63,-15.63,-1,-21535,165163,186698,143628,0,-23001,0,0,0,,23001,-23001
38,09/21/2018,63,15:30,15:45,,-10.01,0,-10.01,-10.01,-1,-14086,151934,166020,137848,0,-39566,0,0,0,,39566,-39566
38,09/21/2018,64,15:45,16:00,,-121.28,0,-121.28,-121.28,-1,-10015,176717,186732,166702,0,-54105,0,0,0,,54105,-54105
38,09/21/2018,65,16:00,16:15,,-143.6,0,-143.6,-143.6,-1,-30649,146542,177191,115893,0,-90311,0,0,0,,90311,-90311
38,09/21/2018,66,16:15,16:30,,,0,53.98,53.98,0,-54670,109808,164478,55138,0,-15802,0,0,0,,15802,-15802
38,09/21/2018,67,16:30,16:45,,36.6,0,36.6,36.6,-1,-38239,93778,132017,55539,0,-5234,0,0,0,,5234,-5234
38,09/21/2018,68,16:45,17:00,,41.28,0,41.28,41.28,-1,-48303,96030,144333,47727,0,-3068,0,0,0,,3068,-3068
38,09/21/2018,69,17:00,17:15,,29.24,0,29.24,29.24,-1,-86554,148662,235216,62108,0,-21909,0,0,0,,21909,-21909
38,09/21/2018,70,17:15,17:30,,,0,53.98,53.98,0,-93363,113265,206628,19902,0,-3412,0,0,0,,3412,-3412
38,09/21/2018,71,17:30,17:45,,,0,53.98,53.98,0,-97704,109084,206788,11380,0,0,0,0,0,,0,0
38,09/21/2018,72,17:45,18:00,,,0,54.26,54.26,0,-69895,91958,161853,22063,0,0,0,0,0,,0,0
38,09/21/2018,73,18:00,18:15,52.94,,0,52.94,52.94,1,-79720,59720,139440,-20000,0,0,11,0,0,,11,11
38,09/21/2018,74,18:15,18:30,79.24,,0,79.24,79.24,1,-98233,44178,142411,-54055,0,0,4471,0,0,,4471,4471
38,09/21/2018,75,18:30,18:45,155.11,,0,155.11,155.11,1,-93330,51489,144819,-41841,0,0,40180,0,0,,40180,40180
38,09/21/2018,76,18:45,19:00,52.94,51.98,0,52.94,51.98,2,-64488,95661,160149,31173,0,-756,6302,0,0,,7058,5546
38,09/21/2018,77,19:00,19:15,,52.65,0,52.65,52.65,-1,-82249,47194,129443,-35055,0,-838,0,0,0,,838,-838
38,09/21/2018,78,19:15,19:30,79.24,52.65,0,79.24,79.24,1,-114958,41029,155987,-73929,0,-14,2581,0,0,,2595,2567
38,09/21/2018,79,19:30,19:45,79.24,,0,79.24,79.24,1,-161729,48889,210618,-112840,0,0,19300,0,0,,19300,19300
38,09/21/2018,80,19:45,20:00,79.24,,0,79.24,79.24,1,-149195,63823,213018,-85372,0,0,28756,0,0,,28756,28756
38,09/21/2018,81,20:00,20:15,64.22,,0,64.22,64.22,1,-76049,63620,139669,-12429,0,0,23120,0,0,,23120,23120
38,09/21/2018,82,20:15,20:30,64.22,51.98,0,51.98,51.98,-1,-69591,56778,126369,-12813,0,-496,2766,0,0,,3262,2270
38,09/21/2018,83,20:30,20:45,,,0,53.77,53.77,0,-75692,53338,129030,-22354,0,0,0,0,0,,0,0
38,09/21/2018,84,20:45,21:00,,29.24,0,29.24,29.24,-1,-49385,73961,123346,24576,0,-10801,0,0,0,,10801,-10801
38,09/21/2018,85,21:00,21:15,54.16,51.05,0,54.16,54.16,1,-70376,49264,119640,-21112,0,-6397,123,0,0,,6520,-6274
38,09/21/2018,86,21:15,21:30,55.98,52.58,0,55.98,31.29,2,-76664,62302,138966,-14362,0,-8,601,0,0,,609,593
38,09/21/2018,87,21:30,21:45,,50.36,0,50.36,50.36,-1,-53977,59763,113740,5786,0,-2775,0,0,0,,2775,-2775
38,09/21/2018,88,21:45,22:00,,29.24,0,29.24,29.24,-1,-49478,84799,134277,35321,0,-30735,0,0,0,,30735,-30735
38,09/21/2018,89,22:00,22:15,,47.98,0,47.98,47.98,-1,-89195,85586,174781,-3609,0,-19089,0,0,0,,19089,-19089
38,09/21/2018,90,22:15,22:30,55.98,41.86,0,55.98,41.86,2,-55012,65221,120233,10209,0,-4292,237,0,0,,4529,-4055
38,09/21/2018,91,22:30,22:45,,41.95,0,41.95,41.95,-1,-65389,80126,145515,14737,0,-9806,0,0,0,,9806,-9806
38,09/21/2018,92,22:45,23:00,,41.59,0,41.59,41.59,-1,-66900,83656,150556,16756,0,-23600,0,0,0,,23600,-23600
38,09/21/2018,93,23:00,23:15,,44.15,0,44.15,44.15,-1,-57839,65586,123425,7747,0,-9059,0,0,0,,9059,-9059
38,09/21/2018,94,23:15,23:30,55.98,29.24,0,55.98,29.24,2,-41245,54382,95627,13137,0,-2846,176,0,0,,3022,-2670
38,09/21/2018,95,23:30,23:45,,-9.99,0,-9.99,-9.99,-1,-55821,90958,146779,35137,0,-22146,0,0,0,,22146,-22146
38,09/21/2018,96,23:45,0:00,,-4.14,0,-4.14,-4.14,-1,-39906,110181,150087,70275,0,-41651,0,0,0,,41651,-41651
39,09/22/2018,1,0:00,0:15,58.16,36.78,0,58.16,58.16,1,-82813,53726,136539,-29087,0,-23356,742,0,0,,24098,-22614
39,09/22/2018,2,0:15,0:30,,,0,48.45,48.45,0,-55295,54811,110106,-484,0,0,89,0,0,,89,89
39,09/22/2018,3,0:30,0:45,,39.09,0,39.09,39.09,-1,-49385,60007,109392,10622,0,-3086,0,0,0,,3086,-3086
39,09/22/2018,4,0:45,1:00,,29.03,0,29.03,29.03,-1,-58125,78166,136291,20041,0,-24951,0,0,0,,24951,-24951
39,09/22/2018,5,1:00,1:15,,43.61,0,43.61,43.61,-1,-34169,88204,122373,54035,0,-13676,0,0,0,,13676,-13676
39,09/22/2018,6,1:15,1:30,,15.78,0,15.78,15.78,-1,-28183,71599,99782,43416,0,-32614,0,0,0,,32614,-32614
39,09/22/2018,7,1:30,1:45,,29.03,0,29.03,29.03,-1,-27830,57872,85702,30042,0,-43524,0,0,0,,43524,-43524
39,09/22/2018,8,1:45,2:00,,43.61,0,43.61,43.61,-1,-46826,48506,95332,1680,0,-12551,0,0,0,,12551,-12551
39,09/22/2018,9,2:00,2:15,,-84.77,0,-84.77,-84.77,-1,-36450,73340,109790,36890,0,-22616,0,0,0,,22616,-22616
39,09/22/2018,10,2:15,2:30,,29.03,0,29.03,29.03,-1,-27675,62763,90438,35088,0,-21417,0,0,0,,21417,-21417
39,09/22/2018,11,2:30,2:45,,43.97,0,43.97,43.97,-1,-38399,50047,88446,11648,0,-24011,0,0,0,,24011,-24011
39,09/22/2018,12,2:45,3:00,,47.77,0,47.77,47.77,-1,-59008,59818,118826,810,0,-7049,0,0,0,,7049,-7049
39,09/22/2018,13,3:00,3:15,129.03,47.77,0,129.03,129.03,1,-102290,40408,142698,-61882,0,-351,15989,0,0,,16340,15638
39,09/22/2018,14,3:15,3:30,61.12,43.97,0,43.97,43.97,-1,-60830,45740,106570,-15090,0,-58,18984,0,0,,19042,18926
39,09/22/2018,15,3:30,3:45,61.12,36.78,0,36.78,36.78,-1,-38648,46621,85269,7973,0,-8705,267,0,0,,8972,-8438
39,09/22/2018,16,3:45,4:00,,49.78,0,49.78,49.78,-1,-42525,45858,88383,3333,0,-3920,0,0,0,,3920,-3920
39,09/22/2018,17,4:00,4:15,144.12,49.78,0,144.12,144.12,1,-110999,23508,134507,-87491,0,-35,32138,0,0,,32173,32103
39,09/22/2018,18,4:15,4:30,79.03,,0,79.03,79.03,1,-90989,33681,124670,-57308,0,0,60208,0,0,,60208,60208
39,09/22/2018,19,4:30,4:45,63.81,,0,63.81,63.81,1,-91737,45624,137361,-46113,0,0,45252,0,0,,45252,45252
39,09/22/2018,20,4:45,5:00,60.12,,0,60.12,60.12,1,-96424,68868,165292,-27556,0,0,37830,0,0,,37830,37830
39,09/22/2018,21,5:00,5:15,60.12,39.19,0,39.19,39.19,-1,-46063,49800,95863,3737,0,-1407,7135,0,0,,8542,5728
39,09/22/2018,22,5:15,5:30,,37.79,0,37.79,37.79,-1,-39626,55365,94991,15739,0,-3889,0,0,0,,3889,-3889
39,09/22/2018,23,5:30,5:45,41.36,35.78,0,46.34,35.78,2,-59706,58398,118104,-1308,0,-12522,50,0,0,,12572,-12472
39,09/22/2018,24,5:45,6:00,59.81,35.78,0,59.81,59.81,1,-72715,44480,117195,-28235,0,-668,6341,0,0,,7009,5673
39,09/22/2018,25,6:00,6:15,63.07,,0,63.07,63.07,1,-74851,62308,137159,-12543,0,0,11293,0,0,,11293,11293
39,09/22/2018,26,6:15,6:30,63.07,,0,63.07,63.07,1,-75336,47731,123067,-27605,0,0,8708,0,0,,8708,8708
39,09/22/2018,27,6:30,6:45,59.03,,0,59.03,59.03,1,-77102,44687,121789,-32415,0,0,22313,0,0,,22313,22313
39,09/22/2018,28,6:45,7:00,65.12,,0,65.12,65.12,1,-96398,54133,150531,-42265,0,0,33426,0,0,,33426,33426
39,09/22/2018,29,7:00,7:15,58.44,37.93,0,37.93,37.93,-1,-68620,73734,142354,5114,0,-1551,16320,0,0,,17871,14769
39,09/22/2018,30,7:15,7:30,,35.83,0,35.83,35.83,-1,-45669,63347,109016,17678,0,-16698,0,0,0,,16698,-16698
39,09/22/2018,31,7:30,7:45,63.07,47.03,0,63.07,63.07,1,-59522,45838,105360,-13684,0,-7492,533,0,0,,8025,-6959
39,09/22/2018,32,7:45,8:00,63.07,,0,63.07,63.07,1,-60625,47970,108595,-12655,0,0,7143,0,0,,7143,7143
39,09/22/2018,33,8:00,8:15,55.03,43.22,0,55.03,43.22,2,-61596,63508,125104,1912,0,-915,521,0,0,,1436,-394
39,09/22/2018,34,8:15,8:30,78.29,,0,78.29,78.29,1,-62971,30906,93877,-32065,0,0,15644,0,0,,15644,15644
39,09/22/2018,35,8:30,8:45,82.08,,0,82.08,82.08,1,-75712,29051,104763,-46661,0,0,32343,0,0,,32343,32343
39,09/22/2018,36,8:45,9:00,191.17,,0,191.17,191.17,1,-85956,28825,114781,-57131,0,0,53084,0,0,,53084,53084
39,09/22/2018,37,9:00,9:15,78.29,,0,78.29,78.29,1,-67820,17914,85734,-49906,0,0,49377,0,0,,49377,49377
39,09/22/2018,38,9:15,9:30,67.17,,0,67.17,67.17,1,-72743,25635,98378,-47108,0,0,42112,0,0,,42112,42112
39,09/22/2018,39,9:30,9:45,91.17,,0,91.17,91.17,1,-86389,24293,110682,-62096,0,0,52985,0,0,,52985,52985
39,09/22/2018,40,9:45,10:00,389.17,,0,389.17,389.17,1,-84245,20188,104433,-64057,0,0,58873,0,0,,58873,58873
39,09/22/2018,41,10:00,10:15,389.17,47.03,0,47.03,47.03,-1,-78175,91164,169339,12989,0,-40,19299,0,0,,19339,19259
39,09/22/2018,42,10:15,10:30,,43.22,0,43.22,43.22,-1,-73819,103734,177553,29915,0,-1271,0,0,0,,1271,-1271
39,09/22/2018,43,10:30,10:45,,28.29,0,28.29,28.29,-1,-68973,109771,178744,40798,0,-20551,0,0,0,,20551,-20551
39,09/22/2018,44,10:45,11:00,,43.22,0,43.22,43.22,-1,-72403,86229,158632,13826,0,-18195,0,0,0,,18195,-18195
39,09/22/2018,45,11:00,11:15,63.22,51.03,0,63.22,46.81,2,-89252,65011,154263,-24241,0,-3847,4167,0,0,,8014,320
39,09/22/2018,46,11:15,11:30,55.03,,0,55.03,55.03,1,-79170,71624,150794,-7546,0,0,1889,0,0,,1889,1889
39,09/22/2018,47,11:30,11:45,55.03,,0,55.03,55.03,1,-79783,71678,151461,-8105,0,0,2947,0,0,,2947,2947
39,09/22/2018,48,11:45,12:00,42.58,43.22,0,46.81,43.22,2,-65678,83030,148708,17352,0,-1208,198,0,0,,1406,-1010
39,09/22/2018,49,12:00,12:15,,51.03,0,51.03,51.03,-1,-104568,48564,153132,-56004,0,-234,0,0,0,,234,-234
39,09/22/2018,50,12:15,12:30,59.03,,0,59.03,59.03,1,-132213,37642,169855,-94571,0,0,2080,0,0,,2080,2080
39,09/22/2018,51,12:30,12:45,389.17,,0,389.17,389.17,1,-138657,46220,184877,-92437,0,0,21995,0,0,,21995,21995
39,09/22/2018,52,12:45,13:00,389.17,,0,389.17,389.17,1,-133003,57729,190732,-75274,0,0,31280,0,0,,31280,31280
39,09/22/2018,53,13:00,13:15,59.03,,0,59.03,59.03,1,-116711,75183,191894,-41528,0,0,1284,0,0,,1284,1284
39,09/22/2018,54,13:15,13:30,,,0,50.6,50.6,0,-94468,77723,172191,-16745,0,0,16,0,0,,16,16
39,09/22/2018,55,13:30,13:45,55.03,,0,55.03,55.03,1,-117078,59766,176844,-57312,0,0,14,0,0,,14,14
39,09/22/2018,56,13:45,14:00,59.03,,0,59.03,59.03,1,-147717,53465,201182,-94252,0,0,4829,0,0,,4829,4829
39,09/22/2018,57,14:00,14:15,389.17,,0,389.17,389.17,1,-143507,50463,193970,-93044,0,0,36798,0,0,,36798,36798
39,09/22/2018,58,14:15,14:30,389.17,,0,389.17,389.17,1,-133616,53486,187102,-80130,0,0,67985,0,0,,67985,67985
39,09/22/2018,59,14:30,14:45,78.29,,0,78.29,78.29,1,-137184,65568,202752,-71616,0,0,60561,0,0,,60561,60561
39,09/22/2018,60,14:45,15:00,78.29,,0,78.29,78.29,1,-153130,61422,214552,-91708,0,0,50131,0,0,,50131,50131
39,09/22/2018,61,15:00,15:15,128.29,,0,128.29,128.29,1,-119763,57746,177509,-62017,0,0,56518,0,0,,56518,56518
39,09/22/2018,62,15:15,15:30,78.29,,0,78.29,78.29,1,-106784,62570,169354,-44214,0,0,45448,0,0,,45448,45448
39,09/22/2018,63,15:30,15:45,128.29,,0,128.29,128.29,1,-117154,53226,170380,-63928,0,0,48405,0,0,,48405,48405
39,09/22/2018,64,15:45,16:00,92.17,,0,92.17,92.17,1,-138407,68866,207273,-69541,0,0,59179,0,0,,59179,59179
39,09/22/2018,65,16:00,16:15,78.29,,0,78.29,78.29,1,-111010,65657,176667,-45353,0,0,44979,0,0,,44979,44979
39,09/22/2018,66,16:15,16:30,78.29,,0,78.29,78.29,1,-105943,72798,178741,-33145,0,0,37018,0,0,,37018,37018
39,09/22/2018,67,16:30,16:45,78.29,,0,78.29,78.29,1,-115029,71283,186312,-43746,0,0,31027,0,0,,31027,31027
39,09/22/2018,68,16:45,17:00,128.29,,0,128.29,128.29,1,-124965,66812,191777,-58153,0,0,51223,0,0,,51223,51223
39,09/22/2018,69,17:00,17:15,82.12,,0,82.12,82.12,1,-96217,31249,127466,-64968,0,0,55048,0,0,,55048,55048
39,09/22/2018,70,17:15,17:30,109.12,,0,109.12,109.12,1,-127746,53610,181356,-74136,0,0,65838,0,0,,65838,65838
39,09/22/2018,71,17:30,17:45,350.12,,0,350.12,350.12,1,-132091,71687,203778,-60404,0,0,68599,0,0,,68599,68599
39,09/22/2018,72,17:45,18:00,350.12,51.03,0,51.03,51.03,-1,-119225,141517,260742,22292,0,-6,18786,0,0,,18792,18780
39,09/22/2018,73,18:00,18:15,,-21.71,0,-21.71,-21.71,-1,-56293,112017,168310,55724,0,-25968,0,0,0,,25968,-25968
39,09/22/2018,74,18:15,18:30,,46.78,0,46.78,46.78,-1,-62510,81777,144287,19267,0,-30698,0,0,0,,30698,-30698
39,09/22/2018,75,18:30,18:45,,47.03,0,47.03,47.03,-1,-58790,81285,140075,22495,0,-13054,0,0,0,,13054,-13054
39,09/22/2018,76,18:45,19:00,,46,0,46,46,-1,-64844,91622,156466,26778,0,-29725,0,0,0,,29725,-29725
39,09/22/2018,77,19:00,19:15,,49.7,0,49.7,49.7,-1,-57235,79492,136727,22257,0,-23119,0,0,0,,23119,-23119
39,09/22/2018,78,19:15,19:30,,50.78,0,50.78,50.78,-1,-56956,82615,139571,25659,0,-22729,0,0,0,,22729,-22729
39,09/22/2018,79,19:30,19:45,,47.15,0,47.15,47.15,-1,-53784,77387,131171,23603,0,-25723,0,0,0,,25723,-25723
39,09/22/2018,80,19:45,20:00,,51.89,0,51.89,51.89,-1,-64851,78171,143022,13320,0,-9781,0,0,0,,9781,-9781
39,09/22/2018,81,20:00,20:15,,52.31,0,52.31,52.31,-1,-64192,81334,145526,17142,0,-2758,0,0,0,,2758,-2758
39,09/22/2018,82,20:15,20:30,,47.15,0,47.15,47.15,-1,-67722,113690,181412,45968,0,-8385,0,0,0,,8385,-8385
39,09/22/2018,83,20:30,20:45,,43.22,0,43.22,43.22,-1,-67836,110504,178340,42668,0,-38074,0,0,0,,38074,-38074
39,09/22/2018,84,20:45,21:00,,43.85,0,43.85,43.85,-1,-70055,113530,183585,43475,0,-48810,0,0,0,,48810,-48810
39,09/22/2018,85,21:00,21:15,,39.8,0,39.8,39.8,-1,-65204,133174,198378,67970,0,-54762,0,0,0,,54762,-54762
39,09/22/2018,86,21:15,21:30,,35,0,35,35,-1,-61195,125973,187168,64778,0,-69202,0,0,0,,69202,-69202
39,09/22/2018,87,21:30,21:45,,43.22,0,43.22,43.22,-1,-66810,132072,198882,65262,0,-60379,0,0,0,,60379,-60379
39,09/22/2018,88,21:45,22:00,,29.45,0,29.45,29.45,-1,-57336,130882,188218,73546,0,-67268,0,0,0,,67268,-67268
39,09/22/2018,89,22:00,22:15,,29.45,0,29.45,29.45,-1,-69151,118208,187359,49057,0,-60815,0,0,0,,60815,-60815
39,09/22/2018,90,22:15,22:30,,43.85,0,43.85,43.85,-1,-77399,120305,197704,42906,0,-37548,0,0,0,,37548,-37548
39,09/22/2018,91,22:30,22:45,,43.22,0,43.22,43.22,-1,-76539,131763,208302,55224,0,-51347,0,0,0,,51347,-51347
39,09/22/2018,92,22:45,23:00,,43.85,0,43.85,43.85,-1,-79310,138031,217341,58721,0,-50771,0,0,0,,50771,-50771
39,09/22/2018,93,23:00,23:15,64.52,47.03,0,64.52,64.52,1,-95999,82115,178114,-13884,0,-29230,2365,0,0,,31595,-26865
39,09/22/2018,94,23:15,23:30,64.52,51.03,0,51.03,51.03,-1,-84671,92149,176820,7478,0,-2212,835,0,0,,3047,-1377
39,09/22/2018,95,23:30,23:45,,47.03,0,47.03,47.03,-1,-81986,116231,198217,34245,0,-23857,0,0,0,,23857,-23857
39,09/22/2018,96,23:45,0:00,,47.15,0,47.15,47.15,-1,-90028,120519,210547,30491,0,-29942,0,0,0,,29942,-29942
39,09/23/2018,1,0:00,0:15,,43.36,0,43.36,43.36,-1,-30156,118743,148899,88587,0,-16952,0,0,0,,16952,-16952
39,09/23/2018,2,0:15,0:30,,,0,49.32,49.32,0,-13208,93150,106358,79942,0,-136,0,0,0,,136,-136
39,09/23/2018,3,0:30,0:45,,51.17,0,51.17,51.17,-1,-46948,96087,143035,49139,0,-101,0,0,0,,101,-101
39,09/23/2018,4,0:45,1:00,,47.15,0,47.15,47.15,-1,-48202,106231,154433,58029,0,-12053,0,0,0,,12053,-12053
39,09/23/2018,5,1:00,1:15,,28.42,0,28.42,28.42,-1,-33755,131136,164891,97381,0,-25145,0,0,0,,25145,-25145
39,09/23/2018,6,1:15,1:30,,-21.58,0,-21.58,-21.58,-1,-26432,82150,108582,55718,0,-37592,0,0,0,,37592,-37592
39,09/23/2018,7,1:30,1:45,55.17,40.59,0,55.17,55.17,1,-53376,54026,107402,650,0,-18651,179,0,0,,18830,-18472
39,09/23/2018,8,1:45,2:00,58.42,47.17,0,58.42,47.17,2,-89472,41963,131435,-47509,0,-92,364,0,0,,456,272
39,09/23/2018,9,2:00,2:15,,43.36,0,43.36,43.36,-1,-9348,119819,129167,110471,0,-2344,0,0,0,,2344,-2344
39,09/23/2018,10,2:15,2:30,,38.57,0,38.57,38.57,-1,-15781,45526,61307,29745,0,-8906,0,0,0,,8906,-8906
39,09/23/2018,11,2:30,2:45,,15.03,0,15.03,15.03,-1,-14471,55454,69925,40983,0,-24658,0,0,0,,24658,-24658
39,09/23/2018,12,2:45,3:00,,35.03,0,35.03,35.03,-1,-37929,59255,97184,21326,0,-41013,0,0,0,,41013,-41013
39,09/23/2018,13,3:00,3:15,,36.12,0,36.12,36.12,-1,-14761,78008,92769,63247,0,-21024,0,0,0,,21024,-21024
39,09/23/2018,14,3:15,3:30,,,0,46.08,46.08,0,-17056,52079,69135,35023,0,-135,0,0,0,,135,-135
39,09/23/2018,15,3:30,3:45,,43.36,0,43.36,43.36,-1,-17220,58487,75707,41267,0,-363,0,0,0,,363,-363
39,09/23/2018,16,3:45,4:00,,28.42,0,28.42,28.42,-1,-38724,63482,102206,24758,0,-19693,0,0,0,,19693,-19693
39,09/23/2018,17,4:00,4:15,,-150.03,0,-150.03,-150.03,-1,-11270,95586,106856,84316,0,-48495,0,0,0,,48495,-48495
39,09/23/2018,18,4:15,4:30,,28.42,0,28.42,28.42,-1,-23971,64894,88865,40923,0,-55288,0,0,0,,55288,-55288
39,09/23/2018,19,4:30,4:45,,39.36,0,39.36,39.36,-1,-25092,53513,78605,28421,0,-28512,0,0,0,,28512,-28512
39,09/23/2018,20,4:45,5:00,,43.36,0,43.36,43.36,-1,-18087,53404,71491,35317,0,-5956,0,0,0,,5956,-5956
39,09/23/2018,21,5:00,5:15,,-150.03,0,-150.03,-150.03,-1,-18462,124638,143100,106176,0,-33517,0,0,0,,33517,-33517
39,09/23/2018,22,5:15,5:30,,-150.03,0,-150.03,-150.03,-1,-28583,103524,132107,74941,0,-61980,0,0,0,,61980,-61980
39,09/23/2018,23,5:30,5:45,,43.36,0,43.36,43.36,-1,-25539,84223,109762,58684,0,-21277,0,0,0,,21277,-21277
39,09/23/2018,24,5:45,6:00,,35.03,0,35.03,35.03,-1,-19479,106037,125516,86558,0,-10042,0,0,0,,10042,-10042
39,09/23/2018,25,6:00,6:15,,28.45,0,28.45,28.45,-1,-23481,78283,101764,54802,0,-27672,0,0,0,,27672,-27672
39,09/23/2018,26,6:15,6:30,,28.45,0,28.45,28.45,-1,-21363,95585,116948,74222,0,-13869,0,0,0,,13869,-13869
39,09/23/2018,27,6:30,6:45,,-150.03,0,-150.03,-150.03,-1,-23687,82167,105854,58480,0,-36113,0,0,0,,36113,-36113
39,09/23/2018,28,6:45,7:00,,,0,46.12,46.12,0,-25400,85785,111185,60385,0,-4115,0,0,0,,4115,-4115
39,09/23/2018,29,7:00,7:15,,,0,47.09,47.09,0,-64484,69996,134480,5512,0,0,0,0,0,,0,0
39,09/23/2018,30,7:15,7:30,,-150.03,0,-150.03,-150.03,-1,-30820,88976,119796,58156,0,-15608,0,0,0,,15608,-15608
39,09/23/2018,31,7:30,7:45,,-150.03,0,-150.03,-150.03,-1,-33945,76021,109966,42076,0,-36891,0,0,0,,36891,-36891
39,09/23/2018,32,7:45,8:00,,,0,46.06,46.06,0,-38567,82979,121546,44412,0,-1064,0,0,0,,1064,-1064
39,09/23/2018,33,8:00,8:15,,39.1,0,39.1,39.1,-1,-28993,54943,83936,25950,0,-10124,0,0,0,,10124,-10124
39,09/23/2018,34,8:15,8:30,,51.2,0,51.2,51.2,-1,-30912,49753,80665,18841,0,-2939,0,0,0,,2939,-2939
39,09/23/2018,35,8:30,8:45,56.64,,0,56.64,56.64,1,-46200,33123,79323,-13077,0,0,508,0,0,,508,508
39,09/23/2018,36,8:45,9:00,63.39,,0,63.39,63.39,1,-63008,30813,93821,-32195,0,0,16186,0,0,,16186,16186
39,09/23/2018,37,9:00,9:15,55.2,47.2,0,47.2,47.2,-1,-40429,79290,119719,38861,0,-339,7466,0,0,,7805,7127
39,09/23/2018,38,9:15,9:30,,,0,49.03,49.03,0,-44471,65028,109499,20557,0,0,0,0,0,,0,0
39,09/23/2018,39,9:30,9:45,59.2,,0,59.2,59.2,1,-60465,50158,110623,-10307,0,0,714,0,0,,714,714
39,09/23/2018,40,9:45,10:00,78.45,,0,78.45,78.45,1,-75528,25479,101007,-50049,0,0,26084,0,0,,26084,26084
39,09/23/2018,41,10:00,10:15,58.03,51.2,0,51.2,51.2,-1,-47170,52198,99368,5028,0,-18,9527,0,0,,9545,9509
39,09/23/2018,42,10:15,10:30,63.39,51.2,0,63.39,49.03,2,-50038,29805,79843,-20233,0,-456,941,0,0,,1397,485
39,09/23/2018,43,10:30,10:45,78.45,,0,78.45,78.45,1,-76328,22092,98420,-54236,0,0,24444,0,0,,24444,24444
39,09/23/2018,44,10:45,11:00,63.39,,0,63.39,63.39,1,-88442,21919,110361,-66523,0,0,32527,0,0,,32527,32527
39,09/23/2018,45,11:00,11:15,62.67,,0,62.67,62.67,1,-78654,60907,139561,-17747,0,0,25651,0,0,,25651,25651
39,09/23/2018,46,11:15,11:30,63.39,,0,63.39,63.39,1,-84006,48965,132971,-35041,0,0,21856,0,0,,21856,21856
39,09/23/2018,47,11:30,11:45,63.39,,0,63.39,63.39,1,-78612,33137,111749,-45475,0,0,28859,0,0,,28859,28859
39,09/23/2018,48,11:45,12:00,63.39,,0,63.39,63.39,1,-82947,27673,110620,-55274,0,0,33231,0,0,,33231,33231
39,09/23/2018,49,12:00,12:15,450,,0,450,450,1,-107954,46952,154906,-61002,0,0,55471,0,0,,55471,55471
39,09/23/2018,50,12:15,12:30,59.41,,0,59.41,59.41,1,-95302,71938,167240,-23364,0,0,22348,0,0,,22348,22348
39,09/23/2018,51,12:30,12:45,59.2,,0,59.2,59.2,1,-90535,64525,155060,-26010,0,0,12380,0,0,,12380,12380
39,09/23/2018,52,12:45,13:00,59.41,,0,59.41,59.41,1,-83632,58317,141949,-25315,0,0,6755,0,0,,6755,6755
39,09/23/2018,53,13:00,13:15,101.02,,0,101.02,101.02,1,-110922,55876,166798,-55046,0,0,33708,0,0,,33708,33708
39,09/23/2018,54,13:15,13:30,63.39,,0,63.39,63.39,1,-105475,60464,165939,-45011,0,0,32398,0,0,,32398,32398
39,09/23/2018,55,13:30,13:45,63.39,43.39,0,43.39,43.39,-1,-83012,84239,167251,1227,0,-290,3891,0,0,,4181,3601
39,09/23/2018,56,13:45,14:00,,43.39,0,43.39,43.39,-1,-72588,116639,189227,44051,0,-834,0,0,0,,834,-834
39,09/23/2018,57,14:00,14:15,,47.2,0,47.2,47.2,-1,-68641,161091,229732,92450,0,-1390,0,0,0,,1390,-1390
39,09/23/2018,58,14:15,14:30,,,0,48.11,48.11,0,-66560,119097,185657,52537,0,-15,0,0,0,,15,-15
39,09/23/2018,59,14:30,14:45,,28.45,0,28.45,28.45,-1,-60748,130054,190802,69306,0,-3655,0,0,0,,3655,-3655
39,09/23/2018,60,14:45,15:00,,28.45,0,28.45,28.45,-1,-56829,152326,209155,95497,0,-11547,0,0,0,,11547,-11547
39,09/23/2018,61,15:00,15:15,,-47.13,0,-47.13,-47.13,-1,-48070,192121,240191,144051,0,-31019,0,0,0,,31019,-31019
39,09/23/2018,62,15:15,15:30,,-150.03,0,-150.03,-150.03,-1,-45800,199455,245255,153655,0,-37448,0,0,0,,37448,-37448
39,09/23/2018,63,15:30,15:45,,-150.03,0,-150.03,-150.03,-1,-58751,150507,209258,91756,0,-41880,0,0,0,,41880,-41880
39,09/23/2018,64,15:45,16:00,,-150.03,0,-150.03,-150.03,-1,-60662,168334,228996,107672,0,-35077,0,0,0,,35077,-35077
39,09/23/2018,65,16:00,16:15,,11.03,0,11.03,11.03,-1,-49635,117322,166957,67687,0,-31197,0,0,0,,31197,-31197
39,09/23/2018,66,16:15,16:30,,43.39,0,43.39,43.39,-1,-37495,139090,176585,101595,0,-942,0,0,0,,942,-942
39,09/23/2018,67,16:30,16:45,,40.37,0,40.37,40.37,-1,-32184,153481,185665,121297,0,-10675,0,0,0,,10675,-10675
39,09/23/2018,68,16:45,17:00,,47.2,0,47.2,47.2,-1,-43588,126788,170376,83200,0,-7946,0,0,0,,7946,-7946
39,09/23/2018,69,17:00,17:15,55.2,47.2,0,55.2,55.2,1,-82866,50659,133525,-32207,0,-38,1178,0,0,,1216,1140
39,09/23/2018,70,17:15,17:30,55.2,,0,55.2,55.2,1,-79472,96336,175808,16864,0,0,1560,0,0,,1560,1560
39,09/23/2018,71,17:30,17:45,59.2,,0,59.2,59.2,1,-83510,85333,168843,1823,0,0,942,0,0,,942,942
39,09/23/2018,72,17:45,18:00,59.2,36.67,0,59.2,36.67,2,-98274,138057,236331,39783,0,-2014,5128,0,0,,7142,3114
39,09/23/2018,73,18:00,18:15,145.02,36.67,0,145.02,145.02,1,-180954,22792,203746,-158162,0,-27,36125,0,0,,36152,36098
39,09/23/2018,74,18:15,18:30,56.02,51.2,0,56.02,49.03,2,-67353,67866,135219,513,0,-25,23352,0,0,,23377,23327
39,09/23/2018,75,18:30,18:45,,,0,48.87,48.87,0,-54502,111659,166161,57157,0,0,0,0,0,,0,0
39,09/23/2018,76,18:45,19:00,,,0,48.89,48.89,0,-48858,137550,186408,88692,0,0,0,0,0,,0,0
39,09/23/2018,77,19:00,19:15,55.2,,0,55.2,55.2,1,-96768,73960,170728,-22808,0,0,658,0,0,,658,658
39,09/23/2018,78,19:15,19:30,55.2,,0,55.2,55.2,1,-60717,69711,130428,8994,0,0,1498,0,0,,1498,1498
39,09/23/2018,79,19:30,19:45,55.2,,0,55.2,55.2,1,-70725,81713,152438,10988,0,0,1278,0,0,,1278,1278
39,09/23/2018,80,19:45,20:00,59.3,,0,59.3,59.3,1,-96804,82923,179727,-13881,0,0,2867,0,0,,2867,2867
39,09/23/2018,81,20:00,20:15,71.64,,0,71.64,71.64,1,-103772,83528,187300,-20244,0,0,9117,0,0,,9117,9117
39,09/23/2018,82,20:15,20:30,61.64,51.2,0,61.64,49.03,2,-76881,73877,150758,-3004,0,-71,3601,0,0,,3672,3530
39,09/23/2018,83,20:30,20:45,61.64,-93.4,0,-93.4,-93.4,-1,-41810,80899,122709,39089,0,-22872,339,0,0,,23211,-22533
39,09/23/2018,84,20:45,21:00,,-27.63,0,-27.63,-27.63,-1,-27080,82035,109115,54955,0,-36410,0,0,0,,36410,-36410
39,09/23/2018,85,21:00,21:15,,27.96,0,27.96,27.96,-1,-26812,93207,120019,66395,0,-48689,0,0,0,,48689,-48689
39,09/23/2018,86,21:15,21:30,,14.38,0,14.38,14.38,-1,-20567,95988,116555,75421,0,-63362,0,0,0,,63362,-63362
39,09/23/2018,87,21:30,21:45,,36.18,0,36.18,36.18,-1,-23874,88233,112107,64359,0,-67091,0,0,0,,67091,-67091
39,09/23/2018,88,21:45,22:00,,43.03,0,43.03,43.03,-1,-24049,92208,116257,68159,0,-59838,0,0,0,,59838,-59838
39,09/23/2018,89,22:00,22:15,,42.34,0,42.34,42.34,-1,-64752,75238,139990,10486,0,-26602,0,0,0,,26602,-26602
39,09/23/2018,90,22:15,22:30,,43.39,0,43.39,43.39,-1,-33483,69154,102637,35671,0,-2370,0,0,0,,2370,-2370
39,09/23/2018,91,22:30,22:45,,43.39,0,43.39,43.39,-1,-25368,80322,105690,54954,0,-11480,0,0,0,,11480,-11480
39,09/23/2018,92,22:45,23:00,,43.39,0,43.39,43.39,-1,-16860,92446,109306,75586,0,-3107,0,0,0,,3107,-3107
39,09/23/2018,93,23:00,23:15,,23.19,0,23.19,23.19,-1,-54567,77014,131581,22447,0,-15907,0,0,0,,15907,-15907
39,09/23/2018,94,23:15,23:30,,35.4,0,35.4,35.4,-1,-31945,70636,102581,38691,0,-29617,0,0,0,,29617,-29617
39,09/23/2018,95,23:30,23:45,,40.48,0,40.48,40.48,-1,-31475,68958,100433,37483,0,-41450,0,0,0,,41450,-41450
39,09/23/2018,96,23:45,0:00,,41.24,0,41.24,41.24,-1,-44956,78693,123649,33737,0,-42117,0,0,0,,42117,-42117
39,09/24/2018,1,0:00,0:15,,-6.65,0,-6.65,-6.65,-1,-48452,82257,130709,33805,0,-39878,0,0,0,,39878,-39878
39,09/24/2018,2,0:15,0:30,55.2,43.39,0,55.2,43.39,2,-61238,58939,120177,-2299,0,-7553,730,0,0,,8283,-6823
39,09/24/2018,3,0:30,0:45,,39.15,0,39.15,39.15,-1,-48744,68913,117657,20169,0,-10309,0,0,0,,10309,-10309
39,09/24/2018,4,0:45,1:00,,38.7,0,38.7,38.7,-1,-53157,76080,129237,22923,0,-24490,0,0,0,,24490,-24490
39,09/24/2018,5,1:00,1:15,,43.39,0,43.39,43.39,-1,-52569,72422,124991,19853,0,-22178,0,0,0,,22178,-22178
39,09/24/2018,6,1:15,1:30,,28.45,0,28.45,28.45,-1,-35460,92533,127993,57073,0,-19596,0,0,0,,19596,-19596
39,09/24/2018,7,1:30,1:45,,-10.97,0,-10.97,-10.97,-1,-50106,69027,119133,18921,0,-29843,0,0,0,,29843,-29843
39,09/24/2018,8,1:45,2:00,,38.14,0,38.14,38.14,-1,-51057,73102,124159,22045,0,-9832,0,0,0,,9832,-9832
39,09/24/2018,9,2:00,2:15,,28.45,0,28.45,28.45,-1,-38760,65276,104036,26516,0,-26891,0,0,0,,26891,-26891
39,09/24/2018,10,2:15,2:30,,36.74,0,36.74,36.74,-1,-41276,64556,105832,23280,0,-10154,0,0,0,,10154,-10154
39,09/24/2018,11,2:30,2:45,,28.45,0,28.45,28.45,-1,-29188,59509,88697,30321,0,-36759,0,0,0,,36759,-36759
39,09/24/2018,12,2:45,3:00,56.78,43.39,0,56.78,43.39,2,-67449,63689,131138,-3760,0,-11149,973,0,0,,12122,-10176
39,09/24/2018,13,3:00,3:15,60.71,,0,60.71,60.71,1,-74501,45958,120459,-28543,0,0,9908,0,0,,9908,9908
39,09/24/2018,14,3:15,3:30,67.85,,0,67.85,67.85,1,-80810,38738,119548,-42072,0,0,31602,0,0,,31602,31602
39,09/24/2018,15,3:30,3:45,59.2,,0,59.2,59.2,1,-60862,41411,102273,-19451,0,0,21251,0,0,,21251,21251
39,09/24/2018,16,3:45,4:00,53.05,47.2,0,47.2,47.2,-1,-54132,54753,108885,621,0,-251,4856,0,0,,5107,4605
39,09/24/2018,17,4:00,4:15,53.05,35.97,0,35.97,35.97,-1,-43488,64811,108299,21323,0,-14196,81,0,0,,14277,-14115
39,09/24/2018,18,4:15,4:30,,36.75,0,36.75,36.75,-1,-28836,60343,89179,31507,0,-22593,0,0,0,,22593,-22593
39,09/24/2018,19,4:30,4:45,63.24,43.39,0,63.24,63.24,1,-47509,30694,78203,-16815,0,-13793,2011,0,0,,15804,-11782
39,09/24/2018,20,4:45,5:00,73.24,43.39,0,73.24,73.24,1,-70232,32754,102986,-37478,0,-212,22749,0,0,,22961,22537
39,09/24/2018,21,5:00,5:15,59.2,43.39,0,59.2,43.39,2,-63187,61919,125106,-1268,0,-213,17212,0,0,,17425,16999
39,09/24/2018,22,5:15,5:30,59.2,37.85,0,37.85,37.85,-1,-38646,46802,85448,8156,0,-4901,705,0,0,,5606,-4196
39,09/24/2018,23,5:30,5:45,,47.2,0,47.2,47.2,-1,-37316,47380,84696,10064,0,-5904,0,0,0,,5904,-5904
39,09/24/2018,24,5:45,6:00,,28.45,0,28.45,28.45,-1,-56055,91047,147102,34992,0,-15010,0,0,0,,15010,-15010
39,09/24/2018,25,6:00,6:15,,35,0,35,35,-1,-55055,85015,140070,29960,0,-38187,0,0,0,,38187,-38187
39,09/24/2018,26,6:15,6:30,,46.06,0,46.06,46.06,-1,-39431,74432,113863,35001,0,-30024,0,0,0,,30024,-30024
39,09/24/2018,27,6:30,6:45,63.45,43.6,0,63.45,63.45,1,-42195,40135,82330,-2060,0,-25003,293,0,0,,25296,-24710
39,09/24/2018,28,6:45,7:00,145.12,43.6,0,145.12,145.12,1,-118123,35884,154007,-82239,0,-1959,45663,0,0,,47622,43704
39,09/24/2018,29,7:00,7:15,78.66,43.6,0,43.6,43.6,-1,-39972,85203,125175,45231,0,-3333,24516,0,0,,27849,21183
39,09/24/2018,30,7:15,7:30,,47.41,0,47.41,47.41,-1,-55029,90718,145747,35689,0,-9881,0,0,0,,9881,-9881
39,09/24/2018,31,7:30,7:45,55.38,51.26,0,55.38,51.26,2,-47015,55944,102959,8929,0,-3990,235,0,0,,4225,-3755
39,09/24/2018,32,7:45,8:00,59.41,51.26,0,59.41,59.41,1,-54967,72560,127527,17593,0,-106,3364,0,0,,3470,3258
39,09/24/2018,33,8:00,8:15,53.32,43.6,0,43.6,43.6,-1,-65871,103786,169657,37915,0,-6693,104,0,0,,6797,-6589
39,09/24/2018,34,8:15,8:30,53.3,31.49,0,53.3,31.49,2,-77557,89985,167542,12428,0,-22774,43,0,0,,22817,-22731
39,09/24/2018,35,8:30,8:45,55.28,52.67,0,55.28,52.67,2,-70364,72038,142402,1674,0,-798,978,0,0,,1776,180
39,09/24/2018,36,8:45,9:00,62.48,,0,62.48,62.48,1,-64730,50380,115110,-14350,0,0,6168,0,0,,6168,6168
39,09/24/2018,37,9:00,9:15,78.66,,0,78.66,78.66,1,-76274,40964,117238,-35310,0,0,27366,0,0,,27366,27366
39,09/24/2018,38,9:15,9:30,54.24,28.66,0,28.66,28.66,-1,-39178,57335,96513,18157,0,-3910,10718,0,0,,14628,6808
39,09/24/2018,39,9:30,9:45,54.24,-65.48,0,-65.48,-65.48,-1,-13839,89255,103094,75416,0,-51062,25,0,0,,51087,-51037
39,09/24/2018,40,9:45,10:00,,-123.96,0,-123.96,-123.96,-1,-26055,67378,93433,41323,0,-64570,0,0,0,,64570,-64570
39,09/24/2018,41,10:00,10:15,,43.6,0,43.6,43.6,-1,-53167,79100,132267,25933,0,-11792,0,0,0,,11792,-11792
39,09/24/2018,42,10:15,10:30,,28.66,0,28.66,28.66,-1,-22757,76327,99084,53570,0,-43904,0,0,0,,43904,-43904
39,09/24/2018,43,10:30,10:45,,28.66,0,28.66,28.66,-1,-27297,95685,122982,68388,0,-58407,0,0,0,,58407,-58407
39,09/24/2018,44,10:45,11:00,,28.66,0,28.66,28.66,-1,-27141,114701,141842,87560,0,-70356,0,0,0,,70356,-70356
39,09/24/2018,45,11:00,11:15,,40.78,0,40.78,40.78,-1,-54967,85523,140490,30556,0,-35822,0,0,0,,35822,-35822
39,09/24/2018,46,11:15,11:30,,39.71,0,39.71,39.71,-1,-30372,105960,136332,75588,0,-22253,0,0,0,,22253,-22253
39,09/24/2018,47,11:30,11:45,,-0.34,0,-0.34,-0.34,-1,-31560,101489,133049,69929,0,-41230,0,0,0,,41230,-41230
39,09/24/2018,48,11:45,12:00,,-20.1,0,-20.1,-20.1,-1,-51118,111478,162596,60360,0,-63809,0,0,0,,63809,-63809
39,09/24/2018,49,12:00,12:15,,43.6,0,43.6,43.6,-1,-25158,150928,176086,125770,0,-39917,0,0,0,,39917,-39917
39,09/24/2018,50,12:15,12:30,,25.72,0,25.72,25.72,-1,-26972,154113,181085,127141,0,-44409,0,0,0,,44409,-44409
39,09/24/2018,51,12:30,12:45,,-6.62,0,-6.62,-6.62,-1,-25599,163960,189559,138361,0,-50118,0,0,0,,50118,-50118
39,09/24/2018,52,12:45,13:00,,28.66,0,28.66,28.66,-1,-26109,152860,178969,126751,0,-39420,0,0,0,,39420,-39420
39,09/24/2018,53,13:00,13:15,,11.74,0,11.74,11.74,-1,-37533,141508,179041,103975,0,-48131,0,0,0,,48131,-48131
39,09/24/2018,54,13:15,13:30,,43.6,0,43.6,43.6,-1,-41100,132111,173211,91011,0,-38792,0,0,0,,38792,-38792
39,09/24/2018,55,13:30,13:45,,28.66,0,28.66,28.66,-1,-38108,113876,151984,75768,0,-53862,0,0,0,,53862,-53862
39,09/24/2018,56,13:45,14:00,,12.52,0,12.52,12.52,-1,-38490,120897,159387,82407,0,-35703,0,0,0,,35703,-35703
39,09/24/2018,57,14:00,14:15,,-54.47,0,-54.47,-54.47,-1,-47291,138593,185884,91302,0,-58575,0,0,0,,58575,-58575
39,09/24/2018,58,14:15,14:30,,-54.47,0,-54.47,-54.47,-1,-58556,118286,176842,59730,0,-59165,0,0,0,,59165,-59165
39,09/24/2018,59,14:30,14:45,,-18.89,0,-18.89,-18.89,-1,-70953,133258,204211,62305,0,-55812,0,0,0,,55812,-55812
39,09/24/2018,60,14:45,15:00,,-24.91,0,-24.91,-24.91,-1,-59435,137070,196505,77635,0,-56396,0,0,0,,56396,-56396
39,09/24/2018,61,15:00,15:15,,-20.09,0,-20.09,-20.09,-1,-79084,134622,213706,55538,0,-61798,0,0,0,,61798,-61798
39,09/24/2018,62,15:15,15:30,,28.22,0,28.22,28.22,-1,-54672,128527,183199,73855,0,-50614,0,0,0,,50614,-50614
39,09/24/2018,63,15:30,15:45,,24.94,0,24.94,24.94,-1,-54566,122464,177030,67898,0,-52625,0,0,0,,52625,-52625
39,09/24/2018,64,15:45,16:00,,33.12,0,33.12,33.12,-1,-79933,130407,210340,50474,0,-31664,0,0,0,,31664,-31664
39,09/24/2018,65,16:00,16:15,,-53,0,-53,-53,-1,-68791,149994,218785,81203,0,-56366,0,0,0,,56366,-56366
39,09/24/2018,66,16:15,16:30,,20.77,0,20.77,20.77,-1,-89034,159079,248113,70045,0,-61909,0,0,0,,61909,-61909
39,09/24/2018,67,16:30,16:45,156.12,37.83,0,156.12,37.83,2,-127425,111378,238803,-16047,0,-51204,4938,0,0,,56142,-46266
39,09/24/2018,68,16:45,17:00,156.12,37.83,0,156.12,156.12,1,-194114,134171,328285,-59943,0,-6208,48424,0,0,,54632,42216
39,09/24/2018,69,17:00,17:15,156.12,-88.15,0,-88.15,-88.15,-1,-108765,193623,302388,84858,0,-27678,5182,0,0,,32860,-22496
39,09/24/2018,70,17:15,17:30,,45.88,0,45.88,45.88,-1,-127733,138440,266173,10707,0,-18942,0,0,0,,18942,-18942
39,09/24/2018,71,17:30,17:45,,50.2,0,50.2,50.2,-1,-136104,141864,277968,5760,0,-4938,0,0,0,,4938,-4938
39,09/24/2018,72,17:45,18:00,,52.64,0,52.64,52.64,-1,-157934,154944,312878,-2990,0,-1049,0,0,0,,1049,-1049
39,09/24/2018,73,18:00,18:15,,-62.14,0,-62.14,-62.14,-1,-82567,127926,210493,45359,0,-10950,0,0,0,,10950,-10950
39,09/24/2018,74,18:15,18:30,67.31,-69.16,0,67.31,-69.16,2,-74940,65057,139997,-9883,0,-27751,1809,0,0,,29560,-25942
39,09/24/2018,75,18:30,18:45,54,51.41,0,54,51.41,2,-60734,102919,163653,42185,0,-532,1119,0,0,,1651,587
39,09/24/2018,76,18:45,19:00,,47.41,0,47.41,47.41,-1,-45764,81034,126798,35270,0,-7118,0,0,0,,7118,-7118
39,09/24/2018,77,19:00,19:15,,29.45,0,29.45,29.45,-1,-71552,117334,188886,45782,0,-30923,0,0,0,,30923,-30923
39,09/24/2018,78,19:15,19:30,,49.7,0,49.7,49.7,-1,-98731,120770,219501,22039,0,-18796,0,0,0,,18796,-18796
39,09/24/2018,79,19:30,19:45,78.66,51.41,0,78.66,78.66,1,-117257,72943,190200,-44314,0,-9715,3195,0,0,,12910,-6520
39,09/24/2018,80,19:45,20:00,160.12,51.41,0,160.12,160.12,1,-190125,63817,253942,-126308,0,-50,55971,0,0,,56021,55921
39,09/24/2018,81,20:00,20:15,160.12,,0,160.12,160.12,1,-242099,82668,324767,-159431,0,0,82481,0,0,,82481,82481
39,09/24/2018,82,20:15,20:30,384.9,,0,384.9,384.9,1,-231068,112125,343193,-118943,0,0,82393,5000,0,,87393,87393
39,09/24/2018,83,20:30,20:45,384.9,52.76,0,52.76,52.76,-1,-193383,162364,355747,-31019,0,-2,53273,5000,0,,58275,58271
39,09/24/2018,84,20:45,21:00,384.9,49.7,0,49.7,49.7,-1,-177578,173273,350851,-4305,0,-2312,999,0,0,,3311,-1313
39,09/24/2018,85,21:00,21:15,,47.41,0,47.41,47.41,-1,-122220,149943,272163,27723,0,-5100,0,0,0,,5100,-5100
39,09/24/2018,86,21:15,21:30,54.24,52.73,0,54.24,52.73,2,-109961,121035,230996,11074,0,-29,92,0,0,,121,63
39,09/24/2018,87,21:30,21:45,,52.76,0,52.76,52.76,-1,-115174,128210,243384,13036,0,-154,0,0,0,,154,-154
39,09/24/2018,88,21:45,22:00,,,0,31.89,31.89,0,-126741,113496,240237,-13245,0,0,0,0,0,,0,0
39,09/24/2018,89,22:00,22:15,160.12,,0,160.12,160.12,1,-144786,66304,211090,-78482,0,0,21319,0,0,,21319,21319
39,09/24/2018,90,22:15,22:30,62.48,,0,62.48,62.48,1,-134557,72387,206944,-62170,0,0,21347,0,0,,21347,21347
39,09/24/2018,91,22:30,22:45,62.48,,0,62.48,62.48,1,-140177,107896,248073,-32281,0,0,23341,0,0,,23341,23341
39,09/24/2018,92,22:45,23:00,53.32,43.6,0,43.6,43.6,-1,-115313,141222,256535,25909,0,-5769,4446,0,0,,10215,-1323
39,09/24/2018,93,23:00,23:15,64.13,35.28,0,64.13,35.28,2,-119883,99567,219450,-20316,0,-7638,4780,0,0,,12418,-2858
39,09/24/2018,94,23:15,23:30,54.24,51.41,0,51.41,51.41,-1,-77869,82892,160761,5023,0,-900,2141,0,0,,3041,1241
39,09/24/2018,95,23:30,23:45,,29.45,0,29.45,29.45,-1,-31550,84739,116289,53189,0,-33417,0,0,0,,33417,-33417
39,09/24/2018,96,23:45,0:00,,29.45,0,29.45,29.45,-1,-35180,86342,121522,51162,0,-59175,0,0,0,,59175,-59175
39,09/25/2018,1,0:00,0:15,,49.18,0,49.18,49.18,-1,-101740,121683,223423,19943,0,-23700,0,0,0,,23700,-23700
39,09/25/2018,2,0:15,0:30,,,0,33.17,33.17,0,-78886,101497,180383,22611,0,-316,0,0,0,,316,-316
39,09/25/2018,3,0:30,0:45,,50.19,0,50.19,50.19,-1,-62390,68315,130705,5925,0,-575,0,0,0,,575,-575
39,09/25/2018,4,0:45,1:00,,49.49,0,49.49,49.49,-1,-48560,70466,119026,21906,0,-18101,0,0,0,,18101,-18101
39,09/25/2018,5,1:00,1:15,,41.75,0,41.75,41.75,-1,-40378,86546,126924,46168,0,-38044,0,0,0,,38044,-38044
39,09/25/2018,6,1:15,1:30,,42.44,0,42.44,42.44,-1,-37342,75447,112789,38105,0,-33118,0,0,0,,33118,-33118
39,09/25/2018,7,1:30,1:45,,36.87,0,36.87,36.87,-1,-17424,78699,96123,61275,0,-40489,0,0,0,,40489,-40489
39,09/25/2018,8,1:45,2:00,,42.44,0,42.44,42.44,-1,-23778,78783,102561,55005,0,-48001,0,0,0,,48001,-48001
39,09/25/2018,9,2:00,2:15,,28.66,0,28.66,28.66,-1,-16325,83854,100179,67529,0,-29015,0,0,0,,29015,-29015
39,09/25/2018,10,2:15,2:30,,,0,54.57,54.57,0,-19723,59772,79495,40049,0,-30,0,0,0,,30,-30
39,09/25/2018,11,2:30,2:45,,46.19,0,46.19,46.19,-1,-16871,52916,69787,36045,0,-6038,0,0,0,,6038,-6038
39,09/25/2018,12,2:45,3:00,,42.44,0,42.44,42.44,-1,-22713,59034,81747,36321,0,-32112,0,0,0,,32112,-32112
39,09/25/2018,13,3:00,3:15,,-150.03,0,-150.03,-150.03,-1,-15898,110104,126002,94206,0,-62286,0,0,0,,62286,-62286
39,09/25/2018,14,3:15,3:30,,36.19,0,36.19,36.19,-1,-23241,75786,99027,52545,0,-48858,0,0,0,,48858,-48858
39,09/25/2018,15,3:30,3:45,,42.44,0,42.44,42.44,-1,-26200,58635,84835,32435,0,-33470,0,0,0,,33470,-33470
39,09/25/2018,16,3:45,4:00,,42.44,0,42.44,42.44,-1,-36696,62388,99084,25692,0,-22255,0,0,0,,22255,-22255
39,09/25/2018,17,4:00,4:15,,42.44,0,42.44,42.44,-1,-26986,65221,92207,38235,0,-28224,0,0,0,,28224,-28224
39,09/25/2018,18,4:15,4:30,,42.44,0,42.44,42.44,-1,-23911,67744,91655,43833,0,-15968,0,0,0,,15968,-15968
39,09/25/2018,19,4:30,4:45,,46.19,0,46.19,46.19,-1,-28725,62804,91529,34079,0,-11042,0,0,0,,11042,-11042
39,09/25/2018,20,4:45,5:00,54.19,46.19,0,54.19,54.19,1,-26086,60948,87034,34862,0,-244,20,0,0,,264,-224
39,09/25/2018,21,5:00,5:15,56.85,52.02,0,56.85,52.02,2,-71455,43915,115370,-27540,0,-243,1318,0,0,,1561,1075
39,09/25/2018,22,5:15,5:30,,50.19,0,50.19,50.19,-1,-29239,52596,81835,23357,0,-9335,0,0,0,,9335,-9335
39,09/25/2018,23,5:30,5:45,,42.44,0,42.44,42.44,-1,-22633,66184,88817,43551,0,-20628,0,0,0,,20628,-20628
39,09/25/2018,24,5:45,6:00,54.19,46.19,0,54.19,54.19,1,-42895,96036,138931,53141,0,-19118,97,0,0,,19215,-19021
39,09/25/2018,25,6:00,6:15,64.07,46.19,0,64.07,64.07,1,-117833,58223,176056,-59610,0,-341,4738,0,0,,5079,4397
39,09/25/2018,26,6:15,6:30,64.07,51.82,0,51.82,51.82,-1,-50324,66330,116654,16006,0,-4974,289,0,0,,5263,-4685
39,09/25/2018,27,6:30,6:45,59.82,53.7,0,59.82,59.82,1,-51610,34737,86347,-16873,0,-3508,2059,0,0,,5567,-1449
39,09/25/2018,28,6:45,7:00,59.82,,0,59.82,59.82,1,-86017,63518,149535,-22499,0,0,14889,0,0,,14889,14889
39,09/25/2018,29,7:00,7:15,55.82,38.69,0,56.14,38.69,2,-51170,88614,139784,37444,0,-8839,6670,0,0,,15509,-2169
39,09/25/2018,30,7:15,7:30,,55.58,0,55.58,55.58,-1,-56352,61503,117855,5151,0,-3359,0,0,0,,3359,-3359
39,09/25/2018,31,7:30,7:45,450,55.58,0,450,450,1,-132296,40396,172692,-91900,0,-11,17718,0,0,,17729,17707
39,09/25/2018,32,7:45,8:00,450,,0,495,495,1,-180078,62342,242420,-117736,0,0,73059,5000,13334,,91393,91393
39,09/25/2018,33,8:00,8:15,414.54,53.39,0,455.99,53.39,2,-100989,118366,219355,17377,0,-508,15735,5000,13334,,34577,33561
39,09/25/2018,34,8:15,8:30,,55.68,0,55.68,55.68,-1,-127418,136185,263603,8767,0,-173,0,0,0,,173,-173
39,09/25/2018,35,8:30,8:45,,54.53,0,54.53,54.53,-1,-118478,105549,224027,-12929,0,-1078,0,0,0,,1078,-1078
39,09/25/2018,36,8:45,9:00,61,,0,61,61,1,-121227,87321,208548,-33906,0,0,79,0,0,,79,79
39,09/25/2018,37,9:00,9:15,61.36,54.26,0,54.26,54.26,-1,-58842,70405,129247,11563,0,-91,138,0,0,,229,47
39,09/25/2018,38,9:15,9:30,,44.07,0,44.07,44.07,-1,-57336,90596,147932,33260,0,-20618,0,0,0,,20618,-20618
39,09/25/2018,39,9:30,9:45,,44.07,0,44.07,44.07,-1,-59882,120151,180033,60269,0,-29420,0,0,0,,29420,-29420
39,09/25/2018,40,9:45,10:00,,-47.49,0,-47.49,-47.49,-1,-53652,141966,195618,88314,0,-64029,0,0,0,,64029,-64029
39,09/25/2018,41,10:00,10:15,,51.82,0,51.82,51.82,-1,-95224,118344,213568,23120,0,-20117,0,0,0,,20117,-20117
39,09/25/2018,42,10:15,10:30,,28.26,0,28.26,28.26,-1,-72813,161454,234267,88641,0,-30983,0,0,0,,30983,-30983
39,09/25/2018,43,10:30,10:45,,20.03,0,20.03,20.03,-1,-62504,179575,242079,117071,0,-65944,0,0,0,,65944,-65944
39,09/25/2018,44,10:45,11:00,,-3.38,0,-3.38,-3.38,-1,-68078,184693,252771,116615,0,-94904,0,0,0,,94904,-94904
39,09/25/2018,45,11:00,11:15,,51.82,0,51.82,51.82,-1,-86064,97728,183792,11664,0,-26037,0,0,0,,26037,-26037
39,09/25/2018,46,11:15,11:30,,30.34,0,30.34,30.34,-1,-75333,140584,215917,65251,0,-37054,0,0,0,,37054,-37054
39,09/25/2018,47,11:30,11:45,,27.49,0,27.49,27.49,-1,-78813,160684,239497,81871,0,-54939,0,0,0,,54939,-54939
39,09/25/2018,48,11:45,12:00,,5.85,0,5.85,5.85,-1,-81364,151833,233197,70469,0,-68607,0,0,0,,68607,-68607
39,09/25/2018,49,12:00,12:15,,30.34,0,30.34,30.34,-1,-85322,99550,184872,14228,0,-40410,0,0,0,,40410,-40410
39,09/25/2018,50,12:15,12:30,,42.27,0,42.27,42.27,-1,-51979,96871,148850,44892,0,-27497,0,0,0,,27497,-27497
39,09/25/2018,51,12:30,12:45,,36.8,0,36.8,36.8,-1,-47036,113496,160532,66460,0,-56692,0,0,0,,56692,-56692
39,09/25/2018,52,12:45,13:00,,44.07,0,44.07,44.07,-1,-52672,91181,143853,38509,0,-50949,0,0,0,,50949,-50949
39,09/25/2018,53,13:00,13:15,,50.04,0,50.04,50.04,-1,-56520,98151,154671,41631,0,-28401,0,0,0,,28401,-28401
39,09/25/2018,54,13:15,13:30,,47.82,0,47.82,47.82,-1,-65236,88331,153567,23095,0,-14962,0,0,0,,14962,-14962
39,09/25/2018,55,13:30,13:45,,44.07,0,44.07,44.07,-1,-49927,90747,140674,40820,0,-20431,0,0,0,,20431,-20431
39,09/25/2018,56,13:45,14:00,,44.07,0,44.07,44.07,-1,-57044,95692,152736,38648,0,-36551,0,0,0,,36551,-36551
39,09/25/2018,57,14:00,14:15,,48.66,0,48.66,48.66,-1,-67495,82265,149760,14770,0,-19518,0,0,0,,19518,-19518
39,09/25/2018,58,14:15,14:30,,44.07,0,44.07,44.07,-1,-42248,76092,118340,33844,0,-4646,0,0,0,,4646,-4646
39,09/25/2018,59,14:30,14:45,,48.73,0,48.73,48.73,-1,-54794,77293,132087,22499,0,-6190,0,0,0,,6190,-6190
39,09/25/2018,60,14:45,15:00,,41.84,0,41.84,41.84,-1,-45883,77955,123838,32072,0,-18228,0,0,0,,18228,-18228
39,09/25/2018,61,15:00,15:15,,30.34,0,30.34,30.34,-1,-41554,107167,148721,65613,0,-39309,0,0,0,,39309,-39309
39,09/25/2018,62,15:15,15:30,,53.64,0,53.64,53.64,-1,-49342,87737,137079,38395,0,-4248,0,0,0,,4248,-4248
39,09/25/2018,63,15:30,15:45,,,0,56.73,56.73,0,-43978,95390,139368,51412,0,-42,0,0,0,,42,-42
39,09/25/2018,64,15:45,16:00,,53.41,0,53.41,53.41,-1,-33287,84081,117368,50794,0,-45,0,0,0,,45,-45
39,09/25/2018,65,16:00,16:15,,-129.59,0,-129.59,-129.59,-1,-22441,121499,143940,99058,0,-40849,0,0,0,,40849,-40849
39,09/25/2018,66,16:15,16:30,,44.07,0,44.07,44.07,-1,-34448,99589,134037,65141,0,-52951,0,0,0,,52951,-52951
39,09/25/2018,67,16:30,16:45,,47.82,0,47.82,47.82,-1,-29473,93002,122475,63529,0,-39191,0,0,0,,39191,-39191
39,09/25/2018,68,16:45,17:00,,,0,56.73,56.73,0,-25174,72436,97610,47262,0,-8285,0,0,0,,8285,-8285
39,09/25/2018,69,17:00,17:15,,-5.55,0,-5.55,-5.55,-1,-23179,141043,164222,117864,0,-20714,0,0,0,,20714,-20714
39,09/25/2018,70,17:15,17:30,,51.82,0,51.82,51.82,-1,-36790,94254,131044,57464,0,-8268,0,0,0,,8268,-8268
39,09/25/2018,71,17:30,17:45,,,0,56.97,56.97,0,-38107,86613,124720,48506,0,0,0,0,0,,0,0
39,09/25/2018,72,17:45,18:00,,,0,56.97,56.97,0,-21425,79974,101399,58549,0,0,0,0,0,,0,0
39,09/25/2018,73,18:00,18:15,55.82,,0,55.82,55.82,1,-65350,25325,90675,-40025,0,0,383,0,0,,383,383
39,09/25/2018,74,18:15,18:30,57.35,,0,57.35,57.35,1,-34980,30123,65103,-4857,0,0,3434,0,0,,3434,3434
39,09/25/2018,75,18:30,18:45,55.82,,0,55.82,55.82,1,-42515,42683,85198,168,0,0,885,0,0,,885,885
39,09/25/2018,76,18:45,19:00,57.38,,0,57.38,57.38,1,-51496,72143,123639,20647,0,0,1406,0,0,,1406,1406
39,09/25/2018,77,19:00,19:15,55.82,-7.65,0,56.98,-7.65,2,-30118,100546,130664,70428,0,-18604,339,0,0,,18943,-18265
39,09/25/2018,78,19:15,19:30,,47.82,0,47.82,47.82,-1,-59501,73703,133204,14202,0,-14239,0,0,0,,14239,-14239
39,09/25/2018,79,19:30,19:45,55.82,47.82,0,55.82,55.82,1,-71086,55190,126276,-15896,0,-28,3,0,0,,31,-25
39,09/25/2018,80,19:45,20:00,161.02,,0,161.02,161.02,1,-117945,58956,176901,-58989,0,0,25695,0,0,,25695,25695
39,09/25/2018,81,20:00,20:15,68.31,56.35,0,56.35,56.35,-1,-42139,60697,102836,18558,0,-19,22185,0,0,,22204,22166
39,09/25/2018,82,20:15,20:30,68.31,26.84,0,26.84,26.84,-1,-16556,88180,104736,71624,0,-10091,62,0,0,,10153,-10029
39,09/25/2018,83,20:30,20:45,,11.99,0,11.99,11.99,-1,-25242,67536,92778,42294,0,-44790,0,0,0,,44790,-44790
39,09/25/2018,84,20:45,21:00,,38.69,0,38.69,38.69,-1,-40709,102782,143491,62073,0,-43688,0,0,0,,43688,-43688
39,09/25/2018,85,21:00,21:15,69.98,51.82,0,69.98,51.82,2,-94751,9406,104157,-85345,0,-14324,1916,0,0,,16240,-12408
39,09/25/2018,86,21:15,21:30,,51.82,0,51.82,51.82,-1,-26392,27866,54258,1474,0,-736,0,0,0,,736,-736
39,09/25/2018,87,21:30,21:45,,43.49,0,43.49,43.49,-1,-22333,73930,96263,51597,0,-33396,0,0,0,,33396,-33396
39,09/25/2018,88,21:45,22:00,,44.07,0,44.07,44.07,-1,-46359,90852,137211,44493,0,-46820,0,0,0,,46820,-46820
39,09/25/2018,89,22:00,22:15,56.73,30.34,0,56.73,30.34,2,-39869,64713,104582,24844,0,-33626,3,0,0,,33629,-33623
39,09/25/2018,90,22:15,22:30,64.07,54.06,0,64.07,54.06,2,-58915,56422,115337,-2493,0,-1533,667,0,0,,2200,-866
39,09/25/2018,91,22:30,22:45,,32.25,0,32.25,32.25,-1,-22713,74920,97633,52207,0,-25944,0,0,0,,25944,-25944
39,09/25/2018,92,22:45,23:00,,28.03,0,28.03,28.03,-1,-30062,104881,134943,74819,0,-63974,0,0,0,,63974,-63974
39,09/25/2018,93,23:00,23:15,80.34,32.09,0,80.34,80.34,1,-83375,74365,157740,-9010,0,-36522,1394,0,0,,37916,-35128
39,09/25/2018,94,23:15,23:30,55.82,44.07,0,44.07,44.07,-1,-43479,63937,107416,20458,0,-3744,1145,0,0,,4889,-2599
39,09/25/2018,95,23:30,23:45,,30.34,0,30.34,30.34,-1,-31413,76630,108043,45217,0,-40354,0,0,0,,40354,-40354
39,09/25/2018,96,23:45,0:00,,36.32,0,36.32,36.32,-1,-38494,86516,125010,48022,0,-52853,0,0,0,,52853,-52853
39,09/26/2018,1,0:00,0:15,,-110.78,0,-110.78,-110.78,-1,-77734,134642,212376,56908,0,-53447,0,0,0,,53447,-53447
39,09/26/2018,2,0:15,0:30,58.28,-110.78,0,58.28,58.28,1,-63155,20276,83431,-42879,0,-2809,783,0,0,,3592,-2026
39,09/26/2018,3,0:30,0:45,64.47,55.54,0,64.47,55.54,2,-61526,29439,90965,-32087,0,-2,7933,0,0,,7935,7931
39,09/26/2018,4,0:45,1:00,64.47,54.75,0,54.75,54.75,-1,-54090,36336,90426,-17754,0,-319,180,0,0,,499,-139
39,09/26/2018,5,1:00,1:15,,45.38,0,45.38,45.38,-1,-43737,52702,96439,8965,0,-5173,0,0,0,,5173,-5173
39,09/26/2018,6,1:15,1:30,64.74,45.38,0,64.74,64.74,1,-54133,31626,85759,-22507,0,-227,5388,0,0,,5615,5161
39,09/26/2018,7,1:30,1:45,64.74,35.25,0,35.25,35.25,-1,-26470,52790,79260,26320,0,-11677,421,0,0,,12098,-11256
39,09/26/2018,8,1:45,2:00,,30.48,0,30.48,30.48,-1,-24485,69532,94017,45047,0,-35449,0,0,0,,35449,-35449
39,09/26/2018,9,2:00,2:15,80.48,11.06,0,80.48,11.06,2,-70860,57292,128152,-13568,0,-32110,1428,0,0,,33538,-30682
39,09/26/2018,10,2:15,2:30,190.12,11.06,0,190.12,190.12,1,-64822,39852,104674,-24970,0,-629,23543,0,0,,24172,22914
39,09/26/2018,11,2:30,2:45,190.12,45.38,0,45.38,45.38,-1,-40292,60185,100477,19893,0,-10015,1302,0,0,,11317,-8713
39,09/26/2018,12,2:45,3:00,,45.38,0,45.38,45.38,-1,-37902,72583,110485,34681,0,-27881,0,0,0,,27881,-27881
39,09/26/2018,13,3:00,3:15,,31.33,0,31.33,31.33,-1,-48218,89316,137534,41098,0,-21721,0,0,0,,21721,-21721
39,09/26/2018,14,3:15,3:30,,,0,49.17,49.17,0,-56534,70607,127141,14073,0,-168,0,0,0,,168,-168
39,09/26/2018,15,3:30,3:45,,30.48,0,30.48,30.48,-1,-36432,85211,121643,48779,0,-13743,0,0,0,,13743,-13743
39,09/26/2018,16,3:45,4:00,,29.13,0,29.13,29.13,-1,-38828,82415,121243,43587,0,-40417,0,0,0,,40417,-40417
39,09/26/2018,17,4:00,4:15,,30.48,0,30.48,30.48,-1,-27317,73556,100873,46239,0,-40901,0,0,0,,40901,-40901
39,09/26/2018,18,4:15,4:30,,36.06,0,36.06,36.06,-1,-35448,73419,108867,37971,0,-40492,0,0,0,,40492,-40492
39,09/26/2018,19,4:30,4:45,,39.21,0,39.21,39.21,-1,-39668,73985,113653,34317,0,-30523,0,0,0,,30523,-30523
39,09/26/2018,20,4:45,5:00,,45.38,0,45.38,45.38,-1,-38656,76123,114779,37467,0,-14388,0,0,0,,14388,-14388
39,09/26/2018,21,5:00,5:15,,29.28,0,29.28,29.28,-1,-28524,61188,89712,32664,0,-12104,0,0,0,,12104,-12104
39,09/26/2018,22,5:15,5:30,56.75,-19.52,0,56.75,-19.52,2,-52066,60127,112193,8061,0,-33153,22,0,0,,33175,-33131
39,09/26/2018,23,5:30,5:45,65.26,-19.52,0,65.26,65.26,1,-59028,35829,94857,-23199,0,-528,5638,0,0,,6166,5110
39,09/26/2018,24,5:45,6:00,65.26,,0,65.26,65.26,1,-62985,26639,89624,-36346,0,0,27228,0,0,,27228,27228
39,09/26/2018,25,6:00,6:15,63.15,,0,63.15,63.15,1,-106885,61444,168329,-45441,0,0,21623,0,0,,21623,21623
39,09/26/2018,26,6:15,6:30,63.15,45.9,0,45.9,45.9,-1,-48846,66564,115410,17718,0,-6689,1917,0,0,,8606,-4772
39,09/26/2018,27,6:30,6:45,57.74,55.51,0,57.74,50.82,2,-49252,41532,90784,-7720,0,-898,508,0,0,,1406,-390
39,09/26/2018,28,6:45,7:00,57.74,45.29,0,45.29,45.29,-1,-83894,137589,221483,53695,0,-6085,16,0,0,,6101,-6069
39,09/26/2018,29,7:00,7:15,,45.9,0,45.9,45.9,-1,-78434,103871,182305,25437,0,-21006,0,0,0,,21006,-21006
39,09/26/2018,30,7:15,7:30,,12.6,0,12.6,12.6,-1,-43562,97355,140917,53793,0,-32481,0,0,0,,32481,-32481
39,09/26/2018,31,7:30,7:45,131,-19,0,131,-19,2,-101141,85077,186218,-16064,0,-36626,1935,0,0,,38561,-34691
39,09/26/2018,32,7:45,8:00,57.51,53.74,0,53.74,53.74,-1,-104386,111671,216057,7285,0,-1346,1705,0,0,,3051,359
39,09/26/2018,33,8:00,8:15,,51.99,0,51.99,51.99,-1,-55592,64875,120467,9283,0,-10952,0,0,0,,10952,-10952
39,09/26/2018,34,8:15,8:30,,53.3,0,53.3,53.3,-1,-44695,54568,99263,9873,0,-10737,0,0,0,,10737,-10737
39,09/26/2018,35,8:30,8:45,,55.31,0,55.31,55.31,-1,-51354,57423,108777,6069,0,-6087,0,0,0,,6087,-6087
39,09/26/2018,36,8:45,9:00,,53.74,0,53.74,53.74,-1,-55723,57984,113707,2261,0,-3366,0,0,0,,3366,-3366
39,09/26/2018,37,9:00,9:15,77.58,53.74,0,77.58,77.58,1,-91727,62981,154708,-28746,0,-460,12930,0,0,,13390,12470
39,09/26/2018,38,9:15,9:30,57.74,-21.47,0,59.32,-21.47,2,-48105,89789,137894,41684,0,-15463,3796,0,0,,19259,-11667
39,09/26/2018,39,9:30,9:45,,43.05,0,43.05,43.05,-1,-46407,80910,127317,34503,0,-25561,0,0,0,,25561,-25561
39,09/26/2018,40,9:45,10:00,,8.16,0,8.16,8.16,-1,-45010,99425,144435,54415,0,-57153,0,0,0,,57153,-57153
39,09/26/2018,41,10:00,10:15,,45.36,0,45.36,45.36,-1,-71645,108319,179964,36674,0,-43184,0,0,0,,43184,-43184
39,09/26/2018,42,10:15,10:30,,19.07,0,19.07,19.07,-1,-51473,111437,162910,59964,0,-43139,0,0,0,,43139,-43139
39,09/26/2018,43,10:30,10:45,,36.5,0,36.5,36.5,-1,-55799,118556,174355,62757,0,-55372,0,0,0,,55372,-55372
39,09/26/2018,44,10:45,11:00,,31,0,31,31,-1,-55998,134571,190569,78573,0,-71899,0,0,0,,71899,-71899
39,09/26/2018,45,11:00,11:15,57.08,31,0,57.08,57.08,1,-81932,42357,124289,-39575,0,-21126,157,0,0,,21283,-20969
39,09/26/2018,46,11:15,11:30,,45.9,0,45.9,45.9,-1,-54592,69288,123880,14696,0,-2421,0,0,0,,2421,-2421
39,09/26/2018,47,11:30,11:45,,-19,0,-19,-19,-1,-44683,92530,137213,47847,0,-44404,0,0,0,,44404,-44404
39,09/26/2018,48,11:45,12:00,,31,0,31,31,-1,-53635,99497,153132,45862,0,-34601,0,0,0,,34601,-34601
39,09/26/2018,49,12:00,12:15,,-1.91,0,-1.91,-1.91,-1,-50480,125515,175995,75035,0,-59920,0,0,0,,59920,-59920
39,09/26/2018,50,12:15,12:30,,-14.15,0,-14.15,-14.15,-1,-72284,133682,205966,61398,0,-64826,0,0,0,,64826,-64826
39,09/26/2018,51,12:30,12:45,,-140.33,0,-140.33,-140.33,-1,-72232,139180,211412,66948,0,-66597,0,0,0,,66597,-66597
39,09/26/2018,52,12:45,13:00,,-23.39,0,-23.39,-23.39,-1,-80585,148175,228760,67590,0,-59268,0,0,0,,59268,-59268
39,09/26/2018,53,13:00,13:15,,45.9,0,45.9,45.9,-1,-78617,138672,217289,60055,0,-23215,0,0,0,,23215,-23215
39,09/26/2018,54,13:15,13:30,,-123.51,0,-123.51,-123.51,-1,-57225,162341,219566,105116,0,-23380,0,0,0,,23380,-23380
39,09/26/2018,55,13:30,13:45,,-111.9,0,-111.9,-111.9,-1,-85343,124353,209696,39010,0,-29452,0,0,0,,29452,-29452
39,09/26/2018,56,13:45,14:00,,-18.1,0,-18.1,-18.1,-1,-95432,133260,228692,37828,0,-32851,0,0,0,,32851,-32851
39,09/26/2018,57,14:00,14:15,,45.9,0,45.9,45.9,-1,-103124,137950,241074,34826,0,-27155,0,0,0,,27155,-27155
39,09/26/2018,58,14:15,14:30,,53.74,0,53.74,53.74,-1,-102184,144751,246935,42567,0,-10462,0,0,0,,10462,-10462
39,09/26/2018,59,14:30,14:45,,45.11,0,45.11,45.11,-1,-92641,135508,228149,42867,0,-1617,0,0,0,,1617,-1617
39,09/26/2018,60,14:45,15:00,,-18.29,0,-18.29,-18.29,-1,-106263,134367,240630,28104,0,-29845,0,0,0,,29845,-29845
39,09/26/2018,61,15:00,15:15,,55.52,0,55.52,55.52,-1,-117571,84169,201740,-33402,0,-1910,0,0,0,,1910,-1910
39,09/26/2018,62,15:15,15:30,,,0,50.82,50.82,0,-131926,77301,209227,-54625,0,0,0,0,0,,0,0
39,09/26/2018,63,15:30,15:45,,,0,50.82,50.82,0,-140508,69814,210322,-70694,0,0,0,0,0,,0,0
39,09/26/2018,64,15:45,16:00,,,0,50.82,50.82,0,-133984,74267,208251,-59717,0,0,0,0,0,,0,0
39,09/26/2018,65,16:00,16:15,,-123.51,0,-123.51,-123.51,-1,-51293,139242,190535,87949,0,-25349,0,0,0,,25349,-25349
39,09/26/2018,66,16:15,16:30,,-123.51,0,-123.51,-123.51,-1,-80008,125622,205630,45614,0,-43626,0,0,0,,43626,-43626
39,09/26/2018,67,16:30,16:45,,45.9,0,45.9,45.9,-1,-74071,97116,171187,23045,0,-9016,0,0,0,,9016,-9016
39,09/26/2018,68,16:45,17:00,59.69,45.9,0,59.69,45.9,2,-98521,90660,189181,-7861,0,-9406,1139,0,0,,10545,-8267
39,09/26/2018,69,17:00,17:15,59.69,-135.58,0,-135.58,-135.58,-1,-71238,145481,216719,74243,0,-26432,272,0,0,,26704,-26160
39,09/26/2018,70,17:15,17:30,,36.05,0,36.05,36.05,-1,-68128,124295,192423,56167,0,-46864,0,0,0,,46864,-46864
39,09/26/2018,71,17:30,17:45,56.63,45.54,0,56.63,56.63,1,-86078,101962,188040,15884,0,-41648,1,0,0,,41649,-41647
39,09/26/2018,72,17:45,18:00,58.04,53.74,0,58.04,52.47,2,-99222,111400,210622,12178,0,-3482,843,0,0,,4325,-2639
39,09/26/2018,73,18:00,18:15,,56.23,0,56.23,56.23,-1,-95092,79068,174160,-16024,0,-351,0,0,0,,351,-351
39,09/26/2018,74,18:15,18:30,64.44,56.23,0,64.44,52.47,2,-101873,84777,186650,-17096,0,-635,1829,0,0,,2464,1194
39,09/26/2018,75,18:30,18:45,57.5,,0,57.5,57.5,1,-87720,84530,172250,-3190,0,0,2987,0,0,,2987,2987
39,09/26/2018,76,18:45,19:00,59.34,,0,59.34,59.34,1,-80915,70331,151246,-10584,0,0,4870,0,0,,4870,4870
39,09/26/2018,77,19:00,19:15,59.34,49.74,0,49.74,49.74,-1,-46315,75745,122060,29430,0,-6070,1015,0,0,,7085,-5055
39,09/26/2018,78,19:15,19:30,,53.74,0,53.74,53.74,-1,-58892,78793,137685,19901,0,-14509,0,0,0,,14509,-14509
39,09/26/2018,79,19:30,19:45,70.99,53.74,0,70.99,70.99,1,-92484,51643,144127,-40841,0,-2976,3784,0,0,,6760,808
39,09/26/2018,80,19:45,20:00,146.12,,0,146.12,146.12,1,-145537,26036,171573,-119501,0,0,58475,0,0,,58475,58475
39,09/26/2018,81,20:00,20:15,114.81,,0,114.81,114.81,1,-58148,44507,102655,-13641,0,0,40836,0,0,,40836,40836
39,09/26/2018,82,20:15,20:30,114.81,53.74,0,53.74,53.74,-1,-43226,46898,90124,3672,0,-1068,192,0,0,,1260,-876
39,09/26/2018,83,20:30,20:45,,45.9,0,45.9,45.9,-1,-39528,66714,106242,27186,0,-16450,0,0,0,,16450,-16450
39,09/26/2018,84,20:45,21:00,,40.64,0,40.64,40.64,-1,-52294,81771,134065,29477,0,-30623,0,0,0,,30623,-30623
39,09/26/2018,85,21:00,21:15,,13.03,0,13.03,13.03,-1,-51524,131851,183375,80327,0,-30142,0,0,0,,30142,-30142
39,09/26/2018,86,21:15,21:30,,42.88,0,42.88,42.88,-1,-49841,101117,150958,51276,0,-31249,0,0,0,,31249,-31249
39,09/26/2018,87,21:30,21:45,,38.85,0,38.85,38.85,-1,-48337,88299,136636,39962,0,-40008,0,0,0,,40008,-40008
39,09/26/2018,88,21:45,22:00,,47.54,0,47.54,47.54,-1,-59692,100131,159823,40439,0,-37139,0,0,0,,37139,-37139
39,09/26/2018,89,22:00,22:15,131,49.74,0,131,131,1,-83049,24661,107710,-58388,0,-18097,9546,0,0,,27643,-8551
39,09/26/2018,90,22:15,22:30,131,49.74,0,131,131,1,-78606,49655,128261,-28951,0,-9,28164,0,0,,28173,28155
39,09/26/2018,91,22:30,22:45,56.12,45.78,0,45.78,45.78,-1,-59688,84272,143960,24584,0,-9042,3693,0,0,,12735,-5349
39,09/26/2018,92,22:45,23:00,,19.79,0,19.79,19.79,-1,-55020,116243,171263,61223,0,-37769,0,0,0,,37769,-37769
39,09/26/2018,93,23:00,23:15,131,-65.97,0,131,131,1,-75311,46620,121931,-28691,0,-30726,4626,0,0,,35352,-26100
39,09/26/2018,94,23:15,23:30,146.12,-65.97,0,146.12,146.12,1,-63332,42333,105665,-20999,0,-17,25512,0,0,,25529,25495
39,09/26/2018,95,23:30,23:45,146.12,40.34,0,40.34,40.34,-1,-42477,78291,120768,35814,0,-7179,330,0,0,,7509,-6849
39,09/26/2018,96,23:45,0:00,,31,0,31,31,-1,-62211,97007,159218,34796,0,-31448,0,0,0,,31448,-31448
39,09/27/2018,1,0:00,0:15,,47.03,0,47.03,47.03,-1,-39342,70047,109389,30705,0,-16545,0,0,0,,16545,-16545
39,09/27/2018,2,0:15,0:30,,,0,32.67,32.67,0,-34725,60795,95520,26070,0,-3,0,0,0,,3,-3
39,09/27/2018,3,0:30,0:45,,,0,32.72,32.72,0,-31446,70190,101636,38744,0,0,0,0,0,,0,0
39,09/27/2018,4,0:45,1:00,,30.29,0,30.29,30.29,-1,-29981,84130,114111,54149,0,-11501,0,0,0,,11501,-11501
39,09/27/2018,5,1:00,1:15,,-16.83,0,-16.83,-16.83,-1,-51042,64560,115602,13518,0,-32385,0,0,0,,32385,-32385
39,09/27/2018,6,1:15,1:30,55.83,49.03,0,55.83,49.03,2,-37781,60540,98321,22759,0,-2621,317,0,0,,2938,-2304
39,09/27/2018,7,1:30,1:45,,53.03,0,53.03,53.03,-1,-30269,77020,107289,46751,0,-2809,0,0,0,,2809,-2809
39,09/27/2018,8,1:45,2:00,,45.46,0,45.46,45.46,-1,-29291,103138,132429,73847,0,-4283,0,0,0,,4283,-4283
39,09/27/2018,9,2:00,2:15,,52.33,0,52.33,52.33,-1,-29346,84747,114093,55401,0,-2803,0,0,0,,2803,-2803
39,09/27/2018,10,2:15,2:30,,54.76,0,54.76,54.76,-1,-27651,82137,109788,54486,0,-588,0,0,0,,588,-588
39,09/27/2018,11,2:30,2:45,,54.72,0,54.72,54.72,-1,-41146,72233,113379,31087,0,-1716,0,0,0,,1716,-1716
39,09/27/2018,12,2:45,3:00,,55.34,0,55.34,55.34,-1,-37164,70004,107168,32840,0,-710,0,0,0,,710,-710
39,09/27/2018,13,3:00,3:15,,47.73,0,47.73,47.73,-1,-35234,61392,96626,26158,0,-2924,0,0,0,,2924,-2924
39,09/27/2018,14,3:15,3:30,,54.31,0,54.31,54.31,-1,-36519,55337,91856,18818,0,-1296,0,0,0,,1296,-1296
39,09/27/2018,15,3:30,3:45,,54.31,0,54.31,54.31,-1,-42282,45533,87815,3251,0,-336,0,0,0,,336,-336
39,09/27/2018,16,3:45,4:00,,,0,49.17,49.17,0,-47464,56184,103648,8720,0,0,0,0,0,,0,0
39,09/27/2018,17,4:00,4:15,,54.56,0,54.56,54.56,-1,-43455,54191,97646,10736,0,-446,0,0,0,,446,-446
39,09/27/2018,18,4:15,4:30,,53.03,0,53.03,53.03,-1,-45817,50810,96627,4993,0,-3210,0,0,0,,3210,-3210
39,09/27/2018,19,4:30,4:45,,54.53,0,54.53,54.53,-1,-41620,42006,83626,386,0,-1442,0,0,0,,1442,-1442
39,09/27/2018,20,4:45,5:00,,,0,48.78,48.78,0,-40895,62983,103878,22088,0,0,0,0,0,,0,0
39,09/27/2018,21,5:00,5:15,61.03,,0,61.03,61.03,1,-97745,54792,152537,-42953,0,0,3606,0,0,,3606,3606
39,09/27/2018,22,5:15,5:30,64.7,,0,64.7,64.7,1,-90632,56127,146759,-34505,0,0,12270,0,0,,12270,12270
39,09/27/2018,23,5:30,5:45,159.02,,0,159.02,159.02,1,-130252,44817,175069,-85435,0,0,46186,0,0,,46186,46186
39,09/27/2018,24,5:45,6:00,143.02,,0,143.02,143.02,1,-161576,41716,203292,-119860,0,0,101128,0,0,,101128,101128
39,09/27/2018,25,6:00,6:15,350.02,49.48,0,49.48,49.48,-1,-177730,107096,284826,-70634,0,-507,53421,0,0,,53928,52914
39,09/27/2018,26,6:15,6:30,,50.62,0,50.62,50.62,-1,-66033,104743,170776,38710,0,-1338,0,0,0,,1338,-1338
39,09/27/2018,27,6:30,6:45,78.43,,0,78.43,78.43,1,-77761,44260,122021,-33501,0,0,4195,0,0,,4195,4195
39,09/27/2018,28,6:45,7:00,144.02,,0,144.02,144.02,1,-178935,54708,233643,-124227,0,0,60674,0,0,,60674,60674
39,09/27/2018,29,7:00,7:15,158.02,,0,158.02,158.02,1,-162601,63522,226123,-99079,0,0,82285,0,0,,82285,82285
39,09/27/2018,30,7:15,7:30,140.02,,0,140.02,140.02,1,-141493,50419,191912,-91074,0,0,82859,0,0,,82859,82859
39,09/27/2018,31,7:30,7:45,158.02,,0,158.02,158.02,1,-195061,36425,231486,-158636,0,0,91501,0,0,,91501,91501
39,09/27/2018,32,7:45,8:00,450,,0,495,495,1,-228866,28318,257184,-200548,0,0,95122,18750,8450,,122322,122322
39,09/27/2018,33,8:00,8:15,287.53,,0,316.28,316.28,1,-145311,61553,206864,-83758,0,0,64999,17500,25350,,107849,107849
39,09/27/2018,34,8:15,8:30,287.53,,0,316.28,316.28,1,-146985,69686,216671,-77299,0,0,22352,17500,16900,,56752,56752
39,09/27/2018,35,8:30,8:45,187.53,,0,187.53,187.53,1,-140244,60379,200623,-79865,0,0,51523,15000,0,,66523,66523
39,09/27/2018,36,8:45,9:00,67.53,,0,67.53,67.53,1,-133037,84469,217506,-48568,0,0,50888,0,0,,50888,50888
39,09/27/2018,37,9:00,9:15,141.1,,0,141.1,141.1,1,-192942,55410,248352,-137532,0,0,63615,0,0,,63615,63615
39,09/27/2018,38,9:15,9:30,391.1,,0,391.1,391.1,1,-169952,59931,229883,-110021,0,0,82500,18750,0,,101250,101250
39,09/27/2018,39,9:30,9:45,291.1,,0,291.1,291.1,1,-141952,96896,238848,-45056,0,0,42462,17500,0,,59962,59962
39,09/27/2018,40,9:45,10:00,291.1,52.32,0,52.32,52.32,-1,-128514,130555,259069,2041,0,-1289,1420,0,0,,2709,131
39,09/27/2018,41,10:00,10:15,,43.21,0,43.21,43.21,-1,-118005,137206,255211,19201,0,-5933,0,0,0,,5933,-5933
39,09/27/2018,42,10:15,10:30,,28.43,0,28.43,28.43,-1,-93854,144649,238503,50795,0,-23556,0,0,0,,23556,-23556
39,09/27/2018,43,10:30,10:45,,28.43,0,28.43,28.43,-1,-85212,138652,223864,53440,0,-53240,0,0,0,,53240,-53240
39,09/27/2018,44,10:45,11:00,,35.26,0,35.26,35.26,-1,-84615,130437,215052,45822,0,-59158,0,0,0,,59158,-59158
39,09/27/2018,45,11:00,11:15,128.43,35.26,0,128.43,128.43,1,-101751,42651,144402,-59100,0,-13195,15539,0,0,,28734,2344
39,09/27/2018,46,11:15,11:30,57.5,49.57,0,49.57,49.57,-1,-74507,82801,157308,8294,0,-1011,7257,0,0,,8268,6246
39,09/27/2018,47,11:30,11:45,,42.25,0,42.25,42.25,-1,-65784,89646,155430,23862,0,-21229,0,0,0,,21229,-21229
39,09/27/2018,48,11:45,12:00,,50.01,0,50.01,50.01,-1,-76098,94554,170652,18456,0,-17893,0,0,0,,17893,-17893
39,09/27/2018,49,12:00,12:15,122.02,51.36,0,122.02,49.14,2,-126938,63053,189991,-63885,0,-6713,18585,0,0,,25298,11872
39,09/27/2018,50,12:15,12:30,60.38,,0,60.38,60.38,1,-109490,79393,188883,-30097,0,0,27284,0,0,,27284,27284
39,09/27/2018,51,12:30,12:45,56.06,28.43,0,28.43,28.43,-1,-93159,108418,201577,15259,0,-5814,10233,0,0,,16047,4419
39,09/27/2018,52,12:45,13:00,,28.43,0,28.43,28.43,-1,-97774,108937,206711,11163,0,-24849,0,0,0,,24849,-24849
39,09/27/2018,53,13:00,13:15,,50.01,0,50.01,50.01,-1,-94372,109426,203798,15054,0,-11037,0,0,0,,11037,-11037
39,09/27/2018,54,13:15,13:30,,49.52,0,49.52,49.52,-1,-94116,107750,201866,13634,0,-12866,0,0,0,,12866,-12866
39,09/27/2018,55,13:30,13:45,,50.01,0,50.01,50.01,-1,-95195,99854,195049,4659,0,-4877,0,0,0,,4877,-4877
39,09/27/2018,56,13:45,14:00,,49.52,0,49.52,49.52,-1,-100261,110762,211023,10501,0,-5235,0,0,0,,5235,-5235
39,09/27/2018,57,14:00,14:15,,46.26,0,46.26,46.26,-1,-97801,103457,201258,5656,0,-10617,0,0,0,,10617,-10617
39,09/27/2018,58,14:15,14:30,,50.01,0,50.01,50.01,-1,-100170,112380,212550,12210,0,-7264,0,0,0,,7264,-7264
39,09/27/2018,59,14:30,14:45,,51.68,0,51.68,51.68,-1,-99577,105230,204807,5653,0,-4516,0,0,0,,4516,-4516
39,09/27/2018,60,14:45,15:00,54.01,51.35,0,54.01,49.13,2,-95074,94468,189542,-606,0,-2418,140,0,0,,2558,-2278
39,09/27/2018,61,15:00,15:15,,30.89,0,30.89,30.89,-1,-85517,119000,204517,33483,0,-13245,0,0,0,,13245,-13245
39,09/27/2018,62,15:15,15:30,55.67,46.01,0,55.67,55.67,1,-102145,99392,201537,-2753,0,-17237,58,0,0,,17295,-17179
39,09/27/2018,63,15:30,15:45,62.25,46.01,0,62.25,62.25,1,-115492,87725,203217,-27767,0,-211,10524,0,0,,10735,10313
39,09/27/2018,64,15:45,16:00,62.25,,0,62.25,62.25,1,-119762,81830,201592,-37932,0,0,31272,0,0,,31272,31272
39,09/27/2018,65,16:00,16:15,62.25,-81.14,0,-81.14,-81.14,-1,-68973,128502,197475,59529,0,-19164,12758,0,0,,31922,-6406
39,09/27/2018,66,16:15,16:30,,42.25,0,42.25,42.25,-1,-101002,107197,208199,6195,0,-17199,0,0,0,,17199,-17199
39,09/27/2018,67,16:30,16:45,54.01,51.03,0,54.01,49.33,2,-104476,102990,207466,-1486,0,-1514,49,0,0,,1563,-1465
39,09/27/2018,68,16:45,17:00,78.43,,0,78.43,78.43,1,-124075,76938,201013,-47137,0,0,17866,0,0,,17866,17866
39,09/27/2018,69,17:00,17:15,78.43,25.17,0,25.17,25.17,-1,-94137,113570,207707,19433,0,-3274,19086,0,0,,22360,15812
39,09/27/2018,70,17:15,17:30,62.47,-4.33,0,62.47,-4.33,2,-89363,81001,170364,-8362,0,-16544,539,0,0,,17083,-16005
39,09/27/2018,71,17:30,17:45,350.02,-4.33,0,350.02,350.02,1,-118272,75928,194200,-42344,0,-135,32449,0,0,,32584,32314
39,09/27/2018,72,17:45,18:00,59.17,51.17,0,51.17,51.17,-1,-95058,98363,193421,3305,0,-997,13473,0,0,,14470,12476
39,09/27/2018,73,18:00,18:15,56.56,51.17,0,56.56,56.56,1,-117183,99793,216976,-17390,0,-590,1714,0,0,,2304,1124
39,09/27/2018,74,18:15,18:30,59.17,,0,59.17,59.17,1,-107892,87604,195496,-20288,0,0,12719,0,0,,12719,12719
39,09/27/2018,75,18:30,18:45,58.71,,0,58.71,58.71,1,-97231,84146,181377,-13085,0,0,11918,0,0,,11918,11918
39,09/27/2018,76,18:45,19:00,63.21,,0,63.21,63.21,1,-103507,72788,176295,-30719,0,0,24232,0,0,,24232,24232
39,09/27/2018,77,19:00,19:15,59.17,52.45,0,52.45,52.45,-1,-89982,86092,176074,-3890,0,-703,14549,0,0,,15252,13846
39,09/27/2018,78,19:15,19:30,61.32,52.45,0,61.32,61.32,1,-97543,78237,175780,-19306,0,-235,2105,0,0,,2340,1870
39,09/27/2018,79,19:30,19:45,179.02,,0,179.02,179.02,1,-137402,64641,202043,-72761,0,0,32289,0,0,,32289,32289
39,09/27/2018,80,19:45,20:00,179.02,,0,278.26,278.26,1,-194452,37358,231810,-157094,0,0,74348,0,0,,74348,74348
39,09/27/2018,81,20:00,20:15,390,,0,429,429,1,-113950,25732,139682,-88218,0,0,69382,18750,27501,,115633,115633
39,09/27/2018,82,20:15,20:30,57.53,55.21,0,57.53,50.07,2,-76582,52478,129060,-24104,0,-37,7479,0,9167,,16683,16609
39,09/27/2018,83,20:30,20:45,57.53,43.21,0,43.21,43.21,-1,-72346,92947,165293,20601,0,-4732,21,0,0,,4753,-4711
39,09/27/2018,84,20:45,21:00,,28.43,0,28.43,28.43,-1,-68603,108559,177162,39956,0,-40798,0,0,0,,40798,-40798
39,09/27/2018,85,21:00,21:15,78.43,43.21,0,78.43,33.09,2,-76605,57012,133617,-19593,0,-29454,2254,0,0,,31708,-27200
39,09/27/2018,86,21:15,21:30,78.43,55.21,0,78.43,32.61,2,-54710,53515,108225,-1195,0,-936,7194,0,0,,8130,6258
39,09/27/2018,87,21:30,21:45,,28.43,0,28.43,28.43,-1,-58607,89264,147871,30657,0,-11524,0,0,0,,11524,-11524
39,09/27/2018,88,21:45,22:00,,28.43,0,28.43,28.43,-1,-80454,90779,171233,10325,0,-26995,0,0,0,,26995,-26995
39,09/27/2018,89,22:00,22:15,180.02,53.72,0,180.02,180.02,1,-101929,30665,132594,-71264,0,-3201,12765,0,0,,15966,9564
39,09/27/2018,90,22:15,22:30,371.57,,0,371.57,371.57,1,-94907,30341,125248,-64566,0,0,58934,18750,0,,77684,77684
39,09/27/2018,91,22:30,22:45,371.57,-71.99,0,-71.99,-71.99,-1,-37315,62166,99481,24851,0,-10933,5532,0,0,,16465,-5401
39,09/27/2018,92,22:45,23:00,59.28,-71.99,0,59.28,59.28,1,-75969,53170,129139,-22799,0,-198,4098,0,0,,4296,3900
39,09/27/2018,93,23:00,23:15,169.02,,0,169.02,169.02,1,-94047,20927,114974,-73120,0,0,35845,0,0,,35845,35845
39,09/27/2018,94,23:15,23:30,63.21,,0,63.21,63.21,1,-49821,35883,85704,-13938,0,0,26013,0,0,,26013,26013
39,09/27/2018,95,23:30,23:45,63.21,43.13,0,43.13,43.13,-1,-32421,54918,87339,22497,0,-8454,1223,0,0,,9677,-7231
39,09/27/2018,96,23:45,0:00,,52.03,0,52.03,52.03,-1,-66300,67865,134165,1565,0,-9817,0,0,0,,9817,-9817
39,09/28/2018,1,0:00,0:15,,42.77,0,42.77,42.77,-1,-60404,89375,149779,28971,0,-10510,0,0,0,,10510,-10510
39,09/28/2018,2,0:15,0:30,,51.19,0,51.19,51.19,-1,-53571,57156,110727,3585,0,-7203,0,0,0,,7203,-7203
39,09/28/2018,3,0:30,0:45,,47.19,0,47.19,47.19,-1,-48766,55787,104553,7021,0,-2267,0,0,0,,2267,-2267
39,09/28/2018,4,0:45,1:00,,29.88,0,29.88,29.88,-1,-25699,68830,94529,43131,0,-36452,0,0,0,,36452,-36452
39,09/28/2018,5,1:00,1:15,,42.77,0,42.77,42.77,-1,-49463,90576,140039,41113,0,-44654,0,0,0,,44654,-44654
39,09/28/2018,6,1:15,1:30,,28.44,0,28.44,28.44,-1,-31552,89179,120731,57627,0,-49054,0,0,0,,49054,-49054
39,09/28/2018,7,1:30,1:45,,-18.87,0,-18.87,-18.87,-1,-35924,97332,133256,61408,0,-66534,0,0,0,,66534,-66534
39,09/28/2018,8,1:45,2:00,,28.44,0,28.44,28.44,-1,-37877,82202,120079,44325,0,-52497,0,0,0,,52497,-52497
39,09/28/2018,9,2:00,2:15,,-65.85,0,-65.85,-65.85,-1,-33632,79248,112880,45616,0,-44003,0,0,0,,44003,-44003
39,09/28/2018,10,2:15,2:30,,28.44,0,28.44,28.44,-1,-36849,75305,112154,38456,0,-5276,0,0,0,,5276,-5276
39,09/28/2018,11,2:30,2:45,,-150.78,0,-150.78,-150.78,-1,-40981,86889,127870,45908,0,-27869,0,0,0,,27869,-27869
39,09/28/2018,12,2:45,3:00,,-150.78,0,-150.78,-150.78,-1,-34606,87984,122590,53378,0,-38678,0,0,0,,38678,-38678
39,09/28/2018,13,3:00,3:15,,47.19,0,47.19,47.19,-1,-48305,50520,98825,2215,0,-12687,0,0,0,,12687,-12687
39,09/28/2018,14,3:15,3:30,,47.19,0,47.19,47.19,-1,-46142,61039,107181,14897,0,-15424,0,0,0,,15424,-15424
39,09/28/2018,15,3:30,3:45,,43.38,0,43.38,43.38,-1,-35701,69371,105072,33670,0,-24290,0,0,0,,24290,-24290
39,09/28/2018,16,3:45,4:00,,28.44,0,28.44,28.44,-1,-23737,80285,104022,56548,0,-45984,0,0,0,,45984,-45984
39,09/28/2018,17,4:00,4:15,,-60.11,0,-60.11,-60.11,-1,-46352,73503,119855,27151,0,-43391,0,0,0,,43391,-43391
39,09/28/2018,18,4:15,4:30,,28.44,0,28.44,28.44,-1,-42025,82396,124421,40371,0,-19195,0,0,0,,19195,-19195
39,09/28/2018,19,4:30,4:45,,28.44,0,28.44,28.44,-1,-52316,80079,132395,27763,0,-34704,0,0,0,,34704,-34704
39,09/28/2018,20,4:45,5:00,,43.38,0,43.38,43.38,-1,-50704,73615,124319,22911,0,-16107,0,0,0,,16107,-16107
39,09/28/2018,21,5:00,5:15,,-150.78,0,-150.78,-150.78,-1,-39547,99044,138591,59497,0,-38367,0,0,0,,38367,-38367
39,09/28/2018,22,5:15,5:30,,28.44,0,28.44,28.44,-1,-31764,90468,122232,58704,0,-50796,0,0,0,,50796,-50796
39,09/28/2018,23,5:30,5:45,,36.75,0,36.75,36.75,-1,-43008,54377,97385,11369,0,-32627,0,0,0,,32627,-32627
39,09/28/2018,24,5:45,6:00,63.25,47.19,0,63.25,47.19,2,-46623,53182,99805,6559,0,-3986,425,0,0,,4411,-3561
39,09/28/2018,25,6:00,6:15,77.14,47.19,0,77.14,77.14,1,-182837,72071,254908,-110766,0,-175,8988,0,0,,9163,8813
39,09/28/2018,26,6:15,6:30,53.67,,0,53.67,53.67,1,-130567,68074,198641,-62493,0,0,547,0,0,,547,547
39,09/28/2018,27,6:30,6:45,61.95,,0,61.95,61.95,1,-92608,48017,140625,-44591,0,0,3562,0,0,,3562,3562
39,09/28/2018,28,6:45,7:00,77.14,,0,77.14,77.14,1,-109578,91700,201278,-17878,0,0,17846,0,0,,17846,17846
39,09/28/2018,29,7:00,7:15,52.75,-124.03,0,-124.03,-124.03,-1,-62248,127925,190173,65677,0,-18559,2670,0,0,,21229,-15889
39,09/28/2018,30,7:15,7:30,56.75,-124.03,0,56.75,-124.03,2,-126535,81069,207604,-45466,0,-24898,258,0,0,,25156,-24640
39,09/28/2018,31,7:30,7:45,56.83,,0,56.83,56.83,1,-140435,75563,215998,-64872,0,0,909,0,0,,909,909
39,09/28/2018,32,7:45,8:00,144.12,,0,144.12,144.12,1,-184026,63774,247800,-120252,0,0,38809,0,0,,38809,38809
39,09/28/2018,33,8:00,8:15,80.12,53.19,0,53.19,53.19,-1,-143623,130978,274601,-12645,0,-16,36110,0,0,,36126,36094
39,09/28/2018,34,8:15,8:30,55.28,52.74,0,55.28,48.99,2,-128843,121831,250674,-7012,0,-120,563,0,0,,683,443
39,09/28/2018,35,8:30,8:45,144.12,,0,144.12,144.12,1,-139395,88317,227712,-51078,0,0,16294,0,0,,16294,16294
39,09/28/2018,36,8:45,9:00,144.12,,0,144.12,144.12,1,-144522,90946,235468,-53576,0,0,57939,0,0,,57939,57939
39,09/28/2018,37,9:00,9:15,55.97,53.19,0,55.97,48.97,2,-101476,90422,191898,-11054,0,-112,15185,0,0,,15297,15073
39,09/28/2018,38,9:15,9:30,144.12,,0,144.12,144.12,1,-121411,70108,191519,-51303,0,0,27447,0,0,,27447,27447
39,09/28/2018,39,9:30,9:45,70,,0,70,70,1,-118137,86337,204474,-31800,0,0,36950,0,0,,36950,36950
39,09/28/2018,40,9:45,10:00,70,47.15,0,47.15,47.15,-1,-80497,87348,167845,6851,0,-2048,12552,0,0,,14600,10504
39,09/28/2018,41,10:00,10:15,84.9,,0,84.9,84.9,1,-93789,61048,154837,-32741,0,0,13150,0,0,,13150,13150
39,09/28/2018,42,10:15,10:30,55.41,-103.37,0,55.41,-103.37,2,-46550,104066,150616,57516,0,-20049,3857,0,0,,23906,-16192
39,09/28/2018,43,10:30,10:45,,45.89,0,45.89,45.89,-1,-63093,73939,137032,10846,0,-11104,0,0,0,,11104,-11104
39,09/28/2018,44,10:45,11:00,,42.08,0,42.08,42.08,-1,-56527,89823,146350,33296,0,-22269,0,0,0,,22269,-22269
39,09/28/2018,45,11:00,11:15,60.98,33.65,0,60.98,33.65,2,-80263,71923,152186,-8340,0,-21261,2206,0,0,,23467,-19055
39,09/28/2018,46,11:15,11:30,60.98,42.08,0,42.08,42.08,-1,-72455,103088,175543,30633,0,-10912,568,0,0,,11480,-10344
39,09/28/2018,47,11:30,11:45,,27.14,0,27.14,27.14,-1,-53864,101983,155847,48119,0,-29561,0,0,0,,29561,-29561
39,09/28/2018,48,11:45,12:00,,9.77,0,9.77,9.77,-1,-74876,108932,183808,34056,0,-45440,0,0,0,,45440,-45440
39,09/28/2018,49,12:00,12:15,127.14,9.77,0,127.14,127.14,1,-99847,57516,157363,-42331,0,-11253,13839,0,0,,25092,2586
39,09/28/2018,50,12:15,12:30,56.75,,0,56.75,56.75,1,-89467,70357,159824,-19110,0,0,4977,0,0,,4977,4977
39,09/28/2018,51,12:30,12:45,59.58,51.49,0,59.58,51.49,2,-95092,86552,181644,-8540,0,-56,12211,0,0,,12267,12155
39,09/28/2018,52,12:45,13:00,59.58,49.89,0,49.89,49.89,-1,-86441,90152,176593,3711,0,-958,757,0,0,,1715,-201
39,09/28/2018,53,13:00,13:15,,42.08,0,42.08,42.08,-1,-57607,81597,139204,23990,0,-14388,0,0,0,,14388,-14388
39,09/28/2018,54,13:15,13:30,,42.08,0,42.08,42.08,-1,-58898,79760,138658,20862,0,-7257,0,0,0,,7257,-7257
39,09/28/2018,55,13:30,13:45,,11.05,0,11.05,11.05,-1,-70834,125916,196750,55082,0,-47683,0,0,0,,47683,-47683
39,09/28/2018,56,13:45,14:00,,42.08,0,42.08,42.08,-1,-80609,121835,202444,41226,0,-50632,0,0,0,,50632,-50632
39,09/28/2018,57,14:00,14:15,53.37,42.1,0,53.37,53.37,1,-77349,86929,164278,9580,0,-24634,127,0,0,,24761,-24507
39,09/28/2018,58,14:15,14:30,,-2.14,0,-2.14,-2.14,-1,-54389,102895,157284,48506,0,-21239,0,0,0,,21239,-21239
39,09/28/2018,59,14:30,14:45,,41.79,0,41.79,41.79,-1,-71994,119695,191689,47701,0,-43442,0,0,0,,43442,-43442
39,09/28/2018,60,14:45,15:00,,36.41,0,36.41,36.41,-1,-68610,125984,194594,57374,0,-52964,0,0,0,,52964,-52964
39,09/28/2018,61,15:00,15:15,,36.23,0,36.23,36.23,-1,-49195,110649,159844,61454,0,-56048,0,0,0,,56048,-56048
39,09/28/2018,62,15:15,15:30,,41.92,0,41.92,41.92,-1,-64574,106105,170679,41531,0,-48529,0,0,0,,48529,-48529
39,09/28/2018,63,15:30,15:45,,27.14,0,27.14,27.14,-1,-76644,133502,210146,56858,0,-47822,0,0,0,,47822,-47822
39,09/28/2018,64,15:45,16:00,,41.92,0,41.92,41.92,-1,-77201,117127,194328,39926,0,-36032,0,0,0,,36032,-36032
39,09/28/2018,65,16:00,16:15,,41.99,0,41.99,41.99,-1,-60290,170821,231111,110531,0,-29256,0,0,0,,29256,-29256
39,09/28/2018,66,16:15,16:30,,41.99,0,41.99,41.99,-1,-65981,159762,225743,93781,0,-11535,0,0,0,,11535,-11535
39,09/28/2018,67,16:30,16:45,,-144.71,0,-144.71,-144.71,-1,-91011,138248,229259,47237,0,-41507,0,0,0,,41507,-41507
39,09/28/2018,68,16:45,17:00,,27.14,0,27.14,27.14,-1,-69886,121418,191304,51532,0,-38887,0,0,0,,38887,-38887
39,09/28/2018,69,17:00,17:15,,42.08,0,42.08,42.08,-1,-94125,133136,227261,39011,0,-28989,0,0,0,,28989,-28989
39,09/28/2018,70,17:15,17:30,,42.63,0,42.63,42.63,-1,-73913,94136,168049,20223,0,-27807,0,0,0,,27807,-27807
39,09/28/2018,71,17:30,17:45,,49.89,0,49.89,49.89,-1,-55044,92244,147288,37200,0,-11524,0,0,0,,11524,-11524
39,09/28/2018,72,17:45,18:00,,,0,53.1,53.1,0,-39547,76643,116190,37096,0,-1610,0,0,0,,1610,-1610
39,09/28/2018,73,18:00,18:15,52.75,3.55,0,53.3,3.55,2,-33340,75518,108858,42178,0,-12868,95,0,0,,12963,-12773
39,09/28/2018,74,18:15,18:30,,46.89,0,46.89,46.89,-1,-45908,78884,124792,32976,0,-12668,0,0,0,,12668,-12668
39,09/28/2018,75,18:30,18:45,,,0,53.3,53.3,0,-44230,68106,112336,23876,0,-478,0,0,0,,478,-478
39,09/28/2018,76,18:45,19:00,,52.94,0,52.94,52.94,-1,-43854,68402,112256,24548,0,-45,0,0,0,,45,-45
39,09/28/2018,77,19:00,19:15,,-22.86,0,-22.86,-22.86,-1,-54462,110205,164667,55743,0,-26913,0,0,0,,26913,-26913
39,09/28/2018,78,19:15,19:30,,45.89,0,45.89,45.89,-1,-61936,87637,149573,25701,0,-17320,0,0,0,,17320,-17320
39,09/28/2018,79,19:30,19:45,60.98,50.08,0,60.98,60.98,1,-87758,66203,153961,-21555,0,-9417,2948,0,0,,12365,-6469
39,09/28/2018,80,19:45,20:00,60.98,50.08,0,60.98,60.98,1,-120031,59075,179106,-60956,0,-77,26371,0,0,,26448,26294
39,09/28/2018,81,20:00,20:15,57.11,,0,57.11,57.11,1,-97557,78443,176000,-19114,0,0,24685,0,0,,24685,24685
39,09/28/2018,82,20:15,20:30,58.81,,0,58.81,58.81,1,-89436,54523,143959,-34913,0,0,12942,0,0,,12942,12942
39,09/28/2018,83,20:30,20:45,54.49,,0,54.49,54.49,1,-84976,61425,146401,-23551,0,0,13043,0,0,,13043,13043
39,09/28/2018,84,20:45,21:00,55.45,,0,55.45,55.45,1,-114205,84696,198901,-29509,0,0,14040,0,0,,14040,14040
39,09/28/2018,85,21:00,21:15,60.98,,0,60.98,60.98,1,-87744,62043,149787,-25701,0,0,15388,0,0,,15388,15388
39,09/28/2018,86,21:15,21:30,60.98,,0,60.98,60.98,1,-94925,58919,153844,-36006,0,0,23321,0,0,,23321,23321
39,09/28/2018,87,21:30,21:45,60.98,51.46,0,51.46,51.46,-1,-71088,67956,139044,-3132,0,-865,5982,0,0,,6847,5117
39,09/28/2018,88,21:45,22:00,,51.46,0,51.46,51.46,-1,-85923,65675,151598,-20248,0,-23,0,0,0,,23,-23
39,09/28/2018,89,22:00,22:15,77.14,36.66,0,77.14,36.66,2,-52098,46425,98523,-5673,0,-6641,3162,0,0,,9803,-3479
39,09/28/2018,90,22:15,22:30,127.14,42.08,0,127.14,42.08,2,-37132,35658,72790,-1474,0,-344,19303,0,0,,19647,18959
39,09/28/2018,91,22:30,22:45,127.14,22.85,0,22.85,22.85,-1,-53489,68482,121971,14993,0,-13954,72,0,0,,14026,-13882
39,09/28/2018,92,22:45,23:00,55.94,52.62,0,55.94,52.62,2,-93040,81645,174685,-11395,0,-230,2036,0,0,,2266,1806
39,09/28/2018,93,23:00,23:15,62.12,49.89,0,62.12,62.12,1,-68087,59556,127643,-8531,0,-75,2005,0,0,,2080,1930
39,09/28/2018,94,23:15,23:30,77.14,49.97,0,77.14,49.97,2,-35641,29295,64936,-6346,0,-89,13716,0,0,,13805,13627
39,09/28/2018,95,23:30,23:45,77.14,9.66,0,9.66,9.66,-1,-41305,83949,125254,42644,0,-24238,67,0,0,,24305,-24171
39,09/28/2018,96,23:45,0:00,,-6.34,0,-6.34,-6.34,-1,-52871,111421,164292,58550,0,-36584,0,0,0,,36584,-36584
40,09/29/2018,1,0:00,0:15,77.32,-6.34,0,77.32,77.32,1,-85126,30411,115537,-54715,0,-13897,6032,0,0,,19929,-7865
40,09/29/2018,2,0:15,0:30,77.32,45.89,0,45.89,45.89,-1,-46984,61077,108061,14093,0,-3824,362,0,0,,4186,-3462
40,09/29/2018,3,0:30,0:45,,45.89,0,45.89,45.89,-1,-44972,74171,119143,29199,0,-26574,0,0,0,,26574,-26574
40,09/29/2018,4,0:45,1:00,,41.93,0,41.93,41.93,-1,-27290,76786,104076,49496,0,-40500,0,0,0,,40500,-40500
40,09/29/2018,5,1:00,1:15,,41.93,0,41.93,41.93,-1,-38771,47422,86193,8651,0,-29764,0,0,0,,29764,-29764
40,09/29/2018,6,1:15,1:30,,49.89,0,49.89,49.89,-1,-25400,39906,65306,14506,0,-1295,0,0,0,,1295,-1295
40,09/29/2018,7,1:30,1:45,,49.78,0,49.78,49.78,-1,-24572,48079,72651,23507,0,-5082,0,0,0,,5082,-5082
40,09/29/2018,8,1:45,2:00,,32.78,0,32.78,32.78,-1,-20057,63384,83441,43327,0,-26798,0,0,0,,26798,-26798
40,09/29/2018,9,2:00,2:15,,41.93,0,41.93,41.93,-1,-24933,62927,87860,37994,0,-23294,0,0,0,,23294,-23294
40,09/29/2018,10,2:15,2:30,,,0,48.55,48.55,0,-30239,68857,99096,38618,0,-375,0,0,0,,375,-375
40,09/29/2018,11,2:30,2:45,,27.14,0,27.14,27.14,-1,-17638,66679,84317,49041,0,-6109,0,0,0,,6109,-6109
40,09/29/2018,12,2:45,3:00,,27.14,0,27.14,27.14,-1,-21608,57327,78935,35719,0,-29243,0,0,0,,29243,-29243
40,09/29/2018,13,3:00,3:15,53.49,27.14,0,53.49,53.49,1,-31795,51082,82877,19287,0,-23540,22,0,0,,23562,-23518
40,09/29/2018,14,3:15,3:30,53.5,37.03,0,53.5,37.03,2,-29945,51039,80984,21094,0,-4888,41,0,0,,4929,-4847
40,09/29/2018,15,3:30,3:45,,34.47,0,34.47,34.47,-1,-29022,58741,87763,29719,0,-27329,0,0,0,,27329,-27329
40,09/29/2018,16,3:45,4:00,,41.93,0,41.93,41.93,-1,-39333,61630,100963,22297,0,-23071,0,0,0,,23071,-23071
40,09/29/2018,17,4:00,4:15,,33.57,0,33.57,33.57,-1,-23469,70269,93738,46800,0,-19461,0,0,0,,19461,-19461
40,09/29/2018,18,4:15,4:30,,,0,47.01,47.01,0,-23475,56693,80168,33218,0,-686,0,0,0,,686,-686
40,09/29/2018,19,4:30,4:45,53.52,,0,53.52,53.52,1,-38232,52270,90502,14038,0,0,28,0,0,,28,28
40,09/29/2018,20,4:45,5:00,53.51,49.89,0,49.89,49.89,-1,-31738,56331,88069,24593,0,-361,21,0,0,,382,-340
40,09/29/2018,21,5:00,5:15,,45.89,0,45.89,45.89,-1,-40186,65402,105588,25216,0,-9115,0,0,0,,9115,-9115
40,09/29/2018,22,5:15,5:30,,42.78,0,42.78,42.78,-1,-32962,60606,93568,27644,0,-21863,0,0,0,,21863,-21863
40,09/29/2018,23,5:30,5:45,,45.89,0,45.89,45.89,-1,-40309,46139,86448,5830,0,-11684,0,0,0,,11684,-11684
40,09/29/2018,24,5:45,6:00,,,0,47.98,47.98,0,-36150,44906,81056,8756,0,-66,0,0,0,,66,-66
40,09/29/2018,25,6:00,6:15,,52.19,0,52.19,52.19,-1,-24366,83328,107694,58962,0,-361,0,0,0,,361,-361
40,09/29/2018,26,6:15,6:30,,41.12,0,41.12,41.12,-1,-15669,67641,83310,51972,0,-3777,0,0,0,,3777,-3777
40,09/29/2018,27,6:30,6:45,,50.79,0,50.79,50.79,-1,-24486,48372,72858,23886,0,-3661,0,0,0,,3661,-3661
40,09/29/2018,28,6:45,7:00,,49.09,0,49.09,49.09,-1,-33320,61511,94831,28191,0,-2409,0,0,0,,2409,-2409
40,09/29/2018,29,7:00,7:15,,,0,47.45,47.45,0,-26744,44339,71083,17595,0,0,0,0,0,,0,0
40,09/29/2018,30,7:15,7:30,,49.08,0,49.08,49.08,-1,-18410,56133,74543,37723,0,-27,0,0,0,,27,-27
40,09/29/2018,31,7:30,7:45,,49.08,0,49.08,49.08,-1,-21726,72360,94086,50634,0,-1846,0,0,0,,1846,-1846
40,09/29/2018,32,7:45,8:00,,52.1,0,52.1,52.1,-1,-33520,91990,125510,58470,0,-2161,0,0,0,,2161,-2161
40,09/29/2018,33,8:00,8:15,,49.57,0,49.57,49.57,-1,-21014,56277,77291,35263,0,-3104,0,0,0,,3104,-3104
40,09/29/2018,34,8:15,8:30,,,0,48.33,48.33,0,-24225,95979,120204,71754,0,-728,0,0,0,,728,-728
40,09/29/2018,35,8:30,8:45,,49.08,0,49.08,49.08,-1,-26766,115811,142577,89045,0,-1791,0,0,0,,1791,-1791
40,09/29/2018,36,8:45,9:00,,,0,48.27,48.27,0,-34962,112419,147381,77457,0,0,0,0,0,,0,0
40,09/29/2018,37,9:00,9:15,,,0,48.6,48.6,0,-24433,52081,76514,27648,0,0,0,0,0,,0,0
40,09/29/2018,38,9:15,9:30,,,0,48.58,48.58,0,-24590,68518,93108,43928,0,0,0,0,0,,0,0
40,09/29/2018,39,9:30,9:45,,49.08,0,49.08,49.08,-1,-31730,78911,110641,47181,0,-1772,0,0,0,,1772,-1772
40,09/29/2018,40,9:45,10:00,,45.08,0,45.08,45.08,-1,-18366,106422,124788,88056,0,-10445,0,0,0,,10445,-10445
40,09/29/2018,41,10:00,10:15,,41.12,0,41.12,41.12,-1,-25240,68178,93418,42938,0,-9761,0,0,0,,9761,-9761
40,09/29/2018,42,10:15,10:30,,-75.55,0,-75.55,-75.55,-1,-19302,114496,133798,95194,0,-27428,0,0,0,,27428,-27428
40,09/29/2018,43,10:30,10:45,,-106.76,0,-106.76,-106.76,-1,-27773,90922,118695,63149,0,-64484,0,0,0,,64484,-64484
40,09/29/2018,44,10:45,11:00,,-70.08,0,-70.08,-70.08,-1,-23547,118695,142242,95148,0,-68771,0,0,0,,68771,-68771
40,09/29/2018,45,11:00,11:15,,26.33,0,26.33,26.33,-1,-83567,113134,196701,29567,0,-53660,0,0,0,,53660,-53660
40,09/29/2018,46,11:15,11:30,,-7.01,0,-7.01,-7.01,-1,-73221,122198,195419,48977,0,-21016,0,0,0,,21016,-21016
40,09/29/2018,47,11:30,11:45,,-114.74,0,-114.74,-114.74,-1,-60828,133535,194363,72707,0,-68372,0,0,0,,68372,-68372
40,09/29/2018,48,11:45,12:00,,11.96,0,11.96,11.96,-1,-68436,156707,225143,88271,0,-73985,0,0,0,,73985,-73985
40,09/29/2018,49,12:00,12:15,54.33,26.33,0,54.33,54.33,1,-96215,104555,200770,8340,0,-42615,153,0,0,,42768,-42462
40,09/29/2018,50,12:15,12:30,54.33,-23.67,0,-23.67,-23.67,-1,-89165,146595,235760,57430,0,-23568,21,0,0,,23589,-23547
40,09/29/2018,51,12:30,12:45,,33.6,0,33.6,33.6,-1,-89098,144738,233836,55640,0,-41387,0,0,0,,41387,-41387
40,09/29/2018,52,12:45,13:00,,-9.28,0,-9.28,-9.28,-1,-82285,159010,241295,76725,0,-63164,0,0,0,,63164,-63164
40,09/29/2018,53,13:00,13:15,,41.12,0,41.12,41.12,-1,-99205,125170,224375,25965,0,-37496,0,0,0,,37496,-37496
40,09/29/2018,54,13:15,13:30,,45.08,0,45.08,45.08,-1,-78669,102400,181069,23731,0,-26327,0,0,0,,26327,-26327
40,09/29/2018,55,13:30,13:45,,41.12,0,41.12,41.12,-1,-68923,105095,174018,36172,0,-32628,0,0,0,,32628,-32628
40,09/29/2018,56,13:45,14:00,,-21.86,0,-21.86,-21.86,-1,-55353,120105,175458,64752,0,-51074,0,0,0,,51074,-51074
40,09/29/2018,57,14:00,14:15,,26.33,0,26.33,26.33,-1,-55782,115074,170856,59292,0,-61621,0,0,0,,61621,-61621
40,09/29/2018,58,14:15,14:30,,30.93,0,30.93,30.93,-1,-55661,117740,173401,62079,0,-50379,0,0,0,,50379,-50379
40,09/29/2018,59,14:30,14:45,,26.33,0,26.33,26.33,-1,-53249,126619,179868,73370,0,-59986,0,0,0,,59986,-59986
40,09/29/2018,60,14:45,15:00,,26.33,0,26.33,26.33,-1,-55479,125183,180662,69704,0,-65330,0,0,0,,65330,-65330
40,09/29/2018,61,15:00,15:15,,-15.3,0,-15.3,-15.3,-1,-51939,134691,186630,82752,0,-69667,0,0,0,,69667,-69667
40,09/29/2018,62,15:15,15:30,,30.23,0,30.23,30.23,-1,-52426,117558,169984,65132,0,-64215,0,0,0,,64215,-64215
40,09/29/2018,63,15:30,15:45,,40.35,0,40.35,40.35,-1,-52844,105000,157844,52156,0,-56326,0,0,0,,56326,-56326
40,09/29/2018,64,15:45,16:00,,41.12,0,41.12,41.12,-1,-52894,99390,152284,46496,0,-41078,0,0,0,,41078,-41078
40,09/29/2018,65,16:00,16:15,,32.94,0,32.94,32.94,-1,-45898,94438,140336,48540,0,-46789,0,0,0,,46789,-46789
40,09/29/2018,66,16:15,16:30,,45.08,0,45.08,45.08,-1,-56558,73111,129669,16553,0,-31350,0,0,0,,31350,-31350
40,09/29/2018,67,16:30,16:45,61.31,45.08,0,61.31,61.31,1,-59109,42057,101166,-17052,0,-3658,9130,0,0,,12788,5472
40,09/29/2018,68,16:45,17:00,53.82,49.36,0,53.82,49.36,2,-74962,69998,144960,-4964,0,-552,6365,0,0,,6917,5813
40,09/29/2018,69,17:00,17:15,,-42.4,0,-42.4,-42.4,-1,-23735,113986,137721,90251,0,-40031,0,0,0,,40031,-40031
40,09/29/2018,70,17:15,17:30,,41.12,0,41.12,41.12,-1,-50767,73437,124204,22670,0,-33333,0,0,0,,33333,-33333
40,09/29/2018,71,17:30,17:45,61.31,49.08,0,61.31,61.31,1,-54921,45334,100255,-9587,0,-13356,1923,0,0,,15279,-11433
40,09/29/2018,72,17:45,18:00,61.31,49.08,0,61.31,61.31,1,-68355,37266,105621,-31089,0,-519,15766,0,0,,16285,15247
40,09/29/2018,73,18:00,18:15,53.08,45.08,0,53.09,45.08,2,-40640,59313,99953,18673,0,-3649,5639,0,0,,9288,1990
40,09/29/2018,74,18:15,18:30,,50.78,0,50.78,50.78,-1,-44893,48505,93398,3612,0,-4954,0,0,0,,4954,-4954
40,09/29/2018,75,18:30,18:45,,,0,53.09,53.09,0,-54358,52861,107219,-1497,0,-50,0,0,0,,50,-50
40,09/29/2018,76,18:45,19:00,,26.33,0,26.33,26.33,-1,-47110,56048,103158,8938,0,-5454,0,0,0,,5454,-5454
40,09/29/2018,77,19:00,19:15,,41.12,0,41.12,41.12,-1,-38782,80610,119392,41828,0,-15643,0,0,0,,15643,-15643
40,09/29/2018,78,19:15,19:30,53.08,41.12,0,53.08,53.08,1,-43636,57221,100857,13585,0,-13812,14,0,0,,13826,-13798
40,09/29/2018,79,19:30,19:45,61.19,41.12,0,61.19,61.19,1,-54075,36998,91073,-17077,0,-322,4817,0,0,,5139,4495
40,09/29/2018,80,19:45,20:00,63.02,,0,63.02,63.02,1,-74328,16638,90966,-57690,0,0,13730,0,0,,13730,13730
40,09/29/2018,81,20:00,20:15,56.9,,0,56.9,56.9,1,-82050,31019,113069,-51031,0,0,1430,0,0,,1430,1430
40,09/29/2018,82,20:15,20:30,,,0,54.98,54.98,0,-74612,37948,112560,-36664,0,0,0,0,0,,0,0
40,09/29/2018,83,20:30,20:45,,45.08,0,45.08,45.08,-1,-54396,62376,116772,7980,0,-1491,0,0,0,,1491,-1491
40,09/29/2018,84,20:45,21:00,,44.39,0,44.39,44.39,-1,-61253,81105,142358,19852,0,-15418,0,0,0,,15418,-15418
40,09/29/2018,85,21:00,21:15,,48.28,0,48.28,48.28,-1,-65132,66322,131454,1190,0,-10533,0,0,0,,10533,-10533
40,09/29/2018,86,21:15,21:30,53.08,48.28,0,53.08,48.28,2,-44662,54792,99454,10130,0,-1126,56,0,0,,1182,-1070
40,09/29/2018,87,21:30,21:45,,41.12,0,41.12,41.12,-1,-47694,72741,120435,25047,0,-17244,0,0,0,,17244,-17244
40,09/29/2018,88,21:45,22:00,,41.12,0,41.12,41.12,-1,-41010,83185,124195,42175,0,-40060,0,0,0,,40060,-40060
40,09/29/2018,89,22:00,22:15,76.33,32.23,0,76.33,32.23,2,-62463,53692,116155,-8771,0,-36618,1699,0,0,,38317,-34919
40,09/29/2018,90,22:15,22:30,78.72,26.33,0,78.72,26.33,2,-49766,60487,110253,10721,0,-3230,10642,0,0,,13872,7412
40,09/29/2018,91,22:30,22:45,,22.58,0,22.58,22.58,-1,-35320,63593,98913,28273,0,-25890,0,0,0,,25890,-25890
40,09/29/2018,92,22:45,23:00,,41.12,0,41.12,41.12,-1,-56267,85954,142221,29687,0,-19488,0,0,0,,19488,-19488
40,09/29/2018,93,23:00,23:15,,26.33,0,26.33,26.33,-1,-54064,94028,148092,39964,0,-37347,0,0,0,,37347,-37347
40,09/29/2018,94,23:15,23:30,,45.65,0,45.65,45.65,-1,-43234,58468,101702,15234,0,-21754,0,0,0,,21754,-21754
40,09/29/2018,95,23:30,23:45,,45.08,0,45.08,45.08,-1,-20941,39313,60254,18372,0,-14659,0,0,0,,14659,-14659
40,09/29/2018,96,23:45,0:00,,-150.78,0,-150.78,-150.78,-1,-15283,70911,86194,55628,0,-35323,0,0,0,,35323,-35323
40,09/30/2018,1,0:00,0:15,135.12,-150.78,0,135.12,135.12,1,-88650,29249,117899,-59401,0,-12580,10434,0,0,,23014,-2146
40,09/30/2018,2,0:15,0:30,57.71,52.97,0,52.97,52.97,-1,-43667,38276,81943,-5391,0,-13,8085,0,0,,8098,8072
40,09/30/2018,3,0:30,0:45,,33.51,0,33.51,33.51,-1,-27416,46689,74105,19273,0,-15390,0,0,0,,15390,-15390
40,09/30/2018,4,0:45,1:00,,45.14,0,45.14,45.14,-1,-38337,42162,80499,3825,0,-14302,0,0,0,,14302,-14302
40,09/30/2018,5,1:00,1:15,,18.78,0,18.78,18.78,-1,-34856,49276,84132,14420,0,-23031,0,0,0,,23031,-23031
40,09/30/2018,6,1:15,1:30,57.14,26.38,0,57.14,26.38,2,-22350,38810,61160,16460,0,-5497,925,0,0,,6422,-4572
40,09/30/2018,7,1:30,1:45,,26.38,0,26.38,26.38,-1,-31554,55183,86737,23629,0,-29443,0,0,0,,29443,-29443
40,09/30/2018,8,1:45,2:00,,38.79,0,38.79,38.79,-1,-29933,53615,83548,23682,0,-18514,0,0,0,,18514,-18514
40,09/30/2018,9,2:00,2:15,63.11,30.2,0,63.11,30.2,2,-49098,41784,90882,-7314,0,-20489,853,0,0,,21342,-19636
40,09/30/2018,10,2:15,2:30,76.38,49.14,0,76.38,49.14,2,-35473,27572,63045,-7901,0,-971,10021,0,0,,10992,9050
40,09/30/2018,11,2:30,2:45,,49.14,0,49.14,49.14,-1,-42335,49377,91712,7042,0,-3619,0,0,0,,3619,-3619
40,09/30/2018,12,2:45,3:00,,26.38,0,26.38,26.38,-1,-35634,69542,105176,33908,0,-24821,0,0,0,,24821,-24821
40,09/30/2018,13,3:00,3:15,,35.98,0,35.98,35.98,-1,-14951,81476,96427,66525,0,-40578,0,0,0,,40578,-40578
40,09/30/2018,14,3:15,3:30,,41.18,0,41.18,41.18,-1,-29369,56728,86097,27359,0,-16070,0,0,0,,16070,-16070
40,09/30/2018,15,3:30,3:45,,41.18,0,41.18,41.18,-1,-20190,54649,74839,34459,0,-18235,0,0,0,,18235,-18235
40,09/30/2018,16,3:45,4:00,,40.56,0,40.56,40.56,-1,-22370,52341,74711,29971,0,-23848,0,0,0,,23848,-23848
40,09/30/2018,17,4:00,4:15,,23.02,0,23.02,23.02,-1,-18840,72772,91612,53932,0,-39621,0,0,0,,39621,-39621
40,09/30/2018,18,4:15,4:30,,33.95,0,33.95,33.95,-1,-31261,64028,95289,32767,0,-46290,0,0,0,,46290,-46290
40,09/30/2018,19,4:30,4:45,,41.18,0,41.18,41.18,-1,-30979,47429,78408,16450,0,-28515,0,0,0,,28515,-28515
40,09/30/2018,20,4:45,5:00,,39.62,0,39.62,39.62,-1,-24602,56835,81437,32233,0,-31088,0,0,0,,31088,-31088
40,09/30/2018,21,5:00,5:15,,41.18,0,41.18,41.18,-1,-30801,43337,74138,12536,0,-22835,0,0,0,,22835,-22835
40,09/30/2018,22,5:15,5:30,,41.18,0,41.18,41.18,-1,-27872,42395,70267,14523,0,-11438,0,0,0,,11438,-11438
40,09/30/2018,23,5:30,5:45,,41.18,0,41.18,41.18,-1,-25982,36684,62666,10702,0,-16645,0,0,0,,16645,-16645
40,09/30/2018,24,5:45,6:00,53.14,49.14,0,53.14,53.14,1,-31654,30000,61654,-1654,0,-3678,39,0,0,,3717,-3639
40,09/30/2018,25,6:00,6:15,,39.76,0,39.76,39.76,-1,-33486,54730,88216,21244,0,-13120,0,0,0,,13120,-13120
40,09/30/2018,26,6:15,6:30,,41.27,0,41.27,41.27,-1,-28497,40850,69347,12353,0,-18481,0,0,0,,18481,-18481
40,09/30/2018,27,6:30,6:45,,45.23,0,45.23,45.23,-1,-29058,33054,62112,3996,0,-10861,0,0,0,,10861,-10861
40,09/30/2018,28,6:45,7:00,53.84,45.23,0,53.84,53.84,1,-31047,32444,63491,1397,0,-5613,35,0,0,,5648,-5578
40,09/30/2018,29,7:00,7:15,93.86,45.23,0,93.86,93.86,1,-120273,44971,165244,-75302,0,-223,29850,0,0,,30073,29627
40,09/30/2018,30,7:15,7:30,61.27,33,0,33,33,-1,-40619,40230,80849,-389,0,-686,22252,0,0,,22938,21566
40,09/30/2018,31,7:30,7:45,61.27,-23.52,0,-23.52,-23.52,-1,-27975,33510,61485,5535,0,-19047,126,0,0,,19173,-18921
40,09/30/2018,32,7:45,8:00,57.23,41.27,0,57.23,41.27,2,-40468,46524,86992,6056,0,-3868,92,0,0,,3960,-3776
40,09/30/2018,33,8:00,8:15,159.12,41.27,0,159.12,159.12,1,-93969,13132,107101,-80837,0,-399,33943,0,0,,34342,33544
40,09/30/2018,34,8:15,8:30,61.27,,0,61.27,61.27,1,-50003,36965,86968,-13038,0,0,20862,0,0,,20862,20862
40,09/30/2018,35,8:30,8:45,53.23,,0,53.23,53.23,1,-29232,38624,67856,9392,0,0,507,0,0,,507,507
40,09/30/2018,36,8:45,9:00,,26.48,0,26.48,26.48,-1,-20062,82303,102365,62241,0,-4001,0,0,0,,4001,-4001
40,09/30/2018,37,9:00,9:15,,26.48,0,26.48,26.48,-1,-21145,45238,66383,24093,0,-22030,0,0,0,,22030,-22030
40,09/30/2018,38,9:15,9:30,,-3.5,0,-3.5,-3.5,-1,-21849,72457,94306,50608,0,-43490,0,0,0,,43490,-43490
40,09/30/2018,39,9:30,9:45,,18.4,0,18.4,18.4,-1,-22634,84230,106864,61596,0,-45576,0,0,0,,45576,-45576
40,09/30/2018,40,9:45,10:00,,10.38,0,10.38,10.38,-1,-25507,107292,132799,81785,0,-66974,0,0,0,,66974,-66974
40,09/30/2018,41,10:00,10:15,76.48,26.48,0,76.48,76.48,1,-97516,75755,173271,-21761,0,-35053,1980,0,0,,37033,-33073
40,09/30/2018,42,10:15,10:30,53.47,41.27,0,41.27,41.27,-1,-58832,62782,121614,3950,0,-1528,2155,0,0,,3683,627
40,09/30/2018,43,10:30,10:45,,0.24,0,0.24,0.24,-1,-35824,78992,114816,43168,0,-34356,0,0,0,,34356,-34356
40,09/30/2018,44,10:45,11:00,,41.27,0,41.27,41.27,-1,-42174,67408,109582,25234,0,-22972,0,0,0,,22972,-22972
40,09/30/2018,45,11:00,11:15,,41.27,0,41.27,41.27,-1,-36797,77165,113962,40368,0,-29872,0,0,0,,29872,-29872
40,09/30/2018,46,11:15,11:30,,22.46,0,22.46,22.46,-1,-42850,99627,142477,56777,0,-47132,0,0,0,,47132,-47132
40,09/30/2018,47,11:30,11:45,,22.46,0,22.46,22.46,-1,-57013,125948,182961,68935,0,-57791,0,0,0,,57791,-57791
40,09/30/2018,48,11:45,12:00,,39.78,0,39.78,39.78,-1,-64292,116599,180891,52307,0,-53702,0,0,0,,53702,-53702
40,09/30/2018,49,12:00,12:15,,41.27,0,41.27,41.27,-1,-73987,96059,170046,22072,0,-31864,0,0,0,,31864,-31864
40,09/30/2018,50,12:15,12:30,,45.23,0,45.23,45.23,-1,-67658,88018,155676,20360,0,-24302,0,0,0,,24302,-24302
40,09/30/2018,51,12:30,12:45,,44.82,0,44.82,44.82,-1,-51145,86025,137170,34880,0,-21453,0,0,0,,21453,-21453
40,09/30/2018,52,12:45,13:00,,45.23,0,45.23,45.23,-1,-49122,76891,126013,27769,0,-25345,0,0,0,,25345,-25345
40,09/30/2018,53,13:00,13:15,,45.23,0,45.23,45.23,-1,-44965,95923,140888,50958,0,-27022,0,0,0,,27022,-27022
40,09/30/2018,54,13:15,13:30,,43.48,0,43.48,43.48,-1,-51768,72717,124485,20949,0,-17867,0,0,0,,17867,-17867
40,09/30/2018,55,13:30,13:45,54.1,41.27,0,54.15,41.27,2,-45871,72759,118630,26888,0,-3368,95,0,0,,3463,-3273
40,09/30/2018,56,13:45,14:00,,41.27,0,41.27,41.27,-1,-51195,67643,118838,16448,0,-18073,0,0,0,,18073,-18073
40,09/30/2018,57,14:00,14:15,,41.27,0,41.27,41.27,-1,-55830,100601,156431,44771,0,-27943,0,0,0,,27943,-27943
40,09/30/2018,58,14:15,14:30,,46.05,0,46.05,46.05,-1,-66349,92436,158785,26087,0,-29175,0,0,0,,29175,-29175
40,09/30/2018,59,14:30,14:45,,49.23,0,49.23,49.23,-1,-69701,91824,161525,22123,0,-19500,0,0,0,,19500,-19500
40,09/30/2018,60,14:45,15:00,,49.23,0,49.23,49.23,-1,-70144,87315,157459,17171,0,-14006,0,0,0,,14006,-14006
40,09/30/2018,61,15:00,15:15,,45.23,0,45.23,45.23,-1,-55916,94699,150615,38783,0,-18897,0,0,0,,18897,-18897
40,09/30/2018,62,15:15,15:30,,41.27,0,41.27,41.27,-1,-57612,87241,144853,29629,0,-30321,0,0,0,,30321,-30321
40,09/30/2018,63,15:30,15:45,,42.38,0,42.38,42.38,-1,-56957,82925,139882,25968,0,-27881,0,0,0,,27881,-27881
40,09/30/2018,64,15:45,16:00,,49.23,0,49.23,49.23,-1,-43346,77863,121209,34517,0,-4231,0,0,0,,4231,-4231
40,09/30/2018,65,16:00,16:15,,-62.83,0,-62.83,-62.83,-1,-37529,117214,154743,79685,0,-33304,0,0,0,,33304,-33304
40,09/30/2018,66,16:15,16:30,,43.22,0,43.22,43.22,-1,-37014,81856,118870,44842,0,-34643,0,0,0,,34643,-34643
40,09/30/2018,67,16:30,16:45,,45.23,0,45.23,45.23,-1,-41101,78572,119673,37471,0,-33034,0,0,0,,33034,-33034
40,09/30/2018,68,16:45,17:00,53.37,49.23,0,54.05,49.23,2,-68049,56384,124433,-11665,0,-10642,651,0,0,,11293,-9991
40,09/30/2018,69,17:00,17:15,,-0.52,0,-0.52,-0.52,-1,-46176,135279,181455,89103,0,-23032,0,0,0,,23032,-23032
40,09/30/2018,70,17:15,17:30,,50.66,0,50.66,50.66,-1,-61574,91645,153219,30071,0,-4995,0,0,0,,4995,-4995
40,09/30/2018,71,17:30,17:45,74.52,,0,74.52,74.52,1,-95863,71399,167262,-24464,0,0,4164,0,0,,4164,4164
40,09/30/2018,72,17:45,18:00,67.08,,0,67.08,67.08,1,-103253,97344,200597,-5909,0,0,10946,0,0,,10946,10946
40,09/30/2018,73,18:00,18:15,53.53,,0,53.53,53.53,1,-82959,74339,157298,-8620,0,0,1029,0,0,,1029,1029
40,09/30/2018,74,18:15,18:30,,,0,54.22,54.22,0,-81245,78844,160089,-2401,0,0,0,0,0,,0,0
40,09/30/2018,75,18:30,18:45,,,0,54.22,54.22,0,-82999,88281,171280,5282,0,0,0,0,0,,0,0
40,09/30/2018,76,18:45,19:00,53.23,,0,53.23,53.23,1,-80978,93006,173984,12028,0,0,11,0,0,,11,11
40,09/30/2018,77,19:00,19:15,,23.58,0,23.58,23.58,-1,-55217,112038,167255,56821,0,-19388,0,0,0,,19388,-19388
40,09/30/2018,78,19:15,19:30,,48.19,0,48.19,48.19,-1,-53767,79032,132799,25265,0,-15723,0,0,0,,15723,-15723
40,09/30/2018,79,19:30,19:45,,51.35,0,51.35,51.35,-1,-56160,66076,122236,9916,0,-8048,0,0,0,,8048,-8048
40,09/30/2018,80,19:45,20:00,,50.78,0,50.78,50.78,-1,-56221,70018,126239,13797,0,-5455,0,0,0,,5455,-5455
40,09/30/2018,81,20:00,20:15,,55.12,0,55.12,55.12,-1,-56162,83371,139533,27209,0,-423,0,0,0,,423,-423
40,09/30/2018,82,20:15,20:30,,41.27,0,41.27,41.27,-1,-56220,94723,150943,38503,0,-4271,0,0,0,,4271,-4271
40,09/30/2018,83,20:30,20:45,,23.58,0,23.58,23.58,-1,-39595,109443,149038,69848,0,-60551,0,0,0,,60551,-60551
40,09/30/2018,84,20:45,21:00,,8.73,0,8.73,8.73,-1,-33541,137155,170696,103614,0,-81925,0,0,0,,81925,-81925
40,09/30/2018,85,21:00,21:15,,25.55,0,25.55,25.55,-1,-34878,46166,81044,11288,0,-47406,0,0,0,,47406,-47406
40,09/30/2018,86,21:15,21:30,,14.9,0,14.9,14.9,-1,-25329,80784,106113,55455,0,-17853,0,0,0,,17853,-17853
40,09/30/2018,87,21:30,21:45,,26.48,0,26.48,26.48,-1,-27439,103103,130542,75664,0,-56787,0,0,0,,56787,-56787
40,09/30/2018,88,21:45,22:00,,40.23,0,40.23,40.23,-1,-82604,106492,189096,23888,0,-39415,0,0,0,,39415,-39415
40,09/30/2018,89,22:00,22:15,55.45,41.27,0,55.45,41.27,2,-37230,20729,57959,-16501,0,-16510,1029,0,0,,17539,-15481
40,09/30/2018,90,22:15,22:30,55.45,37.18,0,37.18,37.18,-1,-49152,60719,109871,11567,0,-4583,685,0,0,,5268,-3898
40,09/30/2018,91,22:30,22:45,,30.4,0,30.4,30.4,-1,-43688,80010,123698,36322,0,-29836,0,0,0,,29836,-29836
40,09/30/2018,92,22:45,23:00,,-110.61,0,-110.61,-110.61,-1,-30902,114361,145263,83459,0,-60238,0,0,0,,60238,-60238
40,09/30/2018,93,23:00,23:15,,32.95,0,32.95,32.95,-1,-70510,74050,144560,3540,0,-33959,0,0,0,,33959,-33959
40,09/30/2018,94,23:15,23:30,,45.23,0,45.23,45.23,-1,-44889,54680,99569,9791,0,-1121,0,0,0,,1121,-1121
40,09/30/2018,95,23:30,23:45,,34.31,0,34.31,34.31,-1,-45487,83219,128706,37732,0,-26671,0,0,0,,26671,-26671
40,09/30/2018,96,23:45,0:00,,-20.23,0,-20.23,-20.23,-1,-55103,110752,165855,55649,0,-44254,0,0,0,,44254,-44254
40,10-01-18,1,0:00,0:15,53.37,-20.98,0,53.48,-20.98,2,-76497,106212,182709,29715,0,-35275,13,0,0,,35288,-35262
40,10-01-18,2,0:15,0:30,53.37,54.85,0,54.85,54.85,-1,-53436,60396,113832,6960,0,-189,58,0,0,,247,-131
40,10-01-18,3,0:30,0:45,,,0,53.54,53.54,0,-107983,40988,148971,-66995,0,-12,0,0,0,,12,-12
40,10-01-18,4,0:45,1:00,,49.06,0,49.06,49.06,-1,-94877,43210,138087,-51667,0,-207,0,0,0,,207,-207
40,10-01-18,5,1:00,1:15,,26.48,0,26.48,26.48,-1,-24750,73647,98397,48897,0,-15811,0,0,0,,15811,-15811
40,10-01-18,6,1:15,1:30,,47.03,0,47.03,47.03,-1,-40046,45561,85607,5515,0,-1683,0,0,0,,1683,-1683
40,10-01-18,7,1:30,1:45,,44.11,0,44.11,44.11,-1,-46304,79226,125530,32922,0,-12082,0,0,0,,12082,-12082
40,10-01-18,8,1:45,2:00,,40.11,0,40.11,40.11,-1,-31272,82787,114059,51515,0,-36400,0,0,0,,36400,-36400
40,10-01-18,9,2:00,2:15,,37.11,0,37.11,37.11,-1,-46325,82233,128558,35908,0,-25168,0,0,0,,25168,-25168
40,10-01-18,10,2:15,2:30,52.11,40.11,0,53.12,40.11,2,-34136,63383,97519,29247,0,-3531,3,0,0,,3534,-3528
40,10-01-18,11,2:30,2:45,,37.51,0,37.51,37.51,-1,-29062,77871,106933,48809,0,-15708,0,0,0,,15708,-15708
40,10-01-18,12,2:45,3:00,,40.11,0,40.11,40.11,-1,-35741,60971,96712,25230,0,-15917,0,0,0,,15917,-15917
40,10-01-18,13,3:00,3:15,,38.03,0,38.03,38.03,-1,-31983,98867,130850,66884,0,-23162,0,0,0,,23162,-23162
40,10-01-18,14,3:15,3:30,,26.48,0,26.48,26.48,-1,-26049,97863,123912,71814,0,-8322,0,0,0,,8322,-8322
40,10-01-18,15,3:30,3:45,,-4.65,0,-4.65,-4.65,-1,-23056,107896,130952,84840,0,-62530,0,0,0,,62530,-62530
40,10-01-18,16,3:45,4:00,,40.11,0,40.11,40.11,-1,-28193,67997,96190,39804,0,-53332,0,0,0,,53332,-53332
40,10-01-18,17,4:00,4:15,,40.11,0,40.11,40.11,-1,-57833,79661,137494,21828,0,-39496,0,0,0,,39496,-39496
40,10-01-18,18,4:15,4:30,,40.11,0,40.11,40.11,-1,-45684,92872,138556,47188,0,-10514,0,0,0,,10514,-10514
40,10-01-18,19,4:30,4:45,,40.11,0,40.11,40.11,-1,-23576,74002,97578,50426,0,-35412,0,0,0,,35412,-35412
40,10-01-18,20,4:45,5:00,,44.11,0,44.11,44.11,-1,-18079,82657,100736,64578,0,-38965,0,0,0,,38965,-38965
40,10-01-18,21,5:00,5:15,,47.85,0,47.85,47.85,-1,-53488,44178,97666,-9310,0,-19108,0,0,0,,19108,-19108
40,10-01-18,22,5:15,5:30,,-102.75,0,-102.75,-102.75,-1,-33529,118020,151549,84491,0,-42428,0,0,0,,42428,-42428
40,10-01-18,23,5:30,5:45,,-7.84,0,-7.84,-7.84,-1,-33806,115523,149329,81717,0,-55102,0,0,0,,55102,-55102
40,10-01-18,24,5:45,6:00,,44.63,0,44.63,44.63,-1,-38649,107687,146336,69038,0,-19041,0,0,0,,19041,-19041
40,10-01-18,25,6:00,6:15,,47.68,0,47.68,47.68,-1,-132810,73228,206038,-59582,0,-5410,0,0,0,,5410,-5410
40,10-01-18,26,6:15,6:30,,24.9,0,24.9,24.9,-1,-27302,99843,127145,72541,0,-36410,0,0,0,,36410,-36410
40,10-01-18,27,6:30,6:45,55.68,43.68,0,55.68,55.68,1,-54177,51957,106134,-2220,0,-15413,450,0,0,,15863,-14963
40,10-01-18,28,6:45,7:00,63.62,43.68,0,63.62,63.62,1,-95263,60357,155620,-34906,0,-8,22200,0,0,,22208,22192
40,10-01-18,29,7:00,7:15,54.99,44.79,0,54.99,44.79,2,-37680,83761,121441,46081,0,-4209,6419,0,0,,10628,2210
40,10-01-18,30,7:15,7:30,77.32,53.19,0,77.32,52.44,2,-82619,49706,132325,-32913,0,-363,5809,0,0,,6172,5446
40,10-01-18,31,7:30,7:45,55.86,,0,55.86,55.86,1,-63189,48325,111514,-14864,0,0,6955,0,0,,6955,6955
40,10-01-18,32,7:45,8:00,51.68,,0,51.68,51.68,1,-79246,46649,125895,-32597,0,0,240,0,0,,240,240
40,10-01-18,33,8:00,8:15,51.68,52.44,0,52.44,52.44,2,-53500,70350,123850,16850,0,-343,68,0,0,,411,-275
40,10-01-18,34,8:15,8:30,,,0,52.38,52.38,0,-51544,66812,118356,15268,0,0,0,0,0,,0,0
40,10-01-18,35,8:30,8:45,,,0,52.37,52.37,0,-46243,60162,106405,13919,0,0,0,0,0,,0,0
40,10-01-18,36,8:45,9:00,,52.97,0,52.97,52.97,-1,-37532,58500,96032,20968,0,-832,0,0,0,,832,-832
40,10-01-18,37,9:00,9:15,79.56,52.97,0,79.56,79.56,1,-104788,56605,161393,-48183,0,-7,13406,0,0,,13413,13399
40,10-01-18,38,9:15,9:30,55.86,,0,55.86,55.86,1,-85894,83804,169698,-2090,0,0,8886,0,0,,8886,8886
40,10-01-18,39,9:30,9:45,51.68,51.05,0,51.05,51.05,-1,-74604,117562,192166,42958,0,-166,2663,0,0,,2829,2497
40,10-01-18,40,9:45,10:00,,40.79,0,40.79,40.79,-1,-52782,154285,207067,101503,0,-4471,0,0,0,,4471,-4471
40,10-01-18,41,10:00,10:15,186.31,48.31,0,186.31,48.31,2,-182865,103493,286358,-79372,0,-3594,14668,0,0,,18262,11074
40,10-01-18,42,10:15,10:30,55.2,,0,55.2,55.2,1,-180118,153938,334056,-26180,0,0,5218,0,0,,5218,5218
40,10-01-18,43,10:30,10:45,,,0,53.38,53.38,0,-178073,135875,313948,-42198,0,0,0,0,0,,0,0
40,10-01-18,44,10:45,11:00,,,0,53.41,53.41,0,-159114,149247,308361,-9867,0,0,0,0,0,,0,0
40,10-01-18,45,11:00,11:15,,,0,53.35,53.35,0,-118598,67519,186117,-51079,0,0,0,0,0,,0,0
40,10-01-18,46,11:15,11:30,,44.79,0,44.79,44.79,-1,-84825,107981,192806,23156,0,-713,0,0,0,,713,-713
40,10-01-18,47,11:30,11:45,,26.03,0,26.03,26.03,-1,-63153,153017,216170,89864,0,-38690,0,0,0,,38690,-38690
40,10-01-18,48,11:45,12:00,,43.14,0,43.14,43.14,-1,-51377,162309,213686,110932,0,-44178,0,0,0,,44178,-44178
40,10-01-18,49,12:00,12:15,,4.13,0,4.13,4.13,-1,-106817,172279,279096,65462,0,-49975,0,0,0,,49975,-49975
40,10-01-18,50,12:15,12:30,,26.03,0,26.03,26.03,-1,-99563,164218,263781,64655,0,-18885,0,0,0,,18885,-18885
40,10-01-18,51,12:30,12:45,,20.44,0,20.44,20.44,-1,-103658,182487,286145,78829,0,-60031,0,0,0,,60031,-60031
40,10-01-18,52,12:45,13:00,,40.79,0,40.79,40.79,-1,-108373,154130,262503,45757,0,-49669,0,0,0,,49669,-49669
40,10-01-18,53,13:00,13:15,,40.79,0,40.79,40.79,-1,-85769,168018,253787,82249,0,-29748,0,0,0,,29748,-29748
40,10-01-18,54,13:15,13:30,53.37,40.79,0,53.37,40.79,2,-83210,140163,223373,56953,0,-3517,83,0,0,,3600,-3434
40,10-01-18,55,13:30,13:45,,40.79,0,40.79,40.79,-1,-82964,125630,208594,42666,0,-9924,0,0,0,,9924,-9924
40,10-01-18,56,13:45,14:00,,26.03,0,26.03,26.03,-1,-79717,138983,218700,59266,0,-35083,0,0,0,,35083,-35083
40,10-01-18,57,14:00,14:15,,26.03,0,26.03,26.03,-1,-85361,138784,224145,53423,0,-38694,0,0,0,,38694,-38694
40,10-01-18,58,14:15,14:30,,48.31,0,48.31,48.31,-1,-75291,115079,190370,39788,0,-1241,0,0,0,,1241,-1241
40,10-01-18,59,14:30,14:45,,48.31,0,48.31,48.31,-1,-102305,101801,204106,-504,0,-1531,0,0,0,,1531,-1531
40,10-01-18,60,14:45,15:00,,49.69,0,49.69,49.69,-1,-111212,89348,200560,-21864,0,-130,0,0,0,,130,-130
40,10-01-18,61,15:00,15:15,,26.03,0,26.03,26.03,-1,-36760,126328,163088,89568,0,-23513,0,0,0,,23513,-23513
40,10-01-18,62,15:15,15:30,,40.79,0,40.79,40.79,-1,-54513,98388,152901,43875,0,-34390,0,0,0,,34390,-34390
40,10-01-18,63,15:30,15:45,,48.31,0,48.31,48.31,-1,-81630,102489,184119,20859,0,-12794,0,0,0,,12794,-12794
40,10-01-18,64,15:45,16:00,53.37,48.31,0,53.37,53.37,1,-88790,59821,148611,-28969,0,-934,1655,0,0,,2589,721
40,10-01-18,65,16:00,16:15,,48.03,0,48.03,48.03,-1,-95030,115487,210517,20457,0,-2786,0,0,0,,2786,-2786
40,10-01-18,66,16:15,16:30,,48.31,0,48.31,48.31,-1,-87789,99495,187284,11706,0,-2421,0,0,0,,2421,-2421
40,10-01-18,67,16:30,16:45,,,0,51.98,51.98,0,-77859,81248,159107,3389,0,0,0,0,0,,0,0
40,10-01-18,68,16:45,17:00,60.79,,0,60.79,60.79,1,-119444,60697,180141,-58747,0,0,7223,0,0,,7223,7223
40,10-01-18,69,17:00,17:15,53.59,26.03,0,26.03,26.03,-1,-82076,132770,214846,50694,0,-8291,5115,0,0,,13406,-3176
40,10-01-18,70,17:15,17:30,,14.37,0,14.37,14.37,-1,-74422,136211,210633,61789,0,-36323,0,0,0,,36323,-36323
40,10-01-18,71,17:30,17:45,,,0,52.34,52.34,0,-75939,103956,179895,28017,0,-1349,0,0,0,,1349,-1349
40,10-01-18,72,17:45,18:00,51.68,52.96,0,51.68,48.99,2,-83713,90989,174702,7276,0,-11,24,0,0,,35,13
40,10-01-18,73,18:00,18:15,,14.95,0,14.95,14.95,-1,-48186,106640,154826,58454,0,-21742,0,0,0,,21742,-21742
40,10-01-18,74,18:15,18:30,,51.58,0,51.58,51.58,-1,-48858,67313,116171,18455,0,-4023,0,0,0,,4023,-4023
40,10-01-18,75,18:30,18:45,,50.94,0,50.94,50.94,-1,-34416,92340,126756,57924,0,-480,0,0,0,,480,-480
40,10-01-18,76,18:45,19:00,71.41,,0,71.41,71.41,1,-60884,42749,103633,-18135,0,0,5611,0,0,,5611,5611
40,10-01-18,77,19:00,19:15,76.03,52.44,0,76.03,52.44,2,-79157,70108,149265,-9049,0,-389,14770,0,0,,15159,14381
40,10-01-18,78,19:15,19:30,76.03,52.44,0,76.03,76.03,1,-82784,49169,131953,-33615,0,-53,8810,0,0,,8863,8757
40,10-01-18,79,19:30,19:45,76.03,,0,76.03,76.03,1,-100430,36207,136637,-64223,0,0,52035,0,0,,52035,52035
40,10-01-18,80,19:45,20:00,267.34,,0,267.34,267.34,1,-136071,38745,174816,-97326,0,0,83501,0,0,,83501,83501
40,10-01-18,81,20:00,20:15,71.86,,0,71.86,71.86,1,-135614,80077,215691,-55537,0,0,56665,0,0,,56665,56665
40,10-01-18,82,20:15,20:30,63.97,,0,63.97,63.97,1,-122296,82705,205001,-39591,0,0,41096,0,0,,41096,41096
40,10-01-18,83,20:30,20:45,55.87,,0,55.87,55.87,1,-116110,93305,209415,-22805,0,0,20672,0,0,,20672,20672
40,10-01-18,84,20:45,21:00,51.68,24.9,0,24.9,24.9,-1,-96152,137766,233918,41614,0,-16466,7151,0,0,,23617,-9315
40,10-01-18,85,21:00,21:15,55.86,40.79,0,55.86,40.79,2,-59411,57980,117391,-1431,0,-20062,1809,0,0,,21871,-18253
40,10-01-18,86,21:15,21:30,55.86,14.01,0,14.01,14.01,-1,-24419,74830,99249,50411,0,-13358,155,0,0,,13513,-13203
40,10-01-18,87,21:30,21:45,,-5.35,0,-5.35,-5.35,-1,-17726,73095,90821,55369,0,-59535,0,0,0,,59535,-59535
40,10-01-18,88,21:45,22:00,,43.24,0,43.24,43.24,-1,-32959,61172,94131,28213,0,-32471,0,0,0,,32471,-32471
40,10-01-18,89,22:00,22:15,,40.79,0,40.79,40.79,-1,-25747,65797,91544,40050,0,-29063,0,0,0,,29063,-29063
40,10-01-18,90,22:15,22:30,,47.75,0,47.75,47.75,-1,-33728,51048,84776,17320,0,-23509,0,0,0,,23509,-23509
40,10-01-18,91,22:30,22:45,,48.31,0,48.31,48.31,-1,-37972,49435,87407,11463,0,-4286,0,0,0,,4286,-4286
40,10-01-18,92,22:45,23:00,,40.79,0,40.79,40.79,-1,-76338,115587,191925,39249,0,-27122,0,0,0,,27122,-27122
40,10-01-18,93,23:00,23:15,76.03,40.79,0,76.03,40.79,2,-73270,63830,137100,-9440,0,-25243,2726,0,0,,27969,-22517
40,10-01-18,94,23:15,23:30,126.03,40.79,0,126.03,126.03,1,-77705,21016,98721,-56689,0,-502,41932,0,0,,42434,41430
40,10-01-18,95,23:30,23:45,59.23,48.31,0,48.31,48.31,-1,-59688,43813,103501,-15875,0,-70,18177,0,0,,18247,18107
40,10-01-18,96,23:45,0:00,,45.22,0,45.22,45.22,-1,-95448,87925,183373,-7523,0,-6296,0,0,0,,6296,-6296
40,10-02-18,1,0:00,0:15,,44.13,0,44.13,44.13,-1,-58684,82494,141178,23810,0,-5674,0,0,0,,5674,-5674
40,10-02-18,2,0:15,0:30,52.69,44.13,0,52.69,52.69,1,-68387,35924,104311,-32463,0,-117,642,0,0,,759,525
40,10-02-18,3,0:30,0:45,68.89,,0,68.89,68.89,1,-90237,23072,113309,-67165,0,0,19847,0,0,,19847,19847
40,10-02-18,4,0:45,1:00,56.13,,0,56.13,56.13,1,-84067,32501,116568,-51566,0,0,8098,0,0,,8098,8098
40,10-02-18,5,1:00,1:15,62.11,,0,62.11,62.11,1,-92212,32773,124985,-59439,0,0,16525,0,0,,16525,16525
40,10-02-18,6,1:15,1:30,76.26,,0,76.26,76.26,1,-95659,23570,119229,-72089,0,0,50649,0,0,,50649,50649
40,10-02-18,7,1:30,1:45,76.26,46.96,0,46.96,46.96,-1,-60821,47917,108738,-12904,0,-61,9226,0,0,,9287,9165
40,10-02-18,8,1:45,2:00,,42.81,0,42.81,42.81,-1,-67150,95793,162943,28643,0,-16414,0,0,0,,16414,-16414
40,10-02-18,9,2:00,2:15,,35.78,0,35.78,35.78,-1,-56443,92291,148734,35848,0,-24946,0,0,0,,24946,-24946
40,10-02-18,10,2:15,2:30,,9.45,0,9.45,9.45,-1,-57832,108778,166610,50946,0,-15723,0,0,0,,15723,-15723
40,10-02-18,11,2:30,2:45,,-96.5,0,-96.5,-96.5,-1,-23604,106037,129641,82433,0,-61410,0,0,0,,61410,-61410
40,10-02-18,12,2:45,3:00,,20.16,0,20.16,20.16,-1,-22708,115939,138647,93231,0,-73781,0,0,0,,73781,-73781
40,10-02-18,13,3:00,3:15,54.31,24.84,0,54.31,54.31,1,-47952,64863,112815,16911,0,-37630,302,0,0,,37932,-37328
40,10-02-18,14,3:15,3:30,54.31,40.13,0,40.13,40.13,-1,-28564,73990,102554,45426,0,-7559,14,0,0,,7573,-7545
40,10-02-18,15,3:30,3:45,,33.38,0,33.38,33.38,-1,-30220,93583,123803,63363,0,-36046,0,0,0,,36046,-36046
40,10-02-18,16,3:45,4:00,,26.26,0,26.26,26.26,-1,-27135,90521,117656,63386,0,-45854,0,0,0,,45854,-45854
40,10-02-18,17,4:00,4:15,,40.13,0,40.13,40.13,-1,-29006,69523,98529,40517,0,-29561,0,0,0,,29561,-29561
40,10-02-18,18,4:15,4:30,,7.12,0,7.12,7.12,-1,-22225,92705,114930,70480,0,-34002,0,0,0,,34002,-34002
40,10-02-18,19,4:30,4:45,,5.59,0,5.59,5.59,-1,-32411,131063,163474,98652,0,-75836,0,0,0,,75836,-75836
40,10-02-18,20,4:45,5:00,,-37.98,0,-37.98,-37.98,-1,-35209,147102,182311,111893,0,-87051,0,0,0,,87051,-87051
40,10-02-18,21,5:00,5:15,,-71.73,0,-71.73,-71.73,-1,-54797,158941,213738,104144,0,-90861,0,0,0,,90861,-90861
40,10-02-18,22,5:15,5:30,,-17.83,0,-17.83,-17.83,-1,-52502,146352,198854,93850,0,-85701,0,0,0,,85701,-85701
40,10-02-18,23,5:30,5:45,,-37.25,0,-37.25,-37.25,-1,-48767,156969,205736,108202,0,-85739,0,0,0,,85739,-85739
40,10-02-18,24,5:45,6:00,,-137.96,0,-137.96,-137.96,-1,-52266,167074,219340,114808,0,-95946,0,0,0,,95946,-95946
40,10-02-18,25,6:00,6:15,,42.87,0,42.87,42.87,-1,-76553,110557,187110,34004,0,-31646,0,0,0,,31646,-31646
40,10-02-18,26,6:15,6:30,,18.59,0,18.59,18.59,-1,-52416,114001,166417,61585,0,-41606,0,0,0,,41606,-41606
40,10-02-18,27,6:30,6:45,52.71,46.87,0,52.71,46.87,2,-86965,81703,168668,-5262,0,-10909,714,0,0,,11623,-10195
40,10-02-18,28,6:45,7:00,58.87,,0,58.87,58.87,1,-108425,81643,190068,-26782,0,0,5304,0,0,,5304,5304
40,10-02-18,29,7:00,7:15,58.87,18.6,0,18.6,18.6,-1,-56205,122726,178931,66521,0,-18552,938,0,0,,19490,-17614
40,10-02-18,30,7:15,7:30,,12.74,0,12.74,12.74,-1,-54388,105696,160084,51308,0,-51418,0,0,0,,51418,-51418
40,10-02-18,31,7:30,7:45,54.88,12.74,0,54.88,54.88,1,-106889,91270,198159,-15619,0,-2499,1345,0,0,,3844,-1154
40,10-02-18,32,7:45,8:00,75.16,,0,75.16,75.16,1,-137062,76575,213637,-60487,0,0,11256,0,0,,11256,11256
40,10-02-18,33,8:00,8:15,59.88,,0,59.88,59.88,1,-144048,74542,218590,-69506,0,0,16580,0,0,,16580,16580
40,10-02-18,34,8:15,8:30,59.88,51.05,0,51.05,51.05,-1,-66850,61718,128568,-5132,0,-889,916,0,0,,1805,27
40,10-02-18,35,8:30,8:45,,,0,52.33,52.33,0,-93094,56065,149159,-37029,0,-201,0,0,0,,201,-201
40,10-02-18,36,8:45,9:00,,,0,52.33,52.33,0,-124040,45686,169726,-78354,0,0,0,0,0,,0,0
40,10-02-18,37,9:00,9:15,54.87,,0,54.87,54.87,1,-91147,75981,167128,-15166,0,0,2791,0,0,,2791,2791
40,10-02-18,38,9:15,9:30,54.87,,0,54.87,54.87,1,-102417,70098,172515,-32319,0,0,4067,0,0,,4067,4067
40,10-02-18,39,9:30,9:45,59.88,,0,59.88,59.88,1,-116300,72056,188356,-44244,0,0,11776,0,0,,11776,11776
40,10-02-18,40,9:45,10:00,54.87,,0,54.87,54.87,1,-127269,73485,200754,-53784,0,0,9236,0,0,,9236,9236
40,10-02-18,41,10:00,10:15,59.88,,0,59.88,59.88,1,-128614,76271,204885,-52343,0,0,6169,0,0,,6169,6169
40,10-02-18,42,10:15,10:30,75.16,,0,75.16,75.16,1,-155794,69725,225519,-86069,0,0,40225,0,0,,40225,40225
40,10-02-18,43,10:30,10:45,75.16,,0,75.16,75.16,1,-148341,58407,206748,-89934,0,0,59011,0,0,,59011,59011
40,10-02-18,44,10:45,11:00,75.16,,0,75.16,75.16,1,-150325,47759,198084,-102566,0,0,45434,0,0,,45434,45434
40,10-02-18,45,11:00,11:15,245.38,,0,245.38,245.38,1,-170299,26119,196418,-144180,0,0,69597,0,0,,69597,69597
40,10-02-18,46,11:15,11:30,189.48,,0,189.48,189.48,1,-144463,23631,168094,-120832,0,0,110501,0,0,,110501,110501
40,10-02-18,47,11:30,11:45,112.98,,0,112.98,112.98,1,-122905,25170,148075,-97735,0,0,100964,0,0,,100964,100964
40,10-02-18,48,11:45,12:00,251.7,,0,251.7,251.7,1,-115502,27001,142503,-88501,0,0,90003,3750,0,,93753,93753
40,10-02-18,49,12:00,12:15,60.29,,0,60.29,60.29,1,-112250,60104,172354,-52146,0,0,49409,0,0,,49409,49409
40,10-02-18,50,12:15,12:30,56.6,,0,56.6,56.6,1,-113842,64787,178629,-49055,0,0,24226,0,0,,24226,24226
40,10-02-18,51,12:30,12:45,59.88,,0,59.88,59.88,1,-100437,63914,164351,-36523,0,0,10120,0,0,,10120,10120
40,10-02-18,52,12:45,13:00,54.87,51,0,54.87,51,2,-93132,85411,178543,-7721,0,-119,11162,0,0,,11281,11043
40,10-02-18,53,13:00,13:15,54.87,39.96,0,39.96,39.96,-1,-62297,78085,140382,15788,0,-531,679,0,0,,1210,148
40,10-02-18,54,13:15,13:30,,,0,51.83,51.83,0,-55858,78456,134314,22598,0,0,0,0,0,,0,0
40,10-02-18,55,13:30,13:45,,39.96,0,39.96,39.96,-1,-48242,101924,150166,53682,0,-729,0,0,0,,729,-729
40,10-02-18,56,13:45,14:00,,-87.75,0,-87.75,-87.75,-1,-51827,112710,164537,60883,0,-41472,0,0,0,,41472,-41472
40,10-02-18,57,14:00,14:15,,43.96,0,43.96,43.96,-1,-64630,127678,192308,63048,0,-19147,0,0,0,,19147,-19147
40,10-02-18,58,14:15,14:30,,47.18,0,47.18,47.18,-1,-49080,143220,192300,94140,0,-1694,0,0,0,,1694,-1694
40,10-02-18,59,14:30,14:45,,25.16,0,25.16,25.16,-1,-35618,158339,193957,122721,0,-18164,0,0,0,,18164,-18164
40,10-02-18,60,14:45,15:00,,-136.89,0,-136.89,-136.89,-1,-41673,193862,235535,152189,0,-31787,0,0,0,,31787,-31787
40,10-02-18,61,15:00,15:15,,-137.58,0,-137.58,-137.58,-1,-44409,110424,154833,66015,0,-50718,0,0,0,,50718,-50718
40,10-02-18,62,15:15,15:30,,47.18,0,47.18,47.18,-1,-35381,159679,195060,124298,0,-2332,0,0,0,,2332,-2332
40,10-02-18,63,15:30,15:45,,47.18,0,47.18,47.18,-1,-30747,189383,220130,158636,0,-3498,0,0,0,,3498,-3498
40,10-02-18,64,15:45,16:00,,4.69,0,4.69,4.69,-1,-34257,197346,231603,163089,0,-33090,0,0,0,,33090,-33090
40,10-02-18,65,16:00,16:15,,-70.93,0,-70.93,-70.93,-1,-56824,123591,180415,66767,0,-74698,0,0,0,,74698,-74698
40,10-02-18,66,16:15,16:30,,3.28,0,3.28,3.28,-1,-58132,144456,202588,86324,0,-57299,0,0,0,,57299,-57299
40,10-02-18,67,16:30,16:45,,25.16,0,25.16,25.16,-1,-59954,141226,201180,81272,0,-75114,0,0,0,,75114,-75114
40,10-02-18,68,16:45,17:00,,25.16,0,25.16,25.16,-1,-72036,125870,197906,53834,0,-58607,0,0,0,,58607,-58607
40,10-02-18,69,17:00,17:15,,25.16,0,25.16,25.16,-1,-53130,126014,179144,72884,0,-48668,0,0,0,,48668,-48668
40,10-02-18,70,17:15,17:30,54.87,40.98,0,54.87,54.87,1,-81821,92036,173857,10215,0,-25299,810,0,0,,26109,-24489
40,10-02-18,71,17:30,17:45,54.87,51.95,0,51.95,51.95,-1,-65928,73422,139350,7494,0,-179,113,0,0,,292,-66
40,10-02-18,72,17:45,18:00,54.86,,0,54.86,54.86,1,-76881,57836,134717,-19045,0,0,1017,0,0,,1017,1017
40,10-02-18,73,18:00,18:15,54.41,39.96,0,39.96,39.96,-1,-50915,75245,126160,24330,0,-1370,2063,0,0,,3433,693
40,10-02-18,74,18:15,18:30,,25.16,0,25.16,25.16,-1,-49985,95363,145348,45378,0,-25479,0,0,0,,25479,-25479
40,10-02-18,75,18:30,18:45,50.87,51.12,0,52.33,51.12,2,-58068,87289,145357,29221,0,-3166,22,0,0,,3188,-3144
40,10-02-18,76,18:45,19:00,50.87,51.12,0,52.33,51.12,2,-56693,76888,133581,20195,0,-667,553,0,0,,1220,-114
40,10-02-18,77,19:00,19:15,50.87,25.16,0,25.16,25.16,-1,-43734,87751,131485,44017,0,-12400,35,0,0,,12435,-12365
40,10-02-18,78,19:15,19:30,59.88,47.18,0,59.88,59.88,1,-67220,41029,108249,-26191,0,-3701,900,0,0,,4601,-2801
40,10-02-18,79,19:30,19:45,75.16,,0,75.16,75.16,1,-94223,22565,116788,-71658,0,0,36305,0,0,,36305,36305
40,10-02-18,80,19:45,20:00,59.88,,0,59.88,59.88,1,-129548,54717,184265,-74831,0,0,47551,0,0,,47551,47551
40,10-02-18,81,20:00,20:15,290.13,,0,290.13,290.13,1,-136823,49639,186462,-87184,0,0,62002,0,0,,62002,62002
40,10-02-18,82,20:15,20:30,248.15,,0,248.15,248.15,1,-94062,36377,130439,-57685,0,0,67670,2500,0,,70170,70170
40,10-02-18,83,20:30,20:45,248.15,37.2,0,37.2,37.2,-1,-58274,77005,135279,18731,0,-5821,16727,0,0,,22548,10906
40,10-02-18,84,20:45,21:00,,44.93,0,44.93,44.93,-1,-51239,80880,132119,29641,0,-22333,0,0,0,,22333,-22333
40,10-02-18,85,21:00,21:15,54.46,39.96,0,54.46,39.96,2,-70405,83175,153580,12770,0,-22360,247,0,0,,22607,-22113
40,10-02-18,86,21:15,21:30,59.88,39.96,0,59.88,59.88,1,-59695,44575,104270,-15120,0,-1366,3932,0,0,,5298,2566
40,10-02-18,87,21:30,21:45,,46.57,0,46.57,46.57,-1,-43232,55272,98504,12040,0,-1667,0,0,0,,1667,-1667
40,10-02-18,88,21:45,22:00,,42.41,0,42.41,42.41,-1,-51358,76469,127827,25111,0,-18321,0,0,0,,18321,-18321
40,10-02-18,89,22:00,22:15,59.33,47.18,0,59.33,32.11,2,-65435,39904,105339,-25531,0,-10881,3656,0,0,,14537,-7225
40,10-02-18,90,22:15,22:30,59.33,54.21,0,54.21,54.21,-1,-55096,51291,106387,-3805,0,-48,279,0,0,,327,231
40,10-02-18,91,22:30,22:45,,40.43,0,40.43,40.43,-1,-47797,71502,119299,23705,0,-11783,0,0,0,,11783,-11783
40,10-02-18,92,22:45,23:00,,47.18,0,47.18,47.18,-1,-59319,70882,130201,11563,0,-13124,0,0,0,,13124,-13124
40,10-02-18,93,23:00,23:15,242.35,49.78,0,242.35,242.35,1,-162442,43977,206419,-118465,0,-2020,31946,0,0,,33966,29926
40,10-02-18,94,23:15,23:30,222.34,,0,222.34,222.34,1,-84301,32616,116917,-51685,0,0,64403,0,0,,64403,64403
40,10-02-18,95,23:30,23:45,222.34,47.18,0,47.18,47.18,-1,-60545,62959,123504,2414,0,-151,2294,0,0,,2445,2143
40,10-02-18,96,23:45,0:00,,34.11,0,34.11,34.11,-1,-54438,80917,135355,26479,0,-20229,0,0,0,,20229,-20229
40,10-03-18,1,0:00,0:15,229.45,42.87,0,229.45,229.45,1,-128814,63786,192600,-65028,0,-8068,16183,0,0,,24251,8115
40,10-03-18,2,0:15,0:30,193.12,38.87,0,38.87,38.87,-1,-100810,101052,201862,242,0,-1208,28330,0,0,,29538,27122
40,10-03-18,3,0:30,0:45,40.89,24.98,0,40.89,24.98,2,-79129,89207,168336,10078,0,-19059,53,0,0,,19112,-19006
40,10-03-18,4,0:45,1:00,74.98,24.98,0,74.98,74.98,1,-102318,72331,174649,-29987,0,-1358,16298,0,0,,17656,14940
40,10-03-18,5,1:00,1:15,58.87,24.98,0,58.87,24.98,2,-96485,102711,199196,6226,0,-5027,3122,0,0,,8149,-1905
40,10-03-18,6,1:15,1:30,74.98,,0,74.98,74.98,1,-97536,64197,161733,-33339,0,0,23551,0,0,,23551,23551
40,10-03-18,7,1:30,1:45,74.98,38.87,0,38.87,38.87,-1,-72046,75290,147336,3244,0,-710,2344,0,0,,3054,1634
40,10-03-18,8,1:45,2:00,,38.87,0,38.87,38.87,-1,-62833,72547,135380,9714,0,-7852,0,0,0,,7852,-7852
40,10-03-18,9,2:00,2:15,61.4,38.87,0,61.4,61.4,1,-69024,33153,102177,-35871,0,-608,12804,0,0,,13412,12196
40,10-03-18,10,2:15,2:30,56.15,,0,56.15,56.15,1,-67837,46242,114079,-21595,0,0,26653,0,0,,26653,26653
40,10-03-18,11,2:30,2:45,54.65,,0,54.65,54.65,1,-62945,50274,113219,-12671,0,0,4545,0,0,,4545,4545
40,10-03-18,12,2:45,3:00,56.15,,0,56.15,56.15,1,-67679,58988,126667,-8691,0,0,4707,0,0,,4707,4707
40,10-03-18,13,3:00,3:15,91.16,,0,91.16,91.16,1,-95519,20793,116312,-74726,0,0,39888,0,0,,39888,39888
40,10-03-18,14,3:15,3:30,56.15,,0,56.15,56.15,1,-71170,39370,110540,-31800,0,0,31031,0,0,,31031,31031
40,10-03-18,15,3:30,3:45,54.65,,0,54.65,54.65,1,-53585,44369,97954,-9216,0,0,14276,0,0,,14276,14276
40,10-03-18,16,3:45,4:00,54.65,46.87,0,46.87,46.87,-1,-49688,49216,98904,-472,0,-329,335,0,0,,664,6
40,10-03-18,17,4:00,4:15,54.87,46.87,0,54.87,43.92,2,-79874,68129,148003,-11745,0,-346,3336,0,0,,3682,2990
40,10-03-18,18,4:15,4:30,40.91,46.87,0,43.89,43.89,2,-57827,59689,117516,1862,0,-877,692,0,0,,1569,-185
40,10-03-18,19,4:30,4:45,58.4,46.87,0,58.4,58.4,1,-71164,48594,119758,-22570,0,-3,7055,0,0,,7058,7052
40,10-03-18,20,4:45,5:00,54.87,,0,54.87,54.87,1,-61009,50228,111237,-10781,0,0,20594,0,0,,20594,20594
40,10-03-18,21,5:00,5:15,54.87,-81.74,0,-81.74,-81.74,-1,-17308,62113,79421,44805,0,-23501,6143,0,0,,29644,-17358
40,10-03-18,22,5:15,5:30,,38.87,0,38.87,38.87,-1,-46348,58448,104796,12100,0,-18137,0,0,0,,18137,-18137
40,10-03-18,23,5:30,5:45,54.87,46.87,0,54.87,43.89,2,-78793,59687,138480,-19106,0,-748,3342,0,0,,4090,2594
40,10-03-18,24,5:45,6:00,54.65,-8.79,0,54.65,-8.79,2,-65496,89230,154726,23734,0,-3180,6424,0,0,,9604,3244
40,10-03-18,25,6:00,6:15,54.65,-34.26,0,-34.26,-34.26,-1,-52808,97261,150069,44453,0,-36194,246,0,0,,36440,-35948
40,10-03-18,26,6:15,6:30,,40.71,0,40.71,40.71,-1,-46793,65015,111808,18222,0,-26784,0,0,0,,26784,-26784
40,10-03-18,27,6:30,6:45,101.77,40.71,0,101.77,101.77,1,-79348,33641,112989,-45707,0,-3879,25613,0,0,,29492,21734
40,10-03-18,28,6:45,7:00,76.86,,0,76.86,76.86,1,-134464,81554,216018,-52910,0,0,50761,0,0,,50761,50761
40,10-03-18,29,7:00,7:15,260.9,,0,260.9,260.9,1,-203376,44895,248271,-158481,0,0,90293,0,0,,90293,90293
40,10-03-18,30,7:15,7:30,82.75,,0,82.75,82.75,1,-121117,72127,193244,-48990,0,0,38142,0,0,,38142,38142
40,10-03-18,31,7:30,7:45,260.9,,0,260.9,260.9,1,-101093,41155,142248,-59938,0,0,57049,0,0,,57049,57049
40,10-03-18,32,7:45,8:00,55.94,51,0,51,51,-1,-121509,108483,229992,-13026,0,-35,21391,0,0,,21426,21356
40,10-03-18,33,8:00,8:15,55.94,-124.26,0,-124.26,-124.26,-1,-60566,119637,180203,59071,0,-30733,3121,0,0,,33854,-27612
40,10-03-18,34,8:15,8:30,,41.85,0,41.85,41.85,-1,-64312,92464,156776,28152,0,-14976,0,0,0,,14976,-14976
40,10-03-18,35,8:30,8:45,,49.04,0,49.04,49.04,-1,-74238,86894,161132,12656,0,-8049,0,0,0,,8049,-8049
40,10-03-18,36,8:45,9:00,52.71,49.04,0,53.11,49.04,2,-103200,103585,206785,385,0,-3877,60,0,0,,3937,-3817
40,10-03-18,37,9:00,9:15,52.71,49.04,0,52.71,52.71,1,-54426,67130,121556,12704,0,-187,840,0,0,,1027,653
40,10-03-18,38,9:15,9:30,52.71,,0,52.71,52.71,1,-58273,59681,117954,1408,0,0,709,0,0,,709,709
40,10-03-18,39,9:30,9:45,,,0,53.14,53.14,0,-54524,67276,121800,12752,0,0,0,0,0,,0,0
40,10-03-18,40,9:45,10:00,,49.04,0,49.04,49.04,-1,-38724,63217,101941,24493,0,-358,0,0,0,,358,-358
40,10-03-18,41,10:00,10:15,,41.5,0,41.5,41.5,-1,-43516,108910,152426,65394,0,-24778,0,0,0,,24778,-24778
40,10-03-18,42,10:15,10:30,,44.71,0,44.71,44.71,-1,-42968,108059,151027,65091,0,-41260,0,0,0,,41260,-41260
40,10-03-18,43,10:30,10:45,,26.85,0,26.85,26.85,-1,-45076,131753,176829,86677,0,-48731,0,0,0,,48731,-48731
40,10-03-18,44,10:45,11:00,,26.85,0,26.85,26.85,-1,-54279,132915,187194,78636,0,-65547,0,0,0,,65547,-65547
40,10-03-18,45,11:00,11:15,,44.71,0,44.71,44.71,-1,-45545,82171,127716,36626,0,-35398,0,0,0,,35398,-35398
40,10-03-18,46,11:15,11:30,,41.5,0,41.5,41.5,-1,-44529,96742,141271,52213,0,-42913,0,0,0,,42913,-42913
40,10-03-18,47,11:30,11:45,,32.25,0,32.25,32.25,-1,-41219,93022,134241,51803,0,-55206,0,0,0,,55206,-55206
40,10-03-18,48,11:45,12:00,,43.67,0,43.67,43.67,-1,-52473,84115,136588,31642,0,-47333,0,0,0,,47333,-47333
40,10-03-18,49,12:00,12:15,,41.5,0,41.5,41.5,-1,-65007,113569,178576,48562,0,-15791,0,0,0,,15791,-15791
40,10-03-18,50,12:15,12:30,,26.85,0,26.85,26.85,-1,-74805,131593,206398,56788,0,-33510,0,0,0,,33510,-33510
40,10-03-18,51,12:30,12:45,,41.5,0,41.5,41.5,-1,-63875,133717,197592,69842,0,-44865,0,0,0,,44865,-44865
40,10-03-18,52,12:45,13:00,,41.5,0,41.5,41.5,-1,-74157,129200,203357,55043,0,-49187,0,0,0,,49187,-49187
40,10-03-18,53,13:00,13:15,,43.86,0,43.86,43.86,-1,-74751,110259,185010,35508,0,-30136,0,0,0,,30136,-30136
40,10-03-18,54,13:15,13:30,52.71,42.03,0,54.18,42.03,2,-69401,95838,165239,26437,0,-8392,17,0,0,,8409,-8375
40,10-03-18,55,13:30,13:45,,41.5,0,41.5,41.5,-1,-85860,106844,192704,20984,0,-21095,0,0,0,,21095,-21095
40,10-03-18,56,13:45,14:00,54.89,55.66,0,54.89,54.19,2,-72778,69473,142251,-3305,0,-6626,429,0,0,,7055,-6197
40,10-03-18,57,14:00,14:15,,26.85,0,26.85,26.85,-1,-57237,111148,168385,53911,0,-11121,0,0,0,,11121,-11121
40,10-03-18,58,14:15,14:30,,26.85,0,26.85,26.85,-1,-45598,102676,148274,57078,0,-41600,0,0,0,,41600,-41600
40,10-03-18,59,14:30,14:45,,44.71,0,44.71,44.71,-1,-58455,111441,169896,52986,0,-32757,0,0,0,,32757,-32757
40,10-03-18,60,14:45,15:00,,44.71,0,44.71,44.71,-1,-67590,113262,180852,45672,0,-33482,0,0,0,,33482,-33482
40,10-03-18,61,15:00,15:15,,6.55,0,6.55,6.55,-1,-86496,161702,248198,75206,0,-43701,0,0,0,,43701,-43701
40,10-03-18,62,15:15,15:30,,41.85,0,41.85,41.85,-1,-91651,150387,242038,58736,0,-63062,0,0,0,,63062,-63062
40,10-03-18,63,15:30,15:45,,45.85,0,45.85,45.85,-1,-114624,139433,254057,24809,0,-30339,0,0,0,,30339,-30339
40,10-03-18,64,15:45,16:00,,49.22,0,49.22,49.22,-1,-120992,131253,252245,10261,0,-7306,0,0,0,,7306,-7306
40,10-03-18,65,16:00,16:15,54.12,51.43,0,54.23,51.43,2,-116488,117781,234269,1293,0,-1096,686,0,0,,1782,-410
40,10-03-18,66,16:15,16:30,,49.04,0,49.04,49.04,-1,-89160,108351,197511,19191,0,-8862,0,0,0,,8862,-8862
40,10-03-18,67,16:30,16:45,,49.04,0,49.04,49.04,-1,-91784,108570,200354,16786,0,-10920,0,0,0,,10920,-10920
40,10-03-18,68,16:45,17:00,,52.93,0,52.93,52.93,-1,-116962,118555,235517,1593,0,-5526,0,0,0,,5526,-5526
40,10-03-18,69,17:00,17:15,,41.85,0,41.85,41.85,-1,-74114,108193,182307,34079,0,-16210,0,0,0,,16210,-16210
40,10-03-18,70,17:15,17:30,60.71,52.97,0,60.71,52.97,2,-114784,101665,216449,-13119,0,-5706,4138,0,0,,9844,-1568
40,10-03-18,71,17:30,17:45,62.37,,0,62.37,62.37,1,-100490,69693,170183,-30797,0,0,15976,0,0,,15976,15976
40,10-03-18,72,17:45,18:00,62.37,,0,62.37,62.37,1,-100451,73626,174077,-26825,0,0,29757,0,0,,29757,29757
40,10-03-18,73,18:00,18:15,62.37,49.22,0,49.22,49.22,-1,-72851,69094,141945,-3757,0,-2707,7837,0,0,,10544,5130
40,10-03-18,74,18:15,18:30,,52.97,0,52.97,52.97,-1,-66923,67299,134222,376,0,-314,0,0,0,,314,-314
40,10-03-18,75,18:30,18:45,55.29,,0,55.29,55.29,1,-64191,59268,123459,-4923,0,0,310,0,0,,310,310
40,10-03-18,76,18:45,19:00,56.71,52.97,0,56.71,52.97,2,-94733,92277,187010,-2456,0,-419,321,0,0,,740,-98
40,10-03-18,77,19:00,19:15,58.05,49.04,0,58.05,49.04,2,-96174,99974,196148,3800,0,-4232,406,0,0,,4638,-3826
40,10-03-18,78,19:15,19:30,98.05,49.04,0,98.05,98.05,1,-104140,38917,143057,-65223,0,-88,19146,0,0,,19234,19058
40,10-03-18,79,19:30,19:45,289.85,,0,289.85,289.85,1,-129694,27273,156967,-102421,0,0,74924,0,0,,74924,74924
40,10-03-18,80,19:45,20:00,98.05,,0,98.05,98.05,1,-114689,33957,148646,-80732,0,0,70107,0,0,,70107,70107
40,10-03-18,81,20:00,20:15,82.7,,0,82.7,82.7,1,-100029,27775,127804,-72254,0,0,63069,0,0,,63069,63069
40,10-03-18,82,20:15,20:30,72.7,43.67,0,43.67,43.67,-1,-57681,49314,106995,-8367,0,-1111,39103,0,0,,40214,37992
40,10-03-18,83,20:30,20:45,72.7,31.58,0,31.58,31.58,-1,-56249,71108,127357,14859,0,-18574,1003,0,0,,19577,-17571
40,10-03-18,84,20:45,21:00,,41.85,0,41.85,41.85,-1,-57251,94102,151353,36851,0,-19609,0,0,0,,19609,-19609
40,10-03-18,85,21:00,21:15,182.82,39.93,0,182.82,39.93,2,-89034,51080,140114,-37954,0,-21236,11195,0,0,,32431,-10041
40,10-03-18,86,21:15,21:30,56.71,52.58,0,56.71,52.58,2,-60095,66059,126154,5964,0,-754,5732,0,0,,6486,4978
40,10-03-18,87,21:30,21:45,,41.85,0,41.85,41.85,-1,-36599,75315,111914,38716,0,-22229,0,0,0,,22229,-22229
40,10-03-18,88,21:45,22:00,56.62,45.85,0,56.62,56.62,1,-65499,75246,140745,9747,0,-23963,312,0,0,,24275,-23651
40,10-03-18,89,22:00,22:15,60.89,45.85,0,60.89,60.89,1,-99997,22987,122984,-77010,0,-545,6916,0,0,,7461,6371
40,10-03-18,90,22:15,22:30,60.89,53.58,0,53.58,53.58,-1,-64646,34478,99124,-30168,0,-8,535,0,0,,543,527
40,10-03-18,91,22:30,22:45,,43.53,0,43.53,43.53,-1,-37714,60742,98456,23028,0,-12971,0,0,0,,12971,-12971
40,10-03-18,92,22:45,23:00,52.71,48.71,0,52.71,48.71,2,-114830,85848,200678,-28982,0,-2939,489,0,0,,3428,-2450
40,10-03-18,93,23:00,23:15,,44.71,0,44.71,44.71,-1,-48371,119074,167445,70703,0,-3267,0,0,0,,3267,-3267
40,10-03-18,94,23:15,23:30,,,0,49.18,49.18,0,-43057,76342,119399,33285,0,0,0,0,0,,0,0
40,10-03-18,95,23:30,23:45,,,0,49.18,49.18,0,-49870,88680,138550,38810,0,0,0,0,0,,0,0
40,10-03-18,96,23:45,0:00,,55.39,0,55.39,55.39,-1,-55979,115931,171910,59952,0,-60,0,0,0,,60,-60
40,10-04-18,1,0:00,0:15,62.3,54.93,0,62.3,50.03,2,-51797,25756,77553,-26041,0,-22,7054,0,0,,7076,7032
40,10-04-18,2,0:15,0:30,60.71,,0,60.71,60.71,1,-46069,28310,74379,-17759,0,0,23208,0,0,,23208,23208
40,10-04-18,3,0:30,0:45,60.71,30.61,0,30.61,30.61,-1,-16410,51162,67572,34752,0,-14670,3908,0,0,,18578,-10762
40,10-04-18,4,0:45,1:00,,44.71,0,44.71,44.71,-1,-17822,63358,81180,45536,0,-43279,0,0,0,,43279,-43279
40,10-04-18,5,1:00,1:15,61.4,44.86,0,61.4,44.86,2,-75653,49346,124999,-26307,0,-18638,2489,0,0,,21127,-16149
40,10-04-18,6,1:15,1:30,54.01,,0,54.01,54.01,1,-42337,32815,75152,-9522,0,0,763,0,0,,763,763
40,10-04-18,7,1:30,1:45,,40.71,0,40.71,40.71,-1,-50174,83076,133250,32902,0,-11418,0,0,0,,11418,-11418
40,10-04-18,8,1:45,2:00,,29.83,0,29.83,29.83,-1,-52791,97793,150584,45002,0,-45137,0,0,0,,45137,-45137
40,10-04-18,9,2:00,2:15,57.22,44.71,0,57.22,57.22,1,-69162,58513,127675,-10649,0,-22276,926,0,0,,23202,-21350
40,10-04-18,10,2:15,2:30,57.46,44.71,0,57.46,57.46,1,-67826,48729,116555,-19097,0,-69,6461,0,0,,6530,6392
40,10-04-18,11,2:30,2:45,55.18,,0,55.18,55.18,1,-61781,44827,106608,-16954,0,0,3989,0,0,,3989,3989
40,10-04-18,12,2:45,3:00,54.01,,0,54.01,54.01,1,-69263,59834,129097,-9429,0,0,4339,0,0,,4339,4339
40,10-04-18,13,3:00,3:15,60.71,,0,60.71,60.71,1,-61980,35629,97609,-26351,0,0,4687,0,0,,4687,4687
40,10-04-18,14,3:15,3:30,56.71,,0,56.71,56.71,1,-63768,29640,93408,-34128,0,0,18174,0,0,,18174,18174
40,10-04-18,15,3:30,3:45,56.71,,0,56.71,56.71,1,-69871,46489,116360,-23382,0,0,17900,0,0,,17900,17900
40,10-04-18,16,3:45,4:00,56.71,48.71,0,48.71,48.71,-1,-70445,57541,127986,-12904,0,-152,5832,0,0,,5984,5680
40,10-04-18,17,4:00,4:15,52.71,48.71,0,52.71,52.71,1,-57367,58179,115546,812,0,-274,2,0,0,,276,-272
40,10-04-18,18,4:15,4:30,59.35,,0,59.35,59.35,1,-62088,34057,96145,-28031,0,0,9243,0,0,,9243,9243
40,10-04-18,19,4:30,4:45,56.71,,0,56.71,56.71,1,-64243,41924,106167,-22319,0,0,9895,0,0,,9895,9895
40,10-04-18,20,4:45,5:00,56.71,,0,56.71,56.71,1,-79267,57436,136703,-21831,0,0,11738,0,0,,11738,11738
40,10-04-18,21,5:00,5:15,60.71,,0,60.71,60.71,1,-116663,44613,161276,-72050,0,0,15847,0,0,,15847,15847
40,10-04-18,22,5:15,5:30,65.68,,0,65.68,65.68,1,-91607,45644,137251,-45963,0,0,16852,0,0,,16852,16852
40,10-04-18,23,5:30,5:45,64.96,,0,64.96,64.96,1,-104202,43127,147329,-61075,0,0,41733,0,0,,41733,41733
40,10-04-18,24,5:45,6:00,60.71,48.78,0,48.78,48.78,-1,-81560,116549,198109,34989,0,-903,22572,0,0,,23475,21669
40,10-04-18,25,6:00,6:15,60.71,52.97,0,52.97,52.97,-1,-90872,77297,168169,-13575,0,-474,23,0,0,,497,-451
40,10-04-18,26,6:15,6:30,57.41,,0,57.41,57.41,1,-51899,48962,100861,-2937,0,0,1011,0,0,,1011,1011
40,10-04-18,27,6:30,6:45,75.59,,0,75.59,75.59,1,-84724,17167,101891,-67557,0,0,26242,0,0,,26242,26242
40,10-04-18,28,6:45,7:00,171.91,,0,171.91,171.91,1,-84978,15686,100664,-69292,0,0,54316,0,0,,54316,54316
40,10-04-18,29,7:00,7:15,171.91,2.48,0,2.48,2.48,-1,-39012,153313,192325,114301,0,-11792,14781,0,0,,26573,2989
40,10-04-18,30,7:15,7:30,,55.76,0,55.76,55.76,-1,-31538,79981,111519,48443,0,-1195,0,0,0,,1195,-1195
40,10-04-18,31,7:30,7:45,79.8,,0,79.8,79.8,1,-81373,29727,111100,-51646,0,0,14990,0,0,,14990,14990
40,10-04-18,32,7:45,8:00,259.98,,0,259.98,259.98,1,-141016,25335,166351,-115681,0,0,79413,0,0,,79413,79413
40,10-04-18,33,8:00,8:15,,,0,52.63,52.63,0,-75264,67147,142411,-8117,0,0,39425,0,0,,39425,39425
40,10-04-18,34,8:15,8:30,,,0,52.63,52.63,0,-102180,53084,155264,-49096,0,0,0,0,0,,0,0
40,10-04-18,35,8:30,8:45,,,0,52.63,52.63,0,-142621,47188,189809,-95433,0,0,0,0,0,,0,0
40,10-04-18,36,8:45,9:00,55.33,,0,55.33,55.33,1,-175255,48120,223375,-127135,0,0,1115,0,0,,1115,1115
40,10-04-18,37,9:00,9:15,95.12,,0,95.12,95.12,1,-193507,121516,315023,-71991,0,0,22969,0,0,,22969,22969
40,10-04-18,38,9:15,9:30,60.33,,0,60.33,60.33,1,-173633,115345,288978,-58288,0,0,21686,0,0,,21686,21686
40,10-04-18,39,9:30,9:45,51.47,,0,51.47,51.47,1,-150279,124509,274788,-25770,0,0,5624,0,0,,5624,5624
40,10-04-18,40,9:45,10:00,,,0,52.63,52.63,0,-148455,127527,275982,-20928,0,0,0,0,0,,0,0
40,10-04-18,41,10:00,10:15,55.13,,0,55.13,55.13,1,-178203,117347,295550,-60856,0,0,592,0,0,,592,592
40,10-04-18,42,10:15,10:30,55.17,,0,55.17,55.17,1,-177459,104472,281931,-72987,0,0,1329,0,0,,1329,1329
40,10-04-18,43,10:30,10:45,,,0,52.63,52.63,0,-173639,118653,292292,-54986,0,0,0,0,0,,0,0
40,10-04-18,44,10:45,11:00,,,0,52.63,52.63,0,-151053,128265,279318,-22788,0,0,0,0,0,,0,0
40,10-04-18,45,11:00,11:15,81.2,,0,81.2,81.2,1,-176627,91730,268357,-84897,0,0,17706,0,0,,17706,17706
40,10-04-18,46,11:15,11:30,71.89,,0,71.89,71.89,1,-157220,94181,251401,-63039,0,0,39460,0,0,,39460,39460
40,10-04-18,47,11:30,11:45,55.47,,0,55.47,55.47,1,-134534,95746,230280,-38788,0,0,13417,0,0,,13417,13417
40,10-04-18,48,11:45,12:00,54.8,51.47,0,54.8,51.47,2,-128382,106553,234935,-21829,0,-65,1582,0,0,,1647,1517
40,10-04-18,49,12:00,12:15,54.8,43.47,0,43.47,43.47,-1,-121784,126289,248073,4505,0,-5409,2,0,0,,5411,-5407
40,10-04-18,50,12:15,12:30,,40.23,0,40.23,40.23,-1,-101162,134194,235356,33032,0,-42551,0,0,0,,42551,-42551
40,10-04-18,51,12:30,12:45,,25.57,0,25.57,25.57,-1,-80088,146203,226291,66115,0,-68484,0,0,0,,68484,-68484
40,10-04-18,52,12:45,13:00,,36.03,0,36.03,36.03,-1,-87135,150067,237202,62932,0,-82550,0,0,0,,82550,-82550
40,10-04-18,53,13:00,13:15,,40.23,0,40.23,40.23,-1,-105011,135479,240490,30468,0,-60481,0,0,0,,60481,-60481
40,10-04-18,54,13:15,13:30,,40.23,0,40.23,40.23,-1,-100494,120074,220568,19580,0,-22280,0,0,0,,22280,-22280
40,10-04-18,55,13:30,13:45,,40.23,0,40.23,40.23,-1,-110951,125663,236614,14712,0,-32921,0,0,0,,32921,-32921
40,10-04-18,56,13:45,14:00,,40.23,0,40.23,40.23,-1,-100409,121357,221766,20948,0,-26707,0,0,0,,26707,-26707
40,10-04-18,57,14:00,14:15,75.57,40.23,0,75.57,40.23,2,-129452,98060,227512,-31392,0,-24200,3366,0,0,,27566,-20834
40,10-04-18,58,14:15,14:30,75.57,40.23,0,75.57,75.57,1,-135596,103747,239343,-31849,0,-173,9715,0,0,,9888,9542
40,10-04-18,59,14:30,14:45,59.47,,0,59.47,59.47,1,-141612,101147,242759,-40465,0,0,16152,0,0,,16152,16152
40,10-04-18,60,14:45,15:00,61.62,,0,61.62,61.62,1,-140201,83841,224042,-56360,0,0,25533,0,0,,25533,25533
40,10-04-18,61,15:00,15:15,55.47,50.37,0,50.37,50.37,-1,-127666,111444,239110,-16222,0,-503,15913,0,0,,16416,15410
40,10-04-18,62,15:15,15:30,69.12,48.12,0,69.12,48.12,2,-139902,100914,240816,-38988,0,-1155,7105,0,0,,8260,5950
40,10-04-18,63,15:30,15:45,75.57,,0,75.57,75.57,1,-143283,106060,249343,-37223,0,0,29119,0,0,,29119,29119
40,10-04-18,64,15:45,16:00,59.47,,0,59.47,59.47,1,-144009,112961,256970,-31048,0,0,15057,0,0,,15057,15057
40,10-04-18,65,16:00,16:15,81.21,,0,81.21,81.21,1,-145168,108245,253413,-36923,0,0,19323,0,0,,19323,19323
40,10-04-18,66,16:15,16:30,90.63,,0,90.63,90.63,1,-121649,69075,190724,-52574,0,0,19580,0,0,,19580,19580
40,10-04-18,67,16:30,16:45,63.71,,0,63.71,63.71,1,-106305,73370,179675,-32935,0,0,31167,0,0,,31167,31167
40,10-04-18,68,16:45,17:00,75.57,,0,75.57,75.57,1,-118720,62882,181602,-55838,0,0,34513,0,0,,34513,34513
40,10-04-18,69,17:00,17:15,64.12,36.98,0,64.12,36.98,2,-65173,107025,172198,41852,0,-4545,20351,0,0,,24896,15806
40,10-04-18,70,17:15,17:30,55.47,51.47,0,55.47,51.47,2,-90203,84870,175073,-5333,0,-1426,585,0,0,,2011,-841
40,10-04-18,71,17:30,17:45,55.47,,0,55.47,55.47,1,-98471,98396,196867,-75,0,0,3258,0,0,,3258,3258
40,10-04-18,72,17:45,18:00,51.47,,0,51.47,51.47,1,-98222,104427,202649,6205,0,0,2159,0,0,,2159,2159
40,10-04-18,73,18:00,18:15,51.47,25.57,0,53.63,25.57,2,-107512,163589,271101,56077,0,-18585,644,0,0,,19229,-17941
40,10-04-18,74,18:15,18:30,,40.23,0,40.23,40.23,-1,-116313,181609,297922,65296,0,-45362,0,0,0,,45362,-45362
40,10-04-18,75,18:30,18:45,,,0,53.63,53.63,0,-97733,181748,279481,84015,0,-7868,0,0,0,,7868,-7868
40,10-04-18,76,18:45,19:00,,,0,53.63,53.63,0,-73707,173005,246712,99298,0,0,0,0,0,,0,0
40,10-04-18,77,19:00,19:15,,48.57,0,48.57,48.57,-1,-51941,169017,220958,117076,0,-819,0,0,0,,819,-819
40,10-04-18,78,19:15,19:30,,,0,53.63,53.63,0,-60554,142575,203129,82021,0,0,0,0,0,,0,0
40,10-04-18,79,19:30,19:45,,,0,32.9,32.9,0,-106227,110160,216387,3933,0,0,0,0,0,,0,0
40,10-04-18,80,19:45,20:00,55.64,,0,55.64,55.64,1,-132069,108963,241032,-23106,0,0,140,0,0,,140,140
40,10-04-18,81,20:00,20:15,154.12,,0,154.12,154.12,1,-158408,97408,255816,-61000,0,0,34027,0,0,,34027,34027
40,10-04-18,82,20:15,20:30,64.18,,0,64.18,64.18,1,-118391,98666,217057,-19725,0,0,28505,0,0,,28505,28505
40,10-04-18,83,20:30,20:45,64.18,46.22,0,46.22,46.22,-1,-97098,102902,200000,5804,0,-2234,1814,0,0,,4048,-420
40,10-04-18,84,20:45,21:00,,42.05,0,42.05,42.05,-1,-103034,124819,227853,21785,0,-24200,0,0,0,,24200,-24200
40,10-04-18,85,21:00,21:15,84.18,44.57,0,84.18,32.58,2,-108266,44156,152422,-64110,0,-13863,10519,0,0,,24382,-3344
40,10-04-18,86,21:15,21:30,60.49,,0,60.49,60.49,1,-96543,52284,148827,-44259,0,0,14985,0,0,,14985,14985
40,10-04-18,87,21:30,21:45,60.49,43.67,0,43.67,43.67,-1,-69011,84151,153162,15140,0,-2479,4817,0,0,,7296,2338
40,10-04-18,88,21:45,22:00,,40.63,0,40.63,40.63,-1,-90787,104973,195760,14186,0,-27844,0,0,0,,27844,-27844
40,10-04-18,89,22:00,22:15,60.49,40.63,0,60.49,60.49,1,-117395,58867,176262,-58528,0,-6437,2796,0,0,,9233,-3641
40,10-04-18,90,22:15,22:30,51.47,,0,51.47,51.47,1,-97088,29960,127048,-67128,0,0,31,0,0,,31,31
40,10-04-18,91,22:30,22:45,,48.88,0,48.88,48.88,-1,-59761,58283,118044,-1478,0,-919,0,0,0,,919,-919
40,10-04-18,92,22:45,23:00,,25.09,0,25.09,25.09,-1,-46256,99304,145560,53048,0,-34281,0,0,0,,34281,-34281
40,10-04-18,93,23:00,23:15,77.65,7.44,0,77.65,7.44,2,-90673,91176,181849,503,0,-40839,2395,0,0,,43234,-38444
40,10-04-18,94,23:15,23:30,125.81,-39.2,0,125.81,-39.2,2,-57806,112257,170063,54451,0,-10228,7658,0,0,,17886,-2570
40,10-04-18,95,23:30,23:45,,-109.08,0,-109.08,-109.08,-1,-49145,113934,163079,64789,0,-47550,0,0,0,,47550,-47550
40,10-04-18,96,23:45,0:00,,-18.28,0,-18.28,-18.28,-1,-60888,134758,195646,73870,0,-65707,0,0,0,,65707,-65707
40,10-05-18,1,0:00,0:15,60.02,40.02,0,60.02,31.71,2,-48627,57246,105873,8619,0,-27034,774,0,0,,27808,-26260
40,10-05-18,2,0:15,0:30,60.02,48.02,0,60.02,48.02,2,-34696,37105,71801,2409,0,-2293,1320,0,0,,3613,-973
40,10-05-18,3,0:30,0:45,60.02,49.77,0,60.02,49.77,2,-72412,42255,114667,-30157,0,-877,7135,0,0,,8012,6258
40,10-05-18,4,0:45,1:00,52.02,40.02,0,40.02,40.02,-1,-49525,66420,115945,16895,0,-7387,1460,0,0,,8847,-5927
40,10-05-18,5,1:00,1:15,,40.02,0,40.02,40.02,-1,-61571,67712,129283,6141,0,-12185,0,0,0,,12185,-12185
40,10-05-18,6,1:15,1:30,,45.17,0,45.17,45.17,-1,-48365,62580,110945,14215,0,-9895,0,0,0,,9895,-9895
40,10-05-18,7,1:30,1:45,,48.02,0,48.02,48.02,-1,-51127,67876,119003,16749,0,-16146,0,0,0,,16146,-16146
40,10-05-18,8,1:45,2:00,,40.02,0,40.02,40.02,-1,-43106,73329,116435,30223,0,-24783,0,0,0,,24783,-24783
40,10-05-18,9,2:00,2:15,,43.61,0,43.61,43.61,-1,-66613,73695,140308,7082,0,-23322,0,0,0,,23322,-23322
40,10-05-18,10,2:15,2:30,40.99,43.61,0,40.99,40.99,1,-75381,69453,144834,-5928,0,-959,419,0,0,,1378,-540
40,10-05-18,11,2:30,2:45,54.74,52.9,0,54.74,46.96,2,-75103,55555,130658,-19548,0,-63,1034,0,0,,1097,971
40,10-05-18,12,2:45,3:00,54.74,48.46,0,48.46,48.46,-1,-76240,73338,149578,-2902,0,-1084,39,0,0,,1123,-1045
40,10-05-18,13,3:00,3:15,41.08,48.7,0,47.06,47.06,2,-81655,73849,155504,-7806,0,-2644,51,0,0,,2695,-2593
40,10-05-18,14,3:15,3:30,41.06,,0,41.06,41.06,1,-77900,68103,146003,-9797,0,0,1167,0,0,,1167,1167
40,10-05-18,15,3:30,3:45,54.75,,0,54.75,54.75,1,-76212,57800,134012,-18412,0,0,2174,0,0,,2174,2174
40,10-05-18,16,3:45,4:00,56.02,,0,56.02,56.02,1,-81181,53246,134427,-27935,0,0,8962,0,0,,8962,8962
40,10-05-18,17,4:00,4:15,57.83,,0,57.83,57.83,1,-103683,53785,157468,-49898,0,0,19103,0,0,,19103,19103
40,10-05-18,18,4:15,4:30,56.02,,0,56.02,56.02,1,-66887,40355,107242,-26532,0,0,15365,0,0,,15365,15365
40,10-05-18,19,4:30,4:45,56.02,,0,56.02,56.02,1,-51032,30578,81610,-20454,0,0,4236,0,0,,4236,4236
40,10-05-18,20,4:45,5:00,56.02,,0,56.02,56.02,1,-47065,19774,66839,-27291,0,0,11238,0,0,,11238,11238
40,10-05-18,21,5:00,5:15,52.02,46.84,0,52.66,46.84,2,-60264,60178,120442,-86,0,-3411,4946,0,0,,8357,1535
40,10-05-18,22,5:15,5:30,54.91,50.59,0,54.91,54.91,1,-47359,27793,75152,-19566,0,-2417,1029,0,0,,3446,-1388
40,10-05-18,23,5:30,5:45,56.02,,0,56.02,56.02,1,-53144,22865,76009,-30279,0,0,5764,0,0,,5764,5764
40,10-05-18,24,5:45,6:00,56.69,,0,56.69,56.69,1,-47871,29116,76987,-18755,0,0,9421,0,0,,9421,9421
40,10-05-18,25,6:00,6:15,60.24,47.51,0,60.24,47.51,2,-120358,87499,207857,-32859,0,-867,11373,0,0,,12240,10506
40,10-05-18,26,6:15,6:30,79.42,47.51,0,79.42,79.42,1,-106764,57777,164541,-48987,0,-661,9868,0,0,,10529,9207
40,10-05-18,27,6:30,6:45,87.47,,0,87.47,87.47,1,-105283,32394,137677,-72889,0,0,51905,0,0,,51905,51905
40,10-05-18,28,6:45,7:00,246.01,,0,246.01,246.01,1,-141846,35703,177549,-106143,0,0,75598,0,0,,75598,75598
40,10-05-18,29,7:00,7:15,256.06,29.87,0,29.87,29.87,-1,-134191,104688,238879,-29503,0,-2651,60408,0,0,,63059,57757
40,10-05-18,30,7:15,7:30,256.06,25.73,0,25.73,25.73,-1,-87471,75113,162584,-12358,0,-9759,907,0,0,,10666,-8852
40,10-05-18,31,7:30,7:45,,,0,52.07,52.07,0,-131455,78255,209710,-53200,0,0,0,0,0,,0,0
40,10-05-18,32,7:45,8:00,,,0,52.02,52.02,0,-154678,76924,231602,-77754,0,0,0,0,0,,0,0
40,10-05-18,33,8:00,8:15,,,0,52.13,52.13,0,-75019,48436,123455,-26583,0,0,0,0,0,,0,0
40,10-05-18,34,8:15,8:30,,,0,52.12,52.12,0,-78162,31679,109841,-46483,0,0,0,0,0,,0,0
40,10-05-18,35,8:30,8:45,,,0,52.08,52.08,0,-82454,30356,112810,-52098,0,0,0,0,0,,0,0
40,10-05-18,36,8:45,9:00,,,0,52.06,52.06,0,-78978,26950,105928,-52028,0,0,0,0,0,,0,0
40,10-05-18,37,9:00,9:15,54.66,,0,54.66,54.66,1,-94129,87212,181341,-6917,0,0,295,0,0,,295,295
40,10-05-18,38,9:15,9:30,,47.02,0,47.02,47.02,-1,-85500,92261,177761,6761,0,-1745,0,0,0,,1745,-1745
40,10-05-18,39,9:30,9:45,,40.4,0,40.4,40.4,-1,-67093,85346,152439,18253,0,-17060,0,0,0,,17060,-17060
40,10-05-18,40,9:45,10:00,,48.24,0,48.24,48.24,-1,-60289,65994,126283,5705,0,-12370,0,0,0,,12370,-12370
40,10-05-18,41,10:00,10:15,60.4,45.54,0,60.4,45.54,2,-74784,57571,132355,-17213,0,-8501,3860,0,0,,12361,-4641
40,10-05-18,42,10:15,10:30,60.4,44.24,0,44.24,44.24,-1,-61798,77518,139316,15720,0,-7116,888,0,0,,8004,-6228
40,10-05-18,43,10:30,10:45,,41.81,0,41.81,41.81,-1,-53459,75954,129413,22495,0,-22111,0,0,0,,22111,-22111
40,10-05-18,44,10:45,11:00,,40.4,0,40.4,40.4,-1,-64054,96265,160319,32211,0,-24607,0,0,0,,24607,-24607
40,10-05-18,45,11:00,11:15,75.59,33.5,0,75.59,33.5,2,-92347,70134,162481,-22213,0,-21628,4233,0,0,,25861,-17395
40,10-05-18,46,11:15,11:30,42.58,46.22,0,47.83,46.22,2,-75022,81458,156480,6436,0,-2586,1232,0,0,,3818,-1354
40,10-05-18,47,11:30,11:45,,34.94,0,34.94,34.94,-1,-68333,101001,169334,32668,0,-22396,0,0,0,,22396,-22396
40,10-05-18,48,11:45,12:00,,40.4,0,40.4,40.4,-1,-62429,102371,164800,39942,0,-40715,0,0,0,,40715,-40715
40,10-05-18,49,12:00,12:15,60.4,43.88,0,60.4,43.88,2,-108673,66537,175210,-42136,0,-19998,2555,0,0,,22553,-17443
40,10-05-18,50,12:15,12:30,,,0,47.92,47.92,0,-94847,55151,149998,-39696,0,0,106,0,0,,106,106
40,10-05-18,51,12:30,12:45,,,0,47.94,47.94,0,-84318,60465,144783,-23853,0,0,0,0,0,,0,0
40,10-05-18,52,12:45,13:00,,49.97,0,49.97,49.97,-1,-76849,69546,146395,-7303,0,-703,0,0,0,,703,-703
40,10-05-18,53,13:00,13:15,,48.24,0,48.24,48.24,-1,-68387,53874,122261,-14513,0,-823,0,0,0,,823,-823
40,10-05-18,54,13:15,13:30,,,0,47.78,47.78,0,-78651,35842,114493,-42809,0,0,0,0,0,,0,0
40,10-05-18,55,13:30,13:45,,,0,47.79,47.79,0,-83392,33223,116615,-50169,0,0,0,0,0,,0,0
40,10-05-18,56,13:45,14:00,,,0,47.79,47.79,0,-83798,43066,126864,-40732,0,0,0,0,0,,0,0
40,10-05-18,57,14:00,14:15,,,0,47.68,47.68,0,-63983,42862,106845,-21121,0,0,0,0,0,,0,0
40,10-05-18,58,14:15,14:30,,,0,47.67,47.67,0,-76686,40673,117359,-36013,0,0,0,0,0,,0,0
40,10-05-18,59,14:30,14:45,,,0,47.68,47.68,0,-85614,36730,122344,-48884,0,0,0,0,0,,0,0
40,10-05-18,60,14:45,15:00,42.12,,0,42.12,42.12,1,-84829,25644,110473,-59185,0,0,215,0,0,,215,215
40,10-05-18,61,15:00,15:15,42.06,40.4,0,47.64,40.4,2,-71008,77347,148355,6339,0,-2362,286,0,0,,2648,-2076
40,10-05-18,62,15:15,15:30,,36.23,0,36.23,36.23,-1,-57234,67793,125027,10559,0,-21199,0,0,0,,21199,-21199
40,10-05-18,63,15:30,15:45,52.24,36.23,0,52.24,52.24,1,-60256,44778,105034,-15478,0,-948,408,0,0,,1356,-540
40,10-05-18,64,15:45,16:00,,,0,47.61,47.61,0,-67563,38972,106535,-28591,0,0,225,0,0,,225,225
40,10-05-18,65,16:00,16:15,,44.81,0,44.81,44.81,-1,-97410,96683,194093,-727,0,-3652,0,0,0,,3652,-3652
40,10-05-18,66,16:15,16:30,,48.92,0,48.92,48.92,-1,-66753,63366,130119,-3387,0,-10440,0,0,0,,10440,-10440
40,10-05-18,67,16:30,16:45,60.4,48.92,0,60.4,60.4,1,-75137,37457,112594,-37680,0,-749,2247,0,0,,2996,1498
40,10-05-18,68,16:45,17:00,137.89,,0,137.89,137.89,1,-83803,23209,107012,-60594,0,0,11416,0,0,,11416,11416
40,10-05-18,69,17:00,17:15,267.3,49.76,0,267.3,49.76,2,-154784,36313,191097,-118471,0,-137,48632,0,0,,48769,48495
40,10-05-18,70,17:15,17:30,60.4,31.58,0,60.4,31.58,2,-43951,25046,68997,-18905,0,-4736,2587,0,0,,7323,-2149
40,10-05-18,71,17:30,17:45,146.22,,0,146.22,146.22,1,-94399,16326,110725,-78073,0,0,33042,0,0,,33042,33042
40,10-05-18,72,17:45,18:00,267.3,,0,267.3,267.3,1,-101450,20160,121610,-81290,0,0,77938,0,0,,77938,77938
40,10-05-18,73,18:00,18:15,65.48,,0,65.48,65.48,1,-99381,38924,138305,-60457,0,0,31771,0,0,,31771,31771
40,10-05-18,74,18:15,18:30,,,0,53.07,53.07,0,-98731,25912,124643,-72819,0,0,24,0,0,,24,24
40,10-05-18,75,18:30,18:45,,,0,53.08,53.08,0,-91556,20295,111851,-71261,0,0,0,0,0,,0,0
40,10-05-18,76,18:45,19:00,256.49,,0,256.49,256.49,1,-100060,7717,107777,-92343,0,0,15862,0,0,,15862,15862
40,10-05-18,77,19:00,19:15,63.39,46.9,0,63.39,46.9,2,-42747,45538,88285,2791,0,-1777,13025,0,0,,14802,11248
40,10-05-18,78,19:15,19:30,52.24,53.9,0,52.24,52.24,1,-68790,22806,91596,-45984,0,-662,41,0,0,,703,-621
40,10-05-18,79,19:30,19:45,52.24,,0,52.24,52.24,1,-95978,19040,115018,-76938,0,0,668,0,0,,668,668
40,10-05-18,80,19:45,20:00,,,0,53.04,53.04,0,-91783,16284,108067,-75499,0,0,0,0,0,,0,0
40,10-05-18,81,20:00,20:15,56.24,,0,56.24,56.24,1,-79447,36664,116111,-42783,0,0,2272,0,0,,2272,2272
40,10-05-18,82,20:15,20:30,,,0,53.05,53.05,0,-68993,38259,107252,-30734,0,0,0,0,0,,0,0
40,10-05-18,83,20:30,20:45,,50.61,0,50.61,50.61,-1,-53341,51053,104394,-2288,0,-548,0,0,0,,548,-548
40,10-05-18,84,20:45,21:00,,44.51,0,44.51,44.51,-1,-54221,61864,116085,7643,0,-14894,0,0,0,,14894,-14894
40,10-05-18,85,21:00,21:15,157.5,48.24,0,157.5,31.85,2,-96602,10720,107322,-85882,0,-10305,10554,0,0,,20859,249
40,10-05-18,86,21:15,21:30,56.24,48.24,0,56.24,56.24,1,-65718,14510,80228,-51208,0,-22,6534,0,0,,6556,6512
40,10-05-18,87,21:30,21:45,52.24,,0,52.24,52.24,1,-50792,27776,78568,-23016,0,0,1646,0,0,,1646,1646
40,10-05-18,88,21:45,22:00,,44.24,0,44.24,44.24,-1,-43543,33041,76584,-10502,0,-1596,0,0,0,,1596,-1596
40,10-05-18,89,22:00,22:15,265.17,36.79,0,265.17,36.79,2,-130471,53775,184246,-76696,0,-7104,13807,0,0,,20911,6703
40,10-05-18,90,22:15,22:30,265.17,,0,265.17,265.17,1,-86792,11770,98562,-75022,0,0,64875,0,0,,64875,64875
40,10-05-18,91,22:30,22:45,57.89,,0,57.89,57.89,1,-55293,17207,72500,-38086,0,0,27087,0,0,,27087,27087
40,10-05-18,92,22:45,23:00,55.39,,0,55.39,55.39,1,-68040,33331,101371,-34709,0,0,20016,0,0,,20016,20016
40,10-05-18,93,23:00,23:15,52.94,48.66,0,52.94,47.71,2,-60720,57775,118495,-2945,0,-1344,6120,0,0,,7464,4776
40,10-05-18,94,23:15,23:30,56.24,,0,56.24,56.24,1,-58755,25001,83756,-33754,0,0,7512,0,0,,7512,7512
40,10-05-18,95,23:30,23:45,60.4,,0,60.4,60.4,1,-67343,15861,83204,-51482,0,0,16218,0,0,,16218,16218
40,10-05-18,96,23:45,0:00,57.83,,0,57.83,57.83,1,-98674,32622,131296,-66052,0,0,25881,0,0,,25881,25881
41,10-06-18,1,0:00,0:15,57.83,18.55,0,18.55,18.55,-1,-30785,102204,132989,71419,0,-17659,6908,0,0,,24567,-10751
41,10-06-18,2,0:15,0:30,62.46,49.68,0,62.46,62.46,1,-49020,15907,64927,-33113,0,-4730,4306,0,0,,9036,-424
41,10-06-18,3,0:30,0:45,157.99,,0,157.99,157.99,1,-97029,7769,104798,-89260,0,0,60598,0,0,,60598,60598
41,10-06-18,4,0:45,1:00,55.48,,0,55.48,55.48,1,-82747,25925,108672,-56822,0,0,34292,0,0,,34292,34292
41,10-06-18,5,1:00,1:15,59.98,,0,59.98,59.98,1,-36428,33465,69893,-2963,0,0,9260,0,0,,9260,9260
41,10-06-18,6,1:15,1:30,65.29,,0,65.29,65.29,1,-50499,31316,81815,-19183,0,0,16430,0,0,,16430,16430
41,10-06-18,7,1:30,1:45,65.29,53.48,0,53.48,53.48,-1,-18728,38159,56887,19431,0,-356,893,0,0,,1249,537
41,10-06-18,8,1:45,2:00,,44.11,0,44.11,44.11,-1,-14469,42301,56770,27832,0,-4238,0,0,0,,4238,-4238
41,10-06-18,9,2:00,2:15,63.9,47.48,0,63.9,63.9,1,-51339,14343,65682,-36996,0,-4333,6941,0,0,,11274,2608
41,10-06-18,10,2:15,2:30,55.12,,0,55.12,55.12,1,-41169,27763,68932,-13406,0,0,8331,0,0,,8331,8331
41,10-06-18,11,2:30,2:45,,,0,49.14,49.14,0,-22559,24445,47004,1886,0,0,0,0,0,,0,0
41,10-06-18,12,2:45,3:00,,43.27,0,43.27,43.27,-1,-18854,45835,64689,26981,0,-7828,0,0,0,,7828,-7828
41,10-06-18,13,3:00,3:15,51.48,47.48,0,51.48,51.48,1,-37248,19585,56833,-17663,0,-6972,153,0,0,,7125,-6819
41,10-06-18,14,3:15,3:30,51.48,53.1,0,53.1,53.1,-1,-31032,29604,60636,-1428,0,-156,102,0,0,,258,-54
41,10-06-18,15,3:30,3:45,,53.12,0,53.12,53.12,-1,-24657,27168,51825,2511,0,-677,0,0,0,,677,-677
41,10-06-18,16,3:45,4:00,,,0,49.13,49.13,0,-26979,21751,48730,-5228,0,0,0,0,0,,0,0
41,10-06-18,17,4:00,4:15,64.1,,0,64.1,64.1,1,-49361,12639,62000,-36722,0,0,11107,0,0,,11107,11107
41,10-06-18,18,4:15,4:30,51.48,,0,51.48,51.48,1,-34959,29650,64609,-5309,0,0,2734,0,0,,2734,2734
41,10-06-18,19,4:30,4:45,51.48,,0,51.48,51.48,1,-32798,27463,60261,-5335,0,0,136,0,0,,136,136
41,10-06-18,20,4:45,5:00,,,0,49.07,49.07,0,-25969,56026,81995,30057,0,0,0,0,0,,0,0
41,10-06-18,21,5:00,5:15,51.48,,0,51.48,51.48,1,-31807,25043,56850,-6764,0,0,7,0,0,,7,7
41,10-06-18,22,5:15,5:30,51.48,,0,51.48,51.48,1,-23181,18779,41960,-4402,0,0,644,0,0,,644,644
41,10-06-18,23,5:30,5:45,45.12,,0,45.12,45.12,1,-27889,22245,50134,-5644,0,0,64,0,0,,64,64
41,10-06-18,24,5:45,6:00,,,0,48.92,48.92,0,-36679,30040,66719,-6639,0,0,0,0,0,,0,0
41,10-06-18,25,6:00,6:15,,49.19,0,49.19,49.19,-1,-23389,57750,81139,34361,0,-569,0,0,0,,569,-569
41,10-06-18,26,6:15,6:30,,,0,49.26,49.26,0,-19226,51420,70646,32194,0,0,0,0,0,,0,0
41,10-06-18,27,6:30,6:45,,,0,49.2,49.2,0,-34198,25717,59915,-8481,0,0,0,0,0,,0,0
41,10-06-18,28,6:45,7:00,59.55,,0,59.55,59.55,1,-44931,9918,54849,-35013,0,0,7200,0,0,,7200,7200
41,10-06-18,29,7:00,7:15,55.06,,0,55.06,55.06,1,-38595,35747,74342,-2848,0,0,5907,0,0,,5907,5907
41,10-06-18,30,7:15,7:30,59.46,,0,59.46,59.46,1,-50219,26542,76761,-23677,0,0,7383,0,0,,7383,7383
41,10-06-18,31,7:30,7:45,51.06,,0,51.06,51.06,1,-30101,20690,50791,-9411,0,0,4575,0,0,,4575,4575
41,10-06-18,32,7:45,8:00,51.06,,0,51.06,51.06,1,-42926,53369,96295,10443,0,0,667,0,0,,667,667
41,10-06-18,33,8:00,8:15,60.31,,0,60.31,60.31,1,-65359,26208,91567,-39151,0,0,11464,0,0,,11464,11464
41,10-06-18,34,8:15,8:30,59.55,,0,59.55,59.55,1,-52664,20708,73372,-31956,0,0,17949,0,0,,17949,17949
41,10-06-18,35,8:30,8:45,59.55,,0,59.55,59.55,1,-59047,17770,76817,-41277,0,0,26555,0,0,,26555,26555
41,10-06-18,36,8:45,9:00,75.36,,0,75.36,75.36,1,-75017,12834,87851,-62183,0,0,40683,0,0,,40683,40683
41,10-06-18,37,9:00,9:15,79.52,,0,79.52,79.52,1,-63540,20229,83769,-43311,0,0,53199,0,0,,53199,53199
41,10-06-18,38,9:15,9:30,55.06,,0,55.06,55.06,1,-45840,20387,66227,-25453,0,0,8963,0,0,,8963,8963
41,10-06-18,39,9:30,9:45,70.83,,0,70.83,70.83,1,-63986,18143,82129,-45843,0,0,27097,0,0,,27097,27097
41,10-06-18,40,9:45,10:00,57.72,,0,57.72,57.72,1,-48509,21402,69911,-27107,0,0,26954,0,0,,26954,26954
41,10-06-18,41,10:00,10:15,254.21,,0,254.21,254.21,1,-109689,7791,117480,-101898,0,0,54341,0,0,,54341,54341
41,10-06-18,42,10:15,10:30,75.36,,0,75.36,75.36,1,-65572,25857,91429,-39715,0,0,53152,0,0,,53152,53152
41,10-06-18,43,10:30,10:45,75.36,39.06,0,39.06,39.06,-1,-48617,58108,106725,9491,0,-6815,7379,0,0,,14194,564
41,10-06-18,44,10:45,11:00,,43.06,0,43.06,43.06,-1,-46919,76310,123229,29391,0,-18655,0,0,0,,18655,-18655
41,10-06-18,45,11:00,11:15,75.36,47.06,0,75.36,47.06,2,-67333,29211,96544,-38122,0,-10361,8584,0,0,,18945,-1777
41,10-06-18,46,11:15,11:30,52.3,47.06,0,52.3,52.3,1,-58599,40695,99294,-17904,0,-1,4092,0,0,,4093,4091
41,10-06-18,47,11:30,11:45,52.3,47.06,0,47.06,47.06,-1,-52255,51638,103893,-617,0,-663,407,0,0,,1070,-256
41,10-06-18,48,11:45,12:00,,43.06,0,43.06,43.06,-1,-43754,55554,99308,11800,0,-10833,0,0,0,,10833,-10833
41,10-06-18,49,12:00,12:15,55.06,43.06,0,55.06,55.06,1,-64111,42846,106957,-21265,0,-2641,3854,0,0,,6495,1213
41,10-06-18,50,12:15,12:30,55.06,43.06,0,43.06,43.06,-1,-54329,61780,116109,7451,0,-4418,258,0,0,,4676,-4160
41,10-06-18,51,12:30,12:45,,39.06,0,39.06,39.06,-1,-38037,51958,89995,13921,0,-8409,0,0,0,,8409,-8409
41,10-06-18,52,12:45,13:00,,39.06,0,39.06,39.06,-1,-41545,56354,97899,14809,0,-23003,0,0,0,,23003,-23003
41,10-06-18,53,13:00,13:15,58.66,39.06,0,58.66,58.66,1,-57049,40863,97912,-16186,0,-6964,4093,0,0,,11057,-2871
41,10-06-18,54,13:15,13:30,58.66,39.06,0,39.06,39.06,-1,-53699,61493,115192,7794,0,-2961,644,0,0,,3605,-2317
41,10-06-18,55,13:30,13:45,,39.06,0,39.06,39.06,-1,-55426,59122,114548,3696,0,-14828,0,0,0,,14828,-14828
41,10-06-18,56,13:45,14:00,,39.06,0,39.06,39.06,-1,-55215,66022,121237,10807,0,-4398,0,0,0,,4398,-4398
41,10-06-18,57,14:00,14:15,,31.89,0,31.89,31.89,-1,-52799,74279,127078,21480,0,-23801,0,0,0,,23801,-23801
41,10-06-18,58,14:15,14:30,51.06,47.06,0,51.06,51.06,1,-67367,62294,129661,-5073,0,-8802,104,0,0,,8906,-8698
41,10-06-18,59,14:30,14:45,52.19,43.06,0,43.06,43.06,-1,-64336,70163,134499,5827,0,-2706,229,0,0,,2935,-2477
41,10-06-18,60,14:45,15:00,52.94,43.06,0,52.94,43.06,2,-86763,64275,151038,-22488,0,-4176,1349,0,0,,5525,-2827
41,10-06-18,61,15:00,15:15,52.94,25.4,0,25.4,25.4,-1,-33103,82180,115283,49077,0,-19382,267,0,0,,19649,-19115
41,10-06-18,62,15:15,15:30,,39.06,0,39.06,39.06,-1,-49407,74973,124380,25566,0,-41166,0,0,0,,41166,-41166
41,10-06-18,63,15:30,15:45,,47.06,0,47.06,47.06,-1,-59680,66496,126176,6816,0,-17752,0,0,0,,17752,-17752
41,10-06-18,64,15:45,16:00,51.06,47.06,0,51.06,47.06,2,-78252,75880,154132,-2372,0,-3283,18,0,0,,3301,-3265
41,10-06-18,65,16:00,16:15,51.06,38.08,0,51.06,38.08,2,-59514,80815,140329,21301,0,-14425,22,0,0,,14447,-14403
41,10-06-18,66,16:15,16:30,59.55,47.06,0,59.55,59.55,1,-87312,58547,145859,-28765,0,-5531,4945,0,0,,10476,-586
41,10-06-18,67,16:30,16:45,76.04,,0,76.04,76.04,1,-100711,30506,131217,-70205,0,0,39544,0,0,,39544,39544
41,10-06-18,68,16:45,17:00,244.57,,0,244.57,244.57,1,-173288,21730,195018,-151558,0,0,100122,0,0,,100122,100122
41,10-06-18,69,17:00,17:15,244.57,-64.41,0,-64.41,-64.41,-1,-65998,103396,169394,37398,0,-7854,46353,0,0,,54207,38499
41,10-06-18,70,17:15,17:30,125.4,-85.95,0,125.4,125.4,1,-97165,41126,138291,-56039,0,-11568,9718,0,0,,21286,-1850
41,10-06-18,71,17:30,17:45,257.79,,0,257.79,257.79,1,-113184,31645,144829,-81539,0,0,69193,0,0,,69193,69193
41,10-06-18,72,17:45,18:00,58.71,,0,58.71,58.71,1,-106240,68422,174662,-37818,0,0,32535,0,0,,32535,32535
41,10-06-18,73,18:00,18:15,59.55,25.4,0,60.4,25.4,2,-98653,107819,206472,9166,0,-2786,12632,0,0,,15418,9846
41,10-06-18,74,18:15,18:30,59.55,-24.6,0,-24.6,-24.6,-1,-81684,110166,191850,28482,0,-32403,432,0,0,,32835,-31971
41,10-06-18,75,18:30,18:45,,25.4,0,25.4,25.4,-1,-79422,131849,211271,52427,0,-28566,0,0,0,,28566,-28566
41,10-06-18,76,18:45,19:00,,39.06,0,39.06,39.06,-1,-77408,128017,205425,50609,0,-47338,0,0,0,,47338,-47338
41,10-06-18,77,19:00,19:15,,47.06,0,47.06,47.06,-1,-79220,84116,163336,4896,0,-22737,0,0,0,,22737,-22737
41,10-06-18,78,19:15,19:30,,47.06,0,47.06,47.06,-1,-84362,82535,166897,-1827,0,-11263,0,0,0,,11263,-11263
41,10-06-18,79,19:30,19:45,45.12,35.27,0,60.38,35.27,2,-58965,90818,149783,31853,0,-13584,8,0,0,,13592,-13576
41,10-06-18,80,19:45,20:00,,25.4,0,25.4,25.4,-1,-53908,99206,153114,45298,0,-58619,0,0,0,,58619,-58619
41,10-06-18,81,20:00,20:15,208.56,25.4,0,208.56,208.56,1,-109207,38470,147677,-70737,0,-15104,19664,0,0,,34768,4560
41,10-06-18,82,20:15,20:30,55.85,43.06,0,43.06,43.06,-1,-63398,66841,130239,3443,0,-1907,6618,0,0,,8525,4711
41,10-06-18,83,20:30,20:45,,39.06,0,39.06,39.06,-1,-37085,77382,114467,40297,0,-36697,0,0,0,,36697,-36697
41,10-06-18,84,20:45,21:00,,39.06,0,39.06,39.06,-1,-51064,101943,153007,50879,0,-50689,0,0,0,,50689,-50689
41,10-06-18,85,21:00,21:15,87.67,43.06,0,87.67,43.06,2,-103980,71505,175485,-32475,0,-26404,7058,0,0,,33462,-19346
41,10-06-18,86,21:15,21:30,55.06,43.06,0,55.06,55.06,1,-85805,68768,154573,-17037,0,-22,4937,0,0,,4959,4915
41,10-06-18,87,21:30,21:45,51.06,11.33,0,11.33,11.33,-1,-70680,111206,181886,40526,0,-13207,1907,0,0,,15114,-11300
41,10-06-18,88,21:45,22:00,,-108.9,0,-108.9,-108.9,-1,-90494,123172,213666,32678,0,-45356,0,0,0,,45356,-45356
41,10-06-18,89,22:00,22:15,59.55,3.46,0,59.55,3.46,2,-69987,96622,166609,26635,0,-41719,160,0,0,,41879,-41559
41,10-06-18,90,22:15,22:30,69.42,39.06,0,69.42,39.06,2,-73139,79754,152893,6615,0,-7751,3025,0,0,,10776,-4726
41,10-06-18,91,22:30,22:45,,25.4,0,25.4,25.4,-1,-28958,82229,111187,53271,0,-53858,0,0,0,,53858,-53858
41,10-06-18,92,22:45,23:00,,-60.75,0,-60.75,-60.75,-1,-22537,100983,123520,78446,0,-68954,0,0,0,,68954,-68954
41,10-06-18,93,23:00,23:15,64.66,39.06,0,64.66,64.66,1,-63394,32141,95535,-31253,0,-30775,1662,0,0,,32437,-29113
41,10-06-18,94,23:15,23:30,75.36,-68.63,0,-68.63,-68.63,-1,-40126,81847,121973,41721,0,-9451,3021,0,0,,12472,-6430
41,10-06-18,95,23:30,23:45,,-121.72,0,-121.72,-121.72,-1,-50858,102531,153389,51673,0,-48285,0,0,0,,48285,-48285
41,10-06-18,96,23:45,0:00,,-101.9,0,-101.9,-101.9,-1,-60280,152964,213244,92684,0,-67304,0,0,0,,67304,-67304
41,10-07-18,1,0:00,0:15,52.36,23.54,0,52.36,23.54,2,-55625,85082,140707,29457,0,-41455,11,0,0,,41466,-41444
41,10-07-18,2,0:15,0:30,54.91,-65.87,0,54.91,-65.87,2,-56443,107998,164441,51555,0,-14432,673,0,0,,15105,-13759
41,10-07-18,3,0:30,0:45,,-150.03,0,-150.03,-150.03,-1,-54994,99257,154251,44263,0,-54181,0,0,0,,54181,-54181
41,10-07-18,4,0:45,1:00,,14.77,0,14.77,14.77,-1,-56485,128888,185373,72403,0,-50691,0,0,0,,50691,-50691
41,10-07-18,5,1:00,1:15,53.97,25.44,0,53.97,25.44,2,-69397,63344,132741,-6053,0,-45267,110,0,0,,45377,-45157
41,10-07-18,6,1:15,1:30,64.47,25.44,0,64.47,25.44,2,-63530,71120,134650,7590,0,-5728,4999,0,0,,10727,-729
41,10-07-18,7,1:30,1:45,,13.15,0,13.15,13.15,-1,-48682,86192,134874,37510,0,-35758,0,0,0,,35758,-35758
41,10-07-18,8,1:45,2:00,,39.32,0,39.32,39.32,-1,-69899,99488,169387,29589,0,-36044,0,0,0,,36044,-36044
41,10-07-18,9,2:00,2:15,125.66,47.32,0,125.66,125.66,1,-95259,54585,149844,-40674,0,-13147,11884,0,0,,25031,-1263
41,10-07-18,10,2:15,2:30,57.3,,0,57.3,57.3,1,-87491,57157,144648,-30334,0,0,18738,0,0,,18738,18738
41,10-07-18,11,2:30,2:45,59.32,,0,59.32,59.32,1,-93393,58201,151594,-35192,0,0,15497,0,0,,15497,15497
41,10-07-18,12,2:45,3:00,77.54,,0,77.54,77.54,1,-113417,38039,151456,-75378,0,0,48209,0,0,,48209,48209
41,10-07-18,13,3:00,3:15,59.32,51.04,0,59.32,48.86,2,-82626,63899,146525,-18727,0,-253,28044,0,0,,28297,27791
41,10-07-18,14,3:15,3:30,53.8,,0,53.8,53.8,1,-83222,62061,145283,-21161,0,0,2671,0,0,,2671,2671
41,10-07-18,15,3:30,3:45,56.27,,0,56.27,56.27,1,-85020,55129,140149,-29891,0,0,7874,0,0,,7874,7874
41,10-07-18,16,3:45,4:00,55.49,,0,55.49,55.49,1,-107586,65879,173465,-41707,0,0,16592,0,0,,16592,16592
41,10-07-18,17,4:00,4:15,52.3,25.44,0,52.3,25.44,2,-56114,87728,143842,31614,0,-9428,7672,0,0,,17100,-1756
41,10-07-18,18,4:15,4:30,,43.32,0,43.32,43.32,-1,-62180,59821,122001,-2359,0,-7550,0,0,0,,7550,-7550
41,10-07-18,19,4:30,4:45,51.32,,0,51.32,51.32,1,-71078,62412,133490,-8666,0,0,1395,0,0,,1395,1395
41,10-07-18,20,4:45,5:00,55.32,,0,55.32,55.32,1,-84174,54463,138637,-29711,0,0,12299,0,0,,12299,12299
41,10-07-18,21,5:00,5:15,52.27,,0,52.27,52.27,1,-97481,75491,172972,-21990,0,0,11938,0,0,,11938,11938
41,10-07-18,22,5:15,5:30,75.44,,0,75.44,75.44,1,-99734,37072,136806,-62662,0,0,31269,0,0,,31269,31269
41,10-07-18,23,5:30,5:45,75.44,,0,75.44,75.44,1,-102442,27266,129708,-75176,0,0,67583,0,0,,67583,67583
41,10-07-18,24,5:45,6:00,59.69,,0,59.69,59.69,1,-87757,23681,111438,-64076,0,0,61476,0,0,,61476,61476
41,10-07-18,25,6:00,6:15,59.69,9.33,0,9.33,9.33,-1,-38105,57948,96053,19843,0,-9023,17080,0,0,,26103,8057
41,10-07-18,26,6:15,6:30,55.56,9.33,0,55.56,55.56,1,-70045,42175,112220,-27870,0,-1402,2841,0,0,,4243,1439
41,10-07-18,27,6:30,6:45,125.91,,0,125.91,125.91,1,-108157,20722,128879,-87435,0,0,42410,0,0,,42410,42410
41,10-07-18,28,6:45,7:00,75.68,,0,75.68,75.68,1,-111659,27963,139622,-83696,0,0,78486,0,0,,78486,78486
41,10-07-18,29,7:00,7:15,51.56,25.68,0,51.56,25.68,2,-55781,62189,117970,6408,0,-5523,21052,0,0,,26575,15529
41,10-07-18,30,7:15,7:30,61.67,47.56,0,61.67,61.67,1,-66389,34177,100566,-32212,0,-4284,4250,0,0,,8534,-34
41,10-07-18,31,7:30,7:45,64.73,,0,64.73,64.73,1,-90911,27625,118536,-63286,0,0,42965,0,0,,42965,42965
41,10-07-18,32,7:45,8:00,65.6,,0,65.6,65.6,1,-111427,43267,154694,-68160,0,0,61657,0,0,,61657,61657
41,10-07-18,33,8:00,8:15,65.6,8.54,0,8.54,8.54,-1,-34748,62113,96861,27365,0,-10077,17917,0,0,,27994,7840
41,10-07-18,34,8:15,8:30,52.41,49.36,0,52.41,52.41,1,-55188,46320,101508,-8868,0,-6172,228,0,0,,6400,-5944
41,10-07-18,35,8:30,8:45,62.14,49.36,0,62.14,62.14,1,-85412,46370,131782,-39042,0,-7,8267,0,0,,8274,8260
41,10-07-18,36,8:45,9:00,84.63,,0,84.63,84.63,1,-102433,28833,131266,-73600,0,0,51697,0,0,,51697,51697
41,10-07-18,37,9:00,9:15,60.98,53.98,0,53.98,53.98,-1,-81762,61149,142911,-20613,0,-21,28450,0,0,,28471,28429
41,10-07-18,38,9:15,9:30,51.56,51.26,0,51.56,49.5,2,-62150,46806,108956,-15344,0,-511,140,0,0,,651,-371
41,10-07-18,39,9:30,9:45,51.56,,0,51.56,51.56,1,-56031,46718,102749,-9313,0,0,314,0,0,,314,314
41,10-07-18,40,9:45,10:00,,49.76,0,49.76,49.76,-1,-50705,50010,100715,-695,0,-731,0,0,0,,731,-731
41,10-07-18,41,10:00,10:15,,47.56,0,47.56,47.56,-1,-59081,57986,117067,-1095,0,-561,0,0,0,,561,-561
41,10-07-18,42,10:15,10:30,,39.56,0,39.56,39.56,-1,-46373,74620,120993,28247,0,-20390,0,0,0,,20390,-20390
41,10-07-18,43,10:30,10:45,,25.68,0,25.68,25.68,-1,-37360,95982,133342,58622,0,-36627,0,0,0,,36627,-36627
41,10-07-18,44,10:45,11:00,,25.68,0,25.68,25.68,-1,-29176,101285,130461,72109,0,-63997,0,0,0,,63997,-63997
41,10-07-18,45,11:00,11:15,,39.56,0,39.56,39.56,-1,-29795,77500,107295,47705,0,-47548,0,0,0,,47548,-47548
41,10-07-18,46,11:15,11:30,,32.65,0,32.65,32.65,-1,-33608,97020,130628,63412,0,-53095,0,0,0,,53095,-53095
41,10-07-18,47,11:30,11:45,,43.56,0,43.56,43.56,-1,-48279,78613,126892,30334,0,-32704,0,0,0,,32704,-32704
41,10-07-18,48,11:45,12:00,,43.56,0,43.56,43.56,-1,-52839,74330,127169,21491,0,-22092,0,0,0,,22092,-22092
41,10-07-18,49,12:00,12:15,55.56,47.56,0,55.56,47.56,2,-75828,61756,137584,-14072,0,-12292,1475,0,0,,13767,-10817
41,10-07-18,50,12:15,12:30,52.19,47.56,0,52.19,52.19,1,-71841,60503,132344,-11338,0,-96,994,0,0,,1090,898
41,10-07-18,51,12:30,12:45,52.19,43.56,0,43.56,43.56,-1,-66183,76300,142483,10117,0,-1693,648,0,0,,2341,-1045
41,10-07-18,52,12:45,13:00,,39.56,0,39.56,39.56,-1,-70203,76347,146550,6144,0,-9309,0,0,0,,9309,-9309
41,10-07-18,53,13:00,13:15,59.56,53.37,0,59.56,49.2,2,-83675,56823,140498,-26852,0,-2524,6916,0,0,,9440,4392
41,10-07-18,54,13:15,13:30,52.19,,0,52.19,52.19,1,-84546,62552,147098,-21994,0,0,9174,0,0,,9174,9174
41,10-07-18,55,13:30,13:45,55.56,,0,55.56,55.56,1,-86399,66161,152560,-20238,0,0,4569,0,0,,4569,4569
41,10-07-18,56,13:45,14:00,59.56,,0,59.56,59.56,1,-98833,65079,163912,-33754,0,0,18457,0,0,,18457,18457
41,10-07-18,57,14:00,14:15,59.56,,0,59.56,59.56,1,-91877,57529,149406,-34348,0,0,15644,0,0,,15644,15644
41,10-07-18,58,14:15,14:30,61.66,,0,61.66,61.66,1,-104114,43584,147698,-60530,0,0,39817,0,0,,39817,39817
41,10-07-18,59,14:30,14:45,59.56,,0,59.56,59.56,1,-104594,49146,153740,-55448,0,0,47689,0,0,,47689,47689
41,10-07-18,60,14:45,15:00,58.66,,0,58.66,58.66,1,-108588,57635,166223,-50953,0,0,41446,0,0,,41446,41446
41,10-07-18,61,15:00,15:15,55.02,43.74,0,43.74,43.74,-1,-63482,71837,135319,8355,0,-1497,19192,0,0,,20689,17695
41,10-07-18,62,15:15,15:30,58.66,43.74,0,58.66,58.66,1,-78486,54302,132788,-24184,0,-149,6698,0,0,,6847,6549
41,10-07-18,63,15:30,15:45,55.56,,0,55.56,55.56,1,-80639,62729,143368,-17910,0,0,4689,0,0,,4689,4689
41,10-07-18,64,15:45,16:00,59.56,,0,59.56,59.56,1,-91202,43486,134688,-47716,0,0,32470,0,0,,32470,32470
41,10-07-18,65,16:00,16:15,55.56,36.35,0,36.35,36.35,-1,-52248,58046,110294,5798,0,-3063,18503,0,0,,21566,15440
41,10-07-18,66,16:15,16:30,51.56,47.56,0,51.56,47.56,2,-62362,57831,120193,-4531,0,-8002,15,0,0,,8017,-7987
41,10-07-18,67,16:30,16:45,59.56,47.56,0,59.56,59.56,1,-87683,52346,140029,-35337,0,-881,8102,0,0,,8983,7221
41,10-07-18,68,16:45,17:00,56.41,,0,56.41,56.41,1,-100188,63013,163201,-37175,0,0,23930,0,0,,23930,23930
41,10-07-18,69,17:00,17:15,59.56,,0,59.56,59.56,1,-114605,78407,193012,-36198,0,0,19257,0,0,,19257,19257
41,10-07-18,70,17:15,17:30,54.97,49.76,0,49.76,49.76,-1,-74738,68362,143100,-6376,0,-1045,10419,0,0,,11464,9374
41,10-07-18,71,17:30,17:45,75.68,49.76,0,75.68,75.68,1,-76652,39273,115925,-37379,0,-82,13415,0,0,,13497,13333
41,10-07-18,72,17:45,18:00,75.68,,0,75.68,75.68,1,-93506,39529,133035,-53977,0,0,56682,0,0,,56682,56682
41,10-07-18,73,18:00,18:15,250.63,,0,250.63,250.63,1,-116512,40949,157461,-75563,0,0,68395,0,0,,68395,68395
41,10-07-18,74,18:15,18:30,54.98,25.43,0,58.62,25.43,2,-43559,54245,97804,10686,0,-4562,11156,0,0,,15718,6594
41,10-07-18,75,18:30,18:45,51.56,47.56,0,58.61,47.56,2,-40789,50879,91668,10090,0,-2960,342,0,0,,3302,-2618
41,10-07-18,76,18:45,19:00,54.44,47.56,0,54.44,54.44,1,-51455,40945,92400,-10510,0,-87,3098,0,0,,3185,3011
41,10-07-18,77,19:00,19:15,54.44,39.56,0,39.56,39.56,-1,-30591,53132,83723,22541,0,-13374,366,0,0,,13740,-13008
41,10-07-18,78,19:15,19:30,130.94,72.22,0,130.94,130.94,1,-76980,17530,94510,-59450,0,-3151,20394,0,0,,23545,17243
41,10-07-18,79,19:30,19:45,130.94,,0,130.94,130.94,1,-77590,25605,103195,-51985,0,0,45853,0,0,,45853,45853
41,10-07-18,80,19:45,20:00,60.94,,0,60.94,60.94,1,-79161,32773,111934,-46388,0,0,33330,0,0,,33330,33330
41,10-07-18,81,20:00,20:15,56.55,,0,56.55,56.55,1,-67274,34130,101404,-33144,0,0,28466,0,0,,28466,28466
41,10-07-18,82,20:15,20:30,51.56,,0,51.56,51.56,1,-52019,35687,87706,-16332,0,0,9444,0,0,,9444,9444
41,10-07-18,83,20:30,20:45,51.56,39.56,0,39.56,39.56,-1,-32009,54065,86074,22056,0,-16078,288,0,0,,16366,-15790
41,10-07-18,84,20:45,21:00,,41.96,0,41.96,41.96,-1,-27711,68636,96347,40925,0,-33439,0,0,0,,33439,-33439
41,10-07-18,85,21:00,21:15,75.55,43.56,0,75.55,43.56,2,-49138,27656,76794,-21482,0,-19299,6607,0,0,,25906,-12692
41,10-07-18,86,21:15,21:30,51.56,72.09,0,58.56,58.56,2,-46805,45516,92321,-1289,0,-40,1341,0,0,,1381,1301
41,10-07-18,87,21:30,21:45,,43.56,0,43.56,43.56,-1,-34363,59051,93414,24688,0,-14399,0,0,0,,14399,-14399
41,10-07-18,88,21:45,22:00,,44.51,0,44.51,44.51,-1,-36264,77926,114190,41662,0,-32003,0,0,0,,32003,-32003
41,10-07-18,89,22:00,22:15,76.29,43.56,0,76.29,43.56,2,-57017,25578,82595,-31439,0,-20910,6265,0,0,,27175,-14645
41,10-07-18,90,22:15,22:30,53.57,47.56,0,47.56,47.56,-1,-43230,43533,86763,303,0,-823,4506,0,0,,5329,3683
41,10-07-18,91,22:30,22:45,,43.51,0,43.51,43.51,-1,-32273,55983,88256,23710,0,-10484,0,0,0,,10484,-10484
41,10-07-18,92,22:45,23:00,,43.56,0,43.56,43.56,-1,-44331,51285,95616,6954,0,-13269,0,0,0,,13269,-13269
41,10-07-18,93,23:00,23:15,,25.68,0,25.68,25.68,-1,-57400,101256,158656,43856,0,-34321,0,0,0,,34321,-34321
41,10-07-18,94,23:15,23:30,,43.56,0,43.56,43.56,-1,-51081,71994,123075,20913,0,-26767,0,0,0,,26767,-26767
41,10-07-18,95,23:30,23:45,,39.56,0,39.56,39.56,-1,-59276,86981,146257,27705,0,-35563,0,0,0,,35563,-35563
41,10-07-18,96,23:45,0:00,,25.68,0,25.68,25.68,-1,-62795,100679,163474,37884,0,-20930,0,0,0,,20930,-20930
41,10-08-18,1,0:00,0:15,57.99,-74.41,0,57.99,-74.41,2,-49381,73979,123360,24598,0,-34427,629,0,0,,35056,-33798
41,10-08-18,2,0:15,0:30,57.99,34.17,0,34.17,34.17,-1,-42469,84906,127375,42437,0,-18620,244,0,0,,18864,-18376
41,10-08-18,3,0:30,0:45,,43.56,0,43.56,43.56,-1,-72261,97435,169696,25174,0,-38149,0,0,0,,38149,-38149
41,10-08-18,4,0:45,1:00,59.56,47.56,0,59.56,47.56,2,-118867,109492,228359,-9375,0,-9799,974,0,0,,10773,-8825
41,10-08-18,5,1:00,1:15,54.2,-86.81,0,54.2,-86.81,2,-59924,103283,163207,43359,0,-33953,27,0,0,,33980,-33926
41,10-08-18,6,1:15,1:30,59.56,-86.81,0,59.56,59.56,1,-77522,68512,146034,-9010,0,-1475,1779,0,0,,3254,304
41,10-08-18,7,1:30,1:45,,25.91,0,25.91,25.91,-1,-38431,75229,113660,36798,0,-16295,0,0,0,,16295,-16295
41,10-08-18,8,1:45,2:00,,28.49,0,28.49,28.49,-1,-42206,85907,128113,43701,0,-49019,0,0,0,,49019,-49019
41,10-08-18,9,2:00,2:15,48.12,43.56,0,48.12,48.12,1,-58388,61922,120310,3534,0,-29256,22,0,0,,29278,-29234
41,10-08-18,10,2:15,2:30,59.56,43.56,0,59.56,59.56,1,-67647,52568,120215,-15079,0,-1449,5355,0,0,,6804,3906
41,10-08-18,11,2:30,2:45,59.56,47.56,0,47.56,47.56,-1,-50212,55101,105313,4889,0,-2218,78,0,0,,2296,-2140
41,10-08-18,12,2:45,3:00,,47.56,0,47.56,47.56,-1,-52523,54268,106791,1745,0,-5744,0,0,0,,5744,-5744
41,10-08-18,13,3:00,3:15,,45.78,0,45.78,45.78,-1,-39210,44864,84074,5654,0,-3695,0,0,0,,3695,-3695
41,10-08-18,14,3:15,3:30,,47.56,0,47.56,47.56,-1,-38962,43861,82823,4899,0,-11334,0,0,0,,11334,-11334
41,10-08-18,15,3:30,3:45,,39.56,0,39.56,39.56,-1,-42565,61807,104372,19242,0,-16925,0,0,0,,16925,-16925
41,10-08-18,16,3:45,4:00,,39.56,0,39.56,39.56,-1,-47447,76971,124418,29524,0,-34103,0,0,0,,34103,-34103
41,10-08-18,17,4:00,4:15,,42.54,0,42.54,42.54,-1,-35105,42292,77397,7187,0,-21698,0,0,0,,21698,-21698
41,10-08-18,18,4:15,4:30,,47.56,0,47.56,47.56,-1,-32122,38362,70484,6240,0,-2244,0,0,0,,2244,-2244
41,10-08-18,19,4:30,4:45,,47.56,0,47.56,47.56,-1,-37189,45210,82399,8021,0,-4717,0,0,0,,4717,-4717
41,10-08-18,20,4:45,5:00,,35.78,0,35.78,35.78,-1,-33901,72521,106422,38620,0,-25106,0,0,0,,25106,-25106
41,10-08-18,21,5:00,5:15,54.91,48.93,0,54.91,48.93,2,-86424,74949,161373,-11475,0,-12899,998,0,0,,13897,-11901
41,10-08-18,22,5:15,5:30,,43.56,0,43.56,43.56,-1,-64840,72219,137059,7379,0,-12098,0,0,0,,12098,-12098
41,10-08-18,23,5:30,5:45,59.26,43.56,0,59.26,59.26,1,-81224,53761,134985,-27463,0,-2644,5290,0,0,,7934,2646
41,10-08-18,24,5:45,6:00,53.4,48.92,0,53.4,48.54,2,-85912,67954,153866,-17958,0,-337,13012,0,0,,13349,12675
41,10-08-18,25,6:00,6:15,79.38,51.25,0,79.38,49.55,2,-107376,52177,159553,-55199,0,-311,12938,0,0,,13249,12627
41,10-08-18,26,6:15,6:30,79.38,39.61,0,39.61,39.61,-1,-35364,60109,95473,24745,0,-19170,1231,0,0,,20401,-17939
41,10-08-18,27,6:30,6:45,52.31,47.61,0,52.31,47.61,2,-46596,44922,91518,-1674,0,-8797,475,0,0,,9272,-8322
41,10-08-18,28,6:45,7:00,52.31,39.61,0,39.61,39.61,-1,-94092,118533,212625,24441,0,-4382,12,0,0,,4394,-4370
41,10-08-18,29,7:00,7:15,,16.82,0,16.82,16.82,-1,-46279,122314,168593,76035,0,-65424,0,0,0,,65424,-65424
41,10-08-18,30,7:15,7:30,53.84,41.96,0,53.84,53.84,1,-65142,69621,134763,4479,0,-29983,207,0,0,,30190,-29776
41,10-08-18,31,7:30,7:45,53.84,,0,53.84,53.84,1,-69477,57233,126710,-12244,0,0,439,0,0,,439,439
41,10-08-18,32,7:45,8:00,53.73,46.84,0,61.97,46.84,2,-61116,57874,118990,-3242,0,-317,2558,0,0,,2875,2241
41,10-08-18,33,8:00,8:15,,39.61,0,39.61,39.61,-1,-58148,72531,130679,14383,0,-22628,0,0,0,,22628,-22628
41,10-08-18,34,8:15,8:30,,41.06,0,41.06,41.06,-1,-58337,91068,149405,32731,0,-20168,0,0,0,,20168,-20168
41,10-08-18,35,8:30,8:45,,47.51,0,47.51,47.51,-1,-64395,87052,151447,22657,0,-32950,0,0,0,,32950,-32950
41,10-08-18,36,8:45,9:00,,47.29,0,47.29,47.29,-1,-72647,86610,159257,13963,0,-19598,0,0,0,,19598,-19598
41,10-08-18,37,9:00,9:15,55.61,47.51,0,62.05,47.51,2,-86248,85732,171980,-516,0,-13171,629,0,0,,13800,-12542
41,10-08-18,38,9:15,9:30,55.61,51.26,0,51.26,51.26,-1,-86893,84355,171248,-2538,0,-975,194,0,0,,1169,-781
41,10-08-18,39,9:30,9:45,,43.61,0,43.61,43.61,-1,-74810,106750,181560,31940,0,-17441,0,0,0,,17441,-17441
41,10-08-18,40,9:45,10:00,,41.96,0,41.96,41.96,-1,-69811,112332,182143,42521,0,-45370,0,0,0,,45370,-45370
41,10-08-18,41,10:00,10:15,55.61,44.78,0,55.61,55.61,1,-65252,65724,130976,472,0,-26470,669,0,0,,27139,-25801
41,10-08-18,42,10:15,10:30,52.34,39.61,0,52.34,39.61,2,-54829,83100,137929,28271,0,-10953,103,0,0,,11056,-10850
41,10-08-18,43,10:30,10:45,,39.61,0,39.61,39.61,-1,-62602,102078,164680,39476,0,-44140,0,0,0,,44140,-44140
41,10-08-18,44,10:45,11:00,,39.61,0,39.61,39.61,-1,-65560,108837,174397,43277,0,-45630,0,0,0,,45630,-45630
41,10-08-18,45,11:00,11:15,75.24,39.61,0,75.24,75.24,1,-88578,64692,153270,-23886,0,-28674,3802,0,0,,32476,-24872
41,10-08-18,46,11:15,11:30,75.24,39.61,0,75.24,75.24,1,-74728,63431,138159,-11297,0,-111,6448,0,0,,6559,6337
41,10-08-18,47,11:30,11:45,,46.46,0,46.46,46.46,-1,-64994,79235,144229,14241,0,-7287,0,0,0,,7287,-7287
41,10-08-18,48,11:45,12:00,,43.46,0,43.46,43.46,-1,-44675,84096,128771,39421,0,-35585,0,0,0,,35585,-35585
41,10-08-18,49,12:00,12:15,52.31,43.61,0,52.31,43.61,2,-61666,61912,123578,246,0,-27607,80,0,0,,27687,-27527
41,10-08-18,50,12:15,12:30,54.75,48.13,0,54.75,48.13,2,-59753,64020,123773,4267,0,-1652,610,0,0,,2262,-1042
41,10-08-18,51,12:30,12:45,,43.34,0,43.34,43.34,-1,-68168,84312,152480,16144,0,-17765,0,0,0,,17765,-17765
41,10-08-18,52,12:45,13:00,,48.59,0,48.59,48.59,-1,-79968,88660,168628,8692,0,-14274,0,0,0,,14274,-14274
41,10-08-18,53,13:00,13:15,54.65,44.95,0,54.65,44.95,2,-72140,76425,148565,4285,0,-15348,440,0,0,,15788,-14908
41,10-08-18,54,13:15,13:30,54.56,49.76,0,54.56,49.76,2,-69475,60229,129704,-9246,0,-1169,1356,0,0,,2525,187
41,10-08-18,55,13:30,13:45,55.61,,0,55.61,55.61,1,-81987,64125,146112,-17862,0,0,1937,0,0,,1937,1937
41,10-08-18,56,13:45,14:00,58.65,,0,58.65,58.65,1,-86074,61614,147688,-24460,0,0,13226,0,0,,13226,13226
41,10-08-18,57,14:00,14:15,52.35,47.78,0,52.35,47.78,2,-63432,57445,120877,-5987,0,-870,5038,0,0,,5908,4168
41,10-08-18,58,14:15,14:30,59.61,47.78,0,59.61,59.61,1,-84700,52944,137644,-31756,0,-247,5624,0,0,,5871,5377
41,10-08-18,59,14:30,14:45,55.61,,0,55.61,55.61,1,-82836,54233,137069,-28603,0,0,12715,0,0,,12715,12715
41,10-08-18,60,14:45,15:00,59.61,,0,59.61,59.61,1,-88728,52668,141396,-36060,0,0,28712,0,0,,28712,28712
41,10-08-18,61,15:00,15:15,52.34,47.78,0,52.34,47.78,2,-96073,86425,182498,-9648,0,-1419,7654,0,0,,9073,6235
41,10-08-18,62,15:15,15:30,59.61,,0,59.61,59.61,1,-97421,62777,160198,-34644,0,0,15656,0,0,,15656,15656
41,10-08-18,63,15:30,15:45,99.82,,0,99.82,99.82,1,-129814,64680,194494,-65134,0,0,24954,0,0,,24954,24954
41,10-08-18,64,15:45,16:00,146,,0,146,146,1,-158678,95914,254592,-62764,0,0,59709,0,0,,59709,59709
41,10-08-18,65,16:00,16:15,59.61,,0,59.61,59.61,1,-139467,93477,232944,-45990,0,0,26578,0,0,,26578,26578
41,10-08-18,66,16:15,16:30,68.12,,0,68.12,68.12,1,-138579,80473,219052,-58106,0,0,33873,0,0,,33873,33873
41,10-08-18,67,16:30,16:45,59.61,,0,59.61,59.61,1,-139813,94370,234183,-45443,0,0,38298,0,0,,38298,38298
41,10-08-18,68,16:45,17:00,62.84,,0,62.84,62.84,1,-169908,127839,297747,-42069,0,0,33531,0,0,,33531,33531
41,10-08-18,69,17:00,17:15,127.04,,0,127.04,127.04,1,-157030,74114,231144,-82916,0,0,37965,0,0,,37965,37965
41,10-08-18,70,17:15,17:30,173.53,,0,173.53,173.53,1,-145749,69256,215005,-76493,0,0,69143,0,0,,69143,69143
41,10-08-18,71,17:30,17:45,65.06,,0,65.06,65.06,1,-135069,76126,211195,-58943,0,0,48643,0,0,,48643,48643
41,10-08-18,72,17:45,18:00,87.09,,0,87.09,87.09,1,-156095,80164,236259,-75931,0,0,62128,0,0,,62128,62128
41,10-08-18,73,18:00,18:15,85.37,,0,85.37,85.37,1,-149842,88139,237981,-61703,0,0,53512,0,0,,53512,53512
41,10-08-18,74,18:15,18:30,56.79,51.73,0,62.94,51.73,2,-110717,92866,203583,-17851,0,-579,8565,0,0,,9144,7986
41,10-08-18,75,18:30,18:45,61.79,,0,61.79,61.79,1,-107155,85388,192543,-21767,0,0,10030,0,0,,10030,10030
41,10-08-18,76,18:45,19:00,61.79,,0,61.79,61.79,1,-102848,80807,183655,-22041,0,0,7667,0,0,,7667,7667
41,10-08-18,77,19:00,19:15,72.73,,0,72.73,72.73,1,-99875,69518,169393,-30357,0,0,5953,0,0,,5953,5953
41,10-08-18,78,19:15,19:30,231.46,,0,231.46,231.46,1,-137637,46855,184492,-90782,0,0,58546,0,0,,58546,58546
41,10-08-18,79,19:30,19:45,101.57,,0,101.57,101.57,1,-118159,53836,171995,-64323,0,0,65381,0,0,,65381,65381
41,10-08-18,80,19:45,20:00,81.57,,0,81.57,81.57,1,-121680,58752,180432,-62928,0,0,46624,0,0,,46624,46624
41,10-08-18,81,20:00,20:15,56.82,44.51,0,62.88,44.51,2,-113611,121119,234730,7508,0,-3006,19528,0,0,,22534,16522
41,10-08-18,82,20:15,20:30,,49.76,0,49.76,49.76,-1,-104130,105225,209355,1095,0,-1758,0,0,0,,1758,-1758
41,10-08-18,83,20:30,20:45,,47.51,0,47.51,47.51,-1,-78313,99371,177684,21058,0,-19890,0,0,0,,19890,-19890
41,10-08-18,84,20:45,21:00,,43.61,0,43.61,43.61,-1,-62432,100578,163010,38146,0,-27655,0,0,0,,27655,-27655
41,10-08-18,85,21:00,21:15,75.49,48.16,0,75.49,75.49,1,-109356,82385,191741,-26971,0,-15870,5024,0,0,,20894,-10846
41,10-08-18,86,21:15,21:30,55.61,48.16,0,55.61,55.61,1,-81129,58675,139804,-22454,0,-460,9326,0,0,,9786,8866
41,10-08-18,87,21:30,21:45,55.61,49.78,0,49.78,49.78,-1,-56507,54461,110968,-2046,0,-1918,1608,0,0,,3526,-310
41,10-08-18,88,21:45,22:00,53.66,47.51,0,62.85,47.51,2,-63068,47767,110835,-15301,0,-1203,386,0,0,,1589,-817
41,10-08-18,89,22:00,22:15,,39.61,0,39.61,39.61,-1,-72463,113425,185888,40962,0,-23145,0,0,0,,23145,-23145
41,10-08-18,90,22:15,22:30,,41.97,0,41.97,41.97,-1,-38875,67177,106052,28302,0,-27250,0,0,0,,27250,-27250
41,10-08-18,91,22:30,22:45,,43.67,0,43.67,43.67,-1,-53786,99131,152917,45345,0,-36809,0,0,0,,36809,-36809
41,10-08-18,92,22:45,23:00,,34.43,0,34.43,34.43,-1,-80079,129446,209525,49367,0,-55403,0,0,0,,55403,-55403
41,10-08-18,93,23:00,23:15,,-72.48,0,-72.48,-72.48,-1,-48856,168049,216905,119193,0,-88057,0,0,0,,88057,-88057
41,10-08-18,94,23:15,23:30,,30.56,0,30.56,30.56,-1,-54384,97066,151450,42682,0,-27246,0,0,0,,27246,-27246
41,10-08-18,95,23:30,23:45,,25.37,0,25.37,25.37,-1,-39505,111803,151308,72298,0,-63673,0,0,0,,63673,-63673
41,10-08-18,96,23:45,0:00,,25.37,0,25.37,25.37,-1,-38505,122078,160583,83573,0,-86226,0,0,0,,86226,-86226
41,10-09-18,1,0:00,0:15,257.02,25.37,0,257.02,257.02,1,-126595,32663,159258,-93932,0,-23860,19972,0,0,,43832,-3888
41,10-09-18,2,0:15,0:30,60.37,,0,60.37,60.37,1,-56846,32906,89752,-23940,0,0,24363,0,0,,24363,24363
41,10-09-18,3,0:30,0:45,52.37,29.24,0,29.24,29.24,-1,-54133,74010,128143,19877,0,-9529,1984,0,0,,11513,-7545
41,10-09-18,4,0:45,1:00,,40.37,0,40.37,40.37,-1,-35812,75553,111365,39741,0,-38314,0,0,0,,38314,-38314
41,10-09-18,5,1:00,1:15,145.02,40.37,0,145.02,145.02,1,-111438,21771,133209,-89667,0,-12791,24603,0,0,,37394,11812
41,10-09-18,6,1:15,1:30,157.02,,0,157.02,157.02,1,-85508,21830,107338,-63678,0,0,24170,0,0,,24170,24170
41,10-09-18,7,1:30,1:45,356.78,,0,356.78,356.78,1,-139707,66287,205994,-73420,0,0,66064,5000,0,,71064,71064
41,10-09-18,8,1:45,2:00,356.78,25.96,0,25.96,25.96,-1,-128375,149144,277519,20769,0,-12115,7963,0,0,,20078,-4152
41,10-09-18,9,2:00,2:15,52.37,47.03,0,52.84,47.03,2,-90456,97707,188163,7251,0,-15635,51,0,0,,15686,-15584
41,10-09-18,10,2:15,2:30,60.37,47.03,0,60.37,60.37,1,-88721,54130,142851,-34591,0,-1602,15278,0,0,,16880,13676
41,10-09-18,11,2:30,2:45,56.37,,0,56.37,56.37,1,-87610,53460,141070,-34150,0,0,20881,0,0,,20881,20881
41,10-09-18,12,2:45,3:00,57.97,,0,57.97,57.97,1,-87941,47560,135501,-40381,0,0,24018,0,0,,24018,24018
41,10-09-18,13,3:00,3:15,56.37,,0,56.37,56.37,1,-67469,33138,100607,-34331,0,0,21222,0,0,,21222,21222
41,10-09-18,14,3:15,3:30,54.64,,0,54.64,54.64,1,-56795,36936,93731,-19859,0,0,14661,0,0,,14661,14661
41,10-09-18,15,3:30,3:45,54.64,48.37,0,48.37,48.37,-1,-51862,51393,103255,-469,0,-2793,1118,0,0,,3911,-1675
41,10-09-18,16,3:45,4:00,,40.37,0,40.37,40.37,-1,-46012,73109,119121,27097,0,-13475,0,0,0,,13475,-13475
41,10-09-18,17,4:00,4:15,60.37,40.37,0,60.37,60.37,1,-74046,43134,117180,-30912,0,-15025,2862,0,0,,17887,-12163
41,10-09-18,18,4:15,4:30,56.37,53.41,0,56.37,52.88,2,-63065,44633,107698,-18432,0,-88,8194,0,0,,8282,8106
41,10-09-18,19,4:30,4:45,54.46,49.57,0,54.46,49.57,2,-61260,43344,104604,-17916,0,-265,1503,0,0,,1768,1238
41,10-09-18,20,4:45,5:00,53.9,,0,53.9,53.9,1,-61240,31979,93219,-29261,0,0,9512,0,0,,9512,9512
41,10-09-18,21,5:00,5:15,52.37,49.3,0,52.95,49.3,2,-72058,63174,135232,-8884,0,-1059,4004,0,0,,5063,2945
41,10-09-18,22,5:15,5:30,58.63,,0,58.63,58.63,1,-75509,50202,125711,-25307,0,0,4727,0,0,,4727,4727
41,10-09-18,23,5:30,5:45,57.97,,0,57.97,57.97,1,-65366,45320,110686,-20046,0,0,13969,0,0,,13969,13969
41,10-09-18,24,5:45,6:00,57.97,36.33,0,36.33,36.33,-1,-73142,105756,178898,32614,0,-9278,2901,0,0,,12179,-6377
41,10-09-18,25,6:00,6:15,171.04,36.33,0,171.04,171.04,1,-175418,85326,260744,-90092,0,-2689,23836,0,0,,26525,21147
41,10-09-18,26,6:15,6:30,171.04,,0,171.04,171.04,1,-155803,49866,205669,-105937,0,0,92913,0,0,,92913,92913
41,10-09-18,27,6:30,6:45,171.04,,0,171.04,171.04,1,-187309,19189,206498,-168120,0,0,107222,0,0,,107222,107222
41,10-09-18,28,6:45,7:00,373.75,,0,373.75,373.75,1,-219271,34913,254184,-184358,0,0,123717,5000,0,,128717,128717
41,10-09-18,29,7:00,7:15,170.68,30.66,0,30.66,30.66,-1,-150189,149228,299417,-961,0,-2188,70229,0,0,,72417,68041
41,10-09-18,30,7:15,7:30,202.79,30.66,0,202.79,202.79,1,-151890,66145,218035,-85745,0,-1422,18323,0,0,,19745,16901
41,10-09-18,31,7:30,7:45,202.79,,0,202.79,202.79,1,-208540,49883,258423,-158657,0,0,104874,0,0,,104874,104874
41,10-09-18,32,7:45,8:00,388.37,,0,388.37,388.37,1,-214219,63708,277927,-150511,0,0,115854,5000,0,,120854,120854
41,10-09-18,33,8:00,8:15,388.37,-67.87,0,-67.87,-67.87,-1,-96539,143758,240297,47219,0,-11271,38198,0,0,,49469,26927
41,10-09-18,34,8:15,8:30,63.52,-67.87,0,63.52,63.52,1,-99361,87962,187323,-11399,0,-1805,2197,0,0,,4002,392
41,10-09-18,35,8:30,8:45,56.38,,0,56.38,56.38,1,-96069,83206,179275,-12863,0,0,2441,0,0,,2441,2441
41,10-09-18,36,8:45,9:00,63.52,,0,63.52,63.52,1,-107873,74595,182468,-33278,0,0,16601,0,0,,16601,16601
41,10-09-18,37,9:00,9:15,56.13,47.3,0,47.3,47.3,-1,-89657,92281,181938,2624,0,-2124,12314,0,0,,14438,10190
41,10-09-18,38,9:15,9:30,56.13,45.74,0,45.74,45.74,-1,-79960,72457,152417,-7503,0,-4846,363,0,0,,5209,-4483
41,10-09-18,39,9:30,9:45,,47.61,0,47.61,47.61,-1,-57568,65752,123320,8184,0,-5202,0,0,0,,5202,-5202
41,10-09-18,40,9:45,10:00,51.61,48.03,0,62.7,48.03,2,-57895,61230,119125,3335,0,-9981,5,0,0,,9986,-9976
41,10-09-18,41,10:00,10:15,184.29,48.03,0,184.29,184.29,1,-132692,43787,176479,-88905,0,-160,31937,0,0,,32097,31777
41,10-09-18,42,10:15,10:30,184.29,49.03,0,49.03,49.03,-1,-68608,66226,134834,-2382,0,-631,9011,0,0,,9642,8380
41,10-09-18,43,10:30,10:45,,42.96,0,42.96,42.96,-1,-55454,73183,128637,17729,0,-7583,0,0,0,,7583,-7583
41,10-09-18,44,10:45,11:00,,39.61,0,39.61,39.61,-1,-82369,107007,189376,24638,0,-30531,0,0,0,,30531,-30531
41,10-09-18,45,11:00,11:15,71.48,47.74,0,71.48,47.74,2,-97016,64469,161485,-32547,0,-13890,8579,0,0,,22469,-5311
41,10-09-18,46,11:15,11:30,65.28,,0,65.28,65.28,1,-141550,103139,244689,-38411,0,0,20515,0,0,,20515,20515
41,10-09-18,47,11:30,11:45,53.11,,0,53.11,53.11,1,-146409,128445,274854,-17964,0,0,7679,0,0,,7679,7679
41,10-09-18,48,11:45,12:00,51.61,53.63,0,52.82,52.82,2,-135179,124870,260049,-10309,0,-333,639,0,0,,972,306
41,10-09-18,49,12:00,12:15,55.41,,0,55.41,55.41,1,-123505,103074,226579,-20431,0,0,3271,0,0,,3271,3271
41,10-09-18,50,12:15,12:30,51.61,53.52,0,53.75,53.52,2,-104572,99154,203726,-5418,0,-45,1429,0,0,,1474,1384
41,10-09-18,51,12:30,12:45,,43.61,0,43.61,43.61,-1,-97776,117101,214877,19325,0,-14582,0,0,0,,14582,-14582
41,10-09-18,52,12:45,13:00,,47.94,0,47.94,47.94,-1,-99061,101883,200944,2822,0,-15437,0,0,0,,15437,-15437
41,10-09-18,53,13:00,13:15,53.09,46.9,0,53.64,46.9,2,-85812,84821,170633,-991,0,-11189,198,0,0,,11387,-10991
41,10-09-18,54,13:15,13:30,62.43,46.9,0,62.43,62.43,1,-122439,79479,201918,-42960,0,-1419,20337,0,0,,21756,18918
41,10-09-18,55,13:30,13:45,54.69,,0,54.69,54.69,1,-111808,87314,199122,-24494,0,0,16567,0,0,,16567,16567
41,10-09-18,56,13:45,14:00,54.57,,0,54.57,54.57,1,-110654,75409,186063,-35245,0,0,14677,0,0,,14677,14677
41,10-09-18,57,14:00,14:15,54.57,-67.22,0,-67.22,-67.22,-1,-65028,172163,237191,107135,0,-44469,4829,0,0,,49298,-39640
41,10-09-18,58,14:15,14:30,,38.9,0,38.9,38.9,-1,-85631,118293,203924,32662,0,-41742,0,0,0,,41742,-41742
41,10-09-18,59,14:30,14:45,,41.61,0,41.61,41.61,-1,-77646,117144,194790,39498,0,-36755,0,0,0,,36755,-36755
41,10-09-18,60,14:45,15:00,,39.61,0,39.61,39.61,-1,-66763,118649,185412,51886,0,-53395,0,0,0,,53395,-53395
41,10-09-18,61,15:00,15:15,,39.61,0,39.61,39.61,-1,-83600,114120,197720,30520,0,-32057,0,0,0,,32057,-32057
41,10-09-18,62,15:15,15:30,54.31,39.61,0,54.31,39.61,2,-93521,96299,189820,2778,0,-33639,57,0,0,,33696,-33582
41,10-09-18,63,15:30,15:45,68.6,39.61,0,68.6,68.6,1,-100363,61895,162258,-38468,0,-2217,18203,0,0,,20420,15986
41,10-09-18,64,15:45,16:00,65.05,,0,65.05,65.05,1,-125522,72902,198424,-52620,0,0,32942,0,0,,32942,32942
41,10-09-18,65,16:00,16:15,78.24,,0,78.24,78.24,1,-128543,79241,207784,-49302,0,0,40464,0,0,,40464,40464
41,10-09-18,66,16:15,16:30,54.7,,0,54.7,54.7,1,-99192,72280,171472,-26912,0,0,12148,0,0,,12148,12148
41,10-09-18,67,16:30,16:45,78.9,,0,78.9,78.9,1,-122581,56670,179251,-65911,0,0,31693,0,0,,31693,31693
41,10-09-18,68,16:45,17:00,91.41,,0,91.41,91.41,1,-149105,52435,201540,-96670,0,0,74490,0,0,,74490,74490
41,10-09-18,69,17:00,17:15,91.41,-42.84,0,-42.84,-42.84,-1,-46898,133429,180327,86531,0,-25436,27010,0,0,,52446,1574
41,10-09-18,70,17:15,17:30,,44.77,0,44.77,44.77,-1,-75999,81310,157309,5311,0,-15003,0,0,0,,15003,-15003
41,10-09-18,71,17:30,17:45,,50.03,0,50.03,50.03,-1,-69337,76901,146238,7564,0,-6005,0,0,0,,6005,-6005
41,10-09-18,72,17:45,18:00,,53.1,0,53.1,53.1,-1,-65704,66377,132081,673,0,-3087,0,0,0,,3087,-3087
41,10-09-18,73,18:00,18:15,66.6,53.1,0,66.6,66.6,1,-105323,72060,177383,-33263,0,-70,6059,0,0,,6129,5989
41,10-09-18,74,18:15,18:30,66.6,53.87,0,53.87,53.87,-1,-74641,81923,156564,7282,0,-1305,335,0,0,,1640,-970
41,10-09-18,75,18:30,18:45,,50.03,0,50.03,50.03,-1,-59963,72656,132619,12693,0,-6737,0,0,0,,6737,-6737
41,10-09-18,76,18:45,19:00,81.36,50.42,0,81.36,81.36,1,-84721,58583,143304,-26138,0,-6696,4162,0,0,,10858,-2534
41,10-09-18,77,19:00,19:15,110.28,50.42,0,110.28,110.28,1,-115713,67235,182948,-48478,0,-24,32967,0,0,,32991,32943
41,10-09-18,78,19:15,19:30,250.38,,0,250.38,250.38,1,-147560,59118,206678,-88442,0,0,41201,0,0,,41201,41201
41,10-09-18,79,19:30,19:45,250.38,,0,250.38,250.38,1,-145769,41863,187632,-103906,0,0,96222,0,0,,96222,96222
41,10-09-18,80,19:45,20:00,84.84,,0,84.84,84.84,1,-126032,53801,179833,-72231,0,0,56369,0,0,,56369,56369
41,10-09-18,81,20:00,20:15,63.02,,0,63.02,63.02,1,-70322,55330,125652,-14992,0,0,28032,0,0,,28032,28032
41,10-09-18,82,20:15,20:30,63.02,47.73,0,47.73,47.73,-1,-46539,44948,91487,-1591,0,-1006,698,0,0,,1704,-308
41,10-09-18,83,20:30,20:45,,47.61,0,47.61,47.61,-1,-37148,49880,87028,12732,0,-13184,0,0,0,,13184,-13184
41,10-09-18,84,20:45,21:00,,47.61,0,47.61,47.61,-1,-44074,68968,113042,24894,0,-21629,0,0,0,,21629,-21629
41,10-09-18,85,21:00,21:15,80.19,47.61,0,80.19,80.19,1,-70155,32162,102317,-37993,0,-5436,13675,0,0,,19111,8239
41,10-09-18,86,21:15,21:30,55.35,49.03,0,49.03,49.03,-1,-52255,43160,95415,-9095,0,-398,8794,0,0,,9192,8396
41,10-09-18,87,21:30,21:45,55.35,42.75,0,42.75,42.75,-1,-46036,74605,120641,28569,0,-23151,83,0,0,,23234,-23068
41,10-09-18,88,21:45,22:00,,47.61,0,47.61,47.61,-1,-79651,77370,157021,-2281,0,-27078,0,0,0,,27078,-27078
41,10-09-18,89,22:00,22:15,,19.04,0,19.04,19.04,-1,-54098,116692,170790,62594,0,-44427,0,0,0,,44427,-44427
41,10-09-18,90,22:15,22:30,74.4,19.04,0,74.4,74.4,1,-64241,29841,94082,-34400,0,-7834,13151,0,0,,20985,5317
41,10-09-18,91,22:30,22:45,53.18,47.33,0,47.33,47.33,-1,-44866,59316,104182,14450,0,-2189,4396,0,0,,6585,2207
41,10-09-18,92,22:45,23:00,,47.61,0,47.61,47.61,-1,-60163,56831,116994,-3332,0,-7346,0,0,0,,7346,-7346
41,10-09-18,93,23:00,23:15,59.61,31.75,0,59.61,31.75,2,-38799,42132,80931,3333,0,-14644,1014,0,0,,15658,-13630
41,10-09-18,94,23:15,23:30,59.61,31.75,0,59.61,59.61,1,-63660,44095,107755,-19565,0,-211,4049,0,0,,4260,3838
41,10-09-18,95,23:30,23:45,59.61,39.61,0,39.61,39.61,-1,-45362,60621,105983,15259,0,-6306,5,0,0,,6311,-6301
41,10-09-18,96,23:45,0:00,,39.61,0,39.61,39.61,-1,-38838,75732,114570,36894,0,-34689,0,0,0,,34689,-34689
41,10-10-18,1,0:00,0:15,,35.24,0,35.24,35.24,-1,-33842,53896,87738,20054,0,-28289,0,0,0,,28289,-28289
41,10-10-18,2,0:15,0:30,,43.66,0,43.66,43.66,-1,-30891,46310,77201,15419,0,-13871,0,0,0,,13871,-13871
41,10-10-18,3,0:30,0:45,,39.66,0,39.66,39.66,-1,-30167,59184,89351,29017,0,-19107,0,0,0,,19107,-19107
41,10-10-18,4,0:45,1:00,,32.57,0,32.57,32.57,-1,-22677,69539,92216,46862,0,-49855,0,0,0,,49855,-49855
41,10-10-18,5,1:00,1:15,58.06,49.78,0,58.06,49.78,2,-48094,29768,77862,-18326,0,-15681,1076,0,0,,16757,-14605
41,10-10-18,6,1:15,1:30,58.06,43.66,0,43.66,43.66,-1,-40877,52312,93189,11435,0,-13641,1,0,0,,13642,-13640
41,10-10-18,7,1:30,1:45,,44.91,0,44.91,44.91,-1,-36979,64418,101397,27439,0,-33023,0,0,0,,33023,-33023
41,10-10-18,8,1:45,2:00,,42.62,0,42.62,42.62,-1,-36472,68356,104828,31884,0,-32949,0,0,0,,32949,-32949
41,10-10-18,9,2:00,2:15,,44.78,0,44.78,44.78,-1,-47162,68378,115540,21216,0,-28102,0,0,0,,28102,-28102
41,10-10-18,10,2:15,2:30,,50.7,0,50.7,50.7,-1,-48536,57543,106079,9007,0,-6174,0,0,0,,6174,-6174
41,10-10-18,11,2:30,2:45,,48.56,0,48.56,48.56,-1,-54440,63774,118214,9334,0,-6849,0,0,0,,6849,-6849
41,10-10-18,12,2:45,3:00,,48.42,0,48.42,48.42,-1,-51735,61239,112974,9504,0,-10650,0,0,0,,10650,-10650
41,10-10-18,13,3:00,3:15,,47.66,0,47.66,47.66,-1,-50885,60077,110962,9192,0,-13088,0,0,0,,13088,-13088
41,10-10-18,14,3:15,3:30,,49.78,0,49.78,49.78,-1,-42787,50215,93002,7428,0,-5641,0,0,0,,5641,-5641
41,10-10-18,15,3:30,3:45,,50.53,0,50.53,50.53,-1,-48026,41232,89258,-6794,0,-5522,0,0,0,,5522,-5522
41,10-10-18,16,3:45,4:00,,,0,52.74,52.74,0,-50960,40915,91875,-10045,0,-514,0,0,0,,514,-514
41,10-10-18,17,4:00,4:15,55.48,,0,55.48,55.48,1,-59559,38460,98019,-21099,0,0,1184,0,0,,1184,1184
41,10-10-18,18,4:15,4:30,51.66,,0,51.66,51.66,1,-49961,41268,91229,-8693,0,0,480,0,0,,480,480
41,10-10-18,19,4:30,4:45,55.66,,0,55.66,55.66,1,-60753,31371,92124,-29382,0,0,4208,0,0,,4208,4208
41,10-10-18,20,4:45,5:00,57.98,,0,57.98,57.98,1,-74787,34692,109479,-40095,0,0,12264,0,0,,12264,12264
41,10-10-18,21,5:00,5:15,53.2,49.77,0,53.2,49.77,2,-46287,44172,90459,-2115,0,-2518,5538,0,0,,8056,3020
41,10-10-18,22,5:15,5:30,51.66,54.01,0,52.84,52.84,2,-44487,34072,78559,-10415,0,-103,10,0,0,,113,-93
41,10-10-18,23,5:30,5:45,75.9,,0,75.9,75.9,1,-72887,27719,100606,-45168,0,0,14051,0,0,,14051,14051
41,10-10-18,24,5:45,6:00,69.12,39.66,0,39.66,39.66,-1,-82916,79824,162740,-3092,0,-1859,22517,0,0,,24376,20658
41,10-10-18,25,6:00,6:15,69.12,41.95,0,41.95,41.95,-1,-89401,115081,204482,25680,0,-20340,203,0,0,,20543,-20137
41,10-10-18,26,6:15,6:30,,47.29,0,47.29,47.29,-1,-64363,89885,154248,25522,0,-31505,0,0,0,,31505,-31505
41,10-10-18,27,6:30,6:45,,47.29,0,47.29,47.29,-1,-62082,70483,132565,8401,0,-24891,0,0,0,,24891,-24891
41,10-10-18,28,6:45,7:00,65.65,47.29,0,65.65,65.65,1,-120224,65994,186218,-54230,0,-5444,9904,0,0,,15348,4460
41,10-10-18,29,7:00,7:15,65.65,9.96,0,9.96,9.96,-1,-69788,135232,205020,65444,0,-35370,2256,0,0,,37626,-33114
41,10-10-18,30,7:15,7:30,88,44.06,0,88,88,1,-91627,50475,142102,-41152,0,-15330,7655,0,0,,22985,-7675
41,10-10-18,31,7:30,7:45,96.21,,0,96.21,96.21,1,-122440,29576,152016,-92864,0,0,59169,0,0,,59169,59169
41,10-10-18,32,7:45,8:00,156.12,,0,156.12,156.12,1,-149508,50414,199922,-99094,0,0,82744,0,0,,82744,82744
41,10-10-18,33,8:00,8:15,73.22,-68.32,0,73.22,-68.32,2,-80176,54870,135046,-25306,0,-10663,19937,0,0,,30600,9274
41,10-10-18,34,8:15,8:30,105.12,,0,105.12,105.12,1,-92589,47874,140463,-44715,0,0,25976,0,0,,25976,25976
41,10-10-18,35,8:30,8:45,69.67,,0,69.67,69.67,1,-98528,61709,160237,-36819,0,0,14394,0,0,,14394,14394
41,10-10-18,36,8:45,9:00,64.89,,0,64.89,64.89,1,-105262,62260,167522,-43002,0,0,25896,0,0,,25896,25896
41,10-10-18,37,9:00,9:15,136.84,,0,136.84,136.84,1,-133775,52171,185946,-81604,0,0,49318,0,0,,49318,49318
41,10-10-18,38,9:15,9:30,64.35,,0,64.35,64.35,1,-103103,66786,169889,-36317,0,0,34996,0,0,,34996,34996
41,10-10-18,39,9:30,9:45,54.84,41.51,0,63.23,41.51,2,-70726,81549,152275,10823,0,-5340,9022,0,0,,14362,3682
41,10-10-18,40,9:45,10:00,,47.81,0,47.81,47.81,-1,-83691,105545,189236,21854,0,-15340,0,0,0,,15340,-15340
41,10-10-18,41,10:00,10:15,170.98,47.81,0,170.98,170.98,1,-132987,47172,180159,-85815,0,-5094,29198,0,0,,34292,24104
41,10-10-18,42,10:15,10:30,55.02,52.1,0,63.23,52.1,2,-84269,74846,159115,-9423,0,-23,9381,0,0,,9404,9358
41,10-10-18,43,10:30,10:45,55.02,43.29,0,43.29,43.29,-1,-98195,112553,210748,14358,0,-13435,538,0,0,,13973,-12897
41,10-10-18,44,10:45,11:00,,47.29,0,47.29,47.29,-1,-90905,114276,205181,23371,0,-19194,0,0,0,,19194,-19194
41,10-10-18,45,11:00,11:15,55.96,47.29,0,55.96,55.96,1,-100806,79308,180114,-21498,0,-4891,3312,0,0,,8203,-1579
41,10-10-18,46,11:15,11:30,,47.29,0,47.29,47.29,-1,-79688,85988,165676,6300,0,-5010,0,0,0,,5010,-5010
41,10-10-18,47,11:30,11:45,,43.29,0,43.29,43.29,-1,-70682,94220,164902,23538,0,-18037,0,0,0,,18037,-18037
41,10-10-18,48,11:45,12:00,,46.74,0,46.74,46.74,-1,-60671,83257,143928,22586,0,-29829,0,0,0,,29829,-29829
41,10-10-18,49,12:00,12:15,53.73,44.83,0,53.73,53.73,1,-75073,80149,155222,5076,0,-16935,1517,0,0,,18452,-15418
41,10-10-18,50,12:15,12:30,53.73,42.02,0,42.02,42.02,-1,-76203,99431,175634,23228,0,-14201,252,0,0,,14453,-13949
41,10-10-18,51,12:30,12:45,,47.29,0,47.29,47.29,-1,-72092,101287,173379,29195,0,-28790,0,0,0,,28790,-28790
41,10-10-18,52,12:45,13:00,,45.1,0,45.1,45.1,-1,-53368,88787,142155,35419,0,-38131,0,0,0,,38131,-38131
41,10-10-18,53,13:00,13:15,53.09,46.74,0,53.23,46.74,2,-32772,42080,74852,9308,0,-31526,7,0,0,,31533,-31519
41,10-10-18,54,13:15,13:30,59.29,50.46,0,59.29,50.46,2,-40744,33581,74325,-7163,0,-2829,2379,0,0,,5208,-450
41,10-10-18,55,13:30,13:45,,47.29,0,47.29,47.29,-1,-41351,49926,91277,8575,0,-6582,0,0,0,,6582,-6582
41,10-10-18,56,13:45,14:00,,47.1,0,47.1,47.1,-1,-47625,53040,100665,5415,0,-8946,0,0,0,,8946,-8946
41,10-10-18,57,14:00,14:15,54.21,43.29,0,54.21,43.29,2,-53627,56893,110520,3266,0,-12259,1155,0,0,,13414,-11104
41,10-10-18,58,14:15,14:30,54.21,48.78,0,48.78,48.78,-1,-61261,62600,123861,1339,0,-4263,80,0,0,,4343,-4183
41,10-10-18,59,14:30,14:45,57.96,48.78,0,57.96,57.96,1,-67349,44282,111631,-23067,0,-62,7789,0,0,,7851,7727
41,10-10-18,60,14:45,15:00,54.72,,0,54.72,54.72,1,-58935,37731,96666,-21204,0,0,9909,0,0,,9909,9909
41,10-10-18,61,15:00,15:15,51.29,50.42,0,50.42,50.42,-1,-61234,54474,115708,-6760,0,-428,2929,0,0,,3357,2501
41,10-10-18,62,15:15,15:30,59.29,49.74,0,59.29,49.74,2,-63628,44805,108433,-18823,0,-3143,3876,0,0,,7019,733
41,10-10-18,63,15:30,15:45,59.29,,0,59.29,59.29,1,-74187,30385,104572,-43802,0,0,27422,0,0,,27422,27422
41,10-10-18,64,15:45,16:00,69.98,,0,69.98,69.98,1,-83466,27611,111077,-55855,0,0,39481,0,0,,39481,39481
41,10-10-18,65,16:00,16:15,69.36,46.74,0,69.36,46.74,2,-82445,83599,166044,1154,0,-3968,17393,0,0,,21361,13425
41,10-10-18,66,16:15,16:30,54.72,46.74,0,54.72,54.72,1,-86143,68370,154513,-17773,0,-273,2363,0,0,,2636,2090
41,10-10-18,67,16:30,16:45,68.25,,0,68.25,68.25,1,-87376,39225,126601,-48151,0,0,21838,0,0,,21838,21838
41,10-10-18,68,16:45,17:00,59.29,,0,59.29,59.29,1,-93643,38690,132333,-54953,0,0,40077,0,0,,40077,40077
41,10-10-18,69,17:00,17:15,59.29,52.77,0,52.77,52.77,-1,-95449,86736,182185,-8713,0,-590,14394,0,0,,14984,13804
41,10-10-18,70,17:15,17:30,75.3,52.77,0,75.3,75.3,1,-99535,48912,148447,-50623,0,-108,18068,0,0,,18176,17960
41,10-10-18,71,17:30,17:45,75.3,,0,75.3,75.3,1,-111075,48637,159712,-62438,0,0,51531,0,0,,51531,51531
41,10-10-18,72,17:45,18:00,74.78,,0,74.78,74.78,1,-115428,53524,168952,-61904,0,0,54762,0,0,,54762,54762
41,10-10-18,73,18:00,18:15,126.92,,0,126.92,126.92,1,-152483,47528,200011,-104955,0,0,75879,0,0,,75879,75879
41,10-10-18,74,18:15,18:30,67.12,,0,67.12,67.12,1,-106414,69095,175509,-37319,0,0,45497,0,0,,45497,45497
41,10-10-18,75,18:30,18:45,67.12,48.35,0,48.35,48.35,-1,-81002,89636,170638,8634,0,-5036,4144,0,0,,9180,-892
41,10-10-18,76,18:45,19:00,,48.86,0,48.86,48.86,-1,-79624,92037,171661,12413,0,-5778,0,0,0,,5778,-5778
41,10-10-18,77,19:00,19:15,,42.78,0,42.78,42.78,-1,-106637,126252,232889,19615,0,-22422,0,0,0,,22422,-22422
41,10-10-18,78,19:15,19:30,55.29,42.78,0,55.29,55.29,1,-114852,100398,215250,-14454,0,-2873,1538,0,0,,4411,-1335
41,10-10-18,79,19:30,19:45,55.29,48.37,0,55.29,48.37,2,-87035,81124,168159,-5911,0,-1926,3032,0,0,,4958,1106
41,10-10-18,80,19:45,20:00,,47.29,0,47.29,47.29,-1,-92779,101258,194037,8479,0,-15096,0,0,0,,15096,-15096
41,10-10-18,81,20:00,20:15,,47.29,0,47.29,47.29,-1,-121720,144788,266508,23068,0,-13507,0,0,0,,13507,-13507
41,10-10-18,82,20:15,20:30,,43.29,0,43.29,43.29,-1,-100729,117909,218638,17180,0,-10808,0,0,0,,10808,-10808
41,10-10-18,83,20:30,20:45,,39.29,0,39.29,39.29,-1,-96148,142089,238237,45941,0,-42023,0,0,0,,42023,-42023
41,10-10-18,84,20:45,21:00,,39.29,0,39.29,39.29,-1,-119955,164914,284869,44959,0,-54384,0,0,0,,54384,-54384
41,10-10-18,85,21:00,21:15,66.67,39.29,0,66.67,39.29,2,-115215,116591,231806,1376,0,-28326,5373,0,0,,33699,-22953
41,10-10-18,86,21:15,21:30,66.67,16.82,0,16.82,16.82,-1,-85985,136477,222462,50492,0,-23097,1960,0,0,,25057,-21137
41,10-10-18,87,21:30,21:45,,18.29,0,18.29,18.29,-1,-63336,120274,183610,56938,0,-69286,0,0,0,,69286,-69286
41,10-10-18,88,21:45,22:00,,46.74,0,46.74,46.74,-1,-55070,92988,148058,37918,0,-44321,0,0,0,,44321,-44321
41,10-10-18,89,22:00,22:15,59.29,39.29,0,59.29,39.29,2,-90923,88066,178989,-2857,0,-32179,1603,0,0,,33782,-30576
41,10-10-18,90,22:15,22:30,59.5,39.29,0,59.5,59.5,1,-85673,63359,149032,-22314,0,-1575,4702,0,0,,6277,3127
41,10-10-18,91,22:30,22:45,54.72,50.29,0,54.72,31.95,2,-61939,55683,117622,-6256,0,-151,4322,0,0,,4473,4171
41,10-10-18,92,22:45,23:00,54.72,48.05,0,48.05,48.05,-1,-96984,103843,200827,6859,0,-2871,13,0,0,,2884,-2858
41,10-10-18,93,23:00,23:15,59.29,43.29,0,59.29,43.29,2,-79925,56483,136408,-23442,0,-4715,7827,0,0,,12542,3112
41,10-10-18,94,23:15,23:30,58.48,45.86,0,58.48,45.86,2,-64701,54379,119080,-10322,0,-611,15725,0,0,,16336,15114
41,10-10-18,95,23:30,23:45,58.48,43.39,0,43.39,43.39,-1,-73770,101360,175130,27590,0,-22681,683,0,0,,23364,-21998
41,10-10-18,96,23:45,0:00,,39.29,0,39.29,39.29,-1,-67232,113249,180481,46017,0,-46154,0,0,0,,46154,-46154
41,10-11-18,1,0:00,0:15,,25.41,0,25.41,25.41,-1,-30520,126078,156598,95558,0,-73660,0,0,0,,73660,-73660
41,10-11-18,2,0:15,0:30,,10.32,0,10.32,10.32,-1,-24632,122458,147090,97826,0,-102497,0,0,0,,102497,-102497
41,10-11-18,3,0:30,0:45,,25.41,0,25.41,25.41,-1,-37655,98953,136608,61298,0,-77751,0,0,0,,77751,-77751
41,10-11-18,4,0:45,1:00,,25.41,0,25.41,25.41,-1,-28415,99723,128138,71308,0,-60887,0,0,0,,60887,-60887
41,10-11-18,5,1:00,1:15,,18.28,0,18.28,18.28,-1,-55960,111475,167435,55515,0,-63619,0,0,0,,63619,-63619
41,10-11-18,6,1:15,1:30,,33.25,0,33.25,33.25,-1,-47923,109518,157441,61595,0,-60997,0,0,0,,60997,-60997
41,10-11-18,7,1:30,1:45,,39.29,0,39.29,39.29,-1,-60230,81806,142036,21576,0,-36695,0,0,0,,36695,-36695
41,10-11-18,8,1:45,2:00,,39.29,0,39.29,39.29,-1,-47658,77528,125186,29870,0,-16310,0,0,0,,16310,-16310
41,10-11-18,9,2:00,2:15,,43.29,0,43.29,43.29,-1,-52968,66806,119774,13838,0,-22489,0,0,0,,22489,-22489
41,10-11-18,10,2:15,2:30,,49.12,0,49.12,49.12,-1,-51776,57324,109100,5548,0,-3747,0,0,0,,3747,-3747
41,10-11-18,11,2:30,2:45,,46.93,0,46.93,46.93,-1,-53723,66712,120435,12989,0,-12881,0,0,0,,12881,-12881
41,10-11-18,12,2:45,3:00,,44.03,0,44.03,44.03,-1,-55472,81320,136792,25848,0,-26678,0,0,0,,26678,-26678
41,10-11-18,13,3:00,3:15,,39.29,0,39.29,39.29,-1,-35428,78479,113907,43051,0,-45163,0,0,0,,45163,-45163
41,10-11-18,14,3:15,3:30,,43.24,0,43.24,43.24,-1,-40707,73588,114295,32881,0,-36808,0,0,0,,36808,-36808
41,10-11-18,15,3:30,3:45,,43.29,0,43.29,43.29,-1,-47272,68768,116040,21496,0,-31240,0,0,0,,31240,-31240
41,10-11-18,16,3:45,4:00,,46.61,0,46.61,46.61,-1,-52834,67990,120824,15156,0,-20041,0,0,0,,20041,-20041
41,10-11-18,17,4:00,4:15,,42.03,0,42.03,42.03,-1,-56733,114378,171111,57645,0,-31009,0,0,0,,31009,-31009
41,10-11-18,18,4:15,4:30,,42.03,0,42.03,42.03,-1,-57958,97618,155576,39660,0,-34410,0,0,0,,34410,-34410
41,10-11-18,19,4:30,4:45,,39.29,0,39.29,39.29,-1,-64174,94072,158246,29898,0,-34284,0,0,0,,34284,-34284
41,10-11-18,20,4:45,5:00,,43.29,0,43.29,43.29,-1,-74579,88026,162605,13447,0,-14508,0,0,0,,14508,-14508
41,10-11-18,21,5:00,5:15,,-150.03,0,-150.03,-150.03,-1,-60577,112051,172628,51474,0,-44107,0,0,0,,44107,-44107
41,10-11-18,22,5:15,5:30,,37.99,0,37.99,37.99,-1,-55642,104807,160449,49165,0,-40896,0,0,0,,40896,-40896
41,10-11-18,23,5:30,5:45,,39.29,0,39.29,39.29,-1,-73174,89995,163169,16821,0,-35140,0,0,0,,35140,-35140
41,10-11-18,24,5:45,6:00,,39.29,0,39.29,39.29,-1,-85913,117571,203484,31658,0,-19820,0,0,0,,19820,-19820
41,10-11-18,25,6:00,6:15,96.73,39.29,0,96.73,96.73,1,-151304,74848,226152,-76456,0,-2119,15752,0,0,,17871,13633
41,10-11-18,26,6:15,6:30,50.02,,0,50.02,50.02,1,-47520,39243,86763,-8277,0,0,1377,0,0,,1377,1377
41,10-11-18,27,6:30,6:45,51.93,,0,51.93,51.93,1,-71211,56196,127407,-15015,0,0,435,0,0,,435,435
41,10-11-18,28,6:45,7:00,51.93,25.96,0,25.96,25.96,-1,-81416,138035,219451,56619,0,-15550,98,0,0,,15648,-15452
41,10-11-18,29,7:00,7:15,169.32,25.96,0,169.32,169.32,1,-209185,88250,297435,-120935,0,-1981,32304,0,0,,34285,30323
41,10-11-18,30,7:15,7:30,66.23,43.26,0,66.23,43.26,2,-90352,80606,170958,-9746,0,-9165,2308,0,0,,11473,-6857
41,10-11-18,31,7:30,7:45,169.32,43.26,0,169.32,169.32,1,-203917,41838,245755,-162079,0,-13,72186,0,0,,72199,72173
41,10-11-18,32,7:45,8:00,169.32,,0,169.32,169.32,1,-170334,47045,217379,-123289,0,0,114133,0,0,,114133,114133
41,10-11-18,33,8:00,8:15,169.32,34.9,0,34.9,34.9,-1,-89330,125764,215094,36434,0,-13891,18107,0,0,,31998,4216
41,10-11-18,34,8:15,8:30,,46.02,0,46.02,46.02,-1,-95684,112723,208407,17039,0,-23430,0,0,0,,23430,-23430
41,10-11-18,35,8:30,8:45,58.02,47.03,0,58.02,58.02,1,-117879,102222,220101,-15657,0,-11460,3992,0,0,,15452,-7468
41,10-11-18,36,8:45,9:00,58.02,47.03,0,58.02,58.02,1,-134551,87961,222512,-46590,0,-27,22571,0,0,,22598,22544
41,10-11-18,37,9:00,9:15,58.02,41.11,0,41.11,41.11,-1,-99208,124794,224002,25586,0,-9606,4881,0,0,,14487,-4725
41,10-11-18,38,9:15,9:30,,49.69,0,49.69,49.69,-1,-108603,110037,218640,1434,0,-6958,0,0,0,,6958,-6958
41,10-11-18,39,9:30,9:45,,47.56,0,47.56,47.56,-1,-113566,116544,230110,2978,0,-6405,0,0,0,,6405,-6405
41,10-11-18,40,9:45,10:00,,50.03,0,50.03,50.03,-1,-100566,110176,210742,9610,0,-5933,0,0,0,,5933,-5933
41,10-11-18,41,10:00,10:15,154.02,52.86,0,154.02,154.02,1,-177150,62185,239335,-114965,0,-559,29022,0,0,,29581,28463
41,10-11-18,42,10:15,10:30,155.02,,0,155.02,155.02,1,-164245,51274,215519,-112971,0,0,103638,0,0,,103638,103638
41,10-11-18,43,10:30,10:45,73.91,,0,73.91,73.91,1,-143654,68387,212041,-75267,0,0,71093,0,0,,71093,71093
41,10-11-18,44,10:45,11:00,73.91,,0,73.91,73.91,1,-153473,68089,221562,-85384,0,0,63847,0,0,,63847,63847
41,10-11-18,45,11:00,11:15,155.02,,0,155.02,155.02,1,-244927,82560,327487,-162367,0,0,103241,0,0,,103241,103241
41,10-11-18,46,11:15,11:30,155.02,,0,155.02,155.02,1,-187511,92034,279545,-95477,0,0,102465,0,0,,102465,102465
41,10-11-18,47,11:30,11:45,105.75,,0,105.75,105.75,1,-164818,86453,251271,-78365,0,0,48640,0,0,,48640,48640
41,10-11-18,48,11:45,12:00,107.99,,0,107.99,107.99,1,-154715,92713,247428,-62002,0,0,62897,0,0,,62897,62897
41,10-11-18,49,12:00,12:15,63.68,,0,63.68,63.68,1,-137567,78836,216403,-58731,0,0,40087,0,0,,40087,40087
41,10-11-18,50,12:15,12:30,58.02,,0,58.02,58.02,1,-128387,87633,216020,-40754,0,0,34878,0,0,,34878,34878
41,10-11-18,51,12:30,12:45,53.56,,0,53.56,53.56,1,-114607,91015,205622,-23592,0,0,11589,0,0,,11589,11589
41,10-11-18,52,12:45,13:00,51.93,52.8,0,52.8,52.8,-1,-106243,92033,198276,-14210,0,-22,5444,0,0,,5466,5422
41,10-11-18,53,13:00,13:15,54.02,45.63,0,54.02,45.63,2,-91147,92288,183435,1141,0,-5039,1973,0,0,,7012,-3066
41,10-11-18,54,13:15,13:30,54.02,52.8,0,54.02,51.41,2,-96958,90030,186988,-6928,0,-96,5278,0,0,,5374,5182
41,10-11-18,55,13:30,13:45,53.34,49.08,0,53.34,49.08,2,-95804,83786,179590,-12018,0,-833,785,0,0,,1618,-48
41,10-11-18,56,13:45,14:00,50.02,50.03,0,50.03,50.03,-1,-86011,85008,171019,-1003,0,-1252,493,0,0,,1745,-759
41,10-11-18,57,14:00,14:15,50.02,52.81,0,51.42,51.42,2,-86672,76205,162877,-10467,0,-2132,253,0,0,,2385,-1879
41,10-11-18,58,14:15,14:30,50.02,38.76,0,51.42,38.76,2,-52401,80422,132823,28021,0,-13338,153,0,0,,13491,-13185
41,10-11-18,59,14:30,14:45,,43.74,0,43.74,43.74,-1,-49120,76076,125196,26956,0,-31369,0,0,0,,31369,-31369
41,10-11-18,60,14:45,15:00,,46.02,0,46.02,46.02,-1,-49716,59091,108807,9375,0,-17685,0,0,0,,17685,-17685
41,10-11-18,61,15:00,15:15,,,0,51.73,51.73,0,-90752,65730,156482,-25022,0,-1390,0,0,0,,1390,-1390
41,10-11-18,62,15:15,15:30,50.02,,0,50.02,50.02,1,-85181,62365,147546,-22816,0,0,1404,0,0,,1404,1404
41,10-11-18,63,15:30,15:45,57.1,,0,57.1,57.1,1,-90427,49189,139616,-41238,0,0,13852,0,0,,13852,13852
41,10-11-18,64,15:45,16:00,58.02,,0,58.02,58.02,1,-91116,39854,130970,-51262,0,0,26391,0,0,,26391,26391
41,10-11-18,65,16:00,16:15,54.02,49.94,0,54.02,49.94,2,-72671,73480,146151,809,0,-1108,11377,0,0,,12485,10269
41,10-11-18,66,16:15,16:30,,,0,51.76,51.76,0,-77767,82845,160612,5078,0,-101,55,0,0,,156,-46
41,10-11-18,67,16:30,16:45,,,0,51.76,51.76,0,-78598,107048,185646,28450,0,0,0,0,0,,0,0
41,10-11-18,68,16:45,17:00,,,0,51.72,51.72,0,-109072,128733,237805,19661,0,0,0,0,0,,0,0
41,10-11-18,69,17:00,17:15,,-13.73,0,-13.73,-13.73,-1,-62157,143334,205491,81177,0,-30680,0,0,0,,30680,-30680
41,10-11-18,70,17:15,17:30,,49.03,0,49.03,49.03,-1,-69943,130494,200437,60551,0,-3395,0,0,0,,3395,-3395
41,10-11-18,71,17:30,17:45,,,0,51.73,51.73,0,-84507,122623,207130,38116,0,0,0,0,0,,0,0
41,10-11-18,72,17:45,18:00,50.02,,0,50.02,50.02,1,-100615,120948,221563,20333,0,0,1,0,0,,1,1
41,10-11-18,73,18:00,18:15,57.88,,0,57.88,57.88,1,-248299,82904,331203,-165395,0,0,9102,0,0,,9102,9102
41,10-11-18,74,18:15,18:30,187.43,,0,187.43,187.43,1,-262617,108326,370943,-154291,0,0,40683,0,0,,40683,40683
41,10-11-18,75,18:30,18:45,187.43,,0,187.43,187.43,1,-235312,111324,346636,-123988,0,0,43552,0,0,,43552,43552
41,10-11-18,76,18:45,19:00,187.43,,0,187.43,187.43,1,-247107,108942,356049,-138165,0,0,89738,0,0,,89738,89738
41,10-11-18,77,19:00,19:15,170.92,,0,170.92,170.92,1,-232977,124561,357538,-108416,0,0,82072,0,0,,82072,82072
41,10-11-18,78,19:15,19:30,106.02,,0,106.02,106.02,1,-238653,115071,353724,-123582,0,0,66853,0,0,,66853,66853
41,10-11-18,79,19:30,19:45,,,0,62.64,62.64,0,-217357,96768,314125,-120589,0,0,27162,0,0,,27162,27162
41,10-11-18,80,19:45,20:00,,,0,42.65,42.65,0,-201215,83029,284244,-118186,0,0,0,0,0,,0,0
41,10-11-18,81,20:00,20:15,,,0,42.7,42.7,0,-176080,103263,279343,-72817,0,0,0,0,0,,0,0
41,10-11-18,82,20:15,20:30,,,0,42.73,42.73,0,-183999,121964,305963,-62035,0,0,0,0,0,,0,0
41,10-11-18,83,20:30,20:45,,,0,42.76,42.76,0,-174937,113699,288636,-61238,0,0,0,0,0,,0,0
41,10-11-18,84,20:45,21:00,,45.97,0,45.97,45.97,-1,-164070,146089,310159,-17981,0,-2836,0,0,0,,2836,-2836
41,10-11-18,85,21:00,21:15,,24.1,0,24.1,24.1,-1,-160904,212401,373305,51497,0,-25638,0,0,0,,25638,-25638
41,10-11-18,86,21:15,21:30,,,0,31.61,31.61,0,-178078,141337,319415,-36741,0,-1005,0,0,0,,1005,-1005
41,10-11-18,87,21:30,21:45,,45.97,0,45.97,45.97,-1,-144818,147600,292418,2782,0,-3300,0,0,0,,3300,-3300
41,10-11-18,88,21:45,22:00,,49.54,0,49.54,49.54,-1,-143553,126170,269723,-17383,0,-4402,0,0,0,,4402,-4402
41,10-11-18,89,22:00,22:15,,36.39,0,36.39,36.39,-1,-89583,147948,237531,58365,0,-27710,0,0,0,,27710,-27710
41,10-11-18,90,22:15,22:30,,24.1,0,24.1,24.1,-1,-68054,125626,193680,57572,0,-69459,0,0,0,,69459,-69459
41,10-11-18,91,22:30,22:45,,39.94,0,39.94,39.94,-1,-63161,117254,180415,54093,0,-49211,0,0,0,,49211,-49211
41,10-11-18,92,22:45,23:00,,-125.93,0,-125.93,-125.93,-1,-44347,165219,209566,120872,0,-58746,0,0,0,,58746,-58746
41,10-11-18,93,23:00,23:15,,24.1,0,24.1,24.1,-1,-88150,111694,199844,23544,0,-32402,0,0,0,,32402,-32402
41,10-11-18,94,23:15,23:30,,24.1,0,24.1,24.1,-1,-45933,108891,154824,62958,0,-37048,0,0,0,,37048,-37048
41,10-11-18,95,23:30,23:45,,24.1,0,24.1,24.1,-1,-34998,105258,140256,70260,0,-76197,0,0,0,,76197,-76197
41,10-11-18,96,23:45,0:00,,16.08,0,16.08,16.08,-1,-27042,130082,157124,103040,0,-90766,0,0,0,,90766,-90766
41,10-12-18,1,0:00,0:15,,28.47,0,28.47,28.47,-1,-45367,105413,150780,60046,0,-45361,0,0,0,,45361,-45361
41,10-12-18,2,0:15,0:30,,30.36,0,30.36,30.36,-1,-34326,146572,180898,112246,0,-33678,0,0,0,,33678,-33678
41,10-12-18,3,0:30,0:45,,-70.96,0,-70.96,-70.96,-1,-30808,169954,200762,139146,0,-69536,0,0,0,,69536,-69536
41,10-12-18,4,0:45,1:00,,-60.06,0,-60.06,-60.06,-1,-40966,139346,180312,98380,0,-91812,0,0,0,,91812,-91812
41,10-12-18,5,1:00,1:15,,24.36,0,24.36,24.36,-1,-44286,110605,154891,66319,0,-56158,0,0,0,,56158,-56158
41,10-12-18,6,1:15,1:30,,37.97,0,37.97,37.97,-1,-72162,112861,185023,40699,0,-19203,0,0,0,,19203,-19203
41,10-12-18,7,1:30,1:45,,-73.2,0,-73.2,-73.2,-1,-50649,112790,163439,62141,0,-53066,0,0,0,,53066,-53066
41,10-12-18,8,1:45,2:00,,-60.06,0,-60.06,-60.06,-1,-61318,135703,197021,74385,0,-61242,0,0,0,,61242,-61242
41,10-12-18,9,2:00,2:15,,37.97,0,37.97,37.97,-1,-69725,120041,189766,50316,0,-22292,0,0,0,,22292,-22292
41,10-12-18,10,2:15,2:30,,45.97,0,45.97,45.97,-1,-59225,118318,177543,59093,0,-10915,0,0,0,,10915,-10915
41,10-12-18,11,2:30,2:45,,48.34,0,48.34,48.34,-1,-63984,103770,167754,39786,0,-6573,0,0,0,,6573,-6573
41,10-12-18,12,2:45,3:00,,41.97,0,41.97,41.97,-1,-60975,104291,165266,43316,0,-10200,0,0,0,,10200,-10200
41,10-12-18,13,3:00,3:15,,48.34,0,48.34,48.34,-1,-52383,111915,164298,59532,0,-2548,0,0,0,,2548,-2548
41,10-12-18,14,3:15,3:30,,48.34,0,48.34,48.34,-1,-56956,109800,166756,52844,0,-955,0,0,0,,955,-955
41,10-12-18,15,3:30,3:45,,37.97,0,37.97,37.97,-1,-52318,122576,174894,70258,0,-6898,0,0,0,,6898,-6898
41,10-12-18,16,3:45,4:00,,-17.82,0,-17.82,-17.82,-1,-61956,139745,201701,77789,0,-65002,0,0,0,,65002,-65002
41,10-12-18,17,4:00,4:15,,-150.78,0,-150.78,-150.78,-1,-65156,157738,222894,92582,0,-76332,0,0,0,,76332,-76332
41,10-12-18,18,4:15,4:30,,22.9,0,22.9,22.9,-1,-57378,185685,243063,128307,0,-82576,0,0,0,,82576,-82576
41,10-12-18,19,4:30,4:45,,27.58,0,27.58,27.58,-1,-61250,144895,206145,83645,0,-69956,0,0,0,,69956,-69956
41,10-12-18,20,4:45,5:00,,37.97,0,37.97,37.97,-1,-64060,118247,182307,54187,0,-35931,0,0,0,,35931,-35931
41,10-12-18,21,5:00,5:15,,24.1,0,24.1,24.1,-1,-74000,147974,221974,73974,0,-38467,0,0,0,,38467,-38467
41,10-12-18,22,5:15,5:30,,34.78,0,34.78,34.78,-1,-52986,125375,178361,72389,0,-46898,0,0,0,,46898,-46898
41,10-12-18,23,5:30,5:45,,41.97,0,41.97,41.97,-1,-52472,100816,153288,48344,0,-17950,0,0,0,,17950,-17950
41,10-12-18,24,5:45,6:00,,45.97,0,45.97,45.97,-1,-44595,103499,148094,58904,0,-1943,0,0,0,,1943,-1943
41,10-12-18,25,6:00,6:15,,39.55,0,39.55,39.55,-1,-153449,150170,303619,-3279,0,-13165,0,0,0,,13165,-13165
41,10-12-18,26,6:15,6:30,,,0,48.33,48.33,0,-166461,116481,282942,-49980,0,-326,0,0,0,,326,-326
41,10-12-18,27,6:30,6:45,61.5,,0,61.5,61.5,1,-208602,78051,286653,-130551,0,0,9007,0,0,,9007,9007
41,10-12-18,28,6:45,7:00,51.94,,0,51.94,51.94,1,-209730,151750,361480,-57980,0,0,15040,0,0,,15040,15040
41,10-12-18,29,7:00,7:15,51.55,,0,51.55,51.55,1,-202748,142259,345007,-60489,0,0,7333,0,0,,7333,7333
41,10-12-18,30,7:15,7:30,88.68,,0,88.68,88.68,1,-179199,102593,281792,-76606,0,0,15658,0,0,,15658,15658
41,10-12-18,31,7:30,7:45,129.82,,0,129.82,129.82,1,-227409,109882,337291,-117527,0,0,76833,0,0,,76833,76833
41,10-12-18,32,7:45,8:00,61.07,,0,61.07,61.07,1,-270449,136921,407370,-133528,0,0,46049,0,0,,46049,46049
41,10-12-18,33,8:00,8:15,54.12,39.55,0,39.55,39.55,-1,-140483,164307,304790,23824,0,-6465,11390,0,0,,17855,4925
41,10-12-18,34,8:15,8:30,54.12,38.23,0,38.23,38.23,-1,-124318,156865,281183,32547,0,-20854,2,0,0,,20856,-20852
41,10-12-18,35,8:30,8:45,,47.14,0,47.14,47.14,-1,-121866,155656,277522,33790,0,-11901,0,0,0,,11901,-11901
41,10-12-18,36,8:45,9:00,,43.55,0,43.55,43.55,-1,-122360,139513,261873,17153,0,-15563,0,0,0,,15563,-15563
41,10-12-18,37,9:00,9:15,,21.62,0,21.62,21.62,-1,-32419,126446,158865,94027,0,-32769,0,0,0,,32769,-32769
41,10-12-18,38,9:15,9:30,,39.51,0,39.51,39.51,-1,-48746,102744,151490,53998,0,-29045,0,0,0,,29045,-29045
41,10-12-18,39,9:30,9:45,,21.62,0,21.62,21.62,-1,-37451,136911,174362,99460,0,-5504,0,0,0,,5504,-5504
41,10-12-18,40,9:45,10:00,,-17.52,0,-17.52,-17.52,-1,-31104,116444,147548,85340,0,-44807,0,0,0,,44807,-44807
41,10-12-18,41,10:00,10:15,51.55,45.57,0,51.55,45.57,2,-137072,82010,219082,-55062,0,-11044,922,0,0,,11966,-10122
41,10-12-18,42,10:15,10:30,,49.91,0,49.91,49.91,-1,-85409,85325,170734,-84,0,-173,0,0,0,,173,-173
41,10-12-18,43,10:30,10:45,,43.55,0,43.55,43.55,-1,-58985,97189,156174,38204,0,-6413,0,0,0,,6413,-6413
41,10-12-18,44,10:45,11:00,,36.29,0,36.29,36.29,-1,-40592,95817,136409,55225,0,-18060,0,0,0,,18060,-18060
41,10-12-18,45,11:00,11:15,71.57,46.17,0,71.57,46.17,2,-111058,30076,141134,-80982,0,-8230,18097,0,0,,26327,9867
41,10-12-18,46,11:15,11:30,55.62,,0,55.62,55.62,1,-111889,51241,163130,-60648,0,0,7515,0,0,,7515,7515
41,10-12-18,47,11:30,11:45,52.3,,0,52.3,52.3,1,-74493,57456,131949,-17037,0,0,463,0,0,,463,463
41,10-12-18,48,11:45,12:00,52.3,41.49,0,41.49,41.49,-1,-58645,83653,142298,25008,0,-4171,4,0,0,,4175,-4167
41,10-12-18,49,12:00,12:15,,40.3,0,40.3,40.3,-1,-31293,80191,111484,48898,0,-4670,0,0,0,,4670,-4670
41,10-12-18,50,12:15,12:30,,44.3,0,44.3,44.3,-1,-24605,99748,124353,75143,0,-4696,0,0,0,,4696,-4696
41,10-12-18,51,12:30,12:45,,45.14,0,45.14,45.14,-1,-19790,140333,160123,120543,0,-3762,0,0,0,,3762,-3762
41,10-12-18,52,12:45,13:00,,21.62,0,21.62,21.62,-1,-17914,140731,158645,122817,0,-7118,0,0,0,,7118,-7118
41,10-12-18,53,13:00,13:15,,-150.78,0,-150.78,-150.78,-1,-55305,95943,151248,40638,0,-46580,0,0,0,,46580,-46580
41,10-12-18,54,13:15,13:30,,34.99,0,34.99,34.99,-1,-72199,104143,176342,31944,0,-15059,0,0,0,,15059,-15059
41,10-12-18,55,13:30,13:45,,36.52,0,36.52,36.52,-1,-63413,104782,168195,41369,0,-45731,0,0,0,,45731,-45731
41,10-12-18,56,13:45,14:00,,25.68,0,25.68,25.68,-1,-52256,109184,161440,56928,0,-45685,0,0,0,,45685,-45685
41,10-12-18,57,14:00,14:15,,36.52,0,36.52,36.52,-1,-46174,69640,115814,23466,0,-35838,0,0,0,,35838,-35838
41,10-12-18,58,14:15,14:30,,44.91,0,44.91,44.91,-1,-48724,68763,117487,20039,0,-2683,0,0,0,,2683,-2683
41,10-12-18,59,14:30,14:45,,44.78,0,44.78,44.78,-1,-48558,53932,102490,5374,0,-7353,0,0,0,,7353,-7353
41,10-12-18,60,14:45,15:00,,,0,50.43,50.43,0,-52330,37783,90113,-14547,0,-1338,0,0,0,,1338,-1338
41,10-12-18,61,15:00,15:15,60.02,,0,60.02,60.02,1,-89935,37179,127114,-52756,0,0,16219,0,0,,16219,16219
41,10-12-18,62,15:15,15:30,56.3,,0,56.3,56.3,1,-88556,47156,135712,-41400,0,0,18721,0,0,,18721,18721
41,10-12-18,63,15:30,15:45,56.31,,0,56.31,56.31,1,-102153,50200,152353,-51953,0,0,34223,0,0,,34223,34223
41,10-12-18,64,15:45,16:00,56.3,,0,56.3,56.3,1,-89911,47866,137777,-42045,0,0,17387,0,0,,17387,17387
41,10-12-18,65,16:00,16:15,68.39,,0,68.39,68.39,1,-127420,35072,162492,-92348,0,0,13177,0,0,,13177,13177
41,10-12-18,66,16:15,16:30,112.64,,0,112.64,112.64,1,-158911,15110,174021,-143801,0,0,40048,0,0,,40048,40048
41,10-12-18,67,16:30,16:45,159.12,,0,159.12,159.12,1,-176322,10169,186491,-166153,0,0,91146,0,0,,91146,91146
41,10-12-18,68,16:45,17:00,159.12,,0,159.12,159.12,1,-182752,20014,202766,-162738,0,0,72272,0,0,,72272,72272
41,10-12-18,69,17:00,17:15,98.12,,0,98.12,98.12,1,-141571,43474,185045,-98097,0,0,51316,0,0,,51316,51316
41,10-12-18,70,17:15,17:30,161.12,,0,161.12,161.12,1,-143858,23481,167339,-120377,0,0,83440,0,0,,83440,83440
41,10-12-18,71,17:30,17:45,161.12,,0,161.12,161.12,1,-160704,53603,214307,-107101,0,0,97958,0,0,,97958,97958
41,10-12-18,72,17:45,18:00,142.12,,0,142.12,142.12,1,-174581,74415,248996,-100166,0,0,94296,0,0,,94296,94296
41,10-12-18,73,18:00,18:15,62.11,51.73,0,51.73,51.73,-1,-122339,82361,204700,-39978,0,-6,21702,0,0,,21708,21696
41,10-12-18,74,18:15,18:30,,,0,50.91,50.91,0,-80275,75049,155324,-5226,0,0,0,0,0,,0,0
41,10-12-18,75,18:30,18:45,,,0,50.93,50.93,0,-78271,75915,154186,-2356,0,0,0,0,0,,0,0
41,10-12-18,76,18:45,19:00,48.3,,0,48.3,48.3,1,-88603,88695,177298,92,0,0,9,0,0,,9,9
41,10-12-18,77,19:00,19:15,47.55,,0,47.55,47.55,1,-101140,41698,142838,-59442,0,0,1003,0,0,,1003,1003
41,10-12-18,78,19:15,19:30,80.12,,0,80.12,80.12,1,-121860,27931,149791,-93929,0,0,28242,0,0,,28242,28242
41,10-12-18,79,19:30,19:45,63.12,,0,63.12,63.12,1,-123024,30617,153641,-92407,0,0,47495,0,0,,47495,47495
41,10-12-18,80,19:45,20:00,51.55,,0,51.55,51.55,1,-110622,50062,160684,-60560,0,0,7328,0,0,,7328,7328
41,10-12-18,81,20:00,20:15,52.53,,0,52.53,52.53,1,-120010,60524,180534,-59486,0,0,2056,0,0,,2056,2056
41,10-12-18,82,20:15,20:30,,,0,50.47,50.47,0,-98605,58636,157241,-39969,0,0,232,0,0,,232,232
41,10-12-18,83,20:30,20:45,,40.62,0,40.62,40.62,-1,-53134,59289,112423,6155,0,-2404,0,0,0,,2404,-2404
41,10-12-18,84,20:45,21:00,,36.62,0,36.62,36.62,-1,-44849,70837,115686,25988,0,-29993,0,0,0,,29993,-29993
41,10-12-18,85,21:00,21:15,52.57,26.09,0,52.57,26.09,2,-78236,85277,163513,7041,0,-27891,780,0,0,,28671,-27111
41,10-12-18,86,21:15,21:30,56.37,26.09,0,56.37,56.37,1,-77625,44235,121860,-33390,0,-701,8307,0,0,,9008,7606
41,10-12-18,87,21:30,21:45,,50.54,0,50.54,50.54,-1,-67713,62610,130323,-5103,0,-1823,0,0,0,,1823,-1823
41,10-12-18,88,21:45,22:00,,51.27,0,51.27,51.27,-1,-91044,67210,158254,-23834,0,-307,0,0,0,,307,-307
41,10-12-18,89,22:00,22:15,,45.2,0,45.2,45.2,-1,-51945,82767,134712,30822,0,-283,0,0,0,,283,-283
41,10-12-18,90,22:15,22:30,47.55,,0,47.55,47.55,1,-79698,48938,128636,-30760,0,0,154,0,0,,154,154
41,10-12-18,91,22:30,22:45,51.55,,0,51.55,51.55,1,-64081,52237,116318,-11844,0,0,886,0,0,,886,886
41,10-12-18,92,22:45,23:00,,48.06,0,48.06,48.06,-1,-63896,61268,125164,-2628,0,-443,0,0,0,,443,-443
41,10-12-18,93,23:00,23:15,71.8,21.8,0,71.8,21.8,2,-72215,49799,122014,-22416,0,-10952,7484,0,0,,18436,-3468
41,10-12-18,94,23:15,23:30,97.7,50.53,0,97.7,47.01,2,-72039,38286,110325,-33753,0,-43,35135,0,0,,35178,35092
41,10-12-18,95,23:30,23:45,97.7,44.39,0,44.39,44.39,-1,-53347,57727,111074,4380,0,-4539,470,0,0,,5009,-4069
41,10-12-18,96,23:45,0:00,,44.39,0,44.39,44.39,-1,-41537,57044,98581,15507,0,-15506,0,0,0,,15506,-15506
42,10/13/2018,1,0:00,0:15,48.57,42.48,0,48.57,48.57,1,-64308,36876,101184,-27432,0,-6373,266,0,0,,6639,-6107
42,10/13/2018,2,0:15,0:30,54.05,,0,54.05,54.05,1,-68206,35228,103434,-32978,0,0,9922,0,0,,9922,9922
42,10/13/2018,3,0:30,0:45,57.55,,0,57.55,57.55,1,-87064,30676,117740,-56388,0,0,21686,0,0,,21686,21686
42,10/13/2018,4,0:45,1:00,52.8,,0,52.8,52.8,1,-95986,39486,135472,-56500,0,0,20438,0,0,,20438,20438
42,10/13/2018,5,1:00,1:15,55.85,,0,55.85,55.85,1,-86179,48937,135116,-37242,0,0,20740,0,0,,20740,20740
42,10/13/2018,6,1:15,1:30,51.55,,0,51.55,51.55,1,-73341,56242,129583,-17099,0,0,15966,0,0,,15966,15966
42,10/13/2018,7,1:30,1:45,51.55,44.62,0,44.62,44.62,-1,-67257,60406,127663,-6851,0,-2705,737,0,0,,3442,-1968
42,10/13/2018,8,1:45,2:00,,48.95,0,48.95,48.95,-1,-66542,56885,123427,-9657,0,-1348,0,0,0,,1348,-1348
42,10/13/2018,9,2:00,2:15,55.85,48.67,0,55.85,55.85,1,-90367,44355,134722,-46012,0,-404,5669,0,0,,6073,5265
42,10/13/2018,10,2:15,2:30,55.85,,0,55.85,55.85,1,-85604,37428,123032,-48176,0,0,14018,0,0,,14018,14018
42,10/13/2018,11,2:30,2:45,49.81,,0,49.81,49.81,1,-82820,41160,123980,-41660,0,0,1100,0,0,,1100,1100
42,10/13/2018,12,2:45,3:00,,,0,47.63,47.63,0,-79460,39052,118512,-40408,0,0,0,0,0,,0,0
42,10/13/2018,13,3:00,3:15,51.55,,0,51.55,51.55,1,-82160,32582,114742,-49578,0,0,6917,0,0,,6917,6917
42,10/13/2018,14,3:15,3:30,47.55,,0,47.55,47.55,1,-64097,20045,84142,-44052,0,0,3195,0,0,,3195,3195
42,10/13/2018,15,3:30,3:45,46.64,,0,46.64,46.64,1,-64055,25694,89749,-38361,0,0,158,0,0,,158,158
42,10/13/2018,16,3:45,4:00,,,0,47.47,47.47,0,-61057,28526,89583,-32531,0,0,0,0,0,,0,0
42,10/13/2018,17,4:00,4:15,52.96,,0,52.96,52.96,1,-69736,31054,100790,-38682,0,0,16805,0,0,,16805,16805
42,10/13/2018,18,4:15,4:30,52.96,,0,52.96,52.96,1,-63944,21155,85099,-42789,0,0,27509,0,0,,27509,27509
42,10/13/2018,19,4:30,4:45,51.55,,0,51.55,51.55,1,-61825,22930,84755,-38895,0,0,16554,0,0,,16554,16554
42,10/13/2018,20,4:45,5:00,52.96,,0,52.96,52.96,1,-58736,23799,82535,-34937,0,0,17208,0,0,,17208,17208
42,10/13/2018,21,5:00,5:15,52.96,48.73,0,48.73,48.73,-1,-56440,36070,92510,-20370,0,-37,680,0,0,,717,643
42,10/13/2018,22,5:15,5:30,47.55,48.74,0,47.55,47.55,1,-54533,29918,84451,-24615,0,-104,102,0,0,,206,-2
42,10/13/2018,23,5:30,5:45,49.21,,0,49.21,49.21,1,-60708,33621,94329,-27087,0,0,4290,0,0,,4290,4290
42,10/13/2018,24,5:45,6:00,49.21,,0,49.21,49.21,1,-68661,34398,103059,-34263,0,0,5621,0,0,,5621,5621
42,10/13/2018,25,6:00,6:15,49.21,42.03,0,42.03,42.03,-1,-39284,52856,92140,13572,0,-6178,1154,0,0,,7332,-5024
42,10/13/2018,26,6:15,6:30,,45.09,0,45.09,45.09,-1,-49489,50770,100259,1281,0,-9651,0,0,0,,9651,-9651
42,10/13/2018,27,6:30,6:45,48.46,49.13,0,48.46,48.46,1,-72357,43458,115815,-28899,0,-656,403,0,0,,1059,-253
42,10/13/2018,28,6:45,7:00,49.21,,0,49.21,49.21,1,-105689,78589,184278,-27100,0,0,5162,0,0,,5162,5162
42,10/13/2018,29,7:00,7:15,48.01,,0,48.01,48.01,1,-76026,44462,120488,-31564,0,0,1257,0,0,,1257,1257
42,10/13/2018,30,7:15,7:30,,,0,48.95,48.95,0,-82996,38052,121048,-44944,0,0,0,0,0,,0,0
42,10/13/2018,31,7:30,7:45,49.69,,0,49.69,49.69,1,-83775,30697,114472,-53078,0,0,1798,0,0,,1798,1798
42,10/13/2018,32,7:45,8:00,72.32,,0,72.32,72.32,1,-95410,25565,120975,-69845,0,0,27548,0,0,,27548,27548
42,10/13/2018,33,8:00,8:15,73.06,,0,73.06,73.06,1,-98462,40238,138700,-58224,0,0,17188,0,0,,17188,17188
42,10/13/2018,34,8:15,8:30,102.02,,0,102.02,102.02,1,-128592,34003,162595,-94589,0,0,35028,0,0,,35028,35028
42,10/13/2018,35,8:30,8:45,72.32,,0,72.32,72.32,1,-125446,32041,157487,-93405,0,0,60023,0,0,,60023,60023
42,10/13/2018,36,8:45,9:00,133.02,,0,133.02,133.02,1,-153005,29579,182584,-123426,0,0,66065,0,0,,66065,66065
42,10/13/2018,37,9:00,9:15,63.35,,0,63.35,63.35,1,-114887,51249,166136,-63638,0,0,57738,0,0,,57738,57738
42,10/13/2018,38,9:15,9:30,146.16,,0,146.16,146.16,1,-141213,40524,181737,-100689,0,0,72766,0,0,,72766,72766
42,10/13/2018,39,9:30,9:45,83.16,,0,83.16,83.16,1,-130932,36858,167790,-94074,0,0,90158,0,0,,90158,90158
42,10/13/2018,40,9:45,10:00,61.73,,0,61.73,61.73,1,-113565,39221,152786,-74344,0,0,66320,0,0,,66320,66320
42,10/13/2018,41,10:00,10:15,183.09,,0,183.09,183.09,1,-181461,28939,210400,-152522,0,0,87675,0,0,,87675,87675
42,10/13/2018,42,10:15,10:30,183.09,,0,183.09,183.09,1,-131564,40402,171966,-91162,0,0,100442,0,0,,100442,100442
42,10/13/2018,43,10:30,10:45,56.79,,0,56.79,56.79,1,-95693,71812,167505,-23881,0,0,18047,0,0,,18047,18047
42,10/13/2018,44,10:45,11:00,53.61,,0,53.61,53.61,1,-93028,63266,156294,-29762,0,0,17933,0,0,,17933,17933
42,10/13/2018,45,11:00,11:15,48.01,49.34,0,48.01,30.32,2,-85322,72185,157507,-13137,0,-26,3559,0,0,,3585,3533
42,10/13/2018,46,11:15,11:30,,,0,30.32,30.32,0,-107582,42393,149975,-65189,0,0,0,0,0,,0,0
42,10/13/2018,47,11:30,11:45,56.31,,0,56.31,56.31,1,-121146,35300,156446,-85846,0,0,7499,0,0,,7499,7499
42,10/13/2018,48,11:45,12:00,50.71,,0,50.71,50.71,1,-107179,49090,156269,-58089,0,0,12480,0,0,,12480,12480
42,10/13/2018,49,12:00,12:15,111.58,,0,111.58,111.58,1,-122280,32646,154926,-89634,0,0,42041,0,0,,42041,42041
42,10/13/2018,50,12:15,12:30,56.31,,0,56.31,56.31,1,-96344,51098,147442,-45246,0,0,46267,0,0,,46267,46267
42,10/13/2018,51,12:30,12:45,50.71,,0,50.71,50.71,1,-92848,65183,158031,-27665,0,0,18956,0,0,,18956,18956
42,10/13/2018,52,12:45,13:00,50.71,,0,50.71,50.71,1,-98712,75076,173788,-23636,0,0,12525,0,0,,12525,12525
42,10/13/2018,53,13:00,13:15,57.74,,0,57.74,57.74,1,-123262,62146,185408,-61116,0,0,32784,0,0,,32784,32784
42,10/13/2018,54,13:15,13:30,56.31,,0,56.31,56.31,1,-113612,56106,169718,-57506,0,0,45801,0,0,,45801,45801
42,10/13/2018,55,13:30,13:45,54.74,,0,54.74,54.74,1,-105927,55178,161105,-50749,0,0,27682,0,0,,27682,27682
42,10/13/2018,56,13:45,14:00,56.31,,0,56.31,56.31,1,-116225,59708,175933,-56517,0,0,34079,0,0,,34079,34079
42,10/13/2018,57,14:00,14:15,57.74,,0,57.74,57.74,1,-122324,41293,163617,-81031,0,0,29046,0,0,,29046,29046
42,10/13/2018,58,14:15,14:30,56.31,,0,56.31,56.31,1,-118745,43227,161972,-75518,0,0,37531,0,0,,37531,37531
42,10/13/2018,59,14:30,14:45,52.16,,0,52.16,52.16,1,-107786,52620,160406,-55166,0,0,32520,0,0,,32520,32520
42,10/13/2018,60,14:45,15:00,54.74,,0,54.74,54.74,1,-117574,53128,170702,-64446,0,0,32398,0,0,,32398,32398
42,10/13/2018,61,15:00,15:15,48.01,37.14,0,48.01,30.14,2,-77440,98139,175579,20699,0,-9904,6562,0,0,,16466,-3342
42,10/13/2018,62,15:15,15:30,48.46,44.63,0,48.46,48.46,1,-97523,72877,170400,-24646,0,-1737,202,0,0,,1939,-1535
42,10/13/2018,63,15:30,15:45,49.46,,0,49.46,49.46,1,-96629,66545,163174,-30084,0,0,5620,0,0,,5620,5620
42,10/13/2018,64,15:45,16:00,56.31,,0,56.31,56.31,1,-117150,57319,174469,-59831,0,0,27907,0,0,,27907,27907
42,10/13/2018,65,16:00,16:15,52.01,,0,52.01,52.01,1,-132972,72742,205714,-60230,0,0,10519,0,0,,10519,10519
42,10/13/2018,66,16:15,16:30,62.58,,0,62.58,62.58,1,-142304,56044,198348,-86260,0,0,6300,0,0,,6300,6300
42,10/13/2018,67,16:30,16:45,144.16,,0,144.16,144.16,1,-148986,36720,185706,-112266,0,0,47315,0,0,,47315,47315
42,10/13/2018,68,16:45,17:00,144.16,,0,144.16,144.16,1,-156233,31339,187572,-124894,0,0,89176,0,0,,89176,89176
42,10/13/2018,69,17:00,17:15,72.32,,0,72.32,72.32,1,-186315,137271,323586,-49044,0,0,47338,0,0,,47338,47338
42,10/13/2018,70,17:15,17:30,72.32,,0,72.32,72.32,1,-167379,104235,271614,-63144,0,0,34623,0,0,,34623,34623
42,10/13/2018,71,17:30,17:45,94.16,,0,94.16,94.16,1,-187366,87483,274849,-99883,0,0,76364,0,0,,76364,76364
42,10/13/2018,72,17:45,18:00,72.32,,0,72.32,72.32,1,-152689,80691,233380,-71998,0,0,80742,0,0,,80742,80742
42,10/13/2018,73,18:00,18:15,72.09,,0,72.09,72.09,1,-163684,82815,246499,-80869,0,0,59601,0,0,,59601,59601
42,10/13/2018,74,18:15,18:30,102.16,,0,102.16,102.16,1,-131053,57649,188702,-73404,0,0,34927,0,0,,34927,34927
42,10/13/2018,75,18:30,18:45,122.09,,0,122.09,122.09,1,-119543,62708,182251,-56835,0,0,46502,0,0,,46502,46502
42,10/13/2018,76,18:45,19:00,56.01,,0,56.01,56.01,1,-139990,85476,225466,-54514,0,0,35973,0,0,,35973,35973
42,10/13/2018,77,19:00,19:15,84.9,,0,84.9,84.9,1,-117737,45133,162870,-72604,0,0,45134,0,0,,45134,45134
42,10/13/2018,78,19:15,19:30,64.9,,0,64.9,64.9,1,-100531,49474,150005,-51057,0,0,48042,0,0,,48042,48042
42,10/13/2018,79,19:30,19:45,55.03,,0,55.03,55.03,1,-93014,52895,145909,-40119,0,0,27717,0,0,,27717,27717
42,10/13/2018,80,19:45,20:00,54.9,40.56,0,40.56,40.56,-1,-74946,65597,140543,-9349,0,-427,13882,0,0,,14309,13455
42,10/13/2018,81,20:00,20:15,52.01,40.56,0,52.01,40.56,2,-105679,82022,187701,-23657,0,-1589,9749,0,0,,11338,8160
42,10/13/2018,82,20:15,20:30,64.86,,0,64.86,64.86,1,-108665,59690,168355,-48975,0,0,22507,0,0,,22507,22507
42,10/13/2018,83,20:30,20:45,65.16,,0,65.16,65.16,1,-86034,51171,137205,-34863,0,0,33932,0,0,,33932,33932
42,10/13/2018,84,20:45,21:00,65.16,46.52,0,46.52,46.52,-1,-58036,53363,111399,-4673,0,-1312,4278,0,0,,5590,2966
42,10/13/2018,85,21:00,21:15,57.46,,0,57.46,57.46,1,-92094,49638,141732,-42456,0,0,14241,0,0,,14241,14241
42,10/13/2018,86,21:15,21:30,57.46,,0,57.46,57.46,1,-94652,62257,156909,-32395,0,0,23957,0,0,,23957,23957
42,10/13/2018,87,21:30,21:45,57.46,40.78,0,40.78,40.78,-1,-56907,58455,115362,1548,0,-5665,6079,0,0,,11744,414
42,10/13/2018,88,21:45,22:00,52.01,,0,52.01,52.01,1,-83377,59148,142525,-24229,0,0,2674,0,0,,2674,2674
42,10/13/2018,89,22:00,22:15,152.25,,0,152.25,152.25,1,-193706,89927,283633,-103779,0,0,37679,0,0,,37679,37679
42,10/13/2018,90,22:15,22:30,72.09,,0,72.09,72.09,1,-153740,109850,263590,-43890,0,0,48329,0,0,,48329,48329
42,10/13/2018,91,22:30,22:45,72.09,46.03,0,46.03,46.03,-1,-117622,116636,234258,-986,0,-3928,2636,0,0,,6564,-1292
42,10/13/2018,92,22:45,23:00,56.01,44.01,0,56.01,44.01,2,-154494,123669,278163,-30825,0,-2853,8503,0,0,,11356,5650
42,10/13/2018,93,23:00,23:15,148.26,,0,148.26,148.26,1,-168547,50834,219381,-117713,0,0,47958,0,0,,47958,47958
42,10/13/2018,94,23:15,23:30,147.21,,0,147.21,147.21,1,-160657,40344,201001,-120313,0,0,114785,0,0,,114785,114785
42,10/13/2018,95,23:30,23:45,72.09,,0,72.09,72.09,1,-119489,68434,187923,-51055,0,0,51177,0,0,,51177,51177
42,10/13/2018,96,23:45,0:00,66.82,,0,66.82,66.82,1,-134152,65384,199536,-68768,0,0,40470,0,0,,40470,40470
42,10/14/2018,1,0:00,0:15,66.82,28.31,0,28.31,28.31,-1,-50378,81656,132034,31278,0,-8628,9721,0,0,,18349,1093
42,10/14/2018,2,0:15,0:30,64.96,49.95,0,64.96,64.96,1,-67776,29208,96984,-38568,0,-329,7469,0,0,,7798,7140
42,10/14/2018,3,0:30,0:45,127.26,,0,127.26,127.26,1,-123331,36686,160017,-86645,0,0,61534,0,0,,61534,61534
42,10/14/2018,4,0:45,1:00,56.01,,0,56.01,56.01,1,-103702,47569,151271,-56133,0,0,50615,0,0,,50615,50615
42,10/14/2018,5,1:00,1:15,126.93,,0,126.93,126.93,1,-141121,42018,183139,-99103,0,0,67599,0,0,,67599,67599
42,10/14/2018,6,1:15,1:30,64.16,,0,64.16,64.16,1,-126316,50189,176505,-76127,0,0,66598,0,0,,66598,66598
42,10/14/2018,7,1:30,1:45,72.09,,0,72.09,72.09,1,-107807,33242,141049,-74565,0,0,62073,0,0,,62073,62073
42,10/14/2018,8,1:45,2:00,60.51,,0,60.51,60.51,1,-112443,36575,149018,-75868,0,0,54126,0,0,,54126,54126
42,10/14/2018,9,2:00,2:15,56.01,,0,56.01,56.01,1,-75055,36551,111606,-38504,0,0,37126,0,0,,37126,37126
42,10/14/2018,10,2:15,2:30,56.01,,0,56.01,56.01,1,-81452,33559,115011,-47893,0,0,38587,0,0,,38587,38587
42,10/14/2018,11,2:30,2:45,53.03,,0,53.03,53.03,1,-79879,35269,115148,-44610,0,0,29519,0,0,,29519,29519
42,10/14/2018,12,2:45,3:00,53.14,,0,53.14,53.14,1,-80127,43236,123363,-36891,0,0,29601,0,0,,29601,29601
42,10/14/2018,13,3:00,3:15,74.03,,0,74.03,74.03,1,-127443,43497,170940,-83946,0,0,48758,0,0,,48758,48758
42,10/14/2018,14,3:15,3:30,56.01,,0,56.01,56.01,1,-79951,46433,126384,-33518,0,0,29230,0,0,,29230,29230
42,10/14/2018,15,3:30,3:45,60.12,,0,60.12,60.12,1,-104706,43718,148424,-60988,0,0,37987,0,0,,37987,37987
42,10/14/2018,16,3:45,4:00,56.01,,0,56.01,56.01,1,-112352,42246,154598,-70106,0,0,47081,0,0,,47081,47081
42,10/14/2018,17,4:00,4:15,48.01,44.01,0,48.49,44.01,2,-53354,57931,111285,4577,0,-2206,11379,0,0,,13585,9173
42,10/14/2018,18,4:15,4:30,50.23,,0,50.23,50.23,1,-68901,50555,119456,-18346,0,0,4366,0,0,,4366,4366
42,10/14/2018,19,4:30,4:45,52.01,,0,52.01,52.01,1,-74383,44112,118495,-30271,0,0,10293,0,0,,10293,10293
42,10/14/2018,20,4:45,5:00,52.01,,0,52.01,52.01,1,-89783,48838,138621,-40945,0,0,23208,0,0,,23208,23208
42,10/14/2018,21,5:00,5:15,52.01,,0,52.01,52.01,1,-79651,48942,128593,-30709,0,0,16551,0,0,,16551,16551
42,10/14/2018,22,5:15,5:30,52.01,,0,52.01,52.01,1,-80954,46551,127505,-34403,0,0,18879,0,0,,18879,18879
42,10/14/2018,23,5:30,5:45,58.87,,0,58.87,58.87,1,-100988,38896,139884,-62092,0,0,36699,0,0,,36699,36699
42,10/14/2018,24,5:45,6:00,56.01,,0,56.01,56.01,1,-97947,42046,139993,-55901,0,0,42870,0,0,,42870,42870
42,10/14/2018,25,6:00,6:15,56.16,,0,56.16,56.16,1,-83689,35150,118839,-48539,0,0,36438,0,0,,36438,36438
42,10/14/2018,26,6:15,6:30,67.63,,0,67.63,67.63,1,-98780,29240,128020,-69540,0,0,43305,0,0,,43305,43305
42,10/14/2018,27,6:30,6:45,60.07,,0,60.07,60.07,1,-94295,28778,123073,-65517,0,0,53485,0,0,,53485,53485
42,10/14/2018,28,6:45,7:00,58.04,,0,58.04,58.04,1,-100481,33731,134212,-66750,0,0,53939,0,0,,53939,53939
42,10/14/2018,29,7:00,7:15,56.16,46.03,0,56.16,46.03,2,-96769,99919,196688,3150,0,-1477,18280,0,0,,19757,16803
42,10/14/2018,30,7:15,7:30,56.16,46.74,0,46.74,46.74,-1,-70428,60876,131304,-9552,0,-1518,2,0,0,,1520,-1516
42,10/14/2018,31,7:30,7:45,68.03,46.74,0,68.03,68.03,1,-108281,58237,166518,-50044,0,-43,20353,0,0,,20396,20310
42,10/14/2018,32,7:45,8:00,54.08,36.91,0,36.91,36.91,-1,-80369,75072,155441,-5297,0,-2898,13186,0,0,,16084,10288
42,10/14/2018,33,8:00,8:15,54.08,40.16,0,40.16,40.16,-1,-34610,52285,86895,17675,0,-4119,28,0,0,,4147,-4091
42,10/14/2018,34,8:15,8:30,,50.05,0,50.05,50.05,-1,-42130,40486,82616,-1644,0,-87,0,0,0,,87,-87
42,10/14/2018,35,8:30,8:45,49.11,,0,49.11,49.11,1,-45538,37428,82966,-8110,0,0,929,0,0,,929,929
42,10/14/2018,36,8:45,9:00,56.16,,0,56.16,56.16,1,-71056,37170,108226,-33886,0,0,10556,0,0,,10556,10556
42,10/14/2018,37,9:00,9:15,72.24,,0,72.24,72.24,1,-100594,39950,140544,-60644,0,0,34895,0,0,,34895,34895
42,10/14/2018,38,9:15,9:30,61.49,,0,61.49,61.49,1,-106885,41745,148630,-65140,0,0,51204,0,0,,51204,51204
42,10/14/2018,39,9:30,9:45,60.81,,0,60.81,60.81,1,-100571,41852,142423,-58719,0,0,50774,0,0,,50774,50774
42,10/14/2018,40,9:45,10:00,56.16,,0,56.16,56.16,1,-78954,38069,117023,-40885,0,0,36391,0,0,,36391,36391
42,10/14/2018,41,10:00,10:15,72.24,,0,72.24,72.24,1,-94362,28606,122968,-65756,0,0,42680,0,0,,42680,42680
42,10/14/2018,42,10:15,10:30,63.12,,0,63.12,63.12,1,-78529,32802,111331,-45727,0,0,48654,0,0,,48654,48654
42,10/14/2018,43,10:30,10:45,48.16,49.75,0,48.96,48.96,2,-53263,37769,91032,-15494,0,-614,7221,0,0,,7835,6607
42,10/14/2018,44,10:45,11:00,52.16,47.23,0,52.16,47.23,2,-59832,51741,111573,-8091,0,-121,4027,0,0,,4148,3906
42,10/14/2018,45,11:00,11:15,50.58,44.16,0,50.58,50.58,1,-60969,47629,108598,-13340,0,-235,472,0,0,,707,237
42,10/14/2018,46,11:15,11:30,56.16,,0,56.16,56.16,1,-68258,45825,114083,-22433,0,0,12720,0,0,,12720,12720
42,10/14/2018,47,11:30,11:45,48.16,49.47,0,49.47,49.47,-1,-67657,65775,133432,-1882,0,-1364,2086,0,0,,3450,722
42,10/14/2018,48,11:45,12:00,,44.16,0,44.16,44.16,-1,-71998,85204,157202,13206,0,-1703,0,0,0,,1703,-1703
42,10/14/2018,49,12:00,12:15,56.16,,0,56.16,56.16,1,-88423,53666,142089,-34757,0,0,12362,0,0,,12362,12362
42,10/14/2018,50,12:15,12:30,50.25,49.55,0,50.25,48.86,2,-67068,82531,149599,15463,0,-828,3941,0,0,,4769,3113
42,10/14/2018,51,12:30,12:45,,43.49,0,43.49,43.49,-1,-45025,98445,143470,53420,0,-8894,0,0,0,,8894,-8894
42,10/14/2018,52,12:45,13:00,,40.16,0,40.16,40.16,-1,-66148,92147,158295,25999,0,-21302,0,0,0,,21302,-21302
42,10/14/2018,53,13:00,13:15,,40.16,0,40.16,40.16,-1,-48606,90607,139213,42001,0,-11639,0,0,0,,11639,-11639
42,10/14/2018,54,13:15,13:30,,40.16,0,40.16,40.16,-1,-57956,89402,147358,31446,0,-930,0,0,0,,930,-930
42,10/14/2018,55,13:30,13:45,,22.24,0,22.24,22.24,-1,-42840,101524,144364,58684,0,-29727,0,0,0,,29727,-29727
42,10/14/2018,56,13:45,14:00,,36.91,0,36.91,36.91,-1,-42118,105357,147475,63239,0,-39216,0,0,0,,39216,-39216
42,10/14/2018,57,14:00,14:15,47.04,40.16,0,47.04,47.04,1,-85425,99057,184482,13632,0,-19277,51,0,0,,19328,-19226
42,10/14/2018,58,14:15,14:30,48.16,40.16,0,48.16,48.16,1,-89266,79074,168340,-10192,0,-46,959,0,0,,1005,913
42,10/14/2018,59,14:30,14:45,48.16,,0,48.16,48.16,1,-90218,76324,166542,-13894,0,0,2573,0,0,,2573,2573
42,10/14/2018,60,14:45,15:00,56.16,,0,56.16,56.16,1,-98627,61914,160541,-36713,0,0,11256,0,0,,11256,11256
42,10/14/2018,61,15:00,15:15,50.23,,0,50.23,50.23,1,-79801,79237,159038,-564,0,0,6441,0,0,,6441,6441
42,10/14/2018,62,15:15,15:30,50.2,,0,50.2,50.2,1,-86533,75800,162333,-10733,0,0,1679,0,0,,1679,1679
42,10/14/2018,63,15:30,15:45,56.16,,0,56.16,56.16,1,-75507,37863,113370,-37644,0,0,17280,0,0,,17280,17280
42,10/14/2018,64,15:45,16:00,72.24,,0,72.24,72.24,1,-104082,28066,132148,-76016,0,0,46470,0,0,,46470,46470
42,10/14/2018,65,16:00,16:15,72.24,,0,72.24,72.24,1,-119469,50691,170160,-68778,0,0,60540,0,0,,60540,60540
42,10/14/2018,66,16:15,16:30,72.24,,0,72.24,72.24,1,-118423,35645,154068,-82778,0,0,61241,0,0,,61241,61241
42,10/14/2018,67,16:30,16:45,72.24,,0,72.24,72.24,1,-123109,26006,149115,-97103,0,0,77596,0,0,,77596,77596
42,10/14/2018,68,16:45,17:00,148.27,,0,148.27,148.27,1,-198012,35491,233503,-162521,0,0,107381,0,0,,107381,107381
42,10/14/2018,69,17:00,17:15,148.27,45.84,0,45.84,45.84,-1,-80430,99459,179889,19029,0,-881,34924,0,0,,35805,34043
42,10/14/2018,70,17:15,17:30,65.43,,0,65.43,65.43,1,-80012,42358,122370,-37654,0,0,5288,0,0,,5288,5288
42,10/14/2018,71,17:30,17:45,148.27,,0,148.27,148.27,1,-159238,22003,181241,-137235,0,0,82473,0,0,,82473,82473
42,10/14/2018,72,17:45,18:00,147.27,,0,147.27,147.27,1,-148566,34652,183218,-113914,0,0,119913,0,0,,119913,119913
42,10/14/2018,73,18:00,18:15,56.16,,0,56.16,56.16,1,-158102,88147,246249,-69955,0,0,28606,0,0,,28606,28606
42,10/14/2018,74,18:15,18:30,147.27,,0,147.27,147.27,1,-149681,60023,209704,-89658,0,0,30218,0,0,,30218,30218
42,10/14/2018,75,18:30,18:45,147.27,,0,147.27,147.27,1,-139677,65483,205160,-74194,0,0,26408,0,0,,26408,26408
42,10/14/2018,76,18:45,19:00,147.27,,0,147.27,147.27,1,-170358,80023,250381,-90335,0,0,20585,0,0,,20585,20585
42,10/14/2018,77,19:00,19:15,158.74,,0,158.74,158.74,1,-274686,50059,324745,-224627,0,0,96079,0,0,,96079,96079
42,10/14/2018,78,19:15,19:30,168.09,,0,168.09,168.09,1,-213425,53476,266901,-159949,0,0,107045,1250,0,,108295,108295
42,10/14/2018,79,19:30,19:45,168.09,,0,168.09,168.09,1,-181712,77468,259180,-104244,0,0,37445,1250,0,,38695,38695
42,10/14/2018,80,19:45,20:00,72.24,,0,72.24,72.24,1,-176752,78145,254897,-98607,0,0,5062,0,0,,5062,5062
42,10/14/2018,81,20:00,20:15,289.27,,0,318.2,318.2,1,-259896,3933,263829,-255963,0,0,82210,0,0,,82210,82210
42,10/14/2018,82,20:15,20:30,289.27,,0,318.2,318.2,1,-220600,25112,245712,-195488,0,0,121849,1250,30000,,153099,153099
42,10/14/2018,83,20:30,20:45,190.1,,0,290.1,290.1,1,-172887,64750,237637,-108137,0,0,79951,1250,30000,,111201,111201
42,10/14/2018,84,20:45,21:00,190.1,,0,290.1,290.1,1,-177321,103005,280326,-74316,0,0,38572,1250,30000,,69822,69822
42,10/14/2018,85,21:00,21:15,180,,0,280,280,1,-184742,94134,278876,-90608,0,0,36551,1250,30000,,67801,67801
42,10/14/2018,86,21:15,21:30,180,,0,280,280,1,-179521,103312,282833,-76209,0,0,37557,1250,30000,,68807,68807
42,10/14/2018,87,21:30,21:45,180,,0,180,180,1,-167696,111466,279162,-56230,0,0,34015,1250,10000,,45265,45265
42,10/14/2018,88,21:45,22:00,90,,0,90,90,1,-153834,95050,248884,-58784,0,0,27321,0,0,,27321,27321
42,10/14/2018,89,22:00,22:15,150.27,,0,150.27,150.27,1,-194192,77766,271958,-116426,0,0,82709,0,0,,82709,82709
42,10/14/2018,90,22:15,22:30,101.59,,0,101.59,101.59,1,-185652,87780,273432,-97872,0,0,98225,0,0,,98225,98225
42,10/14/2018,91,22:30,22:45,71.16,,0,71.16,71.16,1,-161288,94500,255788,-66788,0,0,63496,0,0,,63496,63496
42,10/14/2018,92,22:45,23:00,67.16,,0,67.16,67.16,1,-157953,100404,258357,-57549,0,0,41365,0,0,,41365,41365
42,10/14/2018,93,23:00,23:15,111.27,,0,111.27,111.27,1,-132058,54981,187039,-77077,0,0,51852,0,0,,51852,51852
42,10/14/2018,94,23:15,23:30,71.16,,0,71.16,71.16,1,-98684,56972,155656,-41712,0,0,48202,0,0,,48202,48202
42,10/14/2018,95,23:30,23:45,67.16,,0,67.16,67.16,1,-113203,74124,187327,-39079,0,0,15206,0,0,,15206,15206
42,10/14/2018,96,23:45,0:00,55.45,,0,55.45,55.45,1,-98615,81253,179868,-17362,0,0,13040,0,0,,13040,13040
42,10/15/2018,1,0:00,0:15,77.15,,0,77.15,77.15,1,-122136,48229,170365,-73907,0,0,23012,0,0,,23012,23012
42,10/15/2018,2,0:15,0:30,81.75,,0,81.75,81.75,1,-109373,42695,152068,-66678,0,0,56608,0,0,,56608,56608
42,10/15/2018,3,0:30,0:45,56.16,,0,56.16,56.16,1,-103723,57480,161203,-46243,0,0,36967,0,0,,36967,36967
42,10/15/2018,4,0:45,1:00,49.21,,0,49.21,49.21,1,-105711,65652,171363,-40059,0,0,17727,0,0,,17727,17727
42,10/15/2018,5,1:00,1:15,72.06,48.68,0,72.06,48.68,2,-77846,28526,106372,-49320,0,-23,14402,0,0,,14425,14379
42,10/15/2018,6,1:15,1:30,72.38,,0,72.38,72.38,1,-122217,49643,171860,-72574,0,0,50235,0,0,,50235,50235
42,10/15/2018,7,1:30,1:45,60.5,,0,60.5,60.5,1,-107228,51825,159053,-55403,0,0,42376,0,0,,42376,42376
42,10/15/2018,8,1:45,2:00,72.06,,0,72.06,72.06,1,-129428,51616,181044,-77812,0,0,28870,0,0,,28870,28870
42,10/15/2018,9,2:00,2:15,64.46,,0,64.46,64.46,1,-95308,43047,138355,-52261,0,0,38068,0,0,,38068,38068
42,10/15/2018,10,2:15,2:30,64.8,,0,64.8,64.8,1,-101683,47356,149039,-54327,0,0,44135,0,0,,44135,44135
42,10/15/2018,11,2:30,2:45,57.15,,0,57.15,57.15,1,-102093,47373,149466,-54720,0,0,45240,0,0,,45240,45240
42,10/15/2018,12,2:45,3:00,56.16,,0,56.16,56.16,1,-115662,59953,175615,-55709,0,0,33593,0,0,,33593,33593
42,10/15/2018,13,3:00,3:15,52.16,44.71,0,52.16,44.71,2,-62633,80458,143091,17825,0,-1028,7306,0,0,,8334,6278
42,10/15/2018,14,3:15,3:30,52.16,,0,52.16,52.16,1,-98310,101163,199473,2853,0,0,3901,0,0,,3901,3901
42,10/15/2018,15,3:30,3:45,,,0,49.95,49.95,0,-94899,100062,194961,5163,0,0,0,0,0,,0,0
42,10/15/2018,16,3:45,4:00,,44.72,0,44.72,44.72,-1,-96480,92427,188907,-4053,0,-2297,0,0,0,,2297,-2297
42,10/15/2018,17,4:00,4:15,,26.52,0,26.52,26.52,-1,-49705,110721,160426,61016,0,-27183,0,0,0,,27183,-27183
42,10/15/2018,18,4:15,4:30,,32.89,0,32.89,32.89,-1,-60371,105410,165781,45039,0,-52541,0,0,0,,52541,-52541
42,10/15/2018,19,4:30,4:45,,40.16,0,40.16,40.16,-1,-61758,86750,148508,24992,0,-25053,0,0,0,,25053,-25053
42,10/15/2018,20,4:45,5:00,,39.94,0,39.94,39.94,-1,-58154,86271,144425,28117,0,-26464,0,0,0,,26464,-26464
42,10/15/2018,21,5:00,5:15,,44.16,0,44.16,44.16,-1,-29899,65579,95478,35680,0,-12135,0,0,0,,12135,-12135
42,10/15/2018,22,5:15,5:30,,30.91,0,30.91,30.91,-1,-21520,76888,98408,55368,0,-21121,0,0,0,,21121,-21121
42,10/15/2018,23,5:30,5:45,,44.29,0,44.29,44.29,-1,-43910,60120,104030,16210,0,-9226,0,0,0,,9226,-9226
42,10/15/2018,24,5:45,6:00,,45.74,0,45.74,45.74,-1,-66094,57747,123841,-8347,0,-2853,0,0,0,,2853,-2853
42,10/15/2018,25,6:00,6:15,,45.84,0,45.84,45.84,-1,-72669,90339,163008,17670,0,-926,0,0,0,,926,-926
42,10/15/2018,26,6:15,6:30,,45.84,0,45.84,45.84,-1,-31760,62911,94671,31151,0,-4953,0,0,0,,4953,-4953
42,10/15/2018,27,6:30,6:45,,,0,50.15,50.15,0,-56582,52515,109097,-4067,0,-13,0,0,0,,13,-13
42,10/15/2018,28,6:45,7:00,51.26,,0,51.26,51.26,1,-75803,69337,145140,-6466,0,0,4940,0,0,,4940,4940
42,10/15/2018,29,7:00,7:15,,,0,50.91,50.91,0,-77852,73853,151705,-3999,0,0,0,0,0,,0,0
42,10/15/2018,30,7:15,7:30,52.55,,0,52.55,52.55,1,-63173,40017,103190,-23156,0,0,6815,0,0,,6815,6815
42,10/15/2018,31,7:30,7:45,183.26,,0,183.26,183.26,1,-117713,34701,152414,-83012,0,0,37576,0,0,,37576,37576
42,10/15/2018,32,7:45,8:00,183.26,,0,183.26,183.26,1,-130840,61450,192290,-69390,0,0,71783,0,0,,71783,71783
42,10/15/2018,33,8:00,8:15,183.26,37.3,0,37.3,37.3,-1,-29935,74919,104854,44984,0,-7091,4482,0,0,,11573,-2609
42,10/15/2018,34,8:15,8:30,,51.74,0,51.74,51.74,-1,-32884,42535,75419,9651,0,-268,0,0,0,,268,-268
42,10/15/2018,35,8:30,8:45,50.7,51.74,0,50.7,50.7,1,-58173,44927,103100,-13246,0,-5,851,0,0,,856,846
42,10/15/2018,36,8:45,9:00,52.55,,0,52.55,52.55,1,-67199,47952,115151,-19247,0,0,3997,0,0,,3997,3997
42,10/15/2018,37,9:00,9:15,50.57,,0,50.57,50.57,1,-59389,58210,117599,-1179,0,0,2452,0,0,,2452,2452
42,10/15/2018,38,9:15,9:30,50.57,,0,50.57,50.57,1,-50410,47451,97861,-2959,0,0,5456,0,0,,5456,5456
42,10/15/2018,39,9:30,9:45,50.57,46.77,0,46.77,46.77,-1,-35016,52319,87335,17303,0,-1370,1381,0,0,,2751,11
42,10/15/2018,40,9:45,10:00,,46.95,0,46.95,46.95,-1,-48446,58836,107282,10390,0,-1807,0,0,0,,1807,-1807
42,10/15/2018,41,10:00,10:15,,45.74,0,45.74,45.74,-1,-32573,47498,80071,14925,0,-2202,0,0,0,,2202,-2202
42,10/15/2018,42,10:15,10:30,,37.3,0,37.3,37.3,-1,-26948,69904,96852,42956,0,-22223,0,0,0,,22223,-22223
42,10/15/2018,43,10:30,10:45,,37.3,0,37.3,37.3,-1,-26329,69812,96141,43483,0,-32244,0,0,0,,32244,-32244
42,10/15/2018,44,10:45,11:00,,44.18,0,44.18,44.18,-1,-19528,79394,98922,59866,0,-24364,0,0,0,,24364,-24364
42,10/15/2018,45,11:00,11:15,,46.03,0,46.03,46.03,-1,-33922,59603,93525,25681,0,-7405,0,0,0,,7405,-7405
42,10/15/2018,46,11:15,11:30,,50.42,0,50.42,50.42,-1,-24015,72033,96048,48018,0,-22,0,0,0,,22,-22
42,10/15/2018,47,11:30,11:45,,45.74,0,45.74,45.74,-1,-13792,73611,87403,59819,0,-5126,0,0,0,,5126,-5126
42,10/15/2018,48,11:45,12:00,,44.55,0,44.55,44.55,-1,-21826,89827,111653,68001,0,-13739,0,0,0,,13739,-13739
42,10/15/2018,49,12:00,12:15,48.55,50.42,0,50.15,50.15,2,-57661,44148,101809,-13513,0,-2875,697,0,0,,3572,-2178
42,10/15/2018,50,12:15,12:30,,46.48,0,46.48,46.48,-1,-50956,47656,98612,-3300,0,-4030,0,0,0,,4030,-4030
42,10/15/2018,51,12:30,12:45,,46.48,0,46.48,46.48,-1,-34778,53762,88540,18984,0,-5374,0,0,0,,5374,-5374
42,10/15/2018,52,12:45,13:00,,45.03,0,45.03,45.03,-1,-37681,56333,94014,18652,0,-11243,0,0,0,,11243,-11243
42,10/15/2018,53,13:00,13:15,,44.55,0,44.55,44.55,-1,-49981,58416,108397,8435,0,-8855,0,0,0,,8855,-8855
42,10/15/2018,54,13:15,13:30,,44.55,0,44.55,44.55,-1,-59916,62687,122603,2771,0,-13648,0,0,0,,13648,-13648
42,10/15/2018,55,13:30,13:45,,41.8,0,41.8,41.8,-1,-51880,68335,120215,16455,0,-11820,0,0,0,,11820,-11820
42,10/15/2018,56,13:45,14:00,,46.02,0,46.02,46.02,-1,-64097,61886,125983,-2211,0,-6126,0,0,0,,6126,-6126
42,10/15/2018,57,14:00,14:15,,37.3,0,37.3,37.3,-1,-53133,84922,138055,31789,0,-23327,0,0,0,,23327,-23327
42,10/15/2018,58,14:15,14:30,,44.03,0,44.03,44.03,-1,-67734,86652,154386,18918,0,-21059,0,0,0,,21059,-21059
42,10/15/2018,59,14:30,14:45,48.55,44.55,0,48.55,48.55,1,-69404,66935,136339,-2469,0,-11030,21,0,0,,11051,-11009
42,10/15/2018,60,14:45,15:00,48.55,44.55,0,48.55,48.55,1,-66805,54653,121458,-12152,0,-265,544,0,0,,809,279
42,10/15/2018,61,15:00,15:15,48.55,46.47,0,46.47,46.47,-1,-57801,59985,117786,2184,0,-1909,23,0,0,,1932,-1886
42,10/15/2018,62,15:15,15:30,56.55,50.39,0,56.55,50.15,2,-71923,44601,116524,-27322,0,-214,4468,0,0,,4682,4254
42,10/15/2018,63,15:30,15:45,72.46,,0,72.46,72.46,1,-99621,32493,132114,-67128,0,0,47852,0,0,,47852,47852
42,10/15/2018,64,15:45,16:00,72.46,,0,72.46,72.46,1,-115179,30292,145471,-84887,0,0,65329,0,0,,65329,65329
42,10/15/2018,65,16:00,16:15,72.46,45.84,0,45.84,45.84,-1,-89572,79546,169118,-10026,0,-1632,19471,0,0,,21103,17839
42,10/15/2018,66,16:15,16:30,56.55,,0,56.55,56.55,1,-103619,59275,162894,-44344,0,0,3011,0,0,,3011,3011
42,10/15/2018,67,16:30,16:45,83.66,,0,83.66,83.66,1,-127843,49038,176881,-78805,0,0,49881,0,0,,49881,49881
42,10/15/2018,68,16:45,17:00,122.64,,0,122.64,122.64,1,-159237,38729,197966,-120508,0,0,73742,0,0,,73742,73742
42,10/15/2018,69,17:00,17:15,,,0,50.15,50.15,0,-102153,76742,178895,-25411,0,0,27899,0,0,,27899,27899
42,10/15/2018,70,17:15,17:30,67.88,,0,67.88,67.88,1,-126137,60044,186181,-66093,0,0,2874,0,0,,2874,2874
42,10/15/2018,71,17:30,17:45,91.02,,0,91.02,91.02,1,-151861,62746,214607,-89115,0,0,48308,0,0,,48308,48308
42,10/15/2018,72,17:45,18:00,116.02,,0,116.02,116.02,1,-150222,70148,220370,-80074,0,0,71616,0,0,,71616,71616
42,10/15/2018,73,18:00,18:15,50,50.5,0,50.87,50.5,2,-128311,67645,195956,-60666,0,-341,13899,0,0,,14240,13558
42,10/15/2018,74,18:15,18:30,52.19,,0,52.19,52.19,1,-102291,74361,176652,-27930,0,0,3102,0,0,,3102,3102
42,10/15/2018,75,18:30,18:45,61.78,,0,61.78,61.78,1,-99807,78036,177843,-21771,0,0,7998,0,0,,7998,7998
42,10/15/2018,76,18:45,19:00,70,,0,70,70,1,-140065,99986,240051,-40079,0,0,21977,0,0,,21977,21977
42,10/15/2018,77,19:00,19:15,243.95,,0,243.95,243.95,1,-169555,44260,213815,-125295,0,0,80872,0,0,,80872,80872
42,10/15/2018,78,19:15,19:30,122.43,,0,122.43,122.43,1,-146029,59531,205560,-86498,0,0,81739,0,0,,81739,81739
42,10/15/2018,79,19:30,19:45,65.02,,0,65.02,65.02,1,-115677,59881,175558,-55796,0,0,23279,0,0,,23279,23279
42,10/15/2018,80,19:45,20:00,64.22,,0,64.22,64.22,1,-102560,54599,157159,-47961,0,0,6118,0,0,,6118,6118
42,10/15/2018,81,20:00,20:15,222.62,,0,222.62,222.62,1,-151744,57174,208918,-94570,0,0,50489,0,0,,50489,50489
42,10/15/2018,82,20:15,20:30,77.5,,0,77.5,77.5,1,-123681,61651,185332,-62030,0,0,54804,0,0,,54804,54804
42,10/15/2018,83,20:30,20:45,62.43,,0,62.43,62.43,1,-102088,67892,169980,-34196,0,0,22422,0,0,,22422,22422
42,10/15/2018,84,20:45,21:00,67.04,,0,67.04,67.04,1,-86278,71677,157955,-14601,0,0,1749,0,0,,1749,1749
42,10/15/2018,85,21:00,21:15,183.61,,0,183.61,183.61,1,-161076,33681,194757,-127395,0,0,56048,0,0,,56048,56048
42,10/15/2018,86,21:15,21:30,129.02,,0,129.02,129.02,1,-137431,56169,193600,-81262,0,0,79711,0,0,,79711,79711
42,10/15/2018,87,21:30,21:45,56.2,,0,56.2,56.2,1,-103501,60808,164309,-42693,0,0,29569,0,0,,29569,29569
42,10/15/2018,88,21:45,22:00,52.55,,0,52.55,52.55,1,-81822,53320,135142,-28502,0,0,14418,0,0,,14418,14418
42,10/15/2018,89,22:00,22:15,162.81,,0,162.81,162.81,1,-156705,59048,215753,-97657,0,0,44708,0,0,,44708,44708
42,10/15/2018,90,22:15,22:30,58.32,,0,58.32,58.32,1,-134201,70788,204989,-63413,0,0,51613,0,0,,51613,51613
42,10/15/2018,91,22:30,22:45,56.55,,0,56.55,56.55,1,-109268,65623,174891,-43645,0,0,34524,0,0,,34524,34524
42,10/15/2018,92,22:45,23:00,56.55,,0,56.55,56.55,1,-125295,65414,190709,-59881,0,0,42453,0,0,,42453,42453
42,10/15/2018,93,23:00,23:15,56.55,,0,56.55,56.55,1,-153917,67742,221659,-86175,0,0,32295,0,0,,32295,32295
42,10/15/2018,94,23:15,23:30,62.49,,0,62.49,62.49,1,-156763,47700,204463,-109063,0,0,46604,0,0,,46604,46604
42,10/15/2018,95,23:30,23:45,52.55,,0,52.55,52.55,1,-131628,59322,190950,-72306,0,0,17016,0,0,,17016,17016
42,10/15/2018,96,23:45,0:00,49.17,,0,49.17,49.17,1,-122136,63812,185948,-58324,0,0,2343,0,0,,2343,2343
42,10/16/2018,1,0:00,0:15,,,0,50.06,50.06,0,-78980,16999,95979,-61981,0,0,0,0,0,,0,0
42,10/16/2018,2,0:15,0:30,,48.11,0,48.11,48.11,-1,-47365,27468,74833,-19897,0,-458,0,0,0,,458,-458
42,10/16/2018,3,0:30,0:45,,46.81,0,46.81,46.81,-1,-31029,34968,65997,3939,0,-5973,0,0,0,,5973,-5973
42,10/16/2018,4,0:45,1:00,,46.86,0,46.86,46.86,-1,-48689,49793,98482,1104,0,-6671,0,0,0,,6671,-6671
42,10/16/2018,5,1:00,1:15,,44.55,0,44.55,44.55,-1,-70547,17601,88148,-52946,0,-3995,0,0,0,,3995,-3995
42,10/16/2018,6,1:15,1:30,,,0,50.06,50.06,0,-44836,22629,67465,-22207,0,-23,0,0,0,,23,-23
42,10/16/2018,7,1:30,1:45,,46,0,46,46,-1,-31847,34510,66357,2663,0,-5185,0,0,0,,5185,-5185
42,10/16/2018,8,1:45,2:00,,44.55,0,44.55,44.55,-1,-33239,37197,70436,3958,0,-5209,0,0,0,,5209,-5209
42,10/16/2018,9,2:00,2:15,52.55,40.55,0,52.55,40.55,2,-43782,46722,90504,2940,0,-5793,3029,0,0,,8822,-2764
42,10/16/2018,10,2:15,2:30,50.4,40.55,0,50.4,50.4,1,-35156,54084,89240,18928,0,-38,3467,0,0,,3505,3429
42,10/16/2018,11,2:30,2:45,,,0,50.06,50.06,0,-30848,47253,78101,16405,0,0,0,0,0,,0,0
42,10/16/2018,12,2:45,3:00,,47.46,0,47.46,47.46,-1,-33199,65487,98686,32288,0,-502,0,0,0,,502,-502
42,10/16/2018,13,3:00,3:15,,,0,50.06,50.06,0,-28633,51699,80332,23066,0,-170,0,0,0,,170,-170
42,10/16/2018,14,3:15,3:30,,,0,50.06,50.06,0,-27695,48911,76606,21216,0,0,0,0,0,,0,0
42,10/16/2018,15,3:30,3:45,,,0,50.06,50.06,0,-27976,54621,82597,26645,0,0,0,0,0,,0,0
42,10/16/2018,16,3:45,4:00,,,0,50.06,50.06,0,-25650,50111,75761,24461,0,0,0,0,0,,0,0
42,10/16/2018,17,4:00,4:15,48.55,,0,48.55,48.55,1,-72737,33385,106122,-39352,0,0,753,0,0,,753,753
42,10/16/2018,18,4:15,4:30,48.55,,0,48.55,48.55,1,-66009,32610,98619,-33399,0,0,38,0,0,,38,38
42,10/16/2018,19,4:30,4:45,52.55,,0,52.55,52.55,1,-55016,29659,84675,-25357,0,0,8558,0,0,,8558,8558
42,10/16/2018,20,4:45,5:00,52.55,,0,52.55,52.55,1,-48809,32960,81769,-15849,0,0,3514,0,0,,3514,3514
42,10/16/2018,21,5:00,5:15,48.55,47.78,0,50.09,47.78,2,-42767,44458,87225,1691,0,-2983,1684,0,0,,4667,-1299
42,10/16/2018,22,5:15,5:30,,46.88,0,46.88,46.88,-1,-39906,37804,77710,-2102,0,-4337,0,0,0,,4337,-4337
42,10/16/2018,23,5:30,5:45,52.55,46.88,0,52.55,52.55,1,-60744,35119,95863,-25625,0,-48,552,0,0,,600,504
42,10/16/2018,24,5:45,6:00,56.55,,0,56.55,56.55,1,-59795,34813,94608,-24982,0,0,13132,0,0,,13132,13132
42,10/16/2018,25,6:00,6:15,50.19,38.97,0,51.1,38.97,2,-20875,89028,109903,68153,0,-10688,1329,0,0,,12017,-9359
42,10/16/2018,26,6:15,6:30,,47.73,0,47.73,47.73,-1,-19888,42589,62477,22701,0,-3864,0,0,0,,3864,-3864
42,10/16/2018,27,6:30,6:45,58.19,47.73,0,58.19,58.19,1,-54079,31207,85286,-22872,0,-54,6237,0,0,,6291,6183
42,10/16/2018,28,6:45,7:00,111.12,,0,111.12,111.12,1,-107488,25653,133141,-81835,0,0,39507,0,0,,39507,39507
42,10/16/2018,29,7:00,7:15,77.12,38.97,0,77.12,38.97,2,-39362,86205,125567,46843,0,-6873,22463,0,0,,29336,15590
42,10/16/2018,30,7:15,7:30,75.75,38.97,0,75.75,75.75,1,-96419,48449,144868,-47970,0,-558,9519,0,0,,10077,8961
42,10/16/2018,31,7:30,7:45,199.77,,0,199.77,199.77,1,-175977,32739,208716,-143238,0,0,78434,0,0,,78434,78434
42,10/16/2018,32,7:45,8:00,199.77,,0,199.77,199.77,1,-201587,39889,241476,-161698,0,0,119824,0,0,,119824,119824
42,10/16/2018,33,8:00,8:15,55.01,,0,55.01,55.01,1,-83265,66236,149501,-17029,0,0,35925,0,0,,35925,35925
42,10/16/2018,34,8:15,8:30,65.01,,0,65.01,65.01,1,-83188,56181,139369,-27007,0,0,12319,0,0,,12319,12319
42,10/16/2018,35,8:30,8:45,55.01,,0,55.01,55.01,1,-69140,37812,106952,-31328,0,0,3892,0,0,,3892,3892
42,10/16/2018,36,8:45,9:00,63.56,,0,63.56,63.56,1,-91692,30400,122092,-61292,0,0,11365,0,0,,11365,11365
42,10/16/2018,37,9:00,9:15,56.02,,0,56.02,56.02,1,-117993,36933,154926,-81060,0,0,20689,0,0,,20689,20689
42,10/16/2018,38,9:15,9:30,56.02,,0,56.02,56.02,1,-88579,37590,126169,-50989,0,0,12803,0,0,,12803,12803
42,10/16/2018,39,9:30,9:45,56.02,51.89,0,51.89,51.89,-1,-55574,42355,97929,-13219,0,-17,910,0,0,,927,893
42,10/16/2018,40,9:45,10:00,,51.97,0,51.97,51.97,-1,-36546,44446,80992,7900,0,-252,0,0,0,,252,-252
42,10/16/2018,41,10:00,10:15,182.05,,0,182.05,182.05,1,-134701,16259,150960,-118442,0,0,40989,0,0,,40989,40989
42,10/16/2018,42,10:15,10:30,71.51,,0,71.51,71.51,1,-106918,31739,138657,-75179,0,0,39338,0,0,,39338,39338
42,10/16/2018,43,10:30,10:45,55.98,,0,55.98,55.98,1,-86491,36584,123075,-49907,0,0,27941,0,0,,27941,27941
42,10/16/2018,44,10:45,11:00,58.82,,0,58.82,58.82,1,-83287,32512,115799,-50775,0,0,30499,0,0,,30499,30499
42,10/16/2018,45,11:00,11:15,171.05,,0,171.05,171.05,1,-196505,14168,210673,-182337,0,0,69477,0,0,,69477,69477
42,10/16/2018,46,11:15,11:30,171.06,,0,171.06,171.06,1,-140478,17390,157868,-123088,0,0,104778,0,0,,104778,104778
42,10/16/2018,47,11:30,11:45,58.19,,0,58.19,58.19,1,-84067,31755,115822,-52312,0,0,41347,0,0,,41347,41347
42,10/16/2018,48,11:45,12:00,58.19,,0,58.19,58.19,1,-75139,30668,105807,-44471,0,0,37490,0,0,,37490,37490
42,10/16/2018,49,12:00,12:15,58.19,,0,58.19,58.19,1,-74109,27175,101284,-46934,0,0,24714,0,0,,24714,24714
42,10/16/2018,50,12:15,12:30,51.97,,0,51.97,51.97,1,-70173,19804,89977,-50369,0,0,3644,0,0,,3644,3644
42,10/16/2018,51,12:30,12:45,58.19,,0,58.19,58.19,1,-59917,19151,79068,-40766,0,0,14048,0,0,,14048,14048
42,10/16/2018,52,12:45,13:00,52.11,,0,52.11,52.11,1,-64542,15773,80315,-48769,0,0,4515,0,0,,4515,4515
42,10/16/2018,53,13:00,13:15,129.12,,0,129.12,129.12,1,-87518,16533,104051,-70985,0,0,23702,0,0,,23702,23702
42,10/16/2018,54,13:15,13:30,155.12,,0,155.12,155.12,1,-95441,17009,112450,-78432,0,0,60904,0,0,,60904,60904
42,10/16/2018,55,13:30,13:45,58.19,,0,58.19,58.19,1,-80190,15578,95768,-64612,0,0,19177,0,0,,19177,19177
42,10/16/2018,56,13:45,14:00,58.19,,0,58.19,58.19,1,-103116,14256,117372,-88860,0,0,32925,0,0,,32925,32925
42,10/16/2018,57,14:00,14:15,67.37,,0,67.37,67.37,1,-128167,12148,140315,-116019,0,0,42996,0,0,,42996,42996
42,10/16/2018,58,14:15,14:30,76.72,,0,76.72,76.72,1,-121940,10748,132688,-111192,0,0,53014,0,0,,53014,53014
42,10/16/2018,59,14:30,14:45,67.37,,0,67.37,67.37,1,-127949,22798,150747,-105151,0,0,49871,0,0,,49871,49871
42,10/16/2018,60,14:45,15:00,76.72,,0,76.72,76.72,1,-133531,15367,148898,-118164,0,0,54917,0,0,,54917,54917
42,10/16/2018,61,15:00,15:15,67.12,,0,67.12,67.12,1,-102981,49014,151995,-53967,0,0,46058,0,0,,46058,46058
42,10/16/2018,62,15:15,15:30,58,,0,58,58,1,-112028,57525,169553,-54503,0,0,21382,0,0,,21382,21382
42,10/16/2018,63,15:30,15:45,111.12,,0,111.12,111.12,1,-123789,39217,163006,-84572,0,0,47091,0,0,,47091,47091
42,10/16/2018,64,15:45,16:00,76.72,,0,76.72,76.72,1,-127176,32991,160167,-94185,0,0,77963,0,0,,77963,77963
42,10/16/2018,65,16:00,16:15,50.5,49.15,0,50.98,49.15,2,-81726,77574,159300,-4152,0,-925,23402,0,0,,24327,22477
42,10/16/2018,66,16:15,16:30,76.72,,0,76.72,76.72,1,-106790,52095,158885,-54695,0,0,25338,0,0,,25338,25338
42,10/16/2018,67,16:30,16:45,84.53,,0,84.53,84.53,1,-119896,30954,150850,-88942,0,0,69953,0,0,,69953,69953
42,10/16/2018,68,16:45,17:00,76.72,,0,76.72,76.72,1,-144563,29903,174466,-114660,0,0,70312,0,0,,70312,70312
42,10/16/2018,69,17:00,17:15,60.95,,0,60.95,60.95,1,-126571,68358,194929,-58213,0,0,13882,0,0,,13882,13882
42,10/16/2018,70,17:15,17:30,102.12,,0,102.12,102.12,1,-146125,43894,190019,-102231,0,0,38964,0,0,,38964,38964
42,10/16/2018,71,17:30,17:45,186.67,,0,186.67,186.67,1,-142117,44554,186671,-97563,0,0,79996,0,0,,79996,79996
42,10/16/2018,72,17:45,18:00,80.95,,0,80.95,80.95,1,-123712,49569,173281,-74143,0,0,75809,0,0,,75809,75809
42,10/16/2018,73,18:00,18:15,65.49,48.74,0,65.49,48.74,2,-74236,50218,124454,-24018,0,-479,24961,0,0,,25440,24482
42,10/16/2018,74,18:15,18:30,,,0,51.33,51.33,0,-50239,57182,107421,6943,0,0,16,0,0,,16,16
42,10/16/2018,75,18:30,18:45,,,0,51.33,51.33,0,-55938,82216,138154,26278,0,0,0,0,0,,0,0
42,10/16/2018,76,18:45,19:00,53.39,,0,53.39,53.39,1,-95331,91874,187205,-3457,0,0,156,0,0,,156,156
42,10/16/2018,77,19:00,19:15,191.23,,0,191.23,191.23,1,-155851,72680,228531,-83171,0,0,39465,0,0,,39465,39465
42,10/16/2018,78,19:15,19:30,79.61,,0,79.61,79.61,1,-146650,84450,231100,-62200,0,0,41992,0,0,,41992,41992
42,10/16/2018,79,19:30,19:45,,,0,52.57,52.57,0,-129540,90196,219736,-39344,0,0,3423,0,0,,3423,3423
42,10/16/2018,80,19:45,20:00,,,0,52.57,52.57,0,-124734,92758,217492,-31976,0,0,0,0,0,,0,0
42,10/16/2018,81,20:00,20:15,180.61,,0,180.61,180.61,1,-161851,65189,227040,-96662,0,0,24131,0,0,,24131,24131
42,10/16/2018,82,20:15,20:30,62.58,,0,62.58,62.58,1,-136406,55473,191879,-80933,0,0,22475,0,0,,22475,22475
42,10/16/2018,83,20:30,20:45,,,0,51.45,51.45,0,-112440,77599,190039,-34841,0,0,159,0,0,,159,159
42,10/16/2018,84,20:45,21:00,,49.06,0,49.06,49.06,-1,-100537,93763,194300,-6774,0,-2621,0,0,0,,2621,-2621
42,10/16/2018,85,21:00,21:15,58.19,47.38,0,58.19,47.38,2,-104994,73858,178852,-31136,0,-1293,6515,0,0,,7808,5222
42,10/16/2018,86,21:15,21:30,52.23,51.84,0,52.23,51.02,2,-77108,60153,137261,-16955,0,-22,11905,0,0,,11927,11883
42,10/16/2018,87,21:30,21:45,52.23,45.6,0,45.6,45.6,-1,-56736,79248,135984,22512,0,-1547,749,0,0,,2296,-798
42,10/16/2018,88,21:45,22:00,,38.97,0,38.97,38.97,-1,-47902,81087,128989,33185,0,-27173,0,0,0,,27173,-27173
42,10/16/2018,89,22:00,22:15,,-21.37,0,-21.37,-21.37,-1,-46143,98361,144504,52218,0,-23672,0,0,0,,23672,-23672
42,10/16/2018,90,22:15,22:30,,34.14,0,34.14,34.14,-1,-25123,106723,131846,81600,0,-7558,0,0,0,,7558,-7558
42,10/16/2018,91,22:30,22:45,,24.32,0,24.32,24.32,-1,-22537,133106,155643,110569,0,-41958,0,0,0,,41958,-41958
42,10/16/2018,92,22:45,23:00,,-106.44,0,-106.44,-106.44,-1,-31904,148000,179904,116096,0,-48514,0,0,0,,48514,-48514
42,10/16/2018,93,23:00,23:15,,-121.92,0,-121.92,-121.92,-1,-83003,125446,208449,42443,0,-69336,0,0,0,,69336,-69336
42,10/16/2018,94,23:15,23:30,,2.7,0,2.7,2.7,-1,-48372,99561,147933,51189,0,-17232,0,0,0,,17232,-17232
42,10/16/2018,95,23:30,23:45,,-25.68,0,-25.68,-25.68,-1,-72216,122435,194651,50219,0,-59444,0,0,0,,59444,-59444
42,10/16/2018,96,23:45,0:00,,21.83,0,21.83,21.83,-1,-65505,143369,208874,77864,0,-60922,0,0,0,,60922,-60922
42,10/17/2018,1,0:00,0:15,124.32,37.86,0,124.32,124.32,1,-120171,67518,187689,-52653,0,-20271,12547,0,0,,32818,-7724
42,10/17/2018,2,0:15,0:30,61.21,,0,61.21,61.21,1,-81205,24599,105804,-56606,0,0,39291,0,0,,39291,39291
42,10/17/2018,3,0:30,0:45,57.86,,0,57.86,57.86,1,-83465,28128,111593,-55337,0,0,26222,0,0,,26222,26222
42,10/17/2018,4,0:45,1:00,57.86,45.86,0,45.86,45.86,-1,-70441,37420,107861,-33021,0,-992,938,0,0,,1930,-54
42,10/17/2018,5,1:00,1:15,,50.34,0,50.34,50.34,-1,-75921,86456,162377,10535,0,-1194,0,0,0,,1194,-1194
42,10/17/2018,6,1:15,1:30,,,0,50.82,50.82,0,-76348,68074,144422,-8274,0,0,0,0,0,,0,0
42,10/17/2018,7,1:30,1:45,50.39,,0,50.39,50.39,1,-76393,50077,126470,-26316,0,0,1018,0,0,,1018,1018
42,10/17/2018,8,1:45,2:00,49.86,,0,49.86,49.86,1,-77669,52520,130189,-25149,0,0,1038,0,0,,1038,1038
42,10/17/2018,9,2:00,2:15,49.86,,0,49.86,49.86,1,-75331,67910,143241,-7421,0,0,7,0,0,,7,7
42,10/17/2018,10,2:15,2:30,52.01,,0,52.01,52.01,1,-70096,40768,110864,-29328,0,0,7678,0,0,,7678,7678
42,10/17/2018,11,2:30,2:45,49.86,,0,49.86,49.86,1,-69742,34400,104142,-35342,0,0,3088,0,0,,3088,3088
42,10/17/2018,12,2:45,3:00,,,0,50.84,50.84,0,-65693,30932,96625,-34761,0,0,0,0,0,,0,0
42,10/17/2018,13,3:00,3:15,49.86,,0,49.86,49.86,1,-126444,38927,165371,-87517,0,0,96,0,0,,96,96
42,10/17/2018,14,3:15,3:30,68.54,,0,68.54,68.54,1,-111583,40916,152499,-70667,0,0,19117,0,0,,19117,19117
42,10/17/2018,15,3:30,3:45,68.88,,0,68.88,68.88,1,-115903,46625,162528,-69278,0,0,38897,0,0,,38897,38897
42,10/17/2018,16,3:45,4:00,57.86,,0,57.86,57.86,1,-100372,36364,136736,-64008,0,0,17979,0,0,,17979,17979
42,10/17/2018,17,4:00,4:15,56.73,,0,56.73,56.73,1,-75416,36091,111507,-39325,0,0,7595,0,0,,7595,7595
42,10/17/2018,18,4:15,4:30,50.5,,0,50.5,50.5,1,-61669,57109,118778,-4560,0,0,642,0,0,,642,642
42,10/17/2018,19,4:30,4:45,88.56,,0,88.56,88.56,1,-105093,39088,144181,-66005,0,0,33362,0,0,,33362,33362
42,10/17/2018,20,4:45,5:00,57.86,,0,57.86,57.86,1,-103192,67587,170779,-35605,0,0,26266,0,0,,26266,26266
42,10/17/2018,21,5:00,5:15,49.86,,0,49.86,49.86,1,-113192,71098,184290,-42094,0,0,2546,0,0,,2546,2546
42,10/17/2018,22,5:15,5:30,,,0,50.84,50.84,0,-76791,52423,129214,-24368,0,0,0,0,0,,0,0
42,10/17/2018,23,5:30,5:45,68.52,,0,68.52,68.52,1,-82715,26603,109318,-56112,0,0,15898,0,0,,15898,15898
42,10/17/2018,24,5:45,6:00,59.65,,0,59.65,59.65,1,-100921,58740,159661,-42181,0,0,27309,0,0,,27309,27309
42,10/17/2018,25,6:00,6:15,49.49,-10.29,0,50.73,-10.29,2,-38718,121266,159984,82548,0,-27648,5248,0,0,,32896,-22400
42,10/17/2018,26,6:15,6:30,,27.96,0,27.96,27.96,-1,-22023,99304,121327,77281,0,-66463,0,0,0,,66463,-66463
42,10/17/2018,27,6:30,6:45,57.49,27.96,0,57.49,57.49,1,-32664,26046,58710,-6618,0,-10365,6402,0,0,,16767,-3963
42,10/17/2018,28,6:45,7:00,75.65,,0,75.65,75.65,1,-81251,17906,99157,-63345,0,0,18589,0,0,,18589,18589
42,10/17/2018,29,7:00,7:15,54.37,33.36,0,54.37,33.36,2,-50415,172837,223252,122422,0,-12144,6805,0,0,,18949,-5339
42,10/17/2018,30,7:15,7:30,,49.35,0,49.35,49.35,-1,-35445,105367,140812,69922,0,-2002,0,0,0,,2002,-2002
42,10/17/2018,31,7:30,7:45,51.77,51.86,0,51.77,51.31,2,-70144,49308,119452,-20836,0,-1137,70,0,0,,1207,-1067
42,10/17/2018,32,7:45,8:00,111.41,,0,111.41,111.41,1,-125582,49671,175253,-75911,0,0,31195,0,0,,31195,31195
42,10/17/2018,33,8:00,8:15,61.11,,0,61.11,61.11,1,-106192,62834,169026,-43358,0,0,27790,0,0,,27790,27790
42,10/17/2018,34,8:15,8:30,58.77,,0,58.77,58.77,1,-108564,46719,155283,-61845,0,0,12492,0,0,,12492,12492
42,10/17/2018,35,8:30,8:45,53.02,,0,53.02,53.02,1,-112325,31150,143475,-81175,0,0,9018,0,0,,9018,9018
42,10/17/2018,36,8:45,9:00,,,0,51.53,51.53,0,-125353,25574,150927,-99779,0,0,596,0,0,,596,596
42,10/17/2018,37,9:00,9:15,51.66,,0,51.66,51.66,1,-58965,34636,93601,-24329,0,0,1855,0,0,,1855,1855
42,10/17/2018,38,9:15,9:30,49.49,,0,49.49,49.49,1,-52492,32551,85043,-19941,0,0,1446,0,0,,1446,1446
42,10/17/2018,39,9:30,9:45,,45.49,0,45.49,45.49,-1,-36665,47636,84301,10971,0,-4939,0,0,0,,4939,-4939
42,10/17/2018,40,9:45,10:00,,41.49,0,41.49,41.49,-1,-38785,53967,92752,15182,0,-17799,0,0,0,,17799,-17799
42,10/17/2018,41,10:00,10:15,52.33,41.49,0,52.33,52.33,1,-116205,61351,177556,-54854,0,-1702,835,0,0,,2537,-867
42,10/17/2018,42,10:15,10:30,,,0,51.31,51.31,0,-92404,67726,160130,-24678,0,0,0,0,0,,0,0
42,10/17/2018,43,10:30,10:45,,46.54,0,46.54,46.54,-1,-80308,86035,166343,5727,0,-4290,0,0,0,,4290,-4290
42,10/17/2018,44,10:45,11:00,,47.85,0,47.85,47.85,-1,-69479,89187,158666,19708,0,-7829,0,0,0,,7829,-7829
42,10/17/2018,45,11:00,11:15,170.15,47.85,0,170.15,170.15,1,-158154,55636,213790,-102518,0,-2090,41553,0,0,,43643,39463
42,10/17/2018,46,11:15,11:30,75.65,,0,75.65,75.65,1,-119428,49569,168997,-69859,0,0,71733,0,0,,71733,71733
42,10/17/2018,47,11:30,11:45,52.07,,0,52.07,52.07,1,-93870,61013,154883,-32857,0,0,13621,0,0,,13621,13621
42,10/17/2018,48,11:45,12:00,50.6,,0,50.6,50.6,1,-91167,66540,157707,-24627,0,0,2817,0,0,,2817,2817
42,10/17/2018,49,12:00,12:15,50.31,,0,50.31,50.31,1,-80035,67386,147421,-12649,0,0,822,0,0,,822,822
42,10/17/2018,50,12:15,12:30,,37.49,0,37.49,37.49,-1,-48662,73961,122623,25299,0,-16997,0,0,0,,16997,-16997
42,10/17/2018,51,12:30,12:45,,33.03,0,33.03,33.03,-1,-28529,77289,105818,48760,0,-39020,0,0,0,,39020,-39020
42,10/17/2018,52,12:45,13:00,,32.94,0,32.94,32.94,-1,-25200,84913,110113,59713,0,-64665,0,0,0,,64665,-64665
42,10/17/2018,53,13:00,13:15,,37.49,0,37.49,37.49,-1,-21753,59018,80771,37265,0,-49495,0,0,0,,49495,-49495
42,10/17/2018,54,13:15,13:30,,41.49,0,41.49,41.49,-1,-24502,61691,86193,37189,0,-37644,0,0,0,,37644,-37644
42,10/17/2018,55,13:30,13:45,,38.6,0,38.6,38.6,-1,-25494,64449,89943,38955,0,-41481,0,0,0,,41481,-41481
42,10/17/2018,56,13:45,14:00,,43.92,0,43.92,43.92,-1,-33874,44193,78067,10319,0,-25924,0,0,0,,25924,-25924
42,10/17/2018,57,14:00,14:15,49.49,45.49,0,50.56,45.49,2,-62198,64875,127073,2677,0,-2736,23,0,0,,2759,-2713
42,10/17/2018,58,14:15,14:30,,41.49,0,41.49,41.49,-1,-43373,50486,93859,7113,0,-12320,0,0,0,,12320,-12320
42,10/17/2018,59,14:30,14:45,,50.89,0,50.89,50.89,-1,-46009,42330,88339,-3679,0,-1269,0,0,0,,1269,-1269
42,10/17/2018,60,14:45,15:00,53.12,50.84,0,53.12,50.56,2,-56062,44685,100747,-11377,0,-1836,1141,0,0,,2977,-695
42,10/17/2018,61,15:00,15:15,49.49,,0,49.49,49.49,1,-59371,55943,115314,-3428,0,0,354,0,0,,354,354
42,10/17/2018,62,15:15,15:30,53.49,,0,53.49,53.49,1,-74854,49188,124042,-25666,0,0,9508,0,0,,9508,9508
42,10/17/2018,63,15:30,15:45,57.49,,0,57.49,57.49,1,-79821,37342,117163,-42479,0,0,30177,0,0,,30177,30177
42,10/17/2018,64,15:45,16:00,53.85,,0,53.85,53.85,1,-93613,52141,145754,-41472,0,0,26212,0,0,,26212,26212
42,10/17/2018,65,16:00,16:15,53.49,41.49,0,53.49,41.49,2,-52866,85019,137885,32153,0,-1932,8548,0,0,,10480,6616
42,10/17/2018,66,16:15,16:30,,48.36,0,48.36,48.36,-1,-54352,60439,114791,6087,0,-571,0,0,0,,571,-571
42,10/17/2018,67,16:30,16:45,51.12,,0,51.12,51.12,1,-68270,61143,129413,-7127,0,0,201,0,0,,201,201
42,10/17/2018,68,16:45,17:00,59.94,,0,59.94,59.94,1,-102384,34744,137128,-67640,0,0,23839,0,0,,23839,23839
42,10/17/2018,69,17:00,17:15,52.99,,0,52.99,52.99,1,-74631,59940,134571,-14691,0,0,7164,0,0,,7164,7164
42,10/17/2018,70,17:15,17:30,62.94,,0,62.94,62.94,1,-75588,36728,112316,-38860,0,0,5326,0,0,,5326,5326
42,10/17/2018,71,17:30,17:45,62.94,,0,62.94,62.94,1,-76726,24423,101149,-52303,0,0,29878,0,0,,29878,29878
42,10/17/2018,72,17:45,18:00,62.94,,0,62.94,62.94,1,-63515,30017,93532,-33498,0,0,34517,0,0,,34517,34517
42,10/17/2018,73,18:00,18:15,56.23,46.91,0,56.23,46.91,2,-80216,47932,128148,-32284,0,-1195,9309,0,0,,10504,8114
42,10/17/2018,74,18:15,18:30,56.23,48.39,0,48.39,48.39,-1,-45320,62976,108296,17656,0,-1034,3,0,0,,1037,-1031
42,10/17/2018,75,18:30,18:45,,,0,51.51,51.51,0,-39332,72773,112105,33441,0,0,0,0,0,,0,0
42,10/17/2018,76,18:45,19:00,49.94,,0,49.94,49.94,1,-58298,78402,136700,20104,0,0,21,0,0,,21,21
42,10/17/2018,77,19:00,19:15,62.29,,0,62.29,62.29,1,-71665,51989,123654,-19676,0,0,6283,0,0,,6283,6283
42,10/17/2018,78,19:15,19:30,55.63,,0,55.63,55.63,1,-66002,39476,105478,-26526,0,0,5454,0,0,,5454,5454
42,10/17/2018,79,19:30,19:45,54.88,,0,54.88,54.88,1,-56899,37805,94704,-19094,0,0,4644,0,0,,4644,4644
42,10/17/2018,80,19:45,20:00,54.88,45.49,0,45.49,45.49,-1,-49656,42015,91671,-7641,0,-1170,45,0,0,,1215,-1125
42,10/17/2018,81,20:00,20:15,51.47,45.49,0,51.47,45.49,2,-74151,20654,94805,-53497,0,-794,141,0,0,,935,-653
42,10/17/2018,82,20:15,20:30,,,0,51.36,51.36,0,-59678,30007,89685,-29671,0,0,0,0,0,,0,0
42,10/17/2018,83,20:30,20:45,,45.49,0,45.49,45.49,-1,-42465,48789,91254,6324,0,-7446,0,0,0,,7446,-7446
42,10/17/2018,84,20:45,21:00,,45.49,0,45.49,45.49,-1,-40883,64329,105212,23446,0,-17729,0,0,0,,17729,-17729
42,10/17/2018,85,21:00,21:15,75.65,51.75,0,75.65,51.38,2,-85710,22573,108283,-63137,0,-3886,15759,0,0,,19645,11873
42,10/17/2018,86,21:15,21:30,53.02,,0,53.02,53.02,1,-75371,19803,95174,-55568,0,0,5540,0,0,,5540,5540
42,10/17/2018,87,21:30,21:45,49.49,,0,49.49,49.49,1,-55383,36081,91464,-19302,0,0,666,0,0,,666,666
42,10/17/2018,88,21:45,22:00,,45.57,0,45.57,45.57,-1,-45916,51869,97785,5953,0,-6830,0,0,0,,6830,-6830
42,10/17/2018,89,22:00,22:15,51.03,41.26,0,51.38,41.26,2,-83134,36086,119220,-47048,0,-6812,747,0,0,,7559,-6065
42,10/17/2018,90,22:15,22:30,49.49,,0,49.49,49.49,1,-69470,21688,91158,-47782,0,0,1636,0,0,,1636,1636
42,10/17/2018,91,22:30,22:45,52.15,45.49,0,52.15,45.49,2,-59040,46292,105332,-12748,0,-746,1324,0,0,,2070,578
42,10/17/2018,92,22:45,23:00,,43.65,0,43.65,43.65,-1,-74600,75072,149672,472,0,-21121,0,0,0,,21121,-21121
42,10/17/2018,93,23:00,23:15,57.49,43.65,0,57.49,57.49,1,-78894,48620,127514,-30274,0,-1481,15199,0,0,,16680,13718
42,10/17/2018,94,23:15,23:30,57.49,46.44,0,46.44,46.44,-1,-52316,39745,92061,-12571,0,-808,1648,0,0,,2456,840
42,10/17/2018,95,23:30,23:45,,37.49,0,37.49,37.49,-1,-41926,64535,106461,22609,0,-14620,0,0,0,,14620,-14620
42,10/17/2018,96,23:45,0:00,,41.47,0,41.47,41.47,-1,-28746,69392,98138,40646,0,-31394,0,0,0,,31394,-31394
42,10/18/2018,1,0:00,0:15,84.17,44.88,0,84.17,44.88,2,-106825,47819,154644,-59006,0,-12100,19072,0,0,,31172,6972
42,10/18/2018,2,0:15,0:30,52.88,,0,52.88,52.88,1,-68224,54552,122776,-13672,0,0,6471,0,0,,6471,6471
42,10/18/2018,3,0:30,0:45,,41.68,0,41.68,41.68,-1,-46275,71996,118271,25721,0,-11064,0,0,0,,11064,-11064
42,10/18/2018,4,0:45,1:00,,36.88,0,36.88,36.88,-1,-37280,82418,119698,45138,0,-36071,0,0,0,,36071,-36071
42,10/18/2018,5,1:00,1:15,97.88,44.17,0,97.88,97.88,1,-85216,23932,109148,-61284,0,-14728,14260,0,0,,28988,-468
42,10/18/2018,6,1:15,1:30,56.88,,0,56.88,56.88,1,-74385,36514,110899,-37871,0,0,17795,0,0,,17795,17795
42,10/18/2018,7,1:30,1:45,48.88,,0,48.88,48.88,1,-51113,30908,82021,-20205,0,0,1516,0,0,,1516,1516
42,10/18/2018,8,1:45,2:00,,44.57,0,44.57,44.57,-1,-37850,44744,82594,6894,0,-6171,0,0,0,,6171,-6171
42,10/18/2018,9,2:00,2:15,52.88,50.53,0,52.88,49.71,2,-95088,10497,105585,-84591,0,-2127,750,0,0,,2877,-1377
42,10/18/2018,10,2:15,2:30,52.88,,0,52.88,52.88,1,-86992,8783,95775,-78209,0,0,896,0,0,,896,896
42,10/18/2018,11,2:30,2:45,,,0,49.73,49.73,0,-82920,24938,107858,-57982,0,0,0,0,0,,0,0
42,10/18/2018,12,2:45,3:00,,,0,49.77,49.77,0,-78441,35206,113647,-43235,0,0,0,0,0,,0,0
42,10/18/2018,13,3:00,3:15,52.88,,0,52.88,52.88,1,-66917,39704,106621,-27213,0,0,1494,0,0,,1494,1494
42,10/18/2018,14,3:15,3:30,48.88,,0,48.88,48.88,1,-61512,33558,95070,-27954,0,0,923,0,0,,923,923
42,10/18/2018,15,3:30,3:45,,,0,49.67,49.67,0,-57657,41021,98678,-16636,0,0,0,0,0,,0,0
42,10/18/2018,16,3:45,4:00,,45.82,0,45.82,45.82,-1,-49678,43485,93163,-6193,0,-1410,0,0,0,,1410,-1410
42,10/18/2018,17,4:00,4:15,,47.58,0,47.58,47.58,-1,-44372,43051,87423,-1321,0,-3250,0,0,0,,3250,-3250
42,10/18/2018,18,4:15,4:30,,47.96,0,47.96,47.96,-1,-39852,35876,75728,-3976,0,-5187,0,0,0,,5187,-5187
42,10/18/2018,19,4:30,4:45,,47.96,0,47.96,47.96,-1,-50826,37805,88631,-13021,0,-2523,0,0,0,,2523,-2523
42,10/18/2018,20,4:45,5:00,,,0,49.71,49.71,0,-57834,35214,93048,-22620,0,0,0,0,0,,0,0
42,10/18/2018,21,5:00,5:15,,44.88,0,44.88,44.88,-1,-81063,77711,158774,-3352,0,-1981,0,0,0,,1981,-1981
42,10/18/2018,22,5:15,5:30,,44.88,0,44.88,44.88,-1,-57580,64348,121928,6768,0,-6619,0,0,0,,6619,-6619
42,10/18/2018,23,5:30,5:45,48.88,44.88,0,48.88,48.88,1,-78680,44300,122980,-34380,0,-113,14,0,0,,127,-99
42,10/18/2018,24,5:45,6:00,52.2,,0,52.2,52.2,1,-92780,61997,154777,-30783,0,0,3765,0,0,,3765,3765
42,10/18/2018,25,6:00,6:15,52.2,32.82,0,32.82,32.82,-1,-44856,99762,144618,54906,0,-16280,415,0,0,,16695,-15865
42,10/18/2018,26,6:15,6:30,,48.28,0,48.28,48.28,-1,-50648,47725,98373,-2923,0,-4485,0,0,0,,4485,-4485
42,10/18/2018,27,6:30,6:45,71.47,,0,71.47,71.47,1,-89354,27261,116615,-62093,0,0,9657,0,0,,9657,9657
42,10/18/2018,28,6:45,7:00,141.17,,0,141.17,141.17,1,-170711,30217,200928,-140494,0,0,76524,0,0,,76524,76524
42,10/18/2018,29,7:00,7:15,141.17,-46.51,0,-46.51,-46.51,-1,-37148,105286,142434,68138,0,-16684,12861,0,0,,29545,-3823
42,10/18/2018,30,7:15,7:30,47.85,51.51,0,47.85,47.85,1,-45333,51005,96338,5672,0,-618,3,0,0,,621,-615
42,10/18/2018,31,7:30,7:45,55.85,,0,55.85,55.85,1,-84252,48131,132383,-36121,0,0,3300,0,0,,3300,3300
42,10/18/2018,32,7:45,8:00,144.14,,0,144.14,144.14,1,-119426,57094,176520,-62332,0,0,40452,0,0,,40452,40452
42,10/18/2018,33,8:00,8:15,144.14,49.65,0,49.65,49.65,-1,-32664,53138,85802,20474,0,-947,3457,0,0,,4404,2510
42,10/18/2018,34,8:15,8:30,,47.09,0,47.09,47.09,-1,-42393,51636,94029,9243,0,-1134,0,0,0,,1134,-1134
42,10/18/2018,35,8:30,8:45,,47.05,0,47.05,47.05,-1,-66081,28538,94619,-37543,0,-755,0,0,0,,755,-755
42,10/18/2018,36,8:45,9:00,,,0,49.63,49.63,0,-79699,26028,105727,-53671,0,0,0,0,0,,0,0
42,10/18/2018,37,9:00,9:15,47.85,,0,47.85,47.85,1,-85076,29390,114466,-55686,0,0,281,0,0,,281,281
42,10/18/2018,38,9:15,9:30,60.97,,0,60.97,60.97,1,-89473,33251,122724,-56222,0,0,10024,0,0,,10024,10024
42,10/18/2018,39,9:30,9:45,47.85,,0,47.85,47.85,1,-50150,41584,91734,-8566,0,0,2793,0,0,,2793,2793
42,10/18/2018,40,9:45,10:00,47.85,,0,47.85,47.85,1,-40779,46338,87117,5559,0,0,134,0,0,,134,134
42,10/18/2018,41,10:00,10:15,60.35,,0,60.35,60.35,1,-80353,33202,113555,-47151,0,0,20422,0,0,,20422,20422
42,10/18/2018,42,10:15,10:30,51.85,,0,51.85,51.85,1,-71067,43387,114454,-27680,0,0,17781,0,0,,17781,17781
42,10/18/2018,43,10:30,10:45,47.85,,0,47.85,47.85,1,-62773,61372,124145,-1401,0,0,3957,0,0,,3957,3957
42,10/18/2018,44,10:45,11:00,,43.85,0,43.85,43.85,-1,-43298,82097,125395,38799,0,-1335,0,0,0,,1335,-1335
42,10/18/2018,45,11:00,11:15,,39.85,0,39.85,39.85,-1,-56940,74895,131835,17955,0,-6067,0,0,0,,6067,-6067
42,10/18/2018,46,11:15,11:30,,46.79,0,46.79,46.79,-1,-57230,88758,145988,31528,0,-3425,0,0,0,,3425,-3425
42,10/18/2018,47,11:30,11:45,,21.74,0,21.74,21.74,-1,-52418,94393,146811,41975,0,-26446,0,0,0,,26446,-26446
42,10/18/2018,48,11:45,12:00,,42.59,0,42.59,42.59,-1,-58444,76341,134785,17897,0,-22557,0,0,0,,22557,-22557
42,10/18/2018,49,12:00,12:15,49.95,45.59,0,49.95,49.95,1,-105460,54179,159639,-51281,0,-9604,577,0,0,,10181,-9027
42,10/18/2018,50,12:15,12:30,,,0,49.21,49.21,0,-108181,47438,155619,-60743,0,-8,16,0,0,,24,8
42,10/18/2018,51,12:30,12:45,,,0,49.25,49.25,0,-92638,54948,147586,-37690,0,0,0,0,0,,0,0
42,10/18/2018,52,12:45,13:00,,,0,49.26,49.26,0,-94427,48640,143067,-45787,0,0,0,0,0,,0,0
42,10/18/2018,53,13:00,13:15,,,0,49.25,49.25,0,-99829,59001,158830,-40828,0,0,0,0,0,,0,0
42,10/18/2018,54,13:15,13:30,47.85,,0,47.85,47.85,1,-121436,33984,155420,-87452,0,0,190,0,0,,190,190
42,10/18/2018,55,13:30,13:45,55.85,,0,55.85,55.85,1,-122838,49623,172461,-73215,0,0,10620,0,0,,10620,10620
42,10/18/2018,56,13:45,14:00,,,0,49.24,49.24,0,-119214,43021,162235,-76193,0,0,262,0,0,,262,262
42,10/18/2018,57,14:00,14:15,51.85,,0,51.85,51.85,1,-120204,45893,166097,-74311,0,0,1152,0,0,,1152,1152
42,10/18/2018,58,14:15,14:30,47.85,,0,47.85,47.85,1,-117220,49235,166455,-67985,0,0,2406,0,0,,2406,2406
42,10/18/2018,59,14:30,14:45,50.7,,0,50.7,50.7,1,-119941,39387,159328,-80554,0,0,2119,0,0,,2119,2119
42,10/18/2018,60,14:45,15:00,50.73,,0,50.73,50.73,1,-115137,55206,170343,-59931,0,0,2645,0,0,,2645,2645
42,10/18/2018,61,15:00,15:15,50.08,,0,50.08,50.08,1,-68764,41522,110286,-27242,0,0,1804,0,0,,1804,1804
42,10/18/2018,62,15:15,15:30,50.07,,0,50.07,50.07,1,-68304,47231,115535,-21073,0,0,3120,0,0,,3120,3120
42,10/18/2018,63,15:30,15:45,51.85,,0,51.85,51.85,1,-80172,41608,121780,-38564,0,0,11203,0,0,,11203,11203
42,10/18/2018,64,15:45,16:00,51.65,,0,51.65,51.65,1,-89324,39833,129157,-49491,0,0,11098,0,0,,11098,11098
42,10/18/2018,65,16:00,16:15,51.65,48.76,0,48.76,48.76,-1,-49122,91332,140454,42210,0,-277,753,0,0,,1030,476
42,10/18/2018,66,16:15,16:30,,,0,49.59,49.59,0,-56592,74066,130658,17474,0,-3,0,0,0,,3,-3
42,10/18/2018,67,16:30,16:45,,,0,49.58,49.58,0,-65373,72184,137557,6811,0,0,0,0,0,,0,0
42,10/18/2018,68,16:45,17:00,51.85,,0,51.85,51.85,1,-73501,56681,130182,-16820,0,0,5403,0,0,,5403,5403
42,10/18/2018,69,17:00,17:15,47.85,,0,47.85,47.85,1,-53998,67443,121441,13445,0,0,1103,0,0,,1103,1103
42,10/18/2018,70,17:15,17:30,51.85,,0,51.85,51.85,1,-65308,45152,110460,-20156,0,0,3844,0,0,,3844,3844
42,10/18/2018,71,17:30,17:45,51.85,,0,51.85,51.85,1,-65300,34406,99706,-30894,0,0,16528,0,0,,16528,16528
42,10/18/2018,72,17:45,18:00,52.99,,0,52.99,52.99,1,-63798,38550,102348,-25248,0,0,23004,0,0,,23004,23004
42,10/18/2018,73,18:00,18:15,52.81,,0,52.81,52.81,1,-99671,30253,129924,-69418,0,0,8945,0,0,,8945,8945
42,10/18/2018,74,18:15,18:30,,,0,49.68,49.68,0,-64691,34397,99088,-30294,0,0,75,0,0,,75,75
42,10/18/2018,75,18:30,18:45,51.85,,0,51.85,51.85,1,-72845,51513,124358,-21332,0,0,730,0,0,,730,730
42,10/18/2018,76,18:45,19:00,57.82,,0,57.82,57.82,1,-106285,79202,185487,-27083,0,0,9635,0,0,,9635,9635
42,10/18/2018,77,19:00,19:15,59.66,,0,59.66,59.66,1,-104287,55447,159734,-48840,0,0,26957,0,0,,26957,26957
42,10/18/2018,78,19:15,19:30,63.49,,0,63.49,63.49,1,-96053,52319,148372,-43734,0,0,30528,0,0,,30528,30528
42,10/18/2018,79,19:30,19:45,47.85,,0,47.85,47.85,1,-81350,63898,145248,-17452,0,0,4257,0,0,,4257,4257
42,10/18/2018,80,19:45,20:00,,,0,48.75,48.75,0,-72905,61980,134885,-10925,0,0,2,0,0,,2,2
42,10/18/2018,81,20:00,20:15,51.85,,0,51.85,51.85,1,-78560,24440,103000,-54120,0,0,896,0,0,,896,896
42,10/18/2018,82,20:15,20:30,,,0,49.63,49.63,0,-69680,33883,103563,-35797,0,0,0,0,0,,0,0
42,10/18/2018,83,20:30,20:45,,39.85,0,39.85,39.85,-1,-49909,67015,116924,17106,0,-7811,0,0,0,,7811,-7811
42,10/18/2018,84,20:45,21:00,,40.24,0,40.24,40.24,-1,-60960,78675,139635,17715,0,-24031,0,0,0,,24031,-24031
42,10/18/2018,85,21:00,21:15,,33.99,0,33.99,33.99,-1,-57622,51775,109397,-5847,0,-11206,0,0,0,,11206,-11206
42,10/18/2018,86,21:15,21:30,,50.82,0,50.82,50.82,-1,-59422,44097,103519,-15325,0,-139,0,0,0,,139,-139
42,10/18/2018,87,21:30,21:45,,44.5,0,44.5,44.5,-1,-69052,72449,141501,3397,0,-1619,0,0,0,,1619,-1619
42,10/18/2018,88,21:45,22:00,,21.92,0,21.92,21.92,-1,-40539,100517,141056,59978,0,-21146,0,0,0,,21146,-21146
42,10/18/2018,89,22:00,22:15,49.95,-121.59,0,49.95,-121.59,2,-90771,69918,160689,-20853,0,-31276,429,0,0,,31705,-30847
42,10/18/2018,90,22:15,22:30,49.95,46.75,0,46.75,46.75,-1,-70329,34705,105034,-35624,0,-128,31,0,0,,159,-97
42,10/18/2018,91,22:30,22:45,,35.85,0,35.85,35.85,-1,-31424,76431,107855,45007,0,-19530,0,0,0,,19530,-19530
42,10/18/2018,92,22:45,23:00,,43.85,0,43.85,43.85,-1,-47975,68947,116922,20972,0,-5933,0,0,0,,5933,-5933
42,10/18/2018,93,23:00,23:15,,-122,0,-122,-122,-1,-72299,90161,162460,17862,0,-30483,0,0,0,,30483,-30483
42,10/18/2018,94,23:15,23:30,49.95,50.63,0,49.95,48.38,2,-99518,37090,136608,-62428,0,-155,219,0,0,,374,64
42,10/18/2018,95,23:30,23:45,,43.85,0,43.85,43.85,-1,-48161,52780,100941,4619,0,-2942,0,0,0,,2942,-2942
42,10/18/2018,96,23:45,0:00,,35.85,0,35.85,35.85,-1,-55063,94268,149331,39205,0,-24970,0,0,0,,24970,-24970
42,10/19/2018,1,0:00,0:15,,35.85,0,35.85,35.85,-1,-63082,107333,170415,44251,0,-16629,0,0,0,,16629,-16629
42,10/19/2018,2,0:15,0:30,,31.84,0,31.84,31.84,-1,-22119,76009,98128,53890,0,-22289,0,0,0,,22289,-22289
42,10/19/2018,3,0:30,0:45,,35.85,0,35.85,35.85,-1,-33726,73663,107389,39937,0,-39317,0,0,0,,39317,-39317
42,10/19/2018,4,0:45,1:00,,38.2,0,38.2,38.2,-1,-34827,97696,132523,62869,0,-25863,0,0,0,,25863,-25863
42,10/19/2018,5,1:00,1:15,47.85,45.54,0,49.19,45.54,2,-48961,45625,94586,-3336,0,-8323,132,0,0,,8455,-8191
42,10/19/2018,6,1:15,1:30,,39.81,0,39.81,39.81,-1,-37767,64265,102032,26498,0,-21104,0,0,0,,21104,-21104
42,10/19/2018,7,1:30,1:45,,41.1,0,41.1,41.1,-1,-37278,70681,107959,33403,0,-32197,0,0,0,,32197,-32197
42,10/19/2018,8,1:45,2:00,,39.81,0,39.81,39.81,-1,-34025,69486,103511,35461,0,-40287,0,0,0,,40287,-40287
42,10/19/2018,9,2:00,2:15,51.85,41.81,0,51.85,51.85,1,-44134,48508,92642,4374,0,-25090,41,0,0,,25131,-25049
42,10/19/2018,10,2:15,2:30,51.85,46.31,0,51.85,46.31,2,-32236,39763,71999,7527,0,-2889,448,0,0,,3337,-2441
42,10/19/2018,11,2:30,2:45,,44.06,0,44.06,44.06,-1,-37658,54732,92390,17074,0,-2672,0,0,0,,2672,-2672
42,10/19/2018,12,2:45,3:00,,46.31,0,46.31,46.31,-1,-43109,57576,100685,14467,0,-10728,0,0,0,,10728,-10728
42,10/19/2018,13,3:00,3:15,52.66,46.26,0,52.66,52.66,1,-62608,48736,111344,-13872,0,-6340,1916,0,0,,8256,-4424
42,10/19/2018,14,3:15,3:30,47.85,46.26,0,47.85,47.85,1,-57222,48599,105821,-8623,0,-15,1229,0,0,,1244,1214
42,10/19/2018,15,3:30,3:45,51.85,,0,51.85,51.85,1,-57168,38988,96156,-18180,0,0,4641,0,0,,4641,4641
42,10/19/2018,16,3:45,4:00,47.85,,0,47.85,47.85,1,-56825,45673,102498,-11152,0,0,2809,0,0,,2809,2809
42,10/19/2018,17,4:00,4:15,47.85,,0,47.85,47.85,1,-44644,52777,97421,8133,0,0,173,0,0,,173,173
42,10/19/2018,18,4:15,4:30,,,0,49.23,49.23,0,-49059,45690,94749,-3369,0,0,0,0,0,,0,0
42,10/19/2018,19,4:30,4:45,51.85,,0,51.85,51.85,1,-60646,46355,107001,-14291,0,0,866,0,0,,866,866
42,10/19/2018,20,4:45,5:00,52.09,,0,52.09,52.09,1,-54594,39992,94586,-14602,0,0,4408,0,0,,4408,4408
42,10/19/2018,21,5:00,5:15,51.85,39.85,0,51.85,39.85,2,-26205,50337,76542,24132,0,-11592,2135,0,0,,13727,-9457
42,10/19/2018,22,5:15,5:30,,44.29,0,44.29,44.29,-1,-31354,42418,73772,11064,0,-10984,0,0,0,,10984,-10984
42,10/19/2018,23,5:30,5:45,47.85,44.29,0,47.85,47.85,1,-28967,26180,55147,-2787,0,-19,275,0,0,,294,256
42,10/19/2018,24,5:45,6:00,47.85,50.38,0,49.23,49.23,2,-41372,48790,90162,7418,0,-3,463,0,0,,466,460
42,10/19/2018,25,6:00,6:15,,36.38,0,36.38,36.38,-1,-88869,122252,211121,33383,0,-17866,0,0,0,,17866,-17866
42,10/19/2018,26,6:15,6:30,,44.38,0,44.38,44.38,-1,-31672,72419,104091,40747,0,-10291,0,0,0,,10291,-10291
42,10/19/2018,27,6:30,6:45,56.38,44.38,0,56.38,56.38,1,-56521,42263,98784,-14258,0,-104,2109,0,0,,2213,2005
42,10/19/2018,28,6:45,7:00,72.01,,0,72.01,72.01,1,-108627,33656,142283,-74971,0,0,38945,0,0,,38945,38945
42,10/19/2018,29,7:00,7:15,60.96,22.29,0,60.96,22.29,2,-53493,111394,164887,57901,0,-12558,18828,0,0,,31386,6270
42,10/19/2018,30,7:15,7:30,,45.03,0,45.03,45.03,-1,-89896,102299,192195,12403,0,-11824,0,0,0,,11824,-11824
42,10/19/2018,31,7:30,7:45,52.38,,0,52.38,52.38,1,-124149,44396,168545,-79753,0,0,1430,0,0,,1430,1430
42,10/19/2018,32,7:45,8:00,186.7,,0,186.7,186.7,1,-176660,30854,207514,-145806,0,0,35862,0,0,,35862,35862
42,10/19/2018,33,8:00,8:15,193.49,,0,193.49,193.49,1,-114473,82201,196674,-32272,0,0,45217,0,0,,45217,45217
42,10/19/2018,34,8:15,8:30,51.37,,0,51.37,51.37,1,-105272,75301,180573,-29971,0,0,7414,0,0,,7414,7414
42,10/19/2018,35,8:30,8:45,51.34,,0,51.34,51.34,1,-116111,64919,181030,-51192,0,0,2862,0,0,,2862,2862
42,10/19/2018,36,8:45,9:00,,,0,49.28,49.28,0,-77178,40689,117867,-36489,0,0,45,0,0,,45,45
42,10/19/2018,37,9:00,9:15,,,0,49.28,49.28,0,-60740,75611,136351,14871,0,0,0,0,0,,0,0
42,10/19/2018,38,9:15,9:30,,,0,49.28,49.28,0,-49050,74684,123734,25634,0,0,0,0,0,,0,0
42,10/19/2018,39,9:30,9:45,,,0,49.28,49.28,0,-51953,80077,132030,28124,0,0,0,0,0,,0,0
42,10/19/2018,40,9:45,10:00,,,0,49.28,49.28,0,-41013,94932,135945,53919,0,0,0,0,0,,0,0
42,10/19/2018,41,10:00,10:15,,,0,49.93,49.93,0,-68122,59896,128018,-8226,0,0,0,0,0,,0,0
42,10/19/2018,42,10:15,10:30,,,0,49.26,49.26,0,-48387,73263,121650,24876,0,0,0,0,0,,0,0
42,10/19/2018,43,10:30,10:45,,45.4,0,45.4,45.4,-1,-30705,87223,117928,56518,0,-830,0,0,0,,830,-830
42,10/19/2018,44,10:45,11:00,,44.38,0,44.38,44.38,-1,-34347,110937,145284,76590,0,-7581,0,0,0,,7581,-7581
42,10/19/2018,45,11:00,11:15,,42.04,0,42.04,42.04,-1,-111419,83341,194760,-28078,0,-6965,0,0,0,,6965,-6965
42,10/19/2018,46,11:15,11:30,,47.04,0,47.04,47.04,-1,-79469,92703,172172,13234,0,-777,0,0,0,,777,-777
42,10/19/2018,47,11:30,11:45,,42.6,0,42.6,42.6,-1,-60330,95283,155613,34953,0,-3766,0,0,0,,3766,-3766
42,10/19/2018,48,11:45,12:00,,40.38,0,40.38,40.38,-1,-68403,110002,178405,41599,0,-15271,0,0,0,,15271,-15271
42,10/19/2018,49,12:00,12:15,50.83,45.03,0,50.83,45.03,2,-124561,76336,200897,-48225,0,-9144,2025,0,0,,11169,-7119
42,10/19/2018,50,12:15,12:30,,,0,48.96,48.96,0,-94473,70278,164751,-24195,0,-18,0,0,0,,18,-18
42,10/19/2018,51,12:30,12:45,,40.38,0,40.38,40.38,-1,-75961,84473,160434,8512,0,-4512,0,0,0,,4512,-4512
42,10/19/2018,52,12:45,13:00,,40.38,0,40.38,40.38,-1,-72838,85638,158476,12800,0,-14434,0,0,0,,14434,-14434
42,10/19/2018,53,13:00,13:15,49.94,40.38,0,49.94,40.38,2,-100328,56457,156785,-43871,0,-9814,918,0,0,,10732,-8896
42,10/19/2018,54,13:15,13:30,,,0,48.84,48.84,0,-93638,52544,146182,-41094,0,-56,6,0,0,,62,-50
42,10/19/2018,55,13:30,13:45,,,0,48.84,48.84,0,-84422,59060,143482,-25362,0,0,0,0,0,,0,0
42,10/19/2018,56,13:45,14:00,,44.38,0,44.38,44.38,-1,-81972,67837,149809,-14135,0,-915,0,0,0,,915,-915
42,10/19/2018,57,14:00,14:15,,44.03,0,44.03,44.03,-1,-70231,56883,127114,-13348,0,-1523,0,0,0,,1523,-1523
42,10/19/2018,58,14:15,14:30,,,0,49.64,49.64,0,-77551,45864,123415,-31687,0,0,0,0,0,,0,0
42,10/19/2018,59,14:30,14:45,,,0,49.64,49.64,0,-89655,53248,142903,-36407,0,0,0,0,0,,0,0
42,10/19/2018,60,14:45,15:00,48.38,,0,48.38,48.38,1,-104096,48234,152330,-55862,0,0,29,0,0,,29,29
42,10/19/2018,61,15:00,15:15,48.38,,0,48.38,48.38,1,-78265,60145,138410,-18120,0,0,16,0,0,,16,16
42,10/19/2018,62,15:15,15:30,,,0,49.65,49.65,0,-78459,54386,132845,-24073,0,0,0,0,0,,0,0
42,10/19/2018,63,15:30,15:45,56.38,,0,56.38,56.38,1,-99359,50896,150255,-48463,0,0,7318,0,0,,7318,7318
42,10/19/2018,64,15:45,16:00,56.38,36.38,0,56.38,36.38,2,-96757,39772,136529,-56985,0,-459,20968,0,0,,21427,20509
42,10/19/2018,65,16:00,16:15,50,-46.27,0,50,-46.27,2,-65606,71118,136724,5512,0,-25821,1326,0,0,,27147,-24495
42,10/19/2018,66,16:15,16:30,54.25,-46.27,0,54.25,54.25,1,-73514,45558,119072,-27956,0,-804,1845,0,0,,2649,1041
42,10/19/2018,67,16:30,16:45,56.38,,0,56.38,56.38,1,-70981,28609,99590,-42372,0,0,6299,0,0,,6299,6299
42,10/19/2018,68,16:45,17:00,59.29,,0,59.29,59.29,1,-92907,17807,110714,-75100,0,0,35168,0,0,,35168,35168
42,10/19/2018,69,17:00,17:15,63.13,48.13,0,48.13,48.13,-1,-60507,62225,122732,1718,0,-443,22613,0,0,,23056,22170
42,10/19/2018,70,17:15,17:30,57.1,48.13,0,57.1,57.1,1,-65468,40678,106146,-24790,0,-84,5069,0,0,,5153,4985
42,10/19/2018,71,17:30,17:45,56.59,,0,56.59,56.59,1,-64121,29967,94088,-34154,0,0,17624,0,0,,17624,17624
42,10/19/2018,72,17:45,18:00,54.96,,0,54.96,54.96,1,-62156,24872,87028,-37284,0,0,22400,0,0,,22400,22400
42,10/19/2018,73,18:00,18:15,53.33,48.52,0,48.52,48.52,-1,-64900,24254,89154,-40646,0,-261,10057,0,0,,10318,9796
42,10/19/2018,74,18:15,18:30,53.33,47.74,0,47.74,47.74,-1,-41208,39717,80925,-1491,0,-967,151,0,0,,1118,-816
42,10/19/2018,75,18:30,18:45,,,0,49.91,49.91,0,-30600,49548,80148,18948,0,0,0,0,0,,0,0
42,10/19/2018,76,18:45,19:00,51.84,,0,51.84,51.84,1,-66650,63742,130392,-2908,0,0,184,0,0,,184,184
42,10/19/2018,77,19:00,19:15,63.95,,0,63.95,63.95,1,-78607,28829,107436,-49778,0,0,20715,0,0,,20715,20715
42,10/19/2018,78,19:15,19:30,51.99,,0,51.99,51.99,1,-57376,34454,91830,-22922,0,0,4600,0,0,,4600,4600
42,10/19/2018,79,19:30,19:45,48.38,51.42,0,51.42,51.42,-1,-34216,43124,77340,8908,0,-42,552,0,0,,594,510
42,10/19/2018,80,19:45,20:00,,47.51,0,47.51,47.51,-1,-33535,29970,63505,-3565,0,-2002,0,0,0,,2002,-2002
42,10/19/2018,81,20:00,20:15,50.91,51.95,0,50.91,50.17,2,-63214,32987,96201,-30227,0,-356,435,0,0,,791,79
42,10/19/2018,82,20:15,20:30,,,0,50.17,50.17,0,-61868,8295,70163,-53573,0,0,0,0,0,,0,0
42,10/19/2018,83,20:30,20:45,,,0,50.17,50.17,0,-44331,22905,67236,-21426,0,0,0,0,0,,0,0
42,10/19/2018,84,20:45,21:00,,46.19,0,46.19,46.19,-1,-43416,52992,96408,9576,0,-4315,0,0,0,,4315,-4315
42,10/19/2018,85,21:00,21:15,,51.39,0,51.39,51.39,-1,-84914,20915,105829,-63999,0,-818,0,0,0,,818,-818
42,10/19/2018,86,21:15,21:30,,,0,31.01,31.01,0,-51219,21531,72750,-29688,0,0,0,0,0,,0,0
42,10/19/2018,87,21:30,21:45,,48.02,0,48.02,48.02,-1,-44985,34817,79802,-10168,0,-1090,0,0,0,,1090,-1090
42,10/19/2018,88,21:45,22:00,,40.38,0,40.38,40.38,-1,-51246,60047,111293,8801,0,-21151,0,0,0,,21151,-21151
42,10/19/2018,89,22:00,22:15,,33.99,0,33.99,33.99,-1,-84657,117267,201924,32610,0,-25987,0,0,0,,25987,-25987
42,10/19/2018,90,22:15,22:30,49.94,33.99,0,49.94,49.94,1,-52457,28410,80867,-24047,0,-2587,968,0,0,,3555,-1619
42,10/19/2018,91,22:30,22:45,,44.38,0,44.38,44.38,-1,-53796,54001,107797,205,0,-1643,0,0,0,,1643,-1643
42,10/19/2018,92,22:45,23:00,,39.48,0,39.48,39.48,-1,-49208,67546,116754,18338,0,-19426,0,0,0,,19426,-19426
42,10/19/2018,93,23:00,23:15,52.38,22.29,0,52.38,22.29,2,-42022,63598,105620,21576,0,-35170,391,0,0,,35561,-34779
42,10/19/2018,94,23:15,23:30,56.38,36.38,0,56.38,36.38,2,-49674,65647,115321,15973,0,-10528,2448,0,0,,12976,-8080
42,10/19/2018,95,23:30,23:45,,22.29,0,22.29,22.29,-1,-45833,78725,124558,32892,0,-47032,0,0,0,,47032,-47032
42,10/19/2018,96,23:45,0:00,,30.29,0,30.29,30.29,-1,-44261,79871,124132,35610,0,-18812,0,0,0,,18812,-18812
43,10/20/2018,1,0:00,0:15,,40.06,0,40.06,40.06,-1,-93680,82834,176514,-10846,0,-15543,0,0,0,,15543,-15543
43,10/20/2018,2,0:15,0:30,,,0,51.3,51.3,0,-71017,47258,118275,-23759,0,-129,0,0,0,,129,-129
43,10/20/2018,3,0:30,0:45,,49.15,0,49.15,49.15,-1,-52699,44955,97654,-7744,0,-390,0,0,0,,390,-390
43,10/20/2018,4,0:45,1:00,,41.93,0,41.93,41.93,-1,-50314,58254,108568,7940,0,-9272,0,0,0,,9272,-9272
43,10/20/2018,5,1:00,1:15,49.47,46.93,0,49.47,49.47,1,-80565,75076,155641,-5489,0,-6150,209,0,0,,6359,-5941
43,10/20/2018,6,1:15,1:30,49.47,43.89,0,51.3,43.89,2,-64882,85334,150216,20452,0,-1029,126,0,0,,1155,-903
43,10/20/2018,7,1:30,1:45,,44.84,0,44.84,44.84,-1,-59582,78892,138474,19310,0,-4709,0,0,0,,4709,-4709
43,10/20/2018,8,1:45,2:00,,39.87,0,39.87,39.87,-1,-55079,90880,145959,35801,0,-27666,0,0,0,,27666,-27666
43,10/20/2018,9,2:00,2:15,53.47,39.02,0,53.47,53.47,1,-76407,69367,145774,-7040,0,-17187,4034,0,0,,21221,-13153
43,10/20/2018,10,2:15,2:30,51.73,39.02,0,51.73,51.73,1,-78875,74065,152940,-4810,0,-32,3425,0,0,,3457,3393
43,10/20/2018,11,2:30,2:45,,45.47,0,45.47,45.47,-1,-69249,80496,149745,11247,0,-2344,0,0,0,,2344,-2344
43,10/20/2018,12,2:45,3:00,,39.63,0,39.63,39.63,-1,-59250,81903,141153,22653,0,-14074,0,0,0,,14074,-14074
43,10/20/2018,13,3:00,3:15,53.47,45.47,0,53.47,45.47,2,-63199,54387,117586,-8812,0,-6073,2315,0,0,,8388,-3758
43,10/20/2018,14,3:15,3:30,49.47,,0,49.47,49.47,1,-62830,66448,129278,3618,0,0,495,0,0,,495,495
43,10/20/2018,15,3:30,3:45,,,0,50.82,50.82,0,-57886,64785,122671,6899,0,0,0,0,0,,0,0
43,10/20/2018,16,3:45,4:00,,41.47,0,41.47,41.47,-1,-52565,64933,117498,12368,0,-9299,0,0,0,,9299,-9299
43,10/20/2018,17,4:00,4:15,51.81,39.26,0,51.81,39.26,2,-50169,48769,98938,-1400,0,-11752,1097,0,0,,12849,-10655
43,10/20/2018,18,4:15,4:30,49.47,50.9,0,50.9,50.9,-1,-64499,58151,122650,-6348,0,-333,268,0,0,,601,-65
43,10/20/2018,19,4:30,4:45,,50.9,0,50.9,50.9,-1,-65545,54075,119620,-11470,0,-2404,0,0,0,,2404,-2404
43,10/20/2018,20,4:45,5:00,,50.9,0,50.9,50.9,-1,-60358,55824,116182,-4534,0,-562,0,0,0,,562,-562
43,10/20/2018,21,5:00,5:15,,44.55,0,44.55,44.55,-1,-42485,46885,89370,4400,0,-7416,0,0,0,,7416,-7416
43,10/20/2018,22,5:15,5:30,,,0,50.15,50.15,0,-59473,42771,102244,-16702,0,-165,0,0,0,,165,-165
43,10/20/2018,23,5:30,5:45,,,0,50.15,50.15,0,-64631,62109,126740,-2522,0,0,0,0,0,,0,0
43,10/20/2018,24,5:45,6:00,,,0,50.14,50.14,0,-58132,57899,116031,-233,0,0,0,0,0,,0,0
43,10/20/2018,25,6:00,6:15,,35.89,0,35.89,35.89,-1,-31134,96004,127138,64870,0,-23524,0,0,0,,23524,-23524
43,10/20/2018,26,6:15,6:30,,41.8,0,41.8,41.8,-1,-35536,74501,110037,38965,0,-33762,0,0,0,,33762,-33762
43,10/20/2018,27,6:30,6:45,50.21,47.71,0,50.63,47.71,2,-50530,47979,98509,-2551,0,-6886,463,0,0,,7349,-6423
43,10/20/2018,28,6:45,7:00,50.09,50.93,0,50.51,50.51,2,-34486,40813,75299,6327,0,-55,47,0,0,,102,-8
43,10/20/2018,29,7:00,7:15,,38.5,0,38.5,38.5,-1,-37853,70177,108030,32324,0,-10501,0,0,0,,10501,-10501
43,10/20/2018,30,7:15,7:30,,46.39,0,46.39,46.39,-1,-33317,56354,89671,23037,0,-15118,0,0,0,,15118,-15118
43,10/20/2018,31,7:30,7:45,51.97,46.39,0,51.97,51.97,1,-36623,27360,63983,-9263,0,-1894,2536,0,0,,4430,642
43,10/20/2018,32,7:45,8:00,55.9,,0,55.9,55.9,1,-53996,21089,75085,-32907,0,0,17490,0,0,,17490,17490
43,10/20/2018,33,8:00,8:15,50.39,49.9,0,49.9,49.9,-1,-60110,78119,138229,18009,0,-414,5175,0,0,,5589,4761
43,10/20/2018,34,8:15,8:30,,49.83,0,49.83,49.83,-1,-63214,62701,125915,-513,0,-421,0,0,0,,421,-421
43,10/20/2018,35,8:30,8:45,58.48,,0,58.48,58.48,1,-78097,48301,126398,-29796,0,0,4181,0,0,,4181,4181
43,10/20/2018,36,8:45,9:00,56.67,,0,56.67,56.67,1,-94681,41980,136661,-52701,0,0,24034,0,0,,24034,24034
43,10/20/2018,37,9:00,9:15,58.48,,0,58.48,58.48,1,-86209,39326,125535,-46883,0,0,12075,0,0,,12075,12075
43,10/20/2018,38,9:15,9:30,56.19,,0,56.19,56.19,1,-92284,30113,122397,-62171,0,0,10867,0,0,,10867,10867
43,10/20/2018,39,9:30,9:45,52.89,,0,52.89,52.89,1,-96307,33225,129532,-63082,0,0,3775,0,0,,3775,3775
43,10/20/2018,40,9:45,10:00,53.39,,0,53.39,53.39,1,-89560,42800,132360,-46760,0,0,772,0,0,,772,772
43,10/20/2018,41,10:00,10:15,100.19,,0,100.19,100.19,1,-125082,43895,168977,-81187,0,0,14071,0,0,,14071,14071
43,10/20/2018,42,10:15,10:30,50.78,,0,50.78,50.78,1,-92719,67845,160564,-24874,0,0,385,0,0,,385,385
43,10/20/2018,43,10:30,10:45,,,0,51.96,51.96,0,-76604,59695,136299,-16909,0,0,0,0,0,,0,0
43,10/20/2018,44,10:45,11:00,,46.39,0,46.39,46.39,-1,-63025,62584,125609,-441,0,-2658,0,0,0,,2658,-2658
43,10/20/2018,45,11:00,11:15,,49.73,0,49.73,49.73,-1,-108170,76541,184711,-31629,0,-1993,0,0,0,,1993,-1993
43,10/20/2018,46,11:15,11:30,,49.75,0,49.75,49.75,-1,-111214,89690,200904,-21524,0,-115,0,0,0,,115,-115
43,10/20/2018,47,11:30,11:45,,44.78,0,44.78,44.78,-1,-96656,105578,202234,8922,0,-9867,0,0,0,,9867,-9867
43,10/20/2018,48,11:45,12:00,,44.97,0,44.97,44.97,-1,-96038,105093,201131,9055,0,-15851,0,0,0,,15851,-15851
43,10/20/2018,49,12:00,12:15,54.83,47.8,0,54.83,47.8,2,-113418,75161,188579,-38257,0,-7238,3210,0,0,,10448,-4028
43,10/20/2018,50,12:15,12:30,50.19,47.8,0,50.19,50.19,1,-107090,67458,174548,-39632,0,-25,698,0,0,,723,673
43,10/20/2018,51,12:30,12:45,,,0,51.66,51.66,0,-97399,66098,163497,-31301,0,0,0,0,0,,0,0
43,10/20/2018,52,12:45,13:00,,,0,51.66,51.66,0,-93414,75221,168635,-18193,0,0,0,0,0,,0,0
43,10/20/2018,53,13:00,13:15,50.12,46.84,0,51.07,46.84,2,-99431,59994,159425,-39437,0,-439,180,0,0,,619,-259
43,10/20/2018,54,13:15,13:30,,,0,51.07,51.07,0,-105582,51529,157111,-54053,0,0,0,0,0,,0,0
43,10/20/2018,55,13:30,13:45,50.39,,0,50.39,50.39,1,-98670,45234,143904,-53436,0,0,2549,0,0,,2549,2549
43,10/20/2018,56,13:45,14:00,50.15,,0,50.15,50.15,1,-88881,51320,140201,-37561,0,0,427,0,0,,427,427
43,10/20/2018,57,14:00,14:15,50.08,,0,50.08,50.08,1,-63215,52147,115362,-11068,0,0,362,0,0,,362,362
43,10/20/2018,58,14:15,14:30,,,0,50.99,50.99,0,-68687,50037,118724,-18650,0,0,0,0,0,,0,0
43,10/20/2018,59,14:30,14:45,,49.1,0,49.1,49.1,-1,-71234,53401,124635,-17833,0,-130,0,0,0,,130,-130
43,10/20/2018,60,14:45,15:00,,49.1,0,49.1,49.1,-1,-75799,39155,114954,-36644,0,-16,0,0,0,,16,-16
43,10/20/2018,61,15:00,15:15,,46.39,0,46.39,46.39,-1,-55543,51169,106712,-4374,0,-2096,0,0,0,,2096,-2096
43,10/20/2018,62,15:15,15:30,50.83,46.39,0,50.83,50.83,1,-67524,36681,104205,-30843,0,-176,241,0,0,,417,65
43,10/20/2018,63,15:30,15:45,54.39,,0,54.39,54.39,1,-76705,45491,122196,-31214,0,0,13624,0,0,,13624,13624
43,10/20/2018,64,15:45,16:00,52.33,,0,52.33,52.33,1,-70188,28286,98474,-41902,0,0,18610,0,0,,18610,18610
43,10/20/2018,65,16:00,16:15,52.33,47.79,0,47.79,47.79,-1,-55703,70429,126132,14726,0,-629,1980,0,0,,2609,1351
43,10/20/2018,66,16:15,16:30,,46.39,0,46.39,46.39,-1,-66844,80067,146911,13223,0,-640,0,0,0,,640,-640
43,10/20/2018,67,16:30,16:45,54.39,,0,54.39,54.39,1,-86021,58642,144663,-27379,0,0,5218,0,0,,5218,5218
43,10/20/2018,68,16:45,17:00,50.83,,0,50.83,50.83,1,-105340,56841,162181,-48499,0,0,3600,0,0,,3600,3600
43,10/20/2018,69,17:00,17:15,,42.4,0,42.4,42.4,-1,-55880,77647,133527,21767,0,-11273,0,0,0,,11273,-11273
43,10/20/2018,70,17:15,17:30,,47.65,0,47.65,47.65,-1,-77892,73256,151148,-4636,0,-6424,0,0,0,,6424,-6424
43,10/20/2018,71,17:30,17:45,58.06,47.65,0,58.06,58.06,1,-89253,33964,123217,-55289,0,-611,5239,0,0,,5850,4628
43,10/20/2018,72,17:45,18:00,63.27,,0,63.27,63.27,1,-86493,26901,113394,-59592,0,0,38018,0,0,,38018,38018
43,10/20/2018,73,18:00,18:15,50.06,45.4,0,51.6,45.4,2,-66394,67340,133734,946,0,-5870,6578,0,0,,12448,708
43,10/20/2018,74,18:15,18:30,50.06,45.4,0,50.06,50.06,1,-71112,59688,130800,-11424,0,-92,784,0,0,,876,692
43,10/20/2018,75,18:30,18:45,50.06,,0,50.06,50.06,1,-46250,55825,102075,9575,0,0,811,0,0,,811,811
43,10/20/2018,76,18:45,19:00,70.04,,0,70.04,70.04,1,-67188,36912,104100,-30276,0,0,11680,0,0,,11680,11680
43,10/20/2018,77,19:00,19:15,79.95,,0,79.95,79.95,1,-74698,14300,88998,-60398,0,0,26692,0,0,,26692,26692
43,10/20/2018,78,19:15,19:30,,,0,63.63,63.63,0,-65660,21992,87652,-43668,0,0,419,0,0,,419,419
43,10/20/2018,79,19:30,19:45,,,0,63.65,63.65,0,-60535,30294,90829,-30241,0,0,0,0,0,,0,0
43,10/20/2018,80,19:45,20:00,,46.27,0,46.27,46.27,-1,-53282,51770,105052,-1512,0,-3984,0,0,0,,3984,-3984
43,10/20/2018,81,20:00,20:15,,53.13,0,53.13,53.13,-1,-64513,24854,89367,-39659,0,-588,0,0,0,,588,-588
43,10/20/2018,82,20:15,20:30,,,0,51.6,51.6,0,-42390,25808,68198,-16582,0,0,0,0,0,,0,0
43,10/20/2018,83,20:30,20:45,,38.23,0,38.23,38.23,-1,-33659,60963,94622,27304,0,-12979,0,0,0,,12979,-12979
43,10/20/2018,84,20:45,21:00,,27.76,0,27.76,27.76,-1,-36037,71852,107889,35815,0,-43529,0,0,0,,43529,-43529
43,10/20/2018,85,21:00,21:15,51.27,42.75,0,51.6,42.75,2,-42762,23731,66493,-19031,0,-18726,1038,0,0,,19764,-17688
43,10/20/2018,86,21:15,21:30,51.27,48.16,0,48.16,48.16,-1,-37315,32225,69540,-5090,0,-549,4,0,0,,553,-545
43,10/20/2018,87,21:30,21:45,,41.74,0,41.74,41.74,-1,-35208,64678,99886,29470,0,-20038,0,0,0,,20038,-20038
43,10/20/2018,88,21:45,22:00,50.54,45.4,0,51.6,45.4,2,-78368,68428,146796,-9940,0,-15095,455,0,0,,15550,-14640
43,10/20/2018,89,22:00,22:15,50.06,47.18,0,51.6,47.18,2,-43786,24080,67866,-19706,0,-921,141,0,0,,1062,-780
43,10/20/2018,90,22:15,22:30,50.18,,0,50.18,50.18,1,-73875,25610,99485,-48265,0,0,2311,0,0,,2311,2311
43,10/20/2018,91,22:30,22:45,50.06,46.39,0,46.39,46.39,-1,-31838,35588,67426,3750,0,-440,722,0,0,,1162,282
43,10/20/2018,92,22:45,23:00,,47.65,0,47.65,47.65,-1,-39915,40308,80223,393,0,-3644,0,0,0,,3644,-3644
43,10/20/2018,93,23:00,23:15,50.06,46.39,0,50.55,46.39,2,-63917,45631,109548,-18286,0,-1113,66,0,0,,1179,-1047
43,10/20/2018,94,23:15,23:30,50.06,,0,50.06,50.06,1,-64372,24432,88804,-39940,0,0,1327,0,0,,1327,1327
43,10/20/2018,95,23:30,23:45,50.06,47.09,0,50.57,47.09,2,-41804,31281,73085,-10523,0,-117,916,0,0,,1033,799
43,10/20/2018,96,23:45,0:00,,38.5,0,38.5,38.5,-1,-47818,55440,103258,7622,0,-5751,0,0,0,,5751,-5751
43,10/21/2018,1,0:00,0:15,,10.5,0,10.5,10.5,-1,-46369,88737,135106,42368,0,-32701,0,0,0,,32701,-32701
43,10/21/2018,2,0:15,0:30,51.95,10.5,0,51.95,51.95,1,-44349,12800,57149,-31549,0,-1842,1536,0,0,,3378,-306
43,10/21/2018,3,0:30,0:45,50.3,,0,50.3,50.3,1,-78811,26095,104906,-52716,0,0,188,0,0,,188,188
43,10/21/2018,4,0:45,1:00,51.5,,0,51.5,51.5,1,-89694,21510,111204,-68184,0,0,582,0,0,,582,582
43,10/21/2018,5,1:00,1:15,80.02,,0,80.02,80.02,1,-82126,21607,103733,-60519,0,0,35445,0,0,,35445,35445
43,10/21/2018,6,1:15,1:30,58.46,,0,58.46,58.46,1,-60628,21713,82341,-38915,0,0,20357,0,0,,20357,20357
43,10/21/2018,7,1:30,1:45,,,0,47.86,47.86,0,-54028,30745,84773,-23283,0,0,419,0,0,,419,419
43,10/21/2018,8,1:45,2:00,,,0,48.4,48.4,0,-53731,30411,84142,-23320,0,0,0,0,0,,0,0
43,10/21/2018,9,2:00,2:15,56.7,51.59,0,56.7,56.7,1,-61116,30890,92006,-30226,0,-18,6265,0,0,,6283,6247
43,10/21/2018,10,2:15,2:30,58.46,,0,58.46,58.46,1,-75712,16675,92387,-59037,0,0,22383,0,0,,22383,22383
43,10/21/2018,11,2:30,2:45,,,0,47.82,47.82,0,-55514,30512,86026,-25002,0,0,1676,0,0,,1676,1676
43,10/21/2018,12,2:45,3:00,,51.63,0,51.63,51.63,-1,-52062,29264,81326,-22798,0,-1,0,0,0,,1,-1
43,10/21/2018,13,3:00,3:15,,50.98,0,50.98,50.98,-1,-47203,47454,94657,251,0,-46,0,0,0,,46,-46
43,10/21/2018,14,3:15,3:30,,,0,47.5,47.5,0,-43207,45750,88957,2543,0,0,0,0,0,,0,0
43,10/21/2018,15,3:30,3:45,,47.53,0,47.53,47.53,-1,-42486,55927,98413,13441,0,-431,0,0,0,,431,-431
43,10/21/2018,16,3:45,4:00,,39.83,0,39.83,39.83,-1,-48329,53061,101390,4732,0,-4401,0,0,0,,4401,-4401
43,10/21/2018,17,4:00,4:15,,46.39,0,46.39,46.39,-1,-35708,74783,110491,39075,0,-4765,0,0,0,,4765,-4765
43,10/21/2018,18,4:15,4:30,,,0,47.5,47.5,0,-35455,65213,100668,29758,0,0,0,0,0,,0,0
43,10/21/2018,19,4:30,4:45,,,0,47.5,47.5,0,-36649,64446,101095,27797,0,0,0,0,0,,0,0
43,10/21/2018,20,4:45,5:00,,,0,47.51,47.51,0,-38307,69084,107391,30777,0,0,0,0,0,,0,0
43,10/21/2018,21,5:00,5:15,,,0,47.52,47.52,0,-45850,64022,109872,18172,0,0,0,0,0,,0,0
43,10/21/2018,22,5:15,5:30,,45.62,0,45.62,45.62,-1,-32685,63816,96501,31131,0,-3494,0,0,0,,3494,-3494
43,10/21/2018,23,5:30,5:45,,46.39,0,46.39,46.39,-1,-39687,43296,82983,3609,0,-5224,0,0,0,,5224,-5224
43,10/21/2018,24,5:45,6:00,,38.51,0,38.51,38.51,-1,-28821,73014,101835,44193,0,-14157,0,0,0,,14157,-14157
43,10/21/2018,25,6:00,6:15,,44.88,0,44.88,44.88,-1,-30476,27306,57782,-3170,0,-15810,0,0,0,,15810,-15810
43,10/21/2018,26,6:15,6:30,,44.88,0,44.88,44.88,-1,-20134,38151,58285,18017,0,-18729,0,0,0,,18729,-18729
43,10/21/2018,27,6:30,6:45,,46.39,0,46.39,46.39,-1,-24362,28948,53310,4586,0,-6418,0,0,0,,6418,-6418
43,10/21/2018,28,6:45,7:00,,47.65,0,47.65,47.65,-1,-17316,39201,56517,21885,0,-2027,0,0,0,,2027,-2027
43,10/21/2018,29,7:00,7:15,,38.51,0,38.51,38.51,-1,-19724,81703,101427,61979,0,-10068,0,0,0,,10068,-10068
43,10/21/2018,30,7:15,7:30,,51.59,0,51.59,51.59,-1,-13788,53210,66998,39422,0,-1170,0,0,0,,1170,-1170
43,10/21/2018,31,7:30,7:45,,46.39,0,46.39,46.39,-1,-26583,53396,79979,26813,0,-3369,0,0,0,,3369,-3369
43,10/21/2018,32,7:45,8:00,,51.47,0,51.47,51.47,-1,-42183,60844,103027,18661,0,-957,0,0,0,,957,-957
43,10/21/2018,33,8:00,8:15,,46.39,0,46.39,46.39,-1,-50762,64651,115413,13889,0,-8540,0,0,0,,8540,-8540
43,10/21/2018,34,8:15,8:30,,46.39,0,46.39,46.39,-1,-52552,58543,111095,5991,0,-5360,0,0,0,,5360,-5360
43,10/21/2018,35,8:30,8:45,50.39,46.39,0,50.39,50.39,1,-68678,41422,110100,-27256,0,-1197,686,0,0,,1883,-511
43,10/21/2018,36,8:45,9:00,54.39,,0,54.39,54.39,1,-62128,40294,102422,-21834,0,0,9058,0,0,,9058,9058
43,10/21/2018,37,9:00,9:15,63.51,,0,63.51,63.51,1,-85645,44702,130347,-40943,0,0,14277,0,0,,14277,14277
43,10/21/2018,38,9:15,9:30,54.39,,0,54.39,54.39,1,-80729,40905,121634,-39824,0,0,23568,0,0,,23568,23568
43,10/21/2018,39,9:30,9:45,53.96,,0,53.96,53.96,1,-93947,29679,123626,-64268,0,0,15104,0,0,,15104,15104
43,10/21/2018,40,9:45,10:00,50.39,,0,50.39,50.39,1,-115931,34742,150673,-81189,0,0,2322,0,0,,2322,2322
43,10/21/2018,41,10:00,10:15,144.02,,0,144.02,144.02,1,-154999,40690,195689,-114309,0,0,49723,0,0,,49723,49723
43,10/21/2018,42,10:15,10:30,73.62,,0,73.62,73.62,1,-132766,60977,193743,-71789,0,0,43413,0,0,,43413,43413
43,10/21/2018,43,10:30,10:45,57.57,,0,57.57,57.57,1,-133760,58658,192418,-75102,0,0,16493,0,0,,16493,16493
43,10/21/2018,44,10:45,11:00,,,0,46.91,46.91,0,-140084,50052,190136,-90032,0,0,1434,0,0,,1434,1434
43,10/21/2018,45,11:00,11:15,80.39,,0,80.39,80.39,1,-193336,49118,242454,-144218,0,0,15679,0,0,,15679,15679
43,10/21/2018,46,11:15,11:30,55.3,,0,55.3,55.3,1,-180286,51285,231571,-129001,0,0,13115,0,0,,13115,13115
43,10/21/2018,47,11:30,11:45,55.3,,0,55.3,55.3,1,-180949,56416,237365,-124533,0,0,8321,0,0,,8321,8321
43,10/21/2018,48,11:45,12:00,50.43,,0,50.43,50.43,1,-182908,65535,248443,-117373,0,0,394,0,0,,394,394
43,10/21/2018,49,12:00,12:15,163.11,,0,163.11,163.11,1,-186418,82963,269381,-103455,0,0,51452,0,0,,51452,51452
43,10/21/2018,50,12:15,12:30,88.55,,0,88.55,88.55,1,-141696,88370,230066,-53326,0,0,51941,0,0,,51941,51941
43,10/21/2018,51,12:30,12:45,80.39,,0,80.39,80.39,1,-123717,86572,210289,-37145,0,0,17835,0,0,,17835,17835
43,10/21/2018,52,12:45,13:00,78.25,,0,78.25,78.25,1,-117213,86003,203216,-31210,0,0,26581,0,0,,26581,26581
43,10/21/2018,53,13:00,13:15,54.84,,0,54.84,54.84,1,-93604,76916,170520,-16688,0,0,10305,0,0,,10305,10305
43,10/21/2018,54,13:15,13:30,54.84,,0,54.84,54.84,1,-89640,74796,164436,-14844,0,0,4196,0,0,,4196,4196
43,10/21/2018,55,13:30,13:45,50.46,,0,50.46,50.46,1,-91015,82742,173757,-8273,0,0,2231,0,0,,2231,2231
43,10/21/2018,56,13:45,14:00,54.77,46.39,0,54.77,46.39,2,-100568,84700,185268,-15868,0,-873,1736,0,0,,2609,863
43,10/21/2018,57,14:00,14:15,,41.92,0,41.92,41.92,-1,-64523,81873,146396,17350,0,-11638,0,0,0,,11638,-11638
43,10/21/2018,58,14:15,14:30,,46.39,0,46.39,46.39,-1,-74267,80806,155073,6539,0,-11988,0,0,0,,11988,-11988
43,10/21/2018,59,14:30,14:45,,46.39,0,46.39,46.39,-1,-78869,76993,155862,-1876,0,-8171,0,0,0,,8171,-8171
43,10/21/2018,60,14:45,15:00,,44.2,0,44.2,44.2,-1,-87762,71625,159387,-16137,0,-3901,0,0,0,,3901,-3901
43,10/21/2018,61,15:00,15:15,,38.51,0,38.51,38.51,-1,-47494,86775,134269,39281,0,-3769,0,0,0,,3769,-3769
43,10/21/2018,62,15:15,15:30,,,0,47.26,47.26,0,-49471,58621,108092,9150,0,0,0,0,0,,0,0
43,10/21/2018,63,15:30,15:45,,,0,47.26,47.26,0,-66701,60628,127329,-6073,0,0,0,0,0,,0,0
43,10/21/2018,64,15:45,16:00,50.18,,0,50.18,50.18,1,-77519,56709,134228,-20810,0,0,113,0,0,,113,113
43,10/21/2018,65,16:00,16:15,47.02,,0,47.02,47.02,1,-62747,39396,102143,-23351,0,0,295,0,0,,295,295
43,10/21/2018,66,16:15,16:30,50.23,,0,50.23,50.23,1,-96081,38145,134226,-57936,0,0,47,0,0,,47,47
43,10/21/2018,67,16:30,16:45,54.69,,0,54.69,54.69,1,-110941,40089,151030,-70852,0,0,1930,0,0,,1930,1930
43,10/21/2018,68,16:45,17:00,62,,0,62,62,1,-127485,36812,164297,-90673,0,0,18658,0,0,,18658,18658
43,10/21/2018,69,17:00,17:15,57.76,,0,57.76,57.76,1,-143265,30411,173676,-112854,0,0,13742,0,0,,13742,13742
43,10/21/2018,70,17:15,17:30,,,0,50.96,50.96,0,-106964,20855,127819,-86109,0,0,188,0,0,,188,188
43,10/21/2018,71,17:30,17:45,138.09,,0,138.09,138.09,1,-116225,14160,130385,-102065,0,0,23105,0,0,,23105,23105
43,10/21/2018,72,17:45,18:00,59.5,,0,59.5,59.5,1,-87939,49824,137763,-38115,0,0,46816,0,0,,46816,46816
43,10/21/2018,73,18:00,18:15,58.09,,0,58.09,58.09,1,-91404,35168,126572,-56236,0,0,11813,0,0,,11813,11813
43,10/21/2018,74,18:15,18:30,,,0,47.84,47.84,0,-53732,34394,88126,-19338,0,0,46,0,0,,46,46
43,10/21/2018,75,18:30,18:45,58.55,51.64,0,58.55,47.83,2,-51171,18805,69976,-32366,0,-161,3731,0,0,,3892,3570
43,10/21/2018,76,18:45,19:00,125.02,,0,125.02,125.02,1,-112081,20864,132945,-91217,0,0,54464,0,0,,54464,54464
43,10/21/2018,77,19:00,19:15,74.94,,0,74.94,74.94,1,-74748,20170,94918,-54578,0,0,33656,0,0,,33656,33656
43,10/21/2018,78,19:15,19:30,50.39,,0,50.39,50.39,1,-65442,18002,83444,-47440,0,0,1444,0,0,,1444,1444
43,10/21/2018,79,19:30,19:45,,,0,47.85,47.85,0,-68076,21341,89417,-46735,0,0,0,0,0,,0,0
43,10/21/2018,80,19:45,20:00,,,0,47.85,47.85,0,-89789,18516,108305,-71273,0,0,0,0,0,,0,0
43,10/21/2018,81,20:00,20:15,92.54,,0,92.54,92.54,1,-134118,15171,149289,-118947,0,0,21743,0,0,,21743,21743
43,10/21/2018,82,20:15,20:30,50.39,,0,50.39,50.39,1,-98569,17004,115573,-81565,0,0,2722,0,0,,2722,2722
43,10/21/2018,83,20:30,20:45,50.39,,0,50.39,50.39,1,-62783,22009,84792,-40774,0,0,362,0,0,,362,362
43,10/21/2018,84,20:45,21:00,48.02,,0,48.02,48.02,1,-58387,40951,99338,-17436,0,0,572,0,0,,572,572
43,10/21/2018,85,21:00,21:15,58.55,,0,58.55,58.55,1,-73857,31674,105531,-42183,0,0,12374,0,0,,12374,12374
43,10/21/2018,86,21:15,21:30,73.62,,0,73.62,73.62,1,-88657,18468,107125,-70189,0,0,43923,0,0,,43923,43923
43,10/21/2018,87,21:30,21:45,61.9,,0,61.9,61.9,1,-104677,28245,132922,-76432,0,0,54715,0,0,,54715,54715
43,10/21/2018,88,21:45,22:00,61.82,,0,61.82,61.82,1,-107736,31737,139473,-75999,0,0,50954,0,0,,50954,50954
43,10/21/2018,89,22:00,22:15,58.46,,0,58.46,58.46,1,-117026,79724,196750,-37302,0,0,7987,0,0,,7987,7987
43,10/21/2018,90,22:15,22:30,54.98,,0,54.98,54.98,1,-109996,14469,124465,-95527,0,0,11349,0,0,,11349,11349
43,10/21/2018,91,22:30,22:45,185.34,,0,185.34,185.34,1,-152290,20629,172919,-131661,0,0,48616,0,0,,48616,48616
43,10/21/2018,92,22:45,23:00,169.63,,0,169.63,169.63,1,-155856,31865,187721,-123991,0,0,94051,0,0,,94051,94051
43,10/21/2018,93,23:00,23:15,54.54,,0,54.54,54.54,1,-95833,63389,159222,-32444,0,0,32893,0,0,,32893,32893
43,10/21/2018,94,23:15,23:30,50.39,46.39,0,46.39,46.39,-1,-57620,46743,104363,-10877,0,-636,7641,0,0,,8277,7005
43,10/21/2018,95,23:30,23:45,,42.39,0,42.39,42.39,-1,-33257,49484,82741,16227,0,-20886,0,0,0,,20886,-20886
43,10/21/2018,96,23:45,0:00,,39.96,0,39.96,39.96,-1,-39811,55509,95320,15698,0,-24557,0,0,0,,24557,-24557
43,10/22/2018,1,0:00,0:15,65.3,38.05,0,65.3,38.05,2,-58256,31405,89661,-26851,0,-13957,4707,0,0,,18664,-9250
43,10/22/2018,2,0:15,0:30,52.8,38.05,0,52.8,52.8,1,-43631,25741,69372,-17890,0,-23,8518,0,0,,8541,8495
43,10/22/2018,3,0:30,0:45,50.05,46.86,0,50.5,46.86,2,-40125,32017,72142,-8108,0,-280,166,0,0,,446,-114
43,10/22/2018,4,0:45,1:00,,,0,50.39,50.39,0,-58103,48795,106898,-9308,0,0,0,0,0,,0,0
43,10/22/2018,5,1:00,1:15,54.05,,0,54.05,54.05,1,-48245,26026,74271,-22219,0,0,3050,0,0,,3050,3050
43,10/22/2018,6,1:15,1:30,50.3,,0,50.3,50.3,1,-61589,39448,101037,-22141,0,0,3286,0,0,,3286,3286
43,10/22/2018,7,1:30,1:45,50.3,46.05,0,46.05,46.05,-1,-40285,48347,88632,8062,0,-383,1034,0,0,,1417,651
43,10/22/2018,8,1:45,2:00,,38.05,0,38.05,38.05,-1,-40724,60869,101593,20145,0,-19257,0,0,0,,19257,-19257
43,10/22/2018,9,2:00,2:15,58.05,42.8,0,58.05,58.05,1,-61316,32372,93688,-28944,0,-12189,3444,0,0,,15633,-8745
43,10/22/2018,10,2:15,2:30,50.05,42.8,0,50.05,50.05,1,-55571,44783,100354,-10788,0,-35,2336,0,0,,2371,2301
43,10/22/2018,11,2:30,2:45,,42.8,0,42.8,42.8,-1,-58776,60619,119395,1843,0,-4827,0,0,0,,4827,-4827
43,10/22/2018,12,2:45,3:00,,41.78,0,41.78,41.78,-1,-55519,69148,124667,13629,0,-17351,0,0,0,,17351,-17351
43,10/22/2018,13,3:00,3:15,,42.69,0,42.69,42.69,-1,-40318,44260,84578,3942,0,-11949,0,0,0,,11949,-11949
43,10/22/2018,14,3:15,3:30,,19.78,0,19.78,19.78,-1,-32916,72868,105784,39952,0,-8042,0,0,0,,8042,-8042
43,10/22/2018,15,3:30,3:45,,-5.57,0,-5.57,-5.57,-1,-46187,85079,131266,38892,0,-40163,0,0,0,,40163,-40163
43,10/22/2018,16,3:45,4:00,,-9.77,0,-9.77,-9.77,-1,-43500,111588,155088,68088,0,-59360,0,0,0,,59360,-59360
43,10/22/2018,17,4:00,4:15,,35.78,0,35.78,35.78,-1,-65705,109146,174851,43441,0,-55839,0,0,0,,55839,-55839
43,10/22/2018,18,4:15,4:30,,38.05,0,38.05,38.05,-1,-74172,101886,176058,27714,0,-42680,0,0,0,,42680,-42680
43,10/22/2018,19,4:30,4:45,52.8,40.75,0,52.8,52.8,1,-99926,82312,182238,-17614,0,-24313,178,0,0,,24491,-24135
43,10/22/2018,20,4:45,5:00,54.05,40.75,0,54.05,54.05,1,-85934,54065,139999,-31869,0,-943,1134,0,0,,2077,191
43,10/22/2018,21,5:00,5:15,73.52,,0,73.52,73.52,1,-126150,65791,191941,-60359,0,0,17950,0,0,,17950,17950
43,10/22/2018,22,5:15,5:30,54.05,,0,54.05,54.05,1,-79970,68052,148022,-11918,0,0,9155,0,0,,9155,9155
43,10/22/2018,23,5:30,5:45,107.97,,0,107.97,107.97,1,-103999,37714,141713,-66285,0,0,15955,0,0,,15955,15955
43,10/22/2018,24,5:45,6:00,100.84,,0,100.84,100.84,1,-79639,32592,112231,-47047,0,0,51079,0,0,,51079,51079
43,10/22/2018,25,6:00,6:15,67.3,,0,67.3,67.3,1,-147843,41310,189153,-106533,0,0,18301,0,0,,18301,18301
43,10/22/2018,26,6:15,6:30,73.77,,0,73.77,73.77,1,-105767,33710,139477,-72057,0,0,3665,0,0,,3665,3665
43,10/22/2018,27,6:30,6:45,66.52,,0,66.52,66.52,1,-103534,24934,128468,-78600,0,0,29323,0,0,,29323,29323
43,10/22/2018,28,6:45,7:00,56.59,,0,56.59,56.59,1,-88286,55494,143780,-32792,0,0,26835,0,0,,26835,26835
43,10/22/2018,29,7:00,7:15,56.59,46.3,0,46.3,46.3,-1,-155094,109934,265028,-45160,0,-15,1137,0,0,,1152,1122
43,10/22/2018,30,7:15,7:30,,,0,58.95,58.95,0,-173688,78106,251794,-95582,0,0,0,0,0,,0,0
43,10/22/2018,31,7:30,7:45,124.96,,0,124.96,124.96,1,-143841,38617,182458,-105224,0,0,9109,0,0,,9109,9109
43,10/22/2018,32,7:45,8:00,173.66,,0,173.66,173.66,1,-168065,34070,202135,-133995,0,0,93036,0,0,,93036,93036
43,10/22/2018,33,8:00,8:15,173.66,18.85,0,18.85,18.85,-1,-57026,92275,149301,35249,0,-8280,32629,0,0,,40909,24349
43,10/22/2018,34,8:15,8:30,,45.05,0,45.05,45.05,-1,-58929,69175,128104,10246,0,-19508,0,0,0,,19508,-19508
43,10/22/2018,35,8:30,8:45,,48.26,0,48.26,48.26,-1,-59655,58499,118154,-1156,0,-5883,0,0,0,,5883,-5883
43,10/22/2018,36,8:45,9:00,,47.18,0,47.18,47.18,-1,-62916,46746,109662,-16170,0,-2051,0,0,0,,2051,-2051
43,10/22/2018,37,9:00,9:15,,38.75,0,38.75,38.75,-1,-38808,75694,114502,36886,0,-6236,0,0,0,,6236,-6236
43,10/22/2018,38,9:15,9:30,50.3,72.74,0,50.3,50.3,1,-68276,58109,126385,-10167,0,-2001,33,0,0,,2034,-1968
43,10/22/2018,39,9:30,9:45,53.38,,0,53.38,53.38,1,-79557,55463,135020,-24094,0,0,2054,0,0,,2054,2054
43,10/22/2018,40,9:45,10:00,50.3,,0,50.3,50.3,1,-63920,52064,115984,-11856,0,0,700,0,0,,700,700
43,10/22/2018,41,10:00,10:15,58.3,,0,58.3,58.3,1,-86288,39406,125694,-46882,0,0,8096,0,0,,8096,8096
43,10/22/2018,42,10:15,10:30,50.3,50.11,0,51.75,50.11,2,-73216,64906,138122,-8310,0,-617,2950,0,0,,3567,2333
43,10/22/2018,43,10:30,10:45,,42.3,0,42.3,42.3,-1,-52855,60361,113216,7506,0,-7369,0,0,0,,7369,-7369
43,10/22/2018,44,10:45,11:00,,42.3,0,42.3,42.3,-1,-51201,75472,126673,24271,0,-39119,0,0,0,,39119,-39119
43,10/22/2018,45,11:00,11:15,50.48,46.3,0,50.48,50.48,1,-72619,63401,136020,-9218,0,-17734,321,0,0,,18055,-17413
43,10/22/2018,46,11:15,11:30,,38.3,0,38.3,38.3,-1,-60331,84696,145027,24365,0,-16067,0,0,0,,16067,-16067
43,10/22/2018,47,11:30,11:45,,42.4,0,42.4,42.4,-1,-58878,90516,149394,31638,0,-35313,0,0,0,,35313,-35313
43,10/22/2018,48,11:45,12:00,,41.98,0,41.98,41.98,-1,-58495,87694,146189,29199,0,-41392,0,0,0,,41392,-41392
43,10/22/2018,49,12:00,12:15,50.3,46.3,0,50.3,50.3,1,-68070,57494,125564,-10576,0,-19306,307,0,0,,19613,-18999
43,10/22/2018,50,12:15,12:30,,47.31,0,47.31,47.31,-1,-80142,72842,152984,-7300,0,-2460,0,0,0,,2460,-2460
43,10/22/2018,51,12:30,12:45,,49.17,0,49.17,49.17,-1,-76033,65703,141736,-10330,0,-1072,0,0,0,,1072,-1072
43,10/22/2018,52,12:45,13:00,,45.06,0,45.06,45.06,-1,-73257,72011,145268,-1246,0,-6356,0,0,0,,6356,-6356
43,10/22/2018,53,13:00,13:15,57.8,38.3,0,57.8,38.3,2,-84974,50086,135060,-34888,0,-14714,1994,0,0,,16708,-12720
43,10/22/2018,54,13:15,13:30,57.8,44.98,0,57.8,44.98,2,-69682,73138,142820,3456,0,-4997,1968,0,0,,6965,-3029
43,10/22/2018,55,13:30,13:45,,47.23,0,47.23,47.23,-1,-60280,61167,121447,887,0,-6933,0,0,0,,6933,-6933
43,10/22/2018,56,13:45,14:00,,45.78,0,45.78,45.78,-1,-56293,57264,113557,971,0,-11707,0,0,0,,11707,-11707
43,10/22/2018,57,14:00,14:15,,41.8,0,41.8,41.8,-1,-52922,86912,139834,33990,0,-18561,0,0,0,,18561,-18561
43,10/22/2018,58,14:15,14:30,54.3,42.3,0,54.3,42.3,2,-78133,72915,151048,-5218,0,-25333,322,0,0,,25655,-25011
43,10/22/2018,59,14:30,14:45,57.8,44.78,0,57.8,44.78,2,-66027,78846,144873,12819,0,-10774,1445,0,0,,12219,-9329
43,10/22/2018,60,14:45,15:00,,46.3,0,46.3,46.3,-1,-59134,57171,116305,-1963,0,-6614,0,0,0,,6614,-6614
43,10/22/2018,61,15:00,15:15,,23.63,0,23.63,23.63,-1,-24111,84218,108329,60107,0,-44013,0,0,0,,44013,-44013
43,10/22/2018,62,15:15,15:30,,38.3,0,38.3,38.3,-1,-33585,76985,110570,43400,0,-64880,0,0,0,,64880,-64880
43,10/22/2018,63,15:30,15:45,,44.8,0,44.8,44.8,-1,-37739,56620,94359,18881,0,-20189,0,0,0,,20189,-20189
43,10/22/2018,64,15:45,16:00,,42.3,0,42.3,42.3,-1,-45184,50690,95874,5506,0,-16180,0,0,0,,16180,-16180
43,10/22/2018,65,16:00,16:15,52.83,23.63,0,52.83,23.63,2,-47747,78250,125997,30503,0,-11053,798,0,0,,11851,-10255
43,10/22/2018,66,16:15,16:30,,7.06,0,7.06,7.06,-1,-45241,64139,109380,18898,0,-43451,0,0,0,,43451,-43451
43,10/22/2018,67,16:30,16:45,50.3,7.06,0,50.3,50.3,1,-49798,36620,86418,-13178,0,-1991,152,0,0,,2143,-1839
43,10/22/2018,68,16:45,17:00,58.3,,0,58.3,58.3,1,-68173,29329,97502,-38844,0,0,6243,0,0,,6243,6243
43,10/22/2018,69,17:00,17:15,58.3,23.63,0,23.63,23.63,-1,-58605,103506,162111,44901,0,-19391,1727,0,0,,21118,-17664
43,10/22/2018,70,17:15,17:30,51.21,47.78,0,51.21,47.78,2,-64532,47481,112013,-17051,0,-8311,773,0,0,,9084,-7538
43,10/22/2018,71,17:30,17:45,54.3,,0,54.3,54.3,1,-80604,49614,130218,-30990,0,0,8405,0,0,,8405,8405
43,10/22/2018,72,17:45,18:00,73.58,,0,73.58,73.58,1,-93771,46374,140145,-47397,0,0,31432,0,0,,31432,31432
43,10/22/2018,73,18:00,18:15,78.91,,0,78.91,78.91,1,-143172,39541,182713,-103631,0,0,31195,0,0,,31195,31195
43,10/22/2018,74,18:15,18:30,58.91,,0,58.91,58.91,1,-81497,42756,124253,-38741,0,0,7581,0,0,,7581,7581
43,10/22/2018,75,18:30,18:45,78.91,,0,78.91,78.91,1,-76307,24373,100680,-51934,0,0,15787,0,0,,15787,15787
43,10/22/2018,76,18:45,19:00,182.24,,0,182.24,182.24,1,-127235,20703,147938,-106532,0,0,76156,0,0,,76156,76156
43,10/22/2018,77,19:00,19:15,115.16,,0,115.16,115.16,1,-93839,18148,111987,-75691,0,0,65782,0,0,,65782,65782
43,10/22/2018,78,19:15,19:30,62,,0,62,62,1,-77682,26341,104023,-51341,0,0,12813,0,0,,12813,12813
43,10/22/2018,79,19:30,19:45,54.89,,0,54.89,54.89,1,-57510,17526,75036,-39984,0,0,18981,0,0,,18981,18981
43,10/22/2018,80,19:45,20:00,54.89,51.02,0,51.02,51.02,-1,-40831,16084,56915,-24747,0,-6,4953,0,0,,4959,4947
43,10/22/2018,81,20:00,20:15,73.58,,0,73.58,73.58,1,-77858,28479,106337,-49379,0,0,12367,0,0,,12367,12367
43,10/22/2018,82,20:15,20:30,54.3,,0,54.3,54.3,1,-74918,27767,102685,-47151,0,0,8421,0,0,,8421,8421
43,10/22/2018,83,20:30,20:45,,,0,40.66,40.66,0,-57162,29720,86882,-27442,0,0,0,0,0,,0,0
43,10/22/2018,84,20:45,21:00,,47.65,0,47.65,47.65,-1,-68847,50544,119391,-18303,0,-408,0,0,0,,408,-408
43,10/22/2018,85,21:00,21:15,85,38.3,0,85,31,2,-90006,50134,140140,-39872,0,-2405,7943,0,0,,10348,5538
43,10/22/2018,86,21:15,21:30,117.12,49.43,0,117.12,31,2,-95459,42967,138426,-52492,0,-20,33521,0,0,,33541,33501
43,10/22/2018,87,21:30,21:45,117.12,48.22,0,48.22,48.22,-1,-49240,21880,71120,-27360,0,-732,1230,0,0,,1962,498
43,10/22/2018,88,21:45,22:00,,45.15,0,45.15,45.15,-1,-44670,34262,78932,-10408,0,-2603,0,0,0,,2603,-2603
43,10/22/2018,89,22:00,22:15,84.98,34.1,0,84.98,29.55,2,-78018,48886,126904,-29132,0,-13434,5046,0,0,,18480,-8388
43,10/22/2018,90,22:15,22:30,143.12,38.3,0,143.12,29.56,2,-65866,47299,113165,-18567,0,-378,28422,0,0,,28800,28044
43,10/22/2018,91,22:30,22:45,143.12,13.88,0,13.88,13.88,-1,-35810,55550,91360,19740,0,-20821,302,0,0,,21123,-20519
43,10/22/2018,92,22:45,23:00,,46.3,0,46.3,46.3,-1,-59796,64163,123959,4367,0,-14792,0,0,0,,14792,-14792
43,10/22/2018,93,23:00,23:15,86.63,46.6,0,86.63,86.63,1,-108150,46436,154586,-61714,0,-5801,18494,0,0,,24295,12693
43,10/22/2018,94,23:15,23:30,59.96,,0,59.96,59.96,1,-84471,43319,127790,-41152,0,0,39037,0,0,,39037,39037
43,10/22/2018,95,23:30,23:45,59.96,32.58,0,32.58,32.58,-1,-28378,55016,83394,26638,0,-18967,4505,0,0,,23472,-14462
43,10/22/2018,96,23:45,0:00,,32.86,0,32.86,32.86,-1,-22108,72877,94985,50769,0,-51580,0,0,0,,51580,-51580
43,10/23/2018,1,0:00,0:15,,23.86,0,23.86,23.86,-1,-61929,94064,155993,32135,0,-52877,0,0,0,,52877,-52877
43,10/23/2018,2,0:15,0:30,,23.72,0,23.72,23.72,-1,-29920,72677,102597,42757,0,-15338,0,0,0,,15338,-15338
43,10/23/2018,3,0:30,0:45,,23.86,0,23.86,23.86,-1,-14607,67472,82079,52865,0,-54802,0,0,0,,54802,-54802
43,10/23/2018,4,0:45,1:00,,29.2,0,29.2,29.2,-1,-19483,81653,101136,62170,0,-64689,0,0,0,,64689,-64689
43,10/23/2018,5,1:00,1:15,57.37,31.03,0,57.37,57.37,1,-51651,36521,88172,-15130,0,-24734,4040,0,0,,28774,-20694
43,10/23/2018,6,1:15,1:30,50.08,23.86,0,23.86,23.86,-1,-42173,62785,104958,20612,0,-6747,2774,0,0,,9521,-3973
43,10/23/2018,7,1:30,1:45,,-5.8,0,-5.8,-5.8,-1,-36130,82596,118726,46466,0,-49617,0,0,0,,49617,-49617
43,10/23/2018,8,1:45,2:00,,-13.95,0,-13.95,-13.95,-1,-52432,100911,153343,48479,0,-51256,0,0,0,,51256,-51256
43,10/23/2018,9,2:00,2:15,,42.3,0,42.3,42.3,-1,-43145,55819,98964,12674,0,-20038,0,0,0,,20038,-20038
43,10/23/2018,10,2:15,2:30,,23.86,0,23.86,23.86,-1,-33444,56052,89496,22608,0,-12022,0,0,0,,12022,-12022
43,10/23/2018,11,2:30,2:45,,-5.47,0,-5.47,-5.47,-1,-30391,83970,114361,53579,0,-57304,0,0,0,,57304,-57304
43,10/23/2018,12,2:45,3:00,,-5.58,0,-5.58,-5.58,-1,-35115,94239,129354,59124,0,-54231,0,0,0,,54231,-54231
43,10/23/2018,13,3:00,3:15,53.03,38.3,0,53.03,38.3,2,-54264,48830,103094,-5434,0,-23688,1210,0,0,,24898,-22478
43,10/23/2018,14,3:15,3:30,53.03,42.32,0,42.32,42.32,-1,-53002,51130,104132,-1872,0,-2434,20,0,0,,2454,-2414
43,10/23/2018,15,3:30,3:45,,38.3,0,38.3,38.3,-1,-43471,60302,103773,16831,0,-14576,0,0,0,,14576,-14576
43,10/23/2018,16,3:45,4:00,,-60.79,0,-60.79,-60.79,-1,-43599,79956,123555,36357,0,-37921,0,0,0,,37921,-37921
43,10/23/2018,17,4:00,4:15,52.12,-160.35,0,52.12,-160.35,2,-35167,46928,82095,11761,0,-44186,1431,0,0,,45617,-42755
43,10/23/2018,18,4:15,4:30,52.12,-16,0,-16,-16,-1,-14603,64578,79181,49975,0,-22822,1,0,0,,22823,-22821
43,10/23/2018,19,4:30,4:45,,23.86,0,23.86,23.86,-1,-20467,76123,96590,55656,0,-48559,0,0,0,,48559,-48559
43,10/23/2018,20,4:45,5:00,,23.86,0,23.86,23.86,-1,-19907,73301,93208,53394,0,-52480,0,0,0,,52480,-52480
43,10/23/2018,21,5:00,5:15,50.09,23.86,0,50.09,50.09,1,-76056,62384,138440,-13672,0,-33066,651,0,0,,33717,-32415
43,10/23/2018,22,5:15,5:30,52.35,23.86,0,23.86,23.86,-1,-37895,49463,87358,11568,0,-6460,750,0,0,,7210,-5710
43,10/23/2018,23,5:30,5:45,50.3,38.3,0,50.3,50.3,1,-52307,40809,93116,-11498,0,-11831,567,0,0,,12398,-11264
43,10/23/2018,24,5:45,6:00,50.3,46.3,0,50.3,44.66,2,-64368,51615,115983,-12753,0,-72,2990,0,0,,3062,2918
43,10/23/2018,25,6:00,6:15,50.3,-153.98,0,-153.98,-153.98,-1,-45576,123152,168728,77576,0,-43332,77,0,0,,43409,-43255
43,10/23/2018,26,6:15,6:30,,-19.03,0,-19.03,-19.03,-1,-54863,91719,146582,36856,0,-41501,0,0,0,,41501,-41501
43,10/23/2018,27,6:30,6:45,52.86,41.81,0,52.86,41.81,2,-29932,43677,73609,13745,0,-6583,369,0,0,,6952,-6214
43,10/23/2018,28,6:45,7:00,,23.27,0,23.27,23.27,-1,-44441,99700,144141,55259,0,-33394,0,0,0,,33394,-33394
43,10/23/2018,29,7:00,7:15,,32.06,0,32.06,32.06,-1,-19704,119911,139615,100207,0,-54115,0,0,0,,54115,-54115
43,10/23/2018,30,7:15,7:30,,41.68,0,41.68,41.68,-1,-11159,108786,119945,97627,0,-20841,0,0,0,,20841,-20841
43,10/23/2018,31,7:30,7:45,50.62,41.68,0,50.62,50.62,1,-34984,52012,86996,17028,0,-71,243,0,0,,314,172
43,10/23/2018,32,7:45,8:00,57.81,,0,57.81,57.81,1,-97186,41967,139153,-55219,0,0,22099,0,0,,22099,22099
43,10/23/2018,33,8:00,8:15,53.28,,0,53.28,53.28,1,-68503,24322,92825,-44181,0,0,9803,0,0,,9803,9803
43,10/23/2018,34,8:15,8:30,57.81,,0,57.81,57.81,1,-83983,23933,107916,-60050,0,0,9523,0,0,,9523,9523
43,10/23/2018,35,8:30,8:45,110.02,,0,110.02,110.02,1,-97985,16133,114118,-81852,0,0,57903,0,0,,57903,57903
43,10/23/2018,36,8:45,9:00,95.13,,0,95.13,95.13,1,-123766,15505,139271,-108261,0,0,68733,0,0,,68733,68733
43,10/23/2018,37,9:00,9:15,79.14,,0,79.14,79.14,1,-87298,17854,105152,-69444,0,0,51126,0,0,,51126,51126
43,10/23/2018,38,9:15,9:30,59.14,,0,59.14,59.14,1,-78128,18864,96992,-59264,0,0,34143,0,0,,34143,34143
43,10/23/2018,39,9:30,9:45,59.14,,0,59.14,59.14,1,-80462,20954,101416,-59508,0,0,25289,0,0,,25289,25289
43,10/23/2018,40,9:45,10:00,59.14,,0,59.14,59.14,1,-90594,21669,112263,-68925,0,0,24366,0,0,,24366,24366
43,10/23/2018,41,10:00,10:15,167.5,,0,167.5,167.5,1,-174560,3268,177828,-171292,0,0,66921,0,0,,66921,66921
43,10/23/2018,42,10:15,10:30,167.5,,0,167.5,167.5,1,-160189,1298,161487,-158891,0,0,127300,0,0,,127300,127300
43,10/23/2018,43,10:30,10:45,172.12,,0,172.12,172.12,1,-115445,1276,116721,-114169,0,0,105884,1250,0,,107134,107134
43,10/23/2018,44,10:45,11:00,73.08,,0,73.08,73.08,1,-122785,30895,153680,-91890,0,0,58534,0,0,,58534,58534
43,10/23/2018,45,11:00,11:15,53.81,,0,53.81,53.81,1,-101723,74126,175849,-27597,0,0,20341,0,0,,20341,20341
43,10/23/2018,46,11:15,11:30,52.11,,0,52.11,52.11,1,-96619,71994,168613,-24625,0,0,9112,0,0,,9112,9112
43,10/23/2018,47,11:30,11:45,52.11,49.56,0,49.56,49.56,-1,-84004,71048,155052,-12956,0,-231,517,0,0,,748,286
43,10/23/2018,48,11:45,12:00,,44.7,0,44.7,44.7,-1,-80830,81825,162655,995,0,-2085,0,0,0,,2085,-2085
43,10/23/2018,49,12:00,12:15,52.13,49.13,0,52.13,49.13,2,-102047,79350,181397,-22697,0,-1370,6247,0,0,,7617,4877
43,10/23/2018,50,12:15,12:30,,,0,49.58,49.58,0,-104139,72216,176355,-31923,0,0,1143,0,0,,1143,1143
43,10/23/2018,51,12:30,12:45,,,0,49.58,49.58,0,-76102,79448,155550,3346,0,0,0,0,0,,0,0
43,10/23/2018,52,12:45,13:00,,49.35,0,49.35,49.35,-1,-72957,65968,138925,-6989,0,-1030,0,0,0,,1030,-1030
43,10/23/2018,53,13:00,13:15,65.09,49.43,0,65.09,65.09,1,-119076,66003,185079,-53073,0,-180,10196,0,0,,10376,10016
43,10/23/2018,54,13:15,13:30,73.08,,0,73.08,73.08,1,-114263,50051,164314,-64212,0,0,31455,0,0,,31455,31455
43,10/23/2018,55,13:30,13:45,73.08,,0,73.08,73.08,1,-130483,45058,175541,-85425,0,0,39821,0,0,,39821,39821
43,10/23/2018,56,13:45,14:00,50.09,,0,50.09,50.09,1,-133452,38530,171982,-94922,0,0,7062,0,0,,7062,7062
43,10/23/2018,57,14:00,14:15,184.56,,0,184.56,184.56,1,-130939,33443,164382,-97496,0,0,29705,0,0,,29705,29705
43,10/23/2018,58,14:15,14:30,192.97,,0,192.97,192.97,1,-136184,21199,157383,-114985,0,0,83841,0,0,,83841,83841
43,10/23/2018,59,14:30,14:45,54.37,,0,54.37,54.37,1,-128111,11939,140050,-116172,0,0,13263,0,0,,13263,13263
43,10/23/2018,60,14:45,15:00,57.37,,0,57.37,57.37,1,-119450,12080,131530,-107370,0,0,31938,0,0,,31938,31938
43,10/23/2018,61,15:00,15:15,57.81,,0,57.81,57.81,1,-86400,31845,118245,-54555,0,0,26755,0,0,,26755,26755
43,10/23/2018,62,15:15,15:30,73.08,,0,73.08,73.08,1,-105911,23023,128934,-82888,0,0,44782,0,0,,44782,44782
43,10/23/2018,63,15:30,15:45,98.95,,0,98.95,98.95,1,-127234,14494,141728,-112740,0,0,85457,0,0,,85457,85457
43,10/23/2018,64,15:45,16:00,57.81,,0,57.81,57.81,1,-111333,14442,125775,-96891,0,0,35895,0,0,,35895,35895
43,10/23/2018,65,16:00,16:15,52.19,,0,52.19,52.19,1,-140568,58767,199335,-81801,0,0,7128,0,0,,7128,7128
43,10/23/2018,66,16:15,16:30,55.11,,0,55.11,55.11,1,-106124,45229,151353,-60895,0,0,6523,0,0,,6523,6523
43,10/23/2018,67,16:30,16:45,57.81,,0,57.81,57.81,1,-110405,41326,151731,-69079,0,0,22339,0,0,,22339,22339
43,10/23/2018,68,16:45,17:00,57.89,,0,57.89,57.89,1,-125117,39889,165006,-85228,0,0,36050,0,0,,36050,36050
43,10/23/2018,69,17:00,17:15,57.81,,0,57.81,57.81,1,-97921,60824,158745,-37097,0,0,12932,0,0,,12932,12932
43,10/23/2018,70,17:15,17:30,58.77,,0,58.77,58.77,1,-93478,44283,137761,-49195,0,0,25358,0,0,,25358,25358
43,10/23/2018,71,17:30,17:45,57.81,,0,57.81,57.81,1,-86683,42584,129267,-44099,0,0,34422,0,0,,34422,34422
43,10/23/2018,72,17:45,18:00,59.49,,0,59.49,59.49,1,-93978,53040,147018,-40938,0,0,38911,0,0,,38911,38911
43,10/23/2018,73,18:00,18:15,162.67,,0,162.67,162.67,1,-161802,37908,199710,-123894,0,0,73588,0,0,,73588,73588
43,10/23/2018,74,18:15,18:30,85.02,,0,85.02,85.02,1,-107704,41728,149432,-65976,0,0,72404,0,0,,72404,72404
43,10/23/2018,75,18:30,18:45,59.46,,0,59.46,59.46,1,-87646,41894,129540,-45752,0,0,38315,0,0,,38315,38315
43,10/23/2018,76,18:45,19:00,73.08,,0,73.08,73.08,1,-125933,57060,182993,-68873,0,0,54254,0,0,,54254,54254
43,10/23/2018,77,19:00,19:15,62,,0,62,62,1,-123025,71831,194856,-51194,0,0,45054,0,0,,45054,45054
43,10/23/2018,78,19:15,19:30,62,,0,62,62,1,-102656,41553,144209,-61103,0,0,41861,0,0,,41861,41861
43,10/23/2018,79,19:30,19:45,60.02,,0,60.02,60.02,1,-95417,38637,134054,-56780,0,0,29961,0,0,,29961,29961
43,10/23/2018,80,19:45,20:00,53.81,,0,53.81,53.81,1,-86755,46074,132829,-40681,0,0,11408,0,0,,11408,11408
43,10/23/2018,81,20:00,20:15,52.41,,0,52.41,52.41,1,-86667,67068,153735,-19599,0,0,7983,0,0,,7983,7983
43,10/23/2018,82,20:15,20:30,49.81,45.81,0,45.81,45.81,-1,-57531,69811,127342,12280,0,-1525,1597,0,0,,3122,72
43,10/23/2018,83,20:30,20:45,,44.92,0,44.92,44.92,-1,-49240,69135,118375,19895,0,-18500,0,0,0,,18500,-18500
43,10/23/2018,84,20:45,21:00,,45.81,0,45.81,45.81,-1,-77146,90444,167590,13298,0,-19511,0,0,0,,19511,-19511
43,10/23/2018,85,21:00,21:15,154.02,46.97,0,154.02,154.02,1,-124959,17991,142950,-106968,0,-5640,39146,0,0,,44786,33506
43,10/23/2018,86,21:15,21:30,73.28,,0,73.28,73.28,1,-97671,29495,127166,-68176,0,0,60914,0,0,,60914,60914
43,10/23/2018,87,21:30,21:45,55.52,49.58,0,49.58,49.58,-1,-72027,43749,115776,-28278,0,-28,18637,0,0,,18665,18609
43,10/23/2018,88,21:45,22:00,55.52,45.03,0,45.03,45.03,-1,-56498,75611,132109,19113,0,-9200,563,0,0,,9763,-8637
43,10/23/2018,89,22:00,22:15,123.97,41.97,0,123.97,41.97,2,-123142,62555,185697,-60587,0,-11577,13774,0,0,,25351,2197
43,10/23/2018,90,22:15,22:30,163.48,41.97,0,163.48,163.48,1,-101579,50951,152530,-50628,0,-7,48249,0,0,,48256,48242
43,10/23/2018,91,22:30,22:45,49.81,41.81,0,49.81,41.81,2,-60229,66382,126611,6153,0,-6853,7786,0,0,,14639,933
43,10/23/2018,92,22:45,23:00,,42.51,0,42.51,42.51,-1,-54384,73431,127815,19047,0,-17568,0,0,0,,17568,-17568
43,10/23/2018,93,23:00,23:15,66.61,41.86,0,66.61,66.61,1,-79803,34927,114730,-44876,0,-5378,10587,0,0,,15965,5209
43,10/23/2018,94,23:15,23:30,54.02,,0,54.02,54.02,1,-72492,39870,112362,-32622,0,0,24002,0,0,,24002,24002
43,10/23/2018,95,23:30,23:45,54.02,16.1,0,16.1,16.1,-1,-41008,66241,107249,25233,0,-11858,8124,0,0,,19982,-3734
43,10/23/2018,96,23:45,0:00,,-8.98,0,-8.98,-8.98,-1,-68383,80483,148866,12100,0,-24852,0,0,0,,24852,-24852
43,10/24/2018,1,0:00,0:15,52.44,17.78,0,52.44,17.78,2,-60262,75960,136222,15698,0,-22149,585,0,0,,22734,-21564
43,10/24/2018,2,0:15,0:30,54.82,43.75,0,54.82,43.37,2,-62700,58778,121478,-3922,0,-239,1351,0,0,,1590,1112
43,10/24/2018,3,0:30,0:45,,23.17,0,23.17,23.17,-1,-47567,78204,125771,30637,0,-20687,0,0,0,,20687,-20687
43,10/24/2018,4,0:45,1:00,,21.76,0,21.76,21.76,-1,-35354,95910,131264,60556,0,-65126,0,0,0,,65126,-65126
43,10/24/2018,5,1:00,1:15,54.37,21.76,0,54.37,54.37,1,-60272,45324,105596,-14948,0,-24784,2944,0,0,,27728,-21840
43,10/24/2018,6,1:15,1:30,45.6,42.1,0,45.6,42.1,2,-64192,60383,124575,-3809,0,-226,809,0,0,,1035,583
43,10/24/2018,7,1:30,1:45,,37,0,37,37,-1,-57294,82547,139841,25253,0,-22116,0,0,0,,22116,-22116
43,10/24/2018,8,1:45,2:00,,37.61,0,37.61,37.61,-1,-54521,78710,133231,24189,0,-31870,0,0,0,,31870,-31870
43,10/24/2018,9,2:00,2:15,57.61,38.86,0,57.61,57.61,1,-93752,79494,173246,-14258,0,-16337,934,0,0,,17271,-15403
43,10/24/2018,10,2:15,2:30,71.77,38.86,0,71.77,71.77,1,-105693,58793,164486,-46900,0,-634,30863,0,0,,31497,30229
43,10/24/2018,11,2:30,2:45,51.67,,0,51.67,51.67,1,-91383,58846,150229,-32537,0,0,18899,0,0,,18899,18899
43,10/24/2018,12,2:45,3:00,51.76,42.72,0,51.76,42.72,2,-70439,59825,130264,-10614,0,-74,15656,0,0,,15730,15582
43,10/24/2018,13,3:00,3:15,49.98,37.61,0,49.98,37.61,2,-51578,36583,88161,-14995,0,-951,1466,0,0,,2417,515
43,10/24/2018,14,3:15,3:30,57.61,,0,57.61,57.61,1,-72602,33993,106595,-38609,0,0,18356,0,0,,18356,18356
43,10/24/2018,15,3:30,3:45,51.64,,0,51.64,51.64,1,-63941,42656,106597,-21285,0,0,14173,0,0,,14173,14173
43,10/24/2018,16,3:45,4:00,49.61,,0,49.61,49.61,1,-59375,39689,99064,-19686,0,0,4314,0,0,,4314,4314
43,10/24/2018,17,4:00,4:15,49.61,41.93,0,41.93,41.93,-1,-43050,41412,84462,-1638,0,-3203,629,0,0,,3832,-2574
43,10/24/2018,18,4:15,4:30,,41.82,0,41.82,41.82,-1,-45936,44194,90130,-1742,0,-4316,0,0,0,,4316,-4316
43,10/24/2018,19,4:30,4:45,57.61,41.8,0,57.61,57.61,1,-64454,37433,101887,-27021,0,-2274,4955,0,0,,7229,2681
43,10/24/2018,20,4:45,5:00,57.61,,0,57.61,57.61,1,-48771,25923,74694,-22848,0,0,24611,0,0,,24611,24611
43,10/24/2018,21,5:00,5:15,46.12,45.61,0,45.61,45.61,-1,-73644,55540,129184,-18104,0,-46,1415,0,0,,1461,1369
43,10/24/2018,22,5:15,5:30,53.61,45.61,0,53.61,45.4,2,-54551,29204,83755,-25347,0,-800,6289,0,0,,7089,5489
43,10/24/2018,23,5:30,5:45,54.65,,0,54.65,54.65,1,-69435,32056,101491,-37379,0,0,24366,0,0,,24366,24366
43,10/24/2018,24,5:45,6:00,53.61,,0,53.61,53.61,1,-70109,28706,98815,-41403,0,0,26056,0,0,,26056,26056
43,10/24/2018,25,6:00,6:15,53.61,-29.38,0,-29.38,-29.38,-1,-47356,104188,151544,56832,0,-25667,4520,0,0,,30187,-21147
43,10/24/2018,26,6:15,6:30,,36.46,0,36.46,36.46,-1,-43016,61440,104456,18424,0,-37848,0,0,0,,37848,-37848
43,10/24/2018,27,6:30,6:45,56.46,36.46,0,56.46,56.46,1,-75581,36859,112440,-38722,0,-1792,15279,0,0,,17071,13487
43,10/24/2018,28,6:45,7:00,51.91,,0,51.91,51.91,1,-95421,65875,161296,-29546,0,0,23318,0,0,,23318,23318
43,10/24/2018,29,7:00,7:15,51.91,21.73,0,21.73,21.73,-1,-58542,96396,154938,37854,0,-12184,4348,0,0,,16532,-7836
43,10/24/2018,30,7:15,7:30,58.52,-30.63,0,58.52,-30.63,2,-81194,78923,160117,-2271,0,-29793,2604,0,0,,32397,-27189
43,10/24/2018,31,7:30,7:45,50.91,-30.63,0,50.91,50.91,1,-77577,62829,140406,-14748,0,-23,2509,0,0,,2532,2486
43,10/24/2018,32,7:45,8:00,51.56,44.46,0,51.56,44.46,2,-107971,109279,217250,1308,0,-2876,684,0,0,,3560,-2192
43,10/24/2018,33,8:00,8:15,49.88,39.35,0,50.18,39.35,2,-50509,70140,120649,19631,0,-7024,282,0,0,,7306,-6742
43,10/24/2018,34,8:15,8:30,56.46,36.46,0,56.46,36.46,2,-50250,44561,94811,-5689,0,-18847,1554,0,0,,20401,-17293
43,10/24/2018,35,8:30,8:45,56.46,36.46,0,56.46,56.46,1,-72719,33039,105758,-39680,0,-404,19824,0,0,,20228,19420
43,10/24/2018,36,8:45,9:00,112.69,,0,112.69,112.69,1,-104710,20588,125298,-84122,0,0,50779,0,0,,50779,50779
43,10/24/2018,37,9:00,9:15,133.12,,0,133.12,133.12,1,-87012,38691,125703,-48321,0,0,56372,0,0,,56372,56372
43,10/24/2018,38,9:15,9:30,62.63,,0,62.63,62.63,1,-75023,33166,108189,-41857,0,0,18899,0,0,,18899,18899
43,10/24/2018,39,9:30,9:45,62.89,,0,62.89,62.89,1,-81100,22107,103207,-58993,0,0,48853,0,0,,48853,48853
43,10/24/2018,40,9:45,10:00,61.74,,0,61.74,61.74,1,-76823,19888,96711,-56935,0,0,45461,0,0,,45461,45461
43,10/24/2018,41,10:00,10:15,56.46,46.38,0,56.46,46.38,2,-72759,68299,141058,-4460,0,-1707,14956,0,0,,16663,13249
43,10/24/2018,42,10:15,10:30,56.46,46.38,0,56.46,56.46,1,-78527,57988,136515,-20539,0,-152,2580,0,0,,2732,2428
43,10/24/2018,43,10:30,10:45,56.46,46.71,0,56.46,46.71,2,-71432,65819,137251,-5613,0,-1000,8053,0,0,,9053,7053
43,10/24/2018,44,10:45,11:00,,45.78,0,45.78,45.78,-1,-71324,79733,151057,8409,0,-11316,0,0,0,,11316,-11316
43,10/24/2018,45,11:00,11:15,56.46,45.78,0,56.46,56.46,1,-100468,65118,165586,-35350,0,-159,11239,0,0,,11398,11080
43,10/24/2018,46,11:15,11:30,51.45,49.36,0,49.36,49.36,-1,-74974,68037,143011,-6937,0,-99,6681,0,0,,6780,6582
43,10/24/2018,47,11:30,11:45,49.87,52.76,0,50.61,50.61,2,-97385,75716,173101,-21669,0,-28,384,0,0,,412,356
43,10/24/2018,48,11:45,12:00,,44.34,0,44.34,44.34,-1,-80672,87244,167916,6572,0,-5570,0,0,0,,5570,-5570
43,10/24/2018,49,12:00,12:15,,40.22,0,40.22,40.22,-1,-64442,102493,166935,38051,0,-25278,0,0,0,,25278,-25278
43,10/24/2018,50,12:15,12:30,,33.36,0,33.36,33.36,-1,-62483,126589,189072,64106,0,-58175,0,0,0,,58175,-58175
43,10/24/2018,51,12:30,12:45,,35.91,0,35.91,35.91,-1,-60129,127185,187314,67056,0,-69285,0,0,0,,69285,-69285
43,10/24/2018,52,12:45,13:00,,36.46,0,36.46,36.46,-1,-69646,104328,173974,34682,0,-57505,0,0,0,,57505,-57505
43,10/24/2018,53,13:00,13:15,48.46,44.78,0,50.61,44.78,2,-77208,82073,159281,4865,0,-10780,62,0,0,,10842,-10718
43,10/24/2018,54,13:15,13:30,51.94,44.78,0,51.94,51.94,1,-99252,73057,172309,-26195,0,-190,12582,0,0,,12772,12392
43,10/24/2018,55,13:30,13:45,52.46,,0,52.46,52.46,1,-110605,72278,182883,-38327,0,0,24604,0,0,,24604,24604
43,10/24/2018,56,13:45,14:00,56.46,,0,56.46,56.46,1,-113779,63114,176893,-50665,0,0,30713,0,0,,30713,30713
43,10/24/2018,57,14:00,14:15,57.17,,0,57.17,57.17,1,-121815,71498,193313,-50317,0,0,22329,0,0,,22329,22329
43,10/24/2018,58,14:15,14:30,57.17,,0,57.17,57.17,1,-139137,58369,197506,-80768,0,0,27897,0,0,,27897,27897
43,10/24/2018,59,14:30,14:45,56.46,,0,56.46,56.46,1,-134021,52939,186960,-81082,0,0,46207,0,0,,46207,46207
43,10/24/2018,60,14:45,15:00,56.46,,0,56.46,56.46,1,-130641,50687,181328,-79954,0,0,44846,0,0,,44846,44846
43,10/24/2018,61,15:00,15:15,54.81,,0,54.81,54.81,1,-109824,51680,161504,-58144,0,0,26838,0,0,,26838,26838
43,10/24/2018,62,15:15,15:30,101.56,,0,101.56,101.56,1,-140475,34312,174787,-106163,0,0,33659,0,0,,33659,33659
43,10/24/2018,63,15:30,15:45,91.12,,0,91.12,91.12,1,-134146,43018,177164,-91128,0,0,55974,0,0,,55974,55974
43,10/24/2018,64,15:45,16:00,56.46,,0,56.46,56.46,1,-133902,54045,187947,-79857,0,0,39444,0,0,,39444,39444
43,10/24/2018,65,16:00,16:15,58.16,,0,58.16,58.16,1,-110993,43433,154426,-67560,0,0,29106,0,0,,29106,29106
43,10/24/2018,66,16:15,16:30,71.73,,0,71.73,71.73,1,-118896,34376,153272,-84520,0,0,54740,0,0,,54740,54740
43,10/24/2018,67,16:30,16:45,151.12,,0,151.12,151.12,1,-119179,15223,134402,-103956,0,0,77139,0,0,,77139,77139
43,10/24/2018,68,16:45,17:00,151.12,,0,151.12,151.12,1,-148140,9289,157429,-138851,0,0,117139,0,0,,117139,117139
43,10/24/2018,69,17:00,17:15,82.12,,0,82.12,82.12,1,-91948,66376,158324,-25572,0,0,38378,0,0,,38378,38378
43,10/24/2018,70,17:15,17:30,71.73,,0,71.73,71.73,1,-118506,40473,158979,-78033,0,0,39933,0,0,,39933,39933
43,10/24/2018,71,17:30,17:45,85.98,,0,85.98,85.98,1,-112046,24415,136461,-87631,0,0,71395,0,0,,71395,71395
43,10/24/2018,72,17:45,18:00,88.12,,0,88.12,88.12,1,-112181,23705,135886,-88476,0,0,82044,0,0,,82044,82044
43,10/24/2018,73,18:00,18:15,115.69,,0,115.69,115.69,1,-158512,26894,185406,-131618,0,0,63572,0,0,,63572,63572
43,10/24/2018,74,18:15,18:30,75.1,,0,75.1,75.1,1,-85284,26952,112236,-58332,0,0,48232,0,0,,48232,48232
43,10/24/2018,75,18:30,18:45,75.1,,0,75.1,75.1,1,-116440,52488,168928,-63952,0,0,39691,0,0,,39691,39691
43,10/24/2018,76,18:45,19:00,173.97,,0,173.97,173.97,1,-158593,60144,218737,-98449,0,0,84758,0,0,,84758,84758
43,10/24/2018,77,19:00,19:15,75,,0,75,75,1,-85425,43388,128813,-42037,0,0,42264,0,0,,42264,42264
43,10/24/2018,78,19:15,19:30,51.42,,0,51.42,51.42,1,-95781,37763,133544,-58018,0,0,4755,0,0,,4755,4755
43,10/24/2018,79,19:30,19:45,,,0,50.61,50.61,0,-94658,47034,141692,-47624,0,0,235,0,0,,235,235
43,10/24/2018,80,19:45,20:00,51.47,,0,51.47,51.47,1,-106597,43710,150307,-62887,0,0,931,0,0,,931,931
43,10/24/2018,81,20:00,20:15,71.92,,0,71.92,71.92,1,-104095,19571,123666,-84524,0,0,25284,0,0,,25284,25284
43,10/24/2018,82,20:15,20:30,56.92,,0,56.92,56.92,1,-110520,23458,133978,-87062,0,0,36450,0,0,,36450,36450
43,10/24/2018,83,20:30,20:45,56.46,,0,56.46,56.46,1,-90654,45302,135956,-45352,0,0,19770,0,0,,19770,19770
43,10/24/2018,84,20:45,21:00,52.85,,0,52.85,52.85,1,-114459,44055,158514,-70404,0,0,625,0,0,,625,625
43,10/24/2018,85,21:00,21:15,151.12,,0,151.12,151.12,1,-160092,34422,194514,-125670,0,0,59042,0,0,,59042,59042
43,10/24/2018,86,21:15,21:30,151.12,,0,151.12,151.12,1,-157135,33475,190610,-123660,0,0,116224,0,0,,116224,116224
43,10/24/2018,87,21:30,21:45,210,47.98,0,47.98,47.98,-1,-93344,61260,154604,-32084,0,-19,42987,2500,0,,45506,45468
43,10/24/2018,88,21:45,22:00,210,40.46,0,40.46,40.46,-1,-63579,73845,137424,10266,0,-8967,779,0,0,,9746,-8188
43,10/24/2018,89,22:00,22:15,142.12,43.46,0,142.12,43.46,2,-86892,33897,120789,-52995,0,-2001,12519,0,0,,14520,10518
43,10/24/2018,90,22:15,22:30,150.12,21.92,0,21.92,21.92,-1,-48129,67592,115721,19463,0,-4559,19931,0,0,,24490,15372
43,10/24/2018,91,22:30,22:45,,7.52,0,7.52,7.52,-1,-43901,102014,145915,58113,0,-44220,0,0,0,,44220,-44220
43,10/24/2018,92,22:45,23:00,,21.92,0,21.92,21.92,-1,-67992,142103,210095,74111,0,-71047,0,0,0,,71047,-71047
43,10/24/2018,93,23:00,23:15,142.33,40.46,0,142.33,142.33,1,-125418,65586,191004,-59832,0,-27410,15870,0,0,,43280,-11540
43,10/24/2018,94,23:15,23:30,59.85,,0,59.85,59.85,1,-92326,54064,146390,-38262,0,0,27277,0,0,,27277,27277
43,10/24/2018,95,23:30,23:45,52.46,,0,52.46,52.46,1,-95809,74893,170702,-20916,0,0,9909,0,0,,9909,9909
43,10/24/2018,96,23:45,0:00,48.46,41.78,0,50.61,41.78,2,-96091,92860,188951,-3231,0,-5532,2109,0,0,,7641,-3423
43,10/25/2018,1,0:00,0:15,49.81,43.4,0,49.81,43.4,2,-75633,85607,161240,9974,0,-6038,123,0,0,,6161,-5915
43,10/25/2018,2,0:15,0:30,51.09,46.45,0,51.09,46.45,2,-70777,66473,137250,-4304,0,-1208,2005,0,0,,3213,797
43,10/25/2018,3,0:30,0:45,,43.09,0,43.09,43.09,-1,-63479,66098,129577,2619,0,-7572,0,0,0,,7572,-7572
43,10/25/2018,4,0:45,1:00,,39.09,0,39.09,39.09,-1,-58472,71106,129578,12634,0,-10690,0,0,0,,10690,-10690
43,10/25/2018,5,1:00,1:15,71.16,35.09,0,71.16,35.09,2,-92984,68968,161952,-24016,0,-18034,3473,0,0,,21507,-14561
43,10/25/2018,6,1:15,1:30,81.29,35.09,0,81.29,35.09,2,-74171,74809,148980,638,0,-4841,17545,0,0,,22386,12704
43,10/25/2018,7,1:30,1:45,,27.68,0,27.68,27.68,-1,-61379,97344,158723,35965,0,-40575,0,0,0,,40575,-40575
43,10/25/2018,8,1:45,2:00,,43.03,0,43.03,43.03,-1,-75417,93299,168716,17882,0,-32298,0,0,0,,32298,-32298
43,10/25/2018,9,2:00,2:15,51.54,43.09,0,51.54,51.54,1,-92649,77845,170494,-14804,0,-4239,1852,0,0,,6091,-2387
43,10/25/2018,10,2:15,2:30,47.09,39.09,0,47.61,39.09,2,-74325,85608,159933,11283,0,-8775,1820,0,0,,10595,-6955
43,10/25/2018,11,2:30,2:45,,41.91,0,41.91,41.91,-1,-76170,83378,159548,7208,0,-15372,0,0,0,,15372,-15372
43,10/25/2018,12,2:45,3:00,,35.09,0,35.09,35.09,-1,-61167,94909,156076,33742,0,-29576,0,0,0,,29576,-29576
43,10/25/2018,13,3:00,3:15,,21.37,0,21.37,21.37,-1,-58848,88100,146948,29252,0,-47652,0,0,0,,47652,-47652
43,10/25/2018,14,3:15,3:30,47.09,43.09,0,47.59,43.09,2,-79317,82327,161644,3010,0,-4168,125,0,0,,4293,-4043
43,10/25/2018,15,3:30,3:45,,39.09,0,39.09,39.09,-1,-73316,90358,163674,17042,0,-18561,0,0,0,,18561,-18561
43,10/25/2018,16,3:45,4:00,,39.09,0,39.09,39.09,-1,-61059,88184,149243,27125,0,-30923,0,0,0,,30923,-30923
43,10/25/2018,17,4:00,4:15,,9.47,0,9.47,9.47,-1,-36557,97536,134093,60979,0,-48602,0,0,0,,48602,-48602
43,10/25/2018,18,4:15,4:30,,35.09,0,35.09,35.09,-1,-48739,82918,131657,34179,0,-48685,0,0,0,,48685,-48685
43,10/25/2018,19,4:30,4:45,,40.03,0,40.03,40.03,-1,-74014,78287,152301,4273,0,-14253,0,0,0,,14253,-14253
43,10/25/2018,20,4:45,5:00,,43.09,0,43.09,43.09,-1,-75918,85545,161463,9627,0,-12051,0,0,0,,12051,-12051
43,10/25/2018,21,5:00,5:15,,35.09,0,35.09,35.09,-1,-55133,95560,150693,40427,0,-35281,0,0,0,,35281,-35281
43,10/25/2018,22,5:15,5:30,,39.09,0,39.09,39.09,-1,-62190,87627,149817,25437,0,-39853,0,0,0,,39853,-39853
43,10/25/2018,23,5:30,5:45,49.73,48.49,0,49.73,49.73,1,-89148,79038,168186,-10110,0,-4679,910,0,0,,5589,-3769
43,10/25/2018,24,5:45,6:00,47.09,43.09,0,43.09,43.09,-1,-88534,87728,176262,-806,0,-351,879,0,0,,1230,528
43,10/25/2018,25,6:00,6:15,,37.39,0,37.39,37.39,-1,-51253,61133,112386,9880,0,-7038,0,0,0,,7038,-7038
43,10/25/2018,26,6:15,6:30,51.97,45.07,0,51.97,45.07,2,-82501,70489,152990,-12012,0,-8275,994,0,0,,9269,-7281
43,10/25/2018,27,6:30,6:45,52.12,45.07,0,52.12,52.12,1,-105014,74857,179871,-30157,0,-50,16130,0,0,,16180,16080
43,10/25/2018,28,6:45,7:00,50.62,-24.96,0,-24.96,-24.96,-1,-131761,186986,318747,55225,0,-17293,8008,0,0,,25301,-9285
43,10/25/2018,29,7:00,7:15,50.62,32.95,0,32.95,32.95,-1,-133993,171152,305145,37159,0,-23928,5,0,0,,23933,-23923
43,10/25/2018,30,7:15,7:30,,12.09,0,12.09,12.09,-1,-66023,134370,200393,68347,0,-52405,0,0,0,,52405,-52405
43,10/25/2018,31,7:30,7:45,55.63,43.03,0,55.63,55.63,1,-84836,79554,164390,-5282,0,-16463,4545,0,0,,21008,-11918
43,10/25/2018,32,7:45,8:00,71.51,43.03,0,71.51,71.51,1,-117453,52658,170111,-64795,0,-8,31267,0,0,,31275,31259
43,10/25/2018,33,8:00,8:15,55.63,32.95,0,32.95,32.95,-1,-58352,90250,148602,31898,0,-11221,12759,0,0,,23980,1538
43,10/25/2018,34,8:15,8:30,,40.21,0,40.21,40.21,-1,-67775,90127,157902,22352,0,-32286,0,0,0,,32286,-32286
43,10/25/2018,35,8:30,8:45,55.63,40.21,0,55.63,55.63,1,-99720,72093,171813,-27627,0,-7056,9516,0,0,,16572,2460
43,10/25/2018,36,8:45,9:00,55.63,,0,55.63,55.63,1,-117353,67543,184896,-49810,0,0,26701,0,0,,26701,26701
43,10/25/2018,37,9:00,9:15,64.05,,0,64.05,64.05,1,-121142,88215,209357,-32927,0,0,27479,0,0,,27479,27479
43,10/25/2018,38,9:15,9:30,55.63,,0,55.63,55.63,1,-115847,79425,195272,-36422,0,0,20611,0,0,,20611,20611
43,10/25/2018,39,9:30,9:45,52.57,,0,52.57,52.57,1,-106875,80123,186998,-26752,0,0,21642,0,0,,21642,21642
43,10/25/2018,40,9:45,10:00,56,,0,56,56,1,-111700,71904,183604,-39796,0,0,15680,0,0,,15680,15680
43,10/25/2018,41,10:00,10:15,162.67,,0,162.67,162.67,1,-169990,72192,242182,-97798,0,0,69545,0,0,,69545,69545
43,10/25/2018,42,10:15,10:30,89.02,,0,89.02,89.02,1,-142244,68441,210685,-73803,0,0,76119,0,0,,76119,76119
43,10/25/2018,43,10:30,10:45,56.18,,0,56.18,56.18,1,-133805,80372,214177,-53433,0,0,39615,0,0,,39615,39615
43,10/25/2018,44,10:45,11:00,55.63,,0,55.63,55.63,1,-132185,86532,218717,-45653,0,0,37584,0,0,,37584,37584
43,10/25/2018,45,11:00,11:15,51.63,37.32,0,37.32,37.32,-1,-91899,100057,191956,8158,0,-2658,11517,0,0,,14175,8859
43,10/25/2018,46,11:15,11:30,50.62,35.63,0,50.62,35.63,2,-101485,95134,196619,-6351,0,-11475,222,0,0,,11697,-11253
43,10/25/2018,47,11:30,11:45,50.62,35.63,0,50.62,50.62,1,-114549,96501,211050,-18048,0,-492,4381,0,0,,4873,3889
43,10/25/2018,48,11:45,12:00,55.63,,0,55.63,55.63,1,-134484,93704,228188,-40780,0,0,18251,0,0,,18251,18251
43,10/25/2018,49,12:00,12:15,77.02,,0,77.02,77.02,1,-139191,65820,205011,-73371,0,0,54710,0,0,,54710,54710
43,10/25/2018,50,12:15,12:30,55.63,,0,55.63,55.63,1,-129226,49746,178972,-79480,0,0,44171,0,0,,44171,44171
43,10/25/2018,51,12:30,12:45,55.63,,0,55.63,55.63,1,-112456,44862,157318,-67594,0,0,45355,0,0,,45355,45355
43,10/25/2018,52,12:45,13:00,55.63,,0,55.63,55.63,1,-119851,72964,192815,-46887,0,0,36171,0,0,,36171,36171
43,10/25/2018,53,13:00,13:15,151.02,,0,151.02,151.02,1,-129690,36222,165912,-93468,0,0,47568,0,0,,47568,47568
43,10/25/2018,54,13:15,13:30,151.02,,0,151.02,151.02,1,-107195,18010,125205,-89185,0,0,81348,0,0,,81348,81348
43,10/25/2018,55,13:30,13:45,58.18,,0,58.18,58.18,1,-103039,19570,122609,-83469,0,0,43164,0,0,,43164,43164
43,10/25/2018,56,13:45,14:00,56.3,,0,56.3,56.3,1,-98126,25243,123369,-72883,0,0,45057,0,0,,45057,45057
43,10/25/2018,57,14:00,14:15,51.63,,0,51.63,51.63,1,-80759,52133,132892,-28626,0,0,14772,0,0,,14772,14772
43,10/25/2018,58,14:15,14:30,55.63,,0,55.63,55.63,1,-97687,53697,151384,-43990,0,0,29303,0,0,,29303,29303
43,10/25/2018,59,14:30,14:45,55.63,,0,55.63,55.63,1,-93695,52983,146678,-40712,0,0,30027,0,0,,30027,30027
43,10/25/2018,60,14:45,15:00,55.63,,0,55.63,55.63,1,-102740,56088,158828,-46652,0,0,34808,0,0,,34808,34808
43,10/25/2018,61,15:00,15:15,55.63,35.63,0,55.63,35.63,2,-64546,79707,144253,15161,0,-8035,11294,0,0,,19329,3259
43,10/25/2018,62,15:15,15:30,50.02,45.1,0,50.02,45.1,2,-67178,62522,129700,-4656,0,-10017,518,0,0,,10535,-9499
43,10/25/2018,63,15:30,15:45,55.63,45.1,0,55.63,55.63,1,-77341,51606,128947,-25735,0,-202,11882,0,0,,12084,11680
43,10/25/2018,64,15:45,16:00,54.9,,0,54.9,54.9,1,-85007,48709,133716,-36298,0,0,22687,0,0,,22687,22687
43,10/25/2018,65,16:00,16:15,55.63,,0,55.63,55.63,1,-103409,65089,168498,-38320,0,0,19297,0,0,,19297,19297
43,10/25/2018,66,16:15,16:30,55.63,,0,55.63,55.63,1,-102934,53687,156621,-49247,0,0,36764,0,0,,36764,36764
43,10/25/2018,67,16:30,16:45,55.63,,0,55.63,55.63,1,-99780,50222,150002,-49558,0,0,37583,0,0,,37583,37583
43,10/25/2018,68,16:45,17:00,55.63,,0,55.63,55.63,1,-115572,65083,180655,-50489,0,0,40818,0,0,,40818,40818
43,10/25/2018,69,17:00,17:15,61.07,,0,61.07,61.07,1,-105366,66338,171704,-39028,0,0,31580,0,0,,31580,31580
43,10/25/2018,70,17:15,17:30,55.63,,0,55.63,55.63,1,-105460,75211,180671,-30249,0,0,12657,0,0,,12657,12657
43,10/25/2018,71,17:30,17:45,55.63,,0,55.63,55.63,1,-102245,58810,161055,-43435,0,0,33265,0,0,,33265,33265
43,10/25/2018,72,17:45,18:00,57.77,,0,57.77,57.77,1,-90719,56058,146777,-34661,0,0,37382,0,0,,37382,37382
43,10/25/2018,73,18:00,18:15,47.63,46.97,0,49,46.97,2,-90404,64936,155340,-25468,0,-419,6921,0,0,,7340,6502
43,10/25/2018,74,18:15,18:30,51.63,,0,51.63,51.63,1,-69954,43627,113581,-26327,0,0,450,0,0,,450,450
43,10/25/2018,75,18:30,18:45,52.36,,0,52.36,52.36,1,-99061,52324,151385,-46737,0,0,4342,0,0,,4342,4342
43,10/25/2018,76,18:45,19:00,55.63,,0,55.63,55.63,1,-96508,55519,152027,-40989,0,0,7747,0,0,,7747,7747
43,10/25/2018,77,19:00,19:15,55.63,47.66,0,47.66,47.66,-1,-70845,57517,128362,-13328,0,-794,773,0,0,,1567,-21
43,10/25/2018,78,19:15,19:30,,43.63,0,43.63,43.63,-1,-58535,57465,116000,-1070,0,-4890,0,0,0,,4890,-4890
43,10/25/2018,79,19:30,19:45,,43.63,0,43.63,43.63,-1,-40223,58207,98430,17984,0,-19699,0,0,0,,19699,-19699
43,10/25/2018,80,19:45,20:00,,43.63,0,43.63,43.63,-1,-36664,54847,91511,18183,0,-24607,0,0,0,,24607,-24607
43,10/25/2018,81,20:00,20:15,51.52,45.03,0,51.52,45.03,2,-50727,42053,92780,-8674,0,-8073,1071,0,0,,9144,-7002
43,10/25/2018,82,20:15,20:30,,39.69,0,39.69,39.69,-1,-35563,51842,87405,16279,0,-12929,0,0,0,,12929,-12929
43,10/25/2018,83,20:30,20:45,,40.28,0,40.28,40.28,-1,-30209,63477,93686,33268,0,-25611,0,0,0,,25611,-25611
43,10/25/2018,84,20:45,21:00,,21.7,0,21.7,21.7,-1,-30494,96717,127211,66223,0,-58136,0,0,0,,58136,-58136
43,10/25/2018,85,21:00,21:15,97.98,-24.47,0,97.98,-24.47,2,-44760,30466,75226,-14294,0,-46682,7223,0,0,,53905,-39459
43,10/25/2018,86,21:15,21:30,47.63,47.81,0,47.63,30.21,2,-44012,37989,82001,-6023,0,-165,3247,0,0,,3412,3082
43,10/25/2018,87,21:30,21:45,,32.81,0,32.81,32.81,-1,-19587,74343,93930,54756,0,-11610,0,0,0,,11610,-11610
43,10/25/2018,88,21:45,22:00,,32.81,0,32.81,32.81,-1,-22155,65869,88024,43714,0,-44995,0,0,0,,44995,-44995
43,10/25/2018,89,22:00,22:15,127.7,41.03,0,127.7,127.7,1,-109942,3556,113498,-106386,0,-22199,13887,0,0,,36086,-8312
43,10/25/2018,90,22:15,22:30,140.02,41.03,0,140.02,140.02,1,-63065,17291,80356,-45774,0,-23,29602,0,0,,29625,29579
43,10/25/2018,91,22:30,22:45,140.02,49.69,0,49.69,49.69,-1,-42896,21642,64538,-21254,0,-385,10,0,0,,395,-375
43,10/25/2018,92,22:45,23:00,,,0,29.85,29.85,0,-85805,42656,128461,-43149,0,0,0,0,0,,0,0
43,10/25/2018,93,23:00,23:15,58.02,49.2,0,58.02,58.02,1,-87077,35268,122345,-51809,0,-67,7521,0,0,,7588,7454
43,10/25/2018,94,23:15,23:30,71.7,,0,71.7,71.7,1,-90358,11833,102191,-78525,0,0,28542,0,0,,28542,28542
43,10/25/2018,95,23:30,23:45,47.63,,0,47.63,47.63,1,-59092,18532,77624,-40560,0,0,543,0,0,,543,543
43,10/25/2018,96,23:45,0:00,,47.17,0,47.17,47.17,-1,-43421,38168,81589,-5253,0,-664,0,0,0,,664,-664
43,10/26/2018,1,0:00,0:15,47.41,41.56,0,47.41,28.22,2,-57005,38049,95054,-18956,0,-2140,19,0,0,,2159,-2121
43,10/26/2018,2,0:15,0:30,49.34,43.41,0,49.34,28.22,2,-29807,22442,52249,-7365,0,-272,1638,0,0,,1910,1366
43,10/26/2018,3,0:30,0:45,,43.41,0,43.41,43.41,-1,-24072,29680,53752,5608,0,-6663,0,0,0,,6663,-6663
43,10/26/2018,4,0:45,1:00,,42.78,0,42.78,42.78,-1,-21424,37478,58902,16054,0,-15647,0,0,0,,15647,-15647
43,10/26/2018,5,1:00,1:15,55.41,46.43,0,55.41,46.43,2,-72157,26396,98553,-45761,0,-3459,3193,0,0,,6652,-266
43,10/26/2018,6,1:15,1:30,47.71,,0,47.71,47.71,1,-52648,32699,85347,-19949,0,0,1191,0,0,,1191,1191
43,10/26/2018,7,1:30,1:45,,43.41,0,43.41,43.41,-1,-46704,50313,97017,3609,0,-3649,0,0,0,,3649,-3649
43,10/26/2018,8,1:45,2:00,,39.41,0,39.41,39.41,-1,-30852,58163,89015,27311,0,-25532,0,0,0,,25532,-25532
43,10/26/2018,9,2:00,2:15,63.96,41.78,0,63.96,41.78,2,-67729,23505,91234,-44224,0,-11186,11404,0,0,,22590,218
43,10/26/2018,10,2:15,2:30,51.41,41.78,0,51.41,51.41,1,-54523,36081,90604,-18442,0,-35,6767,0,0,,6802,6732
43,10/26/2018,11,2:30,2:45,47.41,44.7,0,47.41,44.7,2,-51361,47687,99048,-3674,0,-302,1496,0,0,,1798,1194
43,10/26/2018,12,2:45,3:00,,35.41,0,35.41,35.41,-1,-44798,79711,124509,34913,0,-25430,0,0,0,,25430,-25430
43,10/26/2018,13,3:00,3:15,49.34,35.41,0,49.34,49.34,1,-49707,64265,113972,14558,0,-13124,548,0,0,,13672,-12576
43,10/26/2018,14,3:15,3:30,,,0,46.88,46.88,0,-45851,44435,90286,-1416,0,0,207,0,0,,207,207
43,10/26/2018,15,3:30,3:45,,,0,46.88,46.88,0,-38226,37140,75366,-1086,0,0,0,0,0,,0,0
43,10/26/2018,16,3:45,4:00,,39.41,0,39.41,39.41,-1,-20633,57919,78552,37286,0,-10449,0,0,0,,10449,-10449
43,10/26/2018,17,4:00,4:15,,41.78,0,41.78,41.78,-1,-25347,30721,56068,5374,0,-15445,0,0,0,,15445,-15445
43,10/26/2018,18,4:15,4:30,,41.73,0,41.73,41.73,-1,-16781,47205,63986,30424,0,-19080,0,0,0,,19080,-19080
43,10/26/2018,19,4:30,4:45,,41.73,0,41.73,41.73,-1,-30044,67459,97503,37415,0,-22429,0,0,0,,22429,-22429
43,10/26/2018,20,4:45,5:00,,35.41,0,35.41,35.41,-1,-29906,78670,108576,48764,0,-32272,0,0,0,,32272,-32272
43,10/26/2018,21,5:00,5:15,,39.41,0,39.41,39.41,-1,-44642,62092,106734,17450,0,-21648,0,0,0,,21648,-21648
43,10/26/2018,22,5:15,5:30,,35.41,0,35.41,35.41,-1,-28015,62393,90408,34378,0,-38120,0,0,0,,38120,-38120
43,10/26/2018,23,5:30,5:45,,41.73,0,41.73,41.73,-1,-35161,53673,88834,18512,0,-25598,0,0,0,,25598,-25598
43,10/26/2018,24,5:45,6:00,,-29.64,0,-29.64,-29.64,-1,-25590,113864,139454,88274,0,-44495,0,0,0,,44495,-44495
43,10/26/2018,25,6:00,6:15,,40.78,0,40.78,40.78,-1,-94416,96156,190572,1740,0,-18747,0,0,0,,18747,-18747
43,10/26/2018,26,6:15,6:30,,35.02,0,35.02,35.02,-1,-32619,74925,107544,42306,0,-24922,0,0,0,,24922,-24922
43,10/26/2018,27,6:30,6:45,,43.02,0,43.02,43.02,-1,-37336,68982,106318,31646,0,-6774,0,0,0,,6774,-6774
43,10/26/2018,28,6:45,7:00,,,0,47.14,47.14,0,-50310,82563,132873,32253,0,0,0,0,0,,0,0
43,10/26/2018,29,7:00,7:15,,-65.82,0,-65.82,-65.82,-1,-48681,190643,239324,141962,0,-42796,0,0,0,,42796,-42796
43,10/26/2018,30,7:15,7:30,,-65.82,0,-65.82,-65.82,-1,-75833,116863,192696,41030,0,-61284,0,0,0,,61284,-61284
43,10/26/2018,31,7:30,7:45,,43.02,0,43.02,43.02,-1,-61131,92474,153605,31343,0,-4531,0,0,0,,4531,-4531
43,10/26/2018,32,7:45,8:00,,47.31,0,47.31,47.31,-1,-75357,59833,135190,-15524,0,-755,0,0,0,,755,-755
43,10/26/2018,33,8:00,8:15,,-45.51,0,-45.51,-45.51,-1,-48705,108521,157226,59816,0,-26041,0,0,0,,26041,-26041
43,10/26/2018,34,8:15,8:30,49.5,42.43,0,49.5,42.43,2,-71270,80271,151541,9001,0,-5414,128,0,0,,5542,-5286
43,10/26/2018,35,8:30,8:45,,46.15,0,46.15,46.15,-1,-81517,54968,136485,-26549,0,-2066,0,0,0,,2066,-2066
43,10/26/2018,36,8:45,9:00,51.02,,0,51.02,51.02,1,-97456,42128,139584,-55328,0,0,11777,0,0,,11777,11777
43,10/26/2018,37,9:00,9:15,47.02,44.78,0,48.59,44.78,2,-64499,77441,141940,12942,0,-2460,3130,0,0,,5590,670
43,10/26/2018,38,9:15,9:30,51.02,47.42,0,51.02,47.42,2,-75155,55117,130272,-20038,0,-779,1389,0,0,,2168,610
43,10/26/2018,39,9:30,9:45,51.02,,0,51.02,51.02,1,-78695,50434,129129,-28261,0,0,9317,0,0,,9317,9317
43,10/26/2018,40,9:45,10:00,57.61,,0,57.61,57.61,1,-87748,35788,123536,-51960,0,0,30540,0,0,,30540,30540
43,10/26/2018,41,10:00,10:15,84.8,,0,84.8,84.8,1,-118290,50370,168660,-67920,0,0,39756,0,0,,39756,39756
43,10/26/2018,42,10:15,10:30,75.22,,0,75.22,75.22,1,-111236,29072,140308,-82164,0,0,38983,0,0,,38983,38983
43,10/26/2018,43,10:30,10:45,150.12,,0,150.12,150.12,1,-114626,18584,133210,-96042,0,0,43944,0,0,,43944,43944
43,10/26/2018,44,10:45,11:00,77.4,,0,77.4,77.4,1,-120045,46934,166979,-73111,0,0,66465,0,0,,66465,66465
43,10/26/2018,45,11:00,11:15,70.89,,0,70.89,70.89,1,-127065,52614,179679,-74451,0,0,57661,0,0,,57661,57661
43,10/26/2018,46,11:15,11:30,53.36,,0,53.36,53.36,1,-120112,60803,180915,-59309,0,0,33742,0,0,,33742,33742
43,10/26/2018,47,11:30,11:45,51.02,,0,51.02,51.02,1,-126353,57028,183381,-69325,0,0,13897,0,0,,13897,13897
43,10/26/2018,48,11:45,12:00,70.89,,0,70.89,70.89,1,-137085,60699,197784,-76386,0,0,15675,0,0,,15675,15675
43,10/26/2018,49,12:00,12:15,139.29,,0,139.29,139.29,1,-123758,55425,179183,-68333,0,0,35303,0,0,,35303,35303
43,10/26/2018,50,12:15,12:30,61.12,,0,61.12,61.12,1,-94069,48950,143019,-45119,0,0,27913,0,0,,27913,27913
43,10/26/2018,51,12:30,12:45,61.12,42.8,0,42.8,42.8,-1,-58824,66644,125468,7820,0,-2093,2642,0,0,,4735,549
43,10/26/2018,52,12:45,13:00,,37.26,0,37.26,37.26,-1,-81558,86452,168010,4894,0,-18921,0,0,0,,18921,-18921
43,10/26/2018,53,13:00,13:15,139.97,37.26,0,139.97,139.97,1,-99833,36025,135858,-63808,0,-1552,27049,0,0,,28601,25497
43,10/26/2018,54,13:15,13:30,139.97,44.95,0,44.95,44.95,-1,-100433,75960,176393,-24473,0,-93,41107,0,0,,41200,41014
43,10/26/2018,55,13:30,13:45,139.97,30.46,0,30.46,30.46,-1,-63618,95386,159004,31768,0,-24463,809,0,0,,25272,-23654
43,10/26/2018,56,13:45,14:00,,43.78,0,43.78,43.78,-1,-76410,78121,154531,1711,0,-10750,0,0,0,,10750,-10750
43,10/26/2018,57,14:00,14:15,,43.02,0,43.02,43.02,-1,-86877,88975,175852,2098,0,-3118,0,0,0,,3118,-3118
43,10/26/2018,58,14:15,14:30,50.32,46.85,0,50.32,46.85,2,-98609,79164,177773,-19445,0,-154,1904,0,0,,2058,1750
43,10/26/2018,59,14:30,14:45,47.82,,0,47.82,47.82,1,-90981,71957,162938,-19024,0,0,6267,0,0,,6267,6267
43,10/26/2018,60,14:45,15:00,50.32,,0,50.32,50.32,1,-90796,66513,157309,-24283,0,0,8097,0,0,,8097,8097
43,10/26/2018,61,15:00,15:15,50.32,45.96,0,45.96,45.96,-1,-84898,77337,162235,-7561,0,-52,5632,0,0,,5684,5580
43,10/26/2018,62,15:15,15:30,,42.21,0,42.21,42.21,-1,-67599,87971,155570,20372,0,-9697,0,0,0,,9697,-9697
43,10/26/2018,63,15:30,15:45,,35.04,0,35.04,35.04,-1,-67659,102654,170313,34995,0,-38912,0,0,0,,38912,-38912
43,10/26/2018,64,15:45,16:00,,39.21,0,39.21,39.21,-1,-69896,101503,171399,31607,0,-35008,0,0,0,,35008,-35008
43,10/26/2018,65,16:00,16:15,51.02,43.02,0,51.02,43.02,2,-83642,71126,154768,-12516,0,-11399,1578,0,0,,12977,-9821
43,10/26/2018,66,16:15,16:30,,24.77,0,24.77,24.77,-1,-63003,106214,169217,43211,0,-36612,0,0,0,,36612,-36612
43,10/26/2018,67,16:30,16:45,,35.02,0,35.02,35.02,-1,-79048,114160,193208,35112,0,-23164,0,0,0,,23164,-23164
43,10/26/2018,68,16:45,17:00,,30.1,0,30.1,30.1,-1,-76250,110090,186340,33840,0,-38244,0,0,0,,38244,-38244
43,10/26/2018,69,17:00,17:15,51.02,30.1,0,51.02,51.02,1,-84731,71140,155871,-13591,0,-7738,2177,0,0,,9915,-5561
43,10/26/2018,70,17:15,17:30,55.02,,0,55.02,55.02,1,-90976,60391,151367,-30585,0,0,6675,0,0,,6675,6675
43,10/26/2018,71,17:30,17:45,49.61,,0,49.61,49.61,1,-87773,61302,149075,-26471,0,0,6056,0,0,,6056,6056
43,10/26/2018,72,17:45,18:00,49.72,,0,49.72,49.72,1,-81222,57123,138345,-24099,0,0,1114,0,0,,1114,1114
43,10/26/2018,73,18:00,18:15,47.02,45.78,0,48.59,45.78,2,-67835,64746,132581,-3089,0,-2398,74,0,0,,2472,-2324
43,10/26/2018,74,18:15,18:30,,35.02,0,35.02,35.02,-1,-58968,104193,163161,45225,0,-24758,0,0,0,,24758,-24758
43,10/26/2018,75,18:30,18:45,,42.92,0,42.92,42.92,-1,-98141,131822,229963,33681,0,-37598,0,0,0,,37598,-37598
43,10/26/2018,76,18:45,19:00,,39.99,0,39.99,39.99,-1,-77509,119817,197326,42308,0,-39643,0,0,0,,39643,-39643
43,10/26/2018,77,19:00,19:15,49.28,43.02,0,49.28,43.02,2,-75500,41678,117178,-33822,0,-15994,775,0,0,,16769,-15219
43,10/26/2018,78,19:15,19:30,,35.02,0,35.02,35.02,-1,-80390,106106,186496,25716,0,-15572,0,0,0,,15572,-15572
43,10/26/2018,79,19:30,19:45,,43.02,0,43.02,43.02,-1,-91257,99907,191164,8650,0,-16009,0,0,0,,16009,-16009
43,10/26/2018,80,19:45,20:00,,38.88,0,38.88,38.88,-1,-83658,91038,174696,7380,0,-13052,0,0,0,,13052,-13052
43,10/26/2018,81,20:00,20:15,55.02,35.02,0,55.02,35.02,2,-106992,69388,176380,-37604,0,-11772,2528,0,0,,14300,-9244
43,10/26/2018,82,20:15,20:30,51.02,35.02,0,51.02,51.02,1,-133585,58748,192333,-74837,0,-31,8795,0,0,,8826,8764
43,10/26/2018,83,20:30,20:45,51.02,43.02,0,43.02,43.02,-1,-58799,65003,123802,6204,0,-2387,5,0,0,,2392,-2382
43,10/26/2018,84,20:45,21:00,,43.78,0,43.78,43.78,-1,-99724,70525,170249,-29199,0,-2020,0,0,0,,2020,-2020
43,10/26/2018,85,21:00,21:15,55.36,,0,55.36,55.36,1,-81447,48195,129642,-33252,0,0,19667,0,0,,19667,19667
43,10/26/2018,86,21:15,21:30,52.91,,0,52.91,52.91,1,-89366,56365,145731,-33001,0,0,31115,0,0,,31115,31115
43,10/26/2018,87,21:30,21:45,49.95,,0,49.95,49.95,1,-77373,57743,135116,-19630,0,0,8842,0,0,,8842,8842
43,10/26/2018,88,21:45,22:00,49.95,41.78,0,41.78,41.78,-1,-67995,81090,149085,13095,0,-6816,1281,0,0,,8097,-5535
43,10/26/2018,89,22:00,22:15,,34.78,0,34.78,34.78,-1,-58467,71467,129934,13000,0,-10916,0,0,0,,10916,-10916
43,10/26/2018,90,22:15,22:30,,35.02,0,35.02,35.02,-1,-53033,73510,126543,20477,0,-25043,0,0,0,,25043,-25043
43,10/26/2018,91,22:30,22:45,,40.78,0,40.78,40.78,-1,-73850,87987,161837,14137,0,-10054,0,0,0,,10054,-10054
43,10/26/2018,92,22:45,23:00,,33.32,0,33.32,33.32,-1,-41336,82880,124216,41544,0,-27572,0,0,0,,27572,-27572
43,10/26/2018,93,23:00,23:15,,17.38,0,17.38,17.38,-1,-57072,78716,135788,21644,0,-34180,0,0,0,,34180,-34180
43,10/26/2018,94,23:15,23:30,,43.02,0,43.02,43.02,-1,-61294,62725,124019,1431,0,-4407,0,0,0,,4407,-4407
43,10/26/2018,95,23:30,23:45,,35.78,0,35.78,35.78,-1,-57477,71481,128958,14004,0,-13274,0,0,0,,13274,-13274
43,10/26/2018,96,23:45,0:00,,14.78,0,14.78,14.78,-1,-32752,78808,111560,46056,0,-41006,0,0,0,,41006,-41006
44,10/27/2018,1,0:00,0:15,,-28.24,0,-28.24,-28.24,-1,-38616,105337,143953,66721,0,-69469,0,0,0,,69469,-69469
44,10/27/2018,2,0:15,0:30,,35.02,0,35.02,35.02,-1,-40905,71202,112107,30297,0,-29707,0,0,0,,29707,-29707
44,10/27/2018,3,0:30,0:45,47.02,43.02,0,47.02,47.02,1,-79681,77780,157461,-1901,0,-10700,388,0,0,,11088,-10312
44,10/27/2018,4,0:45,1:00,47.02,39.02,0,39.02,39.02,-1,-69888,80085,149973,10197,0,-4623,35,0,0,,4658,-4588
44,10/27/2018,5,1:00,1:15,,21.29,0,21.29,21.29,-1,-51201,77770,128971,26569,0,-21506,0,0,0,,21506,-21506
44,10/27/2018,6,1:15,1:30,,21.29,0,21.29,21.29,-1,-36882,68440,105322,31558,0,-24878,0,0,0,,24878,-24878
44,10/27/2018,7,1:30,1:45,,21.29,0,21.29,21.29,-1,-35195,40322,75517,5127,0,-26882,0,0,0,,26882,-26882
44,10/27/2018,8,1:45,2:00,47.02,-9.59,0,47.02,-9.59,2,-24846,53677,78523,28831,0,-7422,423,0,0,,7845,-6999
44,10/27/2018,9,2:00,2:15,49.17,-30.05,0,49.17,-30.05,2,-51429,50889,102318,-540,0,-21489,537,0,0,,22026,-20952
44,10/27/2018,10,2:15,2:30,,35.02,0,35.02,35.02,-1,-36144,49789,85933,13645,0,-7549,0,0,0,,7549,-7549
44,10/27/2018,11,2:30,2:45,,35.02,0,35.02,35.02,-1,-51026,62235,113261,11209,0,-7357,0,0,0,,7357,-7357
44,10/27/2018,12,2:45,3:00,,20.03,0,20.03,20.03,-1,-36191,75872,112063,39681,0,-38830,0,0,0,,38830,-38830
44,10/27/2018,13,3:00,3:15,,35.02,0,35.02,35.02,-1,-52479,55088,107567,2609,0,-23611,0,0,0,,23611,-23611
44,10/27/2018,14,3:15,3:30,49.32,39.02,0,49.32,39.02,2,-48500,49911,98411,1411,0,-4027,491,0,0,,4518,-3536
44,10/27/2018,15,3:30,3:45,49.27,43.02,0,49.27,43.02,2,-57650,39059,96709,-18591,0,-2924,588,0,0,,3512,-2336
44,10/27/2018,16,3:45,4:00,49.06,,0,49.06,49.06,1,-60743,46868,107611,-13875,0,0,4297,0,0,,4297,4297
44,10/27/2018,17,4:00,4:15,49.06,39.02,0,39.02,39.02,-1,-47967,50839,98806,2872,0,-3157,7,0,0,,3164,-3150
44,10/27/2018,18,4:15,4:30,,28.32,0,28.32,28.32,-1,-31593,73431,105024,41838,0,-37136,0,0,0,,37136,-37136
44,10/27/2018,19,4:30,4:45,,21.29,0,21.29,21.29,-1,-42440,85237,127677,42797,0,-55910,0,0,0,,55910,-55910
44,10/27/2018,20,4:45,5:00,47.02,43.02,0,47.02,43.02,2,-64510,63328,127838,-1182,0,-10933,224,0,0,,11157,-10709
44,10/27/2018,21,5:00,5:15,,24.8,0,24.8,24.8,-1,-32518,68495,101013,35977,0,-26084,0,0,0,,26084,-26084
44,10/27/2018,22,5:15,5:30,,35.02,0,35.02,35.02,-1,-27974,56159,84133,28185,0,-31060,0,0,0,,31060,-31060
44,10/27/2018,23,5:30,5:45,,35.02,0,35.02,35.02,-1,-38098,58146,96244,20048,0,-31050,0,0,0,,31050,-31050
44,10/27/2018,24,5:45,6:00,,39.02,0,39.02,39.02,-1,-56063,75718,131781,19655,0,-13646,0,0,0,,13646,-13646
44,10/27/2018,25,6:00,6:15,,34.91,0,34.91,34.91,-1,-11047,43973,55020,32926,0,-29426,0,0,0,,29426,-29426
44,10/27/2018,26,6:15,6:30,54.34,41.5,0,54.34,54.34,1,-61263,40355,101618,-20908,0,-10194,3243,0,0,,13437,-6951
44,10/27/2018,27,6:30,6:45,54.91,,0,54.91,54.91,1,-66545,34424,100969,-32121,0,0,21443,0,0,,21443,21443
44,10/27/2018,28,6:45,7:00,46.91,32.46,0,32.46,32.46,-1,-55100,75083,130183,19983,0,-8868,2583,0,0,,11451,-6285
44,10/27/2018,29,7:00,7:15,,34.91,0,34.91,34.91,-1,-46436,69329,115765,22893,0,-26229,0,0,0,,26229,-26229
44,10/27/2018,30,7:15,7:30,50.91,40.47,0,50.91,40.47,2,-59866,49311,109177,-10555,0,-14658,1181,0,0,,15839,-13477
44,10/27/2018,31,7:30,7:45,75.96,40.47,0,75.96,75.96,1,-70543,23219,93762,-47324,0,-33,12002,0,0,,12035,11969
44,10/27/2018,32,7:45,8:00,54.91,34.91,0,34.91,34.91,-1,-79665,78382,158047,-1283,0,-1588,17025,0,0,,18613,15437
44,10/27/2018,33,8:00,8:15,54.91,12.2,0,12.2,12.2,-1,-40710,93615,134325,52905,0,-34337,311,0,0,,34648,-34026
44,10/27/2018,34,8:15,8:30,118,3.03,0,118,118,1,-108731,67263,175994,-41468,0,-27092,8762,0,0,,35854,-18330
44,10/27/2018,35,8:30,8:45,121.18,3.03,0,121.18,121.18,1,-84073,57282,141355,-26791,0,-16,21631,0,0,,21647,21615
44,10/27/2018,36,8:45,9:00,49.85,,0,49.85,49.85,1,-88939,65710,154649,-23229,0,0,9732,0,0,,9732,9732
44,10/27/2018,37,9:00,9:15,70.88,47.34,0,70.88,47.34,2,-90607,58787,149394,-31820,0,-37,6672,0,0,,6709,6635
44,10/27/2018,38,9:15,9:30,93.05,,0,93.05,93.05,1,-111606,48891,160497,-62715,0,0,50681,0,0,,50681,50681
44,10/27/2018,39,9:30,9:45,54.91,,0,54.91,54.91,1,-88598,41409,130007,-47189,0,0,41042,0,0,,41042,41042
44,10/27/2018,40,9:45,10:00,51.22,,0,51.22,51.22,1,-93355,57637,150992,-35718,0,0,28402,0,0,,28402,28402
44,10/27/2018,41,10:00,10:15,54.91,,0,54.91,54.91,1,-73592,42926,116518,-30666,0,0,16364,0,0,,16364,16364
44,10/27/2018,42,10:15,10:30,50.91,45.68,0,50.91,45.68,2,-84687,73764,158451,-10923,0,-203,12930,0,0,,13133,12727
44,10/27/2018,43,10:30,10:45,46.91,42.74,0,49.92,42.74,2,-75849,70010,145859,-5839,0,-3068,397,0,0,,3465,-2671
44,10/27/2018,44,10:45,11:00,46.91,43.76,0,49.92,43.76,2,-63852,66611,130463,2759,0,-1619,8,0,0,,1627,-1611
44,10/27/2018,45,11:00,11:15,50.91,43.99,0,50.91,50.91,1,-66395,47309,113704,-19086,0,-958,4510,0,0,,5468,3552
44,10/27/2018,46,11:15,11:30,54.91,,0,54.91,54.91,1,-89926,47668,137594,-42258,0,0,28229,0,0,,28229,28229
44,10/27/2018,47,11:30,11:45,53.43,,0,53.43,53.43,1,-93698,55679,149377,-38019,0,0,22411,0,0,,22411,22411
44,10/27/2018,48,11:45,12:00,50.91,,0,50.91,50.91,1,-97506,70821,168327,-26685,0,0,15607,0,0,,15607,15607
44,10/27/2018,49,12:00,12:15,55.88,,0,55.88,55.88,1,-98733,71493,170226,-27240,0,0,19966,0,0,,19966,19966
44,10/27/2018,50,12:15,12:30,55.88,42.22,0,42.22,42.22,-1,-40428,87241,127669,46813,0,-7333,4246,0,0,,11579,-3087
44,10/27/2018,51,12:30,12:45,,42.91,0,42.91,42.91,-1,-47922,88506,136428,40584,0,-6888,0,0,0,,6888,-6888
44,10/27/2018,52,12:45,13:00,,,0,47.94,47.94,0,-72147,89740,161887,17593,0,-57,0,0,0,,57,-57
44,10/27/2018,53,13:00,13:15,54.91,,0,54.91,54.91,1,-88063,55344,143407,-32719,0,0,11387,0,0,,11387,11387
44,10/27/2018,54,13:15,13:30,50.91,,0,50.91,50.91,1,-55559,61856,117415,6297,0,0,8854,0,0,,8854,8854
44,10/27/2018,55,13:30,13:45,,42.91,0,42.91,42.91,-1,-43998,85173,129171,41175,0,-5513,0,0,0,,5513,-5513
44,10/27/2018,56,13:45,14:00,,39.51,0,39.51,39.51,-1,-39732,72635,112367,32903,0,-3665,0,0,0,,3665,-3665
44,10/27/2018,57,14:00,14:15,,42.91,0,42.91,42.91,-1,-65596,60349,125945,-5247,0,-4431,0,0,0,,4431,-4431
44,10/27/2018,58,14:15,14:30,,47.25,0,47.25,47.25,-1,-69171,62303,131474,-6868,0,-991,0,0,0,,991,-991
44,10/27/2018,59,14:30,14:45,,45.38,0,45.38,45.38,-1,-54478,57863,112341,3385,0,-1466,0,0,0,,1466,-1466
44,10/27/2018,60,14:45,15:00,,42.91,0,42.91,42.91,-1,-55365,67603,122968,12238,0,-9799,0,0,0,,9799,-9799
44,10/27/2018,61,15:00,15:15,,42.91,0,42.91,42.91,-1,-57866,71249,129115,13383,0,-14881,0,0,0,,14881,-14881
44,10/27/2018,62,15:15,15:30,,44.73,0,44.73,44.73,-1,-61539,63168,124707,1629,0,-4724,0,0,0,,4724,-4724
44,10/27/2018,63,15:30,15:45,,44.91,0,44.91,44.91,-1,-52061,45336,97397,-6725,0,-2925,0,0,0,,2925,-2925
44,10/27/2018,64,15:45,16:00,,24.73,0,24.73,24.73,-1,-50539,80979,131518,30440,0,-12024,0,0,0,,12024,-12024
44,10/27/2018,65,16:00,16:15,,34.91,0,34.91,34.91,-1,-80626,95488,176114,14862,0,-13876,0,0,0,,13876,-13876
44,10/27/2018,66,16:15,16:30,,28.39,0,28.39,28.39,-1,-52343,68492,120835,16149,0,-33041,0,0,0,,33041,-33041
44,10/27/2018,67,16:30,16:45,54.91,28.39,0,54.91,54.91,1,-88128,40771,128899,-47357,0,-1324,20651,0,0,,21975,19327
44,10/27/2018,68,16:45,17:00,50.91,,0,50.91,50.91,1,-70246,32024,102270,-38222,0,0,22402,0,0,,22402,22402
44,10/27/2018,69,17:00,17:15,46.91,34.91,0,48.47,34.91,2,-64039,80818,144857,16779,0,-13686,3911,0,0,,17597,-9775
44,10/27/2018,70,17:15,17:30,54.91,46.94,0,54.91,54.91,1,-85557,47719,133276,-37838,0,-2162,5545,0,0,,7707,3383
44,10/27/2018,71,17:30,17:45,94.17,,0,94.17,94.17,1,-101726,32246,133972,-69480,0,0,39278,0,0,,39278,39278
44,10/27/2018,72,17:45,18:00,86.21,,0,86.21,86.21,1,-113415,23910,137325,-89505,0,0,67194,0,0,,67194,67194
44,10/27/2018,73,18:00,18:15,86.21,42.92,0,42.92,42.92,-1,-38786,44272,83058,5486,0,-1752,16430,0,0,,18182,14678
44,10/27/2018,74,18:15,18:30,,46.4,0,46.4,46.4,-1,-50282,55648,105930,5366,0,-517,0,0,0,,517,-517
44,10/27/2018,75,18:30,18:45,50.91,,0,50.91,50.91,1,-80663,52966,133629,-27697,0,0,2880,0,0,,2880,2880
44,10/27/2018,76,18:45,19:00,49.96,,0,49.96,49.96,1,-66121,50103,116224,-16018,0,0,2246,0,0,,2246,2246
44,10/27/2018,77,19:00,19:15,50.91,,0,50.91,50.91,1,-75674,28994,104668,-46680,0,0,2060,0,0,,2060,2060
44,10/27/2018,78,19:15,19:30,,45.64,0,45.64,45.64,-1,-58491,49920,108411,-8571,0,-59,0,0,0,,59,-59
44,10/27/2018,79,19:30,19:45,,38.91,0,38.91,38.91,-1,-35993,64003,99996,28010,0,-18360,0,0,0,,18360,-18360
44,10/27/2018,80,19:45,20:00,,34.91,0,34.91,34.91,-1,-42311,74352,116663,32041,0,-40397,0,0,0,,40397,-40397
44,10/27/2018,81,20:00,20:15,,42.91,0,42.91,42.91,-1,-52443,61374,113817,8931,0,-14454,0,0,0,,14454,-14454
44,10/27/2018,82,20:15,20:30,,34.91,0,34.91,34.91,-1,-30578,66967,97545,36389,0,-31337,0,0,0,,31337,-31337
44,10/27/2018,83,20:30,20:45,,11.03,0,11.03,11.03,-1,-23175,88466,111641,65291,0,-54669,0,0,0,,54669,-54669
44,10/27/2018,84,20:45,21:00,,34.91,0,34.91,34.91,-1,-45939,101243,147182,55304,0,-60493,0,0,0,,60493,-60493
44,10/27/2018,85,21:00,21:15,54.91,27.94,0,54.91,27.94,2,-45466,49317,94783,3851,0,-32697,2223,0,0,,34920,-30474
44,10/27/2018,86,21:15,21:30,54.91,-21.96,0,-21.96,-21.96,-1,-20764,84894,105658,64130,0,-39775,54,0,0,,39829,-39721
44,10/27/2018,87,21:30,21:45,,34.91,0,34.91,34.91,-1,-16662,58627,75289,41965,0,-46851,0,0,0,,46851,-46851
44,10/27/2018,88,21:45,22:00,,-14.01,0,-14.01,-14.01,-1,-20413,91637,112050,71224,0,-61608,0,0,0,,61608,-61608
44,10/27/2018,89,22:00,22:15,,21.18,0,21.18,21.18,-1,-65828,83215,149043,17387,0,-51945,0,0,0,,51945,-51945
44,10/27/2018,90,22:15,22:30,46.91,21.18,0,46.91,21.18,2,-46550,81877,128427,35327,0,-11531,226,0,0,,11757,-11305
44,10/27/2018,91,22:30,22:45,,-67.42,0,-67.42,-67.42,-1,-27307,70981,98288,43674,0,-36792,0,0,0,,36792,-36792
44,10/27/2018,92,22:45,23:00,,34.03,0,34.03,34.03,-1,-48978,83007,131985,34029,0,-34867,0,0,0,,34867,-34867
44,10/27/2018,93,23:00,23:15,,33.03,0,33.03,33.03,-1,-73305,98616,171921,25311,0,-39319,0,0,0,,39319,-39319
44,10/27/2018,94,23:15,23:30,53.45,38.91,0,53.45,38.91,2,-81018,79817,160835,-1201,0,-4510,2097,0,0,,6607,-2413
44,10/27/2018,95,23:30,23:45,,21.18,0,21.18,21.18,-1,-36581,69448,106029,32867,0,-30552,0,0,0,,30552,-30552
44,10/27/2018,96,23:45,0:00,,34.91,0,34.91,34.91,-1,-51064,72173,123237,21109,0,-29806,0,0,0,,29806,-29806
44,10/28/2018,1,0:00,0:15,47.74,43.72,0,47.74,47.74,1,-57117,50142,107259,-6975,0,-9000,459,0,0,,9459,-8541
44,10/28/2018,2,0:15,0:30,46.5,43.7,0,46.5,43.41,2,-47582,49074,96656,1492,0,-50,836,0,0,,886,786
44,10/28/2018,3,0:30,0:45,,43.54,0,43.54,43.54,-1,-77159,69829,146988,-7330,0,-953,0,0,0,,953,-953
44,10/28/2018,4,0:45,1:00,,35.68,0,35.68,35.68,-1,-62942,82146,145088,19204,0,-15661,0,0,0,,15661,-15661
44,10/28/2018,5,1:00,1:15,,38.15,0,38.15,38.15,-1,-43730,63955,107685,20225,0,-22929,0,0,0,,22929,-22929
44,10/28/2018,6,1:15,1:30,,39.22,0,39.22,39.22,-1,-41700,36213,77913,-5487,0,-14364,0,0,0,,14364,-14364
44,10/28/2018,7,1:30,1:45,47.54,35.68,0,47.54,35.68,2,-50828,54955,105783,4127,0,-1456,380,0,0,,1836,-1076
44,10/28/2018,8,1:45,2:00,,14.78,0,14.78,14.78,-1,-38374,81153,119527,42779,0,-37786,0,0,0,,37786,-37786
44,10/28/2018,9,2:00,2:15,,36.02,0,36.02,36.02,-1,-62308,93478,155786,31170,0,-35935,0,0,0,,35935,-35935
44,10/28/2018,10,2:15,2:30,51.54,46.69,0,51.54,46.69,2,-93630,75787,169417,-17843,0,-3075,3813,0,0,,6888,738
44,10/28/2018,11,2:30,2:45,51.54,39.54,0,39.54,39.54,-1,-73857,91372,165229,17515,0,-10401,9,0,0,,10410,-10392
44,10/28/2018,12,2:45,2:00,,39.19,0,39.19,39.19,-1,-62363,87241,149604,24878,0,-21758,0,0,0,,21758,-21758
44,10/28/2018,13,2:00,2:15,,38.82,0,38.82,38.82,-1,-79114,90258,169372,11144,0,-19937,0,0,0,,19937,-19937
44,10/28/2018,14,2:15,2:30,,39.54,0,39.54,39.54,-1,-80087,100654,180741,20567,0,-18515,0,0,0,,18515,-18515
44,10/28/2018,15,2:30,2:45,,36.02,0,36.02,36.02,-1,-68341,103319,171660,34978,0,-26852,0,0,0,,26852,-26852
44,10/28/2018,16,2:45,3:00,,34.78,0,34.78,34.78,-1,-65254,116784,182038,51530,0,-43929,0,0,0,,43929,-43929
44,10/28/2018,17,3:00,3:15,,34.78,0,34.78,34.78,-1,-68665,97989,166654,29324,0,-24864,0,0,0,,24864,-24864
44,10/28/2018,18,3:15,3:30,,43.54,0,43.54,43.54,-1,-75966,83952,159918,7986,0,-1533,0,0,0,,1533,-1533
44,10/28/2018,19,3:30,3:45,51.54,,0,51.54,51.54,1,-89482,69441,158923,-20041,0,0,6505,0,0,,6505,6505
44,10/28/2018,20,3:45,4:00,47.54,39.54,0,39.54,39.54,-1,-74696,80961,155657,6265,0,-4318,5611,0,0,,9929,1293
44,10/28/2018,21,4:00,4:15,,36.02,0,36.02,36.02,-1,-55492,80221,135713,24729,0,-23819,0,0,0,,23819,-23819
44,10/28/2018,22,4:15,4:30,,39.2,0,39.2,39.2,-1,-62683,65351,128034,2668,0,-16956,0,0,0,,16956,-16956
44,10/28/2018,23,4:30,4:45,45.01,39.2,0,45.01,45.01,1,-79385,75644,155029,-3741,0,-830,542,0,0,,1372,-288
44,10/28/2018,24,4:45,5:00,,19.78,0,19.78,19.78,-1,-52905,93511,146416,40606,0,-16512,0,0,0,,16512,-16512
44,10/28/2018,25,5:00,5:15,,6.27,0,6.27,6.27,-1,-38787,116314,155101,77527,0,-69640,0,0,0,,69640,-69640
44,10/28/2018,26,5:15,5:30,,21.16,0,21.16,21.16,-1,-43380,94058,137438,50678,0,-69819,0,0,0,,69819,-69819
44,10/28/2018,27,5:30,5:45,,36.02,0,36.02,36.02,-1,-51117,70785,121902,19668,0,-30083,0,0,0,,30083,-30083
44,10/28/2018,28,5:45,6:00,,43.54,0,43.54,43.54,-1,-68382,64779,133161,-3603,0,-15736,0,0,0,,15736,-15736
44,10/28/2018,29,6:00,6:15,,42.02,0,42.02,42.02,-1,-60880,65794,126674,4914,0,-3647,0,0,0,,3647,-3647
44,10/28/2018,30,6:15,6:30,,39.22,0,39.22,39.22,-1,-61041,75973,137014,14932,0,-16574,0,0,0,,16574,-16574
44,10/28/2018,31,6:30,6:45,50.32,39.22,0,50.32,50.32,1,-75985,67512,143497,-8473,0,-2640,2386,0,0,,5026,-254
44,10/28/2018,32,6:45,7:00,47.82,,0,47.82,47.82,1,-81225,75969,157194,-5256,0,0,2422,0,0,,2422,2422
44,10/28/2018,33,7:00,7:15,43.12,42.45,0,43.12,23.48,2,-57306,73396,130702,16090,0,-8200,88,0,0,,8288,-8112
44,10/28/2018,34,7:15,7:30,,43.22,0,43.22,43.22,-1,-40712,55521,96233,14809,0,-12169,0,0,0,,12169,-12169
44,10/28/2018,35,7:30,7:45,51.22,43.22,0,51.22,51.22,1,-37027,25259,62286,-11768,0,-6690,1572,0,0,,8262,-5118
44,10/28/2018,36,7:45,8:00,61.81,,0,61.81,61.81,1,-68808,26320,95128,-42488,0,0,29440,0,0,,29440,29440
44,10/28/2018,37,8:00,8:15,55.23,,0,55.23,55.23,1,-74257,53542,127799,-20715,0,0,10080,0,0,,10080,10080
44,10/28/2018,38,8:15,8:30,70.3,,0,70.3,70.3,1,-79208,28409,107617,-50799,0,0,36492,0,0,,36492,36492
44,10/28/2018,39,8:30,8:45,55.32,,0,55.32,55.32,1,-91530,38136,129666,-53394,0,0,48898,0,0,,48898,48898
44,10/28/2018,40,8:45,9:00,59.68,,0,59.68,59.68,1,-94138,41998,136136,-52140,0,0,50195,0,0,,50195,50195
44,10/28/2018,41,9:00,9:15,59.68,44.22,0,44.22,44.22,-1,-57119,80515,137634,23396,0,-2419,13942,0,0,,16361,11523
44,10/28/2018,42,9:15,9:30,,45.64,0,45.64,45.64,-1,-49514,97229,146743,47715,0,-1394,0,0,0,,1394,-1394
44,10/28/2018,43,9:30,9:45,,35.23,0,35.23,35.23,-1,-49574,116224,165798,66650,0,-15444,0,0,0,,15444,-15444
44,10/28/2018,44,9:45,10:00,,35.23,0,35.23,35.23,-1,-58022,133007,191029,74985,0,-24625,0,0,0,,24625,-24625
44,10/28/2018,45,10:00,10:15,,20.3,0,20.3,20.3,-1,-46361,152400,198761,106039,0,-40273,0,0,0,,40273,-40273
44,10/28/2018,46,10:15,10:30,,19.49,0,19.49,19.49,-1,-32821,152943,185764,120122,0,-64723,0,0,0,,64723,-64723
44,10/28/2018,47,10:30,10:45,,-119.93,0,-119.93,-119.93,-1,-23209,175930,199139,152721,0,-86770,0,0,0,,86770,-86770
44,10/28/2018,48,10:45,11:00,,11,0,11,11,-1,-16302,169162,185464,152860,0,-100150,0,0,0,,100150,-100150
44,10/28/2018,49,11:00,11:15,,-76.35,0,-76.35,-76.35,-1,-11762,138150,149912,126388,0,-101093,0,0,0,,101093,-101093
44,10/28/2018,50,11:15,11:30,,-76.35,0,-76.35,-76.35,-1,-19953,149662,169615,129709,0,-106044,0,0,0,,106044,-106044
44,10/28/2018,51,11:30,11:45,,-11.43,0,-11.43,-11.43,-1,-21463,144956,166419,123493,0,-105223,0,0,0,,105223,-105223
44,10/28/2018,52,11:45,12:00,,20.3,0,20.3,20.3,-1,-27487,127224,154711,99737,0,-92470,0,0,0,,92470,-92470
44,10/28/2018,53,12:00,12:15,,20.3,0,20.3,20.3,-1,-35765,120011,155776,84246,0,-82822,0,0,0,,82822,-82822
44,10/28/2018,54,12:15,12:30,,20.3,0,20.3,20.3,-1,-34507,118966,153473,84459,0,-80893,0,0,0,,80893,-80893
44,10/28/2018,55,12:30,12:45,,-12.38,0,-12.38,-12.38,-1,-33858,127229,161087,93371,0,-95672,0,0,0,,95672,-95672
44,10/28/2018,56,12:45,13:00,,13.55,0,13.55,13.55,-1,-27464,131721,159185,104257,0,-96871,0,0,0,,96871,-96871
44,10/28/2018,57,13:00,13:15,,11.05,0,11.05,11.05,-1,-37208,124649,161857,87441,0,-92043,0,0,0,,92043,-92043
44,10/28/2018,58,13:15,13:30,,20.3,0,20.3,20.3,-1,-47706,131879,179585,84173,0,-85796,0,0,0,,85796,-85796
44,10/28/2018,59,13:30,13:45,,30.71,0,30.71,30.71,-1,-54133,127602,181735,73469,0,-77435,0,0,0,,77435,-77435
44,10/28/2018,60,13:45,14:00,,20.3,0,20.3,20.3,-1,-58261,127936,186197,69675,0,-82511,0,0,0,,82511,-82511
44,10/28/2018,61,14:00,14:15,,34.78,0,34.78,34.78,-1,-72834,91951,164785,19117,0,-31978,0,0,0,,31978,-31978
44,10/28/2018,62,14:15,14:30,,35.23,0,35.23,35.23,-1,-72848,92319,165167,19471,0,-4765,0,0,0,,4765,-4765
44,10/28/2018,63,14:30,14:45,,26.45,0,26.45,26.45,-1,-45408,92317,137725,46909,0,-40754,0,0,0,,40754,-40754
44,10/28/2018,64,14:45,15:00,,35.23,0,35.23,35.23,-1,-38177,71510,109687,33333,0,-37743,0,0,0,,37743,-37743
44,10/28/2018,65,15:00,15:15,,20.3,0,20.3,20.3,-1,-29733,112655,142388,82922,0,-58637,0,0,0,,58637,-58637
44,10/28/2018,66,15:15,15:30,,34.25,0,34.25,34.25,-1,-30250,60423,90673,30173,0,-49070,0,0,0,,49070,-49070
44,10/28/2018,67,15:30,15:45,47.81,50.29,0,47.81,46.71,2,-49426,38503,87929,-10923,0,-4961,419,0,0,,5380,-4542
44,10/28/2018,68,15:45,16:00,53.83,,0,53.83,53.83,1,-67774,31097,98871,-36677,0,0,10406,0,0,,10406,10406
44,10/28/2018,69,16:00,16:15,50.32,,0,50.32,50.32,1,-97178,95446,192624,-1732,0,0,5191,0,0,,5191,5191
44,10/28/2018,70,16:15,16:30,54.99,,0,54.99,54.99,1,-93969,75704,169673,-18265,0,0,3103,0,0,,3103,3103
44,10/28/2018,71,16:30,16:45,74.22,,0,74.22,74.22,1,-112419,44438,156857,-67981,0,0,46042,0,0,,46042,46042
44,10/28/2018,72,16:45,17:00,72.82,,0,72.82,72.82,1,-147006,61508,208514,-85498,0,0,69431,0,0,,69431,69431
44,10/28/2018,73,17:00,17:15,70.18,36.67,0,70.18,36.67,2,-67097,145821,212918,78724,0,-5868,34994,0,0,,40862,29126
44,10/28/2018,74,17:15,17:30,,,0,47.34,47.34,0,-52011,125583,177594,73572,0,-35,0,0,0,,35,-35
44,10/28/2018,75,17:30,17:45,124.87,,0,124.87,124.87,1,-145940,87666,233606,-58274,0,0,22386,0,0,,22386,22386
44,10/28/2018,76,17:45,18:00,70.18,,0,70.18,70.18,1,-132680,101549,234229,-31131,0,0,54101,0,0,,54101,54101
44,10/28/2018,77,18:00,18:15,67.95,,0,67.95,67.95,1,-133423,56270,189693,-77153,0,0,40305,0,0,,40305,40305
44,10/28/2018,78,18:15,18:30,58.12,,0,58.12,58.12,1,-108410,61790,170200,-46620,0,0,41327,0,0,,41327,41327
44,10/28/2018,79,18:30,18:45,53.47,,0,53.47,53.47,1,-96474,84437,180911,-12037,0,0,14558,0,0,,14558,14558
44,10/28/2018,80,18:45,19:00,53.47,35.23,0,35.23,35.23,-1,-59097,104438,163535,45341,0,-12945,404,0,0,,13349,-12541
44,10/28/2018,81,19:00,19:15,,39.22,0,39.22,39.22,-1,-54665,82218,136883,27553,0,-30596,0,0,0,,30596,-30596
44,10/28/2018,82,19:15,19:30,,35.23,0,35.23,35.23,-1,-45755,90238,135993,44483,0,-35737,0,0,0,,35737,-35737
44,10/28/2018,83,19:30,19:45,,20.3,0,20.3,20.3,-1,-40001,108666,148667,68665,0,-52958,0,0,0,,52958,-52958
44,10/28/2018,84,19:45,20:00,,35.23,0,35.23,35.23,-1,-63001,101884,164885,38883,0,-43845,0,0,0,,43845,-43845
44,10/28/2018,85,20:00,20:15,,35.23,0,35.23,35.23,-1,-101778,147384,249162,45606,0,-26991,0,0,0,,26991,-26991
44,10/28/2018,86,20:15,20:30,,20.3,0,20.3,20.3,-1,-72192,145133,217325,72941,0,-59715,0,0,0,,59715,-59715
44,10/28/2018,87,20:30,20:45,,-29.7,0,-29.7,-29.7,-1,-49546,160028,209574,110482,0,-87588,0,0,0,,87588,-87588
44,10/28/2018,88,20:45,21:00,,-29.7,0,-29.7,-29.7,-1,-67502,129782,197284,62280,0,-78407,0,0,0,,78407,-78407
44,10/28/2018,89,21:00,21:15,,34.78,0,34.78,34.78,-1,-67807,143611,211418,75804,0,-59890,0,0,0,,59890,-59890
44,10/28/2018,90,21:15,21:30,,27.65,0,27.65,27.65,-1,-60604,133068,193672,72464,0,-70298,0,0,0,,70298,-70298
44,10/28/2018,91,21:30,21:45,,22.25,0,22.25,22.25,-1,-54780,138352,193132,83572,0,-76657,0,0,0,,76657,-76657
44,10/28/2018,92,21:45,22:00,,32.72,0,32.72,32.72,-1,-93138,143748,236886,50610,0,-71072,0,0,0,,71072,-71072
44,10/28/2018,93,22:00,22:15,48.37,32.72,0,48.37,48.37,1,-64287,35806,100093,-28481,0,-11186,709,0,0,,11895,-10477
44,10/28/2018,94,22:15,22:30,,34.78,0,34.78,34.78,-1,-39013,75496,114509,36483,0,-15391,0,0,0,,15391,-15391
44,10/28/2018,95,22:30,22:45,,20.3,0,20.3,20.3,-1,-29684,96910,126594,67226,0,-54364,0,0,0,,54364,-54364
44,10/28/2018,96,22:45,23:00,,20.42,0,20.42,20.42,-1,-47274,129125,176399,81851,0,-71465,0,0,0,,71465,-71465
44,10/28/2018,97,23:00,23:15,,20.3,0,20.3,20.3,-1,-64816,79846,144662,15030,0,-39878,0,0,0,,39878,-39878
44,10/28/2018,98,23:15,23:30,,-6.93,0,-6.93,-6.93,-1,-53188,103877,157065,50689,0,-36996,0,0,0,,36996,-36996
44,10/28/2018,99,23:30,23:45,,-6.83,0,-6.83,-6.83,-1,-49452,130935,180387,81483,0,-74523,0,0,0,,74523,-74523
44,10/28/2018,100,23:45,0:00,,-29.7,0,-29.7,-29.7,-1,-52904,120701,173605,67797,0,-84606,0,0,0,,84606,-84606
44,10/29/2018,1,0:00,0:15,,-82.8,0,-82.8,-82.8,-1,-98911,139846,238757,40935,0,-90173,0,0,0,,90173,-90173
44,10/29/2018,2,0:15,0:30,,20.3,0,20.3,20.3,-1,-85274,114655,199929,29381,0,-63529,0,0,0,,63529,-63529
44,10/29/2018,3,0:30,0:45,,35.23,0,35.23,35.23,-1,-81540,114655,196195,33115,0,-39186,0,0,0,,39186,-39186
44,10/29/2018,4,0:45,1:00,,42.26,0,42.26,42.26,-1,-90822,108183,199005,17361,0,-18887,0,0,0,,18887,-18887
44,10/29/2018,5,1:00,1:15,69.61,42.32,0,69.61,69.61,1,-121353,80086,201439,-41267,0,-5762,10897,0,0,,16659,5135
44,10/29/2018,6,1:15,1:30,55.23,,0,55.23,55.23,1,-102127,74991,177118,-27136,0,0,16170,0,0,,16170,16170
44,10/29/2018,7,1:30,1:45,52.78,,0,52.78,52.78,1,-89104,70413,159517,-18691,0,0,4580,0,0,,4580,4580
44,10/29/2018,8,1:45,2:00,49.66,,0,49.66,49.66,1,-95784,73076,168860,-22708,0,0,12705,0,0,,12705,12705
44,10/29/2018,9,2:00,2:15,49.66,44.67,0,44.67,44.67,-1,-97451,99820,197271,2369,0,-624,3254,0,0,,3878,2630
44,10/29/2018,10,2:15,2:30,,39.22,0,39.22,39.22,-1,-81364,96116,177480,14752,0,-12266,0,0,0,,12266,-12266
44,10/29/2018,11,2:30,2:45,,34.03,0,34.03,34.03,-1,-64837,101182,166019,36345,0,-27743,0,0,0,,27743,-27743
44,10/29/2018,12,2:45,3:00,,34.03,0,34.03,34.03,-1,-78010,110281,188291,32271,0,-34707,0,0,0,,34707,-34707
44,10/29/2018,13,3:00,3:15,,38.13,0,38.13,38.13,-1,-92445,119731,212176,27286,0,-21990,0,0,0,,21990,-21990
44,10/29/2018,14,3:15,3:30,,43.22,0,43.22,43.22,-1,-103751,123549,227300,19798,0,-7310,0,0,0,,7310,-7310
44,10/29/2018,15,3:30,3:45,,49.38,0,49.38,49.38,-1,-127110,127022,254132,-88,0,-726,0,0,0,,726,-726
44,10/29/2018,16,3:45,4:00,47.71,,0,47.71,47.71,1,-135664,121317,256981,-14347,0,0,608,0,0,,608,608
44,10/29/2018,17,4:00,4:15,,39.22,0,39.22,39.22,-1,-113097,127020,240117,13923,0,-11608,0,0,0,,11608,-11608
44,10/29/2018,18,4:15,4:30,53.37,49.47,0,53.37,46.25,2,-125471,101601,227072,-23870,0,-2338,3715,0,0,,6053,1377
44,10/29/2018,19,4:30,4:45,53.07,,0,53.07,53.07,1,-129635,101583,231218,-28052,0,0,19600,0,0,,19600,19600
44,10/29/2018,20,4:45,5:00,47.22,20.3,0,20.3,20.3,-1,-93519,123312,216831,29793,0,-16253,5210,0,0,,21463,-11043
44,10/29/2018,21,5:00,5:15,,24.23,0,24.23,24.23,-1,-91323,108282,199605,16959,0,-29993,0,0,0,,29993,-29993
44,10/29/2018,22,5:15,5:30,55.87,45.05,0,55.87,55.87,1,-123006,90990,213996,-32016,0,-4734,3516,0,0,,8250,-1218
44,10/29/2018,23,5:30,5:45,67.09,,0,67.09,67.09,1,-150453,113101,263554,-37352,0,0,30902,0,0,,30902,30902
44,10/29/2018,24,5:45,6:00,55.23,,0,55.23,55.23,1,-153888,113136,267024,-40752,0,0,21788,0,0,,21788,21788
44,10/29/2018,25,6:00,6:15,51.24,43.37,0,51.24,43.37,2,-129373,153139,282512,23766,0,-10449,8071,0,0,,18520,-2378
44,10/29/2018,26,6:15,6:30,,43.21,0,43.21,43.21,-1,-104612,113699,218311,9087,0,-16155,0,0,0,,16155,-16155
44,10/29/2018,27,6:30,6:45,51.6,43.21,0,51.6,51.6,1,-116095,96973,213068,-19122,0,-11,1158,0,0,,1169,1147
44,10/29/2018,28,6:45,7:00,55.29,,0,55.29,55.29,1,-153179,110819,263998,-42360,0,0,17787,0,0,,17787,17787
44,10/29/2018,29,7:00,7:15,51.24,,0,51.24,51.24,1,-114949,82324,197273,-32625,0,0,12788,0,0,,12788,12788
44,10/29/2018,30,7:15,7:30,51.24,42.66,0,42.66,42.66,-1,-79072,94206,173278,15134,0,-13596,386,0,0,,13982,-13210
44,10/29/2018,31,7:30,7:45,72.58,39.21,0,72.58,39.21,2,-89550,74555,164105,-14995,0,-14982,1314,0,0,,16296,-13668
44,10/29/2018,32,7:45,8:00,162.89,39.21,0,162.89,162.89,1,-140636,57569,198205,-83067,0,-137,56340,0,0,,56477,56203
44,10/29/2018,33,8:00,8:15,72.58,38.06,0,38.06,38.06,-1,-79803,52918,132721,-26885,0,-777,42288,0,0,,43065,41511
44,10/29/2018,34,8:15,8:30,65.02,29.39,0,65.02,29.39,2,-70119,45122,115241,-24997,0,-6651,5414,0,0,,12065,-1237
44,10/29/2018,35,8:30,8:45,72.56,,0,72.56,72.56,1,-100274,38620,138894,-61654,0,0,35484,0,0,,35484,35484
44,10/29/2018,36,8:45,9:00,122.79,,0,122.79,122.79,1,-137607,22076,159683,-115531,0,0,89487,0,0,,89487,89487
44,10/29/2018,37,9:00,9:15,122.79,,0,122.79,122.79,1,-140582,45479,186061,-95103,0,0,88040,0,0,,88040,88040
44,10/29/2018,38,9:15,9:30,153.2,,0,153.2,153.2,1,-148454,32370,180824,-116084,0,0,76653,0,0,,76653,76653
44,10/29/2018,39,9:30,9:45,140.2,,0,140.2,140.2,1,-164999,20401,185400,-144598,0,0,112410,0,0,,112410,112410
44,10/29/2018,40,9:45,10:00,153.2,,0,153.2,153.2,1,-163187,20679,183866,-142508,0,0,120254,0,0,,120254,120254
44,10/29/2018,41,10:00,10:15,153.2,,0,153.2,153.2,1,-217665,21276,238941,-196389,0,0,128664,0,0,,128664,128664
44,10/29/2018,42,10:15,10:30,450,,0,450,450,1,-179264,34866,214130,-144398,0,0,121021,5000,0,,126021,126021
44,10/29/2018,43,10:30,10:45,358.34,,0,358.34,358.34,1,-151009,68431,219440,-82578,0,0,37315,5000,0,,42315,42315
44,10/29/2018,44,10:45,11:00,122.79,,0,122.79,122.79,1,-167321,67704,235025,-99617,0,0,61794,0,0,,61794,61794
44,10/29/2018,45,11:00,11:15,99.9,,0,99.9,99.9,1,-150613,63272,213885,-87341,0,0,67888,0,0,,67888,67888
44,10/29/2018,46,11:15,11:30,153.2,,0,153.2,153.2,1,-186460,49886,236346,-136574,0,0,119061,0,0,,119061,119061
44,10/29/2018,47,11:30,11:45,355.25,,0,355.25,355.25,1,-174618,64870,239488,-109748,0,0,114372,5000,0,,119372,119372
44,10/29/2018,48,11:45,12:00,122.79,,0,122.79,122.79,1,-171809,65264,237073,-106545,0,0,77106,0,0,,77106,77106
44,10/29/2018,49,12:00,12:15,153.2,,0,153.2,153.2,1,-176733,61503,238236,-115230,0,0,112613,0,0,,112613,112613
44,10/29/2018,50,12:15,12:30,354.08,,0,354.08,354.08,1,-158003,58801,216804,-99202,0,0,83910,5000,0,,88910,88910
44,10/29/2018,51,12:30,12:45,81.44,,0,81.44,81.44,1,-149055,67318,216373,-81737,0,0,53116,0,0,,53116,53116
44,10/29/2018,52,12:45,13:00,115.2,,0,115.2,115.2,1,-171214,43484,214698,-127730,0,0,84836,0,0,,84836,84836
44,10/29/2018,53,13:00,13:15,80.02,,0,80.02,80.02,1,-164821,65774,230595,-99047,0,0,84348,0,0,,84348,84348
44,10/29/2018,54,13:15,13:30,181.92,,0,181.92,181.92,1,-192711,43825,236536,-148886,0,0,113653,0,0,,113653,113653
44,10/29/2018,55,13:30,13:45,148.09,,0,148.09,148.09,1,-184903,42914,227817,-141989,0,0,115882,0,0,,115882,115882
44,10/29/2018,56,13:45,14:00,109.39,,0,109.39,109.39,1,-179556,46328,225884,-133228,0,0,107794,0,0,,107794,107794
44,10/29/2018,57,14:00,14:15,113.2,,0,113.2,113.2,1,-185249,71001,256250,-114248,0,0,98825,0,0,,98825,98825
44,10/29/2018,58,14:15,14:30,76.55,,0,76.55,76.55,1,-176045,75076,251121,-100969,0,0,83942,0,0,,83942,83942
44,10/29/2018,59,14:30,14:45,72.7,,0,72.7,72.7,1,-170801,82246,253047,-88555,0,0,65082,0,0,,65082,65082
44,10/29/2018,60,14:45,15:00,57.63,,0,57.63,57.63,1,-170270,78624,248894,-91646,0,0,53218,0,0,,53218,53218
44,10/29/2018,61,15:00,15:15,153.2,,0,153.2,153.2,1,-178104,60225,238329,-117879,0,0,74188,0,0,,74188,74188
44,10/29/2018,62,15:15,15:30,99.33,,0,99.33,99.33,1,-142643,90693,233336,-51950,0,0,58166,0,0,,58166,58166
44,10/29/2018,63,15:30,15:45,99.33,,0,99.33,99.33,1,-155436,77095,232531,-78341,0,0,55925,0,0,,55925,55925
44,10/29/2018,64,15:45,16:00,59.95,,0,59.95,59.95,1,-158869,77576,236445,-81293,0,0,64252,0,0,,64252,64252
44,10/29/2018,65,16:00,16:15,72.7,,0,72.7,72.7,1,-146061,93570,239631,-52491,0,0,42570,0,0,,42570,42570
44,10/29/2018,66,16:15,16:30,72.7,,0,72.7,72.7,1,-139247,82308,221555,-56939,0,0,38088,0,0,,38088,38088
44,10/29/2018,67,16:30,16:45,55.12,,0,55.12,55.12,1,-112572,79046,191618,-33526,0,0,30032,0,0,,30032,30032
44,10/29/2018,68,16:45,17:00,53.12,,0,53.12,53.12,1,-121767,84739,206506,-37028,0,0,16215,0,0,,16215,16215
44,10/29/2018,69,17:00,17:15,71.62,,0,71.62,71.62,1,-125665,67309,192974,-58356,0,0,24695,0,0,,24695,24695
44,10/29/2018,70,17:15,17:30,73.51,,0,73.51,73.51,1,-129547,60738,190285,-68809,0,0,48942,0,0,,48942,48942
44,10/29/2018,71,17:30,17:45,73.51,,0,73.51,73.51,1,-114688,59916,174604,-54772,0,0,46571,0,0,,46571,46571
44,10/29/2018,72,17:45,18:00,58.32,,0,58.32,58.32,1,-88826,60186,149012,-28640,0,0,27174,0,0,,27174,27174
44,10/29/2018,73,18:00,18:15,58.32,20.43,0,20.43,20.43,-1,-91605,116889,208494,25284,0,-12699,3588,0,0,,16287,-9111
44,10/29/2018,74,18:15,18:30,,20.43,0,20.43,20.43,-1,-74632,90308,164940,15676,0,-36245,0,0,0,,36245,-36245
44,10/29/2018,75,18:30,18:45,,-15.16,0,-15.16,-15.16,-1,-52149,115886,168035,63737,0,-32133,0,0,0,,32133,-32133
44,10/29/2018,76,18:45,19:00,,20.43,0,20.43,20.43,-1,-60091,117171,177262,57080,0,-51857,0,0,0,,51857,-51857
44,10/29/2018,77,19:00,19:15,,8.41,0,8.41,8.41,-1,-64449,99161,163610,34712,0,-51339,0,0,0,,51339,-51339
44,10/29/2018,78,19:15,19:30,,29.2,0,29.2,29.2,-1,-55554,90085,145639,34531,0,-21569,0,0,0,,21569,-21569
44,10/29/2018,79,19:30,19:45,,20.43,0,20.43,20.43,-1,-34545,97912,132457,63367,0,-60492,0,0,0,,60492,-60492
44,10/29/2018,80,19:45,20:00,,22.44,0,22.44,22.44,-1,-56849,70000,126849,13151,0,-31125,0,0,0,,31125,-31125
44,10/29/2018,81,20:00,20:15,,39.21,0,39.21,39.21,-1,-76283,64432,140715,-11851,0,-2483,0,0,0,,2483,-2483
44,10/29/2018,82,20:15,20:30,,39.21,0,39.21,39.21,-1,-68767,73361,142128,4594,0,-7979,0,0,0,,7979,-7979
44,10/29/2018,83,20:30,20:45,,35.3,0,35.3,35.3,-1,-62287,83654,145941,21367,0,-14783,0,0,0,,14783,-14783
44,10/29/2018,84,20:45,21:00,,39.21,0,39.21,39.21,-1,-76740,72869,149609,-3871,0,-13560,0,0,0,,13560,-13560
44,10/29/2018,85,21:00,21:15,79.62,45.38,0,79.62,30.45,2,-122480,63610,186090,-58870,0,-293,17679,0,0,,17972,17386
44,10/29/2018,86,21:15,21:30,229.2,40.21,0,229.2,40.21,2,-105651,68802,174453,-36849,0,-55,55412,0,0,,55467,55357
44,10/29/2018,87,21:30,21:45,229.2,20.43,0,20.43,20.43,-1,-46206,82485,128691,36279,0,-29388,1000,0,0,,30388,-28388
44,10/29/2018,88,21:45,22:00,,35.3,0,35.3,35.3,-1,-48304,65083,113387,16779,0,-18188,0,0,0,,18188,-18188
44,10/29/2018,89,22:00,22:15,52.65,14.05,0,52.65,14.05,2,-70424,84686,155110,14262,0,-21062,1598,0,0,,22660,-19464
44,10/29/2018,90,22:15,22:30,53.21,39.21,0,53.21,30.35,2,-81262,76515,157777,-4747,0,-645,10792,0,0,,11437,10147
44,10/29/2018,91,22:30,22:45,53.21,20.43,0,20.43,20.43,-1,-48048,83404,131452,35356,0,-31088,29,0,0,,31117,-31059
44,10/29/2018,92,22:45,23:00,,35.34,0,35.34,35.34,-1,-38463,73326,111789,34863,0,-29198,0,0,0,,29198,-29198
44,10/29/2018,93,23:00,23:15,,39.21,0,39.21,39.21,-1,-49335,60077,109412,10742,0,-13552,0,0,0,,13552,-13552
44,10/29/2018,94,23:15,23:30,,20.43,0,20.43,20.43,-1,-30703,73382,104085,42679,0,-38596,0,0,0,,38596,-38596
44,10/29/2018,95,23:30,23:45,,2.44,0,2.44,2.44,-1,-18727,99776,118503,81049,0,-66923,0,0,0,,66923,-66923
44,10/29/2018,96,23:45,0:00,,-5.19,0,-5.19,-5.19,-1,-15163,121389,136552,106226,0,-96640,0,0,0,,96640,-96640
44,10/30/2018,1,0:00,0:15,,-144.1,0,-144.1,-144.1,-1,-55384,114451,169835,59067,0,-66240,0,0,0,,66240,-66240
44,10/30/2018,2,0:15,0:30,,20.43,0,20.43,20.43,-1,-28653,102959,131612,74306,0,-55957,0,0,0,,55957,-55957
44,10/30/2018,3,0:30,0:45,,20.43,0,20.43,20.43,-1,-27584,87344,114928,59760,0,-55688,0,0,0,,55688,-55688
44,10/30/2018,4,0:45,1:00,,15.33,0,15.33,15.33,-1,-25025,103119,128144,78094,0,-76007,0,0,0,,76007,-76007
44,10/30/2018,5,1:00,1:15,,20.43,0,20.43,20.43,-1,-72714,103991,176705,31277,0,-58927,0,0,0,,58927,-58927
44,10/30/2018,6,1:15,1:30,48.99,20.43,0,48.99,48.99,1,-73191,60926,134117,-12265,0,-3700,1506,0,0,,5206,-2194
44,10/30/2018,7,1:30,1:45,51.21,,0,51.21,51.21,1,-74315,55751,130066,-18564,0,0,2048,0,0,,2048,2048
44,10/30/2018,8,1:45,2:00,47.21,42.01,0,42.01,42.01,-1,-78604,77698,156302,-906,0,-1585,2649,0,0,,4234,1064
44,10/30/2018,9,2:00,2:15,56.9,43.21,0,56.9,43.21,2,-78574,39453,118027,-39121,0,-1725,14819,0,0,,16544,13094
44,10/30/2018,10,2:15,2:30,52.13,,0,52.13,52.13,1,-80261,38537,118798,-41724,0,0,28654,0,0,,28654,28654
44,10/30/2018,11,2:30,2:45,51.21,,0,51.21,51.21,1,-69232,46608,115840,-22624,0,0,21352,0,0,,21352,21352
44,10/30/2018,12,2:45,3:00,51.21,47.26,0,47.26,47.26,-1,-60547,74924,135471,14377,0,-1020,3680,0,0,,4700,2660
44,10/30/2018,13,3:00,3:15,,35.24,0,35.24,35.24,-1,-42686,68432,111118,25746,0,-14887,0,0,0,,14887,-14887
44,10/30/2018,14,3:15,3:30,,39.21,0,39.21,39.21,-1,-47610,55696,103306,8086,0,-17543,0,0,0,,17543,-17543
44,10/30/2018,15,3:30,3:45,48.92,39.21,0,48.92,48.92,1,-64249,46503,110752,-17746,0,-511,5950,0,0,,6461,5439
44,10/30/2018,16,3:45,4:00,47.25,,0,47.25,47.25,1,-78866,69995,148861,-8871,0,0,1518,0,0,,1518,1518
44,10/30/2018,17,4:00,4:15,53.59,,0,53.59,53.59,1,-90789,58575,149364,-32214,0,0,7150,0,0,,7150,7150
44,10/30/2018,18,4:15,4:30,58.61,,0,58.61,58.61,1,-86036,32270,118306,-53766,0,0,30682,0,0,,30682,30682
44,10/30/2018,19,4:30,4:45,70.43,,0,70.43,70.43,1,-105429,23008,128437,-82421,0,0,68441,0,0,,68441,68441
44,10/30/2018,20,4:45,5:00,85.25,,0,85.25,85.25,1,-147546,44425,191971,-103121,0,0,79110,0,0,,79110,79110
44,10/30/2018,21,5:00,5:15,70.43,,0,70.43,70.43,1,-103279,37940,141219,-65339,0,0,58934,0,0,,58934,58934
44,10/30/2018,22,5:15,5:30,105.36,,0,105.36,105.36,1,-142394,54845,197239,-87549,0,0,56702,0,0,,56702,56702
44,10/30/2018,23,5:30,5:45,95.66,,0,95.66,95.66,1,-168827,67769,236596,-101058,0,0,81899,0,0,,81899,81899
44,10/30/2018,24,5:45,6:00,97.12,,0,97.12,97.12,1,-184479,74660,259139,-109819,0,0,104677,0,0,,104677,104677
44,10/30/2018,25,6:00,6:15,51.21,,0,51.21,51.21,1,-93435,71533,164968,-21902,0,0,22897,0,0,,22897,22897
44,10/30/2018,26,6:15,6:30,77.74,,0,77.74,77.74,1,-98997,26985,125982,-72012,0,0,42738,0,0,,42738,42738
44,10/30/2018,27,6:30,6:45,142.12,,0,142.12,142.12,1,-148223,17183,165406,-131040,0,0,86185,0,0,,86185,86185
44,10/30/2018,28,6:45,7:00,142.12,,0,142.12,142.12,1,-197697,26242,223939,-171455,0,0,130629,0,0,,130629,130629
44,10/30/2018,29,7:00,7:15,142.12,39.46,0,39.46,39.46,-1,-145432,116692,262124,-28740,0,-1208,55148,0,0,,56356,53940
44,10/30/2018,30,7:15,7:30,162.83,39.46,0,162.83,162.83,1,-171223,36677,207900,-134546,0,-359,37903,0,0,,38262,37544
44,10/30/2018,31,7:30,7:45,148.34,,0,148.34,148.34,1,-220104,40890,260994,-179214,0,0,140154,0,0,,140154,140154
44,10/30/2018,32,7:45,8:00,363.3,,0,363.3,363.3,1,-197555,55561,253116,-141994,0,0,140846,5000,0,,145846,145846
44,10/30/2018,33,8:00,8:15,363.3,-91.19,0,-91.19,-91.19,-1,-65812,143199,209011,77387,0,-27219,25719,0,0,,52938,-1500
44,10/30/2018,34,8:15,8:30,,30.59,0,30.59,30.59,-1,-81146,85453,166599,4307,0,-24908,0,0,0,,24908,-24908
44,10/30/2018,35,8:30,8:45,55.08,45.78,0,55.08,45.78,2,-102319,91117,193436,-11202,0,-4636,1015,0,0,,5651,-3621
44,10/30/2018,36,8:45,9:00,59.97,,0,59.97,59.97,1,-104351,64608,168959,-39743,0,0,24500,0,0,,24500,24500
44,10/30/2018,37,9:00,9:15,56.32,35.24,0,56.32,35.24,2,-56825,75096,131921,18271,0,-8467,10312,0,0,,18779,1845
44,10/30/2018,38,9:15,9:30,47.08,79.31,0,47.08,47.08,1,-76395,62176,138571,-14219,0,-1172,2146,0,0,,3318,974
44,10/30/2018,39,9:30,9:45,47.08,,0,47.08,47.08,1,-81626,67058,148684,-14568,0,0,3603,0,0,,3603,3603
44,10/30/2018,40,9:45,10:00,47.08,,0,47.08,47.08,1,-77724,62288,140012,-15436,0,0,961,0,0,,961,961
44,10/30/2018,41,10:00,10:15,47.08,20.39,0,20.39,20.39,-1,-60402,118294,178696,57892,0,-31142,5,0,0,,31147,-31137
44,10/30/2018,42,10:15,10:30,,42.46,0,42.46,42.46,-1,-91138,114180,205318,23042,0,-31533,0,0,0,,31533,-31533
44,10/30/2018,43,10:30,10:45,,35.29,0,35.29,35.29,-1,-88578,132746,221324,44168,0,-41572,0,0,0,,41572,-41572
44,10/30/2018,44,10:45,11:00,,39.46,0,39.46,39.46,-1,-106949,122635,229584,15686,0,-39690,0,0,0,,39690,-39690
44,10/30/2018,45,11:00,11:15,64.09,43.78,0,64.09,43.78,2,-129080,90816,219896,-38264,0,-5443,9474,0,0,,14917,4031
44,10/30/2018,46,11:15,11:30,55.81,,0,55.81,55.81,1,-136218,90724,226942,-45494,0,0,27079,0,0,,27079,27079
44,10/30/2018,47,11:30,11:45,55.81,,0,55.81,55.81,1,-146973,103747,250720,-43226,0,0,29664,0,0,,29664,29664
44,10/30/2018,48,11:45,12:00,55.81,,0,55.81,55.81,1,-137271,103898,241169,-33373,0,0,30558,0,0,,30558,30558
44,10/30/2018,49,12:00,12:15,111.32,,0,111.32,111.32,1,-146057,63272,209329,-82785,0,0,52218,0,0,,52218,52218
44,10/30/2018,50,12:15,12:30,60.76,,0,60.76,60.76,1,-93540,85744,179284,-7796,0,0,28919,0,0,,28919,28919
44,10/30/2018,51,12:30,12:45,60.76,47.92,0,47.92,47.92,-1,-82964,96647,179611,13683,0,-1627,2546,0,0,,4173,919
44,10/30/2018,52,12:45,13:00,,47.92,0,47.92,47.92,-1,-101355,113137,214492,11782,0,-5874,0,0,0,,5874,-5874
44,10/30/2018,53,13:00,13:15,55.08,47.63,0,55.08,47.63,2,-120312,74304,194616,-46008,0,-1445,15242,0,0,,16687,13797
44,10/30/2018,54,13:15,13:30,55.08,,0,55.08,55.08,1,-94308,51955,146263,-42353,0,0,21077,0,0,,21077,21077
44,10/30/2018,55,13:30,13:45,55.08,,0,55.08,55.08,1,-110479,66621,177100,-43858,0,0,34330,0,0,,34330,34330
44,10/30/2018,56,13:45,14:00,55.08,,0,55.08,55.08,1,-120122,67125,187247,-52997,0,0,37252,0,0,,37252,37252
44,10/30/2018,57,14:00,14:15,70.19,,0,70.19,70.19,1,-145648,53331,198979,-92317,0,0,64361,0,0,,64361,64361
44,10/30/2018,58,14:15,14:30,70.19,,0,70.19,70.19,1,-129160,55397,184557,-73763,0,0,64957,0,0,,64957,64957
44,10/30/2018,59,14:30,14:45,76.12,,0,76.12,76.12,1,-130203,47628,177831,-82575,0,0,59763,0,0,,59763,59763
44,10/30/2018,60,14:45,15:00,103.16,,0,103.16,103.16,1,-148282,49556,197838,-98726,0,0,73393,0,0,,73393,73393
44,10/30/2018,61,15:00,15:15,166.37,,0,166.37,166.37,1,-172257,41369,213626,-130888,0,0,110201,0,0,,110201,110201
44,10/30/2018,62,15:15,15:30,92.12,,0,92.12,92.12,1,-157774,45519,203293,-112255,0,0,102063,0,0,,102063,102063
44,10/30/2018,63,15:30,15:45,122.87,,0,122.87,122.87,1,-163778,38160,201938,-125618,0,0,104010,0,0,,104010,104010
44,10/30/2018,64,15:45,16:00,98.12,,0,98.12,98.12,1,-167000,37128,204128,-129872,0,0,115965,0,0,,115965,115965
44,10/30/2018,65,16:00,16:15,149.12,,0,149.12,149.12,1,-227920,63403,291323,-164517,0,0,113143,0,0,,113143,113143
44,10/30/2018,66,16:15,16:30,149.12,,0,149.12,149.12,1,-212945,64488,277433,-148457,0,0,129309,0,0,,129309,129309
44,10/30/2018,67,16:30,16:45,360,,0,360,360,1,-169957,81122,251079,-88835,0,0,98034,5000,0,,103034,103034
44,10/30/2018,68,16:45,17:00,130.12,,0,130.12,130.12,1,-190816,89654,280470,-101162,0,0,67254,0,0,,67254,67254
44,10/30/2018,69,17:00,17:15,137.49,36.91,0,36.91,36.91,-1,-155855,187242,343097,31387,0,-4900,40177,0,0,,45077,35277
44,10/30/2018,70,17:15,17:30,139.12,45.92,0,139.12,139.12,1,-180958,142754,323712,-38204,0,-2986,15092,0,0,,18078,12106
44,10/30/2018,71,17:30,17:45,149.86,,0,149.86,149.86,1,-220244,132317,352561,-87927,0,0,88019,0,0,,88019,88019
44,10/30/2018,72,17:45,18:00,98.34,,0,98.34,98.34,1,-193088,136840,329928,-56248,0,0,84422,0,0,,84422,84422
44,10/30/2018,73,18:00,18:15,55.13,,0,55.13,55.13,1,-161531,122947,284478,-38584,0,0,40311,0,0,,40311,40311
44,10/30/2018,74,18:15,18:30,51.21,43.78,0,43.78,43.78,-1,-109780,115903,225683,6123,0,-675,14457,0,0,,15132,13782
44,10/30/2018,75,18:30,18:45,49.07,49.48,0,49.07,48.59,2,-104189,92443,196632,-11746,0,-599,744,0,0,,1343,145
44,10/30/2018,76,18:45,19:00,51.21,,0,51.21,51.21,1,-118813,90633,209446,-28180,0,0,5701,0,0,,5701,5701
44,10/30/2018,77,19:00,19:15,147.12,,0,147.12,147.12,1,-136758,45498,182256,-91260,0,0,38141,0,0,,38141,38141
44,10/30/2018,78,19:15,19:30,69.12,44.31,0,69.12,44.31,2,-72559,69354,141913,-3205,0,-1106,20530,0,0,,21636,19424
44,10/30/2018,79,19:30,19:45,,42.06,0,42.06,42.06,-1,-44766,58673,103439,13907,0,-7955,0,0,0,,7955,-7955
44,10/30/2018,80,19:45,20:00,,43.21,0,43.21,43.21,-1,-79755,89358,169113,9603,0,-19223,0,0,0,,19223,-19223
44,10/30/2018,81,20:00,20:15,142.12,43.21,0,142.12,43.21,2,-103359,28009,131368,-75350,0,-9394,13909,0,0,,23303,4515
44,10/30/2018,82,20:15,20:30,142.62,39.21,0,142.62,39.21,2,-54716,39605,94321,-15111,0,-1550,39910,0,0,,41460,38360
44,10/30/2018,83,20:30,20:45,,24.82,0,24.82,24.82,-1,-44745,94693,139438,49948,0,-46392,0,0,0,,46392,-46392
44,10/30/2018,84,20:45,21:00,,30.6,0,30.6,30.6,-1,-63355,113666,177021,50311,0,-46101,0,0,0,,46101,-46101
44,10/30/2018,85,21:00,21:15,,0.78,0,0.78,0.78,-1,-69583,113351,182934,43768,0,-54577,0,0,0,,54577,-54577
44,10/30/2018,86,21:15,21:30,,36.6,0,36.6,36.6,-1,-55800,65052,120852,9252,0,-9140,0,0,0,,9140,-9140
44,10/30/2018,87,21:30,21:45,,35.24,0,35.24,35.24,-1,-33041,61388,94429,28347,0,-25560,0,0,0,,25560,-25560
44,10/30/2018,88,21:45,22:00,,39.1,0,39.1,39.1,-1,-54492,71259,125751,16767,0,-24317,0,0,0,,24317,-24317
44,10/30/2018,89,22:00,22:15,47.22,34.4,0,47.22,34.4,2,-66094,73024,139118,6930,0,-25347,4,0,0,,25351,-25343
44,10/30/2018,90,22:15,22:30,70.39,34.4,0,70.39,70.39,1,-91444,44403,135847,-47041,0,-2253,21298,0,0,,23551,19045
44,10/30/2018,91,22:30,22:45,70.39,35.24,0,35.24,35.24,-1,-47423,74153,121576,26730,0,-11232,568,0,0,,11800,-10664
44,10/30/2018,92,22:45,23:00,,33.66,0,33.66,33.66,-1,-47566,102290,149856,54724,0,-49435,0,0,0,,49435,-49435
44,10/30/2018,93,23:00,23:15,55.24,33.78,0,55.24,26.74,2,-82656,52967,135623,-29689,0,-22654,6477,0,0,,29131,-16177
44,10/30/2018,94,23:15,23:30,47.25,,0,47.25,47.25,1,-87594,74127,161721,-13467,0,0,4072,0,0,,4072,4072
44,10/30/2018,95,23:30,23:45,47.25,35.24,0,35.24,35.24,-1,-103420,113519,216939,10099,0,-4007,35,0,0,,4042,-3972
44,10/30/2018,96,23:45,0:00,,20.39,0,20.39,20.39,-1,-124885,157270,282155,32385,0,-34203,0,0,0,,34203,-34203
44,10/31/2018,1,0:00,0:15,120.61,20.39,0,120.61,120.61,1,-165178,47234,212412,-117944,0,-2765,42032,0,0,,44797,39267
44,10/31/2018,2,0:15,0:30,61.57,,0,61.57,61.57,1,-81690,55608,137298,-26082,0,0,30399,0,0,,30399,30399
44,10/31/2018,3,0:30,0:45,61.57,39.39,0,39.39,39.39,-1,-44151,45479,89630,1328,0,-2296,1040,0,0,,3336,-1256
44,10/31/2018,4,0:45,1:00,,43.39,0,43.39,43.39,-1,-55787,38152,93939,-17635,0,-1538,0,0,0,,1538,-1538
44,10/31/2018,5,1:00,1:15,55.51,,0,55.51,55.51,1,-62635,40045,102680,-22590,0,0,6683,0,0,,6683,6683
44,10/31/2018,6,1:15,1:30,55.51,,0,55.51,55.51,1,-63766,35445,99211,-28321,0,0,24683,0,0,,24683,24683
44,10/31/2018,7,1:30,1:45,47.39,,0,47.39,47.39,1,-51581,31468,83049,-20113,0,0,8942,0,0,,8942,8942
44,10/31/2018,8,1:45,2:00,43.69,43.39,0,43.69,41.71,2,-52004,37596,89600,-14408,0,-21,2412,0,0,,2433,2391
44,10/31/2018,9,2:00,2:15,43.69,35.51,0,35.51,35.51,-1,-52058,76442,128500,24384,0,-14981,178,0,0,,15159,-14803
44,10/31/2018,10,2:15,2:30,,35.51,0,35.51,35.51,-1,-40048,60328,100376,20280,0,-21935,0,0,0,,21935,-21935
44,10/31/2018,11,2:30,2:45,,35.51,0,35.51,35.51,-1,-47150,51512,98662,4362,0,-14137,0,0,0,,14137,-14137
44,10/31/2018,12,2:45,3:00,,35.51,0,35.51,35.51,-1,-40675,50027,90702,9352,0,-6390,0,0,0,,6390,-6390
44,10/31/2018,13,3:00,3:15,,35.51,0,35.51,35.51,-1,-35684,63712,99396,28028,0,-24760,0,0,0,,24760,-24760
44,10/31/2018,14,3:15,3:30,,35.51,0,35.51,35.51,-1,-30183,48259,78442,18076,0,-28302,0,0,0,,28302,-28302
44,10/31/2018,15,3:30,3:45,44.74,39.39,0,44.74,44.74,1,-46382,34495,80877,-11887,0,-8819,189,0,0,,9008,-8630
44,10/31/2018,16,3:45,4:00,48.32,20.61,0,48.32,20.61,2,-32060,50174,82234,18114,0,-2841,2297,0,0,,5138,-544
44,10/31/2018,17,4:00,4:15,,17.02,0,17.02,17.02,-1,-47190,69246,116436,22056,0,-33321,0,0,0,,33321,-33321
44,10/31/2018,18,4:15,4:30,,39.39,0,39.39,39.39,-1,-30376,45994,76370,15618,0,-21992,0,0,0,,21992,-21992
44,10/31/2018,19,4:30,4:45,,39.39,0,39.39,39.39,-1,-25866,36426,62292,10560,0,-17301,0,0,0,,17301,-17301
44,10/31/2018,20,4:45,5:00,,43.39,0,43.39,43.39,-1,-39918,30962,70880,-8956,0,-3587,0,0,0,,3587,-3587
44,10/31/2018,21,5:00,5:15,,28.04,0,28.04,28.04,-1,-23428,67887,91315,44459,0,-23358,0,0,0,,23358,-23358
44,10/31/2018,22,5:15,5:30,48.42,39.39,0,48.42,48.42,1,-37065,26818,63883,-10247,0,-18375,346,0,0,,18721,-18029
44,10/31/2018,23,5:30,5:45,55.51,39.39,0,55.51,55.51,1,-85407,32830,118237,-52577,0,-2586,32844,0,0,,35430,30258
44,10/31/2018,24,5:45,6:00,67.89,,0,67.89,67.89,1,-131526,50989,182515,-80537,0,0,60754,0,0,,60754,60754
44,10/31/2018,25,6:00,6:15,54.65,32.48,0,54.65,32.48,2,-80745,110144,190889,29399,0,-5600,17099,0,0,,22699,11499
44,10/31/2018,26,6:15,6:30,69.75,43.7,0,69.75,69.75,1,-103064,69211,172275,-33853,0,-6573,4884,0,0,,11457,-1689
44,10/31/2018,27,6:30,6:45,97.4,,0,97.4,97.4,1,-129085,51412,180497,-77673,0,0,63328,0,0,,63328,63328
44,10/31/2018,28,6:45,7:00,54.65,38.54,0,38.54,38.54,-1,-109876,111719,221595,1843,0,-555,21826,0,0,,22381,21271
44,10/31/2018,29,7:00,7:15,,38.54,0,38.54,38.54,-1,-82460,105576,188036,23116,0,-12835,0,0,0,,12835,-12835
44,10/31/2018,30,7:15,7:30,69.58,34.65,0,69.58,69.58,1,-104030,58181,162211,-45849,0,-7952,18691,0,0,,26643,10739
44,10/31/2018,31,7:30,7:45,119.75,,0,119.75,119.75,1,-156555,54119,210674,-102436,0,0,75867,0,0,,75867,75867
44,10/31/2018,32,7:45,8:00,141.02,,0,141.02,141.02,1,-178785,61908,240693,-116877,0,0,107665,0,0,,107665,107665
44,10/31/2018,33,8:00,8:15,95.02,,0,95.02,95.02,1,-117217,66930,184147,-50287,0,0,58007,0,0,,58007,58007
44,10/31/2018,34,8:15,8:30,50.23,,0,50.23,50.23,1,-97259,59159,156418,-38100,0,0,20815,0,0,,20815,20815
44,10/31/2018,35,8:30,8:45,69.58,,0,69.58,69.58,1,-128957,48938,177895,-80019,0,0,48694,0,0,,48694,48694
44,10/31/2018,36,8:45,9:00,147.02,,0,147.02,147.02,1,-167119,46197,213316,-120922,0,0,93608,0,0,,93608,93608
44,10/31/2018,37,9:00,9:15,97,,0,97,97,1,-138287,55384,193671,-82903,0,0,89259,0,0,,89259,89259
44,10/31/2018,38,9:15,9:30,54.23,,0,54.23,54.23,1,-112777,58415,171192,-54362,0,0,47813,0,0,,47813,47813
44,10/31/2018,39,9:30,9:45,51.77,46.18,0,46.18,46.18,-1,-67998,58750,126748,-9248,0,-274,21018,0,0,,21292,20744
44,10/31/2018,40,9:45,10:00,46.23,38.66,0,47.47,38.66,2,-64260,65560,129820,1300,0,-3565,586,0,0,,4151,-2979
44,10/31/2018,41,10:00,10:15,50.23,46.18,0,50.23,46.18,2,-65894,56437,122331,-9457,0,-125,6032,0,0,,6157,5907
44,10/31/2018,42,10:15,10:30,48.4,42.54,0,48.4,42.54,2,-84373,63146,147519,-21227,0,-2074,4652,0,0,,6726,2578
44,10/31/2018,43,10:30,10:45,46.9,42.54,0,47.42,42.54,2,-63389,65107,128496,1718,0,-697,4591,0,0,,5288,3894
44,10/31/2018,44,10:45,11:00,,38.54,0,38.54,38.54,-1,-62143,77448,139591,15305,0,-17030,0,0,0,,17030,-17030
44,10/31/2018,45,11:00,11:15,,42.54,0,42.54,42.54,-1,-83214,94833,178047,11619,0,-17934,0,0,0,,17934,-17934
44,10/31/2018,46,11:15,11:30,,42.54,0,42.54,42.54,-1,-88115,87929,176044,-186,0,-11663,0,0,0,,11663,-11663
44,10/31/2018,47,11:30,11:45,,38.54,0,38.54,38.54,-1,-77887,99167,177054,21280,0,-13208,0,0,0,,13208,-13208
44,10/31/2018,48,11:45,12:00,,34.65,0,34.65,34.65,-1,-71681,104421,176102,32740,0,-30409,0,0,0,,30409,-30409
44,10/31/2018,49,12:00,12:15,,34.99,0,34.99,34.99,-1,-55190,108372,163562,53182,0,-31978,0,0,0,,31978,-31978
44,10/31/2018,50,12:15,12:30,,34.65,0,34.65,34.65,-1,-47899,114982,162881,67083,0,-38630,0,0,0,,38630,-38630
44,10/31/2018,51,12:30,12:45,,34.65,0,34.65,34.65,-1,-47590,118776,166366,71186,0,-43352,0,0,0,,43352,-43352
44,10/31/2018,52,12:45,13:00,,34.99,0,34.99,34.99,-1,-67354,101478,168832,34124,0,-34726,0,0,0,,34726,-34726
44,10/31/2018,53,13:00,13:15,,26.03,0,26.03,26.03,-1,-52604,127678,180282,75074,0,-31594,0,0,0,,31594,-31594
44,10/31/2018,54,13:15,13:30,,39.59,0,39.59,39.59,-1,-80427,115791,196218,35364,0,-24170,0,0,0,,24170,-24170
44,10/31/2018,55,13:30,13:45,,40.82,0,40.82,40.82,-1,-79276,117977,197253,38701,0,-9248,0,0,0,,9248,-9248
44,10/31/2018,56,13:45,14:00,,45.02,0,45.02,45.02,-1,-86519,111609,198128,25090,0,-10051,0,0,0,,10051,-10051
44,10/31/2018,57,14:00,14:15,,45.76,0,45.76,45.76,-1,-71099,102116,173215,31017,0,-2233,0,0,0,,2233,-2233
44,10/31/2018,58,14:15,14:30,48.84,48.68,0,48.84,47.46,2,-75204,68382,143586,-6822,0,-393,1648,0,0,,2041,1255
44,10/31/2018,59,14:30,14:45,46.23,,0,46.23,46.23,1,-85197,60953,146150,-24244,0,0,1605,0,0,,1605,1605
44,10/31/2018,60,14:45,15:00,46.23,,0,46.23,46.23,1,-109397,55996,165393,-53401,0,0,523,0,0,,523,523
44,10/31/2018,61,15:00,15:15,47.96,48.68,0,47.96,47.46,2,-88830,70014,158844,-18816,0,-13,1197,0,0,,1210,1184
44,10/31/2018,62,15:15,15:30,47.96,46.18,0,47.96,46.18,2,-85064,58581,143645,-26483,0,-303,2841,0,0,,3144,2538
44,10/31/2018,63,15:30,15:45,47.21,,0,47.21,47.21,1,-88765,45800,134565,-42965,0,0,5075,0,0,,5075,5075
44,10/31/2018,64,15:45,16:00,54.23,,0,54.23,54.23,1,-112006,22473,134479,-89533,0,0,16026,0,0,,16026,16026
44,10/31/2018,65,16:00,16:15,50.23,,0,50.23,50.23,1,-83916,45803,129719,-38113,0,0,9527,0,0,,9527,9527
44,10/31/2018,66,16:15,16:30,,,0,47.46,47.46,0,-100230,46312,146542,-53918,0,0,80,0,0,,80,80
44,10/31/2018,67,16:30,16:45,47.55,,0,47.55,47.55,1,-92504,31621,124125,-60883,0,0,526,0,0,,526,526
44,10/31/2018,68,16:45,17:00,99.53,,0,99.53,99.53,1,-130620,23474,154094,-107146,0,0,22447,0,0,,22447,22447
44,10/31/2018,69,17:00,17:15,52.07,40.74,0,52.07,40.74,2,-60001,85332,145333,25331,0,-2763,6142,0,0,,8905,3379
44,10/31/2018,70,17:15,17:30,82.07,40.74,0,82.07,82.07,1,-83197,33120,116317,-50077,0,-830,13715,0,0,,14545,12885
44,10/31/2018,71,17:30,17:45,146.03,,0,146.03,146.03,1,-125279,29165,154444,-96114,0,0,60321,0,0,,60321,60321
44,10/31/2018,72,17:45,18:00,62.07,,0,62.07,62.07,1,-102965,53583,156548,-49382,0,0,49723,0,0,,49723,49723
44,10/31/2018,73,18:00,18:15,50.23,46.18,0,50.23,46.18,2,-96172,63035,159207,-33137,0,-185,16180,0,0,,16365,15995
44,10/31/2018,74,18:15,18:30,50.23,34.65,0,34.65,34.65,-1,-61332,85422,146754,24090,0,-20113,219,0,0,,20332,-19894
44,10/31/2018,75,18:30,18:45,,42.54,0,42.54,42.54,-1,-52691,74207,126898,21516,0,-24200,0,0,0,,24200,-24200
44,10/31/2018,76,18:45,19:00,,43.04,0,43.04,43.04,-1,-57259,74546,131805,17287,0,-16664,0,0,0,,16664,-16664
44,10/31/2018,77,19:00,19:15,46.23,42.54,0,46.23,46.23,1,-80874,46858,127732,-34016,0,-8742,680,0,0,,9422,-8062
44,10/31/2018,78,19:15,19:30,46.23,42.54,0,42.54,42.54,-1,-58366,69456,127822,11090,0,-3820,186,0,0,,4006,-3634
44,10/31/2018,79,19:30,19:45,,38.54,0,38.54,38.54,-1,-59033,94494,153527,35461,0,-30193,0,0,0,,30193,-30193
44,10/31/2018,80,19:45,20:00,,42.54,0,42.54,42.54,-1,-92448,105381,197829,12933,0,-29272,0,0,0,,29272,-29272
44,10/31/2018,81,20:00,20:15,46.23,39.03,0,47.14,39.03,2,-83869,62198,146067,-21671,0,-6452,1094,0,0,,7546,-5358
44,10/31/2018,82,20:15,20:30,46.23,,0,46.23,46.23,1,-76208,48473,124681,-27735,0,0,1973,0,0,,1973,1973
44,10/31/2018,83,20:30,20:45,41.02,40.03,0,44.72,40.03,2,-43238,65527,108765,22289,0,-7910,140,0,0,,8050,-7770
44,10/31/2018,84,20:45,21:00,,46.17,0,46.17,46.17,-1,-75322,79697,155019,4375,0,-10148,0,0,0,,10148,-10148
44,10/31/2018,85,21:00,21:15,147.69,46.17,0,147.69,147.69,1,-132171,13635,145806,-118536,0,-3001,35053,0,0,,38054,32052
44,10/31/2018,86,21:15,21:30,147.69,,0,147.69,147.69,1,-82716,34187,116903,-48529,0,0,66626,0,0,,66626,66626
44,10/31/2018,87,21:30,21:45,46.23,48.86,0,46.23,44.94,2,-47565,39705,87270,-7860,0,-18,2736,0,0,,2754,2718
44,10/31/2018,88,21:45,22:00,95.99,48.15,0,95.99,44.46,2,-120073,54000,174073,-66073,0,-273,15134,0,0,,15407,14861
44,10/31/2018,89,22:00,22:15,60.75,,0,60.75,60.75,1,-79752,50702,130454,-29050,0,0,18266,0,0,,18266,18266
44,10/31/2018,90,22:15,22:30,96.43,,0,96.43,96.43,1,-117416,41084,158500,-76332,0,0,64881,0,0,,64881,64881
44,10/31/2018,91,22:30,22:45,57.25,,0,57.25,57.25,1,-90131,51845,141976,-38286,0,0,44653,0,0,,44653,44653
44,10/31/2018,92,22:45,23:00,47.02,34.65,0,34.65,34.65,-1,-61517,82697,144214,21180,0,-6384,10494,0,0,,16878,4110
44,10/31/2018,93,23:00,23:15,69.58,42.54,0,69.58,69.58,1,-118280,45266,163546,-73014,0,-3825,23689,0,0,,27514,19864
44,10/31/2018,94,23:15,23:30,69.58,,0,69.58,69.58,1,-103366,21699,125065,-81667,0,0,66572,0,0,,66572,66572
44,10/31/2018,95,23:30,23:45,94.91,,0,94.91,94.91,1,-122310,16689,138999,-105621,0,0,77275,0,0,,77275,77275
44,10/31/2018,96,23:45,0:00,162.59,,0,162.59,162.59,1,-136101,24127,160228,-111974,0,0,102694,0,0,,102694,102694
44,11-01-18,1,0:00,0:15,46.39,,0,46.39,46.39,1,-81300,96232,177532,14932,0,0,16165,0,0,,16165,16165
44,11-01-18,2,0:15,0:30,,,0,43.08,43.08,0,-67746,73696,141442,5950,0,0,0,0,0,,0,0
44,11-01-18,3,0:30,0:45,,,0,43.13,43.13,0,-94618,84163,178781,-10455,0,0,0,0,0,,0,0
44,11-01-18,4,0:45,1:00,46.29,,0,46.29,46.29,1,-87718,86172,173890,-1546,0,0,285,0,0,,285,285
44,11-01-18,5,1:00,1:15,,32.03,0,32.03,32.03,-1,-33738,103301,137039,69563,0,-14047,0,0,0,,14047,-14047
44,11-01-18,6,1:15,1:30,,32.03,0,32.03,32.03,-1,-32582,80922,113504,48340,0,-21071,0,0,0,,21071,-21071
44,11-01-18,7,1:30,1:45,,34.48,0,34.48,34.48,-1,-39175,103621,142796,64446,0,-23445,0,0,0,,23445,-23445
44,11-01-18,8,1:45,2:00,,32.07,0,32.07,32.07,-1,-27224,116984,144208,89760,0,-47851,0,0,0,,47851,-47851
44,11-01-18,9,2:00,2:15,,40.66,0,40.66,40.66,-1,-61375,73476,134851,12101,0,-13545,0,0,0,,13545,-13545
44,11-01-18,10,2:15,2:30,46.04,,0,46.04,46.04,1,-63874,66276,130150,2402,0,0,208,0,0,,208,208
44,11-01-18,11,2:30,2:45,,45.16,0,45.16,45.16,-1,-54882,50036,104918,-4846,0,-364,0,0,0,,364,-364
44,11-01-18,12,2:45,3:00,,42.04,0,42.04,42.04,-1,-49298,63644,112942,14346,0,-7455,0,0,0,,7455,-7455
44,11-01-18,13,3:00,3:15,46.27,42.21,0,46.27,42.21,2,-61231,52778,114009,-8453,0,-5199,158,0,0,,5357,-5041
44,11-01-18,14,3:15,3:30,46.29,,0,46.29,46.29,1,-63775,56524,120299,-7251,0,0,1042,0,0,,1042,1042
44,11-01-18,15,3:30,3:45,46.04,,0,46.04,46.04,1,-89956,83527,173483,-6429,0,0,574,0,0,,574,574
44,11-01-18,16,3:45,4:00,46.04,42.04,0,46.04,42.04,2,-77972,93426,171398,15454,0,-2160,853,0,0,,3013,-1307
44,11-01-18,17,4:00,4:15,,42.04,0,42.04,42.04,-1,-63670,115085,178755,51415,0,-2565,0,0,0,,2565,-2565
44,11-01-18,18,4:15,4:30,,44.93,0,44.93,44.93,-1,-42891,112460,155351,69569,0,-43,0,0,0,,43,-43
44,11-01-18,19,4:30,4:45,,42.68,0,42.68,42.68,-1,-49387,114849,164236,65462,0,-1608,0,0,0,,1608,-1608
44,11-01-18,20,4:45,5:00,,31.09,0,31.09,31.09,-1,-67890,126610,194500,58720,0,-31233,0,0,0,,31233,-31233
44,11-01-18,21,5:00,5:15,,36.03,0,36.03,36.03,-1,-88248,114261,202509,26013,0,-31026,0,0,0,,31026,-31026
44,11-01-18,22,5:15,5:30,,42.04,0,42.04,42.04,-1,-83298,92783,176081,9485,0,-13232,0,0,0,,13232,-13232
44,11-01-18,23,5:30,5:45,,43.75,0,43.75,43.75,-1,-87214,68945,156159,-18269,0,-1730,0,0,0,,1730,-1730
44,11-01-18,24,5:45,6:00,,38.4,0,38.4,38.4,-1,-99829,73273,173102,-26556,0,-766,0,0,0,,766,-766
44,11-01-18,25,6:00,6:15,,-12.13,0,-12.13,-12.13,-1,-54277,140772,195049,86495,0,-38428,0,0,0,,38428,-38428
44,11-01-18,26,6:15,6:30,,38.63,0,38.63,38.63,-1,-47086,82843,129929,35757,0,-24620,0,0,0,,24620,-24620
44,11-01-18,27,6:30,6:45,69.63,45.51,0,69.63,69.63,1,-74166,57831,131997,-16335,0,-6245,3959,0,0,,10204,-2286
44,11-01-18,28,6:45,7:00,197.5,,0,197.5,197.5,1,-140056,59433,199489,-80623,0,0,55472,0,0,,55472,55472
44,11-01-18,29,7:00,7:15,69.89,43.57,0,43.57,43.57,-1,-104571,112283,216854,7712,0,-404,23152,0,0,,23556,22748
44,11-01-18,30,7:15,7:30,69.89,34.63,0,34.63,34.63,-1,-31312,112795,144107,81483,0,-24254,33,0,0,,24287,-24221
44,11-01-18,31,7:30,7:45,,41.84,0,41.84,41.84,-1,-50928,68441,119369,17513,0,-15209,0,0,0,,15209,-15209
44,11-01-18,32,7:45,8:00,,42.54,0,42.54,42.54,-1,-56099,102769,158868,46670,0,-657,0,0,0,,657,-657
44,11-01-18,33,8:00,8:15,,38.63,0,38.63,38.63,-1,-63683,99639,163322,35956,0,-10495,0,0,0,,10495,-10495
44,11-01-18,34,8:15,8:30,,32.88,0,32.88,32.88,-1,-55478,94271,149749,38793,0,-33846,0,0,0,,33846,-33846
44,11-01-18,35,8:30,8:45,50.63,42.91,0,50.63,42.91,2,-73025,60531,133556,-12494,0,-8389,4894,0,0,,13283,-3495
44,11-01-18,36,8:45,9:00,48.32,,0,48.32,48.32,1,-69555,53939,123494,-15616,0,0,8434,0,0,,8434,8434
44,11-01-18,37,9:00,9:15,51.89,,0,51.89,51.89,1,-90890,79833,170723,-11057,0,0,6321,0,0,,6321,6321
44,11-01-18,38,9:15,9:30,69.63,,0,69.63,69.63,1,-89156,51522,140678,-37634,0,0,24377,0,0,,24377,24377
44,11-01-18,39,9:30,9:45,54.63,,0,54.63,54.63,1,-93357,46844,140201,-46513,0,0,34024,0,0,,34024,34024
44,11-01-18,40,9:45,10:00,58.78,,0,58.78,58.78,1,-99950,43922,143872,-56028,0,0,31920,0,0,,31920,31920
44,11-01-18,41,10:00,10:15,54.63,,0,54.63,54.63,1,-91147,39719,130866,-51428,0,0,26071,0,0,,26071,26071
44,11-01-18,42,10:15,10:30,50.63,,0,50.63,50.63,1,-87575,52113,139688,-35462,0,0,11324,0,0,,11324,11324
44,11-01-18,43,10:30,10:45,46.82,,0,46.82,46.82,1,-89314,47442,136756,-41872,0,0,9635,0,0,,9635,9635
44,11-01-18,44,10:45,11:00,119.63,,0,119.63,119.63,1,-128031,55348,183379,-72683,0,0,36146,0,0,,36146,36146
44,11-01-18,45,11:00,11:15,54.63,,0,54.63,54.63,1,-134603,69734,204337,-64869,0,0,39485,0,0,,39485,39485
44,11-01-18,46,11:15,11:30,218.55,,0,218.55,218.55,1,-155824,54084,209908,-101740,0,0,60874,0,0,,60874,60874
44,11-01-18,47,11:30,11:45,100.63,,0,100.63,100.63,1,-173996,83499,257495,-90497,0,0,76481,0,0,,76481,76481
44,11-01-18,48,11:45,12:00,218.55,,0,218.55,218.55,1,-176578,65743,242321,-110835,0,0,77592,0,0,,77592,77592
44,11-01-18,49,12:00,12:15,250.27,,0,250.27,250.27,1,-193688,70487,264175,-123201,0,0,103999,0,0,,103999,103999
44,11-01-18,50,12:15,12:30,150.02,,0,150.02,150.02,1,-139563,67420,206983,-72143,0,0,75383,8750,0,,84133,84133
44,11-01-18,51,12:30,12:45,105.72,,0,105.72,105.72,1,-139604,84620,224224,-54984,0,0,28036,8750,0,,36786,36786
44,11-01-18,52,12:45,13:00,106.02,,0,106.02,106.02,1,-175513,84850,260363,-90663,0,0,59719,0,0,,59719,59719
44,11-01-18,53,13:00,13:15,47.66,,0,47.66,47.66,1,-85820,121493,207313,35673,0,0,16436,0,0,,16436,16436
44,11-01-18,54,13:15,13:30,87.26,,0,87.26,87.26,1,-122890,71276,194166,-51614,0,0,18157,0,0,,18157,18157
44,11-01-18,55,13:30,13:45,122.02,,0,122.02,122.02,1,-125800,61597,187397,-64203,0,0,60329,0,0,,60329,60329
44,11-01-18,56,13:45,14:00,54.63,,0,54.63,54.63,1,-138072,57272,195344,-80800,0,0,35742,0,0,,35742,35742
44,11-01-18,57,14:00,14:15,46.9,,0,46.9,46.9,1,-124762,68595,193357,-56167,0,0,12062,0,0,,12062,12062
44,11-01-18,58,14:15,14:30,51.41,,0,51.41,51.41,1,-142411,49739,192150,-92672,0,0,8001,0,0,,8001,8001
44,11-01-18,59,14:30,14:45,53.66,,0,53.66,53.66,1,-132310,47151,179461,-85159,0,0,28341,0,0,,28341,28341
44,11-01-18,60,14:45,15:00,54.96,,0,54.96,54.96,1,-140730,45322,186052,-95408,0,0,28743,0,0,,28743,28743
44,11-01-18,61,15:00,15:15,50.63,,0,50.63,50.63,1,-116124,67965,184089,-48159,0,0,21350,0,0,,21350,21350
44,11-01-18,62,15:15,15:30,69.63,,0,69.63,69.63,1,-128865,71121,199986,-57744,0,0,31612,0,0,,31612,31612
44,11-01-18,63,15:30,15:45,69.63,,0,69.63,69.63,1,-127922,73677,201599,-54245,0,0,45271,0,0,,45271,45271
44,11-01-18,64,15:45,16:00,97.42,,0,97.42,97.42,1,-160203,85064,245267,-75139,0,0,55103,0,0,,55103,55103
44,11-01-18,65,16:00,16:15,50.02,45.62,0,45.62,45.62,-1,-118353,140573,258926,22220,0,-564,12934,0,0,,13498,12370
44,11-01-18,66,16:15,16:30,,45.63,0,45.63,45.63,-1,-116934,126821,243755,9887,0,-858,0,0,0,,858,-858
44,11-01-18,67,16:30,16:45,,45.62,0,45.62,45.62,-1,-107544,113121,220665,5577,0,-1,0,0,0,,1,-1
44,11-01-18,68,16:45,17:00,,,0,45.83,45.83,0,-129995,103510,233505,-26485,0,0,0,0,0,,0,0
44,11-01-18,69,17:00,17:15,,38.63,0,38.63,38.63,-1,-111727,121035,232762,9308,0,-9570,0,0,0,,9570,-9570
44,11-01-18,70,17:15,17:30,,45.78,0,45.78,45.78,-1,-118209,96652,214861,-21557,0,-1770,0,0,0,,1770,-1770
44,11-01-18,71,17:30,17:45,46.54,,0,46.54,46.54,1,-113992,99146,213138,-14846,0,0,198,0,0,,198,198
44,11-01-18,72,17:45,18:00,50.63,,0,50.63,50.63,1,-88332,118236,206568,29904,0,0,809,0,0,,809,809
44,11-01-18,73,18:00,18:15,70.69,,0,70.69,70.69,1,-172746,41136,213882,-131610,0,0,11771,0,0,,11771,11771
44,11-01-18,74,18:15,18:30,70.69,,0,70.69,70.69,1,-126941,46495,173436,-80446,0,0,17726,0,0,,17726,17726
44,11-01-18,75,18:30,18:45,70.69,45.14,0,45.14,45.14,-1,-80313,63818,144131,-16495,0,-75,989,0,0,,1064,914
44,11-01-18,76,18:45,19:00,,41.39,0,41.39,41.39,-1,-64018,86361,150379,22343,0,-6313,0,0,0,,6313,-6313
44,11-01-18,77,19:00,19:15,254.97,45.67,0,254.97,45.67,2,-158143,19199,177342,-138944,0,-1691,29472,0,0,,31163,27781
44,11-01-18,78,19:15,19:30,54.63,,0,54.63,54.63,1,-155975,23695,179670,-132280,0,0,29109,0,0,,29109,29109
44,11-01-18,79,19:30,19:45,50.63,,0,50.63,50.63,1,-142908,41773,184681,-101135,0,0,12330,0,0,,12330,12330
44,11-01-18,80,19:45,20:00,,,0,46.16,46.16,0,-133631,43381,177012,-90250,0,0,190,0,0,,190,190
44,11-01-18,81,20:00,20:15,214.83,,0,214.83,214.83,1,-212733,27023,239756,-185710,0,0,52548,0,0,,52548,52548
44,11-01-18,82,20:15,20:30,81.02,,0,81.02,81.02,1,-186671,28831,215502,-157840,0,0,54206,0,0,,54206,54206
44,11-01-18,83,20:30,20:45,50.63,,0,50.63,50.63,1,-160591,39172,199763,-121419,0,0,20820,0,0,,20820,20820
44,11-01-18,84,20:45,21:00,54.63,,0,54.63,54.63,1,-172188,35466,207654,-136722,0,0,15032,0,0,,15032,15032
44,11-01-18,85,21:00,21:15,186.42,,0,186.42,186.42,1,-149719,66573,216292,-83146,0,0,37719,0,0,,37719,37719
44,11-01-18,86,21:15,21:30,186.42,,0,186.42,186.42,1,-156019,21722,177741,-134297,0,0,91660,0,0,,91660,91660
44,11-01-18,87,21:30,21:45,62.91,,0,62.91,62.91,1,-139936,51436,191372,-88500,0,0,48199,0,0,,48199,48199
44,11-01-18,88,21:45,22:00,54.63,,0,54.63,54.63,1,-122140,74976,197116,-47164,0,0,24875,0,0,,24875,24875
44,11-01-18,89,22:00,22:15,202.89,,0,202.89,202.89,1,-161446,53831,215277,-107615,0,0,31585,0,0,,31585,31585
44,11-01-18,90,22:15,22:30,202.89,,0,202.89,202.89,1,-152593,45664,198257,-106929,0,0,96862,0,0,,96862,96862
44,11-01-18,91,22:30,22:45,56.93,,0,56.93,56.93,1,-131413,86343,217756,-45070,0,0,45250,0,0,,45250,45250
44,11-01-18,92,22:45,23:00,54.02,,0,54.02,54.02,1,-147055,123267,270322,-23788,0,0,22555,0,0,,22555,22555
44,11-01-18,93,23:00,23:15,202.89,,0,202.89,202.89,1,-198771,84389,283160,-114382,0,0,54358,0,0,,54358,54358
44,11-01-18,94,23:15,23:30,85.7,,0,85.7,85.7,1,-140724,109909,250633,-30815,0,0,43987,0,0,,43987,43987
44,11-01-18,95,23:30,23:45,85.7,38.03,0,38.03,38.03,-1,-124734,131869,256603,7135,0,-2553,2545,0,0,,5098,-8
44,11-01-18,96,23:45,0:00,,30.53,0,30.53,30.53,-1,-111569,136818,248387,25249,0,-11656,0,0,0,,11656,-11656
44,11-02-18,1,0:00,0:15,55.61,38.04,0,55.61,55.61,1,-107408,74227,181635,-33181,0,-8945,7504,0,0,,16449,-1441
44,11-02-18,2,0:15,0:30,49,30.54,0,30.54,30.54,-1,-79422,90280,169702,10858,0,-2853,8165,0,0,,11018,5312
44,11-02-18,3,0:30,0:45,,17.68,0,17.68,17.68,-1,-79880,85666,165546,5786,0,-20806,0,0,0,,20806,-20806
44,11-02-18,4,0:45,1:00,,18,0,18,18,-1,-82325,118283,200608,35958,0,-18147,0,0,0,,18147,-18147
44,11-02-18,5,1:00,1:15,183.79,18,0,183.79,18,2,-71911,76635,148546,4724,0,-24387,12856,0,0,,37243,-11531
44,11-02-18,6,1:15,1:30,350.65,18,0,350.65,350.65,1,-70191,80257,150448,10066,0,-225,55173,0,0,,55398,54948
44,11-02-18,7,1:30,1:45,53,41,0,41,41,-1,-34547,115413,149960,80866,0,-2455,7361,0,0,,9816,4906
44,11-02-18,8,1:45,2:00,,41,0,41,41,-1,-55602,120237,175839,64635,0,-5666,0,0,0,,5666,-5666
44,11-02-18,9,2:00,2:15,,37,0,37,37,-1,-74018,84287,158305,10269,0,-8942,0,0,0,,8942,-8942
44,11-02-18,10,2:15,2:30,,44.6,0,44.6,44.6,-1,-88211,74546,162757,-13665,0,-1456,0,0,0,,1456,-1456
44,11-02-18,11,2:30,2:45,47.81,,0,47.81,47.81,1,-93299,73233,166532,-20066,0,0,4270,0,0,,4270,4270
44,11-02-18,12,2:45,3:00,48.79,42.47,0,48.79,42.11,2,-93782,83620,177402,-10162,0,-284,6882,0,0,,7166,6598
44,11-02-18,13,3:00,3:15,46.19,41,0,46.19,41,2,-76969,70148,147117,-6821,0,-454,629,0,0,,1083,175
44,11-02-18,14,3:15,3:30,,37,0,37,37,-1,-64614,87559,152173,22945,0,-13772,0,0,0,,13772,-13772
44,11-02-18,15,3:30,3:45,,27.65,0,27.65,27.65,-1,-65430,111726,177156,46296,0,-37166,0,0,0,,37166,-37166
44,11-02-18,16,3:45,4:00,48.28,37,0,48.28,48.28,1,-89889,94640,184529,4751,0,-21248,325,0,0,,21573,-20923
44,11-02-18,17,4:00,4:15,68.03,37,0,68.03,68.03,1,-120453,71504,191957,-48949,0,-294,22466,0,0,,22760,22172
44,11-02-18,18,4:15,4:30,115.85,,0,115.85,115.85,1,-140061,72052,212113,-68009,0,0,57571,0,0,,57571,57571
44,11-02-18,19,4:30,4:45,55.71,,0,55.71,55.71,1,-121662,75561,197223,-46101,0,0,34199,0,0,,34199,34199
44,11-02-18,20,4:45,5:00,53,,0,53,53,1,-125403,82510,207913,-42893,0,0,35889,0,0,,35889,35889
44,11-02-18,21,5:00,5:15,49,33,0,33,33,-1,-110904,122890,233794,11986,0,-4133,11563,0,0,,15696,7430
44,11-02-18,22,5:15,5:30,108.5,44.45,0,108.5,108.5,1,-109057,70673,179730,-38384,0,-2681,12139,0,0,,14820,9458
44,11-02-18,23,5:30,5:45,230.65,,0,230.65,230.65,1,-132638,55159,187797,-77479,0,0,53700,0,0,,53700,53700
44,11-02-18,24,5:45,6:00,193.42,,0,193.42,193.42,1,-142866,95885,238751,-46981,0,0,63766,0,0,,63766,63766
44,11-02-18,25,6:00,6:15,193.42,-150.72,0,-150.72,-150.72,-1,-79949,222271,302220,142322,0,-42295,11655,0,0,,53950,-30640
44,11-02-18,26,6:15,6:30,,25.6,0,25.6,25.6,-1,-64401,113053,177454,48652,0,-44824,0,0,0,,44824,-44824
44,11-02-18,27,6:30,6:45,223.65,25.6,0,223.65,223.65,1,-132121,91244,223365,-40877,0,-3352,9127,0,0,,12479,5775
44,11-02-18,28,6:45,7:00,194.54,,0,194.54,194.54,1,-187771,122840,310611,-64931,0,0,49730,0,0,,49730,49730
44,11-02-18,29,7:00,7:15,64.3,41.19,0,41.19,41.19,-1,-143865,153674,297539,9809,0,-1901,28595,0,0,,30496,26694
44,11-02-18,30,7:15,7:30,350.65,41.19,0,350.65,350.65,1,-147735,88941,236676,-58794,0,-258,23003,0,0,,23261,22745
44,11-02-18,31,7:30,7:45,350.65,,0,350.65,350.65,1,-190921,109488,300409,-81433,0,0,58146,0,0,,58146,58146
44,11-02-18,32,7:45,8:00,254.12,,0,254.12,254.12,1,-203679,114769,318448,-88910,0,0,91871,3750,0,,95621,95621
44,11-02-18,33,8:00,8:15,350.65,24.01,0,24.01,24.01,-1,-139803,116256,256059,-23547,0,-848,55133,0,0,,55981,54285
44,11-02-18,34,8:15,8:30,239.31,-85.7,0,239.31,-85.7,2,-112001,66300,178301,-45701,0,-11146,8965,0,0,,20111,-2181
44,11-02-18,35,8:30,8:45,239.31,,0,239.31,239.31,1,-115399,73579,188978,-41820,0,0,40763,0,0,,40763,40763
44,11-02-18,36,8:45,9:00,57.29,,0,57.29,57.29,1,-122857,88817,211674,-34040,0,0,11183,0,0,,11183,11183
44,11-02-18,37,9:00,9:15,252.97,,0,252.97,252.97,1,-154659,55248,209907,-99411,0,0,54929,0,0,,54929,54929
44,11-02-18,38,9:15,9:30,86.92,,0,86.92,86.92,1,-128627,95165,223792,-33462,0,0,44883,0,0,,44883,44883
44,11-02-18,39,9:30,9:45,52.75,,0,52.75,52.75,1,-108272,82589,190861,-25683,0,0,18375,0,0,,18375,18375
44,11-02-18,40,9:45,10:00,54.78,,0,54.78,54.78,1,-129052,82693,211745,-46359,0,0,24803,0,0,,24803,24803
44,11-02-18,41,10:00,10:15,54.78,-140.33,0,-140.33,-140.33,-1,-51434,129885,181319,78451,0,-26474,8320,0,0,,34794,-18154
44,11-02-18,42,10:15,10:30,,27.61,0,27.61,27.61,-1,-73253,116570,189823,43317,0,-34422,0,0,0,,34422,-34422
44,11-02-18,43,10:30,10:45,,15.76,0,15.76,15.76,-1,-69225,140927,210152,71702,0,-56861,0,0,0,,56861,-56861
44,11-02-18,44,10:45,11:00,,0.91,0,0.91,0.91,-1,-80598,145990,226588,65392,0,-78309,0,0,0,,78309,-78309
44,11-02-18,45,11:00,11:15,,17.75,0,17.75,17.75,-1,-78709,151673,230382,72964,0,-69558,0,0,0,,69558,-69558
44,11-02-18,46,11:15,11:30,,15.64,0,15.64,15.64,-1,-87557,169101,256658,81544,0,-93874,0,0,0,,93874,-93874
44,11-02-18,47,11:30,11:45,,27.49,0,27.49,27.49,-1,-93328,160106,253434,66778,0,-80234,0,0,0,,80234,-80234
44,11-02-18,48,11:45,12:00,,21.94,0,21.94,21.94,-1,-109438,145861,255299,36423,0,-65875,0,0,0,,65875,-65875
44,11-02-18,49,12:00,12:15,198.52,21.94,0,198.52,198.52,1,-187238,85287,272525,-101951,0,-11638,21242,0,0,,32880,9604
44,11-02-18,50,12:15,12:30,48.75,32.75,0,48.75,32.75,2,-98186,106670,204856,8484,0,-4756,5912,0,0,,10668,1156
44,11-02-18,51,12:30,12:45,48.47,40.75,0,48.47,40.75,2,-100037,89210,189247,-10827,0,-6108,145,0,0,,6253,-5963
44,11-02-18,52,12:45,13:00,49.97,40.75,0,49.97,49.97,1,-114601,53323,167924,-61278,0,-426,2916,0,0,,3342,2490
44,11-02-18,53,13:00,13:15,212.9,,0,212.9,212.9,1,-134309,28219,162528,-106090,0,0,32111,0,0,,32111,32111
44,11-02-18,54,13:15,13:30,81.65,,0,81.65,81.65,1,-99774,60125,159899,-39649,0,0,41579,0,0,,41579,41579
44,11-02-18,55,13:30,13:45,,,0,45.09,45.09,0,-88648,82434,171082,-6214,0,0,3525,0,0,,3525,3525
44,11-02-18,56,13:45,14:00,,,0,45.09,45.09,0,-100317,82950,183267,-17367,0,0,0,0,0,,0,0
44,11-02-18,57,14:00,14:15,49.63,,0,49.63,49.63,1,-69998,52762,122760,-17236,0,0,1141,0,0,,1141,1141
44,11-02-18,58,14:15,14:30,48.75,,0,48.75,48.75,1,-68825,78063,146888,9238,0,0,1622,0,0,,1622,1622
44,11-02-18,59,14:30,14:45,,,0,45.21,45.21,0,-64901,85476,150377,20575,0,0,0,0,0,,0,0
44,11-02-18,60,14:45,15:00,50.38,,0,50.38,50.38,1,-124050,73477,197527,-50573,0,0,5320,0,0,,5320,5320
44,11-02-18,61,15:00,15:15,48.72,48.87,0,48.72,46.81,2,-124864,70097,194961,-54767,0,-91,270,0,0,,361,179
44,11-02-18,62,15:15,15:30,50.05,,0,50.05,50.05,1,-158481,61819,220300,-96662,0,0,2286,0,0,,2286,2286
44,11-02-18,63,15:30,15:45,217.76,,0,217.76,217.76,1,-187972,58656,246628,-129316,0,0,16446,0,0,,16446,16446
44,11-02-18,64,15:45,16:00,258.73,,0,258.73,258.73,1,-183414,64646,248060,-118768,0,0,41987,0,0,,41987,41987
44,11-02-18,65,16:00,16:15,,,0,46.2,46.2,0,-111550,56986,168536,-54564,0,0,3376,0,0,,3376,3376
44,11-02-18,66,16:15,16:30,70.99,,0,70.99,70.99,1,-130316,33107,163423,-97209,0,0,4287,0,0,,4287,4287
44,11-02-18,67,16:30,16:45,253.94,,0,253.94,253.94,1,-154935,36214,191149,-118721,0,0,28020,0,0,,28020,28020
44,11-02-18,68,16:45,17:00,253.94,,0,253.94,253.94,1,-172644,51401,224045,-121243,0,0,78164,0,0,,78164,78164
44,11-02-18,69,17:00,17:15,253.94,41.39,0,41.39,41.39,-1,-137912,158722,296634,20810,0,-1333,20226,0,0,,21559,18893
44,11-02-18,70,17:15,17:30,144.47,,0,144.47,144.47,1,-160646,111972,272618,-48674,0,0,7329,0,0,,7329,7329
44,11-02-18,71,17:30,17:45,313.76,,0,313.76,313.76,1,-214356,80774,295130,-133582,0,0,67143,0,0,,67143,67143
44,11-02-18,72,17:45,18:00,287.86,,0,287.86,287.86,1,-199980,92642,292622,-107338,0,0,84524,0,0,,84524,84524
44,11-02-18,73,18:00,18:15,44.86,44.82,0,55.46,44.82,2,-81270,108874,190144,27604,0,-175,26308,0,0,,26483,26133
44,11-02-18,74,18:15,18:30,,,0,55.49,55.49,0,-62872,101076,163948,38204,0,0,0,0,0,,0,0
44,11-02-18,75,18:30,18:45,,,0,57.12,57.12,0,-59553,107753,167306,48200,0,0,0,0,0,,0,0
44,11-02-18,76,18:45,19:00,,,0,57.14,57.14,0,-40937,112027,152964,71090,0,0,0,0,0,,0,0
44,11-02-18,77,19:00,19:15,54.17,,0,54.17,54.17,1,-99872,50950,150822,-48922,0,0,5918,0,0,,5918,5918
44,11-02-18,78,19:15,19:30,48.95,,0,48.95,48.95,1,-82576,52271,134847,-30305,0,0,6132,0,0,,6132,6132
44,11-02-18,79,19:30,19:45,51.75,,0,51.75,51.75,1,-84320,52903,137223,-31417,0,0,5497,0,0,,5497,5497
44,11-02-18,80,19:45,20:00,48.95,,0,48.95,48.95,1,-108883,53279,162162,-55604,0,0,9321,0,0,,9321,9321
44,11-02-18,81,20:00,20:15,49.68,,0,49.68,49.68,1,-123374,65489,188863,-57885,0,0,10609,0,0,,10609,10609
44,11-02-18,82,20:15,20:30,,,0,46.85,46.85,0,-103384,58938,162322,-44446,0,0,1582,0,0,,1582,1582
44,11-02-18,83,20:30,20:45,,46.79,0,46.79,46.79,-1,-72137,55966,128103,-16171,0,-55,0,0,0,,55,-55
44,11-02-18,84,20:45,21:00,,40.86,0,40.86,40.86,-1,-82961,81090,164051,-1871,0,-3302,0,0,0,,3302,-3302
44,11-02-18,85,21:00,21:15,96.78,27.32,0,96.78,27.32,2,-117717,105536,223253,-12181,0,-13140,2083,0,0,,15223,-11057
44,11-02-18,86,21:15,21:30,208.17,45.9,0,208.17,45.9,2,-113130,82458,195588,-30672,0,-20,26826,0,0,,26846,26806
44,11-02-18,87,21:30,21:45,208.17,40.86,0,40.86,40.86,-1,-82569,108360,190929,25791,0,-6064,173,0,0,,6237,-5891
44,11-02-18,88,21:45,22:00,,36.95,0,36.95,36.95,-1,-79388,99116,178504,19728,0,-19011,0,0,0,,19011,-19011
44,11-02-18,89,22:00,22:15,350.65,36.95,0,350.65,350.65,1,-108197,41759,149956,-66438,0,-9802,7590,0,0,,17392,-2212
44,11-02-18,90,22:15,22:30,195.6,36.95,0,195.6,195.6,1,-83690,44510,128200,-39180,0,-42,34025,0,0,,34067,33983
44,11-02-18,91,22:30,22:45,48.95,,0,48.95,48.95,1,-77751,58565,136316,-19186,0,0,5243,0,0,,5243,5243
44,11-02-18,92,22:45,23:00,50.95,,0,50.95,50.95,1,-110809,78934,189743,-31875,0,0,13220,0,0,,13220,13220
44,11-02-18,93,23:00,23:15,79.59,37.51,0,79.59,37.51,2,-135770,114606,250376,-21164,0,-2658,6758,0,0,,9416,4100
44,11-02-18,94,23:15,23:30,90.55,36.95,0,90.55,36.95,2,-116391,85782,202173,-30609,0,-354,11199,0,0,,11553,10845
44,11-02-18,95,23:30,23:45,90.55,17.13,0,17.13,17.13,-1,-70509,96043,166552,25534,0,-22998,297,0,0,,23295,-22701
44,11-02-18,96,23:45,0:00,,37.39,0,37.39,37.39,-1,-78662,94673,173335,16011,0,-23782,0,0,0,,23782,-23782
45,11-03-18,1,0:00,0:15,,10.59,0,10.59,10.59,-1,-52876,104407,157283,51531,0,-35615,0,0,0,,35615,-35615
45,11-03-18,2,0:15,0:30,,40.18,0,40.18,40.18,-1,-58633,46767,105400,-11866,0,-8894,0,0,0,,8894,-8894
45,11-03-18,3,0:30,0:45,,40.75,0,40.75,40.75,-1,-42762,41280,84042,-1482,0,-4622,0,0,0,,4622,-4622
45,11-03-18,4,0:45,1:00,,38.83,0,38.83,38.83,-1,-61697,57041,118738,-4656,0,-3651,0,0,0,,3651,-3651
45,11-03-18,5,1:00,1:15,,36.75,0,36.75,36.75,-1,-53828,30518,84346,-23310,0,-4482,0,0,0,,4482,-4482
45,11-03-18,6,1:15,1:30,,41.59,0,41.59,41.59,-1,-43410,23206,66616,-20204,0,-499,0,0,0,,499,-499
45,11-03-18,7,1:30,1:45,,36.75,0,36.75,36.75,-1,-28427,45337,73764,16910,0,-14666,0,0,0,,14666,-14666
45,11-03-18,8,1:45,2:00,,32.75,0,32.75,32.75,-1,-23366,55646,79012,32280,0,-27099,0,0,0,,27099,-27099
45,11-03-18,9,2:00,2:15,,31.03,0,31.03,31.03,-1,-44025,41109,85134,-2916,0,-24131,0,0,0,,24131,-24131
45,11-03-18,10,2:15,2:30,44.12,31.03,0,44.12,44.12,1,-50701,34844,85545,-15857,0,-1400,758,0,0,,2158,-642
45,11-03-18,11,2:30,2:45,44.12,34.09,0,34.09,34.09,-1,-35407,49178,84585,13771,0,-11641,18,0,0,,11659,-11623
45,11-03-18,12,2:45,3:00,,36.75,0,36.75,36.75,-1,-32188,50628,82816,18440,0,-22033,0,0,0,,22033,-22033
45,11-03-18,13,3:00,3:15,,40.08,0,40.08,40.08,-1,-43033,25040,68073,-17993,0,-8875,0,0,0,,8875,-8875
45,11-03-18,14,3:15,3:30,,40.75,0,40.75,40.75,-1,-39811,38495,78306,-1316,0,-2343,0,0,0,,2343,-2343
45,11-03-18,15,3:30,3:45,,33.4,0,33.4,33.4,-1,-40584,59565,100149,18981,0,-19438,0,0,0,,19438,-19438
45,11-03-18,16,3:45,4:00,,34.19,0,34.19,34.19,-1,-37636,53133,90769,15497,0,-27343,0,0,0,,27343,-27343
45,11-03-18,17,4:00,4:15,,40.75,0,40.75,40.75,-1,-32349,34487,66836,2138,0,-7281,0,0,0,,7281,-7281
45,11-03-18,18,4:15,4:30,,40.75,0,40.75,40.75,-1,-42822,51957,94779,9135,0,-6198,0,0,0,,6198,-6198
45,11-03-18,19,4:30,4:45,,40.75,0,40.75,40.75,-1,-47629,50919,98548,3290,0,-4426,0,0,0,,4426,-4426
45,11-03-18,20,4:45,5:00,,38.25,0,38.25,38.25,-1,-46111,54859,100970,8748,0,-7414,0,0,0,,7414,-7414
45,11-03-18,21,5:00,5:15,,35.4,0,35.4,35.4,-1,-25415,41669,67084,16254,0,-22137,0,0,0,,22137,-22137
45,11-03-18,22,5:15,5:30,,38.95,0,38.95,38.95,-1,-37888,53423,91311,15535,0,-11255,0,0,0,,11255,-11255
45,11-03-18,23,5:30,5:45,,40.75,0,40.75,40.75,-1,-51292,52077,103369,785,0,-12109,0,0,0,,12109,-12109
45,11-03-18,24,5:45,6:00,,40.75,0,40.75,40.75,-1,-39306,59747,99053,20441,0,-4416,0,0,0,,4416,-4416
45,11-03-18,25,6:00,6:15,,,0,44.89,44.89,0,-118462,34332,152794,-84130,0,-133,0,0,0,,133,-133
45,11-03-18,26,6:15,6:30,44.83,45.12,0,45.19,45.12,2,-45120,37366,82486,-7754,0,-53,90,0,0,,143,37
45,11-03-18,27,6:30,6:45,,45.03,0,45.03,45.03,-1,-56503,36754,93257,-19749,0,-628,0,0,0,,628,-628
45,11-03-18,28,6:45,7:00,,28.4,0,28.4,28.4,-1,-41198,76321,117519,35123,0,-7226,0,0,0,,7226,-7226
45,11-03-18,29,7:00,7:15,46.03,28.4,0,46.03,46.03,1,-162923,28854,191777,-134069,0,-1793,239,0,0,,2032,-1554
45,11-03-18,30,7:15,7:30,,,0,45.19,45.19,0,-72878,32004,104882,-40874,0,0,0,0,0,,0,0
45,11-03-18,31,7:30,7:45,,,0,45.22,45.22,0,-58692,38507,97199,-20185,0,0,0,0,0,,0,0
45,11-03-18,32,7:45,8:00,,,0,45.22,45.22,0,-69559,53502,123061,-16057,0,0,0,0,0,,0,0
45,11-03-18,33,8:00,8:15,,,0,45.72,45.72,0,-90311,48598,138909,-41713,0,0,0,0,0,,0,0
45,11-03-18,34,8:15,8:30,44.89,,0,44.89,44.89,1,-119685,49835,169520,-69850,0,0,658,0,0,,658,658
45,11-03-18,35,8:30,8:45,68.03,,0,68.03,68.03,1,-146403,52010,198413,-94393,0,0,18172,0,0,,18172,18172
45,11-03-18,36,8:45,9:00,54.17,,0,54.17,54.17,1,-146486,67907,214393,-78579,0,0,23439,0,0,,23439,23439
45,11-03-18,37,9:00,9:15,47.38,,0,47.38,47.38,1,-123630,58293,181923,-65337,0,0,12128,0,0,,12128,12128
45,11-03-18,38,9:15,9:30,,,0,45.67,45.67,0,-127208,43762,170970,-83446,0,0,130,0,0,,130,130
45,11-03-18,39,9:30,9:45,,,0,45.67,45.67,0,-97557,52994,150551,-44563,0,0,0,0,0,,0,0
45,11-03-18,40,9:45,10:00,52.46,41.11,0,52.46,41.11,2,-71825,39903,111728,-31922,0,-13,5568,0,0,,5581,5555
45,11-03-18,41,10:00,10:15,248.38,42.84,0,248.38,42.84,2,-102186,21670,123856,-80516,0,-406,16734,0,0,,17140,16328
45,11-03-18,42,10:15,10:30,248.38,,0,248.38,248.38,1,-99334,59818,159152,-39516,0,0,34014,0,0,,34014,34014
45,11-03-18,43,10:30,10:45,49.03,43.66,0,43.66,43.66,-1,-84053,75425,159478,-8628,0,-1051,14588,0,0,,15639,13537
45,11-03-18,44,10:45,11:00,46.61,43.66,0,46.61,46.61,1,-87342,80165,167507,-7177,0,-601,870,0,0,,1471,269
45,11-03-18,45,11:00,11:15,49.03,,0,49.03,49.03,1,-101355,75049,176404,-26306,0,0,4476,0,0,,4476,4476
45,11-03-18,46,11:15,11:30,44.89,,0,44.89,44.89,1,-89661,83428,173089,-6233,0,0,553,0,0,,553,553
45,11-03-18,47,11:30,11:45,45.96,,0,45.96,45.96,1,-103334,92164,195498,-11170,0,0,712,0,0,,712,712
45,11-03-18,48,11:45,12:00,,41.58,0,41.58,41.58,-1,-101770,94273,196043,-7497,0,-2083,0,0,0,,2083,-2083
45,11-03-18,49,12:00,12:15,,-50.5,0,-50.5,-50.5,-1,-17213,88262,105475,71049,0,-35883,0,0,0,,35883,-35883
45,11-03-18,50,12:15,12:30,,,0,44.39,44.39,0,-47591,74440,122031,26849,0,-11489,0,0,0,,11489,-11489
45,11-03-18,51,12:30,12:45,,15.13,0,15.13,15.13,-1,-23086,89570,112656,66484,0,-4193,0,0,0,,4193,-4193
45,11-03-18,52,12:45,13:00,,-71.15,0,-71.15,-71.15,-1,-16127,102944,119071,86817,0,-74891,0,0,0,,74891,-74891
45,11-03-18,53,13:00,13:15,,18.03,0,18.03,18.03,-1,-52445,83593,136038,31148,0,-50022,0,0,0,,50022,-50022
45,11-03-18,54,13:15,13:30,,,0,44.4,44.4,0,-67004,85015,152019,18011,0,-4374,0,0,0,,4374,-4374
45,11-03-18,55,13:30,13:45,,44.66,0,44.66,44.66,-1,-70103,84452,154555,14349,0,-31,0,0,0,,31,-31
45,11-03-18,56,13:45,14:00,,37.03,0,37.03,37.03,-1,-69902,87446,157348,17544,0,-8655,0,0,0,,8655,-8655
45,11-03-18,57,14:00,14:15,52.07,44.91,0,52.07,44.46,2,-74383,41056,115439,-33327,0,-1061,8090,0,0,,9151,7029
45,11-03-18,58,14:15,14:30,44.89,,0,44.89,44.89,1,-85971,41779,127750,-44192,0,0,3502,0,0,,3502,3502
45,11-03-18,59,14:30,14:45,44.89,,0,44.89,44.89,1,-100303,31307,131610,-68996,0,0,135,0,0,,135,135
45,11-03-18,60,14:45,15:00,44.89,,0,44.89,44.89,1,-121774,27287,149061,-94487,0,0,837,0,0,,837,837
45,11-03-18,61,15:00,15:15,47.34,,0,47.34,47.34,1,-127565,44833,172398,-82732,0,0,1909,0,0,,1909,1909
45,11-03-18,62,15:15,15:30,49.7,,0,49.7,49.7,1,-141501,31623,173124,-109878,0,0,5310,0,0,,5310,5310
45,11-03-18,63,15:30,15:45,224.38,,0,224.38,224.38,1,-170632,33144,203776,-137488,0,0,37867,0,0,,37867,37867
45,11-03-18,64,15:45,16:00,224.38,,0,224.38,224.38,1,-163104,56589,219693,-106515,0,0,64850,0,0,,64850,64850
45,11-03-18,65,16:00,16:15,224.38,18.03,0,18.03,18.03,-1,-57259,80667,137926,23408,0,-10123,10498,0,0,,20621,375
45,11-03-18,66,16:15,16:30,46.43,18.03,0,46.43,46.43,1,-65418,53818,119236,-11600,0,-241,946,0,0,,1187,705
45,11-03-18,67,16:30,16:45,94.02,,0,94.02,94.02,1,-88408,54434,142842,-33974,0,0,12916,0,0,,12916,12916
45,11-03-18,68,16:45,17:00,104.02,,0,104.02,104.02,1,-121772,56205,177977,-65567,0,0,43752,0,0,,43752,43752
45,11-03-18,69,17:00,17:15,104.02,-90.48,0,-90.48,-90.48,-1,-27405,108985,136390,81580,0,-29449,10571,0,0,,40020,-18878
45,11-03-18,70,17:15,17:30,60.71,42.02,0,60.71,60.71,1,-58290,33408,91698,-24882,0,-3042,1641,0,0,,4683,-1401
45,11-03-18,71,17:30,17:45,97.1,,0,97.1,97.1,1,-98355,44563,142918,-53792,0,0,31358,0,0,,31358,31358
45,11-03-18,72,17:45,18:00,53.03,,0,53.03,53.03,1,-89853,56272,146125,-33581,0,0,29317,0,0,,29317,29317
45,11-03-18,73,18:00,18:15,53.03,,0,53.03,53.03,1,-77383,43132,120515,-34251,0,0,26545,0,0,,26545,26545
45,11-03-18,74,18:15,18:30,,,0,45.71,45.71,0,-51652,34823,86475,-16829,0,0,6799,0,0,,6799,6799
45,11-03-18,75,18:30,18:45,44.89,46.55,0,45.72,45.72,2,-46939,42319,89258,-4620,0,-11,1051,0,0,,1062,1040
45,11-03-18,76,18:45,19:00,,36.8,0,36.8,36.8,-1,-41827,76428,118255,34601,0,-11499,0,0,0,,11499,-11499
45,11-03-18,77,19:00,19:15,47.21,40.89,0,47.21,40.89,2,-60009,30387,90396,-29622,0,-12802,801,0,0,,13603,-12001
45,11-03-18,78,19:15,19:30,47.21,43.64,0,43.64,43.64,-1,-42434,42656,85090,222,0,-1405,51,0,0,,1456,-1354
45,11-03-18,79,19:30,19:45,,33.03,0,33.03,33.03,-1,-31616,66567,98183,34951,0,-24928,0,0,0,,24928,-24928
45,11-03-18,80,19:45,20:00,,39.03,0,39.03,39.03,-1,-51336,51984,103320,648,0,-18184,0,0,0,,18184,-18184
45,11-03-18,81,20:00,20:15,,33.03,0,33.03,33.03,-1,-59656,73455,133111,13799,0,-3664,0,0,0,,3664,-3664
45,11-03-18,82,20:15,20:30,,,0,44.94,44.94,0,-67048,33301,100349,-33747,0,0,0,0,0,,0,0
45,11-03-18,83,20:30,20:45,,40.89,0,40.89,40.89,-1,-44212,32927,77139,-11285,0,-192,0,0,0,,192,-192
45,11-03-18,84,20:45,21:00,,40.89,0,40.89,40.89,-1,-67490,45019,112509,-22471,0,-1387,0,0,0,,1387,-1387
45,11-03-18,85,21:00,21:15,85.23,40.89,0,85.23,85.23,1,-104257,64721,168978,-39536,0,-26,8175,0,0,,8201,8149
45,11-03-18,86,21:15,21:30,200.34,,0,200.34,200.34,1,-81341,11283,92624,-70058,0,0,55720,0,0,,55720,55720
45,11-03-18,87,21:30,21:45,47.79,,0,47.79,47.79,1,-37214,27124,64338,-10090,0,0,12248,0,0,,12248,12248
45,11-03-18,88,21:45,22:00,47.79,40.89,0,40.89,40.89,-1,-44067,40770,84837,-3297,0,-1067,632,0,0,,1699,-435
45,11-03-18,89,22:00,22:15,,40.68,0,40.68,40.68,-1,-61264,67663,128927,6399,0,-700,0,0,0,,700,-700
45,11-03-18,90,22:15,22:30,,37.03,0,37.03,37.03,-1,-44792,49392,94184,4600,0,-539,0,0,0,,539,-539
45,11-03-18,91,22:30,22:45,,29.78,0,29.78,29.78,-1,-27304,66685,93989,39381,0,-14916,0,0,0,,14916,-14916
45,11-03-18,92,22:45,23:00,,36.46,0,36.46,36.46,-1,-34735,71270,106005,36535,0,-19455,0,0,0,,19455,-19455
45,11-03-18,93,23:00,23:15,,33.03,0,33.03,33.03,-1,-72519,67955,140474,-4564,0,-12885,0,0,0,,12885,-12885
45,11-03-18,94,23:15,23:30,,,0,43.28,43.28,0,-78084,56549,134633,-21535,0,-120,0,0,0,,120,-120
45,11-03-18,95,23:30,23:45,,41.87,0,41.87,41.87,-1,-52672,37629,90301,-15043,0,-1169,0,0,0,,1169,-1169
45,11-03-18,96,23:45,0:00,,37.03,0,37.03,37.03,-1,-58546,46035,104581,-12511,0,-2638,0,0,0,,2638,-2638
45,11-04-18,1,0:00,0:15,200.34,43.67,0,200.34,43.15,2,-101594,67266,168860,-34328,0,-208,11931,0,0,,12139,11723
45,11-04-18,2,0:15,0:30,200.34,,0,200.34,200.34,1,-199061,41179,240240,-157882,0,0,103902,0,0,,103902,103902
45,11-04-18,3,0:30,0:45,200.34,,0,200.34,200.34,1,-138918,40905,179823,-98013,0,0,80363,15000,0,,95363,95363
45,11-04-18,4,0:45,1:00,40.12,40.53,0,43.26,40.53,2,-93128,104882,198010,11754,0,-4451,4267,0,0,,8718,-184
45,11-04-18,5,1:00,1:15,86.72,43.78,0,86.72,43.2,2,-58380,37232,95612,-21148,0,-1634,6892,0,0,,8526,5258
45,11-04-18,6,1:15,1:30,133.14,,0,133.14,133.14,1,-62846,41249,104095,-21597,0,0,33802,0,0,,33802,33802
45,11-04-18,7,1:30,1:45,48.53,44.86,0,48.53,43.26,2,-51660,49399,101059,-2261,0,-460,3432,0,0,,3892,2972
45,11-04-18,8,1:45,2:00,59.56,,0,59.56,59.56,1,-66067,41826,107893,-24241,0,0,22441,0,0,,22441,22441
45,11-04-18,9,2:00,2:15,44.53,42.39,0,44.53,42.39,2,-67490,74629,142119,7139,0,-979,4016,0,0,,4995,3037
45,11-04-18,10,2:15,2:30,45.51,46.24,0,45.51,43.68,2,-66890,48718,115608,-18172,0,-641,1546,0,0,,2187,905
45,11-04-18,11,2:30,2:45,45.57,,0,45.57,45.57,1,-70870,50380,121250,-20490,0,0,7047,0,0,,7047,7047
45,11-04-18,12,2:45,3:00,44.53,42.39,0,44.53,42.39,2,-56758,54113,110871,-2645,0,-529,2963,0,0,,3492,2434
45,11-04-18,13,3:00,3:15,58.99,42.39,0,58.99,58.99,1,-94268,42802,137070,-51466,0,-1250,21729,0,0,,22979,20479
45,11-04-18,14,3:15,3:30,48.53,,0,48.53,48.53,1,-77445,40534,117979,-36911,0,0,33460,0,0,,33460,33460
45,11-04-18,15,3:30,3:45,48.51,,0,48.51,48.51,1,-68051,36935,104986,-31116,0,0,28824,0,0,,28824,28824
45,11-04-18,16,3:45,4:00,54.83,,0,54.83,54.83,1,-71375,38783,110158,-32592,0,0,28979,0,0,,28979,28979
45,11-04-18,17,4:00,4:15,48.53,,0,48.53,48.53,1,-68957,52215,121172,-16742,0,0,14391,0,0,,14391,14391
45,11-04-18,18,4:15,4:30,58.5,,0,58.5,58.5,1,-92929,34930,127859,-57999,0,0,41586,0,0,,41586,41586
45,11-04-18,19,4:30,4:45,50.54,,0,50.54,50.54,1,-95536,44833,140369,-50703,0,0,42059,0,0,,42059,42059
45,11-04-18,20,4:45,5:00,48.53,,0,48.53,48.53,1,-97679,60205,157884,-37474,0,0,28675,0,0,,28675,28675
45,11-04-18,21,5:00,5:15,47.17,,0,47.17,47.17,1,-58818,31389,90207,-27429,0,0,18361,0,0,,18361,18361
45,11-04-18,22,5:15,5:30,44.91,,0,44.91,44.91,1,-50335,34341,84676,-15994,0,0,11550,0,0,,11550,11550
45,11-04-18,23,5:30,5:45,58.5,,0,58.5,58.5,1,-75660,28968,104628,-46692,0,0,11709,0,0,,11709,11709
45,11-04-18,24,5:45,6:00,80.12,,0,80.12,80.12,1,-96427,34942,131369,-61485,0,0,50912,0,0,,50912,50912
45,11-04-18,25,6:00,6:15,52.96,41.48,0,41.48,41.48,-1,-64740,63352,128092,-1388,0,-1042,16555,0,0,,17597,15513
45,11-04-18,26,6:15,6:30,46.73,36.96,0,46.73,36.96,2,-54726,46590,101316,-8136,0,-9358,607,0,0,,9965,-8751
45,11-04-18,27,6:30,6:45,55.76,36.96,0,55.76,55.76,1,-55842,38626,94468,-17216,0,-146,9641,0,0,,9787,9495
45,11-04-18,28,6:45,7:00,58.24,,0,58.24,58.24,1,-72305,28662,100967,-43643,0,0,27176,0,0,,27176,27176
45,11-04-18,29,7:00,7:15,52.96,44.4,0,44.4,44.4,-1,-73574,61168,134742,-12406,0,-82,19655,0,0,,19737,19573
45,11-04-18,30,7:15,7:30,52.96,39.12,0,39.12,39.12,-1,-64048,57549,121597,-6499,0,-2477,1237,0,0,,3714,-1240
45,11-04-18,31,7:30,7:45,48.96,42.03,0,48.96,42.03,2,-65622,49522,115144,-16100,0,-2273,904,0,0,,3177,-1369
45,11-04-18,32,7:45,8:00,56.15,,0,56.15,56.15,1,-82984,36701,119685,-46283,0,0,24710,0,0,,24710,24710
45,11-04-18,33,8:00,8:15,56.15,42.39,0,42.39,42.39,-1,-42465,31944,74409,-10521,0,-2390,3085,0,0,,5475,695
45,11-04-18,34,8:15,8:30,,45.89,0,45.89,45.89,-1,-42794,26883,69677,-15911,0,-1129,0,0,0,,1129,-1129
45,11-04-18,35,8:30,8:45,,45.88,0,45.88,45.88,-1,-58694,38984,97678,-19710,0,-68,0,0,0,,68,-68
45,11-04-18,36,8:45,9:00,44.07,45.82,0,44.07,42.97,2,-60716,32829,93545,-27887,0,-202,52,0,0,,254,-150
45,11-04-18,37,9:00,9:15,,36.96,0,36.96,36.96,-1,-104276,79701,183977,-24575,0,-15254,0,0,0,,15254,-15254
45,11-04-18,38,9:15,9:30,,39.78,0,39.78,39.78,-1,-74713,82386,157099,7673,0,-15922,0,0,0,,15922,-15922
45,11-04-18,39,9:30,9:45,,40.96,0,40.96,40.96,-1,-69382,83903,153285,14521,0,-13308,0,0,0,,13308,-13308
45,11-04-18,40,9:45,10:00,,40.61,0,40.61,40.61,-1,-63102,64496,127598,1394,0,-9996,0,0,0,,9996,-9996
45,11-04-18,41,10:00,10:15,51.73,40.61,0,51.73,51.73,1,-71081,45863,116944,-25218,0,-61,5705,0,0,,5766,5644
45,11-04-18,42,10:15,10:30,,,0,44.66,44.66,0,-63214,56324,119538,-6890,0,0,1441,0,0,,1441,1441
45,11-04-18,43,10:30,10:45,44.96,,0,44.96,44.96,1,-59921,44156,104077,-15765,0,0,463,0,0,,463,463
45,11-04-18,44,10:45,11:00,48.96,,0,48.96,48.96,1,-54496,37603,92099,-16893,0,0,2806,0,0,,2806,2806
45,11-04-18,45,11:00,11:15,138.12,,0,138.12,138.12,1,-91475,35865,127340,-55610,0,0,25018,0,0,,25018,25018
45,11-04-18,46,11:15,11:30,52.96,,0,52.96,52.96,1,-57524,46560,104084,-10964,0,0,20551,0,0,,20551,20551
45,11-04-18,47,11:30,11:45,44.96,41.17,0,45.45,41.17,2,-50203,39812,90015,-10391,0,-2436,1885,0,0,,4321,-551
45,11-04-18,48,11:45,12:00,55.72,,0,55.72,55.72,1,-67688,20016,87704,-47672,0,0,22358,0,0,,22358,22358
45,11-04-18,49,12:00,12:15,48.96,42.78,0,48.96,42.78,2,-38364,36256,74620,-2108,0,-738,7825,0,0,,8563,7087
45,11-04-18,50,12:15,12:30,49.16,,0,49.16,49.16,1,-55402,25118,80520,-30284,0,0,4157,0,0,,4157,4157
45,11-04-18,51,12:30,12:45,58.64,,0,58.64,58.64,1,-71512,20179,91691,-51333,0,0,33588,0,0,,33588,33588
45,11-04-18,52,12:45,13:00,48.96,,0,48.96,48.96,1,-71435,29249,100684,-42186,0,0,28127,0,0,,28127,28127
45,11-04-18,53,13:00,13:15,44.01,,0,44.01,44.01,1,-54778,32426,87204,-22352,0,0,7122,0,0,,7122,7122
45,11-04-18,54,13:15,13:30,44.01,,0,44.01,44.01,1,-62406,15862,78268,-46544,0,0,574,0,0,,574,574
45,11-04-18,55,13:30,13:45,44.01,,0,44.01,44.01,1,-69824,18355,88179,-51469,0,0,1860,0,0,,1860,1860
45,11-04-18,56,13:45,14:00,44.01,,0,44.01,44.01,1,-74291,23853,98144,-50438,0,0,3,0,0,,3,3
45,11-04-18,57,14:00,14:15,,41.87,0,41.87,41.87,-1,-34714,45429,80143,10715,0,-3081,0,0,0,,3081,-3081
45,11-04-18,58,14:15,14:30,,40.96,0,40.96,40.96,-1,-42417,45575,87992,3158,0,-7097,0,0,0,,7097,-7097
45,11-04-18,59,14:30,14:45,45.75,44.98,0,45.75,45.75,1,-50996,35905,86901,-15091,0,-765,644,0,0,,1409,-121
45,11-04-18,60,14:45,15:00,54.78,,0,54.78,54.78,1,-73727,28569,102296,-45158,0,0,22769,0,0,,22769,22769
45,11-04-18,61,15:00,15:15,50.04,,0,50.04,50.04,1,-53839,33956,87795,-19883,0,0,16842,0,0,,16842,16842
45,11-04-18,62,15:15,15:30,50.04,,0,50.04,50.04,1,-64400,25970,90370,-38430,0,0,15170,0,0,,15170,15170
45,11-04-18,63,15:30,15:45,68.2,,0,68.2,68.2,1,-82351,25253,107604,-57098,0,0,39367,0,0,,39367,39367
45,11-04-18,64,15:45,16:00,60.12,,0,60.12,60.12,1,-79800,23068,102868,-56732,0,0,44961,0,0,,44961,44961
45,11-04-18,65,16:00,16:15,44.96,46.59,0,45.41,45.41,2,-62830,66614,129444,3784,0,-250,7536,0,0,,7786,7286
45,11-04-18,66,16:15,16:30,48.96,46.59,0,48.96,48.96,1,-70993,37029,108022,-33964,0,-4,3671,0,0,,3675,3667
45,11-04-18,67,16:30,16:45,59.28,,0,59.28,59.28,1,-84414,34554,118968,-49860,0,0,11301,0,0,,11301,11301
45,11-04-18,68,16:45,17:00,48.96,,0,48.96,48.96,1,-117539,43773,161312,-73766,0,0,9188,0,0,,9188,9188
45,11-04-18,69,17:00,17:15,,-9.18,0,-9.18,-9.18,-1,-55780,151830,207610,96050,0,-23651,0,0,0,,23651,-23651
45,11-04-18,70,17:15,17:30,72.97,40.96,0,72.97,72.97,1,-88695,48862,137557,-39833,0,-8593,1493,0,0,,10086,-7100
45,11-04-18,71,17:30,17:45,247.65,,0,247.65,247.65,1,-169517,41054,210571,-128463,0,0,59826,0,0,,59826,59826
45,11-04-18,72,17:45,18:00,247.65,,0,247.65,247.65,1,-154768,78723,233491,-76045,0,0,88336,0,0,,88336,88336
45,11-04-18,73,18:00,18:15,68.2,,0,68.2,68.2,1,-128545,82236,210781,-46309,0,0,43888,0,0,,43888,43888
45,11-04-18,74,18:15,18:30,48.96,,0,48.96,48.96,1,-117475,95042,212517,-22433,0,0,15950,0,0,,15950,15950
45,11-04-18,75,18:30,18:45,44.96,44.92,0,45.76,44.92,2,-113947,117552,231499,3605,0,-437,4291,0,0,,4728,3854
45,11-04-18,76,18:45,19:00,48.96,44.92,0,48.96,48.96,1,-89960,77552,167512,-12408,0,-24,1930,0,0,,1954,1906
45,11-04-18,77,19:00,19:15,236.76,,0,236.76,236.76,1,-136089,41615,177704,-94474,0,0,48367,0,0,,48367,48367
45,11-04-18,78,19:15,19:30,210,,0,210,210,1,-140548,84266,224814,-56282,0,0,56601,5000,0,,61601,61601
45,11-04-18,79,19:30,19:45,51.12,,0,51.12,51.12,1,-130063,108686,238749,-21377,0,0,16657,0,0,,16657,16657
45,11-04-18,80,19:45,20:00,56.23,,0,56.23,56.23,1,-139947,101090,241037,-38857,0,0,21480,0,0,,21480,21480
45,11-04-18,81,20:00,20:15,250.3,,0,250.3,250.3,1,-214583,80133,294716,-134450,0,0,49951,0,0,,49951,49951
45,11-04-18,82,20:15,20:30,272.82,,0,300.1,300.1,1,-246899,103584,350483,-143315,0,0,89040,3750,23332,,116122,116122
45,11-04-18,83,20:30,20:45,47.15,40.38,0,269.9,40.38,2,-153026,127233,280259,-25793,0,-1096,23204,0,23332,,47632,45440
45,11-04-18,84,20:45,21:00,52.96,,0,52.96,52.96,1,-165030,131339,296369,-33691,0,0,9484,0,0,,9484,9484
45,11-04-18,85,21:00,21:15,52.96,,0,52.96,52.96,1,-139454,113113,252567,-26341,0,0,15526,0,0,,15526,15526
45,11-04-18,86,21:15,21:30,56.2,,0,56.2,56.2,1,-137327,105471,242798,-31856,0,0,13045,0,0,,13045,13045
45,11-04-18,87,21:30,21:45,91.23,,0,91.23,91.23,1,-136547,76088,212635,-60459,0,0,47059,0,0,,47059,47059
45,11-04-18,88,21:45,22:00,52.37,,0,52.37,52.37,1,-126224,89023,215247,-37201,0,0,23518,0,0,,23518,23518
45,11-04-18,89,22:00,22:15,56.2,,0,56.2,56.2,1,-64117,39267,103384,-24850,0,0,13088,0,0,,13088,13088
45,11-04-18,90,22:15,22:30,47.12,37.37,0,47.12,37.37,2,-59310,60723,120033,1413,0,-4894,6038,0,0,,10932,1144
45,11-04-18,91,22:30,22:45,,40.96,0,40.96,40.96,-1,-79648,85953,165601,6305,0,-16132,0,0,0,,16132,-16132
45,11-04-18,92,22:45,23:00,48.96,46.18,0,48.96,48.96,1,-88571,74947,163518,-13624,0,-3565,1845,0,0,,5410,-1720
45,11-04-18,93,23:00,23:15,217.53,,0,217.53,217.53,1,-110491,22490,132981,-88001,0,0,25429,0,0,,25429,25429
45,11-04-18,94,23:15,23:30,217.53,43.94,0,217.53,43.94,2,-79815,41164,120979,-38651,0,-22,51628,0,0,,51650,51606
45,11-04-18,95,23:30,23:45,217.53,-15.59,0,-15.59,-15.59,-1,-38493,67658,106151,29165,0,-22582,1428,0,0,,24010,-21154
45,11-04-18,96,23:45,0:00,,36.96,0,36.96,36.96,-1,-52233,75353,127586,23120,0,-27703,0,0,0,,27703,-27703
45,11-05-18,1,0:00,0:15,232.72,41.47,0,232.72,232.72,1,-109503,49359,158862,-60144,0,-11195,14902,0,0,,26097,3707
45,11-05-18,2,0:15,0:30,53.47,,0,53.47,53.47,1,-76276,64996,141272,-11280,0,0,14234,0,0,,14234,14234
45,11-05-18,3,0:30,0:45,68.8,,0,68.8,68.8,1,-110498,70036,180534,-40462,0,0,14501,0,0,,14501,14501
45,11-05-18,4,0:45,1:00,62.06,,0,62.06,62.06,1,-123172,83584,206756,-39588,0,0,30977,0,0,,30977,30977
45,11-05-18,5,1:00,1:15,183.95,,0,183.95,183.95,1,-203174,100866,304040,-102308,0,0,48342,0,0,,48342,48342
45,11-05-18,6,1:15,1:30,183.95,,0,183.95,183.95,1,-219625,98416,318041,-121209,0,0,103354,0,0,,103354,103354
45,11-05-18,7,1:30,1:45,188.37,,0,188.37,188.37,1,-195769,111879,307648,-83890,0,0,87022,15000,0,,102022,102022
45,11-05-18,8,1:45,2:00,54.56,,0,54.56,54.56,1,-158162,112761,270923,-45401,0,0,32397,0,0,,32397,32397
45,11-05-18,9,2:00,2:15,48.26,41.8,0,48.26,41.79,2,-83048,126979,210027,43931,0,-1037,11619,0,0,,12656,10582
45,11-05-18,10,2:15,2:30,,,0,43.87,43.87,0,-77272,115603,192875,38331,0,0,4,0,0,,4,4
45,11-05-18,11,2:30,2:45,,,0,43.87,43.87,0,-51604,103804,155408,52200,0,0,0,0,0,,0,0
45,11-05-18,12,2:45,3:00,,40.3,0,40.3,40.3,-1,-61533,82338,143871,20805,0,-2735,0,0,0,,2735,-2735
45,11-05-18,13,3:00,3:15,,42.4,0,42.4,42.4,-1,-50536,89459,139995,38923,0,-1158,0,0,0,,1158,-1158
45,11-05-18,14,3:15,3:30,,,0,43.27,43.27,0,-55575,51626,107201,-3949,0,0,0,0,0,,0,0
45,11-05-18,15,3:30,3:45,44.13,,0,44.13,44.13,1,-56680,52053,108733,-4627,0,0,4,0,0,,4,4
45,11-05-18,16,3:45,4:00,44.12,37.47,0,44.12,37.47,2,-45333,52449,97782,7116,0,-3180,89,0,0,,3269,-3091
45,11-05-18,17,4:00,4:15,,41.71,0,41.71,41.71,-1,-64216,66703,130919,2487,0,-1699,0,0,0,,1699,-1699
45,11-05-18,18,4:15,4:30,,,0,41.74,41.74,0,-66771,60377,127148,-6394,0,0,0,0,0,,0,0
45,11-05-18,19,4:30,4:45,,,0,41.71,41.71,0,-61588,84718,146306,23130,0,0,0,0,0,,0,0
45,11-05-18,20,4:45,5:00,,,0,41.69,41.69,0,-59340,130747,190087,71407,0,0,0,0,0,,0,0
45,11-05-18,21,5:00,5:15,,37.47,0,37.47,37.47,-1,-113050,116213,229263,3163,0,-9951,0,0,0,,9951,-9951
45,11-05-18,22,5:15,5:30,,33.47,0,33.47,33.47,-1,-91336,109102,200438,17766,0,-24710,0,0,0,,24710,-24710
45,11-05-18,23,5:30,5:45,55.65,41.47,0,55.65,55.65,1,-107725,84296,192021,-23429,0,-3167,3588,0,0,,6755,421
45,11-05-18,24,5:45,6:00,53.33,,0,53.33,53.33,1,-81384,70836,152220,-10548,0,0,8014,0,0,,8014,8014
45,11-05-18,25,6:00,6:15,47.06,,0,47.06,47.06,1,-114322,98061,212383,-16261,0,0,1477,0,0,,1477,1477
45,11-05-18,26,6:15,6:30,,,0,43.77,43.77,0,-54975,82685,137660,27710,0,0,0,0,0,,0,0
45,11-05-18,27,6:30,6:45,61.11,,0,61.11,61.11,1,-78578,58499,137077,-20079,0,0,3823,0,0,,3823,3823
45,11-05-18,28,6:45,7:00,62.42,,0,62.42,62.42,1,-113013,112658,225671,-355,0,0,11725,0,0,,11725,11725
45,11-05-18,29,7:00,7:15,62.42,18.5,0,18.5,18.5,-1,-71275,100529,171804,29254,0,-20796,157,0,0,,20953,-20639
45,11-05-18,30,7:15,7:30,264.59,18.5,0,264.59,264.59,1,-113216,37186,150402,-76030,0,-185,30527,0,0,,30712,30342
45,11-05-18,31,7:30,7:45,264.59,,0,264.59,264.59,1,-140117,35909,176026,-104208,0,0,72243,0,0,,72243,72243
45,11-05-18,32,7:45,8:00,264.59,,0,264.59,264.59,1,-182459,42694,225153,-139765,0,0,98792,0,0,,98792,98792
45,11-05-18,33,8:00,8:15,250.33,,0,250.33,250.33,1,-161002,102000,263002,-59002,0,0,62903,0,0,,62903,62903
45,11-05-18,34,8:15,8:30,450,,0,450,450,1,-160509,69456,229965,-91053,0,0,53198,0,0,,53198,53198
45,11-05-18,35,8:30,8:45,250.33,,0,250.33,250.33,1,-166474,82795,249269,-83679,0,0,78782,0,0,,78782,78782
45,11-05-18,36,8:45,9:00,250.33,,0,250.33,250.33,1,-172221,58648,230869,-113573,0,0,81920,0,0,,81920,81920
45,11-05-18,37,9:00,9:15,264.99,,0,264.99,264.99,1,-238625,131794,370419,-106831,0,0,84885,0,0,,84885,84885
45,11-05-18,38,9:15,9:30,217.75,,0,217.75,217.75,1,-222862,149519,372381,-73343,0,0,57396,2500,0,,59896,59896
45,11-05-18,39,9:30,9:45,61.64,,0,61.64,61.64,1,-204609,146388,350997,-58221,0,0,32272,0,0,,32272,32272
45,11-05-18,40,9:45,10:00,110.03,,0,110.03,110.03,1,-204723,130101,334824,-74622,0,0,45865,0,0,,45865,45865
45,11-05-18,41,10:00,10:15,112.63,46.96,0,46.96,46.96,-1,-73593,87545,161138,13952,0,-2,32058,0,0,,32060,32056
45,11-05-18,42,10:15,10:30,55.69,43.46,0,55.69,43.46,2,-74153,61650,135803,-12503,0,-308,3788,0,0,,4096,3480
45,11-05-18,43,10:30,10:45,55.69,,0,55.69,55.69,1,-84139,58126,142265,-26013,0,0,15374,0,0,,15374,15374
45,11-05-18,44,10:45,11:00,50.59,,0,50.59,50.59,1,-89757,65769,155526,-23988,0,0,15208,0,0,,15208,15208
45,11-05-18,45,11:00,11:15,60.47,,0,60.47,60.47,1,-112810,52697,165507,-60113,0,0,23622,0,0,,23622,23622
45,11-05-18,46,11:15,11:30,123.02,,0,123.02,123.02,1,-118622,44317,162939,-74305,0,0,46211,0,0,,46211,46211
45,11-05-18,47,11:30,11:45,70.69,,0,70.69,70.69,1,-110692,46697,157389,-63995,0,0,37149,0,0,,37149,37149
45,11-05-18,48,11:45,12:00,173.55,,0,173.55,173.55,1,-109958,43949,153907,-66009,0,0,52250,0,0,,52250,52250
45,11-05-18,49,12:00,12:15,62.68,,0,62.68,62.68,1,-156202,36341,192543,-119861,0,0,35080,0,0,,35080,35080
45,11-05-18,50,12:15,12:30,48.99,,0,48.99,48.99,1,-127943,35378,163321,-92565,0,0,14357,0,0,,14357,14357
45,11-05-18,51,12:30,12:45,48.99,47.02,0,47.02,47.02,-1,-114637,37168,151805,-77469,0,-264,491,0,0,,755,227
45,11-05-18,52,12:45,13:00,46.49,,0,46.49,46.49,1,-125006,37189,162195,-87817,0,0,367,0,0,,367,367
45,11-05-18,53,13:00,13:15,48.61,,0,48.61,48.61,1,-154775,47573,202348,-107202,0,0,752,0,0,,752,752
45,11-05-18,54,13:15,13:30,45.5,,0,45.5,45.5,1,-160304,44191,204495,-116113,0,0,346,0,0,,346,346
45,11-05-18,55,13:30,13:45,45.5,,0,45.5,45.5,1,-156375,63071,219446,-93304,0,0,248,0,0,,248,248
45,11-05-18,56,13:45,14:00,45.5,,0,45.5,45.5,1,-153666,48506,202172,-105160,0,0,1574,0,0,,1574,1574
45,11-05-18,57,14:00,14:15,57.71,,0,57.71,57.71,1,-131932,76936,208868,-54996,0,0,11494,0,0,,11494,11494
45,11-05-18,58,14:15,14:30,50.59,,0,50.59,50.59,1,-144487,92815,237302,-51672,0,0,18788,0,0,,18788,18788
45,11-05-18,59,14:30,14:45,145.88,,0,145.88,145.88,1,-160452,97525,257977,-62927,0,0,42010,0,0,,42010,42010
45,11-05-18,60,14:45,15:00,62.08,,0,62.08,62.08,1,-152745,89235,241980,-63510,0,0,38667,0,0,,38667,38667
45,11-05-18,61,15:00,15:15,50.59,47,0,47,47,-1,-79380,63988,143368,-15392,0,-91,18233,0,0,,18324,18142
45,11-05-18,62,15:15,15:30,50.59,46.96,0,46.96,46.96,-1,-118955,67713,186668,-51242,0,-11,16,0,0,,27,5
45,11-05-18,63,15:30,15:45,55.69,,0,55.69,55.69,1,-140141,54509,194650,-85632,0,0,4482,0,0,,4482,4482
45,11-05-18,64,15:45,16:00,57.31,,0,57.31,57.31,1,-157115,44689,201804,-112426,0,0,17967,0,0,,17967,17967
45,11-05-18,65,16:00,16:15,49.42,,0,49.42,49.42,1,-105769,78312,184081,-27457,0,0,6573,0,0,,6573,6573
45,11-05-18,66,16:15,16:30,63.25,,0,63.25,63.25,1,-107499,56979,164478,-50520,0,0,13336,0,0,,13336,13336
45,11-05-18,67,16:30,16:45,69.99,,0,69.99,69.99,1,-98795,58663,157458,-40132,0,0,25452,0,0,,25452,25452
45,11-05-18,68,16:45,17:00,101.26,,0,101.26,101.26,1,-122168,66399,188567,-55769,0,0,36690,0,0,,36690,36690
45,11-05-18,69,17:00,17:15,71.12,,0,71.12,71.12,1,-141579,93527,235106,-48052,0,0,25140,0,0,,25140,25140
45,11-05-18,70,17:15,17:30,279.45,,0,279.45,279.45,1,-180226,59674,239900,-120552,0,0,61372,0,0,,61372,61372
45,11-05-18,71,17:30,17:45,332.01,,0,332.01,332.01,1,-162877,48643,211520,-114234,0,0,92746,2500,0,,95246,95246
45,11-05-18,72,17:45,18:00,181.62,,0,181.62,181.62,1,-127770,60759,188529,-67011,0,0,72776,0,0,,72776,72776
45,11-05-18,73,18:00,18:15,103.73,,0,103.73,103.73,1,-152586,60327,212913,-92259,0,0,60874,0,0,,60874,60874
45,11-05-18,74,18:15,18:30,62.02,,0,62.02,62.02,1,-125924,83128,209052,-42796,0,0,29676,0,0,,29676,29676
45,11-05-18,75,18:30,18:45,49.94,,0,49.94,49.94,1,-108670,88111,196781,-20559,0,0,9380,0,0,,9380,9380
45,11-05-18,76,18:45,19:00,,,0,44.02,44.02,0,-99329,106400,205729,7071,0,0,351,0,0,,351,351
45,11-05-18,77,19:00,19:15,141.02,,0,141.02,141.02,1,-139709,74721,214430,-64988,0,0,23356,0,0,,23356,23356
45,11-05-18,78,19:15,19:30,62.02,,0,62.02,62.02,1,-130254,85610,215864,-44644,0,0,38392,0,0,,38392,38392
45,11-05-18,79,19:30,19:45,41.02,43.46,0,44.02,43.46,2,-89927,69899,159826,-20028,0,-286,7427,0,0,,7713,7141
45,11-05-18,80,19:45,20:00,,36.31,0,36.31,36.31,-1,-111028,129716,240744,18688,0,-12230,0,0,0,,12230,-12230
45,11-05-18,81,20:00,20:15,49.5,41.48,0,49.5,41.48,2,-76290,54856,131146,-21434,0,-6850,1192,0,0,,8042,-5658
45,11-05-18,82,20:15,20:30,46.01,,0,46.01,46.01,1,-77519,59668,137187,-17851,0,0,373,0,0,,373,373
45,11-05-18,83,20:30,20:45,49.5,,0,49.5,49.5,1,-80904,54142,135046,-26762,0,0,3538,0,0,,3538,3538
45,11-05-18,84,20:45,21:00,,,0,43.83,43.83,0,-74005,68980,142985,-5025,0,0,92,0,0,,92,92
45,11-05-18,85,21:00,21:15,99.38,,0,99.38,99.38,1,-93693,46676,140369,-47017,0,0,11974,0,0,,11974,11974
45,11-05-18,86,21:15,21:30,49.5,,0,49.5,49.5,1,-75361,43609,118970,-31752,0,0,13779,0,0,,13779,13779
45,11-05-18,87,21:30,21:45,49.5,42.36,0,42.36,42.36,-1,-54189,77268,131457,23079,0,-370,42,0,0,,412,-328
45,11-05-18,88,21:45,22:00,,30.56,0,30.56,30.56,-1,-41717,109088,150805,67371,0,-14787,0,0,0,,14787,-14787
45,11-05-18,89,22:00,22:15,201.07,16.03,0,201.07,201.07,1,-143246,35046,178292,-108200,0,-11277,19776,0,0,,31053,8499
45,11-05-18,90,22:15,22:30,350.2,29.85,0,350.2,29.85,2,-71508,70681,142189,-827,0,-1594,25953,5000,0,,32547,29359
45,11-05-18,91,22:30,22:45,,-132.16,0,-132.16,-132.16,-1,-47063,100176,147239,53113,0,-44457,0,0,0,,44457,-44457
45,11-05-18,92,22:45,23:00,,41.48,0,41.48,41.48,-1,-70389,84438,154827,14049,0,-12917,0,0,0,,12917,-12917
45,11-05-18,93,23:00,23:15,217.46,41.48,0,217.46,217.46,1,-132208,56816,189024,-75392,0,-5050,21075,0,0,,26125,16025
45,11-05-18,94,23:15,23:30,149.02,,0,149.02,149.02,1,-105697,71909,177606,-33788,0,0,35648,0,0,,35648,35648
45,11-05-18,95,23:30,23:45,45.5,,0,45.5,45.5,1,-83603,73470,157073,-10133,0,0,3553,0,0,,3553,3553
45,11-05-18,96,23:45,0:00,,29.47,0,29.47,29.47,-1,-71676,88879,160555,17203,0,-9206,0,0,0,,9206,-9206
45,11-06-18,1,0:00,0:15,61.57,30.78,0,61.57,30.78,2,-76438,49267,125705,-27171,0,-7219,5935,0,0,,13154,-1284
45,11-06-18,2,0:15,0:30,45,,0,45,45,1,-38359,38313,76672,-46,0,0,3819,0,0,,3819,3819
45,11-06-18,3,0:30,0:45,,,0,44.99,44.99,0,-29438,50951,80389,21513,0,0,0,0,0,,0,0
45,11-06-18,4,0:45,1:00,,37,0,37,37,-1,-12110,85019,97129,72909,0,-3028,0,0,0,,3028,-3028
45,11-06-18,5,1:00,1:15,,41,0,41,41,-1,-40928,38748,79676,-2180,0,-615,0,0,0,,615,-615
45,11-06-18,6,1:15,1:30,,37,0,37,37,-1,-26573,54084,80657,27511,0,-5058,0,0,0,,5058,-5058
45,11-06-18,7,1:30,1:45,,37,0,37,37,-1,-16360,53971,70331,37611,0,-14158,0,0,0,,14158,-14158
45,11-06-18,8,1:45,2:00,,41,0,41,41,-1,-47622,45648,93270,-1974,0,-10715,0,0,0,,10715,-10715
45,11-06-18,9,2:00,2:15,45,37,0,45,37,2,-41761,38931,80692,-2830,0,-2880,285,0,0,,3165,-2595
45,11-06-18,10,2:15,2:30,45,37,0,45,45,1,-42108,47401,89509,5293,0,-41,1319,0,0,,1360,1278
45,11-06-18,11,2:30,2:45,44.55,,0,44.55,44.55,1,-43028,44634,87662,1606,0,0,747,0,0,,747,747
45,11-06-18,12,2:45,3:00,44.56,41,0,41,41,-1,-41990,61568,103558,19578,0,-240,92,0,0,,332,-148
45,11-06-18,13,3:00,3:15,49.74,40.44,0,49.74,49.74,1,-54458,56107,110565,1649,0,-520,3570,0,0,,4090,3050
45,11-06-18,14,3:15,3:30,53,,0,53,53,1,-60460,59725,120185,-735,0,0,17858,0,0,,17858,17858
45,11-06-18,15,3:30,3:45,48.6,,0,48.6,48.6,1,-66417,51475,117892,-14942,0,0,4875,0,0,,4875,4875
45,11-06-18,16,3:45,4:00,45,42.87,0,42.87,42.87,-1,-61269,67640,128909,6371,0,-343,3146,0,0,,3489,2803
45,11-06-18,17,4:00,4:15,,42.9,0,42.9,42.9,-1,-48800,67188,115988,18388,0,-1602,0,0,0,,1602,-1602
45,11-06-18,18,4:15,4:30,,,0,43.23,43.23,0,-52928,49152,102080,-3776,0,-31,0,0,0,,31,-31
45,11-06-18,19,4:30,4:45,,,0,43.23,43.23,0,-47911,71088,118999,23177,0,0,0,0,0,,0,0
45,11-06-18,20,4:45,5:00,,,0,43.23,43.23,0,-59957,89072,149029,29115,0,0,0,0,0,,0,0
45,11-06-18,21,5:00,5:15,,42.61,0,42.61,42.61,-1,-36111,78026,114137,41915,0,-2217,0,0,0,,2217,-2217
45,11-06-18,22,5:15,5:30,,43.28,0,43.28,43.28,-1,-41011,62900,103911,21889,0,-2291,0,0,0,,2291,-2291
45,11-06-18,23,5:30,5:45,45.85,45.33,0,45.85,45.85,1,-59244,48247,107491,-10997,0,-303,1345,0,0,,1648,1042
45,11-06-18,24,5:45,6:00,45.2,,0,45.2,45.2,1,-56622,43015,99637,-13607,0,0,8905,0,0,,8905,8905
45,11-06-18,25,6:00,6:15,44.48,31.05,0,45.49,31.05,2,-49984,109964,159948,59980,0,-10348,464,0,0,,10812,-9884
45,11-06-18,26,6:15,6:30,,40.48,0,40.48,40.48,-1,-14930,69463,84393,54533,0,-9079,0,0,0,,9079,-9079
45,11-06-18,27,6:30,6:45,45.91,40.48,0,45.91,45.91,1,-37991,32716,70707,-5275,0,-480,979,0,0,,1459,499
45,11-06-18,28,6:45,7:00,51.83,,0,51.83,51.83,1,-82094,36429,118523,-45665,0,0,24932,0,0,,24932,24932
45,11-06-18,29,7:00,7:15,44.78,7.61,0,45.64,7.61,2,-12405,137532,149937,125127,0,-11366,5300,0,0,,16666,-6066
45,11-06-18,30,7:15,7:30,,46.49,0,46.49,46.49,-1,-20220,74270,94490,54050,0,-919,0,0,0,,919,-919
45,11-06-18,31,7:30,7:45,,,0,45.64,45.64,0,-61836,70895,132731,9059,0,0,0,0,0,,0,0
45,11-06-18,32,7:45,8:00,,44.05,0,44.05,44.05,-1,-98801,77175,175976,-21626,0,-7,0,0,0,,7,-7
45,11-06-18,33,8:00,8:15,,4.22,0,4.22,4.22,-1,-20405,82732,103137,62327,0,-29360,0,0,0,,29360,-29360
45,11-06-18,34,8:15,8:30,,36.78,0,36.78,36.78,-1,-43064,78039,121103,34975,0,-33886,0,0,0,,33886,-33886
45,11-06-18,35,8:30,8:45,,39.31,0,39.31,39.31,-1,-58226,60427,118653,2201,0,-15358,0,0,0,,15358,-15358
45,11-06-18,36,8:45,9:00,,40.78,0,40.78,40.78,-1,-71128,69129,140257,-1999,0,-1790,0,0,0,,1790,-1790
45,11-06-18,37,9:00,9:15,,44.11,0,44.11,44.11,-1,-77981,60771,138752,-17210,0,-863,0,0,0,,863,-863
45,11-06-18,38,9:15,9:30,,44.15,0,44.15,44.15,-1,-79442,60807,140249,-18635,0,-44,0,0,0,,44,-44
45,11-06-18,39,9:30,9:45,,35.56,0,35.56,35.56,-1,-50602,75700,126302,25098,0,-7619,0,0,0,,7619,-7619
45,11-06-18,40,9:45,10:00,,33.58,0,33.58,33.58,-1,-23277,63783,87060,40506,0,-28665,0,0,0,,28665,-28665
45,11-06-18,41,10:00,10:15,44.93,37.36,0,44.93,37.36,2,-108374,42399,150773,-65975,0,-12691,309,0,0,,13000,-12382
45,11-06-18,42,10:15,10:30,,,0,45.57,45.57,0,-76960,59788,136748,-17172,0,0,0,0,0,,0,0
45,11-06-18,43,10:30,10:45,,38.8,0,38.8,38.8,-1,-61331,86007,147338,24676,0,-9525,0,0,0,,9525,-9525
45,11-06-18,44,10:45,11:00,,40.78,0,40.78,40.78,-1,-59685,94536,154221,34851,0,-9683,0,0,0,,9683,-9683
45,11-06-18,45,11:00,11:15,,41.55,0,41.55,41.55,-1,-64438,74522,138960,10084,0,-5936,0,0,0,,5936,-5936
45,11-06-18,46,11:15,11:30,,44.08,0,44.08,44.08,-1,-63686,92968,156654,29282,0,-77,0,0,0,,77,-77
45,11-06-18,47,11:30,11:45,250.82,40.78,0,250.82,40.78,2,-55431,73205,128636,17774,0,-2589,3432,0,0,,6021,843
45,11-06-18,48,11:45,12:00,71.12,,0,71.12,71.12,1,-143528,72181,215709,-71347,0,0,28593,0,0,,28593,28593
45,11-06-18,49,12:00,12:15,239.42,,0,239.42,239.42,1,-197750,63392,261142,-134358,0,0,47871,0,0,,47871,47871
45,11-06-18,50,12:15,12:30,47.12,,0,47.12,47.12,1,-140991,104932,245923,-36059,0,0,12557,0,0,,12557,12557
45,11-06-18,51,12:30,12:45,,,0,43.15,43.15,0,-142575,107828,250403,-34747,0,0,34,0,0,,34,34
45,11-06-18,52,12:45,13:00,,44.16,0,44.16,44.16,-1,-153710,93075,246785,-60635,0,-1,0,0,0,,1,-1
45,11-06-18,53,13:00,13:15,,15.96,0,15.96,15.96,-1,-26638,124769,151407,98131,0,-18168,0,0,0,,18168,-18168
45,11-06-18,54,13:15,13:30,,40.78,0,40.78,40.78,-1,-51111,84797,135908,33686,0,-7344,0,0,0,,7344,-7344
45,11-06-18,55,13:30,13:45,,42.53,0,42.53,42.53,-1,-59372,58160,117532,-1212,0,-3173,0,0,0,,3173,-3173
45,11-06-18,56,13:45,14:00,,,0,43.12,43.12,0,-74447,42288,116735,-32159,0,-138,0,0,0,,138,-138
45,11-06-18,57,14:00,14:15,,,0,43.12,43.12,0,-37245,54339,91584,17094,0,0,0,0,0,,0,0
45,11-06-18,58,14:15,14:30,44.86,,0,44.86,44.86,1,-60064,37231,97295,-22833,0,0,868,0,0,,868,868
45,11-06-18,59,14:30,14:45,248.2,,0,248.2,248.2,1,-111569,27570,139139,-83999,0,0,29726,0,0,,29726,29726
45,11-06-18,60,14:45,15:00,49.95,,0,49.95,49.95,1,-99092,60216,159308,-38876,0,0,15319,0,0,,15319,15319
45,11-06-18,61,15:00,15:15,44.78,,0,44.78,44.78,1,-55626,113142,168768,57516,0,0,1371,0,0,,1371,1371
45,11-06-18,62,15:15,15:30,,,0,44.95,44.95,0,-68825,105621,174446,36796,0,0,0,0,0,,0,0
45,11-06-18,63,15:30,15:45,,,0,44.95,44.95,0,-81846,101625,183471,19779,0,0,0,0,0,,0,0
45,11-06-18,64,15:45,16:00,,,0,44.95,44.95,0,-94308,107909,202217,13601,0,0,0,0,0,,0,0
45,11-06-18,65,16:00,16:15,,,0,45.48,45.48,0,-66382,112389,178771,46007,0,0,0,0,0,,0,0
45,11-06-18,66,16:15,16:30,,,0,45.48,45.48,0,-57201,106601,163802,49400,0,0,0,0,0,,0,0
45,11-06-18,67,16:30,16:45,,44.16,0,44.16,44.16,-1,-54821,114818,169639,59997,0,-845,0,0,0,,845,-845
45,11-06-18,68,16:45,17:00,,44.05,0,44.05,44.05,-1,-78669,110294,188963,31625,0,-210,0,0,0,,210,-210
45,11-06-18,69,17:00,17:15,,-71.65,0,-71.65,-71.65,-1,-32326,145243,177569,112917,0,-32728,0,0,0,,32728,-32728
45,11-06-18,70,17:15,17:30,44.78,40.78,0,44.78,40.78,2,-104655,109754,214409,5099,0,-9060,11,0,0,,9071,-9049
45,11-06-18,71,17:30,17:45,49.95,40.78,0,49.95,49.95,1,-122364,116177,238541,-6187,0,-168,4909,0,0,,5077,4741
45,11-06-18,72,17:45,18:00,44.78,,0,44.78,44.78,1,-99663,146393,246056,46730,0,0,1317,0,0,,1317,1317
45,11-06-18,73,18:00,18:15,275.37,,0,275.37,275.37,1,-164310,64833,229143,-99477,0,0,25350,0,0,,25350,25350
45,11-06-18,74,18:15,18:30,57.85,,0,57.85,57.85,1,-109893,109657,219550,-236,0,0,15083,0,0,,15083,15083
45,11-06-18,75,18:30,18:45,57.85,27.48,0,27.48,27.48,-1,-103439,140256,243695,36817,0,-18324,240,0,0,,18564,-18084
45,11-06-18,76,18:45,19:00,,22.47,0,22.47,22.47,-1,-109282,164560,273842,55278,0,-44288,0,0,0,,44288,-44288
45,11-06-18,77,19:00,19:15,221.95,13.11,0,221.95,221.95,1,-150614,83455,234069,-67159,0,-25491,12536,0,0,,38027,-12955
45,11-06-18,78,19:15,19:30,263.7,,0,263.7,263.7,1,-169329,95052,264381,-74277,0,0,47967,0,0,,47967,47967
45,11-06-18,79,19:30,19:45,73.91,,0,73.91,73.91,1,-164491,119012,283503,-45479,0,0,49348,0,0,,49348,49348
45,11-06-18,80,19:45,20:00,62.93,,0,62.93,62.93,1,-167844,133444,301288,-34400,0,0,19180,0,0,,19180,19180
45,11-06-18,81,20:00,20:15,255.27,,0,255.27,255.27,1,-163662,99432,263094,-64230,0,0,48198,0,0,,48198,48198
45,11-06-18,82,20:15,20:30,55.13,42.53,0,42.53,42.53,-1,-123568,122961,246529,-607,0,-308,21170,0,0,,21478,20862
45,11-06-18,83,20:30,20:45,55.13,43.17,0,43.17,43.17,-1,-96882,139370,236252,42488,0,-667,401,0,0,,1068,-266
45,11-06-18,84,20:45,21:00,44.78,40.98,0,45.59,40.98,2,-74594,75003,149597,409,0,-1358,464,0,0,,1822,-894
45,11-06-18,85,21:00,21:15,67.98,,0,67.98,67.98,1,-95255,57681,152936,-37574,0,0,19748,0,0,,19748,19748
45,11-06-18,86,21:15,21:30,44.89,,0,44.89,44.89,1,-58580,70491,129071,11911,0,0,4458,0,0,,4458,4458
45,11-06-18,87,21:30,21:45,,40.98,0,40.98,40.98,-1,-53806,90003,143809,36197,0,-5550,0,0,0,,5550,-5550
45,11-06-18,88,21:45,22:00,,20.33,0,20.33,20.33,-1,-37949,103979,141928,66030,0,-30650,0,0,0,,30650,-30650
45,11-06-18,89,22:00,22:15,179.12,36.87,0,179.12,179.12,1,-137558,75283,212841,-62275,0,-18645,7667,0,0,,26312,-10978
45,11-06-18,90,22:15,22:30,195.24,38.89,0,195.24,38.89,2,-47047,53588,100635,6541,0,-2341,16394,0,0,,18735,14053
45,11-06-18,91,22:30,22:45,,25.63,0,25.63,25.63,-1,-45704,84572,130276,38868,0,-31725,0,0,0,,31725,-31725
45,11-06-18,92,22:45,23:00,,32.98,0,32.98,32.98,-1,-43305,88508,131813,45203,0,-39285,0,0,0,,39285,-39285
45,11-06-18,93,23:00,23:15,152.89,35.96,0,152.89,35.96,2,-138881,55108,193989,-83773,0,-24210,7057,0,0,,31267,-17153
45,11-06-18,94,23:15,23:30,215.82,35.96,0,215.82,215.82,1,-117517,39224,156741,-78293,0,-149,57768,0,0,,57917,57619
45,11-06-18,95,23:30,23:45,44.89,43.05,0,44.89,43.05,2,-83269,73192,156461,-10077,0,-539,8394,0,0,,8933,7855
45,11-06-18,96,23:45,0:00,48.98,26.04,0,48.98,26.04,2,-89724,91237,180961,1513,0,-3810,3789,0,0,,7599,-21
45,11-07-18,1,0:00,0:15,62.95,-27.04,0,62.95,-27.04,2,-83939,106540,190479,22601,0,-10510,3383,0,0,,13893,-7127
45,11-07-18,2,0:15,0:30,181.69,,0,181.69,181.69,1,-152075,88414,240489,-63661,0,0,48087,0,0,,48087,48087
45,11-07-18,3,0:30,0:45,52.45,,0,52.45,52.45,1,-119413,92694,212107,-26719,0,0,11504,0,0,,11504,11504
45,11-07-18,4,0:45,1:00,71.09,,0,71.09,71.09,1,-135587,83539,219126,-52048,0,0,32478,0,0,,32478,32478
45,11-07-18,5,1:00,1:15,71.09,41.31,0,41.31,41.31,-1,-55793,60237,116030,4444,0,-1063,8551,0,0,,9614,7488
45,11-07-18,6,1:15,1:30,,35.8,0,35.8,35.8,-1,-46329,73471,119800,27142,0,-5919,0,0,0,,5919,-5919
45,11-07-18,7,1:30,1:45,,31.8,0,31.8,31.8,-1,-36179,74418,110597,38239,0,-25206,0,0,0,,25206,-25206
45,11-07-18,8,1:45,2:00,,13.13,0,13.13,13.13,-1,-24387,76880,101267,52493,0,-53075,0,0,0,,53075,-53075
45,11-07-18,9,2:00,2:15,,31.8,0,31.8,31.8,-1,-43752,61394,105146,17642,0,-17714,0,0,0,,17714,-17714
45,11-07-18,10,2:15,2:30,,12.9,0,12.9,12.9,-1,-26904,77449,104353,50545,0,-13661,0,0,0,,13661,-13661
45,11-07-18,11,2:30,2:45,,-37.64,0,-37.64,-37.64,-1,-22716,77320,100036,54604,0,-54580,0,0,0,,54580,-54580
45,11-07-18,12,2:45,3:00,,6.69,0,6.69,6.69,-1,-16032,78600,94632,62568,0,-60290,0,0,0,,60290,-60290
45,11-07-18,13,3:00,3:15,,24.03,0,24.03,24.03,-1,-32273,76434,108707,44161,0,-22914,0,0,0,,22914,-22914
45,11-07-18,14,3:15,3:30,,39.8,0,39.8,39.8,-1,-25149,76389,101538,51240,0,-425,0,0,0,,425,-425
45,11-07-18,15,3:30,3:45,,16.8,0,16.8,16.8,-1,-37464,71511,108975,34047,0,-20401,0,0,0,,20401,-20401
45,11-07-18,16,3:45,4:00,,35.8,0,35.8,35.8,-1,-47358,71183,118541,23825,0,-9243,0,0,0,,9243,-9243
45,11-07-18,17,4:00,4:15,,40.14,0,40.14,40.14,-1,-52623,40161,92784,-12462,0,-3320,0,0,0,,3320,-3320
45,11-07-18,18,4:15,4:30,,39.8,0,39.8,39.8,-1,-48971,55951,104922,6980,0,-4503,0,0,0,,4503,-4503
45,11-07-18,19,4:30,4:45,,41.21,0,41.21,41.21,-1,-48170,57019,105189,8849,0,-2345,0,0,0,,2345,-2345
45,11-07-18,20,4:45,5:00,,46.28,0,46.28,46.28,-1,-33661,61862,95523,28201,0,-2916,0,0,0,,2916,-2916
45,11-07-18,21,5:00,5:15,,41.24,0,41.24,41.24,-1,-41282,83315,124597,42033,0,-1478,0,0,0,,1478,-1478
45,11-07-18,22,5:15,5:30,,39.8,0,39.8,39.8,-1,-40862,94548,135410,53686,0,-3511,0,0,0,,3511,-3511
45,11-07-18,23,5:30,5:45,,40.77,0,40.77,40.77,-1,-58231,59855,118086,1624,0,-1662,0,0,0,,1662,-1662
45,11-07-18,24,5:45,6:00,,40.77,0,40.77,40.77,-1,-43428,82126,125554,38698,0,-1971,0,0,0,,1971,-1971
45,11-07-18,25,6:00,6:15,,41.78,0,41.78,41.78,-1,-88480,111903,200383,23423,0,-1217,0,0,0,,1217,-1217
45,11-07-18,26,6:15,6:30,,40.11,0,40.11,40.11,-1,-50739,99789,150528,49050,0,-4958,0,0,0,,4958,-4958
45,11-07-18,27,6:30,6:45,46.98,40.11,0,46.98,46.98,1,-64434,61424,125858,-3010,0,-270,2640,0,0,,2910,2370
45,11-07-18,28,6:45,7:00,48.11,,0,48.11,48.11,1,-71920,56516,128436,-15404,0,0,14044,0,0,,14044,14044
45,11-07-18,29,7:00,7:15,48.11,34.11,0,34.11,34.11,-1,-60866,126555,187421,65689,0,-9543,388,0,0,,9931,-9155
45,11-07-18,30,7:15,7:30,,-25.6,0,-25.6,-25.6,-1,-21090,114611,135701,93521,0,-48541,0,0,0,,48541,-48541
45,11-07-18,31,7:30,7:45,,30.03,0,30.03,30.03,-1,-34859,79454,114313,44595,0,-35143,0,0,0,,35143,-35143
45,11-07-18,32,7:45,8:00,,41.1,0,41.1,41.1,-1,-58274,72696,130970,14422,0,-12700,0,0,0,,12700,-12700
45,11-07-18,33,8:00,8:15,,-37.78,0,-37.78,-37.78,-1,-18959,76808,95767,57849,0,-25823,0,0,0,,25823,-25823
45,11-07-18,34,8:15,8:30,,29.33,0,29.33,29.33,-1,-35341,73335,108676,37994,0,-19536,0,0,0,,19536,-19536
45,11-07-18,35,8:30,8:45,44.11,42.32,0,44.11,44.11,1,-42036,50236,92272,8200,0,-6662,44,0,0,,6706,-6618
45,11-07-18,36,8:45,9:00,44.11,,0,44.11,44.11,1,-31164,57472,88636,26308,0,0,250,0,0,,250,250
45,11-07-18,37,9:00,9:15,45.17,,0,45.17,45.17,1,-51946,41321,93267,-10625,0,0,1250,0,0,,1250,1250
45,11-07-18,38,9:15,9:30,44.11,,0,44.11,44.11,1,-43328,62905,106233,19577,0,0,685,0,0,,685,685
45,11-07-18,39,9:30,9:45,,,0,45.67,45.67,0,-49296,67203,116499,17907,0,0,0,0,0,,0,0
45,11-07-18,40,9:45,10:00,44.11,,0,44.11,44.11,1,-57691,51588,109279,-6103,0,0,1581,0,0,,1581,1581
45,11-07-18,41,10:00,10:15,48.11,,0,48.11,48.11,1,-118475,93369,211844,-25106,0,0,6722,0,0,,6722,6722
45,11-07-18,42,10:15,10:30,48.11,36.83,0,36.83,36.83,-1,-99025,118289,217314,19264,0,-3262,602,0,0,,3864,-2660
45,11-07-18,43,10:30,10:45,,37.08,0,37.08,37.08,-1,-100422,121756,222178,21334,0,-18880,0,0,0,,18880,-18880
45,11-07-18,44,10:45,11:00,,31.99,0,31.99,31.99,-1,-95755,124981,220736,29226,0,-27130,0,0,0,,27130,-27130
45,11-07-18,45,11:00,11:15,44.11,41.1,0,44.11,44.11,1,-131428,87982,219410,-43446,0,-7104,196,0,0,,7300,-6908
45,11-07-18,46,11:15,11:30,46.45,,0,46.45,46.45,1,-146012,102333,248345,-43679,0,0,1611,0,0,,1611,1611
45,11-07-18,47,11:30,11:45,57.24,,0,57.24,57.24,1,-160404,92956,253360,-67448,0,0,5318,0,0,,5318,5318
45,11-07-18,48,11:45,12:00,213.02,,0,213.02,213.02,1,-165825,82435,248260,-83390,0,0,45278,0,0,,45278,45278
45,11-07-18,49,12:00,12:15,48.11,,0,48.11,48.11,1,-166367,57981,224348,-108386,0,0,20314,0,0,,20314,20314
45,11-07-18,50,12:15,12:30,52.24,,0,52.24,52.24,1,-169138,45440,214578,-123698,0,0,6479,0,0,,6479,6479
45,11-07-18,51,12:30,12:45,48.11,,0,48.11,48.11,1,-175136,53256,228392,-121880,0,0,16567,0,0,,16567,16567
45,11-07-18,52,12:45,13:00,68.1,,0,68.1,68.1,1,-184603,40379,224982,-144224,0,0,22403,0,0,,22403,22403
45,11-07-18,53,13:00,13:15,48.11,,0,48.11,48.11,1,-151306,64189,215495,-87117,0,0,18118,0,0,,18118,18118
45,11-07-18,54,13:15,13:30,70.02,,0,70.02,70.02,1,-186833,48735,235568,-138098,0,0,23278,0,0,,23278,23278
45,11-07-18,55,13:30,13:45,236.87,,0,236.87,236.87,1,-188177,41211,229388,-146966,0,0,55456,0,0,,55456,55456
45,11-07-18,56,13:45,14:00,47.95,,0,47.95,47.95,1,-162437,81792,244229,-80645,0,0,14859,0,0,,14859,14859
45,11-07-18,57,14:00,14:15,46.8,,0,46.8,46.8,1,-170273,70261,240534,-100012,0,0,520,0,0,,520,520
45,11-07-18,58,14:15,14:30,48.11,,0,48.11,48.11,1,-179225,69413,248638,-109812,0,0,8310,0,0,,8310,8310
45,11-07-18,59,14:30,14:45,247.47,,0,247.47,247.47,1,-186701,60294,246995,-126407,0,0,42925,0,0,,42925,42925
45,11-07-18,60,14:45,15:00,247.47,,0,247.47,247.47,1,-135619,85271,220890,-50348,0,0,42581,2500,0,,45081,45081
45,11-07-18,61,15:00,15:15,247.47,41.1,0,41.1,41.1,-1,-86531,107836,194367,21305,0,-6391,335,0,0,,6726,-6056
45,11-07-18,62,15:15,15:30,,47.23,0,47.23,47.23,-1,-110363,106929,217292,-3434,0,-174,0,0,0,,174,-174
45,11-07-18,63,15:30,15:45,52.81,,0,52.81,52.81,1,-119854,99600,219454,-20254,0,0,6079,0,0,,6079,6079
45,11-07-18,64,15:45,16:00,129.08,,0,129.08,129.08,1,-137522,70048,207570,-67474,0,0,27472,0,0,,27472,27472
45,11-07-18,65,16:00,16:15,129.08,-130.42,0,-130.42,-130.42,-1,-55079,128815,183894,73736,0,-23761,5674,0,0,,29435,-18087
45,11-07-18,66,16:15,16:30,,44.73,0,44.73,44.73,-1,-35027,102056,137083,67029,0,-4728,0,0,0,,4728,-4728
45,11-07-18,67,16:30,16:45,,33.1,0,33.1,33.1,-1,-34826,125627,160453,90801,0,-17322,0,0,0,,17322,-17322
45,11-07-18,68,16:45,17:00,,29.33,0,29.33,29.33,-1,-45873,123718,169591,77845,0,-6184,0,0,0,,6184,-6184
45,11-07-18,69,17:00,17:15,,-59.24,0,-59.24,-59.24,-1,-36404,100679,137083,64275,0,-44786,0,0,0,,44786,-44786
45,11-07-18,70,17:15,17:30,,14.02,0,14.02,14.02,-1,-65285,106864,172149,41579,0,-42537,0,0,0,,42537,-42537
45,11-07-18,71,17:30,17:45,,47.29,0,47.29,47.29,-1,-49212,109201,158413,59989,0,-7971,0,0,0,,7971,-7971
45,11-07-18,72,17:45,18:00,,47.33,0,47.33,47.33,-1,-27476,165060,192536,137584,0,-383,0,0,0,,383,-383
45,11-07-18,73,18:00,18:15,92.02,,0,92.02,92.02,1,-108637,45360,153997,-63277,0,0,10580,0,0,,10580,10580
45,11-07-18,74,18:15,18:30,48.11,,0,48.11,48.11,1,-83989,74179,158168,-9810,0,0,12120,0,0,,12120,12120
45,11-07-18,75,18:30,18:45,,,0,45.75,45.75,0,-68293,82789,151082,14496,0,0,1664,0,0,,1664,1664
45,11-07-18,76,18:45,19:00,,,0,45.77,45.77,0,-54454,89846,144300,35392,0,0,0,0,0,,0,0
45,11-07-18,77,19:00,19:15,85.02,,0,85.02,85.02,1,-98263,46330,144593,-51933,0,0,13436,0,0,,13436,13436
45,11-07-18,78,19:15,19:30,49.44,,0,49.44,49.44,1,-78340,63219,141559,-15121,0,0,19416,0,0,,19416,19416
45,11-07-18,79,19:30,19:45,49.44,41.1,0,41.1,41.1,-1,-66414,90894,157308,24480,0,-1593,1947,0,0,,3540,354
45,11-07-18,80,19:45,20:00,,41.1,0,41.1,41.1,-1,-77306,88835,166141,11529,0,-5006,0,0,0,,5006,-5006
45,11-07-18,81,20:00,20:15,118.1,41.1,0,118.1,118.1,1,-93956,31516,125472,-62440,0,-226,15206,0,0,,15432,14980
45,11-07-18,82,20:15,20:30,58.31,,0,58.31,58.31,1,-89423,45076,134499,-44347,0,0,28748,0,0,,28748,28748
45,11-07-18,83,20:30,20:45,46.95,39.92,0,39.92,39.92,-1,-58124,61158,119282,3034,0,-2594,11366,0,0,,13960,8772
45,11-07-18,84,20:45,21:00,46.95,29.47,0,29.47,29.47,-1,-42882,78859,121741,35977,0,-22961,7,0,0,,22968,-22954
45,11-07-18,85,21:00,21:15,171.04,11.59,0,171.04,171.04,1,-116414,73991,190405,-42423,0,-16838,9729,0,0,,26567,-7109
45,11-07-18,86,21:15,21:30,186.43,46.68,0,186.43,45.65,2,-63530,68620,132150,5090,0,-36,19348,0,0,,19384,19312
45,11-07-18,87,21:30,21:45,,34.53,0,34.53,34.53,-1,-37665,74536,112201,36871,0,-10567,0,0,0,,10567,-10567
45,11-07-18,88,21:45,22:00,,41.03,0,41.03,41.03,-1,-35716,53630,89346,17914,0,-9577,0,0,0,,9577,-9577
45,11-07-18,89,22:00,22:15,52.39,43.19,0,52.39,43.19,2,-70997,46522,117519,-24475,0,-1121,4901,0,0,,6022,3780
45,11-07-18,90,22:15,22:30,52.84,18.1,0,18.1,18.1,-1,-43569,66645,110214,23076,0,-5416,8808,0,0,,14224,3392
45,11-07-18,91,22:30,22:45,44.11,20.92,0,44.11,44.11,1,-45769,41960,87729,-3809,0,-8908,156,0,0,,9064,-8752
45,11-07-18,92,22:45,23:00,44.11,13.82,0,13.82,13.82,-1,-38137,78857,116994,40720,0,-15042,13,0,0,,15055,-15029
45,11-07-18,93,23:00,23:15,54.16,36.83,0,54.16,54.16,1,-71940,46512,118452,-25428,0,-13571,6578,0,0,,20149,-6993
45,11-07-18,94,23:15,23:30,48.11,41.1,0,48.11,41.1,2,-41762,44065,85827,2303,0,-966,7515,0,0,,8481,6549
45,11-07-18,95,23:30,23:45,44.11,41.1,0,44.11,41.1,2,-54382,52017,106399,-2365,0,-3274,148,0,0,,3422,-3126
45,11-07-18,96,23:45,0:00,48.11,41.1,0,48.11,41.1,2,-69691,61876,131567,-7815,0,-327,3465,0,0,,3792,3138
45,11-08-18,1,0:00,0:15,45.48,2.64,0,45.48,2.64,2,-47056,66616,113672,19560,0,-16831,57,0,0,,16888,-16774
45,11-08-18,2,0:15,0:30,67.04,41,0,67.04,41,2,-94694,63359,158053,-31335,0,-216,17402,0,0,,17618,17186
45,11-08-18,3,0:30,0:45,67.04,33.02,0,33.02,33.02,-1,-33826,52393,86219,18567,0,-16967,30,0,0,,16997,-16937
45,11-08-18,4,0:45,1:00,,27.98,0,27.98,27.98,-1,-17822,46781,64603,28959,0,-24289,0,0,0,,24289,-24289
45,11-08-18,5,1:00,1:15,48.04,16.89,0,48.04,48.04,1,-35737,31124,66861,-4613,0,-21598,1767,0,0,,23365,-19831
45,11-08-18,6,1:15,1:30,48.04,37.02,0,37.02,37.02,-1,-42170,41271,83441,-899,0,-1361,3857,0,0,,5218,2496
45,11-08-18,7,1:30,1:45,,33.02,0,33.02,33.02,-1,-22961,49448,72409,26487,0,-22436,0,0,0,,22436,-22436
45,11-08-18,8,1:45,2:00,,31.99,0,31.99,31.99,-1,-16952,57823,74775,40871,0,-39058,0,0,0,,39058,-39058
45,11-08-18,9,2:00,2:15,,31.99,0,31.99,31.99,-1,-27235,56850,84085,29615,0,-31024,0,0,0,,31024,-31024
45,11-08-18,10,2:15,2:30,,28.65,0,28.65,28.65,-1,-23349,57983,81332,34634,0,-40878,0,0,0,,40878,-40878
45,11-08-18,11,2:30,2:45,,37.02,0,37.02,37.02,-1,-34136,49707,83843,15571,0,-29350,0,0,0,,29350,-29350
45,11-08-18,12,2:45,3:00,,31.57,0,31.57,31.57,-1,-27644,61364,89008,33720,0,-30273,0,0,0,,30273,-30273
45,11-08-18,13,3:00,3:15,,31.03,0,31.03,31.03,-1,-36126,56650,92776,20524,0,-34931,0,0,0,,34931,-34931
45,11-08-18,14,3:15,3:30,,33.66,0,33.66,33.66,-1,-36240,52235,88475,15995,0,-21317,0,0,0,,21317,-21317
45,11-08-18,15,3:30,3:45,,29.61,0,29.61,29.61,-1,-28940,63828,92768,34888,0,-37500,0,0,0,,37500,-37500
45,11-08-18,16,3:45,4:00,,33.02,0,33.02,33.02,-1,-26993,70997,97990,44004,0,-47860,0,0,0,,47860,-47860
45,11-08-18,17,4:00,4:15,,12.57,0,12.57,12.57,-1,-20900,71421,92321,50521,0,-61146,0,0,0,,61146,-61146
45,11-08-18,18,4:15,4:30,,33.02,0,33.02,33.02,-1,-22049,48377,70426,26328,0,-40327,0,0,0,,40327,-40327
45,11-08-18,19,4:30,4:45,,37.02,0,37.02,37.02,-1,-23006,43866,66872,20860,0,-31562,0,0,0,,31562,-31562
45,11-08-18,20,4:45,5:00,,33.02,0,33.02,33.02,-1,-20625,44638,65263,24013,0,-32565,0,0,0,,32565,-32565
45,11-08-18,21,5:00,5:15,,13.01,0,13.01,13.01,-1,-16852,80222,97074,63370,0,-45635,0,0,0,,45635,-45635
45,11-08-18,22,5:15,5:30,,13.01,0,13.01,13.01,-1,-30649,53837,84486,23188,0,-54020,0,0,0,,54020,-54020
45,11-08-18,23,5:30,5:45,,42.58,0,42.58,42.58,-1,-64416,29795,94211,-34621,0,-5145,0,0,0,,5145,-5145
45,11-08-18,24,5:45,6:00,,37.02,0,37.02,37.02,-1,-43060,50021,93081,6961,0,-3666,0,0,0,,3666,-3666
45,11-08-18,25,6:00,6:15,,37.44,0,37.44,37.44,-1,-104374,114027,218401,9653,0,-6140,0,0,0,,6140,-6140
45,11-08-18,26,6:15,6:30,,19.1,0,19.1,19.1,-1,-32609,80204,112813,47595,0,-31965,0,0,0,,31965,-31965
45,11-08-18,27,6:30,6:45,44.73,19.1,0,44.73,44.73,1,-36706,44220,80926,7514,0,-3246,84,0,0,,3330,-3162
45,11-08-18,28,6:45,7:00,250.24,,0,250.24,250.24,1,-109096,30527,139623,-78569,0,0,30543,0,0,,30543,30543
45,11-08-18,29,7:00,7:15,250.24,-125.24,0,-125.24,-125.24,-1,-34220,172352,206572,138132,0,-44692,6128,0,0,,50820,-38564
45,11-08-18,30,7:15,7:30,,34.1,0,34.1,34.1,-1,-43749,90816,134565,47067,0,-17114,0,0,0,,17114,-17114
45,11-08-18,31,7:30,7:45,,41.71,0,41.71,41.71,-1,-55008,57225,112233,2217,0,-5706,0,0,0,,5706,-5706
45,11-08-18,32,7:45,8:00,,44.21,0,44.21,44.21,-1,-84769,42441,127210,-42328,0,-240,0,0,0,,240,-240
45,11-08-18,33,8:00,8:15,,31.47,0,31.47,31.47,-1,-31193,75601,106794,44408,0,-15475,0,0,0,,15475,-15475
45,11-08-18,34,8:15,8:30,,42.76,0,42.76,42.76,-1,-40264,47600,87864,7336,0,-5455,0,0,0,,5455,-5455
45,11-08-18,35,8:30,8:45,,44.32,0,44.32,44.32,-1,-54200,44309,98509,-9891,0,-1655,0,0,0,,1655,-1655
45,11-08-18,36,8:45,9:00,,44.24,0,44.24,44.24,-1,-72538,46020,118558,-26518,0,-117,0,0,0,,117,-117
45,11-08-18,37,9:00,9:15,,42.69,0,42.69,42.69,-1,-45026,85255,130281,40229,0,-552,0,0,0,,552,-552
45,11-08-18,38,9:15,9:30,,42.69,0,42.69,42.69,-1,-52196,82579,134775,30383,0,-262,0,0,0,,262,-262
45,11-08-18,39,9:30,9:45,,19.1,0,19.1,19.1,-1,-52137,94275,146412,42138,0,-16205,0,0,0,,16205,-16205
45,11-08-18,40,9:45,10:00,,23.49,0,23.49,23.49,-1,-63308,95454,158762,32146,0,-39351,0,0,0,,39351,-39351
45,11-08-18,41,10:00,10:15,,34.1,0,34.1,34.1,-1,-94895,89882,184777,-5013,0,-19070,0,0,0,,19070,-19070
45,11-08-18,42,10:15,10:30,,38.1,0,38.1,38.1,-1,-76053,101289,177342,25236,0,-5935,0,0,0,,5935,-5935
45,11-08-18,43,10:30,10:45,,41.57,0,41.57,41.57,-1,-62251,96421,158672,34170,0,-13171,0,0,0,,13171,-13171
45,11-08-18,44,10:45,11:00,,21.12,0,21.12,21.12,-1,-53222,104823,158045,51601,0,-28746,0,0,0,,28746,-28746
45,11-08-18,45,11:00,11:15,,37.32,0,37.32,37.32,-1,-122695,92444,215139,-30251,0,-15819,0,0,0,,15819,-15819
45,11-08-18,46,11:15,11:30,,42.1,0,42.1,42.1,-1,-105759,106366,212125,607,0,-5016,0,0,0,,5016,-5016
45,11-08-18,47,11:30,11:45,,19.1,0,19.1,19.1,-1,-94892,111000,205892,16108,0,-13285,0,0,0,,13285,-13285
45,11-08-18,48,11:45,12:00,,36.71,0,36.71,36.71,-1,-91601,112326,203927,20725,0,-22515,0,0,0,,22515,-22515
45,11-08-18,49,12:00,12:15,,30.24,0,30.24,30.24,-1,-62616,135100,197716,72484,0,-36317,0,0,0,,36317,-36317
45,11-08-18,50,12:15,12:30,,1.01,0,1.01,1.01,-1,-54408,116393,170801,61985,0,-54291,0,0,0,,54291,-54291
45,11-08-18,51,12:30,12:45,,30.3,0,30.3,30.3,-1,-65954,116589,182543,50635,0,-42233,0,0,0,,42233,-42233
45,11-08-18,52,12:45,13:00,,-31.25,0,-31.25,-31.25,-1,-52488,122882,175370,70394,0,-42227,0,0,0,,42227,-42227
45,11-08-18,53,13:00,13:15,,19.24,0,19.24,19.24,-1,-87494,99347,186841,11853,0,-30222,0,0,0,,30222,-30222
45,11-08-18,54,13:15,13:30,,29.21,0,29.21,29.21,-1,-66348,103313,169661,36965,0,-10596,0,0,0,,10596,-10596
45,11-08-18,55,13:30,13:45,,38.1,0,38.1,38.1,-1,-68802,88358,157160,19556,0,-12303,0,0,0,,12303,-12303
45,11-08-18,56,13:45,14:00,,38.1,0,38.1,38.1,-1,-69543,85005,154548,15462,0,-768,0,0,0,,768,-768
45,11-08-18,57,14:00,14:15,,29.21,0,29.21,29.21,-1,-50889,85748,136637,34859,0,-12209,0,0,0,,12209,-12209
45,11-08-18,58,14:15,14:30,,41.71,0,41.71,41.71,-1,-49067,59448,108515,10381,0,-9617,0,0,0,,9617,-9617
45,11-08-18,59,14:30,14:45,45.66,42.1,0,45.66,42.1,2,-67654,49714,117368,-17940,0,-4497,708,0,0,,5205,-3789
45,11-08-18,60,14:45,15:00,45.66,42.1,0,45.66,45.66,1,-90078,39667,129745,-50411,0,-28,2671,0,0,,2699,2643
45,11-08-18,61,15:00,15:15,45.66,29.21,0,29.21,29.21,-1,-45054,89082,134136,44028,0,-9568,634,0,0,,10202,-8934
45,11-08-18,62,15:15,15:30,,40.24,0,40.24,40.24,-1,-80317,60979,141296,-19338,0,-8109,0,0,0,,8109,-8109
45,11-08-18,63,15:30,15:45,51.09,40.24,0,51.09,51.09,1,-102820,53531,156351,-49289,0,-31,6218,0,0,,6249,6187
45,11-08-18,64,15:45,16:00,113.5,,0,113.5,113.5,1,-108779,33210,141989,-75569,0,0,31710,0,0,,31710,31710
45,11-08-18,65,16:00,16:15,130.24,-63.49,0,-63.49,-63.49,-1,-47943,144393,192336,96450,0,-10331,23577,0,0,,33908,13246
45,11-08-18,66,16:15,16:30,130.24,-88.93,0,-88.93,-88.93,-1,-74131,103124,177255,28993,0,-38352,99,0,0,,38451,-38253
45,11-08-18,67,16:30,16:45,,47.29,0,47.29,47.29,-1,-71458,78947,150405,7489,0,-2235,0,0,0,,2235,-2235
45,11-08-18,68,16:45,17:00,,,0,46.87,46.87,0,-87648,61354,149002,-26294,0,-161,0,0,0,,161,-161
45,11-08-18,69,17:00,17:15,,21.01,0,21.01,21.01,-1,-65839,127422,193261,61583,0,-14161,0,0,0,,14161,-14161
45,11-08-18,70,17:15,17:30,59.9,21.01,0,59.9,59.9,1,-98215,64638,162853,-33577,0,-1374,7495,0,0,,8869,6121
45,11-08-18,71,17:30,17:45,58.02,,0,58.02,58.02,1,-77623,73320,150943,-4303,0,0,7218,0,0,,7218,7218
45,11-08-18,72,17:45,18:00,295.05,,0,295.05,295.05,1,-58111,94523,152634,36412,0,0,10252,0,0,,10252,10252
45,11-08-18,73,18:00,18:15,267.37,32.1,0,32.1,32.1,-1,-56539,76543,133082,20004,0,-1520,11259,0,0,,12779,9739
45,11-08-18,74,18:15,18:30,,28.6,0,28.6,28.6,-1,-47047,106057,153104,59010,0,-4379,0,0,0,,4379,-4379
45,11-08-18,75,18:30,18:45,,5.48,0,5.48,5.48,-1,-47470,104253,151723,56783,0,-33830,0,0,0,,33830,-33830
45,11-08-18,76,18:45,19:00,,34.1,0,34.1,34.1,-1,-37670,99499,137169,61829,0,-35662,0,0,0,,35662,-35662
45,11-08-18,77,19:00,19:15,,32.1,0,32.1,32.1,-1,-73135,60416,133551,-12719,0,-15997,0,0,0,,15997,-15997
45,11-08-18,78,19:15,19:30,,38.1,0,38.1,38.1,-1,-59082,93068,152150,33986,0,-2960,0,0,0,,2960,-2960
45,11-08-18,79,19:30,19:45,,19.1,0,19.1,19.1,-1,-38507,100397,138904,61890,0,-22528,0,0,0,,22528,-22528
45,11-08-18,80,19:45,20:00,,21.12,0,21.12,21.12,-1,-51211,84550,135761,33339,0,-42836,0,0,0,,42836,-42836
45,11-08-18,81,20:00,20:15,47.85,38.1,0,47.85,38.1,2,-82467,51660,134127,-30807,0,-15047,1927,0,0,,16974,-13120
45,11-08-18,82,20:15,20:30,,25.84,0,25.84,25.84,-1,-56770,91417,148187,34647,0,-6313,0,0,0,,6313,-6313
45,11-08-18,83,20:30,20:45,,26.24,0,26.24,26.24,-1,-42272,76113,118385,33841,0,-35245,0,0,0,,35245,-35245
45,11-08-18,84,20:45,21:00,,14.82,0,14.82,14.82,-1,-38773,102325,141098,63552,0,-54505,0,0,0,,54505,-54505
45,11-08-18,85,21:00,21:15,54.1,41.35,0,54.1,28.53,2,-86343,22160,108503,-64183,0,-13712,6101,0,0,,19813,-7611
45,11-08-18,86,21:15,21:30,46.1,42.1,0,42.1,42.1,-1,-46358,55070,101428,8712,0,-184,2811,0,0,,2995,2627
45,11-08-18,87,21:30,21:45,,18.14,0,18.14,18.14,-1,-33009,65809,98818,32800,0,-26532,0,0,0,,26532,-26532
45,11-08-18,88,21:45,22:00,,15.1,0,15.1,15.1,-1,-47134,102249,149383,55115,0,-35591,0,0,0,,35591,-35591
45,11-08-18,89,22:00,22:15,54.1,15.1,0,54.1,54.1,1,-108122,29892,138014,-78230,0,-14616,3482,0,0,,18098,-11134
45,11-08-18,90,22:15,22:30,54.1,29.08,0,29.08,29.08,-1,-40722,49700,90422,8978,0,-7155,9,0,0,,7164,-7146
45,11-08-18,91,22:30,22:45,,22.19,0,22.19,22.19,-1,-22986,69340,92326,46354,0,-29534,0,0,0,,29534,-29534
45,11-08-18,92,22:45,23:00,,26.38,0,26.38,26.38,-1,-55686,108389,164075,52703,0,-40617,0,0,0,,40617,-40617
45,11-08-18,93,23:00,23:15,,14.37,0,14.37,14.37,-1,-39347,71848,111195,32501,0,-52483,0,0,0,,52483,-52483
45,11-08-18,94,23:15,23:30,,5.12,0,5.12,5.12,-1,-40277,76007,116284,35730,0,-16305,0,0,0,,16305,-16305
45,11-08-18,95,23:30,23:45,,-94.83,0,-94.83,-94.83,-1,-28389,74528,102917,46139,0,-57083,0,0,0,,57083,-57083
45,11-08-18,96,23:45,0:00,,14.24,0,14.24,14.24,-1,-26698,87880,114578,61182,0,-58722,0,0,0,,58722,-58722
45,11-09-18,1,0:00,0:15,60.71,24.96,0,60.71,24.96,2,-66489,52765,119254,-13724,0,-35689,3187,0,0,,38876,-32502
45,11-09-18,2,0:15,0:30,49.98,37.98,0,49.98,29.33,2,-55184,47509,102693,-7675,0,-571,8331,0,0,,8902,7760
45,11-09-18,3,0:30,0:45,,24.92,0,24.92,24.92,-1,-42330,43544,85874,1214,0,-14313,0,0,0,,14313,-14313
45,11-09-18,4,0:45,1:00,,33.98,0,33.98,33.98,-1,-44597,70329,114926,25732,0,-23035,0,0,0,,23035,-23035
45,11-09-18,5,1:00,1:15,,-17.05,0,-17.05,-17.05,-1,-30681,65552,96233,34871,0,-39110,0,0,0,,39110,-39110
45,11-09-18,6,1:15,1:30,,37.98,0,37.98,37.98,-1,-36887,41256,78143,4369,0,-5111,0,0,0,,5111,-5111
45,11-09-18,7,1:30,1:45,,35.71,0,35.71,35.71,-1,-47022,53346,100368,6324,0,-10029,0,0,0,,10029,-10029
45,11-09-18,8,1:45,2:00,,37.98,0,37.98,37.98,-1,-46661,70237,116898,23576,0,-19687,0,0,0,,19687,-19687
45,11-09-18,9,2:00,2:15,,37.98,0,37.98,37.98,-1,-13700,69477,83177,55777,0,-13214,0,0,0,,13214,-13214
45,11-09-18,10,2:15,2:30,,-26.31,0,-26.31,-26.31,-1,-12815,93190,106005,80375,0,-24545,0,0,0,,24545,-24545
45,11-09-18,11,2:30,2:45,,-24.93,0,-24.93,-24.93,-1,-25741,68706,94447,42965,0,-46996,0,0,0,,46996,-46996
45,11-09-18,12,2:45,3:00,,-6.58,0,-6.58,-6.58,-1,-25970,94984,120954,69014,0,-57378,0,0,0,,57378,-57378
45,11-09-18,13,3:00,3:15,,31.66,0,31.66,31.66,-1,-21225,67433,88658,46208,0,-23589,0,0,0,,23589,-23589
45,11-09-18,14,3:15,3:30,,37.98,0,37.98,37.98,-1,-26270,68683,94953,42413,0,-2968,0,0,0,,2968,-2968
45,11-09-18,15,3:30,3:45,,37.98,0,37.98,37.98,-1,-40826,67900,108726,27074,0,-7545,0,0,0,,7545,-7545
45,11-09-18,16,3:45,4:00,,41.98,0,41.98,41.98,-1,-33477,56579,90056,23102,0,-8228,0,0,0,,8228,-8228
45,11-09-18,17,4:00,4:15,,43,0,43,43,-1,-43693,80612,124305,36919,0,-6045,0,0,0,,6045,-6045
45,11-09-18,18,4:15,4:30,,45.61,0,45.61,45.61,-1,-21792,79354,101146,57562,0,-2136,0,0,0,,2136,-2136
45,11-09-18,19,4:30,4:45,,47.24,0,47.24,47.24,-1,-15578,77178,92756,61600,0,-544,0,0,0,,544,-544
45,11-09-18,20,4:45,5:00,,,0,46.57,46.57,0,-17926,71603,89529,53677,0,0,0,0,0,,0,0
45,11-09-18,21,5:00,5:15,,22.65,0,22.65,22.65,-1,-49919,93174,143093,43255,0,-13497,0,0,0,,13497,-13497
45,11-09-18,22,5:15,5:30,,7.99,0,7.99,7.99,-1,-25042,45552,70594,20510,0,-28855,0,0,0,,28855,-28855
45,11-09-18,23,5:30,5:45,,41.98,0,41.98,41.98,-1,-37602,36206,73808,-1396,0,-4081,0,0,0,,4081,-4081
45,11-09-18,24,5:45,6:00,49.36,,0,49.36,49.36,1,-46699,46585,93284,-114,0,0,2671,0,0,,2671,2671
45,11-09-18,25,6:00,6:15,51.7,,0,51.7,51.7,1,-102828,103611,206439,783,0,0,4569,0,0,,4569,4569
45,11-09-18,26,6:15,6:30,,28.98,0,28.98,28.98,-1,-18535,57232,75767,38697,0,-16741,0,0,0,,16741,-16741
45,11-09-18,27,6:30,6:45,50.34,48.31,0,50.34,50.34,1,-42740,33452,76192,-9288,0,-889,466,0,0,,1355,-423
45,11-09-18,28,6:45,7:00,133.02,,0,133.02,133.02,1,-105290,29409,134699,-75881,0,0,26723,0,0,,26723,26723
45,11-09-18,29,7:00,7:15,51.7,49.82,0,49.82,49.82,-1,-24069,132763,156832,108694,0,-462,13409,0,0,,13871,12947
45,11-09-18,30,7:15,7:30,,49.82,0,49.82,49.82,-1,-32182,73052,105234,40870,0,-783,0,0,0,,783,-783
45,11-09-18,31,7:30,7:45,55.7,,0,55.7,55.7,1,-65138,46201,111339,-18937,0,0,2921,0,0,,2921,2921
45,11-09-18,32,7:45,8:00,208.31,,0,208.31,208.31,1,-115626,41069,156695,-74557,0,0,41449,0,0,,41449,41449
45,11-09-18,33,8:00,8:15,208.31,-63.48,0,-63.48,-63.48,-1,-34063,88777,122840,54714,0,-6891,9976,0,0,,16867,3085
45,11-09-18,34,8:15,8:30,,,0,48.76,48.76,0,-32178,67678,99856,35500,0,0,0,0,0,,0,0
45,11-09-18,35,8:30,8:45,51.7,,0,51.7,51.7,1,-40142,48173,88315,8031,0,0,353,0,0,,353,353
45,11-09-18,36,8:45,9:00,52.24,,0,52.24,52.24,1,-51226,35861,87087,-15365,0,0,5163,0,0,,5163,5163
45,11-09-18,37,9:00,9:15,65.43,,0,65.43,65.43,1,-88550,49804,138354,-38746,0,0,3895,0,0,,3895,3895
45,11-09-18,38,9:15,9:30,263.02,,0,263.02,263.02,1,-135722,51150,186872,-84572,0,0,28418,0,0,,28418,28418
45,11-09-18,39,9:30,9:45,263.02,,0,263.02,263.02,1,-120811,68192,189003,-52619,0,0,56133,0,0,,56133,56133
45,11-09-18,40,9:45,10:00,51.7,,0,51.7,51.7,1,-54181,50450,104631,-3731,0,0,6779,0,0,,6779,6779
45,11-09-18,41,10:00,10:15,263.02,,0,263.02,263.02,1,-91611,22388,113999,-69223,0,0,28042,0,0,,28042,28042
45,11-09-18,42,10:15,10:30,83.63,,0,83.63,83.63,1,-84011,37028,121039,-46983,0,0,30361,0,0,,30361,30361
45,11-09-18,43,10:30,10:45,95.1,,0,95.1,95.1,1,-96673,25483,122156,-71190,0,0,54780,0,0,,54780,54780
45,11-09-18,44,10:45,11:00,73.27,,0,73.27,73.27,1,-88840,37923,126763,-50917,0,0,45643,0,0,,45643,45643
45,11-09-18,45,11:00,11:15,49.75,49.6,0,49.6,49.6,-1,-68184,67511,135695,-673,0,-104,11972,0,0,,12076,11868
45,11-09-18,46,11:15,11:30,52.06,,0,52.06,52.06,1,-76354,51892,128246,-24462,0,0,6705,0,0,,6705,6705
45,11-09-18,47,11:30,11:45,60.23,,0,60.23,60.23,1,-90880,47386,138266,-43494,0,0,25421,0,0,,25421,25421
45,11-09-18,48,11:45,12:00,263.02,,0,263.02,263.02,1,-155472,53017,208489,-102455,0,0,60282,0,0,,60282,60282
45,11-09-18,49,12:00,12:15,92.02,,0,92.02,92.02,1,-149936,36269,186205,-113667,0,0,63022,0,0,,63022,63022
45,11-09-18,50,12:15,12:30,68.75,,0,68.75,68.75,1,-128342,37439,165781,-90903,0,0,39381,0,0,,39381,39381
45,11-09-18,51,12:30,12:45,73.27,,0,73.27,73.27,1,-134008,25306,159314,-108702,0,0,20752,0,0,,20752,20752
45,11-09-18,52,12:45,13:00,51.7,,0,51.7,51.7,1,-140523,23030,163553,-117493,0,0,17396,0,0,,17396,17396
45,11-09-18,53,13:00,13:15,244.59,,0,244.59,244.59,1,-157347,34247,191594,-123100,0,0,33070,0,0,,33070,33070
45,11-09-18,54,13:15,13:30,244.59,,0,244.59,244.59,1,-131101,42513,173614,-88588,0,0,41891,0,0,,41891,41891
45,11-09-18,55,13:30,13:45,73.27,,0,73.27,73.27,1,-119540,44779,164319,-74761,0,0,30034,0,0,,30034,30034
45,11-09-18,56,13:45,14:00,49.7,,0,49.7,49.7,1,-121462,41497,162959,-79965,0,0,14905,0,0,,14905,14905
45,11-09-18,57,14:00,14:15,247.11,,0,247.11,247.11,1,-123749,53341,177090,-70408,0,0,21307,0,0,,21307,21307
45,11-09-18,58,14:15,14:30,247.11,,0,247.11,247.11,1,-119036,48144,167180,-70892,0,0,41221,0,0,,41221,41221
45,11-09-18,59,14:30,14:45,47.7,,0,47.7,47.7,1,-104858,50794,155652,-54064,0,0,1078,0,0,,1078,1078
45,11-09-18,60,14:45,15:00,47.7,,0,47.7,47.7,1,-122913,64755,187668,-58158,0,0,1332,0,0,,1332,1332
45,11-09-18,61,15:00,15:15,55.7,,0,55.7,55.7,1,-48141,64747,112888,16606,0,0,7361,0,0,,7361,7361
45,11-09-18,62,15:15,15:30,50.13,,0,50.13,50.13,1,-43038,68214,111252,25176,0,0,2119,0,0,,2119,2119
45,11-09-18,63,15:30,15:45,,,0,48.84,48.84,0,-43422,76662,120084,33240,0,0,31,0,0,,31,31
45,11-09-18,64,15:45,16:00,47.7,,0,47.7,47.7,1,-47461,61397,108858,13936,0,0,28,0,0,,28,28
45,11-09-18,65,16:00,16:15,47.7,,0,47.7,47.7,1,-49290,83463,132753,34173,0,0,12,0,0,,12,12
45,11-09-18,66,16:15,16:30,,,0,48.84,48.84,0,-43125,80498,123623,37373,0,0,0,0,0,,0,0
45,11-09-18,67,16:30,16:45,47.7,,0,47.7,47.7,1,-64528,76877,141405,12349,0,0,286,0,0,,286,286
45,11-09-18,68,16:45,17:00,47.7,,0,47.7,47.7,1,-44321,86830,131151,42509,0,0,915,0,0,,915,915
45,11-09-18,69,17:00,17:15,,18.92,0,18.92,18.92,-1,-15151,147082,162233,131931,0,-12399,0,0,0,,12399,-12399
45,11-09-18,70,17:15,17:30,,49.62,0,49.62,49.62,-1,-41960,108414,150374,66454,0,-224,0,0,0,,224,-224
45,11-09-18,71,17:30,17:45,,45.71,0,45.71,45.71,-1,-33616,125390,159006,91774,0,-185,0,0,0,,185,-185
45,11-09-18,72,17:45,18:00,,49.6,0,49.6,49.6,-1,-17672,137602,155274,119930,0,-1088,0,0,0,,1088,-1088
45,11-09-18,73,18:00,18:15,49.18,49.6,0,49.18,48.86,2,-91409,57225,148634,-34184,0,-22,229,0,0,,251,207
45,11-09-18,74,18:15,18:30,,31.52,0,31.52,31.52,-1,-55851,90299,146150,34448,0,-12099,0,0,0,,12099,-12099
45,11-09-18,75,18:30,18:45,,15.58,0,15.58,15.58,-1,-31539,102990,134529,71451,0,-50878,0,0,0,,50878,-50878
45,11-09-18,76,18:45,19:00,,18.03,0,18.03,18.03,-1,-43049,111992,155041,68943,0,-51681,0,0,0,,51681,-51681
45,11-09-18,77,19:00,19:15,263.02,18.03,0,263.02,263.02,1,-185470,18265,203735,-167205,0,-7783,29130,0,0,,36913,21347
45,11-09-18,78,19:15,19:30,58.28,,0,58.28,58.28,1,-86543,61337,147880,-25206,0,0,25425,0,0,,25425,25425
45,11-09-18,79,19:30,19:45,58.28,43.7,0,43.7,43.7,-1,-88904,91759,180663,2855,0,-4262,308,0,0,,4570,-3954
45,11-09-18,80,19:45,20:00,,43.7,0,43.7,43.7,-1,-96908,101770,198678,4862,0,-4180,0,0,0,,4180,-4180
45,11-09-18,81,20:00,20:15,90.6,49.97,0,90.6,48.84,2,-114837,54301,169138,-60536,0,-437,10854,0,0,,11291,10417
45,11-09-18,82,20:15,20:30,47.7,48.21,0,48.21,48.21,-1,-88948,71708,160656,-17240,0,-33,1768,0,0,,1801,1735
45,11-09-18,83,20:30,20:45,,5.64,0,5.64,5.64,-1,-43670,98430,142100,54760,0,-26929,0,0,0,,26929,-26929
45,11-09-18,84,20:45,21:00,,28.93,0,28.93,28.93,-1,-59755,114269,174024,54514,0,-57500,0,0,0,,57500,-57500
45,11-09-18,85,21:00,21:15,138.13,28.93,0,138.13,138.13,1,-94100,63495,157595,-30605,0,-21217,7733,0,0,,28950,-13484
45,11-09-18,86,21:15,21:30,50.27,,0,50.27,50.27,1,-36232,80467,116699,44235,0,0,3671,0,0,,3671,3671
45,11-09-18,87,21:30,21:45,,42.05,0,42.05,42.05,-1,-43108,105799,148907,62691,0,-5598,0,0,0,,5598,-5598
45,11-09-18,88,21:45,22:00,,23.24,0,23.24,23.24,-1,-55528,128477,184005,72949,0,-16264,0,0,0,,16264,-16264
45,11-09-18,89,22:00,22:15,54.35,-8.54,0,54.35,-8.54,2,-77046,95965,173011,18919,0,-34434,269,0,0,,34703,-34165
45,11-09-18,90,22:15,22:30,55.7,9.48,0,9.48,9.48,-1,-39386,97098,136484,57712,0,-17510,387,0,0,,17897,-17123
45,11-09-18,91,22:30,22:45,,9.48,0,9.48,9.48,-1,-34437,85998,120435,51561,0,-48194,0,0,0,,48194,-48194
45,11-09-18,92,22:45,23:00,,16.53,0,16.53,16.53,-1,-44810,116369,161179,71559,0,-44237,0,0,0,,44237,-44237
45,11-09-18,93,23:00,23:15,48.18,-17.61,0,48.18,-17.61,2,-73881,88089,161970,14208,0,-43924,252,0,0,,44176,-43672
45,11-09-18,94,23:15,23:30,51.5,-17.61,0,51.5,51.5,1,-35076,27437,62513,-7639,0,-742,2009,0,0,,2751,1267
45,11-09-18,95,23:30,23:45,198.8,,0,198.8,198.8,1,-82127,20875,103002,-61252,0,0,27523,0,0,,27523,27523
45,11-09-18,96,23:45,0:00,198.8,,0,198.8,198.8,1,-102964,58293,161257,-44671,0,0,60230,0,0,,60230,60230
46,11-10-18,1,0:00,0:15,198.8,30.92,0,30.92,30.92,-1,-73591,145996,219587,72405,0,-1350,3602,0,0,,4952,2252
46,11-10-18,2,0:15,0:30,46.97,,0,46.97,46.97,1,-104220,95552,199772,-8668,0,0,2926,0,0,,2926,2926
46,11-10-18,3,0:30,0:45,47.06,39.38,0,47.38,39.38,2,-78256,81165,159421,2909,0,-644,2248,0,0,,2892,1604
46,11-10-18,4,0:45,1:00,,36.86,0,36.86,36.86,-1,-64654,66213,130867,1559,0,-8550,0,0,0,,8550,-8550
46,11-10-18,5,1:00,1:15,47.76,20.49,0,47.76,20.49,2,-61453,76246,137699,14793,0,-10208,276,0,0,,10484,-9932
46,11-10-18,6,1:15,1:30,65,20.49,0,65,65,1,-70635,30852,101487,-39783,0,-67,21208,0,0,,21275,21141
46,11-10-18,7,1:30,1:45,46.97,30,0,47.08,30,2,-45231,53354,98585,8123,0,-9773,2831,0,0,,12604,-6942
46,11-10-18,8,1:45,2:00,,37.07,0,37.07,37.07,-1,-44233,53802,98035,9569,0,-15787,0,0,0,,15787,-15787
46,11-10-18,9,2:00,2:15,50.97,35.72,0,50.97,50.97,1,-43205,43210,86415,5,0,-7358,2325,0,0,,9683,-5033
46,11-10-18,10,2:15,2:30,66.09,,0,66.09,66.09,1,-81087,27550,108637,-53537,0,0,36365,0,0,,36365,36365
46,11-10-18,11,2:30,2:45,54.97,,0,54.97,54.97,1,-62280,30064,92344,-32216,0,0,27549,0,0,,27549,27549
46,11-10-18,12,2:45,3:00,54.97,10,0,10,10,-1,-37700,55037,92737,17337,0,-6157,3805,0,0,,9962,-2352
46,11-10-18,13,3:00,3:15,47.63,33.39,0,47.63,47.63,1,-47183,53391,100574,6208,0,-4873,778,0,0,,5651,-4095
46,11-10-18,14,3:15,3:30,49.13,39.27,0,49.13,39.27,2,-49808,49383,99191,-425,0,-157,6327,0,0,,6484,6170
46,11-10-18,15,3:30,3:45,,5.79,0,5.79,5.79,-1,-31058,61654,92712,30596,0,-20580,0,0,0,,20580,-20580
46,11-10-18,16,3:45,4:00,,-11.74,0,-11.74,-11.74,-1,-26419,84374,110793,57955,0,-55775,0,0,0,,55775,-55775
46,11-10-18,17,4:00,4:15,,-28.32,0,-28.32,-28.32,-1,-38166,64862,103028,26696,0,-46254,0,0,0,,46254,-46254
46,11-10-18,18,4:15,4:30,,36.26,0,36.26,36.26,-1,-35142,66656,101798,31514,0,-961,0,0,0,,961,-961
46,11-10-18,19,4:30,4:45,,-43.61,0,-43.61,-43.61,-1,-29594,74035,103629,44441,0,-26563,0,0,0,,26563,-26563
46,11-10-18,20,4:45,5:00,,4.29,0,4.29,4.29,-1,-22448,82128,104576,59680,0,-41218,0,0,0,,41218,-41218
46,11-10-18,21,5:00,5:15,,10,0,10,10,-1,-32699,74793,107492,42094,0,-48764,0,0,0,,48764,-48764
46,11-10-18,22,5:15,5:30,,10,0,10,10,-1,-32062,64448,96510,32386,0,-48852,0,0,0,,48852,-48852
46,11-10-18,23,5:30,5:45,,16.78,0,16.78,16.78,-1,-33642,51205,84847,17563,0,-42315,0,0,0,,42315,-42315
46,11-10-18,24,5:45,6:00,,10,0,10,10,-1,-44843,49802,94645,4959,0,-14749,0,0,0,,14749,-14749
46,11-10-18,25,6:00,6:15,,-3.33,0,-3.33,-3.33,-1,-37553,83491,121044,45938,0,-27926,0,0,0,,27926,-27926
46,11-10-18,26,6:15,6:30,,10,0,10,10,-1,-31839,84990,116829,53151,0,-31838,0,0,0,,31838,-31838
46,11-10-18,27,6:30,6:45,,41,0,41,41,-1,-42251,80324,122575,38073,0,-11726,0,0,0,,11726,-11726
46,11-10-18,28,6:45,7:00,,10,0,10,10,-1,-29647,95051,124698,65404,0,-12043,0,0,0,,12043,-12043
46,11-10-18,29,7:00,7:15,,-55.32,0,-55.32,-55.32,-1,-32311,109940,142251,77629,0,-38736,0,0,0,,38736,-38736
46,11-10-18,30,7:15,7:30,,24.93,0,24.93,24.93,-1,-36641,88143,124784,51502,0,-50693,0,0,0,,50693,-50693
46,11-10-18,31,7:30,7:45,,37.74,0,37.74,37.74,-1,-50297,68177,118474,17880,0,-16743,0,0,0,,16743,-16743
46,11-10-18,32,7:45,8:00,,,0,43.91,43.91,0,-44150,86794,130944,42644,0,-223,0,0,0,,223,-223
46,11-10-18,33,8:00,8:15,47.1,45.91,0,47.1,45.91,2,-76733,79440,156173,2707,0,-113,665,0,0,,778,552
46,11-10-18,34,8:15,8:30,,45.91,0,45.91,45.91,-1,-36885,91882,128767,54997,0,-933,0,0,0,,933,-933
46,11-10-18,35,8:30,8:45,,45.81,0,45.81,45.81,-1,-34545,72007,106552,37462,0,-14,0,0,0,,14,-14
46,11-10-18,36,8:45,9:00,,45.78,0,45.78,45.78,-1,-56968,108780,165748,51812,0,-179,0,0,0,,179,-179
46,11-10-18,37,9:00,9:15,47.1,45.7,0,47.1,45.7,2,-41840,62534,104374,20694,0,-507,233,0,0,,740,-274
46,11-10-18,38,9:15,9:30,46.97,45.7,0,46.97,45.7,2,-52356,61266,113622,8910,0,-1157,64,0,0,,1221,-1093
46,11-10-18,39,9:30,9:45,49.37,,0,49.37,49.37,1,-65241,50221,115462,-15020,0,0,7052,0,0,,7052,7052
46,11-10-18,40,9:45,10:00,53.83,,0,53.83,53.83,1,-70077,38591,108668,-31486,0,0,17942,0,0,,17942,17942
46,11-10-18,41,10:00,10:15,50.97,,0,50.97,50.97,1,-67072,45739,112811,-21333,0,0,10349,0,0,,10349,10349
46,11-10-18,42,10:15,10:30,48.94,,0,48.94,48.94,1,-72656,35927,108583,-36729,0,0,13648,0,0,,13648,13648
46,11-10-18,43,10:30,10:45,54.97,,0,54.97,54.97,1,-84675,36562,121237,-48113,0,0,22806,0,0,,22806,22806
46,11-10-18,44,10:45,11:00,58.91,,0,58.91,58.91,1,-89088,40439,129527,-48649,0,0,24020,0,0,,24020,24020
46,11-10-18,45,11:00,11:15,54.97,,0,54.97,54.97,1,-69451,71969,141420,2518,0,0,10343,0,0,,10343,10343
46,11-10-18,46,11:15,11:30,50.15,,0,50.15,50.15,1,-68207,59942,128149,-8265,0,0,973,0,0,,973,973
46,11-10-18,47,11:30,11:45,55.15,,0,55.15,55.15,1,-82534,46463,128997,-36071,0,0,17247,0,0,,17247,17247
46,11-10-18,48,11:45,12:00,64.37,,0,64.37,64.37,1,-94865,33282,128147,-61583,0,0,33782,0,0,,33782,33782
46,11-10-18,49,12:00,12:15,54.97,,0,54.97,54.97,1,-95953,81259,177212,-14694,0,0,20642,0,0,,20642,20642
46,11-10-18,50,12:15,12:30,73.2,,0,73.2,73.2,1,-105196,68989,174185,-36207,0,0,14024,0,0,,14024,14024
46,11-10-18,51,12:30,12:45,52.16,,0,52.16,52.16,1,-92573,70932,163505,-21641,0,0,19638,0,0,,19638,19638
46,11-10-18,52,12:45,13:00,50.97,,0,50.97,50.97,1,-94536,59779,154315,-34757,0,0,16121,0,0,,16121,16121
46,11-10-18,53,13:00,13:15,257.32,,0,257.32,257.32,1,-106841,26333,133174,-80508,0,0,41523,0,0,,41523,41523
46,11-10-18,54,13:15,13:30,73.2,,0,73.2,73.2,1,-80907,47171,128078,-33736,0,0,26438,0,0,,26438,26438
46,11-10-18,55,13:30,13:45,99.46,,0,99.46,99.46,1,-91327,35856,127183,-55471,0,0,35883,0,0,,35883,35883
46,11-10-18,56,13:45,14:00,99.46,,0,99.46,99.46,1,-93767,31467,125234,-62300,0,0,43345,0,0,,43345,43345
46,11-10-18,57,14:00,14:15,80.65,,0,80.65,80.65,1,-85184,49687,134871,-35497,0,0,42886,0,0,,42886,42886
46,11-10-18,58,14:15,14:30,247.26,,0,247.26,247.26,1,-104971,43369,148340,-61602,0,0,38945,0,0,,38945,38945
46,11-10-18,59,14:30,14:45,247.26,,0,247.26,247.26,1,-113905,45517,159422,-68388,0,0,63129,0,0,,63129,63129
46,11-10-18,60,14:45,15:00,247.26,,0,247.26,247.26,1,-116827,44071,160898,-72756,0,0,70812,0,0,,70812,70812
46,11-10-18,61,15:00,15:15,56.66,45.95,0,45.95,45.95,-1,-71168,81188,152356,10020,0,-294,25507,0,0,,25801,25213
46,11-10-18,62,15:15,15:30,54.97,45.95,0,54.97,54.97,1,-85358,82749,168107,-2609,0,-19,1416,0,0,,1435,1397
46,11-10-18,63,15:30,15:45,110.24,,0,110.24,110.24,1,-90982,50113,141095,-40869,0,0,32176,0,0,,32176,32176
46,11-10-18,64,15:45,16:00,98.85,,0,98.85,98.85,1,-116935,62079,179014,-54856,0,0,43183,0,0,,43183,43183
46,11-10-18,65,16:00,16:15,98.85,44.45,0,44.45,44.45,-1,-55399,186548,241947,131149,0,-724,16164,0,0,,16888,15440
46,11-10-18,66,16:15,16:30,,,0,47.39,47.39,0,-43519,134286,177805,90767,0,0,0,0,0,,0,0
46,11-10-18,67,16:30,16:45,,,0,47.39,47.39,0,-55249,119909,175158,64660,0,0,0,0,0,,0,0
46,11-10-18,68,16:45,17:00,53.39,,0,53.39,53.39,1,-103620,96265,199885,-7355,0,0,1336,0,0,,1336,1336
46,11-10-18,69,17:00,17:15,53.39,33.74,0,33.74,33.74,-1,-93606,123410,217016,29804,0,-6632,101,0,0,,6733,-6531
46,11-10-18,70,17:15,17:30,261.61,33.74,0,261.61,261.61,1,-146543,100803,247346,-45740,0,-791,18954,0,0,,19745,18163
46,11-10-18,71,17:30,17:45,66.2,,0,66.2,66.2,1,-94474,90741,185215,-3733,0,0,21275,0,0,,21275,21275
46,11-10-18,72,17:45,18:00,46.97,,0,46.97,46.97,1,-73088,87954,161042,14866,0,0,122,0,0,,122,122
46,11-10-18,73,18:00,18:15,279.9,,0,279.9,279.9,1,-125577,41268,166845,-84309,0,0,21091,0,0,,21091,21091
46,11-10-18,74,18:15,18:30,55.9,,0,55.9,55.9,1,-72904,62526,135430,-10378,0,0,22740,0,0,,22740,22740
46,11-10-18,75,18:30,18:45,55.9,25.05,0,25.05,25.05,-1,-47761,98218,145979,50457,0,-13033,1701,0,0,,14734,-11332
46,11-10-18,76,18:45,19:00,,25.23,0,25.23,25.23,-1,-37285,107747,145032,70462,0,-30656,0,0,0,,30656,-30656
46,11-10-18,77,19:00,19:15,49.83,43.81,0,49.83,49.83,1,-64944,59365,124309,-5579,0,-9464,485,0,0,,9949,-8979
46,11-10-18,78,19:15,19:30,,38.98,0,38.98,38.98,-1,-31191,78382,109573,47191,0,-523,0,0,0,,523,-523
46,11-10-18,79,19:30,19:45,,10,0,10,10,-1,-27163,106567,133730,79404,0,-32146,0,0,0,,32146,-32146
46,11-10-18,80,19:45,20:00,,21.41,0,21.41,21.41,-1,-44802,95515,140317,50713,0,-44605,0,0,0,,44605,-44605
46,11-10-18,81,20:00,20:15,108.16,21.41,0,108.16,108.16,1,-73943,42535,116478,-31408,0,-12023,12678,0,0,,24701,655
46,11-10-18,82,20:15,20:30,108.16,38.98,0,38.98,38.98,-1,-68150,82033,150183,13883,0,-1472,847,0,0,,2319,-625
46,11-10-18,83,20:30,20:45,,30,0,30,30,-1,-75654,95896,171550,20242,0,-5577,0,0,0,,5577,-5577
46,11-10-18,84,20:45,21:00,,32.98,0,32.98,32.98,-1,-69170,79249,148419,10079,0,-11755,0,0,0,,11755,-11755
46,11-10-18,85,21:00,21:15,182.82,30,0,182.82,30,2,-76746,40144,116890,-36602,0,-11435,8816,0,0,,20251,-2619
46,11-10-18,86,21:15,21:30,217.21,44.42,0,217.21,44.42,2,-77258,57079,134337,-20179,0,-462,31741,0,0,,32203,31279
46,11-10-18,87,21:30,21:45,217.21,18.14,0,18.14,18.14,-1,-52502,87947,140449,35445,0,-20408,549,0,0,,20957,-19859
46,11-10-18,88,21:45,22:00,63.8,38.7,0,63.8,63.8,1,-101940,86293,188233,-15647,0,-20795,1393,0,0,,22188,-19402
46,11-10-18,89,22:00,22:15,141.17,38.7,0,141.17,141.17,1,-74045,41766,115811,-32279,0,-748,7660,0,0,,8408,6912
46,11-10-18,90,22:15,22:30,246.09,,0,246.09,246.09,1,-89846,46009,135855,-43837,0,0,44438,0,0,,44438,44438
46,11-10-18,91,22:30,22:45,46.99,29.4,0,46.99,29.4,2,-65965,69468,135433,3503,0,-2828,3402,0,0,,6230,574
46,11-10-18,92,22:45,23:00,48.4,35.51,0,48.4,35.51,2,-72992,75991,148983,2999,0,-594,5101,0,0,,5695,4507
46,11-10-18,93,23:00,23:15,54.97,10,0,54.97,10,2,-51477,50048,101525,-1429,0,-12065,1573,0,0,,13638,-10492
46,11-10-18,94,23:15,23:30,246.09,10,0,246.09,246.09,1,-70530,37630,108160,-32900,0,-49,31684,0,0,,31733,31635
46,11-10-18,95,23:30,23:45,246.09,14,0,14,14,-1,-35612,63322,98934,27710,0,-11919,2479,0,0,,14398,-9440
46,11-10-18,96,23:45,0:00,,36.97,0,36.97,36.97,-1,-42919,66803,109722,23884,0,-16780,0,0,0,,16780,-16780
46,11-11-18,1,0:00,0:15,48.27,38.05,0,48.27,48.27,1,-59885,67459,127344,7574,0,-9210,832,0,0,,10042,-8378
46,11-11-18,2,0:15,0:30,49.77,38.05,0,49.77,49.77,1,-73906,65045,138951,-8861,0,-10,2244,0,0,,2254,2234
46,11-11-18,3,0:30,0:45,114.25,,0,114.25,114.25,1,-107488,52196,159684,-55292,0,0,27154,0,0,,27154,27154
46,11-11-18,4,0:45,1:00,69.05,,0,69.05,69.05,1,-122189,69315,191504,-52874,0,0,38739,0,0,,38739,38739
46,11-11-18,5,1:00,1:15,50.05,43.98,0,50.05,43.98,2,-71108,75405,146513,4297,0,-658,10856,0,0,,11514,10198
46,11-11-18,6,1:15,1:30,,43.98,0,43.98,43.98,-1,-65785,61323,127108,-4462,0,-142,0,0,0,,142,-142
46,11-11-18,7,1:30,1:45,,41.35,0,41.35,41.35,-1,-50199,59731,109930,9532,0,-11596,0,0,0,,11596,-11596
46,11-11-18,8,1:45,2:00,,38.05,0,38.05,38.05,-1,-64545,69911,134456,5366,0,-18580,0,0,0,,18580,-18580
46,11-11-18,9,2:00,2:15,53.08,38.05,0,53.08,53.08,1,-80066,47380,127446,-32686,0,-2384,9029,0,0,,11413,6645
46,11-11-18,10,2:15,2:30,49.94,,0,49.94,49.94,1,-68676,53174,121850,-15502,0,0,9594,0,0,,9594,9594
46,11-11-18,11,2:30,2:45,49.94,38.05,0,38.05,38.05,-1,-51945,89042,140987,37097,0,-2249,301,0,0,,2550,-1948
46,11-11-18,12,2:45,3:00,,34.05,0,34.05,34.05,-1,-63878,96882,160760,33004,0,-18154,0,0,0,,18154,-18154
46,11-11-18,13,3:00,3:15,,-80.18,0,-80.18,-80.18,-1,-21067,113658,134725,92591,0,-22635,0,0,0,,22635,-22635
46,11-11-18,14,3:15,3:30,,-61.68,0,-61.68,-61.68,-1,-49059,87977,137036,38918,0,-34720,0,0,0,,34720,-34720
46,11-11-18,15,3:30,3:45,,-26.01,0,-26.01,-26.01,-1,-37364,83264,120628,45900,0,-31959,0,0,0,,31959,-31959
46,11-11-18,16,3:45,4:00,,-16.37,0,-16.37,-16.37,-1,-31719,69253,100972,37534,0,-40379,0,0,0,,40379,-40379
46,11-11-18,17,4:00,4:15,,3.98,0,3.98,3.98,-1,-40449,89968,130417,49519,0,-42076,0,0,0,,42076,-42076
46,11-11-18,18,4:15,4:30,,-6.77,0,-6.77,-6.77,-1,-49788,91437,141225,41649,0,-49755,0,0,0,,49755,-49755
46,11-11-18,19,4:30,4:45,,-16.74,0,-16.74,-16.74,-1,-42667,90436,133103,47769,0,-47518,0,0,0,,47518,-47518
46,11-11-18,20,4:45,5:00,,-6.42,0,-6.42,-6.42,-1,-42460,91966,134426,49506,0,-46675,0,0,0,,46675,-46675
46,11-11-18,21,5:00,5:15,,9.62,0,9.62,9.62,-1,-40438,109185,149623,68747,0,-43679,0,0,0,,43679,-43679
46,11-11-18,22,5:15,5:30,,11.93,0,11.93,11.93,-1,-43278,105117,148395,61839,0,-14081,0,0,0,,14081,-14081
46,11-11-18,23,5:30,5:45,,10.03,0,10.03,10.03,-1,-50509,101965,152474,51456,0,-20500,0,0,0,,20500,-20500
46,11-11-18,24,5:45,6:00,,38.05,0,38.05,38.05,-1,-66320,88646,154966,22326,0,-15440,0,0,0,,15440,-15440
46,11-11-18,25,6:00,6:15,48.57,38.05,0,48.57,48.57,1,-57027,43144,100171,-13883,0,-3923,2256,0,0,,6179,-1667
46,11-11-18,26,6:15,6:30,,32.03,0,32.03,32.03,-1,-44619,67125,111744,22506,0,-14465,0,0,0,,14465,-14465
46,11-11-18,27,6:30,6:45,,39.44,0,39.44,39.44,-1,-65118,66047,131165,929,0,-9584,0,0,0,,9584,-9584
46,11-11-18,28,6:45,7:00,,42.05,0,42.05,42.05,-1,-65599,68388,133987,2789,0,-111,0,0,0,,111,-111
46,11-11-18,29,7:00,7:15,,42.05,0,42.05,42.05,-1,-55205,57086,112291,1881,0,-5085,0,0,0,,5085,-5085
46,11-11-18,30,7:15,7:30,48.17,42.05,0,48.17,48.17,1,-59611,51086,110697,-8525,0,-55,3275,0,0,,3330,3220
46,11-11-18,31,7:30,7:45,50.05,,0,50.05,50.05,1,-97562,64986,162548,-32576,0,0,26170,0,0,,26170,26170
46,11-11-18,32,7:45,8:00,49,,0,49,49,1,-91779,83049,174828,-8730,0,0,12869,0,0,,12869,12869
46,11-11-18,33,8:00,8:15,55.53,,0,55.53,55.53,1,-114851,45204,160055,-69647,0,0,25314,0,0,,25314,25314
46,11-11-18,34,8:15,8:30,50.05,,0,50.05,50.05,1,-67223,41879,109102,-25344,0,0,18397,0,0,,18397,18397
46,11-11-18,35,8:30,8:45,46.82,,0,46.82,46.82,1,-78690,73598,152288,-5092,0,0,3448,0,0,,3448,3448
46,11-11-18,36,8:45,9:00,50.05,,0,50.05,50.05,1,-103539,90800,194339,-12739,0,0,6588,0,0,,6588,6588
46,11-11-18,37,9:00,9:15,58.02,,0,58.02,58.02,1,-91490,47853,139343,-43637,0,0,24933,0,0,,24933,24933
46,11-11-18,38,9:15,9:30,49.02,,0,49.02,49.02,1,-62391,55152,117543,-7239,0,0,12200,0,0,,12200,12200
46,11-11-18,39,9:30,9:45,46.83,,0,46.83,46.83,1,-59408,49511,108919,-9897,0,0,5286,0,0,,5286,5286
46,11-11-18,40,9:45,10:00,46.05,,0,46.05,46.05,1,-47125,54158,101283,7033,0,0,2792,0,0,,2792,2792
46,11-11-18,41,10:00,10:15,,,0,43.63,43.63,0,-37768,63594,101362,25826,0,0,113,0,0,,113,113
46,11-11-18,42,10:15,10:30,,,0,43.64,43.64,0,-38045,71435,109480,33390,0,0,0,0,0,,0,0
46,11-11-18,43,10:30,10:45,,,0,43.63,43.63,0,-35075,68935,104010,33860,0,0,0,0,0,,0,0
46,11-11-18,44,10:45,11:00,,,0,43.61,43.61,0,-35159,75913,111072,40754,0,0,0,0,0,,0,0
46,11-11-18,45,11:00,11:15,,42.05,0,42.05,42.05,-1,-65891,93471,159362,27580,0,-5046,0,0,0,,5046,-5046
46,11-11-18,46,11:15,11:30,,41.69,0,41.69,41.69,-1,-68765,98299,167064,29534,0,-13377,0,0,0,,13377,-13377
46,11-11-18,47,11:30,11:45,,44.83,0,44.83,44.83,-1,-80645,103207,183852,22562,0,-2619,0,0,0,,2619,-2619
46,11-11-18,48,11:45,12:00,53.72,,0,53.72,53.72,1,-96674,98678,195352,2004,0,0,3539,0,0,,3539,3539
46,11-11-18,49,12:00,12:15,54.75,,0,54.75,54.75,1,-64278,46098,110376,-18180,0,0,19941,0,0,,19941,19941
46,11-11-18,50,12:15,12:30,69.75,,0,69.75,69.75,1,-70058,30105,100163,-39953,0,0,34196,0,0,,34196,34196
46,11-11-18,51,12:30,12:45,94.96,,0,94.96,94.96,1,-67079,26339,93418,-40740,0,0,46465,0,0,,46465,46465
46,11-11-18,52,12:45,13:00,58.02,,0,58.02,58.02,1,-61395,41773,103168,-19622,0,0,33777,0,0,,33777,33777
46,11-11-18,53,13:00,13:15,63.39,,0,63.39,63.39,1,-73703,47389,121092,-26314,0,0,24976,0,0,,24976,24976
46,11-11-18,54,13:15,13:30,69.75,,0,69.75,69.75,1,-68858,35732,104590,-33126,0,0,30856,0,0,,30856,30856
46,11-11-18,55,13:30,13:45,50.75,,0,50.75,50.75,1,-65011,57631,122642,-7380,0,0,17028,0,0,,17028,17028
46,11-11-18,56,13:45,14:00,50.75,42.98,0,42.98,42.98,-1,-59272,69415,128687,10143,0,-892,202,0,0,,1094,-690
46,11-11-18,57,14:00,14:15,,42.07,0,42.07,42.07,-1,-41896,72478,114374,30582,0,-3201,0,0,0,,3201,-3201
46,11-11-18,58,14:15,14:30,,46.55,0,46.55,46.55,-1,-57179,62711,119890,5532,0,-1780,0,0,0,,1780,-1780
46,11-11-18,59,14:30,14:45,47.75,,0,47.75,47.75,1,-69217,59260,128477,-9957,0,0,4575,0,0,,4575,4575
46,11-11-18,60,14:45,15:00,54.75,,0,54.75,54.75,1,-91968,62894,154862,-29074,0,0,13471,0,0,,13471,13471
46,11-11-18,61,15:00,15:15,51.66,46.57,0,46.57,46.57,-1,-65886,76853,142739,10967,0,-236,9129,0,0,,9365,8893
46,11-11-18,62,15:15,15:30,55.16,46.51,0,55.16,43.77,2,-72894,44906,117800,-27988,0,-153,7481,0,0,,7634,7328
46,11-11-18,63,15:30,15:45,54.12,,0,54.12,54.12,1,-103710,42968,146678,-60742,0,0,10909,0,0,,10909,10909
46,11-11-18,64,15:45,16:00,257.01,,0,257.01,257.01,1,-122452,50005,172457,-72447,0,0,46659,0,0,,46659,46659
46,11-11-18,65,16:00,16:15,257.01,39.62,0,39.62,39.62,-1,-69676,82262,151938,12586,0,-5309,14290,0,0,,19599,8981
46,11-11-18,66,16:15,16:30,49.47,38.3,0,49.47,49.47,1,-54180,35412,89592,-18768,0,-3959,125,0,0,,4084,-3834
46,11-11-18,67,16:30,16:45,69.75,,0,69.75,69.75,1,-86040,26505,112545,-59535,0,0,9906,0,0,,9906,9906
46,11-11-18,68,16:45,17:00,69.75,,0,69.75,69.75,1,-113663,53795,167458,-59868,0,0,32708,0,0,,32708,32708
46,11-11-18,69,17:00,17:15,60.46,44.32,0,60.46,44.32,2,-93935,83034,176969,-10901,0,-1449,18601,0,0,,20050,17152
46,11-11-18,70,17:15,17:30,262,,0,262,262,1,-129957,49291,179248,-80666,0,0,35872,0,0,,35872,35872
46,11-11-18,71,17:30,17:45,120.63,,0,120.63,120.63,1,-87586,39662,127248,-47924,0,0,51962,0,0,,51962,51962
46,11-11-18,72,17:45,18:00,54.66,,0,54.66,54.66,1,-80537,76649,157186,-3888,0,0,27077,0,0,,27077,27077
46,11-11-18,73,18:00,18:15,274.77,,0,274.77,274.77,1,-115663,38915,154578,-76748,0,0,35219,0,0,,35219,35219
46,11-11-18,74,18:15,18:30,72.69,,0,72.69,72.69,1,-60681,53204,113885,-7477,0,0,23860,0,0,,23860,23860
46,11-11-18,75,18:30,18:45,137.9,,0,137.9,137.9,1,-100096,53595,153691,-46501,0,0,21208,0,0,,21208,21208
46,11-11-18,76,18:45,19:00,54.48,,0,54.48,54.48,1,-66693,60824,127517,-5869,0,0,14867,0,0,,14867,14867
46,11-11-18,77,19:00,19:15,52.65,,0,52.65,52.65,1,-66223,50791,117014,-15432,0,0,9993,0,0,,9993,9993
46,11-11-18,78,19:15,19:30,49.72,,0,49.72,49.72,1,-56341,47466,103807,-8875,0,0,8566,0,0,,8566,8566
46,11-11-18,79,19:30,19:45,50.32,,0,50.32,50.32,1,-52911,36618,89529,-16293,0,0,2206,0,0,,2206,2206
46,11-11-18,80,19:45,20:00,65.73,,0,65.73,65.73,1,-75400,39532,114932,-35868,0,0,23026,0,0,,23026,23026
46,11-11-18,81,20:00,20:15,183.37,,0,183.37,183.37,1,-95106,45891,140997,-49215,0,0,28005,0,0,,28005,28005
46,11-11-18,82,20:15,20:30,258.83,,0,258.83,258.83,1,-73979,54549,128528,-19430,0,0,41800,0,0,,41800,41800
46,11-11-18,83,20:30,20:45,258.83,36.83,0,36.83,36.83,-1,-46925,64851,111776,17926,0,-8042,2626,0,0,,10668,-5416
46,11-11-18,84,20:45,21:00,,38.72,0,38.72,38.72,-1,-31339,59023,90362,27684,0,-14232,0,0,0,,14232,-14232
46,11-11-18,85,21:00,21:15,241.97,33.69,0,241.97,241.97,1,-91810,54120,145930,-37690,0,-8176,8668,0,0,,16844,492
46,11-11-18,86,21:15,21:30,241.97,,0,241.97,241.97,1,-167885,69088,236973,-98797,0,0,81533,0,0,,81533,81533
46,11-11-18,87,21:30,21:45,361.43,40.54,0,40.54,40.54,-1,-114082,107626,221708,-6456,0,-131,36517,5000,0,,41648,41386
46,11-11-18,88,21:45,22:00,,14.54,0,14.54,14.54,-1,-89525,111335,200860,21810,0,-17081,0,0,0,,17081,-17081
46,11-11-18,89,22:00,22:15,,33.69,0,33.69,33.69,-1,-77738,109163,186901,31425,0,-15890,0,0,0,,15890,-15890
46,11-11-18,90,22:15,22:30,,47.52,0,47.52,47.52,-1,-60992,68114,129106,7122,0,-4632,0,0,0,,4632,-4632
46,11-11-18,91,22:30,22:45,,42.69,0,42.69,42.69,-1,-53916,57604,111520,3688,0,-1117,0,0,0,,1117,-1117
46,11-11-18,92,22:45,23:00,53.35,,0,53.35,53.35,1,-89571,64743,154314,-24828,0,0,8870,0,0,,8870,8870
46,11-11-18,93,23:00,23:15,53.35,-44.49,0,-44.49,-44.49,-1,-61714,122823,184537,61109,0,-23810,2205,0,0,,26015,-21605
46,11-11-18,94,23:15,23:30,,40.18,0,40.18,40.18,-1,-51467,65087,116554,13620,0,-6671,0,0,0,,6671,-6671
46,11-11-18,95,23:30,23:45,,25.99,0,25.99,25.99,-1,-48134,87864,135998,39730,0,-23437,0,0,0,,23437,-23437
46,11-11-18,96,23:45,0:00,,9.44,0,9.44,9.44,-1,-33139,92230,125369,59091,0,-42122,0,0,0,,42122,-42122
46,11-12-18,1,0:00,0:15,,-32.08,0,-32.08,-32.08,-1,-65432,89886,155318,24454,0,-28325,0,0,0,,28325,-28325
46,11-12-18,2,0:15,0:30,,33.69,0,33.69,33.69,-1,-49186,70801,119987,21615,0,-19021,0,0,0,,19021,-19021
46,11-12-18,3,0:30,0:45,45.69,43.78,0,46.03,43.78,2,-46593,52279,98872,5686,0,-5866,80,0,0,,5946,-5786
46,11-12-18,4,0:45,1:00,,36.09,0,36.09,36.09,-1,-31883,50687,82570,18804,0,-9445,0,0,0,,9445,-9445
46,11-12-18,5,1:00,1:15,,10.86,0,10.86,10.86,-1,-34139,70400,104539,36261,0,-25971,0,0,0,,25971,-25971
46,11-12-18,6,1:15,1:30,,41.69,0,41.69,41.69,-1,-43394,51441,94835,8047,0,-13292,0,0,0,,13292,-13292
46,11-12-18,7,1:30,1:45,,41.69,0,41.69,41.69,-1,-32544,50297,82841,17753,0,-8877,0,0,0,,8877,-8877
46,11-12-18,8,1:45,2:00,,36.3,0,36.3,36.3,-1,-31304,48785,80089,17481,0,-16339,0,0,0,,16339,-16339
46,11-12-18,9,2:00,2:15,,35.13,0,35.13,35.13,-1,-26154,55218,81372,29064,0,-14627,0,0,0,,14627,-14627
46,11-12-18,10,2:15,2:30,,,0,45.36,45.36,0,-44011,36518,80529,-7493,0,-576,0,0,0,,576,-576
46,11-12-18,11,2:30,2:45,,,0,45.36,45.36,0,-47286,29901,77187,-17385,0,0,0,0,0,,0,0
46,11-12-18,12,2:45,3:00,45.69,,0,45.69,45.69,1,-58588,32060,90648,-26528,0,0,1273,0,0,,1273,1273
46,11-12-18,13,3:00,3:15,51.73,,0,51.73,51.73,1,-56760,40782,97542,-15978,0,0,6747,0,0,,6747,6747
46,11-12-18,14,3:15,3:30,53.69,,0,53.69,53.69,1,-83347,45438,128785,-37909,0,0,29504,0,0,,29504,29504
46,11-12-18,15,3:30,3:45,53.69,,0,53.69,53.69,1,-84497,40560,125057,-43937,0,0,34666,0,0,,34666,34666
46,11-12-18,16,3:45,4:00,49.69,,0,49.69,49.69,1,-81615,42308,123923,-39307,0,0,26538,0,0,,26538,26538
46,11-12-18,17,4:00,4:15,45.69,43.07,0,43.07,43.07,-1,-51719,74351,126070,22632,0,-2482,6858,0,0,,9340,4376
46,11-12-18,18,4:15,4:30,45.69,41.69,0,41.69,41.69,-1,-33786,59274,93060,25488,0,-8099,1,0,0,,8100,-8098
46,11-12-18,19,4:30,4:45,,42.69,0,42.69,42.69,-1,-39433,55309,94742,15876,0,-4551,0,0,0,,4551,-4551
46,11-12-18,20,4:45,5:00,49.69,42.69,0,49.69,49.69,1,-45822,34576,80398,-11246,0,-8,4475,0,0,,4483,4467
46,11-12-18,21,5:00,5:15,46.97,44.47,0,44.47,44.47,-1,-80091,68827,148918,-11264,0,-95,5220,0,0,,5315,5125
46,11-12-18,22,5:15,5:30,51.16,42.97,0,51.16,42.97,2,-51806,42553,94359,-9253,0,-4489,549,0,0,,5038,-3940
46,11-12-18,23,5:30,5:45,67.69,,0,67.69,67.69,1,-62966,29349,92315,-33617,0,0,23047,0,0,,23047,23047
46,11-12-18,24,5:45,6:00,48.12,,0,48.12,48.12,1,-51137,58230,109367,7093,0,0,12125,0,0,,12125,12125
46,11-12-18,25,6:00,6:15,48.12,43.27,0,43.27,43.27,-1,-64075,65510,129585,1435,0,-2642,605,0,0,,3247,-2037
46,11-12-18,26,6:15,6:30,,43.27,0,43.27,43.27,-1,-16350,84637,100987,68287,0,-6544,0,0,0,,6544,-6544
46,11-12-18,27,6:30,6:45,,51.78,0,51.78,51.78,-1,-55389,55374,110763,-15,0,-340,0,0,0,,340,-340
46,11-12-18,28,6:45,7:00,253.81,,0,253.81,253.81,1,-120393,36434,156827,-83959,0,0,24961,0,0,,24961,24961
46,11-12-18,29,7:00,7:15,253.81,-97.44,0,-97.44,-97.44,-1,-41090,151433,192523,110343,0,-31957,7318,0,0,,39275,-24639
46,11-12-18,30,7:15,7:30,,39.27,0,39.27,39.27,-1,-52656,68447,121103,15791,0,-23633,0,0,0,,23633,-23633
46,11-12-18,31,7:30,7:45,48.59,47.68,0,48.59,48.59,1,-72179,49727,121906,-22452,0,-5999,278,0,0,,6277,-5721
46,11-12-18,32,7:45,8:00,50.74,49.2,0,50.76,49.2,2,-112894,46063,158957,-66831,0,-14,8903,0,0,,8917,8889
46,11-12-18,33,8:00,8:15,50.74,39.27,0,39.27,39.27,-1,-33044,84631,117675,51587,0,-2320,2032,0,0,,4352,-288
46,11-12-18,34,8:15,8:30,,49.39,0,49.39,49.39,-1,-34357,61293,95650,26936,0,-1826,0,0,0,,1826,-1826
46,11-12-18,35,8:30,8:45,50.74,49.32,0,50.74,49.32,2,-64217,46230,110447,-17987,0,-950,819,0,0,,1769,-131
46,11-12-18,36,8:45,9:00,69.74,,0,69.74,69.74,1,-85867,40149,126016,-45718,0,0,23610,0,0,,23610,23610
46,11-12-18,37,9:00,9:15,54.74,,0,54.74,54.74,1,-34885,46285,81170,11400,0,0,17861,0,0,,17861,17861
46,11-12-18,38,9:15,9:30,46.74,47.3,0,50.26,47.3,2,-49399,35192,84591,-14207,0,-339,833,0,0,,1172,494
46,11-12-18,39,9:30,9:45,50.74,,0,50.74,50.74,1,-57067,38033,95100,-19034,0,0,1685,0,0,,1685,1685
46,11-12-18,40,9:45,10:00,54.92,,0,54.92,54.92,1,-68518,41972,110490,-26546,0,0,2204,0,0,,2204,2204
46,11-12-18,41,10:00,10:15,81.21,,0,81.21,81.21,1,-61998,22241,84239,-39757,0,0,32050,0,0,,32050,32050
46,11-12-18,42,10:15,10:30,72.01,,0,72.01,72.01,1,-65986,18274,84260,-47712,0,0,41440,0,0,,41440,41440
46,11-12-18,43,10:30,10:45,72.51,,0,72.51,72.51,1,-63982,11259,75241,-52723,0,0,44601,0,0,,44601,44601
46,11-12-18,44,10:45,11:00,118.22,,0,118.22,118.22,1,-72606,10426,83032,-62180,0,0,52009,0,0,,52009,52009
46,11-12-18,45,11:00,11:15,156.19,,0,156.19,156.19,1,-75939,9141,85080,-66798,0,0,58765,0,0,,58765,58765
46,11-12-18,46,11:15,11:30,76.51,,0,76.51,76.51,1,-63285,23027,86312,-40258,0,0,47890,0,0,,47890,47890
46,11-12-18,47,11:30,11:45,81.89,,0,81.89,81.89,1,-74768,22445,97213,-52323,0,0,41702,0,0,,41702,41702
46,11-12-18,48,11:45,12:00,196.51,,0,196.51,196.51,1,-66482,31849,98331,-34633,0,0,37770,1250,0,,39020,39020
46,11-12-18,49,12:00,12:15,196.51,-14.09,0,-14.09,-14.09,-1,-33954,106291,140245,72337,0,-22955,4232,0,0,,27187,-18723
46,11-12-18,50,12:15,12:30,,41.87,0,41.87,41.87,-1,-43925,74103,118028,30178,0,-27423,0,0,0,,27423,-27423
46,11-12-18,51,12:30,12:45,,41.87,0,41.87,41.87,-1,-46037,76744,122781,30707,0,-32547,0,0,0,,32547,-32547
46,11-12-18,52,12:45,13:00,,41.87,0,41.87,41.87,-1,-51015,74756,125771,23741,0,-22898,0,0,0,,22898,-22898
46,11-12-18,53,13:00,13:15,,41.81,0,41.81,41.81,-1,-39715,86329,126044,46614,0,-11316,0,0,0,,11316,-11316
46,11-12-18,54,13:15,13:30,,,0,50.26,50.26,0,-31265,109214,140479,77949,0,-47,0,0,0,,47,-47
46,11-12-18,55,13:30,13:45,,,0,50.26,50.26,0,-34762,138442,173204,103680,0,0,0,0,0,,0,0
46,11-12-18,56,13:45,14:00,,39.27,0,39.27,39.27,-1,-32724,143825,176549,111101,0,-4880,0,0,0,,4880,-4880
46,11-12-18,57,14:00,14:15,,32.93,0,32.93,32.93,-1,-55499,79446,134945,23947,0,-14208,0,0,0,,14208,-14208
46,11-12-18,58,14:15,14:30,,,0,50.26,50.26,0,-67039,78266,145305,11227,0,-640,0,0,0,,640,-640
46,11-12-18,59,14:30,14:45,46.74,,0,46.74,46.74,1,-61836,64114,125950,2278,0,0,41,0,0,,41,41
46,11-12-18,60,14:45,15:00,46.74,,0,46.74,46.74,1,-60042,74264,134306,14222,0,0,482,0,0,,482,482
46,11-12-18,61,15:00,15:15,50.05,,0,50.05,50.05,1,-82235,56672,138907,-25563,0,0,3156,0,0,,3156,3156
46,11-12-18,62,15:15,15:30,53.22,,0,53.22,53.22,1,-77673,43590,121263,-34083,0,0,13812,0,0,,13812,13812
46,11-12-18,63,15:30,15:45,48.48,,0,48.48,48.48,1,-72139,41600,113739,-30539,0,0,6011,0,0,,6011,6011
46,11-12-18,64,15:45,16:00,54.74,,0,54.74,54.74,1,-59516,37204,96720,-22312,0,0,6158,0,0,,6158,6158
46,11-12-18,65,16:00,16:15,46.74,,0,46.74,46.74,1,-65253,109267,174520,44014,0,0,2895,0,0,,2895,2895
46,11-12-18,66,16:15,16:30,,53.78,0,53.78,53.78,-1,-56302,100327,156629,44025,0,-139,0,0,0,,139,-139
46,11-12-18,67,16:30,16:45,,,0,50.26,50.26,0,-51133,96621,147754,45488,0,0,0,0,0,,0,0
46,11-12-18,68,16:45,17:00,,,0,50.26,50.26,0,-61167,83891,145058,22724,0,0,0,0,0,,0,0
46,11-12-18,69,17:00,17:15,,43.27,0,43.27,43.27,-1,-80404,118735,199139,38331,0,-6028,0,0,0,,6028,-6028
46,11-12-18,70,17:15,17:30,,72.45,0,72.45,72.45,-1,-68317,76734,145051,8417,0,-437,0,0,0,,437,-437
46,11-12-18,71,17:30,17:45,,,0,60.39,60.39,0,-53451,83223,136674,29772,0,0,0,0,0,,0,0
46,11-12-18,72,17:45,18:00,,,0,60.42,60.42,0,-46149,113381,159530,67232,0,0,0,0,0,,0,0
46,11-12-18,73,18:00,18:15,56.59,44.28,0,60.6,44.28,2,-96242,40054,136296,-56188,0,-1643,1747,0,0,,3390,104
46,11-12-18,74,18:15,18:30,56.59,48.67,0,60.72,48.67,2,-88747,83888,172635,-4859,0,-41,1455,0,0,,1496,1414
46,11-12-18,75,18:30,18:45,,35.93,0,35.93,35.93,-1,-64317,101700,166017,37383,0,-27092,0,0,0,,27092,-27092
46,11-12-18,76,18:45,19:00,,33.41,0,33.41,33.41,-1,-57205,129730,186935,72525,0,-52803,0,0,0,,52803,-52803
46,11-12-18,77,19:00,19:15,119.12,39.27,0,119.12,39.27,2,-98023,57482,155505,-40541,0,-20937,5948,0,0,,26885,-14989
46,11-12-18,78,19:15,19:30,46.74,38.83,0,38.83,38.83,-1,-70806,93678,164484,22872,0,-5876,412,0,0,,6288,-5464
46,11-12-18,79,19:30,19:45,,28.61,0,28.61,28.61,-1,-41288,105673,146961,64385,0,-50984,0,0,0,,50984,-50984
46,11-12-18,80,19:45,20:00,,16.76,0,16.76,16.76,-1,-45944,136830,182774,90886,0,-77340,0,0,0,,77340,-77340
46,11-12-18,81,20:00,20:15,101.21,17.69,0,101.21,17.69,2,-72131,47758,119889,-24373,0,-35312,4223,0,0,,39535,-31089
46,11-12-18,82,20:15,20:30,48.67,20.27,0,20.27,20.27,-1,-62402,107065,169467,44663,0,-18633,1466,0,0,,20099,-17167
46,11-12-18,83,20:30,20:45,,23.06,0,23.06,23.06,-1,-56694,129135,185829,72441,0,-64566,0,0,0,,64566,-64566
46,11-12-18,84,20:45,21:00,,16.76,0,16.76,16.76,-1,-57291,142431,199722,85140,0,-76731,0,0,0,,76731,-76731
46,11-12-18,85,21:00,21:15,152.12,14.81,0,152.12,152.12,1,-130641,98220,228861,-32421,0,-37970,3464,0,0,,41434,-34506
46,11-12-18,86,21:15,21:30,260.77,11.42,0,260.77,11.42,2,-48529,65438,113967,16909,0,-3792,14886,3750,0,,22428,14844
46,11-12-18,87,21:30,21:45,,-132.24,0,-132.24,-132.24,-1,-38666,108051,146717,69385,0,-52944,0,0,0,,52944,-52944
46,11-12-18,88,21:45,22:00,,9.31,0,9.31,9.31,-1,-67342,143452,210794,76110,0,-59222,0,0,0,,59222,-59222
46,11-12-18,89,22:00,22:15,119.55,20.27,0,119.55,119.55,1,-112084,74056,186140,-38028,0,-33160,6132,0,0,,39292,-27028
46,11-12-18,90,22:15,22:30,174.59,35.27,0,174.59,35.27,2,-54928,51678,106606,-3250,0,-1114,22373,0,0,,23487,21259
46,11-12-18,91,22:30,22:45,,6.92,0,6.92,6.92,-1,-57960,119727,177687,61767,0,-44939,0,0,0,,44939,-44939
46,11-12-18,92,22:45,23:00,,27.97,0,27.97,27.97,-1,-76843,132458,209301,55615,0,-50501,0,0,0,,50501,-50501
46,11-12-18,93,23:00,23:15,102.61,35.27,0,102.61,102.61,1,-89540,42229,131769,-47311,0,-20150,13010,0,0,,33160,-7140
46,11-12-18,94,23:15,23:30,54.4,39.27,0,39.27,39.27,-1,-57703,59955,117658,2252,0,-418,15183,0,0,,15601,14765
46,11-12-18,95,23:30,23:45,,-55.94,0,-55.94,-55.94,-1,-25346,90440,115786,65094,0,-42535,0,0,0,,42535,-42535
46,11-12-18,96,23:45,0:00,,10.26,0,10.26,10.26,-1,-29526,113791,143317,84265,0,-67758,0,0,0,,67758,-67758
46,11/13/2018,1,0:00,0:15,68.67,18.03,0,68.67,68.67,1,-167920,150946,318866,-16974,0,-39135,2821,0,0,,41956,-36314
46,11/13/2018,2,0:15,0:30,85.87,18.03,0,85.87,85.87,1,-110693,81438,192131,-29255,0,-275,15939,0,0,,16214,15664
46,11/13/2018,3,0:30,0:45,87.23,,0,87.23,87.23,1,-100468,47667,148135,-52801,0,0,35602,0,0,,35602,35602
46,11/13/2018,4,0:45,1:00,56.82,47.77,0,47.77,47.77,-1,-66276,60384,126660,-5892,0,-7,25168,0,0,,25175,25161
46,11/13/2018,5,1:00,1:15,63.87,40.13,0,63.87,40.13,2,-75956,43842,119798,-32114,0,-752,9148,0,0,,9900,8396
46,11/13/2018,6,1:15,1:30,76.23,,0,76.23,76.23,1,-73840,55682,129522,-18158,0,0,29393,0,0,,29393,29393
46,11/13/2018,7,1:30,1:45,76.23,28.88,0,28.88,28.88,-1,-31163,68172,99335,37009,0,-22417,717,0,0,,23134,-21700
46,11/13/2018,8,1:45,2:00,,34.63,0,34.63,34.63,-1,-22566,71217,93783,48651,0,-46264,0,0,0,,46264,-46264
46,11/13/2018,9,2:00,2:15,62.06,40.05,0,62.06,62.06,1,-57547,31365,88912,-26182,0,-18173,5494,0,0,,23667,-12679
46,11/13/2018,10,2:15,2:30,68.64,,0,68.64,68.64,1,-55616,38729,94345,-16887,0,0,12180,0,0,,12180,12180
46,11/13/2018,11,2:30,2:45,46.84,,0,46.84,46.84,1,-49950,43841,93791,-6109,0,0,1330,0,0,,1330,1330
46,11/13/2018,12,2:45,3:00,46.84,42.84,0,46.84,42.84,2,-44941,49241,94182,4300,0,-2985,1552,0,0,,4537,-1433
46,11/13/2018,13,3:00,3:15,50.84,42.84,0,50.84,50.84,1,-61283,49425,110708,-11858,0,-2624,1649,0,0,,4273,-975
46,11/13/2018,14,3:15,3:30,54.84,,0,54.84,54.84,1,-67152,45693,112845,-21459,0,0,20316,0,0,,20316,20316
46,11/13/2018,15,3:30,3:45,47.6,47.45,0,47.45,47.45,-1,-57404,52148,109552,-5256,0,-28,6117,0,0,,6145,6089
46,11/13/2018,16,3:45,4:00,52.89,,0,52.89,52.89,1,-76035,48048,124083,-27987,0,0,12008,0,0,,12008,12008
46,11/13/2018,17,4:00,4:15,50.84,,0,50.84,50.84,1,-107234,66647,173881,-40587,0,0,21172,0,0,,21172,21172
46,11/13/2018,18,4:15,4:30,,,0,44.25,44.25,0,-87271,60185,147456,-27086,0,0,3157,0,0,,3157,3157
46,11/13/2018,19,4:30,4:45,53.64,,0,53.64,53.64,1,-82726,55950,138676,-26776,0,0,4483,0,0,,4483,4483
46,11/13/2018,20,4:45,5:00,50.84,,0,50.84,50.84,1,-92686,60146,152832,-32540,0,0,21372,0,0,,21372,21372
46,11/13/2018,21,5:00,5:15,60.7,,0,60.7,60.7,1,-103251,64227,167478,-39024,0,0,25443,0,0,,25443,25443
46,11/13/2018,22,5:15,5:30,48.02,47.57,0,47.57,47.57,-1,-88349,81465,169814,-6884,0,-317,7036,0,0,,7353,6719
46,11/13/2018,23,5:30,5:45,54.84,,0,54.84,54.84,1,-94041,56607,150648,-37434,0,0,9208,0,0,,9208,9208
46,11/13/2018,24,5:45,6:00,49.85,4.27,0,49.85,4.27,2,-61962,118625,180587,56663,0,-7659,6707,0,0,,14366,-952
46,11/13/2018,25,6:00,6:15,244.23,4.27,0,244.23,244.23,1,-145339,49788,195127,-95551,0,-1014,26805,0,0,,27819,25791
46,11/13/2018,26,6:15,6:30,56.29,,0,56.29,56.29,1,-94858,63235,158093,-31623,0,0,23700,0,0,,23700,23700
46,11/13/2018,27,6:30,6:45,244.23,,0,244.23,244.23,1,-129998,41301,171299,-88697,0,0,58952,0,0,,58952,58952
46,11/13/2018,28,6:45,7:00,244.23,,0,244.23,244.23,1,-180985,63476,244461,-117509,0,0,94117,0,0,,94117,94117
46,11/13/2018,29,7:00,7:15,244.23,-89.09,0,-89.09,-89.09,-1,-91041,195468,286509,104427,0,-21590,30213,0,0,,51803,8623
46,11/13/2018,30,7:15,7:30,104.25,-130.28,0,104.25,-130.28,2,-107843,68489,176332,-39354,0,-26737,8800,0,0,,35537,-17937
46,11/13/2018,31,7:30,7:45,52.08,,0,52.08,52.08,1,-83636,78915,162551,-4721,0,0,5547,0,0,,5547,5547
46,11/13/2018,32,7:45,8:00,52.29,,0,52.29,52.29,1,-110324,83332,193656,-26992,0,0,2287,0,0,,2287,2287
46,11/13/2018,33,8:00,8:15,52.29,20.72,0,20.72,20.72,-1,-28048,91755,119803,63707,0,-20449,116,0,0,,20565,-20333
46,11/13/2018,34,8:15,8:30,,44.29,0,44.29,44.29,-1,-43238,57313,100551,14075,0,-14112,0,0,0,,14112,-14112
46,11/13/2018,35,8:30,8:45,48.29,52.01,0,50.15,50.15,2,-53011,54359,107370,1348,0,-1553,13,0,0,,1566,-1540
46,11/13/2018,36,8:45,9:00,52.29,,0,52.29,52.29,1,-67315,42818,110133,-24497,0,0,7222,0,0,,7222,7222
46,11/13/2018,37,9:00,9:15,54.85,,0,54.85,54.85,1,-76058,50091,126149,-25967,0,0,15058,0,0,,15058,15058
46,11/13/2018,38,9:15,9:30,48.29,,0,48.29,48.29,1,-69477,48152,117629,-21325,0,0,3305,0,0,,3305,3305
46,11/13/2018,39,9:30,9:45,51.62,52.07,0,51.62,50.18,2,-60155,58580,118735,-1575,0,-3,2350,0,0,,2353,2347
46,11/13/2018,40,9:45,10:00,51.62,48.65,0,48.65,48.65,-1,-54427,64747,119174,10320,0,-3546,2,0,0,,3548,-3544
46,11/13/2018,41,10:00,10:15,52.08,48.65,0,52.08,52.08,1,-63226,55397,118623,-7829,0,-253,1347,0,0,,1600,1094
46,11/13/2018,42,10:15,10:30,,,0,50.13,50.13,0,-42864,75659,118523,32795,0,0,0,0,0,,0,0
46,11/13/2018,43,10:30,10:45,,44.29,0,44.29,44.29,-1,-22725,98107,120832,75382,0,-2981,0,0,0,,2981,-2981
46,11/13/2018,44,10:45,11:00,,18.17,0,18.17,18.17,-1,-21138,115125,136263,93987,0,-32232,0,0,0,,32232,-32232
46,11/13/2018,45,11:00,11:15,,40.29,0,40.29,40.29,-1,-36076,45030,81106,8954,0,-13910,0,0,0,,13910,-13910
46,11/13/2018,46,11:15,11:30,,,0,47.01,47.01,0,-21832,85096,106928,63264,0,0,0,0,0,,0,0
46,11/13/2018,47,11:30,11:45,,,0,50.17,50.17,0,-19601,142649,162250,123048,0,0,0,0,0,,0,0
46,11/13/2018,48,11:45,12:00,,,0,50.18,50.18,0,-17763,146958,164721,129195,0,0,0,0,0,,0,0
46,11/13/2018,49,12:00,12:15,,-132.58,0,-132.58,-132.58,-1,-69836,87853,157689,18017,0,-9943,0,0,0,,9943,-9943
46,11/13/2018,50,12:15,12:30,,44.29,0,44.29,44.29,-1,-80681,83951,164632,3270,0,-1818,0,0,0,,1818,-1818
46,11/13/2018,51,12:30,12:45,,28.49,0,28.49,28.49,-1,-70202,113146,183348,42944,0,-18871,0,0,0,,18871,-18871
46,11/13/2018,52,12:45,13:00,,-18.35,0,-18.35,-18.35,-1,-90257,135135,225392,44878,0,-47769,0,0,0,,47769,-47769
46,11/13/2018,53,13:00,13:15,,14.57,0,14.57,14.57,-1,-67346,137715,205061,70369,0,-38700,0,0,0,,38700,-38700
46,11/13/2018,54,13:15,13:30,,40.29,0,40.29,40.29,-1,-67045,95012,162057,27967,0,-23982,0,0,0,,23982,-23982
46,11/13/2018,55,13:30,13:45,,45.49,0,45.49,45.49,-1,-62913,75564,138477,12651,0,-3039,0,0,0,,3039,-3039
46,11/13/2018,56,13:45,14:00,,44.29,0,44.29,44.29,-1,-65476,83431,148907,17955,0,-4581,0,0,0,,4581,-4581
46,11/13/2018,57,14:00,14:15,,51.97,0,51.97,51.97,-1,-51025,85396,136421,34371,0,-2186,0,0,0,,2186,-2186
46,11/13/2018,58,14:15,14:30,,,0,50.13,50.13,0,-47100,86145,133245,39045,0,0,0,0,0,,0,0
46,11/13/2018,59,14:30,14:45,51.24,,0,51.24,51.24,1,-52223,50265,102488,-1958,0,0,297,0,0,,297,297
46,11/13/2018,60,14:45,15:00,56.29,,0,56.29,56.29,1,-65342,28869,94211,-36473,0,0,16880,0,0,,16880,16880
46,11/13/2018,61,15:00,15:15,52.29,52.04,0,52.04,52.04,-1,-48597,75052,123649,26455,0,-990,9912,0,0,,10902,8922
46,11/13/2018,62,15:15,15:30,51.4,52.05,0,51.4,51.4,1,-57512,53280,110792,-4232,0,-967,189,0,0,,1156,-778
46,11/13/2018,63,15:30,15:45,86.02,,0,86.02,86.02,1,-84636,34945,119581,-49691,0,0,9874,0,0,,9874,9874
46,11/13/2018,64,15:45,16:00,121.29,,0,121.29,121.29,1,-95400,42291,137691,-53109,0,0,45268,0,0,,45268,45268
46,11/13/2018,65,16:00,16:15,121.29,33.37,0,33.37,33.37,-1,-48824,69680,118504,20856,0,-10589,9504,0,0,,20093,-1085
46,11/13/2018,66,16:15,16:30,,,0,50.18,50.18,0,-58575,48991,107566,-9584,0,-284,0,0,0,,284,-284
46,11/13/2018,67,16:30,16:45,51.77,,0,51.77,51.77,1,-75742,52021,127763,-23721,0,0,74,0,0,,74,74
46,11/13/2018,68,16:45,17:00,151.79,,0,151.79,151.79,1,-111141,53427,164568,-57714,0,0,30509,0,0,,30509,30509
46,11/13/2018,69,17:00,17:15,51.91,44.42,0,56.64,44.42,2,-49744,57181,106925,7437,0,-1966,15041,0,0,,17007,13075
46,11/13/2018,70,17:15,17:30,283.52,,0,283.52,283.52,1,-86565,25491,112056,-61074,0,0,33487,0,0,,33487,33487
46,11/13/2018,71,17:30,17:45,75.33,,0,75.33,75.33,1,-58612,36215,94827,-22397,0,0,37211,0,0,,37211,37211
46,11/13/2018,72,17:45,18:00,53.7,40.29,0,40.29,40.29,-1,-50583,73496,124079,22913,0,-4498,8264,0,0,,12762,3766
46,11/13/2018,73,18:00,18:15,59.08,46.74,0,59.08,59.08,1,-90428,20057,110485,-70371,0,-6239,872,0,0,,7111,-5367
46,11/13/2018,74,18:15,18:30,60.7,46.74,0,60.7,60.7,1,-51246,39310,90556,-11936,0,-14,4031,0,0,,4045,4017
46,11/13/2018,75,18:30,18:45,60.7,71.2,0,71.2,71.2,-1,-50419,55495,105914,5076,0,-525,343,0,0,,868,-182
46,11/13/2018,76,18:45,19:00,,71.2,0,71.2,71.2,-1,-55902,57384,113286,1482,0,-833,0,0,0,,833,-833
46,11/13/2018,77,19:00,19:15,128.64,,0,128.64,128.64,1,-101844,54014,155858,-47830,0,0,17067,0,0,,17067,17067
46,11/13/2018,78,19:15,19:30,59.93,,0,59.93,59.93,1,-84081,55014,139095,-29067,0,0,29760,0,0,,29760,29760
46,11/13/2018,79,19:30,19:45,52.29,,0,52.29,52.29,1,-73738,65731,139469,-8007,0,0,12435,0,0,,12435,12435
46,11/13/2018,80,19:45,20:00,48.29,51.43,0,48.29,40.59,2,-68867,60429,129296,-8438,0,-567,765,0,0,,1332,198
46,11/13/2018,81,20:00,20:15,48.29,,0,48.29,48.29,1,-74800,64906,139706,-9894,0,0,852,0,0,,852,852
46,11/13/2018,82,20:15,20:30,,,0,33.18,33.18,0,-62936,50412,113348,-12524,0,0,6,0,0,,6,6
46,11/13/2018,83,20:30,20:45,,44.29,0,44.29,44.29,-1,-59611,68238,127849,8627,0,-5100,0,0,0,,5100,-5100
46,11/13/2018,84,20:45,21:00,,44.29,0,44.29,44.29,-1,-77599,90164,167763,12565,0,-16426,0,0,0,,16426,-16426
46,11/13/2018,85,21:00,21:15,254.97,44.29,0,254.97,254.97,1,-91856,42244,134100,-49612,0,-6059,17545,0,0,,23604,11486
46,11/13/2018,86,21:15,21:30,254.97,21.29,0,21.29,21.29,-1,-54026,81031,135057,27005,0,-4695,25250,0,0,,29945,20555
46,11/13/2018,87,21:30,21:45,,19.31,0,19.31,19.31,-1,-56047,111214,167261,55167,0,-44060,0,0,0,,44060,-44060
46,11/13/2018,88,21:45,22:00,,19.31,0,19.31,19.31,-1,-41859,116879,158738,75020,0,-59157,0,0,0,,59157,-59157
46,11/13/2018,89,22:00,22:15,124.67,-22.42,0,124.67,-22.42,2,-98970,74868,173838,-24102,0,-42216,3121,0,0,,45337,-39095
46,11/13/2018,90,22:15,22:30,209.08,27.31,0,209.08,27.31,2,-67628,82608,150236,14980,0,-3286,22074,0,0,,25360,18788
46,11/13/2018,91,22:30,22:45,,15.76,0,15.76,15.76,-1,-49645,105774,155419,56129,0,-41809,0,0,0,,41809,-41809
46,11/13/2018,92,22:45,23:00,,18.5,0,18.5,18.5,-1,-48302,130593,178895,82291,0,-64250,0,0,0,,64250,-64250
46,11/13/2018,93,23:00,23:15,96.15,18.03,0,96.15,96.15,1,-91891,72311,164202,-19580,0,-38519,1807,0,0,,40326,-36712
46,11/13/2018,94,23:15,23:30,213.45,7.61,0,213.45,7.61,2,-69806,88084,157890,18278,0,-4336,20878,0,0,,25214,16542
46,11/13/2018,95,23:30,23:45,,-136.38,0,-136.38,-136.38,-1,-33004,107403,140407,74399,0,-61823,0,0,0,,61823,-61823
46,11/13/2018,96,23:45,0:00,,41.68,0,41.68,41.68,-1,-63891,99460,163351,35569,0,-31119,0,0,0,,31119,-31119
46,11/14/2018,1,0:00,0:15,,10.81,0,10.81,10.81,-1,-56257,106926,163183,50669,0,-36778,0,0,0,,36778,-36778
46,11/14/2018,2,0:15,0:30,,39.68,0,39.68,39.68,-1,-44576,77525,122101,32949,0,-29534,0,0,0,,29534,-29534
46,11/14/2018,3,0:30,0:45,,43.14,0,43.14,43.14,-1,-36555,57834,94389,21279,0,-24749,0,0,0,,24749,-24749
46,11/14/2018,4,0:45,1:00,,45.04,0,45.04,45.04,-1,-42078,63836,105914,21758,0,-18567,0,0,0,,18567,-18567
46,11/14/2018,5,1:00,1:15,58.76,45.04,0,58.76,58.76,1,-62977,33868,96845,-29109,0,-6893,11757,0,0,,18650,4864
46,11/14/2018,6,1:15,1:30,51.87,,0,51.87,51.87,1,-56114,39239,95353,-16875,0,0,12246,0,0,,12246,12246
46,11/14/2018,7,1:30,1:45,51.19,,0,51.19,51.19,1,-51008,32264,83272,-18744,0,0,14455,0,0,,14455,14455
46,11/14/2018,8,1:45,2:00,50.23,,0,50.23,50.23,1,-50841,33307,84148,-17534,0,0,7021,0,0,,7021,7021
46,11/14/2018,9,2:00,2:15,50.16,,0,50.16,50.16,1,-54066,38626,92692,-15440,0,0,12173,0,0,,12173,12173
46,11/14/2018,10,2:15,2:30,52.92,,0,52.92,52.92,1,-62989,33510,96499,-29479,0,0,20475,0,0,,20475,20475
46,11/14/2018,11,2:30,2:45,55.09,,0,55.09,55.09,1,-72838,34656,107494,-38182,0,0,27135,0,0,,27135,27135
46,11/14/2018,12,2:45,3:00,55.12,,0,55.12,55.12,1,-82353,41377,123730,-40976,0,0,31067,0,0,,31067,31067
46,11/14/2018,13,3:00,3:15,51.01,,0,51.01,51.01,1,-44932,37596,82528,-7336,0,0,12029,0,0,,12029,12029
46,11/14/2018,14,3:15,3:30,63.09,,0,63.09,63.09,1,-70237,24437,94674,-45800,0,0,22734,0,0,,22734,22734
46,11/14/2018,15,3:30,3:45,53.1,,0,53.1,53.1,1,-58693,31356,90049,-27337,0,0,28508,0,0,,28508,28508
46,11/14/2018,16,3:45,4:00,50.93,,0,50.93,50.93,1,-45166,32028,77194,-13138,0,0,12801,0,0,,12801,12801
46,11/14/2018,17,4:00,4:15,48.92,30.98,0,48.92,30.98,2,-39719,68620,108339,28901,0,-14914,2119,0,0,,17033,-12795
46,11/14/2018,18,4:15,4:30,,40.92,0,40.92,40.92,-1,-54714,59804,114518,5090,0,-15580,0,0,0,,15580,-15580
46,11/14/2018,19,4:30,4:45,,46.6,0,46.6,46.6,-1,-57612,55253,112865,-2359,0,-2605,0,0,0,,2605,-2605
46,11/14/2018,20,4:45,5:00,48.92,,0,48.92,48.92,1,-57261,52521,109782,-4740,0,0,23,0,0,,23,23
46,11/14/2018,21,5:00,5:15,57.73,47.9,0,57.73,45.39,2,-83516,48354,131870,-35162,0,-75,6418,0,0,,6493,6343
46,11/14/2018,22,5:15,5:30,57.73,44.92,0,44.92,44.92,-1,-64567,71218,135785,6651,0,-6147,42,0,0,,6189,-6105
46,11/14/2018,23,5:30,5:45,71.92,44.92,0,71.92,71.92,1,-93581,32468,126049,-61113,0,-612,5093,0,0,,5705,4481
46,11/14/2018,24,5:45,6:00,81.48,,0,81.48,81.48,1,-85983,59050,145033,-26933,0,0,21497,0,0,,21497,21497
46,11/14/2018,25,6:00,6:15,64.88,49.14,0,49.14,49.14,-1,-80647,73446,154093,-7201,0,-1141,10365,0,0,,11506,9224
46,11/14/2018,26,6:15,6:30,64.88,12.88,0,12.88,12.88,-1,-24683,58437,83120,33754,0,-25826,125,0,0,,25951,-25701
46,11/14/2018,27,6:30,6:45,236.32,54.43,0,236.32,236.32,1,-86197,23567,109764,-62630,0,-1798,12780,0,0,,14578,10982
46,11/14/2018,28,6:45,7:00,236.32,,0,236.32,236.32,1,-162330,29296,191626,-133034,0,0,57166,0,0,,57166,57166
46,11/14/2018,29,7:00,7:15,236.32,-22.53,0,-22.53,-22.53,-1,-76689,165105,241794,88416,0,-10121,17756,0,0,,27877,7635
46,11/14/2018,30,7:15,7:30,,68.71,0,68.71,68.71,-1,-45454,69492,114946,24038,0,-1729,0,0,0,,1729,-1729
46,11/14/2018,31,7:30,7:45,,,0,55.36,55.36,0,-90231,81600,171831,-8631,0,0,0,0,0,,0,0
46,11/14/2018,32,7:45,8:00,50.05,,0,50.05,50.05,1,-135910,91573,227483,-44337,0,0,895,0,0,,895,895
46,11/14/2018,33,8:00,8:15,48.12,-18.21,0,55.42,-18.21,2,-33972,119815,153787,85843,0,-25085,113,0,0,,25198,-24972
46,11/14/2018,34,8:15,8:30,,38.38,0,38.38,38.38,-1,-42275,97266,139541,54991,0,-26452,0,0,0,,26452,-26452
46,11/14/2018,35,8:30,8:45,,46.38,0,46.38,46.38,-1,-47050,72242,119292,25192,0,-17401,0,0,0,,17401,-17401
46,11/14/2018,36,8:45,9:00,,42.38,0,42.38,42.38,-1,-61794,73352,135146,11558,0,-18571,0,0,0,,18571,-18571
46,11/14/2018,37,9:00,9:15,229.54,42.38,0,229.54,229.54,1,-104563,74176,178739,-30387,0,-8294,13504,0,0,,21798,5210
46,11/14/2018,38,9:15,9:30,60.12,68.59,0,68.59,68.59,-1,-84102,112030,196132,27928,0,-7,15266,0,0,,15273,15259
46,11/14/2018,39,9:30,9:45,60.12,45.45,0,45.45,45.45,-1,-68322,122697,191019,54375,0,-2736,18,0,0,,2754,-2718
46,11/14/2018,40,9:45,10:00,,45.45,0,45.45,45.45,-1,-72308,106319,178627,34011,0,-9350,0,0,0,,9350,-9350
46,11/14/2018,41,10:00,10:15,,68.64,0,68.64,68.64,-1,-94117,104896,199013,10779,0,-2544,0,0,0,,2544,-2544
46,11/14/2018,42,10:15,10:30,,,0,55.38,55.38,0,-82869,134491,217360,51622,0,0,0,0,0,,0,0
46,11/14/2018,43,10:30,10:45,,,0,59.5,59.5,0,-65880,139088,204968,73208,0,0,0,0,0,,0,0
46,11/14/2018,44,10:45,11:00,,68.67,0,68.67,68.67,-1,-55103,145150,200253,90047,0,-2,0,0,0,,2,-2
46,11/14/2018,45,11:00,11:15,,46.38,0,46.38,46.38,-1,-90380,132722,223102,42342,0,-1893,0,0,0,,1893,-1893
46,11/14/2018,46,11:15,11:30,,68.78,0,68.78,68.78,-1,-91234,127994,219228,36760,0,-544,0,0,0,,544,-544
46,11/14/2018,47,11:30,11:45,,68.77,0,68.77,68.77,-1,-87979,132460,220439,44481,0,-66,0,0,0,,66,-66
46,11/14/2018,48,11:45,12:00,,68.77,0,68.77,68.77,-1,-96790,134682,231472,37892,0,-67,0,0,0,,67,-67
46,11/14/2018,49,12:00,12:15,,46.38,0,46.38,46.38,-1,-115065,124173,239238,9108,0,-3897,0,0,0,,3897,-3897
46,11/14/2018,50,12:15,12:30,,44.07,0,44.07,44.07,-1,-110541,127575,238116,17034,0,-10291,0,0,0,,10291,-10291
46,11/14/2018,51,12:30,12:45,,44.25,0,44.25,44.25,-1,-108072,129128,237200,21056,0,-14458,0,0,0,,14458,-14458
46,11/14/2018,52,12:45,13:00,,46.38,0,46.38,46.38,-1,-105121,109278,214399,4157,0,-11068,0,0,0,,11068,-11068
46,11/14/2018,53,13:00,13:15,,,0,55.56,55.56,0,-76212,87097,163309,10885,0,-268,0,0,0,,268,-268
46,11/14/2018,54,13:15,13:30,,68.98,0,68.98,68.98,-1,-71854,79544,151398,7690,0,-140,0,0,0,,140,-140
46,11/14/2018,55,13:30,13:45,50.38,,0,50.38,50.38,1,-72781,70314,143095,-2467,0,0,241,0,0,,241,241
46,11/14/2018,56,13:45,14:00,50.38,,0,50.38,50.38,1,-78127,69752,147879,-8375,0,0,1782,0,0,,1782,1782
46,11/14/2018,57,14:00,14:15,,,0,59.7,59.7,0,-71924,86184,158108,14260,0,0,62,0,0,,62,62
46,11/14/2018,58,14:15,14:30,63.49,,0,63.49,63.49,1,-104826,74304,179130,-30522,0,0,5698,0,0,,5698,5698
46,11/14/2018,59,14:30,14:45,94.89,,0,94.89,94.89,1,-128367,68298,196665,-60069,0,0,34430,0,0,,34430,34430
46,11/14/2018,60,14:45,15:00,55.71,68.9,0,68.9,68.9,-1,-91813,61333,153146,-30480,0,-11,23372,0,0,,23383,23361
46,11/14/2018,61,15:00,15:15,55.71,38.38,0,38.38,38.38,-1,-59624,104178,163802,44554,0,-11129,2028,0,0,,13157,-9101
46,11/14/2018,62,15:15,15:30,,68.95,0,68.95,68.95,-1,-60388,78805,139193,18417,0,-2352,0,0,0,,2352,-2352
46,11/14/2018,63,15:30,15:45,52.41,,0,52.41,52.41,1,-62348,57710,120058,-4638,0,0,254,0,0,,254,254
46,11/14/2018,64,15:45,16:00,61.05,,0,61.05,61.05,1,-71884,38509,110393,-33375,0,0,19458,0,0,,19458,19458
46,11/14/2018,65,16:00,16:15,50.38,39.9,0,59.7,39.9,2,-29475,103466,132941,73991,0,-5881,8375,0,0,,14256,2494
46,11/14/2018,66,16:15,16:30,,69.01,0,69.01,69.01,-1,-28047,92293,120340,64246,0,-390,0,0,0,,390,-390
46,11/14/2018,67,16:30,16:45,,,0,59.68,59.68,0,-29519,81313,110832,51794,0,0,0,0,0,,0,0
46,11/14/2018,68,16:45,17:00,53.47,,0,53.47,53.47,1,-46459,38436,84895,-8023,0,0,390,0,0,,390,390
46,11/14/2018,69,17:00,17:15,,6.28,0,6.28,6.28,-1,-47012,105524,152536,58512,0,-16914,0,0,0,,16914,-16914
46,11/14/2018,70,17:15,17:30,63.47,68.86,0,63.47,59.62,2,-87404,50976,138380,-36428,0,-2454,11789,0,0,,14243,9335
46,11/14/2018,71,17:30,17:45,55.71,,0,55.71,55.71,1,-76202,60152,136354,-16050,0,0,10051,0,0,,10051,10051
46,11/14/2018,72,17:45,18:00,50.38,,0,50.38,50.38,1,-58254,73767,132021,15513,0,0,1081,0,0,,1081,1081
46,11/14/2018,73,18:00,18:15,53.97,,0,53.97,53.97,1,-101805,55151,156956,-46654,0,0,2987,0,0,,2987,2987
46,11/14/2018,74,18:15,18:30,,,0,59.62,59.62,0,-67649,75542,143191,7893,0,0,0,0,0,,0,0
46,11/14/2018,75,18:30,18:45,,51.4,0,51.4,51.4,-1,-46338,94695,141033,48357,0,-1244,0,0,0,,1244,-1244
46,11/14/2018,76,18:45,19:00,,50.71,0,50.71,50.71,-1,-40302,113094,153396,72792,0,-3132,0,0,0,,3132,-3132
46,11/14/2018,77,19:00,19:15,54.04,50.71,0,54.04,54.04,1,-90038,64512,154550,-25526,0,-314,2545,0,0,,2859,2231
46,11/14/2018,78,19:15,19:30,51.02,,0,51.02,51.02,1,-78483,68654,147137,-9829,0,0,2754,0,0,,2754,2754
46,11/14/2018,79,19:30,19:45,,42.38,0,42.38,42.38,-1,-59054,83487,142541,24433,0,-5732,0,0,0,,5732,-5732
46,11/14/2018,80,19:45,20:00,,42.38,0,42.38,42.38,-1,-51944,85569,137513,33625,0,-27879,0,0,0,,27879,-27879
46,11/14/2018,81,20:00,20:15,50.38,45.45,0,50.38,50.38,1,-65522,67401,132923,1879,0,-13268,103,0,0,,13371,-13165
46,11/14/2018,82,20:15,20:30,50.38,42.38,0,42.38,42.38,-1,-46906,81667,128573,34761,0,-2004,15,0,0,,2019,-1989
46,11/14/2018,83,20:30,20:45,,38.38,0,38.38,38.38,-1,-34582,102345,136927,67763,0,-12450,0,0,0,,12450,-12450
46,11/14/2018,84,20:45,21:00,,5.92,0,5.92,5.92,-1,-34978,112472,147450,77494,0,-51753,0,0,0,,51753,-51753
46,11/14/2018,85,21:00,21:15,56.37,-127.14,0,59.28,-127.14,2,-76275,107897,184172,31622,0,-60776,603,0,0,,61379,-60173
46,11/14/2018,86,21:15,21:30,61.05,38.38,0,61.05,38.38,2,-57335,70015,127350,12680,0,-8068,2307,0,0,,10375,-5761
46,11/14/2018,87,21:30,21:45,,38.38,0,38.38,38.38,-1,-50298,77449,127747,27151,0,-20397,0,0,0,,20397,-20397
46,11/14/2018,88,21:45,22:00,,38.38,0,38.38,38.38,-1,-46497,88244,134741,41747,0,-31835,0,0,0,,31835,-31835
46,11/14/2018,89,22:00,22:15,54.38,33.71,0,54.38,33.71,2,-72735,70973,143708,-1762,0,-30446,219,0,0,,30665,-30227
46,11/14/2018,90,22:15,22:30,54.38,42.38,0,54.38,42.38,2,-54412,66285,120697,11873,0,-3995,614,0,0,,4609,-3381
46,11/14/2018,91,22:30,22:45,,32.43,0,32.43,32.43,-1,-51535,88001,139536,36466,0,-25315,0,0,0,,25315,-25315
46,11/14/2018,92,22:45,23:00,,46.38,0,46.38,46.38,-1,-73090,88844,161934,15754,0,-20450,0,0,0,,20450,-20450
46,11/14/2018,93,23:00,23:15,,42.04,0,42.04,42.04,-1,-89533,117947,207480,28414,0,-14620,0,0,0,,14620,-14620
46,11/14/2018,94,23:15,23:30,50.38,48.72,0,50.38,45.42,2,-85535,84379,169914,-1156,0,-1056,1084,0,0,,2140,28
46,11/14/2018,95,23:30,23:45,,35.83,0,35.83,35.83,-1,-60943,106520,167463,45577,0,-22978,0,0,0,,22978,-22978
46,11/14/2018,96,23:45,0:00,,40.94,0,40.94,40.94,-1,-78639,121030,199669,42391,0,-29464,0,0,0,,29464,-29464
46,11/15/2018,1,0:00,0:15,58.96,15.03,0,58.96,15.03,2,-64027,62590,126617,-1437,0,-22421,1524,0,0,,23945,-20897
46,11/15/2018,2,0:15,0:30,63.41,45.28,0,63.41,45.28,2,-58031,60352,118383,2321,0,-984,3156,0,0,,4140,2172
46,11/15/2018,3,0:30,0:45,,41.28,0,41.28,41.28,-1,-40967,43114,84081,2147,0,-5813,0,0,0,,5813,-5813
46,11/15/2018,4,0:45,1:00,,45.28,0,45.28,45.28,-1,-51316,49550,100866,-1766,0,-1483,0,0,0,,1483,-1483
46,11/15/2018,5,1:00,1:15,76.74,45.28,0,76.74,44.8,2,-59585,23794,83379,-35791,0,-3738,7841,0,0,,11579,4103
46,11/15/2018,6,1:15,1:30,72.28,,0,72.28,72.28,1,-90899,42357,133256,-48542,0,0,35982,0,0,,35982,35982
46,11/15/2018,7,1:30,1:45,72.28,50.65,0,50.65,50.65,-1,-56476,47448,103924,-9028,0,-329,2711,0,0,,3040,2382
46,11/15/2018,8,1:45,2:00,50.3,,0,50.3,50.3,1,-57455,41537,98992,-15918,0,0,2380,0,0,,2380,2380
46,11/15/2018,9,2:00,2:15,51.93,,0,51.93,51.93,1,-51799,35548,87347,-16251,0,0,2155,0,0,,2155,2155
46,11/15/2018,10,2:15,2:30,50.31,,0,50.31,50.31,1,-48828,36772,85600,-12056,0,0,1647,0,0,,1647,1647
46,11/15/2018,11,2:30,2:45,49.28,47.23,0,49.28,45.58,2,-41664,39363,81027,-2301,0,-138,1341,0,0,,1479,1203
46,11/15/2018,12,2:45,3:00,49.28,39.15,0,39.15,39.15,-1,-29745,48306,78051,18561,0,-15933,11,0,0,,15944,-15922
46,11/15/2018,13,3:00,3:15,50.3,41.28,0,50.3,50.3,1,-39031,45679,84710,6648,0,-7844,475,0,0,,8319,-7369
46,11/15/2018,14,3:15,3:30,39.02,,0,39.02,39.02,1,-33619,32786,66405,-833,0,0,352,0,0,,352,352
46,11/15/2018,15,3:30,3:45,,,0,45.53,45.53,0,-41304,37172,78476,-4132,0,0,0,0,0,,0,0
46,11/15/2018,16,3:45,4:00,,52.03,0,52.03,52.03,-1,-42503,37936,80439,-4567,0,-620,0,0,0,,620,-620
46,11/15/2018,17,4:00,4:15,,45.28,0,45.28,45.28,-1,-34117,45861,79978,11744,0,-8057,0,0,0,,8057,-8057
46,11/15/2018,18,4:15,4:30,,47.18,0,47.18,47.18,-1,-40550,46702,87252,6152,0,-6335,0,0,0,,6335,-6335
46,11/15/2018,19,4:30,4:45,,52.08,0,52.08,52.08,-1,-39510,39823,79333,313,0,-438,0,0,0,,438,-438
46,11/15/2018,20,4:45,5:00,,,0,45.52,45.52,0,-41792,37558,79350,-4234,0,0,0,0,0,,0,0
46,11/15/2018,21,5:00,5:15,,41.28,0,41.28,41.28,-1,-48933,61585,110518,12652,0,-8582,0,0,0,,8582,-8582
46,11/15/2018,22,5:15,5:30,,43.33,0,43.33,43.33,-1,-34620,66592,101212,31972,0,-21844,0,0,0,,21844,-21844
46,11/15/2018,23,5:30,5:45,,45.28,0,45.28,45.28,-1,-44896,42235,87131,-2661,0,-4959,0,0,0,,4959,-4959
46,11/15/2018,24,5:45,6:00,,,0,44.61,44.61,0,-22871,113025,135896,90154,0,0,0,0,0,,0,0
46,11/15/2018,25,6:00,6:15,,-2.98,0,-2.98,-2.98,-1,-71784,152943,224727,81159,0,-35087,0,0,0,,35087,-35087
46,11/15/2018,26,6:15,6:30,,32.27,0,32.27,32.27,-1,-28259,107178,135437,78919,0,-44151,0,0,0,,44151,-44151
46,11/15/2018,27,6:30,6:45,,46.29,0,46.29,46.29,-1,-37053,90017,127070,52964,0,-10267,0,0,0,,10267,-10267
46,11/15/2018,28,6:45,7:00,52.84,,0,52.84,52.84,1,-81933,63178,145111,-18755,0,0,1826,0,0,,1826,1826
46,11/15/2018,29,7:00,7:15,52.84,-78.6,0,-78.6,-78.6,-1,-98921,136321,235242,37400,0,-29509,69,0,0,,29578,-29440
46,11/15/2018,30,7:15,7:30,126.9,-78.6,0,126.9,126.9,1,-126020,68349,194369,-57671,0,-22,14448,0,0,,14470,14426
46,11/15/2018,31,7:30,7:45,261.19,,0,261.19,261.19,1,-151650,60950,212600,-90700,0,0,51605,0,0,,51605,51605
46,11/15/2018,32,7:45,8:00,61.59,,0,61.59,61.59,1,-129795,64190,193985,-65605,0,0,42642,0,0,,42642,42642
46,11/15/2018,33,8:00,8:15,61.59,44.31,0,44.31,44.31,-1,-35460,113393,148853,77933,0,-3306,7175,0,0,,10481,3869
46,11/15/2018,34,8:15,8:30,,66.13,0,66.13,66.13,-1,-37033,78071,115104,41038,0,-14,0,0,0,,14,-14
46,11/15/2018,35,8:30,8:45,,,0,58.21,58.21,0,-49155,57908,107063,8753,0,0,0,0,0,,0,0
46,11/15/2018,36,8:45,9:00,59.44,,0,59.44,59.44,1,-75652,37976,113628,-37676,0,0,10850,0,0,,10850,10850
46,11/15/2018,37,9:00,9:15,52.75,,0,52.75,52.75,1,-36020,80467,116487,44447,0,0,5170,0,0,,5170,5170
46,11/15/2018,38,9:15,9:30,,,0,52.55,52.55,0,-35919,60337,96256,24418,0,0,0,0,0,,0,0
46,11/15/2018,39,9:30,9:45,,,0,52.57,52.57,0,-29761,71074,100835,41313,0,0,0,0,0,,0,0
46,11/15/2018,40,9:45,10:00,,38.29,0,38.29,38.29,-1,-22941,76528,99469,53587,0,-2379,0,0,0,,2379,-2379
46,11/15/2018,41,10:00,10:15,81.75,38.29,0,81.75,81.75,1,-83262,25665,108927,-57597,0,-3532,7733,0,0,,11265,4201
46,11/15/2018,42,10:15,10:30,89.11,,0,89.11,89.11,1,-60430,34233,94663,-26197,0,0,19313,0,0,,19313,19313
46,11/15/2018,43,10:30,10:45,50.29,,0,50.29,50.29,1,-59923,51156,111079,-8767,0,0,492,0,0,,492,492
46,11/15/2018,44,10:45,11:00,54.2,,0,54.2,54.2,1,-57359,67096,124455,9737,0,0,836,0,0,,836,836
46,11/15/2018,45,11:00,11:15,146.25,,0,146.25,146.25,1,-106733,35472,142205,-71261,0,0,27766,0,0,,27766,27766
46,11/15/2018,46,11:15,11:30,58.29,,0,58.29,58.29,1,-97554,61128,158682,-36426,0,0,32228,0,0,,32228,32228
46,11/15/2018,47,11:30,11:45,54.29,,0,54.29,54.29,1,-94424,77345,171769,-17079,0,0,21349,0,0,,21349,21349
46,11/15/2018,48,11:45,12:00,58.29,,0,58.29,58.29,1,-99668,66088,165756,-33580,0,0,15160,0,0,,15160,15160
46,11/15/2018,49,12:00,12:15,54.51,,0,54.51,54.51,1,-104710,53018,157728,-51692,0,0,19539,0,0,,19539,19539
46,11/15/2018,50,12:15,12:30,50.29,,0,50.29,50.29,1,-93442,59375,152817,-34067,0,0,7068,0,0,,7068,7068
46,11/15/2018,51,12:30,12:45,52.36,66.43,0,58.36,58.36,2,-81276,75608,156884,-5668,0,-6,453,0,0,,459,447
46,11/15/2018,52,12:45,13:00,50.29,,0,50.29,50.29,1,-77284,78159,155443,875,0,0,1119,0,0,,1119,1119
46,11/15/2018,53,13:00,13:15,50.29,,0,50.29,50.29,1,-51766,77158,128924,25392,0,0,110,0,0,,110,110
46,11/15/2018,54,13:15,13:30,54.29,,0,54.29,54.29,1,-66143,58295,124438,-7848,0,0,9456,0,0,,9456,9456
46,11/15/2018,55,13:30,13:45,54.58,,0,54.58,54.58,1,-69559,55628,125187,-13931,0,0,21006,0,0,,21006,21006
46,11/15/2018,56,13:45,14:00,54.29,,0,54.29,54.29,1,-73156,44546,117702,-28610,0,0,25699,0,0,,25699,25699
46,11/15/2018,57,14:00,14:15,50.29,47.65,0,53.83,47.65,2,-53713,55664,109377,1951,0,-1804,9509,0,0,,11313,7705
46,11/15/2018,58,14:15,14:30,52.41,,0,52.41,52.41,1,-67549,39826,107375,-27723,0,0,575,0,0,,575,575
46,11/15/2018,59,14:30,14:45,84.73,,0,84.73,84.73,1,-79163,27186,106349,-51977,0,0,15506,0,0,,15506,15506
46,11/15/2018,60,14:45,15:00,52.36,,0,52.36,52.36,1,-87809,15106,102915,-72703,0,0,3999,0,0,,3999,3999
46,11/15/2018,61,15:00,15:15,58.29,,0,58.29,58.29,1,-80887,48691,129578,-32196,0,0,7390,0,0,,7390,7390
46,11/15/2018,62,15:15,15:30,79.14,,0,79.14,79.14,1,-92246,24495,116741,-67751,0,0,34908,0,0,,34908,34908
46,11/15/2018,63,15:30,15:45,260.99,,0,260.99,260.99,1,-101500,11075,112575,-90425,0,0,64127,0,0,,64127,64127
46,11/15/2018,64,15:45,16:00,130.98,,0,130.98,130.98,1,-94046,33131,127177,-60915,0,0,60347,0,0,,60347,60347
46,11/15/2018,65,16:00,16:15,130.98,-0.45,0,-0.45,-0.45,-1,-46343,101014,147357,54671,0,-13892,15046,0,0,,28938,1154
46,11/15/2018,66,16:15,16:30,50.29,42.29,0,50.29,50.29,1,-53470,39615,93085,-13855,0,-7472,478,0,0,,7950,-6994
46,11/15/2018,67,16:30,16:45,50.29,,0,50.29,50.29,1,-42715,48583,91298,5868,0,0,317,0,0,,317,317
46,11/15/2018,68,16:45,17:00,58.29,,0,58.29,58.29,1,-71960,38000,109960,-33960,0,0,3638,0,0,,3638,3638
46,11/15/2018,69,17:00,17:15,58.29,-86.61,0,-86.61,-86.61,-1,-43798,140121,183919,96323,0,-16430,211,0,0,,16641,-16219
46,11/15/2018,70,17:15,17:30,,,0,59.47,59.47,0,-33443,74541,107984,41098,0,-195,0,0,0,,195,-195
46,11/15/2018,71,17:30,17:45,,,0,53.84,53.84,0,-24203,86433,110636,62230,0,0,0,0,0,,0,0
46,11/15/2018,72,17:45,18:00,,,0,53.85,53.85,0,-19107,122910,142017,103803,0,0,0,0,0,,0,0
46,11/15/2018,73,18:00,18:15,277.02,,0,277.02,277.02,1,-116262,25501,141763,-90761,0,0,26448,0,0,,26448,26448
46,11/15/2018,74,18:15,18:30,54.02,,0,54.02,54.02,1,-43739,48989,92728,5250,0,0,7818,0,0,,7818,7818
46,11/15/2018,75,18:30,18:45,,68.71,0,68.71,68.71,-1,-32882,61501,94383,28619,0,-56,0,0,0,,56,-56
46,11/15/2018,76,18:45,19:00,,,0,60,60,0,-36684,60480,97164,23796,0,0,0,0,0,,0,0
46,11/15/2018,77,19:00,19:15,62.76,68.58,0,62.76,59.44,2,-74228,48998,123226,-25230,0,-2,10007,0,0,,10009,10005
46,11/15/2018,78,19:15,19:30,50.74,,0,50.74,50.74,1,-60190,64528,124718,4338,0,0,2530,0,0,,2530,2530
46,11/15/2018,79,19:30,19:45,,52.63,0,52.63,52.63,-1,-64196,73800,137996,9604,0,-149,0,0,0,,149,-149
46,11/15/2018,80,19:45,20:00,,48.77,0,48.77,48.77,-1,-62269,72726,134995,10457,0,-4215,0,0,0,,4215,-4215
46,11/15/2018,81,20:00,20:15,59.8,48.77,0,59.8,59.8,1,-60976,33657,94633,-27319,0,-13,7270,0,0,,7283,7257
46,11/15/2018,82,20:15,20:30,50.29,,0,50.29,50.29,1,-41410,53628,95038,12218,0,0,2048,0,0,,2048,2048
46,11/15/2018,83,20:30,20:45,,42.29,0,42.29,42.29,-1,-36501,59341,95842,22840,0,-2304,0,0,0,,2304,-2304
46,11/15/2018,84,20:45,21:00,,36.82,0,36.82,36.82,-1,-41140,75473,116613,34333,0,-17688,0,0,0,,17688,-17688
46,11/15/2018,85,21:00,21:15,62.77,39.14,0,62.77,39.14,2,-60889,54173,115062,-6716,0,-12200,4195,0,0,,16395,-8005
46,11/15/2018,86,21:15,21:30,53.82,51.24,0,58.08,51.24,2,-39682,37755,77437,-1927,0,-2098,3381,0,0,,5479,1283
46,11/15/2018,87,21:30,21:45,50.29,42.29,0,58.13,42.29,2,-36418,55914,92332,19496,0,-3505,5,0,0,,3510,-3500
46,11/15/2018,88,21:45,22:00,,5.19,0,5.19,5.19,-1,-27707,99844,127551,72137,0,-52616,0,0,0,,52616,-52616
46,11/15/2018,89,22:00,22:15,83.77,10.88,0,83.77,83.77,1,-52355,50852,103207,-1503,0,-45352,1186,0,0,,46538,-44166
46,11/15/2018,90,22:15,22:30,99.33,46.29,0,99.33,46.29,2,-37546,40984,78530,3438,0,-2006,3770,0,0,,5776,1764
46,11/15/2018,91,22:30,22:45,,42.29,0,42.29,42.29,-1,-38471,60976,99447,22505,0,-16245,0,0,0,,16245,-16245
46,11/15/2018,92,22:45,23:00,,44.84,0,44.84,44.84,-1,-57199,71356,128555,14157,0,-16096,0,0,0,,16096,-16096
46,11/15/2018,93,23:00,23:15,86.41,42.29,0,86.41,42.29,2,-54927,41267,96194,-13660,0,-13308,3856,0,0,,17164,-9452
46,11/15/2018,94,23:15,23:30,206.52,48.35,0,206.52,48.35,2,-42687,31999,74686,-10688,0,-818,17456,0,0,,18274,16638
46,11/15/2018,95,23:30,23:45,206.52,36.52,0,36.52,36.52,-1,-32516,63288,95804,30772,0,-16538,28,0,0,,16566,-16510
46,11/15/2018,96,23:45,0:00,,14.85,0,14.85,14.85,-1,-32611,95348,127959,62737,0,-60153,0,0,0,,60153,-60153
46,11/16/2018,1,0:00,0:15,350.98,14.85,0,350.98,350.98,1,-104738,24573,129311,-80165,0,-22516,13235,0,0,,35751,-9281
46,11/16/2018,2,0:15,0:30,350.98,37.56,0,350.98,31.43,2,-46424,36066,82490,-10358,0,-1293,39261,0,0,,40554,37968
46,11/16/2018,3,0:30,0:45,350.98,13.58,0,13.58,13.58,-1,-29797,51324,81121,21527,0,-28130,385,0,0,,28515,-27745
46,11/16/2018,4,0:45,1:00,50.43,53.01,0,50.43,45.5,2,-50717,34951,85668,-15766,0,-2412,1433,0,0,,3845,-979
46,11/16/2018,5,1:00,1:15,108.17,48.53,0,108.17,43.26,2,-70563,24987,95550,-45576,0,-333,13697,0,0,,14030,13364
46,11/16/2018,6,1:15,1:30,189.74,38.6,0,189.74,38.6,2,-58945,41764,100709,-17181,0,-684,41885,0,0,,42569,41201
46,11/16/2018,7,1:30,1:45,50.34,-9.47,0,50.34,-9.47,2,-24894,37898,62792,13004,0,-14372,530,0,0,,14902,-13842
46,11/16/2018,8,1:45,2:00,50.36,44.71,0,44.71,44.71,-1,-30611,33814,64425,3203,0,-2829,467,0,0,,3296,-2362
46,11/16/2018,9,2:00,2:15,51.56,46.55,0,51.56,43.25,2,-32026,25172,57198,-6854,0,-1728,2659,0,0,,4387,931
46,11/16/2018,10,2:15,2:30,49.91,47.27,0,47.27,47.27,-1,-29122,28416,57538,-706,0,-271,977,0,0,,1248,706
46,11/16/2018,11,2:30,2:45,,46.86,0,46.86,46.86,-1,-27157,33277,60434,6120,0,-6642,0,0,0,,6642,-6642
46,11/16/2018,12,2:45,3:00,,39.27,0,39.27,39.27,-1,-22194,40899,63093,18705,0,-14717,0,0,0,,14717,-14717
46,11/16/2018,13,3:00,3:15,,39.27,0,39.27,39.27,-1,-23175,46563,69738,23388,0,-25576,0,0,0,,25576,-25576
46,11/16/2018,14,3:15,3:30,,43.54,0,43.54,43.54,-1,-24053,45214,69267,21161,0,-19679,0,0,0,,19679,-19679
46,11/16/2018,15,3:30,3:45,,43.52,0,43.52,43.52,-1,-26012,39250,65262,13238,0,-20715,0,0,0,,20715,-20715
46,11/16/2018,16,3:45,4:00,,46.84,0,46.84,46.84,-1,-31665,35878,67543,4213,0,-9298,0,0,0,,9298,-9298
46,11/16/2018,17,4:00,4:15,,47.27,0,47.27,47.27,-1,-24431,32074,56505,7643,0,-7065,0,0,0,,7065,-7065
46,11/16/2018,18,4:15,4:30,49.91,47.24,0,49.91,49.91,1,-29986,22410,52396,-7576,0,-1074,96,0,0,,1170,-978
46,11/16/2018,19,4:30,4:45,51.93,,0,51.93,51.93,1,-41730,23694,65424,-18036,0,0,8824,0,0,,8824,8824
46,11/16/2018,20,4:45,5:00,61,,0,61,61,1,-65248,25540,90788,-39708,0,0,26500,0,0,,26500,26500
46,11/16/2018,21,5:00,5:15,51.27,35.81,0,51.27,35.81,2,-39195,65371,104566,26176,0,-10794,8266,0,0,,19060,-2528
46,11/16/2018,22,5:15,5:30,50.43,47.27,0,50.43,50.43,1,-49011,47156,96167,-1855,0,-4485,244,0,0,,4729,-4241
46,11/16/2018,23,5:30,5:45,67.94,,0,67.94,67.94,1,-76007,38834,114841,-37173,0,0,11785,0,0,,11785,11785
46,11/16/2018,24,5:45,6:00,76.11,33.55,0,33.55,33.55,-1,-65516,88108,153624,22592,0,-2892,12405,0,0,,15297,9513
46,11/16/2018,25,6:00,6:15,54.8,13.1,0,54.8,13.1,2,-81995,100881,182876,18886,0,-6939,362,0,0,,7301,-6577
46,11/16/2018,26,6:15,6:30,,-37.56,0,-37.56,-37.56,-1,-28147,64328,92475,36181,0,-43014,0,0,0,,43014,-43014
46,11/16/2018,27,6:30,6:45,58.06,-37.56,0,58.06,58.06,1,-64938,40814,105752,-24124,0,-1455,9877,0,0,,11332,8422
46,11/16/2018,28,6:45,7:00,250.64,,0,250.64,250.64,1,-130764,45283,176047,-85481,0,0,47047,0,0,,47047,47047
46,11/16/2018,29,7:00,7:15,250.64,-66.88,0,-66.88,-66.88,-1,-50295,170752,221047,120457,0,-28645,13975,0,0,,42620,-14670
46,11/16/2018,30,7:15,7:30,,32.27,0,32.27,32.27,-1,-26601,61024,87625,34423,0,-40110,0,0,0,,40110,-40110
46,11/16/2018,31,7:30,7:45,112.98,49.78,0,112.98,112.98,1,-71483,32118,103601,-39365,0,-7730,13568,0,0,,21298,5838
46,11/16/2018,32,7:45,8:00,450,,0,450,450,1,-115048,66256,181304,-48792,0,0,48227,0,0,,48227,48227
46,11/16/2018,33,8:00,8:15,450,32.27,0,32.27,32.27,-1,-54934,108709,163643,53775,0,-3529,4236,0,0,,7765,707
46,11/16/2018,34,8:15,8:30,60.83,,0,60.83,60.83,1,-67140,46638,113778,-20502,0,0,3456,0,0,,3456,3456
46,11/16/2018,35,8:30,8:45,68.33,,0,68.33,68.33,1,-85457,60623,146080,-24834,0,0,17522,0,0,,17522,17522
46,11/16/2018,36,8:45,9:00,80.62,,0,80.62,80.62,1,-100482,58738,159220,-41744,0,0,13993,0,0,,13993,13993
46,11/16/2018,37,9:00,9:15,111.98,,0,111.98,111.98,1,-112618,55501,168119,-57117,0,0,36985,0,0,,36985,36985
46,11/16/2018,38,9:15,9:30,111.98,,0,111.98,111.98,1,-121136,55237,176373,-65899,0,0,53733,0,0,,53733,53733
46,11/16/2018,39,9:30,9:45,95.33,,0,95.33,95.33,1,-113748,53203,166951,-60545,0,0,49656,0,0,,49656,49656
46,11/16/2018,40,9:45,10:00,145.98,,0,145.98,145.98,1,-111781,43522,155303,-68259,0,0,51861,0,0,,51861,51861
46,11/16/2018,41,10:00,10:15,105.25,,0,105.25,105.25,1,-137499,67426,204925,-70073,0,0,62154,0,0,,62154,62154
46,11/16/2018,42,10:15,10:30,176.27,,0,176.27,176.27,1,-125283,76443,201726,-48840,0,0,52158,1250,0,,53408,53408
46,11/16/2018,43,10:30,10:45,76.27,,0,76.27,76.27,1,-117568,83739,201307,-33829,0,0,14730,0,0,,14730,14730
46,11/16/2018,44,10:45,11:00,122.98,,0,122.98,122.98,1,-118352,74988,193340,-43364,0,0,40425,0,0,,40425,40425
46,11/16/2018,45,11:00,11:15,256.92,,0,256.92,256.92,1,-162838,57568,220406,-105270,0,0,72163,0,0,,72163,72163
46,11/16/2018,46,11:15,11:30,99.56,,0,99.56,99.56,1,-138955,74089,213044,-64866,0,0,62093,0,0,,62093,62093
46,11/16/2018,47,11:30,11:45,96.73,,0,96.73,96.73,1,-139968,73481,213449,-66487,0,0,59498,0,0,,59498,59498
46,11/16/2018,48,11:45,12:00,78.98,,0,78.98,78.98,1,-136972,74832,211804,-62140,0,0,61259,0,0,,61259,61259
46,11/16/2018,49,12:00,12:15,124.98,,0,124.98,124.98,1,-162913,88514,251427,-74399,0,0,63595,0,0,,63595,63595
46,11/16/2018,50,12:15,12:30,217.76,51.7,0,51.7,51.7,-1,-120916,102115,223031,-18801,0,-334,35255,2500,0,,38089,37421
46,11/16/2018,51,12:30,12:45,65.14,39.34,0,65.14,39.34,2,-101760,86701,188461,-15059,0,-7308,5604,0,0,,12912,-1704
46,11/16/2018,52,12:45,13:00,64.92,,0,64.92,64.92,1,-108639,70407,179046,-38232,0,0,19159,0,0,,19159,19159
46,11/16/2018,53,13:00,13:15,260.55,,0,260.55,260.55,1,-128195,40741,168936,-87454,0,0,65681,0,0,,65681,65681
46,11/16/2018,54,13:15,13:30,80.82,,0,80.82,80.82,1,-116053,56504,172557,-59549,0,0,57180,0,0,,57180,57180
46,11/16/2018,55,13:30,13:45,87.8,,0,87.8,87.8,1,-111857,49781,161638,-62076,0,0,56444,0,0,,56444,56444
46,11/16/2018,56,13:45,14:00,77.57,,0,77.57,77.57,1,-125478,50048,175526,-75430,0,0,47927,0,0,,47927,47927
46,11/16/2018,57,14:00,14:15,56.95,46.77,0,59.62,46.77,2,-82689,45788,128477,-36901,0,-1897,7488,0,0,,9385,5591
46,11/16/2018,58,14:15,14:30,84.71,,0,84.71,84.71,1,-102491,42073,144564,-60418,0,0,34464,0,0,,34464,34464
46,11/16/2018,59,14:30,14:45,87.18,,0,87.18,87.18,1,-108679,44811,153490,-63868,0,0,49938,0,0,,49938,49938
46,11/16/2018,60,14:45,15:00,131.62,,0,131.62,131.62,1,-116143,44657,160800,-71486,0,0,65337,0,0,,65337,65337
46,11/16/2018,61,15:00,15:15,59,,0,59,59,1,-86191,62518,148709,-23673,0,0,25362,0,0,,25362,25362
46,11/16/2018,62,15:15,15:30,63.61,,0,63.61,63.61,1,-101864,57294,159158,-44570,0,0,25619,0,0,,25619,25619
46,11/16/2018,63,15:30,15:45,74.34,,0,74.34,74.34,1,-101244,56918,158162,-44326,0,0,36717,0,0,,36717,36717
46,11/16/2018,64,15:45,16:00,89.12,,0,89.12,89.12,1,-121138,56670,177808,-64468,0,0,50153,0,0,,50153,50153
46,11/16/2018,65,16:00,16:15,89.12,39.34,0,39.34,39.34,-1,-74266,95091,169357,20825,0,-6685,17223,0,0,,23908,10538
46,11/16/2018,66,16:15,16:30,51.21,51.73,0,59.34,51.73,2,-72847,67185,140032,-5662,0,-2762,453,0,0,,3215,-2309
46,11/16/2018,67,16:30,16:45,53.97,,0,53.97,53.97,1,-76358,63545,139903,-12813,0,0,2452,0,0,,2452,2452
46,11/16/2018,68,16:45,17:00,54.54,,0,54.54,54.54,1,-92074,71539,163613,-20535,0,0,10047,0,0,,10047,10047
46,11/16/2018,69,17:00,17:15,57.23,48.78,0,60.44,48.78,2,-84727,77250,161977,-7477,0,-1930,2179,0,0,,4109,249
46,11/16/2018,70,17:15,17:30,77.23,,0,77.23,77.23,1,-101019,66803,167822,-34216,0,0,21100,0,0,,21100,21100
46,11/16/2018,71,17:30,17:45,56.37,49.08,0,49.08,49.08,-1,-76556,77715,154271,1159,0,-515,6675,0,0,,7190,6160
46,11/16/2018,72,17:45,18:00,56.37,39.34,0,39.34,39.34,-1,-52426,83395,135821,30969,0,-11617,13,0,0,,11630,-11604
46,11/16/2018,73,18:00,18:15,225.77,28.07,0,225.77,28.07,2,-117395,15121,132516,-102274,0,-13969,9626,0,0,,23595,-4343
46,11/16/2018,74,18:15,18:30,61.04,66.51,0,66.51,66.51,-1,-80185,72819,153004,-7366,0,-411,13725,0,0,,14136,13314
46,11/16/2018,75,18:30,18:45,,43.34,0,43.34,43.34,-1,-56906,79293,136199,22387,0,-13977,0,0,0,,13977,-13977
46,11/16/2018,76,18:45,19:00,,45.53,0,45.53,45.53,-1,-45482,80052,125534,34570,0,-22838,0,0,0,,22838,-22838
46,11/16/2018,77,19:00,19:15,168.97,45.53,0,168.97,168.97,1,-101816,37264,139080,-64552,0,-7666,17566,0,0,,25232,9900
46,11/16/2018,78,19:15,19:30,51.21,,0,51.21,51.21,1,-63080,50110,113190,-12970,0,0,2417,0,0,,2417,2417
46,11/16/2018,79,19:30,19:45,51.21,45.53,0,45.53,45.53,-1,-50856,64691,115547,13835,0,-3224,64,0,0,,3288,-3160
46,11/16/2018,80,19:45,20:00,,45.53,0,45.53,45.53,-1,-50329,74611,124940,24282,0,-17676,0,0,0,,17676,-17676
46,11/16/2018,81,20:00,20:15,167.72,38.77,0,167.72,38.77,2,-92612,50654,143266,-41958,0,-13213,16779,0,0,,29992,3566
46,11/16/2018,82,20:15,20:30,56.9,51,0,56.9,51,2,-65251,63744,128995,-1507,0,-649,8470,0,0,,9119,7821
46,11/16/2018,83,20:30,20:45,50.34,34.11,0,52.09,34.11,2,-53219,91865,145084,38646,0,-7556,63,0,0,,7619,-7493
46,11/16/2018,84,20:45,21:00,,12.82,0,12.82,12.82,-1,-46768,118771,165539,72003,0,-57019,0,0,0,,57019,-57019
46,11/16/2018,85,21:00,21:15,53.44,36.78,0,53.44,53.44,1,-71667,81142,152809,9475,0,-29724,595,0,0,,30319,-29129
46,11/16/2018,86,21:15,21:30,53.44,46.77,0,46.77,46.77,-1,-45608,71363,116971,25755,0,-8135,90,0,0,,8225,-8045
46,11/16/2018,87,21:30,21:45,,26.17,0,26.17,26.17,-1,-30971,80941,111912,49970,0,-17649,0,0,0,,17649,-17649
46,11/16/2018,88,21:45,22:00,,23.77,0,23.77,23.77,-1,-28842,87391,116233,58549,0,-46981,0,0,0,,46981,-46981
46,11/16/2018,89,22:00,22:15,99.23,18.93,0,99.23,18.93,2,-66961,86504,153465,19543,0,-34673,1325,0,0,,35998,-33348
46,11/16/2018,90,22:15,22:30,244.4,18.93,0,244.4,244.4,1,-90034,43452,133486,-46582,0,-858,35225,0,0,,36083,34367
46,11/16/2018,91,22:30,22:45,244.4,46.77,0,46.77,46.77,-1,-32382,60708,93090,28326,0,-1700,2514,0,0,,4214,814
46,11/16/2018,92,22:45,23:00,,31.88,0,31.88,31.88,-1,-36545,91204,127749,54659,0,-30309,0,0,0,,30309,-30309
46,11/16/2018,93,23:00,23:15,53.74,24.78,0,53.74,53.74,1,-56606,52322,108928,-4284,0,-23776,360,0,0,,24136,-23416
46,11/16/2018,94,23:15,23:30,,,0,44.95,44.95,0,-48164,33842,82006,-14322,0,-45,86,0,0,,131,41
46,11/16/2018,95,23:30,23:45,,39.8,0,39.8,39.8,-1,-16611,42150,58761,25539,0,-10414,0,0,0,,10414,-10414
46,11/16/2018,96,23:45,0:00,,23.77,0,23.77,23.77,-1,-16433,74535,90968,58102,0,-45667,0,0,0,,45667,-45667
47,11/17/2018,1,0:00,0:15,54.71,-27.94,0,54.71,-27.94,2,-74715,107551,182266,32836,0,-57854,105,0,0,,57959,-57749
47,11/17/2018,2,0:15,0:30,56.73,50.61,0,56.73,46.07,2,-53938,73021,126959,19083,0,-4371,837,0,0,,5208,-3534
47,11/17/2018,3,0:30,0:45,51.85,,0,51.85,51.85,1,-58963,45613,104576,-13350,0,0,3480,0,0,,3480,3480
47,11/17/2018,4,0:45,1:00,55.34,,0,55.34,55.34,1,-63395,44568,107963,-18827,0,0,14241,0,0,,14241,14241
47,11/17/2018,5,1:00,1:15,55.34,47.27,0,55.34,46.09,2,-58435,47601,106036,-10834,0,-345,3294,0,0,,3639,2949
47,11/17/2018,6,1:15,1:30,60.17,,0,60.17,60.17,1,-55561,23723,79284,-31838,0,0,18956,0,0,,18956,18956
47,11/17/2018,7,1:30,1:45,55.34,,0,55.34,55.34,1,-54162,31679,85841,-22483,0,0,16474,0,0,,16474,16474
47,11/17/2018,8,1:45,2:00,52.31,,0,52.31,52.31,1,-64273,34651,98924,-29622,0,0,6601,0,0,,6601,6601
47,11/17/2018,9,2:00,2:15,74.6,,0,74.6,74.6,1,-68587,31263,99850,-37324,0,0,15258,0,0,,15258,15258
47,11/17/2018,10,2:15,2:30,87.59,,0,87.59,87.59,1,-59888,28940,88828,-30948,0,0,36225,0,0,,36225,36225
47,11/17/2018,11,2:30,2:45,51.93,,0,51.93,51.93,1,-48435,28553,76988,-19882,0,0,13596,0,0,,13596,13596
47,11/17/2018,12,2:45,3:00,51.95,,0,51.95,51.95,1,-43056,33255,76311,-9801,0,0,10491,0,0,,10491,10491
47,11/17/2018,13,3:00,3:15,51.95,48.77,0,48.77,48.77,-1,-44369,47357,91726,2988,0,-1898,153,0,0,,2051,-1745
47,11/17/2018,14,3:15,3:30,,48.77,0,48.77,48.77,-1,-45072,42386,87458,-2686,0,-1885,0,0,0,,1885,-1885
47,11/17/2018,15,3:30,3:45,51.11,47.27,0,51.11,47.27,2,-40483,33717,74200,-6766,0,-1664,256,0,0,,1920,-1408
47,11/17/2018,16,3:45,4:00,51.11,41.77,0,51.11,41.77,2,-32516,43274,75790,10758,0,-4456,1850,0,0,,6306,-2606
47,11/17/2018,17,4:00,4:15,,42.96,0,42.96,42.96,-1,-37807,47798,85605,9991,0,-12235,0,0,0,,12235,-12235
47,11/17/2018,18,4:15,4:30,,47.27,0,47.27,47.27,-1,-40430,48236,88666,7806,0,-7165,0,0,0,,7165,-7165
47,11/17/2018,19,4:30,4:45,,40.1,0,40.1,40.1,-1,-41038,57825,98863,16787,0,-10986,0,0,0,,10986,-10986
47,11/17/2018,20,4:45,5:00,,40.42,0,40.42,40.42,-1,-39282,46518,85800,7236,0,-14633,0,0,0,,14633,-14633
47,11/17/2018,21,5:00,5:15,,43.34,0,43.34,43.34,-1,-16731,36201,52932,19470,0,-10781,0,0,0,,10781,-10781
47,11/17/2018,22,5:15,5:30,,46.81,0,46.81,46.81,-1,-25218,45196,70414,19978,0,-15075,0,0,0,,15075,-15075
47,11/17/2018,23,5:30,5:45,,43.34,0,43.34,43.34,-1,-22578,49815,72393,27237,0,-24774,0,0,0,,24774,-24774
47,11/17/2018,24,5:45,6:00,,39.34,0,39.34,39.34,-1,-38742,46555,85297,7813,0,-18643,0,0,0,,18643,-18643
47,11/17/2018,25,6:00,6:15,,-53.82,0,-53.82,-53.82,-1,-35821,79829,115650,44008,0,-33083,0,0,0,,33083,-33083
47,11/17/2018,26,6:15,6:30,50.41,39.63,0,50.41,39.63,2,-26487,49801,76288,23314,0,-9045,535,0,0,,9580,-8510
47,11/17/2018,27,6:30,6:45,,47.56,0,47.56,47.56,-1,-30328,35994,66322,5666,0,-8373,0,0,0,,8373,-8373
47,11/17/2018,28,6:45,7:00,,44.03,0,44.03,44.03,-1,-42070,50024,92094,7954,0,-3775,0,0,0,,3775,-3775
47,11/17/2018,29,7:00,7:15,51.63,47.56,0,51.63,45.94,2,-42044,43724,85768,1680,0,-1362,291,0,0,,1653,-1071
47,11/17/2018,30,7:15,7:30,,31.78,0,31.78,31.78,-1,-33069,66701,99770,33632,0,-30284,0,0,0,,30284,-30284
47,11/17/2018,31,7:30,7:45,55.63,31.78,0,55.63,55.63,1,-71582,53634,125216,-17948,0,-4221,5020,0,0,,9241,799
47,11/17/2018,32,7:45,8:00,52.16,39.63,0,52.16,39.63,2,-52995,83093,136088,30098,0,-10676,1147,0,0,,11823,-9529
47,11/17/2018,33,8:00,8:15,50.56,47.56,0,51.97,47.56,2,-85279,70006,155285,-15273,0,-5235,98,0,0,,5333,-5137
47,11/17/2018,34,8:15,8:30,,39.63,0,39.63,39.63,-1,-59026,73514,132540,14488,0,-14866,0,0,0,,14866,-14866
47,11/17/2018,35,8:30,8:45,,49.65,0,49.65,49.65,-1,-40052,59679,99731,19627,0,-2254,0,0,0,,2254,-2254
47,11/17/2018,36,8:45,9:00,62.88,49.65,0,62.88,62.88,1,-49638,37998,87636,-11640,0,-108,2354,0,0,,2462,2246
47,11/17/2018,37,9:00,9:15,74.63,,0,74.63,74.63,1,-68713,40563,109276,-28150,0,0,13442,0,0,,13442,13442
47,11/17/2018,38,9:15,9:30,64.16,,0,64.16,64.16,1,-67427,36133,103560,-31294,0,0,21506,0,0,,21506,21506
47,11/17/2018,39,9:30,9:45,63.46,,0,63.46,63.46,1,-52714,33255,85969,-19459,0,0,23421,0,0,,23421,23421
47,11/17/2018,40,9:45,10:00,53.13,,0,53.13,53.13,1,-52644,32667,85311,-19977,0,0,12211,0,0,,12211,12211
47,11/17/2018,41,10:00,10:15,90.34,,0,90.34,90.34,1,-84546,38319,122865,-46227,0,0,29674,0,0,,29674,29674
47,11/17/2018,42,10:15,10:30,55.63,,0,55.63,55.63,1,-53029,32566,85595,-20463,0,0,18259,0,0,,18259,18259
47,11/17/2018,43,10:30,10:45,55.63,48.37,0,48.37,48.37,-1,-42385,47161,89546,4776,0,-4952,3409,0,0,,8361,-1543
47,11/17/2018,44,10:45,11:00,,33.99,0,33.99,33.99,-1,-35379,57037,92416,21658,0,-12497,0,0,0,,12497,-12497
47,11/17/2018,45,11:00,11:15,55.63,33.05,0,55.63,33.05,2,-51117,36307,87424,-14810,0,-9509,2518,0,0,,12027,-6991
47,11/17/2018,46,11:15,11:30,51.81,,0,51.81,51.81,1,-46285,27915,74200,-18370,0,0,11773,0,0,,11773,11773
47,11/17/2018,47,11:30,11:45,51.81,48.4,0,48.4,48.4,-1,-40154,49640,89794,9486,0,-4113,2275,0,0,,6388,-1838
47,11/17/2018,48,11:45,12:00,51.63,47.56,0,51.63,46.15,2,-46924,36093,83017,-10831,0,-3922,589,0,0,,4511,-3333
47,11/17/2018,49,12:00,12:15,74.63,,0,74.63,74.63,1,-62366,23279,85645,-39087,0,0,16072,0,0,,16072,16072
47,11/17/2018,50,12:15,12:30,55.63,,0,55.63,55.63,1,-58501,27169,85670,-31332,0,0,25172,0,0,,25172,25172
47,11/17/2018,51,12:30,12:45,51.63,51.57,0,51.67,51.57,2,-48324,45271,93595,-3053,0,-907,6003,0,0,,6910,5096
47,11/17/2018,52,12:45,13:00,51.63,51.81,0,51.7,51.7,2,-60212,45756,105968,-14456,0,-113,613,0,0,,726,500
47,11/17/2018,53,13:00,13:15,,39.76,0,39.76,39.76,-1,-52633,74408,127041,21775,0,-11550,0,0,0,,11550,-11550
47,11/17/2018,54,13:15,13:30,,47.6,0,47.6,47.6,-1,-51520,61388,112908,9868,0,-1526,0,0,0,,1526,-1526
47,11/17/2018,55,13:30,13:45,,44.8,0,44.8,44.8,-1,-45574,66445,112019,20871,0,-11989,0,0,0,,11989,-11989
47,11/17/2018,56,13:45,14:00,,47.56,0,47.56,47.56,-1,-37421,61558,98979,24137,0,-17456,0,0,0,,17456,-17456
47,11/17/2018,57,14:00,14:15,50.33,51.24,0,50.33,50.33,1,-72975,66202,139177,-6773,0,-7308,55,0,0,,7363,-7253
47,11/17/2018,58,14:15,14:30,50.3,51.24,0,50.3,50.3,1,-70469,58310,128779,-12159,0,-2,469,0,0,,471,467
47,11/17/2018,59,14:30,14:45,,,0,51.57,51.57,0,-71892,51977,123869,-19915,0,0,0,0,0,,0,0
47,11/17/2018,60,14:45,15:00,,,0,51.52,51.52,0,-74926,47744,122670,-27182,0,0,0,0,0,,0,0
47,11/17/2018,61,15:00,15:15,55.63,,0,55.63,55.63,1,-77907,63823,141730,-14084,0,0,3910,0,0,,3910,3910
47,11/17/2018,62,15:15,15:30,59.63,,0,59.63,59.63,1,-83978,54223,138201,-29755,0,0,17604,0,0,,17604,17604
47,11/17/2018,63,15:30,15:45,74.63,,0,74.63,74.63,1,-82262,41403,123665,-40859,0,0,34869,0,0,,34869,34869
47,11/17/2018,64,15:45,16:00,83.78,,0,83.78,83.78,1,-96312,33607,129919,-62705,0,0,44916,0,0,,44916,44916
47,11/17/2018,65,16:00,16:15,83.78,36.51,0,36.51,36.51,-1,-55748,80079,135827,24331,0,-6086,17085,0,0,,23171,10999
47,11/17/2018,66,16:15,16:30,,48.35,0,48.35,48.35,-1,-60831,76708,137539,15877,0,-8243,0,0,0,,8243,-8243
47,11/17/2018,67,16:30,16:45,,47.56,0,47.56,47.56,-1,-58544,70349,128893,11805,0,-6115,0,0,0,,6115,-6115
47,11/17/2018,68,16:45,17:00,51.39,47.56,0,51.39,51.39,1,-103944,66310,170254,-37634,0,-12,714,0,0,,726,702
47,11/17/2018,69,17:00,17:15,51.39,34.42,0,34.42,34.42,-1,-73670,113434,187104,39764,0,-11921,1,0,0,,11922,-11920
47,11/17/2018,70,17:15,17:30,55.53,51.4,0,59.56,51.4,2,-82960,76900,159860,-6060,0,-3852,5118,0,0,,8970,1266
47,11/17/2018,71,17:30,17:45,51.39,67.7,0,67.7,67.7,-1,-66150,94549,160699,28399,0,-824,1376,0,0,,2200,552
47,11/17/2018,72,17:45,18:00,,67.73,0,67.73,67.73,-1,-55167,133746,188913,78579,0,-279,0,0,0,,279,-279
47,11/17/2018,73,18:00,18:15,52.68,,0,52.68,52.68,1,-91932,71290,163222,-20642,0,0,1260,0,0,,1260,1260
47,11/17/2018,74,18:15,18:30,52.68,43.63,0,43.63,43.63,-1,-57769,85408,143177,27639,0,-1448,27,0,0,,1475,-1421
47,11/17/2018,75,18:30,18:45,,24.52,0,24.52,24.52,-1,-40179,106994,147173,66815,0,-41642,0,0,0,,41642,-41642
47,11/17/2018,76,18:45,19:00,,42.76,0,42.76,42.76,-1,-37488,96310,133798,58822,0,-43334,0,0,0,,43334,-43334
47,11/17/2018,77,19:00,19:15,,39.63,0,39.63,39.63,-1,-60061,92546,152607,32485,0,-35012,0,0,0,,35012,-35012
47,11/17/2018,78,19:15,19:30,,28.79,0,28.79,28.79,-1,-51860,102008,153868,50148,0,-23378,0,0,0,,23378,-23378
47,11/17/2018,79,19:30,19:45,,39.63,0,39.63,39.63,-1,-60818,112544,173362,51726,0,-44601,0,0,0,,44601,-44601
47,11/17/2018,80,19:45,20:00,,43.03,0,43.03,43.03,-1,-77506,91583,169089,14077,0,-32977,0,0,0,,32977,-32977
47,11/17/2018,81,20:00,20:15,50.33,51.43,0,50.33,50.33,1,-76910,73360,150270,-3550,0,-2557,843,0,0,,3400,-1714
47,11/17/2018,82,20:15,20:30,55.63,,0,55.63,55.63,1,-86471,55407,141878,-31064,0,0,7726,0,0,,7726,7726
47,11/17/2018,83,20:30,20:45,55.63,47.56,0,47.56,47.56,-1,-57092,62797,119889,5705,0,-2078,114,0,0,,2192,-1964
47,11/17/2018,84,20:45,21:00,,47.56,0,47.56,47.56,-1,-72606,80217,152823,7611,0,-4798,0,0,0,,4798,-4798
47,11/17/2018,85,21:00,21:15,59.63,47.56,0,59.63,59.63,1,-78272,62586,140858,-15686,0,-399,8874,0,0,,9273,8475
47,11/17/2018,86,21:15,21:30,59.63,,0,59.63,59.63,1,-92329,57907,150236,-34422,0,0,28485,0,0,,28485,28485
47,11/17/2018,87,21:30,21:45,55.02,,0,55.02,55.02,1,-74569,66010,140579,-8559,0,0,15961,0,0,,15961,15961
47,11/17/2018,88,21:45,22:00,55.02,9.62,0,9.62,9.62,-1,-45984,95178,141162,49194,0,-27047,1123,0,0,,28170,-25924
47,11/17/2018,89,22:00,22:15,,38.48,0,38.48,38.48,-1,-34374,58495,92869,24121,0,-22514,0,0,0,,22514,-22514
47,11/17/2018,90,22:15,22:30,,47.56,0,47.56,47.56,-1,-45421,63722,109143,18301,0,-8347,0,0,0,,8347,-8347
47,11/17/2018,91,22:30,22:45,51.63,47.56,0,51.63,47.56,2,-65118,65535,130653,417,0,-5794,1028,0,0,,6822,-4766
47,11/17/2018,92,22:45,23:00,52.9,47.56,0,52.9,52.9,1,-104082,80035,184117,-24047,0,-172,13432,0,0,,13604,13260
47,11/17/2018,93,23:00,23:15,52.9,24.4,0,24.4,24.4,-1,-25047,64882,89929,39835,0,-19279,1243,0,0,,20522,-18036
47,11/17/2018,94,23:15,23:30,50.96,47.56,0,50.96,43.54,2,-68031,61096,129127,-6935,0,-1849,1224,0,0,,3073,-625
47,11/17/2018,95,23:30,23:45,,38.74,0,38.74,38.74,-1,-44406,65614,110020,21208,0,-3652,0,0,0,,3652,-3652
47,11/17/2018,96,23:45,0:00,,-80.73,0,-80.73,-80.73,-1,-24545,66352,90897,41807,0,-29565,0,0,0,,29565,-29565
47,11/18/2018,1,0:00,0:15,113.44,-80.73,0,113.44,113.44,1,-77185,31496,108681,-45689,0,-2557,20971,0,0,,23528,18414
47,11/18/2018,2,0:15,0:30,55.1,,0,55.1,55.1,1,-58832,49964,108796,-8868,0,0,7909,0,0,,7909,7909
47,11/18/2018,3,0:30,0:45,54.01,,0,54.01,54.01,1,-51717,47297,99014,-4420,0,0,4012,0,0,,4012,4012
47,11/18/2018,4,0:45,1:00,54.01,37.07,0,37.07,37.07,-1,-40493,64840,105333,24347,0,-9147,416,0,0,,9563,-8731
47,11/18/2018,5,1:00,1:15,52.83,27.33,0,52.83,27.33,2,-37142,34376,71518,-2766,0,-8647,2427,0,0,,11074,-6220
47,11/18/2018,6,1:15,1:30,51.1,52.46,0,51.1,45.79,2,-40929,39752,80681,-1177,0,-427,2226,0,0,,2653,1799
47,11/18/2018,7,1:30,1:45,,50.89,0,50.89,50.89,-1,-38627,43393,82020,4766,0,-5493,0,0,0,,5493,-5493
47,11/18/2018,8,1:45,2:00,,42.67,0,42.67,42.67,-1,-34870,55156,90026,20286,0,-13497,0,0,0,,13497,-13497
47,11/18/2018,9,2:00,2:15,,37.73,0,37.73,37.73,-1,-27639,54817,82456,27178,0,-22444,0,0,0,,22444,-22444
47,11/18/2018,10,2:15,2:30,,44.91,0,44.91,44.91,-1,-32014,56099,88113,24085,0,-18157,0,0,0,,18157,-18157
47,11/18/2018,11,2:30,2:45,,45.47,0,45.47,45.47,-1,-31799,57012,88811,25213,0,-13610,0,0,0,,13610,-13610
47,11/18/2018,12,2:45,3:00,,39.9,0,39.9,39.9,-1,-31809,66118,97927,34309,0,-25574,0,0,0,,25574,-25574
47,11/18/2018,13,3:00,3:15,,47.02,0,47.02,47.02,-1,-34303,113373,147676,79070,0,-10814,0,0,0,,10814,-10814
47,11/18/2018,14,3:15,3:30,,52,0,52,52,-1,-30250,86500,116750,56250,0,-1261,0,0,0,,1261,-1261
47,11/18/2018,15,3:30,3:45,,,0,45.56,45.56,0,-25943,60643,86586,34700,0,0,0,0,0,,0,0
47,11/18/2018,16,3:45,4:00,,,0,45.56,45.56,0,-29333,36363,65696,7030,0,0,0,0,0,,0,0
47,11/18/2018,17,4:00,4:15,,45.72,0,45.72,45.72,-1,-25361,57877,83238,32516,0,-4828,0,0,0,,4828,-4828
47,11/18/2018,18,4:15,4:30,,47.02,0,47.02,47.02,-1,-24062,51667,75729,27605,0,-5634,0,0,0,,5634,-5634
47,11/18/2018,19,4:30,4:45,,,0,45.58,45.58,0,-28220,42422,70642,14202,0,0,0,0,0,,0,0
47,11/18/2018,20,4:45,5:00,,,0,45.58,45.58,0,-35032,38885,73917,3853,0,0,0,0,0,,0,0
47,11/18/2018,21,5:00,5:15,39.12,,0,39.12,39.12,1,-42174,33437,75611,-8737,0,0,31,0,0,,31,31
47,11/18/2018,22,5:15,5:30,,,0,45.56,45.56,0,-44917,39753,84670,-5164,0,0,0,0,0,,0,0
47,11/18/2018,23,5:30,5:45,51.1,,0,51.1,51.1,1,-50346,22152,72498,-28194,0,0,290,0,0,,290,290
47,11/18/2018,24,5:45,6:00,55.1,,0,55.1,55.1,1,-53454,27003,80457,-26451,0,0,9243,0,0,,9243,9243
47,11/18/2018,25,6:00,6:15,55.1,47.1,0,47.1,47.1,-1,-27387,49400,76787,22013,0,-2793,145,0,0,,2938,-2648
47,11/18/2018,26,6:15,6:30,,47.1,0,47.1,47.1,-1,-31150,40373,71523,9223,0,-5639,0,0,0,,5639,-5639
47,11/18/2018,27,6:30,6:45,,51.98,0,51.98,51.98,-1,-47866,45675,93541,-2191,0,-1437,0,0,0,,1437,-1437
47,11/18/2018,28,6:45,7:00,,,0,45.53,45.53,0,-56202,65251,121453,9049,0,0,0,0,0,,0,0
47,11/18/2018,29,7:00,7:15,,,0,45.76,45.76,0,-27021,52739,79760,25718,0,0,0,0,0,,0,0
47,11/18/2018,30,7:15,7:30,,,0,45.74,45.74,0,-37348,46683,84031,9335,0,0,0,0,0,,0,0
47,11/18/2018,31,7:30,7:45,51.2,,0,51.2,51.2,1,-51163,42124,93287,-9039,0,0,2234,0,0,,2234,2234
47,11/18/2018,32,7:45,8:00,,,0,45.69,45.69,0,-43239,56602,99841,13363,0,0,23,0,0,,23,23
47,11/18/2018,33,8:00,8:15,50.43,,0,50.43,50.43,1,-63648,26863,90511,-36785,0,0,37,0,0,,37,37
47,11/18/2018,34,8:15,8:30,50.39,,0,50.39,50.39,1,-69640,21178,90818,-48462,0,0,2941,0,0,,2941,2941
47,11/18/2018,35,8:30,8:45,59.2,,0,59.2,59.2,1,-72611,22209,94820,-50402,0,0,14256,0,0,,14256,14256
47,11/18/2018,36,8:45,9:00,51.2,33.51,0,51.2,33.51,2,-61317,110042,171359,48725,0,-4036,8321,0,0,,12357,4285
47,11/18/2018,37,9:00,9:15,60.16,66.22,0,60.16,60.16,1,-65213,31418,96631,-33795,0,-835,4785,0,0,,5620,3950
47,11/18/2018,38,9:15,9:30,69.15,,0,69.15,69.15,1,-62216,21694,83910,-40522,0,0,28047,0,0,,28047,28047
47,11/18/2018,39,9:30,9:45,59.2,,0,59.2,59.2,1,-57381,18815,76196,-38566,0,0,28115,0,0,,28115,28115
47,11/18/2018,40,9:45,10:00,59.95,,0,59.95,59.95,1,-54027,28461,82488,-25566,0,0,24125,0,0,,24125,24125
47,11/18/2018,41,10:00,10:15,60.91,,0,60.91,60.91,1,-61292,29637,90929,-31655,0,0,20886,0,0,,20886,20886
47,11/18/2018,42,10:15,10:30,55.09,,0,55.09,55.09,1,-61296,48055,109351,-13241,0,0,14900,0,0,,14900,14900
47,11/18/2018,43,10:30,10:45,55.09,47.1,0,47.1,47.1,-1,-60988,81736,142724,20748,0,-5393,656,0,0,,6049,-4737
47,11/18/2018,44,10:45,11:00,,39.2,0,39.2,39.2,-1,-50523,92318,142841,41795,0,-27277,0,0,0,,27277,-27277
47,11/18/2018,45,11:00,11:15,,39.2,0,39.2,39.2,-1,-53490,94593,148083,41103,0,-31573,0,0,0,,31573,-31573
47,11/18/2018,46,11:15,11:30,,-27.36,0,-27.36,-27.36,-1,-53043,134628,187671,81585,0,-65536,0,0,0,,65536,-65536
47,11/18/2018,47,11:30,11:45,,33.13,0,33.13,33.13,-1,-70972,125272,196244,54300,0,-56510,0,0,0,,56510,-56510
47,11/18/2018,48,11:45,12:00,,39.2,0,39.2,39.2,-1,-73931,113304,187235,39373,0,-48838,0,0,0,,48838,-48838
47,11/18/2018,49,12:00,12:15,,43.2,0,43.2,43.2,-1,-68065,89187,157252,21122,0,-24113,0,0,0,,24113,-24113
47,11/18/2018,50,12:15,12:30,51.2,65.49,0,52.31,52.31,2,-81046,73570,154616,-7476,0,-1720,2046,0,0,,3766,326
47,11/18/2018,51,12:30,12:45,51.2,,0,51.2,51.2,1,-70355,60588,130943,-9767,0,0,5374,0,0,,5374,5374
47,11/18/2018,52,12:45,13:00,51.2,,0,51.2,51.2,1,-63966,54814,118780,-9152,0,0,6697,0,0,,6697,6697
47,11/18/2018,53,13:00,13:15,51.2,52.06,0,52.35,52.06,2,-52929,46730,99659,-6199,0,-44,935,0,0,,979,891
47,11/18/2018,54,13:15,13:30,,48.78,0,48.78,48.78,-1,-47774,51717,99491,3943,0,-4571,0,0,0,,4571,-4571
47,11/18/2018,55,13:30,13:45,,49.46,0,49.46,49.46,-1,-57221,55740,112961,-1481,0,-4163,0,0,0,,4163,-4163
47,11/18/2018,56,13:45,14:00,51.2,65.65,0,51.2,51.2,1,-78107,50778,128885,-27329,0,-1693,245,0,0,,1938,-1448
47,11/18/2018,57,14:00,14:15,66.53,,0,66.53,66.53,1,-100980,55731,156711,-45249,0,0,18922,0,0,,18922,18922
47,11/18/2018,58,14:15,14:30,56.99,,0,56.99,56.99,1,-102655,63574,166229,-39081,0,0,8468,0,0,,8468,8468
47,11/18/2018,59,14:30,14:45,172.98,,0,172.98,172.98,1,-123620,51035,174655,-72585,0,0,34329,0,0,,34329,34329
47,11/18/2018,60,14:45,15:00,80.11,,0,80.11,80.11,1,-102321,78449,180770,-23872,0,0,33004,0,0,,33004,33004
47,11/18/2018,61,15:00,15:15,80.11,49.85,0,49.85,49.85,-1,-65134,85867,151001,20733,0,-2893,2022,0,0,,4915,-871
47,11/18/2018,62,15:15,15:30,,65.11,0,65.11,65.11,-1,-76924,85555,162479,8631,0,-1794,0,0,0,,1794,-1794
47,11/18/2018,63,15:30,15:45,55.2,,0,55.2,55.2,1,-88977,72863,161840,-16114,0,0,6322,0,0,,6322,6322
47,11/18/2018,64,15:45,16:00,55.2,,0,55.2,55.2,1,-100071,55032,155103,-45039,0,0,11934,0,0,,11934,11934
47,11/18/2018,65,16:00,16:15,45.12,65.48,0,65.48,65.48,-1,-66981,81117,148098,14136,0,-434,5016,0,0,,5450,4582
47,11/18/2018,66,16:15,16:30,,65.48,0,65.48,65.48,-1,-47486,60456,107942,12970,0,-262,0,0,0,,262,-262
47,11/18/2018,67,16:30,16:45,,,0,52.25,52.25,0,-54846,72586,127432,17740,0,0,0,0,0,,0,0
47,11/18/2018,68,16:45,17:00,50.21,,0,50.21,50.21,1,-87688,90227,177915,2539,0,0,26,0,0,,26,26
47,11/18/2018,69,17:00,17:15,89.05,,0,89.05,89.05,1,-106054,57934,163988,-48120,0,0,6051,0,0,,6051,6051
47,11/18/2018,70,17:15,17:30,288.34,,0,288.34,288.34,1,-127987,55606,183593,-72381,0,0,57269,0,0,,57269,57269
47,11/18/2018,71,17:30,17:45,70.25,,0,70.25,70.25,1,-131830,86706,218536,-45124,0,0,46392,0,0,,46392,46392
47,11/18/2018,72,17:45,18:00,59.05,,0,59.05,59.05,1,-122462,116217,238679,-6245,0,0,19100,0,0,,19100,19100
47,11/18/2018,73,18:00,18:15,110.97,,0,110.97,110.97,1,-138574,80567,219141,-58007,0,0,25492,0,0,,25492,25492
47,11/18/2018,74,18:15,18:30,54.49,62.52,0,62.52,62.52,-1,-114649,118036,232685,3387,0,-712,4925,0,0,,5637,4213
47,11/18/2018,75,18:30,18:45,,40.74,0,40.74,40.74,-1,-94916,127409,222325,32493,0,-20838,0,0,0,,20838,-20838
47,11/18/2018,76,18:45,19:00,,43.2,0,43.2,43.2,-1,-91713,132025,223738,40312,0,-26245,0,0,0,,26245,-26245
47,11/18/2018,77,19:00,19:15,,45.27,0,45.27,45.27,-1,-109090,129539,238629,20449,0,-25336,0,0,0,,25336,-25336
47,11/18/2018,78,19:15,19:30,,43.2,0,43.2,43.2,-1,-99698,135566,235264,35868,0,-20055,0,0,0,,20055,-20055
47,11/18/2018,79,19:30,19:45,,37.07,0,37.07,37.07,-1,-95546,148669,244215,53123,0,-37766,0,0,0,,37766,-37766
47,11/18/2018,80,19:45,20:00,,37.07,0,37.07,37.07,-1,-92995,140240,233235,47245,0,-51243,0,0,0,,51243,-51243
47,11/18/2018,81,20:00,20:15,50.32,47.1,0,57.69,47.1,2,-94859,104372,199231,9513,0,-20480,564,0,0,,21044,-19916
47,11/18/2018,82,20:15,20:30,,47.1,0,47.1,47.1,-1,-80615,88283,168898,7668,0,-3011,0,0,0,,3011,-3011
47,11/18/2018,83,20:30,20:45,,39.2,0,39.2,39.2,-1,-74044,108719,182763,34675,0,-26830,0,0,0,,26830,-26830
47,11/18/2018,84,20:45,21:00,,36.76,0,36.76,36.76,-1,-69711,120956,190667,51245,0,-46958,0,0,0,,46958,-46958
47,11/18/2018,85,21:00,21:15,63.57,29.72,0,63.57,63.57,1,-56071,58600,114671,2529,0,-30573,1324,0,0,,31897,-29249
47,11/18/2018,86,21:15,21:30,74.2,29.72,0,74.2,74.2,1,-74011,64074,138085,-9937,0,-229,12984,0,0,,13213,12755
47,11/18/2018,87,21:30,21:45,74.2,48.39,0,48.39,48.39,-1,-60479,72992,133471,12513,0,-3438,134,0,0,,3572,-3304
47,11/18/2018,88,21:45,22:00,,43.68,0,43.68,43.68,-1,-69278,93018,162296,23740,0,-11513,0,0,0,,11513,-11513
47,11/18/2018,89,22:00,22:15,50.21,47.1,0,57.72,47.1,2,-56244,59537,115781,3293,0,-4819,546,0,0,,5365,-4273
47,11/18/2018,90,22:15,22:30,,47.1,0,47.1,47.1,-1,-49681,72385,122066,22704,0,-6706,0,0,0,,6706,-6706
47,11/18/2018,91,22:30,22:45,,43.2,0,43.2,43.2,-1,-35998,60926,96924,24928,0,-13747,0,0,0,,13747,-13747
47,11/18/2018,92,22:45,23:00,65.43,43.2,0,65.43,65.43,1,-83933,64148,148081,-19785,0,-1787,6417,0,0,,8204,4630
47,11/18/2018,93,23:00,23:15,65.43,10.91,0,10.91,10.91,-1,-44669,99503,144172,54834,0,-18891,1688,0,0,,20579,-17203
47,11/18/2018,94,23:15,23:30,,10.39,0,10.39,10.39,-1,-31273,84043,115316,52770,0,-58549,0,0,0,,58549,-58549
47,11/18/2018,95,23:30,23:45,,21.01,0,21.01,21.01,-1,-26876,92244,119120,65368,0,-64510,0,0,0,,64510,-64510
47,11/18/2018,96,23:45,0:00,,13.86,0,13.86,13.86,-1,-38290,108773,147063,70483,0,-69775,0,0,0,,69775,-69775
47,11/19/2018,1,0:00,0:15,,-136.32,0,-136.32,-136.32,-1,-35734,113095,148829,77361,0,-58331,0,0,0,,58331,-58331
47,11/19/2018,2,0:15,0:30,,24.2,0,24.2,24.2,-1,-31185,73747,104932,42562,0,-18996,0,0,0,,18996,-18996
47,11/19/2018,3,0:30,0:45,,24.2,0,24.2,24.2,-1,-29636,58186,87822,28550,0,-27408,0,0,0,,27408,-27408
47,11/19/2018,4,0:45,1:00,,44.75,0,44.75,44.75,-1,-40851,46667,87518,5816,0,-4867,0,0,0,,4867,-4867
47,11/19/2018,5,1:00,1:15,,24.2,0,24.2,24.2,-1,-30648,49649,80297,19001,0,-13873,0,0,0,,13873,-13873
47,11/19/2018,6,1:15,1:30,,39.2,0,39.2,39.2,-1,-28652,55572,84224,26920,0,-14870,0,0,0,,14870,-14870
47,11/19/2018,7,1:30,1:45,,24.2,0,24.2,24.2,-1,-29054,65246,94300,36192,0,-34201,0,0,0,,34201,-34201
47,11/19/2018,8,1:45,2:00,,-11.43,0,-11.43,-11.43,-1,-29684,83683,113367,53999,0,-47415,0,0,0,,47415,-47415
47,11/19/2018,9,2:00,2:15,53.52,29.03,0,53.52,29.03,2,-55746,49674,105420,-6072,0,-19610,1636,0,0,,21246,-17974
47,11/19/2018,10,2:15,2:30,,43.12,0,43.12,43.12,-1,-22374,42369,64743,19995,0,-6584,0,0,0,,6584,-6584
47,11/19/2018,11,2:30,2:45,,39.41,0,39.41,39.41,-1,-20634,45515,66149,24881,0,-15348,0,0,0,,15348,-15348
47,11/19/2018,12,2:45,3:00,,21.03,0,21.03,21.03,-1,-17684,66711,84395,49027,0,-26713,0,0,0,,26713,-26713
47,11/19/2018,13,3:00,3:15,50.25,38.62,0,50.25,50.25,1,-40781,53221,94002,12440,0,-20789,78,0,0,,20867,-20711
47,11/19/2018,14,3:15,3:30,38.02,39.2,0,44.22,39.2,2,-27770,55828,83598,28058,0,-7387,3,0,0,,7390,-7384
47,11/19/2018,15,3:30,3:45,,39.2,0,39.2,39.2,-1,-27154,59533,86687,32379,0,-25107,0,0,0,,25107,-25107
47,11/19/2018,16,3:45,4:00,,40.35,0,40.35,40.35,-1,-25342,48711,74053,23369,0,-26533,0,0,0,,26533,-26533
47,11/19/2018,17,4:00,4:15,,-34.49,0,-34.49,-34.49,-1,-13911,73565,87476,59654,0,-26421,0,0,0,,26421,-26421
47,11/19/2018,18,4:15,4:30,50.35,-36.43,0,50.35,-36.43,2,-34641,42717,77358,8076,0,-26156,356,0,0,,26512,-25800
47,11/19/2018,19,4:30,4:45,50.33,39.2,0,50.33,39.2,2,-25988,61394,87382,35406,0,-13613,93,0,0,,13706,-13520
47,11/19/2018,20,4:45,5:00,,43.2,0,43.2,43.2,-1,-36856,54425,91281,17569,0,-19929,0,0,0,,19929,-19929
47,11/19/2018,21,5:00,5:15,50.43,-18.85,0,50.75,-18.85,2,-49573,105006,154579,55433,0,-18910,64,0,0,,18974,-18846
47,11/19/2018,22,5:15,5:30,,-105.81,0,-105.81,-105.81,-1,-32298,90064,122362,57766,0,-54928,0,0,0,,54928,-54928
47,11/19/2018,23,5:30,5:45,65.43,46.98,0,65.43,65.43,1,-40370,31138,71508,-9232,0,-8573,1980,0,0,,10553,-6593
47,11/19/2018,24,5:45,6:00,64.35,,0,64.35,64.35,1,-69025,40780,109805,-28245,0,0,24406,0,0,,24406,24406
47,11/19/2018,25,6:00,6:15,64.35,-24.41,0,-24.41,-24.41,-1,-50390,107678,158068,57288,0,-22692,1974,0,0,,24666,-20718
47,11/19/2018,26,6:15,6:30,,-30.71,0,-30.71,-30.71,-1,-28876,62777,91653,33901,0,-34167,0,0,0,,34167,-34167
47,11/19/2018,27,6:30,6:45,52.43,47.06,0,52.43,47.06,2,-47738,59110,106848,11372,0,-1087,257,0,0,,1344,-830
47,11/19/2018,28,6:45,7:00,58.06,,0,58.06,58.06,1,-100500,63160,163660,-37340,0,0,22801,0,0,,22801,22801
47,11/19/2018,29,7:00,7:15,51.13,53.38,0,52.09,52.09,2,-86309,69399,155708,-16910,0,-53,5766,0,0,,5819,5713
47,11/19/2018,30,7:15,7:30,55.13,,0,55.13,55.13,1,-73963,61588,135551,-12375,0,0,1357,0,0,,1357,1357
47,11/19/2018,31,7:30,7:45,59.13,,0,59.13,59.13,1,-80081,48563,128644,-31518,0,0,15971,0,0,,15971,15971
47,11/19/2018,32,7:45,8:00,60.48,,0,60.48,60.48,1,-119795,62624,182419,-57171,0,0,34489,0,0,,34489,34489
47,11/19/2018,33,8:00,8:15,51.13,51.76,0,59.37,51.76,2,-48314,75362,123676,27048,0,-782,7049,0,0,,7831,6267
47,11/19/2018,34,8:15,8:30,,67.6,0,67.6,67.6,-1,-37345,56177,93522,18832,0,-1138,0,0,0,,1138,-1138
47,11/19/2018,35,8:30,8:45,55.13,,0,55.13,55.13,1,-55293,47007,102300,-8286,0,0,3230,0,0,,3230,3230
47,11/19/2018,36,8:45,9:00,53.52,,0,53.52,53.52,1,-87160,65438,152598,-21722,0,0,10451,0,0,,10451,10451
47,11/19/2018,37,9:00,9:15,77.7,,0,77.7,77.7,1,-97598,43163,140761,-54435,0,0,30768,0,0,,30768,30768
47,11/19/2018,38,9:15,9:30,66.12,,0,66.12,66.12,1,-85006,28806,113812,-56200,0,0,38456,0,0,,38456,38456
47,11/19/2018,39,9:30,9:45,101.69,,0,101.69,101.69,1,-78249,23178,101427,-55071,0,0,35142,0,0,,35142,35142
47,11/19/2018,40,9:45,10:00,69.32,,0,69.32,69.32,1,-65351,33511,98862,-31840,0,0,30640,0,0,,30640,30640
47,11/19/2018,41,10:00,10:15,267.01,,0,267.01,267.01,1,-125192,37427,162619,-87765,0,0,34696,0,0,,34696,34696
47,11/19/2018,42,10:15,10:30,267.01,,0,267.01,267.01,1,-193887,47812,241699,-146075,0,0,44390,0,0,,44390,44390
47,11/19/2018,43,10:30,10:45,374.9,,0,412.39,412.39,1,-220459,84477,304936,-135982,0,0,80200,5000,8344,,93544,93544
47,11/19/2018,44,10:45,11:00,374.9,51.75,0,51.75,51.75,-1,-191368,129655,321023,-61713,0,-105,10354,0,25974,,36433,36223
47,11/19/2018,45,11:00,11:15,222.92,,0,222.92,222.92,1,-186020,122590,308610,-63430,0,0,31415,0,0,,31415,31415
47,11/19/2018,46,11:15,11:30,94.01,,0,94.01,94.01,1,-189250,125917,315167,-63333,0,0,46899,0,0,,46899,46899
47,11/19/2018,47,11:30,11:45,222.92,,0,222.92,222.92,1,-210658,124160,334818,-86498,0,0,76852,0,0,,76852,76852
47,11/19/2018,48,11:45,12:00,144.88,,0,144.88,144.88,1,-207224,131659,338883,-75565,0,0,66430,0,0,,66430,66430
47,11/19/2018,49,12:00,12:15,96.02,53.09,0,96.02,51.75,2,-175126,145610,320736,-29516,0,-6,55013,0,0,,55019,55007
47,11/19/2018,50,12:15,12:30,96.02,43.26,0,43.26,43.26,-1,-123789,132707,256496,8918,0,-4749,3832,0,0,,8581,-917
47,11/19/2018,51,12:30,12:45,57.93,,0,57.93,57.93,1,-118534,104617,223151,-13917,0,0,4736,0,0,,4736,4736
47,11/19/2018,52,12:45,13:00,59.13,,0,59.13,59.13,1,-126160,99155,225315,-27005,0,0,14514,0,0,,14514,14514
47,11/19/2018,53,13:00,13:15,102.72,,0,102.72,102.72,1,-143835,93880,237715,-49955,0,0,32466,0,0,,32466,32466
47,11/19/2018,54,13:15,13:30,97.77,,0,97.77,97.77,1,-137113,102938,240051,-34175,0,0,39569,0,0,,39569,39569
47,11/19/2018,55,13:30,13:45,59.13,,0,59.13,59.13,1,-131397,104689,236086,-26708,0,0,20749,0,0,,20749,20749
47,11/19/2018,56,13:45,14:00,78.95,,0,78.95,78.95,1,-145284,95901,241185,-49383,0,0,37099,0,0,,37099,37099
47,11/19/2018,57,14:00,14:15,98.76,,0,98.76,98.76,1,-180236,123539,303775,-56697,0,0,51536,0,0,,51536,51536
47,11/19/2018,58,14:15,14:30,151.96,,0,151.96,151.96,1,-189020,118976,307996,-70044,0,0,52307,0,0,,52307,52307
47,11/19/2018,59,14:30,14:45,88.7,,0,88.7,88.7,1,-183870,131973,315843,-51897,0,0,56814,0,0,,56814,56814
47,11/19/2018,60,14:45,15:00,153.89,,0,153.89,153.89,1,-194008,151348,345356,-42660,0,0,44501,1250,0,,45751,45751
47,11/19/2018,61,15:00,15:15,59.13,,0,59.13,59.13,1,-166625,152042,318667,-14583,0,0,20777,0,0,,20777,20777
47,11/19/2018,62,15:15,15:30,58.01,,0,58.01,58.01,1,-165516,153941,319457,-11575,0,0,6313,0,0,,6313,6313
47,11/19/2018,63,15:30,15:45,241.38,,0,241.38,241.38,1,-188647,122900,311547,-65747,0,0,43523,0,0,,43523,43523
47,11/19/2018,64,15:45,16:00,241.39,,0,241.39,241.39,1,-189348,127591,316939,-61757,0,0,67540,0,0,,67540,67540
47,11/19/2018,65,16:00,16:15,241.39,-7.48,0,-7.48,-7.48,-1,-73092,141913,215005,68821,0,-22450,9587,0,0,,32037,-12863
47,11/19/2018,66,16:15,16:30,,67.78,0,67.78,67.78,-1,-78608,107893,186501,29285,0,-1858,0,0,0,,1858,-1858
47,11/19/2018,67,16:30,16:45,,,0,59.46,59.46,0,-96933,116890,213823,19957,0,0,0,0,0,,0,0
47,11/19/2018,68,16:45,17:00,53.36,,0,53.36,53.36,1,-121479,117306,238785,-4173,0,0,1072,0,0,,1072,1072
47,11/19/2018,69,17:00,17:15,85,,0,85,85,1,-163292,96500,259792,-66792,0,0,8882,0,0,,8882,8882
47,11/19/2018,70,17:15,17:30,275.92,,0,275.92,275.92,1,-207118,96449,303567,-110669,0,0,63059,0,0,,63059,63059
47,11/19/2018,71,17:30,17:45,275.92,,0,275.92,275.92,1,-185575,123809,309384,-61766,0,0,66448,0,0,,66448,66448
47,11/19/2018,72,17:45,18:00,67.05,,0,67.05,67.05,1,-174180,137730,311910,-36450,0,0,23353,0,0,,23353,23353
47,11/19/2018,73,18:00,18:15,55.13,48.12,0,48.12,48.12,-1,-157226,153405,310631,-3821,0,-1013,13954,0,0,,14967,12941
47,11/19/2018,74,18:15,18:30,55.13,43.13,0,43.13,43.13,-1,-142574,148522,291096,5948,0,-7658,512,0,0,,8170,-7146
47,11/19/2018,75,18:30,18:45,,47.06,0,47.06,47.06,-1,-139733,151385,291118,11652,0,-5214,0,0,0,,5214,-5214
47,11/19/2018,76,18:45,19:00,,47.78,0,47.78,47.78,-1,-135416,147276,282692,11860,0,-5019,0,0,0,,5019,-5019
47,11/19/2018,77,19:00,19:15,,47.06,0,47.06,47.06,-1,-94725,116210,210935,21485,0,-6459,0,0,0,,6459,-6459
47,11/19/2018,78,19:15,19:30,,47.06,0,47.06,47.06,-1,-87458,113686,201144,26228,0,-6479,0,0,0,,6479,-6479
47,11/19/2018,79,19:30,19:45,,39.13,0,39.13,39.13,-1,-74451,127792,202243,53341,0,-24185,0,0,0,,24185,-24185
47,11/19/2018,80,19:45,20:00,,32.77,0,32.77,32.77,-1,-67926,112799,180725,44873,0,-49637,0,0,0,,49637,-49637
47,11/19/2018,81,20:00,20:15,51.13,43.55,0,51.13,31.33,2,-97891,91105,188996,-6786,0,-15032,931,0,0,,15963,-14101
47,11/19/2018,82,20:15,20:30,51.13,43.55,0,51.13,51.13,1,-93456,59589,153045,-33867,0,-99,733,0,0,,832,634
47,11/19/2018,83,20:30,20:45,51.13,47.06,0,51.13,31.35,2,-71663,70474,142137,-1189,0,-237,1622,0,0,,1859,1385
47,11/19/2018,84,20:45,21:00,,36.45,0,36.45,36.45,-1,-72569,100133,172702,27564,0,-14115,0,0,0,,14115,-14115
47,11/19/2018,85,21:00,21:15,74.13,18.83,0,74.13,18.83,2,-93427,85743,179170,-7684,0,-19871,4989,0,0,,24860,-14882
47,11/19/2018,86,21:15,21:30,51.97,18.83,0,51.97,51.97,1,-82368,53340,135708,-29028,0,-303,5362,0,0,,5665,5059
47,11/19/2018,87,21:30,21:45,52.93,,0,52.93,52.93,1,-100771,56293,157064,-44478,0,0,2412,0,0,,2412,2412
47,11/19/2018,88,21:45,22:00,55.13,,0,55.13,55.13,1,-125374,81244,206618,-44130,0,0,8370,0,0,,8370,8370
47,11/19/2018,89,22:00,22:15,60.51,,0,60.51,60.51,1,-102701,78053,180754,-24648,0,0,19191,0,0,,19191,19191
47,11/19/2018,90,22:15,22:30,53.02,,0,53.02,53.02,1,-79857,70696,150553,-9161,0,0,11318,0,0,,11318,11318
47,11/19/2018,91,22:30,22:45,53.02,47.06,0,47.06,47.06,-1,-50203,61577,111780,11374,0,-1096,177,0,0,,1273,-919
47,11/19/2018,92,22:45,23:00,,-11.42,0,-11.42,-11.42,-1,-32463,80175,112638,47712,0,-25175,0,0,0,,25175,-25175
47,11/19/2018,93,23:00,23:15,150.78,39.13,0,150.78,39.13,2,-121846,51836,173682,-70010,0,-14874,22133,0,0,,37007,7259
47,11/19/2018,94,23:15,23:30,51.02,45.99,0,45.99,45.99,-1,-74101,73194,147295,-907,0,-758,1695,0,0,,2453,937
47,11/19/2018,95,23:30,23:45,,40.01,0,40.01,40.01,-1,-51710,69906,121616,18196,0,-15347,0,0,0,,15347,-15347
47,11/19/2018,96,23:45,0:00,,20.03,0,20.03,20.03,-1,-43656,80889,124545,37233,0,-17702,0,0,0,,17702,-17702
47,11/20/2018,1,0:00,0:15,129.88,43.13,0,129.88,129.88,1,-104660,32726,137386,-71934,0,-9822,20129,0,0,,29951,10307
47,11/20/2018,2,0:15,0:30,178.38,43.13,0,178.38,178.38,1,-97548,46971,144519,-50577,0,-7,52222,0,0,,52229,52215
47,11/20/2018,3,0:30,0:45,55.13,,0,55.13,55.13,1,-62814,42047,104861,-20767,0,0,22207,0,0,,22207,22207
47,11/20/2018,4,0:45,1:00,47.89,31.22,0,47.89,31.22,2,-39413,59324,98737,19911,0,-5913,1812,0,0,,7725,-4101
47,11/20/2018,5,1:00,1:15,86.11,43.13,0,86.11,86.11,1,-68281,12367,80648,-55914,0,-5360,20073,0,0,,25433,14713
47,11/20/2018,6,1:15,1:30,59.13,,0,59.13,59.13,1,-31528,20938,52466,-10590,0,0,18122,0,0,,18122,18122
47,11/20/2018,7,1:30,1:45,49.45,,0,49.45,49.45,1,-16631,13548,30179,-3083,0,0,852,0,0,,852,852
47,11/20/2018,8,1:45,2:00,49.45,18.82,0,18.82,18.82,-1,-14702,36816,51518,22114,0,-5209,11,0,0,,5220,-5198
47,11/20/2018,9,2:00,2:15,55.88,17.32,0,55.88,55.88,1,-39169,25309,64478,-13860,0,-8852,6674,0,0,,15526,-2178
47,11/20/2018,10,2:15,2:30,59.13,,0,59.13,59.13,1,-41593,25895,67488,-15698,0,0,17236,0,0,,17236,17236
47,11/20/2018,11,2:30,2:45,51.13,,0,51.13,51.13,1,-50023,24683,74706,-25340,0,0,15876,0,0,,15876,15876
47,11/20/2018,12,2:45,3:00,51.13,,0,51.13,51.13,1,-51458,28158,79616,-23300,0,0,17049,0,0,,17049,17049
47,11/20/2018,13,3:00,3:15,59.13,,0,59.13,59.13,1,-65403,33027,98430,-32376,0,0,17428,0,0,,17428,17428
47,11/20/2018,14,3:15,3:30,55.13,,0,55.13,55.13,1,-50578,37120,87698,-13458,0,0,15492,0,0,,15492,15492
47,11/20/2018,15,3:30,3:45,55.13,47.06,0,47.06,47.06,-1,-39357,41683,81040,2326,0,-2631,259,0,0,,2890,-2372
47,11/20/2018,16,3:45,4:00,47.81,49.3,0,47.81,43.21,2,-44850,37328,82178,-7522,0,-479,73,0,0,,552,-406
47,11/20/2018,17,4:00,4:15,,44.48,0,44.48,44.48,-1,-22595,34462,57057,11867,0,-4593,0,0,0,,4593,-4593
47,11/20/2018,18,4:15,4:30,47.81,47.06,0,47.81,43.17,2,-34016,29149,63165,-4867,0,-1501,149,0,0,,1650,-1352
47,11/20/2018,19,4:30,4:45,49.14,,0,49.14,49.14,1,-35483,28747,64230,-6736,0,0,2172,0,0,,2172,2172
47,11/20/2018,20,4:45,5:00,50.11,,0,50.11,50.11,1,-41501,25321,66822,-16180,0,0,9296,0,0,,9296,9296
47,11/20/2018,21,5:00,5:15,51.13,39.13,0,39.13,39.13,-1,-32860,50435,83295,17575,0,-7525,4307,0,0,,11832,-3218
47,11/20/2018,22,5:15,5:30,47.82,35.58,0,47.82,47.82,1,-40311,40915,81226,604,0,-11711,198,0,0,,11909,-11513
47,11/20/2018,23,5:30,5:45,59.58,,0,59.58,59.58,1,-55955,27476,83431,-28479,0,0,12681,0,0,,12681,12681
47,11/20/2018,24,5:45,6:00,74.13,,0,74.13,74.13,1,-84200,36169,120369,-48031,0,0,35943,0,0,,35943,35943
47,11/20/2018,25,6:00,6:15,47.66,-97.04,0,49.04,-97.04,2,-27161,82681,109842,55520,0,-22330,7506,0,0,,29836,-14824
47,11/20/2018,26,6:15,6:30,55.43,46.76,0,55.43,46.76,2,-69179,66503,135682,-2676,0,-2091,719,0,0,,2810,-1372
47,11/20/2018,27,6:30,6:45,62.99,,0,62.99,62.99,1,-77501,44642,122143,-32859,0,0,25730,0,0,,25730,25730
47,11/20/2018,28,6:45,7:00,51.66,,0,51.66,51.66,1,-112737,92113,204850,-20624,0,0,25656,0,0,,25656,25656
47,11/20/2018,29,7:00,7:15,55.66,45.28,0,55.66,45.28,2,-107093,92552,199645,-14541,0,-848,9976,0,0,,10824,9128
47,11/20/2018,30,7:15,7:30,101.2,45.28,0,101.2,101.2,1,-94709,62735,157444,-31974,0,-37,3216,0,0,,3253,3179
47,11/20/2018,31,7:30,7:45,450,,0,450,450,1,-143882,75748,219630,-68134,0,0,56641,0,0,,56641,56641
47,11/20/2018,32,7:45,8:00,73.6,,0,73.6,73.6,1,-152191,101755,253946,-50436,0,0,46132,0,0,,46132,46132
47,11/20/2018,33,8:00,8:15,56.58,46.78,0,46.78,46.78,-1,-104646,108183,212829,3537,0,-1197,14895,0,0,,16092,13698
47,11/20/2018,34,8:15,8:30,94.9,47.53,0,94.9,94.9,1,-118593,85004,203597,-33589,0,-105,10014,0,0,,10119,9909
47,11/20/2018,35,8:30,8:45,93.12,,0,93.12,93.12,1,-124405,75549,199954,-48856,0,0,38864,0,0,,38864,38864
47,11/20/2018,36,8:45,9:00,212.32,,0,212.32,212.32,1,-154027,71844,225871,-82183,0,0,58458,0,0,,58458,58458
47,11/20/2018,37,9:00,9:15,212.32,35.66,0,35.66,35.66,-1,-81614,122612,204226,40998,0,-3923,24371,0,0,,28294,20448
47,11/20/2018,38,9:15,9:30,48.07,23.27,0,48.18,23.27,2,-92649,93938,186587,1289,0,-13971,461,0,0,,14432,-13510
47,11/20/2018,39,9:30,9:45,56.58,23.27,0,56.58,56.58,1,-116845,97027,213872,-19818,0,-5,4570,0,0,,4575,4565
47,11/20/2018,40,9:45,10:00,50.65,,0,50.65,50.65,1,-116930,96434,213364,-20496,0,0,11682,0,0,,11682,11682
47,11/20/2018,41,10:00,10:15,80.13,,0,80.13,80.13,1,-119223,74684,193907,-44539,0,0,24673,0,0,,24673,24673
47,11/20/2018,42,10:15,10:30,88.57,,0,88.57,88.57,1,-121926,64586,186512,-57340,0,0,36730,0,0,,36730,36730
47,11/20/2018,43,10:30,10:45,151.12,,0,151.12,151.12,1,-134188,77147,211335,-57041,0,0,50825,0,0,,50825,50825
47,11/20/2018,44,10:45,11:00,58.58,,0,58.58,58.58,1,-132651,86316,218967,-46335,0,0,39185,0,0,,39185,39185
47,11/20/2018,45,11:00,11:15,201.79,,0,201.79,201.79,1,-153668,70521,224189,-83147,0,0,55050,0,0,,55050,55050
47,11/20/2018,46,11:15,11:30,72.95,,0,72.95,72.95,1,-129303,79841,209144,-49462,0,0,34458,0,0,,34458,34458
47,11/20/2018,47,11:30,11:45,118.12,,0,118.12,118.12,1,-149387,79181,228568,-70206,0,0,40433,0,0,,40433,40433
47,11/20/2018,48,11:45,12:00,79.06,,0,79.06,79.06,1,-152512,82440,234952,-70072,0,0,60727,0,0,,60727,60727
47,11/20/2018,49,12:00,12:15,201.39,,0,201.39,201.39,1,-179018,66941,245959,-112077,0,0,67781,0,0,,67781,67781
47,11/20/2018,50,12:15,12:30,150.29,,0,150.29,150.29,1,-134044,78907,212951,-55137,0,0,29627,1250,0,,30877,30877
47,11/20/2018,51,12:30,12:45,93.37,50.38,0,93.37,93.37,1,-114696,74626,189322,-40070,0,-2,8693,0,0,,8695,8691
47,11/20/2018,52,12:45,13:00,130.89,,0,130.89,130.89,1,-126192,67158,193350,-59034,0,0,27027,0,0,,27027,27027
47,11/20/2018,53,13:00,13:15,134.12,,0,134.12,134.12,1,-122697,70667,193364,-52030,0,0,11288,0,0,,11288,11288
47,11/20/2018,54,13:15,13:30,204.53,,0,204.53,204.53,1,-126565,71175,197740,-55390,0,0,22817,0,0,,22817,22817
47,11/20/2018,55,13:30,13:45,47.45,,0,47.45,47.45,1,-122592,73960,196552,-48632,0,0,478,0,0,,478,478
47,11/20/2018,56,13:45,14:00,52.7,,0,52.7,52.7,1,-120959,67019,187978,-53940,0,0,1038,0,0,,1038,1038
47,11/20/2018,57,14:00,14:15,90.83,,0,90.83,90.83,1,-113875,59280,173155,-54595,0,0,9380,0,0,,9380,9380
47,11/20/2018,58,14:15,14:30,103.23,,0,103.23,103.23,1,-104762,68731,173493,-36031,0,0,33795,0,0,,33795,33795
47,11/20/2018,59,14:30,14:45,53.7,,0,53.7,53.7,1,-99521,70689,170210,-28832,0,0,17766,0,0,,17766,17766
47,11/20/2018,60,14:45,15:00,,,0,49.01,49.01,0,-108340,66116,174456,-42224,0,0,2143,0,0,,2143,2143
47,11/20/2018,61,15:00,15:15,,46.54,0,46.54,46.54,-1,-67252,71355,138607,4103,0,-3511,0,0,0,,3511,-3511
47,11/20/2018,62,15:15,15:30,72.95,46,0,72.95,72.95,1,-74698,45924,120622,-28774,0,-1446,10641,0,0,,12087,9195
47,11/20/2018,63,15:30,15:45,135.02,,0,135.02,135.02,1,-90288,61724,152012,-28564,0,0,28445,0,0,,28445,28445
47,11/20/2018,64,15:45,16:00,56.58,,0,56.58,56.58,1,-84664,65190,149854,-19474,0,0,17501,0,0,,17501,17501
47,11/20/2018,65,16:00,16:15,56.58,-26.24,0,-26.24,-26.24,-1,-46368,83632,130000,37264,0,-15381,3956,0,0,,19337,-11425
47,11/20/2018,66,16:15,16:30,47.45,47.42,0,47.45,47.45,1,-41549,53508,95057,11959,0,-3397,1,0,0,,3398,-3396
47,11/20/2018,67,16:30,16:45,85.28,,0,85.28,85.28,1,-73343,40956,114299,-32387,0,0,9107,0,0,,9107,9107
47,11/20/2018,68,16:45,17:00,256.91,,0,256.91,256.91,1,-139556,56169,195725,-83387,0,0,65747,0,0,,65747,65747
47,11/20/2018,69,17:00,17:15,83.12,45.95,0,45.95,45.95,-1,-79489,74819,154308,-4670,0,-651,25223,0,0,,25874,24572
47,11/20/2018,70,17:15,17:30,85.45,45.95,0,85.45,85.45,1,-116782,64932,181714,-51850,0,-24,19355,0,0,,19379,19331
47,11/20/2018,71,17:30,17:45,63.02,,0,63.02,63.02,1,-121071,75799,196870,-45272,0,0,29237,0,0,,29237,29237
47,11/20/2018,72,17:45,18:00,58.7,,0,58.7,58.7,1,-112253,93070,205323,-19183,0,0,21334,0,0,,21334,21334
47,11/20/2018,73,18:00,18:15,78.67,,0,78.67,78.67,1,-158929,78417,237346,-80512,0,0,20512,0,0,,20512,20512
47,11/20/2018,74,18:15,18:30,50.39,,0,50.39,50.39,1,-141452,80481,221933,-60971,0,0,9310,0,0,,9310,9310
47,11/20/2018,75,18:30,18:45,47.45,,0,47.45,47.45,1,-119281,81768,201049,-37513,0,0,1770,0,0,,1770,1770
47,11/20/2018,76,18:45,19:00,51.55,,0,51.55,51.55,1,-117293,73486,190779,-43807,0,0,3834,0,0,,3834,3834
47,11/20/2018,77,19:00,19:15,99.69,,0,99.69,99.69,1,-169042,94695,263737,-74347,0,0,18646,0,0,,18646,18646
47,11/20/2018,78,19:15,19:30,50.43,,0,50.43,50.43,1,-155350,89033,244383,-66317,0,0,8966,0,0,,8966,8966
47,11/20/2018,79,19:30,19:45,,,0,29.41,29.41,0,-135599,88016,223615,-47583,0,0,3,0,0,,3,3
47,11/20/2018,80,19:45,20:00,,,0,29.41,29.41,0,-133285,82512,215797,-50773,0,0,0,0,0,,0,0
47,11/20/2018,81,20:00,20:15,52.8,,0,52.8,52.8,1,-94636,54304,148940,-40332,0,0,4316,0,0,,4316,4316
47,11/20/2018,82,20:15,20:30,57.24,,0,57.24,57.24,1,-86412,69707,156119,-16705,0,0,6938,0,0,,6938,6938
47,11/20/2018,83,20:30,20:45,57.24,43.03,0,43.03,43.03,-1,-61283,83867,145150,22584,0,-10799,404,0,0,,11203,-10395
47,11/20/2018,84,20:45,21:00,,43.6,0,43.6,43.6,-1,-75321,89197,164518,13876,0,-13773,0,0,0,,13773,-13773
47,11/20/2018,85,21:00,21:15,80.38,43.6,0,80.38,30.3,2,-101626,83997,185623,-17629,0,-2367,4526,0,0,,6893,2159
47,11/20/2018,86,21:15,21:30,107.25,,0,107.25,107.25,1,-86803,56122,142925,-30681,0,0,28066,0,0,,28066,28066
47,11/20/2018,87,21:30,21:45,107.25,49.93,0,49.93,49.93,-1,-57744,58114,115858,370,0,-1810,3703,0,0,,5513,1893
47,11/20/2018,88,21:45,22:00,47.66,49.93,0,47.66,43.9,2,-59839,52911,112750,-6928,0,-813,649,0,0,,1462,-164
47,11/20/2018,89,22:00,22:15,79.06,,0,79.06,79.06,1,-105315,55315,160630,-50000,0,0,21398,0,0,,21398,21398
47,11/20/2018,90,22:15,22:30,55.12,,0,55.12,55.12,1,-81617,43519,125136,-38098,0,0,35310,0,0,,35310,35310
47,11/20/2018,91,22:30,22:45,48.78,33.62,0,33.62,33.62,-1,-44886,61221,106107,16335,0,-7041,8057,0,0,,15098,1016
47,11/20/2018,92,22:45,23:00,,31.9,0,31.9,31.9,-1,-39861,68526,108387,28665,0,-23382,0,0,0,,23382,-23382
47,11/20/2018,93,23:00,23:15,72.95,42.82,0,72.95,42.82,2,-72130,46669,118799,-25461,0,-8843,7866,0,0,,16709,-977
47,11/20/2018,94,23:15,23:30,72.95,35.66,0,35.66,35.66,-1,-46589,71415,118004,24826,0,-14445,7,0,0,,14452,-14438
47,11/20/2018,95,23:30,23:45,,31.76,0,31.76,31.76,-1,-37037,78717,115754,41680,0,-35079,0,0,0,,35079,-35079
47,11/20/2018,96,23:45,0:00,,11.24,0,11.24,11.24,-1,-31336,98891,130227,67555,0,-61766,0,0,0,,61766,-61766
47,11/21/2018,1,0:00,0:15,66.35,32,0,66.35,66.35,1,-66932,55170,122102,-11762,0,-25799,1249,0,0,,27048,-24550
47,11/21/2018,2,0:15,0:30,111.57,32,0,111.57,111.57,1,-55385,37785,93170,-17600,0,-236,21405,0,0,,21641,21169
47,11/21/2018,3,0:30,0:45,47.66,39.66,0,47.7,39.66,2,-31243,35830,67073,4587,0,-4514,1159,0,0,,5673,-3355
47,11/21/2018,4,0:45,1:00,47.66,31.03,0,31.03,31.03,-1,-23987,47192,71179,23205,0,-6265,71,0,0,,6336,-6194
47,11/21/2018,5,1:00,1:15,51.77,26.36,0,51.77,26.36,2,-37546,31040,68586,-6506,0,-8466,1271,0,0,,9737,-7195
47,11/21/2018,6,1:15,1:30,47.12,,0,47.12,47.12,1,-32111,28321,60432,-3790,0,0,835,0,0,,835,835
47,11/21/2018,7,1:30,1:45,47.12,43.66,0,43.66,43.66,-1,-28511,39336,67847,10825,0,-5189,6,0,0,,5195,-5183
47,11/21/2018,8,1:45,2:00,,20.66,0,20.66,20.66,-1,-22661,54914,77575,32253,0,-16920,0,0,0,,16920,-16920
47,11/21/2018,9,2:00,2:15,66.95,34.22,0,66.95,34.22,2,-31152,20455,51607,-10697,0,-18101,1696,0,0,,19797,-16405
47,11/21/2018,10,2:15,2:30,75.44,41.96,0,75.44,41.96,2,-26501,26536,53037,35,0,-2387,7116,0,0,,9503,4729
47,11/21/2018,11,2:30,2:45,52.8,46.8,0,52.8,52.8,1,-36002,23744,59746,-12258,0,-2037,2364,0,0,,4401,327
47,11/21/2018,12,2:45,3:00,52.8,,0,52.8,52.8,1,-37494,21869,59363,-15625,0,0,6573,0,0,,6573,6573
47,11/21/2018,13,3:00,3:15,52.8,48.15,0,48.15,48.15,-1,-48946,51348,100294,2402,0,-277,996,0,0,,1273,719
47,11/21/2018,14,3:15,3:30,49.03,,0,49.03,49.03,1,-51469,39520,90989,-11949,0,0,2601,0,0,,2601,2601
47,11/21/2018,15,3:30,3:45,52.8,,0,52.8,52.8,1,-54774,35514,90288,-19260,0,0,8324,0,0,,8324,8324
47,11/21/2018,16,3:45,4:00,61.57,,0,61.57,61.57,1,-66281,19703,85984,-46578,0,0,30688,0,0,,30688,30688
47,11/21/2018,17,4:00,4:15,52.8,,0,52.8,52.8,1,-49356,18343,67699,-31013,0,0,24489,0,0,,24489,24489
47,11/21/2018,18,4:15,4:30,75.02,,0,75.02,75.02,1,-73502,16404,89906,-57098,0,0,41936,0,0,,41936,41936
47,11/21/2018,19,4:30,4:45,71.55,,0,71.55,71.55,1,-86597,22065,108662,-64532,0,0,56344,0,0,,56344,56344
47,11/21/2018,20,4:45,5:00,74.72,,0,74.72,74.72,1,-94273,21804,116077,-72469,0,0,63761,0,0,,63761,63761
47,11/21/2018,21,5:00,5:15,90.43,,0,90.43,90.43,1,-90920,29342,120262,-61578,0,0,60368,0,0,,60368,60368
47,11/21/2018,22,5:15,5:30,212.33,,0,212.33,212.33,1,-113896,15708,129604,-98188,0,0,54876,0,0,,54876,54876
47,11/21/2018,23,5:30,5:45,244.65,,0,244.65,244.65,1,-135778,33693,169471,-102085,0,0,97225,2500,0,,99725,99725
47,11/21/2018,24,5:45,6:00,247.15,,0,247.15,247.15,1,-115868,61087,176955,-54781,0,0,57264,3750,0,,61014,61014
47,11/21/2018,25,6:00,6:15,247.15,32.89,0,32.89,32.89,-1,-118897,130759,249656,11862,0,-7223,5800,0,0,,13023,-1423
47,11/21/2018,26,6:15,6:30,79.87,,0,79.87,79.87,1,-108996,47331,156327,-61665,0,0,16930,0,0,,16930,16930
47,11/21/2018,27,6:30,6:45,207.94,,0,207.94,207.94,1,-138276,42769,181045,-95507,0,0,54272,0,0,,54272,54272
47,11/21/2018,28,6:45,7:00,207.94,,0,207.94,207.94,1,-175830,113163,288993,-62667,0,0,56077,0,0,,56077,56077
47,11/21/2018,29,7:00,7:15,72.96,44.51,0,72.96,44.51,2,-143473,126904,270377,-16569,0,-1619,22939,0,0,,24558,21320
47,11/21/2018,30,7:15,7:30,254.25,44.51,0,254.25,254.25,1,-177724,72845,250569,-104879,0,-50,35883,0,0,,35933,35833
47,11/21/2018,31,7:30,7:45,450,,0,495,495,1,-256874,93032,349906,-163842,0,0,89423,0,7500,,96923,96923
47,11/21/2018,32,7:45,8:00,450,,0,495,495,1,-290787,99723,390510,-191064,0,0,93241,0,45146,,138387,138387
47,11/21/2018,33,8:00,8:15,450,-85.5,0,-85.5,-85.5,-1,-137567,148686,286253,11119,0,-26831,25483,0,83837,,136151,82489
47,11/21/2018,34,8:15,8:30,268.78,-85.5,0,268.78,268.78,1,-161790,90573,252363,-71217,0,-1831,40157,0,0,,41988,38326
47,11/21/2018,35,8:30,8:45,450,,0,450,450,1,-175622,88613,264235,-87009,0,0,71301,0,0,,71301,71301
47,11/21/2018,36,8:45,9:00,174.69,,0,174.69,174.69,1,-177509,101378,278887,-76131,0,0,69248,0,0,,69248,69248
47,11/21/2018,37,9:00,9:15,267.01,,0,267.01,267.01,1,-214218,111731,325949,-102487,0,0,76452,0,0,,76452,76452
47,11/21/2018,38,9:15,9:30,267.01,,0,267.01,267.01,1,-223541,117745,341286,-105796,0,0,81508,0,0,,81508,81508
47,11/21/2018,39,9:30,9:45,350.02,,0,350.02,350.02,1,-222523,121278,343801,-101245,0,0,82713,3750,0,,86463,86463
47,11/21/2018,40,9:45,10:00,274.9,,0,274.9,274.9,1,-217018,137825,354843,-79193,0,0,71044,3750,0,,74794,74794
47,11/21/2018,41,10:00,10:15,49.4,36.84,0,57.81,36.84,2,-122713,131694,254407,8981,0,-4000,19214,0,0,,23214,15214
47,11/21/2018,42,10:15,10:30,57.96,,0,57.96,57.96,1,-113195,85818,199013,-27377,0,0,16111,0,0,,16111,16111
47,11/21/2018,43,10:30,10:45,75.27,,0,75.27,75.27,1,-113018,76190,189208,-36828,0,0,13578,0,0,,13578,13578
47,11/21/2018,44,10:45,11:00,78.16,,0,78.16,78.16,1,-124720,71136,195856,-53584,0,0,26834,0,0,,26834,26834
47,11/21/2018,45,11:00,11:15,79.04,,0,79.04,79.04,1,-112603,37379,149982,-75224,0,0,32220,0,0,,32220,32220
47,11/21/2018,46,11:15,11:30,90.82,,0,90.82,90.82,1,-111034,39466,150500,-71568,0,0,45309,0,0,,45309,45309
47,11/21/2018,47,11:30,11:45,80.46,,0,80.46,80.46,1,-117972,39115,157087,-78857,0,0,49196,0,0,,49196,49196
47,11/21/2018,48,11:45,12:00,128.2,,0,128.2,128.2,1,-124403,41420,165823,-82983,0,0,54041,0,0,,54041,54041
47,11/21/2018,49,12:00,12:15,255.44,,0,255.44,255.44,1,-191259,65281,256540,-125978,0,0,68977,0,0,,68977,68977
47,11/21/2018,50,12:15,12:30,72.96,,0,72.96,72.96,1,-163972,85581,249553,-78391,0,0,17138,0,0,,17138,17138
47,11/21/2018,51,12:30,12:45,86.01,,0,86.01,86.01,1,-166266,75046,241312,-91220,0,0,34692,0,0,,34692,34692
47,11/21/2018,52,12:45,13:00,144.02,,0,144.02,144.02,1,-173204,76089,249293,-97115,0,0,48194,0,0,,48194,48194
47,11/21/2018,53,13:00,13:15,264,,0,264,264,1,-204698,79829,284527,-124869,0,0,65734,0,0,,65734,65734
47,11/21/2018,54,13:15,13:30,90.99,,0,90.99,90.99,1,-221891,83961,305852,-137930,0,0,46131,0,0,,46131,46131
47,11/21/2018,55,13:30,13:45,264,,0,264,264,1,-236791,64675,301466,-172116,0,0,74541,0,0,,74541,74541
47,11/21/2018,56,13:45,14:00,264,,0,290.4,290.4,1,-270649,37087,307736,-233562,0,0,93815,0,0,,93815,93815
47,11/21/2018,57,14:00,14:15,274.03,,0,301.43,301.43,1,-301076,47556,348632,-253520,0,0,87890,0,87498,,175388,175388
47,11/21/2018,58,14:15,14:30,274.03,,0,301.43,301.43,1,-278422,50959,329381,-227463,0,0,86222,0,87498,,173720,173720
47,11/21/2018,59,14:30,14:45,274.03,,0,301.43,301.43,1,-255653,49574,305227,-206079,0,0,86195,0,103599,,189794,189794
47,11/21/2018,60,14:45,15:00,277,,0,304.7,304.7,1,-229960,48417,278377,-181543,0,0,68643,3750,113325,,185718,185718
47,11/21/2018,61,15:00,15:15,52.81,,0,276.43,276.43,1,-209680,94851,304531,-114829,0,0,13843,0,98325,,112168,112168
47,11/21/2018,62,15:15,15:30,111.02,,0,276.43,276.43,1,-232040,86474,318514,-145566,0,0,26232,0,90825,,117057,117057
47,11/21/2018,63,15:30,15:45,376.43,,0,376.43,376.43,1,-243514,93626,337140,-149888,0,0,70427,5000,21666,,97093,97093
47,11/21/2018,64,15:45,16:00,450,,0,450,450,1,-205403,97883,303286,-107520,0,0,89577,5000,0,,94577,94577
47,11/21/2018,65,16:00,16:15,377.14,,0,377.14,377.14,1,-167161,126368,293529,-40793,0,0,36539,5000,0,,41539,41539
47,11/21/2018,66,16:15,16:30,274.49,,0,274.49,274.49,1,-178796,108777,287573,-70019,0,0,20075,0,0,,20075,20075
47,11/21/2018,67,16:30,16:45,350.02,,0,350.02,350.02,1,-204672,110414,315086,-94258,0,0,76025,3750,0,,79775,79775
47,11/21/2018,68,16:45,17:00,350.02,,0,350.02,350.02,1,-252829,111434,364263,-141395,0,0,85469,3750,0,,89219,89219
47,11/21/2018,69,17:00,17:15,439.98,,0,483.98,483.98,1,-323487,67331,390818,-256156,0,0,92501,5000,0,,97501,97501
47,11/21/2018,70,17:15,17:30,439.98,,0,483.98,483.98,1,-342422,68092,410514,-274330,0,0,93741,3750,64998,,162489,162489
47,11/21/2018,71,17:30,17:45,439.97,,0,483.97,483.97,1,-298238,76960,375198,-221278,0,0,94967,3750,70011,,168728,168728
47,11/21/2018,72,17:45,18:00,450,,0,495,495,1,-276182,93482,369664,-182700,0,0,94880,3750,70011,,168641,168641
47,11/21/2018,73,18:00,18:15,438.92,,0,482.81,482.81,1,-332517,60293,392810,-272224,0,0,96044,5000,70011,,171055,171055
47,11/21/2018,74,18:15,18:30,438.92,,0,482.81,482.81,1,-263916,77795,341711,-186121,0,0,92516,5000,66669,,164185,164185
47,11/21/2018,75,18:30,18:45,415.5,,0,457.05,457.05,1,-233045,104696,337741,-128349,0,0,50194,5000,64998,,120192,120192
47,11/21/2018,76,18:45,19:00,415.5,,0,457.05,457.05,1,-214733,118392,333125,-96341,0,0,15742,5000,54998,,75740,75740
47,11/21/2018,77,19:00,19:15,350.02,,0,385.02,385.02,1,-233470,129739,363209,-103731,0,0,33221,3750,34998,,71969,71969
47,11/21/2018,78,19:15,19:30,280,,0,308,308,1,-222487,161569,384056,-60918,0,0,8578,3750,23332,,35660,35660
47,11/21/2018,79,19:30,19:45,48.11,,0,48.11,48.11,1,-201226,172060,373286,-29166,0,0,1607,0,0,,1607,1607
47,11/21/2018,80,19:45,20:00,60,,0,60,60,1,-201822,158990,360812,-42832,0,0,9373,0,0,,9373,9373
47,11/21/2018,81,20:00,20:15,60,39.67,0,39.67,39.67,-1,-72018,109240,181258,37222,0,-2021,1540,0,0,,3561,-481
47,11/21/2018,82,20:15,20:30,,39.07,0,39.07,39.07,-1,-77196,103054,180250,25858,0,-7201,0,0,0,,7201,-7201
47,11/21/2018,83,20:30,20:45,,41.92,0,41.92,41.92,-1,-86015,107133,193148,21118,0,-17983,0,0,0,,17983,-17983
47,11/21/2018,84,20:45,21:00,,41.91,0,41.91,41.91,-1,-96011,125352,221363,29341,0,-23193,0,0,0,,23193,-23193
47,11/21/2018,85,21:00,21:15,218.56,43.05,0,218.56,218.56,1,-145318,50697,196015,-94621,0,-8302,26715,0,0,,35017,18413
47,11/21/2018,86,21:15,21:30,77.74,,0,77.74,77.74,1,-93310,57105,150415,-36205,0,0,35594,0,0,,35594,35594
47,11/21/2018,87,21:30,21:45,57.96,,0,57.96,57.96,1,-120039,80441,200480,-39598,0,0,23560,0,0,,23560,23560
47,11/21/2018,88,21:45,22:00,56.65,,0,56.65,56.65,1,-92756,73730,166486,-19026,0,0,18357,0,0,,18357,18357
47,11/21/2018,89,22:00,22:15,203.36,38.04,0,203.36,38.04,2,-85850,50382,136232,-35468,0,-1198,11130,0,0,,12328,9932
47,11/21/2018,90,22:15,22:30,144.07,48.63,0,144.07,47.86,2,-75885,50406,126291,-25479,0,-31,29327,0,0,,29358,29296
47,11/21/2018,91,22:30,22:45,52.81,47.08,0,52.81,47.08,2,-74514,58908,133422,-15606,0,-1233,3204,0,0,,4437,1971
47,11/21/2018,92,22:45,23:00,47.67,43.03,0,48.01,43.03,2,-62218,84069,146287,21851,0,-7735,2091,0,0,,9826,-5644
47,11/21/2018,93,23:00,23:15,197.39,47.83,0,197.39,47.73,2,-130374,30301,160675,-100073,0,-1769,33169,0,0,,34938,31400
47,11/21/2018,94,23:15,23:30,59.07,,0,59.07,59.07,1,-66629,31337,97966,-35292,0,0,39134,0,0,,39134,39134
47,11/21/2018,95,23:30,23:45,48.72,46.9,0,48.72,46.9,2,-59830,51183,111013,-8647,0,-33,8892,0,0,,8925,8859
47,11/21/2018,96,23:45,0:00,48.72,-0.55,0,-0.55,-0.55,-1,-40226,77359,117585,37133,0,-28137,182,0,0,,28319,-27955
47,11/22/2018,1,0:00,0:15,47.76,24.96,0,47.76,24.96,2,-52226,64867,117093,12641,0,-21117,980,0,0,,22097,-20137
47,11/22/2018,2,0:15,0:30,,34.29,0,34.29,34.29,-1,-36340,67189,103529,30849,0,-8059,0,0,0,,8059,-8059
47,11/22/2018,3,0:30,0:45,,35.19,0,35.19,35.19,-1,-27162,51807,78969,24645,0,-13866,0,0,0,,13866,-13866
47,11/22/2018,4,0:45,1:00,,43.42,0,43.42,43.42,-1,-37331,55699,93030,18368,0,-7041,0,0,0,,7041,-7041
47,11/22/2018,5,1:00,1:15,98.31,43.42,0,98.31,98.31,1,-117765,53488,171253,-64277,0,-726,31737,0,0,,32463,31011
47,11/22/2018,6,1:15,1:30,71.27,,0,71.27,71.27,1,-98324,56989,155313,-41335,0,0,31696,0,0,,31696,31696
47,11/22/2018,7,1:30,1:45,47.13,,0,47.13,47.13,1,-61833,49645,111478,-12188,0,0,3930,0,0,,3930,3930
47,11/22/2018,8,1:45,2:00,47.18,47.78,0,47.78,47.78,-1,-48043,44575,92618,-3468,0,-353,99,0,0,,452,-254
47,11/22/2018,9,2:00,2:15,51.42,47.64,0,51.42,47.55,2,-51866,38641,90507,-13225,0,-233,4584,0,0,,4817,4351
47,11/22/2018,10,2:15,2:30,47.12,,0,47.12,47.12,1,-59740,57420,117160,-2320,0,0,893,0,0,,893,893
47,11/22/2018,11,2:30,2:45,48.76,,0,48.76,48.76,1,-61391,51182,112573,-10209,0,0,2111,0,0,,2111,2111
47,11/22/2018,12,2:45,3:00,47.42,47.66,0,47.56,47.56,2,-30889,33190,64079,2301,0,-204,1408,0,0,,1612,1204
47,11/22/2018,13,3:00,3:15,48.48,47.66,0,48.48,48.48,1,-52123,32451,84574,-19672,0,-120,5608,0,0,,5728,5488
47,11/22/2018,14,3:15,3:30,47.42,,0,47.42,47.42,1,-39505,36702,76207,-2803,0,0,2288,0,0,,2288,2288
47,11/22/2018,15,3:30,3:45,,46.01,0,46.01,46.01,-1,-33227,40540,73767,7313,0,-4531,0,0,0,,4531,-4531
47,11/22/2018,16,3:45,4:00,,45.81,0,45.81,45.81,-1,-28861,33010,61871,4149,0,-2952,0,0,0,,2952,-2952
47,11/22/2018,17,4:00,4:15,47.42,45.78,0,47.82,45.78,2,-43079,32934,76013,-10145,0,-1619,1021,0,0,,2640,-598
47,11/22/2018,18,4:15,4:30,,,0,47.82,47.82,0,-32638,29345,61983,-3293,0,0,0,0,0,,0,0
47,11/22/2018,19,4:30,4:45,47.42,,0,47.42,47.42,1,-37646,26256,63902,-11390,0,0,2551,0,0,,2551,2551
47,11/22/2018,20,4:45,5:00,51.42,,0,51.42,51.42,1,-48516,18594,67110,-29922,0,0,15043,0,0,,15043,15043
47,11/22/2018,21,5:00,5:15,51.42,42.12,0,42.12,42.12,-1,-37880,56790,94670,18910,0,-10829,2426,0,0,,13255,-8403
47,11/22/2018,22,5:15,5:30,,43.42,0,43.42,43.42,-1,-45513,35711,81224,-9802,0,-12086,0,0,0,,12086,-12086
47,11/22/2018,23,5:30,5:45,47.13,43.42,0,47.13,47.13,1,-45449,23307,68756,-22142,0,-727,778,0,0,,1505,51
47,11/22/2018,24,5:45,6:00,47.42,38.9,0,38.9,38.9,-1,-56673,71051,127724,14378,0,-3303,574,0,0,,3877,-2729
47,11/22/2018,25,6:00,6:15,,-55.44,0,-55.44,-55.44,-1,-67375,151386,218761,84011,0,-57965,0,0,0,,57965,-57965
47,11/22/2018,26,6:15,6:30,,20.05,0,20.05,20.05,-1,-47866,104035,151901,56169,0,-49418,0,0,0,,49418,-49418
47,11/22/2018,27,6:30,6:45,80.55,33.99,0,80.55,80.55,1,-51876,49040,100916,-2836,0,-30302,842,0,0,,31144,-29460
47,11/22/2018,28,6:45,7:00,151.26,20.05,0,151.26,20.05,2,-124049,31166,155215,-92883,0,-1592,10842,0,0,,12434,9250
47,11/22/2018,29,7:00,7:15,,-97.79,0,-97.79,-97.79,-1,-15667,206082,221749,190415,0,-81951,0,0,0,,81951,-81951
47,11/22/2018,30,7:15,7:30,,2.14,0,2.14,2.14,-1,-43737,73957,117694,30220,0,-57126,0,0,0,,57126,-57126
47,11/22/2018,31,7:30,7:45,80.49,2.14,0,80.49,80.49,1,-98461,52018,150479,-46443,0,-1087,13498,0,0,,14585,12411
47,11/22/2018,32,7:45,8:00,450,,0,450,450,1,-140750,61924,202674,-78826,0,0,55925,0,0,,55925,55925
47,11/22/2018,33,8:00,8:15,450,-97.79,0,-97.79,-97.79,-1,-20932,153439,174371,132507,0,-36831,12459,0,0,,49290,-24372
47,11/22/2018,34,8:15,8:30,,27.21,0,27.21,27.21,-1,-53060,88339,141399,35279,0,-45203,0,0,0,,45203,-45203
47,11/22/2018,35,8:30,8:45,,67.59,0,67.59,67.59,-1,-63099,67932,131031,4833,0,-6369,0,0,0,,6369,-6369
47,11/22/2018,36,8:45,9:00,57.26,,0,57.26,57.26,1,-92467,66006,158473,-26461,0,0,6110,0,0,,6110,6110
47,11/22/2018,37,9:00,9:15,63.39,,0,63.39,63.39,1,-96741,81491,178232,-15250,0,0,19420,0,0,,19420,19420
47,11/22/2018,38,9:15,9:30,57.4,,0,57.4,57.4,1,-101280,76435,177715,-24845,0,0,12783,0,0,,12783,12783
47,11/22/2018,39,9:30,9:45,62.4,,0,62.4,62.4,1,-111350,75452,186802,-35898,0,0,27868,0,0,,27868,27868
47,11/22/2018,40,9:45,10:00,51.12,,0,51.12,51.12,1,-107324,74566,181890,-32758,0,0,9518,0,0,,9518,9518
47,11/22/2018,41,10:00,10:15,450,,0,450,450,1,-145961,54417,200378,-91544,0,0,35184,0,0,,35184,35184
47,11/22/2018,42,10:15,10:30,69.26,67.34,0,67.34,67.34,-1,-101478,86494,187972,-14984,0,-107,18928,0,0,,19035,18821
47,11/22/2018,43,10:30,10:45,450,,0,450,450,1,-120036,69197,189233,-50839,0,0,26985,0,0,,26985,26985
47,11/22/2018,44,10:45,11:00,72.57,,0,72.57,72.57,1,-116210,90747,206957,-25463,0,0,31854,0,0,,31854,31854
47,11/22/2018,45,11:00,11:15,94.12,,0,94.12,94.12,1,-146885,34819,181704,-112066,0,0,31757,0,0,,31757,31757
47,11/22/2018,46,11:15,11:30,450,,0,450,450,1,-154825,37275,192100,-117550,0,0,48335,0,0,,48335,48335
47,11/22/2018,47,11:30,11:45,54.21,,0,54.21,54.21,1,-124118,38063,162181,-86055,0,0,10234,0,0,,10234,10234
47,11/22/2018,48,11:45,12:00,450,,0,450,450,1,-134464,15050,149514,-119414,0,0,32966,0,0,,32966,32966
47,11/22/2018,49,12:00,12:15,140.87,,0,140.87,140.87,1,-118506,76412,194918,-42094,0,0,43256,0,0,,43256,43256
47,11/22/2018,50,12:15,12:30,140.87,45.23,0,45.23,45.23,-1,-98789,75037,173826,-23752,0,-583,4130,0,0,,4713,3547
47,11/22/2018,51,12:30,12:45,50.87,,0,50.87,50.87,1,-106864,61254,168118,-45610,0,0,530,0,0,,530,530
47,11/22/2018,52,12:45,13:00,47.54,,0,47.54,47.54,1,-112287,57750,170037,-54537,0,0,186,0,0,,186,186
47,11/22/2018,53,13:00,13:15,57.07,,0,57.07,57.07,1,-114404,96275,210679,-18129,0,0,1363,0,0,,1363,1363
47,11/22/2018,54,13:15,13:30,63.34,,0,63.34,63.34,1,-131076,89815,220891,-41261,0,0,14265,0,0,,14265,14265
47,11/22/2018,55,13:30,13:45,65.16,,0,65.16,65.16,1,-140720,93991,234711,-46729,0,0,22545,0,0,,22545,22545
47,11/22/2018,56,13:45,14:00,64.36,,0,64.36,64.36,1,-155808,103992,259800,-51816,0,0,24847,0,0,,24847,24847
47,11/22/2018,57,14:00,14:15,75.53,,0,75.53,75.53,1,-150567,89166,239733,-61401,0,0,32427,0,0,,32427,32427
47,11/22/2018,58,14:15,14:30,65.25,,0,65.25,65.25,1,-152451,88082,240533,-64369,0,0,31631,0,0,,31631,31631
47,11/22/2018,59,14:30,14:45,55.53,,0,55.53,55.53,1,-158181,88756,246937,-69425,0,0,16088,0,0,,16088,16088
47,11/22/2018,60,14:45,15:00,,,0,57.76,57.76,0,-166193,85999,252192,-80194,0,0,630,0,0,,630,630
47,11/22/2018,61,15:00,15:15,450,,0,450,450,1,-120849,71731,192580,-49118,0,0,21075,0,0,,21075,21075
47,11/22/2018,62,15:15,15:30,62.72,,0,62.72,62.72,1,-100155,89401,189556,-10754,0,0,5482,0,0,,5482,5482
47,11/22/2018,63,15:30,15:45,119.12,,0,119.12,119.12,1,-118027,70818,188845,-47209,0,0,33052,0,0,,33052,33052
47,11/22/2018,64,15:45,16:00,65,,0,65,65,1,-111961,67334,179295,-44627,0,0,41491,0,0,,41491,41491
47,11/22/2018,65,16:00,16:15,65,35.05,0,35.05,35.05,-1,-53947,123444,177391,69497,0,-8663,10077,0,0,,18740,1414
47,11/22/2018,66,16:15,16:30,,44.78,0,44.78,44.78,-1,-67703,94243,161946,26540,0,-14394,0,0,0,,14394,-14394
47,11/22/2018,67,16:30,16:45,56.09,44.78,0,56.09,56.09,1,-86941,83372,170313,-3569,0,-2475,511,0,0,,2986,-1964
47,11/22/2018,68,16:45,17:00,450,,0,450,450,1,-139383,67786,207169,-71597,0,0,32738,0,0,,32738,32738
47,11/22/2018,69,17:00,17:15,450,44.94,0,450,44.94,2,-59532,46069,105601,-13463,0,-2326,28291,0,0,,30617,25965
47,11/22/2018,70,17:15,17:30,135,44.94,0,135,135,1,-70077,46424,116501,-23653,0,-242,7159,0,0,,7401,6917
47,11/22/2018,71,17:30,17:45,135,67.48,0,135,59.8,2,-73765,61594,135359,-12171,0,-8,14766,0,0,,14774,14758
47,11/22/2018,72,17:45,18:00,135,43.05,0,135,43.05,2,-59453,84714,144167,25261,0,-2590,876,0,0,,3466,-1714
47,11/22/2018,73,18:00,18:15,450,43.05,0,450,450,1,-123863,35064,158927,-88799,0,-63,42859,0,0,,42922,42796
47,11/22/2018,74,18:15,18:30,71.07,67.44,0,67.44,67.44,-1,-74878,65231,140109,-9647,0,-7,12374,0,0,,12381,12367
47,11/22/2018,75,18:30,18:45,71.07,48.94,0,48.94,48.94,-1,-52265,56662,108927,4397,0,-2061,110,0,0,,2171,-1951
47,11/22/2018,76,18:45,19:00,,66.78,0,66.78,66.78,-1,-50833,52420,103253,1587,0,-1644,0,0,0,,1644,-1644
47,11/22/2018,77,19:00,19:15,105,66.68,0,105,59.17,2,-87249,47113,134362,-40136,0,-238,17780,0,0,,18018,17542
47,11/22/2018,78,19:15,19:30,64.52,,0,64.52,64.52,1,-61707,54603,116310,-7104,0,0,7046,0,0,,7046,7046
47,11/22/2018,79,19:30,19:45,,67.76,0,67.76,67.76,-1,-56238,58326,114564,2088,0,-1865,0,0,0,,1865,-1865
47,11/22/2018,80,19:45,20:00,,45.78,0,45.78,45.78,-1,-54033,68914,122947,14881,0,-8932,0,0,0,,8932,-8932
47,11/22/2018,81,20:00,20:15,266.92,45.78,0,266.92,266.92,1,-140356,10308,150664,-130048,0,-3257,41475,0,0,,44732,38218
47,11/22/2018,82,20:15,20:30,289.9,,0,289.9,289.9,1,-91559,24236,115795,-67323,0,0,72918,3750,0,,76668,76668
47,11/22/2018,83,20:30,20:45,289.9,33.87,0,33.87,33.87,-1,-32338,56548,88886,24210,0,-12213,9168,0,0,,21381,-3045
47,11/22/2018,84,20:45,21:00,,43.05,0,43.05,43.05,-1,-32596,39884,72480,7288,0,-12006,0,0,0,,12006,-12006
47,11/22/2018,85,21:00,21:15,47.05,43.05,0,47.05,47.05,1,-63037,22062,85099,-40975,0,-884,1425,0,0,,2309,541
47,11/22/2018,86,21:15,21:30,51.05,,0,51.05,51.05,1,-57616,36375,93991,-21241,0,0,4221,0,0,,4221,4221
47,11/22/2018,87,21:30,21:45,47.23,,0,47.23,47.23,1,-52327,41908,94235,-10419,0,0,837,0,0,,837,837
47,11/22/2018,88,21:45,22:00,,48.36,0,48.36,48.36,-1,-46386,45937,92323,-449,0,-642,0,0,0,,642,-642
47,11/22/2018,89,22:00,22:15,129.12,45.95,0,129.12,30.5,2,-91944,15938,107882,-76006,0,-1542,17688,0,0,,19230,16146
47,11/22/2018,90,22:15,22:30,62.96,,0,62.96,62.96,1,-89956,19897,109853,-70059,0,0,42308,0,0,,42308,42308
47,11/22/2018,91,22:30,22:45,,,0,30.5,30.5,0,-86367,30753,117120,-55614,0,0,6261,0,0,,6261,6261
47,11/22/2018,92,22:45,23:00,,,0,30.5,30.5,0,-85061,48870,133931,-36191,0,0,0,0,0,,0,0
47,11/22/2018,93,23:00,23:15,95.12,,0,95.12,95.12,1,-130530,23345,153875,-107185,0,0,16059,0,0,,16059,16059
47,11/22/2018,94,23:15,23:30,50.45,,0,50.45,50.45,1,-89192,21183,110375,-68009,0,0,3716,0,0,,3716,3716
47,11/22/2018,95,23:30,23:45,47.05,,0,47.05,47.05,1,-52237,26967,79204,-25270,0,0,738,0,0,,738,738
47,11/22/2018,96,23:45,0:00,47.05,27.23,0,27.23,27.23,-1,-44238,79393,123631,35155,0,-9517,9,0,0,,9526,-9508
47,11/23/2018,1,0:00,0:15,80.12,16.18,0,80.12,16.18,2,-66306,43763,110069,-22543,0,-12153,5716,0,0,,17869,-6437
47,11/23/2018,2,0:15,0:30,51.52,,0,51.52,51.52,1,-68551,33720,102271,-34831,0,0,16515,0,0,,16515,16515
47,11/23/2018,3,0:30,0:45,51.52,46.96,0,46.96,46.96,-1,-46044,35813,81857,-10231,0,-978,2543,0,0,,3521,1565
47,11/23/2018,4,0:45,1:00,,,0,48.56,48.56,0,-68509,57473,125982,-11036,0,0,0,0,0,,0,0
47,11/23/2018,5,1:00,1:15,71.57,,0,71.57,71.57,1,-66860,23210,90070,-43650,0,0,13069,0,0,,13069,13069
47,11/23/2018,6,1:15,1:30,51.59,48.52,0,48.52,48.52,-1,-49914,41125,91039,-8789,0,-89,15041,0,0,,15130,14952
47,11/23/2018,7,1:30,1:45,51.59,43.52,0,43.52,43.52,-1,-41881,53933,95814,12052,0,-11396,311,0,0,,11707,-11085
47,11/23/2018,8,1:45,2:00,,39.52,0,39.52,39.52,-1,-38734,67707,106441,28973,0,-17133,0,0,0,,17133,-17133
47,11/23/2018,9,2:00,2:15,51.52,35.52,0,51.52,35.52,2,-51900,52409,104309,509,0,-20960,394,0,0,,21354,-20566
47,11/23/2018,10,2:15,2:30,53.66,35.52,0,53.66,53.66,1,-46513,40335,86848,-6178,0,-489,1999,0,0,,2488,1510
47,11/23/2018,11,2:30,2:45,,48.5,0,48.5,48.5,-1,-41854,41802,83656,-52,0,-222,0,0,0,,222,-222
47,11/23/2018,12,2:45,3:00,,46.88,0,46.88,46.88,-1,-38926,43603,82529,4677,0,-4005,0,0,0,,4005,-4005
47,11/23/2018,13,3:00,3:15,55.52,46.88,0,55.52,55.52,1,-55144,32881,88025,-22263,0,-660,8994,0,0,,9654,8334
47,11/23/2018,14,3:15,3:30,51.52,,0,51.52,51.52,1,-49033,38891,87924,-10142,0,0,8617,0,0,,8617,8617
47,11/23/2018,15,3:30,3:45,47.52,,0,47.52,47.52,1,-45664,28627,74291,-17037,0,0,2012,0,0,,2012,2012
47,11/23/2018,16,3:45,4:00,47.52,46.83,0,48.53,46.83,2,-46786,41543,88329,-5243,0,-100,971,0,0,,1071,871
47,11/23/2018,17,4:00,4:15,,46.93,0,46.93,46.93,-1,-43534,40685,84219,-2849,0,-411,0,0,0,,411,-411
47,11/23/2018,18,4:15,4:30,,43.65,0,43.65,43.65,-1,-40435,48489,88924,8054,0,-9046,0,0,0,,9046,-9046
47,11/23/2018,19,4:30,4:45,50.88,46.85,0,50.88,50.88,1,-41062,32909,73971,-8153,0,-3983,1064,0,0,,5047,-2919
47,11/23/2018,20,4:45,5:00,50.5,46.85,0,50.5,50.5,1,-40157,18910,59067,-21247,0,-8,5194,0,0,,5202,5186
47,11/23/2018,21,5:00,5:15,51.52,,0,51.52,51.52,1,-76280,46482,122762,-29798,0,0,2537,0,0,,2537,2537
47,11/23/2018,22,5:15,5:30,47.69,,0,47.69,47.69,1,-73764,28241,102005,-45523,0,0,2574,0,0,,2574,2574
47,11/23/2018,23,5:30,5:45,88.29,,0,88.29,88.29,1,-86723,14825,101548,-71898,0,0,21300,0,0,,21300,21300
47,11/23/2018,24,5:45,6:00,226.63,,0,226.63,226.63,1,-100003,14142,114145,-85861,0,0,57726,0,0,,57726,57726
47,11/23/2018,25,6:00,6:15,226.63,-15.66,0,-15.66,-15.66,-1,-83040,147739,230779,64699,0,-21502,6369,0,0,,27871,-15133
47,11/23/2018,26,6:15,6:30,47.73,47.49,0,47.73,47.73,1,-80281,65546,145827,-14735,0,-4758,2,0,0,,4760,-4756
47,11/23/2018,27,6:30,6:45,87.3,,0,87.3,87.3,1,-86815,27444,114259,-59371,0,0,7825,0,0,,7825,7825
47,11/23/2018,28,6:45,7:00,450,,0,450,450,1,-138560,39877,178437,-98683,0,0,56482,0,0,,56482,56482
47,11/23/2018,29,7:00,7:15,450,-98.01,0,-98.01,-98.01,-1,-13227,211190,224417,197963,0,-39392,13855,0,0,,53247,-25537
47,11/23/2018,30,7:15,7:30,51.79,17.72,0,51.79,51.79,1,-48215,78844,127059,30629,0,-42896,182,0,0,,43078,-42714
47,11/23/2018,31,7:30,7:45,71.79,17.72,0,71.79,71.79,1,-105604,43206,148810,-62398,0,-183,23898,0,0,,24081,23715
47,11/23/2018,32,7:45,8:00,450,,0,450,450,1,-157912,39381,197293,-118531,0,0,39992,0,0,,39992,39992
47,11/23/2018,33,8:00,8:15,66,34.37,0,34.37,34.37,-1,-19684,72407,92091,52723,0,-6858,11301,0,0,,18159,4443
47,11/23/2018,34,8:15,8:30,,50.99,0,50.99,50.99,-1,-45904,41433,87337,-4471,0,-8264,0,0,0,,8264,-8264
47,11/23/2018,35,8:30,8:45,206,50.99,0,206,206,1,-84259,30094,114353,-54165,0,-82,18627,0,0,,18709,18545
47,11/23/2018,36,8:45,9:00,106,,0,106,106,1,-107579,32907,140486,-74672,0,0,40512,0,0,,40512,40512
47,11/23/2018,37,9:00,9:15,71.09,65.37,0,65.37,65.37,-1,-63565,59867,123432,-3698,0,-184,17967,0,0,,18151,17783
47,11/23/2018,38,9:15,9:30,68,65.37,0,68,68,1,-86110,54333,140443,-31777,0,-1,12790,0,0,,12791,12789
47,11/23/2018,39,9:30,9:45,71.18,,0,71.18,71.18,1,-98738,54672,153410,-44066,0,0,30758,0,0,,30758,30758
47,11/23/2018,40,9:45,10:00,58,,0,58,58,1,-94794,55880,150674,-38914,0,0,20096,0,0,,20096,20096
47,11/23/2018,41,10:00,10:15,97.17,,0,97.17,97.17,1,-141020,63116,204136,-77904,0,0,15914,0,0,,15914,15914
47,11/23/2018,42,10:15,10:30,67.17,,0,67.17,67.17,1,-118560,64245,182805,-54315,0,0,9885,0,0,,9885,9885
47,11/23/2018,43,10:30,10:45,60.68,,0,60.68,60.68,1,-110834,63524,174358,-47310,0,0,19096,0,0,,19096,19096
47,11/23/2018,44,10:45,11:00,57.17,,0,57.17,57.17,1,-105770,64681,170451,-41089,0,0,15271,0,0,,15271,15271
47,11/23/2018,45,11:00,11:15,450,,0,450,450,1,-124059,54799,178858,-69260,0,0,32263,0,0,,32263,32263
47,11/23/2018,46,11:15,11:30,55.22,,0,55.22,55.22,1,-78975,72298,151273,-6677,0,0,7425,0,0,,7425,7425
47,11/23/2018,47,11:30,11:45,58.67,,0,58.67,58.67,1,-83806,66284,150090,-17522,0,0,4815,0,0,,4815,4815
47,11/23/2018,48,11:45,12:00,58.93,,0,58.93,58.93,1,-95757,64235,159992,-31522,0,0,14094,0,0,,14094,14094
47,11/23/2018,49,12:00,12:15,450,,0,450,450,1,-135653,61965,197618,-73688,0,0,39349,0,0,,39349,39349
47,11/23/2018,50,12:15,12:30,58.28,64.09,0,64.09,64.09,-1,-82732,75512,158244,-7220,0,-197,13376,0,0,,13573,13179
47,11/23/2018,51,12:30,12:45,58.28,61.09,0,61.09,61.09,-1,-60953,69717,130670,8764,0,-229,35,0,0,,264,-194
47,11/23/2018,52,12:45,13:00,,66.17,0,66.17,66.17,-1,-79507,66233,145740,-13274,0,-9,0,0,0,,9,-9
47,11/23/2018,53,13:00,13:15,,66.23,0,66.23,66.23,-1,-63818,76346,140164,12528,0,-496,0,0,0,,496,-496
47,11/23/2018,54,13:15,13:30,74.9,,0,74.9,74.9,1,-94971,71112,166083,-23859,0,0,11583,0,0,,11583,11583
47,11/23/2018,55,13:30,13:45,94.9,,0,94.9,94.9,1,-106722,68929,175651,-37793,0,0,36554,0,0,,36554,36554
47,11/23/2018,56,13:45,14:00,60.29,,0,60.29,60.29,1,-86072,68229,154301,-17843,0,0,24138,0,0,,24138,24138
47,11/23/2018,57,14:00,14:15,66.93,,0,66.93,66.93,1,-88311,55492,143803,-32819,0,0,10433,0,0,,10433,10433
47,11/23/2018,58,14:15,14:30,93.6,,0,93.6,93.6,1,-92624,51048,143672,-41576,0,0,36487,0,0,,36487,36487
47,11/23/2018,59,14:30,14:45,58.79,,0,58.79,58.79,1,-80496,52125,132621,-28371,0,0,23682,0,0,,23682,23682
47,11/23/2018,60,14:45,15:00,68.23,,0,68.23,68.23,1,-109497,42786,152283,-66711,0,0,31039,0,0,,31039,31039
47,11/23/2018,61,15:00,15:15,61.52,,0,61.52,61.52,1,-94216,62918,157134,-31298,0,0,19014,0,0,,19014,19014
47,11/23/2018,62,15:15,15:30,64.43,,0,64.43,64.43,1,-87370,57284,144654,-30086,0,0,13732,0,0,,13732,13732
47,11/23/2018,63,15:30,15:45,94.43,,0,94.43,94.43,1,-101223,54592,155815,-46631,0,0,27278,0,0,,27278,27278
47,11/23/2018,64,15:45,16:00,63.57,,0,63.57,63.57,1,-97274,53790,151064,-43484,0,0,21460,0,0,,21460,21460
47,11/23/2018,65,16:00,16:15,,,0,57.51,57.51,0,-69218,120384,189602,51166,0,0,1066,0,0,,1066,1066
47,11/23/2018,66,16:15,16:30,,,0,57.51,57.51,0,-70748,93641,164389,22893,0,0,0,0,0,,0,0
47,11/23/2018,67,16:30,16:45,,,0,57.5,57.5,0,-77793,84922,162715,7129,0,0,0,0,0,,0,0
47,11/23/2018,68,16:45,17:00,77.09,,0,77.09,77.09,1,-124621,80046,204667,-44575,0,0,9276,0,0,,9276,9276
47,11/23/2018,69,17:00,17:15,58.44,40.1,0,58.44,40.1,2,-69186,180075,249261,110889,0,-907,4014,0,0,,4921,3107
47,11/23/2018,70,17:15,17:30,,,0,57.78,57.78,0,-63223,156199,219422,92976,0,0,0,0,0,,0,0
47,11/23/2018,71,17:30,17:45,,,0,57.77,57.77,0,-53497,154056,207553,100559,0,0,0,0,0,,0,0
47,11/23/2018,72,17:45,18:00,,61.23,0,61.23,61.23,-1,-41369,156725,198094,115356,0,-48,0,0,0,,48,-48
47,11/23/2018,73,18:00,18:15,68.8,16.74,0,68.8,16.74,2,-119992,67797,187789,-52195,0,-10625,1875,0,0,,12500,-8750
47,11/23/2018,74,18:15,18:30,68.8,34.92,0,68.8,34.92,2,-81706,96549,178255,14843,0,-4008,6461,0,0,,10469,2453
47,11/23/2018,75,18:30,18:45,,9.31,0,9.31,9.31,-1,-65245,95169,160414,29924,0,-38439,0,0,0,,38439,-38439
47,11/23/2018,76,18:45,19:00,,6.25,0,6.25,6.25,-1,-50634,103648,154282,53014,0,-22525,0,0,0,,22525,-22525
47,11/23/2018,77,19:00,19:15,50.44,6.25,0,50.44,50.44,1,-110423,65764,176187,-44659,0,-12950,1807,0,0,,14757,-11143
47,11/23/2018,78,19:15,19:30,,44.1,0,44.1,44.1,-1,-66430,83670,150100,17240,0,-1025,0,0,0,,1025,-1025
47,11/23/2018,79,19:30,19:45,,40.1,0,40.1,40.1,-1,-51120,81364,132484,30244,0,-16279,0,0,0,,16279,-16279
47,11/23/2018,80,19:45,20:00,,38.62,0,38.62,38.62,-1,-51041,83233,134274,32192,0,-33188,0,0,0,,33188,-33188
47,11/23/2018,81,20:00,20:15,53.73,38.62,0,53.73,53.73,1,-93559,42192,135751,-51367,0,-8516,3522,0,0,,12038,-4994
47,11/23/2018,82,20:15,20:30,,,0,56.72,56.72,0,-71224,46812,118036,-24412,0,0,0,0,0,,0,0
47,11/23/2018,83,20:30,20:45,,45.25,0,45.25,45.25,-1,-51774,50512,102286,-1262,0,-409,0,0,0,,409,-409
47,11/23/2018,84,20:45,21:00,,44.1,0,44.1,44.1,-1,-54555,77095,131650,22540,0,-5556,0,0,0,,5556,-5556
47,11/23/2018,85,21:00,21:15,70.92,44.1,0,70.92,70.92,1,-88149,52786,140935,-35363,0,-1936,7249,0,0,,9185,5313
47,11/23/2018,86,21:15,21:30,48.1,41.33,0,41.33,41.33,-1,-31496,57515,89011,26019,0,-4636,1885,0,0,,6521,-2751
47,11/23/2018,87,21:30,21:45,,27.75,0,27.75,27.75,-1,-15630,73114,88744,57484,0,-42196,0,0,0,,42196,-42196
47,11/23/2018,88,21:45,22:00,,35.64,0,35.64,35.64,-1,-28682,78615,107297,49933,0,-52943,0,0,0,,52943,-52943
47,11/23/2018,89,22:00,22:15,49.23,36.03,0,49.23,49.23,1,-85369,49058,134427,-36311,0,-20551,418,0,0,,20969,-20133
47,11/23/2018,90,22:15,22:30,50.53,40.19,0,40.19,40.19,-1,-33183,47661,80844,14478,0,-7235,176,0,0,,7411,-7059
47,11/23/2018,91,22:30,22:45,,21.1,0,21.1,21.1,-1,-20227,72737,92964,52510,0,-35506,0,0,0,,35506,-35506
47,11/23/2018,92,22:45,23:00,,22.96,0,22.96,22.96,-1,-19598,76611,96209,57013,0,-38863,0,0,0,,38863,-38863
47,11/23/2018,93,23:00,23:15,49.37,40.1,0,49.37,40.1,2,-56643,48875,105518,-7768,0,-15343,512,0,0,,15855,-14831
47,11/23/2018,94,23:15,23:30,49.37,48.64,0,48.64,48.64,-1,-58425,49227,107652,-9198,0,-261,22,0,0,,283,-239
47,11/23/2018,95,23:30,23:45,,43.38,0,43.38,43.38,-1,-45642,72938,118580,27296,0,-6735,0,0,0,,6735,-6735
47,11/23/2018,96,23:45,0:00,,36.1,0,36.1,36.1,-1,-37935,100269,138204,62334,0,-20626,0,0,0,,20626,-20626
48,11/24/2018,1,0:00,0:15,78.76,35.78,0,78.76,78.76,1,-86803,60982,147785,-25821,0,-14478,2812,0,0,,17290,-11666
48,11/24/2018,2,0:15,0:30,96.34,43.48,0,96.34,43.48,2,-27146,32634,59780,5488,0,-1674,8384,0,0,,10058,6710
48,11/24/2018,3,0:30,0:45,52.42,36.25,0,57.07,36.25,2,-22994,30870,53864,7876,0,-16084,286,0,0,,16370,-15798
48,11/24/2018,4,0:45,1:00,55.48,48.37,0,57.07,48.37,2,-67436,64190,131626,-3246,0,-1016,2846,0,0,,3862,1830
48,11/24/2018,5,1:00,1:15,71.33,48.37,0,71.33,71.33,1,-59757,24806,84563,-34951,0,-172,6375,0,0,,6547,6203
48,11/24/2018,6,1:15,1:30,71.33,,0,71.33,71.33,1,-61350,38494,99844,-22856,0,0,19658,0,0,,19658,19658
48,11/24/2018,7,1:30,1:45,48.15,,0,48.15,48.15,1,-47453,38879,86332,-8574,0,0,5217,0,0,,5217,5217
48,11/24/2018,8,1:45,2:00,47.48,49.41,0,49.41,49.41,-1,-38936,39906,78842,970,0,-1229,858,0,0,,2087,-371
48,11/24/2018,9,2:00,2:15,54.77,65.79,0,56.64,56.64,2,-63739,40833,104572,-22906,0,-1002,5710,0,0,,6712,4708
48,11/24/2018,10,2:15,2:30,47.48,,0,47.48,47.48,1,-44526,31556,76082,-12970,0,0,1094,0,0,,1094,1094
48,11/24/2018,11,2:30,2:45,,,0,56.69,56.69,0,-43733,33290,77023,-10443,0,0,0,0,0,,0,0
48,11/24/2018,12,2:45,3:00,,47.79,0,47.79,47.79,-1,-26943,41394,68337,14451,0,-3336,0,0,0,,3336,-3336
48,11/24/2018,13,3:00,3:15,51.48,50.06,0,51.48,48.77,2,-53974,33208,87182,-20766,0,-530,5172,0,0,,5702,4642
48,11/24/2018,14,3:15,3:30,49.66,,0,49.66,49.66,1,-51938,33361,85299,-18577,0,0,9112,0,0,,9112,9112
48,11/24/2018,15,3:30,3:45,47.48,45.05,0,45.05,45.05,-1,-40600,45127,85727,4527,0,-2749,2941,0,0,,5690,192
48,11/24/2018,16,3:45,4:00,,45.56,0,45.56,45.56,-1,-48509,43400,91909,-5109,0,-3414,0,0,0,,3414,-3414
48,11/24/2018,17,4:00,4:15,48.08,49.68,0,48.77,48.77,2,-44498,32774,77272,-11724,0,-11,1010,0,0,,1021,999
48,11/24/2018,18,4:15,4:30,,,0,48.77,48.77,0,-40087,38971,79058,-1116,0,0,42,0,0,,42,42
48,11/24/2018,19,4:30,4:45,,49.72,0,49.72,49.72,-1,-39082,38140,77222,-942,0,-836,0,0,0,,836,-836
48,11/24/2018,20,4:45,5:00,,48.58,0,48.58,48.58,-1,-38149,42245,80394,4096,0,-4777,0,0,0,,4777,-4777
48,11/24/2018,21,5:00,5:15,,47.09,0,47.09,47.09,-1,-29443,55729,85172,26286,0,-1950,0,0,0,,1950,-1950
48,11/24/2018,22,5:15,5:30,,49.07,0,49.07,49.07,-1,-31143,39255,70398,8112,0,-2609,0,0,0,,2609,-2609
48,11/24/2018,23,5:30,5:45,47.48,50.06,0,47.48,47.48,1,-37828,23910,61738,-13918,0,-106,48,0,0,,154,-58
48,11/24/2018,24,5:45,6:00,48.07,,0,48.07,48.07,1,-37413,27049,64462,-10364,0,0,2033,0,0,,2033,2033
48,11/24/2018,25,6:00,6:15,,43.81,0,43.81,43.81,-1,-35548,68427,103975,32879,0,-9652,0,0,0,,9652,-9652
48,11/24/2018,26,6:15,6:30,,45.78,0,45.78,45.78,-1,-18596,63797,82393,45201,0,-3328,0,0,0,,3328,-3328
48,11/24/2018,27,6:30,6:45,,,0,48.94,48.94,0,-18567,58289,76856,39722,0,-30,0,0,0,,30,-30
48,11/24/2018,28,6:45,7:00,51.81,,0,51.81,51.81,1,-41518,29464,70982,-12054,0,0,867,0,0,,867,867
48,11/24/2018,29,7:00,7:15,51.81,39.49,0,39.49,39.49,-1,-48778,89782,138560,41004,0,-10666,15,0,0,,10681,-10651
48,11/24/2018,30,7:15,7:30,,45.78,0,45.78,45.78,-1,-42546,47831,90377,5285,0,-7435,0,0,0,,7435,-7435
48,11/24/2018,31,7:30,7:45,48.17,45.78,0,48.17,48.17,1,-66047,38026,104073,-28021,0,-146,154,0,0,,300,8
48,11/24/2018,32,7:45,8:00,92.01,,0,92.01,92.01,1,-111042,32297,143339,-78745,0,0,15555,0,0,,15555,15555
48,11/24/2018,33,8:00,8:15,92.01,43.16,0,43.16,43.16,-1,-49871,102939,152810,53068,0,-2862,569,0,0,,3431,-2293
48,11/24/2018,34,8:15,8:30,47.81,38.25,0,57.28,38.25,2,-34165,69682,103847,35517,0,-11613,60,0,0,,11673,-11553
48,11/24/2018,35,8:30,8:45,51.81,,0,51.81,51.81,1,-60446,46624,107070,-13822,0,0,4149,0,0,,4149,4149
48,11/24/2018,36,8:45,9:00,88.78,,0,88.78,88.78,1,-107270,50272,157542,-56998,0,0,33033,0,0,,33033,33033
48,11/24/2018,37,9:00,9:15,55.88,49.58,0,49.58,49.58,-1,-48464,96576,145040,48112,0,-1118,11727,0,0,,12845,10609
48,11/24/2018,38,9:15,9:30,,50.19,0,50.19,50.19,-1,-61332,70729,132061,9397,0,-1467,0,0,0,,1467,-1467
48,11/24/2018,39,9:30,9:45,,,0,57.44,57.44,0,-84113,58584,142697,-25529,0,0,0,0,0,,0,0
48,11/24/2018,40,9:45,10:00,,,0,57.43,57.43,0,-95063,56222,151285,-38841,0,0,0,0,0,,0,0
48,11/24/2018,41,10:00,10:15,,,0,57.44,57.44,0,-68262,56748,125010,-11514,0,0,0,0,0,,0,0
48,11/24/2018,42,10:15,10:30,,,0,57.44,57.44,0,-76645,62821,139466,-13824,0,0,0,0,0,,0,0
48,11/24/2018,43,10:30,10:45,,,0,57.44,57.44,0,-77029,70871,147900,-6158,0,0,0,0,0,,0,0
48,11/24/2018,44,10:45,11:00,,66.32,0,66.32,66.32,-1,-75372,68684,144056,-6688,0,-1484,0,0,0,,1484,-1484
48,11/24/2018,45,11:00,11:15,,66.32,0,66.32,66.32,-1,-58364,37095,95459,-21269,0,-640,0,0,0,,640,-640
48,11/24/2018,46,11:15,11:30,,,0,57.44,57.44,0,-65770,21100,86870,-44670,0,0,0,0,0,,0,0
48,11/24/2018,47,11:30,11:45,,,0,57.44,57.44,0,-64290,21857,86147,-42433,0,0,0,0,0,,0,0
48,11/24/2018,48,11:45,12:00,,,0,57.44,57.44,0,-70827,23891,94718,-46936,0,0,0,0,0,,0,0
48,11/24/2018,49,12:00,12:15,120.12,,0,120.12,120.12,1,-123053,9868,132921,-113185,0,0,10747,0,0,,10747,10747
48,11/24/2018,50,12:15,12:30,65.33,,0,65.33,65.33,1,-109504,12662,122166,-96842,0,0,7158,0,0,,7158,7158
48,11/24/2018,51,12:30,12:45,130.83,,0,130.83,130.83,1,-96410,44856,141266,-51554,0,0,34567,0,0,,34567,34567
48,11/24/2018,52,12:45,13:00,55.88,,0,55.88,55.88,1,-87112,53048,140160,-34064,0,0,23042,0,0,,23042,23042
48,11/24/2018,53,13:00,13:15,57.42,,0,57.42,57.42,1,-92745,61694,154439,-31051,0,0,19526,0,0,,19526,19526
48,11/24/2018,54,13:15,13:30,89.22,,0,89.22,89.22,1,-88067,41087,129154,-46980,0,0,34954,0,0,,34954,34954
48,11/24/2018,55,13:30,13:45,,,0,57.42,57.42,0,-79720,47040,126760,-32680,0,0,6767,0,0,,6767,6767
48,11/24/2018,56,13:45,14:00,,,0,57.42,57.42,0,-76453,35589,112042,-40864,0,0,0,0,0,,0,0
48,11/24/2018,57,14:00,14:15,,,0,57.3,57.3,0,-89030,46402,135432,-42628,0,0,0,0,0,,0,0
48,11/24/2018,58,14:15,14:30,47.81,,0,47.81,47.81,1,-79072,42017,121089,-37055,0,0,287,0,0,,287,287
48,11/24/2018,59,14:30,14:45,,,0,57.3,57.3,0,-74450,51093,125543,-23357,0,0,0,0,0,,0,0
48,11/24/2018,60,14:45,15:00,,,0,57.3,57.3,0,-74192,40106,114298,-34086,0,0,0,0,0,,0,0
48,11/24/2018,61,15:00,15:15,,,0,57.33,57.33,0,-66902,64786,131688,-2116,0,0,0,0,0,,0,0
48,11/24/2018,62,15:15,15:30,49.92,,0,49.92,49.92,1,-65141,52053,117194,-13088,0,0,1819,0,0,,1819,1819
48,11/24/2018,63,15:30,15:45,51.81,,0,51.81,51.81,1,-72821,55322,128143,-17499,0,0,6885,0,0,,6885,6885
48,11/24/2018,64,15:45,16:00,55.88,,0,55.88,55.88,1,-75791,54132,129923,-21659,0,0,10474,0,0,,10474,10474
48,11/24/2018,65,16:00,16:15,47.81,48.69,0,57.44,48.69,2,-25732,95724,121456,69992,0,-881,4795,0,0,,5676,3914
48,11/24/2018,66,16:15,16:30,,67.07,0,67.07,67.07,-1,-26599,67593,94192,40994,0,-331,0,0,0,,331,-331
48,11/24/2018,67,16:30,16:45,47.81,,0,47.81,47.81,1,-49419,55961,105380,6542,0,0,46,0,0,,46,46
48,11/24/2018,68,16:45,17:00,118.12,,0,118.12,118.12,1,-93369,49627,142996,-43742,0,0,24882,0,0,,24882,24882
48,11/24/2018,69,17:00,17:15,52.12,44.41,0,57.69,44.41,2,-20096,104265,124361,84169,0,-2040,7511,0,0,,9551,5471
48,11/24/2018,70,17:15,17:30,,46.44,0,46.44,46.44,-1,-17574,112023,129597,94449,0,-4287,0,0,0,,4287,-4287
48,11/24/2018,71,17:30,17:45,,,0,57.69,57.69,0,-22193,113114,135307,90921,0,-24,0,0,0,,24,-24
48,11/24/2018,72,17:45,18:00,,,0,57.69,57.69,0,-42508,114827,157335,72319,0,0,0,0,0,,0,0
48,11/24/2018,73,18:00,18:15,,,0,59.12,59.12,0,-103473,40057,143530,-63416,0,0,0,0,0,,0,0
48,11/24/2018,74,18:15,18:30,,,0,59.12,59.12,0,-79686,50605,130291,-29081,0,0,0,0,0,,0,0
48,11/24/2018,75,18:30,18:45,,46.44,0,46.44,46.44,-1,-65928,74037,139965,8109,0,-1309,0,0,0,,1309,-1309
48,11/24/2018,76,18:45,19:00,,43.81,0,43.81,43.81,-1,-50978,74250,125228,23272,0,-8211,0,0,0,,8211,-8211
48,11/24/2018,77,19:00,19:15,59.38,43.81,0,59.38,59.38,1,-64774,24782,89556,-39992,0,-375,7975,0,0,,8350,7600
48,11/24/2018,78,19:15,19:30,52.72,,0,52.72,52.72,1,-61126,40029,101155,-21097,0,0,6325,0,0,,6325,6325
48,11/24/2018,79,19:30,19:45,47.81,,0,47.81,47.81,1,-57877,52130,110007,-5747,0,0,716,0,0,,716,716
48,11/24/2018,80,19:45,20:00,47.81,,0,47.81,47.81,1,-53055,44245,97300,-8810,0,0,42,0,0,,42,42
48,11/24/2018,81,20:00,20:15,68.13,,0,68.13,68.13,1,-75368,40625,115993,-34743,0,0,12938,0,0,,12938,12938
48,11/24/2018,82,20:15,20:30,51.56,,0,51.56,51.56,1,-73725,52547,126272,-21178,0,0,9443,0,0,,9443,9443
48,11/24/2018,83,20:30,20:45,47.81,,0,47.81,47.81,1,-61154,64311,125465,3157,0,0,2834,0,0,,2834,2834
48,11/24/2018,84,20:45,21:00,,46.44,0,46.44,46.44,-1,-49455,89055,138510,39600,0,-2821,0,0,0,,2821,-2821
48,11/24/2018,85,21:00,21:15,80.69,64.54,0,80.69,57.35,2,-82549,35165,117714,-47384,0,-2141,16016,0,0,,18157,13875
48,11/24/2018,86,21:15,21:30,54.81,,0,54.81,54.81,1,-82581,48331,130912,-34250,0,0,27651,0,0,,27651,27651
48,11/24/2018,87,21:30,21:45,51.81,,0,51.81,51.81,1,-73620,62394,136014,-11226,0,0,11845,0,0,,11845,11845
48,11/24/2018,88,21:45,22:00,51.81,48.69,0,48.69,48.69,-1,-61351,67024,128375,5673,0,-785,283,0,0,,1068,-502
48,11/24/2018,89,22:00,22:15,71.04,48.69,0,71.04,71.04,1,-104660,19708,124368,-84952,0,-562,10619,0,0,,11181,10057
48,11/24/2018,90,22:15,22:30,54.77,,0,54.77,54.77,1,-83007,23927,106934,-59080,0,0,17107,0,0,,17107,17107
48,11/24/2018,91,22:30,22:45,52.49,,0,52.49,52.49,1,-56923,47592,104515,-9331,0,0,5546,0,0,,5546,5546
48,11/24/2018,92,22:45,23:00,,,0,57.11,57.11,0,-35495,65928,101423,30433,0,0,407,0,0,,407,407
48,11/24/2018,93,23:00,23:15,236.76,,0,236.76,236.76,1,-78638,33954,112592,-44684,0,0,15169,0,0,,15169,15169
48,11/24/2018,94,23:15,23:30,236.76,,0,236.76,236.76,1,-64137,22989,87126,-41148,0,0,43038,0,0,,43038,43038
48,11/24/2018,95,23:30,23:45,51.52,,0,51.52,51.52,1,-57938,47246,105184,-10692,0,0,10814,0,0,,10814,10814
48,11/24/2018,96,23:45,0:00,51.52,43.81,0,43.81,43.81,-1,-53831,49821,103652,-4010,0,-781,611,0,0,,1392,-170
48,11/25/2018,1,0:00,0:15,99.6,34.23,0,99.6,34.23,2,-68662,61661,130323,-7001,0,-2319,7203,0,0,,9522,4884
48,11/25/2018,2,0:15,0:30,216.32,,0,216.32,216.32,1,-72403,42432,114835,-29971,0,0,32194,0,0,,32194,32194
48,11/25/2018,3,0:30,0:45,64.16,50.76,0,64.16,49.42,2,-74316,34901,109217,-39415,0,-123,5954,0,0,,6077,5831
48,11/25/2018,4,0:45,1:00,52.42,,0,52.42,52.42,1,-94995,50999,145994,-43996,0,0,3116,0,0,,3116,3116
48,11/25/2018,5,1:00,1:15,54.2,50.36,0,54.2,49.16,2,-25058,50311,75369,25253,0,-284,1277,0,0,,1561,993
48,11/25/2018,6,1:15,1:30,78.79,,0,78.79,78.79,1,-84450,34988,119438,-49462,0,0,26789,0,0,,26789,26789
48,11/25/2018,7,1:30,1:45,48.06,50.47,0,50.47,50.47,-1,-56887,46299,103186,-10588,0,-302,6522,0,0,,6824,6220
48,11/25/2018,8,1:45,2:00,,50.52,0,50.52,50.52,-1,-56893,59091,115984,2198,0,-411,0,0,0,,411,-411
48,11/25/2018,9,2:00,2:15,78.71,50.52,0,78.71,78.71,1,-91713,21375,113088,-70338,0,-5,25401,0,0,,25406,25396
48,11/25/2018,10,2:15,2:30,56.75,,0,56.75,56.75,1,-84540,32504,117044,-52036,0,0,38067,0,0,,38067,38067
48,11/25/2018,11,2:30,2:45,53.13,,0,53.13,53.13,1,-70692,31925,102617,-38767,0,0,21175,0,0,,21175,21175
48,11/25/2018,12,2:45,3:00,,,0,49.21,49.21,0,-77049,46262,123311,-30787,0,0,603,0,0,,603,603
48,11/25/2018,13,3:00,3:15,48.02,,0,48.02,48.02,1,-61032,57184,118216,-3848,0,0,5,0,0,,5,5
48,11/25/2018,14,3:15,3:30,48.04,,0,48.04,48.04,1,-55005,61784,116789,6779,0,0,241,0,0,,241,241
48,11/25/2018,15,3:30,3:45,,50.13,0,50.13,50.13,-1,-62000,62587,124587,587,0,-66,0,0,0,,66,-66
48,11/25/2018,16,3:45,4:00,,44.56,0,44.56,44.56,-1,-52329,56725,109054,4396,0,-4363,0,0,0,,4363,-4363
48,11/25/2018,17,4:00,4:15,49.55,,0,49.55,49.55,1,-59640,29505,89145,-30135,0,0,1837,0,0,,1837,1837
48,11/25/2018,18,4:15,4:30,48.05,,0,48.05,48.05,1,-50565,28642,79207,-21923,0,0,694,0,0,,694,694
48,11/25/2018,19,4:30,4:45,,,0,49.08,49.08,0,-43904,30272,74176,-13632,0,0,0,0,0,,0,0
48,11/25/2018,20,4:45,5:00,,44.56,0,44.56,44.56,-1,-34675,42914,77589,8239,0,-2861,0,0,0,,2861,-2861
48,11/25/2018,21,5:00,5:15,,,0,49.09,49.09,0,-65044,26351,91395,-38693,0,-530,0,0,0,,530,-530
48,11/25/2018,22,5:15,5:30,,,0,49.09,49.09,0,-62145,23209,85354,-38936,0,0,0,0,0,,0,0
48,11/25/2018,23,5:30,5:45,,,0,49.09,49.09,0,-58421,27516,85937,-30905,0,0,0,0,0,,0,0
48,11/25/2018,24,5:45,6:00,48.05,,0,48.05,48.05,1,-71247,13565,84812,-57682,0,0,322,0,0,,322,322
48,11/25/2018,25,6:00,6:15,,,0,48.77,48.77,0,-73182,50435,123617,-22747,0,0,0,0,0,,0,0
48,11/25/2018,26,6:15,6:30,,,0,48.72,48.72,0,-53845,38555,92400,-15290,0,0,0,0,0,,0,0
48,11/25/2018,27,6:30,6:45,,,0,48.7,48.7,0,-60359,26250,86609,-34109,0,0,0,0,0,,0,0
48,11/25/2018,28,6:45,7:00,,,0,48.62,48.62,0,-58327,24014,82341,-34313,0,0,0,0,0,,0,0
48,11/25/2018,29,7:00,7:15,,47.74,0,47.74,47.74,-1,-60234,66581,126815,6347,0,-866,0,0,0,,866,-866
48,11/25/2018,30,7:15,7:30,,49.92,0,49.92,49.92,-1,-65420,55049,120469,-10371,0,-492,0,0,0,,492,-492
48,11/25/2018,31,7:30,7:45,,,0,48.86,48.86,0,-83291,49260,132551,-34031,0,0,0,0,0,,0,0
48,11/25/2018,32,7:45,8:00,48.35,,0,48.35,48.35,1,-104268,44706,148974,-59562,0,0,7,0,0,,7,7
48,11/25/2018,33,8:00,8:15,52.35,,0,52.35,52.35,1,-160321,48944,209265,-111377,0,0,2879,0,0,,2879,2879
48,11/25/2018,34,8:15,8:30,,,0,48.94,48.94,0,-130048,56063,186111,-73985,0,0,0,0,0,,0,0
48,11/25/2018,35,8:30,8:45,,,0,48.92,48.92,0,-116831,47112,163943,-69719,0,0,0,0,0,,0,0
48,11/25/2018,36,8:45,9:00,48.35,,0,48.35,48.35,1,-82423,54528,136951,-27895,0,0,744,0,0,,744,744
48,11/25/2018,37,9:00,9:15,233.48,,0,233.48,233.48,1,-169689,78766,248455,-90923,0,0,40660,0,0,,40660,40660
48,11/25/2018,38,9:15,9:30,56.35,,0,56.35,56.35,1,-104791,81539,186330,-23252,0,0,8239,0,0,,8239,8239
48,11/25/2018,39,9:30,9:45,109.02,,0,109.02,109.02,1,-116066,70662,186728,-45404,0,0,37717,0,0,,37717,37717
48,11/25/2018,40,9:45,10:00,56.35,,0,56.35,56.35,1,-106956,59468,166424,-47488,0,0,36777,0,0,,36777,36777
48,11/25/2018,41,10:00,10:15,111.96,,0,111.96,111.96,1,-96895,41899,138794,-54996,0,0,22353,0,0,,22353,22353
48,11/25/2018,42,10:15,10:30,222.61,,0,222.61,222.61,1,-103589,43230,146819,-60359,0,0,54118,0,0,,54118,54118
48,11/25/2018,43,10:30,10:45,121.77,,0,121.77,121.77,1,-112758,40385,153143,-72373,0,0,51444,0,0,,51444,51444
48,11/25/2018,44,10:45,11:00,79.15,,0,79.15,79.15,1,-110106,58473,168579,-51633,0,0,52857,0,0,,52857,52857
48,11/25/2018,45,11:00,11:15,59.13,,0,59.13,59.13,1,-103525,64391,167916,-39134,0,0,34967,0,0,,34967,34967
48,11/25/2018,46,11:15,11:30,56.35,,0,56.35,56.35,1,-101705,60900,162605,-40805,0,0,30935,0,0,,30935,30935
48,11/25/2018,47,11:30,11:45,72.29,,0,72.29,72.29,1,-104717,55426,160143,-49291,0,0,35276,0,0,,35276,35276
48,11/25/2018,48,11:45,12:00,85.31,,0,85.31,85.31,1,-122920,56513,179433,-66407,0,0,54817,0,0,,54817,54817
48,11/25/2018,49,12:00,12:15,71.59,,0,71.59,71.59,1,-97551,56460,154011,-41091,0,0,44663,0,0,,44663,44663
48,11/25/2018,50,12:15,12:30,143.11,,0,143.11,143.11,1,-112949,49250,162199,-63699,0,0,42064,0,0,,42064,42064
48,11/25/2018,51,12:30,12:45,82.79,,0,82.79,82.79,1,-97558,59749,157307,-37809,0,0,50341,0,0,,50341,50341
48,11/25/2018,52,12:45,13:00,48.35,49.74,0,49.46,49.46,2,-74178,62715,136893,-11463,0,-271,7306,0,0,,7577,7035
48,11/25/2018,53,13:00,13:15,97.02,,0,97.02,97.02,1,-98740,47627,146367,-51113,0,0,21872,0,0,,21872,21872
48,11/25/2018,54,13:15,13:30,55.58,,0,55.58,55.58,1,-120938,62899,183837,-58039,0,0,17629,0,0,,17629,17629
48,11/25/2018,55,13:30,13:45,52.35,,0,52.35,52.35,1,-115548,61997,177545,-53551,0,0,6051,0,0,,6051,6051
48,11/25/2018,56,13:45,14:00,48.35,,0,48.35,48.35,1,-106574,61211,167785,-45363,0,0,1736,0,0,,1736,1736
48,11/25/2018,57,14:00,14:15,86.02,,0,86.02,86.02,1,-93574,56986,150560,-36588,0,0,16847,0,0,,16847,16847
48,11/25/2018,58,14:15,14:30,52.35,,0,52.35,52.35,1,-72791,54274,127065,-18517,0,0,13393,0,0,,13393,13393
48,11/25/2018,59,14:30,14:45,52.35,,0,52.35,52.35,1,-74907,57196,132103,-17711,0,0,13594,0,0,,13594,13594
48,11/25/2018,60,14:45,15:00,82.83,,0,82.83,82.83,1,-92197,54121,146318,-38076,0,0,22232,0,0,,22232,22232
48,11/25/2018,61,15:00,15:15,55.97,,0,55.97,55.97,1,-74278,48390,122668,-25888,0,0,17848,0,0,,17848,17848
48,11/25/2018,62,15:15,15:30,51.98,,0,51.98,51.98,1,-64828,41880,106708,-22948,0,0,4996,0,0,,4996,4996
48,11/25/2018,63,15:30,15:45,48.35,,0,48.35,48.35,1,-55424,52258,107682,-3166,0,0,3865,0,0,,3865,3865
48,11/25/2018,64,15:45,16:00,,,0,49.34,49.34,0,-56090,57581,113671,1491,0,0,323,0,0,,323,323
48,11/25/2018,65,16:00,16:15,,34.4,0,34.4,34.4,-1,-22596,80736,103332,58140,0,-18020,0,0,0,,18020,-18020
48,11/25/2018,66,16:15,16:30,,49.74,0,49.74,49.74,-1,-40024,53487,93511,13463,0,-4102,0,0,0,,4102,-4102
48,11/25/2018,67,16:30,16:45,52.47,,0,52.47,52.47,1,-64433,43351,107784,-21082,0,0,1776,0,0,,1776,1776
48,11/25/2018,68,16:45,17:00,194.02,,0,194.02,194.02,1,-134916,62023,196939,-72893,0,0,38440,0,0,,38440,38440
48,11/25/2018,69,17:00,17:15,194.02,29.6,0,29.6,29.6,-1,-69244,173587,242831,104343,0,-11342,11917,0,0,,23259,575
48,11/25/2018,70,17:15,17:30,,45.03,0,45.03,45.03,-1,-72062,135546,207608,63484,0,-12018,0,0,0,,12018,-12018
48,11/25/2018,71,17:30,17:45,,32.65,0,32.65,32.65,-1,-73581,132715,206296,59134,0,-19224,0,0,0,,19224,-19224
48,11/25/2018,72,17:45,18:00,,50.37,0,50.37,50.37,-1,-69354,148403,217757,79049,0,-1957,0,0,0,,1957,-1957
48,11/25/2018,73,18:00,18:15,,50.36,0,50.36,50.36,-1,-85167,77101,162268,-8066,0,-450,0,0,0,,450,-450
48,11/25/2018,74,18:15,18:30,,46.58,0,46.58,46.58,-1,-69055,102468,171523,33413,0,-2480,0,0,0,,2480,-2480
48,11/25/2018,75,18:30,18:45,,41.94,0,41.94,41.94,-1,-82784,114921,197705,32137,0,-18478,0,0,0,,18478,-18478
48,11/25/2018,76,18:45,19:00,,41.94,0,41.94,41.94,-1,-69155,106012,175167,36857,0,-13896,0,0,0,,13896,-13896
48,11/25/2018,77,19:00,19:15,,40.35,0,40.35,40.35,-1,-76349,100159,176508,23810,0,-19306,0,0,0,,19306,-19306
48,11/25/2018,78,19:15,19:30,,40.35,0,40.35,40.35,-1,-81142,96550,177692,15408,0,-8820,0,0,0,,8820,-8820
48,11/25/2018,79,19:30,19:45,,32.65,0,32.65,32.65,-1,-68677,118836,187513,50159,0,-41034,0,0,0,,41034,-41034
48,11/25/2018,80,19:45,20:00,,37.97,0,37.97,37.97,-1,-79876,121695,201571,41819,0,-41174,0,0,0,,41174,-41174
48,11/25/2018,81,20:00,20:15,241.38,37.97,0,241.38,241.38,1,-111818,56172,167990,-55646,0,-4884,17157,0,0,,22041,12273
48,11/25/2018,82,20:15,20:30,48.35,39.01,0,39.01,39.01,-1,-59951,80106,140057,20155,0,-4397,2182,0,0,,6579,-2215
48,11/25/2018,83,20:30,20:45,,9.22,0,9.22,9.22,-1,-35610,108190,143800,72580,0,-54161,0,0,0,,54161,-54161
48,11/25/2018,84,20:45,21:00,,36.56,0,36.56,36.56,-1,-47788,84055,131843,36267,0,-52454,0,0,0,,52454,-52454
48,11/25/2018,85,21:00,21:15,143.5,49.87,0,143.5,49.32,2,-81826,31455,113281,-50371,0,-11342,10928,0,0,,22270,-414
48,11/25/2018,86,21:15,21:30,52.35,,0,52.35,52.35,1,-68229,48466,116695,-19763,0,0,3766,0,0,,3766,3766
48,11/25/2018,87,21:30,21:45,,36.35,0,36.35,36.35,-1,-54071,90255,144326,36184,0,-19490,0,0,0,,19490,-19490
48,11/25/2018,88,21:45,22:00,47.76,44.09,0,47.76,47.76,1,-100963,84028,184991,-16935,0,-10365,228,0,0,,10593,-10137
48,11/25/2018,89,22:00,22:15,238.97,,0,238.97,238.97,1,-85962,24067,110029,-61895,0,0,26105,0,0,,26105,26105
48,11/25/2018,90,22:15,22:30,238.97,40.35,0,40.35,40.35,-1,-51423,60258,111681,8835,0,-3296,9281,0,0,,12577,5985
48,11/25/2018,91,22:30,22:45,,36.35,0,36.35,36.35,-1,-46193,72145,118338,25952,0,-22719,0,0,0,,22719,-22719
48,11/25/2018,92,22:45,23:00,,29.6,0,29.6,29.6,-1,-45955,90777,136732,44822,0,-30115,0,0,0,,30115,-30115
48,11/25/2018,93,23:00,23:15,,-13.49,0,-13.49,-13.49,-1,-51056,107072,158128,56016,0,-51589,0,0,0,,51589,-51589
48,11/25/2018,94,23:15,23:30,,40.35,0,40.35,40.35,-1,-35082,52403,87485,17321,0,-16832,0,0,0,,16832,-16832
48,11/25/2018,95,23:30,23:45,,40.35,0,40.35,40.35,-1,-20922,53564,74486,32642,0,-25315,0,0,0,,25315,-25315
48,11/25/2018,96,23:45,0:00,,16.03,0,16.03,16.03,-1,-19913,89972,109885,70059,0,-60940,0,0,0,,60940,-60940
48,11/26/2018,1,0:00,0:15,,-53.3,0,-53.3,-53.3,-1,-45928,88008,133936,42080,0,-48679,0,0,0,,48679,-48679
48,11/26/2018,2,0:15,0:30,,36.89,0,36.89,36.89,-1,-45429,65496,110925,20067,0,-12429,0,0,0,,12429,-12429
48,11/26/2018,3,0:30,0:45,,40.89,0,40.89,40.89,-1,-35420,65813,101233,30393,0,-25007,0,0,0,,25007,-25007
48,11/26/2018,4,0:45,1:00,,32,0,32,32,-1,-34574,89284,123858,54710,0,-41651,0,0,0,,41651,-41651
48,11/26/2018,5,1:00,1:15,49.79,13.4,0,49.79,13.4,2,-49954,61325,111279,11371,0,-34950,323,0,0,,35273,-34627
48,11/26/2018,6,1:15,1:30,56.89,13.4,0,56.89,56.89,1,-65922,47735,113657,-18187,0,-1564,12445,0,0,,14009,10881
48,11/26/2018,7,1:30,1:45,47.66,48.93,0,48.93,48.93,-1,-51837,55009,106846,3172,0,-32,448,0,0,,480,416
48,11/26/2018,8,1:45,2:00,,40.89,0,40.89,40.89,-1,-46460,76070,122530,29610,0,-19163,0,0,0,,19163,-19163
48,11/26/2018,9,2:00,2:15,52.89,40.89,0,52.89,40.89,2,-39227,38515,77742,-712,0,-18527,1556,0,0,,20083,-16971
48,11/26/2018,10,2:15,2:30,52.89,48.87,0,52.89,45.26,2,-38904,41464,80368,2560,0,-2480,1878,0,0,,4358,-602
48,11/26/2018,11,2:30,2:45,,48.97,0,48.97,48.97,-1,-37272,41916,79188,4644,0,-2543,0,0,0,,2543,-2543
48,11/26/2018,12,2:45,3:00,,40.89,0,40.89,40.89,-1,-25777,37403,63180,11626,0,-8867,0,0,0,,8867,-8867
48,11/26/2018,13,3:00,3:15,,38.88,0,38.88,38.88,-1,-24125,41751,65876,17626,0,-20298,0,0,0,,20298,-20298
48,11/26/2018,14,3:15,3:30,,45,0,45,45,-1,-25482,31163,56645,5681,0,-3471,0,0,0,,3471,-3471
48,11/26/2018,15,3:30,3:45,,44.43,0,44.43,44.43,-1,-25759,35864,61623,10105,0,-8408,0,0,0,,8408,-8408
48,11/26/2018,16,3:45,4:00,,44.89,0,44.89,44.89,-1,-28066,36845,64911,8779,0,-12163,0,0,0,,12163,-12163
48,11/26/2018,17,4:00,4:15,,41.37,0,41.37,41.37,-1,-29242,55278,84520,26036,0,-20395,0,0,0,,20395,-20395
48,11/26/2018,18,4:15,4:30,49.51,44.89,0,49.51,44.89,2,-27372,29185,56557,1813,0,-12264,944,0,0,,13208,-11320
48,11/26/2018,19,4:30,4:45,49.35,44.89,0,49.35,49.35,1,-47322,23302,70624,-24020,0,-304,6511,0,0,,6815,6207
48,11/26/2018,20,4:45,5:00,52.89,,0,52.89,52.89,1,-58417,27297,85714,-31120,0,0,6900,0,0,,6900,6900
48,11/26/2018,21,5:00,5:15,56.89,44.89,0,56.89,44.89,2,-81511,75565,157076,-5946,0,-2932,6555,0,0,,9487,3623
48,11/26/2018,22,5:15,5:30,50.26,51.2,0,50.26,45.66,2,-69624,41123,110747,-28501,0,-583,1270,0,0,,1853,687
48,11/26/2018,23,5:30,5:45,56.89,,0,56.89,56.89,1,-52452,24172,76624,-28280,0,0,7913,0,0,,7913,7913
48,11/26/2018,24,5:45,6:00,52.89,,0,52.89,52.89,1,-74714,54534,129248,-20180,0,0,23081,0,0,,23081,23081
48,11/26/2018,25,6:00,6:15,52.89,9.24,0,9.24,9.24,-1,-40050,86196,126246,46146,0,-23016,4280,0,0,,27296,-18736
48,11/26/2018,26,6:15,6:30,,44.43,0,44.43,44.43,-1,-72147,54311,126458,-17836,0,-14075,0,0,0,,14075,-14075
48,11/26/2018,27,6:30,6:45,47.64,44.43,0,47.64,47.64,1,-107838,41082,148920,-66756,0,-294,823,0,0,,1117,529
48,11/26/2018,28,6:45,7:00,239.37,,0,239.37,239.37,1,-154222,31437,185659,-122785,0,0,36062,0,0,,36062,36062
48,11/26/2018,29,7:00,7:15,239.37,-105.58,0,-105.58,-105.58,-1,-53828,177155,230983,123327,0,-37656,18504,0,0,,56160,-19152
48,11/26/2018,30,7:15,7:30,52.4,28.99,0,52.4,52.4,1,-84491,84716,169207,225,0,-22519,680,0,0,,23199,-21839
48,11/26/2018,31,7:30,7:45,262.32,28.99,0,262.32,262.32,1,-151498,61646,213144,-89852,0,-57,35360,0,0,,35417,35303
48,11/26/2018,32,7:45,8:00,262.32,,0,262.32,262.32,1,-199807,76161,275968,-123646,0,0,60807,0,0,,60807,60807
48,11/26/2018,33,8:00,8:15,262.32,24.05,0,24.05,24.05,-1,-31296,119761,151057,88465,0,-9524,10901,0,0,,20425,1377
48,11/26/2018,34,8:15,8:30,,,0,53.56,53.56,0,-44582,72419,117001,27837,0,-1016,0,0,0,,1016,-1016
48,11/26/2018,35,8:30,8:45,54.01,,0,54.01,54.01,1,-63358,58479,121837,-4879,0,0,2092,0,0,,2092,2092
48,11/26/2018,36,8:45,9:00,63.7,,0,63.7,63.7,1,-102981,45020,148001,-57961,0,0,35886,0,0,,35886,35886
48,11/26/2018,37,9:00,9:15,83.34,,0,83.34,83.34,1,-113925,43457,157382,-70468,0,0,27457,0,0,,27457,27457
48,11/26/2018,38,9:15,9:30,85.93,,0,85.93,85.93,1,-111872,38940,150812,-72932,0,0,53818,0,0,,53818,53818
48,11/26/2018,39,9:30,9:45,94.69,,0,94.69,94.69,1,-118005,39765,157770,-78240,0,0,65717,0,0,,65717,65717
48,11/26/2018,40,9:45,10:00,133.34,,0,133.34,133.34,1,-122152,46033,168185,-76119,0,0,47941,0,0,,47941,47941
48,11/26/2018,41,10:00,10:15,87.65,42.64,0,87.65,42.64,2,-81754,40516,122270,-41238,0,-1938,11466,0,0,,13404,9528
48,11/26/2018,42,10:15,10:30,86.3,,0,86.3,86.3,1,-108722,55181,163903,-53541,0,0,35686,0,0,,35686,35686
48,11/26/2018,43,10:30,10:45,80.12,,0,80.12,80.12,1,-123057,54208,177265,-68849,0,0,48632,0,0,,48632,48632
48,11/26/2018,44,10:45,11:00,68,,0,68,68,1,-119658,54937,174595,-64721,0,0,50751,0,0,,50751,50751
48,11/26/2018,45,11:00,11:15,69.99,,0,69.99,69.99,1,-116438,59212,175650,-57226,0,0,47335,0,0,,47335,47335
48,11/26/2018,46,11:15,11:30,87.66,,0,87.66,87.66,1,-125147,59986,185133,-65161,0,0,55252,0,0,,55252,55252
48,11/26/2018,47,11:30,11:45,78.93,,0,78.93,78.93,1,-126010,67251,193261,-58759,0,0,47427,0,0,,47427,47427
48,11/26/2018,48,11:45,12:00,92.66,,0,92.66,92.66,1,-138267,61553,199820,-76714,0,0,60035,0,0,,60035,60035
48,11/26/2018,49,12:00,12:15,94.63,,0,94.63,94.63,1,-127458,64503,191961,-62955,0,0,48961,0,0,,48961,48961
48,11/26/2018,50,12:15,12:30,68,,0,68,68,1,-101832,58325,160157,-43507,0,0,26563,0,0,,26563,26563
48,11/26/2018,51,12:30,12:45,65,,0,65,65,1,-94466,57727,152193,-36739,0,0,9142,0,0,,9142,9142
48,11/26/2018,52,12:45,13:00,50.36,,0,50.36,50.36,1,-96673,65222,161895,-31451,0,0,10177,0,0,,10177,10177
48,11/26/2018,53,13:00,13:15,76.23,,0,76.23,76.23,1,-96705,54522,151227,-42183,0,0,13553,0,0,,13553,13553
48,11/26/2018,54,13:15,13:30,52.42,,0,52.42,52.42,1,-113201,45160,158361,-68041,0,0,23041,0,0,,23041,23041
48,11/26/2018,55,13:30,13:45,57.97,,0,57.97,57.97,1,-114033,44904,158937,-69129,0,0,20413,0,0,,20413,20413
48,11/26/2018,56,13:45,14:00,50.63,,0,50.63,50.63,1,-125683,56072,181755,-69611,0,0,8255,0,0,,8255,8255
48,11/26/2018,57,14:00,14:15,280.54,,0,280.54,280.54,1,-142697,60200,202897,-82497,0,0,40325,0,0,,40325,40325
48,11/26/2018,58,14:15,14:30,67.95,,0,67.95,67.95,1,-121688,72737,194425,-48951,0,0,41587,0,0,,41587,41587
48,11/26/2018,59,14:30,14:45,64.67,,0,64.67,64.67,1,-133655,69421,203076,-64234,0,0,31807,0,0,,31807,31807
48,11/26/2018,60,14:45,15:00,54.74,,0,54.74,54.74,1,-143157,67715,210872,-75442,0,0,8916,0,0,,8916,8916
48,11/26/2018,61,15:00,15:15,55,,0,55,55,1,-152956,78865,231821,-74091,0,0,8065,0,0,,8065,8065
48,11/26/2018,62,15:15,15:30,64.69,,0,64.69,64.69,1,-174039,74704,248743,-99335,0,0,27143,0,0,,27143,27143
48,11/26/2018,63,15:30,15:45,182.8,,0,182.8,182.8,1,-180030,67282,247312,-112748,0,0,47629,0,0,,47629,47629
48,11/26/2018,64,15:45,16:00,54.79,,0,54.79,54.79,1,-156363,73787,230150,-82576,0,0,16609,0,0,,16609,16609
48,11/26/2018,65,16:00,16:15,53.33,,0,53.33,53.33,1,-124204,113332,237536,-10872,0,0,3157,0,0,,3157,3157
48,11/26/2018,66,16:15,16:30,58.44,,0,58.44,58.44,1,-121323,91568,212891,-29755,0,0,8997,0,0,,8997,8997
48,11/26/2018,67,16:30,16:45,100.02,,0,100.02,100.02,1,-128153,76787,204940,-51366,0,0,14930,0,0,,14930,14930
48,11/26/2018,68,16:45,17:00,295.39,,0,295.39,295.39,1,-149939,74043,223982,-75896,0,0,62755,0,0,,62755,62755
48,11/26/2018,69,17:00,17:15,111.13,58.44,0,58.44,58.44,-1,-100958,101206,202164,248,0,-774,22679,0,0,,23453,21905
48,11/26/2018,70,17:15,17:30,70.94,58.44,0,70.94,70.94,1,-104001,82415,186416,-21586,0,-6,20048,0,0,,20054,20042
48,11/26/2018,71,17:30,17:45,53.57,,0,53.57,53.57,1,-77785,119463,197248,41678,0,0,4050,0,0,,4050,4050
48,11/26/2018,72,17:45,18:00,,63.44,0,63.44,63.44,-1,-68640,145282,213922,76642,0,-644,0,0,0,,644,-644
48,11/26/2018,73,18:00,18:15,56.17,58.98,0,56.17,53.03,2,-112289,80663,192952,-31626,0,-514,1302,0,0,,1816,788
48,11/26/2018,74,18:15,18:30,,48.63,0,48.63,48.63,-1,-86336,107060,193396,20724,0,-1009,0,0,0,,1009,-1009
48,11/26/2018,75,18:30,18:45,,40.4,0,40.4,40.4,-1,-87578,126525,214103,38947,0,-18868,0,0,0,,18868,-18868
48,11/26/2018,76,18:45,19:00,,34.4,0,34.4,34.4,-1,-84238,126132,210370,41894,0,-42318,0,0,0,,42318,-42318
48,11/26/2018,77,19:00,19:15,80,44.4,0,80,38.5,2,-79868,64432,144300,-15436,0,-17688,5233,0,0,,22921,-12455
48,11/26/2018,78,19:15,19:30,80,59.27,0,59.27,59.27,-1,-76897,103450,180347,26553,0,-883,1184,0,0,,2067,301
48,11/26/2018,79,19:30,19:45,,31.61,0,31.61,31.61,-1,-80369,121447,201816,41078,0,-6021,0,0,0,,6021,-6021
48,11/26/2018,80,19:45,20:00,48.45,24.13,0,53.45,24.13,2,-89707,99647,189354,9940,0,-20800,48,0,0,,20848,-20752
48,11/26/2018,81,20:00,20:15,276.06,24.13,0,276.06,276.06,1,-143811,30263,174074,-113548,0,-1574,47750,0,0,,49324,46176
48,11/26/2018,82,20:15,20:30,90.04,,0,90.04,90.04,1,-88322,69429,157751,-18893,0,0,26053,0,0,,26053,26053
48,11/26/2018,83,20:30,20:45,90.04,29.01,0,29.01,29.01,-1,-76001,115371,191372,39370,0,-14386,1046,0,0,,15432,-13340
48,11/26/2018,84,20:45,21:00,,40.24,0,40.24,40.24,-1,-78025,119604,197629,41579,0,-29265,0,0,0,,29265,-29265
48,11/26/2018,85,21:00,21:15,250.3,40.24,0,250.3,250.3,1,-124862,39439,164301,-85423,0,-9847,21877,0,0,,31724,12030
48,11/26/2018,86,21:15,21:30,62.22,66.11,0,66.11,66.11,-1,-78975,59240,138215,-19735,0,-16,26820,0,0,,26836,26804
48,11/26/2018,87,21:30,21:45,,-12.63,0,-12.63,-12.63,-1,-45983,99185,145168,53202,0,-23697,0,0,0,,23697,-23697
48,11/26/2018,88,21:45,22:00,,27.97,0,27.97,27.97,-1,-56122,111665,167787,55543,0,-46038,0,0,0,,46038,-46038
48,11/26/2018,89,22:00,22:15,54.01,38,0,54.01,38,2,-72126,31660,103786,-40466,0,-23353,4152,0,0,,27505,-19201
48,11/26/2018,90,22:15,22:30,54.01,44.4,0,44.4,44.4,-1,-44088,45980,90068,1892,0,-688,4,0,0,,692,-684
48,11/26/2018,91,22:30,22:45,,33.8,0,33.8,33.8,-1,-38678,62569,101247,23891,0,-5369,0,0,0,,5369,-5369
48,11/26/2018,92,22:45,23:00,,27.06,0,27.06,27.06,-1,-51521,81600,133121,30079,0,-24067,0,0,0,,24067,-24067
48,11/26/2018,93,23:00,23:15,48.45,32,0,48.45,32,2,-80405,55044,135449,-25361,0,-18961,2175,0,0,,21136,-16786
48,11/26/2018,94,23:15,23:30,48.45,49.31,0,49.31,49.31,-1,-57011,41775,98786,-15236,0,-752,18,0,0,,770,-734
48,11/26/2018,95,23:30,23:45,,36.4,0,36.4,36.4,-1,-58513,71278,129791,12765,0,-5598,0,0,0,,5598,-5598
48,11/26/2018,96,23:45,0:00,,22.55,0,22.55,22.55,-1,-68273,106652,174925,38379,0,-23735,0,0,0,,23735,-23735
48,11/27/2018,1,0:00,0:15,48.4,15.74,0,48.4,15.74,2,-52142,42592,94734,-9550,0,-18397,1463,0,0,,19860,-16934
48,11/27/2018,2,0:15,0:30,47.24,45.71,0,47.73,45.71,2,-33482,28397,61879,-5085,0,-156,546,0,0,,702,390
48,11/27/2018,3,0:30,0:45,,42.07,0,42.07,42.07,-1,-36209,40027,76236,3818,0,-2427,0,0,0,,2427,-2427
48,11/27/2018,4,0:45,1:00,,40.14,0,40.14,40.14,-1,-42536,77491,120027,34955,0,-21109,0,0,0,,21109,-21109
48,11/27/2018,5,1:00,1:15,53.85,40.61,0,53.85,53.85,1,-43182,23798,66980,-19384,0,-10723,3263,0,0,,13986,-7460
48,11/27/2018,6,1:15,1:30,48.4,44.4,0,48.4,44.4,2,-24033,26614,50647,2581,0,-1572,2095,0,0,,3667,523
48,11/27/2018,7,1:30,1:45,,36.72,0,36.72,36.72,-1,-22419,44577,66996,22158,0,-20068,0,0,0,,20068,-20068
48,11/27/2018,8,1:45,2:00,,42.48,0,42.48,42.48,-1,-36708,59535,96243,22827,0,-23673,0,0,0,,23673,-23673
48,11/27/2018,9,2:00,2:15,53.24,44.4,0,53.24,44.4,2,-26583,13124,39707,-13459,0,-9714,2253,0,0,,11967,-7461
48,11/27/2018,10,2:15,2:30,,,0,47.82,47.82,0,-24311,18170,42481,-6141,0,-17,9,0,0,,26,-8
48,11/27/2018,11,2:30,2:45,,46.74,0,46.74,46.74,-1,-23078,26671,49749,3593,0,-3774,0,0,0,,3774,-3774
48,11/27/2018,12,2:45,3:00,,44.4,0,44.4,44.4,-1,-24812,33074,57886,8262,0,-7353,0,0,0,,7353,-7353
48,11/27/2018,13,3:00,3:15,48.4,44.4,0,48.4,48.4,1,-41749,23213,64962,-18536,0,-405,2354,0,0,,2759,1949
48,11/27/2018,14,3:15,3:30,48.4,,0,48.4,48.4,1,-34115,23723,57838,-10392,0,0,4506,0,0,,4506,4506
48,11/27/2018,15,3:30,3:45,,,0,47.89,47.89,0,-31169,27583,58752,-3586,0,0,408,0,0,,408,408
48,11/27/2018,16,3:45,4:00,,44.4,0,44.4,44.4,-1,-28457,31297,59754,2840,0,-2039,0,0,0,,2039,-2039
48,11/27/2018,17,4:00,4:15,,46.82,0,46.82,46.82,-1,-23951,30762,54713,6811,0,-1998,0,0,0,,1998,-1998
48,11/27/2018,18,4:15,4:30,,46.81,0,46.81,46.81,-1,-31942,32477,64419,535,0,-1597,0,0,0,,1597,-1597
48,11/27/2018,19,4:30,4:45,,44.4,0,44.4,44.4,-1,-44040,38976,83016,-5064,0,-1799,0,0,0,,1799,-1799
48,11/27/2018,20,4:45,5:00,,40.9,0,40.9,40.9,-1,-40395,37023,77418,-3372,0,-4749,0,0,0,,4749,-4749
48,11/27/2018,21,5:00,5:15,,9.04,0,9.04,9.04,-1,-24833,81775,106608,56942,0,-36670,0,0,0,,36670,-36670
48,11/27/2018,22,5:15,5:30,,42.52,0,42.52,42.52,-1,-31138,51604,82742,20466,0,-28979,0,0,0,,28979,-28979
48,11/27/2018,23,5:30,5:45,48.68,42.52,0,48.68,48.68,1,-44105,20020,64125,-24085,0,-3654,2467,0,0,,6121,-1187
48,11/27/2018,24,5:45,6:00,49.49,-102.72,0,49.49,-102.72,2,-56687,9639,66326,-47048,0,-4174,6205,0,0,,10379,2031
48,11/27/2018,25,6:00,6:15,,-61.68,0,-61.68,-61.68,-1,-49998,153071,203069,103073,0,-60092,0,0,0,,60092,-60092
48,11/27/2018,26,6:15,6:30,,39.3,0,39.3,39.3,-1,-38632,86126,124758,47494,0,-36039,0,0,0,,36039,-36039
48,11/27/2018,27,6:30,6:45,52.78,39.3,0,52.78,52.78,1,-51817,43359,95176,-8458,0,-4714,2412,0,0,,7126,-2302
48,11/27/2018,28,6:45,7:00,91.7,,0,91.7,91.7,1,-95472,28378,123850,-67094,0,0,36645,0,0,,36645,36645
48,11/27/2018,29,7:00,7:15,91.7,-30.85,0,-30.85,-30.85,-1,-8203,202163,210366,193960,0,-55420,4047,0,0,,59467,-51373
48,11/27/2018,30,7:15,7:30,,28.8,0,28.8,28.8,-1,-14478,67314,81792,52836,0,-35462,0,0,0,,35462,-35462
48,11/27/2018,31,7:30,7:45,94.1,28.8,0,94.1,94.1,1,-65201,35274,100475,-29927,0,-1919,12819,0,0,,14738,10900
48,11/27/2018,32,7:45,8:00,232.07,,0,232.07,232.07,1,-118850,39552,158402,-79298,0,0,53774,0,0,,53774,53774
48,11/27/2018,33,8:00,8:15,60,44.61,0,60,44.61,2,-31163,65234,96397,34071,0,-2472,10068,0,0,,12540,7596
48,11/27/2018,34,8:15,8:30,,39.57,0,39.57,39.57,-1,-32772,55508,88280,22736,0,-14543,0,0,0,,14543,-14543
48,11/27/2018,35,8:30,8:45,,,0,57.91,57.91,0,-63665,51691,115356,-11974,0,-2650,0,0,0,,2650,-2650
48,11/27/2018,36,8:45,9:00,49.03,,0,49.03,49.03,1,-101597,54262,155859,-47335,0,0,8,0,0,,8,8
48,11/27/2018,37,9:00,9:15,,,0,57.88,57.88,0,-53936,72094,126030,18158,0,0,0,0,0,,0,0
48,11/27/2018,38,9:15,9:30,,66.76,0,66.76,66.76,-1,-58038,57981,116019,-57,0,-335,0,0,0,,335,-335
48,11/27/2018,39,9:30,9:45,,64.51,0,64.51,64.51,-1,-50077,64514,114591,14437,0,-1823,0,0,0,,1823,-1823
48,11/27/2018,40,9:45,10:00,,43.36,0,43.36,43.36,-1,-46501,75477,121978,28976,0,-3789,0,0,0,,3789,-3789
48,11/27/2018,41,10:00,10:15,,,0,57.48,57.48,0,-83436,62552,145988,-20884,0,-3457,0,0,0,,3457,-3457
48,11/27/2018,42,10:15,10:30,,,0,57.48,57.48,0,-80421,74227,154648,-6194,0,0,0,0,0,,0,0
48,11/27/2018,43,10:30,10:45,,,0,57.48,57.48,0,-73942,76690,150632,2748,0,0,0,0,0,,0,0
48,11/27/2018,44,10:45,11:00,,43.36,0,43.36,43.36,-1,-64749,88141,152890,23392,0,-3805,0,0,0,,3805,-3805
48,11/27/2018,45,11:00,11:15,,66.54,0,66.54,66.54,-1,-131790,75318,207108,-56472,0,-1054,0,0,0,,1054,-1054
48,11/27/2018,46,11:15,11:30,,,0,57.53,57.53,0,-136333,88807,225140,-47526,0,0,0,0,0,,0,0
48,11/27/2018,47,11:30,11:45,,,0,57.53,57.53,0,-140051,83380,223431,-56671,0,0,0,0,0,,0,0
48,11/27/2018,48,11:45,12:00,49.27,,0,49.27,49.27,1,-137470,53005,190475,-84465,0,0,157,0,0,,157,157
48,11/27/2018,49,12:00,12:15,93.98,,0,93.98,93.98,1,-160115,25215,185330,-134900,0,0,31209,0,0,,31209,31209
48,11/27/2018,50,12:15,12:30,48.98,,0,48.98,48.98,1,-136926,35729,172655,-101197,0,0,6658,0,0,,6658,6658
48,11/27/2018,51,12:30,12:45,48.89,,0,48.89,48.89,1,-144247,56223,200470,-88024,0,0,3920,0,0,,3920,3920
48,11/27/2018,52,12:45,13:00,,,0,57.36,57.36,0,-146466,100571,247037,-45895,0,0,0,0,0,,0,0
48,11/27/2018,53,13:00,13:15,,,0,57.41,57.41,0,-158353,110441,268794,-47912,0,0,0,0,0,,0,0
48,11/27/2018,54,13:15,13:30,52.07,,0,52.07,52.07,1,-171077,94908,265985,-76169,0,0,1562,0,0,,1562,1562
48,11/27/2018,55,13:30,13:45,88.21,,0,88.21,88.21,1,-181647,97516,279163,-84131,0,0,20168,0,0,,20168,20168
48,11/27/2018,56,13:45,14:00,48.17,,0,48.17,48.17,1,-181314,99906,281220,-81408,0,0,2393,0,0,,2393,2393
48,11/27/2018,57,14:00,14:15,62.91,,0,62.91,62.91,1,-136245,104015,240260,-32230,0,0,11770,0,0,,11770,11770
48,11/27/2018,58,14:15,14:30,48.12,,0,48.12,48.12,1,-142477,108696,251173,-33781,0,0,7835,0,0,,7835,7835
48,11/27/2018,59,14:30,14:45,75.74,,0,75.74,75.74,1,-144887,94502,239389,-50385,0,0,26780,0,0,,26780,26780
48,11/27/2018,60,14:45,15:00,55.99,,0,55.99,55.99,1,-139855,96416,236271,-43439,0,0,21761,0,0,,21761,21761
48,11/27/2018,61,15:00,15:15,76.11,,0,76.11,76.11,1,-126397,91978,218375,-34419,0,0,17923,0,0,,17923,17923
48,11/27/2018,62,15:15,15:30,56.94,,0,56.94,56.94,1,-117569,86410,203979,-31159,0,0,25074,0,0,,25074,25074
48,11/27/2018,63,15:30,15:45,56.94,,0,56.94,56.94,1,-127345,77450,204795,-49895,0,0,22540,0,0,,22540,22540
48,11/27/2018,64,15:45,16:00,,,0,57.22,57.22,0,-120545,79387,199932,-41158,0,0,1450,0,0,,1450,1450
48,11/27/2018,65,16:00,16:15,,40.53,0,40.53,40.53,-1,-61044,96927,157971,35883,0,-7164,0,0,0,,7164,-7164
48,11/27/2018,66,16:15,16:30,,43.36,0,43.36,43.36,-1,-69766,84205,153971,14439,0,-5801,0,0,0,,5801,-5801
48,11/27/2018,67,16:30,16:45,,,0,57.06,57.06,0,-74284,78705,152989,4421,0,-557,0,0,0,,557,-557
48,11/27/2018,68,16:45,17:00,57.19,,0,57.19,57.19,1,-95100,77663,172763,-17437,0,0,7970,0,0,,7970,7970
48,11/27/2018,69,17:00,17:15,56.45,,0,56.45,56.45,1,-65355,65624,130979,269,0,0,2380,0,0,,2380,2380
48,11/27/2018,70,17:15,17:30,,,0,57.86,57.86,0,-63793,72615,136408,8822,0,0,0,0,0,,0,0
48,11/27/2018,71,17:30,17:45,,66.76,0,66.76,66.76,-1,-43888,90598,134486,46710,0,-271,0,0,0,,271,-271
48,11/27/2018,72,17:45,18:00,,40.4,0,40.4,40.4,-1,-22826,113917,136743,91091,0,-1882,0,0,0,,1882,-1882
48,11/27/2018,73,18:00,18:15,49.11,39.36,0,57.45,39.36,2,-123592,25214,148806,-98378,0,-2492,450,0,0,,2942,-2042
48,11/27/2018,74,18:15,18:30,,,0,57.55,57.55,0,-81167,55287,136454,-25880,0,0,0,0,0,,0,0
48,11/27/2018,75,18:30,18:45,,66.69,0,66.69,66.69,-1,-68896,68187,137083,-709,0,-36,0,0,0,,36,-36
48,11/27/2018,76,18:45,19:00,,42.56,0,42.56,42.56,-1,-52526,77882,130408,25356,0,-4676,0,0,0,,4676,-4676
48,11/27/2018,77,19:00,19:15,246.84,42.56,0,246.84,246.84,1,-106085,24829,130914,-81256,0,-2722,30505,0,0,,33227,27783
48,11/27/2018,78,19:15,19:30,50,,0,50,50,1,-71030,42475,113505,-28555,0,0,5517,0,0,,5517,5517
48,11/27/2018,79,19:30,19:45,,,0,38.27,38.27,0,-70673,34839,105512,-35834,0,0,0,0,0,,0,0
48,11/27/2018,80,19:45,20:00,47.36,,0,47.36,47.36,1,-116380,28879,145259,-87501,0,0,345,0,0,,345,345
48,11/27/2018,81,20:00,20:15,47.31,,0,47.31,47.31,1,-91227,26506,117733,-64721,0,0,699,0,0,,699,699
48,11/27/2018,82,20:15,20:30,,,0,38.12,38.12,0,-81647,35336,116983,-46311,0,0,0,0,0,,0,0
48,11/27/2018,83,20:30,20:45,,43.36,0,43.36,43.36,-1,-54058,56775,110833,2717,0,-1782,0,0,0,,1782,-1782
48,11/27/2018,84,20:45,21:00,,33.8,0,33.8,33.8,-1,-47441,88098,135539,40657,0,-36078,0,0,0,,36078,-36078
48,11/27/2018,85,21:00,21:15,51.95,35.44,0,51.95,51.95,1,-54308,76206,130514,21898,0,-22773,1782,0,0,,24555,-20991
48,11/27/2018,86,21:15,21:30,47.39,43.36,0,47.39,37.49,2,-31528,55590,87118,24062,0,-1792,1845,0,0,,3637,53
48,11/27/2018,87,21:30,21:45,,9.18,0,9.18,9.18,-1,-27087,104502,131589,77415,0,-39369,0,0,0,,39369,-39369
48,11/27/2018,88,21:45,22:00,,9.18,0,9.18,9.18,-1,-75910,108316,184226,32406,0,-45861,0,0,0,,45861,-45861
48,11/27/2018,89,22:00,22:15,,39.36,0,39.36,39.36,-1,-74913,83306,158219,8393,0,-11676,0,0,0,,11676,-11676
48,11/27/2018,90,22:15,22:30,,43.36,0,43.36,43.36,-1,-46027,66300,112327,20273,0,-1740,0,0,0,,1740,-1740
48,11/27/2018,91,22:30,22:45,,16.1,0,16.1,16.1,-1,-25790,97406,123196,71616,0,-34861,0,0,0,,34861,-34861
48,11/27/2018,92,22:45,23:00,,14.49,0,14.49,14.49,-1,-32931,113020,145951,80089,0,-59542,0,0,0,,59542,-59542
48,11/27/2018,93,23:00,23:15,47.36,43.15,0,47.36,29.18,2,-88740,50425,139165,-38315,0,-12129,472,0,0,,12601,-11657
48,11/27/2018,94,23:15,23:30,,31.08,0,31.08,31.08,-1,-55981,76765,132746,20784,0,-4664,0,0,0,,4664,-4664
48,11/27/2018,95,23:30,23:45,,-8.86,0,-8.86,-8.86,-1,-35903,76548,112451,40645,0,-41925,0,0,0,,41925,-41925
48,11/27/2018,96,23:45,0:00,,-53.42,0,-53.42,-53.42,-1,-44101,105131,149232,61030,0,-29601,0,0,0,,29601,-29601
48,11/28/2018,1,0:00,0:15,55.47,-29.53,0,55.47,-29.53,2,-70247,58105,128352,-12142,0,-26350,2665,0,0,,29015,-23685
48,11/28/2018,2,0:15,0:30,,,0,29.99,29.99,0,-63674,58210,121884,-5464,0,-160,1,0,0,,161,-159
48,11/28/2018,3,0:30,0:45,,,0,29.97,29.97,0,-57785,37286,95071,-20499,0,0,0,0,0,,0,0
48,11/28/2018,4,0:45,1:00,,42.78,0,42.78,42.78,-1,-47084,60677,107761,13593,0,-2304,0,0,0,,2304,-2304
48,11/28/2018,5,1:00,1:15,65.91,42.78,0,65.91,65.91,1,-83232,32377,115609,-50855,0,-120,12738,0,0,,12858,12618
48,11/28/2018,6,1:15,1:30,65.91,36.38,0,36.38,36.38,-1,-40098,46340,86438,6242,0,-5706,797,0,0,,6503,-4909
48,11/28/2018,7,1:30,1:45,,35.47,0,35.47,35.47,-1,-32647,52413,85060,19766,0,-25865,0,0,0,,25865,-25865
48,11/28/2018,8,1:45,2:00,,39.47,0,39.47,39.47,-1,-27191,56736,83927,29545,0,-28555,0,0,0,,28555,-28555
48,11/28/2018,9,2:00,2:15,52.12,39.44,0,52.12,52.12,1,-54325,44941,99266,-9384,0,-14803,3608,0,0,,18411,-11195
48,11/28/2018,10,2:15,2:30,53.63,39.44,0,53.63,53.63,1,-44401,30837,75238,-13564,0,-129,7082,0,0,,7211,6953
48,11/28/2018,11,2:30,2:45,47.47,,0,47.47,47.47,1,-43816,34108,77924,-9708,0,0,1360,0,0,,1360,1360
48,11/28/2018,12,2:45,3:00,,45.41,0,45.41,45.41,-1,-37095,34770,71865,-2325,0,-2804,0,0,0,,2804,-2804
48,11/28/2018,13,3:00,3:15,49.26,45.41,0,49.26,49.26,1,-55532,30006,85538,-25526,0,-650,1369,0,0,,2019,719
48,11/28/2018,14,3:15,3:30,47.47,,0,47.47,47.47,1,-40307,31308,71615,-8999,0,0,895,0,0,,895,895
48,11/28/2018,15,3:30,3:45,47.47,43.47,0,43.47,43.47,-1,-36563,46321,82884,9758,0,-978,533,0,0,,1511,-445
48,11/28/2018,16,3:45,4:00,,43.47,0,43.47,43.47,-1,-40220,49612,89832,9392,0,-1832,0,0,0,,1832,-1832
48,11/28/2018,17,4:00,4:15,,39.47,0,39.47,39.47,-1,-30043,87052,117095,57009,0,-3568,0,0,0,,3568,-3568
48,11/28/2018,18,4:15,4:30,,,0,47.21,47.21,0,-35372,54820,90192,19448,0,0,0,0,0,,0,0
48,11/28/2018,19,4:30,4:45,,,0,47.19,47.19,0,-34916,41560,76476,6644,0,0,0,0,0,,0,0
48,11/28/2018,20,4:45,5:00,,,0,47.18,47.18,0,-38683,31163,69846,-7520,0,0,0,0,0,,0,0
48,11/28/2018,21,5:00,5:15,47.84,44.95,0,48.07,44.95,2,-44076,61365,105441,17289,0,-1038,736,0,0,,1774,-302
48,11/28/2018,22,5:15,5:30,,35.47,0,35.47,35.47,-1,-13993,56884,70877,42891,0,-14690,0,0,0,,14690,-14690
48,11/28/2018,23,5:30,5:45,47.47,43.47,0,47.47,47.47,1,-31917,34479,66396,2562,0,-3291,113,0,0,,3404,-3178
48,11/28/2018,24,5:45,6:00,50.1,,0,50.1,50.1,1,-54439,26831,81270,-27608,0,0,1445,0,0,,1445,1445
48,11/28/2018,25,6:00,6:15,50.1,17.8,0,17.8,17.8,-1,-20362,105907,126269,85545,0,-16001,240,0,0,,16241,-15761
48,11/28/2018,26,6:15,6:30,,41.7,0,41.7,41.7,-1,-29449,66271,95720,36822,0,-16746,0,0,0,,16746,-16746
48,11/28/2018,27,6:30,6:45,47.85,41.7,0,47.85,47.85,1,-54777,42763,97540,-12014,0,-43,560,0,0,,603,517
48,11/28/2018,28,6:45,7:00,87.15,,0,87.15,87.15,1,-110855,67501,178356,-43354,0,0,16763,0,0,,16763,16763
48,11/28/2018,29,7:00,7:15,51.85,-122.4,0,57.93,-122.4,2,-47066,157956,205022,110890,0,-18342,4677,0,0,,23019,-13665
48,11/28/2018,30,7:15,7:30,,44.74,0,44.74,44.74,-1,-35800,115504,151304,79704,0,-4284,0,0,0,,4284,-4284
48,11/28/2018,31,7:30,7:45,51.85,,0,51.85,51.85,1,-92949,91465,184414,-1484,0,0,1378,0,0,,1378,1378
48,11/28/2018,32,7:45,8:00,264.08,,0,264.08,264.08,1,-165496,67011,232507,-98485,0,0,52168,0,0,,52168,52168
48,11/28/2018,33,8:00,8:15,49,67.8,0,67.8,67.8,-1,-43501,131823,175324,88322,0,-173,10084,0,0,,10257,9911
48,11/28/2018,34,8:15,8:30,,67.8,0,67.8,67.8,-1,-43716,104852,148568,61136,0,-156,0,0,0,,156,-156
48,11/28/2018,35,8:30,8:45,,,0,57.83,57.83,0,-66378,79394,145772,13016,0,0,0,0,0,,0,0
48,11/28/2018,36,8:45,9:00,51.85,,0,51.85,51.85,1,-83214,56573,139787,-26641,0,0,6362,0,0,,6362,6362
48,11/28/2018,37,9:00,9:15,,,0,57.95,57.95,0,-66453,100599,167052,34146,0,0,436,0,0,,436,436
48,11/28/2018,38,9:15,9:30,,,0,57.95,57.95,0,-69843,80668,150511,10825,0,0,0,0,0,,0,0
48,11/28/2018,39,9:30,9:45,,,0,57.95,57.95,0,-71048,86941,157989,15893,0,0,0,0,0,,0,0
48,11/28/2018,40,9:45,10:00,,,0,57.95,57.95,0,-68994,76807,145801,7813,0,0,0,0,0,,0,0
48,11/28/2018,41,10:00,10:15,47.85,,0,47.85,47.85,1,-74938,80386,155324,5448,0,0,939,0,0,,939,939
48,11/28/2018,42,10:15,10:30,51.85,,0,51.85,51.85,1,-90150,91091,181241,941,0,0,1567,0,0,,1567,1567
48,11/28/2018,43,10:30,10:45,51.85,,0,51.85,51.85,1,-99694,85597,185291,-14097,0,0,12913,0,0,,12913,12913
48,11/28/2018,44,10:45,11:00,55.85,,0,55.85,55.85,1,-96556,88256,184812,-8300,0,0,7140,0,0,,7140,7140
48,11/28/2018,45,11:00,11:15,55.85,,0,55.85,55.85,1,-110064,69632,179696,-40432,0,0,2606,0,0,,2606,2606
48,11/28/2018,46,11:15,11:30,47.84,,0,47.84,47.84,1,-109074,65556,174630,-43518,0,0,5,0,0,,5,5
48,11/28/2018,47,11:30,11:45,47.84,,0,47.84,47.84,1,-104996,61176,166172,-43820,0,0,394,0,0,,394,394
48,11/28/2018,48,11:45,12:00,47.85,,0,47.85,47.85,1,-100228,56225,156453,-44003,0,0,3163,0,0,,3163,3163
48,11/28/2018,49,12:00,12:15,64.57,,0,64.57,64.57,1,-97318,34214,131532,-63104,0,0,6110,0,0,,6110,6110
48,11/28/2018,50,12:15,12:30,,,0,49.15,49.15,0,-94727,38056,132783,-56671,0,0,228,0,0,,228,228
48,11/28/2018,51,12:30,12:45,47.84,,0,47.84,47.84,1,-88584,42911,131495,-45673,0,0,111,0,0,,111,111
48,11/28/2018,52,12:45,13:00,47.85,,0,47.85,47.85,1,-81410,35824,117234,-45586,0,0,1461,0,0,,1461,1461
48,11/28/2018,53,13:00,13:15,,,0,49.15,49.15,0,-98347,52597,150944,-45750,0,0,0,0,0,,0,0
48,11/28/2018,54,13:15,13:30,50.34,,0,50.34,50.34,1,-130686,49555,180241,-81131,0,0,597,0,0,,597,597
48,11/28/2018,55,13:30,13:45,51.85,,0,51.85,51.85,1,-111290,48827,160117,-62463,0,0,3046,0,0,,3046,3046
48,11/28/2018,56,13:45,14:00,47.84,,0,47.84,47.84,1,-92932,58269,151201,-34663,0,0,327,0,0,,327,327
48,11/28/2018,57,14:00,14:15,55.34,50.49,0,55.34,49.17,2,-77498,65823,143321,-11675,0,-15,4483,0,0,,4498,4468
48,11/28/2018,58,14:15,14:30,55.34,36.74,0,36.74,36.74,-1,-49472,80574,130046,31102,0,-20299,313,0,0,,20612,-19986
48,11/28/2018,59,14:30,14:45,,43.85,0,43.85,43.85,-1,-58374,85917,144291,27543,0,-21104,0,0,0,,21104,-21104
48,11/28/2018,60,14:45,15:00,,40.06,0,40.06,40.06,-1,-66310,90812,157122,24502,0,-22274,0,0,0,,22274,-22274
48,11/28/2018,61,15:00,15:15,,44.75,0,44.75,44.75,-1,-68022,86248,154270,18226,0,-9508,0,0,0,,9508,-9508
48,11/28/2018,62,15:15,15:30,,46.92,0,46.92,46.92,-1,-64188,73569,137757,9381,0,-8401,0,0,0,,8401,-8401
48,11/28/2018,63,15:30,15:45,,46.92,0,46.92,46.92,-1,-53931,78478,132409,24547,0,-6742,0,0,0,,6742,-6742
48,11/28/2018,64,15:45,16:00,,45.19,0,45.19,45.19,-1,-65659,72895,138554,7236,0,-6145,0,0,0,,6145,-6145
48,11/28/2018,65,16:00,16:15,,42.94,0,42.94,42.94,-1,-61415,88222,149637,26807,0,-13247,0,0,0,,13247,-13247
48,11/28/2018,66,16:15,16:30,,49.83,0,49.83,49.83,-1,-65747,49745,115492,-16002,0,-2851,0,0,0,,2851,-2851
48,11/28/2018,67,16:30,16:45,65.21,,0,65.21,65.21,1,-66867,37576,104443,-29291,0,0,2631,0,0,,2631,2631
48,11/28/2018,68,16:45,17:00,76.74,,0,76.74,76.74,1,-89087,62342,151429,-26745,0,0,26286,0,0,,26286,26286
48,11/28/2018,69,17:00,17:15,76.74,29.16,0,29.16,29.16,-1,-84749,106947,191696,22198,0,-14568,5200,0,0,,19768,-9368
48,11/28/2018,70,17:15,17:30,52.02,29.16,0,52.02,52.02,1,-76553,59650,136203,-16903,0,-603,4200,0,0,,4803,3597
48,11/28/2018,71,17:30,17:45,47.85,40.06,0,40.06,40.06,-1,-55944,73881,129825,17937,0,-8169,876,0,0,,9045,-7293
48,11/28/2018,72,17:45,18:00,,34.48,0,34.48,34.48,-1,-47596,106241,153837,58645,0,-37972,0,0,0,,37972,-37972
48,11/28/2018,73,18:00,18:15,,10.58,0,10.58,10.58,-1,-57614,129095,186709,71481,0,-51915,0,0,0,,51915,-51915
48,11/28/2018,74,18:15,18:30,,6.34,0,6.34,6.34,-1,-54118,117069,171187,62951,0,-60053,0,0,0,,60053,-60053
48,11/28/2018,75,18:30,18:45,,2.78,0,2.78,2.78,-1,-40083,129219,169302,89136,0,-53717,0,0,0,,53717,-53717
48,11/28/2018,76,18:45,19:00,,-15.07,0,-15.07,-15.07,-1,-54916,100158,155074,45242,0,-48234,0,0,0,,48234,-48234
48,11/28/2018,77,19:00,19:15,55.85,48.11,0,55.85,48.11,2,-59525,62572,122097,3047,0,-1506,2363,0,0,,3869,857
48,11/28/2018,78,19:15,19:30,55.85,34.18,0,34.18,34.18,-1,-42541,99786,142327,57245,0,-26352,34,0,0,,26386,-26318
48,11/28/2018,79,19:30,19:45,,39.42,0,39.42,39.42,-1,-51961,88680,140641,36719,0,-24339,0,0,0,,24339,-24339
48,11/28/2018,80,19:45,20:00,,31.92,0,31.92,31.92,-1,-46694,92925,139619,46231,0,-36617,0,0,0,,36617,-36617
48,11/28/2018,81,20:00,20:15,90.14,36.17,0,90.14,36.17,2,-117197,109467,226664,-7730,0,-23408,5367,0,0,,28775,-18041
48,11/28/2018,82,20:15,20:30,90.14,20.65,0,20.65,20.65,-1,-77118,113462,190580,36344,0,-8966,856,0,0,,9822,-8110
48,11/28/2018,83,20:30,20:45,,15.85,0,15.85,15.85,-1,-50071,90568,140639,40497,0,-35796,0,0,0,,35796,-35796
48,11/28/2018,84,20:45,21:00,,36.17,0,36.17,36.17,-1,-63425,101851,165276,38426,0,-33713,0,0,0,,33713,-33713
48,11/28/2018,85,21:00,21:15,71.09,39.15,0,71.09,39.15,2,-118999,102940,221939,-16059,0,-20281,5959,0,0,,26240,-14322
48,11/28/2018,86,21:15,21:30,80.37,39.15,0,80.37,80.37,1,-101659,80109,181768,-21550,0,-601,32100,0,0,,32701,31499
48,11/28/2018,87,21:30,21:45,80.37,39.99,0,39.99,39.99,-1,-68465,90750,159215,22285,0,-12265,875,0,0,,13140,-11390
48,11/28/2018,88,21:45,22:00,,44.17,0,44.17,44.17,-1,-94874,94754,189628,-120,0,-3296,0,0,0,,3296,-3296
48,11/28/2018,89,22:00,22:15,87.42,44.34,0,87.42,87.42,1,-168182,113318,281500,-54864,0,-582,20388,0,0,,20970,19806
48,11/28/2018,90,22:15,22:30,95.22,,0,95.22,95.22,1,-108035,65209,173244,-42826,0,0,47643,0,0,,47643,47643
48,11/28/2018,91,22:30,22:45,95.22,44.34,0,44.34,44.34,-1,-77208,76249,153457,-959,0,-36,7894,0,0,,7930,7858
48,11/28/2018,92,22:45,23:00,,-54.32,0,-54.32,-54.32,-1,-52176,109695,161871,57519,0,-27586,0,0,0,,27586,-27586
48,11/28/2018,93,23:00,23:15,209.68,-54.32,0,209.68,209.68,1,-117647,40230,157877,-77417,0,-21191,16432,0,0,,37623,-4759
48,11/28/2018,94,23:15,23:30,234.7,,0,234.7,234.7,1,-94651,52598,147249,-42053,0,0,61769,0,0,,61769,61769
48,11/28/2018,95,23:30,23:45,234.7,37.75,0,37.75,37.75,-1,-50003,74567,124570,24564,0,-15057,2739,0,0,,17796,-12318
48,11/28/2018,96,23:45,0:00,,36.35,0,36.35,36.35,-1,-45722,89004,134726,43282,0,-35408,0,0,0,,35408,-35408
48,11/29/2018,1,0:00,0:15,70.39,39.39,0,70.39,70.39,1,-95600,56658,152258,-38942,0,-11901,3359,0,0,,15260,-8542
48,11/29/2018,2,0:15,0:30,79.54,39.39,0,79.54,79.54,1,-84262,45608,129870,-38654,0,-123,10664,0,0,,10787,10541
48,11/29/2018,3,0:30,0:45,47.39,,0,47.39,47.39,1,-65326,31452,96778,-33874,0,0,302,0,0,,302,302
48,11/29/2018,4,0:45,1:00,50.1,,0,50.1,50.1,1,-63384,32507,95891,-30877,0,0,647,0,0,,647,647
48,11/29/2018,5,1:00,1:15,54.45,,0,54.45,54.45,1,-61746,41471,103217,-20275,0,0,8234,0,0,,8234,8234
48,11/29/2018,6,1:15,1:30,47.49,39.39,0,47.49,39.39,2,-48684,54088,102772,5404,0,-2534,3966,0,0,,6500,1432
48,11/29/2018,7,1:30,1:45,,39.39,0,39.39,39.39,-1,-41354,53919,95273,12565,0,-12063,0,0,0,,12063,-12063
48,11/29/2018,8,1:45,2:00,,39.39,0,39.39,39.39,-1,-39887,56113,96000,16226,0,-18318,0,0,0,,18318,-18318
48,11/29/2018,9,2:00,2:15,,43.39,0,43.39,43.39,-1,-56509,72422,128931,15913,0,-10824,0,0,0,,10824,-10824
48,11/29/2018,10,2:15,2:30,,,0,47.53,47.53,0,-54583,71775,126358,17192,0,-205,0,0,0,,205,-205
48,11/29/2018,11,2:30,2:45,,,0,47.51,47.51,0,-61533,68449,129982,6916,0,0,0,0,0,,0,0
48,11/29/2018,12,2:45,3:00,47.43,,0,47.43,47.43,1,-66632,68457,135089,1825,0,0,526,0,0,,526,526
48,11/29/2018,13,3:00,3:15,,43.39,0,43.39,43.39,-1,-66401,88243,154644,21842,0,-3308,0,0,0,,3308,-3308
48,11/29/2018,14,3:15,3:30,,43.39,0,43.39,43.39,-1,-67603,80163,147766,12560,0,-3678,0,0,0,,3678,-3678
48,11/29/2018,15,3:30,3:45,47.43,47.63,0,47.51,47.51,2,-63837,69062,132899,5225,0,-793,744,0,0,,1537,-49
48,11/29/2018,16,3:45,4:00,,45.43,0,45.43,45.43,-1,-66165,74763,140928,8598,0,-1589,0,0,0,,1589,-1589
48,11/29/2018,17,4:00,4:15,56.67,45.43,0,56.67,56.67,1,-72339,47303,119642,-25036,0,-99,4897,0,0,,4996,4798
48,11/29/2018,18,4:15,4:30,55.83,,0,55.83,55.83,1,-85770,47784,133554,-37986,0,0,27957,0,0,,27957,27957
48,11/29/2018,19,4:30,4:45,63.62,,0,63.62,63.62,1,-97982,49634,147616,-48348,0,0,37613,0,0,,37613,37613
48,11/29/2018,20,4:45,5:00,65.66,,0,65.66,65.66,1,-112765,57297,170062,-55468,0,0,50374,0,0,,50374,50374
48,11/29/2018,21,5:00,5:15,62.6,,0,62.6,62.6,1,-76392,49749,126141,-26643,0,0,24514,0,0,,24514,24514
48,11/29/2018,22,5:15,5:30,101.78,,0,101.78,101.78,1,-106998,38138,145136,-68860,0,0,4416,0,0,,4416,4416
48,11/29/2018,23,5:30,5:45,133.66,,0,133.66,133.66,1,-129238,52472,181710,-76766,0,0,55272,0,0,,55272,55272
48,11/29/2018,24,5:45,6:00,70.39,,0,70.39,70.39,1,-133123,87284,220407,-45839,0,0,51913,0,0,,51913,51913
48,11/29/2018,25,6:00,6:15,69.77,,0,69.77,69.77,1,-137259,85218,222477,-52041,0,0,27899,0,0,,27899,27899
48,11/29/2018,26,6:15,6:30,74.7,,0,74.7,74.7,1,-108014,71844,179858,-36170,0,0,40666,0,0,,40666,40666
48,11/29/2018,27,6:30,6:45,116.52,,0,116.52,116.52,1,-130400,63701,194101,-66699,0,0,56856,0,0,,56856,56856
48,11/29/2018,28,6:45,7:00,232.17,,0,232.17,232.17,1,-181422,101742,283164,-79680,0,0,69486,0,0,,69486,69486
48,11/29/2018,29,7:00,7:15,94.65,-25.16,0,-25.16,-25.16,-1,-178611,239973,418584,61362,0,-4799,33061,0,0,,37860,28262
48,11/29/2018,30,7:15,7:30,266.23,-113.07,0,266.23,266.23,1,-143909,86326,230235,-57583,0,-7425,23249,0,0,,30674,15824
48,11/29/2018,31,7:30,7:45,266.23,,0,266.23,266.23,1,-171762,73250,245012,-98512,0,0,62070,0,0,,62070,62070
48,11/29/2018,32,7:45,8:00,266.23,,0,266.23,266.23,1,-229290,75655,304945,-153635,0,0,98274,0,0,,98274,98274
48,11/29/2018,33,8:00,8:15,267.76,34.11,0,34.11,34.11,-1,-106632,156133,262765,49501,0,-1572,40715,0,0,,42287,39143
48,11/29/2018,34,8:15,8:30,55.13,27.55,0,57.52,27.55,2,-101619,94806,196425,-6813,0,-4472,2160,0,0,,6632,-2312
48,11/29/2018,35,8:30,8:45,97.44,,0,97.44,97.44,1,-140402,79889,220291,-60513,0,0,34843,0,0,,34843,34843
48,11/29/2018,36,8:45,9:00,70.82,,0,70.82,70.82,1,-137549,75775,213324,-61774,0,0,49284,0,0,,49284,49284
48,11/29/2018,37,9:00,9:15,70.82,50.22,0,50.22,50.22,-1,-138023,135670,273693,-2353,0,-554,21153,0,0,,21707,20599
48,11/29/2018,38,9:15,9:30,50.77,50.22,0,50.77,50.77,1,-143836,123522,267358,-20314,0,-22,5574,0,0,,5596,5552
48,11/29/2018,39,9:30,9:45,55.21,,0,55.21,55.21,1,-156979,131581,288560,-25398,0,0,21346,0,0,,21346,21346
48,11/29/2018,40,9:45,10:00,60.21,,0,60.21,60.21,1,-150161,131230,281391,-18931,0,0,8658,0,0,,8658,8658
48,11/29/2018,41,10:00,10:15,72.98,,0,72.98,72.98,1,-161320,114680,276000,-46640,0,0,25845,0,0,,25845,25845
48,11/29/2018,42,10:15,10:30,64.77,,0,64.77,64.77,1,-158678,102895,261573,-55783,0,0,38191,0,0,,38191,38191
48,11/29/2018,43,10:30,10:45,91.87,,0,91.87,91.87,1,-170209,101908,272117,-68301,0,0,54790,0,0,,54790,54790
48,11/29/2018,44,10:45,11:00,77.62,,0,77.62,77.62,1,-172565,102162,274727,-70403,0,0,57992,0,0,,57992,57992
48,11/29/2018,45,11:00,11:15,132.11,,0,132.11,132.11,1,-141059,58276,199335,-82783,0,0,67237,0,0,,67237,67237
48,11/29/2018,46,11:15,11:30,94.92,,0,94.92,94.92,1,-107117,66756,173873,-40361,0,0,48756,0,0,,48756,48756
48,11/29/2018,47,11:30,11:45,70.82,,0,70.82,70.82,1,-113774,72142,185916,-41632,0,0,20470,0,0,,20470,20470
48,11/29/2018,48,11:45,12:00,99.92,,0,99.92,99.92,1,-130664,71036,201700,-59628,0,0,46683,0,0,,46683,46683
48,11/29/2018,49,12:00,12:15,250.78,,0,250.78,250.78,1,-249869,101488,351357,-148381,0,0,79402,0,0,,79402,79402
48,11/29/2018,50,12:15,12:30,250.78,,0,250.78,250.78,1,-196206,126824,323030,-69382,0,0,78422,0,0,,78422,78422
48,11/29/2018,51,12:30,12:45,250.78,,0,250.78,250.78,1,-215648,143268,358916,-72380,0,0,38179,0,0,,38179,38179
48,11/29/2018,52,12:45,13:00,250.78,,0,250.78,250.78,1,-215151,147774,362925,-67377,0,0,60814,0,0,,60814,60814
48,11/29/2018,53,13:00,13:15,249.47,,0,249.47,249.47,1,-243156,120777,363933,-122379,0,0,68519,0,0,,68519,68519
48,11/29/2018,54,13:15,13:30,249.47,,0,274.42,274.42,1,-291185,122250,413435,-168935,0,0,98426,0,12950,,111376,111376
48,11/29/2018,55,13:30,13:45,249.47,,0,274.42,274.42,1,-301326,162308,463634,-139018,0,0,72510,0,83875,,156385,156385
48,11/29/2018,56,13:45,14:00,249.47,,0,274.42,274.42,1,-283666,176718,460384,-106948,0,0,25275,0,37752,,63027,63027
48,11/29/2018,57,14:00,14:15,242.88,69.54,0,242.88,58.16,2,-174440,155194,329634,-19246,0,-22,38888,0,0,,38910,38866
48,11/29/2018,58,14:15,14:30,50.77,31.98,0,58.16,31.98,2,-155122,157886,313008,2764,0,-6128,2157,0,0,,8285,-3971
48,11/29/2018,59,14:30,14:45,60.11,31.98,0,60.11,60.11,1,-165263,127874,293137,-37389,0,-55,23235,0,0,,23290,23180
48,11/29/2018,60,14:45,15:00,55.33,,0,55.33,55.33,1,-150487,105641,256128,-44846,0,0,30725,0,0,,30725,30725
48,11/29/2018,61,15:00,15:15,50.77,35.82,0,58.22,35.82,2,-94902,121528,216430,26626,0,-4192,12515,0,0,,16707,8323
48,11/29/2018,62,15:15,15:30,,45.39,0,45.39,45.39,-1,-104036,118460,222496,14424,0,-2803,0,0,0,,2803,-2803
48,11/29/2018,63,15:30,15:45,,69.61,0,69.61,69.61,-1,-112241,100967,213208,-11274,0,-229,0,0,0,,229,-229
48,11/29/2018,64,15:45,16:00,49.38,39.48,0,58.16,39.48,2,-114184,99690,213874,-14494,0,-382,575,0,0,,957,193
48,11/29/2018,65,16:00,16:15,65.69,-96.15,0,65.69,-96.15,2,-89687,127665,217352,37978,0,-34141,202,0,0,,34343,-33939
48,11/29/2018,66,16:15,16:30,64.18,35.36,0,64.18,35.36,2,-88860,120645,209505,31785,0,-8564,268,0,0,,8832,-8296
48,11/29/2018,67,16:30,16:45,99.51,45.48,0,99.51,99.51,1,-119062,99744,218806,-19318,0,-7552,4195,0,0,,11747,-3357
48,11/29/2018,68,16:45,17:00,261.28,,0,261.28,261.28,1,-157946,98383,256329,-59563,0,0,52949,0,0,,52949,52949
48,11/29/2018,69,17:00,17:15,62.31,11.94,0,11.94,11.94,-1,-82326,108576,190902,26250,0,-8071,23110,0,0,,31181,15039
48,11/29/2018,70,17:15,17:30,46.77,45.03,0,58.2,45.03,2,-91951,89336,181287,-2615,0,-6933,633,0,0,,7566,-6300
48,11/29/2018,71,17:30,17:45,46.77,45.55,0,58.2,45.55,2,-87168,96243,183411,9075,0,-1136,222,0,0,,1358,-914
48,11/29/2018,72,17:45,18:00,,20.82,0,20.82,20.82,-1,-79424,119377,198801,39953,0,-21448,0,0,0,,21448,-21448
48,11/29/2018,73,18:00,18:15,57.63,18.18,0,57.63,57.63,1,-106994,60325,167319,-46669,0,-25619,1154,0,0,,26773,-24465
48,11/29/2018,74,18:15,18:30,60.54,43.82,0,60.54,43.82,2,-74039,70880,144919,-3159,0,-630,2546,0,0,,3176,1916
48,11/29/2018,75,18:30,18:45,,39.82,0,39.82,39.82,-1,-68437,92996,161433,24559,0,-19065,0,0,0,,19065,-19065
48,11/29/2018,76,18:45,19:00,,44.13,0,44.13,44.13,-1,-68931,91675,160606,22744,0,-15742,0,0,0,,15742,-15742
48,11/29/2018,77,19:00,19:15,56.29,44.3,0,56.29,44.3,2,-55969,39588,95557,-16381,0,-5643,4565,0,0,,10208,-1078
48,11/29/2018,78,19:15,19:30,50.85,35.82,0,50.85,35.82,2,-33004,55953,88957,22949,0,-5996,4686,0,0,,10682,-1310
48,11/29/2018,79,19:30,19:45,,35.82,0,35.82,35.82,-1,-39774,68368,108142,28594,0,-20856,0,0,0,,20856,-20856
48,11/29/2018,80,19:45,20:00,,35.82,0,35.82,35.82,-1,-46613,101004,147617,54391,0,-41536,0,0,0,,41536,-41536
48,11/29/2018,81,20:00,20:15,49.95,35.82,0,49.95,49.95,1,-59330,66700,126030,7370,0,-20872,375,0,0,,21247,-20497
48,11/29/2018,82,20:15,20:30,,32.18,0,32.18,32.18,-1,-39282,77518,116800,38236,0,-7905,0,0,0,,7905,-7905
48,11/29/2018,83,20:30,20:45,,30.03,0,30.03,30.03,-1,-43538,105270,148808,61732,0,-51464,0,0,0,,51464,-51464
48,11/29/2018,84,20:45,21:00,,9.75,0,9.75,9.75,-1,-48518,139981,188499,91463,0,-71791,0,0,0,,71791,-71791
48,11/29/2018,85,21:00,21:15,150.02,21.86,0,150.02,150.02,1,-97280,62255,159535,-35025,0,-42764,4468,0,0,,47232,-38296
48,11/29/2018,86,21:15,21:30,230.82,19.09,0,230.82,19.09,2,-44515,60252,104767,15737,0,-4668,21131,0,0,,25799,16463
48,11/29/2018,87,21:30,21:45,,2.74,0,2.74,2.74,-1,-30438,96477,126915,66039,0,-58754,0,0,0,,58754,-58754
48,11/29/2018,88,21:45,22:00,,34.24,0,34.24,34.24,-1,-43529,115951,159480,72422,0,-63714,0,0,0,,63714,-63714
48,11/29/2018,89,22:00,22:15,58.01,20.82,0,58.01,20.82,2,-95700,107347,203047,11647,0,-49967,153,0,0,,50120,-49814
48,11/29/2018,90,22:15,22:30,137.07,46.68,0,137.07,28.34,2,-78137,62434,140571,-15703,0,-2205,13303,0,0,,15508,11098
48,11/29/2018,91,22:30,22:45,137.07,34.25,0,34.25,34.25,-1,-49450,87412,136862,37962,0,-19345,11,0,0,,19356,-19334
48,11/29/2018,92,22:45,23:00,,33.83,0,33.83,33.83,-1,-40662,88457,129119,47795,0,-45066,0,0,0,,45066,-45066
48,11/29/2018,93,23:00,23:15,55.69,35.82,0,55.69,35.82,2,-78246,80952,159198,2706,0,-28515,2977,0,0,,31492,-25538
48,11/29/2018,94,23:15,23:30,73.16,46.05,0,73.16,46.05,2,-64935,49519,114454,-15416,0,-779,19327,0,0,,20106,18548
48,11/29/2018,95,23:30,23:45,73.16,39.82,0,39.82,39.82,-1,-51358,80480,131838,29122,0,-14986,12,0,0,,14998,-14974
48,11/29/2018,96,23:45,0:00,,7.81,0,7.81,7.81,-1,-46036,105252,151288,59216,0,-47890,0,0,0,,47890,-47890
48,11/30/2018,1,0:00,0:15,0,33.7,0,23,23,2,-64675,92184,156859,27509,0,-28189,13,0,0,,28202,-28176
48,11/30/2018,2,0:15,0:30,52.37,33.7,0,52.37,52.37,1,-64020,68482,132502,4462,0,-1197,1961,0,0,,3158,764
48,11/30/2018,3,0:30,0:45,52.37,,0,52.37,52.37,1,-71662,57476,129138,-14186,0,0,5931,0,0,,5931,5931
48,11/30/2018,4,0:45,1:00,47.49,46.05,0,47.49,23.84,2,-91762,105415,197177,13653,0,-547,3777,0,0,,4324,3230
48,11/30/2018,5,1:00,1:15,47.49,38.59,0,47.49,23.79,2,-66885,68748,135633,1863,0,-2193,692,0,0,,2885,-1501
48,11/30/2018,6,1:15,1:30,47.49,38.48,0,38.48,38.48,-1,-49496,70562,120058,21066,0,-9303,228,0,0,,9531,-9075
48,11/30/2018,7,1:30,1:45,,38.48,0,38.48,38.48,-1,-36644,69436,106080,32792,0,-24851,0,0,0,,24851,-24851
48,11/30/2018,8,1:45,2:00,,33.6,0,33.6,33.6,-1,-30207,70947,101154,40740,0,-24797,0,0,0,,24797,-24797
48,11/30/2018,9,2:00,2:15,,31.49,0,31.49,31.49,-1,-47207,75794,123001,28587,0,-29941,0,0,0,,29941,-29941
48,11/30/2018,10,2:15,2:30,,38.59,0,38.59,38.59,-1,-51406,75596,127002,24190,0,-28271,0,0,0,,28271,-28271
48,11/30/2018,11,2:30,2:45,,38.55,0,38.55,38.55,-1,-49408,74496,123904,25088,0,-24465,0,0,0,,24465,-24465
48,11/30/2018,12,2:45,3:00,,38.59,0,38.59,38.59,-1,-42014,67726,109740,25712,0,-23955,0,0,0,,23955,-23955
48,11/30/2018,13,3:00,3:15,,38.13,0,38.13,38.13,-1,-33882,63964,97846,30082,0,-17161,0,0,0,,17161,-17161
48,11/30/2018,14,3:15,3:30,,,0,23.59,23.59,0,-31225,70754,101979,39529,0,-899,0,0,0,,899,-899
48,11/30/2018,15,3:30,3:45,,,0,23.59,23.59,0,-35141,78113,113254,42972,0,0,0,0,0,,0,0
48,11/30/2018,16,3:45,4:00,,,0,23.59,23.59,0,-42486,77599,120085,35113,0,0,0,0,0,,0,0
48,11/30/2018,17,4:00,4:15,,42.59,0,42.59,42.59,-1,-35955,102672,138627,66717,0,-654,0,0,0,,654,-654
48,11/30/2018,18,4:15,4:30,,,0,23.61,23.61,0,-34638,98763,133401,64125,0,0,0,0,0,,0,0
48,11/30/2018,19,4:30,4:45,,,0,23.61,23.61,0,-37082,89013,126095,51931,0,0,0,0,0,,0,0
48,11/30/2018,20,4:45,5:00,,,0,23.61,23.61,0,-43300,72514,115814,29214,0,0,0,0,0,,0,0
48,11/30/2018,21,5:00,5:15,,-37.59,0,-37.59,-37.59,-1,-36581,83180,119761,46599,0,-22826,0,0,0,,22826,-22826
48,11/30/2018,22,5:15,5:30,,38.59,0,38.59,38.59,-1,-33013,53085,86098,20072,0,-22665,0,0,0,,22665,-22665
48,11/30/2018,23,5:30,5:45,145.54,43.47,0,145.54,145.54,1,-104901,47191,152092,-57710,0,-3344,8785,0,0,,12129,5441
48,11/30/2018,24,5:45,6:00,148.12,41.05,0,148.12,41.05,2,-101074,72799,173873,-28275,0,-500,29780,0,0,,30280,29280
48,11/30/2018,25,6:00,6:15,148.12,34.68,0,34.68,34.68,-1,-118878,135409,254287,16531,0,-2768,657,0,0,,3425,-2111
48,11/30/2018,26,6:15,6:30,,-3.93,0,-3.93,-3.93,-1,-78516,103857,182373,25341,0,-26591,0,0,0,,26591,-26591
48,11/30/2018,27,6:30,6:45,,42.68,0,42.68,42.68,-1,-50375,63926,114301,13551,0,-2189,0,0,0,,2189,-2189
48,11/30/2018,28,6:45,7:00,50.68,41.7,0,50.68,41.7,2,-81850,79143,160993,-2707,0,-2388,475,0,0,,2863,-1913
48,11/30/2018,29,7:00,7:15,50.68,-109.69,0,-109.69,-109.69,-1,-144800,193977,338777,49177,0,-9985,7,0,0,,9992,-9978
48,11/30/2018,30,7:15,7:30,,-133.09,0,-133.09,-133.09,-1,-34430,81917,116347,47487,0,-51810,0,0,0,,51810,-51810
48,11/30/2018,31,7:30,7:45,,46.53,0,46.53,46.53,-1,-69833,72210,142043,2377,0,-3136,0,0,0,,3136,-3136
48,11/30/2018,32,7:45,8:00,168.91,,0,168.91,168.91,1,-128162,64778,192940,-63384,0,0,21909,0,0,,21909,21909
48,11/30/2018,33,8:00,8:15,168.91,46.53,0,46.53,46.53,-1,-25915,62044,87959,36129,0,-239,13984,0,0,,14223,13745
48,11/30/2018,34,8:15,8:30,,,0,34.04,34.04,0,-16138,70359,86497,54221,0,0,0,0,0,,0,0
48,11/30/2018,35,8:30,8:45,48.24,,0,48.24,48.24,1,-37797,46690,84487,8893,0,0,195,0,0,,195,195
48,11/30/2018,36,8:45,9:00,51.62,,0,51.62,51.62,1,-55286,41899,97185,-13387,0,0,3447,0,0,,3447,3447
48,11/30/2018,37,9:00,9:15,,,0,34.04,34.04,0,-31544,65366,96910,33822,0,0,229,0,0,,229,229
48,11/30/2018,38,9:15,9:30,,,0,34.04,34.04,0,-34688,53714,88402,19026,0,0,0,0,0,,0,0
48,11/30/2018,39,9:30,9:45,47.73,,0,47.73,47.73,1,-55963,69668,125631,13705,0,0,956,0,0,,956,956
48,11/30/2018,40,9:45,10:00,0,,0,0,0,1,-42020,76521,118541,34501,0,0,96,0,0,,96,96
48,11/30/2018,41,10:00,10:15,59.64,,0,59.64,59.64,1,-101113,64704,165817,-36409,0,0,14489,0,0,,14489,14489
48,11/30/2018,42,10:15,10:30,48.28,,0,48.28,48.28,1,-88110,90386,178496,2276,0,0,11502,0,0,,11502,11502
48,11/30/2018,43,10:30,10:45,48.28,68.18,0,68.18,68.18,-1,-70521,105838,176359,35317,0,-1145,680,0,0,,1825,-465
48,11/30/2018,44,10:45,11:00,,,0,34.1,34.1,0,-68163,107417,175580,39254,0,-26,0,0,0,,26,-26
48,11/30/2018,45,11:00,11:15,51.93,,0,51.93,51.93,1,-105872,58080,163952,-47792,0,0,2881,0,0,,2881,2881
48,11/30/2018,46,11:15,11:30,55.94,,0,55.94,55.94,1,-91339,57440,148779,-33899,0,0,16544,0,0,,16544,16544
48,11/30/2018,47,11:30,11:45,50.04,,0,50.04,50.04,1,-74862,70722,145584,-4140,0,0,8708,0,0,,8708,8708
48,11/30/2018,48,11:45,12:00,50.04,68.21,0,68.21,68.21,-1,-71223,103435,174658,32212,0,-41,32,0,0,,73,-9
48,11/30/2018,49,12:00,12:15,,,0,34.1,34.1,0,-80412,102492,182904,22080,0,0,0,0,0,,0,0
48,11/30/2018,50,12:15,12:30,,,0,34.11,34.11,0,-80891,96953,177844,16062,0,0,0,0,0,,0,0
48,11/30/2018,51,12:30,12:45,50.03,,0,50.03,50.03,1,-90497,88144,178641,-2353,0,0,495,0,0,,495,495
48,11/30/2018,52,12:45,13:00,47.73,,0,47.73,47.73,1,-86704,65958,152662,-20746,0,0,1051,0,0,,1051,1051
48,11/30/2018,53,13:00,13:15,51.99,,0,51.99,51.99,1,-97894,70336,168230,-27558,0,0,2837,0,0,,2837,2837
48,11/30/2018,54,13:15,13:30,55.94,,0,55.94,55.94,1,-103718,48559,152277,-55159,0,0,7887,0,0,,7887,7887
48,11/30/2018,55,13:30,13:45,49.91,,0,49.91,49.91,1,-108541,52305,160846,-56236,0,0,460,0,0,,460,460
48,11/30/2018,56,13:45,14:00,,,0,34.7,34.7,0,-119473,39291,158764,-80182,0,0,0,0,0,,0,0
48,11/30/2018,57,14:00,14:15,55.94,,0,55.94,55.94,1,-106399,44885,151284,-61514,0,0,2084,0,0,,2084,2084
48,11/30/2018,58,14:15,14:30,55.94,,0,55.94,55.94,1,-115128,33187,148315,-81941,0,0,12474,0,0,,12474,12474
48,11/30/2018,59,14:30,14:45,256.07,,0,256.07,256.07,1,-121206,30968,152174,-90238,0,0,29583,0,0,,29583,29583
48,11/30/2018,60,14:45,15:00,54.37,,0,54.37,54.37,1,-109216,36907,146123,-72309,0,0,17827,0,0,,17827,17827
48,11/30/2018,61,15:00,15:15,54.37,45.77,0,45.77,45.77,-1,-53330,73815,127145,20485,0,-122,48,0,0,,170,-74
48,11/30/2018,62,15:15,15:30,51.86,,0,51.86,51.86,1,-71447,43200,114647,-28247,0,0,2420,0,0,,2420,2420
48,11/30/2018,63,15:30,15:45,60.96,,0,60.96,60.96,1,-67767,24616,92383,-43151,0,0,8814,0,0,,8814,8814
48,11/30/2018,64,15:45,16:00,70.94,,0,70.94,70.94,1,-73074,21204,94278,-51870,0,0,36470,0,0,,36470,36470
48,11/30/2018,65,16:00,16:15,70.94,42.7,0,42.7,42.7,-1,-25534,126609,152143,101075,0,-2067,11441,0,0,,13508,9374
48,11/30/2018,66,16:15,16:30,,,0,34.16,34.16,0,-35497,83258,118755,47761,0,0,0,0,0,,0,0
48,11/30/2018,67,16:30,16:45,51.77,,0,51.77,51.77,1,-43020,54073,97093,11053,0,0,210,0,0,,210,210
48,11/30/2018,68,16:45,17:00,263.13,,0,263.13,263.13,1,-125545,54854,180399,-70691,0,0,33074,0,0,,33074,33074
48,11/30/2018,69,17:00,17:15,199.57,37.91,0,199.57,34.15,2,-96411,48029,144440,-48382,0,-1887,14000,0,0,,15887,12113
48,11/30/2018,70,17:15,17:30,258.45,,0,258.45,258.45,1,-111409,47573,158982,-63836,0,0,56116,0,0,,56116,56116
48,11/30/2018,71,17:30,17:45,55.26,45.46,0,55.26,34.09,2,-95696,94961,190657,-735,0,-914,15745,0,0,,16659,14831
48,11/30/2018,72,17:45,18:00,51.94,45.46,0,51.94,51.94,1,-94748,94855,189603,107,0,-55,994,0,0,,1049,939
48,11/30/2018,73,18:00,18:15,55.91,44.48,0,55.91,34.03,2,-74792,62299,137091,-12493,0,-115,5920,0,0,,6035,5805
48,11/30/2018,74,18:15,18:30,,20.94,0,20.94,20.94,-1,-28221,86636,114857,58415,0,-22143,0,0,0,,22143,-22143
48,11/30/2018,75,18:30,18:45,,6.01,0,6.01,6.01,-1,-27097,108054,135151,80957,0,-45984,0,0,0,,45984,-45984
48,11/30/2018,76,18:45,19:00,,17.59,0,17.59,17.59,-1,-43410,149937,193347,106527,0,-75469,0,0,0,,75469,-75469
48,11/30/2018,77,19:00,19:15,,39.46,0,39.46,39.46,-1,-47622,57420,105042,9798,0,-27709,0,0,0,,27709,-27709
48,11/30/2018,78,19:15,19:30,,,0,25.87,25.87,0,-24827,82571,107398,57744,0,0,0,0,0,,0,0
48,11/30/2018,79,19:30,19:45,,33.88,0,33.88,33.88,-1,-34242,97280,131522,63038,0,-6517,0,0,0,,6517,-6517
48,11/30/2018,80,19:45,20:00,,20.94,0,20.94,20.94,-1,-26715,109260,135975,82545,0,-49649,0,0,0,,49649,-49649
48,11/30/2018,81,20:00,20:15,,32.97,0,32.97,32.97,-1,-60584,85392,145976,24808,0,-25529,0,0,0,,25529,-25529
48,11/30/2018,82,20:15,20:30,,,0,34.02,34.02,0,-54843,39534,94377,-15309,0,0,0,0,0,,0,0
48,11/30/2018,83,20:30,20:45,,39.94,0,39.94,39.94,-1,-44515,48441,92956,3926,0,-1931,0,0,0,,1931,-1931
48,11/30/2018,84,20:45,21:00,,22.7,0,22.7,22.7,-1,-48088,95614,143702,47526,0,-40319,0,0,0,,40319,-40319
48,11/30/2018,85,21:00,21:15,49.63,20.94,0,49.63,49.63,1,-50641,55976,106617,5335,0,-30351,894,0,0,,31245,-29457
48,11/30/2018,86,21:15,21:30,49.63,49.77,0,49.77,49.77,-1,-54248,57360,111608,3112,0,-924,711,0,0,,1635,-213
48,11/30/2018,87,21:30,21:45,,39.94,0,39.94,39.94,-1,-43364,66376,109740,23012,0,-10860,0,0,0,,10860,-10860
48,11/30/2018,88,21:45,22:00,,39.5,0,39.5,39.5,-1,-65531,74652,140183,9121,0,-14321,0,0,0,,14321,-14321
48,11/30/2018,89,22:00,22:15,47.73,35.94,0,47.73,24.86,2,-71612,78767,150379,7155,0,-3904,405,0,0,,4309,-3499
48,11/30/2018,90,22:15,22:30,47.4,,0,47.4,47.4,1,-70365,37579,107944,-32786,0,0,1337,0,0,,1337,1337
48,11/30/2018,91,22:30,22:45,47.73,,0,47.73,47.73,1,-44946,39181,84127,-5765,0,0,1509,0,0,,1509,1509
48,11/30/2018,92,22:45,23:00,47.73,,0,47.73,47.73,1,-72991,54050,127041,-18941,0,0,2325,0,0,,2325,2325
48,11/30/2018,93,23:00,23:15,62.06,,0,62.06,62.06,1,-89463,50776,140239,-38687,0,0,14853,0,0,,14853,14853
48,11/30/2018,94,23:15,23:30,48.13,,0,48.13,48.13,1,-72281,54092,126373,-18189,0,0,6716,0,0,,6716,6716
48,11/30/2018,95,23:30,23:45,,43.94,0,43.94,43.94,-1,-61112,64236,125348,3124,0,-2449,0,0,0,,2449,-2449
48,11/30/2018,96,23:45,0:00,,35.94,0,35.94,35.94,-1,-61098,86068,147166,24970,0,-10233,0,0,0,,10233,-10233
49,12-01-18,1,0:00,0:15,82.85,43.75,0,82.85,82.85,1,-111690,50760,162450,-60930,0,-3494,19530,0,0,,23024,16036
49,12-01-18,2,0:15,0:30,55.67,,0,55.67,55.67,1,-80551,61238,141789,-19313,0,0,27531,0,0,,27531,27531
49,12-01-18,3,0:30,0:45,46.71,43.75,0,51.42,43.75,2,-42927,49096,92023,6169,0,-3172,3038,0,0,,6210,-134
49,12-01-18,4,0:45,1:00,,43.75,0,43.75,43.75,-1,-48596,72766,121362,24170,0,-17986,0,0,0,,17986,-17986
49,12-01-18,5,1:00,1:15,58.63,37.15,0,58.63,58.63,1,-66721,51478,118199,-15243,0,-10196,2642,0,0,,12838,-7554
49,12-01-18,6,1:15,1:30,84.01,37.15,0,84.01,84.01,1,-92592,43645,136237,-48947,0,-198,34522,0,0,,34720,34324
49,12-01-18,7,1:30,1:45,52.02,,0,52.02,52.02,1,-70323,62111,132434,-8212,0,0,18852,0,0,,18852,18852
49,12-01-18,8,1:45,2:00,52.02,39.75,0,39.75,39.75,-1,-46987,71988,118975,25001,0,-14092,947,0,0,,15039,-13145
49,12-01-18,9,2:00,2:15,50.71,39.75,0,50.71,50.71,1,-65618,44872,110490,-20746,0,-2102,7622,0,0,,9724,5520
49,12-01-18,10,2:15,2:30,50.71,,0,50.71,50.71,1,-57347,42425,99772,-14922,0,0,7835,0,0,,7835,7835
49,12-01-18,11,2:30,2:45,54.71,,0,54.71,54.71,1,-76093,41898,117991,-34195,0,0,29469,0,0,,29469,29469
49,12-01-18,12,2:45,3:00,50.02,,0,50.02,50.02,1,-70322,48104,118426,-22218,0,0,17481,0,0,,17481,17481
49,12-01-18,13,3:00,3:15,49.26,,0,49.26,49.26,1,-73797,65003,138800,-8794,0,0,7530,0,0,,7530,7530
49,12-01-18,14,3:15,3:30,49.37,,0,49.37,49.37,1,-74126,55223,129349,-18903,0,0,14079,0,0,,14079,14079
49,12-01-18,15,3:30,3:45,46.71,49.95,0,51.42,49.95,2,-61042,55485,116527,-5557,0,-337,4149,0,0,,4486,3812
49,12-01-18,16,3:45,4:00,50.71,48.16,0,51.42,48.16,2,-44952,42344,87296,-2608,0,-260,4168,0,0,,4428,3908
49,12-01-18,17,4:00,4:15,,46.54,0,46.54,46.54,-1,-58171,58776,116947,605,0,-721,0,0,0,,721,-721
49,12-01-18,18,4:15,4:30,,43.75,0,43.75,43.75,-1,-58872,69298,128170,10426,0,-6863,0,0,0,,6863,-6863
49,12-01-18,19,4:30,4:45,,39.75,0,39.75,39.75,-1,-40758,66937,107695,26179,0,-15453,0,0,0,,15453,-15453
49,12-01-18,20,4:45,5:00,,37.9,0,37.9,37.9,-1,-37641,66653,104294,29012,0,-27313,0,0,0,,27313,-27313
49,12-01-18,21,5:00,5:15,,17.85,0,17.85,17.85,-1,-19607,90234,109841,70627,0,-50089,0,0,0,,50089,-50089
49,12-01-18,22,5:15,5:30,,33.23,0,33.23,33.23,-1,-26541,58586,85127,32045,0,-38811,0,0,0,,38811,-38811
49,12-01-18,23,5:30,5:45,,35.97,0,35.97,35.97,-1,-24212,68937,93149,44725,0,-38942,0,0,0,,38942,-38942
49,12-01-18,24,5:45,6:00,,35.97,0,35.97,35.97,-1,-24182,56242,80424,32060,0,-34757,0,0,0,,34757,-34757
49,12-01-18,25,6:00,6:15,,35.97,0,35.97,35.97,-1,-57401,114258,171659,56857,0,-47461,0,0,0,,47461,-47461
49,12-01-18,26,6:15,6:30,,35.97,0,35.97,35.97,-1,-43853,93729,137582,49876,0,-43247,0,0,0,,43247,-43247
49,12-01-18,27,6:30,6:45,,37.31,0,37.31,37.31,-1,-49886,92206,142092,42320,0,-38355,0,0,0,,38355,-38355
49,12-01-18,28,6:45,7:00,,20.97,0,20.97,20.97,-1,-40129,86331,126460,46202,0,-44142,0,0,0,,44142,-44142
49,12-01-18,29,7:00,7:15,,-104.34,0,-104.34,-104.34,-1,-53302,170635,223937,117333,0,-76219,0,0,0,,76219,-76219
49,12-01-18,30,7:15,7:30,,32.87,0,32.87,32.87,-1,-50174,117154,167328,66980,0,-66226,0,0,0,,66226,-66226
49,12-01-18,31,7:30,7:45,,20.97,0,20.97,20.97,-1,-42791,114869,157660,72078,0,-55103,0,0,0,,55103,-55103
49,12-01-18,32,7:45,8:00,,17.28,0,17.28,17.28,-1,-53337,118920,172257,65583,0,-58293,0,0,0,,58293,-58293
49,12-01-18,33,8:00,8:15,,35.97,0,35.97,35.97,-1,-46295,121528,167823,75233,0,-31703,0,0,0,,31703,-31703
49,12-01-18,34,8:15,8:30,,20.97,0,20.97,20.97,-1,-20846,134250,155096,113404,0,-62506,0,0,0,,62506,-62506
49,12-01-18,35,8:30,8:45,,28.57,0,28.57,28.57,-1,-39949,98461,138410,58512,0,-45692,0,0,0,,45692,-45692
49,12-01-18,36,8:45,9:00,,20.97,0,20.97,20.97,-1,-66600,88106,154706,21506,0,-5764,0,0,0,,5764,-5764
49,12-01-18,37,9:00,9:15,,-117.09,0,-117.09,-117.09,-1,-47500,126221,173721,78721,0,-59143,0,0,0,,59143,-59143
49,12-01-18,38,9:15,9:30,,18.51,0,18.51,18.51,-1,-51585,127364,178949,75779,0,-60758,0,0,0,,60758,-60758
49,12-01-18,39,9:30,9:45,,20.97,0,20.97,20.97,-1,-61633,119007,180640,57374,0,-76401,0,0,0,,76401,-76401
49,12-01-18,40,9:45,10:00,,37.03,0,37.03,37.03,-1,-70705,80718,151423,10013,0,-20357,0,0,0,,20357,-20357
49,12-01-18,41,10:00,10:15,,37.98,0,37.98,37.98,-1,-69463,130543,200006,61080,0,-27257,0,0,0,,27257,-27257
49,12-01-18,42,10:15,10:30,,27.81,0,27.81,27.81,-1,-67836,154191,222027,86355,0,-52997,0,0,0,,52997,-52997
49,12-01-18,43,10:30,10:45,,32.96,0,32.96,32.96,-1,-70474,127354,197828,56880,0,-51691,0,0,0,,51691,-51691
49,12-01-18,44,10:45,11:00,,35.97,0,35.97,35.97,-1,-75081,111064,186145,35983,0,-21335,0,0,0,,21335,-21335
49,12-01-18,45,11:00,11:15,,32.63,0,32.63,32.63,-1,-86762,102093,188855,15331,0,-11484,0,0,0,,11484,-11484
49,12-01-18,46,11:15,11:30,,35.97,0,35.97,35.97,-1,-74347,121312,195659,46965,0,-5665,0,0,0,,5665,-5665
49,12-01-18,47,11:30,11:45,,21.03,0,21.03,21.03,-1,-79793,135538,215331,55745,0,-44600,0,0,0,,44600,-44600
49,12-01-18,48,11:45,12:00,,29.98,0,29.98,29.98,-1,-75731,149034,224765,73303,0,-49537,0,0,0,,49537,-49537
49,12-01-18,49,12:00,12:15,51.4,29.98,0,51.4,51.4,1,-93020,59474,152494,-33546,0,-16081,1095,0,0,,17176,-14986
49,12-01-18,50,12:15,12:30,51.4,50.21,0,50.21,50.21,-1,-102411,108412,210823,6001,0,-747,6,0,0,,753,-741
49,12-01-18,51,12:30,12:45,,48.27,0,48.27,48.27,-1,-99273,113640,212913,14367,0,-5956,0,0,0,,5956,-5956
49,12-01-18,52,12:45,13:00,,49.24,0,49.24,49.24,-1,-99237,112350,211587,13113,0,-2536,0,0,0,,2536,-2536
49,12-01-18,53,13:00,13:15,50.71,,0,50.71,50.71,1,-91603,76607,168210,-14996,0,0,1866,0,0,,1866,1866
49,12-01-18,54,13:15,13:30,50.71,,0,50.71,50.71,1,-96039,64591,160630,-31448,0,0,1653,0,0,,1653,1653
49,12-01-18,55,13:30,13:45,51.56,,0,51.56,51.56,1,-92195,73797,165992,-18398,0,0,5689,0,0,,5689,5689
49,12-01-18,56,13:45,14:00,46.71,,0,46.71,46.71,1,-89174,66360,155534,-22814,0,0,1757,0,0,,1757,1757
49,12-01-18,57,14:00,14:15,46.71,,0,46.71,46.71,1,-86577,81331,167908,-5246,0,0,624,0,0,,624,624
49,12-01-18,58,14:15,14:30,46.71,,0,46.71,46.71,1,-82459,88072,170531,5613,0,0,1815,0,0,,1815,1815
49,12-01-18,59,14:30,14:45,46.71,,0,46.71,46.71,1,-68463,85592,154055,17129,0,0,62,0,0,,62,62
49,12-01-18,60,14:45,15:00,,,0,48.92,48.92,0,-52186,86315,138501,34129,0,0,0,0,0,,0,0
49,12-01-18,61,15:00,15:15,,,0,48.92,48.92,0,-59482,79363,138845,19881,0,0,0,0,0,,0,0
49,12-01-18,62,15:15,15:30,,,0,48.92,48.92,0,-48041,80265,128306,32224,0,0,0,0,0,,0,0
49,12-01-18,63,15:30,15:45,,,0,48.92,48.92,0,-41414,71881,113295,30467,0,0,0,0,0,,0,0
49,12-01-18,64,15:45,16:00,,43.75,0,43.75,43.75,-1,-37874,68829,106703,30955,0,-556,0,0,0,,556,-556
49,12-01-18,65,16:00,16:15,,21.86,0,21.86,21.86,-1,-21256,82060,103316,60804,0,-33677,0,0,0,,33677,-33677
49,12-01-18,66,16:15,16:30,,40.29,0,40.29,40.29,-1,-25240,64257,89497,39017,0,-16928,0,0,0,,16928,-16928
49,12-01-18,67,16:30,16:45,,45.6,0,45.6,45.6,-1,-31835,46549,78384,14714,0,-1313,0,0,0,,1313,-1313
49,12-01-18,68,16:45,17:00,,,0,48.26,48.26,0,-79214,61284,140498,-17930,0,0,0,0,0,,0,0
49,12-01-18,69,17:00,17:15,,35.97,0,35.97,35.97,-1,-41840,72176,114016,30336,0,-8349,0,0,0,,8349,-8349
49,12-01-18,70,17:15,17:30,,39.48,0,39.48,39.48,-1,-48485,72007,120492,23522,0,-24770,0,0,0,,24770,-24770
49,12-01-18,71,17:30,17:45,,39.48,0,39.48,39.48,-1,-38683,61950,100633,23267,0,-10398,0,0,0,,10398,-10398
49,12-01-18,72,17:45,18:00,,35.97,0,35.97,35.97,-1,-39264,83041,122305,43777,0,-25143,0,0,0,,25143,-25143
49,12-01-18,73,18:00,18:15,,40.03,0,40.03,40.03,-1,-74311,88485,162796,14174,0,-24394,0,0,0,,24394,-24394
49,12-01-18,74,18:15,18:30,,39.01,0,39.01,39.01,-1,-64046,84678,148724,20632,0,-12644,0,0,0,,12644,-12644
49,12-01-18,75,18:30,18:45,,29.03,0,29.03,29.03,-1,-52146,90468,142614,38322,0,-35310,0,0,0,,35310,-35310
49,12-01-18,76,18:45,19:00,,40.03,0,40.03,40.03,-1,-64284,82591,146875,18307,0,-20015,0,0,0,,20015,-20015
49,12-01-18,77,19:00,19:15,46.71,49.35,0,46.71,46.65,2,-107072,97973,205045,-9099,0,-2243,715,0,0,,2958,-1528
49,12-01-18,78,19:15,19:30,54.71,,0,54.71,54.71,1,-95984,65007,160991,-30977,0,0,18324,0,0,,18324,18324
49,12-01-18,79,19:30,19:45,50.71,,0,50.71,50.71,1,-92910,76901,169811,-16009,0,0,19001,0,0,,19001,19001
49,12-01-18,80,19:45,20:00,46.71,,0,46.71,46.71,1,-86865,80493,167358,-6372,0,0,7367,0,0,,7367,7367
49,12-01-18,81,20:00,20:15,82.84,,0,82.84,82.84,1,-115051,64666,179717,-50385,0,0,20586,0,0,,20586,20586
49,12-01-18,82,20:15,20:30,58.34,,0,58.34,58.34,1,-102533,54036,156569,-48497,0,0,49794,0,0,,49794,49794
49,12-01-18,83,20:30,20:45,43.79,31.19,0,31.19,31.19,-1,-71457,83895,155352,12438,0,-3807,17007,0,0,,20814,13200
49,12-01-18,84,20:45,21:00,53.85,35.97,0,53.85,35.97,2,-72337,57913,130250,-14424,0,-5349,6062,0,0,,11411,713
49,12-01-18,85,21:00,21:15,49.1,53.13,0,51.42,51.42,2,-75984,72123,148107,-3861,0,-64,1854,0,0,,1918,1790
49,12-01-18,86,21:15,21:30,54.71,39.01,0,54.71,39.01,2,-64903,67810,132713,2907,0,-766,8237,0,0,,9003,7471
49,12-01-18,87,21:30,21:45,54.71,24.78,0,24.78,24.78,-1,-38345,68176,106521,29831,0,-21371,60,0,0,,21431,-21311
49,12-01-18,88,21:45,22:00,,39.01,0,39.01,39.01,-1,-25999,62572,88571,36573,0,-22009,0,0,0,,22009,-22009
49,12-01-18,89,22:00,22:15,,38.03,0,38.03,38.03,-1,-59719,68735,128454,9016,0,-20255,0,0,0,,20255,-20255
49,12-01-18,90,22:15,22:30,49.1,43.75,0,51.42,43.75,2,-47382,53237,100619,5855,0,-1099,1503,0,0,,2602,404
49,12-01-18,91,22:30,22:45,,38.6,0,38.6,38.6,-1,-45750,65698,111448,19948,0,-8600,0,0,0,,8600,-8600
49,12-01-18,92,22:45,23:00,,35.97,0,35.97,35.97,-1,-33389,66506,99895,33117,0,-13451,0,0,0,,13451,-13451
49,12-01-18,93,23:00,23:15,54.71,35.97,0,54.71,35.97,2,-70322,51705,122027,-18617,0,-13269,6175,0,0,,19444,-7094
49,12-01-18,94,23:15,23:30,49.63,35.97,0,49.63,49.63,1,-74997,64719,139716,-10278,0,-161,8339,0,0,,8500,8178
49,12-01-18,95,23:30,23:45,46.71,43.75,0,51.42,43.75,2,-51814,61248,113062,9434,0,-917,1313,0,0,,2230,396
49,12-01-18,96,23:45,0:00,,35.97,0,35.97,35.97,-1,-32013,64890,96903,32877,0,-12287,0,0,0,,12287,-12287
49,12-02-18,1,0:00,0:15,49.12,27.71,0,49.12,49.12,1,-83426,95855,179281,12429,0,-10129,73,0,0,,10202,-10056
49,12-02-18,2,0:15,0:30,50.93,,0,50.93,50.93,1,-60230,65231,125461,5001,0,0,438,0,0,,438,438
49,12-02-18,3,0:30,0:45,55.58,,0,55.58,55.58,1,-64190,44263,108453,-19927,0,0,8031,0,0,,8031,8031
49,12-02-18,4,0:45,1:00,55.58,35.54,0,55.58,35.54,2,-58038,55028,113066,-3010,0,-143,17661,0,0,,17804,17518
49,12-02-18,5,1:00,1:15,55.58,-100.21,0,-100.21,-100.21,-1,-62371,107997,170368,45626,0,-23799,2059,0,0,,25858,-21740
49,12-02-18,6,1:15,1:30,,35.54,0,35.54,35.54,-1,-50596,78255,128851,27659,0,-5943,0,0,0,,5943,-5943
49,12-02-18,7,1:30,1:45,,40.21,0,40.21,40.21,-1,-43798,82590,126388,38792,0,-5302,0,0,0,,5302,-5302
49,12-02-18,8,1:45,2:00,,40.41,0,40.41,40.41,-1,-43832,61093,104925,17261,0,-5921,0,0,0,,5921,-5921
49,12-02-18,9,2:00,2:15,70.58,40.41,0,70.58,70.58,1,-82261,47833,130094,-34428,0,-1591,11954,0,0,,13545,10363
49,12-02-18,10,2:15,2:30,54.13,,0,54.13,54.13,1,-63861,30164,94025,-33697,0,0,21163,0,0,,21163,21163
49,12-02-18,11,2:30,2:45,51.36,,0,51.36,51.36,1,-63527,35086,98613,-28441,0,0,20453,0,0,,20453,20453
49,12-02-18,12,2:45,3:00,51.36,,0,51.36,51.36,1,-61379,31102,92481,-30277,0,0,18100,0,0,,18100,18100
49,12-02-18,13,3:00,3:15,51.36,,0,51.36,51.36,1,-73273,52465,125738,-20808,0,0,18980,0,0,,18980,18980
49,12-02-18,14,3:15,3:30,54.46,,0,54.46,54.46,1,-82760,51839,134599,-30921,0,0,23157,0,0,,23157,23157
49,12-02-18,15,3:30,3:45,50.5,,0,50.5,50.5,1,-74256,58929,133185,-15327,0,0,18040,0,0,,18040,18040
49,12-02-18,16,3:45,4:00,47.36,40.41,0,47.36,40.41,2,-72652,66107,138759,-6545,0,-433,3150,0,0,,3583,2717
49,12-02-18,17,4:00,4:15,,41.85,0,41.85,41.85,-1,-49979,88684,138663,38705,0,-1702,0,0,0,,1702,-1702
49,12-02-18,18,4:15,4:30,,43.36,0,43.36,43.36,-1,-48758,82734,131492,33976,0,-118,0,0,0,,118,-118
49,12-02-18,19,4:30,4:45,,41.88,0,41.88,41.88,-1,-48326,86491,134817,38165,0,-3287,0,0,0,,3287,-3287
49,12-02-18,20,4:45,5:00,,41.91,0,41.91,41.91,-1,-61958,70515,132473,8557,0,-2985,0,0,0,,2985,-2985
49,12-02-18,21,5:00,5:15,,35.54,0,35.54,35.54,-1,-50262,81853,132115,31591,0,-5829,0,0,0,,5829,-5829
49,12-02-18,22,5:15,5:30,,35.54,0,35.54,35.54,-1,-58460,67697,126157,9237,0,-13465,0,0,0,,13465,-13465
49,12-02-18,23,5:30,5:45,,41.69,0,41.69,41.69,-1,-52758,65348,118106,12590,0,-3618,0,0,0,,3618,-3618
49,12-02-18,24,5:45,6:00,,35.54,0,35.54,35.54,-1,-45130,76124,121254,30994,0,-7052,0,0,0,,7052,-7052
49,12-02-18,25,6:00,6:15,,35.68,0,35.68,35.68,-1,-63004,99751,162755,36747,0,-12734,0,0,0,,12734,-12734
49,12-02-18,26,6:15,6:30,,40.62,0,40.62,40.62,-1,-55561,82448,138009,26887,0,-14740,0,0,0,,14740,-14740
49,12-02-18,27,6:30,6:45,,41.01,0,41.01,41.01,-1,-61079,76900,137979,15821,0,-13574,0,0,0,,13574,-13574
49,12-02-18,28,6:45,7:00,,43.51,0,43.51,43.51,-1,-80155,82697,162852,2542,0,-1355,0,0,0,,1355,-1355
49,12-02-18,29,7:00,7:15,,-16.84,0,-16.84,-16.84,-1,-31973,85594,117567,53621,0,-30879,0,0,0,,30879,-30879
49,12-02-18,30,7:15,7:30,,43.51,0,43.51,43.51,-1,-62141,74358,136499,12217,0,-6780,0,0,0,,6780,-6780
49,12-02-18,31,7:30,7:45,49.32,48.07,0,49.32,47.79,2,-83979,76473,160452,-7506,0,-1381,389,0,0,,1770,-992
49,12-02-18,32,7:45,8:00,51.51,,0,51.51,51.51,1,-95673,81726,177399,-13947,0,0,1698,0,0,,1698,1698
49,12-02-18,33,8:00,8:15,55.72,,0,55.72,55.72,1,-98357,87217,185574,-11140,0,0,4119,0,0,,4119,4119
49,12-02-18,34,8:15,8:30,55.72,,0,55.72,55.72,1,-107865,92765,200630,-15100,0,0,10658,0,0,,10658,10658
49,12-02-18,35,8:30,8:45,51.51,,0,51.51,51.51,1,-119278,103467,222745,-15811,0,0,10750,0,0,,10750,10750
49,12-02-18,36,8:45,9:00,51.51,,0,51.51,51.51,1,-129451,99938,229389,-29513,0,0,17902,0,0,,17902,17902
49,12-02-18,37,9:00,9:15,55.72,48.92,0,55.72,48.22,2,-107750,101682,209432,-6068,0,-534,10701,0,0,,11235,10167
49,12-02-18,38,9:15,9:30,55.72,,0,55.72,55.72,1,-123248,96972,220220,-26276,0,0,17992,0,0,,17992,17992
49,12-02-18,39,9:30,9:45,93.35,,0,93.35,93.35,1,-141872,87648,229520,-54224,0,0,24953,0,0,,24953,24953
49,12-02-18,40,9:45,10:00,267.12,,0,267.12,267.12,1,-186389,104343,290732,-82046,0,0,62665,17500,0,,80165,80165
49,12-02-18,41,10:00,10:15,70.72,,0,70.72,70.72,1,-219202,182076,401278,-37126,0,0,23547,0,0,,23547,23547
49,12-02-18,42,10:15,10:30,73.91,,0,73.91,73.91,1,-223608,155615,379223,-67993,0,0,57697,0,0,,57697,57697
49,12-02-18,43,10:30,10:45,93.81,,0,93.81,93.81,1,-226493,144017,370510,-82476,0,0,67453,0,0,,67453,67453
49,12-02-18,44,10:45,11:00,106.12,,0,106.12,106.12,1,-227197,129708,356905,-97489,0,0,81200,0,0,,81200,81200
49,12-02-18,45,11:00,11:15,259.12,,0,259.12,259.12,1,-264139,157915,422054,-106224,0,0,91280,0,0,,91280,91280
49,12-02-18,46,11:15,11:30,232.12,,0,232.12,232.12,1,-266458,156998,423456,-109460,0,0,84630,0,0,,84630,84630
49,12-02-18,47,11:30,11:45,267.53,,0,267.53,267.53,1,-265118,146880,411998,-118238,0,0,95547,17500,0,,113047,113047
49,12-02-18,48,11:45,12:00,259.12,,0,259.12,259.12,1,-269123,144329,413452,-124794,0,0,91882,0,0,,91882,91882
49,12-02-18,49,12:00,12:15,256.12,,0,281.73,281.73,1,-291950,113625,405575,-178325,0,0,109518,16250,508,,126276,126276
49,12-02-18,50,12:15,12:30,267,,0,293.7,293.7,1,-272499,146212,418711,-126287,0,0,104807,3750,26232,,134789,134789
49,12-02-18,51,12:30,12:45,96.12,,0,267,267,1,-267238,153756,420994,-113482,0,0,77771,0,26577,,104348,104348
49,12-02-18,52,12:45,13:00,256.12,,0,281.73,281.73,1,-273445,146968,420413,-126477,0,0,90391,0,26577,,116968,116968
49,12-02-18,53,13:00,13:15,84.12,,0,266.6,266.6,1,-247006,139852,386858,-107154,0,0,77921,0,26577,,104498,104498
49,12-02-18,54,13:15,13:30,350.12,,0,350.12,350.12,1,-252442,151591,404033,-100851,0,0,85545,0,0,,85545,85545
49,12-02-18,55,13:30,13:45,98.11,,0,98.11,98.11,1,-252810,172059,424869,-80751,0,0,82283,0,0,,82283,82283
49,12-02-18,56,13:45,14:00,101.64,,0,101.64,101.64,1,-240173,156783,396956,-83390,0,0,77135,0,0,,77135,77135
49,12-02-18,57,14:00,14:15,65,,0,65,65,1,-210468,131129,341597,-79339,0,0,74619,0,0,,74619,74619
49,12-02-18,58,14:15,14:30,77.23,,0,77.23,77.23,1,-206595,135819,342414,-70776,0,0,71888,0,0,,71888,71888
49,12-02-18,59,14:30,14:45,51.48,,0,51.48,51.48,1,-197666,153088,350754,-44578,0,0,34005,0,0,,34005,34005
49,12-02-18,60,14:45,15:00,260.12,,0,260.12,260.12,1,-215959,137138,353097,-78821,0,0,61480,0,0,,61480,61480
49,12-02-18,61,15:00,15:15,60.72,,0,60.72,60.72,1,-203950,125489,329439,-78461,0,0,72207,0,0,,72207,72207
49,12-02-18,62,15:15,15:30,238.12,,0,238.12,238.12,1,-209460,119617,329077,-89843,0,0,70132,0,0,,70132,70132
49,12-02-18,63,15:30,15:45,241.12,,0,241.12,241.12,1,-260802,135989,396791,-124813,0,0,102559,0,0,,102559,102559
49,12-02-18,64,15:45,16:00,350.12,50.1,0,350.12,48.65,2,-286869,155018,441887,-131851,0,-3,91286,0,0,,91289,91283
49,12-02-18,65,16:00,16:15,350.12,-134.19,0,-134.19,-134.19,-1,-139296,230494,369790,91198,0,-28176,8731,0,0,,36907,-19445
49,12-02-18,66,16:15,16:30,47.51,-134.19,0,47.51,47.51,1,-164375,162361,326736,-2014,0,-2127,472,0,0,,2599,-1655
49,12-02-18,67,16:30,16:45,,,0,48.85,48.85,0,-114226,122642,236868,8416,0,0,0,0,0,,0,0
49,12-02-18,68,16:45,17:00,55.46,,0,55.46,55.46,1,-163529,126759,290288,-36770,0,0,15462,0,0,,15462,15462
49,12-02-18,69,17:00,17:15,48.51,47.94,0,48.88,47.94,2,-100181,147604,247785,47423,0,-793,5950,0,0,,6743,5157
49,12-02-18,70,17:15,17:30,,39.51,0,39.51,39.51,-1,-131712,149015,280727,17303,0,-2931,0,0,0,,2931,-2931
49,12-02-18,71,17:30,17:45,58,39.51,0,58,58,1,-195176,166737,361913,-28439,0,-87,4743,0,0,,4830,4656
49,12-02-18,72,17:45,18:00,72.12,,0,72.12,72.12,1,-220233,178905,399138,-41328,0,0,42149,0,0,,42149,42149
49,12-02-18,73,18:00,18:15,112.79,,0,112.79,112.79,1,-228583,136213,364796,-92370,0,0,57745,0,0,,57745,57745
49,12-02-18,74,18:15,18:30,55.9,,0,55.9,55.9,1,-177634,129777,307411,-47857,0,0,53038,0,0,,53038,53038
49,12-02-18,75,18:30,18:45,50.72,,0,50.72,50.72,1,-133587,104632,238219,-28955,0,0,22264,0,0,,22264,22264
49,12-02-18,76,18:45,19:00,47.51,43.51,0,48.84,43.51,2,-94756,111621,206377,16865,0,-2662,6321,0,0,,8983,3659
49,12-02-18,77,19:00,19:15,,39.51,0,39.51,39.51,-1,-118471,127403,245874,8932,0,-9482,0,0,0,,9482,-9482
49,12-02-18,78,19:15,19:30,,41.41,0,41.41,41.41,-1,-90690,107470,198160,16780,0,-10133,0,0,0,,10133,-10133
49,12-02-18,79,19:30,19:45,,43.51,0,43.51,43.51,-1,-97314,110092,207406,12778,0,-18515,0,0,0,,18515,-18515
49,12-02-18,80,19:45,20:00,48.51,43.93,0,48.86,43.93,2,-114583,108944,223527,-5639,0,-4599,856,0,0,,5455,-3743
49,12-02-18,81,20:00,20:15,82.96,43.51,0,82.96,43.51,2,-161389,121541,282930,-39848,0,-439,16135,0,0,,16574,15696
49,12-02-18,82,20:15,20:30,55,47.12,0,55,47.12,2,-135147,119712,254859,-15435,0,-98,26074,0,0,,26172,25976
49,12-02-18,83,20:30,20:45,55,35.68,0,35.68,35.68,-1,-109778,131125,240903,21347,0,-15951,2470,0,0,,18421,-13481
49,12-02-18,84,20:45,21:00,,35.68,0,35.68,35.68,-1,-89365,120154,209519,30789,0,-19177,0,0,0,,19177,-19177
49,12-02-18,85,21:00,21:15,244.12,43.51,0,244.12,244.12,1,-128029,42706,170735,-85323,0,-7866,23287,0,0,,31153,15421
49,12-02-18,86,21:15,21:30,244.12,,0,244.12,244.12,1,-110508,47733,158241,-62775,0,0,70848,0,0,,70848,70848
49,12-02-18,87,21:30,21:45,55.72,,0,55.72,55.72,1,-103546,71629,175175,-31917,0,0,30454,0,0,,30454,30454
49,12-02-18,88,21:45,22:00,51.51,,0,51.51,51.51,1,-86685,71535,158220,-15150,0,0,18755,0,0,,18755,18755
49,12-02-18,89,22:00,22:15,55.72,,0,55.72,55.72,1,-91536,67880,159416,-23656,0,0,9038,0,0,,9038,9038
49,12-02-18,90,22:15,22:30,55.72,,0,55.72,55.72,1,-81184,47623,128807,-33561,0,0,31887,0,0,,31887,31887
49,12-02-18,91,22:30,22:45,51.08,,0,51.08,51.08,1,-66561,50412,116973,-16149,0,0,15356,0,0,,15356,15356
49,12-02-18,92,22:45,23:00,49.12,45.71,0,49.12,45.71,2,-54474,62105,116579,7631,0,-1602,3967,0,0,,5569,2365
49,12-02-18,93,23:00,23:15,58.34,43.51,0,58.34,58.34,1,-108834,74213,183047,-34621,0,-539,5479,0,0,,6018,4940
49,12-02-18,94,23:15,23:30,70.72,,0,70.72,70.72,1,-108489,68316,176805,-40173,0,0,33564,0,0,,33564,33564
49,12-02-18,95,23:30,23:45,51.35,,0,51.35,51.35,1,-94319,69957,164276,-24362,0,0,20468,0,0,,20468,20468
49,12-02-18,96,23:45,0:00,49.13,35.68,0,49.13,35.68,2,-50406,74870,125276,24464,0,-6385,8138,0,0,,14523,1753
49,12-03-18,1,0:00,0:15,54.81,49,0,54.81,48.03,2,-105980,77538,183518,-28442,0,-665,12921,0,0,,13586,12256
49,12-03-18,2,0:15,0:30,53.06,,0,53.06,53.06,1,-73683,53769,127452,-19914,0,0,6367,0,0,,6367,6367
49,12-03-18,3,0:30,0:45,57.32,,0,57.32,57.32,1,-68043,48791,116834,-19252,0,0,23056,0,0,,23056,23056
49,12-03-18,4,0:45,1:00,57.32,42.8,0,42.8,42.8,-1,-51953,57900,109853,5947,0,-56,1261,0,0,,1317,1205
49,12-03-18,5,1:00,1:15,56.31,37.71,0,56.31,37.71,2,-70747,53452,124199,-17295,0,-2923,3175,0,0,,6098,252
49,12-03-18,6,1:15,1:30,60.91,43.51,0,60.91,43.51,2,-66273,56939,123212,-9334,0,-313,14720,0,0,,15033,14407
49,12-03-18,7,1:30,1:45,,39.51,0,39.51,39.51,-1,-52158,64561,116719,12403,0,-6138,0,0,0,,6138,-6138
49,12-03-18,8,1:45,2:00,,43.51,0,43.51,43.51,-1,-50642,60195,110837,9553,0,-9922,0,0,0,,9922,-9922
49,12-03-18,9,2:00,2:15,47.51,43.51,0,47.51,47.51,1,-66066,62004,128070,-4062,0,-2216,1175,0,0,,3391,-1041
49,12-03-18,10,2:15,2:30,47.13,46.9,0,46.9,46.9,-1,-63952,76528,140480,12576,0,-6,816,0,0,,822,810
49,12-03-18,11,2:30,2:45,,36.8,0,36.8,36.8,-1,-52272,75892,128164,23620,0,-11266,0,0,0,,11266,-11266
49,12-03-18,12,2:45,3:00,,43.51,0,43.51,43.51,-1,-55621,61429,117050,5808,0,-11605,0,0,0,,11605,-11605
49,12-03-18,13,3:00,3:15,,35.68,0,35.68,35.68,-1,-38467,98597,137064,60130,0,-10627,0,0,0,,10627,-10627
49,12-03-18,14,3:15,3:30,,30.69,0,30.69,30.69,-1,-37406,81010,118416,43604,0,-18045,0,0,0,,18045,-18045
49,12-03-18,15,3:30,3:45,,30.7,0,30.7,30.7,-1,-31726,77247,108973,45521,0,-40817,0,0,0,,40817,-40817
49,12-03-18,16,3:45,4:00,,35.68,0,35.68,35.68,-1,-33178,80132,113310,46954,0,-40969,0,0,0,,40969,-40969
49,12-03-18,17,4:00,4:15,,4.26,0,4.26,4.26,-1,-35790,102852,138642,67062,0,-51514,0,0,0,,51514,-51514
49,12-03-18,18,4:15,4:30,,34,0,34,34,-1,-44917,73341,118258,28424,0,-31223,0,0,0,,31223,-31223
49,12-03-18,19,4:30,4:45,,43.51,0,43.51,43.51,-1,-46994,71332,118326,24338,0,-10965,0,0,0,,10965,-10965
49,12-03-18,20,4:45,5:00,,34,0,34,34,-1,-40369,101487,141856,61118,0,-2691,0,0,0,,2691,-2691
49,12-03-18,21,5:00,5:15,,-29.24,0,-29.24,-29.24,-1,-52590,121839,174429,69249,0,-36707,0,0,0,,36707,-36707
49,12-03-18,22,5:15,5:30,,35.68,0,35.68,35.68,-1,-42397,94860,137257,52463,0,-27524,0,0,0,,27524,-27524
49,12-03-18,23,5:30,5:45,,,0,44.06,44.06,0,-62396,83188,145584,20792,0,-2016,0,0,0,,2016,-2016
49,12-03-18,24,5:45,6:00,,,0,43.98,43.98,0,-58565,112538,171103,53973,0,0,0,0,0,,0,0
49,12-03-18,25,6:00,6:15,47.6,,0,47.6,47.6,1,-205458,120394,325852,-85064,0,0,1111,0,0,,1111,1111
49,12-03-18,26,6:15,6:30,49.78,,0,49.78,49.78,1,-128703,96754,225457,-31949,0,0,4276,0,0,,4276,4276
49,12-03-18,27,6:30,6:45,47.81,,0,47.81,47.81,1,-116760,89235,205995,-27525,0,0,7964,0,0,,7964,7964
49,12-03-18,28,6:45,7:00,47.6,,0,47.6,47.6,1,-121161,82065,203226,-39096,0,0,3038,0,0,,3038,3038
49,12-03-18,29,7:00,7:15,163.11,,0,163.11,163.11,1,-183901,151194,335095,-32707,0,0,40033,0,0,,40033,40033
49,12-03-18,30,7:15,7:30,120.6,,0,120.6,120.6,1,-178294,131458,309752,-46836,0,0,52624,0,0,,52624,52624
49,12-03-18,31,7:30,7:45,70.5,,0,70.5,70.5,1,-176239,126144,302383,-50095,0,0,73504,0,0,,73504,73504
49,12-03-18,32,7:45,8:00,70.18,,0,70.18,70.18,1,-216624,154639,371263,-61985,0,0,70450,0,0,,70450,70450
49,12-03-18,33,8:00,8:15,70.18,49.84,0,49.84,49.84,-1,-134324,127984,262308,-6340,0,-31,28598,0,0,,28629,28567
49,12-03-18,34,8:15,8:30,46.56,,0,46.56,46.56,1,-136001,106136,242137,-29865,0,0,1278,0,0,,1278,1278
49,12-03-18,35,8:30,8:45,52.92,,0,52.92,52.92,1,-124614,80130,204744,-44484,0,0,7806,0,0,,7806,7806
49,12-03-18,36,8:45,9:00,70.18,,0,70.18,70.18,1,-144644,56852,201496,-87792,0,0,54547,0,0,,54547,54547
49,12-03-18,37,9:00,9:15,70.18,43.34,0,43.34,43.34,-1,-100316,100814,201130,498,0,-1229,28243,0,0,,29472,27014
49,12-03-18,38,9:15,9:30,,45.87,0,45.87,45.87,-1,-103694,102516,206210,-1178,0,-1357,0,0,0,,1357,-1357
49,12-03-18,39,9:30,9:45,,49.75,0,49.75,49.75,-1,-109423,110817,220240,1394,0,-7,0,0,0,,7,-7
49,12-03-18,40,9:45,10:00,48.49,49.74,0,48.49,48.15,2,-110918,95873,206791,-15045,0,-56,3780,0,0,,3836,3724
49,12-03-18,41,10:00,10:15,48.49,38.56,0,38.56,38.56,-1,-55938,94973,150911,39035,0,-4773,362,0,0,,5135,-4411
49,12-03-18,42,10:15,10:30,,34.26,0,34.26,34.26,-1,-44278,107806,152084,63528,0,-29640,0,0,0,,29640,-29640
49,12-03-18,43,10:30,10:45,,31.26,0,31.26,31.26,-1,-49604,121679,171283,72075,0,-51174,0,0,0,,51174,-51174
49,12-03-18,44,10:45,11:00,,23.59,0,23.59,23.59,-1,-35640,109385,145025,73745,0,-55758,0,0,0,,55758,-55758
49,12-03-18,45,11:00,11:15,54.56,36.16,0,54.56,36.16,2,-88076,73066,161142,-15010,0,-22374,4807,0,0,,27181,-17567
49,12-03-18,46,11:15,11:30,46.56,42.56,0,48.13,42.56,2,-64203,84044,148247,19841,0,-2888,1131,0,0,,4019,-1757
49,12-03-18,47,11:30,11:45,,45.81,0,45.81,45.81,-1,-60998,102831,163829,41833,0,-4699,0,0,0,,4699,-4699
49,12-03-18,48,11:45,12:00,,,0,48.13,48.13,0,-66886,119015,185901,52129,0,0,0,0,0,,0,0
49,12-03-18,49,12:00,12:15,,,0,48.13,48.13,0,-46071,88908,134979,42837,0,0,0,0,0,,0,0
49,12-03-18,50,12:15,12:30,,,0,48.13,48.13,0,-54998,65080,120078,10082,0,0,0,0,0,,0,0
49,12-03-18,51,12:30,12:45,,49.7,0,49.7,49.7,-1,-59958,79340,139298,19382,0,-281,0,0,0,,281,-281
49,12-03-18,52,12:45,13:00,46.56,,0,46.56,46.56,1,-64629,58806,123435,-5823,0,0,536,0,0,,536,536
49,12-03-18,53,13:00,13:15,50.56,,0,50.56,50.56,1,-81683,68648,150331,-13035,0,0,6388,0,0,,6388,6388
49,12-03-18,54,13:15,13:30,69.16,,0,69.16,69.16,1,-108379,38844,147223,-69535,0,0,37911,0,0,,37911,37911
49,12-03-18,55,13:30,13:45,72.26,,0,72.26,72.26,1,-130133,47392,177525,-82741,0,0,61421,0,0,,61421,61421
49,12-03-18,56,13:45,14:00,70.04,,0,70.04,70.04,1,-133247,41918,175165,-91329,0,0,68238,0,0,,68238,68238
49,12-03-18,57,14:00,14:15,59.16,,0,59.16,59.16,1,-101854,65091,166945,-36763,0,0,56049,0,0,,56049,56049
49,12-03-18,58,14:15,14:30,76.17,,0,76.17,76.17,1,-119280,48468,167748,-70812,0,0,49683,0,0,,49683,49683
49,12-03-18,59,14:30,14:45,80.16,,0,80.16,80.16,1,-120043,57132,177175,-62911,0,0,69335,0,0,,69335,69335
49,12-03-18,60,14:45,15:00,76.17,,0,76.17,76.17,1,-128933,62468,191401,-66465,0,0,53461,0,0,,53461,53461
49,12-03-18,61,15:00,15:15,54.56,46.08,0,46.08,46.08,-1,-76954,100536,177490,23582,0,-1625,20409,0,0,,22034,18784
49,12-03-18,62,15:15,15:30,,,0,48.24,48.24,0,-88009,81528,169537,-6481,0,-29,0,0,0,,29,-29
49,12-03-18,63,15:30,15:45,111.16,,0,111.16,111.16,1,-119728,68679,188407,-51049,0,0,10417,0,0,,10417,10417
49,12-03-18,64,15:45,16:00,120.6,,0,120.6,120.6,1,-150313,83014,233327,-67299,0,0,53433,0,0,,53433,53433
49,12-03-18,65,16:00,16:15,66.09,31.08,0,31.08,31.08,-1,-86838,134550,221388,47712,0,-5116,25099,0,0,,30215,19983
49,12-03-18,66,16:15,16:30,,31.08,0,31.08,31.08,-1,-97026,113626,210652,16600,0,-9849,0,0,0,,9849,-9849
49,12-03-18,67,16:30,16:45,,,0,48.24,48.24,0,-85207,106453,191660,21246,0,0,0,0,0,,0,0
49,12-03-18,68,16:45,17:00,52.18,,0,52.18,52.18,1,-115786,112458,228244,-3328,0,0,1577,0,0,,1577,1577
49,12-03-18,69,17:00,17:15,57.02,,0,57.02,57.02,1,-78598,86139,164737,7541,0,0,4184,0,0,,4184,4184
49,12-03-18,70,17:15,17:30,,,0,48.68,48.68,0,-77465,86820,164285,9355,0,0,0,0,0,,0,0
49,12-03-18,71,17:30,17:45,,,0,48.69,48.69,0,-79861,79034,158895,-827,0,0,0,0,0,,0,0
49,12-03-18,72,17:45,18:00,,49.17,0,49.17,49.17,-1,-63254,85828,149082,22574,0,-209,0,0,0,,209,-209
49,12-03-18,73,18:00,18:15,,39.6,0,39.6,39.6,-1,-103023,118539,221562,15516,0,-8477,0,0,0,,8477,-8477
49,12-03-18,74,18:15,18:30,,35.58,0,35.58,35.58,-1,-83637,134589,218226,50952,0,-34093,0,0,0,,34093,-34093
49,12-03-18,75,18:30,18:45,,39.6,0,39.6,39.6,-1,-84994,131897,216891,46903,0,-32692,0,0,0,,32692,-32692
49,12-03-18,76,18:45,19:00,51.6,39.6,0,51.6,51.6,1,-74045,91880,165925,17835,0,-5219,376,0,0,,5595,-4843
49,12-03-18,77,19:00,19:15,80,,0,80,80,1,-136062,81829,217891,-54233,0,0,14475,0,0,,14475,14475
49,12-03-18,78,19:15,19:30,51.6,49.92,0,49.92,49.92,-1,-101659,102621,204280,962,0,-21,8999,0,0,,9020,8978
49,12-03-18,79,19:30,19:45,51.6,49.92,0,49.92,49.92,-1,-87926,121485,209411,33559,0,-48,1,0,0,,49,-47
49,12-03-18,80,19:45,20:00,,47.78,0,47.78,47.78,-1,-97913,116523,214436,18610,0,-1450,0,0,0,,1450,-1450
49,12-03-18,81,20:00,20:15,,46.8,0,46.8,46.8,-1,-104271,80000,184271,-24271,0,-1832,0,0,0,,1832,-1832
49,12-03-18,82,20:15,20:30,,42.33,0,42.33,42.33,-1,-70992,82991,153983,11999,0,-3340,0,0,0,,3340,-3340
49,12-03-18,83,20:30,20:45,,38.98,0,38.98,38.98,-1,-68145,113683,181828,45538,0,-16244,0,0,0,,16244,-16244
49,12-03-18,84,20:45,21:00,,31.08,0,31.08,31.08,-1,-79627,130716,210343,51089,0,-34338,0,0,0,,34338,-34338
49,12-03-18,85,21:00,21:15,51.6,39.6,0,51.6,29.96,2,-111621,116377,227998,4756,0,-23295,522,0,0,,23817,-22773
49,12-03-18,86,21:15,21:30,,,0,48.76,48.76,0,-83920,89279,173199,5359,0,-278,254,0,0,,532,-24
49,12-03-18,87,21:30,21:45,,,0,48.71,48.71,0,-84920,94139,179059,9219,0,0,0,0,0,,0,0
49,12-03-18,88,21:45,22:00,,,0,48.71,48.71,0,-82663,101251,183914,18588,0,0,0,0,0,,0,0
49,12-03-18,89,22:00,22:15,71.1,,0,71.1,71.1,1,-117761,56582,174343,-61179,0,0,24170,0,0,,24170,24170
49,12-03-18,90,22:15,22:30,55.23,,0,55.23,55.23,1,-90392,63955,154347,-26437,0,0,34402,0,0,,34402,34402
49,12-03-18,91,22:30,22:45,55.82,,0,55.82,55.82,1,-89579,61738,151317,-27841,0,0,12925,0,0,,12925,12925
49,12-03-18,92,22:45,23:00,51.25,49.39,0,51.25,48.22,2,-72773,70158,142931,-2615,0,-149,15173,0,0,,15322,15024
49,12-03-18,93,23:00,23:15,70.82,49.39,0,70.82,70.82,1,-126037,69911,195948,-56126,0,-339,26941,0,0,,27280,26602
49,12-03-18,94,23:15,23:30,55.82,,0,55.82,55.82,1,-71673,37238,108911,-34435,0,0,37370,0,0,,37370,37370
49,12-03-18,95,23:30,23:45,47.76,,0,47.76,47.76,1,-60376,40655,101031,-19721,0,0,16425,0,0,,16425,16425
49,12-03-18,96,23:45,0:00,47.6,-39.41,0,-39.41,-39.41,-1,-32223,49821,82044,17598,0,-9322,5741,0,0,,15063,-3581
49,12-04-18,1,0:00,0:15,,-155.47,0,-155.47,-155.47,-1,-68887,229245,298132,160358,0,-39870,0,0,0,,39870,-39870
49,12-04-18,2,0:15,0:30,,38.37,0,38.37,38.37,-1,-50632,112110,162742,61478,0,-1156,0,0,0,,1156,-1156
49,12-04-18,3,0:30,0:45,,37.4,0,37.4,37.4,-1,-46980,59211,106191,12231,0,-3462,0,0,0,,3462,-3462
49,12-04-18,4,0:45,1:00,,37.4,0,37.4,37.4,-1,-49545,67842,117387,18297,0,-2263,0,0,0,,2263,-2263
49,12-04-18,5,1:00,1:15,90.59,34.89,0,90.59,34.89,2,-74165,12604,86769,-61561,0,-3380,16084,0,0,,19464,12704
49,12-04-18,6,1:15,1:30,54.32,,0,54.32,54.32,1,-69606,37923,107529,-31683,0,0,30247,0,0,,30247,30247
49,12-04-18,7,1:30,1:45,49.45,,0,49.45,49.45,1,-57136,38227,95363,-18909,0,0,11495,0,0,,11495,11495
49,12-04-18,8,1:45,2:00,45.4,,0,45.4,45.4,1,-53205,54607,107812,1402,0,0,1617,0,0,,1617,1617
49,12-04-18,9,2:00,2:15,57.52,,0,57.52,57.52,1,-97477,55021,152498,-42456,0,0,18731,0,0,,18731,18731
49,12-04-18,10,2:15,2:30,51.27,,0,51.27,51.27,1,-81897,64355,146252,-17542,0,0,21708,0,0,,21708,21708
49,12-04-18,11,2:30,2:45,49.4,42.27,0,49.4,42.27,2,-65842,51455,117297,-14387,0,-76,1657,0,0,,1733,1581
49,12-04-18,12,2:45,3:00,49.41,,0,49.41,49.41,1,-80548,62832,143380,-17716,0,0,2973,0,0,,2973,2973
49,12-04-18,13,3:00,3:15,69.53,,0,69.53,69.53,1,-91130,34502,125632,-56628,0,0,31218,0,0,,31218,31218
49,12-04-18,14,3:15,3:30,57.39,,0,57.39,57.39,1,-87152,25428,112580,-61724,0,0,52911,0,0,,52911,52911
49,12-04-18,15,3:30,3:45,54.32,,0,54.32,54.32,1,-77032,27421,104453,-49611,0,0,41111,0,0,,41111,41111
49,12-04-18,16,3:45,4:00,69.53,,0,69.53,69.53,1,-97584,24722,122306,-72862,0,0,54624,0,0,,54624,54624
49,12-04-18,17,4:00,4:15,55.7,,0,55.7,55.7,1,-86363,33246,119609,-53117,0,0,48354,0,0,,48354,48354
49,12-04-18,18,4:15,4:30,54.32,,0,54.32,54.32,1,-61228,34658,95886,-26570,0,0,30829,0,0,,30829,30829
49,12-04-18,19,4:30,4:45,55.4,,0,55.4,55.4,1,-73875,29017,102892,-44858,0,0,23968,0,0,,23968,23968
49,12-04-18,20,4:45,5:00,70.34,,0,70.34,70.34,1,-92033,26873,118906,-65160,0,0,53561,0,0,,53561,53561
49,12-04-18,21,5:00,5:15,102.06,,0,102.06,102.06,1,-75088,31525,106613,-43563,0,0,47509,0,0,,47509,47509
49,12-04-18,22,5:15,5:30,69.53,,0,69.53,69.53,1,-82169,30700,112869,-51469,0,0,29605,0,0,,29605,29605
49,12-04-18,23,5:30,5:45,59.2,,0,59.2,59.2,1,-70242,21500,91742,-48742,0,0,42065,0,0,,42065,42065
49,12-04-18,24,5:45,6:00,53.27,,0,53.27,53.27,1,-65039,54153,119192,-10886,0,0,16447,0,0,,16447,16447
49,12-04-18,25,6:00,6:15,51.24,34.37,0,34.37,34.37,-1,-78888,118617,197505,39729,0,-10510,2581,0,0,,13091,-7929
49,12-04-18,26,6:15,6:30,,38.73,0,38.73,38.73,-1,-34887,80640,115527,45753,0,-25258,0,0,0,,25258,-25258
49,12-04-18,27,6:30,6:45,,37.4,0,37.4,37.4,-1,-48848,93860,142708,45012,0,-9801,0,0,0,,9801,-9801
49,12-04-18,28,6:45,7:00,81.96,41.84,0,81.96,41.84,2,-109107,82205,191312,-26902,0,-7950,10002,0,0,,17952,2052
49,12-04-18,29,7:00,7:15,49.4,-41.06,0,-41.06,-41.06,-1,-47002,122472,169474,75470,0,-24048,5457,0,0,,29505,-18591
49,12-04-18,30,7:15,7:30,,-30.41,0,-30.41,-30.41,-1,-35811,72129,107940,36318,0,-40449,0,0,0,,40449,-40449
49,12-04-18,31,7:30,7:45,69.59,49.72,0,69.59,69.59,1,-80821,58831,139652,-21990,0,-4115,4842,0,0,,8957,727
49,12-04-18,32,7:45,8:00,160.72,,0,160.72,160.72,1,-145573,50457,196030,-95116,0,0,70641,0,0,,70641,70641
49,12-04-18,33,8:00,8:15,47.31,39.32,0,58.12,39.32,2,-48148,66151,114299,18003,0,-2466,24070,0,0,,26536,21604
49,12-04-18,34,8:15,8:30,50.12,,0,50.12,50.12,1,-49854,46539,96393,-3315,0,0,1349,0,0,,1349,1349
49,12-04-18,35,8:30,8:45,74.22,,0,74.22,74.22,1,-65176,24991,90167,-40185,0,0,24286,0,0,,24286,24286
49,12-04-18,36,8:45,9:00,128.27,,0,128.27,128.27,1,-83621,17020,100641,-66601,0,0,63400,0,0,,63400,63400
49,12-04-18,37,9:00,9:15,128.27,49.91,0,49.91,49.91,-1,-55043,54460,109503,-583,0,-967,9396,0,0,,10363,8429
49,12-04-18,38,9:15,9:30,47.31,,0,47.31,47.31,1,-47808,59101,106909,11293,0,0,127,0,0,,127,127
49,12-04-18,39,9:30,9:45,,68.81,0,68.81,68.81,-1,-43250,62117,105367,18867,0,-1,0,0,0,,1,-1
49,12-04-18,40,9:45,10:00,,39.44,0,39.44,39.44,-1,-41947,77644,119591,35697,0,-7904,0,0,0,,7904,-7904
49,12-04-18,41,10:00,10:15,,49.79,0,49.79,49.79,-1,-51696,62782,114478,11086,0,-2975,0,0,0,,2975,-2975
49,12-04-18,42,10:15,10:30,,42.32,0,42.32,42.32,-1,-49939,94363,144302,44424,0,-6724,0,0,0,,6724,-6724
49,12-04-18,43,10:30,10:45,,39.31,0,39.31,39.31,-1,-59589,85594,145183,26005,0,-18141,0,0,0,,18141,-18141
49,12-04-18,44,10:45,11:00,,35.63,0,35.63,35.63,-1,-56693,85801,142494,29108,0,-15611,0,0,0,,15611,-15611
49,12-04-18,45,11:00,11:15,,31.82,0,31.82,31.82,-1,-74447,94160,168607,19713,0,-19341,0,0,0,,19341,-19341
49,12-04-18,46,11:15,11:30,,39.31,0,39.31,39.31,-1,-71021,115389,186410,44368,0,-18520,0,0,0,,18520,-18520
49,12-04-18,47,11:30,11:45,,35.82,0,35.82,35.82,-1,-71783,123471,195254,51688,0,-28033,0,0,0,,28033,-28033
49,12-04-18,48,11:45,12:00,,35.63,0,35.63,35.63,-1,-74149,130042,204191,55893,0,-39994,0,0,0,,39994,-39994
49,12-04-18,49,12:00,12:15,,35.63,0,35.63,35.63,-1,-65863,108787,174650,42924,0,-35959,0,0,0,,35959,-35959
49,12-04-18,50,12:15,12:30,,39.31,0,39.31,39.31,-1,-67984,116751,184735,48767,0,-37403,0,0,0,,37403,-37403
49,12-04-18,51,12:30,12:45,,39.73,0,39.73,39.73,-1,-78544,130086,208630,51542,0,-39752,0,0,0,,39752,-39752
49,12-04-18,52,12:45,13:00,,35.63,0,35.63,35.63,-1,-69574,125550,195124,55976,0,-48337,0,0,0,,48337,-48337
49,12-04-18,53,13:00,13:15,,39.31,0,39.31,39.31,-1,-55050,102408,157458,47358,0,-46599,0,0,0,,46599,-46599
49,12-04-18,54,13:15,13:30,,43.31,0,43.31,43.31,-1,-58972,83266,142238,24294,0,-13676,0,0,0,,13676,-13676
49,12-04-18,55,13:30,13:45,,23.15,0,23.15,23.15,-1,-56842,110911,167753,54069,0,-20799,0,0,0,,20799,-20799
49,12-04-18,56,13:45,14:00,,23.15,0,23.15,23.15,-1,-88334,104125,192459,15791,0,-25229,0,0,0,,25229,-25229
49,12-04-18,57,14:00,14:15,,23.15,0,23.15,23.15,-1,-51976,106223,158199,54247,0,-17362,0,0,0,,17362,-17362
49,12-04-18,58,14:15,14:30,,36.36,0,36.36,36.36,-1,-79572,91842,171414,12270,0,-27140,0,0,0,,27140,-27140
49,12-04-18,59,14:30,14:45,47.31,36.36,0,47.31,47.31,1,-83866,79331,163197,-4535,0,-1510,642,0,0,,2152,-868
49,12-04-18,60,14:45,15:00,51.31,,0,51.31,51.31,1,-93641,63989,157630,-29652,0,0,10238,0,0,,10238,10238
49,12-04-18,61,15:00,15:15,50.35,,0,50.35,50.35,1,-78108,59230,137338,-18878,0,0,3885,0,0,,3885,3885
49,12-04-18,62,15:15,15:30,47.31,,0,47.31,47.31,1,-91271,51723,142994,-39548,0,0,11,0,0,,11,11
49,12-04-18,63,15:30,15:45,59.43,,0,59.43,59.43,1,-111777,33205,144982,-78572,0,0,19640,0,0,,19640,19640
49,12-04-18,64,15:45,16:00,136.92,,0,136.92,136.92,1,-106332,17989,124321,-88343,0,0,46739,0,0,,46739,46739
49,12-04-18,65,16:00,16:15,136.92,23.15,0,23.15,23.15,-1,-62580,107673,170253,45093,0,-14666,5062,0,0,,19728,-9604
49,12-04-18,66,16:15,16:30,,49.48,0,49.48,49.48,-1,-69597,79484,149081,9887,0,-4873,0,0,0,,4873,-4873
49,12-04-18,67,16:30,16:45,86.19,49.48,0,86.19,86.19,1,-71753,40333,112086,-31420,0,-37,7972,0,0,,8009,7935
49,12-04-18,68,16:45,17:00,198.05,,0,198.05,198.05,1,-147456,21759,169215,-125697,0,0,77894,0,0,,77894,77894
49,12-04-18,69,17:00,17:15,198.05,43.1,0,43.1,43.1,-1,-36687,68309,104996,31622,0,-1800,41789,0,0,,43589,39989
49,12-04-18,70,17:15,17:30,64.17,43.1,0,64.17,64.17,1,-45867,37879,83746,-7988,0,-28,11833,0,0,,11861,11805
49,12-04-18,71,17:30,17:45,67.6,,0,67.6,67.6,1,-48750,32422,81172,-16328,0,0,28998,0,0,,28998,28998
49,12-04-18,72,17:45,18:00,57.6,,0,57.6,57.6,1,-50060,53605,103665,3545,0,0,22542,0,0,,22542,22542
49,12-04-18,73,18:00,18:15,51.02,49.72,0,58.08,49.72,2,-56752,57240,113992,488,0,-149,8059,0,0,,8208,7910
49,12-04-18,74,18:15,18:30,51.02,43.31,0,43.31,43.31,-1,-33563,71521,105084,37958,0,-4922,62,0,0,,4984,-4860
49,12-04-18,75,18:30,18:45,,47.27,0,47.27,47.27,-1,-28286,81273,109559,52987,0,-5068,0,0,0,,5068,-5068
49,12-04-18,76,18:45,19:00,,51.69,0,51.69,51.69,-1,-26239,93376,119615,67137,0,-308,0,0,0,,308,-308
49,12-04-18,77,19:00,19:15,50.76,68.78,0,58.05,58.05,2,-56679,35607,92286,-21072,0,-394,2893,0,0,,3287,2499
49,12-04-18,78,19:15,19:30,47.31,,0,47.31,47.31,1,-49916,42891,92807,-7025,0,0,2031,0,0,,2031,2031
49,12-04-18,79,19:30,19:45,47.31,35.63,0,35.63,35.63,-1,-29170,61392,90562,32222,0,-4924,23,0,0,,4947,-4901
49,12-04-18,80,19:45,20:00,,34.76,0,34.76,34.76,-1,-28738,62514,91252,33776,0,-30390,0,0,0,,30390,-30390
49,12-04-18,81,20:00,20:15,158.85,47.23,0,158.85,47.23,2,-83195,9834,93029,-73361,0,-7569,26268,0,0,,33837,18699
49,12-04-18,82,20:15,20:30,51.31,,0,51.31,51.31,1,-65475,34944,100419,-30531,0,0,6680,0,0,,6680,6680
49,12-04-18,83,20:30,20:45,,52.33,0,52.33,52.33,-1,-57967,46346,104313,-11621,0,-16,0,0,0,,16,-16
49,12-04-18,84,20:45,21:00,,50.57,0,50.57,50.57,-1,-62082,50820,112902,-11262,0,-683,0,0,0,,683,-683
49,12-04-18,85,21:00,21:15,51.31,49.93,0,51.31,51.31,1,-56922,23211,80133,-33711,0,-459,401,0,0,,860,-58
49,12-04-18,86,21:15,21:30,51.31,,0,51.31,51.31,1,-58396,14684,73080,-43712,0,0,616,0,0,,616,616
49,12-04-18,87,21:30,21:45,,50.42,0,50.42,50.42,-1,-44190,41683,85873,-2507,0,-266,0,0,0,,266,-266
49,12-04-18,88,21:45,22:00,,39.31,0,39.31,39.31,-1,-29818,46756,76574,16938,0,-6909,0,0,0,,6909,-6909
49,12-04-18,89,22:00,22:15,51.31,43.31,0,51.31,30.66,2,-80908,38055,118963,-42853,0,-4801,981,0,0,,5782,-3820
49,12-04-18,90,22:15,22:30,47.31,,0,47.31,47.31,1,-61790,25940,87730,-35850,0,0,437,0,0,,437,437
49,12-04-18,91,22:30,22:45,120.63,,0,120.63,120.63,1,-111790,45805,157595,-65985,0,0,3332,0,0,,3332,3332
49,12-04-18,92,22:45,23:00,154.27,,0,253.87,253.87,1,-281690,85312,367002,-196378,0,0,67176,0,25189,,92365,92365
49,12-04-18,93,23:00,23:15,351.14,,0,386.25,386.25,1,-254326,116734,371060,-137592,0,0,56708,5000,51702,,113410,113410
49,12-04-18,94,23:15,23:30,351.14,,0,386.25,386.25,1,-211019,144195,355214,-66824,0,0,31812,0,35036,,66848,66848
49,12-04-18,95,23:30,23:45,55.4,,0,55.4,55.4,1,-194223,151996,346219,-42227,0,0,29969,0,0,,29969,29969
49,12-04-18,96,23:45,0:00,47.31,45.67,0,45.67,45.67,-1,-197643,171129,368772,-26514,0,-71,8580,0,0,,8651,8509
49,12-05-18,1,0:00,0:15,56.4,41.4,0,56.4,29.77,2,-194270,151813,346083,-42457,0,-140,11364,0,0,,11504,11224
49,12-05-18,2,0:15,0:30,57.47,,0,57.47,57.47,1,-183983,123098,307081,-60885,0,0,31793,0,0,,31793,31793
49,12-05-18,3,0:30,0:45,60.31,,0,60.31,60.31,1,-190635,127264,317899,-63371,0,0,31434,0,0,,31434,31434
49,12-05-18,4,0:45,1:00,60.31,42.16,0,42.16,42.16,-1,-174429,138681,313110,-35748,0,-170,1132,0,0,,1302,962
49,12-05-18,5,1:00,1:15,47.7,38.17,0,47.7,47.7,1,-34805,39621,74426,4816,0,-544,39,0,0,,583,-505
49,12-05-18,6,1:15,1:30,47.8,41.4,0,48.64,41.4,2,-27878,41664,69542,13786,0,-1173,503,0,0,,1676,-670
49,12-05-18,7,1:30,1:45,,37.4,0,37.4,37.4,-1,-22342,47298,69640,24956,0,-14755,0,0,0,,14755,-14755
49,12-05-18,8,1:45,2:00,,29.89,0,29.89,29.89,-1,-20410,69860,90270,49450,0,-28334,0,0,0,,28334,-28334
49,12-05-18,9,2:00,2:15,49.14,37.4,0,49.14,37.4,2,-57131,23496,80627,-33635,0,-8413,677,0,0,,9090,-7736
49,12-05-18,10,2:15,2:30,47.81,41.4,0,48.66,41.4,2,-36269,39912,76181,3643,0,-2571,6,0,0,,2577,-2565
49,12-05-18,11,2:30,2:45,,36.3,0,36.3,36.3,-1,-33028,63184,96212,30156,0,-18512,0,0,0,,18512,-18512
49,12-05-18,12,2:45,3:00,,24.17,0,24.17,24.17,-1,-34433,80560,114993,46127,0,-46596,0,0,0,,46596,-46596
49,12-05-18,13,3:00,3:15,,37.4,0,37.4,37.4,-1,-37387,55319,92706,17932,0,-16482,0,0,0,,16482,-16482
49,12-05-18,14,3:15,3:30,,49.48,0,49.48,49.48,-1,-36872,61408,98280,24536,0,-294,0,0,0,,294,-294
49,12-05-18,15,3:30,3:45,,,0,48.68,48.68,0,-47671,59826,107497,12155,0,0,0,0,0,,0,0
49,12-05-18,16,3:45,4:00,,,0,48.68,48.68,0,-43883,58196,102079,14313,0,0,0,0,0,,0,0
49,12-05-18,17,4:00,4:15,,,0,48.74,48.74,0,-45780,59974,105754,14194,0,0,0,0,0,,0,0
49,12-05-18,18,4:15,4:30,,,0,48.71,48.71,0,-49089,49163,98252,74,0,0,0,0,0,,0,0
49,12-05-18,19,4:30,4:45,48.4,,0,48.4,48.4,1,-51924,49297,101221,-2627,0,0,608,0,0,,608,608
49,12-05-18,20,4:45,5:00,52.4,,0,52.4,52.4,1,-64300,43182,107482,-21118,0,0,14414,0,0,,14414,14414
49,12-05-18,21,5:00,5:15,48.4,,0,48.4,48.4,1,-50743,46691,97434,-4052,0,0,3298,0,0,,3298,3298
49,12-05-18,22,5:15,5:30,50.42,,0,50.42,50.42,1,-60992,39636,100628,-21356,0,0,1321,0,0,,1321,1321
49,12-05-18,23,5:30,5:45,56.4,,0,56.4,56.4,1,-103463,35483,138946,-67980,0,0,15666,0,0,,15666,15666
49,12-05-18,24,5:45,6:00,52.4,,0,52.4,52.4,1,-106524,66098,172622,-40426,0,0,18713,0,0,,18713,18713
49,12-05-18,25,6:00,6:15,52.02,48.02,0,48.02,48.02,-1,-117300,119969,237269,2669,0,-868,7814,0,0,,8682,6946
49,12-05-18,26,6:15,6:30,52.02,50.46,0,50.46,50.46,-1,-82377,97421,179798,15044,0,-458,13,0,0,,471,-445
49,12-05-18,27,6:30,6:45,134.83,50.46,0,134.83,134.83,1,-108342,48208,156550,-60134,0,-36,19502,0,0,,19538,19466
49,12-05-18,28,6:45,7:00,229.02,,0,229.02,229.02,1,-163975,63216,227191,-100759,0,0,84960,0,0,,84960,84960
49,12-05-18,29,7:00,7:15,229.02,-77.49,0,-77.49,-77.49,-1,-60230,231416,291646,171186,0,-30809,17137,0,0,,47946,-13672
49,12-05-18,30,7:15,7:30,,37.47,0,37.47,37.47,-1,-38344,111465,149809,73121,0,-16727,0,0,0,,16727,-16727
49,12-05-18,31,7:30,7:45,70.84,37.47,0,70.84,70.84,1,-74643,58438,133081,-16205,0,-841,9152,0,0,,9993,8311
49,12-05-18,32,7:45,8:00,229.02,,0,229.02,229.02,1,-140709,54313,195022,-86396,0,0,61342,0,0,,61342,61342
49,12-05-18,33,8:00,8:15,55.65,69.5,0,69.5,69.5,-1,-99205,90228,189433,-8977,0,-98,16764,0,0,,16862,16666
49,12-05-18,34,8:15,8:30,,,0,58.58,58.58,0,-120561,85869,206430,-34692,0,0,0,0,0,,0,0
49,12-05-18,35,8:30,8:45,,,0,58.55,58.55,0,-127017,79221,206238,-47796,0,0,0,0,0,,0,0
49,12-05-18,36,8:45,9:00,,,0,58.52,58.52,0,-132091,67786,199877,-64305,0,0,0,0,0,,0,0
49,12-05-18,37,9:00,9:15,55.65,,0,55.65,55.65,1,-165164,73039,238203,-92125,0,0,4172,0,0,,4172,4172
49,12-05-18,38,9:15,9:30,54.81,,0,54.81,54.81,1,-160036,66563,226599,-93473,0,0,2805,0,0,,2805,2805
49,12-05-18,39,9:30,9:45,48.51,,0,48.51,48.51,1,-165246,74698,239944,-90548,0,0,2678,0,0,,2678,2678
49,12-05-18,40,9:45,10:00,,,0,58.52,58.52,0,-141117,75022,216139,-66095,0,0,182,0,0,,182,182
49,12-05-18,41,10:00,10:15,52.14,,0,52.14,52.14,1,-130909,85925,216834,-44984,0,0,3667,0,0,,3667,3667
49,12-05-18,42,10:15,10:30,,,0,58.49,58.49,0,-126860,107747,234607,-19113,0,0,8,0,0,,8,8
49,12-05-18,43,10:30,10:45,,44.85,0,44.85,44.85,-1,-94091,112864,206955,18773,0,-1053,0,0,0,,1053,-1053
49,12-05-18,44,10:45,11:00,,41.47,0,41.47,41.47,-1,-71193,101503,172696,30310,0,-3783,0,0,0,,3783,-3783
49,12-05-18,45,11:00,11:15,47.65,41.47,0,58.54,41.47,2,-42097,46534,88631,4437,0,-3799,66,0,0,,3865,-3733
49,12-05-18,46,11:15,11:30,50.21,,0,50.21,50.21,1,-55602,49396,104998,-6206,0,0,9362,0,0,,9362,9362
49,12-05-18,47,11:30,11:45,50.28,,0,50.28,50.28,1,-57753,48428,106181,-9325,0,0,10242,0,0,,10242,10242
49,12-05-18,48,11:45,12:00,48.57,,0,48.57,48.57,1,-68562,45663,114225,-22899,0,0,727,0,0,,727,727
49,12-05-18,49,12:00,12:15,127.02,,0,127.02,127.02,1,-106471,22301,128772,-84170,0,0,30544,0,0,,30544,30544
49,12-05-18,50,12:15,12:30,53.02,,0,53.02,53.02,1,-81932,26379,108311,-55553,0,0,9958,0,0,,9958,9958
49,12-05-18,51,12:30,12:45,123.5,,0,123.5,123.5,1,-94808,25336,120144,-69472,0,0,32831,0,0,,32831,32831
49,12-05-18,52,12:45,13:00,59.2,,0,59.2,59.2,1,-68946,22942,91888,-46004,0,0,42160,0,0,,42160,42160
49,12-05-18,53,13:00,13:15,143.02,,0,143.02,143.02,1,-112892,26208,139100,-86684,0,0,35311,0,0,,35311,35311
49,12-05-18,54,13:15,13:30,154.02,,0,154.02,154.02,1,-117620,23079,140699,-94541,0,0,75174,0,0,,75174,75174
49,12-05-18,55,13:30,13:45,71.55,,0,71.55,71.55,1,-101114,26576,127690,-74538,0,0,68635,0,0,,68635,68635
49,12-05-18,56,13:45,14:00,,,0,49.05,49.05,0,-90654,30977,121631,-59677,0,0,15829,0,0,,15829,15829
49,12-05-18,57,14:00,14:15,54.71,,0,54.71,54.71,1,-77605,43332,120937,-34273,0,0,11292,0,0,,11292,11292
49,12-05-18,58,14:15,14:30,49.92,,0,49.92,49.92,1,-74283,52449,126732,-21834,0,0,11186,0,0,,11186,11186
49,12-05-18,59,14:30,14:45,,,0,49.1,49.1,0,-83512,66225,149737,-17287,0,0,711,0,0,,711,711
49,12-05-18,60,14:45,15:00,,,0,49.1,49.1,0,-84236,76709,160945,-7527,0,0,0,0,0,,0,0
49,12-05-18,61,15:00,15:15,,48.83,0,48.83,48.83,-1,-55891,62905,118796,7014,0,-2525,0,0,0,,2525,-2525
49,12-05-18,62,15:15,15:30,,50.54,0,50.54,50.54,-1,-85916,64227,150143,-21689,0,-93,0,0,0,,93,-93
49,12-05-18,63,15:30,15:45,,,0,49.1,49.1,0,-76821,67293,144114,-9528,0,0,0,0,0,,0,0
49,12-05-18,64,15:45,16:00,,,0,49.1,49.1,0,-78289,74389,152678,-3900,0,0,0,0,0,,0,0
49,12-05-18,65,16:00,16:15,,,0,49.16,49.16,0,-29113,114737,143850,85624,0,0,0,0,0,,0,0
49,12-05-18,66,16:15,16:30,,49.49,0,49.49,49.49,-1,-25091,112176,137267,87085,0,-1063,0,0,0,,1063,-1063
49,12-05-18,67,16:30,16:45,,49.06,0,49.06,49.06,-1,-35840,104505,140345,68665,0,-1668,0,0,0,,1668,-1668
49,12-05-18,68,16:45,17:00,,,0,49.05,49.05,0,-61399,111848,173247,50449,0,0,0,0,0,,0,0
49,12-05-18,69,17:00,17:15,,12.14,0,12.14,12.14,-1,-40153,100675,140828,60522,0,-28889,0,0,0,,28889,-28889
49,12-05-18,70,17:15,17:30,,37.47,0,37.47,37.47,-1,-44026,89607,133633,45581,0,-37430,0,0,0,,37430,-37430
49,12-05-18,71,17:30,17:45,,21.18,0,21.18,21.18,-1,-38148,123306,161454,85158,0,-49352,0,0,0,,49352,-49352
49,12-05-18,72,17:45,18:00,,37.47,0,37.47,37.47,-1,-40603,147879,188482,107276,0,-38169,0,0,0,,38169,-38169
49,12-05-18,73,18:00,18:15,47.65,41.47,0,49.05,41.47,2,-65604,41449,107053,-24155,0,-3875,38,0,0,,3913,-3837
49,12-05-18,74,18:15,18:30,,37.25,0,37.25,37.25,-1,-50793,76020,126813,25227,0,-14925,0,0,0,,14925,-14925
49,12-05-18,75,18:30,18:45,,39.78,0,39.78,39.78,-1,-47919,81568,129487,33649,0,-22722,0,0,0,,22722,-22722
49,12-05-18,76,18:45,19:00,,37.47,0,37.47,37.47,-1,-47716,101100,148816,53384,0,-29814,0,0,0,,29814,-29814
49,12-05-18,77,19:00,19:15,56.18,42.3,0,56.18,42.3,2,-60678,33472,94150,-27206,0,-11081,9329,0,0,,20410,-1752
49,12-05-18,78,19:15,19:30,47.65,35.69,0,49.08,35.69,2,-34470,64430,98900,29960,0,-14851,510,0,0,,15361,-14341
49,12-05-18,79,19:30,19:45,,35.69,0,35.69,35.69,-1,-40335,77570,117905,37235,0,-26158,0,0,0,,26158,-26158
49,12-05-18,80,19:45,20:00,,25.78,0,25.78,25.78,-1,-47456,59879,107335,12423,0,-29711,0,0,0,,29711,-29711
49,12-05-18,81,20:00,20:15,,41.47,0,41.47,41.47,-1,-46441,51970,98411,5529,0,-4026,0,0,0,,4026,-4026
49,12-05-18,82,20:15,20:30,,41.47,0,41.47,41.47,-1,-48441,53758,102199,5317,0,-1081,0,0,0,,1081,-1081
49,12-05-18,83,20:30,20:45,,41,0,41,41,-1,-47164,73351,120515,26187,0,-14701,0,0,0,,14701,-14701
49,12-05-18,84,20:45,21:00,,39.91,0,39.91,39.91,-1,-78788,83296,162084,4508,0,-14862,0,0,0,,14862,-14862
49,12-05-18,85,21:00,21:15,51.65,21.18,0,51.65,21.18,2,-36751,74525,111276,37774,0,-20332,287,0,0,,20619,-20045
49,12-05-18,86,21:15,21:30,60.78,21.18,0,60.78,60.78,1,-75801,40122,115923,-35679,0,-534,18254,0,0,,18788,17720
49,12-05-18,87,21:30,21:45,48.77,,0,48.77,48.77,1,-66160,53448,119608,-12712,0,0,3779,0,0,,3779,3779
49,12-05-18,88,21:45,22:00,48.77,44.97,0,44.97,44.97,-1,-78581,70881,149462,-7700,0,-323,31,0,0,,354,-292
49,12-05-18,89,22:00,22:15,67.25,37.47,0,67.25,37.47,2,-66335,42173,108508,-24162,0,-2916,9593,0,0,,12509,6677
49,12-05-18,90,22:15,22:30,56.18,,0,56.18,56.18,1,-67479,35649,103128,-31830,0,0,14750,0,0,,14750,14750
49,12-05-18,91,22:30,22:45,77.84,,0,77.84,77.84,1,-97851,41381,139232,-56470,0,0,50667,0,0,,50667,50667
49,12-05-18,92,22:45,23:00,51.4,48.44,0,48.44,48.44,-1,-70901,62667,133568,-8234,0,-63,16640,0,0,,16703,16577
49,12-05-18,93,23:00,23:15,56.18,42.03,0,56.18,42.03,2,-78249,47701,125950,-30548,0,-320,9617,0,0,,9937,9297
49,12-05-18,94,23:15,23:30,50.14,,0,50.14,50.14,1,-54642,33289,87931,-21353,0,0,10356,0,0,,10356,10356
49,12-05-18,95,23:30,23:45,47.97,,0,47.97,47.97,1,-48844,39970,88814,-8874,0,0,1322,0,0,,1322,1322
49,12-05-18,96,23:45,0:00,,35.03,0,35.03,35.03,-1,-31652,64804,96456,33152,0,-23096,0,0,0,,23096,-23096
49,12-06-18,1,0:00,0:15,49.47,28.23,0,49.47,28.23,2,-44352,49035,93387,4683,0,-18799,1429,0,0,,20228,-17370
49,12-06-18,2,0:15,0:30,51.16,28.23,0,51.16,51.16,1,-69126,34980,104106,-34146,0,-53,13492,0,0,,13545,13439
49,12-06-18,3,0:30,0:45,49.47,,0,49.47,49.47,1,-87348,56895,144243,-30453,0,0,15013,0,0,,15013,15013
49,12-06-18,4,0:45,1:00,57.48,,0,57.48,57.48,1,-126660,76286,202946,-50374,0,0,22095,0,0,,22095,22095
49,12-06-18,5,1:00,1:15,45.47,44.33,0,45.72,44.33,2,-45147,74026,119173,28879,0,-639,6265,0,0,,6904,5626
49,12-06-18,6,1:15,1:30,,41.47,0,41.47,41.47,-1,-38673,64401,103074,25728,0,-4129,0,0,0,,4129,-4129
49,12-06-18,7,1:30,1:45,,33.47,0,33.47,33.47,-1,-29314,73349,102663,44035,0,-26341,0,0,0,,26341,-26341
49,12-06-18,8,1:45,2:00,,33.47,0,33.47,33.47,-1,-36396,80164,116560,43768,0,-43040,0,0,0,,43040,-43040
49,12-06-18,9,2:00,2:15,,37.47,0,37.47,37.47,-1,-48611,58767,107378,10156,0,-14591,0,0,0,,14591,-14591
49,12-06-18,10,2:15,2:30,,44.34,0,44.34,44.34,-1,-31390,45712,77102,14322,0,-666,0,0,0,,666,-666
49,12-06-18,11,2:30,2:45,49.47,,0,49.47,49.47,1,-50181,37140,87321,-13041,0,0,2898,0,0,,2898,2898
49,12-06-18,12,2:45,3:00,45.47,41.47,0,45.73,41.47,2,-33129,41327,74456,8198,0,-3084,799,0,0,,3883,-2285
49,12-06-18,13,3:00,3:15,,39.78,0,39.78,39.78,-1,-28146,52036,80182,23890,0,-14753,0,0,0,,14753,-14753
49,12-06-18,14,3:15,3:30,,41.47,0,41.47,41.47,-1,-32219,61973,94192,29754,0,-18971,0,0,0,,18971,-18971
49,12-06-18,15,3:30,3:45,,41.82,0,41.82,41.82,-1,-37695,57292,94987,19597,0,-8939,0,0,0,,8939,-8939
49,12-06-18,16,3:45,4:00,,39.78,0,39.78,39.78,-1,-31821,60201,92022,28380,0,-12656,0,0,0,,12656,-12656
49,12-06-18,17,4:00,4:15,,-10.78,0,-10.78,-10.78,-1,-20745,96846,117591,76101,0,-51753,0,0,0,,51753,-51753
49,12-06-18,18,4:15,4:30,,39.78,0,39.78,39.78,-1,-30007,75116,105123,45109,0,-38819,0,0,0,,38819,-38819
49,12-06-18,19,4:30,4:45,,39.78,0,39.78,39.78,-1,-42134,61767,103901,19633,0,-24989,0,0,0,,24989,-24989
49,12-06-18,20,4:45,5:00,45.47,39.78,0,45.47,45.47,1,-46425,48641,95066,2216,0,-617,455,0,0,,1072,-162
49,12-06-18,21,5:00,5:15,,37.47,0,37.47,37.47,-1,-49650,89106,138756,39456,0,-22609,0,0,0,,22609,-22609
49,12-06-18,22,5:15,5:30,,41.57,0,41.57,41.57,-1,-42387,60968,103355,18581,0,-19601,0,0,0,,19601,-19601
49,12-06-18,23,5:30,5:45,,41.47,0,41.47,41.47,-1,-40944,53879,94823,12935,0,-4410,0,0,0,,4410,-4410
49,12-06-18,24,5:45,6:00,45.47,,0,45.47,45.47,1,-61922,78534,140456,16612,0,0,24,0,0,,24,24
49,12-06-18,25,6:00,6:15,45.46,,0,45.46,45.46,1,-150571,130606,281177,-19965,0,0,201,0,0,,201,201
49,12-06-18,26,6:15,6:30,,37.46,0,37.46,37.46,-1,-85194,124192,209386,38998,0,-11777,0,0,0,,11777,-11777
49,12-06-18,27,6:30,6:45,47.15,37.46,0,47.15,47.15,1,-87323,66699,154022,-20624,0,-720,370,0,0,,1090,-350
49,12-06-18,28,6:45,7:00,49.5,,0,49.5,49.5,1,-68501,55646,124147,-12855,0,0,8147,0,0,,8147,8147
49,12-06-18,29,7:00,7:15,45.46,20.72,0,20.72,20.72,-1,-39614,173144,212758,133530,0,-15419,460,0,0,,15879,-14959
49,12-06-18,30,7:15,7:30,,38.07,0,38.07,38.07,-1,-48879,107233,156112,58354,0,-27015,0,0,0,,27015,-27015
49,12-06-18,31,7:30,7:45,,,0,46.11,46.11,0,-65336,68649,133985,3313,0,-84,0,0,0,,84,-84
49,12-06-18,32,7:45,8:00,56.51,,0,56.51,56.51,1,-123898,51211,175109,-72687,0,0,12021,0,0,,12021,12021
49,12-06-18,33,8:00,8:15,50.83,,0,50.83,50.83,1,-75692,81226,156918,5534,0,0,7756,0,0,,7756,7756
49,12-06-18,34,8:15,8:30,55.72,,0,55.72,55.72,1,-112561,68620,181181,-43941,0,0,23592,0,0,,23592,23592
49,12-06-18,35,8:30,8:45,53.05,,0,53.05,53.05,1,-130145,47921,178066,-82224,0,0,22748,0,0,,22748,22748
49,12-06-18,36,8:45,9:00,56.76,,0,56.76,56.76,1,-156361,43105,199466,-113256,0,0,33396,0,0,,33396,33396
49,12-06-18,37,9:00,9:15,103.1,,0,103.1,103.1,1,-126440,36256,162696,-90184,0,0,63211,0,0,,63211,63211
49,12-06-18,38,9:15,9:30,70.72,,0,70.72,70.72,1,-109288,45926,155214,-63362,0,0,65569,0,0,,65569,65569
49,12-06-18,39,9:30,9:45,60.12,,0,60.12,60.12,1,-73742,44476,118218,-29266,0,0,35469,0,0,,35469,35469
49,12-06-18,40,9:45,10:00,45.46,46.8,0,46.8,46.8,-1,-38435,63791,102226,25356,0,-645,6860,0,0,,7505,6215
49,12-06-18,41,10:00,10:15,45.46,46.76,0,46.76,46.76,-1,-40520,60572,101092,20052,0,-413,1,0,0,,414,-412
49,12-06-18,42,10:15,10:30,,,0,46.12,46.12,0,-36213,68430,104643,32217,0,0,0,0,0,,0,0
49,12-06-18,43,10:30,10:45,,,0,46.11,46.11,0,-42739,79133,121872,36394,0,0,0,0,0,,0,0
49,12-06-18,44,10:45,11:00,,,0,46.12,46.12,0,-26049,75995,102044,49946,0,0,0,0,0,,0,0
49,12-06-18,45,11:00,11:15,55.72,,0,55.72,55.72,1,-75321,33490,108811,-41831,0,0,20489,0,0,,20489,20489
49,12-06-18,46,11:15,11:30,50.44,,0,50.44,50.44,1,-56641,54188,110829,-2453,0,0,11423,0,0,,11423,11423
49,12-06-18,47,11:30,11:45,,,0,46.12,46.12,0,-49313,72311,121624,22998,0,0,264,0,0,,264,264
49,12-06-18,48,11:45,12:00,,,0,47.67,47.67,0,-44497,67152,111649,22655,0,0,0,0,0,,0,0
49,12-06-18,49,12:00,12:15,48.51,,0,48.51,48.51,1,-102027,43968,145995,-58059,0,0,809,0,0,,809,809
49,12-06-18,50,12:15,12:30,,45.12,0,45.12,45.12,-1,-69748,67857,137605,-1891,0,-491,0,0,0,,491,-491
49,12-06-18,51,12:30,12:45,,42.61,0,42.61,42.61,-1,-57564,86601,144165,29037,0,-9691,0,0,0,,9691,-9691
49,12-06-18,52,12:45,13:00,,37.46,0,37.46,37.46,-1,-53842,93440,147282,39598,0,-30728,0,0,0,,30728,-30728
49,12-06-18,53,13:00,13:15,47.84,43.76,0,47.84,43.76,2,-83228,55316,138544,-27912,0,-9999,768,0,0,,10767,-9231
49,12-06-18,54,13:15,13:30,,,0,46.16,46.16,0,-87921,52866,140787,-35055,0,0,0,0,0,,0,0
49,12-06-18,55,13:30,13:45,,,0,47.72,47.72,0,-77247,64141,141388,-13106,0,0,0,0,0,,0,0
49,12-06-18,56,13:45,14:00,,49.98,0,49.98,49.98,-1,-80345,83928,164273,3583,0,-1793,0,0,0,,1793,-1793
49,12-06-18,57,14:00,14:15,,45.66,0,45.66,45.66,-1,-57477,76649,134126,19172,0,-1909,0,0,0,,1909,-1909
49,12-06-18,58,14:15,14:30,,,0,47.72,47.72,0,-40704,66107,106811,25403,0,0,0,0,0,,0,0
49,12-06-18,59,14:30,14:45,,46.13,0,46.13,46.13,-1,-34965,82729,117694,47764,0,-2120,0,0,0,,2120,-2120
49,12-06-18,60,14:45,15:00,,45.16,0,45.16,45.16,-1,-34790,53038,87828,18248,0,-5212,0,0,0,,5212,-5212
49,12-06-18,61,15:00,15:15,,45.16,0,45.16,45.16,-1,-35643,47026,82669,11383,0,-2909,0,0,0,,2909,-2909
49,12-06-18,62,15:15,15:30,,46.88,0,46.88,46.88,-1,-56428,42657,99085,-13771,0,-314,0,0,0,,314,-314
49,12-06-18,63,15:30,15:45,,,0,46.17,46.17,0,-65544,49013,114557,-16531,0,0,0,0,0,,0,0
49,12-06-18,64,15:45,16:00,,,0,46.12,46.12,0,-60000,71970,131970,11970,0,0,0,0,0,,0,0
49,12-06-18,65,16:00,16:15,,42.38,0,42.38,42.38,-1,-36717,83964,120681,47247,0,-7205,0,0,0,,7205,-7205
49,12-06-18,66,16:15,16:30,,43.78,0,43.78,43.78,-1,-54848,72795,127643,17947,0,-10359,0,0,0,,10359,-10359
49,12-06-18,67,16:30,16:45,,44.99,0,44.99,44.99,-1,-45479,61568,107047,16089,0,-2949,0,0,0,,2949,-2949
49,12-06-18,68,16:45,17:00,,37.46,0,37.46,37.46,-1,-44876,94871,139747,49995,0,-6644,0,0,0,,6644,-6644
49,12-06-18,69,17:00,17:15,56.59,49.9,0,56.59,47.68,2,-72603,42216,114819,-30387,0,-1714,7105,0,0,,8819,5391
49,12-06-18,70,17:15,17:30,50.6,,0,50.6,50.6,1,-70644,65417,136061,-5227,0,0,9279,0,0,,9279,9279
49,12-06-18,71,17:30,17:45,50.6,43.78,0,43.78,43.78,-1,-55999,66496,122495,10497,0,-4231,255,0,0,,4486,-3976
49,12-06-18,72,17:45,18:00,,41.46,0,41.46,41.46,-1,-46076,81372,127448,35296,0,-12337,0,0,0,,12337,-12337
49,12-06-18,73,18:00,18:15,,43.78,0,43.78,43.78,-1,-66092,69247,135339,3155,0,-11883,0,0,0,,11883,-11883
49,12-06-18,74,18:15,18:30,,41.46,0,41.46,41.46,-1,-51802,81115,132917,29313,0,-22997,0,0,0,,22997,-22997
49,12-06-18,75,18:30,18:45,,33.46,0,33.46,33.46,-1,-45282,95406,140688,50124,0,-35983,0,0,0,,35983,-35983
49,12-06-18,76,18:45,19:00,,37.46,0,37.46,37.46,-1,-49247,88572,137819,39325,0,-45191,0,0,0,,45191,-45191
49,12-06-18,77,19:00,19:15,50.83,37.46,0,50.83,50.83,1,-71609,74042,145651,2433,0,-5961,1232,0,0,,7193,-4729
49,12-06-18,78,19:15,19:30,,46.48,0,46.48,46.48,-1,-67605,77660,145265,10055,0,-13,0,0,0,,13,-13
49,12-06-18,79,19:30,19:45,,37.46,0,37.46,37.46,-1,-57864,91246,149110,33382,0,-10870,0,0,0,,10870,-10870
49,12-06-18,80,19:45,20:00,,36.7,0,36.7,36.7,-1,-43225,85791,129016,42566,0,-34227,0,0,0,,34227,-34227
49,12-06-18,81,20:00,20:15,,32.99,0,32.99,32.99,-1,-50276,90761,141037,40485,0,-30423,0,0,0,,30423,-30423
49,12-06-18,82,20:15,20:30,,39.78,0,39.78,39.78,-1,-32198,69232,101430,37034,0,-24915,0,0,0,,24915,-24915
49,12-06-18,83,20:30,20:45,,20.72,0,20.72,20.72,-1,-35257,102947,138204,67690,0,-52027,0,0,0,,52027,-52027
49,12-06-18,84,20:45,21:00,,37.46,0,37.46,37.46,-1,-57700,96483,154183,38783,0,-45140,0,0,0,,45140,-45140
49,12-06-18,85,21:00,21:15,50.83,39.78,0,50.83,29.78,2,-81994,87200,169194,5206,0,-16849,2420,0,0,,19269,-14429
49,12-06-18,86,21:15,21:30,50.83,42.63,0,42.63,42.63,-1,-49832,77902,127734,28070,0,-501,289,0,0,,790,-212
49,12-06-18,87,21:30,21:45,,36.97,0,36.97,36.97,-1,-46933,100796,147729,53863,0,-23658,0,0,0,,23658,-23658
49,12-06-18,88,21:45,22:00,,26.67,0,26.67,26.67,-1,-40265,107975,148240,67710,0,-61499,0,0,0,,61499,-61499
49,12-06-18,89,22:00,22:15,48.79,39.78,0,48.79,39.78,2,-81706,78729,160435,-2977,0,-17728,883,0,0,,18611,-16845
49,12-06-18,90,22:15,22:30,55.72,46.56,0,55.72,46.01,2,-58575,39076,97651,-19499,0,-20,12833,0,0,,12853,12813
49,12-06-18,91,22:30,22:45,55.72,41.46,0,41.46,41.46,-1,-33928,50574,84502,16646,0,-4415,264,0,0,,4679,-4151
49,12-06-18,92,22:45,23:00,,41.46,0,41.46,41.46,-1,-32611,65003,97614,32392,0,-21000,0,0,0,,21000,-21000
49,12-06-18,93,23:00,23:15,,37.46,0,37.46,37.46,-1,-55112,77798,132910,22686,0,-24040,0,0,0,,24040,-24040
49,12-06-18,94,23:15,23:30,,41.46,0,41.46,41.46,-1,-40209,43527,83736,3318,0,-5797,0,0,0,,5797,-5797
49,12-06-18,95,23:30,23:45,,37.46,0,37.46,37.46,-1,-30529,55453,85982,24924,0,-13070,0,0,0,,13070,-13070
49,12-06-18,96,23:45,0:00,,19.78,0,19.78,19.78,-1,-18207,84382,102589,66175,0,-39257,0,0,0,,39257,-39257
49,12-07-18,1,0:00,0:15,,25.93,0,25.93,25.93,-1,-62942,78665,141607,15723,0,-36921,0,0,0,,36921,-36921
49,12-07-18,2,0:15,0:30,,37.46,0,37.46,37.46,-1,-38557,70589,109146,32032,0,-22140,0,0,0,,22140,-22140
49,12-07-18,3,0:30,0:45,,34.93,0,34.93,34.93,-1,-34875,72420,107295,37545,0,-41727,0,0,0,,41727,-41727
49,12-07-18,4,0:45,1:00,45.46,45.73,0,45.97,45.73,2,-67517,77611,145128,10094,0,-9476,119,0,0,,9595,-9357
49,12-07-18,5,1:00,1:15,49.46,41.46,0,49.46,27.99,2,-60276,52819,113095,-7457,0,-2383,1191,0,0,,3574,-1192
49,12-07-18,6,1:15,1:30,50.9,,0,50.9,50.9,1,-68651,40409,109060,-28242,0,0,14083,0,0,,14083,14083
49,12-07-18,7,1:30,1:45,49.46,,0,49.46,49.46,1,-75863,56858,132721,-19005,0,0,15093,0,0,,15093,15093
49,12-07-18,8,1:45,2:00,45.46,46.1,0,45.78,45.78,2,-65674,54182,119856,-11492,0,-427,1546,0,0,,1973,1119
49,12-07-18,9,2:00,2:15,48.8,,0,48.8,48.8,1,-65642,52431,118073,-13211,0,0,3830,0,0,,3830,3830
49,12-07-18,10,2:15,2:30,49.46,42.27,0,49.46,42.27,2,-51500,48094,99594,-3406,0,-1090,10690,0,0,,11780,9600
49,12-07-18,11,2:30,2:45,49.46,42.38,0,42.38,42.38,-1,-65273,66278,131551,1005,0,-4078,446,0,0,,4524,-3632
49,12-07-18,12,2:45,3:00,47.19,44.46,0,47.19,44.46,2,-63579,55373,118952,-8206,0,-585,702,0,0,,1287,117
49,12-07-18,13,3:00,3:15,,40.66,0,40.66,40.66,-1,-34993,96525,131518,61532,0,-5466,0,0,0,,5466,-5466
49,12-07-18,14,3:15,3:30,,28.31,0,28.31,28.31,-1,-34504,82808,117312,48304,0,-29357,0,0,0,,29357,-29357
49,12-07-18,15,3:30,3:45,,33.46,0,33.46,33.46,-1,-29616,88090,117706,58474,0,-43352,0,0,0,,43352,-43352
49,12-07-18,16,3:45,4:00,,37.46,0,37.46,37.46,-1,-33577,78339,111916,44762,0,-35400,0,0,0,,35400,-35400
49,12-07-18,17,4:00,4:15,,34.74,0,34.74,34.74,-1,-28585,94896,123481,66311,0,-24786,0,0,0,,24786,-24786
49,12-07-18,18,4:15,4:30,,41.46,0,41.46,41.46,-1,-31805,86003,117808,54198,0,-13465,0,0,0,,13465,-13465
49,12-07-18,19,4:30,4:45,,40.99,0,40.99,40.99,-1,-33974,80432,114406,46458,0,-16929,0,0,0,,16929,-16929
49,12-07-18,20,4:45,5:00,,32.65,0,32.65,32.65,-1,-42421,69952,112373,27531,0,-19421,0,0,0,,19421,-19421
49,12-07-18,21,5:00,5:15,,-12.32,0,-12.32,-12.32,-1,-51750,88154,139904,36404,0,-33982,0,0,0,,33982,-33982
49,12-07-18,22,5:15,5:30,,20.36,0,20.36,20.36,-1,-42386,104558,146944,62172,0,-38685,0,0,0,,38685,-38685
49,12-07-18,23,5:30,5:45,,37.46,0,37.46,37.46,-1,-49407,85323,134730,35916,0,-19525,0,0,0,,19525,-19525
49,12-07-18,24,5:45,6:00,,33.46,0,33.46,33.46,-1,-59021,94195,153216,35174,0,-7316,0,0,0,,7316,-7316
49,12-07-18,25,6:00,6:15,,36.94,0,36.94,36.94,-1,-103202,119769,222971,16567,0,-6045,0,0,0,,6045,-6045
49,12-07-18,26,6:15,6:30,,18.38,0,18.38,18.38,-1,-58138,125780,183918,67642,0,-45677,0,0,0,,45677,-45677
49,12-07-18,27,6:30,6:45,44.94,40.94,0,44.94,44.94,1,-86658,97671,184329,11013,0,-10991,18,0,0,,11009,-10973
49,12-07-18,28,6:45,7:00,44.94,,0,44.94,44.94,1,-69180,139645,208825,70465,0,0,71,0,0,,71,71
49,12-07-18,29,7:00,7:15,,-81.09,0,-81.09,-81.09,-1,-78123,161246,239369,83123,0,-41146,0,0,0,,41146,-41146
49,12-07-18,30,7:15,7:30,,37.18,0,37.18,37.18,-1,-56725,101015,157740,44290,0,-42866,0,0,0,,42866,-42866
49,12-07-18,31,7:30,7:45,48.88,42.38,0,48.88,48.88,1,-74098,79944,154042,5846,0,-14445,293,0,0,,14738,-14152
49,12-07-18,32,7:45,8:00,57.36,42.38,0,57.36,57.36,1,-112430,78712,191142,-33718,0,-6,25277,0,0,,25283,25271
49,12-07-18,33,8:00,8:15,57.36,40.35,0,40.35,40.35,-1,-65536,86347,151883,20811,0,-9995,4644,0,0,,14639,-5351
49,12-07-18,34,8:15,8:30,51.12,45.16,0,51.12,45.16,2,-79068,65643,144711,-13425,0,-3382,2816,0,0,,6198,-566
49,12-07-18,35,8:30,8:45,48.88,,0,48.88,48.88,1,-79979,69357,149336,-10622,0,0,5801,0,0,,5801,5801
49,12-07-18,36,8:45,9:00,52.88,,0,52.88,52.88,1,-97207,69590,166797,-27617,0,0,10570,0,0,,10570,10570
49,12-07-18,37,9:00,9:15,52.88,45.16,0,45.16,45.16,-1,-82377,84915,167292,2538,0,-668,3870,0,0,,4538,3202
49,12-07-18,38,9:15,9:30,,45.07,0,45.07,45.07,-1,-83472,77390,160862,-6082,0,-2700,0,0,0,,2700,-2700
49,12-07-18,39,9:30,9:45,,46.88,0,46.88,46.88,-1,-82004,77160,159164,-4844,0,-1282,0,0,0,,1282,-1282
49,12-07-18,40,9:45,10:00,,46.13,0,46.13,46.13,-1,-94852,77698,172550,-17154,0,-358,0,0,0,,358,-358
49,12-07-18,41,10:00,10:15,49.25,46.13,0,49.25,49.25,1,-79858,42526,122384,-37332,0,-435,4350,0,0,,4785,3915
49,12-07-18,42,10:15,10:30,47.97,,0,47.97,47.97,1,-79688,48319,128007,-31369,0,0,1035,0,0,,1035,1035
49,12-07-18,43,10:30,10:45,48.88,,0,48.88,48.88,1,-81601,52037,133638,-29564,0,0,2468,0,0,,2468,2468
49,12-07-18,44,10:45,11:00,47.98,,0,47.98,47.98,1,-77704,56096,133800,-21608,0,0,2560,0,0,,2560,2560
49,12-07-18,45,11:00,11:15,52.88,,0,52.88,52.88,1,-101978,66797,168775,-35181,0,0,20734,0,0,,20734,20734
49,12-07-18,46,11:15,11:30,49.75,,0,49.75,49.75,1,-111203,82131,193334,-29072,0,0,24706,0,0,,24706,24706
49,12-07-18,47,11:30,11:45,49.61,,0,49.61,49.61,1,-113941,81919,195860,-32022,0,0,23084,0,0,,23084,23084
49,12-07-18,48,11:45,12:00,49.81,,0,49.81,49.81,1,-104715,73817,178532,-30898,0,0,22074,0,0,,22074,22074
49,12-07-18,49,12:00,12:15,61.62,,0,61.62,61.62,1,-112933,51689,164622,-61244,0,0,33624,0,0,,33624,33624
49,12-07-18,50,12:15,12:30,52.88,,0,52.88,52.88,1,-101698,62495,164193,-39203,0,0,32905,0,0,,32905,32905
49,12-07-18,51,12:30,12:45,47.43,,0,47.43,47.43,1,-78131,62802,140933,-15329,0,0,8962,0,0,,8962,8962
49,12-07-18,52,12:45,13:00,44.88,,0,44.88,44.88,1,-68772,62714,131486,-6058,0,0,3535,0,0,,3535,3535
49,12-07-18,53,13:00,13:15,,,0,45.83,45.83,0,-63050,100761,163811,37711,0,0,100,0,0,,100,100
49,12-07-18,54,13:15,13:30,,,0,45.83,45.83,0,-61793,95279,157072,33486,0,0,0,0,0,,0,0
49,12-07-18,55,13:30,13:45,,,0,45.83,45.83,0,-69583,88955,158538,19372,0,0,0,0,0,,0,0
49,12-07-18,56,13:45,14:00,,45.17,0,45.17,45.17,-1,-70459,80426,150885,9967,0,-1425,0,0,0,,1425,-1425
49,12-07-18,57,14:00,14:15,,45.12,0,45.12,45.12,-1,-62650,70228,132878,7578,0,-1903,0,0,0,,1903,-1903
49,12-07-18,58,14:15,14:30,,45.17,0,45.17,45.17,-1,-51022,82901,133923,31879,0,-1164,0,0,0,,1164,-1164
49,12-07-18,59,14:30,14:45,,43.46,0,43.46,43.46,-1,-56443,90383,146826,33940,0,-3801,0,0,0,,3801,-3801
49,12-07-18,60,14:45,15:00,,45.46,0,45.46,45.46,-1,-55989,86669,142658,30680,0,-4309,0,0,0,,4309,-4309
49,12-07-18,61,15:00,15:15,,45.73,0,45.73,45.73,-1,-55817,89236,145053,33419,0,-3486,0,0,0,,3486,-3486
49,12-07-18,62,15:15,15:30,,41.18,0,41.18,41.18,-1,-51693,96332,148025,44639,0,-6716,0,0,0,,6716,-6716
49,12-07-18,63,15:30,15:45,,41.18,0,41.18,41.18,-1,-74371,89737,164108,15366,0,-6084,0,0,0,,6084,-6084
49,12-07-18,64,15:45,16:00,,,0,45.71,45.71,0,-89056,104491,193547,15435,0,0,0,0,0,,0,0
49,12-07-18,65,16:00,16:15,,45.16,0,45.16,45.16,-1,-43100,80808,123908,37708,0,-2504,0,0,0,,2504,-2504
49,12-07-18,66,16:15,16:30,,46.78,0,46.78,46.78,-1,-58338,51990,110328,-6348,0,-334,0,0,0,,334,-334
49,12-07-18,67,16:30,16:45,52.88,,0,52.88,52.88,1,-88827,40310,129137,-48517,0,0,2408,0,0,,2408,2408
49,12-07-18,68,16:45,17:00,151.02,,0,151.02,151.02,1,-153919,48315,202234,-105604,0,0,61480,0,0,,61480,61480
49,12-07-18,69,17:00,17:15,70.1,,0,70.1,70.1,1,-93598,55651,149249,-37947,0,0,21979,0,0,,21979,21979
49,12-07-18,70,17:15,17:30,130.02,,0,130.02,130.02,1,-118255,33573,151828,-84682,0,0,12839,0,0,,12839,12839
49,12-07-18,71,17:30,17:45,163.11,,0,163.11,163.11,1,-119630,29357,148987,-90273,0,0,55745,0,0,,55745,55745
49,12-07-18,72,17:45,18:00,163.11,,0,163.11,163.11,1,-154788,36514,191302,-118274,0,0,67508,0,0,,67508,67508
49,12-07-18,73,18:00,18:15,151.02,,0,151.02,151.02,1,-198451,58936,257387,-139515,0,0,108375,0,0,,108375,108375
49,12-07-18,74,18:15,18:30,250.14,,0,250.14,250.14,1,-169153,89120,258273,-80033,0,0,85430,3750,0,,89180,89180
49,12-07-18,75,18:30,18:45,47.28,,0,47.28,47.28,1,-138335,115410,253745,-22925,0,0,18028,0,0,,18028,18028
49,12-07-18,76,18:45,19:00,68.09,,0,68.09,68.09,1,-121442,93391,214833,-28051,0,0,18440,0,0,,18440,18440
49,12-07-18,77,19:00,19:15,52.66,,0,52.66,52.66,1,-117216,86508,203724,-30708,0,0,14193,0,0,,14193,14193
49,12-07-18,78,19:15,19:30,47.07,44.02,0,47.07,44.02,2,-76179,77559,153738,1380,0,-249,5449,0,0,,5698,5200
49,12-07-18,79,19:30,19:45,47.07,33.2,0,33.2,33.2,-1,-49479,106057,155536,56578,0,-32701,101,0,0,,32802,-32600
49,12-07-18,80,19:45,20:00,,37.18,0,37.18,37.18,-1,-34532,78058,112590,43526,0,-44434,0,0,0,,44434,-44434
49,12-07-18,81,20:00,20:15,48.78,41.09,0,48.78,41.09,2,-73544,74121,147665,577,0,-12136,467,0,0,,12603,-11669
49,12-07-18,82,20:15,20:30,47.06,46.31,0,47.06,28.16,2,-57510,56757,114267,-753,0,-44,1244,0,0,,1288,1200
49,12-07-18,83,20:30,20:45,,36.13,0,36.13,36.13,-1,-24467,58341,82808,33874,0,-18721,0,0,0,,18721,-18721
49,12-07-18,84,20:45,21:00,,33.2,0,33.2,33.2,-1,-59699,82789,142488,23090,0,-31102,0,0,0,,31102,-31102
49,12-07-18,85,21:00,21:15,,31.36,0,31.36,31.36,-1,-76333,114841,191174,38508,0,-25356,0,0,0,,25356,-25356
49,12-07-18,86,21:15,21:30,48.88,31.36,0,48.88,48.88,1,-66250,60363,126613,-5887,0,-3307,2255,0,0,,5562,-1052
49,12-07-18,87,21:30,21:45,48.88,32.08,0,32.08,32.08,-1,-41421,82392,123813,40971,0,-16981,31,0,0,,17012,-16950
49,12-07-18,88,21:45,22:00,,27.68,0,27.68,27.68,-1,-40857,108274,149131,67417,0,-58869,0,0,0,,58869,-58869
49,12-07-18,89,22:00,22:15,47.81,18.38,0,47.81,47.81,1,-73710,86148,159858,12438,0,-33259,159,0,0,,33418,-33100
49,12-07-18,90,22:15,22:30,47.92,41.03,0,47.92,41.03,2,-35099,44990,80089,9891,0,-5554,696,0,0,,6250,-4858
49,12-07-18,91,22:30,22:45,48.88,45.51,0,48.88,45.51,2,-50348,41458,91806,-8890,0,-3498,1492,0,0,,4990,-2006
49,12-07-18,92,22:45,23:00,64.6,,0,64.6,64.6,1,-100470,50657,151127,-49813,0,0,14289,0,0,,14289,14289
49,12-07-18,93,23:00,23:15,68.09,40.03,0,68.09,40.03,2,-56907,36433,93340,-20474,0,-1242,11561,0,0,,12803,10319
49,12-07-18,94,23:15,23:30,90.83,40.78,0,90.83,40.78,2,-43976,34340,78316,-9636,0,-1434,26496,0,0,,27930,25062
49,12-07-18,95,23:30,23:45,90.83,33.2,0,33.2,33.2,-1,-29014,57816,86830,28802,0,-27615,633,0,0,,28248,-26982
49,12-07-18,96,23:45,0:00,,41.18,0,41.18,41.18,-1,-36073,56683,92756,20610,0,-9095,0,0,0,,9095,-9095
50,12-08-18,1,0:00,0:15,68.06,37.98,0,68.06,68.06,1,-93215,41231,134446,-51984,0,-2371,10592,0,0,,12963,8221
50,12-08-18,2,0:15,0:30,69.19,,0,69.19,69.19,1,-79304,33456,112760,-45848,0,0,46504,0,0,,46504,46504
50,12-08-18,3,0:30,0:45,68.18,,0,68.18,68.18,1,-82345,25045,107390,-57300,0,0,43218,0,0,,43218,43218
50,12-08-18,4,0:45,1:00,118.18,,0,118.18,118.18,1,-128413,42237,170650,-86176,0,0,66844,0,0,,66844,66844
50,12-08-18,5,1:00,1:15,118.18,,0,118.18,118.18,1,-75714,28268,103982,-47446,0,0,28708,0,0,,28708,28708
50,12-08-18,6,1:15,1:30,151.27,,0,151.27,151.27,1,-108027,28799,136826,-79228,0,0,70354,0,0,,70354,70354
50,12-08-18,7,1:30,1:45,56.27,,0,56.27,56.27,1,-89275,37618,126893,-51657,0,0,48756,0,0,,48756,48756
50,12-08-18,8,1:45,2:00,52.94,,0,52.94,52.94,1,-83014,44544,127558,-38470,0,0,30402,0,0,,30402,30402
50,12-08-18,9,2:00,2:15,49.5,16.66,0,49.5,16.66,2,-56326,72455,128781,16129,0,-4455,6922,0,0,,11377,2467
50,12-08-18,10,2:15,2:30,68.18,,0,68.18,68.18,1,-81978,38067,120045,-43911,0,0,33351,0,0,,33351,33351
50,12-08-18,11,2:30,2:45,48.94,,0,48.94,48.94,1,-71086,46873,117959,-24213,0,0,25739,0,0,,25739,25739
50,12-08-18,12,2:45,3:00,51.07,,0,51.07,51.07,1,-60586,52228,112814,-8358,0,0,13991,0,0,,13991,13991
50,12-08-18,13,3:00,3:15,50.57,,0,50.57,50.57,1,-59156,98124,157280,38968,0,0,16212,0,0,,16212,16212
50,12-08-18,14,3:15,3:30,50.57,40.94,0,40.94,40.94,-1,-39371,88122,127493,48751,0,-641,1432,0,0,,2073,791
50,12-08-18,15,3:30,3:45,,40.94,0,40.94,40.94,-1,-34112,87561,121673,53449,0,-747,0,0,0,,747,-747
50,12-08-18,16,3:45,4:00,,40.94,0,40.94,40.94,-1,-31374,79458,110832,48084,0,-880,0,0,0,,880,-880
50,12-08-18,17,4:00,4:15,,36.94,0,36.94,36.94,-1,-66055,84800,150855,18745,0,-3661,0,0,0,,3661,-3661
50,12-08-18,18,4:15,4:30,,37.59,0,37.59,37.59,-1,-66313,74126,140439,7813,0,-1428,0,0,0,,1428,-1428
50,12-08-18,19,4:30,4:45,41.8,37.59,0,41.8,37.59,2,-53651,54900,108551,1249,0,-3731,212,0,0,,3943,-3519
50,12-08-18,20,4:45,5:00,44.94,,0,44.94,44.94,1,-57541,51695,109236,-5846,0,0,3932,0,0,,3932,3932
50,12-08-18,21,5:00,5:15,43.5,,0,43.5,43.5,1,-60192,72752,132944,12560,0,0,541,0,0,,541,541
50,12-08-18,22,5:15,5:30,43.5,,0,43.5,43.5,1,-62578,64037,126615,1459,0,0,132,0,0,,132,132
50,12-08-18,23,5:30,5:45,50.87,,0,50.87,50.87,1,-71735,52575,124310,-19160,0,0,8558,0,0,,8558,8558
50,12-08-18,24,5:45,6:00,52.94,,0,52.94,52.94,1,-84417,53649,138066,-30768,0,0,26079,0,0,,26079,26079
50,12-08-18,25,6:00,6:15,53.37,,0,53.37,53.37,1,-74394,62232,136626,-12162,0,0,10613,0,0,,10613,10613
50,12-08-18,26,6:15,6:30,62.28,,0,62.28,62.28,1,-72577,46927,119504,-25650,0,0,8986,0,0,,8986,8986
50,12-08-18,27,6:30,6:45,63.61,,0,63.61,63.61,1,-89658,54877,144535,-34781,0,0,38395,0,0,,38395,38395
50,12-08-18,28,6:45,7:00,60.96,,0,60.96,60.96,1,-117796,63062,180858,-54734,0,0,48005,0,0,,48005,48005
50,12-08-18,29,7:00,7:15,60.96,36.69,0,36.69,36.69,-1,-23269,112600,135869,89331,0,-2674,6873,0,0,,9547,4199
50,12-08-18,30,7:15,7:30,,18.37,0,18.37,18.37,-1,-49004,87695,136699,38691,0,-16681,0,0,0,,16681,-16681
50,12-08-18,31,7:30,7:45,44.56,40.56,0,44.56,40.56,2,-59394,56987,116381,-2407,0,-4519,1085,0,0,,5604,-3434
50,12-08-18,32,7:45,8:00,,,0,42.49,42.49,0,-62462,103456,165918,40994,0,0,167,0,0,,167,167
50,12-08-18,33,8:00,8:15,49.69,,0,49.69,49.69,1,-47513,61288,108801,13775,0,0,1922,0,0,,1922,1922
50,12-08-18,34,8:15,8:30,48.85,,0,48.85,48.85,1,-57967,48463,106430,-9504,0,0,3157,0,0,,3157,3157
50,12-08-18,35,8:30,8:45,57.62,,0,57.62,57.62,1,-64899,38509,103408,-26390,0,0,12989,0,0,,12989,12989
50,12-08-18,36,8:45,9:00,54.19,,0,54.19,54.19,1,-75815,33088,108903,-42727,0,0,35699,0,0,,35699,35699
50,12-08-18,37,9:00,9:15,53.37,38.54,0,38.54,38.54,-1,-32601,46797,79398,14196,0,-3546,17978,0,0,,21524,14432
50,12-08-18,38,9:15,9:30,53.37,45.12,0,53.37,53.37,1,-55772,47645,103417,-8127,0,-2832,4662,0,0,,7494,1830
50,12-08-18,39,9:30,9:45,58.39,,0,58.39,58.39,1,-81228,30024,111252,-51204,0,0,39262,0,0,,39262,39262
50,12-08-18,40,9:45,10:00,68.37,,0,68.37,68.37,1,-109299,30971,140270,-78328,0,0,58700,0,0,,58700,58700
50,12-08-18,41,10:00,10:15,159.12,,0,159.12,159.12,1,-124320,33134,157454,-91186,0,0,82024,0,0,,82024,82024
50,12-08-18,42,10:15,10:30,68.37,,0,68.37,68.37,1,-102985,35722,138707,-67263,0,0,62328,0,0,,62328,62328
50,12-08-18,43,10:30,10:45,126.12,,0,126.12,126.12,1,-125035,33376,158411,-91659,0,0,72812,0,0,,72812,72812
50,12-08-18,44,10:45,11:00,75.48,,0,75.48,75.48,1,-112616,44619,157235,-67997,0,0,70614,0,0,,70614,70614
50,12-08-18,45,11:00,11:15,118.37,,0,118.37,118.37,1,-132093,46717,178810,-85376,0,0,68021,0,0,,68021,68021
50,12-08-18,46,11:15,11:30,74.33,,0,74.33,74.33,1,-114863,45616,160479,-69247,0,0,74865,0,0,,74865,74865
50,12-08-18,47,11:30,11:45,54.04,,0,54.04,54.04,1,-93035,46844,139879,-46191,0,0,44499,0,0,,44499,44499
50,12-08-18,48,11:45,12:00,68.37,,0,68.37,68.37,1,-99947,50206,150153,-49741,0,0,44786,0,0,,44786,44786
50,12-08-18,49,12:00,12:15,159.12,,0,159.12,159.12,1,-149296,47766,197062,-101530,0,0,79474,0,0,,79474,79474
50,12-08-18,50,12:15,12:30,94.67,,0,94.67,94.67,1,-126854,52119,178973,-74735,0,0,71151,0,0,,71151,71151
50,12-08-18,51,12:30,12:45,68.37,,0,68.37,68.37,1,-99812,54462,154274,-45350,0,0,56703,0,0,,56703,56703
50,12-08-18,52,12:45,13:00,53.37,,0,53.37,53.37,1,-80066,60309,140375,-19757,0,0,18353,0,0,,18353,18353
50,12-08-18,53,13:00,13:15,62.85,,0,62.85,62.85,1,-89245,46100,135345,-43145,0,0,25302,0,0,,25302,25302
50,12-08-18,54,13:15,13:30,63.7,,0,63.7,63.7,1,-92056,46479,138535,-45577,0,0,35759,0,0,,35759,35759
50,12-08-18,55,13:30,13:45,53.37,,0,53.37,53.37,1,-87061,53009,140070,-34052,0,0,37631,0,0,,37631,37631
50,12-08-18,56,13:45,14:00,51.2,,0,51.2,51.2,1,-70407,56300,126707,-14107,0,0,19332,0,0,,19332,19332
50,12-08-18,57,14:00,14:15,62.51,,0,62.51,62.51,1,-87138,45426,132564,-41712,0,0,24173,0,0,,24173,24173
50,12-08-18,58,14:15,14:30,53.37,,0,53.37,53.37,1,-81131,43854,124985,-37277,0,0,33005,0,0,,33005,33005
50,12-08-18,59,14:30,14:45,53.37,,0,53.37,53.37,1,-71826,50362,122188,-21464,0,0,27566,0,0,,27566,27566
50,12-08-18,60,14:45,15:00,44.56,,0,44.56,44.56,1,-62962,58610,121572,-4352,0,0,5370,0,0,,5370,5370
50,12-08-18,61,15:00,15:15,44.56,,0,44.56,44.56,1,-52669,66132,118801,13463,0,0,697,0,0,,697,697
50,12-08-18,62,15:15,15:30,44.56,,0,44.56,44.56,1,-61497,63455,124952,1958,0,0,148,0,0,,148,148
50,12-08-18,63,15:30,15:45,44.56,,0,44.56,44.56,1,-38983,63314,102297,24331,0,0,870,0,0,,870,870
50,12-08-18,64,15:45,16:00,48.15,,0,48.15,48.15,1,-47651,60082,107733,12431,0,0,523,0,0,,523,523
50,12-08-18,65,16:00,16:15,48.15,37.97,0,37.97,37.97,-1,-74990,108924,183914,33934,0,-18818,60,0,0,,18878,-18758
50,12-08-18,66,16:15,16:30,,42.78,0,42.78,42.78,-1,-76765,93459,170224,16694,0,-6928,0,0,0,,6928,-6928
50,12-08-18,67,16:30,16:45,54.58,44.56,0,54.58,44.56,2,-78792,70019,148811,-8773,0,-1772,3273,0,0,,5045,1501
50,12-08-18,68,16:45,17:00,88.37,,0,88.37,88.37,1,-116762,76210,192972,-40552,0,0,28081,0,0,,28081,28081
50,12-08-18,69,17:00,17:15,53.12,,0,53.12,53.12,1,-63436,91057,154493,27621,0,0,4359,0,0,,4359,4359
50,12-08-18,70,17:15,17:30,59.93,,0,59.93,59.93,1,-63303,66952,130255,3649,0,0,943,0,0,,943,943
50,12-08-18,71,17:30,17:45,68.46,,0,68.46,68.46,1,-80688,62374,143062,-18314,0,0,16159,0,0,,16159,16159
50,12-08-18,72,17:45,18:00,51.49,,0,51.49,51.49,1,-71107,74689,145796,3582,0,0,3747,0,0,,3747,3747
50,12-08-18,73,18:00,18:15,49,41.78,0,49,41.78,2,-50721,73713,124434,22992,0,-5476,170,0,0,,5646,-5306
50,12-08-18,74,18:15,18:30,,45.17,0,45.17,45.17,-1,-58570,96627,155197,38057,0,-3706,0,0,0,,3706,-3706
50,12-08-18,75,18:30,18:45,,33.37,0,33.37,33.37,-1,-49327,104006,153333,54679,0,-25639,0,0,0,,25639,-25639
50,12-08-18,76,18:45,19:00,,37.07,0,37.07,37.07,-1,-56248,83700,139948,27452,0,-25312,0,0,0,,25312,-25312
50,12-08-18,77,19:00,19:15,74.27,37.07,0,74.27,74.27,1,-74841,43830,118671,-31011,0,-730,16927,0,0,,17657,16197
50,12-08-18,78,19:15,19:30,53.16,,0,53.16,53.16,1,-65693,69729,135422,4036,0,0,4770,0,0,,4770,4770
50,12-08-18,79,19:30,19:45,,38.91,0,38.91,38.91,-1,-57101,94838,151939,37737,0,-4691,0,0,0,,4691,-4691
50,12-08-18,80,19:45,20:00,,31.13,0,31.13,31.13,-1,-47918,107972,155890,60054,0,-43745,0,0,0,,43745,-43745
50,12-08-18,81,20:00,20:15,60.91,40.78,0,60.91,40.78,2,-72022,67569,139591,-4453,0,-11936,2192,0,0,,14128,-9744
50,12-08-18,82,20:15,20:30,,40.56,0,40.56,40.56,-1,-56680,87994,144674,31314,0,-16378,0,0,0,,16378,-16378
50,12-08-18,83,20:30,20:45,,37.27,0,37.27,37.27,-1,-52698,89766,142464,37068,0,-26764,0,0,0,,26764,-26764
50,12-08-18,84,20:45,21:00,,36.69,0,36.69,36.69,-1,-53038,85842,138880,32804,0,-35068,0,0,0,,35068,-35068
50,12-08-18,85,21:00,21:15,71.34,41.55,0,71.34,71.34,1,-87834,58086,145920,-29748,0,-9800,12412,0,0,,22212,2612
50,12-08-18,86,21:15,21:30,82.62,,0,82.62,82.62,1,-88106,49516,137622,-38590,0,0,37450,0,0,,37450,37450
50,12-08-18,87,21:30,21:45,53.37,,0,53.37,53.37,1,-95252,62590,157842,-32662,0,0,23860,0,0,,23860,23860
50,12-08-18,88,21:45,22:00,57.29,,0,57.29,57.29,1,-121289,71585,192874,-49704,0,0,35037,0,0,,35037,35037
50,12-08-18,89,22:00,22:15,109.6,,0,109.6,109.6,1,-122908,38667,161575,-84241,0,0,47596,0,0,,47596,47596
50,12-08-18,90,22:15,22:30,195.51,,0,195.51,195.51,1,-118516,60157,178673,-58359,0,0,71696,0,0,,71696,71696
50,12-08-18,91,22:30,22:45,47.17,,0,47.17,47.17,1,-90883,82000,172883,-8883,0,0,9022,0,0,,9022,9022
50,12-08-18,92,22:45,23:00,47.18,,0,47.18,47.18,1,-82358,97395,179753,15037,0,0,540,0,0,,540,540
50,12-08-18,93,23:00,23:15,154.12,46.66,0,154.12,45.61,2,-129116,41638,170754,-87478,0,-23,24785,0,0,,24808,24762
50,12-08-18,94,23:15,23:30,155.12,,0,155.12,155.12,1,-142037,43275,185312,-98762,0,0,100171,0,0,,100171,100171
50,12-08-18,95,23:30,23:45,63.03,,0,63.03,63.03,1,-101571,46093,147664,-55478,0,0,37630,0,0,,37630,37630
50,12-08-18,96,23:45,0:00,68.37,,0,68.37,68.37,1,-130009,59588,189597,-70421,0,0,57243,0,0,,57243,57243
50,12-09-18,1,0:00,0:15,48.69,37.03,0,48.69,37.03,2,-101086,90230,191316,-10856,0,-2196,18595,0,0,,20791,16399
50,12-09-18,2,0:15,0:30,79.16,,0,79.16,79.16,1,-99929,50029,149958,-49900,0,0,31810,0,0,,31810,31810
50,12-09-18,3,0:30,0:45,48.69,,0,48.69,48.69,1,-64359,45379,109738,-18980,0,0,10637,0,0,,10637,10637
50,12-09-18,4,0:45,1:00,44.56,32.97,0,32.97,32.97,-1,-31539,65967,97506,34428,0,-10247,582,0,0,,10829,-9665
50,12-09-18,5,1:00,1:15,53.37,18.37,0,53.37,53.37,1,-77890,71620,149510,-6270,0,-12989,1780,0,0,,14769,-11209
50,12-09-18,6,1:15,1:30,54.8,,0,54.8,54.8,1,-76786,48630,125416,-28156,0,0,19534,0,0,,19534,19534
50,12-09-18,7,1:30,1:45,47.17,40.56,0,40.56,40.56,-1,-58626,57421,116047,-1205,0,-1421,9242,0,0,,10663,7821
50,12-09-18,8,1:45,2:00,47.17,32.97,0,32.97,32.97,-1,-30725,76512,107237,45787,0,-10022,5,0,0,,10027,-10017
50,12-09-18,9,2:00,2:15,,28.07,0,28.07,28.07,-1,-69510,89971,159481,20461,0,-13179,0,0,0,,13179,-13179
50,12-09-18,10,2:15,2:30,,,0,42.76,42.76,0,-48875,83396,132271,34521,0,0,0,0,0,,0,0
50,12-09-18,11,2:30,2:45,,41.01,0,41.01,41.01,-1,-30180,97070,127250,66890,0,-498,0,0,0,,498,-498
50,12-09-18,12,2:45,3:00,,36.56,0,36.56,36.56,-1,-28297,89537,117834,61240,0,-6385,0,0,0,,6385,-6385
50,12-09-18,13,3:00,3:15,,,0,42.67,42.67,0,-25594,92878,118472,67284,0,-3132,0,0,0,,3132,-3132
50,12-09-18,14,3:15,3:30,,40.56,0,40.56,40.56,-1,-23421,86229,109650,62808,0,-235,0,0,0,,235,-235
50,12-09-18,15,3:30,3:45,,-15.43,0,-15.43,-15.43,-1,-22480,89826,112306,67346,0,-19794,0,0,0,,19794,-19794
50,12-09-18,16,3:45,4:00,,32.97,0,32.97,32.97,-1,-37674,75879,113553,38205,0,-40332,0,0,0,,40332,-40332
50,12-09-18,17,4:00,4:15,,33.03,0,33.03,33.03,-1,-26613,99710,126323,73097,0,-18567,0,0,0,,18567,-18567
50,12-09-18,18,4:15,4:30,,,0,41.51,41.51,0,-27754,89674,117428,61920,0,-1,0,0,0,,1,-1
50,12-09-18,19,4:30,4:45,,,0,41.51,41.51,0,-30194,93872,124066,63678,0,0,0,0,0,,0,0
50,12-09-18,20,4:45,5:00,,39.14,0,39.14,39.14,-1,-28409,97386,125795,68977,0,-974,0,0,0,,974,-974
50,12-09-18,21,5:00,5:15,,39.59,0,39.59,39.59,-1,-33102,62933,96035,29831,0,-3507,0,0,0,,3507,-3507
50,12-09-18,22,5:15,5:30,,40.33,0,40.33,40.33,-1,-29021,55465,84486,26444,0,-604,0,0,0,,604,-604
50,12-09-18,23,5:30,5:45,,36.03,0,36.03,36.03,-1,-32599,49948,82547,17349,0,-9685,0,0,0,,9685,-9685
50,12-09-18,24,5:45,6:00,,38.75,0,38.75,38.75,-1,-32686,52860,85546,20174,0,-11698,0,0,0,,11698,-11698
50,12-09-18,25,6:00,6:15,,-7.6,0,-7.6,-7.6,-1,-17876,94291,112167,76415,0,-29132,0,0,0,,29132,-29132
50,12-09-18,26,6:15,6:30,,33.03,0,33.03,33.03,-1,-30897,86353,117250,55456,0,-39402,0,0,0,,39402,-39402
50,12-09-18,27,6:30,6:45,,37.03,0,37.03,37.03,-1,-46649,87248,133897,40599,0,-15541,0,0,0,,15541,-15541
50,12-09-18,28,6:45,7:00,,40.56,0,40.56,40.56,-1,-30487,98919,129406,68432,0,-92,0,0,0,,92,-92
50,12-09-18,29,7:00,7:15,,33.08,0,33.08,33.08,-1,-29176,104261,133437,75085,0,-10119,0,0,0,,10119,-10119
50,12-09-18,30,7:15,7:30,,,0,45.34,45.34,0,-28066,86162,114228,58096,0,0,0,0,0,,0,0
50,12-09-18,31,7:30,7:45,,42.05,0,42.05,42.05,-1,-58227,67280,125507,9053,0,-1342,0,0,0,,1342,-1342
50,12-09-18,32,7:45,8:00,48.73,,0,48.73,48.73,1,-78161,56106,134267,-22055,0,0,2268,0,0,,2268,2268
50,12-09-18,33,8:00,8:15,48.73,46.02,0,46.02,46.02,-1,-35290,97697,132987,62407,0,-890,149,0,0,,1039,-741
50,12-09-18,34,8:15,8:30,,33.08,0,33.08,33.08,-1,-25862,84325,110187,58463,0,-4667,0,0,0,,4667,-4667
50,12-09-18,35,8:30,8:45,,33.08,0,33.08,33.08,-1,-43314,71995,115309,28681,0,-27240,0,0,0,,27240,-27240
50,12-09-18,36,8:45,9:00,,28.09,0,28.09,28.09,-1,-48741,95685,144426,46944,0,-11092,0,0,0,,11092,-11092
50,12-09-18,37,9:00,9:15,,0.89,0,0.89,0.89,-1,-35025,120954,155979,85929,0,-68986,0,0,0,,68986,-68986
50,12-09-18,38,9:15,9:30,,40.56,0,40.56,40.56,-1,-50393,68742,119135,18349,0,-18610,0,0,0,,18610,-18610
50,12-09-18,39,9:30,9:45,47.17,46.56,0,47.17,47.17,1,-66635,62108,128743,-4527,0,-400,377,0,0,,777,-23
50,12-09-18,40,9:45,10:00,50.05,,0,50.05,50.05,1,-89917,61621,151538,-28296,0,0,12769,0,0,,12769,12769
50,12-09-18,41,10:00,10:15,46.02,46.88,0,46.88,46.88,-1,-39008,80702,119710,41694,0,-250,5662,0,0,,5912,5412
50,12-09-18,42,10:15,10:30,,46.88,0,46.88,46.88,-1,-37212,75291,112503,38079,0,-202,0,0,0,,202,-202
50,12-09-18,43,10:30,10:45,,46.09,0,46.09,46.09,-1,-30399,71682,102081,41283,0,-915,0,0,0,,915,-915
50,12-09-18,44,10:45,11:00,,42,0,42,42,-1,-51338,67099,118437,15761,0,-619,0,0,0,,619,-619
50,12-09-18,45,11:00,11:15,,45.16,0,45.16,45.16,-1,-35533,71162,106695,35629,0,-230,0,0,0,,230,-230
50,12-09-18,46,11:15,11:30,,36.56,0,36.56,36.56,-1,-42642,89568,132210,46926,0,-18913,0,0,0,,18913,-18913
50,12-09-18,47,11:30,11:45,,40.56,0,40.56,40.56,-1,-41952,91737,133689,49785,0,-9278,0,0,0,,9278,-9278
50,12-09-18,48,11:45,12:00,,41.39,0,41.39,41.39,-1,-34825,79867,114692,45042,0,-4933,0,0,0,,4933,-4933
50,12-09-18,49,12:00,12:15,,36.56,0,36.56,36.56,-1,-32731,103513,136244,70782,0,-23404,0,0,0,,23404,-23404
50,12-09-18,50,12:15,12:30,,18.59,0,18.59,18.59,-1,-36366,112284,148650,75918,0,-38830,0,0,0,,38830,-38830
50,12-09-18,51,12:30,12:45,,40.56,0,40.56,40.56,-1,-43038,104374,147412,61336,0,-10949,0,0,0,,10949,-10949
50,12-09-18,52,12:45,13:00,,33.08,0,33.08,33.08,-1,-32526,128039,160565,95513,0,-6074,0,0,0,,6074,-6074
50,12-09-18,53,13:00,13:15,,40.56,0,40.56,40.56,-1,-29529,166114,195643,136585,0,-14534,0,0,0,,14534,-14534
50,12-09-18,54,13:15,13:30,,18.59,0,18.59,18.59,-1,-26467,191017,217484,164550,0,-9911,0,0,0,,9911,-9911
50,12-09-18,55,13:30,13:45,,-46.87,0,-46.87,-46.87,-1,-37219,138508,175727,101289,0,-52769,0,0,0,,52769,-52769
50,12-09-18,56,13:45,14:00,,-26.55,0,-26.55,-26.55,-1,-44402,123943,168345,79541,0,-70317,0,0,0,,70317,-70317
50,12-09-18,57,14:00,14:15,,36.32,0,36.32,36.32,-1,-67322,119190,186512,51868,0,-33154,0,0,0,,33154,-33154
50,12-09-18,58,14:15,14:30,,37.01,0,37.01,37.01,-1,-58277,131541,189818,73264,0,-6470,0,0,0,,6470,-6470
50,12-09-18,59,14:30,14:45,,36.56,0,36.56,36.56,-1,-56728,114177,170905,57449,0,-20723,0,0,0,,20723,-20723
50,12-09-18,60,14:45,15:00,,41.03,0,41.03,41.03,-1,-61652,86727,148379,25075,0,-6055,0,0,0,,6055,-6055
50,12-09-18,61,15:00,15:15,44.37,,0,44.37,44.37,1,-71151,73071,144222,1920,0,0,54,0,0,,54,54
50,12-09-18,62,15:15,15:30,50.79,,0,50.79,50.79,1,-75342,58683,134025,-16659,0,0,7514,0,0,,7514,7514
50,12-09-18,63,15:30,15:45,48.79,,0,48.79,48.79,1,-74781,51397,126178,-23384,0,0,20330,0,0,,20330,20330
50,12-09-18,64,15:45,16:00,50.77,46.27,0,50.77,45.32,2,-82074,54817,136891,-27257,0,-24,20601,0,0,,20625,20577
50,12-09-18,65,16:00,16:15,50.77,18.59,0,18.59,18.59,-1,-27767,125885,153652,98118,0,-26801,2515,0,0,,29316,-24286
50,12-09-18,66,16:15,16:30,,40.56,0,40.56,40.56,-1,-41148,98200,139348,57052,0,-31059,0,0,0,,31059,-31059
50,12-09-18,67,16:30,16:45,,46.5,0,46.5,46.5,-1,-43750,68960,112710,25210,0,-6643,0,0,0,,6643,-6643
50,12-09-18,68,16:45,17:00,53.59,,0,53.59,53.59,1,-91808,66004,157812,-25804,0,0,14979,0,0,,14979,14979
50,12-09-18,69,17:00,17:15,78.74,,0,78.74,78.74,1,-74952,44485,119437,-30467,0,0,17274,0,0,,17274,17274
50,12-09-18,70,17:15,17:30,58.74,,0,58.74,58.74,1,-70875,42732,113607,-28143,0,0,10283,0,0,,10283,10283
50,12-09-18,71,17:30,17:45,59.43,,0,59.43,59.43,1,-88338,38422,126760,-49916,0,0,42558,0,0,,42558,42558
50,12-09-18,72,17:45,18:00,78.74,,0,78.74,78.74,1,-99881,36482,136363,-63399,0,0,60688,0,0,,60688,60688
50,12-09-18,73,18:00,18:15,210.24,,0,210.24,210.24,1,-135658,22676,158334,-112982,0,0,91489,0,0,,91489,91489
50,12-09-18,74,18:15,18:30,61.8,,0,61.8,61.8,1,-69594,39767,109361,-29827,0,0,39040,0,0,,39040,39040
50,12-09-18,75,18:30,18:45,60.7,,0,60.7,60.7,1,-84053,50107,134160,-33946,0,0,28230,0,0,,28230,28230
50,12-09-18,76,18:45,19:00,56.5,,0,56.5,56.5,1,-63080,50415,113495,-12665,0,0,19631,0,0,,19631,19631
50,12-09-18,77,19:00,19:15,157.02,,0,157.02,157.02,1,-119815,38803,158618,-81012,0,0,43337,0,0,,43337,43337
50,12-09-18,78,19:15,19:30,81,,0,81,81,1,-85560,34497,120057,-51063,0,0,58484,0,0,,58484,58484
50,12-09-18,79,19:30,19:45,54.95,,0,54.95,54.95,1,-61241,41380,102621,-19861,0,0,23659,0,0,,23659,23659
50,12-09-18,80,19:45,20:00,55.1,,0,55.1,55.1,1,-66178,48410,114588,-17768,0,0,12252,0,0,,12252,12252
50,12-09-18,81,20:00,20:15,57.02,,0,57.02,57.02,1,-79696,34263,113959,-45433,0,0,35553,0,0,,35553,35553
50,12-09-18,82,20:15,20:30,56.08,,0,56.08,56.08,1,-72427,31333,103760,-41094,0,0,38689,0,0,,38689,38689
50,12-09-18,83,20:30,20:45,52.27,,0,52.27,52.27,1,-73599,46971,120570,-26628,0,0,18778,0,0,,18778,18778
50,12-09-18,84,20:45,21:00,52.27,,0,52.27,52.27,1,-67583,53896,121479,-13687,0,0,21814,0,0,,21814,21814
50,12-09-18,85,21:00,21:15,56.82,,0,56.82,56.82,1,-67532,26952,94484,-40580,0,0,21026,0,0,,21026,21026
50,12-09-18,86,21:15,21:30,48.02,43.27,0,48.02,43.27,2,-36390,34657,71047,-1733,0,-2121,8033,0,0,,10154,5912
50,12-09-18,87,21:30,21:45,,42.38,0,42.38,42.38,-1,-33286,70360,103646,37074,0,-8394,0,0,0,,8394,-8394
50,12-09-18,88,21:45,22:00,,40.35,0,40.35,40.35,-1,-45658,81389,127047,35731,0,-20082,0,0,0,,20082,-20082
50,12-09-18,89,22:00,22:15,56.38,20.78,0,56.38,20.78,2,-48024,53072,101096,5048,0,-24970,2117,0,0,,27087,-22853
50,12-09-18,90,22:15,22:30,67.46,20.78,0,67.46,67.46,1,-56085,28038,84123,-28047,0,-505,25936,0,0,,26441,25431
50,12-09-18,91,22:30,22:45,48.73,41.57,0,48.73,41.57,2,-47791,45599,93390,-2192,0,-3107,2876,0,0,,5983,-231
50,12-09-18,92,22:45,23:00,68.59,,0,68.59,68.59,1,-85317,49528,134845,-35789,0,0,18436,0,0,,18436,18436
50,12-09-18,93,23:00,23:15,68.59,41.03,0,68.59,41.03,2,-80113,45516,125629,-34597,0,-1111,17793,0,0,,18904,16682
50,12-09-18,94,23:15,23:30,53.76,,0,53.76,53.76,1,-71872,40706,112578,-31166,0,0,35438,0,0,,35438,35438
50,12-09-18,95,23:30,23:45,53.76,36.56,0,36.56,36.56,-1,-37066,53673,90739,16607,0,-12772,7589,0,0,,20361,-5183
50,12-09-18,96,23:45,0:00,44.56,39.78,0,45.43,39.78,2,-49419,61672,111091,12253,0,-6234,139,0,0,,6373,-6095
50,12-10-18,1,0:00,0:15,51.56,33.59,0,51.56,33.59,2,-68364,60022,128386,-8342,0,-6323,5308,0,0,,11631,-1015
50,12-10-18,2,0:15,0:30,48.56,36.73,0,48.56,36.73,2,-57469,66335,123804,8866,0,-6969,794,0,0,,7763,-6175
50,12-10-18,3,0:30,0:45,52.76,,0,52.76,52.76,1,-61916,32859,94775,-29057,0,0,20157,0,0,,20157,20157
50,12-10-18,4,0:45,1:00,48.76,,0,48.76,48.76,1,-47855,27061,74916,-20794,0,0,13701,0,0,,13701,13701
50,12-10-18,5,1:00,1:15,48.44,,0,48.44,48.44,1,-46996,40628,87624,-6368,0,0,7498,0,0,,7498,7498
50,12-10-18,6,1:15,1:30,48.76,,0,48.76,48.76,1,-51595,39712,91307,-11883,0,0,3921,0,0,,3921,3921
50,12-10-18,7,1:30,1:45,48.76,,0,48.76,48.76,1,-58525,48501,107026,-10024,0,0,7706,0,0,,7706,7706
50,12-10-18,8,1:45,2:00,44.73,42.72,0,45.26,42.72,2,-34042,47557,81599,13515,0,-4519,1529,0,0,,6048,-2990
50,12-10-18,9,2:00,2:15,52.76,45.61,0,52.76,45.17,2,-59616,23593,83209,-36023,0,-1527,12583,0,0,,14110,11056
50,12-10-18,10,2:15,2:30,52.76,,0,52.76,52.76,1,-53933,34305,88238,-19628,0,0,29357,0,0,,29357,29357
50,12-10-18,11,2:30,2:45,52.76,43.99,0,43.99,43.99,-1,-43405,46715,90120,3310,0,-1857,3136,0,0,,4993,1279
50,12-10-18,12,2:45,3:00,48.76,,0,48.76,48.76,1,-53015,34207,87222,-18808,0,0,7321,0,0,,7321,7321
50,12-10-18,13,3:00,3:15,44.73,,0,44.73,44.73,1,-44007,45911,89918,1904,0,0,1407,0,0,,1407,1407
50,12-10-18,14,3:15,3:30,48.66,,0,48.66,48.66,1,-56061,41524,97585,-14537,0,0,4587,0,0,,4587,4587
50,12-10-18,15,3:30,3:45,48.76,,0,48.76,48.76,1,-58440,46516,104956,-11924,0,0,13868,0,0,,13868,13868
50,12-10-18,16,3:45,4:00,48.76,45.54,0,45.54,45.54,-1,-54145,72601,126746,18456,0,-1077,2383,0,0,,3460,1306
50,12-10-18,17,4:00,4:15,,43.78,0,43.78,43.78,-1,-56354,74105,130459,17751,0,-2451,0,0,0,,2451,-2451
50,12-10-18,18,4:15,4:30,48.76,45.58,0,48.76,48.76,1,-66608,40124,106732,-26484,0,-601,2686,0,0,,3287,2085
50,12-10-18,19,4:30,4:45,51.56,,0,51.56,51.56,1,-80484,35352,115836,-45132,0,0,21564,0,0,,21564,21564
50,12-10-18,20,4:45,5:00,52.76,,0,52.76,52.76,1,-87386,30943,118329,-56443,0,0,39022,0,0,,39022,39022
50,12-10-18,21,5:00,5:15,52.76,,0,52.76,52.76,1,-74694,66787,141481,-7907,0,0,16422,0,0,,16422,16422
50,12-10-18,22,5:15,5:30,52.76,45.52,0,45.52,45.52,-1,-34095,39893,73988,5798,0,-943,333,0,0,,1276,-610
50,12-10-18,23,5:30,5:45,66.75,43.51,0,66.75,43.51,2,-72333,28503,100836,-43830,0,-1045,4041,0,0,,5086,2996
50,12-10-18,24,5:45,6:00,96.63,,0,96.63,96.63,1,-93735,38052,131787,-55683,0,0,31099,0,0,,31099,31099
50,12-10-18,25,6:00,6:15,62.28,41.72,0,62.28,41.72,2,-73410,64284,137694,-9126,0,-607,8831,0,0,,9438,8224
50,12-10-18,26,6:15,6:30,68.58,40.83,0,68.58,40.83,2,-66026,43226,109252,-22800,0,-2132,6342,0,0,,8474,4210
50,12-10-18,27,6:30,6:45,103.38,,0,103.38,103.38,1,-101097,42967,144064,-58130,0,0,54376,0,0,,54376,54376
50,12-10-18,28,6:45,7:00,68.58,,0,68.58,68.58,1,-96555,43598,140153,-52957,0,0,40944,0,0,,40944,40944
50,12-10-18,29,7:00,7:15,68.58,-34.79,0,-34.79,-34.79,-1,-69548,114633,184181,45085,0,-10539,21830,0,0,,32369,11291
50,12-10-18,30,7:15,7:30,155.12,-122.2,0,155.12,155.12,1,-102792,39029,141821,-63763,0,-13198,18313,0,0,,31511,5115
50,12-10-18,31,7:30,7:45,155.12,,0,155.12,155.12,1,-143909,38626,182535,-105283,0,0,91702,0,0,,91702,91702
50,12-10-18,32,7:45,8:00,155.12,,0,155.12,155.12,1,-188873,59930,248803,-128943,0,0,108975,0,0,,108975,108975
50,12-10-18,33,8:00,8:15,118.59,36.07,0,36.07,36.07,-1,-72829,75058,147887,2229,0,-4184,50497,0,0,,54681,46313
50,12-10-18,34,8:15,8:30,130.61,46.08,0,130.61,130.61,1,-104081,34771,138852,-69310,0,-2406,27749,0,0,,30155,25343
50,12-10-18,35,8:30,8:45,266.45,,0,266.45,266.45,1,-105535,42138,147673,-63397,0,0,70420,3750,0,,74170,74170
50,12-10-18,36,8:45,9:00,52.98,,0,52.98,52.98,1,-81793,60284,142077,-21509,0,0,6567,0,0,,6567,6567
50,12-10-18,37,9:00,9:15,71.2,,0,71.2,71.2,1,-96184,45029,141213,-51155,0,0,34150,0,0,,34150,34150
50,12-10-18,38,9:15,9:30,55.77,,0,55.77,55.77,1,-96031,38375,134406,-57656,0,0,51926,0,0,,51926,51926
50,12-10-18,39,9:30,9:45,52.76,,0,52.76,52.76,1,-74259,32991,107250,-41268,0,0,43846,0,0,,43846,43846
50,12-10-18,40,9:45,10:00,51.82,,0,51.82,51.82,1,-83470,38033,121503,-45437,0,0,37277,0,0,,37277,37277
50,12-10-18,41,10:00,10:15,73.42,,0,73.42,73.42,1,-101810,44482,146292,-57328,0,0,52368,0,0,,52368,52368
50,12-10-18,42,10:15,10:30,53.42,,0,53.42,53.42,1,-86277,51356,137633,-34921,0,0,27179,0,0,,27179,27179
50,12-10-18,43,10:30,10:45,53.42,,0,53.42,53.42,1,-94201,51074,145275,-43127,0,0,36473,0,0,,36473,36473
50,12-10-18,44,10:45,11:00,53.42,,0,53.42,53.42,1,-94488,55637,150125,-38851,0,0,37534,0,0,,37534,37534
50,12-10-18,45,11:00,11:15,51.82,,0,51.82,51.82,1,-93212,49147,142359,-44065,0,0,42561,0,0,,42561,42561
50,12-10-18,46,11:15,11:30,51.12,,0,51.12,51.12,1,-74080,55519,129599,-18561,0,0,22926,0,0,,22926,22926
50,12-10-18,47,11:30,11:45,47.82,,0,47.82,47.82,1,-69505,50051,119556,-19454,0,0,14206,0,0,,14206,14206
50,12-10-18,48,11:45,12:00,51.82,,0,51.82,51.82,1,-82090,48404,130494,-33686,0,0,20099,0,0,,20099,20099
50,12-10-18,49,12:00,12:15,54.12,,0,54.12,54.12,1,-119379,60443,179822,-58936,0,0,42935,0,0,,42935,42935
50,12-10-18,50,12:15,12:30,48.47,,0,48.47,48.47,1,-95868,63566,159434,-32302,0,0,11980,0,0,,11980,11980
50,12-10-18,51,12:30,12:45,,42.31,0,42.31,42.31,-1,-60721,71225,131946,10504,0,-4965,0,0,0,,4965,-4965
50,12-10-18,52,12:45,13:00,,40.8,0,40.8,40.8,-1,-53774,77627,131401,23853,0,-20270,0,0,0,,20270,-20270
50,12-10-18,53,13:00,13:15,,36.93,0,36.93,36.93,-1,-36511,74966,111477,38455,0,-27845,0,0,0,,27845,-27845
50,12-10-18,54,13:15,13:30,,41.78,0,41.78,41.78,-1,-43760,71625,115385,27865,0,-27321,0,0,0,,27321,-27321
50,12-10-18,55,13:30,13:45,,40.8,0,40.8,40.8,-1,-36240,72821,109061,36581,0,-25863,0,0,0,,25863,-25863
50,12-10-18,56,13:45,14:00,,41.17,0,41.17,41.17,-1,-49756,64322,114078,14566,0,-22068,0,0,0,,22068,-22068
50,12-10-18,57,14:00,14:15,47.27,46.76,0,53.95,46.76,2,-70087,72899,142986,2812,0,-1865,469,0,0,,2334,-1396
50,12-10-18,58,14:15,14:30,,42.89,0,42.89,42.89,-1,-66066,81657,147723,15591,0,-8810,0,0,0,,8810,-8810
50,12-10-18,59,14:30,14:45,51.05,46.76,0,53.94,46.76,2,-71195,58907,130102,-12288,0,-2257,4172,0,0,,6429,1915
50,12-10-18,60,14:45,15:00,57.82,,0,57.82,57.82,1,-81516,47236,128752,-34280,0,0,22641,0,0,,22641,22641
50,12-10-18,61,15:00,15:15,57.82,,0,57.82,57.82,1,-79055,28423,107478,-50632,0,0,14029,0,0,,14029,14029
50,12-10-18,62,15:15,15:30,61.82,,0,61.82,61.82,1,-84422,24511,108933,-59911,0,0,29868,0,0,,29868,29868
50,12-10-18,63,15:30,15:45,78.54,,0,78.54,78.54,1,-103875,20454,124329,-83421,0,0,19856,0,0,,19856,19856
50,12-10-18,64,15:45,16:00,155.12,,0,155.12,155.12,1,-104243,13317,117560,-90926,0,0,68533,0,0,,68533,68533
50,12-10-18,65,16:00,16:15,53.82,42.78,0,55.56,42.78,2,-68091,64437,132528,-3654,0,-1733,15207,0,0,,16940,13474
50,12-10-18,66,16:15,16:30,96.27,,0,96.27,96.27,1,-87954,35008,122962,-52946,0,0,41626,0,0,,41626,41626
50,12-10-18,67,16:30,16:45,86.03,,0,86.03,86.03,1,-83681,37689,121370,-45992,0,0,29683,0,0,,29683,29683
50,12-10-18,68,16:45,17:00,175.99,,0,175.99,175.99,1,-145327,25326,170653,-120001,0,0,89726,0,0,,89726,89726
50,12-10-18,69,17:00,17:15,168.78,,0,168.78,168.78,1,-126763,67915,194678,-58848,0,0,69308,0,0,,69308,69308
50,12-10-18,70,17:15,17:30,98.78,,0,98.78,98.78,1,-120726,45329,166055,-75397,0,0,59655,0,0,,59655,59655
50,12-10-18,71,17:30,17:45,98.78,,0,98.78,98.78,1,-107317,41772,149089,-65545,0,0,64818,0,0,,64818,64818
50,12-10-18,72,17:45,18:00,78.78,,0,78.78,78.78,1,-99073,54104,153177,-44969,0,0,49781,0,0,,49781,49781
50,12-10-18,73,18:00,18:15,55.99,,0,55.99,55.99,1,-95340,55768,151108,-39572,0,0,36865,0,0,,36865,36865
50,12-10-18,74,18:15,18:30,53.61,45.1,0,45.1,45.1,-1,-53136,54546,107682,1410,0,-113,9482,0,0,,9595,9369
50,12-10-18,75,18:30,18:45,57.82,43.24,0,57.82,43.24,2,-54537,40236,94773,-14301,0,-1925,3350,0,0,,5275,1425
50,12-10-18,76,18:45,19:00,59.72,,0,59.72,59.72,1,-77744,47708,125452,-30036,0,0,25377,0,0,,25377,25377
50,12-10-18,77,19:00,19:15,51.67,,0,51.67,51.67,1,-97215,67165,164380,-30050,0,0,27596,0,0,,27596,27596
50,12-10-18,78,19:15,19:30,52.93,41.78,0,54.32,41.78,2,-55246,65159,120405,9913,0,-4997,10171,0,0,,15168,5174
50,12-10-18,79,19:30,19:45,53.82,44.98,0,54.34,44.98,2,-55292,46309,101601,-8983,0,-3644,3257,0,0,,6901,-387
50,12-10-18,80,19:45,20:00,47.25,44.47,0,54.37,44.47,2,-44256,57462,101718,13206,0,-4373,536,0,0,,4909,-3837
50,12-10-18,81,20:00,20:15,53.82,46.87,0,54.28,46.87,2,-96465,66287,162752,-30178,0,-1332,15196,0,0,,16528,13864
50,12-10-18,82,20:15,20:30,62.9,,0,62.9,62.9,1,-87819,37684,125503,-50135,0,0,43498,0,0,,43498,43498
50,12-10-18,83,20:30,20:45,54.53,42.06,0,54.53,42.06,2,-50306,50252,100558,-54,0,-2685,16299,0,0,,18984,13614
50,12-10-18,84,20:45,21:00,50.22,46.13,0,54.39,46.13,2,-56914,57736,114650,822,0,-197,975,0,0,,1172,778
50,12-10-18,85,21:00,21:15,154.12,46.13,0,154.12,154.12,1,-113969,37892,151861,-76077,0,-144,34922,0,0,,35066,34778
50,12-10-18,86,21:15,21:30,64.38,,0,64.38,64.38,1,-95129,44462,139591,-50667,0,0,60187,0,0,,60187,60187
50,12-10-18,87,21:30,21:45,47.19,,0,47.19,47.19,1,-64154,50104,114258,-14050,0,0,12027,0,0,,12027,12027
50,12-10-18,88,21:45,22:00,49.78,44.42,0,49.78,44.42,2,-55800,42549,98349,-13251,0,-220,9236,0,0,,9456,9016
50,12-10-18,89,22:00,22:15,68.54,38.06,0,68.54,38.06,2,-114335,87290,201625,-27045,0,-2014,14515,0,0,,16529,12501
50,12-10-18,90,22:15,22:30,49.78,,0,49.78,49.78,1,-83651,59699,143350,-23952,0,0,25922,0,0,,25922,25922
50,12-10-18,91,22:30,22:45,,,0,45.07,45.07,0,-57281,52616,109897,-4665,0,0,6339,0,0,,6339,6339
50,12-10-18,92,22:45,23:00,47.25,40.8,0,47.25,40.8,2,-45898,52738,98636,6840,0,-3539,207,0,0,,3746,-3332
50,12-10-18,93,23:00,23:15,47.82,14.78,0,47.82,14.78,2,-34500,62541,97041,28041,0,-23026,575,0,0,,23601,-22451
50,12-10-18,94,23:15,23:30,48.09,36.93,0,48.09,36.93,2,-41027,60265,101292,19238,0,-7021,810,0,0,,7831,-6211
50,12-10-18,95,23:30,23:45,,36.93,0,36.93,36.93,-1,-35893,78791,114684,42898,0,-38325,0,0,0,,38325,-38325
50,12-10-18,96,23:45,0:00,,36.88,0,36.88,36.88,-1,-46676,97813,144489,51137,0,-32863,0,0,0,,32863,-32863
50,12-11-18,1,0:00,0:15,78,35.03,0,78,35.03,2,-94503,44660,139163,-49843,0,-14681,13767,0,0,,28448,-914
50,12-11-18,2,0:15,0:30,72.6,35.03,0,72.6,72.6,1,-88936,40183,129119,-48753,0,-8,21906,0,0,,21914,21898
50,12-11-18,3,0:30,0:45,84.39,,0,84.39,84.39,1,-92579,43705,136284,-48874,0,0,51184,0,0,,51184,51184
50,12-11-18,4,0:45,1:00,47.82,,0,47.82,47.82,1,-74801,68664,143465,-6137,0,0,14918,0,0,,14918,14918
50,12-11-18,5,1:00,1:15,68.2,,0,68.2,68.2,1,-103430,30087,133517,-73343,0,0,36957,0,0,,36957,36957
50,12-11-18,6,1:15,1:30,59.74,,0,59.74,59.74,1,-91469,30961,122430,-60508,0,0,53338,0,0,,53338,53338
50,12-11-18,7,1:30,1:45,52.12,,0,52.12,52.12,1,-73923,32672,106595,-41251,0,0,45259,0,0,,45259,45259
50,12-11-18,8,1:45,2:00,48.65,,0,48.65,48.65,1,-62186,36241,98427,-25945,0,0,19132,0,0,,19132,19132
50,12-11-18,9,2:00,2:15,70.16,,0,70.16,70.16,1,-100860,35410,136270,-65450,0,0,42816,0,0,,42816,42816
50,12-11-18,10,2:15,2:30,67,,0,67,67,1,-110443,42449,152892,-67994,0,0,67309,0,0,,67309,67309
50,12-11-18,11,2:30,2:45,57.15,,0,57.15,57.15,1,-101211,41473,142684,-59738,0,0,53963,0,0,,53963,53963
50,12-11-18,12,2:45,3:00,62.16,,0,62.16,62.16,1,-101798,41247,143045,-60551,0,0,53252,0,0,,53252,53252
50,12-11-18,13,3:00,3:15,57.36,,0,57.36,57.36,1,-92166,55044,147210,-37122,0,0,24611,0,0,,24611,24611
50,12-11-18,14,3:15,3:30,72.35,,0,72.35,72.35,1,-119393,49036,168429,-70357,0,0,54766,0,0,,54766,54766
50,12-11-18,15,3:30,3:45,65,,0,65,65,1,-123726,48182,171908,-75544,0,0,62677,0,0,,62677,62677
50,12-11-18,16,3:45,4:00,93.02,,0,93.02,93.02,1,-149229,47443,196672,-101786,0,0,82751,0,0,,82751,82751
50,12-11-18,17,4:00,4:15,104.37,,0,104.37,104.37,1,-162436,47003,209439,-115433,0,0,99952,0,0,,99952,99952
50,12-11-18,18,4:15,4:30,92.15,,0,92.15,92.15,1,-170249,49779,220028,-120470,0,0,110464,0,0,,110464,110464
50,12-11-18,19,4:30,4:45,128.01,,0,128.01,128.01,1,-182003,52504,234507,-129499,0,0,114344,0,0,,114344,114344
50,12-11-18,20,4:45,5:00,109.49,,0,109.49,109.49,1,-191311,54624,245935,-136687,0,0,123383,0,0,,123383,123383
50,12-11-18,21,5:00,5:15,82.02,,0,82.02,82.02,1,-116323,51710,168033,-64613,0,0,67265,0,0,,67265,67265
50,12-11-18,22,5:15,5:30,80.39,,0,80.39,80.39,1,-145360,48386,193746,-96974,0,0,79411,0,0,,79411,79411
50,12-11-18,23,5:30,5:45,156.02,,0,156.02,156.02,1,-200359,39975,240334,-160384,0,0,121342,0,0,,121342,121342
50,12-11-18,24,5:45,6:00,150.02,,0,150.02,150.02,1,-206295,45753,252048,-160542,0,0,150082,0,0,,150082,150082
50,12-11-18,25,6:00,6:15,150.02,0.91,0,0.91,0.91,-1,-72678,112223,184901,39545,0,-12274,38152,0,0,,50426,25878
50,12-11-18,26,6:15,6:30,72.29,41.57,0,72.29,72.29,1,-101626,56752,158378,-44874,0,-4358,10549,0,0,,14907,6191
50,12-11-18,27,6:30,6:45,152.02,,0,152.02,152.02,1,-156615,41220,197835,-115395,0,0,89171,0,0,,89171,89171
50,12-11-18,28,6:45,7:00,152.02,,0,152.02,152.02,1,-198220,57718,255938,-140502,0,0,112165,0,0,,112165,112165
50,12-11-18,29,7:00,7:15,44.58,-6.46,0,46.21,-6.46,2,-77160,122067,199227,44907,0,-10544,29809,0,0,,40353,19265
50,12-11-18,30,7:15,7:30,69.62,-6.46,0,69.62,69.62,1,-95014,49052,144066,-45962,0,-464,26264,0,0,,26728,25800
50,12-11-18,31,7:30,7:45,157.46,,0,157.46,157.46,1,-166215,48297,214512,-117918,0,0,86150,0,0,,86150,86150
50,12-11-18,32,7:45,8:00,267.5,,0,267.5,267.5,1,-244400,64369,308769,-180031,0,0,115153,7500,0,,122653,122653
50,12-11-18,33,8:00,8:15,145.69,,0,145.69,145.69,1,-88328,67722,156050,-20606,0,0,61670,0,0,,61670,61670
50,12-11-18,34,8:15,8:30,173.1,,0,173.1,173.1,1,-143467,46178,189645,-97289,0,0,66948,0,0,,66948,66948
50,12-11-18,35,8:30,8:45,274.7,,0,274.7,274.7,1,-145488,50889,196377,-94599,0,0,87228,11250,0,,98478,98478
50,12-11-18,36,8:45,9:00,86.87,,0,86.87,86.87,1,-132915,47725,180640,-85190,0,0,67627,0,0,,67627,67627
50,12-11-18,37,9:00,9:15,184.61,,0,184.61,184.61,1,-141121,23808,164929,-117313,0,0,99728,0,0,,99728,99728
50,12-11-18,38,9:15,9:30,280,,0,280,280,1,-125351,28897,154248,-96454,0,0,88144,11250,0,,99394,99394
50,12-11-18,39,9:30,9:45,110.02,,0,110.02,110.02,1,-116524,30140,146664,-86384,0,0,68934,0,0,,68934,68934
50,12-11-18,40,9:45,10:00,152.02,,0,152.02,152.02,1,-141094,38545,179639,-102549,0,0,92611,0,0,,92611,92611
50,12-11-18,41,10:00,10:15,152.02,37.13,0,37.13,37.13,-1,-66866,85628,152494,18762,0,-2141,22761,0,0,,24902,20620
50,12-11-18,42,10:15,10:30,47.68,37.13,0,47.68,47.68,1,-76310,73723,150033,-2587,0,-70,492,0,0,,562,422
50,12-11-18,43,10:30,10:45,48.58,70.77,0,57.68,57.68,2,-81784,71872,153656,-9912,0,-36,1678,0,0,,1714,1642
50,12-11-18,44,10:45,11:00,48.58,,0,48.58,48.58,1,-85389,65740,151129,-19649,0,0,11774,0,0,,11774,11774
50,12-11-18,45,11:00,11:15,52.58,,0,52.58,52.58,1,-86079,55042,141121,-31037,0,0,24648,0,0,,24648,24648
50,12-11-18,46,11:15,11:30,58,,0,58,58,1,-91957,57169,149126,-34788,0,0,36042,0,0,,36042,36042
50,12-11-18,47,11:30,11:45,52.58,,0,52.58,52.58,1,-79414,55766,135180,-23648,0,0,14248,0,0,,14248,14248
50,12-11-18,48,11:45,12:00,52.77,,0,52.77,52.77,1,-92039,56895,148934,-35144,0,0,29049,0,0,,29049,29049
50,12-11-18,49,12:00,12:15,78,,0,78,78,1,-109489,46175,155664,-63314,0,0,21048,0,0,,21048,21048
50,12-11-18,50,12:15,12:30,82.18,,0,82.18,82.18,1,-111654,36628,148282,-75026,0,0,58297,0,0,,58297,58297
50,12-11-18,51,12:30,12:45,69.62,,0,69.62,69.62,1,-86593,50383,136976,-36210,0,0,44719,0,0,,44719,44719
50,12-11-18,52,12:45,13:00,69.62,,0,69.62,69.62,1,-92888,52881,145769,-40007,0,0,19569,0,0,,19569,19569
50,12-11-18,53,13:00,13:15,69.62,,0,69.62,69.62,1,-76246,41569,117815,-34677,0,0,9144,0,0,,9144,9144
50,12-11-18,54,13:15,13:30,44.58,,0,44.58,44.58,1,-91273,34485,125758,-56788,0,0,493,0,0,,493,493
50,12-11-18,55,13:30,13:45,47.86,,0,47.86,47.86,1,-112932,33933,146865,-78999,0,0,10124,0,0,,10124,10124
50,12-11-18,56,13:45,14:00,52.58,,0,52.58,52.58,1,-127967,31629,159596,-96338,0,0,22926,0,0,,22926,22926
50,12-11-18,57,14:00,14:15,52.58,45.62,0,45.62,45.62,-1,-77530,66203,143733,-11327,0,-62,3676,0,0,,3738,3614
50,12-11-18,58,14:15,14:30,,,0,52.72,52.72,0,-68983,40091,109074,-28892,0,0,0,0,0,,0,0
50,12-11-18,59,14:30,14:45,,,0,52.72,52.72,0,-88055,43888,131943,-44167,0,0,0,0,0,,0,0
50,12-11-18,60,14:45,15:00,44.58,,0,44.58,44.58,1,-126736,36601,163337,-90135,0,0,137,0,0,,137,137
50,12-11-18,61,15:00,15:15,,,0,52.71,52.71,0,-70966,55691,126657,-15275,0,0,0,0,0,,0,0
50,12-11-18,62,15:15,15:30,,,0,52.71,52.71,0,-67943,46509,114452,-21434,0,0,0,0,0,,0,0
50,12-11-18,63,15:30,15:45,88.73,,0,88.73,88.73,1,-107296,41266,148562,-66030,0,0,17316,0,0,,17316,17316
50,12-11-18,64,15:45,16:00,157.79,,0,157.79,157.79,1,-144208,40487,184695,-103721,0,0,79055,0,0,,79055,79055
50,12-11-18,65,16:00,16:15,157.79,18.59,0,18.59,18.59,-1,-53647,109857,163504,56210,0,-13612,20196,0,0,,33808,6584
50,12-11-18,66,16:15,16:30,,43.31,0,43.31,43.31,-1,-45219,95142,140361,49923,0,-4773,0,0,0,,4773,-4773
50,12-11-18,67,16:30,16:45,44.58,43.31,0,44.58,44.58,1,-53862,78302,132164,24440,0,-135,19,0,0,,154,-116
50,12-11-18,68,16:45,17:00,76.57,,0,76.57,76.57,1,-117089,75940,193029,-41149,0,0,23626,0,0,,23626,23626
50,12-11-18,69,17:00,17:15,47.46,70.84,0,47.46,35.42,2,-93820,98739,192559,4919,0,-472,3919,0,0,,4391,3447
50,12-11-18,70,17:15,17:30,48.88,,0,48.88,48.88,1,-98436,83679,182115,-14757,0,0,3058,0,0,,3058,3058
50,12-11-18,71,17:30,17:45,51.36,,0,51.36,51.36,1,-95898,75296,171194,-20602,0,0,10900,0,0,,10900,10900
50,12-11-18,72,17:45,18:00,48.88,,0,48.88,48.88,1,-89071,88419,177490,-652,0,0,12094,0,0,,12094,12094
50,12-11-18,73,18:00,18:15,48.58,,0,48.58,48.58,1,-149751,46013,195764,-103738,0,0,16958,0,0,,16958,16958
50,12-11-18,74,18:15,18:30,47.69,,0,47.69,47.69,1,-106098,45140,151238,-60958,0,0,7574,0,0,,7574,7574
50,12-11-18,75,18:30,18:45,48.94,,0,48.94,48.94,1,-92542,44115,136657,-48427,0,0,18578,0,0,,18578,18578
50,12-11-18,76,18:45,19:00,48.58,,0,48.58,48.58,1,-75737,59106,134843,-16631,0,0,15049,0,0,,15049,15049
50,12-11-18,77,19:00,19:15,143.02,,0,143.02,143.02,1,-125835,37404,163239,-88431,0,0,54528,0,0,,54528,54528
50,12-11-18,78,19:15,19:30,70.74,,0,70.74,70.74,1,-101862,59490,161352,-42372,0,0,50088,0,0,,50088,50088
50,12-11-18,79,19:30,19:45,48.58,,0,48.58,48.58,1,-80248,53608,133856,-26640,0,0,14301,0,0,,14301,14301
50,12-11-18,80,19:45,20:00,,,0,29.48,29.48,0,-77716,40471,118187,-37245,0,0,664,0,0,,664,664
50,12-11-18,81,20:00,20:15,158.64,,0,158.64,158.64,1,-147109,17858,164967,-129251,0,0,48788,0,0,,48788,48788
50,12-11-18,82,20:15,20:30,101.02,,0,101.02,101.02,1,-101991,46221,148212,-55770,0,0,65569,0,0,,65569,65569
50,12-11-18,83,20:30,20:45,48.07,,0,48.07,48.07,1,-66102,48515,114617,-17587,0,0,3999,0,0,,3999,3999
50,12-11-18,84,20:45,21:00,44.58,,0,44.58,44.58,1,-56176,57168,113344,992,0,0,21,0,0,,21,21
50,12-11-18,85,21:00,21:15,154.02,,0,154.02,154.02,1,-139735,25691,165426,-114044,0,0,42795,0,0,,42795,42795
50,12-11-18,86,21:15,21:30,75.78,,0,75.78,75.78,1,-98462,45170,143632,-53292,0,0,57161,0,0,,57161,57161
50,12-11-18,87,21:30,21:45,,,0,29.48,29.48,0,-55871,48828,104699,-7043,0,0,7339,0,0,,7339,7339
50,12-11-18,88,21:45,22:00,,41.57,0,41.57,41.57,-1,-25526,52923,78449,27397,0,-5650,0,0,0,,5650,-5650
50,12-11-18,89,22:00,22:15,75.56,47.83,0,75.56,29.48,2,-115460,32571,148031,-82889,0,-1973,20423,0,0,,22396,18450
50,12-11-18,90,22:15,22:30,52.58,,0,52.58,52.58,1,-80078,46514,126592,-33564,0,0,26349,0,0,,26349,26349
50,12-11-18,91,22:30,22:45,52.58,42.28,0,42.28,42.28,-1,-54805,51475,106280,-3330,0,-116,2483,0,0,,2599,2367
50,12-11-18,92,22:45,23:00,,33.57,0,33.57,33.57,-1,-25525,59668,85193,34143,0,-24673,0,0,0,,24673,-24673
50,12-11-18,93,23:00,23:15,154.02,47.83,0,154.02,28.92,2,-126480,32399,158879,-94081,0,-6227,33754,0,0,,39981,27527
50,12-11-18,94,23:15,23:30,49.78,,0,49.78,49.78,1,-88847,37421,126268,-51426,0,0,12629,0,0,,12629,12629
50,12-11-18,95,23:30,23:45,48.58,43.81,0,48.58,28.92,2,-63659,53111,116770,-10548,0,-169,15615,0,0,,15784,15446
50,12-11-18,96,23:45,0:00,48.58,41.57,0,41.57,41.57,-1,-63279,76955,140234,13676,0,-2966,1702,0,0,,4668,-1264
50,12-12-18,1,0:00,0:15,48.56,36.78,0,48.56,36.78,2,-68482,65858,134340,-2624,0,-7490,1461,0,0,,8951,-6029
50,12-12-18,2,0:15,0:30,49.91,36.78,0,49.91,49.91,1,-61793,37757,99550,-24036,0,-2,15391,0,0,,15393,15389
50,12-12-18,3,0:30,0:45,,,0,28.51,28.51,0,-47095,22296,69391,-24799,0,0,2021,0,0,,2021,2021
50,12-12-18,4,0:45,1:00,,,0,28.51,28.51,0,-40789,33768,74557,-7021,0,0,0,0,0,,0,0
50,12-12-18,5,1:00,1:15,54.11,,0,54.11,54.11,1,-84487,19566,104053,-64921,0,0,16643,0,0,,16643,16643
50,12-12-18,6,1:15,1:30,49.91,,0,49.91,49.91,1,-62620,24525,87145,-38095,0,0,14911,0,0,,14911,14911
50,12-12-18,7,1:30,1:45,,,0,28.79,28.79,0,-62247,31471,93718,-30776,0,0,556,0,0,,556,556
50,12-12-18,8,1:45,2:00,,,0,28.79,28.79,0,-47469,42872,90341,-4597,0,0,0,0,0,,0,0
50,12-12-18,9,2:00,2:15,83.1,,0,83.1,83.1,1,-113586,34344,147930,-79242,0,0,25170,0,0,,25170,25170
50,12-12-18,10,2:15,2:30,55.9,,0,55.9,55.9,1,-99669,40741,140410,-58928,0,0,44153,0,0,,44153,44153
50,12-12-18,11,2:30,2:45,45.91,,0,45.91,45.91,1,-61807,37800,99607,-24007,0,0,6473,0,0,,6473,6473
50,12-12-18,12,2:45,3:00,,,0,46.75,46.75,0,-57704,26926,84630,-30778,0,0,0,0,0,,0,0
50,12-12-18,13,3:00,3:15,52.69,,0,52.69,52.69,1,-55412,14987,70399,-40425,0,0,9577,0,0,,9577,9577
50,12-12-18,14,3:15,3:30,45.91,,0,45.91,45.91,1,-65870,17071,82941,-48799,0,0,1247,0,0,,1247,1247
50,12-12-18,15,3:30,3:45,45.91,,0,45.91,45.91,1,-60024,18095,78119,-41929,0,0,16,0,0,,16,16
50,12-12-18,16,3:45,4:00,,,0,46.75,46.75,0,-61742,18225,79967,-43517,0,0,0,0,0,,0,0
50,12-12-18,17,4:00,4:15,,,0,46.75,46.75,0,-86327,25007,111334,-61320,0,0,0,0,0,,0,0
50,12-12-18,18,4:15,4:30,156.12,,0,156.12,156.12,1,-217299,26429,243728,-190870,0,0,31972,0,0,,31972,31972
50,12-12-18,19,4:30,4:45,121.11,,0,121.11,121.11,1,-176619,31349,207968,-145270,0,0,47058,0,0,,47058,47058
50,12-12-18,20,4:45,5:00,156.12,,0,156.12,156.12,1,-166621,32925,199546,-133696,0,0,100979,0,0,,100979,100979
50,12-12-18,21,5:00,5:15,252.29,,0,252.29,252.29,1,-178338,123915,302253,-54423,0,0,24071,11250,0,,35321,35321
50,12-12-18,22,5:15,5:30,46.32,43.92,0,47.03,43.92,2,-166886,125501,292387,-41385,0,-54,41,0,0,,95,-13
50,12-12-18,23,5:30,5:45,46.18,,0,46.18,46.18,1,-151692,67040,218732,-84652,0,0,164,0,0,,164,164
50,12-12-18,24,5:45,6:00,82.94,,0,82.94,82.94,1,-129743,52106,181849,-77637,0,0,29643,0,0,,29643,29643
50,12-12-18,25,6:00,6:15,82.94,-123.16,0,-123.16,-123.16,-1,-27453,202757,230210,175304,0,-34419,1892,0,0,,36311,-32527
50,12-12-18,26,6:15,6:30,,43.78,0,43.78,43.78,-1,-27646,98033,125679,70387,0,-5351,0,0,0,,5351,-5351
50,12-12-18,27,6:30,6:45,54.97,,0,54.97,54.97,1,-95246,72336,167582,-22910,0,0,11283,0,0,,11283,11283
50,12-12-18,28,6:45,7:00,156.12,,0,156.12,156.12,1,-165326,61405,226731,-103921,0,0,65909,0,0,,65909,65909
50,12-12-18,29,7:00,7:15,156.12,-29.55,0,-29.55,-29.55,-1,-23691,174855,198546,151164,0,-20774,15888,0,0,,36662,-4886
50,12-12-18,30,7:15,7:30,,43.78,0,43.78,43.78,-1,-78541,97782,176323,19241,0,-4393,0,0,0,,4393,-4393
50,12-12-18,31,7:30,7:45,140.12,,0,140.12,140.12,1,-143227,84513,227740,-58714,0,0,21996,0,0,,21996,21996
50,12-12-18,32,7:45,8:00,195.58,,0,195.58,195.58,1,-215924,83102,299026,-132822,0,0,95143,0,0,,95143,95143
50,12-12-18,33,8:00,8:15,47.57,,0,47.57,47.57,1,-102463,85139,187602,-17324,0,0,39945,0,0,,39945,39945
50,12-12-18,34,8:15,8:30,206.59,,0,206.59,206.59,1,-157001,59241,216242,-97760,0,0,24036,0,0,,24036,24036
50,12-12-18,35,8:30,8:45,206.59,,0,206.59,206.59,1,-171929,60933,232862,-110996,0,0,73550,0,0,,73550,73550
50,12-12-18,36,8:45,9:00,206.59,,0,206.59,206.59,1,-182216,52863,235079,-129353,0,0,80537,0,0,,80537,80537
50,12-12-18,37,9:00,9:15,133.65,,0,133.65,133.65,1,-139442,84367,223809,-55075,0,0,71801,0,0,,71801,71801
50,12-12-18,38,9:15,9:30,89.68,,0,89.68,89.68,1,-147045,88918,235963,-58127,0,0,42879,0,0,,42879,42879
50,12-12-18,39,9:30,9:45,69.68,,0,69.68,69.68,1,-145493,84042,229535,-61451,0,0,54591,0,0,,54591,54591
50,12-12-18,40,9:45,10:00,69.68,,0,69.68,69.68,1,-129412,80118,209530,-49294,0,0,51134,0,0,,51134,51134
50,12-12-18,41,10:00,10:15,66.88,,0,66.88,66.88,1,-129839,76618,206457,-53221,0,0,35589,0,0,,35589,35589
50,12-12-18,42,10:15,10:30,46.88,,0,46.88,46.88,1,-101710,77560,179270,-24150,0,0,7555,0,0,,7555,7555
50,12-12-18,43,10:30,10:45,,44.21,0,44.21,44.21,-1,-80640,84036,164676,3396,0,-16,0,0,0,,16,-16
50,12-12-18,44,10:45,11:00,,,0,58.55,58.55,0,-54180,84930,139110,30750,0,0,0,0,0,,0,0
50,12-12-18,45,11:00,11:15,61.06,,0,61.06,61.06,1,-125292,66472,191764,-58820,0,0,10430,0,0,,10430,10430
50,12-12-18,46,11:15,11:30,61.06,,0,61.06,61.06,1,-126374,61245,187619,-65129,0,0,22019,0,0,,22019,22019
50,12-12-18,47,11:30,11:45,61.06,,0,61.06,61.06,1,-116964,61478,178442,-55486,0,0,28445,0,0,,28445,28445
50,12-12-18,48,11:45,12:00,52.8,,0,52.8,52.8,1,-109076,64288,173364,-44788,0,0,28421,0,0,,28421,28421
50,12-12-18,49,12:00,12:15,136.12,,0,136.12,136.12,1,-150526,32594,183120,-117932,0,0,46019,0,0,,46019,46019
50,12-12-18,50,12:15,12:30,48.6,,0,48.6,48.6,1,-121702,35625,157327,-86077,0,0,7493,0,0,,7493,7493
50,12-12-18,51,12:30,12:45,67.8,,0,67.8,67.8,1,-103286,38701,141987,-64585,0,0,12258,0,0,,12258,12258
50,12-12-18,52,12:45,13:00,52.12,,0,52.12,52.12,1,-102340,34273,136613,-68067,0,0,11961,0,0,,11961,11961
50,12-12-18,53,13:00,13:15,76.41,,0,76.41,76.41,1,-103928,58599,162527,-45329,0,0,10462,0,0,,10462,10462
50,12-12-18,54,13:15,13:30,148.82,,0,148.82,148.82,1,-111521,28114,139635,-83407,0,0,44644,0,0,,44644,44644
50,12-12-18,55,13:30,13:45,176.81,,0,176.81,176.81,1,-120873,26216,147089,-94657,0,0,44525,0,0,,44525,44525
50,12-12-18,56,13:45,14:00,176.81,,0,176.81,176.81,1,-114835,27528,142363,-87307,0,0,76789,0,0,,76789,76789
50,12-12-18,57,14:00,14:15,67.12,,0,67.12,67.12,1,-80662,20649,101311,-60013,0,0,42746,0,0,,42746,42746
50,12-12-18,58,14:15,14:30,59.41,,0,59.41,59.41,1,-87581,19746,107327,-67835,0,0,45359,0,0,,45359,45359
50,12-12-18,59,14:30,14:45,54.12,,0,54.12,54.12,1,-98158,18995,117153,-79163,0,0,25628,0,0,,25628,25628
50,12-12-18,60,14:45,15:00,,,0,58.04,58.04,0,-102306,19615,121921,-82691,0,0,2893,0,0,,2893,2893
50,12-12-18,61,15:00,15:15,,,0,58.8,58.8,0,-79064,51570,130634,-27494,0,0,0,0,0,,0,0
50,12-12-18,62,15:15,15:30,47.07,,0,47.07,47.07,1,-94790,56565,151355,-38225,0,0,1252,0,0,,1252,1252
50,12-12-18,63,15:30,15:45,57.03,,0,57.03,57.03,1,-111458,55399,166857,-56059,0,0,2568,0,0,,2568,2568
50,12-12-18,64,15:45,16:00,62.24,,0,62.24,62.24,1,-137357,53786,191143,-83571,0,0,30248,0,0,,30248,30248
50,12-12-18,65,16:00,16:15,47.11,37.32,0,58.08,37.32,2,-52636,108779,161415,56143,0,-3683,5590,0,0,,9273,1907
50,12-12-18,66,16:15,16:30,,42.71,0,42.71,42.71,-1,-69173,91310,160483,22137,0,-2958,0,0,0,,2958,-2958
50,12-12-18,67,16:30,16:45,62.18,42.71,0,62.18,62.18,1,-100914,73783,174697,-27131,0,-86,7304,0,0,,7390,7218
50,12-12-18,68,16:45,17:00,95.03,,0,95.03,95.03,1,-154177,88121,242298,-66056,0,0,55376,0,0,,55376,55376
50,12-12-18,69,17:00,17:15,69.86,68.28,0,68.28,68.28,-1,-83761,86661,170422,2900,0,-645,23724,0,0,,24369,23079
50,12-12-18,70,17:15,17:30,49.86,68.28,0,49.86,49.86,1,-87261,75353,162614,-11908,0,-144,2841,0,0,,2985,2697
50,12-12-18,71,17:30,17:45,47.55,,0,47.55,47.55,1,-60795,80395,141190,19600,0,0,147,0,0,,147,147
50,12-12-18,72,17:45,18:00,,70,0,70,70,-1,-62250,125809,188059,63559,0,-203,0,0,0,,203,-203
50,12-12-18,73,18:00,18:15,48.5,70.08,0,58.37,58.37,2,-134925,97892,232817,-37033,0,-27,2786,0,0,,2813,2759
50,12-12-18,74,18:15,18:30,,34.97,0,34.97,34.97,-1,-77102,108013,185115,30911,0,-19178,0,0,0,,19178,-19178
50,12-12-18,75,18:30,18:45,,38.77,0,38.77,38.77,-1,-69979,113122,183101,43143,0,-43476,0,0,0,,43476,-43476
50,12-12-18,76,18:45,19:00,,34.97,0,34.97,34.97,-1,-59906,126627,186533,66721,0,-53936,0,0,0,,53936,-53936
50,12-12-18,77,19:00,19:15,77.27,34.97,0,77.27,77.27,1,-124491,37620,162111,-86871,0,-17302,10025,0,0,,27327,-7277
50,12-12-18,78,19:15,19:30,50.77,,0,50.77,50.77,1,-99162,44273,143435,-54889,0,0,9919,0,0,,9919,9919
50,12-12-18,79,19:30,19:45,50.77,70.1,0,70.1,70.1,-1,-72666,54906,127572,-17760,0,-7,384,0,0,,391,377
50,12-12-18,80,19:45,20:00,,68.47,0,68.47,68.47,-1,-55315,52879,108194,-2436,0,-1334,0,0,0,,1334,-1334
50,12-12-18,81,20:00,20:15,96.12,68.47,0,96.12,96.12,1,-121890,11659,133549,-110231,0,-14,19077,0,0,,19091,19063
50,12-12-18,82,20:15,20:30,46.71,,0,46.71,46.71,1,-79666,35241,114907,-44425,0,0,3836,0,0,,3836,3836
50,12-12-18,83,20:30,20:45,,42.71,0,42.71,42.71,-1,-50450,70021,120471,19571,0,-4747,0,0,0,,4747,-4747
50,12-12-18,84,20:45,21:00,,34.97,0,34.97,34.97,-1,-65651,100237,165888,34586,0,-31602,0,0,0,,31602,-31602
50,12-12-18,85,21:00,21:15,46.86,43.78,0,46.86,29.07,2,-79768,76632,156400,-3136,0,-5328,2483,0,0,,7811,-2845
50,12-12-18,86,21:15,21:30,46.15,42.71,0,46.15,29.07,2,-50432,60552,110984,10120,0,-407,928,0,0,,1335,521
50,12-12-18,87,21:30,21:45,,34.97,0,34.97,34.97,-1,-35142,80125,115267,44983,0,-14791,0,0,0,,14791,-14791
50,12-12-18,88,21:45,22:00,,34.97,0,34.97,34.97,-1,-41186,84690,125876,43504,0,-28012,0,0,0,,28012,-28012
50,12-12-18,89,22:00,22:15,46.71,30,0,46.71,46.71,1,-78239,33371,111610,-44868,0,-20919,553,0,0,,21472,-20366
50,12-12-18,90,22:15,22:30,46.71,38.77,0,38.77,38.77,-1,-29321,28032,57353,-1289,0,-1743,445,0,0,,2188,-1298
50,12-12-18,91,22:30,22:45,,22.02,0,22.02,22.02,-1,-25953,114394,140347,88441,0,-43846,0,0,0,,43846,-43846
50,12-12-18,92,22:45,23:00,,20.28,0,20.28,20.28,-1,-27871,160667,188538,132796,0,-64436,0,0,0,,64436,-64436
50,12-12-18,93,23:00,23:15,46.89,29.55,0,46.89,46.89,1,-55639,54881,110520,-758,0,-42194,264,0,0,,42458,-41930
50,12-12-18,94,23:15,23:30,49.74,34.24,0,49.74,28.72,2,-36993,69622,106615,32629,0,-8929,1159,0,0,,10088,-7770
50,12-12-18,95,23:30,23:45,,22.02,0,22.02,22.02,-1,-29719,81858,111577,52139,0,-49425,0,0,0,,49425,-49425
50,12-12-18,96,23:45,0:00,,-43.48,0,-43.48,-43.48,-1,-34231,116395,150626,82164,0,-67726,0,0,0,,67726,-67726
50,12/13/2018,1,0:00,0:15,49.12,-122.97,0,49.12,49.12,1,-47066,71582,118648,24516,0,-54869,2458,0,0,,57327,-52411
50,12/13/2018,2,0:15,0:30,49.12,-116.97,0,-116.97,-116.97,-1,-16701,100528,117229,83827,0,-27008,566,0,0,,27574,-26442
50,12/13/2018,3,0:30,0:45,,-89.02,0,-89.02,-89.02,-1,-47021,71454,118475,24433,0,-36718,0,0,0,,36718,-36718
50,12/13/2018,4,0:45,1:00,,30.68,0,30.68,30.68,-1,-39255,93454,132709,54199,0,-38695,0,0,0,,38695,-38695
50,12/13/2018,5,1:00,1:15,,21.33,0,21.33,21.33,-1,-44403,91486,135889,47083,0,-42152,0,0,0,,42152,-42152
50,12/13/2018,6,1:15,1:30,,34.85,0,34.85,34.85,-1,-38377,42080,80457,3703,0,-25849,0,0,0,,25849,-25849
50,12/13/2018,7,1:30,1:45,,38.21,0,38.21,38.21,-1,-27935,53841,81776,25906,0,-11703,0,0,0,,11703,-11703
50,12/13/2018,8,1:45,2:00,,38.1,0,38.1,38.1,-1,-44072,78315,122387,34243,0,-25655,0,0,0,,25655,-25655
50,12/13/2018,9,2:00,2:15,,42.1,0,42.1,42.1,-1,-58239,44824,103063,-13415,0,-7191,0,0,0,,7191,-7191
50,12/13/2018,10,2:15,2:30,,34.61,0,34.61,34.61,-1,-45013,72473,117486,27460,0,-15822,0,0,0,,15822,-15822
50,12/13/2018,11,2:30,2:45,,38.61,0,38.61,38.61,-1,-50674,70970,121644,20296,0,-30160,0,0,0,,30160,-30160
50,12/13/2018,12,2:45,3:00,,42.1,0,42.1,42.1,-1,-54756,67409,122165,12653,0,-16711,0,0,0,,16711,-16711
50,12/13/2018,13,3:00,3:15,,43.04,0,43.04,43.04,-1,-41280,23903,65183,-17377,0,-6539,0,0,0,,6539,-6539
50,12/13/2018,14,3:15,3:30,,38.61,0,38.61,38.61,-1,-27225,45238,72463,18013,0,-10914,0,0,0,,10914,-10914
50,12/13/2018,15,3:30,3:45,,42.1,0,42.1,42.1,-1,-35988,36119,72107,131,0,-7225,0,0,0,,7225,-7225
50,12/13/2018,16,3:45,4:00,,44.6,0,44.6,44.6,-1,-43835,42490,86325,-1345,0,-1232,0,0,0,,1232,-1232
50,12/13/2018,17,4:00,4:15,,42.14,0,42.14,42.14,-1,-56167,54877,111044,-1290,0,-2945,0,0,0,,2945,-2945
50,12/13/2018,18,4:15,4:30,,,0,46.95,46.95,0,-60185,43952,104137,-16233,0,-57,0,0,0,,57,-57
50,12/13/2018,19,4:30,4:45,,,0,46.95,46.95,0,-46932,32773,79705,-14159,0,0,0,0,0,,0,0
50,12/13/2018,20,4:45,5:00,,,0,46.92,46.92,0,-53444,37676,91120,-15768,0,0,0,0,0,,0,0
50,12/13/2018,21,5:00,5:15,56.49,43.12,0,56.49,43.12,2,-79089,48042,127131,-31047,0,-217,14038,0,0,,14255,13821
50,12/13/2018,22,5:15,5:30,56.49,36.17,0,36.17,36.17,-1,-31775,58202,89977,26427,0,-23691,102,0,0,,23793,-23589
50,12/13/2018,23,5:30,5:45,,42.17,0,42.17,42.17,-1,-27088,37686,64774,10598,0,-11678,0,0,0,,11678,-11678
50,12/13/2018,24,5:45,6:00,,42.1,0,42.1,42.1,-1,-45459,42450,87909,-3009,0,-3864,0,0,0,,3864,-3864
50,12/13/2018,25,6:00,6:15,,-135.01,0,-135.01,-135.01,-1,-49264,166583,215847,117319,0,-36936,0,0,0,,36936,-36936
50,12/13/2018,26,6:15,6:30,,-135.01,0,-135.01,-135.01,-1,-58458,93204,151662,34746,0,-54121,0,0,0,,54121,-54121
50,12/13/2018,27,6:30,6:45,52.8,41.67,0,52.8,41.67,2,-59406,60099,119505,693,0,-13210,1383,0,0,,14593,-11827
50,12/13/2018,28,6:45,7:00,72.01,39.55,0,72.01,39.55,2,-110076,55979,166055,-54097,0,-448,30066,0,0,,30514,29618
50,12/13/2018,29,7:00,7:15,72.01,-81.09,0,-81.09,-81.09,-1,-34480,185021,219501,150541,0,-70759,967,0,0,,71726,-69792
50,12/13/2018,30,7:15,7:30,,34.63,0,34.63,34.63,-1,-46892,68816,115708,21924,0,-35185,0,0,0,,35185,-35185
50,12/13/2018,31,7:30,7:45,56.86,34.63,0,56.86,56.86,1,-76288,41544,117832,-34744,0,-1410,19981,0,0,,21391,18571
50,12/13/2018,32,7:45,8:00,175.84,,0,175.84,175.84,1,-135394,40073,175467,-95321,0,0,56966,0,0,,56966,56966
50,12/13/2018,33,8:00,8:15,175.84,-25.22,0,-25.22,-25.22,-1,-18228,99278,117506,81050,0,-23035,15913,0,0,,38948,-7122
50,12/13/2018,34,8:15,8:30,,41.2,0,41.2,41.2,-1,-25736,57197,82933,31461,0,-25818,0,0,0,,25818,-25818
50,12/13/2018,35,8:30,8:45,,42.25,0,42.25,42.25,-1,-51194,58946,110140,7752,0,-13467,0,0,0,,13467,-13467
50,12/13/2018,36,8:45,9:00,,42.25,0,42.25,42.25,-1,-36401,49291,85692,12890,0,-6297,0,0,0,,6297,-6297
50,12/13/2018,37,9:00,9:15,,28.89,0,28.89,28.89,-1,-25095,84623,109718,59528,0,-38472,0,0,0,,38472,-38472
50,12/13/2018,38,9:15,9:30,,39.17,0,39.17,39.17,-1,-33517,73849,107366,40332,0,-36251,0,0,0,,36251,-36251
50,12/13/2018,39,9:30,9:45,,39.35,0,39.35,39.35,-1,-37298,74434,111732,37136,0,-36222,0,0,0,,36222,-36222
50,12/13/2018,40,9:45,10:00,,40.28,0,40.28,40.28,-1,-41676,77127,118803,35451,0,-32627,0,0,0,,32627,-32627
50,12/13/2018,41,10:00,10:15,80.37,40.28,0,80.37,80.37,1,-81808,38588,120396,-43220,0,-6980,18891,0,0,,25871,11911
50,12/13/2018,42,10:15,10:30,46.8,,0,46.8,46.8,1,-55717,62261,117978,6544,0,0,2890,0,0,,2890,2890
50,12/13/2018,43,10:30,10:45,,,0,58.07,58.07,0,-45911,81969,127880,36058,0,0,48,0,0,,48,48
50,12/13/2018,44,10:45,11:00,,41.38,0,41.38,41.38,-1,-34067,112742,146809,78675,0,-4063,0,0,0,,4063,-4063
50,12/13/2018,45,11:00,11:15,,42.75,0,42.75,42.75,-1,-68666,100069,168735,31403,0,-3749,0,0,0,,3749,-3749
50,12/13/2018,46,11:15,11:30,,69.8,0,69.8,69.8,-1,-64818,126149,190967,61331,0,-19,0,0,0,,19,-19
50,12/13/2018,47,11:30,11:45,,69.75,0,69.75,69.75,-1,-62495,129888,192383,67393,0,-1520,0,0,0,,1520,-1520
50,12/13/2018,48,11:45,12:00,,38.25,0,38.25,38.25,-1,-58388,145203,203591,86815,0,-9475,0,0,0,,9475,-9475
50,12/13/2018,49,12:00,12:15,,23.87,0,23.87,23.87,-1,-47898,141318,189216,93420,0,-35017,0,0,0,,35017,-35017
50,12/13/2018,50,12:15,12:30,,34.3,0,34.3,34.3,-1,-59425,136658,196083,77233,0,-13710,0,0,0,,13710,-13710
50,12/13/2018,51,12:30,12:45,,34.3,0,34.3,34.3,-1,-65394,154853,220247,89459,0,-35968,0,0,0,,35968,-35968
50,12/13/2018,52,12:45,13:00,,36.72,0,36.72,36.72,-1,-61887,153726,215613,91839,0,-32735,0,0,0,,32735,-32735
50,12/13/2018,53,13:00,13:15,,40.94,0,40.94,40.94,-1,-83101,129514,212615,46413,0,-13205,0,0,0,,13205,-13205
50,12/13/2018,54,13:15,13:30,,,0,58.01,58.01,0,-85236,122195,207431,36959,0,0,0,0,0,,0,0
50,12/13/2018,55,13:30,13:45,48.11,,0,48.11,48.11,1,-98075,114399,212474,16324,0,0,6,0,0,,6,6
50,12/13/2018,56,13:45,14:00,,,0,57.99,57.99,0,-104276,110485,214761,6209,0,0,0,0,0,,0,0
50,12/13/2018,57,14:00,14:15,74.4,,0,74.4,74.4,1,-114352,65494,179846,-48858,0,0,24885,0,0,,24885,24885
50,12/13/2018,58,14:15,14:30,74.4,,0,74.4,74.4,1,-118004,57217,175221,-60787,0,0,51140,0,0,,51140,51140
50,12/13/2018,59,14:30,14:45,74.4,,0,74.4,74.4,1,-119827,60287,180114,-59540,0,0,57002,0,0,,57002,57002
50,12/13/2018,60,14:45,15:00,55.06,,0,55.06,55.06,1,-121162,61909,183071,-59253,0,0,45034,0,0,,45034,45034
50,12/13/2018,61,15:00,15:15,46.25,71.26,0,71.26,71.26,-1,-53032,95387,148419,42355,0,-324,7483,0,0,,7807,7159
50,12/13/2018,62,15:15,15:30,56.34,71.25,0,58.75,58.75,2,-71356,65794,137150,-5562,0,-507,4775,0,0,,5282,4268
50,12/13/2018,63,15:30,15:45,58.77,,0,58.77,58.77,1,-85271,52545,137816,-32726,0,0,31615,0,0,,31615,31615
50,12/13/2018,64,15:45,16:00,91.31,,0,91.31,91.31,1,-108748,57541,166289,-51207,0,0,52952,0,0,,52952,52952
50,12/13/2018,65,16:00,16:15,52.09,27.26,0,58.03,27.26,2,-39330,150407,189737,111077,0,-8040,10406,0,0,,18446,2366
50,12/13/2018,66,16:15,16:30,,42.25,0,42.25,42.25,-1,-35547,122470,158017,86923,0,-2964,0,0,0,,2964,-2964
50,12/13/2018,67,16:30,16:45,,,0,57.95,57.95,0,-52704,79896,132600,27192,0,0,0,0,0,,0,0
50,12/13/2018,68,16:45,17:00,82.09,,0,82.09,82.09,1,-83545,41293,124838,-42252,0,0,21095,0,0,,21095,21095
50,12/13/2018,69,17:00,17:15,50.25,,0,50.25,50.25,1,-55385,118823,174208,63438,0,0,3420,0,0,,3420,3420
50,12/13/2018,70,17:15,17:30,,,0,58.81,58.81,0,-51568,85547,137115,33979,0,0,0,0,0,,0,0
50,12/13/2018,71,17:30,17:45,,,0,58.81,58.81,0,-31514,75807,107321,44293,0,0,0,0,0,,0,0
50,12/13/2018,72,17:45,18:00,,69.11,0,69.11,69.11,-1,-36946,102627,139573,65681,0,-46,0,0,0,,46,-46
50,12/13/2018,73,18:00,18:15,67.86,34.25,0,67.86,34.25,2,-79536,19006,98542,-60530,0,-7599,5363,0,0,,12962,-2236
50,12/13/2018,74,18:15,18:30,57.13,,0,57.13,57.13,1,-58323,43468,101791,-14855,0,0,15268,0,0,,15268,15268
50,12/13/2018,75,18:30,18:45,57.13,39.45,0,39.45,39.45,-1,-56832,72043,128875,15211,0,-7238,35,0,0,,7273,-7203
50,12/13/2018,76,18:45,19:00,,38.52,0,38.52,38.52,-1,-59937,74661,134598,14724,0,-6922,0,0,0,,6922,-6922
50,12/13/2018,77,19:00,19:15,46.97,37.52,0,57.95,37.52,2,-46314,49863,96177,3549,0,-6143,505,0,0,,6648,-5638
50,12/13/2018,78,19:15,19:30,47.05,34.8,0,58,34.8,2,-42014,50316,92330,8302,0,-13493,85,0,0,,13578,-13408
50,12/13/2018,79,19:30,19:45,48.71,34.25,0,58.01,34.25,2,-55261,74392,129653,19131,0,-6758,229,0,0,,6987,-6529
50,12/13/2018,80,19:45,20:00,,34.25,0,34.25,34.25,-1,-80391,93088,173479,12697,0,-16611,0,0,0,,16611,-16611
50,12/13/2018,81,20:00,20:15,122.01,43.17,0,122.01,39.82,2,-118541,65874,184415,-52667,0,-5058,27720,0,0,,32778,22662
50,12/13/2018,82,20:15,20:30,54.6,,0,54.6,54.6,1,-117919,86313,204232,-31606,0,0,23893,0,0,,23893,23893
50,12/13/2018,83,20:30,20:45,61.34,44.16,0,61.34,39.93,2,-104872,88060,192932,-16812,0,-225,20967,0,0,,21192,20742
50,12/13/2018,84,20:45,21:00,61.34,41.38,0,41.38,41.38,-1,-102046,117900,219946,15854,0,-11181,1162,0,0,,12343,-10019
50,12/13/2018,85,21:00,21:15,143.17,41.38,0,143.17,143.17,1,-160576,87868,248444,-72708,0,-1216,32860,0,0,,34076,31644
50,12/13/2018,86,21:15,21:30,74.17,,0,74.17,74.17,1,-111138,79396,190534,-31742,0,0,45786,0,0,,45786,45786
50,12/13/2018,87,21:30,21:45,74.17,42.56,0,42.56,42.56,-1,-82368,89536,171904,7168,0,-1542,2744,0,0,,4286,1202
50,12/13/2018,88,21:45,22:00,,40.5,0,40.5,40.5,-1,-96823,135191,232014,38368,0,-23586,0,0,0,,23586,-23586
50,12/13/2018,89,22:00,22:15,151.17,43.49,0,151.17,43.49,2,-135730,26336,162066,-109394,0,-7514,30310,0,0,,37824,22796
50,12/13/2018,90,22:15,22:30,56.89,43.71,0,43.71,43.71,-1,-87676,83336,171012,-4340,0,-149,18837,0,0,,18986,18688
50,12/13/2018,91,22:30,22:45,,42.25,0,42.25,42.25,-1,-86385,102431,188816,16046,0,-8871,0,0,0,,8871,-8871
50,12/13/2018,92,22:45,23:00,,38.25,0,38.25,38.25,-1,-95889,123807,219696,27918,0,-24820,0,0,0,,24820,-24820
50,12/13/2018,93,23:00,23:15,46.25,21.18,0,46.25,21.18,2,-75127,65136,140263,-9991,0,-29119,336,0,0,,29455,-28783
50,12/13/2018,94,23:15,23:30,46.25,44.71,0,46.25,27.36,2,-60400,41036,101436,-19364,0,-687,592,0,0,,1279,-95
50,12/13/2018,95,23:30,23:45,,43.03,0,43.03,43.03,-1,-88243,69698,157941,-18545,0,-497,0,0,0,,497,-497
50,12/13/2018,96,23:45,0:00,,37.46,0,37.46,37.46,-1,-85253,99868,185121,14615,0,-7748,0,0,0,,7748,-7748
50,12/14/2018,1,0:00,0:15,54.77,37.51,0,54.77,28.92,2,-56197,36935,93132,-19262,0,-6637,9607,0,0,,16244,2970
50,12/14/2018,2,0:15,0:30,52.66,,0,52.66,52.66,1,-74953,47142,122095,-27811,0,0,16682,0,0,,16682,16682
50,12/14/2018,3,0:30,0:45,49.68,,0,49.68,49.68,1,-76102,63126,139228,-12976,0,0,7131,0,0,,7131,7131
50,12/14/2018,4,0:45,1:00,49.68,42.78,0,42.78,42.78,-1,-62811,90998,153809,28187,0,-9241,42,0,0,,9283,-9199
50,12/14/2018,5,1:00,1:15,71.45,44.78,0,71.45,28.59,2,-67099,12216,79315,-54883,0,-3111,23433,0,0,,26544,20322
50,12/14/2018,6,1:15,1:30,54.77,,0,54.77,54.77,1,-75136,43796,118932,-31340,0,0,26548,0,0,,26548,26548
50,12/14/2018,7,1:30,1:45,54.77,,0,54.77,54.77,1,-67304,44961,112265,-22343,0,0,24588,0,0,,24588,24588
50,12/14/2018,8,1:45,2:00,50.11,,0,50.11,50.11,1,-65570,60215,125785,-5355,0,0,9006,0,0,,9006,9006
50,12/14/2018,9,2:00,2:15,50.11,46.78,0,46.78,46.78,-1,-45536,44599,90135,-937,0,-124,364,0,0,,488,240
50,12/14/2018,10,2:15,2:30,46.77,,0,46.77,46.77,1,-47171,46055,93226,-1116,0,0,66,0,0,,66,66
50,12/14/2018,11,2:30,2:45,49.13,,0,49.13,49.13,1,-68150,52544,120694,-15606,0,0,8022,0,0,,8022,8022
50,12/14/2018,12,2:45,3:00,54.77,,0,54.77,54.77,1,-79601,47578,127179,-32023,0,0,23530,0,0,,23530,23530
50,12/14/2018,13,3:00,3:15,46.77,39.7,0,46.78,39.7,2,-42063,62442,104505,20379,0,-9742,5560,0,0,,15302,-4182
50,12/14/2018,14,3:15,3:30,,42.77,0,42.77,42.77,-1,-44127,57990,102117,13863,0,-15428,0,0,0,,15428,-15428
50,12/14/2018,15,3:30,3:45,47.5,42.77,0,47.5,47.5,1,-63344,61970,125314,-1374,0,-1112,146,0,0,,1258,-966
50,12/14/2018,16,3:45,4:00,50.77,,0,50.77,50.77,1,-80032,67198,147230,-12834,0,0,11632,0,0,,11632,11632
50,12/14/2018,17,4:00,4:15,47.51,,0,47.51,47.51,1,-78296,71331,149627,-6965,0,0,6371,0,0,,6371,6371
50,12/14/2018,18,4:15,4:30,47.5,45.68,0,47.5,45.68,2,-68415,54438,122853,-13977,0,-536,277,0,0,,813,-259
50,12/14/2018,19,4:30,4:45,47.49,,0,47.49,47.49,1,-54653,47868,102521,-6785,0,0,1696,0,0,,1696,1696
50,12/14/2018,20,4:45,5:00,47.49,45.57,0,45.57,45.57,-1,-50363,44310,94673,-6053,0,-1052,5,0,0,,1057,-1047
50,12/14/2018,21,5:00,5:15,50.77,46.02,0,50.77,46.02,2,-72425,75581,148006,3156,0,-81,3071,0,0,,3152,2990
50,12/14/2018,22,5:15,5:30,50.77,38.77,0,50.77,38.77,2,-53966,60445,114411,6479,0,-12601,539,0,0,,13140,-12062
50,12/14/2018,23,5:30,5:45,54.77,38.77,0,54.77,54.77,1,-63394,40565,103959,-22829,0,-637,9020,0,0,,9657,8383
50,12/14/2018,24,5:45,6:00,51.89,,0,51.89,51.89,1,-62971,41338,104309,-21633,0,0,14718,0,0,,14718,14718
50,12/14/2018,25,6:00,6:15,56.06,45.28,0,45.28,45.28,-1,-105593,100940,206533,-4653,0,-1113,10294,0,0,,11407,9181
50,12/14/2018,26,6:15,6:30,52.06,44.06,0,52.06,44.06,2,-81508,81956,163464,448,0,-8282,607,0,0,,8889,-7675
50,12/14/2018,27,6:30,6:45,72.79,44.06,0,72.79,72.79,1,-109020,42423,151443,-66597,0,-830,9720,0,0,,10550,8890
50,12/14/2018,28,6:45,7:00,158.12,,0,158.12,158.12,1,-135888,24416,160304,-111472,0,0,53285,0,0,,53285,53285
50,12/14/2018,29,7:00,7:15,158.12,15.78,0,15.78,15.78,-1,-57487,192531,250018,135044,0,-22385,3639,0,0,,26024,-18746
50,12/14/2018,30,7:15,7:30,48.06,44.06,0,48.06,48.06,1,-67814,61774,129588,-6040,0,-14165,748,0,0,,14913,-13417
50,12/14/2018,31,7:30,7:45,57.75,,0,57.75,57.75,1,-99171,34826,133997,-64345,0,0,9247,0,0,,9247,9247
50,12/14/2018,32,7:45,8:00,179.72,,0,179.72,179.72,1,-156761,22534,179295,-134227,0,0,68998,0,0,,68998,68998
50,12/14/2018,33,8:00,8:15,70.08,75.33,0,75.33,75.33,-1,-55070,90328,145398,35258,0,-22,19348,0,0,,19370,19326
50,12/14/2018,34,8:15,8:30,,75.26,0,75.26,75.26,-1,-72225,61370,133595,-10855,0,-56,0,0,0,,56,-56
50,12/14/2018,35,8:30,8:45,,,0,62,62,0,-87181,36229,123410,-50952,0,0,0,0,0,,0,0
50,12/14/2018,36,8:45,9:00,,,0,61.95,61.95,0,-96165,31452,127617,-64713,0,0,0,0,0,,0,0
50,12/14/2018,37,9:00,9:15,,,0,61.07,61.07,0,-65698,81954,147652,16256,0,0,0,0,0,,0,0
50,12/14/2018,38,9:15,9:30,48.93,,0,48.93,48.93,1,-74884,67867,142751,-7017,0,0,1966,0,0,,1966,1966
50,12/14/2018,39,9:30,9:45,52.39,,0,52.39,52.39,1,-79552,62757,142309,-16795,0,0,7538,0,0,,7538,7538
50,12/14/2018,40,9:45,10:00,48.65,,0,48.65,48.65,1,-82070,65409,147479,-16661,0,0,263,0,0,,263,263
50,12/14/2018,41,10:00,10:15,64.77,,0,64.77,64.77,1,-115367,40397,155764,-74970,0,0,19435,0,0,,19435,19435
50,12/14/2018,42,10:15,10:30,54.77,,0,54.77,54.77,1,-110768,43675,154443,-67093,0,0,15302,0,0,,15302,15302
50,12/14/2018,43,10:30,10:45,54.77,,0,54.77,54.77,1,-94864,20325,115189,-74539,0,0,23317,0,0,,23317,23317
50,12/14/2018,44,10:45,11:00,54.77,,0,54.77,54.77,1,-97837,18176,116013,-79661,0,0,25226,0,0,,25226,25226
50,12/14/2018,45,11:00,11:15,194.02,,0,194.02,194.02,1,-201812,23717,225529,-178095,0,0,65682,0,0,,65682,65682
50,12/14/2018,46,11:15,11:30,194.02,,0,194.02,194.02,1,-165130,43936,209066,-121194,0,0,105900,0,0,,105900,105900
50,12/14/2018,47,11:30,11:45,384.33,,0,384.33,384.33,1,-130572,57048,187620,-73524,0,0,49544,5000,0,,54544,54544
50,12/14/2018,48,11:45,12:00,64.33,,0,64.33,64.33,1,-134103,72483,206586,-61620,0,0,4578,0,0,,4578,4578
50,12/14/2018,49,12:00,12:15,50.6,,0,50.6,50.6,1,-141917,49930,191847,-91987,0,0,9899,0,0,,9899,9899
50,12/14/2018,50,12:15,12:30,50.48,,0,50.48,50.48,1,-138949,33210,172159,-105739,0,0,9157,0,0,,9157,9157
50,12/14/2018,51,12:30,12:45,83.3,,0,83.3,83.3,1,-110387,36003,146390,-74384,0,0,22654,0,0,,22654,22654
50,12/14/2018,52,12:45,13:00,61.09,,0,61.09,61.09,1,-101990,45579,147569,-56411,0,0,19682,0,0,,19682,19682
50,12/14/2018,53,13:00,13:15,133.57,,0,133.57,133.57,1,-122237,53330,175567,-68907,0,0,24154,0,0,,24154,24154
50,12/14/2018,54,13:15,13:30,145.59,,0,145.59,145.59,1,-121782,55116,176898,-66666,0,0,47298,0,0,,47298,47298
50,12/14/2018,55,13:30,13:45,,,0,61.64,61.64,0,-126450,46423,172873,-80027,0,0,724,0,0,,724,724
50,12/14/2018,56,13:45,14:00,,,0,61.63,61.63,0,-139627,34646,174273,-104981,0,0,0,0,0,,0,0
50,12/14/2018,57,14:00,14:15,191.78,,0,191.78,191.78,1,-233975,26827,260802,-207148,0,0,52995,0,0,,52995,52995
50,12/14/2018,58,14:15,14:30,383.3,,0,383.3,383.3,1,-212100,41926,254026,-170174,0,0,84766,5000,0,,89766,89766
50,12/14/2018,59,14:30,14:45,233.3,,0,233.3,233.3,1,-201106,71857,272963,-129249,0,0,25913,2500,0,,28413,28413
50,12/14/2018,60,14:45,15:00,183.3,,0,183.3,183.3,1,-194757,70511,265268,-124246,0,0,25421,1250,0,,26671,26671
50,12/14/2018,61,15:00,15:15,,,0,61.68,61.68,0,-140528,56689,197217,-83839,0,0,3897,0,0,,3897,3897
50,12/14/2018,62,15:15,15:30,63.04,,0,63.04,63.04,1,-155810,20500,176310,-135310,0,0,15587,0,0,,15587,15587
50,12/14/2018,63,15:30,15:45,191.21,,0,191.21,191.21,1,-188944,23439,212383,-165505,0,0,67011,0,0,,67011,67011
50,12/14/2018,64,15:45,16:00,283.04,,0,283.04,283.04,1,-191229,23688,214917,-167541,0,0,111557,3750,0,,115307,115307
50,12/14/2018,65,16:00,16:15,283.04,39.36,0,39.36,39.36,-1,-110741,180385,291126,69644,0,-5542,30975,0,0,,36517,25433
50,12/14/2018,66,16:15,16:30,,46.46,0,46.46,46.46,-1,-123889,124795,248684,906,0,-3433,0,0,0,,3433,-3433
50,12/14/2018,67,16:30,16:45,64.84,46.46,0,64.84,64.84,1,-140301,68297,208598,-72004,0,-78,3288,0,0,,3366,3210
50,12/14/2018,68,16:45,17:00,195.12,,0,195.12,195.12,1,-168067,44484,212551,-123583,0,0,72191,0,0,,72191,72191
50,12/14/2018,69,17:00,17:15,103.12,,0,103.12,103.12,1,-153600,86643,240243,-66957,0,0,61514,0,0,,61514,61514
50,12/14/2018,70,17:15,17:30,97.29,,0,97.29,97.29,1,-134978,53327,188305,-81651,0,0,20651,0,0,,20651,20651
50,12/14/2018,71,17:30,17:45,297.29,,0,297.29,297.29,1,-101468,41021,142489,-60447,0,0,25212,3750,0,,28962,28962
50,12/14/2018,72,17:45,18:00,61.14,,0,61.14,61.14,1,-77155,64816,141971,-12339,0,0,12084,0,0,,12084,12084
50,12/14/2018,73,18:00,18:15,63.35,,0,63.35,63.35,1,-114818,67887,182705,-46931,0,0,6144,0,0,,6144,6144
50,12/14/2018,74,18:15,18:30,,44.06,0,44.06,44.06,-1,-71414,72581,143995,1167,0,-1912,0,0,0,,1912,-1912
50,12/14/2018,75,18:30,18:45,,42.16,0,42.16,42.16,-1,-64604,83208,147812,18604,0,-21172,0,0,0,,21172,-21172
50,12/14/2018,76,18:45,19:00,,40.06,0,40.06,40.06,-1,-60327,101591,161918,41264,0,-30193,0,0,0,,30193,-30193
50,12/14/2018,77,19:00,19:15,61.71,75.24,0,61.71,61.5,2,-130677,76733,207410,-53944,0,-9465,11667,0,0,,21132,2202
50,12/14/2018,78,19:15,19:30,48.06,,0,48.06,48.06,1,-98561,91770,190331,-6791,0,0,3545,0,0,,3545,3545
50,12/14/2018,79,19:30,19:45,,44.06,0,44.06,44.06,-1,-74935,82037,156972,7102,0,-6314,0,0,0,,6314,-6314
50,12/14/2018,80,19:45,20:00,,35.96,0,35.96,35.96,-1,-61788,110265,172053,48477,0,-34055,0,0,0,,34055,-34055
50,12/14/2018,81,20:00,20:15,48.06,45.78,0,48.68,45.78,2,-107556,68925,176481,-38631,0,-13485,784,0,0,,14269,-12701
50,12/14/2018,82,20:15,20:30,48.06,44.15,0,44.15,44.15,-1,-87076,94328,181404,7252,0,-4189,29,0,0,,4218,-4160
50,12/14/2018,83,20:30,20:45,,40.06,0,40.06,40.06,-1,-57685,94866,152551,37181,0,-26700,0,0,0,,26700,-26700
50,12/14/2018,84,20:45,21:00,,40.06,0,40.06,40.06,-1,-59370,86451,145821,27081,0,-31346,0,0,0,,31346,-31346
50,12/14/2018,85,21:00,21:15,123.94,45.78,0,123.94,45.78,2,-100961,41703,142664,-59258,0,-7950,26282,0,0,,34232,18332
50,12/14/2018,86,21:15,21:30,262,,0,262,262,1,-34844,93507,128351,58663,0,0,2735,3750,0,,6485,6485
50,12/14/2018,87,21:30,21:45,,40.06,0,40.06,40.06,-1,-24100,163458,187558,139358,0,-466,0,0,0,,466,-466
50,12/14/2018,88,21:45,22:00,,-51.06,0,-51.06,-51.06,-1,-33482,164948,198430,131466,0,-64978,0,0,0,,64978,-64978
50,12/14/2018,89,22:00,22:15,47.39,30.74,0,47.39,47.39,1,-126701,99416,226117,-27285,0,-28002,141,0,0,,28143,-27861
50,12/14/2018,90,22:15,22:30,47.39,,0,47.39,47.39,1,-79103,36654,115757,-42449,0,0,508,0,0,,508,508
50,12/14/2018,91,22:30,22:45,,46.23,0,46.23,46.23,-1,-53237,45744,98981,-7493,0,-10,0,0,0,,10,-10
50,12/14/2018,92,22:45,23:00,,44.06,0,44.06,44.06,-1,-70808,76284,147092,5476,0,-2674,0,0,0,,2674,-2674
50,12/14/2018,93,23:00,23:15,,41.76,0,41.76,41.76,-1,-84002,39022,123024,-44980,0,-1766,0,0,0,,1766,-1766
50,12/14/2018,94,23:15,23:30,,,0,47.08,47.08,0,-117131,29987,147118,-87144,0,0,0,0,0,,0,0
50,12/14/2018,95,23:30,23:45,,,0,47.08,47.08,0,-82860,34356,117216,-48504,0,0,0,0,0,,0,0
50,12/14/2018,96,23:45,0:00,,44.06,0,44.06,44.06,-1,-74392,63820,138212,-10572,0,-1001,0,0,0,,1001,-1001
51,12/15/2018,1,0:00,0:15,74,50.82,0,74,49.32,2,-104399,22801,127200,-81598,0,-272,21904,0,0,,22176,21632
51,12/15/2018,2,0:15,0:30,55.81,,0,55.81,55.81,1,-83759,23990,107749,-59769,0,0,39675,0,0,,39675,39675
51,12/15/2018,3,0:30,0:45,55.81,,0,55.81,55.81,1,-67241,31886,99127,-35355,0,0,35220,0,0,,35220,35220
51,12/15/2018,4,0:45,1:00,47.81,46.15,0,48.78,46.15,2,-56393,62933,119326,6540,0,-672,6435,0,0,,7107,5763
51,12/15/2018,5,1:00,1:15,86,,0,86,86,1,-78968,19284,98252,-59684,0,0,21312,0,0,,21312,21312
51,12/15/2018,6,1:15,1:30,56.74,,0,56.74,56.74,1,-67048,23567,90615,-43481,0,0,25658,0,0,,25658,25658
51,12/15/2018,7,1:30,1:45,,,0,48.8,48.8,0,-57521,32494,90015,-25027,0,0,397,0,0,,397,397
51,12/15/2018,8,1:45,2:00,,42.93,0,42.93,42.93,-1,-35732,45546,81278,9814,0,-4850,0,0,0,,4850,-4850
51,12/15/2018,9,2:00,2:15,74,42.93,0,74,74,1,-84314,32639,116953,-51675,0,-940,26265,0,0,,27205,25325
51,12/15/2018,10,2:15,2:30,51.81,,0,51.81,51.81,1,-65789,42163,107952,-23626,0,0,13486,0,0,,13486,13486
51,12/15/2018,11,2:30,2:45,48.17,,0,48.17,48.17,1,-67410,44332,111742,-23078,0,0,3575,0,0,,3575,3575
51,12/15/2018,12,2:45,3:00,47.81,,0,47.81,47.81,1,-58833,36293,95126,-22540,0,0,213,0,0,,213,213
51,12/15/2018,13,3:00,3:15,64.16,,0,64.16,64.16,1,-78348,29613,107961,-48735,0,0,18207,0,0,,18207,18207
51,12/15/2018,14,3:15,3:30,53.2,,0,53.2,53.2,1,-65530,28521,94051,-37009,0,0,22593,0,0,,22593,22593
51,12/15/2018,15,3:30,3:45,51.79,,0,51.79,51.79,1,-59551,35718,95269,-23833,0,0,11241,0,0,,11241,11241
51,12/15/2018,16,3:45,4:00,47.81,,0,47.81,47.81,1,-50394,39079,89473,-11315,0,0,2868,0,0,,2868,2868
51,12/15/2018,17,4:00,4:15,,43.81,0,43.81,43.81,-1,-25773,41354,67127,15581,0,-824,0,0,0,,824,-824
51,12/15/2018,18,4:15,4:30,,43.81,0,43.81,43.81,-1,-33055,48987,82042,15932,0,-2826,0,0,0,,2826,-2826
51,12/15/2018,19,4:30,4:45,,43.81,0,43.81,43.81,-1,-42767,52840,95607,10073,0,-7633,0,0,0,,7633,-7633
51,12/15/2018,20,4:45,5:00,,,0,49.05,49.05,0,-49108,54577,103685,5469,0,-1531,0,0,0,,1531,-1531
51,12/15/2018,21,5:00,5:15,,50.28,0,50.28,50.28,-1,-46852,66077,112929,19225,0,-1276,0,0,0,,1276,-1276
51,12/15/2018,22,5:15,5:30,,48.8,0,48.8,48.8,-1,-51857,64607,116464,12750,0,-1260,0,0,0,,1260,-1260
51,12/15/2018,23,5:30,5:45,,43.81,0,43.81,43.81,-1,-47677,64419,112096,16742,0,-3904,0,0,0,,3904,-3904
51,12/15/2018,24,5:45,6:00,,43.81,0,43.81,43.81,-1,-55131,98109,153240,42978,0,-13905,0,0,0,,13905,-13905
51,12/15/2018,25,6:00,6:15,,31.53,0,31.53,31.53,-1,-32374,89980,122354,57606,0,-26421,0,0,0,,26421,-26421
51,12/15/2018,26,6:15,6:30,,35.3,0,35.3,35.3,-1,-34672,95989,130661,61317,0,-25045,0,0,0,,25045,-25045
51,12/15/2018,27,6:30,6:45,,39.99,0,39.99,39.99,-1,-52154,66528,118682,14374,0,-22505,0,0,0,,22505,-22505
51,12/15/2018,28,6:45,7:00,,25.32,0,25.32,25.32,-1,-73659,89311,162970,15652,0,-8264,0,0,0,,8264,-8264
51,12/15/2018,29,7:00,7:15,,23,0,23,23,-1,-32499,111592,144091,79093,0,-61467,0,0,0,,61467,-61467
51,12/15/2018,30,7:15,7:30,,39.99,0,39.99,39.99,-1,-30228,68381,98609,38153,0,-36828,0,0,0,,36828,-36828
51,12/15/2018,31,7:30,7:45,51.38,44.81,0,51.38,44.81,2,-46294,50996,97290,4702,0,-13280,579,0,0,,13859,-12701
51,12/15/2018,32,7:45,8:00,47.99,,0,47.99,47.99,1,-74289,54580,128869,-19709,0,0,556,0,0,,556,556
51,12/15/2018,33,8:00,8:15,47.99,26.87,0,26.87,26.87,-1,-36582,80024,116606,43442,0,-19487,3,0,0,,19490,-19484
51,12/15/2018,34,8:15,8:30,,40,0,40,40,-1,-66754,46722,113476,-20032,0,-9809,0,0,0,,9809,-9809
51,12/15/2018,35,8:30,8:45,,,0,48.87,48.87,0,-81373,59275,140648,-22098,0,0,0,0,0,,0,0
51,12/15/2018,36,8:45,9:00,53.81,,0,53.81,53.81,1,-131019,55692,186711,-75327,0,0,3569,0,0,,3569,3569
51,12/15/2018,37,9:00,9:15,48.94,,0,48.94,48.94,1,-55744,48627,104371,-7117,0,0,549,0,0,,549,549
51,12/15/2018,38,9:15,9:30,58.08,,0,58.08,58.08,1,-85053,42449,127502,-42604,0,0,25804,0,0,,25804,25804
51,12/15/2018,39,9:30,9:45,123.1,,0,123.1,123.1,1,-132068,40367,172435,-91701,0,0,61779,0,0,,61779,61779
51,12/15/2018,40,9:45,10:00,49.61,,0,49.61,49.61,1,-144260,41166,185426,-103094,0,0,10238,0,0,,10238,10238
51,12/15/2018,41,10:00,10:15,159.66,,0,159.66,159.66,1,-182785,31726,214511,-151059,0,0,31844,0,0,,31844,31844
51,12/15/2018,42,10:15,10:30,159.66,,0,159.66,159.66,1,-169390,38420,207810,-130970,0,0,94253,0,0,,94253,94253
51,12/15/2018,43,10:30,10:45,53.37,,0,53.37,53.37,1,-154449,49838,204287,-104611,0,0,37319,0,0,,37319,37319
51,12/15/2018,44,10:45,11:00,85.88,,0,85.88,85.88,1,-143859,56632,200491,-87227,0,0,11908,0,0,,11908,11908
51,12/15/2018,45,11:00,11:15,144.16,,0,144.16,144.16,1,-140497,54663,195160,-85834,0,0,57701,0,0,,57701,57701
51,12/15/2018,46,11:15,11:30,70,,0,70,70,1,-119589,66402,185991,-53187,0,0,51887,0,0,,51887,51887
51,12/15/2018,47,11:30,11:45,55.99,,0,55.99,55.99,1,-113632,66167,179799,-47465,0,0,37007,0,0,,37007,37007
51,12/15/2018,48,11:45,12:00,55.99,,0,55.99,55.99,1,-111991,71477,183468,-40514,0,0,33600,0,0,,33600,33600
51,12/15/2018,49,12:00,12:15,51.99,,0,51.99,51.99,1,-127931,67171,195102,-60760,0,0,14821,0,0,,14821,14821
51,12/15/2018,50,12:15,12:30,55.99,,0,55.99,55.99,1,-115300,73988,189288,-41312,0,0,17100,0,0,,17100,17100
51,12/15/2018,51,12:30,12:45,154.42,,0,154.42,154.42,1,-148594,76936,225530,-71658,0,0,32523,0,0,,32523,32523
51,12/15/2018,52,12:45,13:00,366.1,,0,366.1,366.1,1,-200941,109766,310707,-91175,0,0,50072,5000,0,,55072,55072
51,12/15/2018,53,13:00,13:15,160.63,,0,160.63,160.63,1,-204023,119548,323571,-84475,0,0,38737,1250,0,,39987,39987
51,12/15/2018,54,13:15,13:30,77.98,,0,77.98,77.98,1,-195683,110388,306071,-85295,0,0,48188,0,0,,48188,48188
51,12/15/2018,55,13:30,13:45,150.16,,0,150.16,150.16,1,-197956,99063,297019,-98893,0,0,45062,0,0,,45062,45062
51,12/15/2018,56,13:45,14:00,160.63,,0,160.63,160.63,1,-183425,107490,290915,-75935,0,0,39009,1250,0,,40259,40259
51,12/15/2018,57,14:00,14:15,55.99,,0,55.99,55.99,1,-137323,102392,239715,-34931,0,0,11743,0,0,,11743,11743
51,12/15/2018,58,14:15,14:30,51.99,,0,51.99,51.99,1,-133262,111591,244853,-21671,0,0,15682,0,0,,15682,15682
51,12/15/2018,59,14:30,14:45,,,0,49.52,49.52,0,-132964,125023,257987,-7941,0,0,2445,0,0,,2445,2445
51,12/15/2018,60,14:45,15:00,,47.69,0,47.69,47.69,-1,-126919,121580,248499,-5339,0,-92,0,0,0,,92,-92
51,12/15/2018,61,15:00,15:15,,43.99,0,43.99,43.99,-1,-104473,129413,233886,24940,0,-2818,0,0,0,,2818,-2818
51,12/15/2018,62,15:15,15:30,,43.99,0,43.99,43.99,-1,-106445,127033,233478,20588,0,-3101,0,0,0,,3101,-3101
51,12/15/2018,63,15:30,15:45,,45.46,0,45.46,45.46,-1,-107621,130544,238165,22923,0,-1872,0,0,0,,1872,-1872
51,12/15/2018,64,15:45,16:00,,41.91,0,41.91,41.91,-1,-99149,121577,220726,22428,0,-5773,0,0,0,,5773,-5773
51,12/15/2018,65,16:00,16:15,,23,0,23,23,-1,-24733,163011,187744,138278,0,-18061,0,0,0,,18061,-18061
51,12/15/2018,66,16:15,16:30,,39.99,0,39.99,39.99,-1,-33563,128971,162534,95408,0,-11951,0,0,0,,11951,-11951
51,12/15/2018,67,16:30,16:45,,46.01,0,46.01,46.01,-1,-31395,105268,136663,73873,0,-2216,0,0,0,,2216,-2216
51,12/15/2018,68,16:45,17:00,,,0,49.5,49.5,0,-53713,95847,149560,42134,0,-241,0,0,0,,241,-241
51,12/15/2018,69,17:00,17:15,,-23.06,0,-23.06,-23.06,-1,-22005,108247,130252,86242,0,-25741,0,0,0,,25741,-25741
51,12/15/2018,70,17:15,17:30,,43.99,0,43.99,43.99,-1,-24193,101495,125688,77302,0,-8436,0,0,0,,8436,-8436
51,12/15/2018,71,17:30,17:45,,26.56,0,26.56,26.56,-1,-18790,116143,134933,97353,0,-14365,0,0,0,,14365,-14365
51,12/15/2018,72,17:45,18:00,,39.99,0,39.99,39.99,-1,-21718,129664,151382,107946,0,-17408,0,0,0,,17408,-17408
51,12/15/2018,73,18:00,18:15,,35.99,0,35.99,35.99,-1,-49475,74821,124296,25346,0,-30323,0,0,0,,30323,-30323
51,12/15/2018,74,18:15,18:30,,35.99,0,35.99,35.99,-1,-39441,95295,134736,55854,0,-51633,0,0,0,,51633,-51633
51,12/15/2018,75,18:30,18:45,,16.83,0,16.83,16.83,-1,-21903,121731,143634,99828,0,-66671,0,0,0,,66671,-66671
51,12/15/2018,76,18:45,19:00,,14.12,0,14.12,14.12,-1,-20635,120547,141182,99912,0,-92158,0,0,0,,92158,-92158
51,12/15/2018,77,19:00,19:15,71.18,39.99,0,71.18,39.99,2,-99269,87836,187105,-11433,0,-26583,5974,0,0,,32557,-20609
51,12/15/2018,78,19:15,19:30,,-107.05,0,-107.05,-107.05,-1,-42690,105358,148048,62668,0,-40275,0,0,0,,40275,-40275
51,12/15/2018,79,19:30,19:45,,-21.14,0,-21.14,-21.14,-1,-35590,120797,156387,85207,0,-24131,0,0,0,,24131,-24131
51,12/15/2018,80,19:45,20:00,,36.73,0,36.73,36.73,-1,-87190,120184,207374,32994,0,-34354,0,0,0,,34354,-34354
51,12/15/2018,81,20:00,20:15,99.16,36.73,0,99.16,99.16,1,-110424,56321,166745,-54103,0,-5657,25871,0,0,,31528,20214
51,12/15/2018,82,20:15,20:30,55.99,,0,55.99,55.99,1,-68290,60672,128962,-7618,0,0,16529,0,0,,16529,16529
51,12/15/2018,83,20:30,20:45,55.99,38.03,0,38.03,38.03,-1,-38300,80543,118843,42243,0,-10618,64,0,0,,10682,-10554
51,12/15/2018,84,20:45,21:00,,36.25,0,36.25,36.25,-1,-28856,82342,111198,53486,0,-34149,0,0,0,,34149,-34149
51,12/15/2018,85,21:00,21:15,48.8,43.99,0,49.44,43.99,2,-70261,78930,149191,8669,0,-11243,499,0,0,,11742,-10744
51,12/15/2018,86,21:15,21:30,,43.99,0,43.99,43.99,-1,-48403,84746,133149,36343,0,-5573,0,0,0,,5573,-5573
51,12/15/2018,87,21:30,21:45,,37.6,0,37.6,37.6,-1,-33648,76916,110564,43268,0,-21053,0,0,0,,21053,-21053
51,12/15/2018,88,21:45,22:00,,39.67,0,39.67,39.67,-1,-46299,90755,137054,44456,0,-25608,0,0,0,,25608,-25608
51,12/15/2018,89,22:00,22:15,,35.99,0,35.99,35.99,-1,-28787,152813,181600,124026,0,-15022,0,0,0,,15022,-15022
51,12/15/2018,90,22:15,22:30,,45.81,0,45.81,45.81,-1,-38392,81948,120340,43556,0,-1704,0,0,0,,1704,-1704
51,12/15/2018,91,22:30,22:45,,43.99,0,43.99,43.99,-1,-51611,69470,121081,17859,0,-3982,0,0,0,,3982,-3982
51,12/15/2018,92,22:45,23:00,61.27,50.53,0,61.27,49.26,2,-89745,60937,150682,-28808,0,-457,12216,0,0,,12673,11759
51,12/15/2018,93,23:00,23:15,61.27,35.99,0,35.99,35.99,-1,-79181,110500,189681,31319,0,-13541,3585,0,0,,17126,-9956
51,12/15/2018,94,23:15,23:30,,43.99,0,43.99,43.99,-1,-68782,69923,138705,1141,0,-7660,0,0,0,,7660,-7660
51,12/15/2018,95,23:30,23:45,48.27,48.4,0,49.06,48.4,2,-72175,64818,136993,-7357,0,-1522,888,0,0,,2410,-634
51,12/15/2018,96,23:45,0:00,48.27,35.99,0,35.99,35.99,-1,-75181,109150,184331,33969,0,-12892,404,0,0,,13296,-12488
51,12/16/2018,1,0:00,0:15,52.44,42.17,0,52.44,42.17,2,-141962,154202,296164,12240,0,-6575,4863,0,0,,11438,-1712
51,12/16/2018,2,0:15,0:30,48.27,47.77,0,49.09,47.77,2,-70394,90745,161139,20351,0,-1359,241,0,0,,1600,-1118
51,12/16/2018,3,0:30,0:45,53.12,,0,53.12,53.12,1,-86942,77726,164668,-9216,0,0,8049,0,0,,8049,8049
51,12/16/2018,4,0:45,1:00,52.44,,0,52.44,52.44,1,-90569,108737,199306,18168,0,0,2873,0,0,,2873,2873
51,12/16/2018,5,1:00,1:15,151.12,,0,151.12,151.12,1,-110694,55476,166170,-55218,0,0,41681,0,0,,41681,41681
51,12/16/2018,6,1:15,1:30,157.12,,0,157.12,157.12,1,-127498,39028,166526,-88470,0,0,78922,0,0,,78922,78922
51,12/16/2018,7,1:30,1:45,90.69,,0,90.69,90.69,1,-113325,55958,169283,-57367,0,0,80386,0,0,,80386,80386
51,12/16/2018,8,1:45,2:00,64.87,,0,64.87,64.87,1,-107981,67510,175491,-40471,0,0,33492,0,0,,33492,33492
51,12/16/2018,9,2:00,2:15,71.64,,0,71.64,71.64,1,-117022,67372,184394,-49650,0,0,45201,0,0,,45201,45201
51,12/16/2018,10,2:15,2:30,52.44,,0,52.44,52.44,1,-115301,70250,185551,-45051,0,0,23235,0,0,,23235,23235
51,12/16/2018,11,2:30,2:45,52.44,,0,52.44,52.44,1,-107422,64905,172327,-42517,0,0,12193,0,0,,12193,12193
51,12/16/2018,12,2:45,3:00,56.44,,0,56.44,56.44,1,-98167,59612,157779,-38555,0,0,12441,0,0,,12441,12441
51,12/16/2018,13,3:00,3:15,115.83,,0,115.83,115.83,1,-121140,44327,165467,-76813,0,0,32229,0,0,,32229,32229
51,12/16/2018,14,3:15,3:30,65.02,,0,65.02,65.02,1,-96753,51725,148478,-45028,0,0,46865,0,0,,46865,46865
51,12/16/2018,15,3:30,3:45,56.44,,0,56.44,56.44,1,-92355,47508,139863,-44847,0,0,30021,0,0,,30021,30021
51,12/16/2018,16,3:45,4:00,71.64,,0,71.64,71.64,1,-97197,47159,144356,-50038,0,0,42790,0,0,,42790,42790
51,12/16/2018,17,4:00,4:15,54.88,50.01,0,50.01,50.01,-1,-68155,75139,143294,6984,0,-88,21877,0,0,,21965,21789
51,12/16/2018,18,4:15,4:30,58.16,46.15,0,58.16,25.51,2,-96251,72020,168271,-24231,0,-752,5620,0,0,,6372,4868
51,12/16/2018,19,4:30,4:45,58.16,,0,58.16,58.16,1,-91046,51367,142413,-39679,0,0,22667,0,0,,22667,22667
51,12/16/2018,20,4:45,5:00,70.98,,0,70.98,70.98,1,-111786,55078,166864,-56708,0,0,47953,0,0,,47953,47953
51,12/16/2018,21,5:00,5:15,56.44,42.39,0,56.44,25.51,2,-56327,85569,141896,29242,0,-4548,16444,0,0,,20992,11896
51,12/16/2018,22,5:15,5:30,48.44,42.39,0,48.44,48.44,1,-79918,69825,149743,-10093,0,-622,376,0,0,,998,-246
51,12/16/2018,23,5:30,5:45,56.44,,0,56.44,56.44,1,-90756,64376,155132,-26380,0,0,8091,0,0,,8091,8091
51,12/16/2018,24,5:45,6:00,57.12,,0,57.12,57.12,1,-99669,59580,159249,-40089,0,0,32464,0,0,,32464,32464
51,12/16/2018,25,6:00,6:15,52.76,,0,52.76,52.76,1,-93517,70523,164040,-22994,0,0,19603,0,0,,19603,19603
51,12/16/2018,26,6:15,6:30,52.76,,0,52.76,52.76,1,-81754,68229,149983,-13525,0,0,7133,0,0,,7133,7133
51,12/16/2018,27,6:30,6:45,56.76,,0,56.76,56.76,1,-93158,57895,151053,-35263,0,0,26434,0,0,,26434,26434
51,12/16/2018,28,6:45,7:00,59.67,,0,59.67,59.67,1,-96424,51063,147487,-45361,0,0,29521,0,0,,29521,29521
51,12/16/2018,29,7:00,7:15,56.76,,0,56.76,56.76,1,-103987,65982,169969,-38005,0,0,18730,0,0,,18730,18730
51,12/16/2018,30,7:15,7:30,56.76,,0,56.76,56.76,1,-90907,58436,149343,-32471,0,0,5880,0,0,,5880,5880
51,12/16/2018,31,7:30,7:45,70.24,,0,70.24,70.24,1,-104353,51388,155741,-52965,0,0,40021,0,0,,40021,40021
51,12/16/2018,32,7:45,8:00,58.12,50.93,0,58.12,47.54,2,-144201,90555,234756,-53646,0,-7,42744,0,0,,42751,42737
51,12/16/2018,33,8:00,8:15,58.12,13.26,0,13.26,13.26,-1,-68996,105179,174175,36183,0,-26776,5335,0,0,,32111,-21441
51,12/16/2018,34,8:15,8:30,52.76,13.26,0,52.76,52.76,1,-108283,81796,190079,-26487,0,-927,4183,0,0,,5110,3256
51,12/16/2018,35,8:30,8:45,48.76,49.37,0,48.76,25.48,2,-94159,89142,183301,-5017,0,-1150,4199,0,0,,5349,3049
51,12/16/2018,36,8:45,9:00,56.76,50.12,0,56.76,56.76,1,-92264,68830,161094,-23434,0,-251,855,0,0,,1106,604
51,12/16/2018,37,9:00,9:15,74.16,,0,74.16,74.16,1,-109651,85033,194684,-24618,0,0,22987,0,0,,22987,22987
51,12/16/2018,38,9:15,9:30,52.76,,0,52.76,52.76,1,-87807,69857,157664,-17950,0,0,6770,0,0,,6770,6770
51,12/16/2018,39,9:30,9:45,147.97,,0,147.97,147.97,1,-128501,53134,181635,-75367,0,0,50717,0,0,,50717,50717
51,12/16/2018,40,9:45,10:00,158.12,,0,158.12,158.12,1,-139854,52512,192366,-87342,0,0,94273,0,0,,94273,94273
51,12/16/2018,41,10:00,10:15,77.84,,0,77.84,77.84,1,-71134,42803,113937,-28331,0,0,30450,0,0,,30450,30450
51,12/16/2018,42,10:15,10:30,179.92,,0,179.92,179.92,1,-115262,10098,125360,-105164,0,0,64875,0,0,,64875,64875
51,12/16/2018,43,10:30,10:45,179.92,,0,179.92,179.92,1,-152024,6909,158933,-145115,0,0,109761,0,0,,109761,109761
51,12/16/2018,44,10:45,11:00,377.84,,0,377.84,377.84,1,-146985,28022,175007,-118963,0,0,109554,5000,0,,114554,114554
51,12/16/2018,45,11:00,11:15,80.1,,0,80.1,80.1,1,-122682,78805,201487,-43877,0,0,41280,0,0,,41280,41280
51,12/16/2018,46,11:15,11:30,184.83,,0,184.83,184.83,1,-149814,65921,215735,-83893,0,0,71751,0,0,,71751,71751
51,12/16/2018,47,11:30,11:45,184.83,,0,184.83,184.83,1,-159182,61478,220660,-97704,0,0,84533,0,0,,84533,84533
51,12/16/2018,48,11:45,12:00,184.83,,0,184.83,184.83,1,-188603,51968,240571,-136635,0,0,103317,0,0,,103317,103317
51,12/16/2018,49,12:00,12:15,185.5,,0,185.5,185.5,1,-161081,101371,262452,-59710,0,0,81460,0,0,,81460,81460
51,12/16/2018,50,12:15,12:30,80.41,,0,80.41,80.41,1,-137909,97526,235435,-40383,0,0,21147,0,0,,21147,21147
51,12/16/2018,51,12:30,12:45,185.5,,0,185.5,185.5,1,-158259,98913,257172,-59346,0,0,51909,0,0,,51909,51909
51,12/16/2018,52,12:45,13:00,80.41,,0,80.41,80.41,1,-158521,91502,250023,-67019,0,0,50818,0,0,,50818,50818
51,12/16/2018,53,13:00,13:15,93.2,,0,93.2,93.2,1,-139511,63869,203380,-75642,0,0,59088,0,0,,59088,59088
51,12/16/2018,54,13:15,13:30,66.12,,0,66.12,66.12,1,-147476,98141,245617,-49335,0,0,51357,0,0,,51357,51357
51,12/16/2018,55,13:30,13:45,59.8,,0,59.8,59.8,1,-136420,100531,236951,-35889,0,0,37838,0,0,,37838,37838
51,12/16/2018,56,13:45,14:00,59.8,,0,59.8,59.8,1,-140169,95844,236013,-44325,0,0,31232,0,0,,31232,31232
51,12/16/2018,57,14:00,14:15,57,,0,57,57,1,-134602,91508,226110,-43094,0,0,35535,0,0,,35535,35535
51,12/16/2018,58,14:15,14:30,56.76,,0,56.76,56.76,1,-120506,90361,210867,-30145,0,0,31762,0,0,,31762,31762
51,12/16/2018,59,14:30,14:45,51.77,,0,51.77,51.77,1,-127198,88617,215815,-38581,0,0,12603,0,0,,12603,12603
51,12/16/2018,60,14:45,15:00,55.33,,0,55.33,55.33,1,-130850,104352,235202,-26498,0,0,7150,0,0,,7150,7150
51,12/16/2018,61,15:00,15:15,50.02,,0,50.02,50.02,1,-114676,112472,227148,-2204,0,0,3305,0,0,,3305,3305
51,12/16/2018,62,15:15,15:30,52.76,,0,52.76,52.76,1,-125474,102671,228145,-22803,0,0,13055,0,0,,13055,13055
51,12/16/2018,63,15:30,15:45,57.97,,0,57.97,57.97,1,-136616,95698,232314,-40918,0,0,30135,0,0,,30135,30135
51,12/16/2018,64,15:45,16:00,53.89,,0,53.89,53.89,1,-141491,109945,251436,-31546,0,0,24668,0,0,,24668,24668
51,12/16/2018,65,16:00,16:15,53.89,43.06,0,43.06,43.06,-1,-52953,74718,127671,21765,0,-3586,4249,0,0,,7835,663
51,12/16/2018,66,16:15,16:30,51.68,,0,51.68,51.68,1,-52995,43913,96908,-9082,0,0,394,0,0,,394,394
51,12/16/2018,67,16:30,16:45,97.63,,0,97.63,97.63,1,-107322,38474,145796,-68848,0,0,34603,0,0,,34603,34603
51,12/16/2018,68,16:45,17:00,74.16,,0,74.16,74.16,1,-136653,63568,200221,-73085,0,0,49037,0,0,,49037,49037
51,12/16/2018,69,17:00,17:15,74.16,44.76,0,44.76,44.76,-1,-47046,86798,133844,39752,0,-1741,10974,0,0,,12715,9233
51,12/16/2018,70,17:15,17:30,,,0,49.86,49.86,0,-49535,77981,127516,28446,0,0,0,0,0,,0,0
51,12/16/2018,71,17:30,17:45,48.76,,0,48.76,48.76,1,-58986,61692,120678,2706,0,0,113,0,0,,113,113
51,12/16/2018,72,17:45,18:00,52.76,,0,52.76,52.76,1,-64288,58820,123108,-5468,0,0,1231,0,0,,1231,1231
51,12/16/2018,73,18:00,18:15,60.85,,0,60.85,60.85,1,-127974,14213,142187,-113761,0,0,27003,0,0,,27003,27003
51,12/16/2018,74,18:15,18:30,56.76,,0,56.76,56.76,1,-80319,46372,126691,-33947,0,0,25213,0,0,,25213,25213
51,12/16/2018,75,18:30,18:45,56.76,47.12,0,47.12,47.12,-1,-70614,50040,120654,-20574,0,-16,1664,0,0,,1680,1648
51,12/16/2018,76,18:45,19:00,,47.12,0,47.12,47.12,-1,-58434,51452,109886,-6982,0,-36,0,0,0,,36,-36
51,12/16/2018,77,19:00,19:15,158.12,,0,158.12,158.12,1,-187723,35955,223678,-151768,0,0,27144,0,0,,27144,27144
51,12/16/2018,78,19:15,19:30,158.12,50.97,0,158.12,49.78,2,-122321,46540,168861,-75781,0,-3,52979,0,0,,52982,52976
51,12/16/2018,79,19:30,19:45,158.12,47.12,0,47.12,47.12,-1,-76130,62980,139110,-13150,0,-555,1430,0,0,,1985,875
51,12/16/2018,80,19:45,20:00,,47.12,0,47.12,47.12,-1,-54425,61410,115835,6985,0,-2607,0,0,0,,2607,-2607
51,12/16/2018,81,20:00,20:15,,,0,49.63,49.63,0,-84936,60818,145754,-24118,0,-1254,0,0,0,,1254,-1254
51,12/16/2018,82,20:15,20:30,,,0,49.66,49.66,0,-79594,54540,134134,-25054,0,0,0,0,0,,0,0
51,12/16/2018,83,20:30,20:45,,40.76,0,40.76,40.76,-1,-51186,84867,136053,33681,0,-6820,0,0,0,,6820,-6820
51,12/16/2018,84,20:45,21:00,,36.76,0,36.76,36.76,-1,-51500,100229,151729,48729,0,-35273,0,0,0,,35273,-35273
51,12/16/2018,85,21:00,21:15,147.12,45.78,0,147.12,45.78,2,-75339,17007,92346,-58332,0,-10294,19848,0,0,,30142,9554
51,12/16/2018,86,21:15,21:30,52.76,,0,52.76,52.76,1,-42063,40247,82310,-1816,0,0,7860,0,0,,7860,7860
51,12/16/2018,87,21:30,21:45,48.76,,0,48.76,48.76,1,-34253,36604,70857,2351,0,0,2919,0,0,,2919,2919
51,12/16/2018,88,21:45,22:00,,46.98,0,46.98,46.98,-1,-26318,63231,89549,36913,0,-1258,0,0,0,,1258,-1258
51,12/16/2018,89,22:00,22:15,,45.06,0,45.06,45.06,-1,-67099,31279,98378,-35820,0,-1112,0,0,0,,1112,-1112
51,12/16/2018,90,22:15,22:30,,,0,49.58,49.58,0,-51664,27668,79332,-23996,0,0,0,0,0,,0,0
51,12/16/2018,91,22:30,22:45,,,0,49.6,49.6,0,-29856,50827,80683,20971,0,0,0,0,0,,0,0
51,12/16/2018,92,22:45,23:00,,44.76,0,44.76,44.76,-1,-38718,67713,106431,28995,0,-5178,0,0,0,,5178,-5178
51,12/16/2018,93,23:00,23:15,48.76,47.02,0,49.54,47.02,2,-66164,48163,114327,-18001,0,-2682,878,0,0,,3560,-1804
51,12/16/2018,94,23:15,23:30,,,0,49.05,49.05,0,-62189,32364,94553,-29825,0,0,0,0,0,,0,0
51,12/16/2018,95,23:30,23:45,,,0,49.15,49.15,0,-67534,31479,99013,-36055,0,0,0,0,0,,0,0
51,12/16/2018,96,23:45,0:00,,,0,49.27,49.27,0,-70989,48457,119446,-22532,0,0,0,0,0,,0,0
51,12/17/2018,1,0:00,0:15,,44.76,0,44.76,44.76,-1,-67849,131873,199722,64024,0,-2231,0,0,0,,2231,-2231
51,12/17/2018,2,0:15,0:30,,42.28,0,42.28,42.28,-1,-53899,114701,168600,60802,0,-4760,0,0,0,,4760,-4760
51,12/17/2018,3,0:30,0:45,,36.76,0,36.76,36.76,-1,-41395,93136,134531,51741,0,-23139,0,0,0,,23139,-23139
51,12/17/2018,4,0:45,1:00,,42.16,0,42.16,42.16,-1,-27057,103886,130943,76829,0,-30383,0,0,0,,30383,-30383
51,12/17/2018,5,1:00,1:15,48.05,29.03,0,49,29.03,2,-63459,77489,140948,14030,0,-35346,38,0,0,,35384,-35308
51,12/17/2018,6,1:15,1:30,50.5,44.76,0,50.5,44.76,2,-63709,74106,137815,10397,0,-6157,2315,0,0,,8472,-3842
51,12/17/2018,7,1:30,1:45,,40.76,0,40.76,40.76,-1,-47129,70031,117160,22902,0,-14606,0,0,0,,14606,-14606
51,12/17/2018,8,1:45,2:00,,44.76,0,44.76,44.76,-1,-49835,73108,122943,23273,0,-13289,0,0,0,,13289,-13289
51,12/17/2018,9,2:00,2:15,,44.76,0,44.76,44.76,-1,-59660,73433,133093,13773,0,-8381,0,0,0,,8381,-8381
51,12/17/2018,10,2:15,2:30,,,0,49,49,0,-57590,75625,133215,18035,0,-3,0,0,0,,3,-3
51,12/17/2018,11,2:30,2:45,,,0,49.01,49.01,0,-56943,89491,146434,32548,0,0,0,0,0,,0,0
51,12/17/2018,12,2:45,3:00,,44.76,0,44.76,44.76,-1,-63983,104237,168220,40254,0,-1490,0,0,0,,1490,-1490
51,12/17/2018,13,3:00,3:15,,49.31,0,49.31,49.31,-1,-74890,97816,172706,22926,0,-1156,0,0,0,,1156,-1156
51,12/17/2018,14,3:15,3:30,,49.37,0,49.37,49.37,-1,-71398,86736,158134,15338,0,-16,0,0,0,,16,-16
51,12/17/2018,15,3:30,3:45,,44.76,0,44.76,44.76,-1,-65910,83112,149022,17202,0,-5725,0,0,0,,5725,-5725
51,12/17/2018,16,3:45,4:00,,47.6,0,47.6,47.6,-1,-61822,71687,133509,9865,0,-6646,0,0,0,,6646,-6646
51,12/17/2018,17,4:00,4:15,,49.42,0,49.42,49.42,-1,-70279,71421,141700,1142,0,-675,0,0,0,,675,-675
51,12/17/2018,18,4:15,4:30,,47.44,0,47.44,47.44,-1,-63938,77450,141388,13512,0,-3012,0,0,0,,3012,-3012
51,12/17/2018,19,4:30,4:45,,49.42,0,49.42,49.42,-1,-66975,80029,147004,13054,0,-1194,0,0,0,,1194,-1194
51,12/17/2018,20,4:45,5:00,,44.76,0,44.76,44.76,-1,-51920,87559,139479,35639,0,-2248,0,0,0,,2248,-2248
51,12/17/2018,21,5:00,5:15,,25.66,0,25.66,25.66,-1,-43644,96797,140441,53153,0,-10740,0,0,0,,10740,-10740
51,12/17/2018,22,5:15,5:30,,23.8,0,23.8,23.8,-1,-59394,79608,139002,20214,0,-28384,0,0,0,,28384,-28384
51,12/17/2018,23,5:30,5:45,,44.14,0,44.14,44.14,-1,-73020,85865,158885,12845,0,-3277,0,0,0,,3277,-3277
51,12/17/2018,24,5:45,6:00,,36.76,0,36.76,36.76,-1,-53527,96886,150413,43359,0,-23977,0,0,0,,23977,-23977
51,12/17/2018,25,6:00,6:15,,13.81,0,13.81,13.81,-1,-45904,150897,196801,104993,0,-51981,0,0,0,,51981,-51981
51,12/17/2018,26,6:15,6:30,,37.07,0,37.07,37.07,-1,-32667,87308,119975,54641,0,-42142,0,0,0,,42142,-42142
51,12/17/2018,27,6:30,6:45,48.76,45.14,0,48.76,48.76,1,-79105,88462,167567,9357,0,-10020,415,0,0,,10435,-9605
51,12/17/2018,28,6:45,7:00,74.68,,0,74.68,74.68,1,-159067,100282,259349,-58785,0,0,22542,0,0,,22542,22542
51,12/17/2018,29,7:00,7:15,48.86,-82.5,0,49.9,-82.5,2,-2558,223456,226014,220898,0,-46950,3766,0,0,,50716,-43184
51,12/17/2018,30,7:15,7:30,,36.76,0,36.76,36.76,-1,-31150,161080,192230,129930,0,-21413,0,0,0,,21413,-21413
51,12/17/2018,31,7:30,7:45,,,0,48.88,48.88,0,-104009,152158,256167,48149,0,-249,0,0,0,,249,-249
51,12/17/2018,32,7:45,8:00,48.76,,0,48.76,48.76,1,-161312,155306,316618,-6006,0,0,1234,0,0,,1234,1234
51,12/17/2018,33,8:00,8:15,,,0,48.96,48.96,0,-72884,129307,202191,56423,0,0,6,0,0,,6,6
51,12/17/2018,34,8:15,8:30,,,0,48.96,48.96,0,-92694,110394,203088,17700,0,0,0,0,0,,0,0
51,12/17/2018,35,8:30,8:45,63.7,,0,63.7,63.7,1,-134471,101258,235729,-33213,0,0,15965,0,0,,15965,15965
51,12/17/2018,36,8:45,9:00,53.7,,0,53.7,53.7,1,-142435,105699,248134,-36736,0,0,19667,0,0,,19667,19667
51,12/17/2018,37,9:00,9:15,56.1,,0,56.1,56.1,1,-113812,87278,201090,-26534,0,0,20398,0,0,,20398,20398
51,12/17/2018,38,9:15,9:30,63.76,,0,63.76,63.76,1,-122872,80258,203130,-42614,0,0,22462,0,0,,22462,22462
51,12/17/2018,39,9:30,9:45,53.76,,0,53.76,53.76,1,-116808,90574,207382,-26234,0,0,13218,0,0,,13218,13218
51,12/17/2018,40,9:45,10:00,48.76,,0,48.76,48.76,1,-110995,84182,195177,-26813,0,0,299,0,0,,299,299
51,12/17/2018,41,10:00,10:15,53.31,,0,53.31,53.31,1,-149455,88324,237779,-61131,0,0,3285,0,0,,3285,3285
51,12/17/2018,42,10:15,10:30,49.19,,0,49.19,49.19,1,-149864,96692,246556,-53172,0,0,371,0,0,,371,371
51,12/17/2018,43,10:30,10:45,52.21,,0,52.21,52.21,1,-133109,103641,236750,-29468,0,0,522,0,0,,522,522
51,12/17/2018,44,10:45,11:00,,,0,49.16,49.16,0,-137042,108406,245448,-28636,0,0,0,0,0,,0,0
51,12/17/2018,45,11:00,11:15,,,0,49.16,49.16,0,-152897,117635,270532,-35262,0,0,0,0,0,,0,0
51,12/17/2018,46,11:15,11:30,,,0,49.16,49.16,0,-121044,104531,225575,-16513,0,0,0,0,0,,0,0
51,12/17/2018,47,11:30,11:45,53.31,,0,53.31,53.31,1,-148062,98535,246597,-49527,0,0,1458,0,0,,1458,1458
51,12/17/2018,48,11:45,12:00,52.18,,0,52.18,52.18,1,-126909,98875,225784,-28034,0,0,2632,0,0,,2632,2632
51,12/17/2018,49,12:00,12:15,59.02,,0,59.02,59.02,1,-200922,79996,280918,-120926,0,0,10124,0,0,,10124,10124
51,12/17/2018,50,12:15,12:30,52.67,,0,52.67,52.67,1,-181060,72198,253258,-108862,0,0,13561,0,0,,13561,13561
51,12/17/2018,51,12:30,12:45,79.02,,0,79.02,79.02,1,-150377,73126,223503,-77251,0,0,5246,0,0,,5246,5246
51,12/17/2018,52,12:45,13:00,49.19,,0,49.19,49.19,1,-150622,77214,227836,-73408,0,0,1646,0,0,,1646,1646
51,12/17/2018,53,13:00,13:15,130.02,,0,130.02,130.02,1,-154653,79845,234498,-74808,0,0,19589,0,0,,19589,19589
51,12/17/2018,54,13:15,13:30,53.07,,0,53.07,53.07,1,-131782,83406,215188,-48376,0,0,7091,0,0,,7091,7091
51,12/17/2018,55,13:30,13:45,,,0,49.14,49.14,0,-138795,76666,215461,-62129,0,0,0,0,0,,0,0
51,12/17/2018,56,13:45,14:00,,,0,49.14,49.14,0,-142244,79055,221299,-63189,0,0,0,0,0,,0,0
51,12/17/2018,57,14:00,14:15,51.94,,0,51.94,51.94,1,-121993,90492,212485,-31501,0,0,833,0,0,,833,833
51,12/17/2018,58,14:15,14:30,,,0,49.12,49.12,0,-106658,91990,198648,-14668,0,0,75,0,0,,75,75
51,12/17/2018,59,14:30,14:45,,47.65,0,47.65,47.65,-1,-85833,90027,175860,4194,0,-120,0,0,0,,120,-120
51,12/17/2018,60,14:45,15:00,,47.65,0,47.65,47.65,-1,-102103,90864,192967,-11239,0,-821,0,0,0,,821,-821
51,12/17/2018,61,15:00,15:15,52.76,,0,52.76,52.76,1,-119245,109474,228719,-9771,0,0,1611,0,0,,1611,1611
51,12/17/2018,62,15:15,15:30,48.76,,0,48.76,48.76,1,-126307,109056,235363,-17251,0,0,1552,0,0,,1552,1552
51,12/17/2018,63,15:30,15:45,51.92,,0,51.92,51.92,1,-139688,102144,241832,-37544,0,0,1170,0,0,,1170,1170
51,12/17/2018,64,15:45,16:00,58.98,,0,58.98,58.98,1,-146665,97725,244390,-48940,0,0,7227,0,0,,7227,7227
51,12/17/2018,65,16:00,16:15,48.76,20.87,0,20.87,20.87,-1,-94456,182440,276896,87984,0,-20185,2262,0,0,,22447,-17923
51,12/17/2018,66,16:15,16:30,,40.37,0,40.37,40.37,-1,-124451,143372,267823,18921,0,-26020,0,0,0,,26020,-26020
51,12/17/2018,67,16:30,16:45,,40.37,0,40.37,40.37,-1,-89592,142279,231871,52687,0,-18543,0,0,0,,18543,-18543
51,12/17/2018,68,16:45,17:00,52.01,45.9,0,52.01,52.01,1,-116618,130738,247356,14120,0,-9083,478,0,0,,9561,-8605
51,12/17/2018,69,17:00,17:15,,46.46,0,46.46,46.46,-1,-83563,137627,221190,54064,0,-347,0,0,0,,347,-347
51,12/17/2018,70,17:15,17:30,,,0,48.89,48.89,0,-89212,137814,227026,48602,0,0,0,0,0,,0,0
51,12/17/2018,71,17:30,17:45,,,0,48.89,48.89,0,-82615,134163,216778,51548,0,0,0,0,0,,0,0
51,12/17/2018,72,17:45,18:00,,,0,48.89,48.89,0,-81360,148847,230207,67487,0,0,0,0,0,,0,0
51,12/17/2018,73,18:00,18:15,52.15,,0,52.15,52.15,1,-151030,78816,229846,-72214,0,0,1164,0,0,,1164,1164
51,12/17/2018,74,18:15,18:30,,,0,48.88,48.88,0,-123294,89404,212698,-33890,0,0,0,0,0,,0,0
51,12/17/2018,75,18:30,18:45,,47.87,0,47.87,47.87,-1,-104822,99013,203835,-5809,0,-71,0,0,0,,71,-71
51,12/17/2018,76,18:45,19:00,,40.37,0,40.37,40.37,-1,-90557,118554,209111,27997,0,-7252,0,0,0,,7252,-7252
51,12/17/2018,77,19:00,19:15,52.03,36.76,0,52.03,52.03,1,-136208,132990,269198,-3218,0,-11324,195,0,0,,11519,-11129
51,12/17/2018,78,19:15,19:30,52.09,44.76,0,52.09,44.76,2,-109110,120186,229296,11076,0,-806,1208,0,0,,2014,402
51,12/17/2018,79,19:30,19:45,,36.62,0,36.62,36.62,-1,-98086,159059,257145,60973,0,-23245,0,0,0,,23245,-23245
51,12/17/2018,80,19:45,20:00,,26.87,0,26.87,26.87,-1,-92713,164720,257433,72007,0,-58870,0,0,0,,58870,-58870
51,12/17/2018,81,20:00,20:15,,43.88,0,43.88,43.88,-1,-145857,173182,319039,27325,0,-27491,0,0,0,,27491,-27491
51,12/17/2018,82,20:15,20:30,,24.03,0,24.03,24.03,-1,-126138,185209,311347,59071,0,-36979,0,0,0,,36979,-36979
51,12/17/2018,83,20:30,20:45,,23.37,0,23.37,23.37,-1,-110099,186400,296499,76301,0,-57070,0,0,0,,57070,-57070
51,12/17/2018,84,20:45,21:00,,23.68,0,23.68,23.68,-1,-117379,178582,295961,61203,0,-60302,0,0,0,,60302,-60302
51,12/17/2018,85,21:00,21:15,,34.03,0,34.03,34.03,-1,-175807,213159,388966,37352,0,-43429,0,0,0,,43429,-43429
51,12/17/2018,86,21:15,21:30,,23.84,0,23.84,23.84,-1,-143522,205807,349329,62285,0,-46970,0,0,0,,46970,-46970
51,12/17/2018,87,21:30,21:45,,33.33,0,33.33,33.33,-1,-123611,194446,318057,70835,0,-65440,0,0,0,,65440,-65440
51,12/17/2018,88,21:45,22:00,,32.45,0,32.45,32.45,-1,-116060,181481,297541,65421,0,-66478,0,0,0,,66478,-66478
51,12/17/2018,89,22:00,22:15,,36.76,0,36.76,36.76,-1,-176425,212322,388747,35897,0,-37644,0,0,0,,37644,-37644
51,12/17/2018,90,22:15,22:30,,23.84,0,23.84,23.84,-1,-121557,178335,299892,56778,0,-33630,0,0,0,,33630,-33630
51,12/17/2018,91,22:30,22:45,,5.24,0,5.24,5.24,-1,-75598,183044,258642,107446,0,-89244,0,0,0,,89244,-89244
51,12/17/2018,92,22:45,23:00,,3.92,0,3.92,3.92,-1,-79222,179071,258293,99849,0,-103085,0,0,0,,103085,-103085
51,12/17/2018,93,23:00,23:15,,-23.41,0,-23.41,-23.41,-1,-115326,205703,321029,90377,0,-84914,0,0,0,,84914,-84914
51,12/17/2018,94,23:15,23:30,,21.59,0,21.59,21.59,-1,-127506,168832,296338,41326,0,-16801,0,0,0,,16801,-16801
51,12/17/2018,95,23:30,23:45,,-80.05,0,-80.05,-80.05,-1,-85450,157797,243247,72347,0,-54759,0,0,0,,54759,-54759
51,12/17/2018,96,23:45,0:00,,-5.23,0,-5.23,-5.23,-1,-91965,191134,283099,99169,0,-58723,0,0,0,,58723,-58723
51,12/18/2018,1,0:00,0:15,53.53,24.29,0,53.53,24.29,2,-95420,92457,187877,-2963,0,-32178,2658,0,0,,34836,-29520
51,12/18/2018,2,0:15,0:30,,32.92,0,32.92,32.92,-1,-53070,96714,149784,43644,0,-21794,0,0,0,,21794,-21794
51,12/18/2018,3,0:30,0:45,,40.83,0,40.83,40.83,-1,-63893,108635,172528,44742,0,-11048,0,0,0,,11048,-11048
51,12/18/2018,4,0:45,1:00,,37.12,0,37.12,37.12,-1,-59503,104078,163581,44575,0,-35310,0,0,0,,35310,-35310
51,12/18/2018,5,1:00,1:15,56.83,43.78,0,56.83,43.78,2,-95099,55943,151042,-39156,0,-11743,5516,0,0,,17259,-6227
51,12/18/2018,6,1:15,1:30,52.66,,0,52.66,52.66,1,-101071,73857,174928,-27214,0,0,3850,0,0,,3850,3850
51,12/18/2018,7,1:30,1:45,,,0,48.48,48.48,0,-96776,79326,176102,-17450,0,0,9,0,0,,9,9
51,12/18/2018,8,1:45,2:00,,,0,48.43,48.43,0,-106535,87319,193854,-19216,0,0,0,0,0,,0,0
51,12/18/2018,9,2:00,2:15,85.94,,0,85.94,85.94,1,-139668,62536,202204,-77132,0,0,20854,0,0,,20854,20854
51,12/18/2018,10,2:15,2:30,60.77,,0,60.77,60.77,1,-138963,89942,228905,-49021,0,0,19902,0,0,,19902,19902
51,12/18/2018,11,2:30,2:45,52.83,,0,52.83,52.83,1,-133036,80080,213116,-52956,0,0,2127,0,0,,2127,2127
51,12/18/2018,12,2:45,3:00,48.83,,0,48.83,48.83,1,-121115,83909,205024,-37206,0,0,1570,0,0,,1570,1570
51,12/18/2018,13,3:00,3:15,65.42,,0,65.42,65.42,1,-108349,68664,177013,-39685,0,0,14963,0,0,,14963,14963
51,12/18/2018,14,3:15,3:30,53.93,,0,53.93,53.93,1,-104102,81761,185863,-22341,0,0,14583,0,0,,14583,14583
51,12/18/2018,15,3:30,3:45,,,0,48.34,48.34,0,-103921,77640,181561,-26281,0,0,21,0,0,,21,21
51,12/18/2018,16,3:45,4:00,,,0,48.33,48.33,0,-104755,86893,191648,-17862,0,0,0,0,0,,0,0
51,12/18/2018,17,4:00,4:15,,37.12,0,37.12,37.12,-1,-75742,99818,175560,24076,0,-19526,0,0,0,,19526,-19526
51,12/18/2018,18,4:15,4:30,,41.78,0,41.78,41.78,-1,-75769,84423,160192,8654,0,-17224,0,0,0,,17224,-17224
51,12/18/2018,19,4:30,4:45,,,0,48.34,48.34,0,-81014,71374,152388,-9640,0,0,0,0,0,,0,0
51,12/18/2018,20,4:45,5:00,,,0,48.32,48.32,0,-85556,56753,142309,-28803,0,0,0,0,0,,0,0
51,12/18/2018,21,5:00,5:15,,46.44,0,46.44,46.44,-1,-81192,81206,162398,14,0,-928,0,0,0,,928,-928
51,12/18/2018,22,5:15,5:30,49.16,,0,49.16,49.16,1,-94298,71294,165592,-23004,0,0,443,0,0,,443,443
51,12/18/2018,23,5:30,5:45,56.83,,0,56.83,56.83,1,-115484,65068,180552,-50416,0,0,4618,0,0,,4618,4618
51,12/18/2018,24,5:45,6:00,65.21,,0,65.21,65.21,1,-97525,77928,175453,-19597,0,0,15742,0,0,,15742,15742
51,12/18/2018,25,6:00,6:15,64.25,,0,64.25,64.25,1,-180719,84320,265039,-96399,0,0,8723,0,0,,8723,8723
51,12/18/2018,26,6:15,6:30,73.16,,0,73.16,73.16,1,-125450,57784,183234,-67666,0,0,26102,0,0,,26102,26102
51,12/18/2018,27,6:30,6:45,253.35,,0,253.35,253.35,1,-158324,46487,204811,-111837,0,0,86931,0,0,,86931,86931
51,12/18/2018,28,6:45,7:00,253.35,,0,253.35,253.35,1,-182941,55419,238360,-127522,0,0,119344,0,0,,119344,119344
51,12/18/2018,29,7:00,7:15,253.35,-93.85,0,-93.85,-93.85,-1,-69817,157969,227786,88152,0,-15679,33797,0,0,,49476,18118
51,12/18/2018,30,7:15,7:30,52.93,45.01,0,52.93,52.93,1,-104422,75618,180040,-28804,0,-5128,315,0,0,,5443,-4813
51,12/18/2018,31,7:30,7:45,83.09,,0,83.09,83.09,1,-172272,58352,230624,-113920,0,0,37763,0,0,,37763,37763
51,12/18/2018,32,7:45,8:00,254.74,,0,254.74,254.74,1,-233055,51307,284362,-181748,0,0,86257,0,0,,86257,86257
51,12/18/2018,33,8:00,8:15,254.74,46.13,0,46.13,46.13,-1,-93091,104376,197467,11285,0,-1258,42884,0,0,,44142,41626
51,12/18/2018,34,8:15,8:30,,,0,50.33,50.33,0,-117520,78283,195803,-39237,0,-6,0,0,0,,6,-6
51,12/18/2018,35,8:30,8:45,,,0,50.33,50.33,0,-116001,75215,191216,-40786,0,0,0,0,0,,0,0
51,12/18/2018,36,8:45,9:00,,,0,50.33,50.33,0,-125951,72711,198662,-53240,0,0,0,0,0,,0,0
51,12/18/2018,37,9:00,9:15,50.08,,0,50.08,50.08,1,-99566,66763,166329,-32803,0,0,355,0,0,,355,355
51,12/18/2018,38,9:15,9:30,,,0,50.33,50.33,0,-86668,53960,140628,-32708,0,0,0,0,0,,0,0
51,12/18/2018,39,9:30,9:45,,48.65,0,48.65,48.65,-1,-81355,74202,155557,-7153,0,-3,0,0,0,,3,-3
51,12/18/2018,40,9:45,10:00,,42.89,0,42.89,42.89,-1,-62253,75629,137882,13376,0,-6493,0,0,0,,6493,-6493
51,12/18/2018,41,10:00,10:15,,,0,50.33,50.33,0,-66546,62250,128796,-4296,0,-493,0,0,0,,493,-493
51,12/18/2018,42,10:15,10:30,,,0,50.33,50.33,0,-60982,84922,145904,23940,0,0,0,0,0,,0,0
51,12/18/2018,43,10:30,10:45,,,0,50.33,50.33,0,-55303,85929,141232,30626,0,0,0,0,0,,0,0
51,12/18/2018,44,10:45,11:00,,37.15,0,37.15,37.15,-1,-50117,89343,139460,39226,0,-6775,0,0,0,,6775,-6775
51,12/18/2018,45,11:00,11:15,,28.24,0,28.24,28.24,-1,-83680,64716,148396,-18964,0,-18710,0,0,0,,18710,-18710
51,12/18/2018,46,11:15,11:30,,,0,50.47,50.47,0,-89729,66222,155951,-23507,0,0,0,0,0,,0,0
51,12/18/2018,47,11:30,11:45,,,0,50.49,50.49,0,-75088,76827,151915,1739,0,0,0,0,0,,0,0
51,12/18/2018,48,11:45,12:00,,,0,50.5,50.5,0,-74485,74949,149434,464,0,0,0,0,0,,0,0
51,12/18/2018,49,12:00,12:15,52.93,,0,52.93,52.93,1,-117330,64017,181347,-53313,0,0,2660,0,0,,2660,2660
51,12/18/2018,50,12:15,12:30,48.93,,0,48.93,48.93,1,-107598,79001,186599,-28597,0,0,222,0,0,,222,222
51,12/18/2018,51,12:30,12:45,,,0,50.51,50.51,0,-91405,72707,164112,-18698,0,0,0,0,0,,0,0
51,12/18/2018,52,12:45,13:00,,,0,50.52,50.52,0,-88369,70399,158768,-17970,0,0,0,0,0,,0,0
51,12/18/2018,53,13:00,13:15,48.93,,0,48.93,48.93,1,-92701,70933,163634,-21768,0,0,658,0,0,,658,658
51,12/18/2018,54,13:15,13:30,48.93,,0,48.93,48.93,1,-97516,61565,159081,-35951,0,0,623,0,0,,623,623
51,12/18/2018,55,13:30,13:45,48.93,,0,48.93,48.93,1,-105287,70375,175662,-34912,0,0,987,0,0,,987,987
51,12/18/2018,56,13:45,14:00,48.93,,0,48.93,48.93,1,-113618,71703,185321,-41915,0,0,1686,0,0,,1686,1686
51,12/18/2018,57,14:00,14:15,53.11,,0,53.11,53.11,1,-120101,90023,210124,-30078,0,0,7614,0,0,,7614,7614
51,12/18/2018,58,14:15,14:30,78.12,,0,78.12,78.12,1,-146070,68207,214277,-77863,0,0,43146,0,0,,43146,43146
51,12/18/2018,59,14:30,14:45,73.16,,0,73.16,73.16,1,-143325,66343,209668,-76982,0,0,57577,0,0,,57577,57577
51,12/18/2018,60,14:45,15:00,201.95,,0,201.95,201.95,1,-163807,72012,235819,-91795,0,0,67471,0,0,,67471,67471
51,12/18/2018,61,15:00,15:15,55.12,44.99,0,55.12,44.99,2,-80755,92901,173656,12146,0,-1174,18509,0,0,,19683,17335
51,12/18/2018,62,15:15,15:30,48.93,,0,48.93,48.93,1,-106700,64907,171607,-41793,0,0,35,0,0,,35,35
51,12/18/2018,63,15:30,15:45,49.56,,0,49.56,49.56,1,-121057,57999,179056,-63058,0,0,885,0,0,,885,885
51,12/18/2018,64,15:45,16:00,,,0,50.41,50.41,0,-112465,65337,177802,-47128,0,0,0,0,0,,0,0
51,12/18/2018,65,16:00,16:15,48.93,51.9,0,50.42,50.42,2,-104619,99327,203946,-5292,0,-24,366,0,0,,390,342
51,12/18/2018,66,16:15,16:30,,44.93,0,44.93,44.93,-1,-85608,93478,179086,7870,0,-3565,0,0,0,,3565,-3565
51,12/18/2018,67,16:30,16:45,,43.78,0,43.78,43.78,-1,-94099,102575,196674,8476,0,-2866,0,0,0,,2866,-2866
51,12/18/2018,68,16:45,17:00,58.85,43.78,0,58.85,58.85,1,-138715,95473,234188,-43242,0,-15,17247,0,0,,17262,17232
51,12/18/2018,69,17:00,17:15,56.93,50.46,0,50.46,50.46,-1,-94177,110227,204404,16050,0,-716,14051,0,0,,14767,13335
51,12/18/2018,70,17:15,17:30,124.86,48.64,0,124.86,48.64,2,-123392,65002,188394,-58390,0,-460,4956,0,0,,5416,4496
51,12/18/2018,71,17:30,17:45,,,0,50.33,50.33,0,-154098,96612,250710,-57486,0,0,106,0,0,,106,106
51,12/18/2018,72,17:45,18:00,,48.74,0,48.74,48.74,-1,-119005,122272,241277,3267,0,-93,0,0,0,,93,-93
51,12/18/2018,73,18:00,18:15,48.93,50.21,0,48.93,48.93,1,-107365,75959,183324,-31406,0,-14,767,0,0,,781,753
51,12/18/2018,74,18:15,18:30,48.93,43.2,0,49.74,43.2,2,-75405,100581,175986,25176,0,-8981,470,0,0,,9451,-8511
51,12/18/2018,75,18:30,18:45,,40.93,0,40.93,40.93,-1,-61421,104565,165986,43144,0,-28344,0,0,0,,28344,-28344
51,12/18/2018,76,18:45,19:00,,44.12,0,44.12,44.12,-1,-62749,112082,174831,49333,0,-35049,0,0,0,,35049,-35049
51,12/18/2018,77,19:00,19:15,63.25,37.15,0,63.25,37.15,2,-95742,84057,179799,-11685,0,-19616,5914,0,0,,25530,-13702
51,12/18/2018,78,19:15,19:30,52.93,44.71,0,44.71,44.71,-1,-88430,101174,189604,12744,0,-3928,4826,0,0,,8754,898
51,12/18/2018,79,19:30,19:45,,42.78,0,42.78,42.78,-1,-76428,102373,178801,25945,0,-14688,0,0,0,,14688,-14688
51,12/18/2018,80,19:45,20:00,,43.78,0,43.78,43.78,-1,-61000,84262,145262,23262,0,-24577,0,0,0,,24577,-24577
51,12/18/2018,81,20:00,20:15,55.68,25,0,55.68,25,2,-60512,82074,142586,21562,0,-26805,691,0,0,,27496,-26114
51,12/18/2018,82,20:15,20:30,62.61,25,0,62.61,62.61,1,-82416,61718,144134,-20698,0,-896,9674,0,0,,10570,8778
51,12/18/2018,83,20:30,20:45,,48.66,0,48.66,48.66,-1,-83563,71735,155298,-11828,0,-1196,0,0,0,,1196,-1196
51,12/18/2018,84,20:45,21:00,73.16,,0,73.16,73.16,1,-161413,66415,227828,-94998,0,0,16614,0,0,,16614,16614
51,12/18/2018,85,21:00,21:15,49.1,51.47,0,49.1,30.74,2,-63334,103180,166514,39846,0,-537,3892,0,0,,4429,3355
51,12/18/2018,86,21:15,21:30,50.52,48.2,0,50.52,48.2,2,-79811,82097,161908,2286,0,-88,1154,0,0,,1242,1066
51,12/18/2018,87,21:30,21:45,,37.59,0,37.59,37.59,-1,-56331,89764,146095,33433,0,-22421,0,0,0,,22421,-22421
51,12/18/2018,88,21:45,22:00,52.93,48.46,0,52.93,30.81,2,-104043,84353,188396,-19690,0,-4512,5798,0,0,,10310,1286
51,12/18/2018,89,22:00,22:15,248.23,,0,248.23,248.23,1,-162583,53018,215601,-109565,0,0,59082,0,0,,59082,59082
51,12/18/2018,90,22:15,22:30,80.12,,0,80.12,80.12,1,-109010,81786,190796,-27224,0,0,46099,0,0,,46099,46099
51,12/18/2018,91,22:30,22:45,80.12,37.15,0,37.15,37.15,-1,-65808,101600,167408,35792,0,-14065,2011,0,0,,16076,-12054
51,12/18/2018,92,22:45,23:00,,39.01,0,39.01,39.01,-1,-69708,112639,182347,42931,0,-36619,0,0,0,,36619,-36619
51,12/18/2018,93,23:00,23:15,73.69,39.01,0,73.69,73.69,1,-120864,70419,191283,-50445,0,-8013,22261,0,0,,30274,14248
51,12/18/2018,94,23:15,23:30,58.55,,0,58.55,58.55,1,-107758,80410,188168,-27348,0,0,25705,0,0,,25705,25705
51,12/18/2018,95,23:30,23:45,49.24,40.93,0,49.24,29.92,2,-83024,93559,176583,10535,0,-9891,2239,0,0,,12130,-7652
51,12/18/2018,96,23:45,0:00,52.93,37.15,0,52.93,29.93,2,-122206,115359,237565,-6847,0,-5010,2888,0,0,,7898,-2122
51,12/19/2018,1,0:00,0:15,,28.21,0,28.21,28.21,-1,-43197,87213,130410,44016,0,-11377,0,0,0,,11377,-11377
51,12/19/2018,2,0:15,0:30,,40.34,0,40.34,40.34,-1,-40798,72390,113188,31592,0,-4326,0,0,0,,4326,-4326
51,12/19/2018,3,0:30,0:45,,39.78,0,39.78,39.78,-1,-52705,68264,120969,15559,0,-17105,0,0,0,,17105,-17105
51,12/19/2018,4,0:45,1:00,,39.78,0,39.78,39.78,-1,-61297,92645,153942,31348,0,-12139,0,0,0,,12139,-12139
51,12/19/2018,5,1:00,1:15,50.71,45.03,0,50.71,45.03,2,-67828,66933,134761,-895,0,-11225,1530,0,0,,12755,-9695
51,12/19/2018,6,1:15,1:30,,42.68,0,42.68,42.68,-1,-47350,68308,115658,20958,0,-5845,0,0,0,,5845,-5845
51,12/19/2018,7,1:30,1:45,,39.68,0,39.68,39.68,-1,-38143,71287,109430,33144,0,-29664,0,0,0,,29664,-29664
51,12/19/2018,8,1:45,2:00,,37.23,0,37.23,37.23,-1,-33642,76156,109798,42514,0,-29162,0,0,0,,29162,-29162
51,12/19/2018,9,2:00,2:15,51.08,41.23,0,51.08,51.08,1,-60236,68470,128706,8234,0,-19851,61,0,0,,19912,-19790
51,12/19/2018,10,2:15,2:30,49.23,41.23,0,41.23,41.23,-1,-63750,86682,150432,22932,0,-7586,117,0,0,,7703,-7469
51,12/19/2018,11,2:30,2:45,,36.09,0,36.09,36.09,-1,-62300,116966,179266,54666,0,-40715,0,0,0,,40715,-40715
51,12/19/2018,12,2:45,3:00,,36.09,0,36.09,36.09,-1,-72190,122220,194410,50030,0,-57308,0,0,0,,57308,-57308
51,12/19/2018,13,3:00,3:15,49.23,45.03,0,49.23,49.23,1,-76326,84783,161109,8457,0,-25762,210,0,0,,25972,-25552
51,12/19/2018,14,3:15,3:30,49.23,45.23,0,49.54,45.23,2,-80342,90792,171134,10450,0,-3844,771,0,0,,4615,-3073
51,12/19/2018,15,3:30,3:45,,45.03,0,45.03,45.03,-1,-66563,81303,147866,14740,0,-12927,0,0,0,,12927,-12927
51,12/19/2018,16,3:45,4:00,,50.49,0,50.49,50.49,-1,-82969,79447,162416,-3522,0,-4179,0,0,0,,4179,-4179
51,12/19/2018,17,4:00,4:15,48.58,,0,48.58,48.58,1,-82792,79267,162059,-3525,0,0,245,0,0,,245,245
51,12/19/2018,18,4:15,4:30,57.47,,0,57.47,57.47,1,-98319,70465,168784,-27854,0,0,7217,0,0,,7217,7217
51,12/19/2018,19,4:30,4:45,57.47,,0,57.47,57.47,1,-103924,70329,174253,-33595,0,0,25222,0,0,,25222,25222
51,12/19/2018,20,4:45,5:00,64.99,,0,64.99,64.99,1,-125131,81542,206673,-43589,0,0,40424,0,0,,40424,40424
51,12/19/2018,21,5:00,5:15,48.58,39.97,0,50.37,39.97,2,-69176,101878,171054,32702,0,-5415,11340,0,0,,16755,5925
51,12/19/2018,22,5:15,5:30,51.08,48.9,0,51.08,48.9,2,-93958,95602,189560,1644,0,-8526,195,0,0,,8721,-8331
51,12/19/2018,23,5:30,5:45,56.72,48.9,0,56.72,56.72,1,-99925,77811,177736,-22114,0,-393,15309,0,0,,15702,14916
51,12/19/2018,24,5:45,6:00,57.47,,0,57.47,57.47,1,-113924,78679,192603,-35245,0,0,20201,0,0,,20201,20201
51,12/19/2018,25,6:00,6:15,57.47,20.4,0,20.4,20.4,-1,-81711,133607,215318,51896,0,-15875,5755,0,0,,21630,-10120
51,12/19/2018,26,6:15,6:30,57.4,20.03,0,57.4,20.03,2,-91347,77781,169128,-13566,0,-29244,2973,0,0,,32217,-26271
51,12/19/2018,27,6:30,6:45,73.85,20.03,0,73.85,73.85,1,-135055,72682,207737,-62373,0,-1,42105,0,0,,42106,42104
51,12/19/2018,28,6:45,7:00,57.4,,0,57.4,57.4,1,-152980,134440,287420,-18540,0,0,22203,0,0,,22203,22203
51,12/19/2018,29,7:00,7:15,57.4,-20.07,0,-20.07,-20.07,-1,-52603,141420,194023,88817,0,-37150,149,0,0,,37299,-37001
51,12/19/2018,30,7:15,7:30,51.23,31.03,0,51.23,51.23,1,-78907,87749,166656,8842,0,-35604,339,0,0,,35943,-35265
51,12/19/2018,31,7:30,7:45,73.85,31.03,0,73.85,73.85,1,-142291,100096,242387,-42195,0,-262,23019,0,0,,23281,22757
51,12/19/2018,32,7:45,8:00,258.03,,0,258.03,258.03,1,-201325,105553,306878,-95772,0,0,72793,0,0,,72793,72793
51,12/19/2018,33,8:00,8:15,258.03,-54.85,0,-54.85,-54.85,-1,-55883,131742,187625,75859,0,-17057,28275,0,0,,45332,11218
51,12/19/2018,34,8:15,8:30,52,46.46,0,52,46.46,2,-92981,88804,181785,-4177,0,-4253,1124,0,0,,5377,-3129
51,12/19/2018,35,8:30,8:45,49.25,,0,49.25,49.25,1,-93200,92015,185215,-1185,0,0,2,0,0,,2,2
51,12/19/2018,36,8:45,9:00,60.02,,0,60.02,60.02,1,-136969,98658,235627,-38311,0,0,22377,0,0,,22377,22377
51,12/19/2018,37,9:00,9:15,58.02,,0,58.02,58.02,1,-112421,81485,193906,-30936,0,0,29694,0,0,,29694,29694
51,12/19/2018,38,9:15,9:30,55.02,,0,55.02,55.02,1,-111220,81873,193093,-29347,0,0,23335,0,0,,23335,23335
51,12/19/2018,39,9:30,9:45,58.02,,0,58.02,58.02,1,-117263,80398,197661,-36865,0,0,27781,0,0,,27781,27781
51,12/19/2018,40,9:45,10:00,64.9,,0,64.9,64.9,1,-115499,74746,190245,-40753,0,0,30309,0,0,,30309,30309
51,12/19/2018,41,10:00,10:15,53.25,,0,53.25,53.25,1,-120551,97852,218403,-22699,0,0,18789,0,0,,18789,18789
51,12/19/2018,42,10:15,10:30,53.25,51.16,0,51.16,51.16,-1,-102163,131671,233834,29508,0,-856,2621,0,0,,3477,1765
51,12/19/2018,43,10:30,10:45,,51.16,0,51.16,51.16,-1,-93763,128266,222029,34503,0,-1044,0,0,0,,1044,-1044
51,12/19/2018,44,10:45,11:00,,51.17,0,51.17,51.17,-1,-86100,124826,210926,38726,0,-63,0,0,0,,63,-63
51,12/19/2018,45,11:00,11:15,,45.46,0,45.46,45.46,-1,-83073,125116,208189,42043,0,-3810,0,0,0,,3810,-3810
51,12/19/2018,46,11:15,11:30,,,0,50.5,50.5,0,-75141,100598,175739,25457,0,-1232,0,0,0,,1232,-1232
51,12/19/2018,47,11:30,11:45,,45.46,0,45.46,45.46,-1,-77000,99800,176800,22800,0,-174,0,0,0,,174,-174
51,12/19/2018,48,11:45,12:00,,44.3,0,44.3,44.3,-1,-85121,106862,191983,21741,0,-2282,0,0,0,,2282,-2282
51,12/19/2018,49,12:00,12:15,64.99,,0,64.99,64.99,1,-143145,89468,232613,-53677,0,0,11380,0,0,,11380,11380
51,12/19/2018,50,12:15,12:30,,,0,50.46,50.46,0,-116606,88437,205043,-28169,0,0,53,0,0,,53,53
51,12/19/2018,51,12:30,12:45,57.4,,0,57.4,57.4,1,-124049,81917,205966,-42132,0,0,11210,0,0,,11210,11210
51,12/19/2018,52,12:45,13:00,50.79,,0,50.79,50.79,1,-119425,85098,204523,-34327,0,0,10113,0,0,,10113,10113
51,12/19/2018,53,13:00,13:15,57.4,,0,57.4,57.4,1,-113578,92890,206468,-20688,0,0,8713,0,0,,8713,8713
51,12/19/2018,54,13:15,13:30,57.4,,0,57.4,57.4,1,-128388,91386,219774,-37002,0,0,29907,0,0,,29907,29907
51,12/19/2018,55,13:30,13:45,57.4,,0,57.4,57.4,1,-128443,91998,220441,-36445,0,0,25341,0,0,,25341,25341
51,12/19/2018,56,13:45,14:00,48.91,,0,48.91,48.91,1,-160372,93163,253535,-67209,0,0,1745,0,0,,1745,1745
51,12/19/2018,57,14:00,14:15,54.17,,0,54.17,54.17,1,-124955,95891,220846,-29064,0,0,6374,0,0,,6374,6374
51,12/19/2018,58,14:15,14:30,57.4,,0,57.4,57.4,1,-118689,96184,214873,-22505,0,0,5022,0,0,,5022,5022
51,12/19/2018,59,14:30,14:45,57.4,,0,57.4,57.4,1,-120418,86391,206809,-34027,0,0,27686,0,0,,27686,27686
51,12/19/2018,60,14:45,15:00,53.25,,0,53.25,53.25,1,-117663,85858,203521,-31805,0,0,19615,0,0,,19615,19615
51,12/19/2018,61,15:00,15:15,51.93,,0,51.93,51.93,1,-116430,76898,193328,-39532,0,0,6792,0,0,,6792,6792
51,12/19/2018,62,15:15,15:30,57.4,,0,57.4,57.4,1,-125235,72686,197921,-52549,0,0,3374,0,0,,3374,3374
51,12/19/2018,63,15:30,15:45,73.85,,0,73.85,73.85,1,-146477,74170,220647,-72307,0,0,29709,0,0,,29709,29709
51,12/19/2018,64,15:45,16:00,208.22,,0,208.22,208.22,1,-157253,79914,237167,-77339,0,0,63652,0,0,,63652,63652
51,12/19/2018,65,16:00,16:15,208.22,46.16,0,46.16,46.16,-1,-76677,127699,204376,51022,0,-881,12177,0,0,,13058,11296
51,12/19/2018,66,16:15,16:30,,,0,50.52,50.52,0,-80212,112658,192870,32446,0,0,0,0,0,,0,0
51,12/19/2018,67,16:30,16:45,53.25,,0,53.25,53.25,1,-92583,87298,179881,-5285,0,0,1054,0,0,,1054,1054
51,12/19/2018,68,16:45,17:00,248.46,,0,248.46,248.46,1,-148864,64247,213111,-84617,0,0,50227,0,0,,50227,50227
51,12/19/2018,69,17:00,17:15,70.99,41.16,0,70.99,41.16,2,-75994,98706,174700,22712,0,-2102,19561,0,0,,21663,17459
51,12/19/2018,70,17:15,17:30,48.85,,0,48.85,48.85,1,-96045,84058,180103,-11987,0,0,196,0,0,,196,196
51,12/19/2018,71,17:30,17:45,48.88,,0,48.88,48.88,1,-96380,82080,178460,-14300,0,0,1140,0,0,,1140,1140
51,12/19/2018,72,17:45,18:00,48.87,,0,48.87,48.87,1,-69767,104482,174249,34715,0,0,151,0,0,,151,151
51,12/19/2018,73,18:00,18:15,57.4,,0,57.4,57.4,1,-115214,64493,179707,-50721,0,0,11429,0,0,,11429,11429
51,12/19/2018,74,18:15,18:30,57.4,44.3,0,44.3,44.3,-1,-74163,90442,164605,16279,0,-2221,1382,0,0,,3603,-839
51,12/19/2018,75,18:30,18:45,,40.3,0,40.3,40.3,-1,-53841,89279,143120,35438,0,-29326,0,0,0,,29326,-29326
51,12/19/2018,76,18:45,19:00,,37.23,0,37.23,37.23,-1,-57152,114066,171218,56914,0,-44154,0,0,0,,44154,-44154
51,12/19/2018,77,19:00,19:15,53.25,27.03,0,53.25,27.03,2,-71109,80048,151157,8939,0,-46602,1754,0,0,,48356,-44848
51,12/19/2018,78,19:15,19:30,53.25,15.19,0,15.19,15.19,-1,-58077,118501,176578,60424,0,-19679,950,0,0,,20629,-18729
51,12/19/2018,79,19:30,19:45,,6.03,0,6.03,6.03,-1,-48724,106258,154982,57534,0,-59302,0,0,0,,59302,-59302
51,12/19/2018,80,19:45,20:00,,40.3,0,40.3,40.3,-1,-52769,108243,161012,55474,0,-53970,0,0,0,,53970,-53970
51,12/19/2018,81,20:00,20:15,57.4,52.16,0,57.4,32.27,2,-100356,57865,158221,-42491,0,-17013,3999,0,0,,21012,-13014
51,12/19/2018,82,20:15,20:30,,46.16,0,46.16,46.16,-1,-60380,75295,135675,14915,0,-3114,0,0,0,,3114,-3114
51,12/19/2018,83,20:30,20:45,,31.54,0,31.54,31.54,-1,-41787,96597,138384,54810,0,-35252,0,0,0,,35252,-35252
51,12/19/2018,84,20:45,21:00,48.74,37.15,0,48.74,32.35,2,-77928,82050,159978,4122,0,-50770,2,0,0,,50772,-50768
51,12/19/2018,85,21:00,21:15,49.25,37.15,0,49.25,49.25,1,-97357,112680,210037,15323,0,-2679,1073,0,0,,3752,-1606
51,12/19/2018,86,21:15,21:30,50.03,,0,50.03,50.03,1,-81104,71687,152791,-9417,0,0,3923,0,0,,3923,3923
51,12/19/2018,87,21:30,21:45,,45.25,0,45.25,45.25,-1,-57724,76250,133974,18526,0,-5757,0,0,0,,5757,-5757
51,12/19/2018,88,21:45,22:00,,38.6,0,38.6,38.6,-1,-49769,88237,138006,38468,0,-39803,0,0,0,,39803,-39803
51,12/19/2018,89,22:00,22:15,48.36,41.25,0,50.98,41.25,2,-76360,106644,183004,30284,0,-23884,26,0,0,,23910,-23858
51,12/19/2018,90,22:15,22:30,49.11,45.25,0,50.98,45.25,2,-89921,85360,175281,-4561,0,-2119,933,0,0,,3052,-1186
51,12/19/2018,91,22:30,22:45,,23.85,0,23.85,23.85,-1,-57407,114454,171861,57047,0,-36744,0,0,0,,36744,-36744
51,12/19/2018,92,22:45,23:00,,23.85,0,23.85,23.85,-1,-66668,125926,192594,59258,0,-64476,0,0,0,,64476,-64476
51,12/19/2018,93,23:00,23:15,50.09,23.85,0,50.09,23.85,2,-95130,90035,185165,-5095,0,-35994,1747,0,0,,37741,-34247
51,12/19/2018,94,23:15,23:30,48.41,41.25,0,48.41,41.25,2,-79696,81002,160698,1306,0,-2903,900,0,0,,3803,-2003
51,12/19/2018,95,23:30,23:45,,37.4,0,37.4,37.4,-1,-54542,88550,143092,34008,0,-16648,0,0,0,,16648,-16648
51,12/19/2018,96,23:45,0:00,,37.4,0,37.4,37.4,-1,-57731,117857,175588,60126,0,-34082,0,0,0,,34082,-34082
51,12/20/2018,1,0:00,0:15,51.16,35.35,0,51.16,35.35,2,-83038,79381,162419,-3657,0,-25906,1442,0,0,,27348,-24464
51,12/20/2018,2,0:15,0:30,,,0,30.05,30.05,0,-63273,68245,131518,4972,0,-141,193,0,0,,334,52
51,12/20/2018,3,0:30,0:45,,,0,30.06,30.06,0,-57732,67262,124994,9530,0,0,0,0,0,,0,0
51,12/20/2018,4,0:45,1:00,,39.16,0,39.16,39.16,-1,-45097,83544,128641,38447,0,-11900,0,0,0,,11900,-11900
51,12/20/2018,5,1:00,1:15,,41.78,0,41.78,41.78,-1,-76066,77633,153699,1567,0,-7632,0,0,0,,7632,-7632
51,12/20/2018,6,1:15,1:30,,,0,48.63,48.63,0,-61425,64105,125530,2680,0,0,0,0,0,,0,0
51,12/20/2018,7,1:30,1:45,,,0,30.05,30.05,0,-52836,55922,108758,3086,0,0,0,0,0,,0,0
51,12/20/2018,8,1:45,2:00,,50.18,0,50.18,50.18,-1,-49236,80550,129786,31314,0,-146,0,0,0,,146,-146
51,12/20/2018,9,2:00,2:15,,,0,48.62,48.62,0,-76150,45681,121831,-30469,0,-90,0,0,0,,90,-90
51,12/20/2018,10,2:15,2:30,,,0,48.62,48.62,0,-73549,56023,129572,-17526,0,0,0,0,0,,0,0
51,12/20/2018,11,2:30,2:45,51.16,,0,51.16,51.16,1,-81516,63410,144926,-18106,0,0,2389,0,0,,2389,2389
51,12/20/2018,12,2:45,3:00,51.16,44.22,0,44.22,44.22,-1,-74281,75580,149861,1299,0,-246,72,0,0,,318,-174
51,12/20/2018,13,3:00,3:15,51.16,44.22,0,51.16,51.16,1,-84708,65382,150090,-19326,0,-202,2951,0,0,,3153,2749
51,12/20/2018,14,3:15,3:30,49.64,,0,49.64,49.64,1,-58647,63536,122183,4889,0,0,3734,0,0,,3734,3734
51,12/20/2018,15,3:30,3:45,,,0,48.57,48.57,0,-53983,63952,117935,9969,0,0,0,0,0,,0,0
51,12/20/2018,16,3:45,4:00,,,0,48.57,48.57,0,-48379,73969,122348,25590,0,0,0,0,0,,0,0
51,12/20/2018,17,4:00,4:15,,,0,48.58,48.58,0,-42486,76002,118488,33516,0,0,0,0,0,,0,0
51,12/20/2018,18,4:15,4:30,,,0,48.58,48.58,0,-39553,67446,106999,27893,0,0,0,0,0,,0,0
51,12/20/2018,19,4:30,4:45,,,0,48.58,48.58,0,-37992,68955,106947,30963,0,0,0,0,0,,0,0
51,12/20/2018,20,4:45,5:00,,43.16,0,43.16,43.16,-1,-38094,59870,97964,21776,0,-1073,0,0,0,,1073,-1073
51,12/20/2018,21,5:00,5:15,,35.35,0,35.35,35.35,-1,-50634,82540,133174,31906,0,-12476,0,0,0,,12476,-12476
51,12/20/2018,22,5:15,5:30,,35.35,0,35.35,35.35,-1,-44968,66283,111251,21315,0,-21230,0,0,0,,21230,-21230
51,12/20/2018,23,5:30,5:45,48.22,43.16,0,48.63,43.16,2,-69708,75302,145010,5594,0,-1087,146,0,0,,1233,-941
51,12/20/2018,24,5:45,6:00,,43.16,0,43.16,43.16,-1,-57349,89614,146963,32265,0,-2497,0,0,0,,2497,-2497
51,12/20/2018,25,6:00,6:15,,,0,49.54,49.54,0,-116952,78625,195577,-38327,0,0,0,0,0,,0,0
51,12/20/2018,26,6:15,6:30,,47.55,0,47.55,47.55,-1,-100920,74928,175848,-25992,0,-194,0,0,0,,194,-194
51,12/20/2018,27,6:30,6:45,60.72,,0,60.72,60.72,1,-76181,50161,126342,-26020,0,0,10721,0,0,,10721,10721
51,12/20/2018,28,6:45,7:00,50.92,,0,50.92,50.92,1,-78176,53730,131906,-24446,0,0,14073,0,0,,14073,14073
51,12/20/2018,29,7:00,7:15,50.92,6.71,0,6.71,6.71,-1,-35477,117005,152482,81528,0,-31887,2892,0,0,,34779,-28995
51,12/20/2018,30,7:15,7:30,,38.05,0,38.05,38.05,-1,-52813,79273,132086,26460,0,-33035,0,0,0,,33035,-33035
51,12/20/2018,31,7:30,7:45,,45.51,0,45.51,45.51,-1,-73159,81452,154611,8293,0,-4927,0,0,0,,4927,-4927
51,12/20/2018,32,7:45,8:00,70.99,45.51,0,70.99,70.99,1,-126230,80925,207155,-45305,0,-270,8689,0,0,,8959,8419
51,12/20/2018,33,8:00,8:15,77.12,,0,77.12,77.12,1,-85444,39711,125155,-45733,0,0,22387,0,0,,22387,22387
51,12/20/2018,34,8:15,8:30,54.92,,0,54.92,54.92,1,-93247,34353,127600,-58894,0,0,10225,0,0,,10225,10225
51,12/20/2018,35,8:30,8:45,98.12,,0,98.12,98.12,1,-111433,25085,136518,-86348,0,0,36031,0,0,,36031,36031
51,12/20/2018,36,8:45,9:00,46.92,,0,46.92,46.92,1,-99714,21298,121012,-78416,0,0,5820,0,0,,5820,5820
51,12/20/2018,37,9:00,9:15,58.98,,0,58.98,58.98,1,-103105,39964,143069,-63141,0,0,15176,0,0,,15176,15176
51,12/20/2018,38,9:15,9:30,54.92,,0,54.92,54.92,1,-110245,38601,148846,-71644,0,0,26146,0,0,,26146,26146
51,12/20/2018,39,9:30,9:45,50.59,,0,50.59,50.59,1,-73953,41168,115121,-32785,0,0,11113,0,0,,11113,11113
51,12/20/2018,40,9:45,10:00,,,0,51.16,51.16,0,-66483,42077,108560,-24406,0,0,1123,0,0,,1123,1123
51,12/20/2018,41,10:00,10:15,184.76,,0,184.76,184.76,1,-108632,38457,147089,-70175,0,0,25916,0,0,,25916,25916
51,12/20/2018,42,10:15,10:30,54.12,,0,54.12,54.12,1,-75420,52935,128355,-22485,0,0,11723,0,0,,11723,11723
51,12/20/2018,43,10:30,10:45,48.84,,0,48.84,48.84,1,-69609,54213,123822,-15396,0,0,2438,0,0,,2438,2438
51,12/20/2018,44,10:45,11:00,50.52,,0,50.52,50.52,1,-75883,58919,134802,-16964,0,0,4009,0,0,,4009,4009
51,12/20/2018,45,11:00,11:15,52.47,,0,52.47,52.47,1,-111368,45660,157028,-65708,0,0,6358,0,0,,6358,6358
51,12/20/2018,46,11:15,11:30,54.92,,0,54.92,54.92,1,-111725,37458,149183,-74267,0,0,13472,0,0,,13472,13472
51,12/20/2018,47,11:30,11:45,50.92,,0,50.92,50.92,1,-107794,45950,153744,-61844,0,0,6975,0,0,,6975,6975
51,12/20/2018,48,11:45,12:00,50.92,,0,50.92,50.92,1,-106760,38935,145695,-67825,0,0,4576,0,0,,4576,4576
51,12/20/2018,49,12:00,12:15,70.52,,0,70.52,70.52,1,-142587,42306,184893,-100281,0,0,9010,0,0,,9010,9010
51,12/20/2018,50,12:15,12:30,,,0,51.23,51.23,0,-103605,51171,154776,-52434,0,0,753,0,0,,753,753
51,12/20/2018,51,12:30,12:45,51.29,,0,51.29,51.29,1,-98826,60699,159525,-38127,0,0,2944,0,0,,2944,2944
51,12/20/2018,52,12:45,13:00,50.92,,0,50.92,50.92,1,-92954,59410,152364,-33544,0,0,2299,0,0,,2299,2299
51,12/20/2018,53,13:00,13:15,72.12,,0,72.12,72.12,1,-95016,29885,124901,-65131,0,0,15103,0,0,,15103,15103
51,12/20/2018,54,13:15,13:30,51.29,,0,51.29,51.29,1,-96384,22153,118537,-74231,0,0,16173,0,0,,16173,16173
51,12/20/2018,55,13:30,13:45,,,0,51.25,51.25,0,-100246,26299,126545,-73947,0,0,800,0,0,,800,800
51,12/20/2018,56,13:45,14:00,,,0,51.24,51.24,0,-114910,23057,137967,-91853,0,0,0,0,0,,0,0
51,12/20/2018,57,14:00,14:15,50.92,,0,50.92,50.92,1,-116582,50062,166644,-66520,0,0,237,0,0,,237,237
51,12/20/2018,58,14:15,14:30,46.92,,0,46.92,46.92,1,-125232,35585,160817,-89647,0,0,699,0,0,,699,699
51,12/20/2018,59,14:30,14:45,46.92,,0,46.92,46.92,1,-114898,21534,136432,-93364,0,0,332,0,0,,332,332
51,12/20/2018,60,14:45,15:00,,,0,51.21,51.21,0,-127345,21014,148359,-106331,0,0,0,0,0,,0,0
51,12/20/2018,61,15:00,15:15,,54.05,0,54.05,54.05,-1,-55820,70131,125951,14311,0,-914,0,0,0,,914,-914
51,12/20/2018,62,15:15,15:30,,53.87,0,53.87,53.87,-1,-52262,77396,129658,25134,0,-3048,0,0,0,,3048,-3048
51,12/20/2018,63,15:30,15:45,,53.76,0,53.76,53.76,-1,-54997,64042,119039,9045,0,-4175,0,0,0,,4175,-4175
51,12/20/2018,64,15:45,16:00,,53.13,0,53.13,53.13,-1,-54300,54889,109189,589,0,-657,0,0,0,,657,-657
51,12/20/2018,65,16:00,16:15,,-126.53,0,-126.53,-126.53,-1,-36961,131093,168054,94132,0,-39768,0,0,0,,39768,-39768
51,12/20/2018,66,16:15,16:30,,35.14,0,35.14,35.14,-1,-38513,98900,137413,60387,0,-44314,0,0,0,,44314,-44314
51,12/20/2018,67,16:30,16:45,,41.16,0,41.16,41.16,-1,-44929,76353,121282,31424,0,-38398,0,0,0,,38398,-38398
51,12/20/2018,68,16:45,17:00,50.92,41.16,0,50.92,50.92,1,-81556,80069,161625,-1487,0,-3538,1065,0,0,,4603,-2473
51,12/20/2018,69,17:00,17:15,54.92,,0,54.92,54.92,1,-139498,96936,236434,-42562,0,0,15358,0,0,,15358,15358
51,12/20/2018,70,17:15,17:30,54.92,,0,54.92,54.92,1,-129767,90285,220052,-39482,0,0,30634,0,0,,30634,30634
51,12/20/2018,71,17:30,17:45,52.91,53.71,0,53.71,53.71,-1,-105097,94520,199617,-10577,0,-202,18379,0,0,,18581,18177
51,12/20/2018,72,17:45,18:00,52.91,42.92,0,42.92,42.92,-1,-79095,110456,189551,31361,0,-4807,644,0,0,,5451,-4163
51,12/20/2018,73,18:00,18:15,46.92,52.16,0,46.92,46.92,1,-86246,64557,150803,-21689,0,-3015,520,0,0,,3535,-2495
51,12/20/2018,74,18:15,18:30,46.92,51.65,0,51.16,51.16,2,-43176,62221,105397,19045,0,-618,422,0,0,,1040,-196
51,12/20/2018,75,18:30,18:45,,35.14,0,35.14,35.14,-1,-56639,121718,178357,65079,0,-17339,0,0,0,,17339,-17339
51,12/20/2018,76,18:45,19:00,,35.78,0,35.78,35.78,-1,-49542,106505,156047,56963,0,-37028,0,0,0,,37028,-37028
51,12/20/2018,77,19:00,19:15,56.67,47.15,0,56.67,47.15,2,-71769,42302,114071,-29467,0,-13755,6881,0,0,,20636,-6874
51,12/20/2018,78,19:15,19:30,46.92,47.15,0,46.92,46.92,1,-83933,70991,154924,-12942,0,-2,585,0,0,,587,583
51,12/20/2018,79,19:30,19:45,,42.92,0,42.92,42.92,-1,-56430,81806,138236,25376,0,-10195,0,0,0,,10195,-10195
51,12/20/2018,80,19:45,20:00,,42.92,0,42.92,42.92,-1,-56176,70301,126477,14125,0,-13993,0,0,0,,13993,-13993
51,12/20/2018,81,20:00,20:15,50.92,-22.43,0,51.01,-22.43,2,-45645,95474,141119,49829,0,-35448,396,0,0,,35844,-35052
51,12/20/2018,82,20:15,20:30,54.57,-33.88,0,54.57,-33.88,2,-20297,94305,114602,74008,0,-22598,1389,0,0,,23987,-21209
51,12/20/2018,83,20:30,20:45,,-29.08,0,-29.08,-29.08,-1,-36674,75020,111694,38346,0,-49022,0,0,0,,49022,-49022
51,12/20/2018,84,20:45,21:00,49.88,46.16,0,51.06,46.16,2,-61545,41270,102815,-20275,0,-16563,1896,0,0,,18459,-14667
51,12/20/2018,85,21:00,21:15,46.92,45.19,0,49.54,45.19,2,-76178,71288,147466,-4890,0,-997,160,0,0,,1157,-837
51,12/20/2018,86,21:15,21:30,54.92,,0,54.92,54.92,1,-59290,38539,97829,-20751,0,0,13250,0,0,,13250,13250
51,12/20/2018,87,21:30,21:45,54.92,42.92,0,42.92,42.92,-1,-30984,59527,90511,28543,0,-3188,1854,0,0,,5042,-1334
51,12/20/2018,88,21:45,22:00,,44.23,0,44.23,44.23,-1,-58891,94032,152923,35141,0,-19550,0,0,0,,19550,-19550
51,12/20/2018,89,22:00,22:15,46.92,40.78,0,46.92,46.92,1,-115702,60120,175822,-55582,0,-10166,703,0,0,,10869,-9463
51,12/20/2018,90,22:15,22:30,46.92,40.78,0,46.92,46.92,1,-85700,55000,140700,-30700,0,-7,863,0,0,,870,856
51,12/20/2018,91,22:30,22:45,,38.92,0,38.92,38.92,-1,-41895,75954,117849,34059,0,-6763,0,0,0,,6763,-6763
51,12/20/2018,92,22:45,23:00,,38.92,0,38.92,38.92,-1,-41205,94674,135879,53469,0,-35083,0,0,0,,35083,-35083
51,12/20/2018,93,23:00,23:15,,41.57,0,41.57,41.57,-1,-71641,86103,157744,14462,0,-15773,0,0,0,,15773,-15773
51,12/20/2018,94,23:15,23:30,,29.25,0,29.25,29.25,-1,-42789,107832,150621,65043,0,-12144,0,0,0,,12144,-12144
51,12/20/2018,95,23:30,23:45,,24.63,0,24.63,24.63,-1,-48038,131316,179354,83278,0,-47467,0,0,0,,47467,-47467
51,12/20/2018,96,23:45,0:00,,-51.8,0,-51.8,-51.8,-1,-48924,159583,208507,110659,0,-87344,0,0,0,,87344,-87344
51,12/21/2018,1,0:00,0:15,49.57,-107.24,0,49.57,-107.24,2,-58821,123960,182781,65139,0,-60785,156,0,0,,60941,-60629
51,12/21/2018,2,0:15,0:30,50.4,35.76,0,50.4,35.76,2,-58810,129004,187814,70194,0,-11268,255,0,0,,11523,-11013
51,12/21/2018,3,0:30,0:45,,-36.05,0,-36.05,-36.05,-1,-32650,128779,161429,96129,0,-52428,0,0,0,,52428,-52428
51,12/21/2018,4,0:45,1:00,,9.93,0,9.93,9.93,-1,-59585,153467,213052,93882,0,-74818,0,0,0,,74818,-74818
51,12/21/2018,5,1:00,1:15,,12.55,0,12.55,12.55,-1,-73065,121819,194884,48754,0,-37906,0,0,0,,37906,-37906
51,12/21/2018,6,1:15,1:30,,42.51,0,42.51,42.51,-1,-66635,116574,183209,49939,0,-3226,0,0,0,,3226,-3226
51,12/21/2018,7,1:30,1:45,,20.72,0,20.72,20.72,-1,-54129,114545,168674,60416,0,-26170,0,0,0,,26170,-26170
51,12/21/2018,8,1:45,2:00,,35.76,0,35.76,35.76,-1,-61012,111208,172220,50196,0,-50168,0,0,0,,50168,-50168
51,12/21/2018,9,2:00,2:15,,35.76,0,35.76,35.76,-1,-44341,109109,153450,64768,0,-33749,0,0,0,,33749,-33749
51,12/21/2018,10,2:15,2:30,,27.59,0,27.59,27.59,-1,-48895,91119,140014,42224,0,-9948,0,0,0,,9948,-9948
51,12/21/2018,11,2:30,2:45,,35.76,0,35.76,35.76,-1,-40503,83355,123858,42852,0,-34770,0,0,0,,34770,-34770
51,12/21/2018,12,2:45,3:00,,22.33,0,22.33,22.33,-1,-43977,99317,143294,55340,0,-45431,0,0,0,,45431,-45431
51,12/21/2018,13,3:00,3:15,,5.76,0,5.76,5.76,-1,-26108,117684,143792,91576,0,-59030,0,0,0,,59030,-59030
51,12/21/2018,14,3:15,3:30,,33.02,0,33.02,33.02,-1,-24329,107967,132296,83638,0,-45153,0,0,0,,45153,-45153
51,12/21/2018,15,3:30,3:45,,22.33,0,22.33,22.33,-1,-35750,98749,134499,62999,0,-52323,0,0,0,,52323,-52323
51,12/21/2018,16,3:45,4:00,,43.32,0,43.32,43.32,-1,-52513,75264,127777,22751,0,-14852,0,0,0,,14852,-14852
51,12/21/2018,17,4:00,4:15,,,0,46.33,46.33,0,-39468,72134,111602,32666,0,-215,0,0,0,,215,-215
51,12/21/2018,18,4:15,4:30,,,0,46.32,46.32,0,-54148,91137,145285,36989,0,0,0,0,0,,0,0
51,12/21/2018,19,4:30,4:45,,,0,46.31,46.31,0,-74893,101252,176145,26359,0,0,0,0,0,,0,0
51,12/21/2018,20,4:45,5:00,,,0,46.27,46.27,0,-94282,111846,206128,17564,0,0,0,0,0,,0,0
51,12/21/2018,21,5:00,5:15,,37.91,0,37.91,37.91,-1,-131952,143717,275669,11765,0,-5934,0,0,0,,5934,-5934
51,12/21/2018,22,5:15,5:30,,39.6,0,39.6,39.6,-1,-107559,116473,224032,8914,0,-10956,0,0,0,,10956,-10956
51,12/21/2018,23,5:30,5:45,47.6,,0,47.6,47.6,1,-132506,114417,246923,-18089,0,0,2257,0,0,,2257,2257
51,12/21/2018,24,5:45,6:00,47.6,35.76,0,35.76,35.76,-1,-112526,133393,245919,20867,0,-6146,151,0,0,,6297,-5995
51,12/21/2018,25,6:00,6:15,,37.1,0,37.1,37.1,-1,-80101,182018,262119,101917,0,-24748,0,0,0,,24748,-24748
51,12/21/2018,26,6:15,6:30,,36.05,0,36.05,36.05,-1,-83159,161942,245101,78783,0,-28234,0,0,0,,28234,-28234
51,12/21/2018,27,6:30,6:45,,45.03,0,45.03,45.03,-1,-95751,163088,258839,67337,0,-8039,0,0,0,,8039,-8039
51,12/21/2018,28,6:45,7:00,,,0,48.62,48.62,0,-124128,235212,359340,111084,0,0,0,0,0,,0,0
51,12/21/2018,29,7:00,7:15,,-7.48,0,-7.48,-7.48,-1,-72826,192513,265339,119687,0,-29109,0,0,0,,29109,-29109
51,12/21/2018,30,7:15,7:30,,-56,0,-56,-56,-1,-87048,126643,213691,39595,0,-41856,0,0,0,,41856,-41856
51,12/21/2018,31,7:30,7:45,47.92,-56,0,47.92,47.92,1,-109133,122066,231199,12933,0,-54,121,0,0,,175,67
51,12/21/2018,32,7:45,8:00,83.97,,0,83.97,83.97,1,-171672,121729,293401,-49943,0,0,16115,0,0,,16115,16115
51,12/21/2018,33,8:00,8:15,53.91,36.96,0,53.91,36.96,2,-42992,110884,153876,67892,0,-2212,7767,0,0,,9979,5555
51,12/21/2018,34,8:15,8:30,50.94,,0,50.94,50.94,1,-83084,73406,156490,-9678,0,0,652,0,0,,652,652
51,12/21/2018,35,8:30,8:45,50.93,,0,50.93,50.93,1,-105183,74011,179194,-31172,0,0,2721,0,0,,2721,2721
51,12/21/2018,36,8:45,9:00,50.93,39.92,0,39.92,39.92,-1,-113553,122085,235638,8532,0,-1847,24,0,0,,1871,-1823
51,12/21/2018,37,9:00,9:15,,27.59,0,27.59,27.59,-1,-80392,124319,204711,43927,0,-33247,0,0,0,,33247,-33247
51,12/21/2018,38,9:15,9:30,63.28,27.59,0,63.28,63.28,1,-125462,90611,216073,-34851,0,-4389,17199,0,0,,21588,12810
51,12/21/2018,39,9:30,9:45,55.92,,0,55.92,55.92,1,-123879,91936,215815,-31943,0,0,33230,0,0,,33230,33230
51,12/21/2018,40,9:45,10:00,53.34,,0,53.34,53.34,1,-130180,107019,237199,-23161,0,0,18719,0,0,,18719,18719
51,12/21/2018,41,10:00,10:15,76.93,,0,76.93,76.93,1,-151110,100505,251615,-50605,0,0,35996,0,0,,35996,35996
51,12/21/2018,42,10:15,10:30,51.03,,0,51.03,51.03,1,-131068,116680,247748,-14388,0,0,14970,0,0,,14970,14970
51,12/21/2018,43,10:30,10:45,47.92,,0,47.92,47.92,1,-120160,113457,233617,-6703,0,0,2367,0,0,,2367,2367
51,12/21/2018,44,10:45,11:00,,54.57,0,54.57,54.57,-1,-87078,122400,209478,35322,0,-379,0,0,0,,379,-379
51,12/21/2018,45,11:00,11:15,51.92,54.58,0,59.97,54.58,2,-160168,118937,279105,-41231,0,-551,1220,0,0,,1771,669
51,12/21/2018,46,11:15,11:30,47.92,53.33,0,59.97,53.33,2,-136017,133703,269720,-2314,0,-91,63,0,0,,154,-28
51,12/21/2018,47,11:30,11:45,,44.08,0,44.08,44.08,-1,-103091,131429,234520,28338,0,-15179,0,0,0,,15179,-15179
51,12/21/2018,48,11:45,12:00,,50.83,0,50.83,50.83,-1,-99400,124961,224361,25561,0,-18306,0,0,0,,18306,-18306
51,12/21/2018,49,12:00,12:15,84.02,50.83,0,84.02,84.02,1,-135166,99186,234352,-35980,0,-3677,11690,0,0,,15367,8013
51,12/21/2018,50,12:15,12:30,104.73,53.55,0,104.73,53.55,2,-99295,122462,221757,23167,0,-138,24368,0,0,,24506,24230
51,12/21/2018,51,12:30,12:45,104.73,51.58,0,51.58,51.58,-1,-61324,124470,185794,63146,0,-435,51,0,0,,486,-384
51,12/21/2018,52,12:45,13:00,,41.41,0,41.41,41.41,-1,-42295,138790,181085,96495,0,-3033,0,0,0,,3033,-3033
51,12/21/2018,53,13:00,13:15,,36.05,0,36.05,36.05,-1,-59077,129854,188931,70777,0,-8439,0,0,0,,8439,-8439
51,12/21/2018,54,13:15,13:30,,36.05,0,36.05,36.05,-1,-52544,113260,165804,60716,0,-19479,0,0,0,,19479,-19479
51,12/21/2018,55,13:30,13:45,,50.57,0,50.57,50.57,-1,-45501,113112,158613,67611,0,-13160,0,0,0,,13160,-13160
51,12/21/2018,56,13:45,14:00,47.92,,0,47.92,47.92,1,-58136,87959,146095,29823,0,0,13,0,0,,13,13
51,12/21/2018,57,14:00,14:15,55.92,,0,55.92,55.92,1,-75960,57457,133417,-18503,0,0,9336,0,0,,9336,9336
51,12/21/2018,58,14:15,14:30,55.92,53.66,0,53.66,53.66,-1,-52323,72164,124487,19841,0,-484,1473,0,0,,1957,989
51,12/21/2018,59,14:30,14:45,,46.03,0,46.03,46.03,-1,-47689,83719,131408,36030,0,-3924,0,0,0,,3924,-3924
51,12/21/2018,60,14:45,15:00,,43.92,0,43.92,43.92,-1,-62222,97024,159246,34802,0,-19318,0,0,0,,19318,-19318
51,12/21/2018,61,15:00,15:15,,43.92,0,43.92,43.92,-1,-74672,78901,153573,4229,0,-5356,0,0,0,,5356,-5356
51,12/21/2018,62,15:15,15:30,,39.92,0,39.92,39.92,-1,-83245,117009,200254,33764,0,-22858,0,0,0,,22858,-22858
51,12/21/2018,63,15:30,15:45,,45.94,0,45.94,45.94,-1,-88796,118140,206936,29344,0,-25003,0,0,0,,25003,-25003
51,12/21/2018,64,15:45,16:00,,43.92,0,43.92,43.92,-1,-89474,120839,210313,31365,0,-21898,0,0,0,,21898,-21898
51,12/21/2018,65,16:00,16:15,,6.72,0,6.72,6.72,-1,-62373,156370,218743,93997,0,-58522,0,0,0,,58522,-58522
51,12/21/2018,66,16:15,16:30,,39.92,0,39.92,39.92,-1,-75681,132064,207745,56383,0,-49679,0,0,0,,49679,-49679
51,12/21/2018,67,16:30,16:45,47.92,43.92,0,47.92,47.92,1,-91174,109511,200685,18337,0,-35068,29,0,0,,35097,-35039
51,12/21/2018,68,16:45,17:00,52.5,43.92,0,52.5,52.5,1,-104386,88403,192789,-15983,0,-3077,2233,0,0,,5310,-844
51,12/21/2018,69,17:00,17:15,,43.95,0,43.95,43.95,-1,-65860,90278,156138,24418,0,-7697,0,0,0,,7697,-7697
51,12/21/2018,70,17:15,17:30,,43.92,0,43.92,43.92,-1,-41806,76316,118122,34510,0,-16253,0,0,0,,16253,-16253
51,12/21/2018,71,17:30,17:45,,19.85,0,19.85,19.85,-1,-43138,125876,169014,82738,0,-53939,0,0,0,,53939,-53939
51,12/21/2018,72,17:45,18:00,,22.38,0,22.38,22.38,-1,-50608,159900,210508,109292,0,-86622,0,0,0,,86622,-86622
51,12/21/2018,73,18:00,18:15,,36.05,0,36.05,36.05,-1,-73242,104495,177737,31253,0,-49137,0,0,0,,49137,-49137
51,12/21/2018,74,18:15,18:30,,36.05,0,36.05,36.05,-1,-66277,132105,198382,65828,0,-47392,0,0,0,,47392,-47392
51,12/21/2018,75,18:30,18:45,,39.45,0,39.45,39.45,-1,-69721,139402,209123,69681,0,-62634,0,0,0,,62634,-62634
51,12/21/2018,76,18:45,19:00,47.92,39.92,0,47.92,47.92,1,-110907,138208,249115,27301,0,-48045,26,0,0,,48071,-48019
51,12/21/2018,77,19:00,19:15,48.95,39.92,0,48.95,48.95,1,-88406,137243,225649,48837,0,-3071,113,0,0,,3184,-2958
51,12/21/2018,78,19:15,19:30,,44.95,0,44.95,44.95,-1,-88862,136515,225377,47653,0,-831,0,0,0,,831,-831
51,12/21/2018,79,19:30,19:45,,44.95,0,44.95,44.95,-1,-82857,139324,222181,56467,0,-5207,0,0,0,,5207,-5207
51,12/21/2018,80,19:45,20:00,,46.46,0,46.46,46.46,-1,-108349,134582,242931,26233,0,-2013,0,0,0,,2013,-2013
51,12/21/2018,81,20:00,20:15,,31.4,0,31.4,31.4,-1,-112091,174306,286397,62215,0,-13399,0,0,0,,13399,-13399
51,12/21/2018,82,20:15,20:30,50.02,31.4,0,50.02,50.02,1,-157407,146427,303834,-10980,0,-322,1843,0,0,,2165,1521
51,12/21/2018,83,20:30,20:45,48.95,,0,48.95,48.95,1,-154443,144851,299294,-9592,0,0,834,0,0,,834,834
51,12/21/2018,84,20:45,21:00,56.51,,0,56.51,56.51,1,-203959,123876,327835,-80083,0,0,14981,0,0,,14981,14981
51,12/21/2018,85,21:00,21:15,49.88,,0,49.88,49.88,1,-157778,171054,328832,13276,0,0,6928,0,0,,6928,6928
51,12/21/2018,86,21:15,21:30,57.38,,0,57.38,57.38,1,-166850,129910,296760,-36940,0,0,22410,0,0,,22410,22410
51,12/21/2018,87,21:30,21:45,48.95,,0,48.95,48.95,1,-147408,121784,269192,-25624,0,0,9545,0,0,,9545,9545
51,12/21/2018,88,21:45,22:00,48.37,,0,48.37,48.37,1,-156428,119690,276118,-36738,0,0,1814,0,0,,1814,1814
51,12/21/2018,89,22:00,22:15,55.65,,0,55.65,55.65,1,-174732,132452,307184,-42280,0,0,2193,0,0,,2193,2193
51,12/21/2018,90,22:15,22:30,120.85,,0,120.85,120.85,1,-195179,98575,293754,-96604,0,0,51536,0,0,,51536,51536
51,12/21/2018,91,22:30,22:45,72.38,,0,72.38,72.38,1,-161173,74875,236048,-86298,0,0,62458,0,0,,62458,62458
51,12/21/2018,92,22:45,23:00,63.37,,0,63.37,63.37,1,-140908,74758,215666,-66150,0,0,54504,0,0,,54504,54504
51,12/21/2018,93,23:00,23:15,108.41,,0,108.41,108.41,1,-208936,108961,317897,-99975,0,0,59122,0,0,,59122,59122
51,12/21/2018,94,23:15,23:30,72.33,,0,72.33,72.33,1,-186629,111452,298081,-75177,0,0,72433,0,0,,72433,72433
51,12/21/2018,95,23:30,23:45,55.63,,0,55.63,55.63,1,-134750,108888,243638,-25862,0,0,22564,0,0,,22564,22564
51,12/21/2018,96,23:45,0:00,48.95,,0,48.95,48.95,1,-143756,115833,259589,-27923,0,0,3992,0,0,,3992,3992
52,12/22/2018,1,0:00,0:15,,,0,49.53,49.53,0,-76609,76744,153353,135,0,0,735,0,0,,735,735
52,12/22/2018,2,0:15,0:30,53.02,,0,53.02,53.02,1,-67370,53424,120794,-13946,0,0,3880,0,0,,3880,3880
52,12/22/2018,3,0:30,0:45,63.37,,0,63.37,63.37,1,-79572,33915,113487,-45657,0,0,27182,0,0,,27182,27182
52,12/22/2018,4,0:45,1:00,63.88,,0,63.88,63.88,1,-81985,40388,122373,-41597,0,0,40315,0,0,,40315,40315
52,12/22/2018,5,1:00,1:15,57.38,45.2,0,57.38,45.2,2,-86924,63998,150922,-22926,0,-1219,10397,0,0,,11616,9178
52,12/22/2018,6,1:15,1:30,63.12,,0,63.12,63.12,1,-104257,56468,160725,-47789,0,0,38000,0,0,,38000,38000
52,12/22/2018,7,1:30,1:45,94.78,,0,94.78,94.78,1,-109305,35752,145057,-73553,0,0,44124,0,0,,44124,44124
52,12/22/2018,8,1:45,2:00,66.55,,0,66.55,66.55,1,-96870,49868,146738,-47002,0,0,52662,0,0,,52662,52662
52,12/22/2018,9,2:00,2:15,84.12,50.3,0,84.12,49.34,2,-104454,41561,146015,-62893,0,-31,14880,0,0,,14911,14849
52,12/22/2018,10,2:15,2:30,177.93,,0,177.93,177.93,1,-105208,46862,152070,-58346,0,0,53299,0,0,,53299,53299
52,12/22/2018,11,2:30,2:45,59.12,,0,59.12,59.12,1,-113150,64645,177795,-48505,0,0,36413,0,0,,36413,36413
52,12/22/2018,12,2:45,3:00,66.55,,0,66.55,66.55,1,-110433,52958,163391,-57475,0,0,47188,0,0,,47188,47188
52,12/22/2018,13,3:00,3:15,46.44,42.06,0,48.05,42.06,2,-75212,84780,159992,9568,0,-3339,18220,0,0,,21559,14881
52,12/22/2018,14,3:15,3:30,53.02,,0,53.02,53.02,1,-87376,57117,144493,-30259,0,0,4596,0,0,,4596,4596
52,12/22/2018,15,3:30,3:45,53.02,,0,53.02,53.02,1,-84389,52102,136491,-32287,0,0,6501,0,0,,6501,6501
52,12/22/2018,16,3:45,4:00,49.11,,0,49.11,49.11,1,-84308,50330,134638,-33978,0,0,14777,0,0,,14777,14777
52,12/22/2018,17,4:00,4:15,54.11,,0,54.11,54.11,1,-73353,42501,115854,-30852,0,0,11782,0,0,,11782,11782
52,12/22/2018,18,4:15,4:30,53.02,,0,53.02,53.02,1,-84335,53606,137941,-30729,0,0,20277,0,0,,20277,20277
52,12/22/2018,19,4:30,4:45,72.38,,0,72.38,72.38,1,-111009,55614,166623,-55395,0,0,30652,0,0,,30652,30652
52,12/22/2018,20,4:45,5:00,85.87,,0,85.87,85.87,1,-132572,46890,179462,-85682,0,0,69051,0,0,,69051,69051
52,12/22/2018,21,5:00,5:15,63.37,,0,63.37,63.37,1,-111719,48759,160478,-62960,0,0,59471,0,0,,59471,59471
52,12/22/2018,22,5:15,5:30,63.37,,0,63.37,63.37,1,-128355,48409,176764,-79946,0,0,55657,0,0,,55657,55657
52,12/22/2018,23,5:30,5:45,118.37,,0,118.37,118.37,1,-143901,40802,184703,-103099,0,0,64675,0,0,,64675,64675
52,12/22/2018,24,5:45,6:00,73.37,,0,73.37,73.37,1,-131592,44142,175734,-87450,0,0,75005,0,0,,75005,75005
52,12/22/2018,25,6:00,6:15,57.42,45.31,0,57.42,45.31,2,-56746,59543,116289,2797,0,-1922,28411,0,0,,30333,26489
52,12/22/2018,26,6:15,6:30,48.37,,0,48.37,48.37,1,-51640,63498,115138,11858,0,0,583,0,0,,583,583
52,12/22/2018,27,6:30,6:45,49.23,,0,49.23,49.23,1,-51197,60979,112176,9782,0,0,389,0,0,,389,389
52,12/22/2018,28,6:45,7:00,50.59,,0,50.59,50.59,1,-79992,49943,129935,-30049,0,0,11047,0,0,,11047,11047
52,12/22/2018,29,7:00,7:15,50.59,14.97,0,14.97,14.97,-1,-42920,109850,152770,66930,0,-15099,553,0,0,,15652,-14546
52,12/22/2018,30,7:15,7:30,,10.78,0,10.78,10.78,-1,-45929,93287,139216,47358,0,-32380,0,0,0,,32380,-32380
52,12/22/2018,31,7:30,7:45,,,0,45.79,45.79,0,-57352,81566,138918,24214,0,-1338,0,0,0,,1338,-1338
52,12/22/2018,32,7:45,8:00,,,0,45.41,45.41,0,-64778,99027,163805,34249,0,0,0,0,0,,0,0
52,12/22/2018,33,8:00,8:15,,,0,46.89,46.89,0,-82068,71639,153707,-10429,0,0,0,0,0,,0,0
52,12/22/2018,34,8:15,8:30,,43.29,0,43.29,43.29,-1,-57327,80230,137557,22903,0,-9761,0,0,0,,9761,-9761
52,12/22/2018,35,8:30,8:45,,48.75,0,48.75,48.75,-1,-59667,76156,135823,16489,0,-892,0,0,0,,892,-892
52,12/22/2018,36,8:45,9:00,,41.78,0,41.78,41.78,-1,-53672,84474,138146,30802,0,-5473,0,0,0,,5473,-5473
52,12/22/2018,37,9:00,9:15,251.24,41.78,0,251.24,251.24,1,-124515,47544,172059,-76971,0,-650,29105,0,0,,29755,28455
52,12/22/2018,38,9:15,9:30,52.01,,0,52.01,52.01,1,-50060,88464,138524,38404,0,0,4104,0,0,,4104,4104
52,12/22/2018,39,9:30,9:45,,,0,49.58,49.58,0,-50998,74297,125295,23299,0,0,0,0,0,,0,0
52,12/22/2018,40,9:45,10:00,,50.97,0,50.97,50.97,-1,-33875,83546,117421,49671,0,-56,0,0,0,,56,-56
52,12/22/2018,41,10:00,10:15,,51.03,0,51.03,51.03,-1,-35638,68262,103900,32624,0,-149,0,0,0,,149,-149
52,12/22/2018,42,10:15,10:30,,47.56,0,47.56,47.56,-1,-37630,67212,104842,29582,0,-1473,0,0,0,,1473,-1473
52,12/22/2018,43,10:30,10:45,,47.72,0,47.72,47.72,-1,-39340,72983,112323,33643,0,-5215,0,0,0,,5215,-5215
52,12/22/2018,44,10:45,11:00,,46.78,0,46.78,46.78,-1,-44844,65549,110393,20705,0,-4407,0,0,0,,4407,-4407
52,12/22/2018,45,11:00,11:15,,37.82,0,37.82,37.82,-1,-57514,100469,157983,42955,0,-22582,0,0,0,,22582,-22582
52,12/22/2018,46,11:15,11:30,,45.78,0,45.78,45.78,-1,-50610,100224,150834,49614,0,-7494,0,0,0,,7494,-7494
52,12/22/2018,47,11:30,11:45,,51.06,0,51.06,51.06,-1,-45954,114172,160126,68218,0,-1085,0,0,0,,1085,-1085
52,12/22/2018,48,11:45,12:00,,37.25,0,37.25,37.25,-1,-43185,125021,168206,81836,0,-14488,0,0,0,,14488,-14488
52,12/22/2018,49,12:00,12:15,,44.2,0,44.2,44.2,-1,-55216,77519,132735,22303,0,-12131,0,0,0,,12131,-12131
52,12/22/2018,50,12:15,12:30,,37.25,0,37.25,37.25,-1,-44649,96194,140843,51545,0,-16568,0,0,0,,16568,-16568
52,12/22/2018,51,12:30,12:45,,40.89,0,40.89,40.89,-1,-37490,105594,143084,68104,0,-17951,0,0,0,,17951,-17951
52,12/22/2018,52,12:45,13:00,,44.2,0,44.2,44.2,-1,-30948,114307,145255,83359,0,-2981,0,0,0,,2981,-2981
52,12/22/2018,53,13:00,13:15,,37.78,0,37.78,37.78,-1,-46186,103652,149838,57466,0,-4901,0,0,0,,4901,-4901
52,12/22/2018,54,13:15,13:30,,37.25,0,37.25,37.25,-1,-47349,95711,143060,48362,0,-13409,0,0,0,,13409,-13409
52,12/22/2018,55,13:30,13:45,,42.78,0,42.78,42.78,-1,-52176,86268,138444,34092,0,-31274,0,0,0,,31274,-31274
52,12/22/2018,56,13:45,14:00,,44.2,0,44.2,44.2,-1,-54356,77005,131361,22649,0,-19265,0,0,0,,19265,-19265
52,12/22/2018,57,14:00,14:15,,37.25,0,37.25,37.25,-1,-62110,112991,175101,50881,0,-23832,0,0,0,,23832,-23832
52,12/22/2018,58,14:15,14:30,,44.2,0,44.2,44.2,-1,-64844,83367,148211,18523,0,-22910,0,0,0,,22910,-22910
52,12/22/2018,59,14:30,14:45,,53.39,0,53.39,53.39,-1,-63276,76555,139831,13279,0,-7473,0,0,0,,7473,-7473
52,12/22/2018,60,14:45,15:00,,52.61,0,52.61,52.61,-1,-67465,57104,124569,-10361,0,-1481,0,0,0,,1481,-1481
52,12/22/2018,61,15:00,15:15,,55.27,0,55.27,55.27,-1,-57897,65822,123719,7925,0,-640,0,0,0,,640,-640
52,12/22/2018,62,15:15,15:30,,,0,27.66,27.66,0,-73755,46113,119868,-27642,0,0,0,0,0,,0,0
52,12/22/2018,63,15:30,15:45,,,0,51.74,51.74,0,-92894,63424,156318,-29470,0,0,0,0,0,,0,0
52,12/22/2018,64,15:45,16:00,,,0,51.73,51.73,0,-98564,61416,159980,-37148,0,0,0,0,0,,0,0
52,12/22/2018,65,16:00,16:15,,54.26,0,54.26,54.26,-1,-64221,82956,147177,18735,0,-1108,0,0,0,,1108,-1108
52,12/22/2018,66,16:15,16:30,52.2,55.4,0,52.2,52.2,1,-91808,52382,144190,-39426,0,-298,803,0,0,,1101,505
52,12/22/2018,67,16:30,16:45,234.91,,0,234.91,234.91,1,-126558,36991,163549,-89567,0,0,47518,0,0,,47518,47518
52,12/22/2018,68,16:45,17:00,234.91,,0,234.91,234.91,1,-181174,34225,215399,-146949,0,0,103215,0,0,,103215,103215
52,12/22/2018,69,17:00,17:15,243.57,,0,243.57,243.57,1,-119070,52157,171227,-66913,0,0,64759,6250,0,,71009,71009
52,12/22/2018,70,17:15,17:30,56.2,,0,56.2,56.2,1,-77500,46539,124039,-30961,0,0,2127,0,0,,2127,2127
52,12/22/2018,71,17:30,17:45,72.61,,0,72.61,72.61,1,-85526,37027,122553,-48499,0,0,35148,0,0,,35148,35148
52,12/22/2018,72,17:45,18:00,103.3,,0,103.3,103.3,1,-94974,43467,138441,-51507,0,0,52551,0,0,,52551,52551
52,12/22/2018,73,18:00,18:15,272.76,,0,272.76,272.76,1,-156507,53583,210090,-102924,0,0,72146,0,0,,72146,72146
52,12/22/2018,74,18:15,18:30,62.97,,0,62.97,62.97,1,-107815,90219,198034,-17596,0,0,33166,0,0,,33166,33166
52,12/22/2018,75,18:30,18:45,48.2,,0,48.2,48.2,1,-89250,77635,166885,-11615,0,0,696,0,0,,696,696
52,12/22/2018,76,18:45,19:00,56.2,,0,56.2,56.2,1,-83062,73876,156938,-9186,0,0,4446,0,0,,4446,4446
52,12/22/2018,77,19:00,19:15,71.82,,0,71.82,71.82,1,-93768,50350,144118,-43418,0,0,27465,0,0,,27465,27465
52,12/22/2018,78,19:15,19:30,52.47,53.72,0,53.72,53.72,-1,-56427,68694,125121,12267,0,-152,11774,0,0,,11926,11622
52,12/22/2018,79,19:30,19:45,52.47,48.35,0,48.35,48.35,-1,-36154,60201,96355,24047,0,-851,159,0,0,,1010,-692
52,12/22/2018,80,19:45,20:00,,37.25,0,37.25,37.25,-1,-30764,108224,138988,77460,0,-12275,0,0,0,,12275,-12275
52,12/22/2018,81,20:00,20:15,71.82,22.78,0,71.82,22.78,2,-68210,41103,109313,-27107,0,-12855,8574,0,0,,21429,-4281
52,12/22/2018,82,20:15,20:30,48.2,44.2,0,44.2,44.2,-1,-38584,61047,99631,22463,0,-188,1175,0,0,,1363,987
52,12/22/2018,83,20:30,20:45,,37.25,0,37.25,37.25,-1,-19812,89389,109201,69577,0,-3344,0,0,0,,3344,-3344
52,12/22/2018,84,20:45,21:00,,37.25,0,37.25,37.25,-1,-19904,88671,108575,68767,0,-25589,0,0,0,,25589,-25589
52,12/22/2018,85,21:00,21:15,148.48,22.42,0,148.48,22.42,2,-64870,57134,122004,-7736,0,-23035,7373,0,0,,30408,-15662
52,12/22/2018,86,21:15,21:30,163.33,22.42,0,163.33,163.33,1,-54317,42356,96673,-11961,0,-31,14794,0,0,,14825,14763
52,12/22/2018,87,21:30,21:45,,,0,51.83,51.83,0,-56364,83146,139510,26782,0,0,178,0,0,,178,178
52,12/22/2018,88,21:45,22:00,,50.96,0,50.96,50.96,-1,-52576,83950,136526,31374,0,-2478,0,0,0,,2478,-2478
52,12/22/2018,89,22:00,22:15,71.82,43.91,0,71.82,43.91,2,-58886,30779,89665,-28107,0,-3520,8106,0,0,,11626,4586
52,12/22/2018,90,22:15,22:30,71.82,53.13,0,71.82,51.7,2,-38375,41943,80318,3568,0,-30,13393,0,0,,13423,13363
52,12/22/2018,91,22:30,22:45,71.82,50.05,0,50.05,50.05,-1,-46691,85620,132311,38929,0,-672,363,0,0,,1035,-309
52,12/22/2018,92,22:45,23:00,,53.64,0,53.64,53.64,-1,-33204,75459,108663,42255,0,-205,0,0,0,,205,-205
52,12/22/2018,93,23:00,23:15,71.82,-128.28,0,71.82,-128.28,2,-40825,45286,86111,4461,0,-10874,3062,0,0,,13936,-7812
52,12/22/2018,94,23:15,23:30,71.82,,0,71.82,71.82,1,-69007,41338,110345,-27669,0,0,21719,0,0,,21719,21719
52,12/22/2018,95,23:30,23:45,71.82,45.89,0,45.89,45.89,-1,-61898,66309,128207,4411,0,-1627,4294,0,0,,5921,2667
52,12/22/2018,96,23:45,0:00,,37.25,0,37.25,37.25,-1,-62771,97410,160181,34639,0,-15345,0,0,0,,15345,-15345
52,12/23/2018,1,0:00,0:15,50.66,21.92,0,50.66,21.92,2,-34741,58944,93685,24203,0,-37516,358,0,0,,37874,-37158
52,12/23/2018,2,0:15,0:30,51.23,44.98,0,51.23,44.98,2,-31442,38788,70230,7346,0,-5339,739,0,0,,6078,-4600
52,12/23/2018,3,0:30,0:45,48.26,50.15,0,49.21,49.21,2,-52542,51368,103910,-1174,0,-48,706,0,0,,754,658
52,12/23/2018,4,0:45,1:00,,45.42,0,45.42,45.42,-1,-56719,67440,124159,10721,0,-9562,0,0,0,,9562,-9562
52,12/23/2018,5,1:00,1:15,50.66,45.42,0,50.66,45.42,2,-94367,80451,174818,-13916,0,-2921,2971,0,0,,5892,50
52,12/23/2018,6,1:15,1:30,55.58,,0,55.58,55.58,1,-87124,51064,138188,-36060,0,0,11549,0,0,,11549,11549
52,12/23/2018,7,1:30,1:45,,,0,24.46,24.46,0,-60136,41201,101337,-18935,0,0,231,0,0,,231,231
52,12/23/2018,8,1:45,2:00,49.42,,0,49.42,49.42,1,-56764,41793,98557,-14971,0,0,644,0,0,,644,644
52,12/23/2018,9,2:00,2:15,51.28,,0,51.28,51.28,1,-69061,83142,152203,14081,0,0,1448,0,0,,1448,1448
52,12/23/2018,10,2:15,2:30,53.51,,0,53.51,53.51,1,-50135,45062,95197,-5073,0,0,8851,0,0,,8851,8851
52,12/23/2018,11,2:30,2:45,48.26,,0,48.26,48.26,1,-50260,55807,106067,5547,0,0,110,0,0,,110,110
52,12/23/2018,12,2:45,3:00,53.42,,0,53.42,53.42,1,-58099,61122,119221,3023,0,0,2864,0,0,,2864,2864
52,12/23/2018,13,3:00,3:15,,,0,49.24,49.24,0,-57099,67563,124662,10464,0,0,272,0,0,,272,272
52,12/23/2018,14,3:15,3:30,,,0,49.24,49.24,0,-58280,92850,151130,34570,0,0,0,0,0,,0,0
52,12/23/2018,15,3:30,3:45,,45.46,0,45.46,45.46,-1,-63091,83360,146451,20269,0,-182,0,0,0,,182,-182
52,12/23/2018,16,3:45,4:00,,41.42,0,41.42,41.42,-1,-67457,92980,160437,25523,0,-18231,0,0,0,,18231,-18231
52,12/23/2018,17,4:00,4:15,,41.06,0,41.06,41.06,-1,-43947,112038,155985,68091,0,-17650,0,0,0,,17650,-17650
52,12/23/2018,18,4:15,4:30,,36.61,0,36.61,36.61,-1,-48330,116251,164581,67921,0,-37489,0,0,0,,37489,-37489
52,12/23/2018,19,4:30,4:45,,37.42,0,37.42,37.42,-1,-61879,109920,171799,48041,0,-41539,0,0,0,,41539,-41539
52,12/23/2018,20,4:45,5:00,,29.95,0,29.95,29.95,-1,-62662,113236,175898,50574,0,-41275,0,0,0,,41275,-41275
52,12/23/2018,21,5:00,5:15,,22.46,0,22.46,22.46,-1,-54269,127599,181868,73330,0,-66175,0,0,0,,66175,-66175
52,12/23/2018,22,5:15,5:30,,37.31,0,37.31,37.31,-1,-63934,112027,175961,48093,0,-45752,0,0,0,,45752,-45752
52,12/23/2018,23,5:30,5:45,,30.48,0,30.48,30.48,-1,-62306,115725,178031,53419,0,-52346,0,0,0,,52346,-52346
52,12/23/2018,24,5:45,6:00,,10.93,0,10.93,10.93,-1,-50809,126708,177517,75899,0,-64662,0,0,0,,64662,-64662
52,12/23/2018,25,6:00,6:15,48.3,41.45,0,48.3,48.3,1,-76881,85842,162723,8961,0,-22092,350,0,0,,22442,-21742
52,12/23/2018,26,6:15,6:30,,41.45,0,41.45,41.45,-1,-58969,77961,136930,18992,0,-18521,0,0,0,,18521,-18521
52,12/23/2018,27,6:30,6:45,53.45,46.35,0,53.45,53.45,1,-62044,48550,110594,-13494,0,-3879,3187,0,0,,7066,-692
52,12/23/2018,28,6:45,7:00,60.66,,0,60.66,60.66,1,-83579,37255,120834,-46324,0,0,22560,0,0,,22560,22560
52,12/23/2018,29,7:00,7:15,49.45,43.85,0,49.55,43.85,2,-48841,70213,119054,21372,0,-5047,7229,0,0,,12276,2182
52,12/23/2018,30,7:15,7:30,,45.45,0,45.45,45.45,-1,-62089,76140,138229,14051,0,-13449,0,0,0,,13449,-13449
52,12/23/2018,31,7:30,7:45,,47.62,0,47.62,47.62,-1,-59641,75698,135339,16057,0,-3118,0,0,0,,3118,-3118
52,12/23/2018,32,7:45,8:00,,41.45,0,41.45,41.45,-1,-62965,105732,168697,42767,0,-9925,0,0,0,,9925,-9925
52,12/23/2018,33,8:00,8:15,50.36,,0,50.36,50.36,1,-86479,83518,169997,-2961,0,0,271,0,0,,271,271
52,12/23/2018,34,8:15,8:30,53.45,,0,53.45,53.45,1,-71196,60279,131475,-10917,0,0,7347,0,0,,7347,7347
52,12/23/2018,35,8:30,8:45,49.45,,0,49.45,49.45,1,-74113,70629,144742,-3484,0,0,1534,0,0,,1534,1534
52,12/23/2018,36,8:45,9:00,48.26,,0,48.26,48.26,1,-72055,61506,133561,-10549,0,0,631,0,0,,631,631
52,12/23/2018,37,9:00,9:15,48.3,,0,48.3,48.3,1,-76309,105593,181902,29284,0,0,1178,0,0,,1178,1178
52,12/23/2018,38,9:15,9:30,49.45,,0,49.45,49.45,1,-86312,86823,173135,511,0,0,1242,0,0,,1242,1242
52,12/23/2018,39,9:30,9:45,57.53,,0,57.53,57.53,1,-90010,62410,152420,-27600,0,0,16544,0,0,,16544,16544
52,12/23/2018,40,9:45,10:00,72.59,,0,72.59,72.59,1,-102386,51952,154338,-50434,0,0,33751,0,0,,33751,33751
52,12/23/2018,41,10:00,10:15,62.02,,0,62.02,62.02,1,-92267,68026,160293,-24241,0,0,28852,0,0,,28852,28852
52,12/23/2018,42,10:15,10:30,53.45,,0,53.45,53.45,1,-85582,66590,152172,-18992,0,0,14763,0,0,,14763,14763
52,12/23/2018,43,10:30,10:45,57.53,,0,57.53,57.53,1,-102597,63139,165736,-39458,0,0,27999,0,0,,27999,27999
52,12/23/2018,44,10:45,11:00,136.22,,0,136.22,136.22,1,-115067,40048,155115,-75019,0,0,56408,0,0,,56408,56408
52,12/23/2018,45,11:00,11:15,66.02,,0,66.02,66.02,1,-112433,71206,183639,-41227,0,0,41857,0,0,,41857,41857
52,12/23/2018,46,11:15,11:30,152.02,,0,152.02,152.02,1,-133209,50917,184126,-82292,0,0,65004,0,0,,65004,65004
52,12/23/2018,47,11:30,11:45,270,,0,270,270,1,-124205,57722,181927,-66483,0,0,66019,10000,0,,76019,76019
52,12/23/2018,48,11:45,12:00,270,,0,270,270,1,-100109,72109,172218,-28000,0,0,19999,10000,0,,29999,29999
52,12/23/2018,49,12:00,12:15,52.33,,0,52.33,52.33,1,-86412,86356,172768,-56,0,0,2917,0,0,,2917,2917
52,12/23/2018,50,12:15,12:30,72.21,,0,72.21,72.21,1,-101653,54194,155847,-47459,0,0,32794,0,0,,32794,32794
52,12/23/2018,51,12:30,12:45,75.1,,0,75.1,75.1,1,-110286,49376,159662,-60910,0,0,55529,0,0,,55529,55529
52,12/23/2018,52,12:45,13:00,120.95,,0,120.95,120.95,1,-113716,36390,150106,-77326,0,0,56983,0,0,,56983,56983
52,12/23/2018,53,13:00,13:15,120.95,46.29,0,46.29,46.29,-1,-22144,105965,128109,83821,0,-1490,13390,0,0,,14880,11900
52,12/23/2018,54,13:15,13:30,,,0,52.19,52.19,0,-32184,61355,93539,29171,0,0,0,0,0,,0,0
52,12/23/2018,55,13:30,13:45,,,0,52.19,52.19,0,-23184,61509,84693,38325,0,0,0,0,0,,0,0
52,12/23/2018,56,13:45,14:00,,,0,52.19,52.19,0,-24625,56333,80958,31708,0,0,0,0,0,,0,0
52,12/23/2018,57,14:00,14:15,48.33,,0,48.33,48.33,1,-34563,39741,74304,5178,0,0,512,0,0,,512,512
52,12/23/2018,58,14:15,14:30,51.74,,0,51.74,51.74,1,-39426,28281,67707,-11145,0,0,5754,0,0,,5754,5754
52,12/23/2018,59,14:30,14:45,56.33,,0,56.33,56.33,1,-60421,29660,90081,-30761,0,0,17734,0,0,,17734,17734
52,12/23/2018,60,14:45,15:00,52.33,,0,52.33,52.33,1,-59655,22166,81821,-37489,0,0,22822,0,0,,22822,22822
52,12/23/2018,61,15:00,15:15,52.33,,0,52.33,52.33,1,-52595,29096,81691,-23499,0,0,19737,0,0,,19737,19737
52,12/23/2018,62,15:15,15:30,52.33,,0,52.33,52.33,1,-73543,27963,101506,-45580,0,0,17476,0,0,,17476,17476
52,12/23/2018,63,15:30,15:45,52.33,,0,52.33,52.33,1,-85677,28777,114454,-56900,0,0,13975,0,0,,13975,13975
52,12/23/2018,64,15:45,16:00,55.63,,0,55.63,55.63,1,-94951,29825,124776,-65126,0,0,24752,0,0,,24752,24752
52,12/23/2018,65,16:00,16:15,48.33,46.03,0,52.26,46.03,2,-26735,61735,88470,35000,0,-2883,5315,0,0,,8198,2432
52,12/23/2018,66,16:15,16:30,,,0,52.16,52.16,0,-42005,62029,104034,20024,0,-2,0,0,0,,2,-2
52,12/23/2018,67,16:30,16:45,52.33,,0,52.33,52.33,1,-57871,45849,103720,-12022,0,0,1881,0,0,,1881,1881
52,12/23/2018,68,16:45,17:00,56.33,,0,56.33,56.33,1,-102429,38357,140786,-64072,0,0,23454,0,0,,23454,23454
52,12/23/2018,69,17:00,17:15,52.66,5.32,0,5.32,5.32,-1,-29689,103444,133133,73755,0,-7741,9322,0,0,,17063,1581
52,12/23/2018,70,17:15,17:30,52.66,-27.41,0,-27.41,-27.41,-1,-23713,68459,92172,44746,0,-44161,14,0,0,,44175,-44147
52,12/23/2018,71,17:30,17:45,,32.15,0,32.15,32.15,-1,-15825,77236,93061,61411,0,-27339,0,0,0,,27339,-27339
52,12/23/2018,72,17:45,18:00,,32.09,0,32.09,32.09,-1,-12752,117533,130285,104781,0,-30143,0,0,0,,30143,-30143
52,12/23/2018,73,18:00,18:15,,22.59,0,22.59,22.59,-1,-28107,70309,98416,42202,0,-6040,0,0,0,,6040,-6040
52,12/23/2018,74,18:15,18:30,,16.03,0,16.03,16.03,-1,-33758,78269,112027,44511,0,-38801,0,0,0,,38801,-38801
52,12/23/2018,75,18:30,18:45,,-19.66,0,-19.66,-19.66,-1,-19021,102358,121379,83337,0,-50243,0,0,0,,50243,-50243
52,12/23/2018,76,18:45,19:00,,-1.65,0,-1.65,-1.65,-1,-23965,102486,126451,78521,0,-74096,0,0,0,,74096,-74096
52,12/23/2018,77,19:00,19:15,,41.45,0,41.45,41.45,-1,-57439,71341,128780,13902,0,-29813,0,0,0,,29813,-29813
52,12/23/2018,78,19:15,19:30,,37.46,0,37.46,37.46,-1,-42217,84807,127024,42590,0,-17454,0,0,0,,17454,-17454
52,12/23/2018,79,19:30,19:45,,41.45,0,41.45,41.45,-1,-35652,79385,115037,43733,0,-35176,0,0,0,,35176,-35176
52,12/23/2018,80,19:45,20:00,,37.46,0,37.46,37.46,-1,-32889,85101,117990,52212,0,-45977,0,0,0,,45977,-45977
52,12/23/2018,81,20:00,20:15,50.98,30.85,0,52.09,30.85,2,-65485,61261,126746,-4224,0,-35109,343,0,0,,35452,-34766
52,12/23/2018,82,20:15,20:30,51.62,15.31,0,52.13,15.31,2,-52881,90907,143788,38026,0,-10984,689,0,0,,11673,-10295
52,12/23/2018,83,20:30,20:45,,17.05,0,17.05,17.05,-1,-45868,95504,141372,49636,0,-47847,0,0,0,,47847,-47847
52,12/23/2018,84,20:45,21:00,,9.11,0,9.11,9.11,-1,-39538,122101,161639,82563,0,-63765,0,0,0,,63765,-63765
52,12/23/2018,85,21:00,21:15,,-71.19,0,-71.19,-71.19,-1,-20203,107788,127991,87585,0,-49963,0,0,0,,49963,-49963
52,12/23/2018,86,21:15,21:30,,,0,49.5,49.5,0,-27248,64623,91871,37375,0,-402,0,0,0,,402,-402
52,12/23/2018,87,21:30,21:45,,,0,49.56,49.56,0,-44713,82022,126735,37309,0,0,0,0,0,,0,0
52,12/23/2018,88,21:45,22:00,,45.45,0,45.45,45.45,-1,-73472,94374,167846,20902,0,-3040,0,0,0,,3040,-3040
52,12/23/2018,89,22:00,22:15,52.33,45.45,0,52.33,52.33,1,-69405,34044,103449,-35361,0,-346,3499,0,0,,3845,3153
52,12/23/2018,90,22:15,22:30,,37.95,0,37.95,37.95,-1,-44506,63851,108357,19345,0,-5631,0,0,0,,5631,-5631
52,12/23/2018,91,22:30,22:45,,37.46,0,37.46,37.46,-1,-47492,78259,125751,30767,0,-11657,0,0,0,,11657,-11657
52,12/23/2018,92,22:45,23:00,,41.45,0,41.45,41.45,-1,-31887,107048,138935,75161,0,-1926,0,0,0,,1926,-1926
52,12/23/2018,93,23:00,23:15,,37.46,0,37.46,37.46,-1,-65132,77362,142494,12230,0,-7249,0,0,0,,7249,-7249
52,12/23/2018,94,23:15,23:30,,29.7,0,29.7,29.7,-1,-43251,86068,129319,42817,0,-19836,0,0,0,,19836,-19836
52,12/23/2018,95,23:30,23:45,,12.74,0,12.74,12.74,-1,-49655,128098,177753,78443,0,-63985,0,0,0,,63985,-63985
52,12/23/2018,96,23:45,0:00,,37.46,0,37.46,37.46,-1,-39730,93795,133525,54065,0,-52854,0,0,0,,52854,-52854
52,12/24/2018,1,0:00,0:15,,37.45,0,37.45,37.45,-1,-38170,96784,134954,58614,0,-16352,0,0,0,,16352,-16352
52,12/24/2018,2,0:15,0:30,,22.59,0,22.59,22.59,-1,-30949,71048,101997,40099,0,-4347,0,0,0,,4347,-4347
52,12/24/2018,3,0:30,0:45,,-55.02,0,-55.02,-55.02,-1,-40393,78300,118693,37907,0,-34685,0,0,0,,34685,-34685
52,12/24/2018,4,0:45,1:00,,-150.78,0,-150.78,-150.78,-1,-43838,104744,148582,60906,0,-33452,0,0,0,,33452,-33452
52,12/24/2018,5,1:00,1:15,,7.46,0,7.46,7.46,-1,-31922,145024,176946,113102,0,-35744,0,0,0,,35744,-35744
52,12/24/2018,6,1:15,1:30,,3.88,0,3.88,3.88,-1,-42933,135175,178108,92242,0,-50674,0,0,0,,50674,-50674
52,12/24/2018,7,1:30,1:45,,-6.51,0,-6.51,-6.51,-1,-32893,139542,172435,106649,0,-49197,0,0,0,,49197,-49197
52,12/24/2018,8,1:45,2:00,,-150.78,0,-150.78,-150.78,-1,-53724,98780,152504,45056,0,-51041,0,0,0,,51041,-51041
52,12/24/2018,9,2:00,2:15,,22.59,0,22.59,22.59,-1,-32288,191544,223832,159256,0,-33625,0,0,0,,33625,-33625
52,12/24/2018,10,2:15,2:30,,-150.78,0,-150.78,-150.78,-1,-33527,197300,230827,163773,0,-56577,0,0,0,,56577,-56577
52,12/24/2018,11,2:30,2:45,,-150.78,0,-150.78,-150.78,-1,-48367,88851,137218,40484,0,-47882,0,0,0,,47882,-47882
52,12/24/2018,12,2:45,3:00,49.97,-150.78,0,49.97,-150.78,2,-19427,76997,96424,57570,0,-46578,99,0,0,,46677,-46479
52,12/24/2018,13,3:00,3:15,53.99,35.45,0,53.99,35.45,2,-21429,88922,110351,67493,0,-8312,1819,0,0,,10131,-6493
52,12/24/2018,14,3:15,3:30,,31.45,0,31.45,31.45,-1,-38141,135645,173786,97504,0,-22056,0,0,0,,22056,-22056
52,12/24/2018,15,3:30,3:45,,41.78,0,41.78,41.78,-1,-42956,123264,166220,80308,0,-23560,0,0,0,,23560,-23560
52,12/24/2018,16,3:45,4:00,,42.78,0,42.78,42.78,-1,-46265,116871,163136,70606,0,-9444,0,0,0,,9444,-9444
52,12/24/2018,17,4:00,4:15,,46.68,0,46.68,46.68,-1,-56200,58623,114823,2423,0,-102,0,0,0,,102,-102
52,12/24/2018,18,4:15,4:30,49.9,,0,49.9,49.9,1,-76100,70795,146895,-5305,0,0,760,0,0,,760,760
52,12/24/2018,19,4:30,4:45,57.68,,0,57.68,57.68,1,-98658,41115,139773,-57543,0,0,28073,0,0,,28073,28073
52,12/24/2018,20,4:45,5:00,57.45,,0,57.45,57.45,1,-119286,67587,186873,-51699,0,0,46061,0,0,,46061,46061
52,12/24/2018,21,5:00,5:15,53.45,46.12,0,53.45,46.12,2,-95803,94866,190669,-937,0,-1104,15486,0,0,,16590,14382
52,12/24/2018,22,5:15,5:30,54.26,,0,54.26,54.26,1,-89930,76435,166365,-13495,0,0,3382,0,0,,3382,3382
52,12/24/2018,23,5:30,5:45,57.45,,0,57.45,57.45,1,-106434,53653,160087,-52781,0,0,36153,0,0,,36153,36153
52,12/24/2018,24,5:45,6:00,70.91,,0,70.91,70.91,1,-108911,54001,162912,-54910,0,0,48327,0,0,,48327,48327
52,12/24/2018,25,6:00,6:15,70.91,45.78,0,45.78,45.78,-1,-42081,129613,171694,87532,0,-1759,10066,0,0,,11825,8307
52,12/24/2018,26,6:15,6:30,,45.45,0,45.45,45.45,-1,-36010,117787,153797,81777,0,-710,0,0,0,,710,-710
52,12/24/2018,27,6:30,6:45,,46.86,0,46.86,46.86,-1,-40892,124956,165848,84064,0,-3651,0,0,0,,3651,-3651
52,12/24/2018,28,6:45,7:00,,,0,48.36,48.36,0,-74720,111891,186611,37171,0,0,0,0,0,,0,0
52,12/24/2018,29,7:00,7:15,,37.45,0,37.45,37.45,-1,-69585,129787,199372,60202,0,-19207,0,0,0,,19207,-19207
52,12/24/2018,30,7:15,7:30,,41.45,0,41.45,41.45,-1,-81414,102488,183902,21074,0,-24327,0,0,0,,24327,-24327
52,12/24/2018,31,7:30,7:45,49.45,41.45,0,49.45,49.45,1,-69596,78394,147990,8798,0,-907,879,0,0,,1786,-28
52,12/24/2018,32,7:45,8:00,48.15,,0,48.15,48.15,1,-56405,82020,138425,25615,0,0,919,0,0,,919,919
52,12/24/2018,33,8:00,8:15,52.63,,0,52.63,52.63,1,-91116,76200,167316,-14916,0,0,3880,0,0,,3880,3880
52,12/24/2018,34,8:15,8:30,50.13,,0,50.13,50.13,1,-86653,75248,161901,-11405,0,0,5366,0,0,,5366,5366
52,12/24/2018,35,8:30,8:45,57.45,,0,57.45,57.45,1,-86968,60251,147219,-26717,0,0,10081,0,0,,10081,10081
52,12/24/2018,36,8:45,9:00,57.45,,0,57.45,57.45,1,-93290,68750,162040,-24540,0,0,20734,0,0,,20734,20734
52,12/24/2018,37,9:00,9:15,52.28,,0,52.28,52.28,1,-93089,80103,173192,-12986,0,0,11284,0,0,,11284,11284
52,12/24/2018,38,9:15,9:30,52.28,,0,52.28,52.28,1,-81936,66982,148918,-14954,0,0,11844,0,0,,11844,11844
52,12/24/2018,39,9:30,9:45,56.28,,0,56.28,56.28,1,-91855,56217,148072,-35638,0,0,21947,0,0,,21947,21947
52,12/24/2018,40,9:45,10:00,54.3,,0,54.3,54.3,1,-95543,89114,184657,-6429,0,0,15986,0,0,,15986,15986
52,12/24/2018,41,10:00,10:15,56.28,,0,56.28,56.28,1,-96640,78993,175633,-17647,0,0,9013,0,0,,9013,9013
52,12/24/2018,42,10:15,10:30,56.28,48.5,0,48.5,48.5,-1,-81622,100395,182017,18773,0,-581,841,0,0,,1422,260
52,12/24/2018,43,10:30,10:45,,37.41,0,37.41,37.41,-1,-75946,136731,212677,60785,0,-16500,0,0,0,,16500,-16500
52,12/24/2018,44,10:45,11:00,,15.93,0,15.93,15.93,-1,-77867,169929,247796,92062,0,-39405,0,0,0,,39405,-39405
52,12/24/2018,45,11:00,11:15,,32.85,0,32.85,32.85,-1,-73449,116204,189653,42755,0,-32558,0,0,0,,32558,-32558
52,12/24/2018,46,11:15,11:30,,12.74,0,12.74,12.74,-1,-80195,149527,229722,69332,0,-60915,0,0,0,,60915,-60915
52,12/24/2018,47,11:30,11:45,,22.45,0,22.45,22.45,-1,-73708,143794,217502,70086,0,-50932,0,0,0,,50932,-50932
52,12/24/2018,48,11:45,12:00,,9.96,0,9.96,9.96,-1,-75792,167613,243405,91821,0,-81145,0,0,0,,81145,-81145
52,12/24/2018,49,12:00,12:15,,32.32,0,32.32,32.32,-1,-85034,134581,219615,49547,0,-35227,0,0,0,,35227,-35227
52,12/24/2018,50,12:15,12:30,,7.84,0,7.84,7.84,-1,-88941,157772,246713,68831,0,-59328,0,0,0,,59328,-59328
52,12/24/2018,51,12:30,12:45,,37.41,0,37.41,37.41,-1,-80927,157255,238182,76328,0,-55681,0,0,0,,55681,-55681
52,12/24/2018,52,12:45,13:00,,29.89,0,29.89,29.89,-1,-82429,172219,254648,89790,0,-71643,0,0,0,,71643,-71643
52,12/24/2018,53,13:00,13:15,,36.46,0,36.46,36.46,-1,-88603,133567,222170,44964,0,-50918,0,0,0,,50918,-50918
52,12/24/2018,54,13:15,13:30,,37.41,0,37.41,37.41,-1,-90164,136506,226670,46342,0,-42456,0,0,0,,42456,-42456
52,12/24/2018,55,13:30,13:45,,43.91,0,43.91,43.91,-1,-92862,121927,214789,29065,0,-30139,0,0,0,,30139,-30139
52,12/24/2018,56,13:45,14:00,,44.72,0,44.72,44.72,-1,-98173,119877,218050,21704,0,-22229,0,0,0,,22229,-22229
52,12/24/2018,57,14:00,14:15,,50.94,0,50.94,50.94,-1,-99138,114441,213579,15303,0,-9763,0,0,0,,9763,-9763
52,12/24/2018,58,14:15,14:30,,44.72,0,44.72,44.72,-1,-102712,124061,226773,21349,0,-11325,0,0,0,,11325,-11325
52,12/24/2018,59,14:30,14:45,52.28,54.98,0,52.28,52.28,1,-108588,109401,217989,813,0,-7092,614,0,0,,7706,-6478
52,12/24/2018,60,14:45,15:00,53.14,54.98,0,53.14,53.14,1,-114490,94696,209186,-19794,0,-331,11739,0,0,,12070,11408
52,12/24/2018,61,15:00,15:15,53.14,45.91,0,45.91,45.91,-1,-95265,119092,214357,23827,0,-5139,3369,0,0,,8508,-1770
52,12/24/2018,62,15:15,15:30,,56.58,0,56.58,56.58,-1,-95442,104516,199958,9074,0,-3315,0,0,0,,3315,-3315
52,12/24/2018,63,15:30,15:45,,56.55,0,56.55,56.55,-1,-102469,89255,191724,-13214,0,-242,0,0,0,,242,-242
52,12/24/2018,64,15:45,16:00,,,0,52.24,52.24,0,-100684,89340,190024,-11344,0,0,0,0,0,,0,0
52,12/24/2018,65,16:00,16:15,,22.45,0,22.45,22.45,-1,-89540,143029,232569,53489,0,-25442,0,0,0,,25442,-25442
52,12/24/2018,66,16:15,16:30,,45.91,0,45.91,45.91,-1,-93761,120379,214140,26618,0,-20760,0,0,0,,20760,-20760
52,12/24/2018,67,16:30,16:45,56.28,52.85,0,56.28,56.28,1,-100146,91013,191159,-9133,0,-9279,5425,0,0,,14704,-3854
52,12/24/2018,68,16:45,17:00,125.17,,0,125.17,125.17,1,-127306,65526,192832,-61780,0,0,50809,0,0,,50809,50809
52,12/24/2018,69,17:00,17:15,71.38,46.97,0,46.97,46.97,-1,-107104,112420,219524,5316,0,-925,28121,0,0,,29046,27196
52,12/24/2018,70,17:15,17:30,51.38,46.97,0,51.38,51.38,1,-106122,107706,213828,1584,0,-206,161,0,0,,367,-45
52,12/24/2018,71,17:30,17:45,51.38,,0,51.38,51.38,1,-95661,106190,201851,10529,0,0,807,0,0,,807,807
52,12/24/2018,72,17:45,18:00,,44.72,0,44.72,44.72,-1,-72351,129528,201879,57177,0,-2863,0,0,0,,2863,-2863
52,12/24/2018,73,18:00,18:15,65.08,44.72,0,65.08,65.08,1,-119761,79746,199507,-40015,0,-512,8990,0,0,,9502,8478
52,12/24/2018,74,18:15,18:30,55.08,,0,55.08,55.08,1,-102074,95466,197540,-6608,0,0,7046,0,0,,7046,7046
52,12/24/2018,75,18:30,18:45,55.08,41.31,0,41.31,41.31,-1,-91600,119804,211404,28204,0,-10877,305,0,0,,11182,-10572
52,12/24/2018,76,18:45,19:00,,37.41,0,37.41,37.41,-1,-96752,121932,218684,25180,0,-25865,0,0,0,,25865,-25865
52,12/24/2018,77,19:00,19:15,52.28,52.45,0,52.62,52.45,2,-103108,102027,205135,-1081,0,-5617,902,0,0,,6519,-4715
52,12/24/2018,78,19:15,19:30,,47.21,0,47.21,47.21,-1,-90525,111172,201697,20647,0,-8295,0,0,0,,8295,-8295
52,12/24/2018,79,19:30,19:45,,24.15,0,24.15,24.15,-1,-92775,154509,247284,61734,0,-37906,0,0,0,,37906,-37906
52,12/24/2018,80,19:45,20:00,,37.41,0,37.41,37.41,-1,-104636,131805,236441,27169,0,-33044,0,0,0,,33044,-33044
52,12/24/2018,81,20:00,20:15,,9.88,0,9.88,9.88,-1,-85768,153078,238846,67310,0,-47845,0,0,0,,47845,-47845
52,12/24/2018,82,20:15,20:30,,22.45,0,22.45,22.45,-1,-82461,128264,210725,45803,0,-15961,0,0,0,,15961,-15961
52,12/24/2018,83,20:30,20:45,,5.8,0,5.8,5.8,-1,-71956,139624,211580,67668,0,-60541,0,0,0,,60541,-60541
52,12/24/2018,84,20:45,21:00,,37.41,0,37.41,37.41,-1,-96795,115605,212400,18810,0,-36288,0,0,0,,36288,-36288
52,12/24/2018,85,21:00,21:15,53.07,37.41,0,53.07,53.07,1,-86206,109164,195370,22958,0,-4289,6,0,0,,4295,-4283
52,12/24/2018,86,21:15,21:30,,49.4,0,49.4,49.4,-1,-76870,109549,186419,32679,0,-480,0,0,0,,480,-480
52,12/24/2018,87,21:30,21:45,,44.72,0,44.72,44.72,-1,-87033,122532,209565,35499,0,-255,0,0,0,,255,-255
52,12/24/2018,88,21:45,22:00,,31.13,0,31.13,31.13,-1,-81182,142026,223208,60844,0,-10304,0,0,0,,10304,-10304
52,12/24/2018,89,22:00,22:15,71.9,11.91,0,71.9,11.91,2,-97646,89076,186722,-8570,0,-32020,804,0,0,,32824,-31216
52,12/24/2018,90,22:15,22:30,246.46,11.91,0,246.46,246.46,1,-96580,51474,148054,-45106,0,-537,30965,0,0,,31502,30428
52,12/24/2018,91,22:30,22:45,246.46,41.31,0,41.31,41.31,-1,-81568,97978,179546,16410,0,-5335,434,0,0,,5769,-4901
52,12/24/2018,92,22:45,23:00,52.28,45.25,0,52.28,45.25,2,-95116,90813,185929,-4303,0,-3509,2009,0,0,,5518,-1500
52,12/24/2018,93,23:00,23:15,252.6,,0,252.6,252.6,1,-121039,45279,166318,-75760,0,0,38578,0,0,,38578,38578
52,12/24/2018,94,23:15,23:30,56.28,,0,56.28,56.28,1,-85392,48087,133479,-37305,0,0,37053,0,0,,37053,37053
52,12/24/2018,95,23:30,23:45,55.88,,0,55.88,55.88,1,-70039,60949,130988,-9090,0,0,16119,0,0,,16119,16119
52,12/24/2018,96,23:45,0:00,55.88,37.41,0,37.41,37.41,-1,-73372,100356,173728,26984,0,-5302,272,0,0,,5574,-5030
52,12/25/2018,1,0:00,0:15,269.28,37.41,0,269.28,269.28,1,-137632,17123,154755,-120509,0,-3022,42120,0,0,,45142,39098
52,12/25/2018,2,0:15,0:30,152,,0,152,152,1,-92497,41436,133933,-51061,0,0,62827,0,0,,62827,62827
52,12/25/2018,3,0:30,0:45,55.78,,0,55.78,55.78,1,-80613,52489,133102,-28124,0,0,26969,0,0,,26969,26969
52,12/25/2018,4,0:45,1:00,60.8,,0,60.8,60.8,1,-90022,60074,150096,-29948,0,0,21220,0,0,,21220,21220
52,12/25/2018,5,1:00,1:15,57.45,,0,57.45,57.45,1,-97616,48074,145690,-49542,0,0,35953,0,0,,35953,35953
52,12/25/2018,6,1:15,1:30,57.45,,0,57.45,57.45,1,-97725,50577,148302,-47148,0,0,40652,0,0,,40652,40652
52,12/25/2018,7,1:30,1:45,57.45,,0,57.45,57.45,1,-88353,62327,150680,-26026,0,0,24101,0,0,,24101,24101
52,12/25/2018,8,1:45,2:00,74.01,,0,74.01,74.01,1,-115049,51640,166689,-63409,0,0,35517,0,0,,35517,35517
52,12/25/2018,9,2:00,2:15,57.99,,0,57.99,57.99,1,-110862,90089,200951,-20773,0,0,17145,0,0,,17145,17145
52,12/25/2018,10,2:15,2:30,72.54,49.75,0,72.54,49.75,2,-72925,52099,125024,-20826,0,-26,35819,0,0,,35845,35793
52,12/25/2018,11,2:30,2:45,72.54,46.03,0,46.03,46.03,-1,-63778,72649,136427,8871,0,-712,1136,0,0,,1848,424
52,12/25/2018,12,2:45,3:00,51.24,52.25,0,51.24,50.85,2,-70748,67059,137807,-3689,0,-11,701,0,0,,712,690
52,12/25/2018,13,3:00,3:15,53.45,45.82,0,53.45,25.78,2,-65681,50977,116658,-14704,0,-342,3758,0,0,,4100,3416
52,12/25/2018,14,3:15,3:30,53.87,,0,53.87,53.87,1,-80515,61807,142322,-18708,0,0,8519,0,0,,8519,8519
52,12/25/2018,15,3:30,3:45,53.87,,0,53.87,53.87,1,-81471,69158,150629,-12313,0,0,14123,0,0,,14123,14123
52,12/25/2018,16,3:45,4:00,,,0,50.46,50.46,0,-44707,89277,133984,44570,0,0,80,0,0,,80,80
52,12/25/2018,17,4:00,4:15,50.12,,0,50.12,50.12,1,-87578,75808,163386,-11770,0,0,1878,0,0,,1878,1878
52,12/25/2018,18,4:15,4:30,49.45,,0,49.45,49.45,1,-77599,72956,150555,-4643,0,0,3274,0,0,,3274,3274
52,12/25/2018,19,4:30,4:45,50.12,,0,50.12,50.12,1,-70723,58687,129410,-12036,0,0,5997,0,0,,5997,5997
52,12/25/2018,20,4:45,5:00,50.12,,0,50.12,50.12,1,-80162,63755,143917,-16407,0,0,5054,0,0,,5054,5054
52,12/25/2018,21,5:00,5:15,,,0,50.36,50.36,0,-75218,110215,185433,34997,0,0,70,0,0,,70,70
52,12/25/2018,22,5:15,5:30,,,0,50.36,50.36,0,-77410,89588,166998,12178,0,0,0,0,0,,0,0
52,12/25/2018,23,5:30,5:45,50.66,,0,50.66,50.66,1,-77074,63106,140180,-13968,0,0,4956,0,0,,4956,4956
52,12/25/2018,24,5:45,6:00,50.14,,0,50.14,50.14,1,-55039,47697,102736,-7342,0,0,6940,0,0,,6940,6940
52,12/25/2018,25,6:00,6:15,54.94,,0,54.94,54.94,1,-83694,70280,153974,-13414,0,0,10161,0,0,,10161,10161
52,12/25/2018,26,6:15,6:30,51.11,,0,51.11,51.11,1,-75106,60470,135576,-14636,0,0,11545,0,0,,11545,11545
52,12/25/2018,27,6:30,6:45,53.45,,0,53.45,53.45,1,-79472,56315,135787,-23157,0,0,15565,0,0,,15565,15565
52,12/25/2018,28,6:45,7:00,60.62,,0,60.62,60.62,1,-86159,29338,115497,-56821,0,0,40056,0,0,,40056,40056
52,12/25/2018,29,7:00,7:15,57.83,51.72,0,51.72,51.72,-1,-77708,77062,154770,-646,0,-1148,17912,0,0,,19060,16764
52,12/25/2018,30,7:15,7:30,57.83,52.47,0,52.47,52.47,-1,-66530,80033,146563,13503,0,-560,6,0,0,,566,-554
52,12/25/2018,31,7:30,7:45,53.45,,0,53.45,53.45,1,-69196,55502,124698,-13694,0,0,5069,0,0,,5069,5069
52,12/25/2018,32,7:45,8:00,91.86,,0,91.86,91.86,1,-94292,40249,134541,-54043,0,0,29665,0,0,,29665,29665
52,12/25/2018,33,8:00,8:15,91.86,-1.43,0,-1.43,-1.43,-1,-24701,95311,120012,70610,0,-17747,6486,0,0,,24233,-11261
52,12/25/2018,34,8:15,8:30,,45.45,0,45.45,45.45,-1,-43964,71208,115172,27244,0,-7434,0,0,0,,7434,-7434
52,12/25/2018,35,8:30,8:45,,42.03,0,42.03,42.03,-1,-35540,76318,111858,40778,0,-17771,0,0,0,,17771,-17771
52,12/25/2018,36,8:45,9:00,,45.45,0,45.45,45.45,-1,-43626,68701,112327,25075,0,-6590,0,0,0,,6590,-6590
52,12/25/2018,37,9:00,9:15,,,0,25.2,25.2,0,-57026,116644,173670,59618,0,0,0,0,0,,0,0
52,12/25/2018,38,9:15,9:30,,,0,48.99,48.99,0,-57570,90002,147572,32432,0,0,0,0,0,,0,0
52,12/25/2018,39,9:30,9:45,,,0,48.97,48.97,0,-55481,77392,132873,21911,0,0,0,0,0,,0,0
52,12/25/2018,40,9:45,10:00,,,0,48.93,48.93,0,-38995,73786,112781,34791,0,0,0,0,0,,0,0
52,12/25/2018,41,10:00,10:15,76.36,,0,76.36,76.36,1,-88876,52367,141243,-36509,0,0,15883,0,0,,15883,15883
52,12/25/2018,42,10:15,10:30,52.82,,0,52.82,52.82,1,-71545,60930,132475,-10615,0,0,7949,0,0,,7949,7949
52,12/25/2018,43,10:30,10:45,53.45,,0,53.45,53.45,1,-71511,56268,127779,-15243,0,0,5626,0,0,,5626,5626
52,12/25/2018,44,10:45,11:00,57.45,,0,57.45,57.45,1,-70695,38647,109342,-32048,0,0,16118,0,0,,16118,16118
52,12/25/2018,45,11:00,11:15,52.73,,0,52.73,52.73,1,-69822,62340,132162,-7482,0,0,11368,0,0,,11368,11368
52,12/25/2018,46,11:15,11:30,53.45,,0,53.45,53.45,1,-68377,51905,120282,-16472,0,0,16234,0,0,,16234,16234
52,12/25/2018,47,11:30,11:45,49.51,,0,49.51,49.51,1,-67760,58613,126373,-9147,0,0,5973,0,0,,5973,5973
52,12/25/2018,48,11:45,12:00,50.84,46.41,0,50.89,46.41,2,-67654,67741,135395,87,0,-103,3325,0,0,,3428,3222
52,12/25/2018,49,12:00,12:15,50.84,22.71,0,22.71,22.71,-1,-40332,114434,154766,74102,0,-13294,60,0,0,,13354,-13234
52,12/25/2018,50,12:15,12:30,,41.45,0,41.45,41.45,-1,-50089,75522,125611,25433,0,-7928,0,0,0,,7928,-7928
52,12/25/2018,51,12:30,12:45,,45.77,0,45.77,45.77,-1,-44251,81471,125722,37220,0,-3620,0,0,0,,3620,-3620
52,12/25/2018,52,12:45,13:00,,41.44,0,41.44,41.44,-1,-35749,112176,147925,76427,0,-4900,0,0,0,,4900,-4900
52,12/25/2018,53,13:00,13:15,53.45,51.87,0,53.45,50.63,2,-87961,72991,160952,-14970,0,-989,4606,0,0,,5595,3617
52,12/25/2018,54,13:15,13:30,,26.66,0,26.66,26.66,-1,-57021,90700,147721,33679,0,-16716,0,0,0,,16716,-16716
52,12/25/2018,55,13:30,13:45,,41.61,0,41.61,41.61,-1,-68876,92960,161836,24084,0,-24423,0,0,0,,24423,-24423
52,12/25/2018,56,13:45,14:00,52.88,45.45,0,52.88,45.45,2,-89813,85132,174945,-4681,0,-9799,642,0,0,,10441,-9157
52,12/25/2018,57,14:00,14:15,,31.99,0,31.99,31.99,-1,-60079,119805,179884,59726,0,-16693,0,0,0,,16693,-16693
52,12/25/2018,58,14:15,14:30,,37.45,0,37.45,37.45,-1,-60805,91327,152132,30522,0,-14371,0,0,0,,14371,-14371
52,12/25/2018,59,14:30,14:45,,37.45,0,37.45,37.45,-1,-55946,86450,142396,30504,0,-19120,0,0,0,,19120,-19120
52,12/25/2018,60,14:45,15:00,,41.45,0,41.45,41.45,-1,-59132,81748,140880,22616,0,-16421,0,0,0,,16421,-16421
52,12/25/2018,61,15:00,15:15,49.45,41.45,0,49.45,49.45,1,-81018,70682,151700,-10336,0,-412,294,0,0,,706,-118
52,12/25/2018,62,15:15,15:30,49.45,,0,49.45,49.45,1,-75934,71897,147831,-4037,0,0,6013,0,0,,6013,6013
52,12/25/2018,63,15:30,15:45,49.45,,0,49.45,49.45,1,-63741,62673,126414,-1068,0,0,3343,0,0,,3343,3343
52,12/25/2018,64,15:45,16:00,51.81,,0,51.81,51.81,1,-66240,47381,113621,-18859,0,0,7488,0,0,,7488,7488
52,12/25/2018,65,16:00,16:15,,32.01,0,32.01,32.01,-1,-43249,107596,150845,64347,0,-17797,0,0,0,,17797,-17797
52,12/25/2018,66,16:15,16:30,,32.06,0,32.06,32.06,-1,-63609,104352,167961,40743,0,-34511,0,0,0,,34511,-34511
52,12/25/2018,67,16:30,16:45,,45.45,0,45.45,45.45,-1,-85077,96504,181581,11427,0,-6379,0,0,0,,6379,-6379
52,12/25/2018,68,16:45,17:00,57.45,,0,57.45,57.45,1,-127832,92956,220788,-34876,0,0,5339,0,0,,5339,5339
52,12/25/2018,69,17:00,17:15,57.45,52.4,0,52.4,52.4,-1,-91563,115465,207028,23902,0,-7,3993,0,0,,4000,3986
52,12/25/2018,70,17:15,17:30,,45.45,0,45.45,45.45,-1,-82964,109559,192523,26595,0,-572,0,0,0,,572,-572
52,12/25/2018,71,17:30,17:45,52.85,,0,52.85,52.85,1,-84643,90352,174995,5709,0,0,340,0,0,,340,340
52,12/25/2018,72,17:45,18:00,53.45,,0,53.45,53.45,1,-89319,105924,195243,16605,0,0,2784,0,0,,2784,2784
52,12/25/2018,73,18:00,18:15,,42.43,0,42.43,42.43,-1,-95199,100769,195968,5570,0,-3678,0,0,0,,3678,-3678
52,12/25/2018,74,18:15,18:30,,41.45,0,41.45,41.45,-1,-81875,103746,185621,21871,0,-15553,0,0,0,,15553,-15553
52,12/25/2018,75,18:30,18:45,,37.45,0,37.45,37.45,-1,-72739,114399,187138,41660,0,-25680,0,0,0,,25680,-25680
52,12/25/2018,76,18:45,19:00,,41.45,0,41.45,41.45,-1,-80756,119980,200736,39224,0,-26544,0,0,0,,26544,-26544
52,12/25/2018,77,19:00,19:15,57.45,45.45,0,57.45,45.45,2,-89225,73858,163083,-15367,0,-11168,2802,0,0,,13970,-8366
52,12/25/2018,78,19:15,19:30,57.45,39.27,0,39.27,39.27,-1,-74197,102983,177180,28786,0,-11502,130,0,0,,11632,-11372
52,12/25/2018,79,19:30,19:45,,22.71,0,22.71,22.71,-1,-63026,119651,182677,56625,0,-36871,0,0,0,,36871,-36871
52,12/25/2018,80,19:45,20:00,,32.97,0,32.97,32.97,-1,-66908,125229,192137,58321,0,-51020,0,0,0,,51020,-51020
52,12/25/2018,81,20:00,20:15,54.38,37.45,0,54.38,54.38,1,-59023,98544,157567,39521,0,-22471,1745,0,0,,24216,-20726
52,12/25/2018,82,20:15,20:30,,,0,50.84,50.84,0,-58707,97672,156379,38965,0,0,67,0,0,,67,67
52,12/25/2018,83,20:30,20:45,,,0,50.84,50.84,0,-64530,105316,169846,40786,0,0,0,0,0,,0,0
52,12/25/2018,84,20:45,21:00,,52.18,0,52.18,52.18,-1,-70075,117636,187711,47561,0,-114,0,0,0,,114,-114
52,12/25/2018,85,21:00,21:15,49.45,45.45,0,50.85,45.45,2,-88579,82830,171409,-5749,0,-584,479,0,0,,1063,-105
52,12/25/2018,86,21:15,21:30,49.45,45.45,0,45.45,45.45,-1,-81391,87022,168413,5631,0,-1116,2,0,0,,1118,-1114
52,12/25/2018,87,21:30,21:45,,38.39,0,38.39,38.39,-1,-80638,102315,182953,21677,0,-11529,0,0,0,,11529,-11529
52,12/25/2018,88,21:45,22:00,,37.45,0,37.45,37.45,-1,-82853,99763,182616,16910,0,-20360,0,0,0,,20360,-20360
52,12/25/2018,89,22:00,22:15,,22.71,0,22.71,22.71,-1,-41018,102627,143645,61609,0,-32495,0,0,0,,32495,-32495
52,12/25/2018,90,22:15,22:30,,37.45,0,37.45,37.45,-1,-44598,84694,129292,40096,0,-17304,0,0,0,,17304,-17304
52,12/25/2018,91,22:30,22:45,,35.19,0,35.19,35.19,-1,-38599,92372,130971,53773,0,-40566,0,0,0,,40566,-40566
52,12/25/2018,92,22:45,23:00,,33.39,0,33.39,33.39,-1,-35640,100009,135649,64369,0,-36576,0,0,0,,36576,-36576
52,12/25/2018,93,23:00,23:15,,37.45,0,37.45,37.45,-1,-38210,66144,104354,27934,0,-30849,0,0,0,,30849,-30849
52,12/25/2018,94,23:15,23:30,,31.61,0,31.61,31.61,-1,-26241,76633,102874,50392,0,-28445,0,0,0,,28445,-28445
52,12/25/2018,95,23:30,23:45,,34.69,0,34.69,34.69,-1,-23753,84079,107832,60326,0,-46501,0,0,0,,46501,-46501
52,12/25/2018,96,23:45,0:00,,35.44,0,35.44,35.44,-1,-27075,109047,136122,81972,0,-51357,0,0,0,,51357,-51357
52,12/26/2018,1,0:00,0:15,86.14,-27.29,0,86.14,-27.29,2,-62972,72615,135587,9643,0,-47133,1145,0,0,,48278,-45988
52,12/26/2018,2,0:15,0:30,165.08,23.09,0,165.08,23.09,2,-48240,76267,124507,28027,0,-7830,6730,0,0,,14560,-1100
52,12/26/2018,3,0:30,0:45,,22.71,0,22.71,22.71,-1,-64543,95901,160444,31358,0,-25073,0,0,0,,25073,-25073
52,12/26/2018,4,0:45,1:00,,37.45,0,37.45,37.45,-1,-80111,124646,204757,44535,0,-25625,0,0,0,,25625,-25625
52,12/26/2018,5,1:00,1:15,,33.4,0,33.4,33.4,-1,-63973,86809,150782,22836,0,-30741,0,0,0,,30741,-30741
52,12/26/2018,6,1:15,1:30,,45.45,0,45.45,45.45,-1,-66979,74195,141174,7216,0,-14015,0,0,0,,14015,-14015
52,12/26/2018,7,1:30,1:45,,22.71,0,22.71,22.71,-1,-63391,99933,163324,36542,0,-16479,0,0,0,,16479,-16479
52,12/26/2018,8,1:45,2:00,,32.25,0,32.25,32.25,-1,-56644,95131,151775,38487,0,-35206,0,0,0,,35206,-35206
52,12/26/2018,9,2:00,2:15,,24.24,0,24.24,24.24,-1,-57785,104741,162526,46956,0,-18291,0,0,0,,18291,-18291
52,12/26/2018,10,2:15,2:30,51.62,,0,51.62,51.62,1,-57572,87611,145183,30039,0,0,63,0,0,,63,63
52,12/26/2018,11,2:30,2:45,,,0,49.91,49.91,0,-68030,81866,149896,13836,0,0,0,0,0,,0,0
52,12/26/2018,12,2:45,3:00,,,0,49.92,49.92,0,-57063,83684,140747,26621,0,0,0,0,0,,0,0
52,12/26/2018,13,3:00,3:15,,,0,49.93,49.93,0,-53545,98387,151932,44842,0,0,0,0,0,,0,0
52,12/26/2018,14,3:15,3:30,,45.45,0,45.45,45.45,-1,-63271,78391,141662,15120,0,-3018,0,0,0,,3018,-3018
52,12/26/2018,15,3:30,3:45,,41.45,0,41.45,41.45,-1,-54469,71150,125619,16681,0,-12226,0,0,0,,12226,-12226
52,12/26/2018,16,3:45,4:00,,42.38,0,42.38,42.38,-1,-44613,60439,105052,15826,0,-11836,0,0,0,,11836,-11836
52,12/26/2018,17,4:00,4:15,,30,0,30,30,-1,-77269,90334,167603,13065,0,-13357,0,0,0,,13357,-13357
52,12/26/2018,18,4:15,4:30,,28.98,0,28.98,28.98,-1,-89237,86690,175927,-2547,0,-22869,0,0,0,,22869,-22869
52,12/26/2018,19,4:30,4:45,,45.45,0,45.45,45.45,-1,-80088,81648,161736,1560,0,-8664,0,0,0,,8664,-8664
52,12/26/2018,20,4:45,5:00,,45.45,0,45.45,45.45,-1,-75029,72177,147206,-2852,0,-6975,0,0,0,,6975,-6975
52,12/26/2018,21,5:00,5:15,,45.45,0,45.45,45.45,-1,-49407,130705,180112,81298,0,-1522,0,0,0,,1522,-1522
52,12/26/2018,22,5:15,5:30,,26.78,0,26.78,26.78,-1,-53135,100008,153143,46873,0,-26920,0,0,0,,26920,-26920
52,12/26/2018,23,5:30,5:45,,45.45,0,45.45,45.45,-1,-68455,87217,155672,18762,0,-11704,0,0,0,,11704,-11704
52,12/26/2018,24,5:45,6:00,,51.37,0,51.37,51.37,-1,-81271,84989,166260,3718,0,-600,0,0,0,,600,-600
52,12/26/2018,25,6:00,6:15,,45.76,0,45.76,45.76,-1,-116154,127633,243787,11479,0,-819,0,0,0,,819,-819
52,12/26/2018,26,6:15,6:30,,45.44,0,45.44,45.44,-1,-116466,122420,238886,5954,0,-6888,0,0,0,,6888,-6888
52,12/26/2018,27,6:30,6:45,52.44,50.23,0,52.44,50.17,2,-112848,103156,216004,-9692,0,-2876,215,0,0,,3091,-2661
52,12/26/2018,28,6:45,7:00,72.2,,0,72.2,72.2,1,-134641,103260,237901,-31381,0,0,14461,0,0,,14461,14461
52,12/26/2018,29,7:00,7:15,51.35,37.44,0,51.35,37.44,2,-105177,115881,221058,10704,0,-5172,3391,0,0,,8563,-1781
52,12/26/2018,30,7:15,7:30,56.44,,0,56.44,56.44,1,-126825,93602,220427,-33223,0,0,17566,0,0,,17566,17566
52,12/26/2018,31,7:30,7:45,72.2,,0,72.2,72.2,1,-119368,77343,196711,-42025,0,0,36075,0,0,,36075,36075
52,12/26/2018,32,7:45,8:00,56.44,,0,56.44,56.44,1,-120050,80443,200493,-39607,0,0,20933,0,0,,20933,20933
52,12/26/2018,33,8:00,8:15,121.23,,0,121.23,121.23,1,-174489,100643,275132,-73846,0,0,43506,0,0,,43506,43506
52,12/26/2018,34,8:15,8:30,190.12,,0,190.12,190.12,1,-129641,92919,222560,-36722,0,0,64689,0,0,,64689,64689
52,12/26/2018,35,8:30,8:45,58.97,,0,58.97,58.97,1,-104631,90777,195408,-13854,0,0,29017,0,0,,29017,29017
52,12/26/2018,36,8:45,9:00,122.71,,0,122.71,122.71,1,-114126,76220,190346,-37906,0,0,51134,0,0,,51134,51134
52,12/26/2018,37,9:00,9:15,150.63,,0,150.63,150.63,1,-112842,51021,163863,-61821,0,0,74307,0,0,,74307,74307
52,12/26/2018,38,9:15,9:30,72.2,,0,72.2,72.2,1,-87594,59322,146916,-28272,0,0,34806,0,0,,34806,34806
52,12/26/2018,39,9:30,9:45,113.17,,0,113.17,113.17,1,-101930,43626,145556,-58304,0,0,56586,0,0,,56586,56586
52,12/26/2018,40,9:45,10:00,242.58,,0,242.58,242.58,1,-127353,43358,170711,-83995,0,0,76397,0,0,,76397,76397
52,12/26/2018,41,10:00,10:15,48.44,44.49,0,50.38,44.49,2,-54714,70017,124731,15303,0,-863,23666,0,0,,24529,22803
52,12/26/2018,42,10:15,10:30,56.44,,0,56.44,56.44,1,-87621,49719,137340,-37902,0,0,14468,0,0,,14468,14468
52,12/26/2018,43,10:30,10:45,72.2,,0,72.2,72.2,1,-95663,40899,136562,-54764,0,0,31404,0,0,,31404,31404
52,12/26/2018,44,10:45,11:00,56.44,,0,56.44,56.44,1,-98242,41187,139429,-57055,0,0,35976,0,0,,35976,35976
52,12/26/2018,45,11:00,11:15,258.58,,0,258.58,258.58,1,-192467,51929,244396,-140538,0,0,59286,0,0,,59286,59286
52,12/26/2018,46,11:15,11:30,258.58,,0,258.58,258.58,1,-165621,63634,229255,-101987,0,0,83136,0,0,,83136,83136
52,12/26/2018,47,11:30,11:45,258.58,,0,258.58,258.58,1,-145991,79486,225477,-66505,0,0,68938,0,0,,68938,68938
52,12/26/2018,48,11:45,12:00,72.25,,0,72.25,72.25,1,-151583,79868,231451,-71715,0,0,51768,0,0,,51768,51768
52,12/26/2018,49,12:00,12:15,72.2,,0,72.2,72.2,1,-105255,71148,176403,-34107,0,0,45690,0,0,,45690,45690
52,12/26/2018,50,12:15,12:30,72.2,,0,72.2,72.2,1,-129720,69707,199427,-60013,0,0,41590,0,0,,41590,41590
52,12/26/2018,51,12:30,12:45,255.47,,0,255.47,255.47,1,-145653,71292,216945,-74361,0,0,64719,0,0,,64719,64719
52,12/26/2018,52,12:45,13:00,72.2,,0,72.2,72.2,1,-132692,86798,219490,-45894,0,0,39584,0,0,,39584,39584
52,12/26/2018,53,13:00,13:15,156.25,,0,156.25,156.25,1,-186494,106851,293345,-79643,0,0,59993,0,0,,59993,59993
52,12/26/2018,54,13:15,13:30,84.29,,0,84.29,84.29,1,-172336,111258,283594,-61078,0,0,53648,0,0,,53648,53648
52,12/26/2018,55,13:30,13:45,84.58,,0,84.58,84.58,1,-179909,105709,285618,-74200,0,0,46870,0,0,,46870,46870
52,12/26/2018,56,13:45,14:00,115.36,,0,115.36,115.36,1,-178835,92390,271225,-86445,0,0,62333,0,0,,62333,62333
52,12/26/2018,57,14:00,14:15,135.25,,0,135.25,135.25,1,-214487,126456,340943,-88031,0,0,62971,0,0,,62971,62971
52,12/26/2018,58,14:15,14:30,48.44,,0,48.44,48.44,1,-149273,115102,264375,-34171,0,0,13459,0,0,,13459,13459
52,12/26/2018,59,14:30,14:45,56.36,,0,56.36,56.36,1,-142635,101048,243683,-41587,0,0,11114,0,0,,11114,11114
52,12/26/2018,60,14:45,15:00,72.2,,0,72.2,72.2,1,-145642,93105,238747,-52537,0,0,25965,0,0,,25965,25965
52,12/26/2018,61,15:00,15:15,72.2,,0,72.2,72.2,1,-166603,89917,256520,-76686,0,0,41905,0,0,,41905,41905
52,12/26/2018,62,15:15,15:30,122.71,,0,122.71,122.71,1,-167852,92975,260827,-74877,0,0,55271,0,0,,55271,55271
52,12/26/2018,63,15:30,15:45,87.9,,0,87.9,87.9,1,-153337,83285,236622,-70052,0,0,66712,0,0,,66712,66712
52,12/26/2018,64,15:45,16:00,85.09,,0,85.09,85.09,1,-163399,94700,258099,-68699,0,0,65236,0,0,,65236,65236
52,12/26/2018,65,16:00,16:15,72.2,49.24,0,49.24,49.24,-1,-124314,112607,236921,-11707,0,-662,31498,0,0,,32160,30836
52,12/26/2018,66,16:15,16:30,72.2,48.92,0,72.2,72.2,1,-119449,95246,214695,-24203,0,-138,7460,0,0,,7598,7322
52,12/26/2018,67,16:30,16:45,239.74,,0,239.74,239.74,1,-134052,57985,192037,-76067,0,0,58851,0,0,,58851,58851
52,12/26/2018,68,16:45,17:00,123.02,,0,123.02,123.02,1,-142953,57661,200614,-85292,0,0,81219,0,0,,81219,81219
52,12/26/2018,69,17:00,17:15,118.34,,0,118.34,118.34,1,-160758,115251,276009,-45507,0,0,46891,0,0,,46891,46891
52,12/26/2018,70,17:15,17:30,125.83,,0,125.83,125.83,1,-168622,98760,267382,-69862,0,0,58795,0,0,,58795,58795
52,12/26/2018,71,17:30,17:45,75.83,,0,75.83,75.83,1,-156792,111912,268704,-44880,0,0,42234,0,0,,42234,42234
52,12/26/2018,72,17:45,18:00,75.83,,0,75.83,75.83,1,-155382,127435,282817,-27947,0,0,32179,0,0,,32179,32179
52,12/26/2018,73,18:00,18:15,55.78,42.75,0,42.75,42.75,-1,-105057,171431,276488,66374,0,-1492,11006,0,0,,12498,9514
52,12/26/2018,74,18:15,18:30,55.78,42.11,0,42.11,42.11,-1,-84267,170604,254871,86337,0,-4263,26,0,0,,4289,-4237
52,12/26/2018,75,18:30,18:45,,37.44,0,37.44,37.44,-1,-46730,194516,241246,147786,0,-19545,0,0,0,,19545,-19545
52,12/26/2018,76,18:45,19:00,,33.44,0,33.44,33.44,-1,-41797,200481,242278,158684,0,-46007,0,0,0,,46007,-46007
52,12/26/2018,77,19:00,19:15,,,0,50.4,50.4,0,-49660,146909,196569,97249,0,-15602,0,0,0,,15602,-15602
52,12/26/2018,78,19:15,19:30,,,0,50.4,50.4,0,-47825,155992,203817,108167,0,0,0,0,0,,0,0
52,12/26/2018,79,19:30,19:45,,29.89,0,29.89,29.89,-1,-43516,162202,205718,118686,0,-9578,0,0,0,,9578,-9578
52,12/26/2018,80,19:45,20:00,,30.26,0,30.26,30.26,-1,-42190,161105,203295,118915,0,-43911,0,0,0,,43911,-43911
52,12/26/2018,81,20:00,20:15,72.2,37.44,0,72.2,72.2,1,-72256,63860,136116,-8396,0,-23012,1848,0,0,,24860,-21164
52,12/26/2018,82,20:15,20:30,72.2,48.29,0,48.29,48.29,-1,-68878,75599,144477,6721,0,-262,76,0,0,,338,-186
52,12/26/2018,83,20:30,20:45,,45.44,0,45.44,45.44,-1,-67441,87361,154802,19920,0,-8044,0,0,0,,8044,-8044
52,12/26/2018,84,20:45,21:00,,39.26,0,39.26,39.26,-1,-59553,101858,161411,42305,0,-21177,0,0,0,,21177,-21177
52,12/26/2018,85,21:00,21:15,56.44,41.15,0,56.44,26.15,2,-57802,54215,112017,-3587,0,-11076,4010,0,0,,15086,-7066
52,12/26/2018,86,21:15,21:30,51.37,41.15,0,51.37,51.37,1,-79202,86853,166055,7651,0,-8,998,0,0,,1006,990
52,12/26/2018,87,21:30,21:45,48.44,52.25,0,50.35,50.35,2,-81920,106969,188889,25049,0,-81,1168,0,0,,1249,1087
52,12/26/2018,88,21:45,22:00,,45.15,0,45.15,45.15,-1,-75351,99880,175231,24529,0,-3418,0,0,0,,3418,-3418
52,12/26/2018,89,22:00,22:15,,45.15,0,45.15,45.15,-1,-64379,66735,131114,2356,0,-2138,0,0,0,,2138,-2138
52,12/26/2018,90,22:15,22:30,,,0,50.35,50.35,0,-72750,65854,138604,-6896,0,0,0,0,0,,0,0
52,12/26/2018,91,22:30,22:45,48.44,,0,48.44,48.44,1,-72206,75873,148079,3667,0,0,50,0,0,,50,50
52,12/26/2018,92,22:45,23:00,48.44,,0,48.44,48.44,1,-85761,85972,171733,211,0,0,1123,0,0,,1123,1123
52,12/26/2018,93,23:00,23:15,48.44,,0,48.44,48.44,1,-62614,96778,159392,34164,0,0,73,0,0,,73,73
52,12/26/2018,94,23:15,23:30,,,0,50.09,50.09,0,-61081,81389,142470,20308,0,0,0,0,0,,0,0
52,12/26/2018,95,23:30,23:45,,45.15,0,45.15,45.15,-1,-57305,103552,160857,46247,0,-236,0,0,0,,236,-236
52,12/26/2018,96,23:45,0:00,,23.49,0,23.49,23.49,-1,-43989,110261,154250,66272,0,-12344,0,0,0,,12344,-12344
52,12/27/2018,1,0:00,0:15,,26.5,0,26.5,26.5,-1,-49541,61370,110911,11829,0,-15703,0,0,0,,15703,-15703
52,12/27/2018,2,0:15,0:30,,44.44,0,44.44,44.44,-1,-46065,54885,100950,8820,0,-9332,0,0,0,,9332,-9332
52,12/27/2018,3,0:30,0:45,,49.94,0,49.94,49.94,-1,-69133,72617,141750,3484,0,-3023,0,0,0,,3023,-3023
52,12/27/2018,4,0:45,1:00,,44.44,0,44.44,44.44,-1,-74085,100325,174410,26240,0,-9145,0,0,0,,9145,-9145
52,12/27/2018,5,1:00,1:15,84.3,51.33,0,84.3,84.3,1,-113439,40176,153615,-73263,0,-3132,25955,0,0,,29087,22823
52,12/27/2018,6,1:15,1:30,58.81,,0,58.81,58.81,1,-71780,56628,128408,-15152,0,0,21207,0,0,,21207,21207
52,12/27/2018,7,1:30,1:45,57.44,,0,57.44,57.44,1,-81991,48900,130891,-33091,0,0,11808,0,0,,11808,11808
52,12/27/2018,8,1:45,2:00,48.44,,0,48.44,48.44,1,-87080,72117,159197,-14963,0,0,2440,0,0,,2440,2440
52,12/27/2018,9,2:00,2:15,52.61,,0,52.61,52.61,1,-64647,46330,110977,-18317,0,0,7309,0,0,,7309,7309
52,12/27/2018,10,2:15,2:30,49.48,,0,49.48,49.48,1,-63238,37614,100852,-25624,0,0,4209,0,0,,4209,4209
52,12/27/2018,11,2:30,2:45,,,0,49.79,49.79,0,-61558,53740,115298,-7818,0,0,503,0,0,,503,503
52,12/27/2018,12,2:45,3:00,,44.44,0,44.44,44.44,-1,-56730,60292,117022,3562,0,-2273,0,0,0,,2273,-2273
52,12/27/2018,13,3:00,3:15,,44.44,0,44.44,44.44,-1,-48675,57104,105779,8429,0,-5399,0,0,0,,5399,-5399
52,12/27/2018,14,3:15,3:30,,41.33,0,41.33,41.33,-1,-54350,73864,128214,19514,0,-14125,0,0,0,,14125,-14125
52,12/27/2018,15,3:30,3:45,,46.26,0,46.26,46.26,-1,-60581,63433,124014,2852,0,-4080,0,0,0,,4080,-4080
52,12/27/2018,16,3:45,4:00,,44.44,0,44.44,44.44,-1,-73845,76246,150091,2401,0,-6284,0,0,0,,6284,-6284
52,12/27/2018,17,4:00,4:15,,46.33,0,46.33,46.33,-1,-73646,71451,145097,-2195,0,-3250,0,0,0,,3250,-3250
52,12/27/2018,18,4:15,4:30,,47.85,0,47.85,47.85,-1,-74560,71152,145712,-3408,0,-626,0,0,0,,626,-626
52,12/27/2018,19,4:30,4:45,,46.2,0,46.2,46.2,-1,-75514,65745,141259,-9769,0,-2194,0,0,0,,2194,-2194
52,12/27/2018,20,4:45,5:00,,,0,48.12,48.12,0,-93809,66136,159945,-27673,0,0,0,0,0,,0,0
52,12/27/2018,21,5:00,5:15,,37.17,0,37.17,37.17,-1,-53343,88319,141662,34976,0,-5425,0,0,0,,5425,-5425
52,12/27/2018,22,5:15,5:30,,26.5,0,26.5,26.5,-1,-69077,101376,170453,32299,0,-35164,0,0,0,,35164,-35164
52,12/27/2018,23,5:30,5:45,,45.78,0,45.78,45.78,-1,-92630,94239,186869,1609,0,-5439,0,0,0,,5439,-5439
52,12/27/2018,24,5:45,6:00,,41.03,0,41.03,41.03,-1,-98144,124941,223085,26797,0,-8507,0,0,0,,8507,-8507
52,12/27/2018,25,6:00,6:15,,40.84,0,40.84,40.84,-1,-91882,118634,210516,26752,0,-15094,0,0,0,,15094,-15094
52,12/27/2018,26,6:15,6:30,,37.2,0,37.2,37.2,-1,-94808,94231,189039,-577,0,-16465,0,0,0,,16465,-16465
52,12/27/2018,27,6:30,6:45,48.56,37.2,0,48.56,48.56,1,-95883,64210,160093,-31673,0,-587,485,0,0,,1072,-102
52,12/27/2018,28,6:45,7:00,50.12,,0,50.12,50.12,1,-122347,70827,193174,-51520,0,0,987,0,0,,987,987
52,12/27/2018,29,7:00,7:15,48.56,44.56,0,49.57,44.56,2,-89580,104426,194006,14846,0,-2542,875,0,0,,3417,-1667
52,12/27/2018,30,7:15,7:30,52.71,47.92,0,52.71,47.92,2,-64212,73247,137459,9035,0,-586,864,0,0,,1450,278
52,12/27/2018,31,7:30,7:45,72.44,,0,72.44,72.44,1,-73371,47240,120611,-26131,0,0,19646,0,0,,19646,19646
52,12/27/2018,32,7:45,8:00,103.78,,0,103.78,103.78,1,-69288,29002,98290,-40286,0,0,47393,0,0,,47393,47393
52,12/27/2018,33,8:00,8:15,72.83,22.19,0,22.19,22.19,-1,-76398,154369,230767,77971,0,-7808,17821,0,0,,25629,10013
52,12/27/2018,34,8:15,8:30,53.6,8.04,0,53.6,8.04,2,-64590,89837,154427,25247,0,-9598,1312,0,0,,10910,-8286
52,12/27/2018,35,8:30,8:45,57.79,,0,57.79,57.79,1,-64787,69982,134769,5195,0,0,12338,0,0,,12338,12338
52,12/27/2018,36,8:45,9:00,85.02,,0,85.02,85.02,1,-63849,52075,115924,-11774,0,0,25287,0,0,,25287,25287
52,12/27/2018,37,9:00,9:15,114.02,45.65,0,114.02,45.65,2,-60232,60844,121076,612,0,-682,23950,0,0,,24632,23268
52,12/27/2018,38,9:15,9:30,114.02,45.33,0,45.33,45.33,-1,-46843,61018,107861,14175,0,-1162,69,0,0,,1231,-1093
52,12/27/2018,39,9:30,9:45,49.6,,0,49.6,49.6,1,-51415,50428,101843,-987,0,0,37,0,0,,37,37
52,12/27/2018,40,9:45,10:00,53.67,,0,53.67,53.67,1,-48577,35699,84276,-12878,0,0,5808,0,0,,5808,5808
52,12/27/2018,41,10:00,10:15,59.15,,0,59.15,59.15,1,-31317,29144,60461,-2173,0,0,7356,0,0,,7356,7356
52,12/27/2018,42,10:15,10:30,,,0,65.48,65.48,0,-30530,33851,64381,3321,0,0,163,0,0,,163,163
52,12/27/2018,43,10:30,10:45,,,0,65.48,65.48,0,-36544,38174,74718,1630,0,0,0,0,0,,0,0
52,12/27/2018,44,10:45,11:00,,,0,65.48,65.48,0,-38831,40014,78845,1183,0,0,0,0,0,,0,0
52,12/27/2018,45,11:00,11:15,52.48,,0,52.48,52.48,1,-32140,29110,61250,-3030,0,0,622,0,0,,622,622
52,12/27/2018,46,11:15,11:30,53.72,,0,53.72,53.72,1,-35317,24444,59761,-10873,0,0,2934,0,0,,2934,2934
52,12/27/2018,47,11:30,11:45,53.72,,0,53.72,53.72,1,-35141,20803,55944,-14338,0,0,4067,0,0,,4067,4067
52,12/27/2018,48,11:45,12:00,57.83,,0,57.83,57.83,1,-47173,21233,68406,-25940,0,0,11767,0,0,,11767,11767
52,12/27/2018,49,12:00,12:15,245.59,,0,245.59,245.59,1,-78611,15299,93910,-63312,0,0,56142,0,0,,56142,56142
52,12/27/2018,50,12:15,12:30,73.55,,0,73.55,73.55,1,-75117,32730,107847,-42387,0,0,54738,0,0,,54738,54738
52,12/27/2018,51,12:30,12:45,86.73,,0,86.73,86.73,1,-75136,27606,102742,-47530,0,0,60550,0,0,,60550,60550
52,12/27/2018,52,12:45,13:00,73.55,,0,73.55,73.55,1,-69860,40080,109940,-29780,0,0,54168,0,0,,54168,54168
52,12/27/2018,53,13:00,13:15,70,,0,70,70,1,-82101,34073,116174,-48028,0,0,32326,0,0,,32326,32326
52,12/27/2018,54,13:15,13:30,,,0,50.95,50.95,0,-92929,21317,114246,-71612,0,0,1398,0,0,,1398,1398
52,12/27/2018,55,13:30,13:45,,,0,50.95,50.95,0,-110471,16217,126688,-94254,0,0,0,0,0,,0,0
52,12/27/2018,56,13:45,14:00,51.4,,0,51.4,51.4,1,-125810,18675,144485,-107135,0,0,1734,0,0,,1734,1734
52,12/27/2018,57,14:00,14:15,73.55,,0,73.55,73.55,1,-110416,40238,150654,-70178,0,0,25160,0,0,,25160,25160
52,12/27/2018,58,14:15,14:30,58.86,,0,58.86,58.86,1,-113352,38926,152278,-74426,0,0,33440,0,0,,33440,33440
52,12/27/2018,59,14:30,14:45,,,0,50.96,50.96,0,-114837,39623,154460,-75214,0,0,2605,0,0,,2605,2605
52,12/27/2018,60,14:45,15:00,,,0,50.93,50.93,0,-125265,40901,166166,-84364,0,0,0,0,0,,0,0
52,12/27/2018,61,15:00,15:15,,,0,50.98,50.98,0,-86579,55440,142019,-31139,0,0,0,0,0,,0,0
52,12/27/2018,62,15:15,15:30,49.6,,0,49.6,49.6,1,-93167,53799,146966,-39368,0,0,900,0,0,,900,900
52,12/27/2018,63,15:30,15:45,49.6,,0,49.6,49.6,1,-107818,50703,158521,-57115,0,0,1558,0,0,,1558,1558
52,12/27/2018,64,15:45,16:00,51.66,,0,51.66,51.66,1,-108018,46070,154088,-61948,0,0,2180,0,0,,2180,2180
52,12/27/2018,65,16:00,16:15,51.66,22.83,0,22.83,22.83,-1,-57795,97368,155163,39573,0,-15741,62,0,0,,15803,-15679
52,12/27/2018,66,16:15,16:30,,49.29,0,49.29,49.29,-1,-61449,65541,126990,4092,0,-4462,0,0,0,,4462,-4462
52,12/27/2018,67,16:30,16:45,57.83,52.45,0,57.83,51.03,2,-71121,45565,116686,-25556,0,-559,542,0,0,,1101,-17
52,12/27/2018,68,16:45,17:00,258.18,,0,258.18,258.18,1,-121588,47836,169424,-73752,0,0,43136,0,0,,43136,43136
52,12/27/2018,69,17:00,17:15,258.18,44.2,0,44.2,44.2,-1,-70452,82174,152626,11722,0,-1443,10690,0,0,,12133,9247
52,12/27/2018,70,17:15,17:30,73.55,,0,73.55,73.55,1,-93019,60580,153599,-32439,0,0,8809,0,0,,8809,8809
52,12/27/2018,71,17:30,17:45,73.55,,0,73.55,73.55,1,-94994,72915,167909,-22079,0,0,16111,0,0,,16111,16111
52,12/27/2018,72,17:45,18:00,53.43,,0,53.43,53.43,1,-63058,91144,154202,28086,0,0,258,0,0,,258,258
52,12/27/2018,73,18:00,18:15,57.83,,0,57.83,57.83,1,-106090,41170,147260,-64920,0,0,7604,0,0,,7604,7604
52,12/27/2018,74,18:15,18:30,53.72,,0,53.72,53.72,1,-71893,49272,121165,-22621,0,0,7307,0,0,,7307,7307
52,12/27/2018,75,18:30,18:45,49.6,,0,49.6,49.6,1,-58812,61355,120167,2543,0,0,1767,0,0,,1767,1767
52,12/27/2018,76,18:45,19:00,,,0,51.02,51.02,0,-52991,76196,129187,23205,0,0,0,0,0,,0,0
52,12/27/2018,77,19:00,19:15,50.85,,0,50.85,50.85,1,-80790,74630,155420,-6160,0,0,2566,0,0,,2566,2566
52,12/27/2018,78,19:15,19:30,53.72,,0,53.72,53.72,1,-62594,53074,115668,-9520,0,0,2741,0,0,,2741,2741
52,12/27/2018,79,19:30,19:45,57.83,,0,57.83,57.83,1,-82479,50199,132678,-32280,0,0,15719,0,0,,15719,15719
52,12/27/2018,80,19:45,20:00,,,0,51.03,51.03,0,-92237,58320,150557,-33917,0,0,3444,0,0,,3444,3444
52,12/27/2018,81,20:00,20:15,84.37,,0,84.37,84.37,1,-74942,34738,109680,-40204,0,0,12744,0,0,,12744,12744
52,12/27/2018,82,20:15,20:30,52.02,52.35,0,52.02,50.98,2,-52889,50905,103794,-1984,0,-33,8328,0,0,,8361,8295
52,12/27/2018,83,20:30,20:45,52.02,45.44,0,45.44,45.44,-1,-46951,68687,115638,21736,0,-502,213,0,0,,715,-289
52,12/27/2018,84,20:45,21:00,,45.03,0,45.03,45.03,-1,-49142,90244,139386,41102,0,-10795,0,0,0,,10795,-10795
52,12/27/2018,85,21:00,21:15,49.6,46.03,0,49.6,49.6,1,-80190,26202,106392,-53988,0,-4037,55,0,0,,4092,-3982
52,12/27/2018,86,21:15,21:30,53.72,45.49,0,53.72,45.49,2,-47145,48614,95759,1469,0,-206,2440,0,0,,2646,2234
52,12/27/2018,87,21:30,21:45,,44.78,0,44.78,44.78,-1,-41374,74406,115780,33032,0,-14260,0,0,0,,14260,-14260
52,12/27/2018,88,21:45,22:00,,41.44,0,41.44,41.44,-1,-44853,96668,141521,51815,0,-29919,0,0,0,,29919,-29919
52,12/27/2018,89,22:00,22:15,51.32,42.65,0,51.32,42.65,2,-91652,27517,119169,-64135,0,-10633,524,0,0,,11157,-10109
52,12/27/2018,90,22:15,22:30,,,0,50.97,50.97,0,-50706,23632,74338,-27074,0,0,19,0,0,,19,19
52,12/27/2018,91,22:30,22:45,,52.36,0,52.36,52.36,-1,-49806,60757,110563,10951,0,-116,0,0,0,,116,-116
52,12/27/2018,92,22:45,23:00,,22.83,0,22.83,22.83,-1,-39981,82034,122015,42053,0,-11612,0,0,0,,11612,-11612
52,12/27/2018,93,23:00,23:15,,-4.02,0,-4.02,-4.02,-1,-68306,73091,141397,4785,0,-15356,0,0,0,,15356,-15356
52,12/27/2018,94,23:15,23:30,,,0,50.7,50.7,0,-50932,20482,71414,-30450,0,0,0,0,0,,0,0
52,12/27/2018,95,23:30,23:45,,46.66,0,46.66,46.66,-1,-46265,56755,103020,10490,0,-2796,0,0,0,,2796,-2796
52,12/27/2018,96,23:45,0:00,,30.88,0,30.88,30.88,-1,-49797,72798,122595,23001,0,-7087,0,0,0,,7087,-7087
52,12/28/2018,1,0:00,0:15,49.12,-4.38,0,50.24,-4.38,2,-38588,78426,117014,39838,0,-20085,22,0,0,,20107,-20063
52,12/28/2018,2,0:15,0:30,49.27,45.44,0,50.33,45.44,2,-32224,51549,83773,19325,0,-1276,302,0,0,,1578,-974
52,12/28/2018,3,0:30,0:45,51.08,45.44,0,51.08,45.44,2,-60024,46012,106036,-14012,0,-2224,770,0,0,,2994,-1454
52,12/28/2018,4,0:45,1:00,74.04,43.25,0,74.04,43.25,2,-86627,57411,144038,-29216,0,-156,14394,0,0,,14550,14238
52,12/28/2018,5,1:00,1:15,50.95,37.69,0,50.95,37.69,2,-39574,72454,112028,32880,0,-843,1640,0,0,,2483,797
52,12/28/2018,6,1:15,1:30,53.27,51.2,0,53.27,50.24,2,-48686,45667,94353,-3019,0,-27,2079,0,0,,2106,2052
52,12/28/2018,7,1:30,1:45,,45.27,0,45.27,45.27,-1,-49823,64792,114615,14969,0,-1399,0,0,0,,1399,-1399
52,12/28/2018,8,1:45,2:00,,40.61,0,40.61,40.61,-1,-41724,72253,113977,30529,0,-22032,0,0,0,,22032,-22032
52,12/28/2018,9,2:00,2:15,53.27,47.02,0,53.27,47.02,2,-48646,40835,89481,-7811,0,-9410,970,0,0,,10380,-8440
52,12/28/2018,10,2:15,2:30,,,0,49.82,49.82,0,-56820,52830,109650,-3990,0,0,0,0,0,,0,0
52,12/28/2018,11,2:30,2:45,,,0,49.82,49.82,0,-56782,57331,114113,549,0,0,0,0,0,,0,0
52,12/28/2018,12,2:45,3:00,,49.65,0,49.65,49.65,-1,-53978,56649,110627,2671,0,-1625,0,0,0,,1625,-1625
52,12/28/2018,13,3:00,3:15,,45.27,0,45.27,45.27,-1,-38456,67332,105788,28876,0,-3339,0,0,0,,3339,-3339
52,12/28/2018,14,3:15,3:30,,41.27,0,41.27,41.27,-1,-41146,68409,109555,27263,0,-14252,0,0,0,,14252,-14252
52,12/28/2018,15,3:30,3:45,,43.01,0,43.01,43.01,-1,-44703,68304,113007,23601,0,-19002,0,0,0,,19002,-19002
52,12/28/2018,16,3:45,4:00,,44.38,0,44.38,44.38,-1,-43387,71554,114941,28167,0,-24117,0,0,0,,24117,-24117
52,12/28/2018,17,4:00,4:15,51.08,51.06,0,51.08,49.78,2,-42314,39893,82207,-2421,0,-9715,195,0,0,,9910,-9520
52,12/28/2018,18,4:15,4:30,,,0,49.77,49.77,0,-34296,63540,97836,29244,0,0,0,0,0,,0,0
52,12/28/2018,19,4:30,4:45,,,0,49.77,49.77,0,-37609,53715,91324,16106,0,0,0,0,0,,0,0
52,12/28/2018,20,4:45,5:00,,,0,49.76,49.76,0,-48548,45736,94284,-2812,0,0,0,0,0,,0,0
52,12/28/2018,21,5:00,5:15,,37.54,0,37.54,37.54,-1,-43670,69020,112690,25350,0,-9150,0,0,0,,9150,-9150
52,12/28/2018,22,5:15,5:30,,37.54,0,37.54,37.54,-1,-30464,63164,93628,32700,0,-33716,0,0,0,,33716,-33716
52,12/28/2018,23,5:30,5:45,51.03,45.27,0,51.03,51.03,1,-44506,46192,90698,1686,0,-13367,304,0,0,,13671,-13063
52,12/28/2018,24,5:45,6:00,49.27,45.27,0,49.27,49.27,1,-60793,52229,113022,-8564,0,-114,514,0,0,,628,400
52,12/28/2018,25,6:00,6:15,52.17,43.78,0,52.17,43.78,2,-67607,46448,114055,-21159,0,-265,1381,0,0,,1646,1116
52,12/28/2018,26,6:15,6:30,,22.78,0,22.78,22.78,-1,-39245,97659,136904,58414,0,-42997,0,0,0,,42997,-42997
52,12/28/2018,27,6:30,6:45,,43.21,0,43.21,43.21,-1,-42194,49526,91720,7332,0,-7929,0,0,0,,7929,-7929
52,12/28/2018,28,6:45,7:00,,45.56,0,45.56,45.56,-1,-40942,47157,88099,6215,0,-514,0,0,0,,514,-514
52,12/28/2018,29,7:00,7:15,,44.46,0,44.46,44.46,-1,-57902,94344,152246,36442,0,-12621,0,0,0,,12621,-12621
52,12/28/2018,30,7:15,7:30,,37.71,0,37.71,37.71,-1,-58804,100352,159156,41548,0,-26080,0,0,0,,26080,-26080
52,12/28/2018,31,7:30,7:45,,37.89,0,37.89,37.89,-1,-56010,87351,143361,31341,0,-32305,0,0,0,,32305,-32305
52,12/28/2018,32,7:45,8:00,55.48,45.37,0,55.48,45.37,2,-68673,55629,124302,-13044,0,-6916,1925,0,0,,8841,-4991
52,12/28/2018,33,8:00,8:15,,-117.54,0,-117.54,-117.54,-1,-50942,160377,211319,109435,0,-52071,0,0,0,,52071,-52071
52,12/28/2018,34,8:15,8:30,,41.37,0,41.37,41.37,-1,-66746,91211,157957,24465,0,-21275,0,0,0,,21275,-21275
52,12/28/2018,35,8:30,8:45,,,0,50.74,50.74,0,-60243,66332,126575,6089,0,-3365,0,0,0,,3365,-3365
52,12/28/2018,36,8:45,9:00,52.88,45.37,0,52.88,45.37,2,-67797,46882,114679,-20915,0,-89,617,0,0,,706,528
52,12/28/2018,37,9:00,9:15,55.48,-110.42,0,55.48,-110.42,2,-53007,94262,147269,41255,0,-14331,362,0,0,,14693,-13969
52,12/28/2018,38,9:15,9:30,71.7,-110.42,0,71.7,71.7,1,-80296,77895,158191,-2401,0,-21,19427,0,0,,19448,19406
52,12/28/2018,39,9:30,9:45,71.7,,0,71.7,71.7,1,-80819,69333,150152,-11486,0,0,19071,0,0,,19071,19071
52,12/28/2018,40,9:45,10:00,71.12,51.46,0,71.12,50.72,2,-87037,51947,138984,-35090,0,-107,28374,0,0,,28481,28267
52,12/28/2018,41,10:00,10:15,95.12,45.23,0,95.12,45.23,2,-84178,32439,116617,-51739,0,-2644,12691,0,0,,15335,10047
52,12/28/2018,42,10:15,10:30,55.48,,0,55.48,55.48,1,-72718,36904,109622,-35814,0,0,31597,0,0,,31597,31597
52,12/28/2018,43,10:30,10:45,55.48,,0,55.48,55.48,1,-66301,36216,102517,-30085,0,0,29260,0,0,,29260,29260
52,12/28/2018,44,10:45,11:00,55.48,,0,55.48,55.48,1,-72162,49790,121952,-22372,0,0,14518,0,0,,14518,14518
52,12/28/2018,45,11:00,11:15,248.23,,0,248.23,248.23,1,-101463,37341,138804,-64122,0,0,28758,0,0,,28758,28758
52,12/28/2018,46,11:15,11:30,71.36,,0,71.36,71.36,1,-90750,59045,149795,-31705,0,0,26760,0,0,,26760,26760
52,12/28/2018,47,11:30,11:45,,,0,50.73,50.73,0,-91519,62474,153993,-29045,0,0,1946,0,0,,1946,1946
52,12/28/2018,48,11:45,12:00,,,0,50.72,50.72,0,-99625,46938,146563,-52687,0,0,0,0,0,,0,0
52,12/28/2018,49,12:00,12:15,258.35,,0,258.35,258.35,1,-113531,35614,149145,-77917,0,0,30425,0,0,,30425,30425
52,12/28/2018,50,12:15,12:30,56.57,,0,56.57,56.57,1,-95035,51299,146334,-43736,0,0,35750,0,0,,35750,35750
52,12/28/2018,51,12:30,12:45,71.7,,0,71.7,71.7,1,-93678,60698,154376,-32980,0,0,32035,0,0,,32035,32035
52,12/28/2018,52,12:45,13:00,55.48,,0,55.48,55.48,1,-98454,64877,163331,-33577,0,0,10421,0,0,,10421,10421
52,12/28/2018,53,13:00,13:15,68.12,,0,68.12,68.12,1,-97375,68592,165967,-28783,0,0,25178,0,0,,25178,25178
52,12/28/2018,54,13:15,13:30,71.7,,0,71.7,71.7,1,-104226,61858,166084,-42368,0,0,43634,0,0,,43634,43634
52,12/28/2018,55,13:30,13:45,58.12,,0,58.12,58.12,1,-91628,56382,148010,-35246,0,0,39950,0,0,,39950,39950
52,12/28/2018,56,13:45,14:00,55.48,,0,55.48,55.48,1,-82693,58986,141679,-23707,0,0,24978,0,0,,24978,24978
52,12/28/2018,57,14:00,14:15,55.48,,0,55.48,55.48,1,-77483,54129,131612,-23354,0,0,9750,0,0,,9750,9750
52,12/28/2018,58,14:15,14:30,51.48,,0,51.48,51.48,1,-77846,63190,141036,-14656,0,0,8878,0,0,,8878,8878
52,12/28/2018,59,14:30,14:45,47.48,,0,47.48,47.48,1,-74097,58424,132521,-15673,0,0,1039,0,0,,1039,1039
52,12/28/2018,60,14:45,15:00,,,0,50.75,50.75,0,-71598,63475,135073,-8123,0,0,0,0,0,,0,0
52,12/28/2018,61,15:00,15:15,,,0,50.77,50.77,0,-70364,91063,161427,20699,0,0,0,0,0,,0,0
52,12/28/2018,62,15:15,15:30,,45.37,0,45.37,45.37,-1,-61885,103526,165411,41641,0,-2584,0,0,0,,2584,-2584
52,12/28/2018,63,15:30,15:45,,54.07,0,54.07,54.07,-1,-64422,110808,175230,46386,0,-1584,0,0,0,,1584,-1584
52,12/28/2018,64,15:45,16:00,,46.03,0,46.03,46.03,-1,-62774,112123,174897,49349,0,-403,0,0,0,,403,-403
52,12/28/2018,65,16:00,16:15,,25.23,0,25.23,25.23,-1,-39725,93098,132823,53373,0,-33767,0,0,0,,33767,-33767
52,12/28/2018,66,16:15,16:30,,50.99,0,50.99,50.99,-1,-51048,76395,127443,25347,0,-9136,0,0,0,,9136,-9136
52,12/28/2018,67,16:30,16:45,47.48,52.37,0,50.71,50.71,2,-60131,63192,123323,3061,0,-2720,3,0,0,,2723,-2717
52,12/28/2018,68,16:45,17:00,82.61,52.37,0,82.61,82.61,1,-90571,39825,130396,-50746,0,-28,19519,0,0,,19547,19491
52,12/28/2018,69,17:00,17:15,55.48,37.52,0,55.48,37.52,2,-31646,58872,90518,27226,0,-8956,9832,0,0,,18788,876
52,12/28/2018,70,17:15,17:30,51.48,37.52,0,51.48,51.48,1,-49463,44073,93536,-5390,0,-1643,1160,0,0,,2803,-483
52,12/28/2018,71,17:30,17:45,51.71,,0,51.71,51.71,1,-47400,39143,86543,-8257,0,0,6555,0,0,,6555,6555
52,12/28/2018,72,17:45,18:00,55.48,,0,55.48,55.48,1,-53291,69921,123212,16630,0,0,2548,0,0,,2548,2548
52,12/28/2018,73,18:00,18:15,84.45,,0,84.45,84.45,1,-108257,12414,120671,-95843,0,0,15959,0,0,,15959,15959
52,12/28/2018,74,18:15,18:30,84.05,,0,84.05,84.05,1,-89397,29081,118478,-60316,0,0,7664,0,0,,7664,7664
52,12/28/2018,75,18:30,18:45,55.48,,0,55.48,55.48,1,-71576,58883,130459,-12693,0,0,10749,0,0,,10749,10749
52,12/28/2018,76,18:45,19:00,55.48,54.09,0,54.09,54.09,-1,-58763,70003,128766,11240,0,-43,28,0,0,,71,-15
52,12/28/2018,77,19:00,19:15,257.17,,0,257.17,257.17,1,-92654,19896,112550,-72758,0,0,28503,0,0,,28503,28503
52,12/28/2018,78,19:15,19:30,71.7,,0,71.7,71.7,1,-63515,39318,102833,-24197,0,0,33616,0,0,,33616,33616
52,12/28/2018,79,19:30,19:45,71.7,44.78,0,44.78,44.78,-1,-53044,73909,126953,20865,0,-3613,2176,0,0,,5789,-1437
52,12/28/2018,80,19:45,20:00,,42.83,0,42.83,42.83,-1,-52158,85984,138142,33826,0,-32525,0,0,0,,32525,-32525
52,12/28/2018,81,20:00,20:15,55.48,42.83,0,55.48,55.48,1,-55891,31090,86981,-24801,0,-7990,1868,0,0,,9858,-6122
52,12/28/2018,82,20:15,20:30,47.48,,0,47.48,47.48,1,-42145,45428,87573,3283,0,0,879,0,0,,879,879
52,12/28/2018,83,20:30,20:45,,41.37,0,41.37,41.37,-1,-29213,78767,107980,49554,0,-5206,0,0,0,,5206,-5206
52,12/28/2018,84,20:45,21:00,,41.37,0,41.37,41.37,-1,-29984,103287,133271,73303,0,-30496,0,0,0,,30496,-30496
52,12/28/2018,85,21:00,21:15,,37.52,0,37.52,37.52,-1,-69163,98206,167369,29043,0,-29414,0,0,0,,29414,-29414
52,12/28/2018,86,21:15,21:30,,41.37,0,41.37,41.37,-1,-51893,88019,139912,36126,0,-20341,0,0,0,,20341,-20341
52,12/28/2018,87,21:30,21:45,,31.19,0,31.19,31.19,-1,-41645,112486,154131,70841,0,-52831,0,0,0,,52831,-52831
52,12/28/2018,88,21:45,22:00,,24.06,0,24.06,24.06,-1,-44489,130240,174729,85751,0,-79433,0,0,0,,79433,-79433
52,12/28/2018,89,22:00,22:15,,24.06,0,24.06,24.06,-1,-76508,100389,176897,23881,0,-43677,0,0,0,,43677,-43677
52,12/28/2018,90,22:15,22:30,47.48,49.99,0,49.53,49.53,2,-66011,63719,129730,-2292,0,-392,521,0,0,,913,129
52,12/28/2018,91,22:30,22:45,,47.79,0,47.79,47.79,-1,-50341,63386,113727,13045,0,-5845,0,0,0,,5845,-5845
52,12/28/2018,92,22:45,23:00,,37.19,0,37.19,37.19,-1,-51261,76780,128041,25519,0,-14981,0,0,0,,14981,-14981
52,12/28/2018,93,23:00,23:15,93.26,24.06,0,93.26,24.06,2,-90503,57997,148500,-32506,0,-21181,4111,0,0,,25292,-17070
52,12/28/2018,94,23:15,23:30,51.48,49.91,0,49.91,49.91,-1,-80988,50805,131793,-30183,0,-24,2313,0,0,,2337,2289
52,12/28/2018,95,23:30,23:45,,49.92,0,49.92,49.92,-1,-78563,53209,131772,-25354,0,-35,0,0,0,,35,-35
52,12/28/2018,96,23:45,0:00,,,0,47.84,47.84,0,-125436,98336,223772,-27100,0,0,0,0,0,,0,0
1,12/29/2018,1,0:00,0:15,,49.97,0,49.97,49.97,-1,-61485,95293,156778,33808,0,-519,0,0,0,,519,-519
1,12/29/2018,2,0:15,0:30,,,0,48.4,48.4,0,-50275,65758,116033,15483,0,0,0,0,0,,0,0
1,12/29/2018,3,0:30,0:45,,,0,48.42,48.42,0,-74110,76172,150282,2062,0,0,0,0,0,,0,0
1,12/29/2018,4,0:45,1:00,,,0,48.47,48.47,0,-131139,84180,215319,-46959,0,0,0,0,0,,0,0
1,12/29/2018,5,1:00,1:15,,49.55,0,49.55,49.55,-1,-44843,97112,141955,52269,0,-490,0,0,0,,490,-490
1,12/29/2018,6,1:15,1:30,47.43,,0,47.43,47.43,1,-46040,71012,117052,24972,0,0,237,0,0,,237,237
1,12/29/2018,7,1:30,1:45,,,0,48.66,48.66,0,-42870,78130,121000,35260,0,0,0,0,0,,0,0
1,12/29/2018,8,1:45,2:00,,41.37,0,41.37,41.37,-1,-45165,79316,124481,34151,0,-3182,0,0,0,,3182,-3182
1,12/29/2018,9,2:00,2:15,,39.96,0,39.96,39.96,-1,-35235,135372,170607,100137,0,-4704,0,0,0,,4704,-4704
1,12/29/2018,10,2:15,2:30,,,0,48.58,48.58,0,-48320,76062,124382,27742,0,0,0,0,0,,0,0
1,12/29/2018,11,2:30,2:45,,,0,48.63,48.63,0,-47656,89344,137000,41688,0,0,0,0,0,,0,0
1,12/29/2018,12,2:45,3:00,,35.23,0,35.23,35.23,-1,-26153,97370,123523,71217,0,-24409,0,0,0,,24409,-24409
1,12/29/2018,13,3:00,3:15,,43.96,0,43.96,43.96,-1,-47189,77361,124550,30172,0,-6782,0,0,0,,6782,-6782
1,12/29/2018,14,3:15,3:30,,,0,23.97,23.97,0,-47184,64122,111306,16938,0,0,0,0,0,,0,0
1,12/29/2018,15,3:30,3:45,,,0,48.56,48.56,0,-49937,72506,122443,22569,0,0,0,0,0,,0,0
1,12/29/2018,16,3:45,4:00,,,0,48.53,48.53,0,-49230,69475,118705,20245,0,0,0,0,0,,0,0
1,12/29/2018,17,4:00,4:15,,,0,48.51,48.51,0,-52093,68933,121026,16840,0,0,0,0,0,,0,0
1,12/29/2018,18,4:15,4:30,,,0,48.52,48.52,0,-54796,65430,120226,10634,0,0,0,0,0,,0,0
1,12/29/2018,19,4:30,4:45,49.09,,0,49.09,49.09,1,-63826,57452,121278,-6374,0,0,569,0,0,,569,569
1,12/29/2018,20,4:45,5:00,49.08,,0,49.08,49.08,1,-62462,67610,130072,5148,0,0,328,0,0,,328,328
1,12/29/2018,21,5:00,5:15,,,0,48.5,48.5,0,-34975,81489,116464,46514,0,0,0,0,0,,0,0
1,12/29/2018,22,5:15,5:30,,,0,48.48,48.48,0,-32802,95572,128374,62770,0,0,0,0,0,,0,0
1,12/29/2018,23,5:30,5:45,,47.86,0,47.86,47.86,-1,-33502,101531,135033,68029,0,-970,0,0,0,,970,-970
1,12/29/2018,24,5:45,6:00,,,0,48.37,48.37,0,-38411,95982,134393,57571,0,0,0,0,0,,0,0
1,12/29/2018,25,6:00,6:15,,44.77,0,44.77,44.77,-1,-43193,105163,148356,61970,0,-1415,0,0,0,,1415,-1415
1,12/29/2018,26,6:15,6:30,,47.94,0,47.94,47.94,-1,-48573,120047,168620,71474,0,-232,0,0,0,,232,-232
1,12/29/2018,27,6:30,6:45,,,0,48.32,48.32,0,-64112,107413,171525,43301,0,0,0,0,0,,0,0
1,12/29/2018,28,6:45,7:00,,,0,48.3,48.3,0,-51533,105048,156581,53515,0,0,0,0,0,,0,0
1,12/29/2018,29,7:00,7:15,,12.69,0,12.69,12.69,-1,-31178,131941,163119,100763,0,-34404,0,0,0,,34404,-34404
1,12/29/2018,30,7:15,7:30,,22.84,0,22.84,22.84,-1,-43659,113532,157191,69873,0,-50779,0,0,0,,50779,-50779
1,12/29/2018,31,7:30,7:45,,22.84,0,22.84,22.84,-1,-52648,130932,183580,78284,0,-62220,0,0,0,,62220,-62220
1,12/29/2018,32,7:45,8:00,,39.03,0,39.03,39.03,-1,-67475,140051,207526,72576,0,-29468,0,0,0,,29468,-29468
1,12/29/2018,33,8:00,8:15,,42.21,0,42.21,42.21,-1,-70586,119328,189914,48742,0,-6169,0,0,0,,6169,-6169
1,12/29/2018,34,8:15,8:30,,35.82,0,35.82,35.82,-1,-60106,122015,182121,61909,0,-23376,0,0,0,,23376,-23376
1,12/29/2018,35,8:30,8:45,,,0,47.31,47.31,0,-46979,121249,168228,74270,0,-2490,0,0,0,,2490,-2490
1,12/29/2018,36,8:45,9:00,,,0,48.16,48.16,0,-46361,165556,211917,119195,0,0,0,0,0,,0,0
1,12/29/2018,37,9:00,9:15,,,0,49,49,0,-73927,117761,191688,43834,0,0,0,0,0,,0,0
1,12/29/2018,38,9:15,9:30,,,0,49,49,0,-55209,105391,160600,50182,0,0,0,0,0,,0,0
1,12/29/2018,39,9:30,9:45,,,0,50.73,50.73,0,-44471,103101,147572,58630,0,0,0,0,0,,0,0
1,12/29/2018,40,9:45,10:00,,,0,50.73,50.73,0,-42352,98022,140374,55670,0,0,0,0,0,,0,0
1,12/29/2018,41,10:00,10:15,,,0,50.73,50.73,0,-50542,80599,131141,30057,0,0,0,0,0,,0,0
1,12/29/2018,42,10:15,10:30,,,0,50.73,50.73,0,-50303,88112,138415,37809,0,0,0,0,0,,0,0
1,12/29/2018,43,10:30,10:45,,,0,50.73,50.73,0,-43403,86455,129858,43052,0,0,0,0,0,,0,0
1,12/29/2018,44,10:45,11:00,,53.42,0,53.42,53.42,-1,-48776,85749,134525,36973,0,-3,0,0,0,,3,-3
1,12/29/2018,45,11:00,11:15,0,53.42,0,26.71,26.71,2,-91253,74658,165911,-16595,0,-105,2740,0,0,,2845,2635
1,12/29/2018,46,11:15,11:30,0,,0,0,0,1,-107638,74958,182596,-32680,0,0,6380,0,0,,6380,6380
1,12/29/2018,47,11:30,11:45,0,,0,0,0,1,-107172,85000,192172,-22172,0,0,1640,0,0,,1640,1640
1,12/29/2018,48,11:45,12:00,0,,0,0,0,1,-109530,93880,203410,-15650,0,0,3300,0,0,,3300,3300
1,12/29/2018,49,12:00,12:15,249.23,,0,249.23,249.23,1,-135123,50526,185649,-84597,0,0,33126,0,0,,33126,33126
1,12/29/2018,50,12:15,12:30,59.02,,0,59.02,59.02,1,-108137,65382,173519,-42755,0,0,29432,0,0,,29432,29432
1,12/29/2018,51,12:30,12:45,51.33,,0,51.33,51.33,1,-91565,72495,164060,-19070,0,0,4744,0,0,,4744,4744
1,12/29/2018,52,12:45,13:00,49.17,,0,49.17,49.17,1,-90813,86120,176933,-4693,0,0,4032,0,0,,4032,4032
1,12/29/2018,53,13:00,13:15,233.41,,0,233.41,233.41,1,-112407,32405,144812,-80002,0,0,37846,0,0,,37846,37846
1,12/29/2018,54,13:15,13:30,57.67,,0,57.67,57.67,1,-107115,61375,168490,-45740,0,0,42145,0,0,,42145,42145
1,12/29/2018,55,13:30,13:45,53.02,,0,53.02,53.02,1,-110227,67086,177313,-43141,0,0,16632,0,0,,16632,16632
1,12/29/2018,56,13:45,14:00,,,0,50.69,50.69,0,-128379,73407,201786,-54972,0,0,2463,0,0,,2463,2463
1,12/29/2018,57,14:00,14:15,,,0,50.72,50.72,0,-96504,104749,201253,8245,0,0,0,0,0,,0,0
1,12/29/2018,58,14:15,14:30,56.87,,0,56.87,56.87,1,-107252,83796,191048,-23456,0,0,11096,0,0,,11096,11096
1,12/29/2018,59,14:30,14:45,51.22,,0,51.22,51.22,1,-108592,83189,191781,-25403,0,0,14958,0,0,,14958,14958
1,12/29/2018,60,14:45,15:00,56.87,,0,56.87,56.87,1,-91775,67224,158999,-24551,0,0,16242,0,0,,16242,16242
1,12/29/2018,61,15:00,15:15,52.09,,0,52.09,52.09,1,-87596,68803,156399,-18793,0,0,12035,0,0,,12035,12035
1,12/29/2018,62,15:15,15:30,52.77,,0,52.77,52.77,1,-90596,66348,156944,-24248,0,0,16303,0,0,,16303,16303
1,12/29/2018,63,15:30,15:45,52.77,,0,52.77,52.77,1,-88803,65420,154223,-23383,0,0,20355,0,0,,20355,20355
1,12/29/2018,64,15:45,16:00,52.77,,0,52.77,52.77,1,-83479,53926,137405,-29553,0,0,19516,0,0,,19516,19516
1,12/29/2018,65,16:00,16:15,52.77,52.78,0,52.78,52.78,-1,-48674,104539,153213,55865,0,-852,5216,0,0,,6068,4364
1,12/29/2018,66,16:15,16:30,49.19,,0,49.19,49.19,1,-68080,69817,137897,1737,0,0,718,0,0,,718,718
1,12/29/2018,67,16:30,16:45,52.77,,0,52.77,52.77,1,-72284,58463,130747,-13821,0,0,7256,0,0,,7256,7256
1,12/29/2018,68,16:45,17:00,52.81,,0,52.81,52.81,1,-84337,51230,135567,-33107,0,0,21648,0,0,,21648,21648
1,12/29/2018,69,17:00,17:15,72.84,,0,72.84,72.84,1,-100938,53813,154751,-47125,0,0,24961,0,0,,24961,24961
1,12/29/2018,70,17:15,17:30,56.87,,0,56.87,56.87,1,-79651,45439,125090,-34212,0,0,29979,0,0,,29979,29979
1,12/29/2018,71,17:30,17:45,54.59,,0,54.59,54.59,1,-69225,35918,105143,-33307,0,0,27138,0,0,,27138,27138
1,12/29/2018,72,17:45,18:00,52.77,,0,52.77,52.77,1,-59903,58011,117914,-1892,0,0,15732,0,0,,15732,15732
1,12/29/2018,73,18:00,18:15,126.07,,0,126.07,126.07,1,-86805,16683,103488,-70122,0,0,34541,0,0,,34541,34541
1,12/29/2018,74,18:15,18:30,56.87,,0,56.87,56.87,1,-69662,30744,100406,-38918,0,0,35342,0,0,,35342,35342
1,12/29/2018,75,18:30,18:45,56.87,,0,56.87,56.87,1,-80808,62531,143339,-18277,0,0,26888,0,0,,26888,26888
1,12/29/2018,76,18:45,19:00,48.03,52.11,0,50.81,50.81,2,-75543,87813,163356,12270,0,-811,2766,0,0,,3577,1955
1,12/29/2018,77,19:00,19:15,56.87,,0,56.87,56.87,1,-115112,64781,179893,-50331,0,0,25361,0,0,,25361,25361
1,12/29/2018,78,19:15,19:30,56.87,,0,56.87,56.87,1,-114253,64743,178996,-49510,0,0,41094,0,0,,41094,41094
1,12/29/2018,79,19:30,19:45,56.87,,0,56.87,56.87,1,-96745,57596,154341,-39149,0,0,34342,0,0,,34342,34342
1,12/29/2018,80,19:45,20:00,60.42,,0,60.42,60.42,1,-90212,36246,126458,-53966,0,0,39660,0,0,,39660,39660
1,12/29/2018,81,20:00,20:15,51.81,,0,51.81,51.81,1,-120579,64701,185280,-55878,0,0,24743,0,0,,24743,24743
1,12/29/2018,82,20:15,20:30,56.87,,0,56.87,56.87,1,-102915,55740,158655,-47175,0,0,22051,0,0,,22051,22051
1,12/29/2018,83,20:30,20:45,72.84,,0,72.84,72.84,1,-81431,32482,113913,-48949,0,0,37364,0,0,,37364,37364
1,12/29/2018,84,20:45,21:00,55.25,,0,55.25,55.25,1,-72478,40976,113454,-31502,0,0,26310,0,0,,26310,26310
1,12/29/2018,85,21:00,21:15,53.53,,0,53.53,53.53,1,-89387,64587,153974,-24800,0,0,15251,0,0,,15251,15251
1,12/29/2018,86,21:15,21:30,51.19,,0,51.19,51.19,1,-84042,62073,146115,-21969,0,0,14632,0,0,,14632,14632
1,12/29/2018,87,21:30,21:45,47.38,,0,47.38,47.38,1,-74819,64669,139488,-10150,0,0,1798,0,0,,1798,1798
1,12/29/2018,88,21:45,22:00,47.43,,0,47.43,47.43,1,-63392,62824,126216,-568,0,0,406,0,0,,406,406
1,12/29/2018,89,22:00,22:15,85.28,,0,85.28,85.28,1,-112357,54104,166461,-58253,0,0,25640,0,0,,25640,25640
1,12/29/2018,90,22:15,22:30,85.28,53.52,0,53.52,53.52,-1,-59495,46926,106421,-12569,0,-8,27520,0,0,,27528,27512
1,12/29/2018,91,22:30,22:45,85.28,44.77,0,44.77,44.77,-1,-45724,59696,105420,13972,0,-3459,182,0,0,,3641,-3277
1,12/29/2018,92,22:45,23:00,,43.91,0,43.91,43.91,-1,-41086,70786,111872,29700,0,-14276,0,0,0,,14276,-14276
1,12/29/2018,93,23:00,23:15,,44.77,0,44.77,44.77,-1,-49864,51587,101451,1723,0,-12051,0,0,0,,12051,-12051
1,12/29/2018,94,23:15,23:30,,44.77,0,44.77,44.77,-1,-42765,48940,91705,6175,0,-1644,0,0,0,,1644,-1644
1,12/29/2018,95,23:30,23:45,,44.77,0,44.77,44.77,-1,-39490,44409,83899,4919,0,-3249,0,0,0,,3249,-3249
1,12/29/2018,96,23:45,0:00,,22.84,0,22.84,22.84,-1,-38207,64969,103176,26762,0,-12514,0,0,0,,12514,-12514
1,12/30/2018,1,0:00,0:15,51.65,21.77,0,51.65,51.65,1,-59091,80626,139717,21535,0,-11176,3360,0,0,,14536,-7816
1,12/30/2018,2,0:15,0:30,52.77,,0,52.77,52.77,1,-79699,59993,139692,-19706,0,0,15150,0,0,,15150,15150
1,12/30/2018,3,0:30,0:45,50.52,,0,50.52,50.52,1,-89825,72128,161953,-17697,0,0,6491,0,0,,6491,6491
1,12/30/2018,4,0:45,1:00,48.02,52.54,0,50.28,50.28,2,-93869,85490,179359,-8379,0,-31,1012,0,0,,1043,981
1,12/30/2018,5,1:00,1:15,63.17,53.24,0,63.17,63.17,1,-99530,64977,164507,-34553,0,-135,13439,0,0,,13574,13304
1,12/30/2018,6,1:15,1:30,72.32,,0,72.32,72.32,1,-95098,47178,142276,-47920,0,0,32938,0,0,,32938,32938
1,12/30/2018,7,1:30,1:45,80.1,,0,80.1,80.1,1,-107009,47407,154416,-59602,0,0,31365,0,0,,31365,31365
1,12/30/2018,8,1:45,2:00,80.1,,0,80.1,80.1,1,-90812,57138,147950,-33674,0,0,43733,0,0,,43733,43733
1,12/30/2018,9,2:00,2:15,52.77,53.12,0,52.77,51,2,-69786,51012,120798,-18774,0,-620,6411,0,0,,7031,5791
1,12/30/2018,10,2:15,2:30,54.04,,0,54.04,54.04,1,-63493,54977,118470,-8516,0,0,5617,0,0,,5617,5617
1,12/30/2018,11,2:30,2:45,48.77,,0,48.77,48.77,1,-59919,50570,110489,-9349,0,0,382,0,0,,382,382
1,12/30/2018,12,2:45,3:00,52.77,,0,52.77,52.77,1,-75112,46620,121732,-28492,0,0,14907,0,0,,14907,14907
1,12/30/2018,13,3:00,3:15,49.83,,0,49.83,49.83,1,-54284,48376,102660,-5908,0,0,6309,0,0,,6309,6309
1,12/30/2018,14,3:15,3:30,72.32,,0,72.32,72.32,1,-86480,30778,117258,-55702,0,0,33219,0,0,,33219,33219
1,12/30/2018,15,3:30,3:45,72.32,,0,72.32,72.32,1,-94126,23104,117230,-71022,0,0,60082,0,0,,60082,60082
1,12/30/2018,16,3:45,4:00,72.32,,0,72.32,72.32,1,-94881,20867,115748,-74014,0,0,54619,0,0,,54619,54619
1,12/30/2018,17,4:00,4:15,72.32,52.64,0,52.64,52.64,-1,-43762,48271,92033,4509,0,-815,14566,0,0,,15381,13751
1,12/30/2018,18,4:15,4:30,47.48,52.64,0,47.48,47.48,1,-58419,48631,107050,-9788,0,-13,2639,0,0,,2652,2626
1,12/30/2018,19,4:30,4:45,49.49,,0,49.49,49.49,1,-66506,49213,115719,-17293,0,0,6809,0,0,,6809,6809
1,12/30/2018,20,4:45,5:00,56.81,,0,56.81,56.81,1,-86832,42468,129300,-44364,0,0,25661,0,0,,25661,25661
1,12/30/2018,21,5:00,5:15,47.48,53.7,0,53.7,53.7,-1,-43910,59233,103143,15323,0,-266,4055,0,0,,4321,3789
1,12/30/2018,22,5:15,5:30,,53.62,0,53.62,53.62,-1,-49023,53995,103018,4972,0,-112,0,0,0,,112,-112
1,12/30/2018,23,5:30,5:45,47.37,,0,47.37,47.37,1,-57168,53162,110330,-4006,0,0,946,0,0,,946,946
1,12/30/2018,24,5:45,6:00,48.72,,0,48.72,48.72,1,-69124,51190,120314,-17934,0,0,4742,0,0,,4742,4742
1,12/30/2018,25,6:00,6:15,182.77,,0,182.77,182.77,1,-97271,27197,124468,-70074,0,0,43921,0,0,,43921,43921
1,12/30/2018,26,6:15,6:30,56.78,,0,56.78,56.78,1,-54485,35687,90172,-18798,0,0,29903,0,0,,29903,29903
1,12/30/2018,27,6:30,6:45,83.19,,0,83.19,83.19,1,-81537,29365,110902,-52172,0,0,39293,0,0,,39293,39293
1,12/30/2018,28,6:45,7:00,81.47,,0,81.47,81.47,1,-111163,33149,144312,-78014,0,0,69036,0,0,,69036,69036
1,12/30/2018,29,7:00,7:15,69.12,51.13,0,51.13,51.13,-1,-52453,37549,90002,-14904,0,-701,30569,0,0,,31270,29868
1,12/30/2018,30,7:15,7:30,73.59,51.13,0,73.59,73.59,1,-93254,23857,117111,-69397,0,-20,32198,0,0,,32218,32178
1,12/30/2018,31,7:30,7:45,131.12,,0,131.12,131.12,1,-140645,17026,157671,-123619,0,0,95413,0,0,,95413,95413
1,12/30/2018,32,7:45,8:00,258.62,,0,258.62,258.62,1,-132393,41660,174053,-90733,0,0,89159,17500,0,,106659,106659
1,12/30/2018,33,8:00,8:15,103.09,-138.35,0,103.09,-138.35,2,-76313,53199,129512,-23114,0,-34927,15523,0,0,,50450,-19404
1,12/30/2018,34,8:15,8:30,246.58,,0,246.58,246.58,1,-130047,20217,150264,-109830,0,0,89153,0,0,,89153,89153
1,12/30/2018,35,8:30,8:45,88.46,,0,88.46,88.46,1,-110737,16837,127574,-93900,0,0,82470,0,0,,82470,82470
1,12/30/2018,36,8:45,9:00,70.89,,0,70.89,70.89,1,-121485,28625,150110,-92860,0,0,54806,0,0,,54806,54806
1,12/30/2018,37,9:00,9:15,56.78,,0,56.78,56.78,1,-66147,20227,86374,-45920,0,0,34002,0,0,,34002,34002
1,12/30/2018,38,9:15,9:30,52.73,,0,52.73,52.73,1,-64544,22478,87022,-42066,0,0,17658,0,0,,17658,17658
1,12/30/2018,39,9:30,9:45,56.78,,0,56.78,56.78,1,-78922,31105,110027,-47817,0,0,34794,0,0,,34794,34794
1,12/30/2018,40,9:45,10:00,72.31,,0,72.31,72.31,1,-100751,33431,134182,-67320,0,0,49820,0,0,,49820,49820
1,12/30/2018,41,10:00,10:15,48.73,49.89,0,49.69,49.69,2,-68615,109294,177909,40679,0,-600,11847,0,0,,12447,11247
1,12/30/2018,42,10:15,10:30,,,0,49.75,49.75,0,-74845,112540,187385,37695,0,0,0,0,0,,0,0
1,12/30/2018,43,10:30,10:45,,,0,49.69,49.69,0,-64519,90118,154637,25599,0,0,0,0,0,,0,0
1,12/30/2018,44,10:45,11:00,,52.17,0,52.17,52.17,-1,-52592,81088,133680,28496,0,-18,0,0,0,,18,-18
1,12/30/2018,45,11:00,11:15,,50.37,0,50.37,50.37,-1,-28845,96530,125375,67685,0,-143,0,0,0,,143,-143
1,12/30/2018,46,11:15,11:30,,,0,49.71,49.71,0,-29522,91173,120695,61651,0,0,0,0,0,,0,0
1,12/30/2018,47,11:30,11:45,,39.16,0,39.16,39.16,-1,-37753,92351,130104,54598,0,-6230,0,0,0,,6230,-6230
1,12/30/2018,48,11:45,12:00,,47.65,0,47.65,47.65,-1,-46864,106079,152943,59215,0,-2405,0,0,0,,2405,-2405
1,12/30/2018,49,12:00,12:15,,50.95,0,50.95,50.95,-1,-30873,107952,138825,77079,0,-473,0,0,0,,473,-473
1,12/30/2018,50,12:15,12:30,,52.09,0,52.09,52.09,-1,-41954,91761,133715,49807,0,-554,0,0,0,,554,-554
1,12/30/2018,51,12:30,12:45,,52.07,0,52.07,52.07,-1,-44417,74396,118813,29979,0,-92,0,0,0,,92,-92
1,12/30/2018,52,12:45,13:00,49.15,,0,49.15,49.15,1,-57391,66609,124000,9218,0,0,752,0,0,,752,752
1,12/30/2018,53,13:00,13:15,122.31,,0,122.31,122.31,1,-110640,28761,139401,-81879,0,0,39532,0,0,,39532,39532
1,12/30/2018,54,13:15,13:30,72.31,,0,72.31,72.31,1,-77382,27413,104795,-49969,0,0,54275,0,0,,54275,54275
1,12/30/2018,55,13:30,13:45,56.78,,0,56.78,56.78,1,-74092,24538,98630,-49554,0,0,30019,0,0,,30019,30019
1,12/30/2018,56,13:45,14:00,72.31,,0,72.31,72.31,1,-91334,28802,120136,-62532,0,0,37167,0,0,,37167,37167
1,12/30/2018,57,14:00,14:15,52.73,50.79,0,52.73,49.51,2,-45878,90126,136004,44248,0,-406,8920,0,0,,9326,8514
1,12/30/2018,58,14:15,14:30,,,0,49.48,49.48,0,-46181,70231,116412,24050,0,0,0,0,0,,0,0
1,12/30/2018,59,14:30,14:45,,,0,50.12,50.12,0,-57665,71995,129660,14330,0,0,0,0,0,,0,0
1,12/30/2018,60,14:45,15:00,,,0,50.09,50.09,0,-79276,72526,151802,-6750,0,0,0,0,0,,0,0
1,12/30/2018,61,15:00,15:15,48.73,,0,48.73,48.73,1,-62652,59062,121714,-3590,0,0,2276,0,0,,2276,2276
1,12/30/2018,62,15:15,15:30,48.73,,0,48.73,48.73,1,-61631,51877,113508,-9754,0,0,4417,0,0,,4417,4417
1,12/30/2018,63,15:30,15:45,52.73,,0,52.73,52.73,1,-74791,49350,124141,-25441,0,0,15216,0,0,,15216,15216
1,12/30/2018,64,15:45,16:00,52.73,,0,52.73,52.73,1,-87686,59136,146822,-28550,0,0,18032,0,0,,18032,18032
1,12/30/2018,65,16:00,16:15,52.73,36.73,0,36.73,36.73,-1,-37607,131837,169444,94230,0,-3879,1043,0,0,,4922,-2836
1,12/30/2018,66,16:15,16:30,,36.73,0,36.73,36.73,-1,-49757,112221,161978,62464,0,-15658,0,0,0,,15658,-15658
1,12/30/2018,67,16:30,16:45,,,0,50.03,50.03,0,-61147,86372,147519,25225,0,-3181,0,0,0,,3181,-3181
1,12/30/2018,68,16:45,17:00,56.78,,0,56.78,56.78,1,-107867,80291,188158,-27576,0,0,7074,0,0,,7074,7074
1,12/30/2018,69,17:00,17:15,48.73,50.19,0,50.68,50.19,2,-41920,83384,125304,41464,0,-769,1578,0,0,,2347,809
1,12/30/2018,70,17:15,17:30,,42.84,0,42.84,42.84,-1,-33100,67151,100251,34051,0,-6856,0,0,0,,6856,-6856
1,12/30/2018,71,17:30,17:45,,,0,50.63,50.63,0,-38299,57449,95748,19150,0,-243,0,0,0,,243,-243
1,12/30/2018,72,17:45,18:00,,,0,50.62,50.62,0,-50285,66416,116701,16131,0,0,0,0,0,,0,0
1,12/30/2018,73,18:00,18:15,52.73,,0,52.73,52.73,1,-66500,24493,90993,-42007,0,0,2510,0,0,,2510,2510
1,12/30/2018,74,18:15,18:30,52.73,,0,52.73,52.73,1,-52101,29864,81965,-22237,0,0,2390,0,0,,2390,2390
1,12/30/2018,75,18:30,18:45,53.31,,0,53.31,53.31,1,-49662,29213,78875,-20449,0,0,4200,0,0,,4200,4200
1,12/30/2018,76,18:45,19:00,53.36,,0,53.36,53.36,1,-45935,34802,80737,-11133,0,0,1857,0,0,,1857,1857
1,12/30/2018,77,19:00,19:15,188.57,,0,188.57,188.57,1,-111003,23096,134099,-87907,0,0,37454,0,0,,37454,37454
1,12/30/2018,78,19:15,19:30,72.31,,0,72.31,72.31,1,-90519,33241,123760,-57278,0,0,50154,0,0,,50154,50154
1,12/30/2018,79,19:30,19:45,52.37,,0,52.37,52.37,1,-80826,35623,116449,-45203,0,0,10507,0,0,,10507,10507
1,12/30/2018,80,19:45,20:00,55.8,,0,55.8,55.8,1,-74985,32370,107355,-42615,0,0,11358,0,0,,11358,11358
1,12/30/2018,81,20:00,20:15,234.52,,0,234.52,234.52,1,-131977,32584,164561,-99393,0,0,27087,0,0,,27087,27087
1,12/30/2018,82,20:15,20:30,56.78,,0,56.78,56.78,1,-126821,36281,163102,-90540,0,0,24816,0,0,,24816,24816
1,12/30/2018,83,20:30,20:45,52.73,,0,52.73,52.73,1,-105260,39614,144874,-65646,0,0,8045,0,0,,8045,8045
1,12/30/2018,84,20:45,21:00,48.73,,0,48.73,48.73,1,-96900,47999,144899,-48901,0,0,3845,0,0,,3845,3845
1,12/30/2018,85,21:00,21:15,56.78,,0,56.78,56.78,1,-103534,64272,167806,-39262,0,0,13460,0,0,,13460,13460
1,12/30/2018,86,21:15,21:30,49.1,,0,49.1,49.1,1,-82024,55909,137933,-26115,0,0,8220,0,0,,8220,8220
1,12/30/2018,87,21:30,21:45,49.1,52.31,0,52.31,52.31,-1,-56490,65854,122344,9364,0,-25,130,0,0,,155,105
1,12/30/2018,88,21:45,22:00,,36.73,0,36.73,36.73,-1,-47019,82123,129142,35104,0,-11773,0,0,0,,11773,-11773
1,12/30/2018,89,22:00,22:15,48.73,42.84,0,48.73,48.73,1,-62681,47677,110358,-15004,0,-10545,286,0,0,,10831,-10259
1,12/30/2018,90,22:15,22:30,48.73,42.84,0,48.73,48.73,1,-45838,51136,96974,5298,0,-41,40,0,0,,81,-1
1,12/30/2018,91,22:30,22:45,,,0,49.95,49.95,0,-35239,61215,96454,25976,0,0,0,0,0,,0,0
1,12/30/2018,92,22:45,23:00,,36.73,0,36.73,36.73,-1,-30874,86514,117388,55640,0,-5568,0,0,0,,5568,-5568
1,12/30/2018,93,23:00,23:15,72.31,42.84,0,72.31,42.84,2,-78408,33461,111869,-44947,0,-4994,13549,0,0,,18543,8555
1,12/30/2018,94,23:15,23:30,52.73,,0,52.73,52.73,1,-47074,50465,97539,3391,0,0,7706,0,0,,7706,7706
1,12/30/2018,95,23:30,23:45,,,0,49.81,49.81,0,-39475,64841,104316,25366,0,0,0,0,0,,0,0
1,12/30/2018,96,23:45,0:00,,-1.03,0,-1.03,-1.03,-1,-29798,68550,98348,38752,0,-7906,0,0,0,,7906,-7906
1,12/31/2018,1,0:00,0:15,,-124.33,0,-124.33,-124.33,-1,-81178,182178,263356,101000,0,-22556,0,0,0,,22556,-22556
1,12/31/2018,2,0:15,0:30,48.97,49.55,0,48.97,48.25,2,-65248,55947,121195,-9301,0,-59,698,0,0,,757,639
1,12/31/2018,3,0:30,0:45,,45,0,45,45,-1,-77477,69413,146890,-8064,0,-2208,0,0,0,,2208,-2208
1,12/31/2018,4,0:45,1:00,,44.24,0,44.24,44.24,-1,-78342,80480,158822,2138,0,-2026,0,0,0,,2026,-2026
1,12/31/2018,5,1:00,1:15,71.73,40.61,0,71.73,71.73,1,-71160,39161,110321,-31999,0,-1870,6710,0,0,,8580,4840
1,12/31/2018,6,1:15,1:30,71.73,,0,71.73,71.73,1,-75598,51630,127228,-23968,0,0,16917,0,0,,16917,16917
1,12/31/2018,7,1:30,1:45,71.73,42.84,0,42.84,42.84,-1,-71425,76868,148293,5443,0,-4094,6,0,0,,4100,-4088
1,12/31/2018,8,1:45,2:00,,42.84,0,42.84,42.84,-1,-57008,80303,137311,23295,0,-7204,0,0,0,,7204,-7204
1,12/31/2018,9,2:00,2:15,,44.7,0,44.7,44.7,-1,-67893,72252,140145,4359,0,-1410,0,0,0,,1410,-1410
1,12/31/2018,10,2:15,2:30,,42.59,0,42.59,42.59,-1,-65343,81262,146605,15919,0,-9018,0,0,0,,9018,-9018
1,12/31/2018,11,2:30,2:45,,42.84,0,42.84,42.84,-1,-63766,72720,136486,8954,0,-12143,0,0,0,,12143,-12143
1,12/31/2018,12,2:45,3:00,,42.84,0,42.84,42.84,-1,-67061,65685,132746,-1376,0,-1137,0,0,0,,1137,-1137
1,12/31/2018,13,3:00,3:15,,42.84,0,42.84,42.84,-1,-57917,92197,150114,34280,0,-1233,0,0,0,,1233,-1233
1,12/31/2018,14,3:15,3:30,,,0,47.45,47.45,0,-59918,69118,129036,9200,0,0,0,0,0,,0,0
1,12/31/2018,15,3:30,3:45,,47.94,0,47.94,47.94,-1,-66597,76773,143370,10176,0,-829,0,0,0,,829,-829
1,12/31/2018,16,3:45,4:00,,44.53,0,44.53,44.53,-1,-68479,84271,152750,15792,0,-5408,0,0,0,,5408,-5408
1,12/31/2018,17,4:00,4:15,,45.47,0,45.47,45.47,-1,-62531,89141,151672,26610,0,-1548,0,0,0,,1548,-1548
1,12/31/2018,18,4:15,4:30,,,0,47.43,47.43,0,-64180,86540,150720,22360,0,0,0,0,0,,0,0
1,12/31/2018,19,4:30,4:45,,,0,47.43,47.43,0,-67282,81162,148444,13880,0,0,0,0,0,,0,0
1,12/31/2018,20,4:45,5:00,,,0,47.41,47.41,0,-70327,68564,138891,-1763,0,0,0,0,0,,0,0
1,12/31/2018,21,5:00,5:15,,42.84,0,42.84,42.84,-1,-56316,102777,159093,46461,0,-1969,0,0,0,,1969,-1969
1,12/31/2018,22,5:15,5:30,,39.16,0,39.16,39.16,-1,-62316,108214,170530,45898,0,-11751,0,0,0,,11751,-11751
1,12/31/2018,23,5:30,5:45,,42.03,0,42.03,42.03,-1,-66044,82645,148689,16601,0,-12304,0,0,0,,12304,-12304
1,12/31/2018,24,5:45,6:00,,49.2,0,49.2,49.2,-1,-80765,78005,158770,-2760,0,-177,0,0,0,,177,-177
1,12/31/2018,25,6:00,6:15,,45.78,0,45.78,45.78,-1,-66838,153316,220154,86478,0,-639,0,0,0,,639,-639
1,12/31/2018,26,6:15,6:30,,,0,46.69,46.69,0,-80020,133301,213321,53281,0,0,0,0,0,,0,0
1,12/31/2018,27,6:30,6:45,,,0,46.64,46.64,0,-80422,124085,204507,43663,0,0,0,0,0,,0,0
1,12/31/2018,28,6:45,7:00,,,0,46.58,46.58,0,-61016,154900,215916,93884,0,0,0,0,0,,0,0
1,12/31/2018,29,7:00,7:15,,46.93,0,46.93,46.93,-1,-128952,139525,268477,10573,0,-664,0,0,0,,664,-664
1,12/31/2018,30,7:15,7:30,,46.93,0,46.93,46.93,-1,-139581,143286,282867,3705,0,-441,0,0,0,,441,-441
1,12/31/2018,31,7:30,7:45,49.65,,0,49.65,49.65,1,-104555,103433,207988,-1122,0,0,4039,0,0,,4039,4039
1,12/31/2018,32,7:45,8:00,,,0,47.19,47.19,0,-98139,114966,213105,16827,0,0,0,0,0,,0,0
1,12/31/2018,33,8:00,8:15,,49.06,0,49.06,49.06,-1,-145632,135207,280839,-10425,0,-1442,0,0,0,,1442,-1442
1,12/31/2018,34,8:15,8:30,,,0,49.35,49.35,0,-138266,102827,241093,-35439,0,-11,0,0,0,,11,-11
1,12/31/2018,35,8:30,8:45,69.22,,0,69.22,69.22,1,-159319,94858,254177,-64461,0,0,22767,0,0,,22767,22767
1,12/31/2018,36,8:45,9:00,69.56,,0,69.56,69.56,1,-161690,82519,244209,-79171,0,0,48167,0,0,,48167,48167
1,12/31/2018,37,9:00,9:15,69.02,,0,69.02,69.02,1,-158600,112448,271048,-46152,0,0,44221,0,0,,44221,44221
1,12/31/2018,38,9:15,9:30,69.56,,0,69.56,69.56,1,-164529,96213,260742,-68316,0,0,44811,0,0,,44811,44811
1,12/31/2018,39,9:30,9:45,60.22,,0,60.22,60.22,1,-179179,88867,268046,-90312,0,0,17860,0,0,,17860,17860
1,12/31/2018,40,9:45,10:00,167.02,,0,167.02,167.02,1,-188844,81321,270165,-107523,0,0,59258,0,0,,59258,59258
1,12/31/2018,41,10:00,10:15,69.56,,0,69.56,69.56,1,-179813,69067,248880,-110746,0,0,55955,0,0,,55955,55955
1,12/31/2018,42,10:15,10:30,69.56,,0,69.56,69.56,1,-185160,63677,248837,-121483,0,0,49990,0,0,,49990,49990
1,12/31/2018,43,10:30,10:45,92.02,,0,92.02,92.02,1,-186881,60907,247788,-125974,0,0,58941,0,0,,58941,58941
1,12/31/2018,44,10:45,11:00,66.45,,0,66.45,66.45,1,-178302,68731,247033,-109571,0,0,49564,0,0,,49564,49564
1,12/31/2018,45,11:00,11:15,49.88,,0,49.88,49.88,1,-164291,90532,254823,-73759,0,0,8105,0,0,,8105,8105
1,12/31/2018,46,11:15,11:30,,,0,47.86,47.86,0,-168847,100599,269446,-68248,0,0,0,0,0,,0,0
1,12/31/2018,47,11:30,11:45,48.14,,0,48.14,48.14,1,-161767,89134,250901,-72633,0,0,278,0,0,,278,278
1,12/31/2018,48,11:45,12:00,45.88,,0,45.88,45.88,1,-152429,83534,235963,-68895,0,0,46,0,0,,46,46
1,12/31/2018,49,12:00,12:15,62.93,,0,62.93,62.93,1,-145572,44724,190296,-100848,0,0,14625,0,0,,14625,14625
1,12/31/2018,50,12:15,12:30,,,0,49.27,49.27,0,-131042,59094,190136,-71948,0,0,1586,0,0,,1586,1586
1,12/31/2018,51,12:30,12:45,53.88,,0,53.88,53.88,1,-134556,72411,206967,-62145,0,0,12824,0,0,,12824,12824
1,12/31/2018,52,12:45,13:00,51.3,,0,51.3,51.3,1,-140028,76023,216051,-64005,0,0,15870,0,0,,15870,15870
1,12/31/2018,53,13:00,13:15,197.02,,0,197.02,197.02,1,-163600,75650,239250,-87950,0,0,36306,0,0,,36306,36306
1,12/31/2018,54,13:15,13:30,52.52,,0,52.52,52.52,1,-146852,99776,246628,-47076,0,0,16324,0,0,,16324,16324
1,12/31/2018,55,13:30,13:45,,,0,48.36,48.36,0,-142611,101430,244041,-41181,0,0,625,0,0,,625,625
1,12/31/2018,56,13:45,14:00,,,0,48.86,48.86,0,-139618,92204,231822,-47414,0,0,0,0,0,,0,0
1,12/31/2018,57,14:00,14:15,83.02,,0,83.02,83.02,1,-167986,94540,262526,-73446,0,0,29502,0,0,,29502,29502
1,12/31/2018,58,14:15,14:30,72.44,,0,72.44,72.44,1,-156367,96061,252428,-60306,0,0,58968,0,0,,58968,58968
1,12/31/2018,59,14:30,14:45,55.26,,0,55.26,55.26,1,-145871,97084,242955,-48787,0,0,43940,0,0,,43940,43940
1,12/31/2018,60,14:45,15:00,49.88,,0,49.88,49.88,1,-117045,91588,208633,-25457,0,0,8661,0,0,,8661,8661
1,12/31/2018,61,15:00,15:15,45.88,,0,45.88,45.88,1,-96049,113752,209801,17703,0,0,2557,0,0,,2557,2557
1,12/31/2018,62,15:15,15:30,,,0,48.85,48.85,0,-83653,149601,233254,65948,0,0,140,0,0,,140,140
1,12/31/2018,63,15:30,15:45,,,0,48.34,48.34,0,-84280,166279,250559,81999,0,0,0,0,0,,0,0
1,12/31/2018,64,15:45,16:00,,,0,47.84,47.84,0,-130825,165725,296550,34900,0,0,0,0,0,,0,0
1,12/31/2018,65,16:00,16:15,,39.16,0,39.16,39.16,-1,-147243,170416,317659,23173,0,-7330,0,0,0,,7330,-7330
1,12/31/2018,66,16:15,16:30,,52.79,0,52.79,52.79,-1,-148294,136359,284653,-11935,0,-2280,0,0,0,,2280,-2280
1,12/31/2018,67,16:30,16:45,51.94,,0,51.94,51.94,1,-162254,118715,280969,-43539,0,0,1254,0,0,,1254,1254
1,12/31/2018,68,16:45,17:00,95.93,,0,95.93,95.93,1,-166543,102199,268742,-64344,0,0,38434,0,0,,38434,38434
1,12/31/2018,69,17:00,17:15,53.88,42.85,0,42.85,42.85,-1,-150783,131577,282360,-19206,0,-344,16604,0,0,,16948,16260
1,12/31/2018,70,17:15,17:30,,41.03,0,41.03,41.03,-1,-124982,175240,300222,50258,0,-8410,0,0,0,,8410,-8410
1,12/31/2018,71,17:30,17:45,,44.4,0,44.4,44.4,-1,-124790,179738,304528,54948,0,-2708,0,0,0,,2708,-2708
1,12/31/2018,72,17:45,18:00,,52.82,0,52.82,52.82,-1,-110408,194501,304909,84093,0,-334,0,0,0,,334,-334
1,12/31/2018,73,18:00,18:15,57.02,,0,57.02,57.02,1,-132101,113128,245229,-18973,0,0,13251,0,0,,13251,13251
1,12/31/2018,74,18:15,18:30,62.49,,0,62.49,62.49,1,-111454,127276,238730,15822,0,0,28194,0,0,,28194,28194
1,12/31/2018,75,18:30,18:45,45.88,,0,45.88,45.88,1,-95816,143257,239073,47441,0,0,6506,0,0,,6506,6506
1,12/31/2018,76,18:45,19:00,,,0,48.98,48.98,0,-82444,152198,234642,69754,0,0,44,0,0,,44,44
1,12/31/2018,77,19:00,19:15,48.25,,0,48.25,48.25,1,-138499,117649,256148,-20850,0,0,2749,0,0,,2749,2749
1,12/31/2018,78,19:15,19:30,45.88,,0,45.88,45.88,1,-100262,126970,227232,26708,0,0,612,0,0,,612,612
1,12/31/2018,79,19:30,19:45,,,0,49.3,49.3,0,-95445,145822,241267,50377,0,0,0,0,0,,0,0
1,12/31/2018,80,19:45,20:00,,41.32,0,41.32,41.32,-1,-101021,153729,254750,52708,0,-1365,0,0,0,,1365,-1365
1,12/31/2018,81,20:00,20:15,,20.03,0,20.03,20.03,-1,-69628,153487,223115,83859,0,-21534,0,0,0,,21534,-21534
1,12/31/2018,82,20:15,20:30,,36.73,0,36.73,36.73,-1,-58825,143781,202606,84956,0,-14703,0,0,0,,14703,-14703
1,12/31/2018,83,20:30,20:45,,36.73,0,36.73,36.73,-1,-50058,161757,211815,111699,0,-14481,0,0,0,,14481,-14481
1,12/31/2018,84,20:45,21:00,,-6.63,0,-6.63,-6.63,-1,-67473,180961,248434,113488,0,-49750,0,0,0,,49750,-49750
1,12/31/2018,85,21:00,21:15,,39.16,0,39.16,39.16,-1,-55941,171987,227928,116046,0,-18882,0,0,0,,18882,-18882
1,12/31/2018,86,21:15,21:30,,39.16,0,39.16,39.16,-1,-55936,167799,223735,111863,0,-161,0,0,0,,161,-161
1,12/31/2018,87,21:30,21:45,,11.64,0,11.64,11.64,-1,-50899,200822,251721,149923,0,-38712,0,0,0,,38712,-38712
1,12/31/2018,88,21:45,22:00,47.37,-47.55,0,48.03,-47.55,2,-87565,151036,238601,63471,0,-80072,2,0,0,,80074,-80070
1,12/31/2018,89,22:00,22:15,143.02,-47.55,0,143.02,143.02,1,-155883,61912,217795,-93971,0,-6097,19954,0,0,,26051,13857
1,12/31/2018,90,22:15,22:30,,,0,46.29,46.29,0,-101152,94991,196143,-6161,0,0,124,0,0,,124,124
1,12/31/2018,91,22:30,22:45,,46.47,0,46.47,46.47,-1,-105707,102377,208084,-3330,0,-921,0,0,0,,921,-921
1,12/31/2018,92,22:45,23:00,,21.73,0,21.73,21.73,-1,-133362,94460,227822,-38902,0,-2416,0,0,0,,2416,-2416
1,12/31/2018,93,23:00,23:15,71.73,-150.03,0,71.73,-150.03,2,-81622,75735,157357,-5887,0,-32589,4051,0,0,,36640,-28538
1,12/31/2018,94,23:15,23:30,69.4,42.85,0,69.4,42.85,2,-69258,68619,137877,-639,0,-1025,8443,0,0,,9468,7418
1,12/31/2018,95,23:30,23:45,,36.73,0,36.73,36.73,-1,-72851,100516,173367,27665,0,-21912,0,0,0,,21912,-21912
1,12/31/2018,96,23:45,0:00,,-9.69,0,-9.69,-9.69,-1,-41053,117326,158379,76273,0,-34619,0,0,0,,34619,-34619
